GIS_Number_valuations,Map_Name_valuations,Class_valuations,2011 Land Res,2011 Land Comm,2011 Land Total,2011 Dwlg,2011 Improv,2011 Total
112235302100000,NE 175,Ag Land,21090,0,21090,0,0,21090
112625100100000,CHURCH,Exempt,0,464400,464400,0,518023,982423
112625100200000,CHURCH,Exempt,0,663984,663984,0,5593600,6257584
112630300100000,NE 160,Residential,30870,0,30870,172914,0,203784
112630300200000,NE 160,Residential,29734,0,29734,203330,0,233064
112630300300000,NE 160,Residential,29070,0,29070,200252,0,229322
112630400100000,NE 160,Residential,30345,0,30345,269006,0,299351
112630400200000,NE 160,Residential,28560,0,28560,206108,0,234668
112630400300000,NE 160,Residential,28666,0,28666,204245,0,232911
112630400400000,NE 160,Residential,29988,0,29988,212103,0,242091
112630400500000,NE 160,Residential,28882,0,28882,200163,0,229045
112630400600000,NE 160,Residential,28759,0,28759,207183,0,235942
112630400700000,NE 160,Residential,26600,0,26600,192704,0,219304
112630400800000,NE 160,Residential,28000,0,28000,201501,0,229501
112630400900000,NE 160,Residential,29506,0,29506,222158,0,251664
112630401000000,NE 160,Residential,29144,0,29144,219652,0,248796
112630401100000,NE 160,Residential,30366,0,30366,173933,0,204299
112630401200000,NE 160,Residential,30607,0,30607,164637,0,195244
112630500100000,NE 160,Residential,30576,0,30576,244321,0,274897
112630500200000,NE 160,Residential,28657,0,28657,195854,0,224511
112630500300000,NE 160,Residential,28935,0,28935,193365,0,222300
112630500400000,NE 160,Residential,29988,0,29988,211832,0,241820
112630500500000,NE 160,Residential,28560,0,28560,199302,0,227862
112630500600000,NE 160,Residential,28560,0,28560,197563,0,226123
112630500700000,NE 160,Residential,32779,0,32779,194793,0,227572
112630600100000,NE 160,Residential,29404,0,29404,199433,0,228837
112630600200000,NE 160,Residential,29447,0,29447,215188,0,244635
112630600300000,NE 160,Residential,29125,0,29125,190469,0,219594
112630600400000,NE 160,Residential,30329,0,30329,241797,0,272126
112630600500000,NE 160,Residential,30031,0,30031,192565,0,222596
112630600600000,NE 160,Residential,26375,0,26375,192982,0,219357
112630600700000,NE 160,Residential,28546,0,28546,231913,0,260459
112630600800000,NE 160,Residential,27849,0,27849,233040,0,260889
112630600900000,NE 160,Residential,29400,0,29400,206755,0,236155
112630601000000,NE 160,Residential,26600,0,26600,203888,0,230488
112630601100000,NE 160,Residential,29400,0,29400,253793,0,283193
112630601200000,NE 160,Residential,28000,0,28000,220170,0,248170
112630601300000,NE 160,Residential,26600,0,26600,221267,0,247867
112630601400000,NE 160,Residential,29050,0,29050,238103,0,267153
112630601500000,NE 160,Residential,27687,0,27687,210971,0,238658
112630601600000,NE 160,Residential,29458,0,29458,211274,0,240732
112630601700000,NE 160,Residential,26781,0,26781,194835,0,221616
112630601800000,NE 160,Residential,27776,0,27776,231340,0,259116
112630601900000,NE 160,Residential,30048,0,30048,189271,0,219319
112630700100000,NE 160,Residential,30941,0,30941,186763,0,217704
112632700100000,NE 160,Residential,29747,0,29747,219753,0,249500
112632700200000,NE 160,Residential,31468,0,31468,233251,0,264719
112632700300000,NE 160,Residential,31890,0,31890,228082,0,259972
112632700400000,NE 160,Residential,27573,0,27573,209517,0,237090
112632700500000,NE 160,Residential,28881,0,28881,194758,0,223639
112632700600000,NE 160,Residential,28952,0,28952,203537,0,232489
112632700700000,NE 160,Residential,27927,0,27927,173069,0,200996
112632700800000,NE 160,Residential,29694,0,29694,182985,0,212679
112632700900000,NE 160,Residential,29610,0,29610,199195,0,228805
112632701000000,NE 160,Residential,29121,0,29121,171524,0,200645
112632701100000,NE 160,Residential,27846,0,27846,187451,0,215297
112632701200000,NE 160,Residential,29000,0,29000,219201,0,248201
112632701300000,NE 160,Residential,28960,0,28960,202108,0,231068
112632701400000,NE 160,Residential,30560,0,30560,201192,0,231752
112632701500000,NE 160,Residential,28560,0,28560,210279,0,238839
112632701600000,NE 160,Residential,29506,0,29506,205604,0,235110
112632701700000,NE 160,Residential,28960,0,28960,266608,0,295568
112632701800000,NE 160,Residential,26081,0,26081,219658,0,245739
112632701900000,NE 160,Residential,29299,0,29299,279067,0,308366
112632702000000,NE 160,Residential,28720,0,28720,190646,0,219366
112632702100000,NE 160,Residential,28885,0,28885,236914,0,265799
112632702200000,NE 160,Residential,26866,0,26866,183455,0,210321
112632702300000,NE 160,Residential,29694,0,29694,204283,0,233977
112632702400000,NE 160,Residential,29826,0,29826,252556,0,282382
112632800100000,NE 160,Residential,30245,0,30245,214076,0,244321
112632800200000,NE 160,Residential,71200,0,71200,41044,0,112244
112632800300000,NE 160,Residential,55350,0,55350,173386,0,228736
112632800400000,NE 160,Residential,53450,0,53450,166412,0,219862
112632800500000,NE 160,Residential,30594,0,30594,184507,0,215101
112632800600000,NE 160,Residential,30154,0,30154,231261,0,261415
112632800700000,NE 160,Residential,28560,0,28560,188175,0,216735
112632800800000,NE 160,Residential,30345,0,30345,204086,0,234431
112632800900000,NE 160,Residential,29850,0,29850,218654,0,248504
112632801000000,NE 160,Residential,32523,0,32523,211126,0,243649
112632801100000,NE 160,Residential,30358,0,30358,223006,0,253364
112632801200000,NE 160,Residential,29960,0,29960,204830,0,234790
112632801300000,NE 160,Residential,30749,0,30749,233193,0,263942
112632801400000,NE 160,Residential,29753,0,29753,260356,0,290109
112632801500000,NE 160,Residential,29724,0,29724,187610,0,217334
112632801600000,NE 160,Residential,28650,0,28650,203361,0,232011
112632801700000,NE 160,Residential,29613,0,29613,196856,0,226469
112632801800000,NE 160,Residential,28636,0,28636,194809,0,223445
112632801900000,NE 160,Residential,29441,0,29441,182144,0,211585
112632802000000,NE 160,Residential,30118,0,30118,202010,0,232128
112632802100000,NE 160,Residential,28560,0,28560,203513,0,232073
112632802200000,NE 160,Residential,29167,0,29167,165267,0,194434
112632802300000,NE 160,Residential,27846,0,27846,208812,0,236658
112632802400000,NE 160,Residential,29988,0,29988,204885,0,234873
112632802500000,NE 160,Residential,28560,0,28560,206420,0,234980
112632900100000,NE 160,Residential,30941,0,30941,222007,0,252948
112632900200000,NE 160,Residential,28595,0,28595,213010,0,241605
112632900300000,NE 160,Residential,27418,0,27418,199095,0,226513
112632900400000,NE 160,Residential,29057,0,29057,185480,0,214537
112632900500000,NE 160,Residential,29204,0,29204,222060,0,251264
112632900600000,NE 160,Residential,27569,0,27569,247813,0,275382
112632900700000,NE 160,Residential,29416,0,29416,210848,0,240264
112632900800000,NE 160,Residential,27132,0,27132,207403,0,234535
112632900900000,NE 160,Residential,28560,0,28560,208196,0,236756
112632901000000,NE 160,Residential,29988,0,29988,237741,0,267729
112632901100000,NE 160,Residential,28152,0,28152,187479,0,215631
112632901200000,NE 160,Residential,28768,0,28768,197344,0,226112
112632901300000,NE 160,Residential,29077,0,29077,207734,0,236811
112635100100000,NE 160,Residential,30358,0,30358,209860,0,240218
112635100200000,NE 160,Residential,28628,0,28628,196010,0,224638
112635100300000,NE 160,Residential,29799,0,29799,205230,0,235029
112635100400000,NE 160,Residential,28117,0,28117,213828,0,241945
112635100500000,NE 160,Residential,31091,0,31091,257347,0,288438
112635100600000,NE 160,Residential,30677,0,30677,258356,0,289033
112635100700000,NE 160,Residential,28591,0,28591,182450,0,211041
112635100800000,NE 160,Residential,29757,0,29757,199633,0,229390
112635200100000,NE 160,Residential,28679,0,28679,185041,0,213720
112635200200000,NE 160,Residential,30891,0,30891,208321,0,239212
112635200300000,NE 160,Residential,29106,0,29106,197899,0,227005
112635200400000,NE 160,Residential,30345,0,30345,223792,0,254137
112635300100000,NE 160,Residential,30184,0,30184,230186,0,260370
112635300200000,NE 160,Residential,28566,0,28566,190432,0,218998
112635300300000,NE 160,Residential,30297,0,30297,178854,0,209151
112635300400000,NE 160,Residential,28560,0,28560,182897,0,211457
112635300500000,NE 160,Residential,28560,0,28560,202447,0,231007
112635300600000,NE 160,Residential,28842,0,28842,190369,0,219211
112635300700000,NE 160,Residential,28828,0,28828,192452,0,221280
112635300800000,NE 160,Residential,29225,0,29225,198423,0,227648
112635300900000,NE 160,Residential,28538,0,28538,199487,0,228025
112635301000000,NE 160,Residential,28560,0,28560,182379,0,210939
112635301100000,NE 160,Residential,28560,0,28560,171924,0,200484
112635301200000,NE 160,Residential,28190,0,28190,216677,0,244867
112635301300000,NE 160,Residential,29939,0,29939,196037,0,225976
112635301400000,NE 160,Residential,30316,0,30316,184757,0,215073
112635301500000,NE 160,Residential,29925,0,29925,186318,0,216243
112635301600000,NE 160,Residential,30330,0,30330,203551,0,233881
112635301700000,NE 160,Residential,28574,0,28574,213805,0,242379
112635301800000,NE 160,Residential,29988,0,29988,230229,0,260217
112635301900000,NE 160,Residential,27132,0,27132,190691,0,217823
112635302000000,NE 160,Residential,29432,0,29432,252977,0,282409
112635302100000,NE 160,Residential,29869,0,29869,205902,0,235771
112635302200000,NE 160,Residential,29869,0,29869,209182,0,239051
112635302300000,NE 160,Residential,29234,0,29234,203763,0,232997
112635302400000,NE 160,Residential,28870,0,28870,204967,0,233837
112635302500000,NE 160,Residential,29080,0,29080,191802,0,220882
112635302600000,NE 160,Residential,31410,0,31410,194304,0,225714
112635302700000,NE 160,Residential,31395,0,31395,207787,0,239182
112635302800000,NE 160,Residential,29400,0,29400,205564,0,234964
112635400100000,NE 160,Residential,28333,0,28333,155752,0,184085
112635400200000,NE 160,Residential,28560,0,28560,204104,0,232664
112635400300000,NE 160,Residential,29466,0,29466,205162,0,234628
112635400400000,NE 160,Residential,29938,0,29938,209737,0,239675
112635400500000,NE 160,Residential,30381,0,30381,213537,0,243918
112635400600000,NE 160,Residential,33005,0,33005,182666,0,215671
112635400700000,NE 160,Residential,32452,0,32452,217383,0,249835
112635400800000,NE 160,Residential,29976,0,29976,205177,0,235153
112635400900000,NE 160,Residential,29420,0,29420,243702,0,273122
112635401000000,NE 160,Residential,29267,0,29267,213118,0,242385
112635401100000,NE 160,Residential,28854,0,28854,208523,0,237377
112635401200000,NE 160,Residential,29566,0,29566,186774,0,216340
112635401300000,NE 160,Residential,29830,0,29830,195587,0,225417
112635401400000,NE 160,Residential,30444,0,30444,240205,0,270649
112635401500000,NE 160,Residential,30559,0,30559,208536,0,239095
112635401600000,NE 160,Residential,30667,0,30667,228840,0,259507
112635401700000,NE 160,Residential,46350,0,46350,266250,0,312600
112635401800000,NE 160,Residential,31601,0,31601,249584,0,281185
112635401900000,NE 160,Residential,30521,0,30521,209482,0,240003
112635402000000,NE 160,Residential,30523,0,30523,209074,0,239597
112635402100000,NE 160,Residential,30674,0,30674,230570,0,261244
112635402200000,NE 160,Residential,29130,0,29130,201151,0,230281
112635402300000,NE 160,Residential,30800,0,30800,218042,0,248842
112635402400000,NE 160,Residential,29188,0,29188,192515,0,221703
112635402500000,NE 160,Residential,28000,0,28000,232597,0,260597
112635402600000,NE 160,Residential,29792,0,29792,215877,0,245669
112635402700000,NE 160,Residential,29792,0,29792,191591,0,221383
112635402800000,NE 160,Residential,29792,0,29792,218379,0,248171
112635402900000,NE 160,Residential,29420,0,29420,193435,0,222855
112635403000000,NE 160,Residential,28616,0,28616,186226,0,214842
112635403100000,NE 160,Residential,29715,0,29715,178373,0,208088
112635403200000,NE 160,Residential,30164,0,30164,251597,0,281761
112635403300000,NE 160,Residential,30264,0,30264,209014,0,239278
112635403400000,NE 160,Residential,29543,0,29543,167361,0,196904
112635403500000,NE 160,Residential,28989,0,28989,213056,0,242045
112635403600000,NE 160,Residential,30070,0,30070,203669,0,233739
112635403700000,NE 160,Residential,31086,0,31086,207614,0,238700
112635403800000,NE 160,Residential,30070,0,30070,231333,0,261403
112635403900000,NE 160,Residential,29096,0,29096,219428,0,248524
112635404000000,NE 160,Residential,30807,0,30807,178075,0,208882
112635404100000,NE 160,Residential,28613,0,28613,214603,0,243216
112635404200000,NE 160,Residential,29318,0,29318,197488,0,226806
112635500100000,NE 160,Residential,30446,0,30446,181859,0,212305
112635600100000,NE 160,Residential,31118,0,31118,192985,0,224103
112635700100000,NE 160,Residential,32879,0,32879,266680,0,299559
112635700300000,NE 160,Residential,29605,0,29605,198116,0,227721
112635700400000,NE 160,Residential,29393,0,29393,194263,0,223656
112635700500000,NE 160,Residential,28561,0,28561,195194,0,223755
112637600100000,NE 160,Residential,28938,0,28938,198073,0,227011
112637600200000,NE 160,Residential,29072,0,29072,207313,0,236385
112637600300000,NE 160,Residential,29451,0,29451,163102,0,192553
112637600400000,NE 160,Residential,29724,0,29724,176326,0,206050
112637600500000,NE 160,Residential,29684,0,29684,187195,0,216879
112637600600000,NE 160,Residential,28817,0,28817,204505,0,233322
112637600700000,NE 160,Residential,29840,0,29840,167561,0,197401
112637600800000,NE 160,Residential,29345,0,29345,206269,0,235614
112637600900000,NE 160,Residential,26671,0,26671,175808,0,202479
112637601000000,NE 160,Residential,29925,0,29925,217651,0,247576
112637700100000,NE 160,Residential,28932,0,28932,184106,0,213038
112637700200000,NE 160,Residential,26866,0,26866,206290,0,233156
112637700300000,NE 160,Residential,29200,0,29200,196862,0,226062
112637700400000,NE 160,Residential,29645,0,29645,188891,0,218536
112637700500000,NE 160,Residential,29694,0,29694,224861,0,254555
112637700600000,NE 160,Residential,27743,0,27743,177149,0,204892
112637700700000,NE 160,Residential,29283,0,29283,194324,0,223607
112637700800000,NE 160,Residential,26437,0,26437,201115,0,227552
112637700900000,NE 160,Residential,27916,0,27916,185036,0,212952
112637701000000,NE 160,Residential,26950,0,26950,183189,0,210139
112637701100000,NE 160,Residential,29988,0,29988,192829,0,222817
112637701200000,NE 160,Residential,29686,0,29686,227554,0,257240
112637701300000,NE 160,Residential,29377,0,29377,221674,0,251051
112637701400000,NE 160,Residential,28469,0,28469,162936,0,191405
112637701500000,NE 160,Residential,30680,0,30680,218822,0,249502
112637701600000,NE 160,Residential,30721,0,30721,189141,0,219862
112637701700000,NE 160,Residential,29054,0,29054,180982,0,210036
112637701800000,NE 160,Residential,29155,0,29155,178297,0,207452
112637701900000,NE 160,Residential,29260,0,29260,180718,0,209978
112637702000000,NE 160,Residential,27720,0,27720,191162,0,218882
112637702100000,NE 160,Residential,27720,0,27720,203065,0,230785
112637702200000,NE 160,Residential,29400,0,29400,189571,0,218971
112637702300000,NE 160,Residential,28392,0,28392,194315,0,222707
112637702400000,NE 160,Residential,29136,0,29136,179394,0,208530
112637702500000,NE 160,Residential,28978,0,28978,210794,0,239772
112637702600000,NE 160,Residential,30315,0,30315,192654,0,222969
112637702700000,NE 160,Residential,28946,0,28946,204062,0,233008
112637800100000,NE 160,Residential,28560,0,28560,211278,0,239838
112637800200000,NE 160,Residential,27132,0,27132,209459,0,236591
112637800300000,NE 160,Residential,29631,0,29631,214415,0,244046
112637800400000,NE 160,Residential,29047,0,29047,239843,0,268890
112637800500000,NE 160,Residential,28679,0,28679,230135,0,258814
112637800600000,NE 160,Residential,29370,0,29370,207143,0,236513
112637800700000,NE 160,Residential,28233,0,28233,211656,0,239889
112637800800000,NE 160,Residential,28053,0,28053,177341,0,205394
112637800900000,NE 160,Residential,28700,0,28700,214066,0,242766
112637801000000,NE 160,Residential,29223,0,29223,196598,0,225821
112637801100000,NE 160,Residential,30356,0,30356,209180,0,239536
112637801200000,NE 160,Residential,28583,0,28583,200844,0,229427
112637801300000,NE 160,Residential,28382,0,28382,207989,0,236371
112637801400000,NE 160,Residential,28000,0,28000,208378,0,236378
112637801500000,NE 160,Residential,28000,0,28000,196241,0,224241
112637801600000,NE 160,Residential,26984,0,26984,202194,0,229178
112637801700000,NE 160,Residential,28827,0,28827,192753,0,221580
112637801800000,NE 160,Residential,28916,0,28916,201419,0,230335
112637801900000,NE 160,Residential,29825,0,29825,187965,0,217790
112637802000000,NE 160,Residential,28560,0,28560,182778,0,211338
112637900100000,NE 160,Residential,30047,0,30047,224785,0,254832
112637900200000,NE 160,Residential,28541,0,28541,196363,0,224904
112637900300000,NE 160,Residential,29006,0,29006,202088,0,231094
112637900400000,NE 160,Residential,28009,0,28009,190880,0,218889
112637900500000,NE 160,Residential,29274,0,29274,191635,0,220909
112637900600000,NE 160,Residential,30307,0,30307,167098,0,197405
112637900700000,NE 160,Residential,29000,0,29000,193845,0,222845
112637900800000,NE 160,Residential,28280,0,28280,206246,0,234526
112637900900000,NE 160,Residential,31462,0,31462,245247,0,276709
112637901000000,NE 160,Residential,29662,0,29662,254741,0,284403
112638000100000,NE 160,Residential,29925,0,29925,196796,0,226721
112638000200000,NE 160,Residential,26600,0,26600,216021,0,242621
112638000300000,NE 160,Residential,29400,0,29400,188049,0,217449
112638000400000,NE 160,Residential,28000,0,28000,188898,0,216898
112638000500000,NE 160,Residential,28000,0,28000,185180,0,213180
112638100100000,NE 160,Residential,31424,0,31424,186375,0,217799
112638100200000,NE 160,Residential,29925,0,29925,156842,0,186767
112638100300000,NE 160,Residential,29568,0,29568,173001,0,202569
112638100400000,NE 160,Residential,30000,0,30000,198039,0,228039
112638100500000,NE 160,Residential,28185,0,28185,195448,0,223633
112638100600000,NE 160,Residential,27132,0,27132,183545,0,210677
112638100700000,NE 160,Residential,28560,0,28560,192827,0,221387
112638100800000,NE 160,Residential,28502,0,28502,174994,0,203496
112638100900000,NE 160,Residential,27190,0,27190,149920,0,177110
112638101000000,NE 160,Residential,28560,0,28560,173189,0,201749
112638101100000,NE 160,Residential,28560,0,28560,186711,0,215271
112638101200000,NE 160,Residential,27132,0,27132,201135,0,228267
112638101300000,NE 160,Residential,29988,0,29988,186334,0,216322
112638101400000,NE 160,Residential,28560,0,28560,195641,0,224201
112638101500000,NE 160,Residential,28560,0,28560,200246,0,228806
112638101600000,NE 160,Residential,27720,0,27720,200344,0,228064
112638101700000,NE 160,Residential,30030,0,30030,149502,0,179532
112638200100000,NE 160,Residential,30522,0,30522,191298,0,221820
112638200200000,NE 160,Residential,25100,0,25100,173146,0,198246
112638200300000,NE 160,Residential,29252,0,29252,209228,0,238480
112638200400000,NE 160,Residential,30430,0,30430,172757,0,203187
112638200500000,NE 160,Residential,29457,0,29457,200466,0,229923
112638200600000,NE 160,Residential,29512,0,29512,179424,0,208936
112638200700000,NE 160,Residential,29988,0,29988,188974,0,218962
112638200800000,NE 160,Residential,27132,0,27132,180044,0,207176
112638200900000,NE 160,Residential,27132,0,27132,189713,0,216845
112638201000000,NE 160,Residential,29988,0,29988,205326,0,235314
112638201100000,NE 160,Residential,31118,0,31118,242066,0,273184
112638201200000,NE 160,Residential,29988,0,29988,216681,0,246669
112638201300000,NE 160,Residential,28203,0,28203,211907,0,240110
112638201400000,NE 160,Residential,26061,0,26061,169914,0,195975
112638201500000,NE 160,Residential,29988,0,29988,183331,0,213319
112638201600000,NE 160,Residential,27132,0,27132,200319,0,227451
112638201700000,NE 160,Residential,29047,0,29047,197074,0,226121
112638201800000,NE 160,Residential,30953,0,30953,189420,0,220373
112638201900000,NE 160,Residential,31450,0,31450,223894,0,255344
112638202000000,NE 160,Residential,28560,0,28560,159114,0,187674
112638202100000,NE 160,Residential,28560,0,28560,149571,0,178131
112638202200000,NE 160,Residential,28560,0,28560,197775,0,226335
112638202300000,NE 160,Residential,30430,0,30430,203759,0,234189
112638300100000,NE 160,Residential,29792,0,29792,189905,0,219697
112638300200000,NE 160,Residential,29792,0,29792,184688,0,214480
112712600400000,NE 110,Residential,49600,0,49600,226409,0,276009
112712600500000,NE 110,Residential,51750,0,51750,160497,0,212247
112712600600000,NE 110,Residential,53750,0,53750,222194,0,275944
112712700200000,NE 173,Residential,50639,0,50639,186671,0,237310
112712700300000,NE 173,Residential,46283,0,46283,227638,0,273921
112712700400000,NE 173,Residential,46283,0,46283,199307,0,245590
112712700500000,NE 173,Residential,46283,0,46283,208897,0,255180
112712800100000,NE 173,Residential,48620,0,48620,205230,0,253850
112715200100000,NE 101,Ag Land,18013,0,18013,0,0,18013
112715200200000,NE 173,Residential,59796,0,59796,235402,0,295198
112715200300000,NE 173,Residential,52470,0,52470,243440,0,295910
112715200400000,NE 173,Residential,71058,0,71058,256486,0,327544
112715200500000,NE 173,Residential,47218,0,47218,177671,0,224889
112715200600000,NE 173,Residential,48620,0,48620,219688,0,268308
112715200700000,NE 173,Residential,53387,0,53387,220678,0,274065
112715200800000,NE 173,Residential,45760,0,45760,215267,0,261027
112715200900000,NE 173,Residential,45760,0,45760,228134,0,273894
112715201000000,NE 173,Residential,45760,0,45760,227371,0,273131
112715201100000,NE 173,Residential,45760,0,45760,242850,0,288610
112715201200000,NE 173,Residential,45760,0,45760,211931,0,257691
112715201300000,NE 173,Residential,45760,0,45760,225765,0,271525
112715201400000,NE 173,Residential,50490,0,50490,235645,0,286135
112715201500000,NE 173,Residential,62770,0,62770,231176,0,293946
112715201600000,NE 173,Residential,60048,0,60048,0,0,60048
112715201700000,NE 173,Residential,55550,0,55550,0,0,55550
112715201800000,NE 173,Residential,62729,0,62729,228039,0,290768
112715201900000,NE 173,Residential,56940,0,56940,237505,0,294445
112715202000000,NE 173,Residential,48620,0,48620,238441,0,287061
112715202100000,NE 173,Residential,46130,0,46130,4990,0,51120
112715202200000,NE 173,Residential,61371,0,61371,237553,0,298924
112715202300000,NE 173,Residential,75295,0,75295,308256,0,383551
112715202400000,NE 173,Residential,59253,0,59253,144992,0,204245
112715202500000,NE 173,Residential,52515,0,52515,0,0,52515
112715202600000,NE 173,Residential,59557,0,59557,0,0,59557
112715300100000,NE 173,Residential,48895,0,48895,222509,0,271404
112715300200000,NE 173,Residential,51304,0,51304,213528,0,264832
112715300300000,NE 173,Residential,45760,0,45760,0,0,45760
112715300400000,NE 173,Residential,45320,0,45320,0,0,45320
112715300500000,NE 173,Residential,45320,0,45320,0,0,45320
112715300600000,NE 173,Residential,45320,0,45320,0,0,45320
112715300700000,NE 173,Residential,45320,0,45320,0,0,45320
112715300800000,NE 173,Residential,44880,0,44880,208882,0,253762
112715300900000,NE 173,Residential,44880,0,44880,220768,0,265648
112715301000000,NE 173,Residential,51333,0,51333,228996,0,280329
112715301100000,NE 173,Residential,54230,0,54230,232255,0,286485
112715301200000,NE 173,Residential,55440,0,55440,207452,0,262892
112715301300000,NE 173,Residential,60236,0,60236,256751,0,316987
112715400100000,NE 173,Residential,60517,0,60517,0,0,60517
112715400200000,NE 173,Residential,53093,0,53093,0,0,53093
112715400300000,NE 173,Residential,52250,0,52250,0,0,52250
112715400400000,NE 173,Residential,46750,0,46750,0,0,46750
112715400500000,NE 173,Residential,46750,0,46750,210647,0,257397
112715400600000,NE 173,Residential,46750,0,46750,0,0,46750
112715400700000,NE 173,Residential,46750,0,46750,0,0,46750
112715400800000,NE 173,Residential,46750,0,46750,231192,0,277942
112715400900000,NE 173,Residential,46750,0,46750,217892,0,264642
112715401000000,NE 173,Residential,46750,0,46750,233091,0,279841
112715401100000,NE 173,Residential,46750,0,46750,189285,0,236035
112715401200000,NE 173,Residential,46750,0,46750,209048,0,255798
112715401300000,NE 173,Residential,58542,0,58542,191542,0,250084
112717700100000,NE 101,Ag Land,12975,0,12975,0,0,12975
112720401500000,NE 162,Ag Land,10346,0,10346,0,0,10346
112720401600000,SCHOOL,Exempt,0,0,0,0,0,0
112720401700000,NE 101,Ag Land,87,0,87,0,0,87
112722600500000,NE 175,Ag Land,9218,0,9218,0,0,9218
112722700100000,NE 175,Residential,32700,0,32700,63934,0,96634
112722700200000,NE 175,Residential,31392,0,31392,37820,0,69212
112722700300000,NE 175,Residential,31080,0,31080,35907,0,66987
112722700400000,NE 175,Residential,26000,0,26000,35215,0,61215
112722700500000,NE 175,Residential,173,0,173,0,0,173
112722700600000,NE 175,Residential,173,0,173,0,0,173
112722700700000,NE 175,Residential,173,0,173,0,0,173
112722700800000,NE 175,Residential,173,0,173,0,0,173
112722700900000,NE 175,Residential,202,0,202,0,0,202
112722800100000,NE 175,Residential,194,0,194,0,0,194
112722800200000,NE 175,Residential,193,0,193,0,0,193
112722900100000,NE 175,Residential,188,0,188,0,0,188
112722900200000,NE 175,Residential,188,0,188,0,0,188
112722900300000,NE 175,Residential,188,0,188,0,0,188
112722900400000,NE 175,Residential,188,0,188,0,0,188
112722900500000,NE 175,Residential,188,0,188,0,0,188
112722900600000,NE 175,Residential,188,0,188,0,0,188
112722900700000,NE 175,Residential,188,0,188,0,0,188
112722900800000,NE 175,Residential,188,0,188,0,0,188
112722900900000,NE 175,Residential,188,0,188,0,0,188
112722901000000,NE 175,Residential,188,0,188,0,0,188
112723000100000,NE 175,Residential,212,0,212,0,0,212
112723000200000,NE 175,Residential,31916,0,31916,35670,0,67586
112723000300000,NE 175,Residential,24240,0,24240,10395,0,34635
112723000400000,NE 175,Residential,165,0,165,0,0,165
112723000500000,NE 175,Residential,165,0,165,0,0,165
112723000600000,NE 175,Residential,24240,0,24240,10395,0,34635
112723000700000,NE 175,Residential,212,0,212,0,0,212
112723000800000,NE 175,Residential,212,0,212,0,0,212
112723000900000,NE 175,Residential,165,0,165,0,0,165
112723001000000,NE 175,Residential,165,0,165,0,0,165
112723001100000,NE 175,Residential,165,0,165,0,0,165
112723001200000,NE 175,Residential,165,0,165,0,0,165
112723100100000,NE 175,Residential,206,0,206,0,0,206
112723100200000,NE 175,Residential,302,0,302,0,0,302
112723100300000,NE 175,Residential,226,0,226,0,0,226
112723100400000,NE 175,Residential,233,0,233,0,0,233
112723100500000,NE 175,Residential,202,0,202,0,0,202
112723100600000,NE 175,Residential,153,0,153,0,0,153
112723100700000,NE 175,Residential,153,0,153,0,0,153
112723100800000,NE 175,Residential,154,0,154,0,0,154
112723100900000,NE 175,Residential,235,0,235,0,0,235
112723101000000,NE 175,Residential,24240,0,24240,10395,0,34635
112723101100000,NE 175,Residential,24240,0,24240,10395,0,34635
112723101200000,NE 175,Residential,167,0,167,0,0,167
112723101300000,NE 175,Residential,167,0,167,0,0,167
112723101400000,NE 175,Residential,167,0,167,0,0,167
112723101500000,NE 175,Residential,184,0,184,0,0,184
112723101600000,NE 175,Residential,194,0,194,0,0,194
112723200100000,NE 175,Residential,186,0,186,0,0,186
112723300100000,NE 175,Residential,180,0,180,0,0,180
112723300200000,NE 175,Residential,189,0,189,0,0,189
112723400100000,NE 175,Residential,176,0,176,0,0,176
112723400200000,NE 175,Residential,151,0,151,0,0,151
112723400300000,NE 175,Residential,23520,0,23520,10395,0,33915
112723400400000,NE 175,Residential,151,0,151,0,0,151
112723400500000,NE 175,Residential,23520,0,23520,120146,0,143666
112723400600000,NE 175,Residential,23520,0,23520,119477,0,142997
112723400700000,NE 175,Residential,23280,0,23280,107034,0,130314
112723400800000,NE 175,Residential,23040,0,23040,120146,0,143186
112723400900000,NE 175,Residential,23040,0,23040,105622,0,128662
112723401000000,NE 175,Residential,23520,0,23520,120146,0,143666
112723401100000,NE 175,Residential,24000,0,24000,99558,0,123558
112723401200000,NE 175,Residential,24240,0,24240,116430,0,140670
112723401300000,NE 175,Residential,24480,0,24480,98418,0,122898
112723401400000,NE 175,Residential,26520,0,26520,120146,0,146666
112723500100000,NE 175,Residential,27072,0,27072,99558,0,126630
112723500200000,NE 175,Residential,27072,0,27072,107319,0,134391
112723500300000,NE 175,Residential,27824,0,27824,99380,0,127204
112723500400000,NE 175,Residential,121,0,121,0,0,121
112725100400000,NE 101,Ag Dwelling,39117,0,39117,236940,0,276057
112725100500000,NE 175,Ag Land,24967,0,24967,0,0,24967
112727600100000,NE 101,Ag Land,40786,0,40786,0,0,40786
112727600200000,NE 173,Residential,57173,0,57173,0,0,57173
112727600300000,NE 173,Residential,46283,0,46283,212623,0,258906
112727600400000,NE 173,Residential,46283,0,46283,93681,0,139964
112727600500000,NE 173,Residential,46283,0,46283,159136,0,205419
112727600600000,NE 173,Residential,49005,0,49005,223738,0,272743
112727700100000,NE 173,Residential,52250,0,52250,278368,0,330618
112727700200000,NE 173,Residential,47300,0,47300,0,0,47300
112727700300000,NE 173,Residential,47300,0,47300,244571,0,291871
112727700400000,NE 173,Residential,47300,0,47300,257018,0,304318
112727800100000,NE 173,Residential,64251,0,64251,258827,0,323078
112727800200000,NE 173,Residential,61050,0,61050,224234,0,285284
112727800300000,NE 173,Residential,66385,0,66385,210932,0,277317
112727800400000,NE 173,Residential,60060,0,60060,238853,0,298913
112727900100000,NE 173,Residential,47260,0,47260,202740,0,250000
112727900200000,NE 173,Residential,47850,0,47850,226537,0,274387
112727900300000,NE 173,Residential,44000,0,44000,281731,0,325731
112727900400000,NE 173,Residential,44000,0,44000,0,0,44000
112727900500000,NE 173,Residential,43633,0,43633,219856,0,263489
112727900600000,NE 173,Residential,43083,0,43083,0,0,43083
112727900700000,NE 173,Residential,42289,0,42289,0,0,42289
112727900800000,NE 173,Residential,41701,0,41701,251673,0,293374
112727900900000,NE 173,Residential,46332,0,46332,207406,0,253738
112727901000000,NE 173,Residential,46640,0,46640,211942,0,258582
112728100100000,NE 173,Residential,48950,0,48950,0,0,48950
112728200100000,NE 173,Residential,48950,0,48950,185381,0,234331
112728200200000,NE 173,Residential,48950,0,48950,194724,0,243674
112730100100000,NE 101,Ag Land,17942,0,17942,0,0,17942
112730100300000,NE 163,Residential,30269,0,30269,135869,0,166138
112730100400000,NE 163,Residential,26948,0,26948,152205,0,179153
112730100500000,NE 163,Residential,26948,0,26948,162215,0,189163
112730100600000,NE 163,Residential,26948,0,26948,150430,0,177378
112730100700000,NE 163,Residential,26948,0,26948,155644,0,182592
112730100800000,NE 163,Residential,26948,0,26948,139734,0,166682
112730100900000,NE 163,Residential,26948,0,26948,145874,0,172822
112730101000000,NE 163,Residential,26948,0,26948,184569,0,211517
112730101100000,NE 163,Residential,26948,0,26948,140271,0,167219
112730101200000,NE 163,Residential,26948,0,26948,177473,0,204421
112730101300000,NE 163,Residential,26948,0,26948,140351,0,167299
112730101400000,NE 163,Residential,26948,0,26948,117220,0,144168
112730101500000,NE 163,Residential,26948,0,26948,138550,0,165498
112730101600000,NE 163,Residential,26948,0,26948,131529,0,158477
112730101700000,NE 163,Residential,26948,0,26948,155837,0,182785
112730101800000,NE 163,Residential,26948,0,26948,140677,0,167625
112730101900000,NE 163,Residential,30000,0,30000,185426,0,215426
112730102000000,NE 163,Residential,30000,0,30000,154701,0,184701
112730102100000,NE 163,Residential,26948,0,26948,142896,0,169844
112730102200000,NE 163,Residential,26948,0,26948,152886,0,179834
112730102300000,NE 163,Residential,26948,0,26948,157691,0,184639
112730102400000,NE 163,Residential,26948,0,26948,170428,0,197376
112730102500000,NE 163,Residential,26948,0,26948,157627,0,184575
112730102600000,NE 163,Residential,26948,0,26948,165848,0,192796
112730102700000,NE 163,Residential,26948,0,26948,168199,0,195147
112730102800000,NE 163,Residential,26948,0,26948,168665,0,195613
112730102900000,NE 163,Residential,26948,0,26948,144649,0,171597
112730103000000,NE 163,Residential,26948,0,26948,144264,0,171212
112730103100000,NE 163,Residential,26948,0,26948,160188,0,187136
112730103200000,NE 163,Residential,26948,0,26948,181932,0,208880
112730103300000,NE 163,Residential,26948,0,26948,170170,0,197118
112730103400000,NE 163,Residential,26948,0,26948,184866,0,211814
112730103500000,NE 163,Residential,26948,0,26948,168441,0,195389
112730103600000,NE 163,Residential,31349,0,31349,155921,0,187270
112730200100000,NE 163,Residential,26000,0,26000,157994,0,183994
112730200200000,NE 163,Residential,31532,0,31532,157572,0,189104
112730200300000,NE 163,Residential,28620,0,28620,162867,0,191487
112730200400000,NE 163,Residential,28620,0,28620,161269,0,189889
112730200500000,NE 163,Residential,28620,0,28620,175931,0,204551
112730200600000,NE 163,Residential,30600,0,30600,182446,0,213046
112730200700000,NE 163,Residential,32980,0,32980,167002,0,199982
112730200800000,NE 163,Residential,32000,0,32000,157609,0,189609
112730200900000,NE 163,Residential,31040,0,31040,158981,0,190021
112730201000000,NE 163,Residential,20,0,20,0,0,20
112730201100000,NE 163,Residential,15,0,15,0,0,15
112730300100000,NE 163,Residential,30000,0,30000,152591,0,182591
112730300200000,NE 163,Residential,420,0,420,0,0,420
112730300300000,NE 163,Residential,420,0,420,0,0,420
112730300400000,NE 163,Residential,396,0,396,0,0,396
112730300500000,NE 163,Residential,26400,0,26400,158834,0,185234
112730300600000,NE 163,Residential,26400,0,26400,165765,0,192165
112730300700000,NE 163,Residential,26400,0,26400,154804,0,181204
112730300800000,NE 163,Residential,26400,0,26400,153769,0,180169
112730300900000,NE 163,Residential,26400,0,26400,134870,0,161270
112730301000000,NE 163,Residential,26400,0,26400,158757,0,185157
112730301100000,NE 163,Residential,26400,0,26400,133483,0,159883
112730301200000,NE 163,Residential,26400,0,26400,147803,0,174203
112730301300000,NE 163,Residential,26400,0,26400,153621,0,180021
112730301400000,NE 163,Residential,26400,0,26400,135321,0,161721
112730301500000,NE 163,Residential,26400,0,26400,158549,0,184949
112730301600000,NE 163,Residential,26400,0,26400,149838,0,176238
112730301700000,NE 163,Residential,26400,0,26400,134832,0,161232
112730301800000,NE 163,Residential,26400,0,26400,142788,0,169188
112730301900000,NE 163,Residential,26403,0,26403,132655,0,159058
112730302000000,NE 163,Residential,27141,0,27141,139796,0,166937
112730400100000,NE 163,Residential,31200,0,31200,158264,0,189464
112730400200000,NE 163,Residential,26948,0,26948,151140,0,178088
112730400300000,NE 163,Residential,26948,0,26948,172096,0,199044
112730400400000,NE 163,Residential,26948,0,26948,135488,0,162436
112730400500000,NE 163,Residential,26948,0,26948,158229,0,185177
112730400600000,NE 163,Residential,26948,0,26948,141645,0,168593
112730400700000,NE 163,Residential,27148,0,27148,157852,0,185000
112730400800000,NE 163,Residential,26948,0,26948,143383,0,170331
112730400900000,NE 163,Residential,26948,0,26948,177027,0,203975
112730401000000,NE 163,Residential,26948,0,26948,176670,0,203618
112730401100000,NE 163,Residential,26948,0,26948,144277,0,171225
112730401200000,NE 163,Residential,26948,0,26948,158885,0,185833
112730401300000,NE 163,Residential,26948,0,26948,159595,0,186543
112730401400000,NE 163,Residential,26948,0,26948,155995,0,182943
112730401500000,NE 163,Residential,26948,0,26948,158260,0,185208
112730401600000,NE 163,Residential,26948,0,26948,158781,0,185729
112730401700000,NE 163,Residential,31093,0,31093,171150,0,202243
112730401800000,NE 101,Residential,122,0,122,0,0,122
112730401900000,NE 163,Residential,32173,0,32173,141772,0,173945
112730402000000,NE 163,Residential,26948,0,26948,136424,0,163372
112730402100000,NE 163,Residential,26948,0,26948,149292,0,176240
112730402200000,NE 163,Residential,26948,0,26948,141612,0,168560
112730402300000,NE 163,Residential,26948,0,26948,162128,0,189076
112730402400000,NE 163,Residential,26948,0,26948,155926,0,182874
112730402500000,NE 163,Residential,26948,0,26948,161272,0,188220
112730402600000,NE 163,Residential,26948,0,26948,147251,0,174199
112730402700000,NE 163,Residential,26948,0,26948,171592,0,198540
112730402800000,NE 163,Residential,26948,0,26948,160501,0,187449
112730402900000,NE 163,Residential,26948,0,26948,159871,0,186819
112730403000000,NE 163,Residential,26948,0,26948,139177,0,166125
112730403100000,NE 163,Residential,26948,0,26948,155726,0,182674
112730403200000,NE 163,Residential,26948,0,26948,173384,0,200332
112730403300000,NE 163,Residential,26948,0,26948,168890,0,195838
112730403400000,NE 163,Residential,26948,0,26948,154339,0,181287
112730403500000,NE 163,Residential,31200,0,31200,149714,0,180914
112730500100000,NE 163,Residential,30000,0,30000,143952,0,173952
112730500200000,NE 163,Residential,26152,0,26152,173729,0,199881
112730500300000,NE 163,Residential,26152,0,26152,163903,0,190055
112730500400000,NE 163,Residential,26152,0,26152,140447,0,166599
112730500500000,NE 163,Residential,26152,0,26152,152292,0,178444
112730500600000,NE 163,Residential,26152,0,26152,144097,0,170249
112730500700000,NE 163,Residential,26152,0,26152,191045,0,217197
112730500800000,NE 163,Residential,26152,0,26152,142257,0,168409
112730500900000,NE 163,Residential,26152,0,26152,163036,0,189188
112730501000000,NE 163,Residential,26152,0,26152,156507,0,182659
112730501100000,NE 163,Residential,26152,0,26152,169295,0,195447
112730501200000,NE 163,Residential,26144,0,26144,163861,0,190005
112730501300000,NE 163,Residential,26152,0,26152,178048,0,204200
112730501400000,NE 163,Residential,26152,0,26152,177472,0,203624
112730501500000,NE 163,Residential,26152,0,26152,200051,0,226203
112730501600000,NE 163,Residential,26152,0,26152,160831,0,186983
112730501700000,NE 163,Residential,30269,0,30269,174812,0,205081
112732600200000,NE 162,Residential,42480,0,42480,217221,0,259701
112732600300000,NE 162,Residential,49240,0,49240,192239,0,241479
112732600400000,NE 162,Residential,45720,0,45720,192721,0,238441
112732600500000,CITY PROPERTY,Exempt,0,0,0,0,0,0
112732600600000,NE 162,Residential,32912,0,32912,151885,0,184797
112732600700000,NE 162,Residential,31680,0,31680,158097,0,189777
112732600800000,NE 162,Residential,31640,0,31640,152530,0,184170
112732600900000,NE 162,Residential,32160,0,32160,200438,0,232598
112732601000000,NE 162,Residential,33070,0,33070,171591,0,204661
112732601100000,NE 162,Residential,35075,0,35075,175715,0,210790
112732601200000,NE 162,Residential,31304,0,31304,168491,0,199795
112732601300000,NE 162,Residential,30633,0,30633,148671,0,179304
112732601400000,NE 162,Residential,33535,0,33535,177736,0,211271
112732601500000,CITY PROPERTY,Exempt,0,0,0,0,0,0
112732601600000,NE 162,Residential,32368,0,32368,145718,0,178086
112732601700000,NE 162,Residential,33120,0,33120,174398,0,207518
112732601800000,NE 162,Residential,33424,0,33424,151453,0,184877
112732601900000,NE 162,Residential,31272,0,31272,152544,0,183816
112732602000000,NE 162,Residential,30501,0,30501,165219,0,195720
112732602100000,NE 162,Residential,31919,0,31919,154983,0,186902
112732602200000,NE 101,Ag Land,14394,0,14394,0,0,14394
112732700100000,NE 162,Residential,28527,0,28527,162289,0,190816
112732700200000,NE 162,Residential,30620,0,30620,158562,0,189182
112735100100000,NE 162,Residential,28811,0,28811,160691,0,189502
112735100200000,NE 162,Residential,29120,0,29120,177253,0,206373
112735100300000,NE 162,Residential,29120,0,29120,144629,0,173749
112735100400000,NE 162,Residential,29120,0,29120,131951,0,161071
112735100500000,NE 162,Residential,29447,0,29447,159569,0,189016
112735100600000,NE 162,Residential,31121,0,31121,170728,0,201849
112735100700000,NE 162,Residential,26637,0,26637,151428,0,178065
112735200100000,NE 162,Residential,26920,0,26920,152822,0,179742
112735200200000,NE 162,Residential,30845,0,30845,183351,0,214196
112735200300000,NE 162,Residential,27456,0,27456,162933,0,190389
112735200400000,NE 162,Residential,29781,0,29781,148902,0,178683
112735200500000,NE 162,Residential,29120,0,29120,159009,0,188129
112735200600000,NE 162,Residential,27456,0,27456,155920,0,183376
112735200700000,NE 162,Residential,29120,0,29120,159739,0,188859
112735200800000,NE 162,Residential,29536,0,29536,147750,0,177286
112735200900000,NE 162,Residential,29536,0,29536,181293,0,210829
112735201000000,NE 162,Residential,29120,0,29120,146822,0,175942
112735201100000,NE 162,Residential,27456,0,27456,173246,0,200702
112735201200000,NE 162,Residential,29120,0,29120,162329,0,191449
112735201300000,NE 162,Residential,29120,0,29120,155464,0,184584
112735201400000,NE 162,Residential,31175,0,31175,163750,0,194925
112735201500000,NE 162,Residential,31650,0,31650,137570,0,169220
112735300100000,NE 162,Residential,30477,0,30477,152032,0,182509
112735300200000,NE 162,Residential,28560,0,28560,170138,0,198698
112735300300000,NE 162,Residential,28560,0,28560,132796,0,161356
112735300400000,NE 162,Residential,26928,0,26928,158507,0,185435
112735300500000,NE 162,Residential,28560,0,28560,155254,0,183814
112735300600000,NE 162,Residential,28560,0,28560,162805,0,191365
112735300700000,NE 162,Residential,26928,0,26928,162929,0,189857
112735300800000,NE 162,Residential,28560,0,28560,121055,0,149615
112735300900000,NE 162,Residential,28560,0,28560,155521,0,184081
112735301000000,NE 162,Residential,26928,0,26928,146187,0,173115
112735301100000,NE 162,Residential,28560,0,28560,150323,0,178883
112735301200000,NE 162,Residential,28560,0,28560,150766,0,179326
112735301300000,NE 162,Residential,26928,0,26928,131025,0,157953
112735301400000,NE 162,Residential,28840,0,28840,155110,0,183950
112735301500000,NE 162,Residential,32916,0,32916,166977,0,199893
112735301600000,NE 162,Residential,31492,0,31492,139224,0,170716
112735301700000,NE 162,Residential,28560,0,28560,159517,0,188077
112735301800000,NE 162,Residential,26928,0,26928,163013,0,189941
112735301900000,NE 162,Residential,28560,0,28560,151912,0,180472
112735302000000,NE 162,Residential,28560,0,28560,158089,0,186649
112735302100000,NE 162,Residential,26928,0,26928,174980,0,201908
112735302200000,NE 162,Residential,28560,0,28560,181475,0,210035
112735302300000,NE 162,Residential,28560,0,28560,164967,0,193527
112735302400000,NE 162,Residential,26928,0,26928,157122,0,184050
112735302500000,NE 162,Residential,28560,0,28560,175825,0,204385
112735302600000,NE 162,Residential,28560,0,28560,164764,0,193324
112735302700000,NE 162,Residential,21114,0,21114,163041,0,184155
112735302800000,NE 162,Residential,26932,0,26932,152879,0,179811
112735302900000,NE 162,Residential,28560,0,28560,151504,0,180064
112735303000000,NE 162,Residential,30965,0,30965,149405,0,180370
112735400100000,NE 162,Residential,27218,0,27218,131665,0,158883
112735400200000,NE 162,Residential,28560,0,28560,166822,0,195382
112735400300000,NE 162,Residential,28560,0,28560,157224,0,185784
112735400400000,NE 162,Residential,30192,0,30192,160010,0,190202
112735400500000,NE 162,Residential,30192,0,30192,169985,0,200177
112735400600000,NE 162,Residential,26928,0,26928,151273,0,178201
112735400700000,NE 162,Residential,28560,0,28560,147524,0,176084
112735400800000,NE 162,Residential,30192,0,30192,152026,0,182218
112735400900000,NE 162,Residential,27520,0,27520,151987,0,179507
112735401000000,NE 162,Residential,27532,0,27532,177463,0,204995
112735401100000,NE 162,Residential,30192,0,30192,162703,0,192895
112735401200000,NE 162,Residential,28560,0,28560,175831,0,204391
112735401300000,NE 162,Residential,26928,0,26928,161821,0,188749
112735401400000,NE 162,Residential,30192,0,30192,158228,0,188420
112735401500000,NE 162,Residential,30192,0,30192,172216,0,202408
112735401600000,NE 162,Residential,28560,0,28560,171474,0,200034
112735401700000,NE 162,Residential,26928,0,26928,164233,0,191161
112735401800000,NE 162,Residential,30931,0,30931,151936,0,182867
112735402100000,NE 162,Residential,30625,0,30625,169368,0,199993
112735402200000,NE 162,Residential,30488,0,30488,167279,0,197767
112735402300000,NE 162,Residential,30001,0,30001,191599,0,221600
112735402400000,NE 162,Residential,30282,0,30282,194779,0,225061
112735402500000,NE 162,Residential,29786,0,29786,214412,0,244198
112735402600000,NE 162,Residential,31239,0,31239,159493,0,190732
112735402700000,NE 162,Residential,32844,0,32844,177769,0,210613
112735402800000,NE 162,Residential,30750,0,30750,186987,0,217737
112735402900000,NE 162,Residential,32947,0,32947,192307,0,225254
112735403000000,NE 162,Residential,30186,0,30186,169646,0,199832
112735403100000,NE 162,Residential,29813,0,29813,191088,0,220901
112735403200000,NE 162,Residential,32634,0,32634,196098,0,228732
112735403300000,NE 162,Residential,33415,0,33415,190514,0,223929
112735403400000,NE 162,Residential,34243,0,34243,186112,0,220355
112735403500000,NE 162,Residential,33832,0,33832,147688,0,181520
112735403600000,NE 162,Residential,32401,0,32401,173524,0,205925
112735403700000,NE 162,Residential,31920,0,31920,147826,0,179746
112735403800000,NE 162,Residential,29934,0,29934,164317,0,194251
112735403900000,NE 162,Residential,30836,0,30836,209164,0,240000
112735404000000,NE 174,Residential,65550,0,65550,153289,0,218839
112735404100000,CITY PROPERTY,Exempt,0,0,0,0,0,0
112737600300000,NE 174,Ag Land,6215,0,6215,0,0,6215
112737700100000,NE 174,Residential,267,0,267,0,0,267
112737700200000,NE 174,Residential,267,0,267,0,0,267
112737700300000,NE 174,Residential,267,0,267,0,0,267
112737700400000,NE 174,Residential,267,0,267,0,0,267
112737700500000,NE 174,Residential,25452,0,25452,35562,0,61014
112737700600000,NE 174,Residential,25452,0,25452,36088,0,61540
112737700700000,NE 174,Residential,25452,0,25452,87921,0,113373
112737700800000,NE 174,Residential,267,0,267,0,0,267
112737700900000,NE 174,Residential,267,0,267,0,0,267
112737701000000,NE 174,Residential,268,0,268,0,0,268
112737701100000,NE 174,Residential,27232,0,27232,134912,0,162144
112737701200000,NE 174,Residential,30947,0,30947,146117,0,177064
112737701300000,NE 174,Residential,647,0,647,0,0,647
112737701400000,NE 174,Residential,415,0,415,0,0,415
112737701500000,NE 174,Residential,319,0,319,0,0,319
112737701600000,NE 174,Residential,274,0,274,0,0,274
112737701700000,NE 174,Residential,272,0,272,0,0,272
112737701800000,NE 174,Residential,273,0,273,0,0,273
112737800100000,NE 174,Residential,214,0,214,0,0,214
112737800200000,NE 174,Residential,214,0,214,0,0,214
112737800300000,NE 174,Residential,214,0,214,0,0,214
112737800400000,NE 174,Residential,214,0,214,0,0,214
112737800500000,NE 174,Residential,214,0,214,0,0,214
112737800600000,NE 174,Residential,214,0,214,0,0,214
112737800700000,NE 174,Residential,214,0,214,0,0,214
112737800800000,NE 174,Residential,214,0,214,0,0,214
112737800900000,NE 174,Residential,214,0,214,0,0,214
112737801000000,NE 174,Residential,20200,0,20200,33885,0,54085
112737801100000,NE 174,Residential,20200,0,20200,34446,0,54646
112737801200000,NE 174,Residential,20200,0,20200,34280,0,54480
112737801300000,NE 174,Residential,235,0,235,0,0,235
112737801400000,NE 174,Residential,238,0,238,0,0,238
112737801500000,NE 174,Residential,220,0,220,0,0,220
112737801600000,NE 174,Residential,253,0,253,0,0,253
112737804500000,NE 174,Residential,4513,0,4513,0,0,4513
112737900100000,NE 174,Residential,5522,0,5522,0,0,5522
112737900200000,NE 174,Residential,228,0,228,0,0,228
112737900300000,NE 174,Residential,208,0,208,0,0,208
112737900400000,NE 174,Residential,208,0,208,0,0,208
112737900500000,NE 174,Residential,214,0,214,0,0,214
112737900600000,NE 174,Residential,214,0,214,0,0,214
112737900700000,NE 174,Residential,214,0,214,0,0,214
112737900800000,NE 174,Residential,214,0,214,0,0,214
112737900900000,NE 174,Residential,263,0,263,0,0,263
112737901000000,NE 174,Residential,273,0,273,0,0,273
112737901100000,NE 174,Residential,249,0,249,0,0,249
112737901200000,NE 174,Residential,249,0,249,0,0,249
112737901300000,NE 174,Residential,249,0,249,0,0,249
112737901400000,NE 174,Residential,300,0,300,0,0,300
112737901500000,NE 174,Residential,277,0,277,0,0,277
112738000100000,NE 174,Residential,141000,0,141000,8910,0,149910
112738100100000,NE 174,Residential,129000,0,129000,274697,0,403697
112738200100000,NE 174,Residential,6949,0,6949,0,0,6949
112740100100000,NE 101,Ag Land,31987,0,31987,0,0,31987
112740200100000,NE 163,Residential,30149,0,30149,152529,0,182678
112740200200000,NE 163,Residential,27384,0,27384,162668,0,190052
112740200300000,NE 163,Residential,27384,0,27384,136658,0,164042
112740200400000,NE 163,Residential,27384,0,27384,174269,0,201653
112740200500000,CITY PROPERTY,Exempt,0,0,0,0,0,0
112740200600000,NE 163,Residential,29052,0,29052,159746,0,188798
112740200700000,NE 163,Residential,28172,0,28172,152048,0,180220
112740200800000,NE 163,Residential,28680,0,28680,148038,0,176718
112740200900000,NE 163,Residential,28680,0,28680,161644,0,190324
112740201000000,NE 163,Residential,28680,0,28680,170000,0,198680
112740201100000,NE 163,Residential,25587,0,25587,151682,0,177269
112740300100000,NE 163,Residential,31351,0,31351,155491,0,186842
112740300200000,NE 163,Residential,25800,0,25800,157775,0,183575
112740300300000,NE 163,Residential,25800,0,25800,143077,0,168877
112740300400000,NE 163,Residential,25800,0,25800,156742,0,182542
112740300500000,NE 163,Residential,25800,0,25800,146194,0,171994
112740300600000,NE 163,Residential,25800,0,25800,135119,0,160919
112740300700000,NE 163,Residential,30000,0,30000,141022,0,171022
112740300800000,NE 163,Residential,25800,0,25800,148095,0,173895
112740300900000,NE 163,Residential,25800,0,25800,152999,0,178799
112740301000000,NE 163,Residential,25800,0,25800,140326,0,166126
112740301100000,NE 163,Residential,25800,0,25800,137690,0,163490
112740301200000,NE 163,Residential,25800,0,25800,165025,0,190825
112740301300000,NE 163,Residential,25800,0,25800,155418,0,181218
112740301400000,NE 163,Residential,25800,0,25800,124089,0,149889
112740301500000,NE 163,Residential,25800,0,25800,154898,0,180698
112740301600000,NE 163,Residential,25800,0,25800,133333,0,159133
112740301700000,NE 163,Residential,31596,0,31596,156851,0,188447
112740301800000,NE 163,Residential,25800,0,25800,169596,0,195396
112740301900000,NE 163,Residential,25800,0,25800,155080,0,180880
112740302000000,NE 163,Residential,25800,0,25800,145927,0,171727
112740302100000,NE 163,Residential,25800,0,25800,179736,0,205536
112740302200000,NE 163,Residential,29524,0,29524,170476,0,200000
112740400100000,NE 163,Residential,31292,0,31292,154075,0,185367
112740400200000,NE 163,Residential,26372,0,26372,117051,0,143423
112740400300000,NE 163,Residential,26372,0,26372,155357,0,181729
112740400400000,NE 163,Residential,26372,0,26372,159019,0,185391
112740400500000,NE 163,Residential,26372,0,26372,134530,0,160902
112740400600000,NE 163,Residential,26372,0,26372,137997,0,164369
112740400700000,NE 163,Residential,26372,0,26372,135351,0,161723
112740400800000,NE 163,Residential,26372,0,26372,128794,0,155166
112740400900000,NE 163,Residential,26372,0,26372,152201,0,178573
112740401000000,NE 163,Residential,26372,0,26372,131704,0,158076
112740401100000,NE 163,Residential,26372,0,26372,164407,0,190779
112742600100000,NE 101,Ag Land,18959,0,18959,0,0,18959
112742800800000,NE 163,Residential,30000,0,30000,146353,0,176353
112742800900000,NE 163,Residential,25600,0,25600,131717,0,157317
112742801000000,NE 163,Residential,25600,0,25600,144279,0,169879
112742801100000,NE 163,Residential,25600,0,25600,150844,0,176444
112742801200000,NE 163,Residential,25600,0,25600,145177,0,170777
112742801300000,NE 163,Residential,25600,0,25600,133385,0,158985
112742801400000,NE 163,Residential,25600,0,25600,151451,0,177051
112742801500000,NE 163,Residential,25600,0,25600,147469,0,173069
112742801600000,NE 163,Residential,25600,0,25600,164029,0,189629
112742801700000,NE 163,Residential,25600,0,25600,149791,0,175391
112742801800000,NE 163,Residential,25600,0,25600,152407,0,178007
112742801900000,NE 163,Residential,25600,0,25600,157300,0,182900
112742802000000,NE 163,Residential,25600,0,25600,157222,0,182822
112742802100000,NE 163,Residential,30000,0,30000,153514,0,183514
112742900300000,NE 163,Residential,30400,0,30400,176893,0,207293
112742900400000,NE 163,Residential,30400,0,30400,158193,0,188593
112742900500000,NE 163,Residential,30400,0,30400,171005,0,201405
112742900600000,NE 163,Residential,26668,0,26668,162164,0,188832
112742900700000,NE 163,Residential,26668,0,26668,178063,0,204731
112742900800000,NE 162,Residential,25868,0,25868,159771,0,185639
112742900900000,NE 163,Residential,26668,0,26668,176620,0,203288
112742901000000,NE 163,Residential,26668,0,26668,151321,0,177989
112742901100000,NE 163,Residential,26700,0,26700,141889,0,168589
112742901200000,NE 163,Residential,26700,0,26700,183928,0,210628
112742901300000,NE 163,Residential,26700,0,26700,157354,0,184054
112742901400000,NE 163,Residential,26560,0,26560,155072,0,181632
112743000100000,NE 163,Residential,26380,0,26380,135316,0,161696
112743000200000,NE 163,Residential,30000,0,30000,148219,0,178219
112743100100000,NE 163,Residential,30000,0,30000,156150,0,186150
112743100200000,NE 163,Residential,26800,0,26800,128325,0,155125
112743100300000,NE 163,Residential,26800,0,26800,133592,0,160392
112743100400000,NE 163,Residential,26800,0,26800,130007,0,156807
112743100500000,NE 163,Residential,26800,0,26800,150400,0,177200
112743100600000,NE 163,Residential,26800,0,26800,190865,0,217665
112743100700000,NE 163,Residential,26800,0,26800,155751,0,182551
112743100800000,NE 163,Residential,26800,0,26800,143447,0,170247
112743100900000,NE 163,Residential,26800,0,26800,143586,0,170386
112743101000000,NE 163,Residential,26800,0,26800,154749,0,181549
112743101100000,NE 163,Residential,26800,0,26800,138843,0,165643
112743101200000,NE 163,Residential,26800,0,26800,155832,0,182632
112743101300000,NE 163,Residential,26800,0,26800,162959,0,189759
112743101400000,NE 163,Residential,26800,0,26800,147133,0,173933
112743101500000,NE 163,Residential,26800,0,26800,136741,0,163541
112743101600000,NE 163,Residential,30000,0,30000,148904,0,178904
112743200100000,NE 163,Residential,26000,0,26000,0,0,26000
112745100200000,NE 174,Residential,63700,0,63700,221337,0,285037
112745100300000,NE 174,Ag Land,44287,0,44287,0,0,44287
112747600100000,CITY PROPERTY,Exempt,0,0,0,0,0,0
112747600200000,NE 163,Residential,25867,0,25867,134246,0,160113
112747600300000,NE 163,Residential,26000,0,26000,144671,0,170671
112747600400000,NE 163,Residential,28000,0,28000,155085,0,183085
112747600500000,NE 163,Residential,28000,0,28000,145031,0,173031
112747600600000,NE 163,Residential,26000,0,26000,131068,0,157068
112747600700000,NE 163,Residential,26000,0,26000,148655,0,174655
112747600800000,NE 163,Residential,26000,0,26000,149252,0,175252
112747600900000,NE 163,Residential,26000,0,26000,128421,0,154421
112747601000000,NE 163,Residential,26000,0,26000,115970,0,141970
112747601100000,NE 163,Residential,30333,0,30333,145846,0,176179
112747601200000,NE 163,Residential,30526,0,30526,144549,0,175075
112747601300000,NE 163,Residential,30800,0,30800,169157,0,199957
112747601400000,NE 163,Residential,30400,0,30400,131691,0,162091
112747601500000,NE 163,Residential,30400,0,30400,136752,0,167152
112747601600000,NE 163,Residential,30905,0,30905,140682,0,171587
112747700100000,NE 163,Residential,31716,0,31716,133899,0,165615
112747700200000,NE 163,Residential,28152,0,28152,138566,0,166718
112747700300000,NE 163,Residential,28152,0,28152,128372,0,156524
112747700400000,NE 163,Residential,28152,0,28152,139793,0,167945
112747700500000,NE 163,Residential,28152,0,28152,179638,0,207790
112747700600000,NE 163,Residential,28152,0,28152,141167,0,169319
112747700700000,NE 163,Residential,28152,0,28152,140074,0,168226
112747700800000,NE 163,Residential,28152,0,28152,143598,0,171750
112747700900000,NE 163,Residential,28152,0,28152,174357,0,202509
112747701000000,NE 163,Residential,28152,0,28152,147214,0,175366
112747701100000,NE 163,Residential,29995,0,29995,135119,0,165114
112747800100000,NE 163,Residential,31486,0,31486,160483,0,191969
112747800200000,NE 163,Residential,26260,0,26260,144911,0,171171
112747800300000,NE 163,Residential,26260,0,26260,142154,0,168414
112747800400000,NE 163,Residential,26260,0,26260,141258,0,167518
112747800500000,NE 163,Residential,26260,0,26260,142249,0,168509
112747800600000,NE 163,Residential,26260,0,26260,133996,0,160256
112747800700000,NE 163,Residential,26260,0,26260,168157,0,194417
112747800800000,NE 163,Residential,30516,0,30516,165397,0,195913
112747800900000,NE 163,Residential,26839,0,26839,115626,0,142465
112747801000000,NE 163,Residential,26260,0,26260,145272,0,171532
112747801100000,NE 163,Residential,26260,0,26260,165258,0,191518
112747801200000,NE 163,Residential,26260,0,26260,143771,0,170031
112747801300000,NE 163,Residential,26480,0,26480,145599,0,172079
112747801400000,NE 163,Residential,30602,0,30602,145987,0,176589
112747801500000,NE 163,Residential,26000,0,26000,137589,0,163589
112747801600000,NE 163,Residential,26000,0,26000,117563,0,143563
112747801700000,NE 163,Residential,26000,0,26000,149529,0,175529
112747801800000,NE 163,Residential,26000,0,26000,141589,0,167589
112747801900000,NE 163,Residential,26000,0,26000,133182,0,159182
112747802000000,NE 163,Residential,27367,0,27367,137025,0,164392
112747802100000,NE 163,Residential,29422,0,29422,146473,0,175895
112747802200000,NE 163,Residential,31484,0,31484,164419,0,195903
112747802300000,NE 163,Residential,30897,0,30897,139421,0,170318
112747802400000,NE 163,Residential,28323,0,28323,176402,0,204725
112747802500000,NE 163,Residential,28323,0,28323,164284,0,192607
112747802600000,NE 163,Residential,28262,0,28262,143318,0,171580
112747802700000,NE 163,Residential,24365,0,24365,158685,0,183050
112747802800000,NE 163,Residential,30031,0,30031,168448,0,198479
112747802900000,NE 163,Residential,28804,0,28804,165526,0,194330
112747803000000,NE 163,Residential,29180,0,29180,133177,0,162357
112747803100000,NE 163,Residential,31280,0,31280,173883,0,205163
112747803200000,NE 163,Residential,25810,0,25810,139670,0,165480
112747803300000,NE 163,Residential,27300,0,27300,180493,0,207793
112747803400000,NE 163,Residential,27300,0,27300,142715,0,170015
112747803500000,NE 163,Residential,25740,0,25740,168226,0,193966
112747803600000,NE 163,Residential,30057,0,30057,134567,0,164624
112747803700000,NE 163,Residential,28157,0,28157,152230,0,180387
112747900100000,NE 163,Residential,31208,0,31208,143669,0,174877
112747900200000,NE 163,Residential,27263,0,27263,159932,0,187195
112747900300000,NE 163,Residential,27263,0,27263,141750,0,169013
112747900400000,NE 163,Residential,27263,0,27263,141115,0,168378
112747900500000,NE 163,Residential,27263,0,27263,149066,0,176329
112747900600000,NE 163,Residential,27263,0,27263,121267,0,148530
112747900700000,NE 163,Residential,26928,0,26928,147559,0,174487
112747900800000,NE 163,Residential,28152,0,28152,170717,0,198869
112747900900000,NE 163,Residential,28152,0,28152,159061,0,187213
112747901000000,NE 163,Residential,26928,0,26928,139493,0,166421
112747901100000,NE 163,Residential,26928,0,26928,146507,0,173435
112747901200000,NE 163,Residential,26928,0,26928,136199,0,163127
112747901300000,NE 163,Residential,26928,0,26928,140539,0,167467
112747901400000,NE 163,Residential,26928,0,26928,163019,0,189947
112747901500000,NE 163,Residential,26928,0,26928,152730,0,179658
112747901600000,NE 163,Residential,30785,0,30785,147918,0,178703
112748000100000,NE 163,Residential,30853,0,30853,143830,0,174683
112748000200000,NE 163,Residential,27300,0,27300,128395,0,155695
112748000300000,NE 163,Residential,30263,0,30263,136519,0,166782
112748000400000,NE 163,Residential,30562,0,30562,137271,0,167833
112748000500000,NE 163,Residential,32776,0,32776,157224,0,190000
112748000600000,NE 163,Residential,30872,0,30872,140749,0,171621
112748000700000,NE 163,Residential,30471,0,30471,148907,0,179378
112748000800000,NE 163,Residential,29208,0,29208,148051,0,177259
112748000900000,NE 163,Residential,30492,0,30492,141537,0,172029
112748001000000,NE 163,Residential,30805,0,30805,176163,0,206968
112748001100000,NE 163,Residential,30523,0,30523,122370,0,152893
112748001200000,NE 163,Residential,28379,0,28379,164067,0,192446
112748001300000,NE 163,Residential,26693,0,26693,164464,0,191157
112748001400000,NE 163,Residential,26000,0,26000,153267,0,179267
112748001500000,NE 163,Residential,26000,0,26000,137692,0,163692
112748001600000,NE 163,Residential,30561,0,30561,148027,0,178588
112748100100000,NE 163,Residential,30722,0,30722,127320,0,158042
112748100200000,NE 163,Residential,26000,0,26000,144484,0,170484
112748100300000,NE 163,Residential,26000,0,26000,110799,0,136799
112748100400000,NE 163,Residential,26609,0,26609,136391,0,163000
112748100500000,NE 163,Residential,27300,0,27300,111140,0,138440
112748100600000,NE 163,Residential,30720,0,30720,134153,0,164873
112748100700000,NE 163,Residential,30934,0,30934,136258,0,167192
112748100800000,NE 163,Residential,31787,0,31787,169703,0,201490
112748100900000,NE 163,Residential,26000,0,26000,131048,0,157048
112748101000000,NE 163,Residential,26520,0,26520,167438,0,193958
112748101100000,NE 163,Residential,31456,0,31456,146800,0,178256
112748101200000,NE 163,Residential,32191,0,32191,134194,0,166385
112748101300000,NE 163,Residential,31353,0,31353,164251,0,195604
112748101400000,NE 163,Residential,32634,0,32634,152127,0,184761
112748101500000,NE 163,Residential,30172,0,30172,153518,0,183690
112748101600000,NE 163,Residential,29568,0,29568,139912,0,169480
112748101700000,NE 163,Residential,26520,0,26520,166273,0,192793
112748101800000,NE 163,Residential,26000,0,26000,147927,0,173927
112748101900000,NE 163,Residential,30905,0,30905,157968,0,188873
112748102000000,NE 163,Residential,26260,0,26260,137303,0,163563
112748102100000,NE 163,Residential,30704,0,30704,157102,0,187806
112748102200000,NE 163,Residential,27300,0,27300,122248,0,149548
112748102300000,NE 163,Residential,26260,0,26260,124299,0,150559
112748102400000,NE 163,Residential,26000,0,26000,129956,0,155956
112748102500000,NE 163,Residential,26000,0,26000,150094,0,176094
112748102600000,NE 163,Residential,30601,0,30601,121202,0,151803
112817600100000,CENTRALLY ASSESSED,Other,0,0,0,0,0,0
112817600200000,NE 162,Ag Dwelling,52273,0,52273,85765,12956,150994
112840100100000,NE 162,Ag Land,28155,0,28155,0,0,28155
112840100200000,NE 162,Residential,40513,0,40513,310397,0,350910
112840100300000,NE 162,Residential,40400,0,40400,216473,0,256873
112840100400000,NE 162,Residential,40400,0,40400,237121,0,277521
112840100500000,NE 162,Residential,40400,0,40400,232284,0,272684
112840100600000,NE 162,Residential,40400,0,40400,222917,0,263317
112840100700000,NE 162,Residential,40400,0,40400,232536,0,272936
112840100800000,NE 162,Residential,40400,0,40400,239761,0,280161
112840100900000,NE 162,Residential,40400,0,40400,193804,0,234204
112840101000000,NE 162,Residential,40400,0,40400,227118,0,267518
112840101100000,NE 162,Residential,40400,0,40400,230905,0,271305
112840101200000,NE 162,Residential,40400,0,40400,204511,0,244911
112840101300000,NE 162,Residential,29444,0,29444,149882,0,179326
112840200100000,NE 162,Residential,27120,0,27120,269827,0,296947
112840200200000,NE 162,Residential,30300,0,30300,166379,0,196679
112840200300000,NE 162,Residential,40400,0,40400,212670,0,253070
112840200400000,NE 162,Residential,40400,0,40400,205118,0,245518
112840200500000,NE 162,Residential,40400,0,40400,225220,0,265620
112840200600000,NE 162,Residential,40400,0,40400,208216,0,248616
112840200700000,NE 162,Residential,42218,0,42218,221165,0,263383
112840200800000,NE 162,Residential,42218,0,42218,359168,0,401386
112840200900000,NE 162,Residential,42218,0,42218,204609,0,246827
112840201000000,NE 162,Residential,41204,0,41204,209854,0,251058
112840201100000,NE 162,Residential,71000,0,71000,165662,0,236662
112840201200000,NE 162,Residential,40000,0,40000,85959,0,125959
112842600100000,NE 162,Residential,39097,0,39097,220370,0,259467
112842600200000,NE 162,Residential,34884,0,34884,174147,0,209031
112842600300000,NE 162,Residential,34884,0,34884,197220,0,232104
112842600400000,NE 162,Residential,34884,0,34884,245317,0,280201
112842600500000,NE 162,Residential,36720,0,36720,198467,0,235187
112842600600000,NE 162,Residential,36720,0,36720,202749,0,239469
112842600700000,NE 162,Residential,38556,0,38556,205394,0,243950
112842600800000,NE 162,Residential,38556,0,38556,212920,0,251476
112842600900000,NE 162,Residential,42151,0,42151,173191,0,215342
112842700100000,NE 162,Residential,42120,0,42120,210600,0,252720
112842700200000,NE 162,Residential,37440,0,37440,219234,0,256674
112842700300000,NE 162,Residential,37440,0,37440,194861,0,232301
112842700400000,NE 162,Residential,34020,0,34020,198098,0,232118
112842700500000,NE 162,Residential,37800,0,37800,192186,0,229986
112842700600000,NE 162,Residential,43578,0,43578,219862,0,263440
112842700700000,NE 162,Residential,42642,0,42642,213945,0,256587
112842700800000,NE 162,Residential,34884,0,34884,203111,0,237995
112842700900000,NE 162,Residential,36720,0,36720,207902,0,244622
112842701000000,NE 162,Residential,38004,0,38004,271427,0,309431
112842701100000,NE 162,Residential,33048,0,33048,148954,0,182002
112842701200000,NE 162,Residential,36720,0,36720,220246,0,256966
112842701300000,NE 162,Residential,36720,0,36720,227465,0,264185
112842701400000,NE 162,Residential,34884,0,34884,164147,0,199031
112842701500000,NE 162,Residential,36720,0,36720,201763,0,238483
112842701600000,NE 162,Residential,33966,0,33966,177792,0,211758
112842701700000,NE 162,Residential,36720,0,36720,189081,0,225801
112842701800000,NE 162,Residential,37122,0,37122,180283,0,217405
112842701900000,NE 162,Residential,40500,0,40500,226100,0,266600
112842702000000,NE 162,Residential,50398,0,50398,194612,0,245010
112842702100000,NE 162,Residential,42793,0,42793,229156,0,271949
112842702200000,NE 162,Residential,41518,0,41518,214622,0,256140
112842800200000,CENTRALLY ASSESSED,Other,0,0,0,0,0,0
112842900100000,NE 162,Residential,41310,0,41310,176187,0,217497
112842900200000,NE 162,Residential,34425,0,34425,190879,0,225304
112842900300000,NE 162,Residential,35802,0,35802,220689,0,256491
112842900400000,NE 162,Residential,34344,0,34344,164463,0,198807
112842900500000,NE 162,Residential,48769,0,48769,172246,0,221015
112842900600000,NE 162,Residential,36252,0,36252,177430,0,213682
112842900700000,NE 162,Residential,36720,0,36720,222453,0,259173
112842900800000,NE 162,Residential,33048,0,33048,176435,0,209483
112842900900000,NE 162,Residential,34884,0,34884,216487,0,251371
112842901000000,NE 162,Residential,36720,0,36720,166487,0,203207
112842901100000,NE 162,Residential,33048,0,33048,159980,0,193028
112842901200000,NE 162,Residential,34884,0,34884,212049,0,246933
112842901300000,NE 162,Residential,33048,0,33048,155125,0,188173
112842901400000,NE 162,Residential,36720,0,36720,209091,0,245811
112842901500000,NE 162,Residential,32576,0,32576,155708,0,188284
112842901600000,NE 162,Residential,44960,0,44960,197905,0,242865
112842901700000,NE 162,Residential,41616,0,41616,168978,0,210594
112842901800000,NE 162,Residential,43012,0,43012,213774,0,256786
112842901900000,NE 162,Residential,35256,0,35256,166668,0,201924
112842902000000,NE 162,Residential,38473,0,38473,183122,0,221595
112842902100000,NE 162,Residential,33507,0,33507,194026,0,227533
112842902200000,NE 162,Residential,36720,0,36720,216696,0,253416
112842902300000,NE 162,Residential,33048,0,33048,191937,0,224985
112842902400000,NE 162,Residential,38556,0,38556,221681,0,260237
112842902500000,NE 162,Residential,35263,0,35263,197434,0,232697
112842902600000,NE 162,Residential,41004,0,41004,235743,0,276747
112842902700000,NE 162,Residential,38604,0,38604,197680,0,236284
112842902800000,NE 162,Residential,34425,0,34425,170821,0,205246
112842902900000,NE 162,Residential,41310,0,41310,217071,0,258381
112843000100000,NE 162,Residential,43650,0,43650,260754,0,304404
112843000200000,NE 162,Residential,48323,0,48323,215732,0,264055
112843000300000,NE 162,Residential,32400,0,32400,159877,0,192277
112843000400000,NE 162,Residential,37179,0,37179,192297,0,229476
112843000500000,NE 162,Residential,31212,0,31212,178476,0,209688
112843000600000,NE 162,Residential,33048,0,33048,189428,0,222476
112843000700000,NE 162,Residential,33201,0,33201,212858,0,246059
112843000800000,NE 162,Residential,33222,0,33222,165660,0,198882
112843000900000,NE 162,Residential,41623,0,41623,177638,0,219261
112843001000000,NE 162,Residential,32521,0,32521,222942,0,255463
112843001100000,NE 162,Residential,42900,0,42900,196743,0,239643
112843001200000,NE 162,Residential,33824,0,33824,195891,0,229715
112843001300000,NE 162,Residential,33118,0,33118,176091,0,209209
112843001400000,NE 162,Residential,35880,0,35880,179206,0,215086
112843001500000,NE 162,Residential,34845,0,34845,170919,0,205764
112843001600000,NE 162,Residential,34050,0,34050,180020,0,214070
112843100100000,NE 162,Residential,43886,0,43886,218324,0,262210
112843100200000,NE 162,Residential,36259,0,36259,241060,0,277319
112843100300000,NE 162,Residential,41769,0,41769,224781,0,266550
112843100400000,NE 162,Residential,40117,0,40117,224975,0,265092
112843100500000,NE 162,Residential,35166,0,35166,199994,0,235160
112843100600000,NE 162,Residential,44860,0,44860,216062,0,260922
112845100100000,NE 162,Residential,49459,0,49459,237578,0,287037
112845100200000,NE 162,Residential,35802,0,35802,227484,0,263286
112845100300000,NE 162,Residential,39750,0,39750,185228,0,224978
112845100400000,NE 162,Residential,41148,0,41148,174647,0,215795
112845100500000,NE 162,Residential,37620,0,37620,212924,0,250544
112845100600000,NE 162,Residential,37796,0,37796,192646,0,230442
112845100700000,NE 162,Residential,38260,0,38260,211202,0,249462
112845100800000,NE 162,Residential,41835,0,41835,264764,0,306599
112845100900000,NE 162,Residential,40682,0,40682,204899,0,245581
112845101000000,NE 162,Residential,43734,0,43734,219870,0,263604
112845101100000,NE 162,Residential,43000,0,43000,240757,0,283757
112845101200000,CITY PROPERTY,Exempt,0,0,0,0,0,0
112845101400000,CITY PROPERTY,Exempt,0,0,0,0,0,0
112845101500000,CITY PROPERTY,Exempt,0,0,0,0,0,0
112847600100000,NE 162,Residential,38681,0,38681,152371,0,191052
112847600200000,NE 162,Residential,28373,0,28373,142338,0,170711
112847600300000,NE 162,Residential,30555,0,30555,160020,0,190575
112847600400000,NE 162,Residential,28373,0,28373,145563,0,173936
112847600500000,NE 162,Residential,30555,0,30555,169961,0,200516
112847600600000,NE 162,Residential,28373,0,28373,165253,0,193626
112847600700000,NE 162,Residential,30555,0,30555,182564,0,213119
112847600800000,NE 162,Residential,28373,0,28373,162671,0,191044
112847600900000,NE 162,Residential,32738,0,32738,183401,0,216139
112847601000000,NE 162,Residential,28373,0,28373,154991,0,183364
112847601100000,NE 162,Residential,32738,0,32738,171905,0,204643
112847601200000,NE 162,Residential,32738,0,32738,176675,0,209413
112847601300000,NE 162,Residential,34920,0,34920,172060,0,206980
112847601400000,NE 162,Residential,40592,0,40592,268746,0,309338
112847601500000,CITY PROPERTY,Exempt,0,0,0,0,0,0
112847700100000,NE 162,Residential,39079,0,39079,194642,0,233721
112847700200000,NE 162,Residential,28512,0,28512,164602,0,193114
112847700300000,NE 162,Residential,32400,0,32400,174079,0,206479
112847700400000,NE 162,Residential,28512,0,28512,159350,0,187862
112847700500000,NE 162,Residential,32400,0,32400,144684,0,177084
112847700600000,NE 162,Residential,28512,0,28512,178123,0,206635
112847700700000,NE 162,Residential,32400,0,32400,177926,0,210326
112847700800000,NE 162,Residential,28512,0,28512,155595,0,184107
112847700900000,NE 162,Residential,32400,0,32400,171513,0,203913
112847701000000,NE 162,Residential,28512,0,28512,175907,0,204419
112847701100000,NE 162,Residential,32400,0,32400,151798,0,184198
112847701200000,NE 162,Residential,34560,0,34560,180053,0,214613
112847701300000,NE 162,Residential,34560,0,34560,183300,0,217860
112847701400000,NE 162,Residential,42052,0,42052,168975,0,211027
112847701500000,CITY PROPERTY,Exempt,0,0,0,0,0,0
112847701600000,WAREHOUSE;MINI STORG,Commercial,0,125194,125194,0,144806,270000
112847701700000,NE 162,Residential,7400,0,7400,0,0,7400
112847701800000,NE 103,Residential,17120,0,17120,139418,0,156538
112847701900000,NE 103,Residential,20330,0,20330,129647,0,149977
112847702000000,NE 103,Residential,20330,0,20330,165001,0,185331
112847702100000,NE 103,Residential,20351,0,20351,145561,0,165912
112847702200000,NE 103,Residential,22967,0,22967,136077,0,159044
112847702300000,NE 103,Residential,24120,0,24120,149536,0,173656
112847702400000,NE 102,Residential,20738,0,20738,196155,0,216893
112847702500000,NE 102,Residential,20738,0,20738,139620,0,160358
112847702600000,NE 102,Residential,28980,0,28980,140015,0,168995
112847702700000,NE 102,Residential,31273,0,31273,190987,0,222260
112847702800000,NE 102,Residential,31363,0,31363,268302,0,299665
112847702900000,NE 102,Residential,32151,0,32151,198162,0,230313
112847703000000,NE 102,Residential,27720,0,27720,179813,0,207533
112847703100000,NE 102,Residential,30096,0,30096,179074,0,209170
112847703200000,NE 102,Residential,26841,0,26841,155159,0,182000
112847703300000,NE 102,Residential,30888,0,30888,167306,0,198194
112847703400000,NE 102,Residential,27720,0,27720,160984,0,188704
112847703500000,NE 102,Residential,34984,0,34984,149344,0,184328
112847800100000,NE 102,Residential,31301,0,31301,130357,0,161658
112847800200000,NE 102,Residential,30096,0,30096,144293,0,174389
112847800300000,NE 102,Residential,26136,0,26136,174201,0,200337
112847800400000,NE 102,Residential,30096,0,30096,160061,0,190157
112847800500000,NE 102,Residential,25872,0,25872,156041,0,181913
112847800600000,NE 102,Residential,25344,0,25344,176529,0,201873
112847800700000,NE 102,Residential,31775,0,31775,150846,0,182621
112847800800000,NE 102,Residential,24938,0,24938,206178,0,231116
112847800900000,NE 102,Residential,16560,0,16560,124818,0,141378
112847801000000,NE 102,Residential,19319,0,19319,172160,0,191479
112847801100000,NE 102,Residential,16987,0,16987,147112,0,164099
112847801200000,NE 105,Residential,19515,0,19515,121222,0,140737
112847801300000,NE 102,Residential,21500,0,21500,145382,0,166882
112847801400000,NE 102,Residential,20037,0,20037,130618,0,150655
112847801500000,NE 102,Residential,18901,0,18901,141099,0,160000
112847801600000,NE 103,Residential,19380,0,19380,190236,0,209616
112847900100000,NE 102,Residential,20849,0,20849,140974,0,161823
112847900200000,NE 102,Residential,16995,0,16995,142972,0,159967
112847900300000,NE 102,Residential,18865,0,18865,162076,0,180941
112847900400000,NE 102,Residential,18208,0,18208,144458,0,162666
112847900500000,NE 102,Residential,20449,0,20449,134003,0,154452
112847900600000,NE 103,Residential,20672,0,20672,158292,0,178964
112847900700000,NE 103,Residential,19250,0,19250,161191,0,180441
112847900800000,NE 103,Residential,20325,0,20325,156608,0,176933
112847900900000,NE 103,Residential,16665,0,16665,137762,0,154427
112847901000000,NE 103,Residential,18724,0,18724,148938,0,167662
112847901100000,NE 103,Residential,20825,0,20825,156589,0,177414
112848000100000,NE 103,Residential,20766,0,20766,158027,0,178793
113015100100000,NE 168,Ag Land,35016,0,35016,0,1202,36218
113017600100000,NE 168,Ag Land,29783,0,29783,0,0,29783
113025200100000,NE 168,Ag Land,753,0,753,0,0,753
113025200700000,NE 168,Ag Land,11145,0,11145,0,0,11145
113027700100000,NE 168,Ag Land,8798,0,8798,0,0,8798
113030100100000,NE 168,Ag Land,53306,0,53306,0,0,53306
113030100200000,NE 168,Residential,36600,0,36600,0,0,36600
113032600100000,NE 168,Ag Land,50656,0,50656,0,0,50656
113035100100000,NE 169,Residential,75751,0,75751,221409,0,297160
113035100200000,NE 169,Residential,75600,0,75600,271307,0,346907
113035100300000,NE 168,Residential,440,0,440,0,0,440
113035100400000,NE 169,Residential,76000,0,76000,284069,0,360069
113035100500000,NE 169,Residential,76000,0,76000,246592,0,322592
113035100600000,NE 169,Residential,76000,0,76000,226292,0,302292
113035100700000,NE 169,Residential,75550,0,75550,252023,0,327573
113035100800000,NE 169,Residential,75550,0,75550,206413,0,281963
113035100900000,NE 168,Residential,900,0,900,0,0,900
113035200100000,NE 169,Residential,75001,0,75001,231832,0,306833
113035200200000,NE 169,Residential,75800,0,75800,288099,0,363899
113035200300000,NE 168,Ag Land,22262,0,22262,0,0,22262
113035300100000,NE 169,Residential,77050,0,77050,267458,0,344508
113035300200000,NE 169,Residential,77051,0,77051,211658,0,288709
113035300300000,NE 169,Residential,75000,0,75000,248166,0,323166
113035300400000,NE 169,Residential,75000,0,75000,254603,0,329603
113037600100000,NE 168,Ag Land,61352,0,61352,0,0,61352
113042600100000,NE 168,Residential,106600,0,106600,88622,0,195222
113042600200000,CHURCH,Exempt,0,10175,10175,0,0,10175
113042600300000,CHURCH,Exempt,0,13740,13740,0,5527,19267
113042600400000,NE 168,Residential,100450,0,100450,113327,0,213777
113045100200000,NE 168,Residential,5057,0,5057,0,0,5057
113045100300000,NE 168,Residential,58600,0,58600,60466,0,119066
113045100400000,NE 168,Ag Land,46686,0,46686,0,0,46686
113112600100000,NE 168,Ag Land,8159,0,8159,0,0,8159
113112600200000,NE 168,Ag Land,46226,0,46226,0,0,46226
113120100100000,NE 168,Ag Land,53933,0,53933,0,29859,83792
113122600100000,NE 168,Residential,12200,0,12200,0,0,12200
113122600200000,NE 168,Ag Land,36735,0,36735,0,0,36735
113125100100000,NE 168,Residential,50150,0,50150,110604,0,160754
113125100200000,NE 168,Residential,50200,0,50200,122634,0,172834
113125100300000,NE 168,Residential,50200,0,50200,149637,0,199837
113125100400000,NE 168,Residential,50250,0,50250,164175,0,214425
113125200100000,NE 168,Residential,50300,0,50300,0,0,50300
113125200200000,NE 168,Residential,50350,0,50350,0,0,50350
113125300100000,NE 168,Residential,50100,0,50100,136237,0,186337
113125300200000,NE 168,Residential,50100,0,50100,196211,0,246311
113125300300000,NE 168,Residential,40040,0,40040,288739,0,328779
113125300400000,NE 168,Residential,50050,0,50050,0,0,50050
113125300600000,NE 168,Ag Land,23545,0,23545,0,0,23545
113125300700000,NE 168,Ag Land,3385,0,3385,0,0,3385
113125400100000,NE 168,Residential,50300,0,50300,151783,0,202083
113125400200000,NE 168,Residential,50500,0,50500,124066,0,174566
113130100100000,NE 168,Residential,75000,0,75000,148659,0,223659
113130100200000,NE 168,Residential,75250,0,75250,207411,0,282661
113130100300000,NE 168,Residential,75250,0,75250,167088,0,242338
113130100400000,NE 168,Residential,75250,0,75250,204924,0,280174
113130100500000,NE 168,Residential,58500,0,58500,160943,0,219443
113130100600000,NE 168,Residential,61343,0,61343,163219,0,224562
113130100700000,NE 168,Residential,63270,0,63270,159646,0,222916
113130100800000,NE 168,Residential,61393,0,61393,185388,0,246781
113130200100000,NE 168,Residential,59495,0,59495,176155,0,235650
113130200200000,NE 168,Residential,62141,0,62141,202600,0,264741
113130200300000,NE 168,Residential,53294,0,53294,258709,0,312003
113130300100000,NE 168,Residential,75150,0,75150,107735,0,182885
113130300200000,NE 168,Residential,75150,0,75150,145342,0,220492
113130300300000,NE 168,Residential,75150,0,75150,242654,0,317804
113130300400000,NE 168,Residential,75150,0,75150,221615,0,296765
113130300500000,NE 168,Residential,75150,0,75150,173343,0,248493
113130300600000,NE 168,Residential,58500,0,58500,146653,0,205153
113130300700000,NE 168,Residential,60645,0,60645,191667,0,252312
113130300800000,NE 168,Residential,62130,0,62130,229280,0,291410
113130300900000,NE 168,Residential,61560,0,61560,157420,0,218980
113130301300000,NE 168,Residential,75100,0,75100,109449,0,184549
113130301400000,NE 168,Residential,75100,0,75100,132556,0,207656
113130301500000,NE 168,Residential,75100,0,75100,143433,0,218533
113130301600000,NE 168,Residential,75100,0,75100,172654,0,247754
113130301700000,NE 168,Residential,75100,0,75100,165856,0,240956
113130400100000,NE 168,Residential,75150,0,75150,126159,0,201309
113130400200000,NE 168,Residential,75150,0,75150,203034,0,278184
113130400300000,NE 168,Residential,75150,0,75150,217865,0,293015
113130400400000,NE 168,Residential,75200,0,75200,116729,0,191929
113130401200000,NE 168,Residential,59951,0,59951,155504,0,215455
113130401300000,NE 168,Residential,59411,0,59411,155655,0,215066
113130401400000,NE 168,Residential,59189,0,59189,232070,0,291259
113132600200000,NE 168,Residential,5250,0,5250,0,0,5250
113132600300000,NE 168,Residential,32625,0,32625,0,0,32625
113132600400000,NE 168,Residential,100,0,100,0,0,100
113132700100000,CITY PROPERTY,Exempt,0,0,0,0,0,0
113132700200000,NE 172,Residential,46200,0,46200,201667,0,247867
113132700300000,NE 172,Residential,44400,0,44400,210365,0,254765
113132700400000,NE 172,Residential,44400,0,44400,222713,0,267113
113132700500000,NE 172,Residential,44400,0,44400,268871,0,313271
113132700600000,NE 172,Residential,45600,0,45600,248357,0,293957
113132700700000,NE 172,Residential,43962,0,43962,295710,0,339672
113132700800000,NE 172,Residential,46035,0,46035,299305,0,345340
113132700900000,NE 172,Residential,50437,0,50437,187770,0,238207
113132701000000,CITY PROPERTY,Exempt,0,0,0,0,0,0
113132800100000,NE 172,Residential,48844,0,48844,238710,0,287554
113132800200000,NE 172,Residential,48480,0,48480,227759,0,276239
113132800300000,NE 172,Residential,48480,0,48480,239056,0,287536
113132800400000,NE 172,Residential,48480,0,48480,232302,0,280782
113132800500000,NE 172,Residential,48480,0,48480,216855,0,265335
113132800600000,NE 172,Residential,48480,0,48480,163919,0,212399
113132800700000,NE 172,Residential,46317,0,46317,244893,0,291210
113132800800000,NE 172,Residential,46627,0,46627,223256,0,269883
113132800900000,NE 172,Residential,48680,0,48680,228748,0,277428
113132801000000,NE 172,Residential,48156,0,48156,266303,0,314459
113132801100000,NE 172,Residential,47271,0,47271,237400,0,284671
113132801200000,NE 172,Residential,48960,0,48960,214940,0,263900
113132801300000,NE 172,Residential,48960,0,48960,237185,0,286145
113132801400000,NE 172,Residential,48642,0,48642,220415,0,269057
113132801500000,NE 172,Residential,62400,0,62400,0,0,62400
113132801600000,NE 172,Residential,58509,0,58509,0,0,58509
113132801700000,NE 172,Residential,57624,0,57624,0,0,57624
113132801800000,NE 172,Residential,60617,0,60617,218383,0,279000
113132801900000,NE 172,Residential,60449,0,60449,184738,0,245187
113132802000000,NE 172,Residential,50490,0,50490,234648,0,285138
113132802100000,NE 172,Residential,64796,0,64796,225567,0,290363
113132802200000,NE 172,Residential,64480,0,64480,286239,0,350719
113132802300000,NE 172,Residential,50708,0,50708,268663,0,319371
113132802400000,NE 172,Residential,50634,0,50634,0,0,50634
113132802500000,NE 172,Residential,51430,0,51430,204264,0,255694
113132802600000,NE 172,Residential,47250,0,47250,0,0,47250
113132802700000,NE 172,Residential,67200,0,67200,0,0,67200
113132802800000,NE 172,Residential,58092,0,58092,262996,0,321088
113132802900000,NE 172,Residential,58032,0,58032,333346,0,391378
113132803000000,NE 172,Residential,71136,0,71136,277440,0,348576
113132803100000,NE 172,Residential,75159,0,75159,305647,0,380806
113132803200000,NE 172,Residential,57330,0,57330,0,0,57330
113132900100000,NE 172,Residential,49432,0,49432,205013,0,254445
113132900200000,NE 172,Residential,48256,0,48256,196744,0,245000
113132900300000,NE 172,Residential,48480,0,48480,201467,0,249947
113132900400000,NE 172,Residential,48480,0,48480,255515,0,303995
113132900500000,NE 172,Residential,48480,0,48480,175844,0,224324
113132900600000,NE 172,Residential,48480,0,48480,182959,0,231439
113132900700000,NE 172,Residential,56679,0,56679,375153,0,431832
113132900800000,NE 172,Residential,49909,0,49909,233505,0,283414
113132900900000,NE 172,Residential,48480,0,48480,206714,0,255194
113132901000000,NE 172,Residential,48480,0,48480,247667,0,296147
113132901100000,NE 172,Residential,48480,0,48480,211444,0,259924
113132901200000,NE 172,Residential,48480,0,48480,188926,0,237406
113132901300000,NE 172,Residential,48480,0,48480,186291,0,234771
113132901400000,NE 172,Residential,48424,0,48424,176545,0,224969
113133000100000,NE 172,Residential,62868,0,62868,286959,0,349827
113133000200000,NE 172,Residential,59830,0,59830,0,0,59830
113133000300000,NE 172,Residential,48558,0,48558,185794,0,234352
113133000400000,NE 172,Residential,48480,0,48480,0,0,48480
113133000500000,NE 172,Residential,47062,0,47062,0,0,47062
113133100100000,NE 172,Residential,51231,0,51231,0,0,51231
113133100200000,NE 172,Residential,50490,0,50490,215511,0,266001
113133100300000,NE 172,Residential,50490,0,50490,199373,0,249863
113133100400000,NE 172,Residential,63247,0,63247,221416,0,284663
113133100500000,NE 172,Residential,58828,0,58828,0,0,58828
113133100600000,NE 172,Residential,50490,0,50490,291406,0,341896
113133200100000,NE 172,Residential,48000,0,48000,0,0,48000
113133200200000,NE 172,Residential,51000,0,51000,294736,0,345736
113133200300000,NE 172,Residential,48000,0,48000,0,0,48000
113133200400000,NE 172,Residential,48000,0,48000,205517,0,253517
113133200500000,NE 172,Residential,48000,0,48000,264145,0,312145
113133200600000,NE 172,Residential,48000,0,48000,200739,0,248739
113133200700000,NE 172,Residential,47040,0,47040,0,0,47040
113133200800000,NE 172,Residential,64504,0,64504,0,0,64504
113133200900000,NE 172,Residential,51000,0,51000,225097,0,276097
113133201000000,NE 172,Residential,51000,0,51000,230340,0,281340
113133201100000,NE 172,Residential,48000,0,48000,0,0,48000
113133201200000,NE 172,Residential,48000,0,48000,0,0,48000
113135100300000,SCHOOL,Exempt,0,0,0,0,0,0
113135100500000,NE 172,Residential,42271,0,42271,156672,0,198943
113135100600000,NE 172,Residential,41630,0,41630,157744,0,199374
113135100700000,NE 172,Residential,39780,0,39780,154897,0,194677
113135100800000,NE 172,Residential,38355,0,38355,153620,0,191975
113135100900000,NE 172,Residential,46703,0,46703,143590,0,190293
113135101000000,NE 172,Residential,44496,0,44496,148053,0,192549
113135101100000,NE 172,Residential,43543,0,43543,174334,0,217877
113135101200000,NE 172,Residential,45410,0,45410,180276,0,225686
113135101300000,NE 172,Residential,43956,0,43956,167015,0,210971
113135101400000,NE 172,Residential,45931,0,45931,180066,0,225997
113135101500000,NE 172,Residential,43507,0,43507,137626,0,181133
113135101600000,NE 172,Residential,36660,0,36660,150233,0,186893
113135101700000,NE 172,Residential,39900,0,39900,172842,0,212742
113135101800000,NE 172,Residential,38610,0,38610,146785,0,185395
113135101900000,NE 172,Residential,38760,0,38760,153578,0,192338
113135102000000,NE 172,Residential,43940,0,43940,147216,0,191156
113135102100000,NE 172,Residential,46620,0,46620,173121,0,219741
113135102200000,NE 172,Residential,47177,0,47177,143564,0,190741
113135102300000,NE 172,Residential,41627,0,41627,167360,0,208987
113135102400000,NE 172,Residential,44015,0,44015,166180,0,210195
113135102500000,NE 172,Residential,43330,0,43330,194231,0,237561
113135102600000,NE 172,Residential,39984,0,39984,158421,0,198405
113135102700000,NE 172,Residential,44036,0,44036,168476,0,212512
113135102800000,NE 172,Residential,38986,0,38986,155203,0,194189
113135102900000,NE 172,Residential,38110,0,38110,156665,0,194775
113135103000000,NE 172,Residential,42840,0,42840,144357,0,187197
113135103100000,NE 172,Residential,38755,0,38755,150682,0,189437
113135103200000,NE 172,Residential,46810,0,46810,130063,0,176873
113135103300000,NE 172,Residential,48000,0,48000,203424,0,251424
113135103400000,NE 172,Residential,48000,0,48000,219202,0,267202
113135103500000,NE 172,Residential,48000,0,48000,217617,0,265617
113135103600000,NE 172,Residential,48000,0,48000,255999,0,303999
113135103700000,NE 172,Residential,48000,0,48000,206242,0,254242
113135103800000,NE 172,Residential,47221,0,47221,206750,0,253971
113135200100000,NE 172,Residential,48000,0,48000,347750,0,395750
113135200200000,NE 172,Residential,48000,0,48000,178471,0,226471
113135200300000,NE 172,Residential,48000,0,48000,273039,0,321039
113135200400000,NE 172,Residential,48000,0,48000,267579,0,315579
113135200500000,NE 172,Residential,48000,0,48000,282577,0,330577
113135200600000,NE 172,Residential,48000,0,48000,272703,0,320703
113135200700000,NE 172,Residential,48000,0,48000,279312,0,327312
113135200800000,NE 172,Residential,48000,0,48000,242189,0,290189
113135200900000,NE 172,Residential,48000,0,48000,180791,0,228791
113135201000000,NE 172,Residential,48000,0,48000,209372,0,257372
113135201100000,NE 172,Residential,42000,0,42000,160238,0,202238
113135201200000,NE 172,Residential,20,0,20,0,0,20
113135201300000,NE 172,Residential,48000,0,48000,254969,0,302969
113135201400000,NE 172,Residential,40720,0,40720,0,0,40720
113135201500000,NE 172,Residential,520,0,520,0,0,520
113135201600000,NE 172,Residential,580,0,580,0,0,580
113135201700000,NE 172,Residential,48000,0,48000,216880,0,264880
113135300100000,NE 172,Residential,44694,0,44694,195050,0,239744
113135300200000,NE 172,Residential,42522,0,42522,121423,0,163945
113142600100000,NE 168,Residential,75750,0,75750,146970,0,222720
113142600200000,NE 168,Residential,75000,0,75000,107620,0,182620
113142600300000,NE 168,Residential,75050,0,75050,125963,0,201013
113142600400000,NE 168,Residential,75050,0,75050,110851,0,185901
113142600500000,NE 168,Residential,75000,0,75000,123155,0,198155
113142700100000,NE 168,Residential,75450,0,75450,132347,0,207797
113142700200000,NE 168,Residential,75350,0,75350,165457,0,240807
113142700300000,NE 168,Residential,75550,0,75550,156537,0,232087
113142700400000,NE 168,Residential,76100,0,76100,141399,0,217499
113142700500000,NE 168,Residential,75000,0,75000,145504,0,220504
113142700600000,NE 168,Residential,75000,0,75000,130690,0,205690
113142700700000,NE 168,Residential,75000,0,75000,163373,0,238373
113142700800000,NE 168,Residential,102850,0,102850,217310,0,320160
113142700900000,NE 168,Residential,83600,0,83600,200887,0,284487
113142800100000,NE 168,Residential,75250,0,75250,124527,0,199777
113142800200000,NE 168,Residential,75150,0,75150,159883,0,235033
113142800300000,NE 168,Residential,75150,0,75150,132049,0,207199
113142800400000,NE 168,Residential,75300,0,75300,127832,0,203132
113143000100000,NE 168,Residential,75250,0,75250,154346,0,229596
113143000200000,NE 168,Residential,75200,0,75200,179322,0,254522
113143000300000,NE 168,Residential,75150,0,75150,182233,0,257383
113143000400000,NE 168,Residential,75150,0,75150,180683,0,255833
113143000500000,NE 168,Residential,75150,0,75150,115638,0,190788
113310100100000,NE 103,Residential,19703,0,19703,157476,0,177179
113310100200000,NE 103,Residential,21510,0,21510,173474,0,194984
113310100300000,NE 103,Residential,16914,0,16914,159922,0,176836
113310100400000,NE 103,Residential,18810,0,18810,146555,0,165365
113310100500000,NE 103,Residential,16284,0,16284,135794,0,152078
113310100600000,NE 103,Residential,19863,0,19863,141902,0,161765
113310100700000,NE 103,Residential,16830,0,16830,149275,0,166105
113310100800000,NE 103,Residential,19192,0,19192,148768,0,167960
113310100900000,NE 103,Residential,18394,0,18394,123946,0,142340
113310101000000,NE 103,Residential,21375,0,21375,157449,0,178824
113310101100000,NE 103,Residential,16497,0,16497,114120,0,130617
113310101200000,NE 103,Residential,15641,0,15641,159120,0,174761
113310101300000,NE 103,Residential,15641,0,15641,150734,0,166375
113310101400000,NE 103,Residential,18845,0,18845,146470,0,165315
113310101500000,NE 103,Residential,19680,0,19680,132007,0,151687
113310101600000,NE 103,Residential,19338,0,19338,135785,0,155123
113310101700000,NE 103,Residential,18810,0,18810,140972,0,159782
113310101800000,NE 103,Residential,18790,0,18790,147693,0,166483
113310101900000,NE 103,Residential,20808,0,20808,133905,0,154713
113310102000000,NE 103,Residential,20460,0,20460,162650,0,183110
113310102100000,NE 103,Residential,20218,0,20218,129570,0,149788
113310102200000,NE 103,Residential,16369,0,16369,161304,0,177673
113310102300000,NE 103,Residential,20479,0,20479,140306,0,160785
113310102400000,NE 103,Residential,19541,0,19541,145116,0,164657
113310102500000,NE 103,Residential,20924,0,20924,140428,0,161352
113310102600000,NE 103,Residential,18473,0,18473,131366,0,149839
113310102700000,NE 103,Residential,17820,0,17820,126629,0,144449
113310102800000,NE 103,Residential,19868,0,19868,143266,0,163134
113310102900000,NE 103,Residential,20971,0,20971,154923,0,175894
113310103000000,NE 103,Residential,18563,0,18563,158413,0,176976
113310103100000,NE 103,Residential,18563,0,18563,142401,0,160964
113310103200000,NE 103,Residential,19800,0,19800,138361,0,158161
113310103300000,NE 103,Residential,19513,0,19513,158772,0,178285
113310200100000,NE 103,Residential,20861,0,20861,154163,0,175024
113310200200000,NE 103,Residential,18810,0,18810,132791,0,151601
113310200300000,NE 103,Residential,18810,0,18810,139536,0,158346
113310200400000,NE 103,Residential,17417,0,17417,149311,0,166728
113310200500000,NE 103,Residential,20116,0,20116,168250,0,188366
113310200600000,NE 103,Residential,19230,0,19230,137770,0,157000
113310200700000,NE 103,Residential,19885,0,19885,147951,0,167836
113310200800000,NE 103,Residential,14550,0,14550,113898,0,128448
113310200900000,NE 103,Residential,18915,0,18915,135247,0,154162
113310201000000,NE 103,Residential,18005,0,18005,151995,0,170000
113310201100000,NE 103,Residential,17770,0,17770,157353,0,175123
113310201200000,NE 103,Residential,14308,0,14308,113689,0,127997
113310201300000,NE 103,Residential,14773,0,14773,121481,0,136254
113310201400000,NE 103,Residential,14850,0,14850,144110,0,158960
113310201500000,NE 103,Residential,18810,0,18810,146952,0,165762
113310201600000,NE 103,Residential,17325,0,17325,142608,0,159933
113310201700000,NE 103,Residential,19757,0,19757,132327,0,152084
113310300100000,NE 103,Residential,20206,0,20206,151975,0,172181
113310300200000,NE 103,Residential,17500,0,17500,132213,0,149713
113310300300000,NE 103,Residential,16250,0,16250,156387,0,172637
113310300400000,NE 103,Residential,17636,0,17636,140207,0,157843
113310300500000,NE 103,Residential,14850,0,14850,148104,0,162954
113310300600000,NE 103,Residential,18315,0,18315,134455,0,152770
113310300700000,NE 103,Residential,17737,0,17737,144791,0,162528
113310300800000,NE 103,Residential,20327,0,20327,148747,0,169074
113310300900000,NE 103,Residential,18902,0,18902,157894,0,176796
113310301000000,NE 103,Residential,16125,0,16125,141783,0,157908
113310301100000,NE 103,Residential,20715,0,20715,165677,0,186392
113310301200000,NE 103,Residential,21064,0,21064,143240,0,164304
113310301300000,NE 103,Residential,20149,0,20149,144089,0,164238
113310301400000,NE 103,Residential,20026,0,20026,142597,0,162623
113310301500000,NE 103,Residential,20167,0,20167,138384,0,158551
113310301600000,NE 103,Residential,20071,0,20071,151038,0,171109
113310301700000,NE 103,Residential,20100,0,20100,132120,0,152220
113310301800000,NE 103,Residential,20667,0,20667,133578,0,154245
113310301900000,NE 103,Residential,18150,0,18150,121201,0,139351
113310302000000,NE 103,Residential,16830,0,16830,147579,0,164409
113310302100000,NE 103,Residential,16063,0,16063,149546,0,165609
113310302200000,NE 103,Residential,16063,0,16063,141763,0,157826
113310302300000,NE 103,Residential,17445,0,17445,115211,0,132656
113310302400000,NE 103,Residential,18398,0,18398,120759,0,139157
113310302500000,NE 103,Residential,17677,0,17677,142124,0,159801
113310302600000,NE 103,Residential,21505,0,21505,141026,0,162531
113310400100000,NE 103,Residential,21780,0,21780,134906,0,156686
113310400200000,NE 103,Residential,19075,0,19075,144921,0,163996
113310400300000,NE 103,Residential,26626,0,26626,133330,0,159956
113310400400000,NE 103,Residential,22064,0,22064,144325,0,166389
113310400500000,NE 103,Residential,20701,0,20701,145795,0,166496
113310400600000,NE 103,Residential,20531,0,20531,143027,0,163558
113310400700000,NE 103,Residential,24302,0,24302,156700,0,181002
113310400800000,NE 103,Residential,19568,0,19568,130267,0,149835
113310500100000,NE 103,Residential,19520,0,19520,153924,0,173444
113310500200000,NE 103,Residential,16413,0,16413,128999,0,145412
113310500300000,NE 103,Residential,18061,0,18061,128521,0,146582
113310500400000,NE 103,Residential,19635,0,19635,152347,0,171982
113310500500000,NE 103,Residential,19617,0,19617,139857,0,159474
113310500600000,NE 103,Residential,15449,0,15449,145825,0,161274
113310500700000,NE 103,Residential,14550,0,14550,139291,0,153841
113310500800000,NE 103,Residential,14550,0,14550,145122,0,159672
113310500900000,NE 103,Residential,16170,0,16170,144936,0,161106
113310501000000,NE 103,Residential,19963,0,19963,147059,0,167022
113310501100000,NE 103,Residential,17298,0,17298,146324,0,163622
113310501200000,NE 103,Residential,15158,0,15158,121092,0,136250
113310501300000,NE 103,Residential,14100,0,14100,127799,0,141899
113310501400000,NE 103,Residential,18080,0,18080,134420,0,152500
113310501500000,NE 103,Residential,17636,0,17636,131082,0,148718
113310501600000,NE 103,Residential,17595,0,17595,142790,0,160385
113310501700000,NE 103,Residential,17338,0,17338,138393,0,155731
113310501800000,NE 103,Residential,16289,0,16289,131529,0,147818
113310501900000,NE 103,Residential,17500,0,17500,109278,0,126778
113310502000000,NE 103,Residential,15500,0,15500,113511,0,129011
113310502100000,NE 103,Residential,15725,0,15725,147060,0,162785
113310502200000,NE 103,Residential,14668,0,14668,140232,0,154900
113310502300000,NE 103,Residential,15620,0,15620,143199,0,158819
113310502400000,NE 103,Residential,21350,0,21350,134958,0,156308
113310502500000,CHURCH,Exempt,0,387450,387450,0,1254334,1641784
113310502600000,NE 103,Residential,25200,0,25200,187570,0,212770
113310502700000,NE 103,Residential,25052,0,25052,173522,0,198574
113310502800000,NE 103,Residential,26125,0,26125,151128,0,177253
113310502900000,NE 103,Residential,24798,0,24798,167301,0,192099
113310503000000,NE 103,Residential,24860,0,24860,171944,0,196804
113310503100000,NE 103,Residential,24900,0,24900,142592,0,167492
113310600100000,NE 103,Residential,21261,0,21261,143777,0,165038
113310600200000,NE 103,Residential,20459,0,20459,124705,0,145164
113310600300000,NE 103,Residential,16320,0,16320,126155,0,142475
113310600400000,NE 103,Residential,20014,0,20014,125506,0,145520
113310600500000,NE 103,Residential,21026,0,21026,145913,0,166939
113310600600000,NE 103,Residential,16830,0,16830,145435,0,162265
113312600100000,VACANT LAND,Exempt,0,712422,712422,0,0,712422
113312600200000,NE 108,Exempt,0,128520,128520,0,327152,455672
113312600300000,NE 108,Residential,39577,0,39577,125423,0,165000
113315100100000,NE 108,Residential,33089,0,33089,137075,0,170164
113315100200000,NE 108,Residential,31928,0,31928,109192,0,141120
113315100300000,NE 108,Residential,33075,0,33075,107564,0,140639
113315100400000,NE 108,Residential,33075,0,33075,107397,0,140472
113315100500000,NE 108,Residential,33075,0,33075,125480,0,158555
113315100600000,NE 108,Residential,31605,0,31605,98124,0,129729
113315100700000,NE 108,Residential,33600,0,33600,122686,0,156286
113315100800000,NE 108,Residential,33972,0,33972,108235,0,142207
113315100900000,NE 108,Residential,30565,0,30565,82618,0,113183
113315101000000,NE 108,Residential,31605,0,31605,112762,0,144367
113315101100000,NE 108,Residential,31605,0,31605,105978,0,137583
113315101200000,NE 108,Residential,31605,0,31605,110840,0,142445
113315101300000,NE 108,Residential,33075,0,33075,115651,0,148726
113315101400000,NE 108,Residential,33075,0,33075,114230,0,147305
113315101500000,NE 108,Residential,30158,0,30158,106341,0,136499
113315101600000,NE 108,Residential,32585,0,32585,91326,0,123911
113315101700000,NE 108,Residential,29645,0,29645,110545,0,140190
113315101800000,NE 108,Residential,29645,0,29645,99211,0,128856
113315101900000,NE 108,Residential,29645,0,29645,122924,0,152569
113315102000000,NE 108,Residential,30583,0,30583,101250,0,131833
113315102100000,NE 108,Residential,34450,0,34450,121340,0,155790
113315102200000,NE 108,Residential,32928,0,32928,98399,0,131327
113315102300000,NE 108,Residential,30642,0,30642,86089,0,116731
113315102400000,NE 108,Residential,30642,0,30642,96857,0,127499
113315102500000,NE 108,Residential,28267,0,28267,147403,0,175670
113315102600000,NE 108,Residential,28267,0,28267,102276,0,130543
113315102700000,NE 108,Residential,28734,0,28734,110631,0,139365
113315102800000,NE 108,Residential,33163,0,33163,84608,0,117771
113315102900000,NE 108,Residential,32170,0,32170,95541,0,127711
113315103000000,NE 108,Residential,33405,0,33405,97559,0,130964
113315103100000,NE 108,Residential,31600,0,31600,83852,0,115452
113315103200000,NE 108,Residential,34377,0,34377,106396,0,140773
113315103300000,NE 108,Residential,34320,0,34320,137858,0,172178
113315103400000,NE 108,Residential,31920,0,31920,88439,0,120359
113315103500000,NE 108,Residential,31968,0,31968,98975,0,130943
113315103600000,NE 108,Residential,32592,0,32592,105340,0,137932
113315103700000,NE 108,Residential,31932,0,31932,97011,0,128943
113315103800000,NE 108,Residential,33653,0,33653,96629,0,130282
113315103900000,CITY PROPERTY,Exempt,0,0,0,0,0,0
113315104000000,CITY PROPERTY,Exempt,0,0,0,0,0,0
113315200100000,NE 108,Residential,33075,0,33075,116814,0,149889
113315200200000,NE 108,Residential,30380,0,30380,101680,0,132060
113315200300000,NE 108,Residential,33075,0,33075,96823,0,129898
113315200400000,NE 108,Residential,32400,0,32400,109303,0,141703
113315200500000,NE 108,Residential,30960,0,30960,99289,0,130249
113315200600000,NE 108,Residential,30960,0,30960,106167,0,137127
113315200700000,NE 108,Residential,30816,0,30816,103511,0,134327
113315200800000,NE 108,Residential,32998,0,32998,111943,0,144941
113315200900000,NE 108,Residential,30960,0,30960,87063,0,118023
113315201000000,NE 108,Residential,29040,0,29040,90992,0,120032
113315201100000,NE 108,Residential,29040,0,29040,97260,0,126300
113315201200000,NE 108,Residential,29040,0,29040,82985,0,112025
113315201300000,NE 108,Residential,31200,0,31200,90403,0,121603
113315201400000,NE 108,Residential,30550,0,30550,92069,0,122619
113315201500000,NE 108,Residential,29040,0,29040,85494,0,114534
113315201600000,NE 108,Residential,29040,0,29040,81007,0,110047
113315201700000,NE 108,Residential,29040,0,29040,85077,0,114117
113315201800000,NE 108,Residential,30960,0,30960,95933,0,126893
113315201900000,NE 108,Residential,32520,0,32520,101277,0,133797
113315202000000,NE 108,Residential,30816,0,30816,102188,0,133004
113315202100000,NE 108,Residential,31150,0,31150,96850,0,128000
113315202200000,NE 108,Residential,30791,0,30791,72249,0,103040
113315202300000,NE 108,Residential,32400,0,32400,91132,0,123532
113315300100000,NE 108,Residential,33075,0,33075,126270,0,159345
113315300200000,NE 108,Residential,30380,0,30380,99542,0,129922
113315300300000,NE 108,Residential,32400,0,32400,98996,0,131396
113315300400000,NE 108,Residential,27802,0,27802,98411,0,126213
113315300500000,NE 108,Residential,27840,0,27840,97675,0,125515
113315300600000,NE 108,Residential,27840,0,27840,108420,0,136260
113315300700000,NE 108,Residential,27840,0,27840,96155,0,123995
113315300800000,NE 108,Residential,27840,0,27840,100435,0,128275
113315300900000,NE 108,Residential,27227,0,27227,100103,0,127330
113315301000000,NE 108,Residential,32400,0,32400,98399,0,130799
113315301100000,NE 108,Residential,27360,0,27360,98575,0,125935
113315301200000,NE 108,Residential,27360,0,27360,90852,0,118212
113315301300000,NE 108,Residential,27360,0,27360,89983,0,117343
113315301400000,NE 108,Residential,30550,0,30550,120837,0,151387
113315301500000,NE 108,Residential,31200,0,31200,88806,0,120006
113315301600000,NE 108,Residential,27360,0,27360,93584,0,120944
113315301700000,NE 108,Residential,27360,0,27360,106175,0,133535
113315301800000,NE 108,Residential,27360,0,27360,89070,0,116430
113315301900000,NE 108,Residential,32400,0,32400,102881,0,135281
113315302000000,NE 108,Residential,32520,0,32520,113192,0,145712
113315302100000,NE 108,Residential,30960,0,30960,94983,0,125943
113315302200000,NE 108,Residential,30960,0,30960,102374,0,133334
113315302300000,NE 108,Residential,30960,0,30960,115256,0,146216
113315302400000,NE 108,Residential,33160,0,33160,122152,0,155312
113315400100000,NE 108,Residential,31094,0,31094,114350,0,145444
113315400200000,NE 108,Residential,31416,0,31416,97882,0,129298
113315500100000,NE 108,Residential,32148,0,32148,93061,0,125209
113315500200000,NE 108,Residential,32148,0,32148,87327,0,119475
113315600100000,NE 108,Residential,32148,0,32148,95874,0,128022
113315600200000,NE 108,Residential,32148,0,32148,92413,0,124561
113317600100000,CHURCH,Exempt,0,456192,456192,0,402215,858407
113317600200000,NE 103,Residential,13128,0,13128,79623,0,92751
113317600300000,NE 103,Residential,11992,0,11992,79915,0,91907
113317600400000,NE 103,Residential,12632,0,12632,76477,0,89109
113317600500000,NE 103,Residential,13281,0,13281,76580,0,89861
113317600600000,NE 103,Residential,25359,0,25359,152906,0,178265
113317700100000,NE 103,Residential,26089,0,26089,191343,0,217432
113317700200000,NE 103,Residential,14910,0,14910,76502,0,91412
113317700300000,NE 103,Residential,18683,0,18683,79964,0,98647
113317800100000,NE 108,Residential,32325,0,32325,143792,0,176117
113317800200000,NE 108,Residential,31450,0,31450,91490,0,122940
113317800300000,NE 108,Residential,29760,0,29760,97535,0,127295
113317800400000,NE 108,Residential,28800,0,28800,95938,0,124738
113317800500000,NE 108,Residential,27840,0,27840,88825,0,116665
113317800600000,NE 108,Residential,29760,0,29760,94624,0,124384
113317800700000,NE 108,Residential,27840,0,27840,87035,0,114875
113317800800000,NE 108,Residential,29760,0,29760,101737,0,131497
113317800900000,NE 108,Residential,28800,0,28800,90813,0,119613
113317801000000,NE 108,Residential,29751,0,29751,87749,0,117500
113317801100000,NE 108,Residential,31484,0,31484,87802,0,119286
113317801200000,NE 108,Residential,33787,0,33787,105967,0,139754
113317801300000,NE 108,Residential,31384,0,31384,99921,0,131305
113317801400000,NE 108,Residential,31920,0,31920,92983,0,124903
113317801500000,NE 108,Residential,31920,0,31920,91256,0,123176
113317801600000,NE 108,Residential,31508,0,31508,94832,0,126340
113317801700000,NE 108,Residential,33919,0,33919,95523,0,129442
113317801800000,NE 108,Residential,30068,0,30068,105782,0,135850
113317801900000,NE 108,Residential,29760,0,29760,91646,0,121406
113317802000000,NE 108,Residential,28800,0,28800,100338,0,129138
113317802100000,NE 108,Residential,29760,0,29760,96054,0,125814
113317802200000,NE 108,Residential,29760,0,29760,101659,0,131419
113317802300000,NE 108,Residential,27840,0,27840,94164,0,122004
113317802400000,NE 108,Residential,27840,0,27840,84643,0,112483
113317802500000,NE 108,Residential,28800,0,28800,91777,0,120577
113317802600000,NE 108,Residential,29760,0,29760,103196,0,132956
113317802700000,NE 108,Residential,30770,0,30770,90889,0,121659
113317802800000,NE 108,Residential,31237,0,31237,93651,0,124888
113317802900000,NE 108,Residential,29760,0,29760,85168,0,114928
113317803000000,NE 108,Residential,28800,0,28800,84748,0,113548
113317803100000,NE 108,Residential,27840,0,27840,83588,0,111428
113317803200000,NE 108,Residential,27840,0,27840,94735,0,122575
113317803300000,NE 108,Residential,29760,0,29760,87288,0,117048
113317803400000,NE 108,Residential,29760,0,29760,134163,0,163923
113317803500000,NE 108,Residential,28800,0,28800,104252,0,133052
113317803600000,NE 108,Residential,29760,0,29760,94005,0,123765
113317803700000,NE 108,Residential,31429,0,31429,83477,0,114906
113317803800000,NE 108,Residential,32944,0,32944,92481,0,125425
113317803900000,NE 108,Residential,31775,0,31775,94869,0,126644
113317804000000,NE 108,Residential,31920,0,31920,95211,0,127131
113317804100000,NE 108,Residential,31920,0,31920,97263,0,129183
113317804200000,NE 108,Residential,32014,0,32014,108080,0,140094
113317804300000,NE 108,Residential,36619,0,36619,109608,0,146227
113317804400000,NE 108,Residential,30736,0,30736,105966,0,136702
113317804500000,NE 108,Residential,28800,0,28800,84120,0,112920
113317804600000,NE 108,Residential,28800,0,28800,91539,0,120339
113317804700000,NE 108,Residential,32400,0,32400,99453,0,131853
113317804800000,NE 108,Residential,32278,0,32278,105022,0,137300
113317804900000,NE 108,Residential,28800,0,28800,102179,0,130979
113317805000000,NE 108,Residential,28500,0,28500,91736,0,120236
113317805100000,NE 108,Residential,28902,0,28902,98702,0,127604
113317805200000,NE 108,Residential,31980,0,31980,102375,0,134355
113317805300000,NE 108,Residential,31734,0,31734,108917,0,140651
113317805400000,NE 108,Residential,33075,0,33075,106990,0,140065
113317805500000,NE 108,Residential,32000,0,32000,91539,0,123539
113317805600000,NE 108,Residential,31264,0,31264,101903,0,133167
113317805700000,NE 108,Residential,33919,0,33919,106563,0,140482
113317805800000,NE 108,Residential,32818,0,32818,102718,0,135536
113317805900000,NE 108,Residential,31968,0,31968,87935,0,119903
113317806000000,NE 108,Residential,31920,0,31920,85334,0,117254
113317806100000,NE 108,Residential,32765,0,32765,103864,0,136629
113317806200000,NE 108,Residential,33075,0,33075,89337,0,122412
113317806300000,NE 108,Residential,32328,0,32328,88795,0,121123
113317806400000,NE 108,Residential,33252,0,33252,94877,0,128129
113317806500000,NE 108,Residential,35140,0,35140,107311,0,142451
113317806600000,NE 108,Residential,32818,0,32818,88369,0,121187
113317806700000,NE 108,Residential,31968,0,31968,93678,0,125646
113317806800000,NE 108,Residential,31920,0,31920,98475,0,130395
113317806900000,NE 108,Residential,31734,0,31734,100345,0,132079
113317807000000,NE 108,Residential,33075,0,33075,93980,0,127055
113317807100000,NE 108,Residential,32442,0,32442,91099,0,123541
113317807200000,NE 108,Residential,33858,0,33858,94836,0,128694
113317807300000,NE 108,Residential,33858,0,33858,102197,0,136055
113317807400000,NE 108,Residential,32935,0,32935,105657,0,138592
113317807500000,NE 108,Residential,30636,0,30636,121637,0,152273
113317807600000,NE 108,Residential,27720,0,27720,107734,0,135454
113317807700000,NE 108,Residential,30294,0,30294,86658,0,116952
113317807800000,NE 108,Residential,30332,0,30332,100063,0,130395
113317807900000,NE 108,Residential,29700,0,29700,104462,0,134162
113317808000000,NE 108,Residential,30332,0,30332,102490,0,132822
113317808100000,NE 108,Residential,31272,0,31272,114367,0,145639
113317808200000,NE 108,Residential,31135,0,31135,104422,0,135557
113317808300000,NE 108,Residential,30739,0,30739,118765,0,149504
113317808400000,NE 108,Residential,31680,0,31680,121876,0,153556
113317900100000,NE 108,Residential,31808,0,31808,89544,0,121352
113317900200000,NE 108,Residential,31394,0,31394,109085,0,140479
113317900300000,NE 108,Residential,28800,0,28800,88877,0,117677
113317900400000,NE 108,Residential,26400,0,26400,87797,0,114197
113317900500000,NE 108,Residential,26400,0,26400,88080,0,114480
113317900600000,NE 108,Residential,27840,0,27840,89492,0,117332
113317900700000,NE 108,Residential,28800,0,28800,88308,0,117108
113317900800000,NE 108,Residential,28800,0,28800,90145,0,118945
113317900900000,NE 108,Residential,26400,0,26400,98144,0,124544
113317901000000,NE 108,Residential,28800,0,28800,95620,0,124420
113317901100000,NE 108,Residential,30550,0,30550,92250,0,122800
113317901200000,NE 108,Residential,30550,0,30550,89185,0,119735
113317901300000,NE 108,Residential,28800,0,28800,109108,0,137908
113317901400000,NE 108,Residential,26400,0,26400,76762,0,103162
113317901500000,NE 108,Residential,28800,0,28800,84280,0,113080
113317901600000,NE 108,Residential,28800,0,28800,97587,0,126387
113317901700000,NE 108,Residential,27840,0,27840,94157,0,121997
113317901800000,NE 108,Residential,26400,0,26400,90253,0,116653
113317901900000,NE 108,Residential,26400,0,26400,94970,0,121370
113317902000000,NE 108,Residential,28800,0,28800,97313,0,126113
113318000100000,NE 108,Residential,30838,0,30838,109069,0,139907
113318000200000,NE 108,Residential,31022,0,31022,92619,0,123641
113318000300000,NE 108,Residential,30960,0,30960,90529,0,121489
113318000400000,NE 108,Residential,28800,0,28800,93990,0,122790
113318000500000,NE 108,Residential,30960,0,30960,92482,0,123442
113318000600000,NE 108,Residential,31920,0,31920,103877,0,135797
113318000700000,NE 108,Residential,30960,0,30960,80231,0,111191
113318000800000,NE 108,Residential,28800,0,28800,95951,0,124751
113318000900000,NE 108,Residential,28800,0,28800,87300,0,116100
113318001000000,NE 108,Residential,28800,0,28800,90602,0,119402
113318001100000,NE 108,Residential,30550,0,30550,103392,0,133942
113318001200000,NE 108,Residential,30550,0,30550,94098,0,124648
113318001300000,NE 108,Residential,28800,0,28800,102633,0,131433
113318001400000,NE 108,Residential,28800,0,28800,100290,0,129090
113318001500000,NE 108,Residential,28800,0,28800,93716,0,122516
113318001600000,NE 108,Residential,30960,0,30960,95434,0,126394
113318001700000,NE 108,Residential,31920,0,31920,107835,0,139755
113318001800000,NE 108,Residential,30960,0,30960,92116,0,123076
113318001900000,NE 108,Residential,28800,0,28800,102671,0,131471
113318002000000,NE 108,Residential,30960,0,30960,92353,0,123313
113318002100000,NE 108,Residential,31437,0,31437,96967,0,128404
113318100100000,NE 108,Residential,33792,0,33792,112230,0,146022
113318100200000,NE 108,Residential,32626,0,32626,102825,0,135451
113318100300000,NE 108,Residential,34125,0,34125,104735,0,138860
113318100400000,NE 108,Residential,30960,0,30960,96909,0,127869
113318100500000,NE 108,Residential,30960,0,30960,101318,0,132278
113318100600000,NE 108,Residential,31829,0,31829,96703,0,128532
113318100700000,NE 108,Residential,32630,0,32630,100486,0,133116
113318100800000,NE 108,Residential,30720,0,30720,95969,0,126689
113318100900000,NE 108,Residential,28800,0,28800,98850,0,127650
113318101000000,NE 108,Residential,28800,0,28800,102306,0,131106
113318101100000,NE 108,Residential,31890,0,31890,102086,0,133976
113318101200000,NE 108,Residential,32400,0,32400,98347,0,130747
113318101300000,NE 108,Residential,30960,0,30960,91151,0,122111
113318101400000,NE 108,Residential,29760,0,29760,97170,0,126930
113318101500000,NE 108,Residential,30960,0,30960,88645,0,119605
113318101600000,NE 108,Residential,30784,0,30784,90747,0,121531
113318101700000,NE 108,Residential,31177,0,31177,124943,0,156120
113318101800000,NE 108,Residential,28000,0,28000,97765,0,125765
113318200100000,NE 108,Residential,32148,0,32148,82110,0,114258
113318200200000,NE 108,Residential,32148,0,32148,92051,0,124199
113318300100000,NE 108,Residential,32148,0,32148,102820,0,134968
113318300200000,NE 108,Residential,32148,0,32148,102211,0,134359
113340100100000,NE 108,Residential,31928,0,31928,85731,0,117659
113340100200000,NE 108,Residential,30960,0,30960,91614,0,122574
113340100300000,NE 108,Residential,32832,0,32832,93468,0,126300
113340100400000,NE 108,Residential,30960,0,30960,89402,0,120362
113340100500000,NE 108,Residential,31920,0,31920,95198,0,127118
113340100600000,NE 108,Residential,32832,0,32832,105260,0,138092
113340100700000,NE 108,Residential,32400,0,32400,109276,0,141676
113340100800000,NE 108,Residential,33075,0,33075,102598,0,135673
113340100900000,NE 108,Residential,33516,0,33516,91523,0,125039
113340101000000,NE 108,Residential,32585,0,32585,108659,0,141244
113340101100000,NE 108,Residential,31605,0,31605,88202,0,119807
113340101200000,NE 108,Residential,33516,0,33516,86719,0,120235
113340200100000,NE 108,Residential,31920,0,31920,100666,0,132586
113340200200000,NE 108,Residential,31920,0,31920,95298,0,127218
113340200300000,NE 108,Residential,30960,0,30960,88227,0,119187
113340200400000,NE 108,Residential,30720,0,30720,97756,0,128476
113340200500000,NE 108,Residential,30960,0,30960,83905,0,114865
113340200600000,NE 108,Residential,31920,0,31920,104112,0,136032
113340200700000,NE 108,Residential,32400,0,32400,97850,0,130250
113340200800000,NE 108,Residential,32400,0,32400,93718,0,126118
113340200900000,NE 108,Residential,31920,0,31920,97904,0,129824
113340201000000,NE 108,Residential,30960,0,30960,87939,0,118899
113340201100000,NE 108,Residential,30720,0,30720,89836,0,120556
113340201200000,NE 108,Residential,30960,0,30960,88464,0,119424
113340300100000,NE 108,Residential,31920,0,31920,102155,0,134075
113340300200000,NE 108,Residential,31920,0,31920,92275,0,124195
113340300300000,NE 108,Residential,30960,0,30960,92537,0,123497
113340300400000,NE 108,Residential,30720,0,30720,90500,0,121220
113340300500000,NE 108,Residential,30960,0,30960,95622,0,126582
113340300600000,NE 108,Residential,31920,0,31920,105882,0,137802
113340300700000,NE 108,Residential,32400,0,32400,90663,0,123063
113340300800000,NE 108,Residential,32400,0,32400,94227,0,126627
113340300900000,NE 108,Residential,31920,0,31920,69502,0,101422
113340301000000,NE 108,Residential,30960,0,30960,94548,0,125508
113340301100000,NE 108,Residential,30720,0,30720,88577,0,119297
113340301200000,NE 108,Residential,30960,0,30960,88964,0,119924
113340400100000,NE 108,Residential,31920,0,31920,97645,0,129565
113340400200000,NE 108,Residential,31920,0,31920,100385,0,132305
113340400300000,NE 108,Residential,30960,0,30960,104016,0,134976
113340400400000,NE 108,Residential,30720,0,30720,102935,0,133655
113340400500000,NE 108,Residential,30960,0,30960,91540,0,122500
113340400600000,NE 108,Residential,31920,0,31920,72290,0,104210
113340400700000,NE 108,Residential,32400,0,32400,99901,0,132301
113340400800000,NE 108,Residential,32400,0,32400,90238,0,122638
113340400900000,NE 108,Residential,31920,0,31920,97901,0,129821
113340401000000,NE 108,Residential,30960,0,30960,91950,0,122910
113340401100000,NE 108,Residential,30720,0,30720,93333,0,124053
113340401200000,NE 108,Residential,30960,0,30960,88936,0,119896
113340500100000,NE 108,Residential,31920,0,31920,97477,0,129397
113340500200000,NE 108,Residential,28424,0,28424,92149,0,120573
113340500300000,NE 108,Residential,28800,0,28800,84196,0,112996
113340500400000,NE 108,Residential,30960,0,30960,89307,0,120267
113340500500000,NE 108,Residential,30720,0,30720,91754,0,122474
113340500600000,NE 108,Residential,30960,0,30960,94507,0,125467
113340500700000,NE 108,Residential,31920,0,31920,103533,0,135453
113340500800000,NE 108,Residential,32400,0,32400,93286,0,125686
113340500900000,NE 108,Residential,32400,0,32400,96913,0,129313
113340501000000,NE 108,Residential,31920,0,31920,99534,0,131454
113340501100000,NE 108,Residential,30960,0,30960,99075,0,130035
113340501200000,NE 108,Residential,30720,0,30720,97402,0,128122
113340501300000,NE 108,Residential,30960,0,30960,75153,0,106113
113340600100000,NE 108,Residential,33660,0,33660,116371,0,150031
113340600200000,NE 108,Residential,34793,0,34793,104115,0,138908
113340600300000,NE 108,Residential,34226,0,34226,109336,0,143562
113340600400000,NE 108,Residential,32700,0,32700,102530,0,135230
113340600500000,NE 108,Residential,32700,0,32700,95302,0,128002
113340600600000,NE 108,Residential,32700,0,32700,102495,0,135195
113340600700000,NE 108,Residential,32700,0,32700,113160,0,145860
113340600800000,NE 108,Residential,32700,0,32700,100593,0,133293
113340600900000,NE 108,Residential,32700,0,32700,101785,0,134485
113340601000000,NE 108,Residential,32700,0,32700,113514,0,146214
113340601100000,NE 108,Residential,32700,0,32700,103352,0,136052
113340601200000,NE 108,Residential,32700,0,32700,99231,0,131931
113340601300000,NE 108,Residential,32700,0,32700,102589,0,135289
113340601400000,NE 108,Residential,32700,0,32700,107713,0,140413
113340601500000,NE 108,Residential,32700,0,32700,108081,0,140781
113340601600000,NE 108,Residential,32887,0,32887,107113,0,140000
113340601700000,NE 108,Residential,32700,0,32700,98852,0,131552
113340601800000,NE 108,Residential,36242,0,36242,103832,0,140074
113340601900000,NE 108,Residential,37650,0,37650,108963,0,146613
113340602000000,NE 108,Residential,32700,0,32700,91648,0,124348
113340602200000,NE 108,Residential,33813,0,33813,56187,0,90000
113342600100000,NE 108,Residential,31920,0,31920,94535,0,126455
113342600200000,NE 108,Residential,30960,0,30960,81486,0,112446
113342600300000,NE 108,Residential,31920,0,31920,92604,0,124524
113342600400000,NE 108,Residential,30720,0,30720,84339,0,115059
113342600500000,NE 108,Residential,30960,0,30960,91582,0,122542
113342600600000,NE 108,Residential,31920,0,31920,94561,0,126481
113342600700000,NE 108,Residential,32400,0,32400,93814,0,126214
113342600800000,NE 108,Residential,32400,0,32400,89596,0,121996
113342600900000,NE 108,Residential,31920,0,31920,90484,0,122404
113342601000000,NE 108,Residential,30960,0,30960,80594,0,111554
113342601100000,NE 108,Residential,30720,0,30720,87724,0,118444
113342601200000,NE 108,Residential,30960,0,30960,96995,0,127955
113342700100000,NE 108,Residential,28565,0,28565,93048,0,121613
113342700200000,NE 108,Residential,30960,0,30960,93624,0,124584
113342700300000,NE 108,Residential,31920,0,31920,102152,0,134072
113342700400000,NE 108,Residential,30720,0,30720,119643,0,150363
113342700500000,NE 108,Residential,30960,0,30960,101706,0,132666
113342700600000,NE 108,Residential,31920,0,31920,105163,0,137083
113342700700000,NE 108,Residential,32400,0,32400,89837,0,122237
113342700800000,NE 108,Residential,32400,0,32400,79722,0,112122
113342700900000,NE 108,Residential,31920,0,31920,91957,0,123877
113342701000000,NE 108,Residential,30960,0,30960,95190,0,126150
113342701100000,NE 108,Residential,30720,0,30720,79552,0,110272
113342701200000,NE 108,Residential,30960,0,30960,83611,0,114571
113342701300000,NE 108,Residential,28800,0,28800,93917,0,122717
113342800100000,NE 108,Residential,30960,0,30960,96897,0,127857
113342800200000,NE 108,Residential,30960,0,30960,85736,0,116696
113342800300000,NE 108,Residential,31920,0,31920,82067,0,113987
113342800400000,NE 108,Residential,30720,0,30720,93295,0,124015
113342800500000,NE 108,Residential,30960,0,30960,85427,0,116387
113342800600000,NE 108,Residential,31920,0,31920,90813,0,122733
113342800700000,NE 108,Residential,32400,0,32400,97165,0,129565
113342800800000,NE 108,Residential,32400,0,32400,92966,0,125366
113342800900000,NE 108,Residential,31920,0,31920,95922,0,127842
113342801000000,NE 108,Residential,30960,0,30960,91558,0,122518
113342801100000,NE 108,Residential,30720,0,30720,82013,0,112733
113342801200000,NE 108,Residential,31920,0,31920,94258,0,126178
113342900100000,NE 108,Residential,32585,0,32585,102230,0,134815
113342900200000,NE 108,Residential,31605,0,31605,93767,0,125372
113342900300000,NE 108,Residential,31360,0,31360,91061,0,122421
113342900400000,NE 108,Residential,31605,0,31605,95164,0,126769
113342900500000,NE 108,Residential,32585,0,32585,94943,0,127528
113342900600000,NE 108,Residential,33075,0,33075,99598,0,132673
113343000100000,NE 108,Residential,35207,0,35207,104701,0,139908
113343000200000,NE 108,Residential,35207,0,35207,113121,0,148328
113343000300000,NE 108,Residential,32700,0,32700,92060,0,124760
113343000400000,NE 108,Residential,32700,0,32700,93460,0,126160
113343000500000,NE 108,Residential,33790,0,33790,82301,0,116091
113343000600000,NE 108,Residential,33790,0,33790,95860,0,129650
113343000700000,NE 108,Residential,33790,0,33790,87882,0,121672
113343000800000,NE 108,Residential,32700,0,32700,97237,0,129937
113343000900000,NE 108,Residential,32700,0,32700,99040,0,131740
113343001000000,NE 108,Residential,32700,0,32700,95475,0,128175
113343001100000,NE 108,Residential,32700,0,32700,103979,0,136679
113343001200000,NE 108,Residential,32700,0,32700,89618,0,122318
113343001300000,NE 108,Residential,32700,0,32700,101265,0,133965
113343001400000,NE 108,Residential,36539,0,36539,68552,0,105091
113343100100000,NE 108,Residential,35700,0,35700,138449,0,174149
113343100200000,NE 108,Residential,35700,0,35700,120572,0,156272
113347600100000,GOLF COURSE,Commercial,0,661625,661625,0,796407,1458032
113347700100000,OFFICE; MEDICAL,Commercial,0,247104,247104,0,652896,900000
113347700300000,FLAT PARKING,Commercial,0,7290,7290,0,7557,14847
113347700400000,OFFICE,Commercial,0,245376,245376,0,1023911,1269287
113410100100000,NE 163,Residential,40308,0,40308,66788,0,107096
113410100200000,CHURCH,Exempt,0,625968,625968,0,1358133,1984101
113410100300000,NE 163,Residential,27802,0,27802,154149,0,181951
113410100400000,NE 163,Residential,24480,0,24480,161787,0,186267
113410100500000,NE 163,Residential,24480,0,24480,147839,0,172319
113410100600000,NE 163,Residential,27120,0,27120,158394,0,185514
113410100700000,NE 163,Residential,27120,0,27120,159213,0,186333
113410100800000,NE 163,Residential,28928,0,28928,151085,0,180013
113410100900000,NE 163,Residential,26400,0,26400,145459,0,171859
113410101000000,NE 163,Residential,30103,0,30103,153596,0,183699
113410101100000,NE 163,Residential,28728,0,28728,165109,0,193837
113410101200000,NE 163,Residential,27157,0,27157,163986,0,191143
113410101300000,NE 163,Residential,27157,0,27157,145441,0,172598
113410101400000,NE 163,Residential,29400,0,29400,171516,0,200916
113410101500000,NE 163,Residential,25200,0,25200,164795,0,189995
113410101600000,NE 163,Residential,29820,0,29820,163216,0,193036
113410200100000,NE 163,Residential,28560,0,28560,194264,0,222824
113410200200000,NE 163,Residential,27030,0,27030,161083,0,188113
113410200300000,NE 163,Residential,27030,0,27030,158148,0,185178
113410200400000,NE 163,Residential,30031,0,30031,160930,0,190961
113410300100000,NE 163,Residential,33835,0,33835,176258,0,210093
113410300200000,NE 163,Residential,24480,0,24480,179136,0,203616
113410300300000,NE 163,Residential,25704,0,25704,189072,0,214776
113410300400000,NE 163,Residential,24888,0,24888,176439,0,201327
113410300500000,NE 163,Residential,28424,0,28424,171321,0,199745
113410400200000,CITY PROPERTY,Exempt,0,0,0,0,0,0
113410400300000,NE 163,Residential,30715,0,30715,164464,0,195179
113410400400000,NE 163,Residential,28711,0,28711,170189,0,198900
113410400500000,OFFICE; MEDICAL,Commercial,0,172800,172800,0,636261,809061
113410400701000,NBHD SHOPPING CENTER,Commercial,0,25272,25272,0,61398,86670
113410400701001,NBHD SHOPPING CENTER,Commercial,0,25272,25272,0,61398,86670
113410400701002,NBHD SHOPPING CENTER,Commercial,0,25272,25272,0,61398,86670
113410400701003,NBHD SHOPPING CENTER,Commercial,0,25272,25272,0,135880,161152
113410400701004,NBHD SHOPPING CENTER,Commercial,0,25272,25272,0,135880,161152
113410400701005,NBHD SHOPPING CENTER,Commercial,0,33696,33696,0,180574,214270
113410400701006,NBHD SHOPPING CENTER,Commercial,0,42120,42120,0,227065,269185
113410400701007,VACANT LAND,Commercial,0,23587,23587,0,0,23587
113410400701008,VACANT LAND,Commercial,0,23587,23587,0,0,23587
113410400701009,VACANT LAND,Commercial,0,23587,23587,0,0,23587
113410400701010,VACANT LAND,Commercial,0,23587,23587,0,0,23587
113410400701011,NBHD SHOPPING CENTER,Commercial,0,23587,23587,0,126411,149998
113410400701012,NBHD SHOPPING CENTER,Commercial,0,21060,21060,0,111639,132699
113410400701013,NBHD SHOPPING CENTER,Commercial,0,51948,51948,0,268067,320015
113410401000000,FLAT PARKING,Commercial,0,180900,180900,0,21462,202362
113410401101000,NBHD SHOPPING CENTER,Commercial,0,284040,284040,0,1339277,1623317
113410401101001,NBHD SHOPPING CENTER,Commercial,0,235440,235440,0,830443,1065883
113410401101002,FLAT PARKING,Commercial,0,235440,235440,0,0,235440
113410401101003,NBHD SHOPPING CENTER,Commercial,0,93960,93960,0,511055,605015
113410401200000,BRANCH BANK/CU,Commercial,0,212544,212544,0,766877,979421
113410401300000,NBHD SHOPPING CENTER,Commercial,0,115776,115776,0,461670,577446
113410500100000,NE 163,Residential,29680,0,29680,150110,0,179790
113410500200000,NE 163,Residential,25864,0,25864,171722,0,197586
113410500300000,NE 163,Residential,25822,0,25822,162603,0,188425
113410500400000,NE 163,Residential,26712,0,26712,156069,0,182781
113410500500000,NE 163,Residential,26712,0,26712,149875,0,176587
113410500600000,NE 163,Residential,31428,0,31428,131335,0,162763
113412600100000,NE 163,Residential,27030,0,27030,151150,0,178180
113412600200000,NE 163,Residential,27030,0,27030,136170,0,163200
113412600300000,NE 163,Residential,27030,0,27030,171525,0,198555
113412600400000,NE 163,Residential,27030,0,27030,143966,0,170996
113412600500000,NE 163,Residential,27030,0,27030,165015,0,192045
113412600600000,NE 163,Residential,27030,0,27030,136366,0,163396
113412600700000,NE 163,Residential,27030,0,27030,151552,0,178582
113412600800000,NE 163,Residential,28560,0,28560,140667,0,169227
113412600900000,NE 163,Residential,30704,0,30704,141276,0,171980
113412601000000,NE 163,Residential,27030,0,27030,138166,0,165196
113412601100000,NE 163,Residential,27030,0,27030,143201,0,170231
113412601200000,NE 163,Residential,27030,0,27030,131315,0,158345
113412601300000,NE 163,Residential,27030,0,27030,142812,0,169842
113412601400000,NE 163,Residential,27030,0,27030,156134,0,183164
113412601500000,NE 163,Residential,27030,0,27030,168514,0,195544
113412601600000,NE 163,Residential,27030,0,27030,171465,0,198495
113412700100000,NE 163,Residential,30600,0,30600,156521,0,187121
113412700200000,NE 163,Residential,28560,0,28560,161035,0,189595
113412700300000,NE 163,Residential,28560,0,28560,167274,0,195834
113412700500000,NE 163,Residential,31981,0,31981,157358,0,189339
113412700600000,NE 163,Residential,24480,0,24480,150370,0,174850
113412700700000,NE 163,Residential,25671,0,25671,162387,0,188058
113412700800000,NE 163,Residential,28549,0,28549,166759,0,195308
113412700900000,NE 163,Residential,31172,0,31172,189402,0,220574
113412701000000,NE 163,Residential,30636,0,30636,164470,0,195106
113412701100000,NE 163,Residential,28973,0,28973,168457,0,197430
113412701200000,NE 163,Residential,28004,0,28004,152460,0,180464
113412701300000,NE 163,Residential,25000,0,25000,145392,0,170392
113412701400000,NE 163,Residential,25000,0,25000,165492,0,190492
113412701500000,NE 163,Residential,25000,0,25000,166677,0,191677
113412701600000,NE 163,Residential,25000,0,25000,160320,0,185320
113412701700000,NE 163,Residential,28000,0,28000,168941,0,196941
113412701800000,NE 163,Residential,30426,0,30426,173029,0,203455
113412701900000,NE 163,Residential,30360,0,30360,178982,0,209342
113412702000000,NE 163,Residential,29921,0,29921,188856,0,218777
113412702100000,NE 163,Exempt,0,27840,27840,0,174981,202821
113412702200000,NE 163,Residential,28080,0,28080,177522,0,205602
113412800200000,NE 163,Residential,29536,0,29536,172957,0,202493
113412800300000,NE 163,Residential,28560,0,28560,181960,0,210520
113412800400000,NE 163,Residential,23582,0,23582,175841,0,199423
113412800500000,NE 163,Residential,26112,0,26112,172547,0,198659
113412800600000,NE 163,Residential,24847,0,24847,162687,0,187534
113412800700000,NE 163,Residential,24480,0,24480,168277,0,192757
113412800800000,NE 163,Residential,25582,0,25582,184098,0,209680
113412800900000,NE 163,Residential,24480,0,24480,148727,0,173207
113412801000000,NE 163,Residential,24847,0,24847,169021,0,193868
113412801100000,NE 163,Residential,24847,0,24847,165291,0,190138
113412801200000,NE 163,Residential,23990,0,23990,166120,0,190110
113412801300000,NE 163,Residential,24480,0,24480,160969,0,185449
113412801400000,NE 163,Residential,24480,0,24480,168300,0,192780
113412801500000,NE 163,Residential,24480,0,24480,172269,0,196749
113412801600000,NE 163,Residential,24480,0,24480,137663,0,162143
113412801700000,NE 163,Residential,26520,0,26520,167790,0,194310
113412801800000,NE 163,Residential,22440,0,22440,135565,0,158005
113412801900000,NE 163,Residential,24480,0,24480,165947,0,190427
113412802000000,NE 163,Residential,24480,0,24480,139402,0,163882
113412802100000,NE 163,Residential,24480,0,24480,156406,0,180886
113412900100000,NE 163,Residential,25822,0,25822,152695,0,178517
113412900200000,NE 163,Residential,25822,0,25822,136788,0,162610
113412900300000,NE 163,Residential,25822,0,25822,150577,0,176399
113412900400000,NE 163,Residential,25822,0,25822,155331,0,181153
113412900500000,NE 163,Residential,25822,0,25822,159446,0,185268
113412900600000,NE 163,Residential,25822,0,25822,169330,0,195152
113412900700000,NE 163,Residential,25822,0,25822,178385,0,204207
113412900800000,NE 163,Residential,25822,0,25822,155833,0,181655
113412900900000,NE 163,Residential,25822,0,25822,140272,0,166094
113412901000000,NE 163,Residential,29680,0,29680,179389,0,209069
113412901100000,NE 163,Residential,31906,0,31906,153094,0,185000
113412901200000,NE 163,Residential,26712,0,26712,152052,0,178764
113412901300000,NE 163,Residential,26712,0,26712,178845,0,205557
113412901400000,NE 163,Residential,26712,0,26712,158318,0,185030
113412901500000,NE 163,Residential,26712,0,26712,157589,0,184301
113412901600000,NE 163,Residential,26712,0,26712,174676,0,201388
113412901700000,NE 163,Residential,26712,0,26712,160495,0,187207
113412901800000,NE 163,Residential,26712,0,26712,156372,0,183084
113412901900000,NE 163,Residential,26712,0,26712,188571,0,215283
113413000100000,NE 163,Residential,25201,0,25201,167325,0,192526
113413000200000,NE 163,Residential,25217,0,25217,185947,0,211164
113413000300000,NE 163,Residential,26337,0,26337,179530,0,205867
113413000400000,NE 163,Residential,26460,0,26460,187020,0,213480
113413000500000,NE 163,Residential,26460,0,26460,162403,0,188863
113413000600000,NE 163,Residential,26460,0,26460,176915,0,203375
113413000700000,NE 163,Residential,26460,0,26460,187510,0,213970
113413000800000,NE 163,Residential,26460,0,26460,170149,0,196609
113413000900000,NE 163,Residential,26460,0,26460,184600,0,211060
113413001000000,NE 163,Residential,31104,0,31104,157566,0,188670
113413001100000,NE 163,Residential,31378,0,31378,230889,0,262267
113413001200000,NE 163,Residential,31408,0,31408,204638,0,236046
113413001300000,NE 163,Residential,31527,0,31527,186670,0,218197
113413001400000,NE 163,Residential,31500,0,31500,166953,0,198453
113413001500000,NE 163,Residential,32340,0,32340,169968,0,202308
113413001600000,NE 163,Residential,32832,0,32832,185859,0,218691
113413001700000,NE 163,Residential,32477,0,32477,168984,0,201461
113413001800000,NE 163,Residential,33101,0,33101,177121,0,210222
113413001900000,NE 163,Residential,28307,0,28307,159317,0,187624
113413002000000,NE 163,Residential,28453,0,28453,161139,0,189592
113413002100000,NE 163,Residential,30932,0,30932,144256,0,175188
113413002200000,CITY PROPERTY,Exempt,0,0,0,0,0,0
113413002300000,NE 163,Residential,33182,0,33182,187174,0,220356
113413002400000,NE 163,Residential,32308,0,32308,164394,0,196702
113413002500000,NE 163,Residential,29963,0,29963,151050,0,181013
113413002600000,NE 163,Residential,24752,0,24752,156023,0,180775
113415100100000,CHURCH,Exempt,0,582552,582552,0,928548,1511100
113415100300000,NE 163,Residential,42050,0,42050,303722,0,345772
113415100400000,NE 163,Residential,40675,0,40675,276528,0,317203
113415100500000,NE 163,Residential,28000,0,28000,308889,0,336889
113415100600000,NE 163,Residential,31600,0,31600,0,0,31600
113415200100000,VACANT LAND,Commercial,0,350676,350676,0,0,350676
113415200200000,ANTENNAS/TOWERS(BLL),Commercial,0,290995,290995,0,395528,686523
113417600500000,SMALL RETAIL,Commercial,0,302400,302400,0,746574,1048974
113417600600000,NBHD SHOPPING CENTER,Commercial,0,104427,104427,0,424194,528621
113417600700000,VACANT LAND,Commercial,0,247536,247536,0,0,247536
113417600800000,BRANCH BANK/CU,Commercial,0,174636,174636,0,1780794,1955430
113417600900000,CARWASH,Commercial,0,27350,27350,0,169197,196547
113417700100000,LG DISCOUNT/RETAIL,Commercial,0,341550,341550,0,652374,993924
113417700300000,CITY PROPERTY,Exempt,0,0,0,0,0,0
113417700400000,CHURCH,Exempt,0,458525,458525,0,487700,946225
113420100800000,NE 159,Residential,26384,0,26384,186512,0,212896
113420100900000,NE 159,Residential,26384,0,26384,170504,0,196888
113420101000000,NE 159,Residential,26384,0,26384,213435,0,239819
113420101100000,NE 159,Residential,26384,0,26384,198333,0,224717
113420101200000,NE 159,Residential,27146,0,27146,227953,0,255099
113420101300000,NE 159,Residential,28660,0,28660,201439,0,230099
113420101400000,NE 159,Residential,30531,0,30531,205175,0,235706
113420101500000,NE 159,Residential,32544,0,32544,195317,0,227861
113420101600000,NE 159,Residential,29627,0,29627,196393,0,226020
113420101700000,NE 159,Residential,31920,0,31920,215833,0,247753
113420101800000,NE 159,Residential,28000,0,28000,217165,0,245165
113420101900000,NE 159,Residential,30000,0,30000,217173,0,247173
113420102000000,NE 159,Residential,31387,0,31387,174298,0,205685
113420102100000,NE 159,Residential,33277,0,33277,191123,0,224400
113420102200000,NE 159,Residential,32301,0,32301,165423,0,197724
113420102300000,NE 159,Residential,32556,0,32556,199995,0,232551
113420102400000,NE 159,Residential,31062,0,31062,207043,0,238105
113420102500000,NE 159,Residential,31108,0,31108,175941,0,207049
113420102600000,NE 159,Residential,27624,0,27624,178553,0,206177
113420102700000,NE 159,Residential,28560,0,28560,193091,0,221651
113420102800000,NE 159,Residential,32781,0,32781,176415,0,209196
113420102900000,NE 159,Residential,32769,0,32769,181551,0,214320
113420103000000,NE 159,Residential,33850,0,33850,200209,0,234059
113420103100000,NE 159,Residential,32436,0,32436,222516,0,254952
113420103200000,NE 159,Residential,33266,0,33266,203708,0,236974
113420103300000,NE 159,Residential,31956,0,31956,250832,0,282788
113420103400000,NE 159,Residential,28280,0,28280,182280,0,210560
113420103500000,NE 159,Residential,28280,0,28280,201208,0,229488
113420103600000,NE 159,Residential,28280,0,28280,177875,0,206155
113420103700000,NE 159,Residential,32549,0,32549,177775,0,210324
113420200200000,NE 159,Residential,34560,0,34560,203303,0,237863
113420200300000,NE 159,Residential,33589,0,33589,200221,0,233810
113420200400000,NE 159,Residential,32400,0,32400,159423,0,191823
113420200500000,NE 159,Residential,34043,0,34043,194769,0,228812
113420200600000,NE 159,Residential,37394,0,37394,184780,0,222174
113420200700000,NE 159,Residential,37645,0,37645,186918,0,224563
113420200800000,NE 159,Residential,34191,0,34191,196644,0,230835
113420200900000,NE 159,Residential,31040,0,31040,196798,0,227838
113420201000000,NE 159,Residential,29255,0,29255,174404,0,203659
113420201100000,NE 159,Residential,31601,0,31601,198435,0,230036
113420201200000,NE 159,Residential,31279,0,31279,210322,0,241601
113420201300000,NE 159,Residential,32172,0,32172,223126,0,255298
113420201400000,NE 159,Residential,29044,0,29044,188745,0,217789
113420201500000,NE 159,Residential,32187,0,32187,189094,0,221281
113420201600000,NE 159,Residential,28000,0,28000,176479,0,204479
113420300100000,NE 159,Residential,27936,0,27936,170007,0,197943
113420300200000,NE 159,Residential,27936,0,27936,171486,0,199422
113420300300000,NE 159,Residential,29100,0,29100,149003,0,178103
113420300400000,NE 159,Residential,35578,0,35578,169718,0,205296
113420300500000,NE 159,Residential,33799,0,33799,249505,0,283304
113420300600000,NE 159,Residential,34885,0,34885,208481,0,243366
113420300700000,NE 159,Residential,34064,0,34064,183796,0,217860
113420400100000,NE 159,Residential,34992,0,34992,198439,0,233431
113420400200000,NE 159,Residential,32560,0,32560,184736,0,217296
113420400300000,NE 159,Residential,31803,0,31803,177446,0,209249
113420400400000,NE 159,Residential,30384,0,30384,211592,0,241976
113420400500000,NE 159,Residential,33589,0,33589,190197,0,223786
113420400600000,NE 159,Residential,29476,0,29476,215078,0,244554
113420400700000,NE 159,Residential,29120,0,29120,197420,0,226540
113420400800000,NE 159,Residential,33688,0,33688,170946,0,204634
113420400900000,NE 159,Residential,33283,0,33283,192135,0,225418
113420500100000,NE 159,Residential,34706,0,34706,184175,0,218881
113420500200000,NE 159,Residential,46353,0,46353,204779,0,251132
113420500300000,NE 159,Residential,34454,0,34454,182752,0,217206
113420500400000,NE 159,Residential,36968,0,36968,238032,0,275000
113420500500000,NE 159,Residential,37901,0,37901,210663,0,248564
113420500600000,NE 159,Residential,33451,0,33451,201852,0,235303
113420500700000,NE 159,Residential,30720,0,30720,230122,0,260842
113420500800000,NE 159,Residential,31799,0,31799,187286,0,219085
113420500900000,NE 159,Residential,36557,0,36557,270545,0,307102
113420501000000,NE 159,Residential,33878,0,33878,226711,0,260589
113420501100000,NE 159,Residential,34344,0,34344,242433,0,276777
113420501200000,NE 159,Residential,37255,0,37255,253137,0,290392
113422600100000,NE 159,Residential,32866,0,32866,189297,0,222163
113422600200000,NE 159,Residential,29767,0,29767,194249,0,224016
113422600300000,NE 159,Residential,26000,0,26000,192700,0,218700
113422600400000,NE 159,Residential,24400,0,24400,172761,0,197161
113422600500000,NE 159,Residential,27600,0,27600,209139,0,236739
113422600600000,NE 159,Residential,27467,0,27467,174065,0,201532
113422600700000,NE 159,Residential,30736,0,30736,166865,0,197601
113422600800000,NE 159,Residential,29784,0,29784,167166,0,196950
113422600900000,NE 159,Residential,28661,0,28661,165057,0,193718
113422601000000,NE 159,Residential,28280,0,28280,176884,0,205164
113422601100000,NE 159,Residential,32070,0,32070,219066,0,251136
113422601200000,NE 159,Residential,31360,0,31360,164254,0,195614
113422601300000,NE 159,Residential,32905,0,32905,207095,0,240000
113422601400000,NE 159,Residential,31328,0,31328,185886,0,217214
113422601500000,NE 159,Residential,30720,0,30720,202539,0,233259
113422601600000,NE 159,Residential,28616,0,28616,171036,0,199652
113422601700000,NE 159,Residential,27160,0,27160,169389,0,196549
113422601800000,NE 159,Residential,32635,0,32635,177641,0,210276
113422601900000,NE 159,Residential,32849,0,32849,196433,0,229282
113422602000000,NE 159,Residential,27160,0,27160,213189,0,240349
113422602100000,NE 159,Residential,27160,0,27160,184093,0,211253
113422700100000,NE 159,Residential,32823,0,32823,185198,0,218021
113422700200000,NE 159,Residential,31312,0,31312,186834,0,218146
113422700300000,NE 159,Residential,27160,0,27160,177496,0,204656
113422700400000,NE 159,Residential,27160,0,27160,180317,0,207477
113422700500000,NE 159,Residential,27160,0,27160,189899,0,217059
113422700600000,NE 159,Residential,31393,0,31393,175407,0,206800
113422700700000,NE 159,Residential,31596,0,31596,173716,0,205312
113422700800000,NE 159,Residential,27160,0,27160,179516,0,206676
113422700900000,NE 159,Residential,27160,0,27160,174194,0,201354
113422701000000,NE 159,Residential,27160,0,27160,171567,0,198727
113422701100000,NE 159,Residential,27160,0,27160,200228,0,227388
113422701200000,NE 159,Residential,29488,0,29488,181741,0,211229
113422701300000,NE 159,Residential,30653,0,30653,187047,0,217700
113422701400000,NE 159,Residential,29780,0,29780,172492,0,202272
113422800100000,NE 162,Residential,41350,0,41350,143810,0,185160
113422800200000,NE 159,Residential,36000,0,36000,97671,0,133671
113422800300000,NE 159,Residential,34800,0,34800,0,0,34800
113422800400000,NE 159,Residential,30000,0,30000,168522,0,198522
113422800500000,NE 159,Residential,30000,0,30000,165126,0,195126
113422800600000,NE 101,Residential,25200,0,25200,156126,0,181326
113422800700000,NE 101,Residential,29736,0,29736,173811,0,203547
113422800800000,NE 159,Residential,31416,0,31416,152035,0,183451
113422800900000,NE 159,Residential,31416,0,31416,166294,0,197710
113422801000000,NE 159,Residential,31416,0,31416,157521,0,188937
113422801100000,NE 159,Residential,31108,0,31108,152210,0,183318
113422801200000,NE 159,Residential,31108,0,31108,151171,0,182279
113422801300000,NE 159,Residential,31108,0,31108,145221,0,176329
113422801400000,NE 159,Residential,32623,0,32623,168679,0,201302
113422801500000,NE 159,Residential,31512,0,31512,188565,0,220077
113422801600000,NE 159,Residential,31512,0,31512,158255,0,189767
113422801700000,NE 159,Residential,31512,0,31512,158750,0,190262
113422801800000,NE 159,Residential,31512,0,31512,178823,0,210335
113422801900000,NE 159,Residential,31200,0,31200,180943,0,212143
113422802000000,NE 159,Residential,31200,0,31200,166087,0,197287
113422802100000,NE 159,Residential,31200,0,31200,180105,0,211305
113422802200000,NE 159,Residential,31200,0,31200,176912,0,208112
113422802300000,NE 159,Residential,32492,0,32492,133181,0,165673
113422900100000,NE 159,Residential,33712,0,33712,166164,0,199876
113422900200000,NE 159,Residential,32485,0,32485,174745,0,207230
113422900300000,NE 159,Residential,32190,0,32190,180762,0,212952
113422900400000,NE 159,Residential,32362,0,32362,161515,0,193877
113422900500000,NE 159,Residential,33863,0,33863,206494,0,240357
113422900600000,NE 159,Residential,32660,0,32660,169953,0,202613
113422900700000,NE 159,Residential,31808,0,31808,173246,0,205054
113422900800000,NE 159,Residential,33320,0,33320,165416,0,198736
113422900900000,NE 159,Residential,30133,0,30133,163968,0,194101
113422901000000,NE 159,Residential,31311,0,31311,170342,0,201653
113422901100000,NE 159,Residential,32365,0,32365,146808,0,179173
113422901200000,NE 159,Residential,30450,0,30450,162954,0,193404
113422901300000,NE 159,Residential,29120,0,29120,142499,0,171619
113422901400000,NE 159,Residential,29120,0,29120,166713,0,195833
113422901500000,NE 159,Residential,29120,0,29120,146672,0,175792
113422901600000,NE 159,Residential,29120,0,29120,164015,0,193135
113422901700000,NE 159,Residential,28574,0,28574,150132,0,178706
113422901800000,NE 159,Residential,32893,0,32893,176444,0,209337
113422901900000,NE 159,Residential,28549,0,28549,158749,0,187298
113422902000000,NE 159,Residential,32472,0,32472,180148,0,212620
113422902100000,NE 159,Residential,30456,0,30456,162888,0,193344
113422902200000,NE 159,Residential,28800,0,28800,176129,0,204929
113422902300000,NE 159,Residential,26000,0,26000,156416,0,182416
113422902400000,NE 159,Residential,26000,0,26000,167137,0,193137
113423000100000,NE 159,Residential,32171,0,32171,169071,0,201242
113423000200000,NE 159,Residential,32473,0,32473,152233,0,184706
113423000300000,NE 159,Residential,33048,0,33048,169956,0,203004
113423000400000,NE 159,Residential,33928,0,33928,171094,0,205022
113423000500000,NE 159,Residential,34508,0,34508,179636,0,214144
113423000600000,NE 159,Residential,31920,0,31920,184024,0,215944
113423100100000,NE 159,Residential,31280,0,31280,198697,0,229977
113423100200000,NE 159,Residential,28980,0,28980,164383,0,193363
113423100300000,NE 159,Residential,30940,0,30940,161413,0,192353
113423100400000,NE 159,Residential,29744,0,29744,180436,0,210180
113423100500000,NE 159,Residential,26000,0,26000,155187,0,181187
113423100600000,NE 159,Residential,26000,0,26000,163366,0,189366
113423100700000,NE 159,Residential,26000,0,26000,164774,0,190774
113423100800000,NE 159,Residential,26000,0,26000,190202,0,216202
113423100900000,NE 159,Residential,26000,0,26000,143570,0,169570
113423101000000,NE 159,Residential,32535,0,32535,173407,0,205942
113423101100000,NE 159,Residential,30873,0,30873,159714,0,190587
113423101200000,NE 159,Residential,30520,0,30520,175566,0,206086
113423200100000,NE 159,Residential,33002,0,33002,243563,0,276565
113423200200000,NE 159,Residential,32438,0,32438,149767,0,182205
113423200300000,NE 159,Residential,27160,0,27160,160152,0,187312
113423200400000,NE 159,Residential,33326,0,33326,170671,0,203997
113423200500000,NE 159,Residential,32736,0,32736,169974,0,202710
113423200600000,NE 159,Residential,32742,0,32742,190572,0,223314
113423200700000,NE 159,Residential,32695,0,32695,216509,0,249204
113423200800000,NE 159,Residential,26384,0,26384,176026,0,202410
113423200900000,NE 159,Residential,296,0,296,0,0,296
113423300200000,NE 159,Residential,29999,0,29999,185975,0,215974
113425100100000,CITY PROPERTY,Exempt,0,0,0,0,0,0
113425200100000,NE 159,Residential,29328,0,29328,148160,0,177488
113425200200000,NE 159,Residential,35752,0,35752,170208,0,205960
113425200300000,NE 159,Residential,34200,0,34200,146178,0,180378
113425300100000,NE 159,Residential,31500,0,31500,153931,0,185431
113425300200000,NE 159,Residential,30000,0,30000,159816,0,189816
113425400100000,NE 159,Residential,31416,0,31416,175290,0,206706
113425400200000,NE 101,Residential,30400,0,30400,174314,0,204714
113425400300000,CITY PROPERTY,Exempt,0,0,0,0,0,0
113425400400000,NE 159,Residential,32724,0,32724,168343,0,201067
113425400500000,NE 159,Residential,31416,0,31416,170746,0,202162
113425400600000,NE 159,Residential,31416,0,31416,164131,0,195547
113425500100000,NE 159,Residential,32000,0,32000,167731,0,199731
113425500200000,NE 159,Residential,28000,0,28000,148400,0,176400
113425500300000,NE 159,Residential,28000,0,28000,155356,0,183356
113425500400000,NE 159,Residential,28000,0,28000,177833,0,205833
113425500500000,NE 159,Residential,28000,0,28000,154558,0,182558
113425500600000,NE 159,Residential,28000,0,28000,161979,0,189979
113425500700000,NE 159,Residential,28000,0,28000,158397,0,186397
113425500800000,NE 159,Residential,28000,0,28000,155073,0,183073
113425500900000,NE 159,Residential,32000,0,32000,177943,0,209943
113425600200000,DAY CARE CENTER,Commercial,0,81216,81216,0,114422,195638
113425700101000,DAY CARE CENTER,Commercial,0,107250,107250,0,300331,407581
113425700101001,OFFICE,Commercial,0,107250,107250,0,305488,412738
113425700200000,VACANT LAND,Commercial,0,211950,211950,0,0,211950
113425700300000,VACANT LAND,Commercial,0,249750,249750,0,0,249750
113425800100000,CITY PROPERTY,Exempt,0,0,0,0,0,0
113425900100000,CITY PROPERTY,Exempt,0,0,0,0,0,0
113427600200000,NE 159,Residential,129200,0,129200,0,0,129200
113427700300000,NE 159,Residential,20,0,20,0,0,20
113427800200000,NE 159,Residential,34200,0,34200,93697,0,127897
113427800300000,NE 159,Residential,34200,0,34200,81745,0,115945
113427800400000,NE 159,Residential,29963,0,29963,150952,0,180915
113427800500000,NE 159,Residential,27044,0,27044,149063,0,176107
113427800600000,NE 159,Residential,27040,0,27040,185449,0,212489
113427800700000,NE 159,Residential,27040,0,27040,198839,0,225879
113427800800000,NE 159,Residential,26484,0,26484,178116,0,204600
113427800900000,NE 159,Residential,27004,0,27004,169643,0,196647
113427801000000,NE 159,Residential,28000,0,28000,183489,0,211489
113427801100000,NE 159,Residential,27972,0,27972,138253,0,166225
113427801200000,NE 159,Residential,27960,0,27960,153559,0,181519
113427801300000,NE 159,Residential,27937,0,27937,132428,0,160365
113427801400000,NE 159,Residential,29653,0,29653,164106,0,193759
113427801500000,NE 159,Residential,33914,0,33914,243987,0,277901
113427801600000,NE 159,Residential,28859,0,28859,147857,0,176716
113427801700000,NE 159,Residential,27958,0,27958,190901,0,218859
113427801800000,NE 159,Residential,27300,0,27300,168381,0,195681
113427801900000,NE 159,Residential,25740,0,25740,145692,0,171432
113427802000000,NE 159,Residential,29104,0,29104,167873,0,196977
113427802100000,NE 159,Residential,32429,0,32429,152665,0,185094
113427802200000,NE 159,Residential,33223,0,33223,165372,0,198595
113427802300000,NE 159,Residential,32308,0,32308,148867,0,181175
113427802400000,NE 159,Residential,29680,0,29680,182876,0,212556
113427802500000,NE 159,Residential,32000,0,32000,165116,0,197116
113427802600000,NE 159,Residential,26000,0,26000,160812,0,186812
113427802700000,NE 159,Residential,27820,0,27820,135829,0,163649
113427802800000,NE 159,Residential,27820,0,27820,170972,0,198792
113427802900000,NE 159,Residential,27820,0,27820,192143,0,219963
113427803000000,NE 159,Residential,27420,0,27420,163957,0,191377
113427803100000,NE 159,Residential,26520,0,26520,148902,0,175422
113427803200000,NE 159,Residential,26520,0,26520,138905,0,165425
113427803300000,NE 159,Residential,26520,0,26520,164416,0,190936
113427803400000,NE 159,Residential,26520,0,26520,159905,0,186425
113427803500000,NE 159,Residential,112800,0,112800,0,0,112800
113427900100000,NE 159,Residential,40068,0,40068,136692,0,176760
113427900200000,NE 159,Residential,32528,0,32528,187713,0,220241
113427900300000,NE 159,Residential,32528,0,32528,178116,0,210644
113427900400000,NE 159,Residential,32224,0,32224,194166,0,226390
113427900500000,NE 159,Residential,37122,0,37122,211181,0,248303
113427900600000,NE 159,Residential,36520,0,36520,207191,0,243711
113427900700000,NE 159,Residential,39936,0,39936,193058,0,232994
113427900800000,NE 159,Residential,40147,0,40147,184745,0,224892
113427900900000,NE 159,Residential,40768,0,40768,230030,0,270798
113427901000000,NE 159,Residential,38608,0,38608,219661,0,258269
113427901100000,NE 159,Residential,38196,0,38196,248398,0,286594
113427901200000,NE 159,Residential,38991,0,38991,239272,0,278263
113427901300000,NE 159,Residential,40012,0,40012,214457,0,254469
113427901400000,NE 159,Residential,38236,0,38236,233325,0,271561
113427901500000,NE 159,Residential,38236,0,38236,227554,0,265790
113427901600000,NE 159,Residential,38236,0,38236,192250,0,230486
113427901700000,NE 159,Residential,38236,0,38236,226612,0,264848
113427901800000,NE 159,Residential,38236,0,38236,232843,0,271079
113427901900000,NE 159,Residential,38236,0,38236,262625,0,300861
113427902000000,NE 159,Residential,38236,0,38236,231467,0,269703
113427902100000,NE 159,Residential,38236,0,38236,251276,0,289512
113427902200000,NE 159,Residential,39019,0,39019,212874,0,251893
113428000100000,NE 159,Residential,31712,0,31712,210616,0,242328
113428000200000,NE 159,Residential,26000,0,26000,195179,0,221179
113428000300000,NE 159,Residential,26000,0,26000,169614,0,195614
113428000400000,NE 159,Residential,26000,0,26000,176766,0,202766
113428000500000,NE 159,Residential,26000,0,26000,158986,0,184986
113428000600000,NE 159,Residential,26000,0,26000,140356,0,166356
113428000700000,NE 159,Residential,26000,0,26000,167673,0,193673
113428000800000,NE 159,Residential,26000,0,26000,162243,0,188243
113428000900000,NE 159,Residential,26000,0,26000,138244,0,164244
113428001000000,NE 159,Residential,26055,0,26055,151560,0,177615
113428001100000,NE 159,Residential,26323,0,26323,163887,0,190210
113428001200000,NE 159,Residential,25930,0,25930,187281,0,213211
113428001300000,NE 159,Residential,25740,0,25740,195192,0,220932
113428001400000,NE 159,Residential,26000,0,26000,186463,0,212463
113428001500000,NE 159,Residential,26000,0,26000,180901,0,206901
113428001600000,NE 159,Residential,26000,0,26000,169266,0,195266
113428001700000,NE 159,Residential,26000,0,26000,154244,0,180244
113428001800000,NE 159,Residential,26000,0,26000,151973,0,177973
113428001900000,NE 159,Residential,26000,0,26000,196338,0,222338
113428002000000,NE 159,Residential,26000,0,26000,226482,0,252482
113428002100000,NE 159,Residential,26000,0,26000,164002,0,190002
113428002200000,NE 159,Residential,31712,0,31712,198461,0,230173
113430100100000,WAREHOUSE,Commercial,0,225504,225504,0,157655,383159
113430100200000,OFFICE,Exempt,0,382590,382590,0,2445452,2828042
113430100300000,VACANT LAND,Commercial,0,1296,1296,0,0,1296
113430200100000,VACANT LAND,Commercial,0,448362,448362,0,0,448362
113430200200000,SR/NURSING/ASSTD LIV,Commercial,0,167940,167940,0,4814056,4981996
113432700200000,NE 101,Residential,92700,0,92700,0,0,92700
113432700300000,NE 108,Residential,27846,0,27846,79797,0,107643
113432800100000,VACANT LAND,Commercial,0,38394,38394,0,0,38394
113432800200000,NE 101,Residential,51050,0,51050,0,0,51050
113432800300000,SR/NURSING/ASSTD LIV,Commercial,0,378540,378540,0,2481537,2860077
113432900200000,OFFICE,Commercial,0,365580,365580,0,1869955,2235535
113432900300000,GOLF COURSE,Commercial,0,65610,65610,0,59972,125582
113435100100000,OFFICE,Commercial,0,369630,369630,0,1146417,1516047
113435100200000,OFFICE,Commercial,0,282312,282312,0,1182849,1465161
113435100300000,GOLF COURSE,Commercial,0,54918,54918,0,56536,111454
113435100400000,FEDERAL PROPERTY,Exempt,0,0,0,0,0,0
113435100500000,SHOP,Commercial,0,277776,277776,0,658245,936021
113435100600000,MATERIALS MFG;INDUST,Industrial,0,398952,398952,0,2495611,2894563
113435100700000,MATERIALS MFG;INDUST,Industrial,0,288792,288792,0,1363488,1652280
113435100900000,SHOP,Commercial,0,106245,106245,0,289615,395860
113435200100000,OFFICE,Commercial,0,228150,228150,0,562728,790878
113435200200000,OFFICE,Commercial,0,441936,441936,0,2958950,3400886
113435200300000,OFFICE,Commercial,0,121905,121905,0,451032,572937
113437600100000,OFFICE,Commercial,0,139050,139050,0,767372,906422
113437600300000,OFFICE,Commercial,0,182250,182250,0,561746,743996
113437600400000,OFFICE,Commercial,0,141750,141750,0,742253,884003
113437600600000,HIGH TECH/RESEARCH,Industrial,0,462213,462213,0,4922049,5384262
113437700100000,OFFICE,Commercial,0,117180,117180,0,373664,490844
113437700200000,OFFICE,Commercial,0,123660,123660,0,337495,461155
113437700300000,FLAT PARKING,Commercial,0,187650,187650,0,0,187650
113437700400000,VACANT LAND,Commercial,0,252450,252450,0,0,252450
113437800300000,NE 101,Residential,3700,0,3700,0,0,3700
113437900100000,VACANT LAND,Commercial,0,5789,5789,0,0,5789
113437900200000,CENTRALLY ASSESSED,Other,0,0,0,0,0,0
113437900300000,VACANT LAND,Commercial,0,373842,373842,0,0,373842
113440100100000,NE 110,Exempt,0,44895,44895,0,187906,232801
113440100300000,NE 110,Residential,36360,0,36360,153851,0,190211
113440100400000,NE 110,Residential,36360,0,36360,177056,0,213416
113440100500000,NE 110,Residential,36360,0,36360,177727,0,214087
113440100600000,NE 110,Residential,37774,0,37774,126167,0,163941
113440200100000,NE 110,Residential,16014,0,16014,101263,0,117277
113440200200000,NE 110,Residential,15908,0,15908,110717,0,126625
113440200300000,NE 110,Residential,15908,0,15908,117875,0,133783
113440200400000,NE 110,Residential,15908,0,15908,117388,0,133296
113440200500000,NE 110,Residential,15908,0,15908,117832,0,133740
113440200600000,NE 110,Residential,15908,0,15908,114061,0,129969
113440200700000,NE 110,Residential,15908,0,15908,103654,0,119562
113440200800000,NE 110,Residential,15908,0,15908,103706,0,119614
113440200900000,NE 110,Residential,15908,0,15908,111207,0,127115
113440201000000,NE 110,Residential,15908,0,15908,112878,0,128786
113440300100000,CITY PROPERTY,Exempt,0,0,0,0,0,0
113440300200000,APARTMENT,Commercial,0,365040,365040,0,3628097,3993137
113440300301000,OFFICE; MEDICAL,Commercial,0,102580,102580,0,410057,512637
113440300301001,OFFICE; MEDICAL,Commercial,0,65036,65036,0,258582,323618
113440400100000,NE 110,Residential,19980,0,19980,122442,0,142422
113440400200000,NE 110,Residential,15750,0,15750,116952,0,132702
113440400300000,NE 110,Residential,15750,0,15750,106619,0,122369
113440400400000,NE 110,Residential,15750,0,15750,106619,0,122369
113440400500000,NE 110,Residential,15750,0,15750,97345,0,113095
113440400600000,NE 110,Residential,15750,0,15750,111530,0,127280
113440400700000,NE 110,Residential,15750,0,15750,120992,0,136742
113440400800000,NE 110,Residential,15750,0,15750,122865,0,138615
113440400900000,NE 110,Residential,15750,0,15750,109437,0,125187
113440401000000,NE 110,Residential,15750,0,15750,119719,0,135469
113440401100000,APARTMENT,Commercial,0,402840,402840,0,1652939,2055779
113440401200000,APARTMENT,Commercial,0,421740,421740,0,1176125,1597865
113442600100000,APARTMENT,Commercial,0,864000,864000,0,7336000,8200000
113445100100000,NE 110,Residential,20358,0,20358,96782,0,117140
113445100200000,NE 110,Residential,20370,0,20370,137969,0,158339
113445100300000,NE 110,Residential,20370,0,20370,113065,0,133435
113445100400000,NE 110,Residential,20370,0,20370,129609,0,149979
113445100500000,NE 110,Residential,20370,0,20370,145564,0,165934
113445100600000,NE 110,Residential,20370,0,20370,133299,0,153669
113445100700000,NE 110,Residential,20370,0,20370,131265,0,151635
113445100800000,NE 110,Residential,20370,0,20370,122818,0,143188
113445100900000,NE 110,Residential,20370,0,20370,113140,0,133510
113445101000000,NE 110,Residential,20370,0,20370,138998,0,159368
113445101100000,NE 110,Residential,20790,0,20790,149752,0,170542
113445101200000,NE 110,Residential,21420,0,21420,175134,0,196554
113445101300000,NE 110,Residential,20318,0,20318,113841,0,134159
113445101400000,NE 110,Residential,24236,0,24236,111527,0,135763
113445101500000,NE 110,Residential,24240,0,24240,131954,0,156194
113445101600000,NE 110,Residential,25785,0,25785,131948,0,157733
113445200100000,NE 110,Residential,20532,0,20532,118876,0,139408
113445200200000,NE 110,Residential,19200,0,19200,114574,0,133774
113445200300000,NE 110,Residential,19200,0,19200,88090,0,107290
113445200400000,NE 110,Residential,19200,0,19200,98274,0,117474
113445200500000,NE 110,Residential,19200,0,19200,108214,0,127414
113445200600000,NE 110,Residential,19200,0,19200,122281,0,141481
113445200700000,NE 110,Residential,19200,0,19200,87945,0,107145
113445200800000,NE 110,Residential,19200,0,19200,100336,0,119536
113445200900000,NE 110,Residential,19206,0,19206,125636,0,144842
113445201000000,NE 110,Residential,36600,0,36600,152796,0,189396
113445300100000,NE 110,Residential,21823,0,21823,135245,0,157068
113445300200000,NE 110,Residential,21750,0,21750,139261,0,161011
113445300300000,NE 110,Residential,21750,0,21750,98492,0,120242
113445300400000,NE 110,Residential,21750,0,21750,90150,0,111900
113445300500000,NE 110,Residential,21750,0,21750,146823,0,168573
113445300600000,NE 110,Residential,21750,0,21750,129575,0,151325
113445300700000,NE 110,Residential,21750,0,21750,104497,0,126247
113445300800000,NE 110,Residential,21835,0,21835,147770,0,169605
113445300900000,NE 110,Residential,21805,0,21805,145747,0,167552
113445301000000,NE 110,Residential,21750,0,21750,137435,0,159185
113445301100000,NE 110,Residential,21750,0,21750,124097,0,145847
113445301200000,NE 110,Residential,21750,0,21750,137283,0,159033
113445301300000,NE 110,Residential,21750,0,21750,139029,0,160779
113445301400000,NE 110,Residential,21750,0,21750,139252,0,161002
113445301500000,NE 110,Residential,21750,0,21750,112131,0,133881
113445301600000,NE 110,Residential,21900,0,21900,136499,0,158399
113445301800000,SR/NURSING/ASSTD LIV,Commercial,0,270346,270346,0,6961587,7231933
113445301900000,NE 110,Residential,22320,0,22320,204828,0,227148
113445302000000,NE 110,Residential,23760,0,23760,164785,0,188545
113445302100000,NE 110,Residential,23760,0,23760,170911,0,194671
113445302200000,NE 110,Residential,23760,0,23760,176024,0,199784
113445302300000,NE 110,Residential,24934,0,24934,174925,0,199859
113445302400000,NE 110,Residential,28044,0,28044,204627,0,232671
113445400100000,NE 110,Residential,22418,0,22418,134181,0,156599
113445400200000,NE 110,Residential,21750,0,21750,126684,0,148434
113445400300000,NE 110,Residential,21750,0,21750,112046,0,133796
113445400400000,NE 110,Residential,21750,0,21750,110650,0,132400
113445400500000,NE 110,Residential,21750,0,21750,108291,0,130041
113445400600000,NE 110,Residential,21750,0,21750,84528,0,106278
113445400700000,NE 110,Residential,21750,0,21750,124743,0,146493
113445400800000,NE 110,Residential,21779,0,21779,130836,0,152615
113445401000000,NE 110,Residential,21966,0,21966,93333,0,115299
113445401100000,NE 110,Residential,21210,0,21210,106826,0,128036
113445401200000,NE 110,Residential,21210,0,21210,104969,0,126179
113445401300000,NE 110,Residential,21210,0,21210,96567,0,117777
113445401400000,NE 110,Residential,21210,0,21210,147669,0,168879
113445401500000,NE 110,Residential,21210,0,21210,114677,0,135887
113445401600000,NE 110,Residential,21210,0,21210,123792,0,145002
113445401700000,NE 110,Residential,24795,0,24795,109486,0,134281
113445500100000,NE 110,Residential,23562,0,23562,123199,0,146761
113445500200000,NE 110,Residential,20502,0,20502,114685,0,135187
113445500300000,NE 110,Residential,20502,0,20502,122401,0,142903
113445500400000,NE 110,Residential,20502,0,20502,112034,0,132536
113445500500000,NE 110,Residential,20502,0,20502,78759,0,99261
113445500600000,NE 110,Residential,20502,0,20502,112036,0,132538
113445500700000,NE 110,Residential,20502,0,20502,105655,0,126157
113445500800000,NE 110,Residential,20518,0,20518,130244,0,150762
113445500900000,NE 110,Residential,21624,0,21624,99138,0,120762
113445501000000,NE 110,Residential,21624,0,21624,84453,0,106077
113445501100000,NE 110,Residential,21624,0,21624,69919,0,91543
113445501200000,NE 110,Residential,21624,0,21624,82718,0,104342
113445501300000,NE 110,Residential,21624,0,21624,112668,0,134292
113445501400000,NE 110,Residential,17479,0,17479,239766,0,257245
113445501500000,NE 110,Residential,23943,0,23943,226684,0,250627
113445501700000,OFFICE; MEDICAL,Commercial,0,300002,300002,0,1996879,2296881
113445501900000,FLAT PARKING,Commercial,0,81000,81000,0,64386,145386
113445502000000,VACANT LAND,Commercial,0,336096,336096,0,0,336096
113445600100000,NE 110,Residential,25680,0,25680,94705,0,120385
113445700100000,NE 110,Residential,21624,0,21624,121975,0,143599
113445700200000,NE 110,Residential,21624,0,21624,87349,0,108973
113445700300000,NE 110,Residential,21624,0,21624,87146,0,108770
113445700400000,NE 110,Residential,21624,0,21624,99960,0,121584
113445700500000,NE 110,Residential,21624,0,21624,78601,0,100225
113445700700000,NE 110,Residential,34339,0,34339,196488,0,230827
113445700800000,NE 110,Exempt,0,44215,44215,0,166919,211134
113445800100000,NE 110,Residential,40525,0,40525,49523,0,90048
113447600100000,CITY PROPERTY,Exempt,0,0,0,0,0,0
113447600400000,NE 110,Residential,23400,0,23400,153892,0,177292
113447600500000,NE 110,Residential,22050,0,22050,153532,0,175582
113447600600000,NE 110,Residential,24570,0,24570,144717,0,169287
113447600700000,NE 110,Residential,23280,0,23280,157094,0,180374
113447600800000,NE 110,Residential,23280,0,23280,139941,0,163221
113447600900000,NE 110,Residential,23280,0,23280,119719,0,142999
113447601000000,CITY PROPERTY,Exempt,0,0,0,0,0,0
113447601100000,NE 110,Residential,23280,0,23280,128293,0,151573
113447601200000,NE 110,Residential,23280,0,23280,145002,0,168282
113447601300000,NE 110,Residential,23280,0,23280,159281,0,182561
113447601400000,NE 110,Residential,23280,0,23280,157977,0,181257
113447601500000,NE 110,Residential,23280,0,23280,133696,0,156976
113447601600000,NE 110,Residential,23280,0,23280,149035,0,172315
113447601700000,NE 110,Residential,26308,0,26308,181218,0,207526
113447601900000,CITY PROPERTY,Exempt,0,0,0,0,0,0
113447602000000,NE 110,Residential,29995,0,29995,137420,0,167415
113447602100000,NE 110,Residential,25543,0,25543,162007,0,187550
113447602200000,NE 110,Residential,22407,0,22407,167017,0,189424
113447602300000,NE 110,Residential,26279,0,26279,140675,0,166954
113447602400000,NE 110,Residential,27535,0,27535,222251,0,249786
113447602500000,NE 110,Residential,24444,0,24444,112889,0,137333
113447602600000,NE 110,Residential,24444,0,24444,139055,0,163499
113447602700000,NE 110,Residential,24444,0,24444,150650,0,175094
113447602800000,NE 110,Residential,24444,0,24444,151453,0,175897
113447602900000,NE 110,Residential,24444,0,24444,171763,0,196207
113447603000000,NE 110,Residential,24668,0,24668,164008,0,188676
113447603100000,NE 110,Residential,22407,0,22407,129369,0,151776
113447603200000,NE 110,Residential,22344,0,22344,136098,0,158442
113447700100000,NE 110,Residential,25180,0,25180,157387,0,182567
113447700200000,NE 110,Residential,22135,0,22135,139954,0,162089
113447700300000,NE 110,Residential,25235,0,25235,168489,0,193724
113447700400000,NE 110,Residential,25645,0,25645,140231,0,165876
113447700500000,NE 110,Residential,25584,0,25584,146387,0,171971
113447700600000,NE 110,Residential,23456,0,23456,160666,0,184122
113447700700000,NE 110,Residential,23280,0,23280,181056,0,204336
113447700800000,NE 110,Residential,23280,0,23280,128130,0,151410
113447700900000,NE 110,Residential,23280,0,23280,141502,0,164782
113447701000000,NE 110,Residential,23280,0,23280,153669,0,176949
113447701100000,NE 110,Residential,23280,0,23280,153519,0,176799
113447701200000,NE 110,Residential,23280,0,23280,126220,0,149500
113447701300000,NE 110,Residential,23054,0,23054,142546,0,165600
113447701400000,NE 110,Residential,23280,0,23280,140947,0,164227
113447701500000,NE 110,Residential,23280,0,23280,132138,0,155418
113447701600000,NE 110,Residential,24925,0,24925,166693,0,191618
113447701700000,NE 110,Residential,23026,0,23026,141732,0,164758
113447701800000,NE 110,Residential,22050,0,22050,106003,0,128053
113447701900000,NE 110,Residential,22680,0,22680,121318,0,143998
113447702000000,NE 110,Residential,22365,0,22365,88871,0,111236
113447702100000,NE 110,Residential,22365,0,22365,106196,0,128561
113447702200000,NE 110,Residential,22365,0,22365,132145,0,154510
113447702300000,NE 110,Residential,22365,0,22365,0,0,22365
113447702400000,NE 110,Residential,22680,0,22680,98531,0,121211
113447702500000,NE 110,Residential,22050,0,22050,143868,0,165918
113447702600000,NE 110,Residential,22578,0,22578,139798,0,162376
113447702700000,NE 110,Residential,23004,0,23004,123834,0,146838
113447702800000,NE 110,Residential,23430,0,23430,127677,0,151107
113447702900000,NE 110,Residential,22650,0,22650,161267,0,183917
113447703000000,NE 110,Residential,20661,0,20661,135647,0,156308
113447703100000,NE 110,Residential,20661,0,20661,108724,0,129385
113447703200000,NE 110,Residential,21880,0,21880,96207,0,118087
113447703300000,NE 110,Residential,22968,0,22968,47513,0,70481
113447800100000,NE 110,Residential,18793,0,18793,88771,0,107564
113447800200000,NE 110,Residential,19176,0,19176,129950,0,149126
113447800300000,NE 110,Residential,19176,0,19176,136725,0,155901
113447800400000,NE 110,Residential,19176,0,19176,109410,0,128586
113447800500000,NE 110,Residential,19380,0,19380,110084,0,129464
113447800600000,NE 110,Residential,19992,0,19992,110767,0,130759
113447800700000,NE 110,Residential,20400,0,20400,124954,0,145354
113447800800000,NE 110,Residential,20554,0,20554,144976,0,165530
113447800900000,NE 110,Residential,22842,0,22842,112272,0,135114
113447801000000,NE 110,Residential,22312,0,22312,116525,0,138837
113447900100000,NE 110,Residential,20370,0,20370,140836,0,161206
113447900200000,NE 110,Residential,20370,0,20370,118880,0,139250
113447900300000,NE 110,Residential,22464,0,22464,130560,0,153024
113447900400000,NE 110,Residential,22464,0,22464,130692,0,153156
113447900500000,NE 110,Residential,21216,0,21216,114873,0,136089
113447900600000,NE 110,Residential,23712,0,23712,131808,0,155520
113447900700000,NE 110,Residential,22464,0,22464,139655,0,162119
113447900800000,NE 110,Residential,22464,0,22464,108510,0,130974
113447900900000,NE 110,Residential,23850,0,23850,114385,0,138235
113512600200000,NE 107,Residential,24629,0,24629,138183,0,162812
113512600300000,NE 107,Residential,21420,0,21420,149619,0,171039
113512600400000,NE 107,Residential,22950,0,22950,156291,0,179241
113512600500000,NE 107,Residential,21806,0,21806,145780,0,167586
113512600600000,NE 107,Residential,23868,0,23868,184631,0,208499
113512600700000,NE 107,Residential,22360,0,22360,141308,0,163668
113512600800000,NE 107,Residential,21945,0,21945,164170,0,186115
113512600900000,NE 107,Residential,22091,0,22091,143082,0,165173
113512601000000,NE 107,Residential,23532,0,23532,168847,0,192379
113512601100000,NE 107,Residential,23714,0,23714,145181,0,168895
113512601200000,NE 107,Residential,24032,0,24032,149472,0,173504
113512601300000,NE 107,Residential,24455,0,24455,145545,0,170000
113512601400000,NE 107,Residential,26249,0,26249,158445,0,184694
113512601500000,NE 107,Residential,25509,0,25509,142272,0,167781
113512601600000,NE 107,Residential,722,0,722,0,0,722
113512601700000,NE 107,Residential,699,0,699,0,0,699
113512700100000,NE 107,Residential,690,0,690,0,0,690
113512700200000,NE 107,Residential,495,0,495,0,0,495
113512700300000,NE 107,Residential,23068,0,23068,128932,0,152000
113512700400000,NE 107,Residential,25086,0,25086,187873,0,212959
113512700500000,NE 107,Residential,25335,0,25335,115931,0,141266
113512700600000,NE 107,Residential,24840,0,24840,144863,0,169703
113512700700000,NE 107,Residential,24920,0,24920,160562,0,185482
113512700800000,NE 107,Residential,4625,0,4625,0,0,4625
113512800100000,NE 107,Residential,26006,0,26006,143691,0,169697
113512800200000,NE 107,Residential,18900,0,18900,126307,0,145207
113512800300000,NE 107,Residential,25233,0,25233,154801,0,180034
113512800400000,NE 107,Residential,20867,0,20867,156952,0,177819
113512800500000,NE 107,Residential,22087,0,22087,142329,0,164416
113512800600000,NE 107,Residential,21534,0,21534,148946,0,170480
113512800700000,NE 107,Residential,21825,0,21825,145622,0,167447
113512800800000,NE 107,Residential,22795,0,22795,125912,0,148707
113512800900000,NE 107,Residential,21470,0,21470,132801,0,154271
113512801000000,NE 107,Residential,25568,0,25568,128537,0,154105
113512801100000,NE 107,Residential,26706,0,26706,151978,0,178684
113512801200000,NE 107,Residential,23128,0,23128,127785,0,150913
113512801300000,NE 107,Residential,24726,0,24726,163108,0,187834
113512801400000,NE 107,Residential,23280,0,23280,136464,0,159744
113512801500000,NE 107,Residential,22800,0,22800,179308,0,202108
113512801600000,NE 107,Residential,22922,0,22922,158959,0,181881
113512801700000,NE 107,Residential,20756,0,20756,135011,0,155767
113512801800000,NE 107,Residential,23467,0,23467,133457,0,156924
113512801900000,NE 107,Residential,25915,0,25915,149085,0,175000
113512900100000,NE 107,Residential,23762,0,23762,154238,0,178000
113512900200000,NE 107,Residential,21473,0,21473,172635,0,194108
113512900300000,NE 107,Residential,23981,0,23981,146991,0,170972
113512900400000,NE 107,Residential,24990,0,24990,172732,0,197722
113512900500000,NE 107,Residential,23265,0,23265,146942,0,170207
113512900600000,NE 107,Residential,22610,0,22610,145742,0,168352
113512900700000,NE 107,Residential,22074,0,22074,148326,0,170400
113512900800000,NE 107,Residential,23086,0,23086,133198,0,156284
113512900900000,NE 107,Residential,23302,0,23302,161333,0,184635
113512901000000,NE 107,Residential,21630,0,21630,143337,0,164967
113512901100000,NE 107,Residential,25245,0,25245,163945,0,189190
113512901200000,NE 107,Residential,26124,0,26124,110390,0,136514
113512901300000,NE 107,Residential,21459,0,21459,113351,0,134810
113512901400000,NE 107,Residential,22800,0,22800,160859,0,183659
113512901500000,NE 107,Residential,24336,0,24336,141833,0,166169
113515100100000,NE 107,Residential,4100,0,4100,0,0,4100
113515100200000,NE 107,Residential,24211,0,24211,144802,0,169013
113515100300000,NE 107,Residential,23250,0,23250,155696,0,178946
113515100400000,NE 107,Residential,22816,0,22816,144007,0,166823
113515100500000,NE 107,Residential,22560,0,22560,134838,0,157398
113515100600000,NE 107,Residential,21181,0,21181,110105,0,131286
113515100700000,NE 107,Residential,22295,0,22295,118585,0,140880
113515100800000,NE 107,Residential,19600,0,19600,135645,0,155245
113515100900000,NE 107,Residential,23616,0,23616,141503,0,165119
113515101000000,NE 107,Residential,24057,0,24057,121771,0,145828
113515200100000,NE 107,Residential,20807,0,20807,148556,0,169363
113515200200000,NE 107,Residential,21298,0,21298,142416,0,163714
113515200300000,NE 107,Residential,19896,0,19896,135665,0,155561
113515200400000,NE 107,Residential,24582,0,24582,154740,0,179322
113515200500000,NE 107,Residential,24000,0,24000,128532,0,152532
113515200600000,NE 107,Residential,19080,0,19080,109441,0,128521
113515200700000,NE 107,Residential,17395,0,17395,141578,0,158973
113515200800000,NE 107,Residential,18334,0,18334,111690,0,130024
113515200900000,NE 107,Residential,18612,0,18612,113700,0,132312
113515201000000,NE 107,Residential,18246,0,18246,107431,0,125677
113515201100000,NE 107,Residential,23226,0,23226,111350,0,134576
113515201200000,NE 107,Residential,23226,0,23226,110383,0,133609
113515201300000,NE 107,Residential,23226,0,23226,122718,0,145944
113515201400000,NE 107,Residential,18963,0,18963,133867,0,152830
113515201500000,NE 107,Residential,23520,0,23520,121407,0,144927
113515201600000,NE 107,Residential,22089,0,22089,123679,0,145768
113515201700000,NE 107,Residential,23610,0,23610,113010,0,136620
113515201800000,NE 107,Residential,25114,0,25114,151649,0,176763
113515201900000,NE 106,Residential,47040,0,47040,270772,0,317812
113515202000000,NE 106,Residential,44109,0,44109,184821,0,228930
113515202100000,NE 106,Residential,45485,0,45485,253560,0,299045
113515202200000,NE 106,Residential,47740,0,47740,213105,0,260845
113515202300000,NE 106,Residential,46464,0,46464,234550,0,281014
113515202400000,NE 106,Residential,45148,0,45148,241526,0,286674
113515202500000,NE 106,Residential,42984,0,42984,234643,0,277627
113515202600000,NE 106,Residential,41333,0,41333,237501,0,278834
113515202700000,NE 106,Residential,42432,0,42432,302631,0,345063
113515202800000,NE 106,Residential,40000,0,40000,250757,0,290757
113515202900000,NE 106,Residential,44687,0,44687,0,0,44687
113515203000000,NE 106,Residential,42132,0,42132,272562,0,314694
113515203100000,NE 106,Residential,48433,0,48433,203829,0,252262
113515203200000,NE 106,Residential,45256,0,45256,317028,0,362284
113515203300000,NE 106,Residential,42213,0,42213,316718,0,358931
113515203400000,NE 106,Residential,36000,0,36000,238871,0,274871
113515203500000,NE 106,Residential,45150,0,45150,264121,0,309271
113515203600000,NE 106,Residential,48062,0,48062,244971,0,293033
113515203700000,NE 106,Residential,46011,0,46011,292989,0,339000
113515203800000,NE 106,Residential,43200,0,43200,261614,0,304814
113515203900000,NE 106,Residential,44336,0,44336,235800,0,280136
113515204000000,NE 106,Residential,46512,0,46512,264712,0,311224
113515204100000,NE 106,Residential,40307,0,40307,239460,0,279767
113515204200000,NE 106,Residential,40280,0,40280,240408,0,280688
113515204300000,NE 106,Residential,42400,0,42400,258336,0,300736
113515204400000,NE 106,Residential,40280,0,40280,267301,0,307581
113515204500000,NE 106,Residential,40280,0,40280,294495,0,334775
113515204600000,NE 106,Residential,47064,0,47064,261770,0,308834
113515300100000,NE 106,Residential,42776,0,42776,244554,0,287330
113515300200000,NE 106,Residential,43200,0,43200,311503,0,354703
113515300300000,NE 106,Residential,46080,0,46080,288119,0,334199
113515300400000,NE 106,Residential,40615,0,40615,250732,0,291347
113515300500000,NE 106,Residential,43228,0,43228,230036,0,273264
113515300600000,NE 106,Residential,40400,0,40400,271052,0,311452
113515300700000,NE 106,Residential,40400,0,40400,296281,0,336681
113515300800000,NE 106,Residential,40400,0,40400,216422,0,256822
113515300900000,NE 106,Residential,39053,0,39053,270206,0,309259
113515301000000,NE 106,Residential,47700,0,47700,213931,0,261631
113515301100000,NE 106,Residential,48434,0,48434,308798,0,357232
113515301200000,NE 106,Residential,42420,0,42420,292489,0,334909
113515301300000,NE 106,Residential,43313,0,43313,307854,0,351167
113515301400000,NE 106,Residential,45640,0,45640,294240,0,339880
113515400100000,NE 107,Residential,22080,0,22080,111191,0,133271
113515400200000,NE 107,Residential,17802,0,17802,119068,0,136870
113515400300000,NE 107,Residential,17802,0,17802,153054,0,170856
113515400400000,NE 107,Residential,20976,0,20976,173457,0,194433
113515400500000,NE 107,Residential,21925,0,21925,172465,0,194390
113515400600000,FITNESS CENTER,Commercial,0,34128,34128,0,117364,151492
113515500100000,SCHOOL,Exempt,0,0,0,0,0,0
113520100100000,NE 160,Residential,29191,0,29191,164669,0,193860
113520100200000,NE 160,Residential,29565,0,29565,220022,0,249587
113520100300000,NE 160,Residential,29021,0,29021,162684,0,191705
113520200100000,NE 160,Residential,30194,0,30194,222806,0,253000
113520200200000,NE 160,Residential,30256,0,30256,224558,0,254814
113520300100000,NE 160,Residential,451,0,451,0,0,451
113520300200000,NE 160,Residential,39700,0,39700,206091,0,245791
113520300300000,NE 107,Residential,23256,0,23256,179145,0,202401
113520300400000,NE 107,Residential,19585,0,19585,129087,0,148672
113520400100000,NE 160,Residential,29820,0,29820,163339,0,193159
113520400200000,NE 160,Residential,28728,0,28728,204736,0,233464
113520400300000,NE 160,Residential,28728,0,28728,172032,0,200760
113520400400000,NE 160,Residential,28728,0,28728,192408,0,221136
113520400500000,NE 160,Residential,30164,0,30164,183907,0,214071
113520400600000,NE 160,Residential,29566,0,29566,195715,0,225281
113520400700000,NE 160,Residential,28998,0,28998,155625,0,184623
113520400800000,NE 160,Residential,30444,0,30444,189683,0,220127
113520400900000,NE 160,Residential,28994,0,28994,185915,0,214909
113520401000000,NE 160,Residential,28994,0,28994,184794,0,213788
113520401100000,NE 160,Residential,30444,0,30444,204317,0,234761
113520401200000,NE 160,Residential,30479,0,30479,205189,0,235668
113520401300000,NE 160,Residential,31696,0,31696,196882,0,228578
113520401400000,NE 160,Residential,28616,0,28616,184399,0,213015
113520401500000,NE 160,Residential,31371,0,31371,209263,0,240634
113520401600000,NE 105,Residential,25524,0,25524,188862,0,214386
113520401700000,NE 105,Residential,24960,0,24960,168735,0,193695
113520401800000,NE 105,Residential,24450,0,24450,168085,0,192535
113520401900000,NE 105,Residential,25380,0,25380,176347,0,201727
113520402000000,NE 160,Residential,24486,0,24486,189425,0,213911
113520402100000,NE 160,Residential,25583,0,25583,174596,0,200179
113520402200000,NE 160,Residential,25405,0,25405,178127,0,203532
113520402300000,NE 160,Residential,25112,0,25112,170895,0,196007
113520402400000,NE 160,Residential,25304,0,25304,174999,0,200303
113520402500000,NE 160,Residential,25310,0,25310,177297,0,202607
113520402600000,NE 160,Residential,25511,0,25511,175916,0,201427
113520402700000,NE 160,Residential,26573,0,26573,157022,0,183595
113520402800000,NE 160,Residential,26732,0,26732,194999,0,221731
113520402900000,NE 160,Residential,25582,0,25582,153492,0,179074
113520403000000,NE 160,Residential,24716,0,24716,145154,0,169870
113520403100000,NE 160,Residential,23188,0,23188,154281,0,177469
113520403200000,NE 160,Residential,23410,0,23410,188628,0,212038
113520403300000,NE 160,Residential,23760,0,23760,177811,0,201571
113520403400000,NE 160,Residential,24415,0,24415,188877,0,213292
113520403500000,NE 160,Residential,23661,0,23661,172727,0,196388
113520403600000,NE 160,Residential,23923,0,23923,191112,0,215035
113520403700000,NE 105,Residential,25140,0,25140,164080,0,189220
113520403800000,NE 105,Residential,25029,0,25029,153104,0,178133
113520403900000,NE 105,Residential,23175,0,23175,149109,0,172284
113520404000000,NE 107,Residential,23175,0,23175,166861,0,190036
113520404100000,NE 107,Residential,24952,0,24952,185215,0,210167
113520404200000,NE 107,Residential,24720,0,24720,178651,0,203371
113520404300000,NE 107,Residential,25029,0,25029,193120,0,218149
113520404400000,NE 107,Residential,24658,0,24658,196723,0,221381
113520404500000,NE 107,Residential,24720,0,24720,192635,0,217355
113520404600000,NE 107,Residential,22681,0,22681,168611,0,191292
113520404700000,NE 107,Residential,24720,0,24720,175058,0,199778
113520404800000,NE 107,Residential,24720,0,24720,202651,0,227371
113520404900000,NE 107,Residential,23175,0,23175,184068,0,207243
113520405000000,NE 107,Residential,26164,0,26164,195945,0,222109
113520405100000,NE 160,Residential,30234,0,30234,167211,0,197445
113520405200000,NE 160,Residential,33088,0,33088,198065,0,231153
113520500100000,NE 107,Residential,25650,0,25650,170755,0,196405
113520500200000,NE 107,Residential,21000,0,21000,151204,0,172204
113520500300000,NE 107,Residential,21000,0,21000,139040,0,160040
113520500400000,NE 107,Residential,21000,0,21000,224044,0,245044
113520500500000,NE 107,Residential,24000,0,24000,163521,0,187521
113520500600000,NE 107,Residential,24000,0,24000,192568,0,216568
113520600100000,NE 107,Residential,25650,0,25650,179834,0,205484
113520600200000,NE 107,Residential,20909,0,20909,151385,0,172294
113520600300000,NE 107,Residential,23760,0,23760,157931,0,181691
113520600400000,NE 107,Residential,22275,0,22275,148593,0,170868
113520600500000,NE 107,Residential,23760,0,23760,170869,0,194629
113520600600000,NE 107,Residential,22275,0,22275,141212,0,163487
113520600700000,NE 107,Residential,22050,0,22050,154059,0,176109
113520600800000,NE 107,Residential,25707,0,25707,164681,0,190388
113520600900000,NE 107,Residential,22725,0,22725,182582,0,205307
113520601000000,NE 107,Residential,22671,0,22671,181800,0,204471
113520601100000,NE 107,Residential,25688,0,25688,191257,0,216945
113520601200000,NE 107,Residential,25618,0,25618,201854,0,227472
113520601300000,NE 107,Residential,24948,0,24948,225809,0,250757
113520601400000,NE 107,Residential,25310,0,25310,150690,0,176000
113520601500000,NE 107,Residential,26283,0,26283,170048,0,196331
113520601600000,NE 107,Residential,27078,0,27078,215616,0,242694
113520601700000,NE 107,Residential,25393,0,25393,222125,0,247518
113520601800000,NE 107,Residential,25554,0,25554,203146,0,228700
113520601900000,NE 107,Residential,25650,0,25650,190564,0,216214
113520602000000,NE 107,Residential,22800,0,22800,150704,0,173504
113520700100000,NE 107,Residential,25920,0,25920,183049,0,208969
113520700200000,NE 107,Residential,20790,0,20790,176696,0,197486
113520700300000,NE 105,Residential,22119,0,22119,130682,0,152801
113520700400000,NE 105,Residential,25755,0,25755,164736,0,190491
113520700500000,NE 105,Residential,25436,0,25436,153199,0,178635
113520700600000,NE 105,Residential,25440,0,25440,157013,0,182453
113520700700000,NE 105,Residential,25758,0,25758,168457,0,194215
113520700800000,NE 105,Residential,25492,0,25492,161469,0,186961
113520700900000,NE 107,Residential,21879,0,21879,163893,0,185772
113520701000000,NE 107,Residential,23520,0,23520,193789,0,217309
113520701100000,NE 107,Residential,22134,0,22134,144053,0,166187
113520701200000,NE 107,Residential,21420,0,21420,175658,0,197078
113520800100000,NE 107,Residential,25398,0,25398,162267,0,187665
113520800200000,NE 107,Residential,19081,0,19081,139270,0,158351
113520800300000,NE 107,Residential,19740,0,19740,156978,0,176718
113520800400000,NE 107,Residential,26289,0,26289,177617,0,203906
113522600100000,NE 105,Residential,24359,0,24359,171215,0,195574
113522600200000,NE 105,Residential,25175,0,25175,197606,0,222781
113522600300000,NE 105,Residential,23979,0,23979,150135,0,174114
113522600400000,NE 105,Residential,24122,0,24122,157605,0,181727
113522600500000,NE 105,Residential,23562,0,23562,161987,0,185549
113522600600000,NE 105,Residential,23256,0,23256,196154,0,219410
113522600700000,NE 105,Residential,22644,0,22644,179677,0,202321
113522600800000,NE 105,Residential,24174,0,24174,178225,0,202399
113522600900000,NE 105,Residential,23890,0,23890,140580,0,164470
113522601000000,NE 105,Residential,25420,0,25420,162899,0,188319
113522601100000,NE 105,Residential,29057,0,29057,159419,0,188476
113522601200000,NE 105,Residential,24800,0,24800,173895,0,198695
113522601300000,NE 105,Residential,25741,0,25741,192768,0,218509
113522700100000,NE 105,Residential,28187,0,28187,170409,0,198596
113522700200000,NE 105,Residential,26386,0,26386,203640,0,230026
113522700300000,NE 105,Residential,25962,0,25962,198770,0,224732
113522700400000,NE 105,Residential,25756,0,25756,175804,0,201560
113522700500000,NE 105,Residential,25436,0,25436,168012,0,193448
113522700600000,NE 105,Residential,25596,0,25596,168644,0,194240
113522700700000,NE 105,Residential,23400,0,23400,173834,0,197234
113522700800000,NE 105,Residential,25463,0,25463,182390,0,207853
113522800100000,NE 105,Residential,27343,0,27343,155292,0,182635
113522800200000,NE 105,Residential,25970,0,25970,177249,0,203219
113522800300000,NE 105,Residential,26365,0,26365,107777,0,134142
113522800400000,NE 105,Residential,22567,0,22567,173028,0,195595
113522800500000,NE 105,Residential,20677,0,20677,153302,0,173979
113522800600000,NE 105,Residential,24627,0,24627,164289,0,188916
113522800700000,NE 105,Residential,22746,0,22746,151864,0,174610
113522800800000,NE 105,Residential,24523,0,24523,172675,0,197198
113522800900000,NE 105,Residential,24232,0,24232,159181,0,183413
113522801000000,NE 105,Residential,23634,0,23634,149062,0,172696
113522801100000,NE 105,Residential,25858,0,25858,160141,0,185999
113522801200000,NE 105,Residential,25188,0,25188,141021,0,166209
113522801300000,NE 105,Residential,24480,0,24480,137093,0,161573
113522801400000,NE 105,Residential,22950,0,22950,141286,0,164236
113522801500000,NE 105,Residential,24480,0,24480,134959,0,159439
113522801600000,NE 105,Residential,22950,0,22950,141755,0,164705
113522801700000,NE 105,Residential,24480,0,24480,159481,0,183961
113522801800000,NE 105,Residential,22950,0,22950,137204,0,160154
113522801900000,NE 105,Residential,26010,0,26010,157359,0,183369
113522802000000,NE 105,Residential,25102,0,25102,173295,0,198397
113522802100000,NE 105,Residential,23406,0,23406,151200,0,174606
113522900100000,NE 105,Residential,25718,0,25718,169071,0,194789
113522900200000,NE 105,Residential,22680,0,22680,164818,0,187498
113522900300000,NE 105,Residential,25200,0,25200,161271,0,186471
113522900400000,NE 105,Residential,25941,0,25941,149269,0,175210
113522900500000,NE 105,Residential,22344,0,22344,155512,0,177856
113522900600000,NE 105,Residential,22344,0,22344,129363,0,151707
113522900700000,NE 105,Residential,25380,0,25380,149343,0,174723
113522900800000,NE 105,Residential,24255,0,24255,186465,0,210720
113522900900000,NE 105,Residential,23625,0,23625,132802,0,156427
113522901000000,NE 105,Residential,25291,0,25291,141158,0,166449
113522901100000,NE 105,Residential,23573,0,23573,157233,0,180806
113522901200000,NE 105,Residential,22990,0,22990,180626,0,203616
113523000100000,NE 105,Residential,25273,0,25273,173577,0,198850
113523000200000,NE 105,Residential,24243,0,24243,190310,0,214553
113523000300000,NE 105,Residential,24354,0,24354,169731,0,194085
113523000400000,NE 105,Residential,24857,0,24857,151818,0,176675
113523000500000,NE 105,Residential,24960,0,24960,153634,0,178594
113523000600000,NE 105,Residential,24960,0,24960,194527,0,219487
113523000700000,NE 105,Residential,23712,0,23712,169616,0,193328
113523000800000,NE 105,Residential,26076,0,26076,181835,0,207911
113523000900000,NE 105,Residential,24597,0,24597,183872,0,208469
113523001000000,NE 105,Residential,24388,0,24388,158988,0,183376
113523001100000,NE 105,Residential,24480,0,24480,156293,0,180773
113523001200000,NE 105,Residential,24072,0,24072,157288,0,181360
113523001300000,NE 105,Residential,23358,0,23358,172781,0,196139
113523001400000,NE 105,Residential,23690,0,23690,164603,0,188293
113523001500000,NE 105,Residential,22725,0,22725,158204,0,180929
113523001600000,NE 105,Residential,25236,0,25236,165004,0,190240
113523001700000,NE 105,Residential,22500,0,22500,125625,0,148125
113523001800000,NE 105,Residential,24452,0,24452,155107,0,179559
113523001900000,NE 105,Residential,25532,0,25532,124863,0,150395
113523002000000,NE 105,Residential,25271,0,25271,178303,0,203574
113523002100000,NE 105,Residential,22725,0,22725,126853,0,149578
113523002200000,NE 105,Residential,24240,0,24240,159147,0,183387
113523002300000,NE 105,Residential,26260,0,26260,151743,0,178003
113523002400000,NE 105,Residential,22725,0,22725,159343,0,182068
113523002500000,NE 105,Residential,24240,0,24240,122324,0,146564
113523002600000,NE 105,Residential,25927,0,25927,150660,0,176587
113523002700000,NE 105,Residential,25650,0,25650,164943,0,190593
113523002800000,NE 105,Residential,25398,0,25398,121870,0,147268
113523002900000,NE 105,Residential,24824,0,24824,151536,0,176360
113523003000000,NE 105,Residential,26190,0,26190,141853,0,168043
113523003100000,NE 105,Residential,23680,0,23680,145040,0,168720
113523003200000,NE 105,Residential,24174,0,24174,142483,0,166657
113523003300000,NE 105,Residential,20624,0,20624,125621,0,146245
113523003400000,NE 105,Residential,25264,0,25264,120377,0,145641
113523003500000,NE 105,Residential,26275,0,26275,159818,0,186093
113523003600000,NE 105,Residential,21930,0,21930,122339,0,144269
113523003700000,NE 105,Residential,24585,0,24585,158946,0,183531
113523003800000,NE 105,Residential,22800,0,22800,153217,0,176017
113523003900000,NE 105,Residential,24558,0,24558,152054,0,176612
113523004000000,NE 105,Residential,23833,0,23833,117596,0,141429
113523004100000,NE 105,Residential,25789,0,25789,183688,0,209477
113523004200000,NE 105,Residential,25586,0,25586,174289,0,199875
113523004300000,NE 105,Residential,25137,0,25137,175336,0,200473
113523004400000,NE 105,Residential,25200,0,25200,164587,0,189787
113523004500000,NE 105,Residential,25224,0,25224,156509,0,181733
113523004600000,NE 105,Residential,24648,0,24648,155709,0,180357
113523004700000,NE 105,Residential,24495,0,24495,124375,0,148870
113523004800000,NE 105,Residential,24735,0,24735,178549,0,203284
113523100100000,NE 105,Residential,26254,0,26254,162092,0,188346
113523100200000,NE 105,Residential,23814,0,23814,166434,0,190248
113523100300000,NE 105,Residential,23955,0,23955,163389,0,187344
113523100400000,NE 105,Residential,25800,0,25800,171601,0,197401
113523100500000,NE 105,Residential,26343,0,26343,176606,0,202949
113523100600000,NE 105,Residential,25440,0,25440,173605,0,199045
113523100700000,NE 105,Residential,25393,0,25393,167571,0,192964
113523100800000,NE 105,Residential,26299,0,26299,143270,0,169569
113523100900000,NE 105,Residential,25494,0,25494,174592,0,200086
113525100100000,NE 107,Residential,25240,0,25240,140347,0,165587
113525100200000,NE 107,Residential,23197,0,23197,172883,0,196080
113525100300000,NE 107,Residential,21846,0,21846,180154,0,202000
113525100400000,NE 107,Residential,23040,0,23040,196039,0,219079
113525100500000,NE 107,Residential,22684,0,22684,162316,0,185000
113525100600000,NE 107,Residential,22275,0,22275,144389,0,166664
113525100700000,NE 107,Residential,24000,0,24000,182691,0,206691
113525100800000,NE 107,Residential,25500,0,25500,188299,0,213799
113525100900000,NE 107,Residential,24000,0,24000,211612,0,235612
113525101000000,NE 107,Residential,28350,0,28350,199800,0,228150
113525101100000,NE 107,Residential,24000,0,24000,205781,0,229781
113525101200000,NE 107,Residential,24000,0,24000,214939,0,238939
113525101300000,NE 107,Residential,24000,0,24000,181421,0,205421
113525101400000,NE 107,Residential,21600,0,21600,0,0,21600
113525101500000,NE 107,Residential,23867,0,23867,176490,0,200357
113525101600000,NE 107,Residential,23818,0,23818,157757,0,181575
113525101700000,NE 107,Residential,26196,0,26196,141056,0,167252
113525101800000,NE 107,Residential,23180,0,23180,191084,0,214264
113525200100000,NE 107,Residential,25888,0,25888,178596,0,204484
113525200200000,NE 107,Residential,25942,0,25942,209664,0,235606
113525200300000,NE 107,Residential,27841,0,27841,223698,0,251539
113525200400000,NE 107,Residential,29174,0,29174,207953,0,237127
113525200500000,NE 107,Residential,26058,0,26058,198955,0,225013
113525200600000,NE 107,Residential,23886,0,23886,208073,0,231959
113525200700000,NE 107,Residential,23496,0,23496,0,0,23496
113525200800000,NE 107,Residential,23100,0,23100,172031,0,195131
113525300100000,NE 107,Residential,20952,0,20952,135948,0,156900
113525300200000,NE 107,Residential,20708,0,20708,122822,0,143530
113525300300000,NE 107,Residential,24948,0,24948,104361,0,129309
113525300400000,NE 107,Residential,20790,0,20790,133682,0,154472
113525300500000,NE 107,Residential,25200,0,25200,108090,0,133290
113525300600000,NE 107,Residential,23400,0,23400,136247,0,159647
113525300700000,NE 107,Residential,21210,0,21210,137873,0,159083
113525300800000,NE 107,Residential,21420,0,21420,124935,0,146355
113525300900000,NE 107,Residential,19931,0,19931,141905,0,161836
113525301000000,NE 107,Residential,25404,0,25404,122660,0,148064
113525301100000,NE 107,Residential,24150,0,24150,153368,0,177518
113525301200000,NE 107,Residential,23833,0,23833,135058,0,158891
113525301300000,NE 107,Residential,22157,0,22157,101091,0,123248
113525301400000,NE 107,Residential,25975,0,25975,124919,0,150894
113525301500000,NE 107,Residential,23310,0,23310,96053,0,119363
113525301600000,NE 107,Residential,25260,0,25260,109665,0,134925
113525301700000,NE 107,Residential,25210,0,25210,147418,0,172628
113525301800000,NE 107,Residential,25525,0,25525,137084,0,162609
113525301900000,NE 107,Residential,26031,0,26031,114951,0,140982
113525302000000,NE 107,Residential,24010,0,24010,101853,0,125863
113525302100000,NE 107,Residential,24010,0,24010,124435,0,148445
113525302200000,NE 107,Residential,24010,0,24010,112215,0,136225
113525302300000,NE 107,Residential,24010,0,24010,118692,0,142702
113525400100000,NE 107,Residential,30278,0,30278,278545,0,308823
113525400200000,NE 107,Residential,28080,0,28080,227349,0,255429
113525400300000,NE 107,Residential,31489,0,31489,253724,0,285213
113525400400000,NE 107,Residential,26634,0,26634,120364,0,146998
113525400500000,NE 107,Residential,25725,0,25725,149949,0,175674
113525400600000,NE 107,Residential,24873,0,24873,118578,0,143451
113525400700000,NE 107,Residential,24417,0,24417,122648,0,147065
113525400800000,NE 107,Residential,24512,0,24512,122279,0,146791
113525400900000,NE 107,Residential,24907,0,24907,132965,0,157872
113525401000000,NE 107,Residential,23802,0,23802,141862,0,165664
113525401100000,NE 107,Residential,25323,0,25323,131246,0,156569
113525401200000,NE 107,Residential,25606,0,25606,114106,0,139712
113525401300000,NE 107,Residential,21612,0,21612,121633,0,143245
113525401400000,NE 107,Residential,22869,0,22869,104683,0,127552
113525401500000,NE 107,Residential,25916,0,25916,100233,0,126149
113525401600000,NE 107,Residential,23688,0,23688,104267,0,127955
113525401700000,NE 107,Residential,30216,0,30216,184253,0,214469
113525401800000,NE 107,Residential,31741,0,31741,185808,0,217549
113525401900000,NE 107,Residential,30059,0,30059,190852,0,220911
113525402000000,NE 107,Residential,29568,0,29568,187524,0,217092
113525402100000,NE 107,Residential,30696,0,30696,204466,0,235162
113525402200000,NE 107,Residential,24938,0,24938,115054,0,139992
113525402300000,NE 107,Residential,24938,0,24938,106058,0,130996
113525500100000,NE 107,Residential,22511,0,22511,119585,0,142096
113525500200000,NE 107,Residential,22290,0,22290,131220,0,153510
113525500300000,NE 107,Residential,22270,0,22270,114974,0,137244
113525500400000,NE 107,Residential,23896,0,23896,123847,0,147743
113525500500000,NE 107,Residential,24544,0,24544,119682,0,144226
113525500600000,NE 107,Residential,24197,0,24197,143219,0,167416
113525500700000,NE 107,Residential,24393,0,24393,120432,0,144825
113525500800000,NE 107,Residential,21258,0,21258,105233,0,126491
113525500900000,NE 107,Residential,20671,0,20671,131702,0,152373
113525501000000,NE 107,Residential,24498,0,24498,131507,0,156005
113525501100000,NE 107,Residential,23140,0,23140,107162,0,130302
113525501200000,NE 107,Residential,21868,0,21868,126675,0,148543
113525501300000,NE 107,Residential,24897,0,24897,175103,0,200000
113525501400000,NE 107,Residential,24872,0,24872,110562,0,135434
113525501500000,NE 107,Residential,25841,0,25841,110447,0,136288
113525501600000,NE 107,Residential,25906,0,25906,121324,0,147230
113525501700000,NE 107,Residential,26250,0,26250,124650,0,150900
113525501800000,NE 107,Residential,26003,0,26003,116352,0,142355
113525501900000,NE 107,Residential,25988,0,25988,136770,0,162758
113525502000000,NE 107,Residential,25988,0,25988,138564,0,164552
113525502100000,NE 107,Residential,25988,0,25988,147980,0,173968
113525600100000,NE 107,Residential,23478,0,23478,126661,0,150139
113525600200000,NE 107,Residential,25686,0,25686,108394,0,134080
113525600300000,NE 107,Residential,25436,0,25436,108341,0,133777
113525600400000,NE 107,Residential,26489,0,26489,123304,0,149793
113525600500000,NE 107,Residential,26307,0,26307,105670,0,131977
113525600600000,NE 107,Residential,25599,0,25599,114076,0,139675
113525600700000,NE 107,Residential,25416,0,25416,117840,0,143256
113525600800000,NE 107,Residential,25305,0,25305,126944,0,152249
113525600900000,NE 107,Residential,26019,0,26019,168345,0,194364
113525601000000,NE 107,Residential,26281,0,26281,122089,0,148370
113525601100000,NE 107,Residential,24038,0,24038,103368,0,127406
113525700100000,NE 107,Residential,25490,0,25490,92460,0,117950
113525700200000,NE 107,Residential,25827,0,25827,137218,0,163045
113525700300000,NE 107,Residential,25358,0,25358,105712,0,131070
113525700400000,NE 107,Residential,25917,0,25917,135639,0,161556
113525800100000,NE 107,Residential,26726,0,26726,122074,0,148800
113525800200000,NE 107,Residential,26006,0,26006,119430,0,145436
113525800300000,NE 107,Residential,25235,0,25235,125095,0,150330
113525800400000,NE 107,Residential,25988,0,25988,114263,0,140251
113525800500000,NE 107,Residential,25436,0,25436,113229,0,138665
113525800600000,NE 107,Residential,23559,0,23559,115746,0,139305
113525800700000,NE 107,Residential,20447,0,20447,117427,0,137874
113527600100000,NE 107,Residential,21000,0,21000,167277,0,188277
113527600200000,NE 107,Residential,22500,0,22500,187177,0,209677
113527600300000,NE 107,Residential,24898,0,24898,153253,0,178151
113527600400000,NE 107,Residential,23910,0,23910,187741,0,211651
113527700100000,NE 107,Residential,26507,0,26507,187788,0,214295
113527700200000,NE 107,Residential,22104,0,22104,147523,0,169627
113527700300000,NE 107,Residential,22998,0,22998,169719,0,192717
113527700400000,NE 107,Residential,23994,0,23994,168432,0,192426
113527700500000,NE 107,Residential,23760,0,23760,179042,0,202802
113527700600000,NE 107,Residential,19200,0,19200,150786,0,169986
113527700700000,NE 107,Residential,21420,0,21420,195453,0,216873
113527700800000,NE 107,Residential,24480,0,24480,181977,0,206457
113527700900000,NE 107,Residential,26163,0,26163,170369,0,196532
113527701000000,NE 107,Residential,23520,0,23520,167697,0,191217
113527701100000,NE 107,Residential,23520,0,23520,187701,0,211221
113527701200000,NE 107,Residential,20580,0,20580,133829,0,154409
113527701300000,NE 107,Residential,22950,0,22950,161308,0,184258
113527701400000,NE 107,Residential,26365,0,26365,144188,0,170553
113527701500000,NE 107,Residential,23427,0,23427,207708,0,231135
113527701600000,NE 107,Residential,20332,0,20332,185798,0,206130
113527701700000,NE 107,Residential,25718,0,25718,164519,0,190237
113527701800000,NE 107,Residential,22295,0,22295,177361,0,199656
113527701900000,NE 107,Residential,24939,0,24939,170061,0,195000
113527702000000,NE 107,Residential,25004,0,25004,183924,0,208928
113527800100000,NE 107,Residential,22116,0,22116,176001,0,198117
113527800200000,NE 107,Residential,21462,0,21462,192121,0,213583
113527800300000,NE 107,Residential,20988,0,20988,168779,0,189767
113527800400000,NE 107,Residential,18563,0,18563,153144,0,171707
113527800500000,NE 107,Residential,21518,0,21518,194664,0,216182
113527800600000,NE 107,Residential,25650,0,25650,175290,0,200940
113527800700000,NE 107,Residential,25650,0,25650,153087,0,178737
113527800800000,NE 107,Residential,22800,0,22800,191230,0,214030
113527800900000,NE 107,Residential,18303,0,18303,149921,0,168224
113527801000000,NE 107,Residential,18330,0,18330,154717,0,173047
113527900100000,NE 107,Residential,21375,0,21375,191422,0,212797
113527900200000,NE 107,Residential,24500,0,24500,181060,0,205560
113527900300000,NE 107,Residential,26286,0,26286,143714,0,170000
113527900400000,NE 107,Residential,25625,0,25625,158061,0,183686
113527900500000,NE 107,Residential,25650,0,25650,182219,0,207869
113527900600000,NE 107,Residential,22800,0,22800,205084,0,227884
113527900700000,NE 107,Residential,19950,0,19950,175685,0,195635
113527900800000,NE 107,Residential,19665,0,19665,179935,0,199600
113528000100000,NE 107,Residential,25578,0,25578,162455,0,188033
113528000200000,NE 107,Residential,21898,0,21898,149731,0,171629
113528000300000,NE 107,Residential,25293,0,25293,111784,0,137077
113528000400000,NE 107,Residential,26074,0,26074,116092,0,142166
113528000500000,NE 107,Residential,26068,0,26068,176821,0,202889
113528000600000,NE 107,Residential,25313,0,25313,134361,0,159674
113528000700000,NE 107,Residential,25468,0,25468,127437,0,152905
113528000800000,NE 107,Residential,26277,0,26277,154776,0,181053
113528000900000,NE 107,Residential,25463,0,25463,110267,0,135730
113528100100000,NE 107,Residential,28952,0,28952,125131,0,154083
113528100200000,NE 107,Residential,20424,0,20424,162199,0,182623
113528100300000,NE 107,Residential,22843,0,22843,165274,0,188117
113528100400000,NE 107,Residential,18612,0,18612,166829,0,185441
113528100500000,NE 107,Residential,23124,0,23124,130293,0,153417
113528100600000,NE 107,Residential,19740,0,19740,130253,0,149993
113528100700000,NE 107,Residential,18189,0,18189,163068,0,181257
113528100800000,NE 107,Residential,19740,0,19740,130894,0,150634
113528100900000,NE 107,Residential,23688,0,23688,120311,0,143999
113528101000000,NE 107,Residential,19740,0,19740,114441,0,134181
113528101100000,NE 107,Residential,26436,0,26436,129233,0,155669
113528101200000,NE 107,Residential,20898,0,20898,111005,0,131903
113528101300000,NE 107,Residential,22908,0,22908,126463,0,149371
113528101400000,NE 107,Residential,21221,0,21221,120872,0,142093
113528101500000,NE 107,Residential,21221,0,21221,109515,0,130736
113528101600000,NE 107,Residential,21221,0,21221,150119,0,171340
113528101700000,NE 107,Residential,21221,0,21221,119213,0,140434
113528101800000,NE 107,Residential,21221,0,21221,118441,0,139662
113528101900000,NE 107,Residential,19740,0,19740,110561,0,130301
113528102000000,NE 107,Residential,19740,0,19740,121968,0,141708
113528102100000,NE 107,Residential,19740,0,19740,109144,0,128884
113528102200000,NE 107,Residential,21824,0,21824,126817,0,148641
113528102300000,NE 107,Residential,20676,0,20676,129935,0,150611
113528102400000,NE 107,Residential,22932,0,22932,139329,0,162261
113528102500000,NE 107,Residential,20898,0,20898,130541,0,151439
113528200100000,NE 107,Residential,25114,0,25114,131825,0,156939
113528200200000,NE 107,Residential,20700,0,20700,125775,0,146475
113528200300000,NE 107,Residential,19997,0,19997,134916,0,154913
113528200400000,NE 107,Residential,21728,0,21728,104882,0,126610
113528200500000,NE 107,Residential,22035,0,22035,122077,0,144112
113528200600000,NE 107,Residential,26150,0,26150,151855,0,178005
113528200700000,NE 107,Residential,21363,0,21363,114189,0,135552
113528300100000,NE 107,Residential,25035,0,25035,118071,0,143106
113528300200000,NE 107,Residential,24631,0,24631,130469,0,155100
113528300300000,NE 107,Residential,23545,0,23545,131476,0,155021
113528300400000,NE 107,Residential,22860,0,22860,110528,0,133388
113528300500000,NE 107,Residential,22349,0,22349,129506,0,151855
113528300600000,NE 107,Residential,21672,0,21672,127552,0,149224
113528300700000,NE 107,Residential,21221,0,21221,106993,0,128214
113528300800000,NE 107,Residential,21221,0,21221,126544,0,147765
113528300900000,NE 107,Residential,21221,0,21221,110732,0,131953
113528301000000,NE 107,Residential,21221,0,21221,127251,0,148472
113528301100000,NE 107,Residential,21221,0,21221,112807,0,134028
113528301200000,NE 107,Residential,21446,0,21446,115054,0,136500
113528301300000,NE 107,Residential,21898,0,21898,126677,0,148575
113528301400000,NE 107,Residential,22153,0,22153,109080,0,131233
113528301500000,NE 107,Residential,21093,0,21093,138482,0,159575
113528301600000,NE 107,Residential,20836,0,20836,127604,0,148440
113528301700000,NE 107,Residential,20790,0,20790,124760,0,145550
113528301800000,NE 107,Residential,20790,0,20790,106951,0,127741
113528301900000,NE 107,Residential,22181,0,22181,102643,0,124824
113528302000000,NE 107,Residential,22181,0,22181,122210,0,144391
113528302100000,NE 107,Residential,22181,0,22181,118955,0,141136
113528302200000,NE 107,Residential,22942,0,22942,118597,0,141539
113528302300000,NE 107,Residential,22180,0,22180,118848,0,141028
113528302400000,NE 107,Residential,21221,0,21221,108547,0,129768
113528302500000,NE 107,Residential,21714,0,21714,127554,0,149268
113528302600000,NE 107,Residential,25481,0,25481,153995,0,179476
113528302700000,NE 107,Residential,24384,0,24384,128965,0,153349
113528302800000,NE 107,Residential,25164,0,25164,129696,0,154860
113528302900000,NE 107,Residential,21221,0,21221,106180,0,127401
113528303000000,NE 107,Residential,20069,0,20069,125203,0,145272
113528303100000,NE 107,Residential,21735,0,21735,124810,0,146545
113528400100000,NE 107,Residential,26085,0,26085,101711,0,127796
113528400200000,NE 107,Residential,25930,0,25930,131323,0,157253
113528400300000,NE 107,Residential,25463,0,25463,124553,0,150016
113528400400000,NE 107,Residential,25187,0,25187,104327,0,129514
113528500100000,NE 107,Residential,26639,0,26639,125861,0,152500
113528500200000,NE 107,Residential,25420,0,25420,123242,0,148662
113528500300000,NE 107,Residential,23417,0,23417,125056,0,148473
113528500400000,NE 107,Residential,24948,0,24948,109151,0,134099
113528500500000,NE 107,Residential,24570,0,24570,124079,0,148649
113528500600000,NE 107,Residential,24381,0,24381,108471,0,132852
113528500700000,NE 107,Residential,24155,0,24155,151108,0,175263
113528500800000,NE 107,Residential,23930,0,23930,114222,0,138152
113528500900000,NE 107,Residential,23704,0,23704,113408,0,137112
113528501000000,NE 107,Residential,25491,0,25491,124937,0,150428
113528501100000,NE 107,Residential,22801,0,22801,129141,0,151942
113528501200000,NE 107,Residential,25436,0,25436,106771,0,132207
113528501300000,NE 107,Residential,23478,0,23478,105453,0,128931
113528501400000,NE 107,Residential,25370,0,25370,159651,0,185021
113528501500000,NE 107,Residential,26088,0,26088,138878,0,164966
113528501600000,NE 107,Residential,25881,0,25881,117184,0,143065
113530100100000,NE 107,Residential,30544,0,30544,118498,0,149042
113530100200000,NE 107,Residential,24010,0,24010,116388,0,140398
113530100300000,NE 107,Residential,25063,0,25063,140854,0,165917
113530100400000,NE 107,Residential,25407,0,25407,131887,0,157294
113530100500000,NE 107,Residential,25099,0,25099,126387,0,151486
113530200100000,NE 107,Residential,25987,0,25987,154987,0,180974
113530200200000,NE 107,Residential,25440,0,25440,126056,0,151496
113530200300000,NE 107,Residential,23793,0,23793,97989,0,121782
113530200400000,NE 107,Residential,26156,0,26156,126918,0,153074
113530200500000,NE 107,Residential,25952,0,25952,110867,0,136819
113530200600000,NE 107,Residential,25867,0,25867,120226,0,146093
113530200700000,NE 107,Residential,26082,0,26082,137598,0,163680
113530200800000,NE 107,Residential,26065,0,26065,117383,0,143448
113530200900000,NE 107,Residential,26301,0,26301,147628,0,173929
113530201000000,NE 107,Residential,25704,0,25704,163264,0,188968
113530201100000,NE 107,Residential,25711,0,25711,131250,0,156961
113530201200000,NE 107,Residential,23426,0,23426,125244,0,148670
113530201300000,NE 107,Residential,21280,0,21280,115880,0,137160
113530201400000,NE 107,Residential,24938,0,24938,106605,0,131543
113530201500000,NE 107,Residential,21056,0,21056,124751,0,145807
113530201600000,NE 107,Residential,21359,0,21359,147527,0,168886
113530201700000,NE 107,Residential,22153,0,22153,123518,0,145671
113530201800000,NE 107,Residential,23683,0,23683,148973,0,172656
113530201900000,NE 107,Residential,24514,0,24514,117244,0,141758
113530202000000,NE 107,Residential,25268,0,25268,148301,0,173569
113530202100000,NE 107,Residential,26264,0,26264,107641,0,133905
113530202200000,NE 107,Residential,24239,0,24239,112161,0,136400
113530202300000,NE 107,Residential,22977,0,22977,108032,0,131009
113530202400000,NE 107,Residential,25010,0,25010,125375,0,150385
113530202500000,NE 107,Residential,24897,0,24897,127610,0,152507
113530202600000,NE 107,Residential,20809,0,20809,98049,0,118858
113530202700000,NE 107,Residential,25684,0,25684,107051,0,132735
113530202800000,NE 107,Residential,25115,0,25115,108540,0,133655
113530202900000,NE 107,Residential,24733,0,24733,119891,0,144624
113530203000000,NE 107,Residential,28088,0,28088,150241,0,178329
113530203100000,NE 107,Residential,26214,0,26214,135855,0,162069
113530203200000,NE 107,Residential,25853,0,25853,100252,0,126105
113530300100000,NE 107,Residential,25004,0,25004,131153,0,156157
113530400100000,NE 107,Residential,26565,0,26565,169801,0,196366
113530400200000,NE 107,Residential,25116,0,25116,136225,0,161341
113530400300000,NE 107,Residential,25725,0,25725,100599,0,126324
113530400400000,NE 107,Residential,26225,0,26225,147988,0,174213
113530400500000,NE 107,Residential,26239,0,26239,122766,0,149005
113530400600000,NE 107,Residential,25436,0,25436,115475,0,140911
113530400700000,NE 107,Residential,26185,0,26185,117000,0,143185
113530400800000,NE 107,Residential,25502,0,25502,124750,0,150252
113530400900000,NE 107,Residential,24514,0,24514,125496,0,150010
113530401000000,NE 107,Residential,24148,0,24148,104679,0,128827
113530401100000,NE 107,Residential,25436,0,25436,118348,0,143784
113530401200000,NE 107,Residential,26567,0,26567,181254,0,207821
113530401300000,NE 107,Residential,25853,0,25853,140081,0,165934
113530401400000,NE 107,Residential,26973,0,26973,113823,0,140796
113530401500000,NE 107,Residential,21929,0,21929,101107,0,123036
113530500100000,NE 107,Residential,25780,0,25780,110544,0,136324
113530500200000,NE 107,Residential,23053,0,23053,104541,0,127594
113530500300000,NE 107,Residential,21162,0,21162,109957,0,131119
113530500400000,NE 107,Residential,21851,0,21851,125420,0,147271
113530500500000,NE 107,Residential,21446,0,21446,109677,0,131123
113530500600000,NE 107,Residential,21446,0,21446,113553,0,134999
113530500700000,NE 107,Residential,24938,0,24938,128515,0,153453
113530500800000,NE 107,Residential,24938,0,24938,123943,0,148881
113530500900000,NE 107,Residential,24938,0,24938,123765,0,148703
113530501000000,NE 107,Residential,24938,0,24938,105651,0,130589
113530501100000,NE 107,Residential,26250,0,26250,129749,0,155999
113530501200000,NE 107,Residential,22261,0,22261,109398,0,131659
113530501300000,NE 107,Residential,26549,0,26549,145341,0,171890
113530501400000,NE 107,Residential,21446,0,21446,137289,0,158735
113530501500000,NE 107,Residential,21446,0,21446,137502,0,158948
113530501600000,NE 107,Residential,21446,0,21446,147548,0,168994
113530501700000,NE 107,Residential,21446,0,21446,122199,0,143645
113530501800000,NE 107,Residential,24938,0,24938,144529,0,169467
113530501900000,NE 107,Residential,21446,0,21446,124531,0,145977
113530502000000,NE 107,Residential,21673,0,21673,120642,0,142315
113530502100000,NE 107,Residential,23327,0,23327,130847,0,154174
113530502200000,NE 107,Residential,25888,0,25888,110054,0,135942
113530502300000,NE 107,Residential,21125,0,21125,123859,0,144984
113530600100000,NE 107,Residential,27370,0,27370,138934,0,166304
113530600200000,NE 107,Residential,25157,0,25157,143966,0,169123
113530600300000,NE 107,Residential,22575,0,22575,156440,0,179015
113530600400000,NE 107,Residential,22994,0,22994,118006,0,141000
113530600500000,NE 107,Residential,22575,0,22575,157065,0,179640
113530600600000,NE 107,Residential,22575,0,22575,121855,0,144430
113530600700000,NE 107,Residential,22575,0,22575,117070,0,139645
113530600800000,NE 107,Residential,22575,0,22575,125113,0,147688
113530600900000,NE 107,Residential,24627,0,24627,123491,0,148118
113530601000000,NE 107,Residential,25722,0,25722,130010,0,155732
113530601100000,NE 107,Residential,25935,0,25935,121630,0,147565
113530601200000,NE 107,Residential,25915,0,25915,115917,0,141832
113530601300000,NE 107,Residential,28224,0,28224,149036,0,177260
113530601400000,NE 107,Residential,29260,0,29260,132895,0,162155
113530601500000,NE 107,Residential,27899,0,27899,110104,0,138003
113530601600000,NE 107,Residential,25545,0,25545,109781,0,135326
113530601700000,NE 107,Residential,23520,0,23520,132791,0,156311
113530601800000,NE 107,Residential,25984,0,25984,101818,0,127802
113530601900000,NE 107,Residential,25802,0,25802,134162,0,159964
113530602000000,NE 107,Residential,27812,0,27812,119095,0,146907
113530602100000,NE 107,Residential,30269,0,30269,126282,0,156551
113530602200000,NE 107,Residential,31147,0,31147,163853,0,195000
113530602300000,NE 107,Residential,26454,0,26454,127685,0,154139
113530602400000,NE 107,Residential,25595,0,25595,104691,0,130286
113530602500000,NE 107,Residential,19396,0,19396,128660,0,148056
113530602600000,NE 107,Residential,24868,0,24868,126118,0,150986
113530602700000,NE 107,Residential,21221,0,21221,107294,0,128515
113530602800000,NE 107,Residential,25148,0,25148,156806,0,181954
113530602900000,NE 107,Residential,21039,0,21039,127795,0,148834
113530603000000,NE 107,Residential,19866,0,19866,112015,0,131881
113530700100000,NE 107,Residential,25725,0,25725,128190,0,153915
113530700200000,NE 107,Residential,26185,0,26185,138155,0,164340
113530700300000,NE 107,Residential,26460,0,26460,141013,0,167473
113530700400000,NE 107,Residential,26056,0,26056,143030,0,169086
113530700500000,NE 107,Residential,27232,0,27232,128726,0,155958
113530700600000,NE 107,Residential,27930,0,27930,146073,0,174003
113530800100000,NE 107,Residential,26460,0,26460,114673,0,141133
113530800200000,NE 107,Residential,25468,0,25468,140196,0,165664
113530800300000,NE 107,Residential,25358,0,25358,124414,0,149772
113530800400000,NE 107,Residential,23888,0,23888,122140,0,146028
113530800500000,NE 107,Residential,25468,0,25468,118656,0,144124
113530800600000,NE 107,Residential,26521,0,26521,118455,0,144976
113530800700000,NE 107,Residential,29790,0,29790,125210,0,155000
113530800800000,NE 107,Residential,28538,0,28538,184998,0,213536
113530800900000,NE 107,Residential,28839,0,28839,167254,0,196093
113530801000000,NE 107,Residential,26347,0,26347,182304,0,208651
113532600100000,NE 107,Residential,26649,0,26649,122804,0,149453
113532600600000,NE 107,Residential,24941,0,24941,100659,0,125600
113532700100000,NE 107,Residential,26370,0,26370,142268,0,168638
113532700200000,NE 107,Residential,26422,0,26422,111868,0,138290
113532700300000,NE 107,Residential,24444,0,24444,127249,0,151693
113532700400000,NE 107,Residential,23940,0,23940,96070,0,120010
113532700500000,NE 107,Residential,26355,0,26355,149759,0,176114
113532700600000,NE 107,Residential,25366,0,25366,137094,0,162460
113532700700000,NE 107,Residential,25257,0,25257,94884,0,120141
113532700800000,NE 107,Residential,25071,0,25071,106336,0,131407
113532700900000,NE 107,Residential,24871,0,24871,125986,0,150857
113532701000000,NE 107,Residential,24010,0,24010,118591,0,142601
113532800100000,CHURCH,Exempt,0,421632,421632,0,474234,895866
113532800200000,NE 107,Residential,25464,0,25464,122650,0,148114
113532800300000,NE 107,Residential,25436,0,25436,153930,0,179366
113532800400000,NE 107,Residential,23134,0,23134,137158,0,160292
113532800500000,NE 107,Residential,23134,0,23134,121927,0,145061
113532800600000,NE 107,Residential,24276,0,24276,127987,0,152263
113532800700000,NE 107,Residential,25061,0,25061,134511,0,159572
113532800800000,NE 107,Residential,25806,0,25806,143469,0,169275
113532800900000,NE 107,Residential,26979,0,26979,130426,0,157405
113532900100000,NE 107,Residential,25836,0,25836,131958,0,157794
113532900200000,NE 107,Residential,23399,0,23399,93971,0,117370
113532900300000,NE 107,Residential,26855,0,26855,127566,0,154421
113532900400000,NE 107,Residential,22540,0,22540,103646,0,126186
113532900500000,NE 107,Residential,25123,0,25123,103895,0,129018
113533000100000,NE 107,Residential,25728,0,25728,111059,0,136787
113533000200000,NE 107,Residential,25430,0,25430,116402,0,141832
113533000300000,NE 107,Residential,25760,0,25760,130009,0,155769
113533000400000,NE 107,Residential,25161,0,25161,121404,0,146565
113533000500000,NE 107,Residential,25108,0,25108,93096,0,118204
113533000600000,NE 107,Residential,26250,0,26250,123613,0,149863
113533000700000,NE 107,Residential,26972,0,26972,100032,0,127004
113533000800000,NE 107,Residential,26239,0,26239,117701,0,143940
113533000900000,NE 107,Residential,25794,0,25794,124903,0,150697
113533001000000,NE 107,Residential,25490,0,25490,130939,0,156429
113533001100000,NE 107,Residential,25935,0,25935,121206,0,147141
113533001200000,NE 107,Residential,24938,0,24938,96572,0,121510
113533001300000,NE 107,Residential,25704,0,25704,102594,0,128298
113533001400000,NE 107,Residential,25933,0,25933,107556,0,133489
113533001500000,NE 107,Residential,25379,0,25379,121479,0,146858
113533001600000,NE 107,Residential,26712,0,26712,126649,0,153361
113533001700000,NE 107,Residential,26040,0,26040,136498,0,162538
113533001800000,NE 107,Residential,26101,0,26101,135096,0,161197
113533001900000,NE 107,Residential,25400,0,25400,125679,0,151079
113533002000000,NE 107,Residential,24881,0,24881,122617,0,147498
113533002100000,NE 107,Residential,24494,0,24494,116927,0,141421
113533002200000,NE 107,Residential,23828,0,23828,128027,0,151855
113533002300000,NE 107,Residential,26184,0,26184,114162,0,140346
113533100100000,NE 107,Residential,25558,0,25558,130214,0,155772
113533100200000,NE 107,Residential,27070,0,27070,122152,0,149222
113533100300000,NE 107,Residential,25956,0,25956,144044,0,170000
113533100400000,NE 107,Residential,25565,0,25565,111682,0,137247
113533100500000,NE 107,Exempt,0,25456,25456,0,122978,148434
113533100600000,NE 107,Residential,25294,0,25294,106077,0,131371
113533100700000,NE 107,Residential,25550,0,25550,98685,0,124235
113533100800000,NE 107,Residential,26567,0,26567,97134,0,123701
113533100900000,NE 107,Residential,26371,0,26371,129890,0,156261
113533101000000,NE 107,Residential,25187,0,25187,133601,0,158788
113533101100000,NE 107,Residential,26419,0,26419,102696,0,129115
113533101200000,NE 107,Residential,26068,0,26068,129413,0,155481
113533101300000,NE 107,Residential,25159,0,25159,139602,0,164761
113533101400000,NE 107,Residential,26567,0,26567,109408,0,135975
113533101500000,NE 107,Residential,23027,0,23027,117714,0,140741
113533101600000,NE 107,Residential,25760,0,25760,120050,0,145810
113533101700000,NE 107,Residential,22540,0,22540,110197,0,132737
113533101800000,NE 107,Residential,25430,0,25430,184603,0,210033
113533101900000,NE 107,Residential,25855,0,25855,132403,0,158258
113533102000000,NE 107,Residential,26697,0,26697,141407,0,168104
113533102100000,NE 107,Residential,25872,0,25872,133547,0,159419
113533102200000,NE 107,Residential,23660,0,23660,128306,0,151966
113533102300000,NE 107,Residential,25073,0,25073,135774,0,160847
113533102400000,NE 107,Residential,26712,0,26712,141807,0,168519
113533102500000,NE 107,Residential,30642,0,30642,150101,0,180743
113533102600000,NE 107,Residential,29575,0,29575,119494,0,149069
113533102700000,NE 107,Residential,26444,0,26444,78781,0,105225
113533102800000,NE 107,Residential,26185,0,26185,109552,0,135737
113533102900000,NE 107,Residential,26434,0,26434,124405,0,150839
113533103000000,NE 107,Residential,26250,0,26250,105209,0,131459
113533103100000,NE 107,Residential,26507,0,26507,119318,0,145825
113533103200000,NE 107,Residential,27741,0,27741,145440,0,173181
113533103300000,NE 107,Residential,34726,0,34726,117886,0,152612
113533103400000,NE 107,Residential,32889,0,32889,133077,0,165966
113533200100000,NE 107,Residential,25035,0,25035,150404,0,175439
113533200200000,NE 107,Residential,25725,0,25725,127671,0,153396
113533200300000,NE 107,Residential,25725,0,25725,167498,0,193223
113533200400000,NE 107,Residential,26250,0,26250,137762,0,164012
113533200500000,NE 107,Residential,26250,0,26250,143851,0,170101
113533200600000,NE 107,Residential,26250,0,26250,149566,0,175816
113533200700000,NE 107,Residential,22750,0,22750,135705,0,158455
113533200800000,NE 107,Residential,26250,0,26250,123949,0,150199
113533200900000,NE 107,Residential,25725,0,25725,130434,0,156159
113533201000000,NE 107,Residential,25802,0,25802,174940,0,200742
113533201100000,NE 107,Residential,26334,0,26334,146692,0,173026
113533201200000,NE 107,Residential,26233,0,26233,137064,0,163297
113533201300000,NE 107,Residential,22727,0,22727,129598,0,152325
113533201400000,NE 107,Residential,22680,0,22680,156439,0,179119
113533201500000,NE 107,Residential,22680,0,22680,124289,0,146969
113533201600000,NE 107,Residential,22680,0,22680,120293,0,142973
113533201700000,NE 107,Residential,26934,0,26934,110552,0,137486
113535100300000,NE 164,Residential,31442,0,31442,206637,0,238079
113535100400000,NE 164,Residential,30453,0,30453,132573,0,163026
113535100500000,NE 164,Residential,30294,0,30294,133924,0,164218
113535100600000,NE 164,Residential,30972,0,30972,153405,0,184377
113535100700000,NE 164,Residential,31580,0,31580,205898,0,237478
113535100800000,NE 164,Residential,32742,0,32742,169050,0,201792
113535100900000,NE 164,Residential,29964,0,29964,172694,0,202658
113535101000000,NE 164,Residential,30251,0,30251,169018,0,199269
113535101100000,NE 164,Residential,31167,0,31167,207433,0,238600
113535101200000,NE 164,Residential,28000,0,28000,168204,0,196204
113535101300000,NE 164,Residential,32040,0,32040,167371,0,199411
113535101400000,NE 164,Residential,29433,0,29433,192116,0,221549
113535101500000,NE 164,Residential,28062,0,28062,173973,0,202035
113535101600000,NE 164,Residential,57442,0,57442,256978,0,314420
113535101700000,NE 164,Residential,53996,0,53996,240504,0,294500
113535101800000,NE 164,Residential,50400,0,50400,236836,0,287236
113535101900000,NE 164,Residential,56700,0,56700,247524,0,304224
113535102000000,NE 164,Residential,55590,0,55590,227454,0,283044
113535102100000,NE 164,Residential,54519,0,54519,200238,0,254757
113535102200000,NE 164,Residential,57969,0,57969,278428,0,336397
113535102300000,NE 164,Residential,59340,0,59340,238319,0,297659
113535102400000,NE 164,Residential,55501,0,55501,196578,0,252079
113535102600000,NE 164,Residential,57085,0,57085,219923,0,277008
113535102700000,NE 164,Residential,54943,0,54943,264616,0,319559
113535102900000,NE 164,Residential,56732,0,56732,221648,0,278380
113535103000000,NE 164,Residential,53000,0,53000,245221,0,298221
113535103100000,NE 164,Residential,56026,0,56026,209409,0,265435
113535103200000,NE 164,Residential,51072,0,51072,236720,0,287792
113535103300000,NE 164,Residential,56618,0,56618,213489,0,270107
113535103400000,NE 164,Residential,57818,0,57818,218458,0,276276
113535103500000,NE 164,Residential,48323,0,48323,175474,0,223797
113535103600000,NE 164,Residential,51480,0,51480,220316,0,271796
113535103700000,NE 164,Residential,54936,0,54936,260026,0,314962
113535103800000,NE 164,Residential,55388,0,55388,231469,0,286857
113535103900000,NE 164,Residential,57215,0,57215,272126,0,329341
113535104000000,NE 164,Residential,54570,0,54570,247988,0,302558
113535104100000,NE 164,Residential,57780,0,57780,275464,0,333244
113535104200000,NE 164,Residential,55590,0,55590,219336,0,274926
113535104300000,NE 164,Residential,56943,0,56943,271697,0,328640
113535104400000,NE 164,Residential,47520,0,47520,0,0,47520
113535104500000,NE 164,Residential,15299,0,15299,0,0,15299
113535200100000,NE 164,Residential,31210,0,31210,191031,0,222241
113535200200000,NE 164,Residential,31016,0,31016,214502,0,245518
113535200300000,CITY PROPERTY,Exempt,0,0,0,0,0,0
113535200400000,NE 164,Residential,51660,0,51660,271513,0,323173
113535200500000,NE 164,Residential,53550,0,53550,257110,0,310660
113535200600000,NE 164,Residential,52920,0,52920,238298,0,291218
113535200700000,NE 164,Residential,47250,0,47250,226382,0,273632
113535200800000,NE 164,Residential,50400,0,50400,282632,0,333032
113535200900000,NE 164,Residential,52296,0,52296,241055,0,293351
113535201000000,NE 164,Residential,53372,0,53372,277458,0,330830
113535201100000,NE 164,Residential,54773,0,54773,305097,0,359870
113535201200000,NE 164,Residential,50400,0,50400,302247,0,352647
113535201300000,NE 164,Residential,53550,0,53550,238042,0,291592
113535201400000,NE 164,Residential,53934,0,53934,225939,0,279873
113535201500000,NE 164,Residential,54167,0,54167,283873,0,338040
113535201600000,NE 164,Residential,54167,0,54167,251482,0,305649
113535201700000,NE 164,Residential,54167,0,54167,267791,0,321958
113535201800000,NE 164,Residential,53382,0,53382,241130,0,294512
113535201900000,NE 164,Residential,47700,0,47700,229786,0,277486
113535300500000,NE 164,Residential,30131,0,30131,147067,0,177198
113535300600000,NE 164,Residential,30210,0,30210,154217,0,184427
113535300700000,NE 164,Residential,31747,0,31747,212336,0,244083
113535300800000,NE 164,Residential,31503,0,31503,173199,0,204702
113535400100000,NE 164,Residential,51012,0,51012,307029,0,358041
113535400200000,NE 164,Residential,54734,0,54734,222373,0,277107
113535400300000,NE 164,Residential,50400,0,50400,241222,0,291622
113535400400000,NE 164,Residential,46809,0,46809,238530,0,285339
113535400500000,NE 164,Residential,50400,0,50400,278491,0,328891
113535400600000,NE 164,Residential,53550,0,53550,264217,0,317767
113535400700000,NE 164,Residential,47250,0,47250,311343,0,358593
113535400800000,NE 164,Residential,50400,0,50400,216476,0,266876
113537600100000,NE 164,Residential,36777,0,36777,202620,0,239397
113537600200000,NE 164,Residential,35700,0,35700,225252,0,260952
113537600300000,NE 164,Residential,35700,0,35700,174958,0,210658
113537600400000,NE 164,Residential,35700,0,35700,176893,0,212593
113537600500000,NE 164,Residential,37928,0,37928,162173,0,200101
113537700100000,NE 164,Residential,36847,0,36847,182583,0,219430
113537700300000,NE 115,Residential,38540,0,38540,0,0,38540
113537700400000,NE 164,Residential,37312,0,37312,202621,0,239933
113537700500000,NE 164,Residential,35750,0,35750,213648,0,249398
113537700600000,NE 164,Residential,35446,0,35446,199985,0,235431
113537700700000,NE 164,Residential,36309,0,36309,240145,0,276454
113537700800000,NE 164,Residential,36608,0,36608,239312,0,275920
113537700900000,NE 164,Residential,37271,0,37271,208738,0,246009
113537701000000,NE 164,Residential,36105,0,36105,178426,0,214531
113537701200000,NE 164,Residential,49864,0,49864,312188,0,362052
113537701300000,NE 164,Residential,53550,0,53550,274432,0,327982
113537701400000,NE 164,Residential,53352,0,53352,223001,0,276353
113537701500000,NE 164,Residential,53352,0,53352,258275,0,311627
113537701600000,NE 164,Residential,54264,0,54264,273269,0,327533
113537701700000,NE 164,Residential,53736,0,53736,259251,0,312987
113537701800000,NE 164,Residential,49140,0,49140,254991,0,304131
113537701900000,NE 164,Residential,54998,0,54998,290260,0,345258
113537702000000,NE 164,Residential,57655,0,57655,280038,0,337693
113537800100000,NE 164,Residential,37713,0,37713,215574,0,253287
113537800200000,NE 164,Residential,35360,0,35360,253004,0,288364
113537800300000,NE 164,Residential,35360,0,35360,237318,0,272678
113537800400000,NE 164,Residential,35012,0,35012,196351,0,231363
113537800500000,NE 164,Residential,37207,0,37207,212481,0,249688
113537800600000,NE 164,Residential,38909,0,38909,180519,0,219428
113537800700000,NE 164,Residential,35994,0,35994,184833,0,220827
113537800800000,NE 164,Residential,30368,0,30368,167341,0,197709
113537800900000,NE 164,Residential,36608,0,36608,186424,0,223032
113537801000000,NE 164,Residential,36908,0,36908,176756,0,213664
113537900100000,NE 164,Residential,35784,0,35784,217538,0,253322
113537900200000,NE 164,Residential,31616,0,31616,191506,0,223122
113537900300000,NE 164,Residential,36608,0,36608,192717,0,229325
113542600100000,NE 107,Residential,29216,0,29216,136744,0,165960
113542600200000,NE 107,Residential,26347,0,26347,143768,0,170115
113542600300000,NE 107,Residential,26132,0,26132,132676,0,158808
113542600500000,NE 107,Residential,25578,0,25578,164768,0,190346
113542600600000,NE 107,Residential,26025,0,26025,137969,0,163994
113542600700000,NE 107,Residential,25490,0,25490,126043,0,151533
113542600800000,NE 107,Residential,25704,0,25704,133614,0,159318
113542600900000,NE 107,Residential,25704,0,25704,118834,0,144538
113542601000000,NE 107,Residential,25704,0,25704,125362,0,151066
113542601100000,NE 107,Residential,25009,0,25009,160491,0,185500
113542601200000,NE 107,Residential,25793,0,25793,157642,0,183435
113542601300000,NE 107,Residential,27132,0,27132,142007,0,169139
113542601400000,NE 107,Residential,27132,0,27132,119439,0,146571
113542601500000,NE 107,Residential,25793,0,25793,137167,0,162960
113542601600000,NE 107,Residential,25287,0,25287,137886,0,163173
113542601700000,NE 107,Residential,26019,0,26019,114378,0,140397
113542601800000,NE 107,Residential,26450,0,26450,126941,0,153391
113542601900000,NE 107,Residential,26490,0,26490,149996,0,176486
113542602000000,NE 107,Residential,24794,0,24794,112947,0,137741
113542602100000,NE 107,Residential,25725,0,25725,114659,0,140384
113542602200000,NE 107,Residential,26460,0,26460,104874,0,131334
113542602300000,NE 107,Residential,25725,0,25725,106043,0,131768
113542602400000,NE 107,Residential,26460,0,26460,110544,0,137004
113542700100000,NE 107,Residential,25411,0,25411,118820,0,144231
113542700200000,NE 107,Residential,22517,0,22517,122513,0,145030
113542700300000,NE 107,Residential,22407,0,22407,101814,0,124221
113542700400000,NE 107,Residential,25270,0,25270,120911,0,146181
113542800100000,NE 107,Residential,24529,0,24529,128248,0,152777
113542800200000,CITY PROPERTY,Exempt,0,0,0,0,0,0
113542800300000,NE 107,Residential,24967,0,24967,111326,0,136293
113542800400000,NE 107,Residential,24969,0,24969,131097,0,156066
113542800500000,NE 107,Residential,22919,0,22919,107312,0,130231
113542800600000,NE 107,Residential,25704,0,25704,138807,0,164511
113542800700000,NE 107,Residential,23098,0,23098,109718,0,132816
113542800800000,NE 107,Residential,22491,0,22491,146192,0,168683
113542800900000,NE 107,Residential,22491,0,22491,117374,0,139865
113542801000000,NE 107,Residential,22491,0,22491,108851,0,131342
113542801100000,NE 107,Residential,25187,0,25187,133038,0,158225
113542801200000,NE 107,Residential,24817,0,24817,136710,0,161527
113542801300000,NE 107,Residential,20160,0,20160,105894,0,126054
113542801400000,NE 107,Residential,20160,0,20160,104077,0,124237
113542801500000,NE 107,Residential,22034,0,22034,107391,0,129425
113542801600000,NE 107,Residential,20370,0,20370,127032,0,147402
113542801700000,NE 107,Residential,23765,0,23765,112433,0,136198
113542801800000,NE 107,Residential,20370,0,20370,100912,0,121282
113542801900000,NE 107,Residential,21932,0,21932,130575,0,152507
113542802000000,NE 107,Residential,20370,0,20370,113220,0,133590
113542900100000,NE 107,Residential,26241,0,26241,127741,0,153982
113542900200000,NE 107,Residential,21945,0,21945,126490,0,148435
113542900300000,NE 107,Residential,20580,0,20580,116444,0,137024
113542900400000,NE 107,Residential,20503,0,20503,103158,0,123661
113542900500000,NE 107,Residential,25725,0,25725,158963,0,184688
113542900600000,NE 107,Residential,22680,0,22680,119374,0,142054
113542900700000,NE 107,Residential,23520,0,23520,104853,0,128373
113542900800000,NE 107,Residential,25357,0,25357,126528,0,151885
113542900900000,NE 107,Residential,22591,0,22591,134618,0,157209
113542901000000,NE 107,Residential,21840,0,21840,119499,0,141339
113542901100000,NE 107,Residential,23072,0,23072,113785,0,136857
113542901200000,NE 107,Residential,21210,0,21210,108392,0,129602
113542901300000,NE 107,Residential,20790,0,20790,104017,0,124807
113542901400000,NE 107,Residential,20370,0,20370,106804,0,127174
113542901500000,NE 107,Residential,21714,0,21714,111276,0,132990
113542901600000,NE 107,Residential,25316,0,25316,134022,0,159338
122447800100000,NE 168,Ag Land,3525,0,3525,0,0,3525
122447800200000,NE 168,Residential,50000,0,50000,167089,0,217089
122510200200000,NE 168,Residential,69600,0,69600,0,0,69600
122510200700000,NE 168,Ag Dwelling,27677,0,27677,99198,9753,136628
122517600400000,NE 168,Ag Land,30172,0,30172,0,0,30172
122517600500000,NE 168,Residential,123750,0,123750,252954,0,376704
122517600600000,NE 168,Residential,108550,0,108550,0,0,108550
122540100100000,NE 168,Ag Dwelling,65407,0,65407,82997,10930,159334
122547600100000,NE 168,Residential,1440,0,1440,0,0,1440
122547600200000,NE 169,Residential,75550,0,75550,215912,0,291462
122547600300000,NE 169,Residential,75499,0,75499,218436,0,293935
122547600400000,NE 169,Residential,75501,0,75501,202986,0,278487
122547600500000,NE 169,Residential,75500,0,75500,250632,0,326132
122547600600000,NE 169,Residential,75500,0,75500,196812,0,272312
122547600700000,NE 169,Residential,75500,0,75500,227199,0,302699
122547600800000,NE 169,Residential,75500,0,75500,262226,0,337726
122547600900000,NE 169,Residential,75549,0,75549,241369,0,316918
122547601000000,NE 169,Residential,75549,0,75549,301552,0,377101
122547700100000,NE 169,Residential,74999,0,74999,246778,0,321777
122547700200000,NE 169,Residential,75000,0,75000,222638,0,297638
122547700300000,NE 169,Residential,74999,0,74999,282923,0,357922
122547700400000,NE 169,Residential,75000,0,75000,199161,0,274161
122547700500000,NE 169,Residential,75000,0,75000,209016,0,284016
122547700600000,NE 169,Residential,74900,0,74900,200308,0,275208
122547700700000,NE 169,Residential,75000,0,75000,252453,0,327453
122547700800000,NE 169,Residential,74999,0,74999,189174,0,264173
122547700900000,NE 169,Residential,75749,0,75749,225664,0,301413
122547701000000,NE 168,Ag Land,23751,0,23751,0,24740,48491
123610100100000,NE 168,Ag Dwelling,20206,0,20206,85011,1157,106374
123610100200000,NE 168,Residential,93700,0,93700,3404,0,97104
123610100300000,NE 168,Residential,52800,0,52800,119188,0,171988
123610100500000,NE 168,Residential,44620,0,44620,284494,0,329114
123610100600000,NE 168,Residential,44620,0,44620,298029,0,342649
123610100700000,NE 168,Residential,44620,0,44620,285952,0,330572
123610100800000,NE 168,Residential,44620,0,44620,296351,0,340971
123610100900000,NE 168,Residential,44620,0,44620,319353,0,363973
123610101000000,NE 168,Residential,44620,0,44620,292623,0,337243
123610101100000,NE 168,Residential,44620,0,44620,277674,0,322294
123610101200000,NE 168,Residential,44620,0,44620,257164,0,301784
123610101300000,NE 168,Residential,45080,0,45080,293783,0,338863
123610101400000,NE 168,Residential,45080,0,45080,0,0,45080
123610101500000,NE 168,Residential,45080,0,45080,0,0,45080
123610101600000,NE 168,Residential,49291,0,49291,119976,0,169267
123610200100000,NE 168,Residential,47276,0,47276,264619,0,311895
123610200200000,NE 168,Residential,47142,0,47142,311076,0,358218
123610200300000,NE 168,Residential,47142,0,47142,305106,0,352248
123610200400000,NE 168,Residential,47142,0,47142,305225,0,352367
123610200500000,NE 168,Residential,47142,0,47142,304872,0,352014
123610200600000,NE 168,Residential,47142,0,47142,308572,0,355714
123610200700000,NE 168,Residential,47142,0,47142,297990,0,345132
123610200800000,NE 168,Residential,47142,0,47142,279504,0,326646
123610200900000,NE 168,Residential,47142,0,47142,293832,0,340974
123610201000000,NE 168,Residential,47142,0,47142,316961,0,364103
123610201100000,NE 168,Residential,47142,0,47142,236878,0,284020
123610201200000,CITY PROPERTY,Exempt,0,0,0,0,0,0
123612600100000,NE 168,Residential,16300,0,16300,0,0,16300
123612600700000,NE 168,Residential,72100,0,72100,251538,0,323638
123617600100000,NE 168,Residential,52300,0,52300,150657,0,202957
123617600200000,NE 168,Residential,51850,0,51850,150295,0,202145
123617600300000,NE 168,Residential,51850,0,51850,187356,0,239206
123617600400000,NE 168,Residential,51850,0,51850,132996,0,184846
123617600500000,NE 168,Residential,51850,0,51850,165877,0,217727
123617600600000,NE 168,Residential,51850,0,51850,163338,0,215188
123617600700000,NE 168,Residential,51850,0,51850,137537,0,189387
123617600800000,NE 168,Residential,51850,0,51850,144926,0,196776
123617700100000,NE 168,Residential,51100,0,51100,206186,0,257286
123617700200000,NE 168,Residential,50600,0,50600,160477,0,211077
123617700300000,NE 168,Residential,50600,0,50600,161089,0,211689
123617700400000,NE 168,Residential,50600,0,50600,151485,0,202085
123617700500000,NE 168,Residential,50600,0,50600,162529,0,213129
123617700600000,NE 168,Residential,50600,0,50600,121276,0,171876
123617700700000,NE 168,Residential,50600,0,50600,141230,0,191830
123617700800000,NE 168,Residential,50600,0,50600,103709,0,154309
123617700900000,NE 168,Residential,50400,0,50400,228672,0,279072
123617701000000,NE 168,Residential,50150,0,50150,169511,0,219661
123617701100000,NE 168,Residential,50600,0,50600,134322,0,184922
123617701200000,NE 168,Residential,50600,0,50600,150996,0,201596
123617701300000,NE 168,Residential,50600,0,50600,228005,0,278605
123617701400000,NE 168,Residential,50600,0,50600,171435,0,222035
123617701500000,NE 168,Residential,50600,0,50600,178658,0,229258
123617701600000,NE 168,Residential,51450,0,51450,190623,0,242073
123617800100000,NE 168,Residential,50850,0,50850,172717,0,223567
123617800200000,NE 168,Residential,50800,0,50800,234713,0,285513
123617800300000,NE 168,Residential,50800,0,50800,164276,0,215076
123617800400000,NE 168,Residential,51100,0,51100,165556,0,216656
123617800500000,NE 168,Residential,50550,0,50550,198967,0,249517
123617800600000,NE 168,Residential,51900,0,51900,101971,0,153871
123617800700000,NE 168,Residential,50350,0,50350,158433,0,208783
123617800800000,NE 168,Residential,50300,0,50300,141791,0,192091
123640100100000,NE 168,Residential,50020,0,50020,136168,0,186188
123640100200000,NE 168,Residential,50020,0,50020,141226,0,191246
123640100300000,NE 168,Residential,50020,0,50020,142250,0,192270
123640100400000,NE 168,Residential,50020,0,50020,129940,0,179960
123640100500000,NE 168,Residential,50020,0,50020,153264,0,203284
123640100600000,NE 168,Residential,50020,0,50020,131790,0,181810
123640200100000,NE 168,Residential,50720,0,50720,112188,0,162908
123640200200000,NE 168,Residential,50720,0,50720,158608,0,209328
123640200300000,NE 168,Residential,50720,0,50720,149177,0,199897
123640200400000,NE 168,Residential,50720,0,50720,201929,0,252649
123640200500000,NE 168,Residential,50720,0,50720,135706,0,186426
123640200700000,NE 168,Residential,50000,0,50000,178327,0,228327
123640200800000,NE 168,Residential,50000,0,50000,134667,0,184667
123640200900000,NE 168,Residential,50000,0,50000,86019,0,136019
123640201000000,NE 168,Residential,45496,0,45496,136633,0,182129
123640201100000,COUNTY PROPERTY,Exempt,0,0,0,0,0,0
123640201300000,NE 172,Residential,134,0,134,0,0,134
123640201400000,NE 172,Residential,35672,0,35672,32448,0,68120
123640201500000,NE 172,Residential,35672,0,35672,32448,0,68120
123640201600000,NE 172,Residential,35252,0,35252,93383,0,128635
123640300100000,NE 172,Residential,43900,0,43900,171892,0,215792
123640300200000,NE 172,Residential,44680,0,44680,212347,0,257027
123640300300000,NE 172,Residential,45746,0,45746,185100,0,230846
123640300400000,NE 172,Residential,52458,0,52458,207315,0,259773
123640300500000,NE 172,Residential,49599,0,49599,210044,0,259643
123640300600000,NE 172,Residential,48960,0,48960,260113,0,309073
123640300700000,CITY PROPERTY,Exempt,0,0,0,0,0,0
123640300800000,NE 172,Residential,52240,0,52240,0,0,52240
123640300900000,NE 172,Residential,58214,0,58214,0,0,58214
123640301000000,NE 172,Residential,56769,0,56769,0,0,56769
123640301100000,NE 172,Residential,60420,0,60420,280463,0,340883
123640301200000,NE 172,Residential,51938,0,51938,230305,0,282243
123640301300000,NE 172,Residential,56160,0,56160,206372,0,262532
123640301400000,NE 172,Residential,57970,0,57970,240521,0,298491
123640301500000,NE 172,Residential,53000,0,53000,252680,0,305680
123640301600000,NE 172,Residential,58320,0,58320,252819,0,311139
123640301700000,NE 172,Residential,58982,0,58982,0,0,58982
123640301800000,NE 172,Residential,57906,0,57906,209094,0,267000
123640301900000,NE 172,Ag Land,6426,0,6426,0,0,6426
123640400100000,NE 172,Residential,43026,0,43026,170361,0,213387
123640400200000,NE 172,Residential,42926,0,42926,0,0,42926
123640400300000,NE 172,Residential,42400,0,42400,0,0,42400
123640400400000,NE 172,Residential,43262,0,43262,175862,0,219124
123640400500000,NE 172,Residential,40836,0,40836,197944,0,238780
123640400600000,NE 172,Residential,40068,0,40068,0,0,40068
123640400700000,NE 172,Residential,54475,0,54475,210770,0,265245
123640400800000,NE 172,Residential,45644,0,45644,0,0,45644
123640400900000,NE 172,Residential,47951,0,47951,196860,0,244811
123640401000000,NE 172,Residential,56802,0,56802,182436,0,239238
123640401100000,NE 172,Residential,45578,0,45578,193596,0,239174
123640401200000,NE 172,Residential,49500,0,49500,221297,0,270797
123640401300000,NE 172,Residential,49028,0,49028,217044,0,266072
123640401400000,NE 172,Residential,60221,0,60221,225579,0,285800
123640401500000,NE 172,Residential,66240,0,66240,261869,0,328109
123640401600000,NE 172,Residential,54621,0,54621,280927,0,335548
123642600100000,NE 172,Residential,309000,0,309000,9770,0,318770
123642600700000,NE 172,Residential,52626,0,52626,329475,0,382101
123642600800000,NE 172,Residential,49561,0,49561,260043,0,309604
123642600900000,NE 172,Residential,48668,0,48668,311529,0,360197
123642601000000,NE 172,Residential,47775,0,47775,279743,0,327518
123642700100000,NE 172,Residential,45900,0,45900,328190,0,374090
123642700200000,NE 172,Residential,45050,0,45050,326000,0,371050
123642700300000,NE 172,Residential,44200,0,44200,312584,0,356784
123642700400000,NE 172,Residential,59610,0,59610,0,0,59610
123642700500000,NE 172,Residential,36110,0,36110,0,0,36110
123642700600000,NE 172,Residential,79560,0,79560,52459,0,132019
123642700700000,NE 172,Residential,56610,0,56610,78756,0,135366
123642700800000,NE 172,Residential,83640,0,83640,79037,0,162677
123642700900000,NE 172,Residential,62160,0,62160,81074,0,143234
123642701000000,NE 172,Residential,53760,0,53760,364084,0,417844
123642701100000,NE 172,Residential,53280,0,53280,374158,0,427438
123642701200000,NE 172,Residential,48960,0,48960,351985,0,400945
123642800100000,NE 172,Residential,52700,0,52700,38230,0,90930
123642800200000,NE 172,Residential,46410,0,46410,244418,0,290828
123642800300000,NE 172,Residential,46920,0,46920,258626,0,305546
123642800400000,NE 172,Residential,54500,0,54500,296505,0,351005
123642800500000,NE 172,Residential,62100,0,62100,275700,0,337800
123645100300000,NE 172,Residential,48500,0,48500,0,0,48500
123645100400000,NE 172,Residential,620,0,620,0,0,620
123645100500000,NE 172,Residential,45000,0,45000,371385,0,416385
123645100600000,NE 172,Residential,44550,0,44550,0,0,44550
123645100700000,NE 172,Residential,53883,0,53883,346740,0,400623
123645100800000,NE 172,Residential,44550,0,44550,282812,0,327362
123645100900000,NE 172,Residential,54000,0,54000,282792,0,336792
123647600300000,NE 172,Residential,42120,0,42120,120241,0,162361
123647600400000,NE 172,Residential,42120,0,42120,102801,0,144921
123647600500000,NE 172,Residential,48731,0,48731,137392,0,186123
123647600600000,NE 172,Residential,46592,0,46592,176285,0,222877
123647600700000,NE 172,Residential,52668,0,52668,208077,0,260745
123647600800000,NE 172,Residential,45120,0,45120,175314,0,220434
123647600900000,NE 172,Residential,40656,0,40656,165754,0,206410
123647601000000,NE 172,Residential,44965,0,44965,218010,0,262975
123647601100000,NE 172,Residential,43033,0,43033,211530,0,254563
123647601200000,NE 172,Residential,42846,0,42846,252816,0,295662
123647601300000,NE 172,Residential,36375,0,36375,0,0,36375
123647601400000,NE 172,Residential,46350,0,46350,0,0,46350
123647601500000,NE 172,Residential,44940,0,44940,185164,0,230104
123647601600000,NE 172,Residential,43785,0,43785,0,0,43785
123647601700000,NE 172,Residential,49310,0,49310,0,0,49310
123647601800000,NE 172,Residential,49978,0,49978,0,0,49978
123647601900000,NE 172,Residential,50616,0,50616,189131,0,239747
123647602400000,NE 172,Residential,160,0,160,0,0,160
123647602500000,NE 172,Residential,142,0,142,0,0,142
123647602600000,NE 172,Residential,142,0,142,0,0,142
123647602700000,NE 172,Residential,33581,0,33581,119097,0,152678
123647602800000,NE 172,Residential,288,0,288,0,0,288
123647602900000,NE 172,Residential,35056,0,35056,116161,0,151217
123647603000000,NE 172,Residential,32928,0,32928,118431,0,151359
123647603100000,NE 172,Residential,33339,0,33339,132735,0,166074
123647603200000,NE 172,Residential,35129,0,35129,135598,0,170727
123647603300000,NE 172,Residential,37240,0,37240,135048,0,172288
123647603400000,NE 172,Residential,37800,0,37800,135787,0,173587
123647603500000,NE 172,Residential,37800,0,37800,3876,0,41676
123647603600000,NE 172,Residential,37800,0,37800,86528,0,124328
123647603700000,NE 172,Residential,37100,0,37100,74388,0,111488
123647603800000,NE 172,Residential,35700,0,35700,74388,0,110088
123647603900000,NE 172,Residential,35534,0,35534,95003,0,130537
123647604000000,NE 172,Residential,33273,0,33273,32268,0,65541
123647604100000,NE 172,Residential,31500,0,31500,79813,0,111313
123647604200000,NE 172,Residential,34561,0,34561,78779,0,113340
123647604300000,NE 172,Residential,37838,0,37838,107694,0,145532
123647900100000,NE 172,Residential,46180,0,46180,171849,0,218029
123647900200000,NE 172,Residential,41552,0,41552,217333,0,258885
123647900300000,NE 172,Residential,41370,0,41370,223303,0,264673
123647900400000,NE 172,Residential,44642,0,44642,182441,0,227083
123647900500000,NE 172,Residential,42192,0,42192,177842,0,220034
123647900600000,NE 172,Residential,41405,0,41405,171151,0,212556
123647900700000,NE 172,Residential,42675,0,42675,152704,0,195379
123647900800000,NE 172,Residential,45938,0,45938,167540,0,213478
123647900900000,NE 172,Residential,47480,0,47480,210803,0,258283
123647901000000,NE 172,Residential,32982,0,32982,0,0,32982
123647901100000,NE 172,Residential,27713,0,27713,0,0,27713
123647901200000,NE 172,Residential,44909,0,44909,170520,0,215429
123647901300000,NE 172,Residential,43177,0,43177,189756,0,232933
123647901400000,NE 172,Residential,42531,0,42531,215806,0,258337
123647901500000,NE 172,Residential,47168,0,47168,207412,0,254580
123647901600000,NE 172,Residential,43894,0,43894,221586,0,265480
123647901700000,NE 172,Residential,44606,0,44606,214170,0,258776
123648000100000,NE 172,Residential,40352,0,40352,0,0,40352
123648000200000,NE 172,Residential,40940,0,40940,43649,0,84589
123648000300000,NE 172,Residential,40319,0,40319,205586,0,245905
123648000400000,NE 172,Residential,41006,0,41006,0,0,41006
123648000500000,NE 172,Residential,36266,0,36266,183714,0,219980
123648000600000,NE 172,Residential,7,0,7,0,0,7
123648000700000,NE 172,Residential,16,0,16,0,0,16
123648000800000,NE 172,Residential,45512,0,45512,0,0,45512
123648000900000,SCHOOL,Exempt,0,0,0,0,0,0
123648001000000,NE 172,Residential,47524,0,47524,0,0,47524
123648001100000,NE 172,Residential,42248,0,42248,0,0,42248
123648001200000,NE 172,Residential,161,0,161,0,0,161
123648001300000,NE 172,Residential,47520,0,47520,214021,0,261541
123648001400000,NE 172,Residential,44640,0,44640,221787,0,266427
123648001500000,NE 172,Residential,42960,0,42960,199815,0,242775
123648001600000,NE 172,Residential,52590,0,52590,196577,0,249167
123648001700000,NE 172,Residential,52608,0,52608,187556,0,240164
123648001800000,NE 172,Residential,56114,0,56114,190821,0,246935
123648001900000,NE 172,Residential,50880,0,50880,213052,0,263932
123648002000000,NE 172,Residential,53352,0,53352,232557,0,285909
123648002100000,NE 172,Residential,204,0,204,0,0,204
123648100100000,NE 172,Residential,239,0,239,0,0,239
123648100200000,NE 172,Residential,33600,0,33600,110452,0,144052
123648100300000,NE 172,Residential,33950,0,33950,111223,0,145173
123648100400000,NE 172,Residential,289,0,289,0,0,289
123648100500000,NE 172,Residential,36751,0,36751,113530,0,150281
123648100600000,NE 172,Residential,34494,0,34494,101745,0,136239
123648100700000,NE 172,Residential,33124,0,33124,91215,0,124339
123648100800000,NE 172,Residential,33488,0,33488,108609,0,142097
123648100900000,NE 172,Residential,38734,0,38734,30184,0,68918
123648101000000,NE 172,Residential,221,0,221,0,0,221
123648101100000,NE 172,Residential,236,0,236,0,0,236
123648101200000,NE 172,Residential,32900,0,32900,149892,0,182792
123648101300000,NE 172,Residential,150,0,150,0,0,150
123648101400000,NE 172,Residential,169,0,169,0,0,169
123648101500000,NE 172,Residential,247,0,247,0,0,247
130140100100000,NE 161,Residential,42575,0,42575,233190,0,275765
130140100200000,NE 161,Residential,42500,0,42500,249739,0,292239
130140100300000,NE 161,Residential,42500,0,42500,241729,0,284229
130140100400000,NE 161,Residential,42500,0,42500,180455,0,222955
130140100500000,NE 161,Residential,42500,0,42500,0,0,42500
130140100600000,NE 161,Residential,42500,0,42500,242182,0,284682
130140100700000,NE 161,Residential,42500,0,42500,243725,0,286225
130140100800000,NE 161,Residential,42500,0,42500,220010,0,262510
130140100900000,NE 161,Residential,47667,0,47667,199048,0,246715
130140101000000,NE 161,Residential,42500,0,42500,236518,0,279018
130140101100000,NE 161,Residential,42500,0,42500,0,0,42500
130140200100000,NE 161,Residential,43350,0,43350,217902,0,261252
130140200200000,NE 161,Residential,46750,0,46750,238544,0,285294
130140200300000,NE 161,Residential,46027,0,46027,261848,0,307875
130140200400000,NE 161,Residential,44752,0,44752,324518,0,369270
130140200500000,NE 161,Residential,42349,0,42349,279307,0,321656
130140200600000,NE 161,Residential,48675,0,48675,215503,0,264178
130140200700000,NE 161,Residential,46315,0,46315,311012,0,357327
130140200800000,NE 161,Residential,45591,0,45591,210844,0,256435
130140200900000,NE 161,Residential,44752,0,44752,214173,0,258925
130140201000000,NE 161,Residential,48150,0,48150,0,0,48150
130140201200000,NE 161,Residential,1110,0,1110,0,0,1110
130140201300000,NE 161,Residential,1090,0,1090,0,0,1090
130140201400000,NE 161,Residential,1045,0,1045,0,0,1045
130140201500000,NE 161,Residential,1050,0,1050,0,0,1050
130140201600000,NE 161,Residential,55539,0,55539,408801,0,464340
130140201700000,NE 161,Residential,58810,0,58810,263398,0,322208
130140201800000,NE 161,Residential,55242,0,55242,223131,0,278373
130140201900000,NE 161,Residential,61778,0,61778,496423,0,558201
130140202000000,NE 161,Residential,59836,0,59836,232793,0,292629
130140202100000,NE 161,Residential,73489,0,73489,292347,0,365836
130140202200000,NE 161,Residential,65016,0,65016,277947,0,342963
130140202300000,NE 161,Residential,61603,0,61603,361568,0,423171
130140202400000,NE 161,Residential,56644,0,56644,0,0,56644
130140202500000,NE 161,Residential,54683,0,54683,251691,0,306374
130140202600000,NE 161,Residential,55080,0,55080,0,0,55080
130140202700000,NE 161,Residential,55080,0,55080,0,0,55080
130140300100000,NE 161,Residential,53742,0,53742,236055,0,289797
130140300200000,NE 161,Residential,42797,0,42797,249862,0,292659
130140300300000,NE 161,Residential,44550,0,44550,236034,0,280584
130140300400000,NE 161,Residential,46863,0,46863,274249,0,321112
130140300500000,NE 161,Residential,54000,0,54000,0,0,54000
130140300600000,NE 161,Residential,54900,0,54900,319057,0,373957
130140300700000,NE 161,Residential,53244,0,53244,291472,0,344716
130140300800000,NE 161,Residential,56304,0,56304,235272,0,291576
130140300900000,NE 161,Residential,53489,0,53489,258810,0,312299
130140400100000,NE 128,Residential,20350,0,20350,0,0,20350
130142700100000,NE 161,Residential,78100,0,78100,0,0,78100
130142700200000,NE 161,Residential,47736,0,47736,0,0,47736
130142700300000,NE 161,Residential,47974,0,47974,227026,0,275000
130142700400000,NE 161,Residential,48960,0,48960,0,0,48960
130142700500000,NE 161,Residential,47124,0,47124,323596,0,370720
130142700600000,NE 161,Residential,47124,0,47124,261250,0,308374
130142700700000,NE 161,Residential,48960,0,48960,300831,0,349791
130142700800000,NE 161,Residential,47736,0,47736,389894,0,437630
130142700900000,NE 161,Residential,43834,0,43834,0,0,43834
130142701000000,NE 161,Residential,54810,0,54810,322236,0,377046
130142701100000,NE 161,Residential,55003,0,55003,0,0,55003
130142701200000,NE 161,Residential,62550,0,62550,353556,0,416106
130142701300000,NE 161,Residential,56222,0,56222,0,0,56222
130142701400000,NE 161,Residential,52020,0,52020,231650,0,283670
130142701500000,NE 161,Residential,52020,0,52020,0,0,52020
130142701600000,NE 161,Residential,57900,0,57900,0,0,57900
130142800100000,NE 161,Residential,53489,0,53489,313271,0,366760
130142800200000,NE 161,Residential,53560,0,53560,219083,0,272643
130145100100000,SCHOOL,Exempt,0,1173960,1173960,0,14363622,15537582
130145200100000,NE 128,Residential,32450,0,32450,73212,0,105662
130147600100000,NE 128,Residential,120042,0,120042,250374,0,370416
130147600200000,NE 128,Residential,58345,0,58345,0,0,58345
130147600300000,NE 128,Residential,150000,0,150000,487306,0,637306
130147600400000,NE 128,Residential,121769,0,121769,510345,0,632114
130147600500000,NE 128,Residential,115851,0,115851,313029,0,428880
130147600600000,NE 128,Residential,114501,0,114501,271412,0,385913
130147600700000,NE 128,Residential,124499,0,124499,411866,0,536365
130147600800000,NE 128,Residential,147558,0,147558,460499,0,608057
130147600900000,NE 128,Residential,140251,0,140251,466177,0,606428
130147601000000,NE 128,Residential,152550,0,152550,347688,0,500238
130147601100000,NE 128,Residential,128414,0,128414,483041,0,611455
130147601200000,NE 128,Residential,122429,0,122429,357699,0,480128
130147601300000,NE 128,Residential,114379,0,114379,337391,0,451770
130147601400000,NE 128,Residential,111100,0,111100,272244,0,383344
130147601500000,NE 128,Residential,112320,0,112320,425428,0,537748
130147601600000,NE 128,Residential,111240,0,111240,538641,0,649881
130147601700000,NE 128,Residential,71974,0,71974,0,0,71974
130147602000000,NE 128,Residential,65200,0,65200,110698,0,175898
130147602700000,NE 128,Residential,2100,0,2100,0,0,2100
130147800100000,NE 128,Residential,109036,0,109036,476051,0,585087
130147800200000,NE 128,Residential,102960,0,102960,403028,0,505988
130147800300000,NE 128,Residential,112320,0,112320,497785,0,610105
130147800400000,NE 128,Residential,106609,0,106609,316776,0,423385
130147800500000,NE 128,Residential,20,0,20,0,0,20
130147900100000,NE 128,Residential,110140,0,110140,377789,0,487929
130147900200000,NE 128,Residential,112320,0,112320,279820,0,392140
130147900300000,NE 128,Residential,83430,0,83430,691928,0,775358
130147900400000,NE 128,Residential,53227,0,53227,0,0,53227
131140100100000,NE 165,Residential,787600,0,787600,1744229,0,2531829
131147600100000,CITY PROPERTY,Exempt,0,0,0,0,0,0
131212600300000,NE 128,Residential,50490,0,50490,107113,0,157603
131220100100000,NE 165,Residential,44458,0,44458,312169,0,356627
131220100200000,NE 165,Residential,43289,0,43289,364540,0,407829
131220100300000,NE 165,Residential,47072,0,47072,255784,0,302856
131220100400000,NE 165,Residential,46060,0,46060,284229,0,330289
131220100500000,NE 165,Residential,49680,0,49680,368826,0,418506
131220100600000,NE 165,Residential,51187,0,51187,357153,0,408340
131220100700000,NE 165,Residential,49440,0,49440,417656,0,467096
131220100800000,NE 165,Residential,60233,0,60233,348081,0,408314
131220100900000,NE 165,Residential,58594,0,58594,0,0,58594
131220101000000,NE 165,Residential,61803,0,61803,433997,0,495800
131220101100000,NE 165,Residential,60533,0,60533,374467,0,435000
131220101200000,NE 165,Residential,61803,0,61803,435066,0,496869
131220101300000,NE 165,Residential,64065,0,64065,432921,0,496986
131220101400000,NE 165,Residential,61651,0,61651,379497,0,441148
131220101500000,NE 165,Residential,58743,0,58743,308329,0,367072
131220101600000,NE 165,Residential,59863,0,59863,0,0,59863
131220101700000,NE 165,Residential,69572,0,69572,457830,0,527402
131220101800000,NE 165,Residential,62510,0,62510,455695,0,518205
131220101900000,NE 165,Residential,64365,0,64365,342358,0,406723
131220102000000,NE 165,Residential,100400,0,100400,562347,0,662747
131220102100000,NE 165,Residential,77974,0,77974,0,0,77974
131220102200000,NE 165,Residential,104500,0,104500,659851,0,764351
131220102300000,NE 165,Residential,86672,0,86672,626171,0,712843
131220102400000,NE 165,Residential,86888,0,86888,383112,0,470000
131220102500000,NE 165,Residential,100700,0,100700,406882,0,507582
131220102600000,NE 165,Residential,84179,0,84179,466386,0,550565
131220102900000,NE 165,Residential,46500,0,46500,1856,0,48356
131220103000000,NE 165,Residential,50000,0,50000,562241,0,612241
131220103100000,NE 165,Residential,56863,0,56863,461605,0,518468
131220103200000,NE 165,Residential,51493,0,51493,474193,0,525686
131220103300000,NE 165,Residential,51300,0,51300,381637,0,432937
131220103400000,NE 165,Residential,51775,0,51775,477988,0,529763
131220103500000,NE 165,Residential,63588,0,63588,420575,0,484163
131220103600000,NE 165,Residential,63750,0,63750,431927,0,495677
131220103700000,NE 165,Residential,61349,0,61349,463651,0,525000
131220103800000,NE 165,Residential,61609,0,61609,376377,0,437986
131220103900000,NE 165,Residential,48384,0,48384,235558,0,283942
131220104000000,NE 165,Residential,49169,0,49169,0,0,49169
131220104100000,NE 165,Residential,63832,0,63832,517975,0,581807
131220104200000,NE 165,Residential,60180,0,60180,377238,0,437418
131220104300000,NE 165,Residential,62006,0,62006,408671,0,470677
131220104400000,NE 165,Residential,55767,0,55767,422713,0,478480
131220104500000,NE 165,Residential,45900,0,45900,0,0,45900
131220104600000,NE 165,Residential,58154,0,58154,418358,0,476512
131220104700000,NE 165,Residential,49379,0,49379,317245,0,366624
131220104800000,NE 165,Residential,50575,0,50575,471373,0,521948
131220104900000,NE 165,Residential,52351,0,52351,486782,0,539133
131220105000000,NE 165,Residential,56206,0,56206,390123,0,446329
131220105100000,NE 165,Residential,49147,0,49147,389482,0,438629
131222700100000,NE 165,Residential,81280,0,81280,392710,0,473990
131222700200000,NE 165,Residential,78511,0,78511,352764,0,431275
131222700300000,NE 165,Residential,70612,0,70612,0,0,70612
131222700400000,NE 165,Residential,76152,0,76152,0,0,76152
131222700500000,NE 165,Residential,82536,0,82536,383382,0,465918
131222700600000,NE 165,Residential,80520,0,80520,0,0,80520
131222700700000,NE 165,Residential,92500,0,92500,0,0,92500
131222700800000,NE 165,Residential,87840,0,87840,564205,0,652045
131222700900000,NE 165,Residential,100100,0,100100,567308,0,667408
131222701000000,NE 165,Residential,74412,0,74412,426269,0,500681
131222701100000,NE 165,Residential,81058,0,81058,488379,0,569437
131222701200000,NE 165,Residential,84710,0,84710,425290,0,510000
131222701300000,NE 165,Residential,104300,0,104300,545978,0,650278
131222701400000,NE 165,Residential,104400,0,104400,538586,0,642986
131222701500000,NE 165,Residential,92207,0,92207,0,0,92207
131222701600000,NE 165,Residential,68972,0,68972,0,0,68972
131222701700000,NE 165,Residential,83402,0,83402,534728,0,618130
131222701800000,NE 165,Residential,92862,0,92862,443263,0,536125
131222702000000,NE 151,Residential,74851,0,74851,0,0,74851
131222702100000,NE 151,Residential,86580,0,86580,572833,0,659413
131222702200000,NE 151,Residential,76608,0,76608,0,0,76608
131222702300000,NE 151,Residential,84180,0,84180,305009,0,389189
131222702400000,NE 151,Residential,71350,0,71350,0,0,71350
131222800100000,NE 151,Residential,62643,0,62643,0,0,62643
131225100100000,NE 165,Residential,96289,0,96289,0,0,96289
131225100500000,NE 165,Residential,100650,0,100650,574350,0,675000
131225100600000,NE 165,Residential,653,0,653,0,0,653
131225100700000,NE 165,Residential,191,0,191,0,0,191
131225100800000,NE 165,Residential,125400,0,125400,486825,0,612225
131225100900000,NE 165,Residential,86550,0,86550,0,0,86550
131225101000000,NE 165,Residential,86894,0,86894,0,0,86894
131225101100000,NE 165,Residential,75000,0,75000,0,0,75000
131225101200000,NE 165,Residential,130422,0,130422,464578,0,595000
131225101300000,NE 165,Residential,101600,0,101600,1007040,0,1108640
131225101400000,NE 165,Residential,128360,0,128360,748589,0,876949
131225101500000,NE 165,Residential,101440,0,101440,655382,0,756822
131225101600000,NE 165,Residential,87858,0,87858,0,0,87858
131225101700000,NE 165,Residential,103040,0,103040,506213,0,609253
131225101800000,NE 165,Residential,102480,0,102480,590620,0,693100
131225101900000,NE 165,Residential,86275,0,86275,0,0,86275
131225102000000,NE 165,Residential,101250,0,101250,495793,0,597043
131225102200000,NE 151,Residential,72595,0,72595,0,0,72595
131225102300000,NE 151,Residential,102524,0,102524,0,0,102524
131225102400000,NE 151,Residential,127800,0,127800,550805,0,678605
131225102500000,NE 151,Residential,71686,0,71686,0,0,71686
131225102600000,NE 151,Residential,71557,0,71557,0,0,71557
131225102700000,NE 151,Residential,141900,0,141900,0,0,141900
131225102800000,NE 151,Residential,90476,0,90476,513743,0,604219
131225102900000,NE 151,Residential,61110,0,61110,0,0,61110
131225103000000,NE 151,Residential,58176,0,58176,0,0,58176
131225103100000,NE 151,Residential,68384,0,68384,0,0,68384
131225103200000,NE 151,Residential,69156,0,69156,287118,0,356274
131225103400000,NE 151,Residential,11980,0,11980,0,0,11980
131225103500000,NE 151,Residential,8497,0,8497,0,0,8497
131225103600000,NE 151,Residential,8855,0,8855,0,0,8855
131225103700000,NE 151,Residential,5265,0,5265,0,0,5265
131225103800000,NE 165,Residential,145000,0,145000,699320,0,844320
131227600100000,NE 151,Residential,65000,0,65000,119430,0,184430
131227600200000,NE 151,Residential,84900,0,84900,170807,0,255707
131227600300000,NE 165,Residential,100152,0,100152,481848,0,582000
131227600400000,NE 165,Residential,85428,0,85428,495248,0,580676
131227600500000,NE 165,Residential,100400,0,100400,511466,0,611866
131227600600000,NE 165,Residential,100960,0,100960,552670,0,653630
131227600700000,NE 165,Residential,95957,0,95957,512537,0,608494
131227600800000,NE 165,Residential,100080,0,100080,536513,0,636593
131227700100000,NE 165,Residential,89154,0,89154,607555,0,696709
131227700200000,NE 165,Residential,93380,0,93380,513292,0,606672
131227800100000,NE 151,Residential,166800,0,166800,0,0,166800
131227900100000,NE 165,Residential,93816,0,93816,0,0,93816
131227900200000,NE 165,Residential,88920,0,88920,506102,0,595022
131227900300000,NE 165,Residential,94160,0,94160,767921,0,862081
131227900400000,NE 165,Residential,101200,0,101200,0,0,101200
131227900600000,NE 151,Residential,60000,0,60000,119497,0,179497
131227900700000,NE 151,Residential,60000,0,60000,123947,0,183947
131227900800000,NE 165,Residential,100960,0,100960,497390,0,598350
131227901100000,NE 165,Residential,5200,0,5200,0,0,5200
131227901200000,NE 165,Residential,90059,0,90059,0,0,90059
131227901300000,NE 165,Residential,86206,0,86206,0,0,86206
131230100300000,NE 151,Residential,40008,0,40008,312435,0,352443
131230100400000,NE 151,Residential,36448,0,36448,0,0,36448
131230100500000,NE 151,Residential,40498,0,40498,267666,0,308164
131230100600000,NE 151,Residential,36448,0,36448,0,0,36448
131230100700000,NE 151,Residential,38473,0,38473,0,0,38473
131230100800000,NE 151,Residential,40498,0,40498,305422,0,345920
131230100900000,NE 151,Residential,39586,0,39586,0,0,39586
131230101000000,NE 151,Residential,74450,0,74450,0,0,74450
131230200200000,NE 151,Residential,11500,0,11500,0,0,11500
131230200300000,NE 151,Residential,72000,0,72000,102832,0,174832
131230200600000,NE 151,Residential,47376,0,47376,0,0,47376
131230200700000,NE 151,Residential,43428,0,43428,0,0,43428
131230200800000,NE 151,Residential,51640,0,51640,0,0,51640
131230200900000,NE 151,Residential,66537,0,66537,0,0,66537
131230201100000,NE 151,Residential,89833,0,89833,328446,0,418279
131230201200000,NE 151,Residential,51333,0,51333,359563,0,410896
131230201300000,NE 151,Residential,57200,0,57200,310980,0,368180
131230201400000,NE 151,Residential,57200,0,57200,366183,0,423383
131230201500000,NE 151,Residential,52000,0,52000,449157,0,501157
131230201600000,NE 151,Residential,50985,0,50985,269885,0,320870
131230201700000,NE 151,Residential,61749,0,61749,0,0,61749
131230201800000,NE 151,Residential,109925,0,109925,429864,0,539789
131230201900000,NE 151,Residential,1620,0,1620,0,0,1620
131230202000000,NE 151,Residential,70132,0,70132,0,0,70132
131230300100000,NE 151,Residential,44160,0,44160,261069,0,305229
131230300200000,NE 151,Residential,36260,0,36260,197572,0,233832
131230300300000,NE 151,Residential,36260,0,36260,251780,0,288040
131230300400000,NE 151,Residential,36260,0,36260,197123,0,233383
131230300500000,NE 151,Residential,33590,0,33590,0,0,33590
131230300600000,NE 151,Residential,38920,0,38920,250751,0,289671
131230300900000,NE 151,Residential,34485,0,34485,0,0,34485
131230301000000,NE 151,Residential,31850,0,31850,0,0,31850
131230301100000,NE 151,Residential,35339,0,35339,0,0,35339
131230301200000,NE 151,Residential,35344,0,35344,0,0,35344
131230301300000,NE 151,Residential,33727,0,33727,0,0,33727
131230301400000,NE 151,Residential,35968,0,35968,0,0,35968
131230301500000,NE 151,Residential,39100,0,39100,288388,0,327488
131230301600000,NE 151,Residential,38369,0,38369,253631,0,292000
131230301900000,NE 151,Residential,33320,0,33320,252164,0,285484
131230302000000,NE 151,Residential,32830,0,32830,261433,0,294263
131230302100000,NE 151,Residential,35280,0,35280,279229,0,314509
131230302200000,NE 151,Residential,43366,0,43366,283618,0,326984
131230302300000,NE 151,Residential,43200,0,43200,307750,0,350950
131230302400000,NE 151,Residential,40800,0,40800,276459,0,317259
131230302500000,NE 151,Residential,38051,0,38051,0,0,38051
131230302600000,NE 151,Residential,2350,0,2350,0,0,2350
131230302700000,NE 151,Residential,850,0,850,0,0,850
131230302800000,NE 151,Residential,43100,0,43100,258379,0,301479
131230302900000,NE 151,Residential,50300,0,50300,234928,0,285228
131230303100000,NE 151,Residential,32448,0,32448,0,0,32448
131230303200000,NE 151,Residential,53041,0,53041,280326,0,333367
131230400100000,NE 151,Residential,46925,0,46925,0,0,46925
131230400200000,NE 151,Residential,49858,0,49858,0,0,49858
131230400300000,NE 151,Residential,53040,0,53040,239704,0,292744
131230400400000,NE 151,Residential,49400,0,49400,347121,0,396521
131232600200000,NE 151,Residential,212800,0,212800,277863,0,490663
131232600300000,NE 151,Residential,78301,0,78301,0,0,78301
131232600400000,NE 151,Residential,50985,0,50985,0,0,50985
131232600500000,NE 151,Residential,52000,0,52000,0,0,52000
131232600600000,NE 151,Residential,57200,0,57200,0,0,57200
131232600900000,NE 151,Residential,61050,0,61050,321144,0,382194
131232601000000,NE 151,Residential,45261,0,45261,0,0,45261
131232601100000,NE 151,Residential,46800,0,46800,0,0,46800
131232601200000,NE 151,Residential,52000,0,52000,308726,0,360726
131232601300000,NE 151,Residential,49566,0,49566,0,0,49566
131232601400000,NE 151,Residential,86399,0,86399,355702,0,442101
131232601500000,NE 151,Residential,79185,0,79185,0,0,79185
131232601600000,NE 151,Residential,81951,0,81951,375496,0,457447
131232601700000,NE 151,Residential,52170,0,52170,0,0,52170
131232601800000,NE 151,Residential,49923,0,49923,0,0,49923
131232601900000,NE 151,Residential,77503,0,77503,455385,0,532888
131232602000000,NE 151,Residential,70,0,70,0,0,70
131232602100000,NE 151,Residential,85,0,85,0,0,85
131232602200000,NE 151,Residential,113,0,113,0,0,113
131232602300000,NE 151,Residential,65286,0,65286,339427,0,404713
131232602400000,NE 151,Residential,117,0,117,0,0,117
131232602500000,NE 151,Residential,1591,0,1591,0,0,1591
131232700100000,NE 151,Residential,49400,0,49400,283403,0,332803
131232700200000,NE 151,Residential,49400,0,49400,271563,0,320963
131232700300000,NE 151,Residential,49400,0,49400,234021,0,283421
131232700400000,NE 151,Residential,46436,0,46436,0,0,46436
131232700500000,NE 151,Residential,54775,0,54775,333130,0,387905
131232700600000,NE 151,Residential,54237,0,54237,306500,0,360737
131232700700000,NE 151,Residential,77,0,77,0,0,77
131232700800000,NE 151,Residential,48880,0,48880,413917,0,462797
131232700900000,NE 151,Residential,98,0,98,0,0,98
131232701000000,NE 151,Residential,92,0,92,0,0,92
131232701100000,NE 151,Residential,70,0,70,0,0,70
131232701200000,NE 151,Residential,51653,0,51653,371141,0,422794
131232701300000,NE 151,Residential,90,0,90,0,0,90
131232701400000,NE 151,Residential,56300,0,56300,331409,0,387709
131232701500000,NE 151,Residential,89,0,89,0,0,89
131232701600000,NE 151,Residential,1186,0,1186,0,0,1186
131235100300000,NE 150,Residential,46545,0,46545,242139,0,288684
131235100400000,NE 150,Residential,46545,0,46545,318086,0,364631
131235100500000,NE 150,Residential,47952,0,47952,277916,0,325868
131235100600000,NE 150,Residential,45842,0,45842,279707,0,325549
131235100700000,NE 150,Residential,45450,0,45450,272845,0,318295
131235100800000,NE 150,Residential,50058,0,50058,310925,0,360983
131235100900000,NE 150,Residential,48875,0,48875,286950,0,335825
131235101000000,NE 150,Residential,57881,0,57881,529280,0,587161
131235101100000,NE 150,Residential,56475,0,56475,214520,0,270995
131235101200000,NE 150,Residential,48386,0,48386,219609,0,267995
131235101400000,NE 150,Residential,40388,0,40388,252135,0,292523
131235101500000,NE 150,Residential,59676,0,59676,280617,0,340293
131235101600000,NE 150,Residential,52877,0,52877,0,0,52877
131235101700000,NE 150,Residential,55080,0,55080,306516,0,361596
131235101800000,NE 150,Residential,55892,0,55892,281411,0,337303
131235101900000,NE 150,Residential,71410,0,71410,321444,0,392854
131235102000000,NE 150,Residential,56150,0,56150,320715,0,376865
131235102100000,NE 150,Residential,58629,0,58629,371153,0,429782
131235102200000,NE 150,Residential,67105,0,67105,327895,0,395000
131235102300000,NE 150,Residential,63625,0,63625,325171,0,388796
131235102400000,NE 150,Residential,57270,0,57270,391901,0,449171
131235102500000,NE 150,Residential,61608,0,61608,348338,0,409946
131235102600000,NE 150,Residential,55080,0,55080,318041,0,373121
131235102700000,NE 150,Residential,55262,0,55262,310901,0,366163
131235102800000,NE 150,Residential,24500,0,24500,0,0,24500
131235102900000,NE 150,Residential,23240,0,23240,0,0,23240
131235103000000,NE 150,Residential,56150,0,56150,321199,0,377349
131235103100000,NE 150,Residential,56160,0,56160,270851,0,327011
131235103200000,NE 150,Residential,56160,0,56160,276476,0,332636
131235103300000,NE 150,Residential,56160,0,56160,198339,0,254499
131235103400000,NE 150,Residential,56160,0,56160,212921,0,269081
131235103500000,NE 150,Residential,55000,0,55000,0,0,55000
131235103600000,NE 151,Residential,1250,0,1250,0,0,1250
131235103700000,NE 150,Residential,3340,0,3340,1070,0,4410
131235103800000,NE 150,Residential,61480,0,61480,204977,0,266457
131235200100000,NE 150,Residential,46980,0,46980,250687,0,297667
131235200200000,NE 150,Residential,45360,0,45360,264867,0,310227
131235200300000,NE 150,Residential,45081,0,45081,260769,0,305850
131235200400000,NE 150,Residential,45360,0,45360,213883,0,259243
131235200500000,NE 150,Residential,45360,0,45360,292838,0,338198
131235200600000,NE 150,Residential,44012,0,44012,297394,0,341406
131235200700000,NE 150,Residential,44779,0,44779,291242,0,336021
131235200800000,NE 150,Residential,46638,0,46638,169190,0,215828
131235200900000,NE 150,Residential,46332,0,46332,162072,0,208404
131235201000000,NE 150,Residential,45360,0,45360,167464,0,212824
131235201100000,NE 150,Residential,45360,0,45360,176218,0,221578
131235201200000,NE 150,Residential,39162,0,39162,227524,0,266686
131235201300000,NE 150,Residential,44409,0,44409,224316,0,268725
131235201400000,NE 150,Residential,45894,0,45894,215513,0,261407
131235300100000,NE 150,Residential,57339,0,57339,362762,0,420101
131235300200000,NE 150,Residential,56844,0,56844,281258,0,338102
131235300300000,NE 150,Residential,56844,0,56844,243295,0,300139
131235300400000,NE 150,Residential,56652,0,56652,354006,0,410658
131237600100000,NE 150,Residential,45720,0,45720,123431,0,169151
131237600200000,NE 150,Residential,44300,0,44300,104192,0,148492
131237600300000,NE 150,Residential,45020,0,45020,160456,0,205476
131237600500000,NE 150,Residential,20,0,20,0,0,20
131237600600000,NE 150,Residential,45920,0,45920,168639,0,214559
131237600700000,NE 150,Residential,44300,0,44300,187173,0,231473
131237600800000,NE 150,Residential,43670,0,43670,287245,0,330915
131237600900000,NE 150,Residential,52826,0,52826,0,0,52826
131237601000000,NE 150,Residential,52568,0,52568,368001,0,420569
131237601100000,NE 150,Residential,52559,0,52559,330149,0,382708
131237601200000,NE 150,Residential,70100,0,70100,396494,0,466594
131237601300000,NE 150,Residential,16900,0,16900,0,0,16900
131237601500000,NE 150,Residential,62000,0,62000,139329,0,201329
131237700100000,NE 150,Residential,40363,0,40363,233353,0,273716
131237700200000,NE 150,Residential,36504,0,36504,238106,0,274610
131237700300000,NE 150,Residential,36188,0,36188,228934,0,265122
131237700400000,NE 150,Residential,37736,0,37736,233594,0,271330
131237700500000,NE 150,Residential,39312,0,39312,263800,0,303112
131237800100000,NE 150,Residential,49401,0,49401,203967,0,253368
131237800200000,NE 150,Residential,47669,0,47669,256576,0,304245
131237800300000,NE 150,Residential,52200,0,52200,180137,0,232337
131237800400000,NE 150,Residential,52200,0,52200,250103,0,302303
131237800500000,NE 150,Residential,52200,0,52200,387003,0,439203
131237800600000,NE 150,Residential,46980,0,46980,181960,0,228940
131237800700000,NE 150,Residential,51750,0,51750,246505,0,298255
131237900100000,NE 150,Residential,41724,0,41724,261558,0,303282
131237900200000,NE 150,Residential,42066,0,42066,286565,0,328631
131237900300000,NE 150,Residential,46545,0,46545,282100,0,328645
131237900400000,NE 150,Residential,49755,0,49755,275075,0,324830
131237900500000,NE 150,Residential,45765,0,45765,298170,0,343935
131238000100000,NE 150,Residential,50220,0,50220,272030,0,322250
131238000200000,NE 150,Residential,46980,0,46980,279093,0,326073
131238000300000,NE 150,Residential,44298,0,44298,220104,0,264402
131238000400000,NE 150,Residential,48600,0,48600,204618,0,253218
131240100200000,NE 151,Residential,10000,0,10000,0,0,10000
131240100500000,NE 151,Residential,105150,0,105150,0,0,105150
131240100600000,NE 151,Residential,103800,0,103800,0,0,103800
131242700100000,NE 151,Residential,49011,0,49011,274722,0,323733
131242700200000,NE 151,Residential,43224,0,43224,347750,0,390974
131242700300000,NE 151,Residential,48052,0,48052,7286,0,55338
131242700400000,NE 151,Residential,42674,0,42674,357827,0,400501
131242700500000,NE 151,Residential,51810,0,51810,381547,0,433357
131242700700000,NE 151,Residential,81700,0,81700,0,0,81700
131242700800000,NE 151,Residential,68800,0,68800,316944,0,385744
131242700900000,NE 151,Residential,90600,0,90600,401098,0,491698
131242701000000,NE 151,Residential,57800,0,57800,290310,0,348110
131242701100000,NE 151,Residential,59850,0,59850,61140,0,120990
131242800100000,NE 151,Residential,46449,0,46449,0,0,46449
131242800200000,NE 151,Residential,62416,0,62416,0,0,62416
131242800300000,NE 151,Residential,49000,0,49000,342583,0,391583
131242800500000,NE 151,Residential,70787,0,70787,313201,0,383988
131242800600000,NE 151,Residential,64050,0,64050,274739,0,338789
131242800700000,NE 151,Residential,70860,0,70860,242566,0,313426
131242800800000,NE 151,Residential,43937,0,43937,261638,0,305575
131242800900000,NE 151,Residential,44100,0,44100,163740,0,207840
131242801000000,NE 151,Residential,44100,0,44100,62438,0,106538
131242801100000,NE 151,Residential,41895,0,41895,0,0,41895
131242801300000,NE 151,Residential,43475,0,43475,0,0,43475
131242801400000,NE 151,Residential,41895,0,41895,0,0,41895
131242801500000,NE 151,Residential,42322,0,42322,0,0,42322
131242801600000,NE 151,Residential,46653,0,46653,339500,0,386153
131242801700000,NE 151,Residential,62573,0,62573,405317,0,467890
131242801800000,NE 151,Residential,66750,0,66750,324227,0,390977
131242801900000,NE 151,Residential,57600,0,57600,310887,0,368487
131242802000000,NE 151,Residential,59000,0,59000,430542,0,489542
131242802200000,NE 151,Residential,48183,0,48183,368932,0,417115
131242802400000,NE 151,Residential,51653,0,51653,395098,0,446751
131242802500000,NE 151,Residential,41381,0,41381,396384,0,437765
131242802600000,NE 151,Residential,980,0,980,0,0,980
131242802700000,NE 151,Residential,43120,0,43120,0,0,43120
131242900100000,NE 151,Residential,43602,0,43602,285036,0,328638
131242900200000,NE 151,Residential,45450,0,45450,283691,0,329141
131242900300000,NE 151,Residential,44940,0,44940,255382,0,300322
131242900400000,NE 151,Residential,49842,0,49842,0,0,49842
131242900500000,NE 151,Residential,44100,0,44100,0,0,44100
131242900600000,NE 151,Residential,44100,0,44100,391607,0,435707
131242900700000,NE 151,Residential,41895,0,41895,0,0,41895
131242900800000,NE 151,Residential,41895,0,41895,0,0,41895
131242900900000,NE 151,Residential,43650,0,43650,0,0,43650
131242901000000,NE 151,Residential,43558,0,43558,0,0,43558
131242901100000,NE 151,Residential,66618,0,66618,211969,0,278587
131242901200000,NE 151,Residential,44150,0,44150,0,0,44150
131242901300000,NE 151,Residential,38676,0,38676,255640,0,294316
131242901400000,NE 151,Residential,48645,0,48645,182466,0,231111
131242901500000,NE 151,Residential,58140,0,58140,230684,0,288824
131242901600000,NE 151,Residential,43443,0,43443,0,0,43443
131242901700000,NE 151,Residential,38083,0,38083,0,0,38083
131242901800000,NE 151,Residential,48975,0,48975,347042,0,396017
131242901900000,NE 151,Residential,48992,0,48992,216612,0,265604
131242902000000,NE 151,Residential,42500,0,42500,226773,0,269273
131242902100000,NE 151,Residential,35145,0,35145,232549,0,267694
131242902200000,NE 151,Residential,34650,0,34650,208637,0,243287
131242902300000,NE 151,Residential,30690,0,30690,204277,0,234967
131242902400000,NE 151,Residential,59763,0,59763,0,0,59763
131243000100000,NE 151,Residential,41333,0,41333,0,0,41333
131243000200000,NE 151,Residential,44239,0,44239,0,0,44239
131243000300000,NE 151,Residential,44940,0,44940,0,0,44940
131243000400000,NE 151,Residential,49157,0,49157,0,0,49157
131243000500000,NE 151,Residential,48267,0,48267,0,0,48267
131243000600000,NE 151,Residential,49300,0,49300,0,0,49300
131243100100000,NE 151,Residential,47628,0,47628,290454,0,338082
131243100200000,NE 151,Residential,48269,0,48269,0,0,48269
131243100300000,NE 151,Residential,46075,0,46075,0,0,46075
131245100200000,NE 150,Residential,60350,0,60350,207181,0,267531
131245100300000,NE 150,Residential,60300,0,60300,160782,0,221082
131245100400000,NE 150,Residential,60250,0,60250,159995,0,220245
131245100500000,NE 150,Residential,20,0,20,0,0,20
131245100600000,NE 150,Residential,20,0,20,0,0,20
131245200100000,NE 150,Residential,60700,0,60700,163903,0,224603
131245200200000,NE 150,Residential,61100,0,61100,167633,0,228733
131245200300000,NE 150,Residential,60100,0,60100,178724,0,238824
131245200400000,NE 150,Residential,20,0,20,0,0,20
131245200500000,NE 150,Residential,55370,0,55370,186272,0,241642
131245200600000,NE 150,Residential,60300,0,60300,161950,0,222250
131245200700000,NE 150,Residential,61050,0,61050,212495,0,273545
131245200800000,NE 150,Residential,61150,0,61150,199976,0,261126
131245201000000,NE 150,Residential,43721,0,43721,171458,0,215179
131245201100000,NE 150,Residential,46446,0,46446,155960,0,202406
131245201200000,NE 150,Residential,61750,0,61750,229083,0,290833
131245201300000,NE 150,Residential,22000,0,22000,0,0,22000
131245201400000,NE 150,Residential,62815,0,62815,157185,0,220000
131245201500000,NE 150,Residential,60300,0,60300,175510,0,235810
131245201600000,NE 150,Residential,20,0,20,0,0,20
131245300200000,NE 151,Residential,50490,0,50490,0,0,50490
131245300900000,NE 151,Residential,970,0,970,0,0,970
131245301000000,NE 151,Residential,669,0,669,0,0,669
131245301100000,NE 151,Residential,59670,0,59670,413635,0,473305
131245301600000,NE 151,Residential,64800,0,64800,411875,0,476675
131245301700000,NE 151,Residential,105052,0,105052,286644,0,391696
131245400100000,NE 151,Residential,50196,0,50196,0,0,50196
131245400200000,NE 151,Residential,48672,0,48672,0,0,48672
131245400300000,NE 151,Residential,49413,0,49413,0,0,49413
131245400400000,NE 151,Residential,50792,0,50792,237653,0,288445
131245400500000,NE 151,Residential,48614,0,48614,0,0,48614
131245400600000,NE 151,Residential,47197,0,47197,302006,0,349203
131245400800000,NE 151,Residential,55590,0,55590,0,0,55590
131245400900000,NE 151,Residential,59417,0,59417,291452,0,350869
131245401000000,NE 151,Residential,2220,0,2220,0,0,2220
131247600500000,NE 151,Residential,11839,0,11839,0,0,11839
131247600600000,NE 151,Residential,104000,0,104000,475665,0,579665
131247600700000,NE 151,Residential,3739,0,3739,0,0,3739
131247600800000,NE 151,Residential,4828,0,4828,0,0,4828
131247600900000,NE 151,Residential,81223,0,81223,505944,0,587167
131247601000000,NE 151,Residential,73500,0,73500,410378,0,483878
131247601100000,NE 151,Residential,106604,0,106604,487815,0,594419
131247601200000,NE 151,Residential,81041,0,81041,301951,0,382992
131247601300000,NE 151,Residential,4051,0,4051,0,0,4051
131247601400000,NE 151,Residential,2718,0,2718,0,0,2718
131247601500000,NE 151,Residential,2575,0,2575,0,0,2575
131247601600000,NE 151,Residential,2569,0,2569,0,0,2569
131247601700000,NE 151,Residential,229659,0,229659,0,0,229659
131247601800000,NE 151,Residential,81150,0,81150,0,0,81150
131312700100000,NE 150,Ag Land,22408,0,22408,0,0,22408
131320100100000,NE 150,Ag Dwelling,10449,0,10449,104342,0,114791
131320200100000,NE 150,Residential,51750,0,51750,258488,0,310238
131320200200000,NE 150,Residential,35313,0,35313,113288,0,148601
131320200300000,NE 150,Residential,36563,0,36563,142222,0,178785
131320300100000,NE 150,Residential,49050,0,49050,233947,0,282997
131320300200000,NE 150,Residential,44712,0,44712,293683,0,338395
131320300300000,NE 150,Residential,40875,0,40875,143579,0,184454
131320300400000,NE 150,Residential,40875,0,40875,124102,0,164977
131320400100000,NE 150,Residential,39360,0,39360,141496,0,180856
131320400200000,NE 150,Residential,41605,0,41605,178436,0,220041
131320400300000,NE 150,Residential,39322,0,39322,191660,0,230982
131320400400000,NE 150,Residential,45985,0,45985,182775,0,228760
131322600100000,NE 150,Residential,46539,0,46539,206013,0,252552
131322600200000,NE 150,Residential,45412,0,45412,167481,0,212893
131322600300000,NE 150,Residential,41053,0,41053,203185,0,244238
131322600400000,NE 150,Residential,45126,0,45126,159648,0,204774
131322600500000,NE 150,Residential,47087,0,47087,252658,0,299745
131322600600000,NE 150,Residential,46105,0,46105,175528,0,221633
131322600700000,NE 150,Residential,46091,0,46091,227102,0,273193
131322600800000,NE 150,Residential,37427,0,37427,159113,0,196540
131322600900000,NE 150,Residential,40875,0,40875,183796,0,224671
131322601000000,NE 150,Residential,40875,0,40875,162866,0,203741
131322601100000,NE 150,Residential,40875,0,40875,145236,0,186111
131322601200000,NE 150,Residential,40875,0,40875,162635,0,203510
131322601300000,NE 150,Residential,40875,0,40875,119931,0,160806
131322601400000,NE 150,Residential,40875,0,40875,143188,0,184063
131322700100000,NE 150,Residential,45985,0,45985,231190,0,277175
131322700200000,NE 150,Residential,40875,0,40875,244785,0,285660
131322700300000,NE 150,Residential,40875,0,40875,159858,0,200733
131322700400000,NE 150,Residential,40875,0,40875,213019,0,253894
131322700500000,NE 150,Residential,40875,0,40875,283759,0,324634
131322700600000,NE 150,Residential,39967,0,39967,165657,0,205624
131322700700000,NE 150,Residential,45075,0,45075,213055,0,258130
131322700800000,NE 150,Residential,34960,0,34960,152102,0,187062
131322700900000,NE 150,Residential,33656,0,33656,173797,0,207453
131322701000000,NE 150,Residential,44887,0,44887,173075,0,217962
131322701100000,NE 150,Residential,44799,0,44799,251288,0,296087
131327600100000,CITY PROPERTY,Exempt,0,0,0,0,0,0
131330100100000,NW 302,Residential,85680,0,85680,237800,0,323480
131335100700000,NW 302,Residential,111700,0,111700,782774,0,894474
131335100800000,NW 302,Residential,2700,0,2700,0,0,2700
131335100900000,NW 302,Residential,12250,0,12250,0,0,12250
131337600500000,NW 302,Residential,35640,0,35640,0,0,35640
131337600600000,NW 302,Residential,42000,0,42000,0,0,42000
131337600700000,NW 302,Residential,50400,0,50400,252956,0,303356
131337600800000,NW 302,Residential,50880,0,50880,0,0,50880
131337600900000,NW 302,Residential,62527,0,62527,0,0,62527
131337601000000,NW 302,Residential,64800,0,64800,0,0,64800
131337601100000,NW 302,Residential,110287,0,110287,0,0,110287
131337601300000,NW 302,Residential,3257,0,3257,0,0,3257
131337601400000,NW 302,Residential,3106,0,3106,0,0,3106
131337601500000,NW 302,Residential,3319,0,3319,0,0,3319
131337601600000,NW 302,Residential,3639,0,3639,0,0,3639
131337601700000,NW 302,Residential,24863,0,24863,0,0,24863
131337601800000,NW 302,Residential,84700,0,84700,0,0,84700
131337700100000,NW 302,Residential,31640,0,31640,0,0,31640
131337700200000,NW 302,Residential,36380,0,36380,0,0,36380
131337700300000,NW 302,Residential,34668,0,34668,0,0,34668
131337700400000,NW 302,Residential,34240,0,34240,0,0,34240
131337700500000,NW 302,Residential,36380,0,36380,274020,0,310400
131337700600000,NW 302,Residential,56068,0,56068,0,0,56068
131342600300000,NW 302,Residential,144400,0,144400,94760,0,239160
131342600400000,NW 302,Residential,78250,0,78250,174318,0,252568
131345100300000,NW 302,Residential,35272,0,35272,0,0,35272
131345100400000,NW 302,Residential,36480,0,36480,243649,0,280129
131345100500000,NW 302,Residential,39317,0,39317,249264,0,288581
131345100600000,NW 302,Residential,37240,0,37240,0,0,37240
131345100700000,NW 302,Residential,37813,0,37813,213564,0,251377
131345100800000,NW 302,Residential,30480,0,30480,0,0,30480
131345100900000,NW 302,Residential,41944,0,41944,0,0,41944
131345101000000,CITY PROPERTY,Exempt,0,0,0,0,0,0
131345101400000,NW 302,Residential,1918,0,1918,0,0,1918
131345101600000,NW 302,Ag Land,6601,0,6601,0,0,6601
131345101800000,NW 302,Residential,33660,0,33660,263475,0,297135
131345101900000,NW 302,Residential,33660,0,33660,156864,0,190524
131345102000000,NW 302,Residential,2776,0,2776,0,0,2776
131345102100000,NW 302,Residential,34848,0,34848,193941,0,228789
131345200100000,NW 302,Residential,38080,0,38080,323316,0,361396
131345200200000,NW 302,Residential,37248,0,37248,216552,0,253800
131345200300000,NW 302,Residential,37231,0,37231,208849,0,246080
131345200400000,NW 302,Residential,34340,0,34340,204456,0,238796
131345200500000,NW 302,Residential,36360,0,36360,195858,0,232218
131345200600000,NW 302,Residential,35304,0,35304,206771,0,242075
131345200700000,NW 302,Residential,35812,0,35812,165324,0,201136
131345200800000,NW 302,Residential,36860,0,36860,269469,0,306329
131345200900000,NW 302,Residential,38409,0,38409,216679,0,255088
131345300100000,NW 302,Residential,37146,0,37146,260854,0,298000
131345300200000,NW 302,Residential,37451,0,37451,345210,0,382661
131345300300000,NW 302,Residential,34000,0,34000,217710,0,251710
131345300400000,NW 302,Residential,81800,0,81800,190295,0,272095
131345400200000,NW 302,Residential,41801,0,41801,201634,0,243435
131345400300000,NW 302,Residential,42293,0,42293,226168,0,268461
131345400400000,NW 302,Residential,40400,0,40400,256976,0,297376
131347600300000,NW 302,Residential,41850,0,41850,65704,0,107554
131347600700000,NW 302,Residential,33962,0,33962,143942,0,177904
131347600800000,NW 302,Residential,25245,0,25245,44564,0,69809
131410100100000,CITY PROPERTY,Exempt,0,0,0,0,0,0
131515200500000,NW 332,Residential,59400,0,59400,0,0,59400
131515200600000,NW 332,Residential,59400,0,59400,275543,0,334943
131515200700000,NW 332,Residential,67056,0,67056,9459,0,76515
131515200800000,NW 332,Residential,68640,0,68640,253081,0,321721
131515200900000,CITY PROPERTY,Exempt,0,0,0,0,0,0
131515201000000,NW 332,Residential,68392,0,68392,254079,0,322471
131515201100000,NW 332,Residential,72360,0,72360,218482,0,290842
131515201200000,NW 332,Residential,74120,0,74120,192329,0,266449
131515201300000,NW 332,Residential,7140,0,7140,0,0,7140
131515201400000,NW 332,Residential,6985,0,6985,0,0,6985
131515201500000,NW 332,Residential,6697,0,6697,0,0,6697
131515201600000,NW 332,Residential,6645,0,6645,0,0,6645
131515201700000,NW 332,Residential,9321,0,9321,0,0,9321
131515201800000,NW 332,Residential,12875,0,12875,0,0,12875
131515201900000,NW 332,Residential,8901,0,8901,0,0,8901
131515202000000,NW 332,Residential,6459,0,6459,0,0,6459
131515202100000,NW 332,Residential,5492,0,5492,0,0,5492
131515202200000,NW 332,Residential,5492,0,5492,0,0,5492
131515202300000,NW 332,Residential,5835,0,5835,0,0,5835
131515202400000,NW 332,Residential,5835,0,5835,0,0,5835
131515202500000,NW 332,Residential,5141,0,5141,0,0,5141
131515300100000,NW 332,Residential,55080,0,55080,285486,0,340566
131515300200000,NW 332,Residential,48960,0,48960,0,0,48960
131515300300000,NW 332,Residential,55080,0,55080,0,0,55080
131515300400000,NW 332,Residential,72169,0,72169,0,0,72169
131515300500000,NW 332,Residential,61924,0,61924,246814,0,308738
131515300600000,NW 332,Residential,51816,0,51816,246451,0,298267
131515300700000,NW 332,Residential,52020,0,52020,307193,0,359213
131515300800000,NW 332,Residential,6179,0,6179,0,0,6179
131515300900000,NW 332,Residential,5835,0,5835,0,0,5835
131515301000000,NW 332,Residential,6179,0,6179,0,0,6179
131515301100000,NW 332,Residential,6179,0,6179,0,0,6179
131515301200000,NW 332,Residential,5985,0,5985,0,0,5985
131515301300000,NW 332,Residential,7268,0,7268,0,0,7268
131515301400000,NW 332,Residential,7978,0,7978,0,0,7978
131515301500000,NW 332,Residential,6865,0,6865,0,0,6865
131515301600000,NW 332,Residential,6865,0,6865,0,0,6865
131515301700000,NW 332,Residential,6865,0,6865,0,0,6865
131515400100000,NW 332,Residential,54060,0,54060,247011,0,301071
131515400200000,NW 332,Residential,54180,0,54180,252351,0,306531
131515400300000,NW 332,Residential,70384,0,70384,209083,0,279467
131515400400000,NW 332,Residential,7002,0,7002,0,0,7002
131515400500000,NW 332,Residential,6613,0,6613,0,0,6613
131515400600000,NW 332,Residential,6613,0,6613,0,0,6613
131515400700000,NW 332,Residential,7002,0,7002,0,0,7002
131515400800000,NW 332,Residential,7565,0,7565,0,0,7565
131515400900000,NW 332,Residential,8877,0,8877,0,0,8877
131515500100000,NW 332,Residential,71280,0,71280,0,0,71280
131515500200000,NW 332,Residential,58320,0,58320,196984,0,255304
131515500300000,NW 332,Residential,67625,0,67625,192879,0,260504
131522600100000,CITY PROPERTY,Exempt,0,0,0,0,0,0
131522600200000,NW 332,Ag Land,34691,0,34691,0,0,34691
131522600300000,NW 332,Ag Land,21197,0,21197,0,0,21197
131525100200000,NW 332,Ag Land,51427,0,51427,0,0,51427
131527600300000,NW 332,Ag Land,28877,0,28877,0,0,28877
131527600500000,NW 332,Ag Land,10997,0,10997,0,0,10997
131527600600000,NW 332,Ag Land,21399,0,21399,0,0,21399
131527600700000,NW 332,Ag Land,3591,0,3591,0,0,3591
131527600800000,NW 332,Residential,5980,0,5980,0,0,5980
131527700100000,NW 332,Residential,5833,0,5833,0,0,5833
131527700200000,NW 332,Residential,5803,0,5803,0,0,5803
131527700300000,NW 332,Residential,5782,0,5782,0,0,5782
131527700400000,NW 332,Residential,5422,0,5422,0,0,5422
131527800100000,NW 332,Residential,7412,0,7412,0,0,7412
131527800200000,NW 332,Residential,6024,0,6024,0,0,6024
131527900100000,NW 332,Residential,7323,0,7323,0,0,7323
131527900200000,NW 332,Residential,5858,0,5858,0,0,5858
131532600100000,CITY PROPERTY,Exempt,0,0,0,0,0,0
131542600200000,NW 332,Ag Dwelling,42259,0,42259,104902,14772,161933
131542600400000,NW 332,Residential,66874,0,66874,236204,0,303078
131542600500000,NW 332,Residential,4791,0,4791,0,0,4791
131542600600000,NW 332,Residential,4775,0,4775,0,0,4775
131542600700000,NW 332,Residential,4758,0,4758,0,0,4758
131542600800000,NW 332,Residential,6044,0,6044,0,0,6044
131542600900000,NW 332,Residential,6437,0,6437,0,0,6437
131542601000000,NW 332,Residential,6049,0,6049,0,0,6049
131542601100000,NW 332,Residential,9217,0,9217,0,0,9217
131542601200000,CITY PROPERTY,Exempt,0,0,0,0,0,0
131542700100000,NW 332,Residential,5283,0,5283,0,0,5283
131542700200000,NW 332,Residential,4870,0,4870,0,0,4870
131542700300000,NW 332,Residential,5562,0,5562,0,0,5562
131542700400000,NW 332,Residential,8496,0,8496,0,0,8496
131542700500000,NW 332,Residential,4755,0,4755,0,0,4755
131542700600000,NW 332,Residential,5426,0,5426,0,0,5426
131542700700000,NW 332,Residential,3863,0,3863,0,0,3863
131542700800000,NW 332,Residential,55080,0,55080,226871,0,281951
131542700900000,NW 332,Residential,62424,0,62424,40527,0,102951
131542800100000,NW 332,Residential,4520,0,4520,0,0,4520
131542800200000,NW 332,Residential,4000,0,4000,0,0,4000
131542800300000,NW 332,Residential,4155,0,4155,0,0,4155
131542800400000,NW 332,Residential,5135,0,5135,0,0,5135
132222600100000,NW 332,Ag Land,30627,0,30627,0,0,30627
132222600200000,NW 332,Ag Land,28685,0,28685,0,0,28685
132225100100000,NW 332,Ag Land,56620,0,56620,0,0,56620
132225100200000,NW 332,Residential,45144,0,45144,80372,0,125516
132232600100000,NW 332,Ag Land,45845,0,45845,0,0,45845
132235100100000,NW 332,Ag Land,56526,0,56526,0,0,56526
132237600100000,COUNTY PROPERTY,Exempt,0,0,0,0,0,0
132245100100000,COUNTY PROPERTY,Exempt,0,0,0,0,0,0
132245100200000,NW 332,Ag Land,56733,0,56733,0,0,56733
132247600200000,NW 332,Ag Land,20022,0,20022,0,0,20022
132247600500000,NW 332,Residential,48127,0,48127,201005,0,249132
132247600600000,NW 332,Residential,40375,0,40375,220506,0,260881
132247600700000,NW 332,Residential,41695,0,41695,180198,0,221893
132247600800000,NW 332,Residential,39257,0,39257,181091,0,220348
132247600900000,NW 332,Residential,36575,0,36575,174098,0,210673
132247601000000,NW 332,Residential,38000,0,38000,164502,0,202502
132247601100000,NW 332,Residential,38000,0,38000,177404,0,215404
132247601200000,NW 332,Residential,34884,0,34884,171398,0,206282
132247601300000,NW 332,Residential,25952,0,25952,196278,0,222230
132247601400000,NW 332,Residential,276,0,276,0,0,276
132247601500000,NW 332,Residential,381,0,381,0,0,381
132247601600000,NW 322,Residential,38836,0,38836,80952,0,119788
132247601700000,NW 322,Residential,543,0,543,0,0,543
132247601800000,NW 322,Residential,498,0,498,0,0,498
132247601900000,NW 322,Residential,425,0,425,0,0,425
132247602000000,NW 322,Residential,35910,0,35910,179094,0,215004
132247602100000,NW 322,Residential,44888,0,44888,139435,0,184323
132247602200000,NW 322,Residential,488,0,488,0,0,488
132247602300000,NW 322,Residential,557,0,557,0,0,557
132247602400000,NW 322,Residential,30267,0,30267,207011,0,237278
132247602500000,NW 322,Residential,1900,0,1900,0,0,1900
132247602600000,NW 322,Residential,30780,0,30780,228585,0,259365
132247602700000,NW 322,Residential,24467,0,24467,197485,0,221952
132247602800000,NW 322,Residential,40660,0,40660,240902,0,281562
132247602900000,NW 322,Residential,37272,0,37272,212971,0,250243
132247603000000,NW 322,Residential,47342,0,47342,184424,0,231766
132247700100000,NW 332,Residential,46157,0,46157,200221,0,246378
132247700200000,NW 332,Residential,37544,0,37544,179678,0,217222
132247700300000,NW 332,Residential,40375,0,40375,192401,0,232776
132247700400000,NW 332,Residential,28101,0,28101,225684,0,253785
132247700500000,NW 332,Residential,38276,0,38276,184162,0,222438
132247700600000,NW 332,Residential,42151,0,42151,243339,0,285490
132247700700000,NW 332,Residential,283,0,283,0,0,283
132247700800000,NW 332,Residential,34672,0,34672,205536,0,240208
132247700900000,NW 332,Residential,40483,0,40483,209967,0,250450
132247701000000,NW 332,Residential,325,0,325,0,0,325
132247701100000,NW 332,Residential,38950,0,38950,136406,0,175356
132247701200000,NW 332,Residential,39710,0,39710,199693,0,239403
132247701300000,NW 332,Residential,65981,0,65981,203083,0,269064
132247701400000,NW 332,Residential,421,0,421,0,0,421
132247701500000,CITY PROPERTY,Exempt,0,0,0,0,0,0
132247701600000,NW 322,Residential,522,0,522,0,0,522
132247701700000,NW 322,Residential,453,0,453,0,0,453
132247701800000,NW 322,Residential,425,0,425,0,0,425
132247701900000,NW 322,Residential,345,0,345,0,0,345
132247702000000,NW 322,Residential,425,0,425,0,0,425
132247702100000,NW 322,Residential,356,0,356,0,0,356
132247702200000,NW 322,Residential,401,0,401,0,0,401
132247702300000,NW 322,Residential,414,0,414,0,0,414
132247702400000,NW 322,Residential,1194,0,1194,0,0,1194
132247702500000,NW 322,Residential,210,0,210,0,0,210
132247800100000,NW 322,Residential,700,0,700,0,0,700
132247800200000,NW 322,Residential,45234,0,45234,226372,0,271606
132247800300000,NW 322,Residential,40660,0,40660,229812,0,270472
132247800400000,NW 322,Residential,409,0,409,0,0,409
132247800500000,NW 322,Residential,46081,0,46081,4099,0,50180
132247800600000,NW 322,Residential,566,0,566,0,0,566
132247800700000,NW 322,Residential,453,0,453,0,0,453
132247800800000,NW 322,Residential,178,0,178,0,0,178
132247900100000,NW 322,Residential,43724,0,43724,206961,0,250685
132247900200000,NW 322,Residential,36908,0,36908,200337,0,237245
132247900300000,NW 322,Residential,571,0,571,0,0,571
132340200200000,SCHOOL,Exempt,0,0,0,0,0,0
132340200300000,NW 329,Residential,24056,0,24056,93283,0,117339
132340200400000,NW 329,Residential,23914,0,23914,97807,0,121721
132340200500000,NW 329,Residential,26209,0,26209,87972,0,114181
132340200600000,NW 329,Residential,27390,0,27390,98312,0,125702
132340200700000,NW 329,Residential,26536,0,26536,99180,0,125716
132340200800000,NW 329,Residential,26683,0,26683,115036,0,141719
132340200900000,NW 329,Residential,26670,0,26670,74389,0,101059
132340201000000,NW 329,Residential,29316,0,29316,102152,0,131468
132340300100000,NW 329,Residential,25995,0,25995,96900,0,122895
132340300200000,NW 329,Residential,24832,0,24832,104490,0,129322
132340300300000,NW 329,Residential,27645,0,27645,96995,0,124640
132340300400000,NW 329,Residential,27645,0,27645,93769,0,121414
132340300500000,NW 329,Residential,25175,0,25175,92236,0,117411
132340400100000,NW 329,Residential,26293,0,26293,103321,0,129614
132340400200000,NW 329,Residential,27234,0,27234,97040,0,124274
132340400300000,NW 329,Residential,26937,0,26937,91798,0,118735
132340400400000,NW 329,Residential,25867,0,25867,84071,0,109938
132340400500000,NW 329,Residential,24522,0,24522,101579,0,126101
132340400600000,NW 329,Residential,24522,0,24522,96092,0,120614
132340400700000,NW 329,Residential,27791,0,27791,91849,0,119640
132347600100000,NW 329,Residential,25175,0,25175,91506,0,116681
132347600200000,NW 329,Residential,25175,0,25175,97822,0,122997
132347600300000,NW 329,Residential,25175,0,25175,133899,0,159074
132347600400000,NW 329,Residential,25175,0,25175,105342,0,130517
132347600500000,NW 329,Residential,25175,0,25175,106413,0,131588
132347600600000,NW 329,Residential,27645,0,27645,109858,0,137503
132347700100000,NW 329,Residential,24522,0,24522,86973,0,111495
132347700200000,NW 329,Residential,24522,0,24522,90623,0,115145
132347700300000,NW 329,Residential,24522,0,24522,88269,0,112791
132347700400000,NW 329,Residential,24522,0,24522,106640,0,131162
132347700500000,NW 329,Residential,24522,0,24522,98790,0,123312
132347700600000,NW 329,Residential,24522,0,24522,86826,0,111348
132347700700000,NW 329,Residential,27238,0,27238,94733,0,121971
132347700800000,NW 329,Residential,24832,0,24832,95941,0,120773
132347700900000,NW 329,Residential,27238,0,27238,109517,0,136755
132347701000000,NW 329,Residential,24522,0,24522,87865,0,112387
132347701100000,NW 329,Residential,24522,0,24522,95053,0,119575
132347701200000,NW 329,Residential,24522,0,24522,100250,0,124772
132347701300000,NW 329,Residential,24522,0,24522,81570,0,106092
132347800100000,NW 329,Residential,24056,0,24056,100968,0,125024
132347800200000,NW 329,Residential,24056,0,24056,83329,0,107385
132347800300000,NW 329,Residential,25802,0,25802,124359,0,150161
132347800400000,NW 329,Residential,25802,0,25802,100272,0,126074
132347800500000,NW 329,Residential,24832,0,24832,109031,0,133863
132347800600000,NW 329,Residential,24832,0,24832,93553,0,118385
132347800700000,NW 329,Residential,24832,0,24832,95411,0,120243
132347800800000,NW 329,Residential,24832,0,24832,104202,0,129034
132347800900000,NW 329,Residential,26384,0,26384,107488,0,133872
132347801000000,SCHOOL,Exempt,0,0,0,0,0,0
132347900100000,NW 329,Residential,27373,0,27373,107844,0,135217
132347900200000,NW 329,Residential,24832,0,24832,85654,0,110486
132347900300000,NW 329,Residential,24832,0,24832,98725,0,123557
132347900400000,NW 329,Residential,24832,0,24832,116861,0,141693
132347900500000,NW 329,Residential,24832,0,24832,101314,0,126146
132347900600000,NW 329,Residential,24832,0,24832,102261,0,127093
132347900700000,NW 329,Residential,24832,0,24832,94658,0,119490
132347900800000,NW 329,Residential,24832,0,24832,92040,0,116872
132347900900000,NW 329,Residential,24832,0,24832,86956,0,111788
132347901000000,NW 329,Residential,24832,0,24832,94577,0,119409
132347901100000,NW 329,Residential,24832,0,24832,96290,0,121122
132347901200000,NW 329,Residential,27373,0,27373,104166,0,131539
132348000100000,NW 329,Residential,27238,0,27238,96524,0,123762
132348000200000,NW 329,Residential,24832,0,24832,98123,0,122955
132348000300000,NW 329,Residential,27238,0,27238,76735,0,103973
132348000400000,NW 329,Residential,25802,0,25802,96506,0,122308
132348000500000,NW 329,Residential,24716,0,24716,96804,0,121520
132348000600000,NW 329,Residential,24716,0,24716,91282,0,115998
132348000700000,NW 329,Residential,24716,0,24716,97098,0,121814
132348000800000,NW 329,Residential,24716,0,24716,112674,0,137390
132348000900000,NW 329,Residential,24716,0,24716,98557,0,123273
132348001000000,NW 329,Residential,24716,0,24716,86551,0,111267
132348001100000,NW 329,Residential,24716,0,24716,100393,0,125109
132348001200000,NW 329,Residential,25802,0,25802,103002,0,128804
132348001300000,NW 329,Residential,27238,0,27238,93109,0,120347
132348001400000,NW 329,Residential,24832,0,24832,110714,0,135546
132348001500000,NW 329,Residential,27238,0,27238,111579,0,138817
132348001600000,NW 329,Residential,25802,0,25802,100634,0,126436
132348001700000,NW 329,Residential,24716,0,24716,99621,0,124337
132348001800000,NW 329,Residential,24716,0,24716,94308,0,119024
132348001900000,NW 329,Residential,24716,0,24716,112085,0,136801
132348002000000,NW 329,Residential,24716,0,24716,98505,0,123221
132348002100000,NW 329,Residential,24716,0,24716,108558,0,133274
132348002200000,NW 329,Residential,24716,0,24716,108941,0,133657
132348002300000,NW 329,Residential,24716,0,24716,91663,0,116379
132348002400000,NW 329,Residential,25802,0,25802,97739,0,123541
132348100100000,NW 329,Residential,28557,0,28557,112927,0,141484
132348100200000,NW 329,Residential,25802,0,25802,82946,0,108748
132348100300000,NW 329,Residential,25802,0,25802,86365,0,112167
132348100400000,NW 329,Residential,25802,0,25802,83533,0,109335
132348100500000,NW 329,Residential,25802,0,25802,103784,0,129586
132348100600000,NW 329,Residential,25802,0,25802,107033,0,132835
132348100700000,NW 329,Residential,25802,0,25802,91587,0,117389
132348100800000,NW 329,Residential,26772,0,26772,124021,0,150793
132410100100000,NW 337,Residential,30000,0,30000,121275,0,151275
132410100500000,CITY PROPERTY,Exempt,0,0,0,0,0,0
132410100700000,NW 337,Residential,51100,0,51100,142735,0,193835
132410100800000,NW 337,Residential,53500,0,53500,90921,0,144421
132410100900000,NW 337,Residential,41400,0,41400,153848,0,195248
132410200400000,NW 309,Residential,40460,0,40460,252673,0,293133
132412600100000,NW 339,Residential,34319,0,34319,152302,0,186621
132412600200000,NW 339,Residential,34680,0,34680,161304,0,195984
132412600300000,NW 339,Residential,34680,0,34680,161068,0,195748
132412600400000,NW 339,Residential,34680,0,34680,185975,0,220655
132412600500000,NW 339,Residential,33320,0,33320,176058,0,209378
132412600600000,NW 309,Residential,31360,0,31360,143341,0,174701
132412600700000,NW 309,Residential,31360,0,31360,165809,0,197169
132412600800000,NW 309,Residential,34365,0,34365,198078,0,232443
132412600900000,NW 309,Residential,32248,0,32248,235018,0,267266
132412601000000,NW 309,Residential,32367,0,32367,205382,0,237749
132412601100000,NW 309,Residential,35711,0,35711,181169,0,216880
132412601200000,NW 309,Residential,34353,0,34353,261432,0,295785
132412700100000,NW 309,Residential,35436,0,35436,198635,0,234071
132412700200000,NW 309,Residential,35578,0,35578,142576,0,178154
132412700300000,NW 309,Residential,34896,0,34896,137166,0,172062
132412800200000,NW 339,Residential,33141,0,33141,175839,0,208980
132412800300000,NW 339,Residential,31280,0,31280,193274,0,224554
132412800400000,NW 339,Residential,31280,0,31280,221399,0,252679
132412800500000,NW 339,Residential,31620,0,31620,169386,0,201006
132412800600000,NW 339,Residential,32319,0,32319,167679,0,199998
132412800700000,NW 339,Residential,29732,0,29732,181876,0,211608
132412800800000,NW 342,Ag Land,15622,0,15622,0,2348,17970
132412800900000,NW 309,Residential,32399,0,32399,0,0,32399
132412801000000,NW 309,Residential,32399,0,32399,275991,0,308390
132412801100000,NW 309,Residential,32313,0,32313,183896,0,216209
132412801200000,NW 309,Residential,32040,0,32040,241091,0,273131
132412801400000,NW 309,Residential,31331,0,31331,184662,0,215993
132412801500000,NW 309,Residential,5906,0,5906,0,0,5906
132412801600000,NW 309,Residential,6444,0,6444,0,0,6444
132412900100000,NW 339,Residential,33393,0,33393,172892,0,206285
132412900200000,NW 339,Residential,34157,0,34157,194005,0,228162
132412900300000,NW 339,Residential,32301,0,32301,167659,0,199960
132412900400000,NW 339,Residential,31950,0,31950,142803,0,174753
132412900500000,NW 339,Residential,35343,0,35343,151118,0,186461
132412900600000,NW 339,Residential,35272,0,35272,0,0,35272
132412900700000,NW 339,Residential,34084,0,34084,154733,0,188817
132412900800000,NW 339,Residential,36030,0,36030,210940,0,246970
132412900900000,NW 339,Residential,34836,0,34836,188044,0,222880
132412901000000,NW 339,Residential,35607,0,35607,134792,0,170399
132412901100000,NW 339,Residential,35992,0,35992,150039,0,186031
132412901200000,NW 339,Residential,35319,0,35319,177974,0,213293
132412901300000,NW 339,Residential,35404,0,35404,182853,0,218257
132412901400000,NW 339,Residential,34016,0,34016,148612,0,182628
132412901500000,NW 309,Residential,63700,0,63700,16358,0,80058
132412901600000,NW 339,Residential,27211,0,27211,0,0,27211
132412901700000,NW 339,Residential,33409,0,33409,247678,0,281087
132412901800000,NW 339,Residential,33062,0,33062,177048,0,210110
132412901900000,NW 339,Residential,33001,0,33001,218074,0,251075
132412902000000,NW 339,Residential,32981,0,32981,161186,0,194167
132413000100000,NW 309,Residential,31929,0,31929,110045,0,141974
132413000200000,NW 309,Residential,31559,0,31559,121826,0,153385
132413000300000,NW 309,Residential,33115,0,33115,181699,0,214814
132413000400000,NW 309,Residential,29207,0,29207,174726,0,203933
132413000500000,NW 309,Residential,30835,0,30835,170778,0,201613
132413000600000,NW 309,Residential,33120,0,33120,128825,0,161945
132413000700000,NW 339,Residential,33728,0,33728,173488,0,207216
132413000800000,NW 339,Residential,32079,0,32079,148505,0,180584
132413000900000,NW 339,Residential,34775,0,34775,138152,0,172927
132413001000000,NW 339,Residential,35402,0,35402,156458,0,191860
132413001100000,NW 339,Residential,35425,0,35425,186177,0,221602
132413001200000,NW 339,Residential,34453,0,34453,202945,0,237398
132413001300000,NW 339,Residential,38118,0,38118,0,0,38118
132413001400000,NW 339,Residential,33787,0,33787,252001,0,285788
132413001500000,NW 339,Residential,35618,0,35618,156190,0,191808
132413001600000,NW 339,Residential,36443,0,36443,231211,0,267654
132413001700000,NW 339,Residential,38235,0,38235,184330,0,222565
132413001800000,NW 339,Residential,36508,0,36508,226092,0,262600
132413001900000,NW 339,Residential,34669,0,34669,154270,0,188939
132413002000000,NW 339,Residential,35156,0,35156,156888,0,192044
132413002100000,NW 339,Residential,34519,0,34519,141903,0,176422
132413002200000,NW 339,Residential,34757,0,34757,175857,0,210614
132413002300000,NW 339,Residential,37060,0,37060,152675,0,189735
132413002400000,NW 337,Residential,64200,0,64200,183646,0,247846
132413100100000,NW 337,Residential,29264,0,29264,123214,0,152478
132413200100000,NW 309,Residential,37471,0,37471,232629,0,270100
132413200700000,NW 309,Residential,37048,0,37048,242952,0,280000
132413200800000,NW 309,Residential,36193,0,36193,174184,0,210377
132413200900000,NW 309,Residential,33048,0,33048,227765,0,260813
132413201000000,NW 309,Residential,36720,0,36720,0,0,36720
132415100200000,NW 337,Residential,61250,0,61250,134283,0,195533
132415200100000,NW 309,Residential,61950,0,61950,41152,0,103102
132415200200000,NW 309,Residential,72950,0,72950,37831,0,110781
132415200300000,NW 309,Residential,64450,0,64450,172103,0,236553
132415200500000,NW 342,Residential,900,0,900,0,0,900
132415200600000,NW 342,Residential,28900,0,28900,157734,0,186634
132415200700000,NW 342,Residential,29070,0,29070,195665,0,224735
132415200800000,NW 342,Residential,28305,0,28305,166695,0,195000
132415200900000,NW 342,Residential,27455,0,27455,194351,0,221806
132415201000000,NW 342,Residential,28305,0,28305,153479,0,181784
132415201100000,NW 342,Residential,26350,0,26350,124053,0,150403
132415201200000,NW 342,Residential,26350,0,26350,122205,0,148555
132415201300000,NW 342,Residential,26350,0,26350,122998,0,149348
132415201400000,NW 339,Residential,45040,0,45040,203533,0,248573
132415201500000,NW 339,Residential,44887,0,44887,245308,0,290195
132415201600000,NW 339,Residential,44460,0,44460,0,0,44460
132415201700000,NW 339,Residential,56120,0,56120,353639,0,409759
132415201800000,NW 339,Residential,64521,0,64521,974983,0,1039504
132415201900000,NW 339,Residential,59816,0,59816,372075,0,431891
132415202000000,NW 339,Residential,39351,0,39351,0,0,39351
132415202100000,NW 339,Residential,39900,0,39900,0,0,39900
132415202200000,NW 339,Residential,39900,0,39900,275963,0,315863
132415202300000,NW 339,Residential,39900,0,39900,0,0,39900
132415202400000,CITY PROPERTY,Exempt,0,0,0,0,0,0
132415300100000,SCHOOL,Exempt,0,0,0,0,0,0
132415300200000,CITY PROPERTY,Exempt,0,0,0,0,0,0
132415300300000,NW 342,Residential,27815,0,27815,144327,0,172142
132415300400000,NW 342,Residential,26665,0,26665,132530,0,159195
132415300500000,NW 342,Residential,27994,0,27994,161236,0,189230
132415300600000,NW 342,Residential,28457,0,28457,160185,0,188642
132415300700000,NW 342,Residential,29437,0,29437,152414,0,181851
132415300800000,NW 342,Residential,28091,0,28091,156562,0,184653
132415300900000,NW 342,Residential,28019,0,28019,147170,0,175189
132415301000000,NW 342,Residential,26130,0,26130,135130,0,161260
132415301100000,NW 342,Residential,25925,0,25925,163969,0,189894
132415301200000,NW 342,Residential,25925,0,25925,156340,0,182265
132415301300000,NW 342,Residential,25925,0,25925,148020,0,173945
132415301400000,NW 342,Residential,27540,0,27540,132606,0,160146
132415301500000,CITY PROPERTY,Exempt,0,0,0,0,0,0
132415301600000,NW 337,Residential,31065,0,31065,61000,0,92065
132415400100000,NW 342,Residential,30603,0,30603,165068,0,195671
132415400200000,NW 342,Residential,25713,0,25713,141598,0,167311
132415400300000,NW 342,Residential,28050,0,28050,119803,0,147853
132415400400000,NW 342,Residential,28050,0,28050,142587,0,170637
132415400500000,NW 342,Residential,26563,0,26563,165598,0,192161
132415400600000,NW 342,Residential,22932,0,22932,164701,0,187633
132415400700000,NW 342,Residential,21943,0,21943,167331,0,189274
132415400800000,NW 342,Residential,22698,0,22698,145511,0,168209
132415400900000,NW 342,Residential,25767,0,25767,149951,0,175718
132415401000000,NW 342,Residential,27806,0,27806,141949,0,169755
132415401100000,NW 342,Residential,30300,0,30300,121546,0,151846
132415401200000,NW 342,Residential,28552,0,28552,136030,0,164582
132417600100000,NW 337,Residential,54000,0,54000,97356,0,151356
132417600200000,NW 309,Residential,41540,0,41540,171264,0,212804
132417600300000,NW 309,Residential,37583,0,37583,167364,0,204947
132417600400000,NW 309,Residential,44472,0,44472,160527,0,204999
132417600500000,NW 309,Residential,44872,0,44872,144704,0,189576
132417600600000,NW 309,Residential,60020,0,60020,329354,0,389374
132417600700000,NW 309,Residential,40120,0,40120,173005,0,213125
132417600800000,NW 309,Residential,65878,0,65878,109122,0,175000
132417600900000,NW 309,Residential,76550,0,76550,0,0,76550
132417601000000,NW 309,Residential,71300,0,71300,156270,0,227570
132417601100000,NW 337,Residential,57000,0,57000,137210,0,194210
132417601200000,NW 309,Residential,20,0,20,0,0,20
132417601300000,NW 309,Residential,20,0,20,0,0,20
132417601400000,NW 309,Residential,20,0,20,0,0,20
132417601500000,NW 309,Residential,20,0,20,0,0,20
132417601600000,NW 309,Residential,20,0,20,0,0,20
132417700100000,APARTMENT,Commercial,0,386640,386640,0,3030114,3416754
132417700200000,NW 315,Residential,27467,0,27467,198468,0,225935
132417700300000,NW 315,Residential,28804,0,28804,243400,0,272204
132417700400000,NW 315,Residential,33045,0,33045,191840,0,224885
132417700500000,NW 315,Residential,29513,0,29513,213305,0,242818
132417700600000,NW 315,Residential,29348,0,29348,191809,0,221157
132417700800000,NW 315,Residential,35760,0,35760,275939,0,311699
132417700900000,NW 315,Residential,29548,0,29548,220286,0,249834
132417701000000,NW 315,Residential,33988,0,33988,208871,0,242859
132417701100000,NW 315,Residential,33498,0,33498,242449,0,275947
132417701200000,NW 315,Residential,31373,0,31373,255186,0,286559
132417701300000,NW 315,Residential,31560,0,31560,182076,0,213636
132417701400000,NW 315,Residential,30720,0,30720,217045,0,247765
132417701500000,NW 315,Residential,30720,0,30720,192299,0,223019
132417701600000,NW 315,Residential,33819,0,33819,254080,0,287899
132417701700000,NW 315,Residential,29788,0,29788,243046,0,272834
132417701800000,NW 315,Residential,32044,0,32044,175617,0,207661
132417701900000,NW 315,Residential,31172,0,31172,185408,0,216580
132417702000000,NW 309,Residential,46604,0,46604,48017,0,94621
132417702100000,NW 315,Residential,31202,0,31202,218973,0,250175
132417702200000,NW 315,Residential,26842,0,26842,214236,0,241078
132417702300000,NW 315,Residential,27867,0,27867,193662,0,221529
132417702400000,NW 315,Residential,31040,0,31040,217134,0,248174
132417702500000,NW 315,Residential,30720,0,30720,221377,0,252097
132417702600000,NW 315,Residential,30720,0,30720,185938,0,216658
132417702700000,NW 315,Residential,34560,0,34560,208569,0,243129
132417702800000,NW 315,Residential,41827,0,41827,223829,0,265656
132417702900000,NW 315,Residential,40972,0,40972,239175,0,280147
132417703000000,NW 315,Residential,42851,0,42851,242024,0,284875
132417703100000,NW 315,Residential,48663,0,48663,187558,0,236221
132417703200000,NW 315,Residential,160,0,160,0,0,160
132420100300000,NW 309,Residential,575,0,575,0,0,575
132420100400000,NW 309,Residential,575,0,575,0,0,575
132420100500000,NW 309,Residential,1255,0,1255,0,0,1255
132420100600000,NW 309,Residential,39828,0,39828,264004,0,303832
132420100700000,NW 309,Residential,39936,0,39936,190604,0,230540
132420100800000,NW 309,Residential,41684,0,41684,268761,0,310445
132420100900000,NW 309,Residential,46070,0,46070,0,0,46070
132420101000000,NW 309,Residential,30600,0,30600,194786,0,225386
132420101100000,NW 309,Residential,30600,0,30600,106902,0,137502
132420101200000,NW 309,Residential,155,0,155,0,0,155
132420101300000,NW 309,Residential,31320,0,31320,177562,0,208882
132420101400000,NW 309,Residential,35290,0,35290,191904,0,227194
132420200100000,NW 309,Residential,39932,0,39932,219123,0,259055
132420200200000,NW 309,Residential,34944,0,34944,208897,0,243841
132420200300000,NW 309,Residential,35942,0,35942,241695,0,277637
132420200500000,NW 309,Residential,45338,0,45338,233345,0,278683
132420200600000,NW 309,Residential,41512,0,41512,277986,0,319498
132420200700000,NW 309,Residential,47643,0,47643,291319,0,338962
132420300100000,NW 309,Residential,33480,0,33480,136992,0,170472
132420300200000,NW 309,Residential,30000,0,30000,139376,0,169376
132420300300000,NW 309,Residential,30000,0,30000,166305,0,196305
132420300400000,NW 309,Residential,30000,0,30000,148980,0,178980
132420300500000,NW 309,Residential,30000,0,30000,130703,0,160703
132420300600000,NW 309,Residential,30000,0,30000,138529,0,168529
132420300700000,NW 309,Residential,30000,0,30000,142026,0,172026
132420300800000,NW 309,Residential,29777,0,29777,168815,0,198592
132420300900000,NW 309,Residential,31282,0,31282,170279,0,201561
132420301000000,NW 309,Residential,26640,0,26640,113850,0,140490
132420400100000,NW 309,Residential,32717,0,32717,131279,0,163996
132420400200000,NW 309,Residential,34406,0,34406,201013,0,235419
132420400300000,NW 309,Residential,36809,0,36809,243057,0,279866
132420400400000,NW 309,Residential,34452,0,34452,250609,0,285061
132420400500000,NW 309,Residential,33024,0,33024,193682,0,226706
132420400600000,NW 309,Residential,37128,0,37128,265637,0,302765
132420400700000,NW 309,Residential,37128,0,37128,265338,0,302466
132420400800000,NW 309,Residential,35496,0,35496,245708,0,281204
132420400900000,NW 309,Residential,35088,0,35088,233387,0,268475
132420401000000,NW 309,Residential,37128,0,37128,233561,0,270689
132420401100000,NW 309,Residential,42083,0,42083,367162,0,409245
132420401700000,NW 309,Residential,51400,0,51400,209973,0,261373
132420402000000,NW 309,Residential,25600,0,25600,107454,0,133054
132420402100000,NW 309,Residential,27934,0,27934,141299,0,169233
132420402200000,NW 309,Residential,30000,0,30000,122091,0,152091
132420402300000,NW 309,Residential,30000,0,30000,148792,0,178792
132420402400000,NW 309,Residential,30000,0,30000,172767,0,202767
132420402500000,NW 309,Residential,30000,0,30000,121967,0,151967
132420402600000,NW 309,Residential,29483,0,29483,128054,0,157537
132420402700000,NW 309,Residential,29940,0,29940,132370,0,162310
132420500600000,NW 337,Residential,60000,0,60000,206284,0,266284
132422600200000,NW 309,Residential,44185,0,44185,254775,0,298960
132422600300000,NW 309,Residential,65500,0,65500,140585,0,206085
132422601300000,NW 309,Residential,48199,0,48199,296296,0,344495
132422601400000,NW 309,Residential,45629,0,45629,287454,0,333083
132422601500000,NW 309,Residential,43978,0,43978,0,0,43978
132422601600000,NW 309,Residential,10487,0,10487,0,0,10487
132422601700000,NW 309,Residential,10486,0,10486,0,0,10486
132422800100000,NW 309,Residential,48988,0,48988,294882,0,343870
132422800200000,NW 309,Residential,46359,0,46359,295187,0,341546
132422800300000,NW 309,Residential,45501,0,45501,334313,0,379814
132422800400000,NW 309,Residential,36754,0,36754,0,0,36754
132422800500000,NW 309,Residential,36384,0,36384,0,0,36384
132422900100000,NW 309,Residential,42925,0,42925,0,0,42925
132422900200000,NW 309,Residential,14406,0,14406,0,0,14406
132422900300000,NW 309,Residential,43656,0,43656,234852,0,278508
132422900400000,NW 309,Residential,46944,0,46944,0,0,46944
132422900500000,NW 309,Residential,44090,0,44090,0,0,44090
132422900600000,NW 309,Residential,56270,0,56270,0,0,56270
132422900700000,NW 309,Residential,34272,0,34272,0,0,34272
132422900800000,NW 309,Residential,1341,0,1341,0,0,1341
132423000100000,NW 345,Residential,17226,0,17226,169827,0,187053
132423000200000,NW 345,Residential,18281,0,18281,0,0,18281
132423000300000,NW 345,Residential,18432,0,18432,134851,0,153283
132423000400000,NW 345,Residential,20497,0,20497,148016,0,168513
132423000500000,NW 345,Residential,23626,0,23626,153058,0,176684
132423000600000,NW 345,Residential,60010,0,60010,0,0,60010
132423000700000,NW 345,Residential,27068,0,27068,178424,0,205492
132423000800000,NW 345,Residential,21815,0,21815,202353,0,224168
132423000900000,NW 345,Residential,21430,0,21430,159831,0,181261
132423001000000,NW 345,Residential,22618,0,22618,176485,0,199103
132423001100000,NW 345,Residential,21680,0,21680,165321,0,187001
132423001200000,NW 345,Residential,17234,0,17234,139500,0,156734
132423001300000,NW 345,Residential,17226,0,17226,147551,0,164777
132423001400000,NW 345,Residential,17160,0,17160,166686,0,183846
132423001500000,NW 345,Residential,17745,0,17745,170858,0,188603
132423001600000,NW 345,Residential,18810,0,18810,168835,0,187645
132423001700000,NW 345,Residential,19404,0,19404,155147,0,174551
132423001800000,NW 345,Residential,19800,0,19800,166285,0,186085
132423001900000,NW 345,Residential,20196,0,20196,180667,0,200863
132423002000000,NW 345,Residential,6750,0,6750,0,0,6750
132423100100000,NW 345,Residential,24030,0,24030,180187,0,204217
132423100200000,NW 345,Residential,19998,0,19998,186565,0,206563
132423100300000,NW 345,Residential,20592,0,20592,160291,0,180883
132423100400000,NW 345,Residential,20394,0,20394,173885,0,194279
132423100500000,NW 345,Residential,19602,0,19602,166543,0,186145
132423100600000,NW 345,Residential,21372,0,21372,155591,0,176963
132423100700000,NW 345,Residential,20592,0,20592,164665,0,185257
132423100800000,NW 345,Residential,20592,0,20592,171397,0,191989
132423100900000,NW 345,Residential,20592,0,20592,135928,0,156520
132423101000000,NW 345,Residential,20592,0,20592,135616,0,156208
132423200100000,NW 345,Residential,25553,0,25553,176923,0,202476
132423200200000,NW 345,Residential,19320,0,19320,178352,0,197672
132423200300000,NW 345,Residential,20151,0,20151,182171,0,202322
132423200400000,NW 345,Residential,24520,0,24520,186663,0,211183
132423200500000,NW 302,Residential,5700,0,5700,0,0,5700
132423200600000,NW 302,Residential,7633,0,7633,0,0,7633
132423200700000,NW 302,Residential,7286,0,7286,0,0,7286
132423200800000,NW 302,Residential,6390,0,6390,0,0,6390
132423200900000,NW 302,Residential,6098,0,6098,0,0,6098
132423300100000,NW 345,Residential,20598,0,20598,0,0,20598
132423300200000,NW 345,Residential,18900,0,18900,180223,0,199123
132423300300000,NW 345,Residential,18900,0,18900,181653,0,200553
132423300400000,NW 345,Residential,18900,0,18900,191592,0,210492
132423300500000,NW 302,Residential,67879,0,67879,0,0,67879
132423400100000,NW 345,Residential,19320,0,19320,176286,0,195606
132423400200000,NW 345,Residential,20372,0,20372,182830,0,203202
132423400300000,NW 302,Residential,21600,0,21600,163754,0,185354
132423400400000,NW 302,Residential,5205,0,5205,0,0,5205
132423400500000,NW 302,Residential,7683,0,7683,0,0,7683
132425100200000,NW 345,Residential,19005,0,19005,153751,0,172756
132425100300000,NW 345,Residential,18414,0,18414,157645,0,176059
132425100400000,NW 345,Residential,20339,0,20339,156087,0,176426
132425100500000,NW 345,Residential,22292,0,22292,164902,0,187194
132425100600000,NW 345,Residential,17675,0,17675,154686,0,172361
132425100700000,NW 345,Residential,21576,0,21576,197295,0,218871
132425100800000,NW 345,Residential,13985,0,13985,169195,0,183180
132425100900000,NW 345,Residential,16216,0,16216,172975,0,189191
132425101000000,NW 345,Residential,21028,0,21028,165682,0,186710
132425101100000,CITY PROPERTY,Exempt,0,0,0,0,0,0
132425200200000,NW 345,Residential,20085,0,20085,154762,0,174847
132425300200000,NW 345,Residential,25524,0,25524,191363,0,216887
132425300300000,NW 345,Residential,19788,0,19788,167430,0,187218
132425300400000,NW 345,Residential,20127,0,20127,159429,0,179556
132425300500000,NW 345,Residential,34202,0,34202,174798,0,209000
132425300800000,NW 345,Residential,22181,0,22181,157645,0,179826
132425300900000,NW 345,Residential,20187,0,20187,160362,0,180549
132425301000000,NW 345,Residential,19341,0,19341,227619,0,246960
132425301100000,NW 345,Residential,24102,0,24102,243668,0,267770
132425301200000,NW 345,Residential,24102,0,24102,0,0,24102
132425301400000,NW 345,Residential,22330,0,22330,0,0,22330
132425301500000,NW 345,Residential,16249,0,16249,0,0,16249
132425301600000,NW 345,Residential,18288,0,18288,0,0,18288
132425301700000,CITY PROPERTY,Exempt,0,0,0,0,0,0
132425301800000,NW 345,Residential,20808,0,20808,147854,0,168662
132425301900000,NW 345,Residential,15300,0,15300,148465,0,163765
132425302000000,NW 345,Residential,15300,0,15300,147109,0,162409
132425302100000,NW 345,Residential,15300,0,15300,149621,0,164921
132425302200000,NW 345,Residential,15300,0,15300,149621,0,164921
132425302300000,NW 345,Residential,15300,0,15300,149435,0,164735
132425302400000,NW 345,Residential,15150,0,15150,150288,0,165438
132425302500000,NW 345,Residential,15150,0,15150,150288,0,165438
132425302600000,NW 345,Residential,5174,0,5174,0,0,5174
132425302700000,NW 345,Residential,5174,0,5174,0,0,5174
132425302800000,NW 345,Residential,15150,0,15150,100015,0,115165
132425302900000,NW 345,Residential,15000,0,15000,100015,0,115015
132425303000000,NW 345,Residential,15000,0,15000,100015,0,115015
132425303100000,NW 345,Residential,15000,0,15000,100015,0,115015
132425303200000,NW 345,Residential,15000,0,15000,100015,0,115015
132425303300000,NW 345,Residential,15000,0,15000,100046,0,115046
132425303400000,NW 345,Residential,14850,0,14850,100015,0,114865
132425303500000,NW 302,Residential,7309,0,7309,0,0,7309
132425303600000,NW 302,Residential,7309,0,7309,0,0,7309
132425303700000,NW 302,Residential,7309,0,7309,0,0,7309
132425303800000,NW 302,Residential,7309,0,7309,0,0,7309
132425303900000,NW 302,Residential,8005,0,8005,0,0,8005
132425304000000,NW 302,Residential,9745,0,9745,0,0,9745
132425304100000,NW 302,Residential,10232,0,10232,0,0,10232
132425400100000,NW 345,Residential,20769,0,20769,164121,0,184890
132425400200000,NW 345,Residential,20733,0,20733,153618,0,174351
132425400300000,NW 345,Residential,20733,0,20733,154108,0,174841
132425400400000,NW 345,Residential,20940,0,20940,153618,0,174558
132425400500000,NW 345,Residential,20940,0,20940,179146,0,200086
132425400600000,NW 345,Residential,20940,0,20940,153618,0,174558
132425400700000,NW 345,Residential,20940,0,20940,176840,0,197780
132425400800000,NW 345,Residential,21148,0,21148,154328,0,175476
132425400900000,NW 345,Residential,21148,0,21148,150991,0,172139
132425401000000,NW 345,Residential,21148,0,21148,159081,0,180229
132425401100000,NW 345,Residential,20784,0,20784,149123,0,169907
132425500100000,NW 345,Residential,19967,0,19967,152492,0,172459
132425500200000,NW 345,Residential,20663,0,20663,163725,0,184388
132425500300000,NW 345,Residential,19020,0,19020,153618,0,172638
132425500400000,NW 345,Residential,19020,0,19020,151166,0,170186
132425500500000,NW 345,Residential,19020,0,19020,153618,0,172638
132425500600000,NW 345,Residential,19020,0,19020,152951,0,171971
132425500700000,NW 345,Residential,19020,0,19020,153347,0,172367
132425500800000,NW 345,Residential,19020,0,19020,165760,0,184780
132425500900000,NW 345,Residential,19020,0,19020,162505,0,181525
132425501000000,NW 345,Residential,19020,0,19020,174761,0,193781
132425501100000,NW 345,Residential,19020,0,19020,152573,0,171593
132425501200000,NW 345,Residential,19020,0,19020,158491,0,177511
132425501300000,NW 345,Residential,19759,0,19759,173203,0,192962
132425501400000,NW 345,Residential,19967,0,19967,153018,0,172985
132425501500000,NW 345,Residential,19967,0,19967,153618,0,173585
132425501600000,NW 345,Residential,19967,0,19967,154762,0,174729
132425501700000,NW 345,Residential,19967,0,19967,164774,0,184741
132425501800000,NW 345,Residential,19967,0,19967,154272,0,174239
132425501900000,NW 345,Residential,19967,0,19967,151166,0,171133
132425502000000,NW 345,Residential,19967,0,19967,154272,0,174239
132425502100000,NW 345,Residential,19967,0,19967,149608,0,169575
132425502200000,NW 345,Residential,19967,0,19967,150903,0,170870
132425600100000,NW 345,Residential,21891,0,21891,154762,0,176653
132425600300000,NW 345,Residential,19901,0,19901,132144,0,152045
132425600400000,NW 345,Residential,19901,0,19901,150513,0,170414
132425600500000,NW 345,Residential,19901,0,19901,153166,0,173067
132425600600000,NW 345,Residential,19901,0,19901,154762,0,174663
132425600700000,NW 345,Residential,19901,0,19901,163892,0,183793
132425600800000,NW 345,Residential,19901,0,19901,163244,0,183145
132425600900000,NW 345,Residential,19901,0,19901,153563,0,173464
132425601000000,NW 345,Residential,19901,0,19901,154490,0,174391
132425601100000,NW 345,Residential,19901,0,19901,154762,0,174663
132425601200000,NW 345,Residential,19901,0,19901,161933,0,181834
132425601300000,NW 345,Residential,21042,0,21042,164958,0,186000
132425601400000,NW 345,Residential,19992,0,19992,182959,0,202951
132425601500000,NW 345,Residential,19901,0,19901,156768,0,176669
132425601600000,NW 345,Residential,19901,0,19901,180722,0,200623
132425601700000,NW 345,Residential,19901,0,19901,170669,0,190570
132425601800000,NW 345,Residential,19901,0,19901,160250,0,180151
132425601900000,NW 345,Residential,19901,0,19901,190598,0,210499
132425602000000,NW 345,Residential,19901,0,19901,165741,0,185642
132425602100000,NW 345,Residential,19901,0,19901,198476,0,218377
132425602200000,NW 345,Residential,19901,0,19901,185020,0,204921
132425602300000,NW 345,Residential,19901,0,19901,169309,0,189210
132425602400000,NW 345,Residential,19901,0,19901,167288,0,187189
132425700400000,NW 345,Residential,22464,0,22464,210482,0,232946
132425700500000,NW 345,Residential,22464,0,22464,190270,0,212734
132425700600000,NW 345,Residential,22464,0,22464,149831,0,172295
132425700700000,NW 345,Residential,22464,0,22464,184168,0,206632
132425700800000,NW 345,Residential,22464,0,22464,172114,0,194578
132425700900000,NW 345,Residential,22464,0,22464,227071,0,249535
132425701000000,NW 345,Residential,22464,0,22464,228379,0,250843
132425701100000,NW 345,Residential,22464,0,22464,193659,0,216123
132425701200000,NW 345,Residential,22464,0,22464,180530,0,202994
132425701300000,NW 345,Residential,22464,0,22464,168975,0,191439
132425701400000,NW 345,Residential,21654,0,21654,242063,0,263717
132425701700000,NW 345,Residential,14400,0,14400,161725,0,176125
132425701800000,NW 345,Residential,14400,0,14400,153433,0,167833
132425701900000,NW 345,Residential,14400,0,14400,156850,0,171250
132425702000000,NW 345,Residential,14400,0,14400,153903,0,168303
132425702100000,NW 345,Residential,14400,0,14400,152576,0,166976
132425702200000,NW 345,Residential,14400,0,14400,152792,0,167192
132425702300000,NW 345,Residential,14400,0,14400,169172,0,183572
132425702400000,NW 345,Residential,14400,0,14400,142885,0,157285
132425702500000,NW 345,Residential,14400,0,14400,143455,0,157855
132425702600000,NW 345,Residential,14400,0,14400,156765,0,171165
132425702700000,NW 345,Residential,14400,0,14400,127308,0,141708
132425702800000,NW 345,Residential,14400,0,14400,131912,0,146312
132425702900000,NW 345,Residential,14400,0,14400,127308,0,141708
132425703000000,NW 345,Residential,14400,0,14400,127308,0,141708
132425703100000,NW 345,Residential,14400,0,14400,127308,0,141708
132425703200000,NW 345,Residential,4666,0,4666,0,0,4666
132425703300000,NW 345,Residential,4666,0,4666,0,0,4666
132425800100000,NW 345,Residential,21087,0,21087,143220,0,164307
132425800200000,NW 345,Residential,21934,0,21934,157023,0,178957
132427600100000,NW 337,Residential,39195,0,39195,96808,0,136003
132427600200000,NW 337,Residential,28890,0,28890,41124,0,70014
132427600300000,NW 337,Residential,33900,0,33900,136654,0,170554
132427600400000,NW 337,Residential,33900,0,33900,164296,0,198196
132427600500000,NW 337,Residential,36000,0,36000,178548,0,214548
132427600600000,NW 337,Residential,36393,0,36393,79302,0,115695
132427600800000,NW 337,Residential,37800,0,37800,101046,0,138846
132427600900000,NW 337,Residential,37800,0,37800,141025,0,178825
132427601000000,NW 337,Residential,37800,0,37800,74167,0,111967
132427601100000,NW 337,Residential,22680,0,22680,0,0,22680
132427601200000,NW 337,Residential,37800,0,37800,111669,0,149469
132427601300000,NW 337,Residential,37800,0,37800,114137,0,151937
132427601400000,NW 337,Residential,37800,0,37800,81370,0,119170
132427601500000,NW 337,Residential,37800,0,37800,84410,0,122210
132427601600000,NW 337,Residential,34581,0,34581,128738,0,163319
132427700100000,NW 337,Residential,42646,0,42646,74656,0,117302
132427700200000,NW 337,Residential,31590,0,31590,108671,0,140261
132427700300000,NW 337,Residential,35100,0,35100,83117,0,118217
132427700400000,NW 337,Residential,35100,0,35100,139049,0,174149
132427700500000,NW 337,Residential,35100,0,35100,112641,0,147741
132427700600000,NW 337,Residential,35100,0,35100,152089,0,187189
132427700700000,NW 337,Residential,31124,0,31124,174466,0,205590
132427700800000,NW 337,Residential,22950,0,22950,79818,0,102768
132427700900000,NW 337,Residential,29431,0,29431,129045,0,158476
132427701000000,NW 337,Residential,29970,0,29970,108197,0,138167
132427701100000,NW 337,Residential,29970,0,29970,93352,0,123322
132427701200000,NW 337,Residential,29970,0,29970,100744,0,130714
132427701300000,NW 337,Residential,29970,0,29970,78708,0,108678
132427701500000,NW 337,Residential,29970,0,29970,122721,0,152691
132427701600000,NW 337,Residential,29970,0,29970,91405,0,121375
132427701700000,NW 337,Residential,29970,0,29970,94034,0,124004
132427701800000,NW 337,Residential,29970,0,29970,111865,0,141835
132427701900000,NW 337,Residential,29548,0,29548,83576,0,113124
132427702000000,NW 337,Residential,30709,0,30709,99204,0,129913
132427702100000,NW 337,Residential,30709,0,30709,81729,0,112438
132427702200000,NW 337,Residential,29548,0,29548,88873,0,118421
132427702300000,NW 337,Residential,29970,0,29970,97709,0,127679
132427702400000,NW 337,Residential,29970,0,29970,122427,0,152397
132427702500000,NW 337,Residential,29970,0,29970,101527,0,131497
132427702600000,NW 337,Residential,29970,0,29970,132432,0,162402
132427702700000,NW 337,Residential,21316,0,21316,132787,0,154103
132427702800000,NW 337,Residential,24103,0,24103,119532,0,143635
132427800100000,NW 337,Residential,33109,0,33109,95400,0,128509
132427800200000,NW 337,Residential,33257,0,33257,54648,0,87905
132427800300000,NW 337,Residential,37500,0,37500,128137,0,165637
132427800400000,NW 337,Residential,37500,0,37500,129073,0,166573
132427800500000,NW 337,Residential,37500,0,37500,118218,0,155718
132427800600000,NW 337,Residential,37500,0,37500,139170,0,176670
132427800700000,NW 337,Residential,30000,0,30000,0,0,30000
132427800800000,NW 337,Residential,37500,0,37500,81394,0,118894
132430100100000,NW 337,Residential,36750,0,36750,87519,0,124269
132430100200000,NW 337,Residential,40260,0,40260,72848,0,113108
132430100300000,NW 337,Residential,34749,0,34749,111935,0,146684
132430100400000,NW 337,Residential,31860,0,31860,139272,0,171132
132430100500000,NW 337,Residential,28890,0,28890,144344,0,173234
132430100600000,NW 337,Residential,23760,0,23760,0,0,23760
132430100700000,NW 337,Residential,25344,0,25344,0,0,25344
132430100800000,NW 337,Residential,26884,0,26884,65272,0,92156
132430100900000,NW 337,Residential,37440,0,37440,77217,0,114657
132430101000000,NW 337,Residential,25175,0,25175,138795,0,163970
132430101100000,NW 337,Residential,26122,0,26122,91860,0,117982
132430101200000,NW 337,Residential,20268,0,20268,109446,0,129714
132430101300000,NW 337,Residential,37500,0,37500,147219,0,184719
132430200100000,NW 337,Residential,49640,0,49640,89527,0,139167
132430200200000,NW 337,Residential,17473,0,17473,98382,0,115855
132430200300000,NW 337,Residential,39487,0,39487,71444,0,110931
132430200400000,NW 337,Residential,71300,0,71300,87919,0,159219
132430200600000,NW 337,Residential,63850,0,63850,108502,0,172352
132430200700000,NW 309,Residential,22897,0,22897,122767,0,145664
132430200800000,NW 309,Residential,21420,0,21420,124475,0,145895
132430200900000,NW 309,Residential,21420,0,21420,152672,0,174092
132430201000000,NW 309,Residential,21420,0,21420,125183,0,146603
132430201100000,NW 309,Residential,24255,0,24255,141515,0,165770
132430201200000,NW 309,Residential,24255,0,24255,166973,0,191228
132430201300000,NW 309,Residential,24435,0,24435,144904,0,169339
132430201400000,NW 309,Residential,25187,0,25187,129697,0,154884
132430201500000,NW 309,Residential,27386,0,27386,140992,0,168378
132430201600000,NW 309,Residential,28006,0,28006,105969,0,133975
132430201700000,NW 309,Residential,27386,0,27386,171299,0,198685
132430201800000,NW 309,Residential,24482,0,24482,164705,0,189187
132430201900000,NW 309,Residential,24255,0,24255,149988,0,174243
132430202000000,NW 309,Residential,24255,0,24255,170310,0,194565
132430202100000,NW 309,Residential,1150,0,1150,0,0,1150
132430300200000,NW 337,Residential,38376,0,38376,96190,0,134566
132430300300000,NW 337,Residential,27468,0,27468,101411,0,128879
132430300400000,NW 337,Residential,27468,0,27468,132245,0,159713
132430300500000,NW 337,Residential,37125,0,37125,116943,0,154068
132430300700000,NW 337,Residential,37125,0,37125,99735,0,136860
132430300800000,NW 337,Residential,37125,0,37125,105917,0,143042
132430300900000,NW 337,Residential,37125,0,37125,97418,0,134543
132430301000000,NW 337,Residential,30636,0,30636,78367,0,109003
132430301100000,NW 337,Residential,38605,0,38605,89192,0,127797
132430301200000,NW 337,Residential,37125,0,37125,112157,0,149282
132430301300000,NW 337,Residential,37125,0,37125,106792,0,143917
132430301400000,NW 337,Residential,37125,0,37125,92723,0,129848
132430301500000,NW 337,Residential,37125,0,37125,68920,0,106045
132430301600000,NW 337,Residential,37125,0,37125,68066,0,105191
132430301700000,NW 337,Residential,37125,0,37125,166052,0,203177
132430301800000,NW 337,Residential,31500,0,31500,98155,0,129655
132430301900000,NW 337,Residential,27468,0,27468,67077,0,94545
132430302100000,NW 337,Residential,27403,0,27403,148735,0,176138
132430302200000,NW 337,Residential,55800,0,55800,0,0,55800
132430302300000,NW 337,Residential,55800,0,55800,104090,0,159890
132432600100000,NW 345,Residential,22118,0,22118,147647,0,169765
132432600200000,NW 345,Residential,22766,0,22766,154478,0,177244
132432600300000,NW 345,Residential,23871,0,23871,155023,0,178894
132432600400000,NW 345,Residential,22032,0,22032,163075,0,185107
132432600500000,NW 345,Residential,20777,0,20777,162593,0,183370
132432600600000,NW 345,Residential,19291,0,19291,176428,0,195719
132432600700000,CITY PROPERTY,Exempt,0,0,0,0,0,0
132432600800000,NW 345,Residential,20198,0,20198,169771,0,189969
132432600900000,NW 345,Residential,20790,0,20790,168543,0,189333
132432601000000,NW 345,Residential,23718,0,23718,151560,0,175278
132432601100000,NW 345,Residential,24778,0,24778,176445,0,201223
132432601200000,NW 345,Residential,25459,0,25459,164537,0,189996
132432601300000,NW 345,Residential,23192,0,23192,155990,0,179182
132432601400000,NW 345,Residential,22938,0,22938,159773,0,182711
132432700100000,NW 345,Residential,19551,0,19551,169836,0,189387
132432700200000,NW 345,Residential,19020,0,19020,133248,0,152268
132432700300000,NW 345,Residential,19175,0,19175,149533,0,168708
132432700400000,NW 345,Residential,20254,0,20254,159517,0,179771
132432700500000,NW 345,Residential,20079,0,20079,156991,0,177070
132432700600000,NW 345,Residential,20211,0,20211,152681,0,172892
132432800100000,NW 345,Residential,19901,0,19901,172923,0,192824
132432800200000,NW 345,Residential,19899,0,19899,164305,0,184204
132432800300000,NW 345,Residential,22481,0,22481,163826,0,186307
132432800400000,NW 345,Residential,21258,0,21258,147298,0,168556
132432800500000,NW 345,Residential,21369,0,21369,166504,0,187873
132432800900000,NW 345,Residential,18360,0,18360,148110,0,166470
132432801000000,NW 345,Residential,22770,0,22770,170812,0,193582
132432801100000,NW 345,Residential,20070,0,20070,152196,0,172266
132432801200000,NW 345,Residential,19901,0,19901,179525,0,199426
132432801300000,NW 345,Residential,19901,0,19901,171838,0,191739
132432801400000,NW 345,Residential,21122,0,21122,202421,0,223543
132432801500000,NW 345,Residential,20045,0,20045,179309,0,199354
132432801600000,NW 345,Residential,20400,0,20400,148308,0,168708
132432900200000,NW 345,Residential,20740,0,20740,154751,0,175491
132432901000000,NW 345,Residential,22464,0,22464,181145,0,203609
132432901100000,NW 345,Residential,22464,0,22464,196112,0,218576
132432901200000,NW 345,Residential,22464,0,22464,181878,0,204342
132432901300000,NW 345,Residential,21528,0,21528,184022,0,205550
132432901500000,NW 345,Residential,8901,0,8901,0,0,8901
132432901600000,NW 345,Residential,13950,0,13950,162543,0,176493
132432901700000,NW 345,Residential,14250,0,14250,145750,0,160000
132432901800000,NW 345,Residential,14400,0,14400,155626,0,170026
132432901900000,NW 345,Residential,14400,0,14400,145732,0,160132
132432902000000,NW 345,Residential,14400,0,14400,157644,0,172044
132433000100000,NW 345,Residential,20544,0,20544,169529,0,190073
132433000200000,NW 345,Residential,19264,0,19264,161071,0,180335
132433000300000,NW 345,Residential,17620,0,17620,146655,0,164275
132433000400000,NW 345,Residential,18650,0,18650,148465,0,167115
132433000500000,NW 345,Residential,16226,0,16226,0,0,16226
132433000600000,NW 345,Residential,12675,0,12675,0,0,12675
132433000700000,NW 345,Residential,16050,0,16050,0,0,16050
132433000800000,NW 345,Residential,16335,0,16335,100015,0,116350
132433000900000,NW 345,Residential,14850,0,14850,100015,0,114865
132433001000000,NW 345,Residential,14850,0,14850,100015,0,114865
132433001100000,NW 345,Residential,14850,0,14850,108869,0,123719
132433100100000,NW 326,Residential,69750,0,69750,103968,0,173718
132433100200000,NW 326,Residential,69850,0,69850,0,0,69850
132435100100000,NW 326,Residential,26887,0,26887,132323,0,159210
132435100200000,NW 326,Residential,23312,0,23312,90469,0,113781
132435100300000,NW 326,Residential,26725,0,26725,107332,0,134057
132435100400000,NW 326,Residential,29171,0,29171,115992,0,145163
132435100500000,NW 326,Residential,24755,0,24755,115190,0,139945
132435100600000,NW 326,Residential,27608,0,27608,127269,0,154877
132435100700000,NW 326,Residential,23040,0,23040,121089,0,144129
132435100800000,NW 326,Residential,24960,0,24960,111735,0,136695
132435100900000,NW 326,Residential,24552,0,24552,103012,0,127564
132435101000000,NW 326,Residential,26400,0,26400,98532,0,124932
132435101100000,NW 326,Residential,25515,0,25515,102387,0,127902
132435101200000,NW 326,Residential,25693,0,25693,107155,0,132848
132435101300000,NW 326,Residential,23712,0,23712,123220,0,146932
132435101400000,NW 326,Residential,24662,0,24662,105645,0,130307
132435101500000,NW 326,Residential,23560,0,23560,101896,0,125456
132435101600000,NW 326,Residential,27075,0,27075,122244,0,149319
132435101700000,NW 326,Residential,27075,0,27075,116305,0,143380
132435101800000,NW 326,Residential,24402,0,24402,113355,0,137757
132435101900000,NW 326,Residential,26790,0,26790,106160,0,132950
132435102000000,NW 326,Residential,26885,0,26885,114381,0,141266
132435200100000,NW 326,Residential,26171,0,26171,113210,0,139381
132435200200000,NW 326,Residential,24922,0,24922,110252,0,135174
132435200300000,NW 326,Residential,23808,0,23808,108039,0,131847
132435200400000,NW 326,Residential,24922,0,24922,120637,0,145559
132435200500000,NW 326,Residential,23808,0,23808,126372,0,150180
132435200600000,NW 326,Residential,26380,0,26380,130638,0,157018
132435300100000,NW 326,Residential,26486,0,26486,136322,0,162808
132435300200000,NW 326,Residential,23312,0,23312,98596,0,121908
132435300300000,NW 326,Residential,24402,0,24402,106953,0,131355
132435300400000,NW 326,Residential,26790,0,26790,112515,0,139305
132435300500000,NW 326,Residential,24402,0,24402,116638,0,141040
132435300600000,NW 326,Residential,26076,0,26076,110196,0,136272
132435300700000,NW 326,Residential,19247,0,19247,119429,0,138676
132435300800000,NW 326,Residential,22936,0,22936,101026,0,123962
132435300900000,NW 326,Residential,24641,0,24641,107852,0,132493
132435301000000,NW 326,Residential,24189,0,24189,101899,0,126088
132435301100000,NW 326,Residential,23312,0,23312,127264,0,150576
132435301200000,NW 326,Residential,26790,0,26790,129789,0,156579
132435301300000,NW 326,Residential,23312,0,23312,126681,0,149993
132435301400000,NW 326,Residential,24402,0,24402,113524,0,137926
132435301500000,NW 326,Residential,26790,0,26790,121206,0,147996
132435301600000,NW 326,Residential,24402,0,24402,124452,0,148854
132435301700000,NW 326,Residential,24402,0,24402,122845,0,147247
132435301800000,NW 326,Residential,25129,0,25129,129968,0,155097
132435400100000,NW 326,Residential,27369,0,27369,111063,0,138432
132435400200000,NW 326,Residential,23654,0,23654,104056,0,127710
132435400300000,NW 326,Residential,28465,0,28465,127279,0,155744
132435400400000,NW 326,Residential,25544,0,25544,109959,0,135503
132435400500000,NW 326,Residential,26896,0,26896,126764,0,153660
132435400600000,NW 326,Residential,26539,0,26539,118286,0,144825
132435400700000,NW 326,Residential,25840,0,25840,116859,0,142699
132435400800000,NW 326,Residential,28859,0,28859,104980,0,133839
132435500100000,NW 326,Residential,27635,0,27635,119377,0,147012
132435500200000,NW 326,Residential,24480,0,24480,114312,0,138792
132435500300000,NW 326,Residential,24480,0,24480,104235,0,128715
132435500400000,NW 326,Residential,26479,0,26479,138027,0,164506
132435500500000,NW 326,Residential,26479,0,26479,102060,0,128539
132435500600000,NW 326,Residential,26479,0,26479,110378,0,136857
132435500700000,NW 326,Residential,26479,0,26479,117265,0,143744
132435500800000,NW 326,Residential,27348,0,27348,118446,0,145794
132435500900000,NW 326,Residential,29036,0,29036,111957,0,140993
132435501000000,NW 326,Residential,27490,0,27490,113050,0,140540
132435501100000,NW 326,Residential,26787,0,26787,108124,0,134911
132435501200000,NW 326,Residential,25700,0,25700,116100,0,141800
132435501300000,NW 326,Residential,25700,0,25700,129825,0,155525
132435501400000,NW 326,Residential,26141,0,26141,116535,0,142676
132435501500000,NW 326,Residential,27178,0,27178,109603,0,136781
132435501600000,NW 326,Residential,28534,0,28534,114862,0,143396
132435501700000,NW 326,Residential,26557,0,26557,143265,0,169822
132435501800000,NW 326,Residential,23200,0,23200,125043,0,148243
132435501900000,NW 326,Residential,27608,0,27608,129493,0,157101
132435502000000,NW 326,Residential,22200,0,22200,125537,0,147737
132435502100000,NW 326,Residential,25960,0,25960,133370,0,159330
132435502200000,NW 326,Residential,24360,0,24360,157984,0,182344
132435502300000,NW 326,Residential,27360,0,27360,124023,0,151383
132435502400000,NW 326,Residential,28326,0,28326,130437,0,158763
132435502500000,NW 326,Residential,29427,0,29427,134182,0,163609
132435502600000,NW 326,Residential,27187,0,27187,119728,0,146915
132435502700000,NW 326,Residential,27082,0,27082,139299,0,166381
132435502800000,NW 326,Residential,27636,0,27636,129509,0,157145
132435502900000,NW 326,Residential,27212,0,27212,125617,0,152829
132435503000000,NW 326,Residential,25944,0,25944,131004,0,156948
132435503100000,NW 326,Residential,28637,0,28637,155035,0,183672
132435503200000,NW 326,Residential,29702,0,29702,140624,0,170326
132435503300000,NW 326,Residential,29088,0,29088,116863,0,145951
132435503400000,NW 326,Residential,29702,0,29702,143456,0,173158
132435503500000,NW 326,Residential,27773,0,27773,130919,0,158692
132435503600000,NW 326,Residential,26645,0,26645,128297,0,154942
132435503700000,NW 326,Residential,27588,0,27588,148416,0,176004
132435503800000,NW 326,Residential,26524,0,26524,159933,0,186457
132435503900000,NW 326,Residential,26714,0,26714,159807,0,186521
132435504000000,NW 326,Residential,26565,0,26565,117186,0,143751
132435504100000,NW 326,Residential,26928,0,26928,115735,0,142663
132435504200000,NW 326,Residential,26585,0,26585,121578,0,148163
132435504300000,NW 326,Residential,27283,0,27283,115915,0,143198
132435504400000,NW 326,Residential,26825,0,26825,123743,0,150568
132435504500000,NW 326,Residential,23760,0,23760,118182,0,141942
132435504600000,NW 326,Residential,25344,0,25344,117698,0,143042
132435504700000,NW 326,Residential,27839,0,27839,113021,0,140860
132435504800000,NW 326,Residential,27850,0,27850,112150,0,140000
132435504900000,NW 326,Residential,27086,0,27086,124911,0,151997
132435505000000,NW 326,Residential,24453,0,24453,144803,0,169256
132435505100000,NW 326,Residential,27086,0,27086,107039,0,134125
132435505200000,NW 326,Residential,23760,0,23760,105111,0,128871
132435505300000,NW 326,Residential,27388,0,27388,114881,0,142269
132435505400000,NW 326,Residential,23322,0,23322,120523,0,143845
132435505500000,NW 326,Residential,22672,0,22672,104280,0,126952
132435505600000,NW 326,Residential,24804,0,24804,97592,0,122396
132435505700000,NW 326,Residential,23040,0,23040,100986,0,124026
132435505800000,NW 326,Residential,23040,0,23040,118438,0,141478
132435505900000,NW 326,Residential,23040,0,23040,104576,0,127616
132435506000000,NW 326,Residential,23040,0,23040,106784,0,129824
132435506100000,NW 326,Residential,24922,0,24922,105870,0,130792
132435506200000,NW 326,Residential,25920,0,25920,100369,0,126289
132435506300000,NW 326,Residential,25920,0,25920,106098,0,132018
132435506400000,NW 326,Residential,24922,0,24922,118491,0,143413
132435506500000,NW 326,Residential,25920,0,25920,121517,0,147437
132435506600000,NW 326,Residential,25920,0,25920,90954,0,116874
132435506700000,NW 326,Residential,21579,0,21579,115149,0,136728
132435506800000,NW 326,Residential,26423,0,26423,113877,0,140300
132435506900000,NW 326,Residential,28657,0,28657,120125,0,148782
132435600100000,NW 326,Residential,27197,0,27197,109170,0,136367
132435600200000,NW 326,Residential,27197,0,27197,104616,0,131813
132435600300000,NW 326,Residential,24000,0,24000,111897,0,135897
132435600400000,NW 326,Residential,25960,0,25960,97584,0,123544
132435600500000,NW 326,Residential,25960,0,25960,111881,0,137841
132435600600000,NW 326,Residential,25960,0,25960,106033,0,131993
132435600700000,NW 326,Residential,25960,0,25960,113696,0,139656
132435600800000,NW 326,Residential,27360,0,27360,105609,0,132969
132435600900000,NW 326,Residential,26597,0,26597,124683,0,151280
132435601000000,NW 326,Residential,27529,0,27529,117893,0,145422
132435601100000,NW 326,Residential,28866,0,28866,124897,0,153763
132435601200000,NW 326,Residential,28866,0,28866,118257,0,147123
132435601300000,NW 326,Residential,25960,0,25960,115773,0,141733
132435601400000,NW 326,Residential,25960,0,25960,104916,0,130876
132435601500000,NW 326,Residential,24000,0,24000,110481,0,134481
132435700100000,NW 326,Residential,22320,0,22320,121550,0,143870
132435700200000,NW 326,Residential,26505,0,26505,117939,0,144444
132435700300000,NW 326,Residential,24240,0,24240,131609,0,155849
132435700400000,NW 326,Residential,22220,0,22220,111628,0,133848
132435700500000,NW 326,Residential,23836,0,23836,120341,0,144177
132435700600000,NW 326,Residential,22220,0,22220,107837,0,130057
132435700700000,NW 326,Residential,24644,0,24644,127714,0,152358
132435700800000,NW 326,Residential,24240,0,24240,133420,0,157660
132435700900000,NW 326,Residential,27592,0,27592,105417,0,133009
132437600100000,NW 337,Residential,40314,0,40314,99618,0,139932
132437600200000,NW 337,Residential,21696,0,21696,103072,0,124768
132437600300000,NW 337,Residential,43243,0,43243,50058,0,93301
132437600400000,NW 337,Residential,32314,0,32314,160586,0,192900
132437600500000,NW 337,Residential,33233,0,33233,87582,0,120815
132437600600000,NW 337,Residential,29430,0,29430,0,0,29430
132437600700000,NW 337,Residential,64350,0,64350,168056,0,232406
132437600800000,NW 337,Residential,50760,0,50760,178903,0,229663
132437600900000,NW 337,Residential,60750,0,60750,71089,0,131839
132437700100000,NW 309,Residential,35802,0,35802,153314,0,189116
132437800100000,VACANT LAND,Commercial,0,48600,48600,0,364,48964
132437800200000,NW 326,Residential,33015,0,33015,73283,0,106298
132437800300000,NW 326,Residential,28821,0,28821,115539,0,144360
132437800400000,NW 326,Residential,27540,0,27540,116689,0,144229
132437800500000,NW 326,Residential,27122,0,27122,119978,0,147100
132437800600000,NW 326,Residential,27472,0,27472,154486,0,181958
132437800700000,NW 326,Residential,28016,0,28016,138088,0,166104
132437800800000,NW 326,Residential,28302,0,28302,126720,0,155022
132437800900000,NW 326,Residential,28448,0,28448,136911,0,165359
132437801000000,NW 326,Residential,28177,0,28177,116399,0,144576
132437801100000,NW 326,Residential,28219,0,28219,135393,0,163612
132437801200000,NW 326,Residential,27706,0,27706,136376,0,164082
132437801300000,NW 326,Residential,27550,0,27550,124083,0,151633
132437801400000,NW 326,Residential,28864,0,28864,152263,0,181127
132437801500000,NW 326,Residential,29172,0,29172,135461,0,164633
132437801600000,NW 326,Residential,28907,0,28907,124697,0,153604
132437801700000,NW 326,Residential,28642,0,28642,138163,0,166805
132437801800000,NW 326,Residential,28376,0,28376,115525,0,143901
132437801900000,NW 326,Residential,28111,0,28111,127462,0,155573
132437802000000,NW 326,Residential,28334,0,28334,114752,0,143086
132437802100000,NW 326,Residential,30030,0,30030,129349,0,159379
132437900100000,NW 326,Residential,27486,0,27486,122067,0,149553
132437900200000,NW 326,Residential,27166,0,27166,135221,0,162387
132437900300000,NW 326,Residential,27581,0,27581,129047,0,156628
132437900400000,NW 326,Residential,27468,0,27468,143776,0,171244
132437900500000,NW 326,Residential,27953,0,27953,125925,0,153878
132437900600000,NW 326,Residential,28682,0,28682,126873,0,155555
132437900700000,NW 326,Residential,26961,0,26961,127796,0,154757
132437900800000,NW 326,Residential,27524,0,27524,146060,0,173584
132437900900000,NW 326,Residential,27331,0,27331,129931,0,157262
132437901000000,NW 326,Residential,27382,0,27382,129372,0,156754
132437901100000,NW 326,Residential,26058,0,26058,150057,0,176115
132438000100000,NW 326,Residential,28127,0,28127,144091,0,172218
132438000200000,NW 326,Residential,26772,0,26772,131778,0,158550
132438000300000,NW 326,Residential,28350,0,28350,128554,0,156904
132438000400000,NW 326,Residential,24180,0,24180,112997,0,137177
132438000500000,NW 326,Residential,27543,0,27543,127428,0,154971
132438000600000,NW 326,Residential,25637,0,25637,133482,0,159119
132438000700000,NW 326,Residential,25898,0,25898,135209,0,161107
132438000800000,NW 326,Residential,21528,0,21528,173813,0,195341
132438000900000,NW 326,Residential,29302,0,29302,126277,0,155579
132438001000000,NW 326,Residential,27676,0,27676,130236,0,157912
132438001100000,NW 326,Residential,28710,0,28710,117286,0,145996
132438001200000,NW 326,Residential,30138,0,30138,147017,0,177155
132438001300000,NW 326,Residential,27005,0,27005,121658,0,148663
132438001400000,NW 326,Residential,26676,0,26676,133539,0,160215
132438001500000,NW 326,Residential,28967,0,28967,133015,0,161982
132438001600000,NW 326,Residential,27050,0,27050,119702,0,146752
132438001700000,NW 326,Residential,27676,0,27676,121543,0,149219
132438001800000,NW 326,Residential,27925,0,27925,117997,0,145922
132438001900000,NW 326,Residential,27075,0,27075,117885,0,144960
132438002000000,NW 326,Residential,28175,0,28175,114325,0,142500
132438002100000,NW 326,Residential,28687,0,28687,134809,0,163496
132438002200000,NW 326,Residential,26894,0,26894,138343,0,165237
132438002300000,NW 326,Residential,32062,0,32062,61723,0,93785
132438002400000,NW 326,Residential,35904,0,35904,87710,0,123614
132438002500000,NW 326,Residential,44282,0,44282,118045,0,162327
132438002600000,NW 326,Residential,64500,0,64500,110656,0,175156
132438002700000,CITY PROPERTY,Exempt,0,0,0,0,0,0
132438002702000,ANTENNAS/TOWERS(BLL),Commercial,0,0,0,0,12045,12045
132438002800000,NW 326,Residential,64150,0,64150,119318,0,183468
132438002900000,NW 326,Residential,33696,0,33696,100481,0,134177
132438003000000,NW 326,Residential,25680,0,25680,138094,0,163774
132440100100000,NW 315,Residential,29969,0,29969,211490,0,241459
132440200100000,NW 337,Residential,70650,0,70650,0,0,70650
132440200300000,NW 337,Residential,53100,0,53100,0,0,53100
132440200400000,NW 337,Residential,8550,0,8550,0,0,8550
132440200500000,NW 337,Residential,5050,0,5050,0,0,5050
132440200600000,NW 315,Residential,28109,0,28109,192618,0,220727
132440200700000,NW 315,Residential,33307,0,33307,193822,0,227129
132440200800000,NW 315,Residential,32563,0,32563,144396,0,176959
132440200900000,NW 315,Residential,25633,0,25633,199718,0,225351
132440201000000,NW 315,Residential,33601,0,33601,155399,0,189000
132440201100000,NW 315,Residential,27633,0,27633,171462,0,199095
132440201200000,NW 315,Residential,28465,0,28465,177888,0,206353
132440201300000,NW 315,Residential,44840,0,44840,168866,0,213706
132440201400000,NW 315,Residential,30680,0,30680,158184,0,188864
132440201500000,NW 337,Residential,41888,0,41888,96958,0,138846
132440201600000,NW 337,Residential,41888,0,41888,140878,0,182766
132440201700000,NW 337,Residential,42602,0,42602,81512,0,124114
132440201800000,NW 337,Residential,40592,0,40592,147092,0,187684
132440201900000,NW 337,Residential,43322,0,43322,94001,0,137323
132440202000000,NW 337,Residential,33355,0,33355,184853,0,218208
132440202100000,NW 337,Residential,30680,0,30680,47214,0,77894
132440202200000,NW 337,Residential,11400,0,11400,8360,0,19760
132440202300000,NW 337,Residential,26400,0,26400,64789,0,91189
132440300100000,NW 337,Residential,52100,0,52100,72619,0,124719
132440300200000,NW 337,Residential,31590,0,31590,93421,0,125011
132440300300000,NW 305,Residential,27216,0,27216,155950,0,183166
132440300400000,NW 305,Residential,27136,0,27136,107890,0,135026
132440300500000,NW 305,Residential,26880,0,26880,138315,0,165195
132440300600000,NW 305,Residential,26624,0,26624,154286,0,180910
132440300700000,NW 305,Residential,26624,0,26624,156120,0,182744
132440300800000,NW 305,Residential,26463,0,26463,152740,0,179203
132440300900000,NW 337,Residential,42399,0,42399,0,0,42399
132440301000000,NW 305,Residential,27454,0,27454,179267,0,206721
132440301100000,NW 337,Residential,43424,0,43424,252057,0,295481
132440301200000,NW 337,Residential,43424,0,43424,0,0,43424
132440301300000,NW 337,Residential,71750,0,71750,213958,0,285708
132440301400000,NW 337,Residential,40332,0,40332,83435,0,123767
132440301500000,NW 337,Residential,48644,0,48644,101976,0,150620
132440301600000,NW 337,Residential,60520,0,60520,0,0,60520
132440301700000,NW 305,Residential,28561,0,28561,179020,0,207581
132440301800000,NW 305,Residential,26733,0,26733,151763,0,178496
132440301900000,NW 305,Residential,27832,0,27832,174985,0,202817
132440302000000,NW 305,Residential,28547,0,28547,179392,0,207939
132440302100000,NW 305,Residential,26624,0,26624,157365,0,183989
132440302200000,NW 305,Residential,26624,0,26624,151155,0,177779
132440302300000,NW 305,Residential,26624,0,26624,147065,0,173689
132440302400000,NW 305,Residential,26624,0,26624,171031,0,197655
132440302500000,NW 305,Residential,25856,0,25856,155131,0,180987
132440302600000,NW 305,Residential,26334,0,26334,176287,0,202621
132442600100000,NW 315,Residential,28973,0,28973,131105,0,160078
132442600200000,NW 315,Residential,25026,0,25026,123390,0,148416
132442600300000,NW 315,Residential,25026,0,25026,111716,0,136742
132442600400000,NW 315,Residential,25026,0,25026,125671,0,150697
132442600500000,NW 315,Residential,25026,0,25026,131603,0,156629
132442600600000,NW 315,Residential,25026,0,25026,112639,0,137665
132442600700000,NW 315,Residential,25026,0,25026,121353,0,146379
132442600800000,NW 315,Residential,17199,0,17199,129479,0,146678
132442600900000,NW 315,Residential,17199,0,17199,9546,0,26745
132442700100000,NW 315,Residential,24987,0,24987,128118,0,153105
132442700200000,NW 315,Residential,34398,0,34398,185240,0,219638
132442700300000,NW 315,Residential,31115,0,31115,49801,0,80916
132442700400000,NW 315,Residential,28858,0,28858,76295,0,105153
132442700500000,NW 315,Residential,22068,0,22068,146571,0,168639
132442700600000,NW 315,Residential,42120,0,42120,98371,0,140491
132442700700000,NW 315,Residential,39690,0,39690,120930,0,160620
132442700800000,NW 315,Residential,25026,0,25026,119601,0,144627
132442700900000,NW 315,Residential,25026,0,25026,136828,0,161854
132442701000000,NW 315,Residential,25026,0,25026,117043,0,142069
132442701100000,NW 315,Residential,25026,0,25026,125724,0,150750
132442701200000,NW 315,Residential,25026,0,25026,123391,0,148417
132442701300000,NW 315,Residential,25026,0,25026,138789,0,163815
132442800100000,NW 315,Residential,30555,0,30555,121271,0,151826
132442800200000,NW 315,Residential,26496,0,26496,136956,0,163452
132442800300000,NW 315,Residential,33120,0,33120,167571,0,200691
132442800400000,NW 315,Residential,33120,0,33120,163786,0,196906
132442800500000,NW 315,Residential,33776,0,33776,159554,0,193330
132442800700000,NW 315,Residential,35249,0,35249,200575,0,235824
132442800800000,NW 315,Residential,34869,0,34869,179973,0,214842
132442800900000,NW 315,Residential,34768,0,34768,201724,0,236492
132442801000000,NW 315,Residential,32400,0,32400,141390,0,173790
132442801100000,NW 315,Residential,32400,0,32400,162493,0,194893
132442801200000,NW 315,Residential,29340,0,29340,0,0,29340
132442801300000,NW 315,Residential,28896,0,28896,247352,0,276248
132442801400000,NW 315,Residential,28824,0,28824,214798,0,243622
132442801500000,NW 337,Residential,38038,0,38038,94899,0,132937
132442801600000,NW 315,Residential,30221,0,30221,193293,0,223514
132442801700000,NW 315,Residential,30912,0,30912,167020,0,197932
132442801800000,NW 315,Residential,30867,0,30867,169053,0,199920
132442801900000,NW 315,Residential,27455,0,27455,107913,0,135368
132442802000000,NW 315,Residential,31231,0,31231,151094,0,182325
132442802100000,NW 315,Residential,24024,0,24024,124466,0,148490
132442802200000,NW 315,Residential,24024,0,24024,0,0,24024
132442802300000,APARTMENT,Commercial,0,24805,24805,0,261210,286015
132442802400000,NW 315,Residential,24166,0,24166,119834,0,144000
132442802500000,NW 315,Residential,24024,0,24024,117582,0,141606
132442802600000,NW 315,Residential,24840,0,24840,53622,0,78462
132442802700000,NW 315,Residential,24840,0,24840,40891,0,65731
132442802800000,NW 315,Residential,25698,0,25698,47683,0,73381
132442802900000,NW 315,Residential,30555,0,30555,143467,0,174022
132442803000000,NW 315,Residential,30555,0,30555,98766,0,129321
132442803100000,NW 315,Residential,30555,0,30555,141930,0,172485
132442803200000,NW 315,Residential,20,0,20,0,0,20
132442803300000,NW 337,Residential,37174,0,37174,170124,0,207298
132442803400000,NW 337,Residential,36944,0,36944,220564,0,257508
132442803500000,NW 337,Residential,39906,0,39906,238458,0,278364
132442900100000,NW 337,Residential,67050,0,67050,138990,0,206040
132442900200000,NW 337,Residential,67050,0,67050,56112,0,123162
132442900300000,NW 337,Residential,82650,0,82650,87731,0,170381
132442900400000,NW 337,Residential,33920,0,33920,76646,0,110566
132442900500000,NW 337,Ag Land,11798,0,11798,0,0,11798
132442900600000,NW 337,Residential,61250,0,61250,70330,0,131580
132445100100000,NW 337,Residential,35050,0,35050,0,0,35050
132445100200000,NW 337,Residential,16020,0,16020,36079,0,52099
132445100300000,NW 337,Residential,28419,0,28419,22002,0,50421
132445100400000,NW 337,Residential,31152,0,31152,41021,0,72173
132445100500000,NW 337,Residential,54100,0,54100,146234,0,200334
132445100600000,NW 337,Residential,56750,0,56750,63335,0,120085
132445100700000,NW 337,Residential,68800,0,68800,85990,0,154790
132445100800000,NW 337,Residential,21240,0,21240,37124,0,58364
132445100900000,NW 337,Residential,21240,0,21240,108662,0,129902
132445101000000,NW 337,Residential,21240,0,21240,88135,0,109375
132445101100000,NW 337,Residential,28320,0,28320,99202,0,127522
132445101200000,SHOP,Commercial,0,195750,195750,0,448118,643868
132445101300000,NW 337,Residential,32816,0,32816,42150,0,74966
132445200100000,NW 337,Residential,30090,0,30090,115670,0,145760
132445200200000,NW 337,Residential,28320,0,28320,63826,0,92146
132445200300000,NW 337,Residential,31948,0,31948,92921,0,124869
132445200400000,NW 337,Residential,24780,0,24780,121117,0,145897
132445200500000,NW 337,Residential,29205,0,29205,94949,0,124154
132445200600000,NW 337,Residential,29205,0,29205,96906,0,126111
132445200700000,NW 337,Residential,33453,0,33453,95274,0,128727
132445200800000,VACANT LAND,Commercial,0,42120,42120,0,0,42120
132445200900000,SHOP,Commercial,0,280368,280368,0,373634,654002
132445201000000,NW 337,Residential,32978,0,32978,77745,0,110723
132445201100000,NW 337,Residential,34098,0,34098,38075,0,72173
132445201200000,NW 337,Residential,31860,0,31860,5828,0,37688
132445201300000,NW 337,Residential,33842,0,33842,37133,0,70975
132445201400000,NW 337,Residential,30351,0,30351,81344,0,111695
132445201500000,NW 337,Residential,21825,0,21825,109466,0,131291
132445201600000,NW 337,Residential,21534,0,21534,76533,0,98067
132445201700000,NW 337,Residential,29051,0,29051,86117,0,115168
132445201800000,NW 337,Residential,31152,0,31152,0,0,31152
132445201900000,NW 337,Residential,38940,0,38940,183475,0,222415
132445202000000,NW 337,Residential,51552,0,51552,71480,0,123032
132445202100000,NW 337,Residential,51552,0,51552,70679,0,122231
132445202200000,NW 337,Residential,44604,0,44604,126129,0,170733
132445202300000,NW 337,Residential,28320,0,28320,97277,0,125597
132445202400000,NW 337,Residential,40120,0,40120,85660,0,125780
132445202500000,NW 337,Residential,37760,0,37760,61327,0,99087
132445202600000,NW 337,Residential,51552,0,51552,84128,0,135680
132447600100000,NW 337,Residential,39305,0,39305,10188,0,49493
132447600200000,NW 337,Residential,19620,0,19620,82034,0,101654
132447600300000,NW 324,Residential,23436,0,23436,99631,0,123067
132447600400000,NW 324,Residential,23180,0,23180,111656,0,134836
132447600500000,NW 324,Residential,23180,0,23180,111775,0,134955
132447600600000,NW 324,Residential,23180,0,23180,99252,0,122432
132447600700000,NW 324,Residential,23180,0,23180,90591,0,113771
132447600800000,NW 324,Residential,23180,0,23180,108071,0,131251
132447600900000,NW 324,Residential,23180,0,23180,107888,0,131068
132447601000000,NW 324,Residential,23180,0,23180,120775,0,143955
132447601100000,NW 324,Residential,23180,0,23180,101628,0,124808
132447601200000,NW 324,Residential,23962,0,23962,124839,0,148801
132447601300000,NW 337,Residential,75700,0,75700,0,0,75700
132447601400000,CHURCH,Exempt,0,382428,382428,0,520192,902620
132447700100000,NW 324,Residential,23894,0,23894,91238,0,115132
132447700200000,NW 324,Residential,23180,0,23180,105811,0,128991
132447700300000,NW 324,Residential,23180,0,23180,105326,0,128506
132447700400000,NW 324,Residential,23180,0,23180,120777,0,143957
132447700500000,NW 324,Residential,23180,0,23180,99104,0,122284
132447700600000,NW 324,Residential,23180,0,23180,114647,0,137827
132447700700000,NW 324,Residential,23180,0,23180,98603,0,121783
132447700800000,NW 324,Residential,23180,0,23180,92124,0,115304
132447700900000,NW 324,Residential,23180,0,23180,107129,0,130309
132447701000000,NW 324,Residential,23556,0,23556,168718,0,192274
132447701100000,NW 337,Residential,33384,0,33384,102260,0,135644
132447701200000,NW 337,Residential,31421,0,31421,27477,0,58898
132447701300000,NW 337,Residential,35437,0,35437,91917,0,127354
132447701400000,OFFICE,Commercial,0,67341,67341,0,278074,345415
132447701500000,BRANCH BANK/CU,Commercial,0,336960,336960,0,540777,877737
132447800200000,NW 301,Residential,33408,0,33408,113875,0,147283
132447800300000,NW 337,Residential,28050,0,28050,109471,0,137521
132447800400000,NW 337,Residential,32393,0,32393,104158,0,136551
132447800500000,NW 337,Residential,29205,0,29205,88238,0,117443
132447800600000,NW 337,Residential,29264,0,29264,93371,0,122635
132447800700000,NW 337,Residential,25245,0,25245,102423,0,127668
132447800800000,NW 337,Residential,25245,0,25245,45336,0,70581
132447800900000,NW 337,Residential,23796,0,23796,82354,0,106150
132447801000000,NW 337,Residential,23871,0,23871,82560,0,106431
132447801100000,NW 337,Residential,29340,0,29340,189996,0,219336
132447801200000,NW 337,Residential,29340,0,29340,154642,0,183982
132447801300000,NW 337,Residential,33862,0,33862,126392,0,160254
132447801400000,NW 337,Residential,35162,0,35162,113376,0,148538
132447801500000,NW 324,Residential,28403,0,28403,108753,0,137156
132447801600000,NW 324,Residential,26858,0,26858,127516,0,154374
132447801700000,NW 324,Residential,26858,0,26858,99180,0,126038
132447801800000,NW 324,Residential,27454,0,27454,134140,0,161594
132447801900000,NW 324,Residential,26040,0,26040,128252,0,154292
132447802000000,NW 324,Residential,26858,0,26858,99679,0,126537
132447802300000,CHURCH,Exempt,0,550800,550800,0,553520,1104320
132447900100000,NW 324,Residential,27637,0,27637,119473,0,147110
132447900200000,NW 324,Residential,27900,0,27900,118135,0,146035
132447900300000,NW 324,Residential,27900,0,27900,110052,0,137952
132447900400000,NW 324,Residential,27900,0,27900,114410,0,142310
132447900500000,NW 324,Residential,26040,0,26040,89247,0,115287
132447900600000,NW 324,Residential,26784,0,26784,134592,0,161376
132447900700000,NW 324,Residential,27900,0,27900,120753,0,148653
132447900800000,NW 324,Residential,27900,0,27900,111185,0,139085
132447900900000,NW 324,Residential,27900,0,27900,116685,0,144585
132447901000000,NW 324,Residential,27900,0,27900,123708,0,151608
132447901100000,NW 324,Residential,27900,0,27900,133330,0,161230
132447901200000,NW 324,Residential,28165,0,28165,108355,0,136520
132448000100000,NW 324,Residential,36190,0,36190,137947,0,174137
132448000200000,NW 337,Residential,38940,0,38940,69898,0,108838
132448000300000,NW 337,Residential,43920,0,43920,74683,0,118603
132448000400000,NW 337,Residential,34456,0,34456,107348,0,141804
132448000500000,NW 337,Residential,40479,0,40479,42773,0,83252
132448000600000,NW 337,Residential,37760,0,37760,194886,0,232646
132448000700000,NW 337,Residential,31452,0,31452,91282,0,122734
132448000800000,NW 337,Residential,27540,0,27540,109526,0,137066
132448000900000,NW 337,Residential,25500,0,25500,93697,0,119197
132448001000000,NW 337,Residential,28050,0,28050,58067,0,86117
132448001100000,NW 324,Residential,25760,0,25760,91724,0,117484
132448001200000,NW 324,Residential,25760,0,25760,97546,0,123306
132510100100000,NW 324,Residential,27743,0,27743,77246,0,104989
132510100200000,VACANT LAND,Commercial,0,40499,40499,0,0,40499
132510100300000,LAUNDROMAT/CLEANERS,Commercial,0,40499,40499,0,63164,103663
132510100400000,VACANT LAND,Commercial,0,40499,40499,0,0,40499
132510100700000,NW 324,Residential,56700,0,56700,0,0,56700
132510100800000,NW 324,Residential,56700,0,56700,71578,0,128278
132510100900000,NW 324,Residential,68000,0,68000,118617,0,186617
132510101000000,NW 324,Residential,68500,0,68500,601824,0,670324
132510101100000,NW 324,Residential,55400,0,55400,119091,0,174491
132510101200000,NW 324,Residential,20265,0,20265,72618,0,92883
132510101300000,NW 324,Residential,50850,0,50850,101653,0,152503
132510101400000,NW 324,Residential,50850,0,50850,135114,0,185964
132510101500000,NW 324,Residential,50850,0,50850,165238,0,216088
132510101600000,NW 324,Residential,50850,0,50850,146608,0,197458
132510102000000,SMALL RETAIL,Commercial,0,257850,257850,0,233867,491717
132510102100000,RESTAURANT,Commercial,0,313200,313200,0,239397,552597
132510102200000,AUTO REPAIR/SALES,Commercial,0,286200,286200,0,255838,542038
132510102300000,FAST FOOD,Commercial,0,286200,286200,0,607417,893617
132510102400000,VETERINARY CLINIC,Commercial,0,159667,159667,0,116957,276624
132510102500000,OFFICE,Commercial,0,418500,418500,0,512633,931133
132510102502000,BILLBOARD(BLL),Commercial,0,0,0,0,64724,64724
132510102600000,VETERINARY CLINIC,Commercial,0,114806,114806,0,354700,469506
132510102700000,NW 324,Residential,54650,0,54650,0,0,54650
132510102800000,LG DISCOUNT/RETAIL,Commercial,0,605880,605880,0,1032191,1638071
132512600100000,NW 324,Residential,56700,0,56700,141075,0,197775
132512600200000,NW 324,Residential,60500,0,60500,210217,0,270717
132512600300000,NW 324,Residential,5950,0,5950,0,0,5950
132512600400000,NW 324,Residential,82500,0,82500,0,0,82500
132512600600000,CENTRALLY ASSESSED,Other,0,0,0,0,0,0
132512600700000,CENTRALLY ASSESSED,Other,0,0,0,0,0,0
132512600800000,NW 324,Residential,58200,0,58200,143558,0,201758
132512600900000,NW 327,Residential,30464,0,30464,125636,0,156100
132512601000000,NW 327,Residential,30464,0,30464,122753,0,153217
132512601100000,NW 327,Residential,30464,0,30464,105085,0,135549
132512601200000,NW 327,Residential,30464,0,30464,106521,0,136985
132512601300000,NW 327,Residential,22855,0,22855,106200,0,129055
132512601400000,NW 327,Residential,22855,0,22855,104225,0,127080
132512601500000,NW 324,Residential,34957,0,34957,112849,0,147806
132512601600000,NW 324,Residential,41269,0,41269,125403,0,166672
132512601700000,NW 324,Residential,56700,0,56700,212957,0,269657
132512601800000,NW 324,Residential,56700,0,56700,161618,0,218318
132512601900000,NW 324,Residential,56700,0,56700,56719,0,113419
132512602000000,NW 324,Residential,56700,0,56700,196321,0,253021
132512602100000,NW 324,Residential,56700,0,56700,326580,0,383280
132512602200000,NW 324,Residential,46062,0,46062,101379,0,147441
132512602300000,NW 324,Residential,48835,0,48835,0,0,48835
132512602400000,NW 324,Residential,44540,0,44540,384645,0,429185
132512602500000,NW 324,Residential,42556,0,42556,334453,0,377009
132512602600000,NW 324,Residential,42567,0,42567,297886,0,340453
132515100100000,CITY PROPERTY,Exempt,0,0,0,0,0,0
132515100200000,CITY PROPERTY,Exempt,0,0,0,0,0,0
132515100300000,CITY PROPERTY,Exempt,0,0,0,0,0,0
132515200100000,CITY PROPERTY,Exempt,0,0,0,0,0,0
132515300500000,NW 335,Residential,23400,0,23400,94157,0,117557
132515300600000,NW 335,Residential,23400,0,23400,87704,0,111104
132515300700000,NW 335,Residential,26707,0,26707,64563,0,91270
132515300800000,CITY PROPERTY,Exempt,0,0,0,0,0,0
132515300900000,NW 335,Residential,30240,0,30240,136900,0,167140
132515301000000,NW 335,Residential,28402,0,28402,87728,0,116130
132515301100000,NW 335,Residential,27711,0,27711,96467,0,124178
132515301200000,NW 335,Residential,21630,0,21630,62423,0,84053
132515301300000,NW 335,Residential,20790,0,20790,55237,0,76027
132515400200000,NW 335,Residential,22701,0,22701,90981,0,113682
132515400300000,NW 335,Residential,26062,0,26062,82430,0,108492
132515500100000,NW 335,Residential,27540,0,27540,93994,0,121534
132515500200000,NW 335,Residential,23085,0,23085,73347,0,96432
132515500300000,NW 335,Residential,23868,0,23868,95131,0,118999
132515500400000,NW 335,Residential,21021,0,21021,79813,0,100834
132515500500000,NW 335,Residential,19110,0,19110,0,0,19110
132515500600000,NW 335,Residential,17820,0,17820,0,0,17820
132515500700000,NW 335,Residential,23306,0,23306,108559,0,131865
132515500800000,NW 335,Residential,18720,0,18720,109354,0,128074
132515500900000,NW 335,Residential,18720,0,18720,118374,0,137094
132515501000000,NW 335,Residential,18720,0,18720,92693,0,111413
132515501100000,APARTMENT,Commercial,0,13414,13414,0,128947,142361
132515501200000,NW 335,Residential,21492,0,21492,73555,0,95047
132515501300000,NW 335,Residential,21400,0,21400,71489,0,92889
132515501400000,CONVERSION,Commercial,0,17360,17360,0,86772,104132
132515501500000,NW 335,Residential,27612,0,27612,127938,0,155550
132515501600000,APARTMENT,Commercial,0,14458,14458,0,124813,139271
132515501700000,NW 335,Residential,23730,0,23730,64976,0,88706
132515501800000,NW 335,Residential,24798,0,24798,86031,0,110829
132515501900000,NW 335,Residential,25620,0,25620,104549,0,130169
132515502000000,NW 335,Residential,25272,0,25272,129666,0,154938
132515502100000,NW 335,Residential,26973,0,26973,105066,0,132039
132515502200000,NW 335,Residential,21185,0,21185,130121,0,151306
132515600100000,NW 335,Residential,25431,0,25431,152367,0,177798
132515600200000,NW 335,Residential,35538,0,35538,129269,0,164807
132515600300000,NW 335,Residential,33441,0,33441,143767,0,177208
132515600400000,NW 335,Residential,33280,0,33280,117900,0,151180
132515600500000,NW 335,Residential,35274,0,35274,161483,0,196757
132515600600000,NW 335,Residential,30009,0,30009,135985,0,165994
132515600700000,NW 335,Residential,32280,0,32280,167798,0,200078
132515600800000,NW 335,Residential,32292,0,32292,168458,0,200750
132515600900000,NW 335,Residential,33575,0,33575,179646,0,213221
132515601000000,NW 335,Residential,27160,0,27160,128175,0,155335
132515601100000,NW 335,Residential,31040,0,31040,165787,0,196827
132515601200000,NW 335,Residential,32110,0,32110,152890,0,185000
132515601300000,NW 335,Residential,31450,0,31450,168627,0,200077
132515601400000,NW 335,Residential,20,0,20,0,0,20
132515601500000,NW 335,Residential,32763,0,32763,164849,0,197612
132515601600000,NW 335,Residential,32000,0,32000,136651,0,168651
132515601700000,NW 335,Residential,33398,0,33398,172918,0,206316
132515601800000,NW 335,Residential,48859,0,48859,154758,0,203617
132515601900000,SCHOOL,Exempt,0,0,0,0,0,0
132515700100000,NW 335,Residential,32646,0,32646,183908,0,216554
132515700200000,NW 335,Residential,23256,0,23256,137956,0,161212
132515700300000,NW 335,Residential,32105,0,32105,168511,0,200616
132515700400000,NW 335,Residential,32685,0,32685,173913,0,206598
132515700500000,NW 335,Residential,32300,0,32300,164385,0,196685
132515700600000,NW 335,Residential,25181,0,25181,145812,0,170993
132515700700000,NW 335,Residential,29139,0,29139,144818,0,173957
132515700800000,NW 335,Residential,32365,0,32365,150566,0,182931
132515700900000,NW 335,Residential,29563,0,29563,127231,0,156794
132515701000000,NW 335,Residential,31579,0,31579,128160,0,159739
132517600200000,CITY PROPERTY,Exempt,0,0,0,0,0,0
132517600400000,NW 324,Residential,20700,0,20700,95053,0,115753
132517600500000,NW 324,Residential,21060,0,21060,74119,0,95179
132517600600000,NW 324,Residential,21420,0,21420,87735,0,109155
132517600700000,NW 324,Residential,21780,0,21780,99214,0,120994
132517600800000,NW 324,Residential,26077,0,26077,98398,0,124475
132517600900000,NW 324,Residential,20820,0,20820,99575,0,120395
132517601000000,NW 324,Residential,21081,0,21081,107912,0,128993
132517700100000,FAST FOOD,Commercial,0,105127,105127,0,168210,273337
132517700200000,NBHD SHOPPING CENTER,Commercial,0,253800,253800,0,463320,717120
132517700300000,NW 324,Residential,22806,0,22806,105476,0,128282
132517700400000,NW 324,Residential,23552,0,23552,123545,0,147097
132517700500000,NW 324,Residential,23552,0,23552,98147,0,121699
132517700600000,NW 324,Residential,23257,0,23257,101165,0,124422
132517700700000,NW 324,Residential,24437,0,24437,102082,0,126519
132517700800000,NW 324,Residential,25080,0,25080,93063,0,118143
132517700900000,NW 324,Residential,25194,0,25194,140981,0,166175
132517701000000,NW 324,Residential,22560,0,22560,104405,0,126965
132517701100000,NW 324,Residential,23552,0,23552,112920,0,136472
132517701200000,NW 324,Residential,23296,0,23296,109581,0,132877
132517701300000,NW 324,Residential,23296,0,23296,90105,0,113401
132517701400000,NW 324,Exempt,0,23296,23296,0,117202,140498
132517701500000,NW 324,Residential,23296,0,23296,111256,0,134552
132517701600000,NW 324,Residential,23296,0,23296,107026,0,130322
132517701700000,NW 324,Residential,23332,0,23332,103342,0,126674
132517701800000,NW 324,Residential,24315,0,24315,100194,0,124509
132517701900000,NW 324,Residential,24064,0,24064,101429,0,125493
132517702000000,NW 324,Residential,24064,0,24064,91407,0,115471
132517702100000,NW 324,Residential,24064,0,24064,96108,0,120172
132517702200000,NW 324,Residential,24064,0,24064,102624,0,126688
132517702300000,NW 324,Residential,24064,0,24064,103756,0,127820
132517702400000,NW 324,Residential,24064,0,24064,102627,0,126691
132517702500000,NW 324,Residential,27072,0,27072,123551,0,150623
132517702600000,NW 324,Residential,26611,0,26611,113595,0,140206
132517702700000,FLAT PARKING,Commercial,0,109890,109890,0,9360,119250
132517702800000,OFFICE,Commercial,0,114100,114100,0,377815,491915
132517800100000,NW 324,Residential,24546,0,24546,111621,0,136167
132517800200000,NW 324,Residential,27615,0,27615,102992,0,130607
132517800300000,NW 324,Residential,23296,0,23296,104707,0,128003
132517800400000,NW 324,Residential,23296,0,23296,111928,0,135224
132517800500000,NW 324,Residential,23296,0,23296,102846,0,126142
132517800600000,NW 324,Residential,23296,0,23296,105141,0,128437
132517800700000,NW 324,Residential,23296,0,23296,103123,0,126419
132517800800000,NW 324,Residential,23296,0,23296,95502,0,118798
132517800900000,NW 324,Residential,25480,0,25480,93461,0,118941
132517801000000,NW 324,Residential,25480,0,25480,116371,0,141851
132517801100000,NW 324,Residential,25480,0,25480,103576,0,129056
132517801200000,NW 324,Residential,25480,0,25480,105334,0,130814
132517801300000,NW 324,Residential,23338,0,23338,106196,0,129534
132517801400000,NW 324,Residential,23338,0,23338,108461,0,131799
132517801500000,NW 324,Residential,23296,0,23296,99049,0,122345
132517801600000,NW 324,Residential,23296,0,23296,97381,0,120677
132517801700000,NW 324,Residential,25080,0,25080,99577,0,124657
132517801800000,NW 324,Residential,25480,0,25480,113394,0,138874
132517801900000,NW 324,Residential,27784,0,27784,111623,0,139407
132517802000000,NW 324,Residential,30560,0,30560,110426,0,140986
132517802100000,NW 324,Residential,30555,0,30555,107603,0,138158
132517802200000,NW 324,Residential,28208,0,28208,109935,0,138143
132517802300000,NW 324,Residential,25480,0,25480,124268,0,149748
132517802400000,NW 324,Residential,30781,0,30781,118583,0,149364
132517802500000,NW 324,Residential,29028,0,29028,114183,0,143211
132517802600000,NW 324,Residential,27873,0,27873,121413,0,149286
132517802700000,NW 324,Residential,28565,0,28565,98927,0,127492
132517802800000,NW 324,Residential,25216,0,25216,143295,0,168511
132517802900000,NW 324,Residential,22693,0,22693,104107,0,126800
132517803000000,NW 324,Residential,23296,0,23296,98292,0,121588
132517900100000,NW 324,Residential,28436,0,28436,105821,0,134257
132517900200000,NW 324,Residential,23138,0,23138,104909,0,128047
132517900300000,NW 324,Residential,21840,0,21840,107357,0,129197
132517900400000,NW 324,Residential,22444,0,22444,105966,0,128410
132517900500000,NW 324,Residential,23296,0,23296,94888,0,118184
132517900600000,NW 324,Residential,23296,0,23296,106106,0,129402
132517900700000,NW 324,Residential,23296,0,23296,101631,0,124927
132517900800000,NW 324,Residential,23296,0,23296,97854,0,121150
132517900900000,NW 324,Residential,23296,0,23296,93660,0,116956
132517901000000,NW 324,Residential,23296,0,23296,121791,0,145087
132517901100000,NW 324,Residential,23296,0,23296,117822,0,141118
132517901200000,NW 324,Residential,23338,0,23338,106986,0,130324
132517901300000,NW 324,Residential,23508,0,23508,96980,0,120488
132517901400000,NW 324,Residential,25480,0,25480,96708,0,122188
132517901500000,NW 324,Residential,25480,0,25480,110659,0,136139
132517901600000,NW 324,Residential,25480,0,25480,104835,0,130315
132517901700000,NW 324,Residential,25480,0,25480,98792,0,124272
132517901800000,NW 324,Residential,25480,0,25480,114702,0,140182
132517901900000,NW 324,Residential,23296,0,23296,105279,0,128575
132517902000000,NW 324,Residential,23296,0,23296,100438,0,123734
132517902100000,NW 324,Residential,23296,0,23296,106479,0,129775
132517902200000,NW 324,Residential,23296,0,23296,100086,0,123382
132518000100000,NW 324,Residential,24873,0,24873,118097,0,142970
132518000400000,NW 324,Residential,52600,0,52600,0,0,52600
132518000500000,NW 324,Residential,23381,0,23381,102750,0,126131
132518000600000,NW 324,Residential,23296,0,23296,101225,0,124521
132518000700000,NW 324,Residential,23296,0,23296,113014,0,136310
132518000800000,NW 324,Residential,23296,0,23296,148343,0,171639
132518000900000,NW 324,Residential,23296,0,23296,114865,0,138161
132518001000000,NW 324,Residential,23296,0,23296,91728,0,115024
132518001100000,NW 324,Residential,23296,0,23296,81500,0,104796
132518001200000,NW 324,Residential,22204,0,22204,100586,0,122790
132518001300000,NW 324,Residential,23296,0,23296,91986,0,115282
132518001400000,APARTMENT,Residential,49734,0,49734,453529,0,503263
132518100100000,NW 324,Residential,23280,0,23280,91695,0,114975
132518100200000,NW 324,Residential,23296,0,23296,109431,0,132727
132518100300000,NW 324,Residential,23296,0,23296,97106,0,120402
132518100400000,NW 324,Residential,22204,0,22204,97691,0,119895
132518100500000,NW 324,Residential,23296,0,23296,103647,0,126943
132518100600000,NW 324,Residential,23296,0,23296,119921,0,143217
132518100700000,NW 324,Residential,22168,0,22168,100141,0,122309
132518100800000,NW 324,Residential,23296,0,23296,97941,0,121237
132518100900000,NW 324,Residential,22204,0,22204,96571,0,118775
132518101000000,NW 324,Residential,23326,0,23326,90234,0,113560
132518200100000,NW 324,Residential,21810,0,21810,103619,0,125429
132518200200000,NW 324,Residential,21840,0,21840,99816,0,121656
132518200300000,NW 324,Residential,21840,0,21840,142693,0,164533
132518200400000,NW 324,Residential,21840,0,21840,111420,0,133260
132518200500000,NW 324,Residential,21840,0,21840,102396,0,124236
132518200600000,NW 324,Residential,21870,0,21870,99634,0,121504
132518200700000,APARTMENT,Residential,31900,0,31900,298792,0,330692
132520100100000,NW 328,Residential,38146,0,38146,153501,0,191647
132520100200000,NW 328,Residential,38160,0,38160,154778,0,192938
132520100300000,NW 328,Residential,36524,0,36524,162218,0,198742
132520100400000,NW 328,Residential,38178,0,38178,139054,0,177232
132520100500000,NW 328,Residential,38624,0,38624,156307,0,194931
132520100600000,NW 328,Residential,33950,0,33950,162250,0,196200
132520100700000,NW 328,Residential,33950,0,33950,133041,0,166991
132520100800000,NW 328,Residential,33950,0,33950,137468,0,171418
132520100900000,NW 328,Residential,33950,0,33950,153707,0,187657
132520101000000,NW 328,Residential,33950,0,33950,139714,0,173664
132520101100000,NW 328,Residential,33475,0,33475,138753,0,172228
132520101200000,NW 328,Residential,33475,0,33475,141651,0,175126
132520101300000,NW 328,Residential,35671,0,35671,165214,0,200885
132520101400000,NW 328,Residential,34300,0,34300,132005,0,166305
132520101500000,NW 328,Residential,31893,0,31893,133498,0,165391
132520101600000,NW 327,Residential,30233,0,30233,87743,0,117976
132520101700000,NW 327,Residential,29349,0,29349,97345,0,126694
132520101800000,NW 327,Residential,29002,0,29002,100046,0,129048
132520101900000,NW 327,Residential,24000,0,24000,108263,0,132263
132520102000000,NW 327,Residential,24000,0,24000,105728,0,129728
132520102100000,NW 327,Residential,24000,0,24000,100183,0,124183
132520102200000,NW 327,Residential,24000,0,24000,99806,0,123806
132520102300000,NW 327,Residential,24000,0,24000,112793,0,136793
132520102400000,NW 328,Residential,27730,0,27730,153834,0,181564
132520102500000,NW 328,Residential,27440,0,27440,135416,0,162856
132520102600000,NW 328,Residential,27440,0,27440,139817,0,167257
132520102700000,NW 328,Residential,27440,0,27440,134085,0,161525
132520102800000,NW 328,Residential,27160,0,27160,147764,0,174924
132520200100000,NW 328,Residential,46800,0,46800,149123,0,195923
132520200200000,NW 328,Residential,36400,0,36400,139523,0,175923
132520200300000,NW 328,Residential,36400,0,36400,136640,0,173040
132520200400000,NW 328,Residential,36400,0,36400,142129,0,178529
132520200500000,NW 328,Residential,36400,0,36400,143960,0,180360
132520200600000,NW 328,Residential,36400,0,36400,131240,0,167640
132520200700000,NW 328,Residential,36400,0,36400,147333,0,183733
132520200800000,NW 328,Residential,36400,0,36400,131141,0,167541
132520200900000,NW 328,Residential,36400,0,36400,138286,0,174686
132520201000000,NW 328,Residential,36400,0,36400,143152,0,179552
132520201100000,NW 328,Residential,36400,0,36400,142530,0,178930
132520201200000,NW 328,Residential,33800,0,33800,130520,0,164320
132520201300000,NW 328,Residential,36400,0,36400,143113,0,179513
132520201400000,NW 328,Residential,36400,0,36400,142454,0,178854
132520300100000,NW 328,Residential,37102,0,37102,149429,0,186531
132520300200000,NW 328,Residential,33950,0,33950,157639,0,191589
132520300300000,NW 328,Residential,33950,0,33950,163912,0,197862
132520300400000,NW 328,Residential,33950,0,33950,147107,0,181057
132520300500000,NW 328,Residential,33950,0,33950,155273,0,189223
132520300600000,NW 328,Residential,33950,0,33950,160134,0,194084
132520300700000,NW 328,Residential,33950,0,33950,190486,0,224436
132520300800000,NW 328,Residential,33950,0,33950,168825,0,202775
132520300900000,NW 328,Residential,33950,0,33950,150210,0,184160
132520301000000,NW 328,Residential,33950,0,33950,148111,0,182061
132520301100000,NW 328,Residential,34700,0,34700,148513,0,183213
132520301200000,NW 328,Residential,33800,0,33800,148961,0,182761
132520301300000,NW 328,Residential,36050,0,36050,154954,0,191004
132520301400000,NW 328,Residential,34650,0,34650,131183,0,165833
132520301500000,NW 328,Residential,37492,0,37492,145670,0,183162
132520301600000,NW 328,Residential,36400,0,36400,131184,0,167584
132520301700000,NW 328,Residential,37789,0,37789,130295,0,168084
132520301800000,NW 328,Residential,35774,0,35774,151699,0,187473
132520301900000,NW 328,Residential,33668,0,33668,143382,0,177050
132520302000000,NW 328,Residential,35724,0,35724,141790,0,177514
132520302100000,NW 328,Residential,31525,0,31525,155517,0,187042
132520302200000,NW 328,Residential,31525,0,31525,156195,0,187720
132520302300000,NW 328,Residential,31525,0,31525,158914,0,190439
132520302400000,NW 328,Residential,31525,0,31525,148293,0,179818
132520302500000,NW 328,Residential,31525,0,31525,148847,0,180372
132520302600000,NW 328,Residential,31525,0,31525,140019,0,171544
132520302700000,NW 328,Residential,31525,0,31525,163164,0,194689
132520302800000,NW 328,Residential,34920,0,34920,143625,0,178545
132520400100000,NW 328,Residential,34920,0,34920,169493,0,204413
132520400200000,NW 328,Residential,31525,0,31525,130768,0,162293
132520400300000,NW 328,Residential,36075,0,36075,158586,0,194661
132520400400000,NW 328,Residential,36400,0,36400,131139,0,167539
132520400500000,NW 328,Residential,35425,0,35425,140674,0,176099
132520400600000,NW 328,Residential,34450,0,34450,149041,0,183491
132520400700000,NW 328,Residential,33400,0,33400,142738,0,176138
132520400800000,NW 328,Residential,41300,0,41300,137534,0,178834
132520400900000,NW 328,Residential,37867,0,37867,146564,0,184431
132520401000000,NW 328,Residential,34650,0,34650,116076,0,150726
132520401100000,NW 328,Residential,34912,0,34912,131208,0,166120
132520401200000,NW 328,Residential,35981,0,35981,142347,0,178328
132520401300000,NW 328,Residential,37762,0,37762,119264,0,157026
132520401400000,NW 328,Residential,39187,0,39187,151608,0,190795
132520401500000,NW 328,Residential,39900,0,39900,133939,0,173839
132520401600000,CITY PROPERTY,Exempt,0,0,0,0,0,0
132520401700000,NW 327,Residential,41274,0,41274,136738,0,178012
132520401800000,NW 327,Residential,40400,0,40400,92106,0,132506
132520401900000,NW 328,Residential,36075,0,36075,139392,0,175467
132520402000000,NW 328,Residential,33475,0,33475,136503,0,169978
132520500100000,NW 328,Residential,42112,0,42112,131019,0,173131
132520500200000,NW 328,Residential,33150,0,33150,123536,0,156686
132520500300000,NW 328,Residential,35750,0,35750,125911,0,161661
132520500400000,NW 328,Residential,37375,0,37375,118257,0,155632
132520500500000,NW 328,Residential,38675,0,38675,114128,0,152803
132520500600000,NW 328,Residential,31525,0,31525,139820,0,171345
132520500700000,NW 328,Residential,31525,0,31525,133214,0,164739
132520500800000,NW 328,Residential,34920,0,34920,124543,0,159463
132520500900000,NW 328,Residential,37368,0,37368,139726,0,177094
132520501000000,NW 328,Residential,37874,0,37874,148211,0,186085
132520501100000,NW 328,Residential,37047,0,37047,155460,0,192507
132520501200000,NW 327,Residential,24800,0,24800,85321,0,110121
132520501300000,NW 327,Residential,24800,0,24800,86184,0,110984
132520501400000,NW 327,Residential,24800,0,24800,107877,0,132677
132520501500000,NW 327,Residential,24800,0,24800,92899,0,117699
132520501600000,NW 327,Residential,24800,0,24800,99279,0,124079
132520501700000,NW 327,Residential,24800,0,24800,97929,0,122729
132520501800000,NW 327,Residential,24800,0,24800,90927,0,115727
132520501900000,NW 327,Residential,24880,0,24880,121721,0,146601
132520502000000,NW 327,Residential,24800,0,24800,104475,0,129275
132520502100000,NW 327,Residential,26107,0,26107,102950,0,129057
132520502200000,NW 327,Residential,34320,0,34320,93732,0,128052
132520600100000,NW 328,Residential,37102,0,37102,175272,0,212374
132520600200000,NW 328,Residential,33950,0,33950,144897,0,178847
132520600300000,NW 328,Residential,39894,0,39894,119694,0,159588
132520700100000,NW 327,Residential,32680,0,32680,105253,0,137933
132520700200000,NW 327,Residential,26730,0,26730,100097,0,126827
132520700300000,NW 327,Residential,26933,0,26933,91572,0,118505
132520700400000,NW 327,Residential,25200,0,25200,97227,0,122427
132520700500000,NW 327,Residential,25200,0,25200,104667,0,129867
132520700600000,NW 327,Residential,25200,0,25200,89506,0,114706
132520700700000,NW 327,Residential,25200,0,25200,97466,0,122666
132520700800000,NW 327,Residential,25200,0,25200,106807,0,132007
132520700900000,NW 327,Residential,25200,0,25200,91764,0,116964
132520701000000,NW 327,Residential,25200,0,25200,93785,0,118985
132520701100000,NW 327,Residential,28000,0,28000,93560,0,121560
132520800100000,NW 327,Residential,24000,0,24000,77780,0,101780
132520800200000,NW 327,Residential,24000,0,24000,86080,0,110080
132520800300000,NW 327,Residential,24000,0,24000,101452,0,125452
132520800400000,NW 327,Residential,24000,0,24000,82691,0,106691
132520800500000,NW 327,Residential,24000,0,24000,86288,0,110288
132520800600000,NW 327,Residential,24240,0,24240,112498,0,136738
132522600100000,NW 328,Residential,36400,0,36400,151854,0,188254
132522600200000,NW 328,Residential,37331,0,37331,156962,0,194293
132522600300000,NW 328,Residential,36750,0,36750,146266,0,183016
132522600400000,NW 328,Residential,37450,0,37450,119832,0,157282
132522600500000,NW 328,Residential,37800,0,37800,112555,0,150355
132522600600000,NW 328,Residential,38880,0,38880,121406,0,160286
132522700100000,NW 328,Residential,40162,0,40162,169297,0,209459
132522700200000,NW 328,Residential,31824,0,31824,140130,0,171954
132522700300000,NW 328,Residential,29952,0,29952,129837,0,159789
132522700400000,NW 328,Residential,37800,0,37800,159343,0,197143
132522800100000,NW 328,Residential,32000,0,32000,129971,0,161971
132522800200000,NW 328,Residential,32000,0,32000,128838,0,160838
132522800300000,NW 328,Residential,28000,0,28000,116509,0,144509
132522800400000,NW 328,Residential,28000,0,28000,129272,0,157272
132522800500000,NW 328,Residential,28000,0,28000,125402,0,153402
132522800600000,NW 328,Residential,28000,0,28000,145124,0,173124
132522800700000,NW 328,Residential,28000,0,28000,132811,0,160811
132522800800000,NW 328,Residential,28000,0,28000,146706,0,174706
132522800900000,NW 328,Residential,28000,0,28000,122022,0,150022
132522801000000,NW 328,Residential,28000,0,28000,130226,0,158226
132522801100000,NW 328,Residential,27393,0,27393,132735,0,160128
132522801200000,NW 328,Residential,27331,0,27331,124313,0,151644
132522801300000,NW 328,Residential,27160,0,27160,118482,0,145642
132522801400000,NW 327,Residential,24800,0,24800,86486,0,111286
132522801500000,NW 327,Residential,24800,0,24800,102139,0,126939
132522801600000,NW 327,Residential,24800,0,24800,84129,0,108929
132522801700000,NW 327,Residential,25600,0,25600,98101,0,123701
132522801800000,NW 327,Residential,26000,0,26000,94010,0,120010
132522801900000,NW 327,Residential,24400,0,24400,86958,0,111358
132522802000000,NW 327,Residential,24800,0,24800,96594,0,121394
132522802100000,NW 327,Residential,24800,0,24800,104352,0,129152
132522802200000,NW 328,Residential,29280,0,29280,138733,0,168013
132522802300000,NW 328,Residential,27699,0,27699,143538,0,171237
132522802400000,NW 328,Residential,29079,0,29079,119342,0,148421
132522802500000,NW 328,Residential,28000,0,28000,134321,0,162321
132522802600000,NW 328,Residential,28000,0,28000,162114,0,190114
132522802700000,NW 328,Residential,28000,0,28000,127178,0,155178
132522802800000,NW 328,Residential,28000,0,28000,123520,0,151520
132522802900000,NW 328,Residential,28000,0,28000,130892,0,158892
132522803000000,NW 328,Residential,28000,0,28000,141743,0,169743
132522803100000,NW 328,Residential,28000,0,28000,123569,0,151569
132522803200000,NW 328,Residential,28000,0,28000,147269,0,175269
132522900100000,NW 328,Residential,32640,0,32640,144184,0,176824
132522900200000,NW 328,Residential,28560,0,28560,121762,0,150322
132522900300000,NW 328,Residential,28560,0,28560,117164,0,145724
132522900400000,NW 328,Residential,28560,0,28560,117769,0,146329
132522900500000,NW 328,Residential,28560,0,28560,117556,0,146116
132522900600000,NW 328,Residential,28560,0,28560,124711,0,153271
132522900700000,NW 328,Residential,28560,0,28560,136386,0,164946
132522900800000,NW 328,Residential,28560,0,28560,141248,0,169808
132522900900000,NW 328,Residential,28560,0,28560,120085,0,148645
132522901000000,NW 328,Residential,28511,0,28511,125291,0,153802
132522901100000,NW 328,Residential,29155,0,29155,133090,0,162245
132522901200000,NW 328,Residential,27831,0,27831,120303,0,148134
132522901300000,NW 327,Residential,26040,0,26040,122876,0,148916
132522901400000,NW 327,Residential,26040,0,26040,99292,0,125332
132522901500000,NW 327,Residential,26040,0,26040,92982,0,119022
132522901600000,NW 327,Residential,26880,0,26880,97729,0,124609
132523000100000,NW 328,Residential,32550,0,32550,124151,0,156701
132523000200000,NW 328,Residential,32981,0,32981,132978,0,165959
132523000300000,NW 328,Residential,43566,0,43566,123428,0,166994
132523000400000,NW 328,Residential,35340,0,35340,120501,0,155841
132523000500000,NW 328,Residential,34556,0,34556,127585,0,162141
132523000600000,NW 328,Residential,34718,0,34718,122056,0,156774
132523003000000,NW 328,Residential,33950,0,33950,142853,0,176803
132523100100000,NW 328,Residential,37933,0,37933,119886,0,157819
132523100200000,NW 328,Residential,40250,0,40250,119363,0,159613
132523100300000,NW 328,Residential,40250,0,40250,140746,0,180996
132523100400000,NW 328,Residential,29952,0,29952,128227,0,158179
132523100500000,NW 328,Residential,29120,0,29120,124763,0,153883
132523100600000,NW 328,Residential,29120,0,29120,121814,0,150934
132523100700000,NW 328,Residential,29120,0,29120,172132,0,201252
132523100800000,NW 328,Residential,29120,0,29120,136696,0,165816
132523100900000,NW 328,Residential,29120,0,29120,118503,0,147623
132523101000000,NW 328,Residential,28883,0,28883,129604,0,158487
132523101100000,NW 328,Residential,27623,0,27623,157358,0,184981
132523101200000,NW 328,Residential,27477,0,27477,121611,0,149088
132523101300000,NW 327,Residential,24800,0,24800,105955,0,130755
132523101400000,NW 327,Residential,24800,0,24800,99925,0,124725
132523101500000,NW 327,Residential,24000,0,24000,88657,0,112657
132523101600000,NW 327,Residential,26400,0,26400,89620,0,116020
132523101700000,NW 327,Residential,26400,0,26400,89248,0,115648
132523101800000,NW 328,Residential,33570,0,33570,148162,0,181732
132523101900000,NW 328,Residential,32273,0,32273,124424,0,156697
132523102000000,NW 328,Residential,33303,0,33303,127491,0,160794
132523102100000,NW 328,Residential,31525,0,31525,152285,0,183810
132523102200000,NW 328,Residential,31525,0,31525,149138,0,180663
132523102300000,NW 328,Residential,31850,0,31850,164412,0,196262
132523102400000,NW 328,Residential,39558,0,39558,168561,0,208119
132523102500000,NW 328,Residential,40500,0,40500,164879,0,205379
132523102600000,NW 328,Residential,37026,0,37026,147782,0,184808
132523102700000,NW 328,Residential,39069,0,39069,142646,0,181715
132523102800000,NW 328,Residential,39157,0,39157,154451,0,193608
132523102900000,NW 328,Residential,37409,0,37409,136431,0,173840
132523103100000,NW 328,Residential,33950,0,33950,117815,0,151765
132523103200000,NW 328,Residential,33950,0,33950,137929,0,171879
132523103300000,NW 328,Residential,39200,0,39200,160545,0,199745
132523103400000,NW 328,Residential,38850,0,38850,146546,0,185396
132523103500000,NW 328,Residential,39435,0,39435,167261,0,206696
132523103600000,NW 328,Residential,35350,0,35350,154700,0,190050
132523103700000,NW 328,Residential,38227,0,38227,118251,0,156478
132523103800000,NW 328,Residential,39544,0,39544,134121,0,173665
132523103900000,NW 328,Residential,37080,0,37080,123521,0,160601
132523104000000,NW 328,Residential,33738,0,33738,144653,0,178391
132523104100000,NW 328,Residential,35389,0,35389,136648,0,172037
132523104200000,NW 328,Residential,37986,0,37986,127331,0,165317
132523200100000,NW 328,Residential,35941,0,35941,142480,0,178421
132523200200000,NW 328,Residential,34144,0,34144,133368,0,167512
132523200300000,NW 328,Residential,31525,0,31525,163215,0,194740
132523200400000,NW 328,Residential,31525,0,31525,147124,0,178649
132523200500000,NW 328,Residential,31525,0,31525,126382,0,157907
132523200600000,NW 328,Residential,31525,0,31525,127428,0,158953
132523200700000,NW 328,Residential,31525,0,31525,125215,0,156740
132523200800000,NW 328,Residential,32600,0,32600,146294,0,178894
132523200900000,NW 328,Residential,37875,0,37875,141957,0,179832
132523201000000,NW 327,Residential,25600,0,25600,85772,0,111372
132523201100000,NW 327,Residential,24800,0,24800,92288,0,117088
132523201200000,NW 327,Residential,24800,0,24800,87977,0,112777
132523201300000,NW 327,Residential,24800,0,24800,89441,0,114241
132523201400000,NW 327,Residential,24800,0,24800,89714,0,114514
132523201500000,NW 327,Residential,24800,0,24800,94305,0,119105
132523201600000,NW 327,Residential,24800,0,24800,84157,0,108957
132523201700000,NW 327,Residential,24800,0,24800,84575,0,109375
132523201800000,NW 327,Residential,24800,0,24800,83961,0,108761
132523201900000,NW 327,Residential,24800,0,24800,102425,0,127225
132523300100000,NW 327,Residential,25960,0,25960,111921,0,137881
132523300200000,NW 327,Residential,25960,0,25960,89633,0,115593
132523300300000,NW 327,Residential,25960,0,25960,99599,0,125559
132523300400000,NW 327,Residential,25960,0,25960,87431,0,113391
132523300500000,NW 327,Residential,24800,0,24800,93137,0,117937
132523300600000,NW 327,Residential,24800,0,24800,85458,0,110258
132523300700000,NW 327,Residential,24800,0,24800,89465,0,114265
132523300800000,NW 327,Residential,24800,0,24800,81823,0,106623
132523300900000,NW 327,Residential,24800,0,24800,107829,0,132629
132523301000000,NW 327,Residential,24800,0,24800,89689,0,114489
132523301100000,NW 327,Residential,24800,0,24800,85502,0,110302
132523301200000,NW 327,Residential,24800,0,24800,95291,0,120091
132523301300000,NW 327,Residential,24800,0,24800,94347,0,119147
132523301400000,NW 327,Residential,26600,0,26600,105810,0,132410
132523400100000,NW 327,Residential,24000,0,24000,94562,0,118562
132523400200000,NW 327,Residential,24000,0,24000,86469,0,110469
132523400300000,NW 327,Residential,24000,0,24000,88052,0,112052
132523400400000,NW 327,Residential,24000,0,24000,105192,0,129192
132523400500000,NW 327,Residential,24000,0,24000,96626,0,120626
132523400600000,NW 327,Residential,29310,0,29310,84303,0,113613
132525100100000,NW 329,Residential,19740,0,19740,70505,0,90245
132525100200000,NW 329,Residential,20504,0,20504,78496,0,99000
132525100300000,NW 329,Residential,21714,0,21714,64970,0,86684
132525100400000,NW 329,Residential,20398,0,20398,73732,0,94130
132525100500000,NW 329,Residential,19740,0,19740,71296,0,91036
132525100600000,NW 329,Residential,20398,0,20398,85727,0,106125
132525100700000,NW 329,Residential,21714,0,21714,88806,0,110520
132525100800000,NW 329,Residential,20398,0,20398,79535,0,99933
132525100900000,NW 329,Residential,19740,0,19740,77707,0,97447
132525101000000,NW 329,Residential,19113,0,19113,73887,0,93000
132525101100000,NW 329,Residential,24255,0,24255,79116,0,103371
132525101200000,NW 329,Residential,24898,0,24898,101811,0,126709
132525101300000,NW 329,Residential,20946,0,20946,84716,0,105662
132525101400000,NW 329,Residential,20467,0,20467,70144,0,90611
132525101500000,NW 329,Residential,21341,0,21341,73663,0,95004
132525101600000,NW 329,Residential,20398,0,20398,63499,0,83897
132525101700000,NW 329,Residential,21338,0,21338,103684,0,125022
132525101800000,NW 329,Residential,20946,0,20946,76970,0,97916
132525101900000,NW 329,Residential,25856,0,25856,83490,0,109346
132525102000000,NW 329,Residential,23312,0,23312,78853,0,102165
132525102100000,NW 329,Residential,24800,0,24800,72373,0,97173
132525102200000,NW 329,Residential,23061,0,23061,79201,0,102262
132525102300000,NW 329,Residential,23061,0,23061,87571,0,110632
132525102400000,NW 329,Residential,22936,0,22936,86417,0,109353
132525102500000,NW 329,Residential,22936,0,22936,91326,0,114262
132525102600000,NW 329,Residential,22811,0,22811,84753,0,107564
132525102700000,NW 329,Residential,22685,0,22685,78222,0,100907
132525102800000,NW 329,Residential,21763,0,21763,82563,0,104326
132525200100000,NW 329,Residential,24350,0,24350,82365,0,106715
132525200200000,NW 329,Residential,26888,0,26888,86733,0,113621
132525200300000,NW 329,Residential,24218,0,24218,80564,0,104782
132525200400000,NW 329,Residential,24970,0,24970,69915,0,94885
132525200500000,NW 329,Residential,25393,0,25393,97855,0,123248
132525200600000,NW 329,Residential,27843,0,27843,86051,0,113894
132525200700000,NW 329,Residential,25380,0,25380,96594,0,121974
132525200800000,NW 329,Residential,26226,0,26226,73515,0,99741
132525200900000,NW 329,Residential,32314,0,32314,85598,0,117912
132525201000000,NW 329,Residential,31531,0,31531,83774,0,115305
132525201100000,NW 329,Residential,32670,0,32670,92942,0,125612
132525201200000,NW 329,Residential,32076,0,32076,80927,0,113003
132525201300000,NW 329,Residential,32773,0,32773,76202,0,108975
132525300100000,NW 329,Residential,20952,0,20952,76242,0,97194
132525300200000,NW 329,Residential,20398,0,20398,86321,0,106719
132525300300000,NW 329,Residential,21714,0,21714,84296,0,106010
132525300400000,NW 329,Residential,20398,0,20398,81091,0,101489
132525300500000,NW 329,Residential,20398,0,20398,77645,0,98043
132525300600000,NW 329,Residential,21714,0,21714,79236,0,100950
132525300700000,NW 329,Residential,20398,0,20398,73098,0,93496
132525300800000,NW 329,Residential,21496,0,21496,87504,0,109000
132525300900000,NW 329,Residential,20398,0,20398,72739,0,93137
132525301000000,NW 329,Residential,21714,0,21714,86171,0,107885
132525301100000,NW 329,Residential,20398,0,20398,73920,0,94318
132525301200000,NW 329,Residential,20398,0,20398,84768,0,105166
132525301300000,NW 329,Residential,22222,0,22222,84964,0,107186
132525301400000,NW 329,Residential,21233,0,21233,77190,0,98423
132525301500000,CITY PROPERTY,Exempt,0,0,0,0,0,0
132525301600000,CITY PROPERTY,Exempt,0,0,0,0,0,0
132525400100000,NW 329,Residential,20952,0,20952,64893,0,85845
132525400200000,NW 329,Residential,20952,0,20952,73947,0,94899
132525400300000,NW 329,Residential,21714,0,21714,84222,0,105936
132525400400000,NW 329,Residential,20398,0,20398,72879,0,93277
132525400500000,NW 329,Residential,19740,0,19740,73634,0,93374
132525400600000,NW 329,Residential,20398,0,20398,78901,0,99299
132525400700000,NW 329,Residential,21714,0,21714,85606,0,107320
132525400800000,NW 329,Residential,20398,0,20398,89003,0,109401
132525400900000,NW 329,Residential,20398,0,20398,76200,0,96598
132525401000000,NW 329,Residential,21468,0,21468,57796,0,79264
132525401100000,NW 329,Residential,20398,0,20398,72067,0,92465
132525401200000,NW 329,Residential,19740,0,19740,86876,0,106616
132525401300000,NW 329,Residential,21714,0,21714,87211,0,108925
132525401400000,NW 329,Residential,22338,0,22338,91077,0,113415
132525401500000,NW 329,Residential,21883,0,21883,80078,0,101961
132525401600000,NW 329,Residential,20398,0,20398,76387,0,96785
132525401700000,NW 329,Residential,19740,0,19740,82237,0,101977
132525401800000,NW 329,Residential,20398,0,20398,80130,0,100528
132525401900000,NW 329,Exempt,0,21714,21714,1099,86568,109381
132525402000000,NW 329,Residential,20398,0,20398,84163,0,104561
132525402100000,NW 329,Residential,20398,0,20398,82176,0,102574
132525402200000,NW 329,Residential,21714,0,21714,90959,0,112673
132525402300000,NW 329,Residential,20398,0,20398,89577,0,109975
132525402400000,NW 329,Residential,19740,0,19740,69583,0,89323
132525402500000,NW 329,Residential,20398,0,20398,77344,0,97742
132525402600000,NW 329,Residential,21714,0,21714,85036,0,106750
132525500100000,NW 329,Residential,19735,0,19735,74852,0,94587
132525500200000,NW 329,Residential,23333,0,23333,85527,0,108860
132525500300000,NW 329,Residential,23539,0,23539,73743,0,97282
132525500400000,NW 329,Residential,22000,0,22000,70614,0,92614
132525500500000,NW 329,Residential,21896,0,21896,79392,0,101288
132525500600000,NW 329,Residential,20769,0,20769,87717,0,108486
132525500700000,NW 329,Residential,22152,0,22152,72052,0,94204
132525500800000,NW 329,Residential,20160,0,20160,87861,0,108021
132525500900000,NW 329,Residential,21618,0,21618,77018,0,98636
132525501000000,NW 329,Residential,21104,0,21104,75997,0,97101
132525501100000,NW 329,Residential,25693,0,25693,73432,0,99125
132525501200000,NW 329,Residential,23312,0,23312,70473,0,93785
132525501300000,NW 329,Residential,24656,0,24656,72310,0,96966
132525501400000,NW 329,Residential,22403,0,22403,103100,0,125503
132525501500000,NW 329,Residential,23334,0,23334,78695,0,102029
132525501600000,NW 329,Residential,22454,0,22454,85108,0,107562
132525501700000,NW 329,Residential,22906,0,22906,81179,0,104085
132525501800000,NW 329,Residential,22186,0,22186,50712,0,72898
132525501900000,NW 329,Residential,22560,0,22560,78802,0,101362
132525502000000,NW 329,Residential,22560,0,22560,71151,0,93711
132525502100000,NW 329,Residential,23714,0,23714,70952,0,94666
132525502200000,NW 329,Residential,23827,0,23827,74060,0,97887
132525502300000,NW 329,Residential,21957,0,21957,72113,0,94070
132525502400000,NW 329,Residential,20398,0,20398,87184,0,107582
132525502500000,NW 329,Residential,19740,0,19740,71601,0,91341
132525502600000,NW 329,Residential,20398,0,20398,86103,0,106501
132525502700000,NW 329,Residential,21714,0,21714,86030,0,107744
132525502800000,NW 329,Residential,20398,0,20398,75541,0,95939
132525502900000,NW 329,Residential,19740,0,19740,70415,0,90155
132525503000000,NW 329,Residential,20398,0,20398,83656,0,104054
132525503100000,NW 329,Residential,21714,0,21714,84456,0,106170
132525503200000,NW 329,Residential,20398,0,20398,75730,0,96128
132525503300000,NW 329,Residential,20398,0,20398,79781,0,100179
132525503400000,NW 329,Residential,20398,0,20398,89559,0,109957
132525600100000,NW 329,Residential,28272,0,28272,91061,0,119333
132525600200000,NW 329,Residential,29703,0,29703,85629,0,115332
132525600300000,NW 329,Residential,25317,0,25317,82148,0,107465
132525600400000,NW 329,Residential,25587,0,25587,82001,0,107588
132525600500000,NW 329,Residential,25856,0,25856,80768,0,106624
132525600600000,NW 329,Residential,23940,0,23940,71792,0,95732
132525600700000,NW 329,Residential,25587,0,25587,81178,0,106765
132525600800000,NW 329,Residential,23940,0,23940,77346,0,101286
132525600900000,NW 329,Residential,25177,0,25177,90958,0,116135
132525601000000,NW 329,Residential,27072,0,27072,88417,0,115489
132525601100000,NW 329,Residential,26319,0,26319,96028,0,122347
132525601200000,NW 329,Residential,24941,0,24941,77328,0,102269
132525601300000,NW 329,Residential,27867,0,27867,84412,0,112279
132525601400000,NW 329,Residential,24498,0,24498,72539,0,97037
132525601500000,NW 329,Residential,23808,0,23808,76338,0,100146
132525601600000,NW 329,Residential,25958,0,25958,84590,0,110548
132525601700000,NW 329,Residential,23243,0,23243,89726,0,112969
132525601800000,NW 329,Exempt,0,23813,23813,0,111804,135617
132525601900000,NW 329,Residential,25587,0,25587,87344,0,112931
132525602000000,NW 329,Residential,22819,0,22819,90091,0,112910
132525602100000,NW 329,Residential,23851,0,23851,77881,0,101732
132525602200000,NW 329,Residential,25599,0,25599,87540,0,113139
132525602300000,NW 329,Residential,24105,0,24105,78426,0,102531
132525602400000,NW 329,Residential,24901,0,24901,75320,0,100221
132525700100000,NW 329,Residential,29421,0,29421,94709,0,124130
132525700200000,NW 329,Residential,36708,0,36708,104167,0,140875
132525700300000,NW 329,Residential,27009,0,27009,92603,0,119612
132525700400000,NW 329,Residential,27918,0,27918,89681,0,117599
132525700500000,NW 329,Residential,27072,0,27072,81958,0,109030
132525700600000,NW 329,Residential,26901,0,26901,82445,0,109346
132525700700000,NW 329,Residential,24548,0,24548,105410,0,129958
132525700800000,NW 329,Residential,26195,0,26195,73697,0,99892
132525700900000,NW 329,Residential,22560,0,22560,91237,0,113797
132525701000000,NW 329,Residential,23688,0,23688,105455,0,129143
132525701100000,NW 329,Residential,23312,0,23312,71470,0,94782
132525701200000,NW 329,Residential,22936,0,22936,74419,0,97355
132525701300000,NW 329,Residential,24067,0,24067,80726,0,104793
132525701400000,NW 329,Residential,23238,0,23238,86333,0,109571
132525701500000,NW 329,Residential,23823,0,23823,80036,0,103859
132525701600000,NW 329,Residential,23061,0,23061,101678,0,124739
132525800100000,CITY PROPERTY,Exempt,0,0,0,0,0,0
132525900100000,NW 329,Residential,36981,0,36981,87184,0,124165
132527600100000,NW 327,Residential,28850,0,28850,98354,0,127204
132527600200000,NW 327,Residential,26368,0,26368,99622,0,125990
132527600300000,NW 327,Residential,26368,0,26368,106431,0,132799
132527600400000,NW 327,Residential,26698,0,26698,103892,0,130590
132527600500000,NW 327,Residential,26698,0,26698,105217,0,131915
132527600600000,NW 327,Residential,26698,0,26698,98823,0,125521
132527600700000,NW 327,Residential,26698,0,26698,96411,0,123109
132527600800000,NW 327,Residential,26698,0,26698,97308,0,124006
132527600900000,NW 327,Residential,26438,0,26438,109966,0,136404
132527601000000,CITY PROPERTY,Exempt,0,0,0,0,0,0
132527601100000,APARTMENT,Commercial,0,19035,19035,0,162989,182024
132527700100000,NW 327,Residential,27650,0,27650,91905,0,119555
132527700200000,NW 327,Residential,22633,0,22633,94356,0,116989
132527700300000,NW 327,Residential,24500,0,24500,106006,0,130506
132527700400000,NW 327,Residential,23800,0,23800,109670,0,133470
132527700500000,NW 327,Residential,24500,0,24500,107712,0,132212
132527700600000,NW 327,Residential,24500,0,24500,110122,0,134622
132527700700000,NW 327,Residential,24500,0,24500,110323,0,134823
132527700800000,NW 327,Residential,24500,0,24500,98823,0,123323
132527700900000,NW 327,Residential,24500,0,24500,102599,0,127099
132527701000000,NW 327,Residential,24500,0,24500,85349,0,109849
132527800100000,NW 327,Residential,21000,0,21000,107862,0,128862
132527800200000,NW 327,Residential,21000,0,21000,96888,0,117888
132527800300000,NW 327,Residential,21000,0,21000,112950,0,133950
132527800400000,NW 327,Residential,21000,0,21000,91258,0,112258
132527800500000,NW 327,Residential,21000,0,21000,85284,0,106284
132527800600000,NW 327,Residential,21000,0,21000,72507,0,93507
132527900100000,NW 327,Residential,28000,0,28000,109252,0,137252
132527900200000,NW 327,Residential,24500,0,24500,94933,0,119433
132527900300000,NW 327,Residential,22643,0,22643,127924,0,150567
132527900400000,NW 327,Residential,22400,0,22400,96554,0,118954
132527900500000,NW 327,Residential,21700,0,21700,108188,0,129888
132527900600000,NW 327,Residential,22400,0,22400,101457,0,123857
132527900700000,NW 327,Residential,21700,0,21700,114070,0,135770
132527900800000,NW 327,Residential,22400,0,22400,113173,0,135573
132527900900000,NW 327,Residential,24238,0,24238,108753,0,132991
132527901000000,NW 327,Residential,27940,0,27940,101286,0,129226
132527901100000,NW 327,Residential,25600,0,25600,95043,0,120643
132527901200000,NW 327,Residential,24800,0,24800,97608,0,122408
132527901300000,NW 327,Residential,25600,0,25600,100225,0,125825
132527901400000,NW 327,Residential,24800,0,24800,99067,0,123867
132527901500000,NW 327,Residential,25600,0,25600,121379,0,146979
132527901600000,NW 327,Residential,25544,0,25544,83900,0,109444
132528000100000,NW 327,Residential,24500,0,24500,93705,0,118205
132528000200000,NW 327,Residential,24500,0,24500,110646,0,135146
132528000300000,NW 327,Residential,21946,0,21946,118236,0,140182
132528000400000,NW 327,Residential,22400,0,22400,103061,0,125461
132528000500000,NW 327,Residential,22400,0,22400,102447,0,124847
132528000600000,NW 327,Residential,22400,0,22400,95054,0,117454
132528000700000,NW 327,Residential,22400,0,22400,107980,0,130380
132528000800000,NW 327,Residential,22400,0,22400,109663,0,132063
132528000900000,NW 327,Residential,22400,0,22400,92963,0,115363
132528001000000,NW 327,Residential,22295,0,22295,101749,0,124044
132528001100000,NW 327,Residential,22505,0,22505,118848,0,141353
132528001200000,NW 327,Residential,22400,0,22400,110113,0,132513
132528001300000,NW 327,Residential,22400,0,22400,111598,0,133998
132528001400000,NW 327,Residential,22400,0,22400,106054,0,128454
132528001500000,NW 327,Residential,22400,0,22400,106313,0,128713
132528001600000,NW 327,Residential,22400,0,22400,95203,0,117603
132528001700000,NW 327,Residential,22400,0,22400,101388,0,123788
132528001800000,NW 327,Residential,21657,0,21657,114925,0,136582
132528100100000,NW 327,Residential,24500,0,24500,101686,0,126186
132528100200000,NW 327,Residential,24500,0,24500,113217,0,137717
132528100300000,NW 327,Residential,22049,0,22049,105053,0,127102
132528100400000,NW 327,Residential,22400,0,22400,109560,0,131960
132528100500000,NW 327,Residential,22400,0,22400,0,0,22400
132528100600000,NW 327,Residential,22400,0,22400,111916,0,134316
132528100700000,NW 327,Residential,22400,0,22400,94939,0,117339
132528100800000,NW 327,Residential,22400,0,22400,109815,0,132215
132528100900000,NW 327,Residential,24395,0,24395,95760,0,120155
132528101000000,NW 327,Residential,24605,0,24605,112072,0,136677
132528101100000,NW 327,Residential,22400,0,22400,86856,0,109256
132528101200000,NW 327,Residential,22400,0,22400,112751,0,135151
132528101300000,NW 327,Residential,21700,0,21700,97953,0,119653
132528101400000,NW 327,Residential,22400,0,22400,121277,0,143677
132528101500000,NW 327,Residential,22400,0,22400,98406,0,120806
132528101600000,NW 327,Residential,21818,0,21818,88350,0,110168
132528200100000,NW 327,Residential,24500,0,24500,81900,0,106400
132528200200000,NW 327,Residential,24500,0,24500,96333,0,120833
132528200300000,NW 327,Residential,22327,0,22327,97088,0,119415
132528200400000,NW 327,Residential,22400,0,22400,101102,0,123502
132528200500000,NW 327,Residential,22400,0,22400,120182,0,142582
132528200600000,NW 327,Residential,22400,0,22400,97148,0,119548
132528200700000,NW 327,Residential,22400,0,22400,113531,0,135931
132528200800000,NW 327,Residential,22575,0,22575,115752,0,138327
132528200900000,NW 327,Residential,22575,0,22575,92994,0,115569
132528201000000,NW 327,Residential,22575,0,22575,91135,0,113710
132528201100000,NW 327,Residential,22575,0,22575,89343,0,111918
132528201200000,NW 327,Residential,22610,0,22610,96809,0,119419
132528201300000,NW 327,Residential,24633,0,24633,94094,0,118727
132528201400000,NW 327,Residential,22351,0,22351,93182,0,115533
132528201500000,NW 327,Residential,24633,0,24633,106024,0,130657
132528201600000,NW 327,Residential,22820,0,22820,106674,0,129494
132528201700000,NW 327,Residential,22575,0,22575,103030,0,125605
132528201800000,NW 327,Residential,22575,0,22575,93488,0,116063
132528201900000,NW 327,Residential,22264,0,22264,82736,0,105000
132528202000000,NW 327,Residential,22575,0,22575,94976,0,117551
132528202100000,NW 327,Residential,22400,0,22400,108614,0,131014
132528202200000,NW 327,Residential,22400,0,22400,96893,0,119293
132528202300000,NW 327,Residential,22400,0,22400,101634,0,124034
132528202400000,NW 327,Residential,22400,0,22400,97373,0,119773
132528202500000,NW 327,Residential,22033,0,22033,92430,0,114463
132528300100000,NW 327,Residential,24500,0,24500,105505,0,130005
132528300200000,NW 327,Residential,22474,0,22474,93581,0,116055
132528300300000,NW 327,Residential,21700,0,21700,119504,0,141204
132528300400000,NW 327,Residential,22400,0,22400,107856,0,130256
132528300500000,NW 327,Residential,22400,0,22400,102219,0,124619
132528300600000,NW 327,Residential,22400,0,22400,90666,0,113066
132528300700000,NW 327,Residential,22400,0,22400,114903,0,137303
132528300800000,NW 327,Residential,22400,0,22400,94566,0,116966
132528300900000,NW 327,Residential,22400,0,22400,88289,0,110689
132528301000000,NW 327,Residential,22400,0,22400,92556,0,114956
132528301100000,NW 327,Residential,22400,0,22400,98731,0,121131
132528301200000,NW 327,Residential,22400,0,22400,73421,0,95821
132528301300000,NW 327,Residential,24979,0,24979,80841,0,105820
132528400100000,CITY PROPERTY,Exempt,0,0,0,0,0,0
132528400200000,CITY PROPERTY,Exempt,0,0,0,0,0,0
132528400300000,CHURCH,Exempt,0,437184,437184,0,661057,1098241
132528500100000,CITY PROPERTY,Exempt,0,0,0,0,0,0
132528600100000,NW 327,Residential,22015,0,22015,117651,0,139666
132528600200000,NW 327,Residential,24448,0,24448,104851,0,129299
132528600300000,NW 327,Residential,21700,0,21700,96298,0,117998
132528600400000,NW 327,Residential,21700,0,21700,92832,0,114532
132528600500000,NW 327,Residential,25514,0,25514,90192,0,115706
132528600600000,CITY PROPERTY,Exempt,0,0,0,0,0,0
132528700100000,CITY PROPERTY,Exempt,0,0,0,0,0,0
132528700200000,CITY PROPERTY,Exempt,0,0,0,0,0,0
132530100100000,NW 329,Residential,31870,0,31870,113872,0,145742
132530100200000,NW 329,Residential,57850,0,57850,115298,0,173148
132530100300000,NW 329,Residential,52350,0,52350,101212,0,153562
132530100400000,NW 329,Residential,58550,0,58550,0,0,58550
132530100500000,APARTMENT,Commercial,0,49896,49896,0,400104,450000
132530100600000,NW 329,Residential,33900,0,33900,207422,0,241322
132530200100000,NW 329,Ag Dwelling,10452,0,10452,134647,21228,166327
132530200200000,NW 344,Residential,49811,0,49811,181443,0,231254
132530200300000,NW 344,Residential,46600,0,46600,266127,0,312727
132530200400000,NW 344,Residential,46354,0,46354,228379,0,274733
132530200500000,NW 344,Residential,48151,0,48151,226641,0,274792
132530200600000,NW 344,Residential,46713,0,46713,283989,0,330702
132530200700000,NW 344,Residential,46084,0,46084,293499,0,339583
132530200800000,NW 344,Residential,45815,0,45815,253189,0,299004
132530200900000,NW 344,Residential,45815,0,45815,227948,0,273763
132530201000000,NW 344,Residential,46609,0,46609,221284,0,267893
132530201100000,NW 344,Residential,47025,0,47025,257157,0,304182
132530201200000,NW 344,Residential,50860,0,50860,227604,0,278464
132530300100000,NW 344,Residential,48706,0,48706,286054,0,334760
132530300200000,CITY PROPERTY,Exempt,0,0,0,0,0,0
132530300300000,NW 344,Residential,51300,0,51300,90651,0,141951
132530300500000,NW 344,Residential,44280,0,44280,251304,0,295584
132530300600000,NW 344,Residential,46632,0,46632,232176,0,278808
132530300700000,NW 344,Residential,45815,0,45815,265428,0,311243
132530300800000,NW 344,Residential,45815,0,45815,253469,0,299284
132530300900000,NW 344,Residential,47669,0,47669,236626,0,284295
132530400100000,NW 344,Residential,50090,0,50090,251750,0,301840
132530400200000,NW 344,Residential,45012,0,45012,215458,0,260470
132530400300000,NW 344,Residential,46329,0,46329,219799,0,266128
132530400400000,NW 344,Residential,44000,0,44000,233813,0,277813
132530400500000,NW 344,Residential,47025,0,47025,249970,0,296995
132530400600000,NW 344,Residential,44000,0,44000,212203,0,256203
132530400700000,NW 344,Residential,45641,0,45641,226134,0,271775
132530400800000,NW 344,Residential,46550,0,46550,270572,0,317122
132530400900000,NW 344,Residential,51937,0,51937,333086,0,385023
132530401000000,NW 344,Residential,47667,0,47667,202983,0,250650
132530401200000,NW 344,Residential,48645,0,48645,233274,0,281919
132530401300000,NW 344,Residential,44550,0,44550,272381,0,316931
132530401400000,NW 344,Residential,46750,0,46750,228414,0,275164
132530401500000,NW 344,Residential,46750,0,46750,264687,0,311437
132530401600000,NW 344,Residential,46750,0,46750,193008,0,239758
132530401700000,NW 344,Residential,46750,0,46750,261228,0,307978
132530401800000,NW 344,Residential,46404,0,46404,216299,0,262703
132530401900000,NW 344,Residential,50935,0,50935,253033,0,303968
132530402000000,NW 344,Residential,52411,0,52411,265951,0,318362
132530402100000,NW 344,Residential,50330,0,50330,255985,0,306315
132530402200000,NW 344,Residential,50879,0,50879,239283,0,290162
132530402300000,NW 344,Residential,46750,0,46750,207269,0,254019
132530402400000,NW 344,Residential,46750,0,46750,230681,0,277431
132530402500000,NW 344,Residential,46750,0,46750,210366,0,257116
132530402600000,NW 344,Residential,44000,0,44000,210963,0,254963
132530402700000,NW 344,Residential,46750,0,46750,217346,0,264096
132530402800000,NW 344,Residential,46750,0,46750,247848,0,294598
132530402900000,NW 344,Residential,44000,0,44000,228083,0,272083
132530403000000,NW 344,Residential,46750,0,46750,257978,0,304728
132530403100000,NW 344,Residential,48369,0,48369,246495,0,294864
132530403200000,NW 344,Residential,51275,0,51275,235798,0,287073
132530403300000,NW 344,Residential,53259,0,53259,243206,0,296465
132530403400000,NW 344,Residential,55566,0,55566,235366,0,290932
132530403500000,NW 344,Residential,52479,0,52479,225234,0,277713
132530403600000,NW 344,Residential,51414,0,51414,201593,0,253007
132532600100000,APARTMENT,Commercial,0,52974,52974,0,1110025,1162999
132532600200000,BRANCH BANK/CU,Commercial,0,83981,83981,0,214305,298286
132532600300000,NBHD SHOPPING CENTER,Commercial,0,358560,358560,0,259316,617876
132532600400000,NBHD SHOPPING CENTER,Commercial,0,175392,175392,0,464704,640096
132532600500000,AUTO REPAIR/SALES,Commercial,0,54000,54000,0,48122,102122
132532700100000,NW 329,Residential,26483,0,26483,65059,0,91542
132532700200000,CITY PROPERTY,Exempt,0,0,0,0,0,0
132532700300000,NW 329,Residential,21301,0,21301,109688,0,130989
132532700400000,NW 329,Residential,21210,0,21210,124671,0,145881
132532700500000,NW 329,Residential,21210,0,21210,134652,0,155862
132532700600000,NW 329,Residential,21489,0,21489,108157,0,129646
132532700700000,NW 329,Residential,19695,0,19695,116477,0,136172
132532700800000,NW 329,Residential,19695,0,19695,118774,0,138469
132532700900000,NW 329,Residential,19695,0,19695,191349,0,211044
132532701200000,DAY CARE CENTER,Commercial,0,71515,71515,0,250827,322342
132532701300000,NW 340,Residential,22557,0,22557,127342,0,149899
132532701400000,NW 340,Residential,21631,0,21631,129201,0,150832
132532701500000,NW 340,Residential,20854,0,20854,131026,0,151880
132532701600000,NW 340,Residential,20924,0,20924,132193,0,153117
132532701700000,NW 340,Residential,19885,0,19885,153211,0,173096
132532701800000,NW 340,Residential,20272,0,20272,142897,0,163169
132532701900000,NW 340,Residential,20249,0,20249,136696,0,156945
132532702000000,NW 340,Residential,21321,0,21321,140201,0,161522
132532702100000,NW 340,Residential,22792,0,22792,157278,0,180070
132532702200000,NW 340,Residential,21039,0,21039,149015,0,170054
132532702300000,NW 340,Residential,19500,0,19500,143736,0,163236
132532702400000,NW 340,Residential,21725,0,21725,128632,0,150357
132532702600000,OFFICE; MEDICAL,Commercial,0,136350,136350,0,511832,648182
132532702700000,CONVENIENCE STORE,Commercial,0,77760,77760,0,223580,301340
132532702800000,RESTAURANT,Commercial,0,67392,67392,0,90616,158008
132532702900000,CHURCH,Exempt,0,14170,14170,0,0,14170
132532703000000,CHURCH,Exempt,0,188352,188352,0,530779,719131
132532703100000,NW 329,Exempt,0,36453,36453,0,61456,97909
132532703200000,NW 329,Residential,27233,0,27233,57712,0,84945
132532703300000,NW 329,Residential,26481,0,26481,88465,0,114946
132532703400000,NW 329,Residential,26481,0,26481,93064,0,119545
132532703500000,OFFICE,Commercial,0,17432,17432,0,62959,80391
132532800100000,NW 329,Residential,20447,0,20447,109834,0,130281
132532800200000,NW 329,Residential,20370,0,20370,103418,0,123788
132532800300000,NW 329,Residential,20370,0,20370,121727,0,142097
132532800400000,NW 329,Residential,20370,0,20370,114676,0,135046
132532800500000,NW 329,Residential,22484,0,22484,126773,0,149257
132532800600000,NW 329,Residential,22485,0,22485,127155,0,149640
132532900100000,NW 329,Residential,11754,0,11754,112479,0,124233
132532900200000,NW 329,Residential,9693,0,9693,112722,0,122415
132532900300000,APARTMENT,Commercial,0,19600,19600,0,158947,178547
132532900400000,APARTMENT,Commercial,0,19600,19600,0,158947,178547
132533000100000,SERVICE STATION,Commercial,0,139968,139968,0,50609,190577
132533000200000,WAREHOUSE;MINI STORG,Commercial,0,45000,45000,0,95629,140629
132533100200000,AUTO REPAIR/SALES,Commercial,0,173664,173664,0,195220,368884
132533100300000,LG DISCOUNT/RETAIL,Commercial,0,369792,369792,0,419223,789015
132533100400000,WAREHOUSE,Commercial,0,135067,135067,0,137139,272206
132533100500000,WAREHOUSE,Commercial,0,112455,112455,0,141618,254073
132533200400000,OFFICE,Commercial,0,57132,57132,0,183847,240979
132533200500000,NBHD SHOPPING CENTER,Commercial,0,51840,51840,0,209095,260935
132533200600000,OFFICE,Commercial,0,20236,20236,0,119175,139411
132533200700000,SHOP,Commercial,0,62208,62208,0,103780,165988
132533200800000,APARTMENT,Commercial,0,42552,42552,0,36952,79504
132533200900000,APARTMENT,Exempt,0,28836,28836,0,381975,410811
132535100300000,VACANT LAND,Commercial,0,16821,16821,0,0,16821
132535100400000,APARTMENT,Commercial,0,146880,146880,0,2192235,2339115
132535100500000,CITY PROPERTY,Exempt,0,0,0,0,0,0
132535200200000,APARTMENT,Commercial,0,377298,377298,0,3403162,3780460
132535200300000,APARTMENT,Commercial,0,255960,255960,0,1635885,1891845
132535200500000,FITNESS CENTER,Commercial,0,383400,383400,0,758127,1141527
132537600200000,NW 344,Residential,1646,0,1646,0,0,1646
132537600300000,NW 344,Residential,2182,0,2182,0,0,2182
132537700100000,CITY PROPERTY,Exempt,0,0,0,0,0,0
132537700201000,OFFICE,Commercial,0,36720,36720,0,172813,209533
132537700201001,OFFICE,Commercial,0,36720,36720,0,172813,209533
132537700201002,OFFICE; MEDICAL,Commercial,0,32400,32400,0,173255,205655
132537700201003,OFFICE,Commercial,0,36720,36720,0,172813,209533
132537700201004,OFFICE,Commercial,0,36720,36720,0,172813,209533
132537700300000,APARTMENT,Commercial,0,337500,337500,0,3620712,3958212
132537800100000,GROCERY STORE,Commercial,0,692647,692647,0,1157353,1850000
132537800200000,VACANT LAND,Commercial,0,58608,58608,0,0,58608
132537800300000,VACANT LAND,Commercial,0,54470,54470,0,0,54470
132537800400000,NBHD SHOPPING CENTER,Commercial,0,275832,275832,0,1426427,1702259
132540100100000,NW 335,Residential,23651,0,23651,131551,0,155202
132540100200000,NW 335,Residential,23560,0,23560,160330,0,183890
132540100300000,NW 335,Residential,24304,0,24304,152722,0,177026
132540100400000,NW 335,Residential,25792,0,25792,142941,0,168733
132540100500000,NW 335,Residential,26288,0,26288,126369,0,152657
132540100600000,NW 335,Residential,26288,0,26288,167643,0,193931
132540100700000,NW 335,Residential,26288,0,26288,108439,0,134727
132540100800000,NW 335,Residential,26360,0,26360,135640,0,162000
132540100900000,NW 335,Residential,26288,0,26288,133473,0,159761
132540101000000,NW 335,Residential,26843,0,26843,140737,0,167580
132540200100000,NW 335,Residential,36634,0,36634,193363,0,229997
132540200200000,NW 335,Residential,36040,0,36040,159776,0,195816
132540200300000,NW 335,Residential,28196,0,28196,124878,0,153074
132540200400000,NW 335,Residential,27348,0,27348,172549,0,199897
132540200500000,NW 335,Residential,29402,0,29402,190538,0,219940
132540200600000,NW 335,Residential,31574,0,31574,125722,0,157296
132540200700000,NW 335,Residential,29680,0,29680,114068,0,143748
132540300100000,NW 335,Residential,19530,0,19530,114930,0,134460
132540300200000,NW 335,Residential,29154,0,29154,107222,0,136376
132540300300000,NW 335,Residential,27864,0,27864,149599,0,177463
132540300400000,NW 335,Residential,27348,0,27348,130189,0,157537
132540300500000,NW 335,Residential,27348,0,27348,126724,0,154072
132540300600000,NW 335,Residential,27348,0,27348,124633,0,151981
132540300700000,NW 335,Residential,27348,0,27348,125685,0,153033
132540300800000,NW 335,Residential,27348,0,27348,98234,0,125582
132540300900000,NW 335,Residential,27348,0,27348,183630,0,210978
132540301000000,NW 335,Residential,27348,0,27348,267,0,27615
132540301100000,NW 335,Residential,28620,0,28620,130186,0,158806
132540301200000,NW 335,Residential,28408,0,28408,112911,0,141319
132540301300000,NW 335,Residential,28408,0,28408,126661,0,155069
132540301400000,NW 335,Residential,36930,0,36930,146996,0,183926
132540301500000,NW 335,Residential,29119,0,29119,108525,0,137644
132540301600000,NW 335,Residential,25660,0,25660,105640,0,131300
132540301700000,NW 335,Residential,23808,0,23808,134330,0,158138
132540301800000,NW 335,Residential,23572,0,23572,115004,0,138576
132540301900000,NW 335,Residential,23312,0,23312,115253,0,138565
132540302000000,NW 335,Residential,23312,0,23312,131097,0,154409
132540302100000,NW 335,Residential,23312,0,23312,129640,0,152952
132540302200000,NW 335,Residential,23312,0,23312,111019,0,134331
132540302300000,NW 335,Residential,23312,0,23312,143767,0,167079
132540302400000,NW 335,Residential,23312,0,23312,146103,0,169415
132540302500000,NW 335,Residential,23312,0,23312,126613,0,149925
132540302600000,NW 335,Residential,24064,0,24064,112869,0,136933
132540302700000,NW 335,Residential,33163,0,33163,176253,0,209416
132540302800000,NW 335,Residential,23312,0,23312,125201,0,148513
132540302900000,NW 335,Residential,23312,0,23312,107628,0,130940
132540303000000,NW 335,Residential,23312,0,23312,107982,0,131294
132540303100000,NW 335,Residential,24440,0,24440,137979,0,162419
132540303200000,SCHOOL,Exempt,0,499554,499554,0,1068533,1568087
132540303300000,SCHOOL,Exempt,0,979560,979560,0,2095520,3075080
132540303400000,NW 335,Residential,19530,0,19530,135005,0,154535
132540303500000,NW 335,Residential,19530,0,19530,127935,0,147465
132542600100000,NW 335,Residential,29680,0,29680,144354,0,174034
132542600200000,NW 335,Residential,31701,0,31701,112491,0,144192
132542600300000,NW 335,Residential,31800,0,31800,123206,0,155006
132542600400000,NW 335,Residential,34238,0,34238,127911,0,162149
132542600500000,NW 335,Residential,34238,0,34238,128414,0,162652
132542600600000,NW 335,Residential,27357,0,27357,127643,0,155000
132542600700000,NW 335,Residential,31048,0,31048,141297,0,172345
132542600800000,NW 335,Residential,34272,0,34272,165578,0,199850
132542600900000,NW 335,Residential,31616,0,31616,119435,0,151051
132542601000000,NW 335,Residential,32936,0,32936,111699,0,144635
132542601100000,NW 335,Residential,28224,0,28224,139476,0,167700
132542601200000,NW 335,Residential,25872,0,25872,139105,0,164977
132542601300000,NW 335,Residential,29792,0,29792,130613,0,160405
132542601400000,NW 335,Residential,25408,0,25408,128692,0,154100
132542601500000,NW 335,Residential,25166,0,25166,120855,0,146021
132542601600000,NW 335,Residential,25733,0,25733,123748,0,149481
132542601700000,NW 335,Residential,29832,0,29832,113260,0,143092
132542601800000,NW 335,Residential,25285,0,25285,156351,0,181636
132542601900000,NW 335,Residential,29610,0,29610,133284,0,162894
132542602000000,NW 335,Residential,27936,0,27936,140111,0,168047
132542602100000,NW 335,Residential,29488,0,29488,125783,0,155271
132542602200000,NW 335,Residential,25560,0,25560,148221,0,173781
132542602300000,NW 335,Residential,28350,0,28350,124076,0,152426
132542602400000,NW 335,Residential,32851,0,32851,153476,0,186327
132542602500000,NW 335,Residential,33987,0,33987,133221,0,167208
132542602600000,NW 335,Residential,31916,0,31916,115552,0,147468
132542602700000,NW 335,Residential,27120,0,27120,159990,0,187110
132542602800000,NW 335,Residential,26400,0,26400,139166,0,165566
132542602900000,NW 335,Residential,27200,0,27200,156208,0,183408
132542603000000,NW 335,Residential,26251,0,26251,150871,0,177122
132542603100000,NW 335,Residential,32486,0,32486,157641,0,190127
132542603200000,NW 335,Residential,33136,0,33136,129942,0,163078
132542603300000,NW 335,Residential,31392,0,31392,158608,0,190000
132542603400000,NW 335,Residential,29557,0,29557,139167,0,168724
132542603500000,NW 335,Residential,32000,0,32000,187879,0,219879
132542603600000,NW 335,Residential,32000,0,32000,157926,0,189926
132542603700000,NW 335,Residential,31600,0,31600,168530,0,200130
132542603800000,NW 335,Residential,32395,0,32395,135155,0,167550
132542603900000,SCHOOL,Exempt,0,0,0,0,0,0
132542700100000,NW 335,Residential,29530,0,29530,148628,0,178158
132542700200000,NW 335,Residential,25287,0,25287,112213,0,137500
132542700300000,NW 335,Residential,25852,0,25852,148148,0,174000
132542700400000,NW 335,Residential,31040,0,31040,118416,0,149456
132542700500000,NW 335,Residential,31040,0,31040,122645,0,153685
132542700600000,NW 335,Residential,32068,0,32068,111419,0,143487
132542700700000,NW 335,Residential,30997,0,30997,144098,0,175095
132542700800000,NW 335,Residential,28512,0,28512,123556,0,152068
132542700900000,NW 335,Residential,31104,0,31104,153489,0,184593
132542701000000,NW 335,Residential,30672,0,30672,130415,0,161087
132542701100000,NW 335,Residential,34088,0,34088,125912,0,160000
132542701200000,NW 335,Residential,28198,0,28198,141302,0,169500
132542701300000,NW 335,Residential,33440,0,33440,110829,0,144269
132542701400000,NW 335,Residential,31104,0,31104,152460,0,183564
132542701500000,NW 335,Residential,32224,0,32224,118334,0,150558
132542701600000,NW 335,Residential,33696,0,33696,144308,0,178004
132542701700000,NW 335,Residential,30031,0,30031,147447,0,177478
132542701800000,NW 335,Residential,30933,0,30933,130576,0,161509
132542701900000,NW 335,Residential,32013,0,32013,137839,0,169852
132542702000000,NW 335,Residential,33510,0,33510,148851,0,182361
132542702100000,NW 335,Residential,28638,0,28638,145202,0,173840
132542702200000,NW 335,Residential,29154,0,29154,129924,0,159078
132542702300000,NW 335,Residential,24252,0,24252,141740,0,165992
132542702400000,NW 335,Residential,26320,0,26320,149444,0,175764
132542702500000,NW 335,Residential,36816,0,36816,120551,0,157367
132542702600000,NW 335,Residential,30702,0,30702,147930,0,178632
132542702700000,NW 335,Residential,37268,0,37268,229914,0,267182
132542702800000,NW 335,Residential,37576,0,37576,194227,0,231803
132542702900000,NW 335,Residential,31734,0,31734,154307,0,186041
132542703000000,NW 335,Residential,28952,0,28952,130454,0,159406
132542703200000,NW 335,Residential,35230,0,35230,144129,0,179359
132542703300000,NW 335,Residential,24252,0,24252,118274,0,142526
132542703400000,NW 335,Residential,4940,0,4940,0,0,4940
132542703500000,NW 335,Residential,1113,0,1113,0,0,1113
132542703600000,NW 335,Residential,1590,0,1590,0,0,1590
132542703800000,NW 335,Residential,8932,0,8932,0,0,8932
132542703900000,NW 335,Residential,6160,0,6160,0,0,6160
132542704000000,NW 335,Residential,5160,0,5160,0,0,5160
132542704100000,NW 335,Residential,31734,0,31734,153739,0,185473
132542800100000,NW 335,Residential,33696,0,33696,150050,0,183746
132542800200000,NW 335,Residential,29466,0,29466,142221,0,171687
132542800300000,NW 335,Residential,28560,0,28560,148261,0,176821
132542800400000,NW 335,Residential,30000,0,30000,170740,0,200740
132542800500000,NW 335,Residential,34320,0,34320,150948,0,185268
132542800600000,NW 335,Residential,32619,0,32619,184713,0,217332
132542800700000,NW 335,Residential,32000,0,32000,169395,0,201395
132542800800000,NW 335,Residential,32000,0,32000,154167,0,186167
132542800900000,NW 335,Residential,31200,0,31200,152733,0,183933
132542801000000,NW 335,Residential,32205,0,32205,144364,0,176569
132542801100000,NW 335,Residential,23715,0,23715,166511,0,190226
132542801200000,NW 335,Residential,26299,0,26299,166519,0,192818
132542801300000,NW 335,Residential,28248,0,28248,312975,0,341223
132542801400000,NW 335,Residential,24840,0,24840,176111,0,200951
132542801500000,NW 335,Residential,26002,0,26002,231622,0,257624
132542801600000,NW 335,Residential,22554,0,22554,142117,0,164671
132542801700000,NW 335,Residential,25024,0,25024,195194,0,220218
132542801800000,NW 335,Residential,21888,0,21888,142052,0,163940
132545100100000,NW 335,Residential,24880,0,24880,257427,0,282307
132545100200000,NW 335,Residential,24909,0,24909,167091,0,192000
132545100300000,NW 335,Residential,26880,0,26880,136133,0,163013
132545100400000,NW 335,Residential,26880,0,26880,149246,0,176126
132545100500000,NW 335,Residential,26880,0,26880,129786,0,156666
132545100600000,NW 335,Residential,26481,0,26481,113026,0,139507
132545100700000,NW 335,Residential,26481,0,26481,115611,0,142092
132545200100000,SR/NURSING/ASSTD LIV,Commercial,0,340740,340740,0,3701092,4041832
132545200200000,NW 335,Residential,23212,0,23212,147655,0,170867
132545200300000,NW 335,Residential,21825,0,21825,159353,0,181178
132545200400000,NW 335,Residential,21825,0,21825,98961,0,120786
132545200500000,NW 335,Residential,21825,0,21825,164962,0,186787
132545200600000,NW 335,Residential,21825,0,21825,131011,0,152836
132545200700000,NW 335,Residential,22206,0,22206,167761,0,189967
132545200800000,NW 335,Residential,22127,0,22127,136835,0,158962
132545200900000,NW 335,Residential,22050,0,22050,144438,0,166488
132545201000000,NW 335,Residential,22050,0,22050,119856,0,141906
132545201100000,NW 335,Residential,21644,0,21644,142002,0,163646
132545201200000,NW 335,Residential,24749,0,24749,167729,0,192478
132545201300000,NW 335,Residential,23988,0,23988,170746,0,194734
132545201400000,NW 335,Residential,25102,0,25102,191605,0,216707
132545201500000,NW 335,Residential,21630,0,21630,127063,0,148693
132545201600000,NW 335,Residential,22050,0,22050,160739,0,182789
132545201700000,NW 335,Residential,22050,0,22050,144245,0,166295
132545201800000,NW 335,Residential,22205,0,22205,162210,0,184415
132545201900000,VACANT LAND,Commercial,0,236250,236250,0,0,236250
132545300100000,NW 335,Residential,25039,0,25039,130557,0,155596
132545300200000,NW 335,Residential,27440,0,27440,140706,0,168146
132545300300000,NW 335,Residential,26754,0,26754,123057,0,149811
132545300400000,NW 335,Residential,27309,0,27309,132798,0,160107
132545400200000,APARTMENT,Residential,50058,0,50058,563993,0,614051
132545500100000,OFFICE,Commercial,0,413370,413370,0,3070744,3484114
132545500200000,OFFICE,Commercial,0,261900,261900,0,356140,618040
132545500300000,VACANT LAND,Commercial,0,13478,13478,0,0,13478
132545500400000,VACANT LAND,Commercial,0,19602,19602,0,0,19602
132545500500000,FLAT PARKING,Commercial,0,33372,33372,0,39000,72372
132547600100000,NW 335,Residential,21888,0,21888,128663,0,150551
132547600200000,NW 335,Residential,20160,0,20160,128633,0,148793
132547600300000,NW 335,Residential,19950,0,19950,94291,0,114241
132547600400000,NW 335,Residential,18189,0,18189,122819,0,141008
132547600500000,NW 335,Residential,18189,0,18189,114611,0,132800
132547600600000,NW 335,Residential,20138,0,20138,136969,0,157107
132547600700000,NW 335,Residential,21432,0,21432,148039,0,169471
132547600800000,NW 335,Residential,21705,0,21705,175337,0,197042
132547600900000,NW 335,Residential,23373,0,23373,121729,0,145102
132547601000000,NW 335,Residential,23373,0,23373,108544,0,131917
132547601100000,NW 335,Residential,23373,0,23373,112149,0,135522
132547601200000,NW 335,Residential,23373,0,23373,123540,0,146913
132547601300000,NW 335,Residential,23997,0,23997,131003,0,155000
132547601400000,APARTMENT,Commercial,0,22861,22861,0,128532,151393
132547601500000,APARTMENT,Commercial,0,19596,19596,0,204953,224549
132547601600000,APARTMENT,Commercial,0,20412,20412,0,205353,225765
132547601700000,APARTMENT,Commercial,0,26127,26127,0,263643,289770
132547601800000,SR/NURSING/ASSTD LIV,Commercial,0,52542,52542,0,1085439,1137981
132547601900000,NW 335,Residential,18360,0,18360,110594,0,128954
132547602000000,NW 335,Residential,21420,0,21420,133314,0,154734
132547602100000,NW 335,Residential,21384,0,21384,134436,0,155820
132547602200000,NW 335,Residential,20460,0,20460,121325,0,141785
132547602300000,NW 335,Residential,21784,0,21784,131216,0,153000
132547602400000,NW 335,Residential,20976,0,20976,94655,0,115631
132547602500000,NW 335,Residential,21627,0,21627,119013,0,140640
132547602600000,NW 335,Residential,19110,0,19110,89009,0,108119
132547602700000,NW 335,Residential,20516,0,20516,131553,0,152069
132547602800000,NW 335,Residential,20370,0,20370,108553,0,128923
132547602900000,NW 335,Residential,20952,0,20952,104820,0,125772
132547700100000,NW 335,Exempt,0,28428,28428,0,181817,210245
132547700200000,NW 335,Residential,24776,0,24776,160929,0,185705
132547700300000,NW 335,Residential,23280,0,23280,177801,0,201081
132547700400000,NW 335,Residential,24735,0,24735,163730,0,188465
132547700500000,NW 335,Residential,23280,0,23280,189138,0,212418
132547700600000,NW 335,Residential,22116,0,22116,129451,0,151567
132547700700000,NW 335,Residential,22116,0,22116,126901,0,149017
132547700800000,NW 335,Residential,24784,0,24784,127424,0,152208
132547700900000,NW 335,Residential,27160,0,27160,135357,0,162517
132547701000000,NW 335,Residential,28468,0,28468,154518,0,182986
132547701100000,NW 335,Residential,27104,0,27104,124896,0,152000
132547701200000,NW 335,Residential,26481,0,26481,116921,0,143402
132547701300000,NW 335,Residential,22068,0,22068,105355,0,127423
132547701400000,NW 335,Residential,28968,0,28968,127643,0,156611
132547701500000,NW 335,Residential,30450,0,30450,109556,0,140006
132547800100000,NW 335,Residential,26811,0,26811,114597,0,141408
132547800200000,NW 335,Residential,26712,0,26712,146288,0,173000
132547800300000,NW 335,Residential,25725,0,25725,110273,0,135998
132547800400000,NW 335,Residential,27783,0,27783,150805,0,178588
132547800500000,NW 335,Residential,26754,0,26754,117904,0,144658
132547800600000,NW 335,Residential,26754,0,26754,112373,0,139127
132547800700000,NW 335,Residential,26754,0,26754,121599,0,148353
132547800800000,NW 335,Residential,25725,0,25725,109010,0,134735
132547800900000,APARTMENT,Commercial,0,38556,38556,0,534530,573086
132547801000000,APARTMENT,Residential,38772,0,38772,336228,0,375000
132547801100000,APARTMENT,Residential,38718,0,38718,336282,0,375000
132547900101000,SMALL RETAIL,Commercial,0,126360,126360,0,135265,261625
132547900101001,OFFICE,Commercial,0,126360,126360,0,145657,272017
132547900200000,OFFICE,Commercial,0,757944,757944,0,2113274,2871218
132547900300000,FAST FOOD,Commercial,0,137402,137402,0,227190,364592
132548000100000,APARTMENT,Residential,26946,0,26946,322179,0,349125
132548000200000,APARTMENT,Residential,75060,0,75060,704940,0,780000
132548000300000,APARTMENT,Residential,64800,0,64800,535200,0,600000
132548000400000,MISCELLANEOUS,Commercial,0,416448,416448,0,2191736,2608184
132548000500000,APARTMENT,Residential,26838,0,26838,273162,0,300000
132548000600000,CITY PROPERTY,Exempt,0,0,0,0,0,0
132610100100000,NW 329,Residential,37600,0,37600,96240,0,133840
132610100200000,NW 329,Residential,31020,0,31020,91838,0,122858
132610100300000,NW 329,Residential,29610,0,29610,94140,0,123750
132610100400000,NW 329,Residential,29610,0,29610,100135,0,129745
132610100500000,NW 329,Residential,29610,0,29610,105476,0,135086
132610100600000,NW 329,Residential,29610,0,29610,100714,0,130324
132610100700000,NW 329,Residential,29610,0,29610,89488,0,119098
132610100800000,NW 329,Residential,29610,0,29610,86175,0,115785
132610100900000,NW 329,Residential,29610,0,29610,87059,0,116669
132610101000000,NW 329,Residential,29610,0,29610,84500,0,114110
132610101100000,NW 329,Residential,29610,0,29610,103280,0,132890
132610101200000,NW 329,Residential,29610,0,29610,93011,0,122621
132610101300000,NW 329,Residential,29610,0,29610,81564,0,111174
132610101400000,NW 329,Residential,29610,0,29610,97322,0,126932
132610101500000,NW 329,Residential,29610,0,29610,91614,0,121224
132610101600000,NW 329,Residential,29610,0,29610,94756,0,124366
132610101700000,NW 329,Residential,33558,0,33558,94939,0,128497
132610200100000,NW 329,Residential,36000,0,36000,95281,0,131281
132610200200000,NW 329,Residential,36000,0,36000,95902,0,131902
132610200300000,NW 329,Residential,30789,0,30789,83440,0,114229
132610200400000,NW 329,Residential,30240,0,30240,86572,0,116812
132610200500000,NW 329,Residential,30240,0,30240,84781,0,115021
132610200600000,NW 329,Residential,30240,0,30240,102137,0,132377
132610200700000,NW 329,Residential,30240,0,30240,88418,0,118658
132610200800000,NW 329,Residential,30240,0,30240,106170,0,136410
132610200900000,NW 329,Residential,30240,0,30240,86169,0,116409
132610201000000,NW 329,Residential,30240,0,30240,101597,0,131837
132610201100000,NW 329,Residential,30240,0,30240,97923,0,128163
132610201200000,NW 329,Residential,30240,0,30240,98884,0,129124
132610201300000,NW 329,Residential,30240,0,30240,91047,0,121287
132610201400000,NW 329,Residential,30240,0,30240,96238,0,126478
132610201500000,NW 329,Residential,29149,0,29149,88878,0,118027
132610201600000,NW 329,Residential,31040,0,31040,85540,0,116580
132610201700000,NW 329,Residential,33456,0,33456,98347,0,131803
132610201800000,NW 329,Residential,31520,0,31520,98413,0,129933
132610201900000,NW 329,Residential,32430,0,32430,86107,0,118537
132610202000000,NW 329,Residential,29610,0,29610,94445,0,124055
132610202100000,NW 329,Residential,30240,0,30240,84612,0,114852
132610202200000,NW 329,Residential,30240,0,30240,98310,0,128550
132610202300000,NW 329,Residential,30240,0,30240,76530,0,106770
132610202400000,NW 329,Residential,30240,0,30240,95242,0,125482
132610202500000,NW 329,Residential,30240,0,30240,83504,0,113744
132610202600000,NW 329,Residential,30240,0,30240,107998,0,138238
132610202700000,NW 329,Residential,30240,0,30240,86156,0,116396
132610202800000,NW 329,Residential,30240,0,30240,106731,0,136971
132610202900000,NW 329,Residential,29696,0,29696,85304,0,115000
132610203000000,NW 329,Residential,30240,0,30240,86568,0,116808
132610203100000,NW 329,Residential,30240,0,30240,92453,0,122693
132610203200000,NW 329,Residential,30240,0,30240,105545,0,135785
132610203300000,NW 329,Residential,30240,0,30240,94566,0,124806
132610203400000,NW 329,Residential,31059,0,31059,102196,0,133255
132610300100000,NW 329,Residential,30879,0,30879,71459,0,102338
132610300200000,NW 329,Residential,30080,0,30080,88478,0,118558
132610300300000,NW 329,Residential,30879,0,30879,89802,0,120681
132610300400000,NW 329,Residential,30789,0,30789,93952,0,124741
132610300500000,NW 329,Residential,30240,0,30240,87452,0,117692
132610300600000,NW 329,Residential,30240,0,30240,89659,0,119899
132610300700000,NW 329,Residential,30240,0,30240,99256,0,129496
132610300800000,NW 329,Residential,30240,0,30240,92778,0,123018
132610300900000,NW 329,Residential,30240,0,30240,100546,0,130786
132610301000000,NW 329,Residential,30240,0,30240,94631,0,124871
132610301100000,NW 329,Residential,30240,0,30240,90346,0,120586
132610301200000,NW 329,Residential,30240,0,30240,93930,0,124170
132610301300000,NW 329,Residential,30240,0,30240,89227,0,119467
132610301400000,NW 329,Residential,30240,0,30240,96737,0,126977
132610301500000,NW 329,Residential,30240,0,30240,104773,0,135013
132610301600000,NW 329,Residential,30240,0,30240,96656,0,126896
132610301700000,NW 329,Residential,33638,0,33638,97193,0,130831
132610301800000,NW 329,Residential,37128,0,37128,83268,0,120396
132610301900000,NW 329,Residential,32142,0,32142,98626,0,130768
132610302000000,NW 329,Residential,30240,0,30240,90612,0,120852
132610302100000,NW 329,Residential,30240,0,30240,88332,0,118572
132610302200000,NW 329,Residential,30240,0,30240,100008,0,130248
132610302300000,NW 329,Residential,30240,0,30240,90520,0,120760
132610302400000,NW 329,Residential,30240,0,30240,101214,0,131454
132610302500000,NW 329,Residential,30240,0,30240,85011,0,115251
132610302600000,NW 329,Residential,30240,0,30240,88885,0,119125
132610302700000,NW 329,Residential,30240,0,30240,88898,0,119138
132610302800000,NW 329,Residential,30240,0,30240,90017,0,120257
132610302900000,NW 329,Residential,30240,0,30240,93151,0,123391
132610303000000,NW 329,Residential,30240,0,30240,84714,0,114954
132610303100000,NW 329,Residential,31054,0,31054,58546,0,89600
132610400100000,NW 329,Residential,33752,0,33752,110101,0,143853
132610400200000,NW 329,Residential,30080,0,30080,85144,0,115224
132610400300000,NW 329,Residential,30080,0,30080,85059,0,115139
132610400400000,NW 329,Residential,30080,0,30080,94278,0,124358
132610400500000,NW 329,Residential,30080,0,30080,76712,0,106792
132610400600000,NW 329,Residential,29610,0,29610,99897,0,129507
132610400700000,NW 329,Residential,29627,0,29627,76059,0,105686
132610400800000,NW 329,Residential,35250,0,35250,168867,0,204117
132610400900000,CITY PROPERTY,Exempt,0,0,0,0,0,0
132610401000000,SCHOOL,Exempt,0,0,0,0,0,0
132610401100000,NW 329,Residential,33345,0,33345,92232,0,125577
132610401200000,NW 329,Residential,32800,0,32800,72976,0,105776
132610401300000,NW 329,Residential,33072,0,33072,101473,0,134545
132610401400000,NW 329,Residential,32800,0,32800,93909,0,126709
132610401500000,NW 329,Residential,31983,0,31983,90269,0,122252
132610401600000,NW 329,Residential,35008,0,35008,87813,0,122821
132610401700000,NW 329,Residential,29610,0,29610,87803,0,117413
132610401800000,NW 329,Residential,29610,0,29610,89875,0,119485
132610401900000,NW 329,Residential,29610,0,29610,85464,0,115074
132610402000000,NW 329,Residential,29610,0,29610,88319,0,117929
132610402100000,NW 329,Residential,29610,0,29610,85558,0,115168
132610402200000,NW 329,Residential,29610,0,29610,82942,0,112552
132610402300000,NW 329,Residential,29610,0,29610,100821,0,130431
132610402400000,NW 329,Residential,29610,0,29610,76159,0,105769
132610402500000,NW 329,Residential,29610,0,29610,90925,0,120535
132610402600000,NW 329,Residential,29610,0,29610,85813,0,115423
132610402700000,NW 329,Residential,29610,0,29610,96915,0,126525
132610402800000,NW 329,Residential,29610,0,29610,92462,0,122072
132610402900000,NW 329,Residential,28607,0,28607,95766,0,124373
132610500100000,NW 329,Residential,33840,0,33840,95982,0,129822
132610600100000,NW 329,Residential,31960,0,31960,86823,0,118783
132610600200000,NW 329,Residential,27930,0,27930,85480,0,113410
132610600300000,NW 329,Residential,32500,0,32500,105438,0,137938
132610700100000,NW 329,Residential,33840,0,33840,97682,0,131522
132610700200000,NW 329,Residential,30400,0,30400,89330,0,119730
132610700300000,NW 329,Residential,35456,0,35456,88997,0,124453
132610700400000,NW 329,Residential,31232,0,31232,85471,0,116703
132610700500000,NW 329,Residential,29700,0,29700,87865,0,117565
132610700600000,NW 329,Residential,31936,0,31936,87441,0,119377
132610800100000,CHURCH,Exempt,0,86400,86400,0,969260,1055660
132610900100000,NW 329,Residential,31040,0,31040,77468,0,108508
132610900200000,NW 329,Residential,31200,0,31200,90869,0,122069
132610900300000,NW 329,Residential,32099,0,32099,98802,0,130901
132610900400000,NW 329,Residential,32000,0,32000,99990,0,131990
132612600100000,NW 329,Residential,32386,0,32386,123807,0,156193
132612600200000,NW 329,Residential,30720,0,30720,135824,0,166544
132612600300000,NW 329,Residential,30720,0,30720,92484,0,123204
132612600400000,NW 329,Residential,30720,0,30720,128058,0,158778
132612600500000,NW 329,Residential,37120,0,37120,90995,0,128115
132612600600000,NW 329,Residential,30720,0,30720,142304,0,173024
132612600700000,NW 329,Residential,6400,0,6400,0,0,6400
132612600800000,NW 329,Residential,12800,0,12800,0,0,12800
132612600900000,NW 329,Residential,37120,0,37120,95089,0,132209
132612601000000,NW 329,Residential,6400,0,6400,0,0,6400
132612601100000,NW 329,Residential,6400,0,6400,0,0,6400
132612601200000,NW 329,Residential,6400,0,6400,0,0,6400
132612601300000,NW 329,Residential,6400,0,6400,0,0,6400
132612601400000,NW 329,Residential,7500,0,7500,0,0,7500
132612601500000,NW 329,Residential,32400,0,32400,92663,0,125063
132612601600000,NW 329,Residential,30720,0,30720,89929,0,120649
132612601700000,NW 329,Residential,30720,0,30720,100821,0,131541
132612601800000,NW 329,Residential,30720,0,30720,87570,0,118290
132612601900000,NW 329,Residential,30720,0,30720,94833,0,125553
132612602000000,NW 329,Residential,30720,0,30720,97150,0,127870
132612602100000,NW 329,Residential,30720,0,30720,103515,0,134235
132612602200000,NW 329,Residential,30720,0,30720,90967,0,121687
132612602300000,NW 329,Residential,30720,0,30720,84144,0,114864
132612602400000,NW 329,Residential,30720,0,30720,84236,0,114956
132612602500000,NW 329,Residential,30720,0,30720,89189,0,119909
132612602600000,NW 329,Residential,30720,0,30720,88795,0,119515
132612602700000,NW 329,Residential,32328,0,32328,105232,0,137560
132612700100000,NW 329,Residential,29981,0,29981,105992,0,135973
132612700200000,NW 329,Residential,34800,0,34800,100156,0,134956
132612700300000,NW 329,Residential,6000,0,6000,0,0,6000
132612700400000,NW 329,Residential,6050,0,6050,13855,0,19905
132612700500000,NW 329,Residential,28848,0,28848,121820,0,150668
132612700600000,NW 329,Residential,28800,0,28800,97445,0,126245
132612700800000,NW 329,Residential,29981,0,29981,87610,0,117591
132612800100000,NW 329,Residential,32467,0,32467,90132,0,122599
132612800200000,NW 329,Residential,29100,0,29100,86185,0,115285
132612800300000,NW 329,Residential,32252,0,32252,86049,0,118301
132612800400000,NW 329,Residential,30870,0,30870,76928,0,107798
132612800500000,NW 329,Residential,30080,0,30080,94979,0,125059
132612800600000,NW 329,Residential,30332,0,30332,78451,0,108783
132612800700000,NW 329,Residential,30070,0,30070,99688,0,129758
132612800800000,NW 329,Residential,30393,0,30393,92566,0,122959
132612800900000,NW 329,Residential,30237,0,30237,98713,0,128950
132612801000000,NW 329,Residential,30080,0,30080,86872,0,116952
132612801100000,NW 329,Residential,30400,0,30400,94561,0,124961
132612801200000,NW 329,Residential,31664,0,31664,111632,0,143296
132612801300000,NW 329,Residential,31687,0,31687,95458,0,127145
132612801400000,NW 329,Residential,31665,0,31665,74847,0,106512
132612801500000,NW 329,Residential,32993,0,32993,117579,0,150572
132612801600000,NW 329,Residential,31960,0,31960,103837,0,135797
132612801700000,NW 329,Residential,28200,0,28200,76264,0,104464
132612801800000,NW 329,Residential,31363,0,31363,107340,0,138703
132612801900000,NW 329,Residential,30720,0,30720,76982,0,107702
132612802000000,NW 329,Residential,30720,0,30720,97523,0,128243
132612802100000,NW 329,Residential,31033,0,31033,98488,0,129521
132612802200000,NW 329,Residential,31033,0,31033,92703,0,123736
132612802300000,NW 329,Residential,31360,0,31360,86737,0,118097
132612802400000,NW 329,Residential,30707,0,30707,84635,0,115342
132612802500000,NW 329,Residential,30339,0,30339,88958,0,119297
132612802600000,NW 329,Residential,31020,0,31020,91206,0,122226
132612900100000,NW 329,Residential,32252,0,32252,91538,0,123790
132612900200000,NW 329,Residential,29100,0,29100,80948,0,110048
132612900300000,NW 329,Residential,32483,0,32483,100254,0,132737
132612900400000,NW 329,Residential,31020,0,31020,85713,0,116733
132612900500000,NW 329,Residential,30080,0,30080,90641,0,120721
132612900600000,NW 329,Residential,29930,0,29930,107553,0,137483
132612900700000,NW 329,Residential,30237,0,30237,85879,0,116116
132612900800000,NW 329,Residential,30276,0,30276,86084,0,116360
132612900900000,NW 329,Residential,30260,0,30260,90570,0,120830
132612901000000,NW 329,Residential,29798,0,29798,84818,0,114616
132612901100000,NW 329,Residential,30400,0,30400,103425,0,133825
132612901200000,NW 329,Residential,30408,0,30408,94327,0,124735
132612901300000,NW 329,Residential,31040,0,31040,95539,0,126579
132612901400000,NW 329,Residential,31525,0,31525,89110,0,120635
132612901500000,NW 329,Residential,32495,0,32495,88768,0,121263
132612901600000,NW 329,Residential,32014,0,32014,89122,0,121136
132612901700000,NW 329,Residential,28200,0,28200,88002,0,116202
132612901800000,NW 329,Residential,31960,0,31960,108940,0,140900
132612901900000,NW 329,Residential,31843,0,31843,97791,0,129634
132612902000000,NW 329,Residential,32495,0,32495,89374,0,121869
132612902100000,NW 329,Residential,31687,0,31687,93025,0,124712
132612902200000,NW 329,Residential,31033,0,31033,87583,0,118616
132612902300000,NW 329,Residential,31040,0,31040,91301,0,122341
132612902400000,NW 329,Residential,30720,0,30720,92831,0,123551
132612902500000,NW 329,Residential,30875,0,30875,91724,0,122599
132612902600000,NW 329,Residential,30550,0,30550,97562,0,128112
132612902700000,NW 329,Residential,30550,0,30550,90960,0,121510
132612902800000,NW 329,Residential,30730,0,30730,86846,0,117576
132612902900000,NW 329,Residential,30080,0,30080,86245,0,116325
132612903000000,NW 329,Residential,31020,0,31020,80519,0,111539
132613000100000,NW 329,Residential,32252,0,32252,106648,0,138900
132613000200000,NW 329,Residential,29100,0,29100,82986,0,112086
132613000300000,NW 329,Residential,32483,0,32483,86701,0,119184
132613000400000,NW 329,Residential,31020,0,31020,84375,0,115395
132613000500000,NW 329,Residential,30080,0,30080,78250,0,108330
132613000600000,NW 329,Residential,30080,0,30080,95786,0,125866
132613000700000,NW 329,Residential,30080,0,30080,93002,0,123082
132613000800000,NW 329,Residential,30080,0,30080,87720,0,117800
132613000900000,NW 329,Residential,31200,0,31200,85432,0,116632
132613001000000,NW 329,Residential,31200,0,31200,88015,0,119215
132613001100000,NW 329,Residential,31850,0,31850,87920,0,119770
132613001200000,NW 329,Residential,31213,0,31213,80243,0,111456
132613001300000,NW 329,Residential,31360,0,31360,78275,0,109635
132613001400000,NW 329,Residential,31126,0,31126,93647,0,124773
132613001500000,NW 329,Residential,32621,0,32621,79741,0,112362
132613001600000,NW 329,Residential,32439,0,32439,83469,0,115908
132613001700000,NW 329,Residential,28200,0,28200,82370,0,110570
132613001800000,NW 329,Residential,31906,0,31906,93766,0,125672
132613001900000,NW 329,Residential,31115,0,31115,89577,0,120692
132613002000000,NW 329,Residential,31515,0,31515,95409,0,126924
132613002100000,NW 329,Residential,32863,0,32863,92137,0,125000
132613002200000,NW 329,Residential,31360,0,31360,99425,0,130785
132613002300000,NW 329,Residential,31040,0,31040,88945,0,119985
132613002400000,NW 329,Residential,31525,0,31525,91656,0,123181
132613002500000,NW 329,Residential,31360,0,31360,96450,0,127810
132613002600000,NW 329,Residential,31020,0,31020,83897,0,114917
132613002700000,NW 329,Residential,30237,0,30237,82367,0,112604
132613002800000,NW 329,Residential,30237,0,30237,93908,0,124145
132613002900000,NW 329,Residential,30080,0,30080,85125,0,115205
132613003000000,NW 329,Residential,31020,0,31020,82002,0,113022
132613100100000,NW 329,Residential,32252,0,32252,72062,0,104314
132613100200000,NW 329,Residential,29100,0,29100,89440,0,118540
132613100300000,NW 329,Residential,32367,0,32367,81640,0,114007
132613100400000,NW 329,Residential,31020,0,31020,94923,0,125943
132613100500000,NW 329,Residential,30080,0,30080,89460,0,119540
132613100600000,NW 329,Residential,30080,0,30080,85163,0,115243
132613100700000,NW 329,Residential,30080,0,30080,82272,0,112352
132613100800000,NW 329,Residential,30080,0,30080,93764,0,123844
132613100900000,NW 329,Residential,30080,0,30080,85848,0,115928
132613101000000,NW 329,Residential,31144,0,31144,105363,0,136507
132613101100000,NW 329,Residential,30717,0,30717,71793,0,102510
132613101200000,NW 329,Residential,32670,0,32670,97187,0,129857
132613101300000,NW 329,Residential,33210,0,33210,85584,0,118794
132613101400000,NW 329,Residential,32700,0,32700,101642,0,134342
132613101500000,NW 329,Residential,32917,0,32917,97779,0,130696
132613101600000,NW 329,Residential,35760,0,35760,86918,0,122678
132613101700000,NW 329,Residential,32252,0,32252,93027,0,125279
132613101800000,NW 329,Residential,32240,0,32240,88436,0,120676
132613101900000,NW 329,Residential,31765,0,31765,87137,0,118902
132613102000000,NW 329,Residential,35436,0,35436,100631,0,136067
132613102100000,NW 329,Residential,31687,0,31687,95500,0,127187
132613102200000,NW 329,Residential,32101,0,32101,95455,0,127556
132613102300000,NW 329,Residential,31815,0,31815,83109,0,114924
132613102400000,NW 329,Residential,32175,0,32175,85637,0,117812
132613102500000,NW 329,Residential,31200,0,31200,88294,0,119494
132613102600000,NW 329,Residential,30875,0,30875,82916,0,113791
132613102700000,NW 329,Residential,30512,0,30512,95136,0,125648
132613102800000,NW 329,Residential,30166,0,30166,102562,0,132728
132613102900000,NW 329,Residential,30080,0,30080,90090,0,120170
132613103000000,NW 329,Residential,30080,0,30080,84183,0,114263
132613103100000,NW 329,Residential,30080,0,30080,90979,0,121059
132613103200000,NW 329,Residential,31020,0,31020,81393,0,112413
132613200100000,NW 329,Residential,32737,0,32737,91864,0,124601
132613200200000,NW 329,Residential,29100,0,29100,89176,0,118276
132613200300000,NW 329,Residential,32345,0,32345,93134,0,125479
132613200400000,NW 329,Residential,31350,0,31350,89222,0,120572
132613200500000,NW 329,Residential,30400,0,30400,93542,0,123942
132613200600000,NW 329,Residential,30400,0,30400,88793,0,119193
132613200700000,NW 329,Residential,30400,0,30400,88770,0,119170
132613200800000,NW 329,Residential,28975,0,28975,77631,0,106606
132613200900000,NW 329,Residential,28500,0,28500,95453,0,123953
132613201000000,NW 329,Residential,28714,0,28714,85129,0,113843
132613201100000,NW 329,Residential,35956,0,35956,92374,0,128330
132613201200000,NW 329,Residential,31920,0,31920,68529,0,100449
132613201300000,NW 329,Residential,30560,0,30560,93815,0,124375
132613201400000,NW 329,Residential,29416,0,29416,97452,0,126868
132613201500000,NW 329,Residential,30720,0,30720,94169,0,124889
132613201600000,NW 329,Residential,30720,0,30720,97697,0,128417
132613201700000,NW 329,Residential,30720,0,30720,92523,0,123243
132613201800000,NW 329,Residential,30720,0,30720,94712,0,125432
132613201900000,NW 329,Residential,30720,0,30720,90267,0,120987
132613202000000,NW 329,Residential,31680,0,31680,94367,0,126047
132613300100000,NW 329,Residential,35134,0,35134,94476,0,129610
132613300200000,NW 329,Residential,32617,0,32617,116668,0,149285
132613300300000,NW 329,Residential,32300,0,32300,86286,0,118586
132613300400000,NW 329,Residential,32896,0,32896,87689,0,120585
132613300500000,NW 329,Residential,31350,0,31350,101132,0,132482
132615100100000,NW 329,Residential,28200,0,28200,77504,0,105704
132615100200000,NW 329,Residential,31960,0,31960,87527,0,119487
132615100300000,NW 329,Residential,29100,0,29100,93461,0,122561
132615100400000,NW 329,Residential,29229,0,29229,82359,0,111588
132615100500000,NW 329,Residential,29264,0,29264,60615,0,89879
132615100600000,NW 329,Residential,28576,0,28576,77217,0,105793
132615100700000,NW 329,Residential,28670,0,28670,91239,0,119909
132615100800000,NW 329,Residential,28576,0,28576,95651,0,124227
132615100900000,NW 329,Residential,29344,0,29344,84345,0,113689
132615101000000,NW 329,Residential,30525,0,30525,83721,0,114246
132615101100000,NW 329,Residential,31790,0,31790,81351,0,113141
132615101200000,NW 329,Residential,31547,0,31547,78671,0,110218
132615101300000,NW 329,Residential,34730,0,34730,99031,0,133761
132615101400000,NW 329,Residential,28658,0,28658,90620,0,119278
132615101500000,NW 329,Residential,28816,0,28816,88640,0,117456
132615101600000,NW 329,Residential,28658,0,28658,82640,0,111298
132615101700000,NW 329,Residential,33965,0,33965,88164,0,122129
132615101800000,NW 329,Residential,28900,0,28900,104337,0,133237
132615101900000,NW 329,Residential,29813,0,29813,85765,0,115578
132615102000000,NW 329,Residential,28953,0,28953,73243,0,102196
132615102100000,NW 329,Residential,28654,0,28654,67246,0,95900
132615102200000,NW 329,Residential,30380,0,30380,89305,0,119685
132615102300000,NW 329,Residential,31850,0,31850,90119,0,121969
132615102400000,NW 329,Residential,30870,0,30870,76664,0,107534
132615200100000,NW 329,Residential,40425,0,40425,100804,0,141229
132615200200000,NW 329,Residential,40425,0,40425,109109,0,149534
132615200300000,NW 329,Residential,29844,0,29844,96685,0,126529
132615200400000,NW 329,Residential,32800,0,32800,73892,0,106692
132615200500000,NW 329,Residential,27730,0,27730,77030,0,104760
132615200600000,NW 329,Residential,27714,0,27714,89448,0,117162
132615200700000,NW 329,Residential,30393,0,30393,85371,0,115764
132615200800000,NW 329,Residential,33516,0,33516,91734,0,125250
132615200900000,NW 329,Residential,29700,0,29700,76142,0,105842
132615201000000,NW 329,Residential,35932,0,35932,91506,0,127438
132615201100000,NW 329,Residential,33157,0,33157,91657,0,124814
132615201200000,NW 329,Residential,29700,0,29700,59760,0,89460
132615201300000,NW 329,Residential,30500,0,30500,76969,0,107469
132615201400000,NW 329,Residential,30500,0,30500,87724,0,118224
132615201500000,NW 329,Residential,30053,0,30053,96691,0,126744
132615201600000,NW 329,Residential,30053,0,30053,111997,0,142050
132615201700000,NW 329,Residential,31428,0,31428,83952,0,115380
132615300100000,NW 329,Residential,32980,0,32980,97345,0,130325
132615300200000,NW 329,Residential,30456,0,30456,89595,0,120051
132615300300000,NW 329,Residential,28200,0,28200,75791,0,103991
132615300400000,NW 329,Residential,29100,0,29100,83275,0,112375
132615300500000,NW 329,Residential,29700,0,29700,91637,0,121337
132615300600000,NW 329,Residential,29400,0,29400,93837,0,123237
132615300700000,NW 329,Residential,29100,0,29100,92021,0,121121
132615300800000,NW 329,Residential,28800,0,28800,87053,0,115853
132615300900000,NW 329,Residential,29760,0,29760,97611,0,127371
132615301000000,NW 329,Residential,33696,0,33696,91581,0,125277
132615301100000,NW 329,Residential,33696,0,33696,99658,0,133354
132615301200000,NW 329,Residential,29497,0,29497,92493,0,121990
132615301300000,NW 329,Residential,28000,0,28000,97287,0,125287
132615301400000,NW 329,Residential,28453,0,28453,93074,0,121527
132615301500000,NW 329,Residential,29963,0,29963,81592,0,111555
132615301600000,NW 329,Residential,31200,0,31200,86838,0,118038
132615301700000,NW 329,Residential,29963,0,29963,92896,0,122859
132615301800000,NW 329,Residential,30167,0,30167,87934,0,118101
132615301900000,NW 329,Residential,39616,0,39616,99744,0,139360
132615302000000,NW 329,Residential,33728,0,33728,96847,0,130575
132615302100000,NW 329,Residential,31815,0,31815,95741,0,127556
132615302200000,NW 329,Residential,28667,0,28667,90637,0,119304
132615302300000,NW 329,Residential,29100,0,29100,101362,0,130462
132615302400000,NW 329,Residential,30070,0,30070,108948,0,139018
132615400100000,NW 329,Residential,28513,0,28513,98478,0,126991
132615400200000,NW 329,Residential,30550,0,30550,99218,0,129768
132615400300000,NW 329,Residential,30550,0,30550,109892,0,140442
132615400400000,NW 329,Residential,28200,0,28200,88291,0,116491
132615400500000,NW 329,Residential,28200,0,28200,89164,0,117364
132615400600000,NW 329,Residential,28200,0,28200,98888,0,127088
132615400700000,NW 329,Residential,28200,0,28200,97044,0,125244
132615400800000,NW 329,Residential,31960,0,31960,93782,0,125742
132615500100000,NW 329,Residential,32613,0,32613,84941,0,117554
132615500200000,NW 329,Residential,31845,0,31845,85911,0,117756
132615500300000,NW 329,Residential,29205,0,29205,86211,0,115416
132615500400000,NW 329,Residential,30132,0,30132,92140,0,122272
132615500500000,NW 329,Residential,31373,0,31373,100270,0,131643
132615500600000,NW 329,Residential,32400,0,32400,76383,0,108783
132615500700000,NW 329,Residential,32100,0,32100,88914,0,121014
132615500800000,NW 329,Residential,29750,0,29750,101887,0,131637
132615500900000,NW 329,Residential,28833,0,28833,83423,0,112256
132615501000000,NW 329,Residential,27225,0,27225,94554,0,121779
132615501100000,NW 329,Residential,29400,0,29400,83685,0,113085
132615501200000,NW 329,Residential,29100,0,29100,75488,0,104588
132615501300000,NW 329,Residential,28800,0,28800,87536,0,116336
132615501400000,NW 329,Residential,29600,0,29600,82786,0,112386
132615501500000,NW 329,Residential,29084,0,29084,74505,0,103589
132615501600000,NW 329,Residential,29400,0,29400,81684,0,111084
132615501700000,NW 329,Residential,29400,0,29400,87764,0,117164
132615501800000,NW 329,Residential,29100,0,29100,78441,0,107541
132615501900000,NW 329,Residential,29262,0,29262,88195,0,117457
132615502000000,NW 329,Residential,28960,0,28960,87355,0,116315
132615502100000,NW 329,Residential,30400,0,30400,90908,0,121308
132615502200000,NW 329,Residential,33696,0,33696,75575,0,109271
132615502300000,NW 329,Residential,33725,0,33725,87381,0,121106
132615502400000,NW 329,Residential,30928,0,30928,94775,0,125703
132615502500000,NW 329,Residential,29920,0,29920,87399,0,117319
132615502600000,NW 329,Residential,29760,0,29760,90650,0,120410
132615502700000,NW 329,Residential,29760,0,29760,89581,0,119341
132615502800000,NW 329,Residential,29760,0,29760,99144,0,128904
132615502900000,NW 329,Residential,29280,0,29280,91559,0,120839
132615503000000,NW 329,Residential,28800,0,28800,103590,0,132390
132615503100000,NW 329,Residential,29007,0,29007,90396,0,119403
132615503200000,NW 329,Residential,28200,0,28200,87126,0,115326
132615503300000,NW 329,Residential,28960,0,28960,89766,0,118726
132615503400000,NW 329,Residential,29727,0,29727,94310,0,124037
132615503500000,NW 329,Residential,30167,0,30167,88799,0,118966
132615503600000,NW 329,Residential,31720,0,31720,79921,0,111641
132615503700000,NW 329,Residential,37248,0,37248,83093,0,120341
132615503800000,NW 329,Residential,33269,0,33269,89617,0,122886
132615503900000,NW 329,Residential,31024,0,31024,86073,0,117097
132615504000000,NW 329,Residential,29425,0,29425,102111,0,131536
132615504100000,NW 329,Residential,28500,0,28500,94190,0,122690
132615504200000,NW 329,Residential,28093,0,28093,93616,0,121709
132615504300000,NW 329,Residential,28159,0,28159,91602,0,119761
132615504400000,NW 329,Residential,31720,0,31720,85153,0,116873
132615504500000,NW 329,Residential,28216,0,28216,94144,0,122360
132615600100000,CHURCH,Exempt,0,58374,58374,0,981779,1040153
132615600200000,NW 329,Residential,28992,0,28992,95593,0,124585
132615600300000,NW 329,Residential,29872,0,29872,82775,0,112647
132615600400000,NW 329,Residential,29440,0,29440,90126,0,119566
132615600500000,NW 329,Residential,29904,0,29904,92130,0,122034
132615600600000,NW 329,Residential,30393,0,30393,102891,0,133284
132615600700000,NW 329,Residential,34042,0,34042,103490,0,137532
132615600800000,NW 329,Residential,29297,0,29297,98365,0,127662
132615600900000,NW 329,Residential,35289,0,35289,123516,0,158805
132615601000000,NW 329,Residential,32529,0,32529,77369,0,109898
132615601100000,NW 329,Residential,28480,0,28480,92153,0,120633
132615601200000,NW 329,Residential,28512,0,28512,86855,0,115367
132615601300000,NW 329,Residential,28480,0,28480,106205,0,134685
132615601400000,NW 329,Residential,27360,0,27360,90089,0,117449
132615601500000,NW 329,Residential,28420,0,28420,89004,0,117424
132615601600000,NW 329,Residential,29073,0,29073,89061,0,118134
132615700100000,NW 329,Residential,34648,0,34648,92139,0,126787
132615700200000,NW 329,Residential,29440,0,29440,103142,0,132582
132615700300000,NW 329,Residential,31960,0,31960,107441,0,139401
132615700400000,NW 329,Residential,34200,0,34200,81984,0,116184
132615700500000,NW 329,Residential,33545,0,33545,99164,0,132709
132615700600000,NW 329,Residential,32505,0,32505,84294,0,116799
132615700700000,NW 329,Residential,29735,0,29735,82973,0,112708
132615700800000,NW 329,Residential,30409,0,30409,90437,0,120846
132615700900000,NW 329,Residential,34317,0,34317,88940,0,123257
132615701000000,NW 329,Residential,34686,0,34686,99338,0,134024
132615701100000,NW 329,Residential,32917,0,32917,94982,0,127899
132615701200000,NW 329,Residential,30232,0,30232,84008,0,114240
132615701300000,NW 329,Residential,29563,0,29563,82105,0,111668
132615701400000,NW 329,Residential,30380,0,30380,87116,0,117496
132615701500000,NW 329,Residential,31000,0,31000,83628,0,114628
132615800100000,NW 329,Residential,32400,0,32400,96043,0,128443
132615800200000,NW 329,Residential,28480,0,28480,88158,0,116638
132615800300000,NW 329,Residential,28800,0,28800,81797,0,110597
132615800400000,NW 329,Residential,29400,0,29400,92725,0,122125
132615800500000,NW 329,Residential,30300,0,30300,82284,0,112584
132615800600000,NW 329,Residential,31200,0,31200,91724,0,122924
132615800700000,NW 329,Residential,31800,0,31800,76860,0,108660
132615800800000,NW 329,Residential,31800,0,31800,90695,0,122495
132615800900000,NW 329,Residential,31200,0,31200,98592,0,129792
132615801000000,NW 329,Residential,29700,0,29700,86871,0,116571
132615801100000,NW 329,Residential,28800,0,28800,96185,0,124985
132615801200000,NW 329,Residential,31960,0,31960,97481,0,129441
132615900100000,NW 329,Residential,31960,0,31960,83720,0,115680
132615900200000,NW 329,Residential,28200,0,28200,100006,0,128206
132615900300000,NW 329,Residential,28200,0,28200,79612,0,107812
132615900400000,NW 329,Residential,29100,0,29100,94340,0,123440
132615900500000,NW 329,Residential,31040,0,31040,89312,0,120352
132615900600000,NW 329,Residential,33231,0,33231,99560,0,132791
132615900700000,NW 329,Residential,32585,0,32585,94216,0,126801
132615900800000,NW 329,Residential,29120,0,29120,88290,0,117410
132617600100000,NW 329,Residential,31680,0,31680,81688,0,113368
132617600200000,NW 329,Residential,32832,0,32832,69905,0,102737
132617700100000,NW 329,Residential,31803,0,31803,83844,0,115647
132617700200000,NW 329,Residential,30550,0,30550,64794,0,95344
132617700300000,NW 329,Residential,32241,0,32241,84550,0,116791
132617700400000,NW 329,Residential,33600,0,33600,85704,0,119304
132617700500000,NW 329,Residential,34200,0,34200,87086,0,121286
132617700600000,NW 329,Residential,33804,0,33804,92041,0,125845
132617700700000,NW 329,Residential,31200,0,31200,80691,0,111891
132617700800000,NW 329,Residential,32522,0,32522,82040,0,114562
132617700900000,NW 329,Residential,29760,0,29760,79804,0,109564
132617701000000,NW 329,Residential,32900,0,32900,91400,0,124300
132617701100000,NW 329,Residential,32900,0,32900,63609,0,96509
132617701200000,NW 329,Residential,32406,0,32406,74502,0,106908
132617701300000,NW 329,Residential,31965,0,31965,73849,0,105814
132617701400000,NW 329,Residential,31587,0,31587,79778,0,111365
132617701500000,NW 329,Residential,30732,0,30732,69986,0,100718
132617701600000,NW 329,Residential,32458,0,32458,88403,0,120861
132617800100000,NW 329,Residential,33804,0,33804,77609,0,111413
132617800200000,NW 329,Residential,29760,0,29760,89330,0,119090
132617800300000,NW 329,Residential,28983,0,28983,68335,0,97318
132617800400000,NW 329,Residential,30522,0,30522,74890,0,105412
132617800500000,NW 329,Residential,33345,0,33345,85348,0,118693
132617800600000,NW 329,Residential,34014,0,34014,71331,0,105345
132617900100000,NW 329,Residential,33543,0,33543,87035,0,120578
132617900200000,NW 329,Residential,33091,0,33091,77253,0,110344
132617900300000,NW 329,Residential,34167,0,34167,78232,0,112399
132617900400000,NW 329,Residential,33320,0,33320,75327,0,108647
132617900500000,NW 329,Residential,32480,0,32480,84471,0,116951
132617900600000,NW 329,Residential,31803,0,31803,100221,0,132024
132617900700000,NW 329,Residential,31806,0,31806,79255,0,111061
132618000100000,NW 329,Residential,31960,0,31960,68854,0,100814
132618000200000,NW 329,Residential,29400,0,29400,97041,0,126441
132618000300000,NW 329,Residential,30232,0,30232,93363,0,123595
132618000400000,NW 329,Residential,30543,0,30543,73586,0,104129
132618000500000,NW 329,Residential,30543,0,30543,74766,0,105309
132618100100000,NW 329,Residential,29297,0,29297,100347,0,129644
132618200100000,NW 329,Residential,30550,0,30550,85913,0,116463
132618200200000,NW 329,Residential,31680,0,31680,83060,0,114740
132618200300000,NW 329,Residential,30320,0,30320,95876,0,126196
132618200400000,NW 329,Residential,29767,0,29767,89435,0,119202
132618200500000,NW 329,Residential,30083,0,30083,87814,0,117897
132618200600000,NW 329,Residential,32320,0,32320,82040,0,114360
132618200700000,NW 329,Residential,28960,0,28960,84834,0,113794
132618200800000,NW 329,Residential,29767,0,29767,103083,0,132850
132618200900000,NW 329,Residential,29767,0,29767,86747,0,116514
132618201000000,NW 329,Residential,31692,0,31692,83308,0,115000
132618201100000,NW 329,Residential,28658,0,28658,79050,0,107708
132618201200000,NW 329,Residential,29767,0,29767,67112,0,96879
132618201300000,NW 329,Residential,29767,0,29767,76657,0,106424
132618201400000,NW 329,Residential,32349,0,32349,1198,0,33547
132618201500000,NW 329,Residential,30083,0,30083,83479,0,113562
132618201600000,NW 329,Residential,28658,0,28658,76485,0,105143
132618201700000,NW 329,Residential,31904,0,31904,85237,0,117141
132618201800000,NW 329,Residential,32072,0,32072,144777,0,176849
132618201900000,NW 329,Residential,32640,0,32640,103029,0,135669
132618202000000,NW 329,Residential,31200,0,31200,94198,0,125398
132618202100000,NW 329,Residential,31525,0,31525,99531,0,131056
132618202200000,NW 329,Residential,33142,0,33142,93067,0,126209
132618202300000,NW 329,Residential,31200,0,31200,83527,0,114727
132618202400000,NW 329,Residential,31200,0,31200,86533,0,117733
132618202500000,NW 329,Residential,32495,0,32495,83419,0,115914
132618202600000,NW 329,Residential,31040,0,31040,93657,0,124697
132618202700000,NW 329,Residential,30875,0,30875,64003,0,94878
132618202800000,NW 329,Residential,31983,0,31983,97193,0,129176
132618202900000,NW 329,Residential,31192,0,31192,91012,0,122204
132618203000000,NW 329,Residential,30237,0,30237,84496,0,114733
132618203100000,NW 329,Residential,29936,0,29936,87211,0,117147
132618203200000,NW 329,Residential,31255,0,31255,81254,0,112509
132618300100000,NW 329,Residential,29356,0,29356,76959,0,106315
132618300200000,NW 329,Residential,24269,0,24269,102990,0,127259
132618300300000,NW 329,Residential,24440,0,24440,91990,0,116430
132618300400000,NW 329,Residential,27203,0,27203,92669,0,119872
132618300500000,NW 329,Residential,25218,0,25218,88082,0,113300
132618300600000,NW 329,Residential,25944,0,25944,90700,0,116644
132618300700000,NW 329,Residential,26933,0,26933,87874,0,114807
132618301500000,NW 329,Residential,32821,0,32821,86383,0,119204
132618301600000,NW 329,Residential,27840,0,27840,78817,0,106657
132618301700000,NW 329,Residential,27840,0,27840,83572,0,111412
132618301800000,NW 329,Residential,28810,0,28810,79968,0,108778
132618301900000,NW 329,Residential,28000,0,28000,81066,0,109066
132618302000000,NW 329,Residential,29600,0,29600,91664,0,121264
132618302100000,NW 329,Residential,27920,0,27920,87609,0,115529
132618302200000,NW 329,Residential,29328,0,29328,77556,0,106884
132618302300000,NW 329,Residential,30720,0,30720,92791,0,123511
132618302400000,NW 329,Residential,30880,0,30880,80734,0,111614
132618302500000,NW 329,Residential,29100,0,29100,81467,0,110567
132618302600000,NW 329,Residential,29400,0,29400,87149,0,116549
132618302700000,NW 329,Residential,32705,0,32705,78677,0,111382
132618302800000,NW 329,Residential,35323,0,35323,98773,0,134096
132618400100000,NW 329,Residential,31255,0,31255,69313,0,100568
132618400200000,NW 329,Residential,30064,0,30064,94246,0,124310
132618400300000,NW 329,Residential,32640,0,32640,77423,0,110063
132618400400000,NW 329,Residential,31040,0,31040,74328,0,105368
132618400500000,NW 329,Residential,32640,0,32640,71578,0,104218
132618400600000,NW 329,Residential,32300,0,32300,88369,0,120669
132618400700000,NW 329,Residential,32300,0,32300,95494,0,127794
132618400800000,NW 329,Residential,32640,0,32640,82672,0,115312
132618400900000,NW 329,Residential,30720,0,30720,82655,0,113375
132618401000000,NW 329,Residential,31960,0,31960,80042,0,112002
132618401100000,NW 329,Residential,32458,0,32458,93704,0,126162
132618401200000,NW 329,Residential,32640,0,32640,83874,0,116514
132618401300000,NW 329,Residential,32640,0,32640,88081,0,120721
132618401400000,NW 329,Residential,32256,0,32256,86610,0,118866
132618500100000,NW 329,Residential,29335,0,29335,84910,0,114245
132618500200000,NW 329,Residential,26539,0,26539,87585,0,114124
132618500300000,NW 329,Residential,27495,0,27495,100684,0,128179
132618500400000,NW 329,Residential,33361,0,33361,82594,0,115955
132618500500000,NW 329,Residential,31983,0,31983,78968,0,110951
132618500600000,NW 329,Residential,30855,0,30855,98545,0,129400
132618500700000,NW 329,Residential,30690,0,30690,78902,0,109592
132618500800000,NW 329,Residential,33280,0,33280,63500,0,96780
132618500900000,NW 329,Residential,32591,0,32591,80232,0,112823
132618501000000,NW 329,Residential,32770,0,32770,66404,0,99174
132618501100000,NW 329,Residential,32770,0,32770,91170,0,123940
132618501200000,NW 329,Residential,31973,0,31973,85512,0,117485
132618501300000,NW 329,Residential,29925,0,29925,80465,0,110390
132618501400000,NW 329,Residential,30720,0,30720,76193,0,106913
132618501500000,NW 329,Residential,31883,0,31883,86100,0,117983
132618501600000,NW 329,Residential,28983,0,28983,91498,0,120481
132618501700000,NW 329,Residential,30450,0,30450,97066,0,127516
132618501800000,NW 329,Residential,32480,0,32480,100088,0,132568
132618501900000,NW 329,Residential,33790,0,33790,94487,0,128277
132618502000000,NW 329,Residential,32679,0,32679,94316,0,126995
132618502100000,NW 329,Residential,30870,0,30870,89212,0,120082
132618502200000,NW 329,Residential,33075,0,33075,97910,0,130985
132618502300000,NW 329,Residential,33390,0,33390,90267,0,123657
132618502400000,NW 329,Residential,32130,0,32130,102148,0,134278
132618502500000,NW 329,Residential,31185,0,31185,94728,0,125913
132618502600000,NW 329,Residential,30240,0,30240,90255,0,120495
132618502700000,NW 329,Residential,30240,0,30240,111516,0,141756
132618502800000,NW 329,Residential,29760,0,29760,93931,0,123691
132618502900000,NW 329,Residential,33566,0,33566,99283,0,132849
132618503000000,NW 329,Residential,33830,0,33830,98926,0,132756
132618503100000,NW 329,Residential,30360,0,30360,91751,0,122111
132618503200000,NW 329,Residential,32832,0,32832,89443,0,122275
132618503300000,CHURCH,Exempt,0,41364,41364,0,517824,559188
132618503400000,NW 329,Residential,30294,0,30294,73395,0,103689
132618503500000,NW 329,Residential,32592,0,32592,74549,0,107141
132618503600000,NW 329,Residential,34476,0,34476,66365,0,100841
132618503700000,NW 329,Residential,36586,0,36586,74019,0,110605
132618600100000,NW 329,Residential,31694,0,31694,91508,0,123202
132618600200000,NW 329,Residential,29280,0,29280,84573,0,113853
132618600300000,NW 329,Residential,32980,0,32980,87274,0,120254
132618600400000,NW 329,Residential,30070,0,30070,97984,0,128054
132618600500000,NW 329,Residential,30070,0,30070,93811,0,123881
132618600600000,NW 329,Residential,30070,0,30070,92896,0,122966
132618600700000,NW 329,Residential,30070,0,30070,94529,0,124599
132618600800000,NW 329,Residential,31760,0,31760,100557,0,132317
132618600900000,NW 329,Residential,28670,0,28670,75461,0,104131
132618601000000,NW 329,Residential,31667,0,31667,93036,0,124703
132618601100000,NW 329,Residential,30070,0,30070,97050,0,127120
132618601200000,NW 329,Residential,30070,0,30070,93101,0,123171
132618601300000,NW 329,Residential,30070,0,30070,104127,0,134197
132618601400000,NW 329,Residential,30380,0,30380,100457,0,130837
132618700100000,NW 329,Residential,31648,0,31648,95183,0,126831
132618700200000,NW 329,Residential,28199,0,28199,91929,0,120128
132618700300000,NW 329,Residential,29280,0,29280,91463,0,120743
132618700400000,NW 329,Residential,27840,0,27840,87947,0,115787
132618700500000,NW 329,Residential,27840,0,27840,96736,0,124576
132618700600000,NW 329,Residential,27840,0,27840,82516,0,110356
132618700700000,NW 329,Residential,27840,0,27840,113969,0,141809
132618700800000,NW 329,Residential,28800,0,28800,106338,0,135138
132618700900000,NW 329,Residential,27840,0,27840,98514,0,126354
132618701000000,NW 329,Residential,27840,0,27840,82054,0,109894
132618701100000,NW 329,Residential,27840,0,27840,95241,0,123081
132618701200000,NW 329,Residential,27840,0,27840,90907,0,118747
132618701300000,NW 329,Residential,28800,0,28800,99556,0,128356
132618701400000,NW 329,Residential,28800,0,28800,89256,0,118056
132618701500000,NW 329,Residential,31226,0,31226,102935,0,134161
132620100100000,NW 329,Residential,64960,0,64960,100738,0,165698
132620100500000,NW 329,Residential,36803,0,36803,0,0,36803
132620100600000,NW 329,Residential,36976,0,36976,180519,0,217495
132620100700000,NW 329,Residential,36976,0,36976,188771,0,225747
132620100800000,NW 329,Residential,38150,0,38150,159800,0,197950
132620100900000,NW 329,Residential,37800,0,37800,150888,0,188688
132620101000000,NW 329,Residential,65867,0,65867,0,0,65867
132620101100000,NW 329,Residential,42840,0,42840,145688,0,188528
132620101200000,NW 329,Residential,43200,0,43200,161852,0,205052
132620101300000,NW 329,Residential,40680,0,40680,164107,0,204787
132620101400000,NW 329,Residential,55077,0,55077,146833,0,201910
132620101500000,NW 329,Residential,50416,0,50416,141805,0,192221
132620101600000,NW 329,Residential,39650,0,39650,153289,0,192939
132620101800000,NW 329,Residential,56420,0,56420,145787,0,202207
132620102000000,NW 329,Residential,33333,0,33333,170023,0,203356
132620102100000,NW 329,Residential,49856,0,49856,147013,0,196869
132620200100000,NW 329,Residential,33127,0,33127,82531,0,115658
132620200200000,NW 329,Residential,32500,0,32500,87440,0,119940
132620200300000,NW 329,Residential,31000,0,31000,87606,0,118606
132620200400000,NW 329,Residential,31000,0,31000,82461,0,113461
132620200500000,NW 329,Residential,31000,0,31000,95861,0,126861
132620200600000,NW 329,Residential,31000,0,31000,90784,0,121784
132620200700000,NW 329,Residential,31000,0,31000,78894,0,109894
132620200800000,NW 329,Residential,31000,0,31000,96766,0,127766
132620200900000,NW 329,Residential,31000,0,31000,88293,0,119293
132620201000000,NW 329,Residential,33923,0,33923,94326,0,128249
132620201100000,NW 329,Residential,47950,0,47950,160322,0,208272
132620201200000,NW 329,Residential,44625,0,44625,162686,0,207311
132620201300000,NW 329,Residential,48825,0,48825,0,0,48825
132620201400000,NW 329,Residential,44625,0,44625,151751,0,196376
132620201500000,NW 329,Residential,44625,0,44625,154449,0,199074
132620201600000,NW 329,Residential,44381,0,44381,170619,0,215000
132620201700000,NW 329,Residential,44625,0,44625,160581,0,205206
132620201800000,NW 329,Residential,45475,0,45475,172902,0,218377
132620201900000,NW 329,Residential,60455,0,60455,161774,0,222229
132620202000000,NW 329,Residential,55770,0,55770,137537,0,193307
132620202100000,NW 329,Residential,51412,0,51412,171352,0,222764
132620202200000,NW 329,Residential,40280,0,40280,157809,0,198089
132620202300000,NW 329,Residential,40810,0,40810,161110,0,201920
132620202400000,NW 329,Residential,40810,0,40810,175090,0,215900
132620202500000,NW 329,Residential,41843,0,41843,0,0,41843
132622600100000,CHURCH,Exempt,0,561535,561535,0,3579313,4140848
132625100100000,NW 329,Residential,30650,0,30650,85249,0,115899
132625100300000,NW 329,Residential,33179,0,33179,106957,0,140136
132625100400000,NW 329,Residential,30000,0,30000,90506,0,120506
132625100500000,NW 329,Residential,30000,0,30000,94868,0,124868
132625100600000,NW 329,Residential,27250,0,27250,110814,0,138064
132625100700000,NW 329,Residential,28750,0,28750,87877,0,116627
132625100800000,NW 329,Residential,26000,0,26000,104634,0,130634
132625100900000,NW 329,Residential,30000,0,30000,97300,0,127300
132625101000000,NW 329,Residential,26000,0,26000,111622,0,137622
132625200100000,NW 329,Residential,33844,0,33844,107900,0,141744
132625200200000,NW 329,Residential,31065,0,31065,216695,0,247760
132625200300000,NW 329,Residential,25800,0,25800,106744,0,132544
132625200400000,NW 329,Residential,25800,0,25800,109628,0,135428
132625200500000,NW 329,Residential,25800,0,25800,98797,0,124597
132625200600000,NW 329,Residential,25800,0,25800,93086,0,118886
132625200700000,NW 329,Residential,25800,0,25800,96882,0,122682
132625200800000,NW 329,Residential,25800,0,25800,99743,0,125543
132625200900000,NW 329,Residential,25800,0,25800,109904,0,135704
132625201000000,NW 329,Residential,25800,0,25800,91499,0,117299
132625201100000,NW 329,Residential,25800,0,25800,94526,0,120326
132625201200000,NW 329,Residential,25800,0,25800,99067,0,124867
132625201300000,NW 329,Residential,25800,0,25800,83112,0,108912
132625201400000,NW 329,Residential,25800,0,25800,89111,0,114911
132625201500000,NW 329,Residential,25800,0,25800,84863,0,110663
132625201600000,NW 329,Residential,25800,0,25800,89277,0,115077
132625201700000,NW 329,Residential,25800,0,25800,91584,0,117384
132625201800000,NW 329,Residential,25800,0,25800,99549,0,125349
132625201900000,NW 329,Residential,29726,0,29726,85410,0,115136
132625202000000,NW 329,Residential,29778,0,29778,86637,0,116415
132625202100000,NW 329,Residential,31500,0,31500,103965,0,135465
132625202200000,NW 329,Residential,30000,0,30000,94709,0,124709
132625202300000,NW 329,Residential,31500,0,31500,110576,0,142076
132625202400000,NW 329,Residential,30000,0,30000,86911,0,116911
132625202500000,NW 329,Residential,32000,0,32000,91754,0,123754
132625202600000,NW 329,Residential,30000,0,30000,105570,0,135570
132625202700000,NW 329,Residential,32400,0,32400,101335,0,133735
132627600100000,CITY PROPERTY,Exempt,0,0,0,0,0,0
132627600200000,NW 329,Residential,33158,0,33158,104867,0,138025
132627600300000,NW 329,Residential,30550,0,30550,89864,0,120414
132627600400000,NW 329,Residential,30550,0,30550,102142,0,132692
132627600500000,NW 329,Residential,30550,0,30550,96666,0,127216
132627600600000,NW 329,Residential,30550,0,30550,109547,0,140097
132627600700000,NW 329,Residential,30550,0,30550,99327,0,129877
132627700100000,NW 329,Residential,28700,0,28700,104406,0,133106
132627700200000,NW 329,Residential,29000,0,29000,84958,0,113958
132627700300000,NW 329,Residential,29000,0,29000,105041,0,134041
132627700400000,NW 329,Residential,29000,0,29000,77815,0,106815
132627700500000,NW 329,Residential,30400,0,30400,101566,0,131966
132627700600000,NW 329,Residential,30000,0,30000,91488,0,121488
132627700700000,NW 329,Residential,31448,0,31448,101841,0,133289
132627700800000,NW 329,Residential,30102,0,30102,100045,0,130147
132627700900000,NW 329,Residential,28200,0,28200,88672,0,116872
132627701000000,NW 329,Residential,28200,0,28200,105381,0,133581
132627701100000,NW 329,Residential,28200,0,28200,83935,0,112135
132627701200000,NW 329,Residential,29337,0,29337,89318,0,118655
132627701300000,NW 329,Residential,29962,0,29962,107864,0,137826
132627800100000,NW 329,Residential,36036,0,36036,100905,0,136941
132627800200000,NW 329,Residential,33165,0,33165,83117,0,116282
132627800300000,NW 329,Residential,33165,0,33165,91547,0,124712
132627800400000,NW 329,Residential,33165,0,33165,83546,0,116711
132627800500000,NW 329,Residential,33165,0,33165,85609,0,118774
132627800600000,NW 329,Residential,35680,0,35680,102650,0,138330
132627900100000,NW 329,Residential,33158,0,33158,103775,0,136933
132627900200000,NW 329,Residential,30080,0,30080,81445,0,111525
132627900300000,NW 329,Residential,33158,0,33158,94601,0,127759
132627900400000,NW 329,Residential,31680,0,31680,90085,0,121765
132627900500000,NW 329,Residential,31680,0,31680,83681,0,115361
132627900600000,NW 329,Residential,31680,0,31680,83058,0,114738
132627900700000,NW 329,Residential,31680,0,31680,102685,0,134365
132627900800000,NW 329,Residential,31680,0,31680,96554,0,128234
132627900900000,NW 329,Residential,31680,0,31680,100563,0,132243
132627901000000,NW 329,Residential,31680,0,31680,95834,0,127514
132627901100000,NW 329,Residential,31680,0,31680,94240,0,125920
132627901200000,NW 329,Residential,32175,0,32175,112830,0,145005
132627901300000,NW 329,Residential,31829,0,31829,95749,0,127578
132627901400000,NW 329,Residential,32373,0,32373,104242,0,136615
132627901500000,NW 329,Residential,32175,0,32175,79242,0,111417
132627901600000,NW 329,Residential,31680,0,31680,93718,0,125398
132627901700000,NW 329,Residential,31680,0,31680,103557,0,135237
132627901800000,NW 329,Residential,31680,0,31680,90186,0,121866
132627901900000,NW 329,Residential,31680,0,31680,94654,0,126334
132627902000000,NW 329,Residential,31680,0,31680,93744,0,125424
132627902100000,NW 329,Residential,31680,0,31680,84077,0,115757
132627902200000,NW 329,Residential,31680,0,31680,91910,0,123590
132627902300000,NW 329,Residential,31680,0,31680,93079,0,124759
132628000100000,NW 329,Residential,33158,0,33158,97296,0,130454
132628000200000,NW 329,Residential,30080,0,30080,100644,0,130724
132628000300000,NW 329,Residential,33158,0,33158,88430,0,121588
132628000400000,NW 329,Residential,31680,0,31680,91244,0,122924
132628000500000,NW 329,Residential,31185,0,31185,107748,0,138933
132628000600000,NW 329,Residential,31185,0,31185,96526,0,127711
132628000700000,NW 329,Residential,31185,0,31185,93102,0,124287
132628000800000,NW 329,Residential,31185,0,31185,93682,0,124867
132628000900000,NW 329,Residential,31185,0,31185,87572,0,118757
132628001000000,NW 329,Residential,31185,0,31185,86902,0,118087
132628001100000,NW 329,Residential,31185,0,31185,84872,0,116057
132628001200000,NW 329,Residential,33165,0,33165,94894,0,128059
132628001300000,NW 329,Residential,33297,0,33297,84662,0,117959
132628001400000,NW 329,Residential,32134,0,32134,86661,0,118795
132628001500000,NW 329,Residential,31507,0,31507,89948,0,121455
132628001600000,NW 329,Residential,31185,0,31185,90224,0,121409
132628001700000,NW 329,Residential,31185,0,31185,88380,0,119565
132628001800000,NW 329,Residential,31185,0,31185,99811,0,130996
132628001900000,NW 329,Residential,31185,0,31185,91370,0,122555
132628002000000,NW 329,Residential,31185,0,31185,91838,0,123023
132628002100000,NW 329,Residential,31185,0,31185,88313,0,119498
132628002200000,NW 329,Residential,31185,0,31185,87590,0,118775
132628002300000,NW 329,Residential,31680,0,31680,89199,0,120879
132628100100000,NW 329,Residential,33158,0,33158,100147,0,133305
132628100200000,NW 329,Residential,30080,0,30080,97940,0,128020
132628100300000,NW 329,Residential,33158,0,33158,111628,0,144786
132628100400000,NW 329,Residential,32126,0,32126,84244,0,116370
132628100500000,NW 329,Residential,27720,0,27720,112350,0,140070
132628100600000,NW 329,Residential,29700,0,29700,110420,0,140120
132628100700000,NW 329,Residential,27720,0,27720,75734,0,103454
132628100800000,NW 329,Residential,29700,0,29700,100858,0,130558
132628100900000,NW 329,Residential,28545,0,28545,92291,0,120836
132628101000000,NW 329,Residential,30855,0,30855,111159,0,142014
132628101100000,NW 329,Residential,30805,0,30805,98687,0,129492
132628101200000,NW 329,Residential,33977,0,33977,109848,0,143825
132628101300000,NW 329,Residential,28070,0,28070,111054,0,139124
132628101400000,NW 329,Residential,28560,0,28560,86163,0,114723
132628101500000,NW 329,Residential,32835,0,32835,93806,0,126641
132628101600000,NW 329,Residential,33165,0,33165,97124,0,130289
132628101700000,NW 329,Residential,31185,0,31185,75297,0,106482
132628101800000,NW 329,Residential,31185,0,31185,99933,0,131118
132628101900000,NW 329,Residential,31185,0,31185,102170,0,133355
132628102000000,NW 329,Residential,31185,0,31185,96577,0,127762
132628102100000,NW 329,Residential,31185,0,31185,92758,0,123943
132628102200000,NW 329,Residential,31185,0,31185,92529,0,123714
132628102300000,NW 329,Residential,31185,0,31185,105120,0,136305
132628102400000,NW 329,Residential,31680,0,31680,95384,0,127064
132628200100000,NW 329,Residential,30699,0,30699,80752,0,111451
132628200200000,NW 329,Residential,26675,0,26675,84644,0,111319
132628200300000,NW 329,Residential,26675,0,26675,85052,0,111727
132628200400000,NW 329,Residential,30489,0,30489,83763,0,114252
132628200500000,NW 329,Residential,31008,0,31008,100824,0,131832
132628200600000,NW 329,Residential,27775,0,27775,101147,0,128922
132628200700000,NW 329,Residential,27775,0,27775,86050,0,113825
132628200800000,NW 329,Residential,27775,0,27775,89108,0,116883
132628200900000,NW 329,Residential,30300,0,30300,95247,0,125547
132628201000000,NW 329,Residential,27775,0,27775,96989,0,124764
132628201100000,NW 329,Residential,27500,0,27500,99664,0,127164
132628201200000,NW 329,Residential,30520,0,30520,98807,0,129327
132628201300000,NW 329,Residential,29260,0,29260,89696,0,118956
132628201400000,NW 329,Residential,29203,0,29203,111048,0,140251
132628201500000,NW 329,Residential,29700,0,29700,90585,0,120285
132628201600000,NW 329,Residential,29627,0,29627,94071,0,123698
132628201700000,NW 329,Residential,27220,0,27220,90395,0,117615
132628201800000,NW 329,Residential,30300,0,30300,97908,0,128208
132628201900000,NW 329,Residential,28280,0,28280,93843,0,122123
132628202000000,NW 329,Residential,30300,0,30300,74775,0,105075
132628202100000,NW 329,Residential,28280,0,28280,84854,0,113134
132628202200000,NW 329,Residential,31361,0,31361,97910,0,129271
132628300100000,NW 329,Residential,35764,0,35764,96467,0,132231
132628300200000,NW 329,Residential,33412,0,33412,98177,0,131589
132628300300000,NW 329,Residential,33145,0,33145,102797,0,135942
132630100100000,NW 329,Residential,33383,0,33383,84207,0,117590
132630100200000,NW 329,Residential,32667,0,32667,84972,0,117639
132630100300000,NW 329,Residential,32440,0,32440,80011,0,112451
132630100400000,NW 329,Residential,33714,0,33714,80715,0,114429
132630100500000,NW 329,Residential,35150,0,35150,103932,0,139082
132630100600000,NW 329,Residential,37145,0,37145,92794,0,129939
132630100700000,NW 329,Residential,34347,0,34347,94299,0,128646
132630100800000,NW 329,Residential,27594,0,27594,101000,0,128594
132630100900000,NW 329,Residential,26112,0,26112,93174,0,119286
132630101000000,NW 329,Residential,30240,0,30240,102671,0,132911
132630101100000,NW 329,Residential,29440,0,29440,106053,0,135493
132630200100000,NW 329,Residential,35482,0,35482,106770,0,142252
132630200200000,NW 329,Residential,34890,0,34890,86367,0,121257
132630200300000,NW 329,Residential,31945,0,31945,94558,0,126503
132630200400000,NW 329,Residential,31603,0,31603,103682,0,135285
132630200500000,NW 329,Residential,32992,0,32992,85162,0,118154
132630200600000,NW 329,Residential,27618,0,27618,95844,0,123462
132630200700000,NW 329,Residential,24832,0,24832,85639,0,110471
132630200800000,NW 329,Residential,27179,0,27179,106575,0,133754
132630200900000,NW 329,Residential,33050,0,33050,94519,0,127569
132630201000000,NW 329,Exempt,0,33809,33809,0,79792,113601
132630201100000,NW 329,Residential,33516,0,33516,88324,0,121840
132630201200000,NW 329,Residential,33858,0,33858,101268,0,135126
132630300100000,NW 329,Residential,32616,0,32616,103913,0,136529
132630300200000,NW 329,Residential,33530,0,33530,97968,0,131498
132630300300000,NW 329,Residential,28054,0,28054,104662,0,132716
132630300400000,NW 329,Residential,25718,0,25718,103922,0,129640
132630300500000,NW 329,Residential,26313,0,26313,114153,0,140466
132630300600000,NW 329,Residential,34580,0,34580,82133,0,116713
132630300700000,NW 329,Residential,31699,0,31699,78849,0,110548
132630400100000,NW 329,Residential,32840,0,32840,89160,0,122000
132630500100000,NW 329,Residential,30614,0,30614,106691,0,137305
132630500200000,NW 329,Residential,27231,0,27231,84611,0,111842
132630500300000,NW 329,Residential,26928,0,26928,104933,0,131861
132630500400000,NW 329,Residential,26040,0,26040,94121,0,120161
132630500500000,NW 329,Residential,27249,0,27249,100077,0,127326
132630500600000,NW 329,Residential,27363,0,27363,108208,0,135571
132630500700000,NW 329,Residential,28533,0,28533,113826,0,142359
132630500800000,NW 329,Residential,37450,0,37450,106168,0,143618
132630500900000,NW 329,Residential,37100,0,37100,94269,0,131369
132630501000000,NW 329,Residential,36750,0,36750,96670,0,133420
132630501100000,NW 329,Residential,37306,0,37306,110351,0,147657
132630501200000,NW 329,Residential,39462,0,39462,93888,0,133350
132630600100000,NW 329,Residential,27373,0,27373,104287,0,131660
132630600200000,NW 329,Residential,26125,0,26125,105126,0,131251
132630600300000,NW 329,Residential,34791,0,34791,104975,0,139766
132630600400000,NW 329,Residential,33838,0,33838,98511,0,132349
132630600500000,NW 329,Residential,34485,0,34485,94278,0,128763
132630600600000,NW 329,Residential,33330,0,33330,91191,0,124521
132630600700000,NW 329,Residential,31667,0,31667,107692,0,139359
132630600800000,NW 329,Residential,32250,0,32250,102008,0,134258
132630600900000,NW 329,Residential,32250,0,32250,91784,0,124034
132630601000000,NW 329,Residential,32250,0,32250,105753,0,138003
132630601100000,NW 329,Residential,32250,0,32250,93007,0,125257
132630601200000,NW 329,Residential,32450,0,32450,96671,0,129121
132630601300000,NW 329,Residential,32450,0,32450,102314,0,134764
132630601400000,NW 329,Residential,32450,0,32450,92074,0,124524
132630601500000,NW 329,Residential,33660,0,33660,91505,0,125165
132630601600000,NW 329,Residential,33000,0,33000,96103,0,129103
132630601700000,NW 329,Residential,33884,0,33884,97011,0,130895
132630601800000,NW 329,Residential,31500,0,31500,105783,0,137283
132630601900000,NW 329,Residential,31500,0,31500,89749,0,121249
132630602000000,NW 329,Residential,33167,0,33167,90794,0,123961
132630602100000,NW 329,Residential,33167,0,33167,109060,0,142227
132630700100000,NW 329,Residential,27238,0,27238,99066,0,126304
132630700200000,NW 329,Residential,24832,0,24832,84901,0,109733
132630700300000,NW 329,Residential,27238,0,27238,111048,0,138286
132630700400000,NW 329,Residential,31371,0,31371,94194,0,125565
132630700500000,NW 329,Residential,31360,0,31360,94156,0,125516
132630700600000,NW 329,Residential,31325,0,31325,80089,0,111414
132630700700000,NW 329,Residential,31200,0,31200,82799,0,113999
132630700800000,NW 329,Residential,32320,0,32320,105369,0,137689
132630700900000,NW 329,Residential,32320,0,32320,90049,0,122369
132630701000000,NW 329,Residential,32552,0,32552,99905,0,132457
132630701100000,NW 329,Residential,30717,0,30717,89894,0,120611
132630701200000,NW 329,Residential,31801,0,31801,89255,0,121056
132630701300000,NW 329,Residential,31801,0,31801,95551,0,127352
132630701400000,NW 329,Residential,31801,0,31801,82173,0,113974
132630701500000,NW 329,Residential,33075,0,33075,97021,0,130096
132630701600000,NW 329,Residential,26597,0,26597,95845,0,122442
132630701700000,NW 329,Residential,28800,0,28800,82495,0,111295
132630701800000,NW 329,Residential,26413,0,26413,85010,0,111423
132630701900000,NW 329,Residential,28800,0,28800,86416,0,115216
132630702000000,NW 329,Residential,29760,0,29760,89196,0,118956
132630702100000,NW 329,Residential,27645,0,27645,88901,0,116546
132630702200000,NW 329,Residential,28134,0,28134,101436,0,129570
132630702300000,NW 329,Residential,29727,0,29727,86350,0,116077
132630702400000,NW 329,Residential,33516,0,33516,97433,0,130949
132630702500000,NW 329,Residential,31811,0,31811,102280,0,134091
132630702600000,NW 329,Residential,31811,0,31811,85573,0,117384
132630702700000,NW 329,Residential,32139,0,32139,99916,0,132055
132630702800000,NW 329,Residential,32139,0,32139,83214,0,115353
132630702900000,NW 329,Residential,32139,0,32139,96322,0,128461
132630703000000,NW 329,Residential,32139,0,32139,85904,0,118043
132630800100000,NW 329,Residential,34452,0,34452,111738,0,146190
132630800200000,NW 329,Residential,27962,0,27962,92026,0,119988
132630800300000,NW 329,Residential,27373,0,27373,98913,0,126286
132630800400000,NW 329,Residential,33375,0,33375,98098,0,131473
132630800500000,NW 329,Residential,33375,0,33375,115860,0,149235
132630800600000,NW 329,Residential,33660,0,33660,102340,0,136000
132630800700000,NW 329,Residential,32505,0,32505,118135,0,150640
132630800800000,NW 329,Residential,31525,0,31525,102014,0,133539
132630800900000,NW 329,Residential,31446,0,31446,100161,0,131607
132630801000000,NW 329,Residential,31040,0,31040,88714,0,119754
132630801100000,NW 329,Residential,31114,0,31114,109822,0,140936
132630801200000,NW 329,Residential,32340,0,32340,91631,0,123971
132630801300000,NW 329,Residential,29563,0,29563,109768,0,139331
132630801400000,NW 329,Residential,29056,0,29056,91442,0,120498
132630801500000,NW 329,Residential,26277,0,26277,97030,0,123307
132630801600000,NW 329,Residential,29100,0,29100,89301,0,118401
132630801700000,NW 329,Residential,26675,0,26675,89805,0,116480
132630801800000,NW 329,Residential,29100,0,29100,94782,0,123882
132630801900000,NW 329,Residential,26675,0,26675,101259,0,127934
132630802000000,NW 329,Residential,29165,0,29165,95675,0,124840
132630802100000,NW 329,Residential,29035,0,29035,86175,0,115210
132630802200000,NW 329,Residential,26675,0,26675,89038,0,115713
132630802300000,NW 329,Residential,29100,0,29100,123940,0,153040
132630802400000,NW 329,Residential,26675,0,26675,100273,0,126948
132630802500000,NW 329,Residential,29100,0,29100,95539,0,124639
132630802600000,NW 329,Residential,29727,0,29727,90654,0,120381
132630802700000,NW 329,Residential,27416,0,27416,83912,0,111328
132630802800000,NW 329,Residential,27489,0,27489,104265,0,131754
132630802900000,NW 329,Residential,27200,0,27200,85614,0,112814
132630803000000,NW 329,Residential,31520,0,31520,106127,0,137647
132630803100000,NW 329,Residential,32056,0,32056,97555,0,129611
132630803200000,NW 329,Residential,31687,0,31687,84476,0,116163
132630803300000,NW 329,Residential,31848,0,31848,90562,0,122410
132630803400000,NW 329,Residential,31360,0,31360,87676,0,119036
132630803500000,NW 329,Residential,31360,0,31360,92011,0,123371
132630803600000,NW 329,Residential,33333,0,33333,92841,0,126174
132630803700000,NW 329,Residential,33428,0,33428,93685,0,127113
132630803800000,NW 329,Residential,33705,0,33705,89264,0,122969
132630803900000,NW 329,Residential,35768,0,35768,101867,0,137635
132630804000000,NW 329,Residential,32320,0,32320,83968,0,116288
132630900100000,NW 329,Residential,29485,0,29485,114099,0,143584
132630900200000,NW 329,Residential,33745,0,33745,106681,0,140426
132630900300000,NW 329,Residential,32000,0,32000,95845,0,127845
132630900400000,NW 329,Residential,32000,0,32000,102728,0,134728
132630900500000,NW 329,Residential,32000,0,32000,90749,0,122749
132630900600000,NW 329,Residential,32000,0,32000,95289,0,127289
132630900700000,NW 329,Residential,32000,0,32000,86863,0,118863
132631000100000,NW 329,Residential,31040,0,31040,94216,0,125256
132631000200000,NW 329,Residential,31040,0,31040,90900,0,121940
132631000300000,NW 329,Residential,31040,0,31040,98468,0,129508
132631000400000,NW 329,Residential,34408,0,34408,110786,0,145194
132631000500000,NW 329,Residential,36140,0,36140,109067,0,145207
132631000600000,NW 329,Residential,36309,0,36309,88369,0,124678
132631000700000,NW 329,Residential,40145,0,40145,105033,0,145178
132631000800000,NW 329,Residential,36356,0,36356,93709,0,130065
132631000900000,NW 329,Residential,35686,0,35686,110523,0,146209
132631001000000,NW 329,Residential,34952,0,34952,99086,0,134038
132631001100000,NW 329,Residential,33300,0,33300,83426,0,116726
132631001200000,NW 329,Residential,34029,0,34029,101285,0,135314
132631001300000,NW 329,Residential,34300,0,34300,97562,0,131862
132631001400000,NW 329,Residential,33870,0,33870,99966,0,133836
132631100100000,NW 329,Residential,33412,0,33412,105380,0,138792
132631100200000,NW 329,Residential,31360,0,31360,96600,0,127960
132631100300000,NW 329,Residential,29400,0,29400,87087,0,116487
132631100400000,NW 329,Residential,31360,0,31360,97636,0,128996
132631100500000,NW 329,Residential,31360,0,31360,94806,0,126166
132631100600000,NW 329,Residential,31360,0,31360,99867,0,131227
132632600100000,NW 329,Residential,34938,0,34938,106920,0,141858
132632600200000,NW 329,Residential,31040,0,31040,91434,0,122474
132632600300000,NW 329,Residential,31040,0,31040,94136,0,125176
132632600400000,NW 329,Residential,35453,0,35453,101456,0,136909
132632700100000,NW 329,Residential,34042,0,34042,86975,0,121017
132632700200000,SCHOOL,Exempt,0,0,0,0,0,0
132632700300000,CITY PROPERTY,Exempt,0,0,0,0,0,0
132632700400000,NW 329,Residential,33532,0,33532,95350,0,128882
132632700500000,NW 329,Residential,31500,0,31500,104566,0,136066
132632700600000,NW 329,Residential,31500,0,31500,100312,0,131812
132632700700000,NW 329,Residential,31500,0,31500,100395,0,131895
132632700800000,NW 329,Residential,31500,0,31500,90732,0,122232
132632700900000,NW 329,Residential,31500,0,31500,94335,0,125835
132632701000000,NW 329,Residential,31500,0,31500,95226,0,126726
132632701100000,NW 329,Residential,31500,0,31500,94393,0,125893
132632800100000,NW 329,Residential,34411,0,34411,100175,0,134586
132632800200000,NW 332,Residential,44413,0,44413,201027,0,245440
132632800300000,NW 332,Residential,40375,0,40375,167338,0,207713
132632800400000,NW 332,Residential,40375,0,40375,190475,0,230850
132632800500000,NW 332,Residential,40375,0,40375,225997,0,266372
132632800600000,NW 332,Residential,40375,0,40375,183666,0,224041
132632800700000,NW 332,Residential,40375,0,40375,220425,0,260800
132632800800000,NW 332,Residential,44175,0,44175,187049,0,231224
132632801100000,NW 332,Residential,41800,0,41800,252544,0,294344
132632801200000,NW 332,Residential,41800,0,41800,250584,0,292384
132632801300000,NW 332,Residential,41800,0,41800,241829,0,283629
132632801400000,NW 332,Residential,41673,0,41673,287729,0,329402
132632801500000,NW 332,Residential,61740,0,61740,75682,0,137422
132632801600000,NW 329,Residential,33609,0,33609,101839,0,135448
132632801700000,NW 329,Residential,33099,0,33099,120932,0,154031
132632801800000,NW 329,Residential,30243,0,30243,97084,0,127327
132632801900000,NW 329,Residential,28050,0,28050,94330,0,122380
132632802000000,NW 329,Residential,32690,0,32690,89692,0,122382
132632802100000,NW 329,Residential,32320,0,32320,89433,0,121753
132632802200000,NW 329,Residential,29778,0,29778,74998,0,104776
132632802300000,NW 329,Residential,32421,0,32421,96626,0,129047
132632802400000,NW 329,Residential,30199,0,30199,89293,0,119492
132632802500000,NW 329,Residential,33553,0,33553,104386,0,137939
132632802600000,NW 329,Residential,33839,0,33839,86986,0,120825
132632802700000,NW 329,Residential,31815,0,31815,84839,0,116654
132632802800000,NW 329,Residential,31815,0,31815,82703,0,114518
132632802900000,NW 329,Residential,31815,0,31815,94026,0,125841
132632803000000,NW 329,Residential,31815,0,31815,89550,0,121365
132632803100000,NW 329,Residential,31815,0,31815,93881,0,125696
132632803200000,NW 329,Residential,31815,0,31815,89026,0,120841
132632803300000,NW 329,Residential,31815,0,31815,105176,0,136991
132632803400000,NW 332,Residential,48279,0,48279,238926,0,287205
132632900100000,NW 329,Residential,34144,0,34144,87375,0,121519
132632900200000,NW 329,Residential,31040,0,31040,86367,0,117407
132632900300000,NW 329,Residential,34532,0,34532,86527,0,121059
132633000100000,NW 329,Residential,34047,0,34047,93033,0,127080
132633000200000,NW 329,Residential,31040,0,31040,96590,0,127630
132633000300000,NW 329,Residential,33974,0,33974,98791,0,132765
132633100100000,NW 329,Residential,33221,0,33221,109170,0,142391
132633100200000,NW 329,Residential,31549,0,31549,96888,0,128437
132633100300000,NW 329,Residential,31477,0,31477,78851,0,110328
132633100400000,NW 329,Residential,31477,0,31477,84230,0,115707
132633100500000,NW 329,Residential,31477,0,31477,96220,0,127697
132633100600000,NW 329,Residential,31477,0,31477,87223,0,118700
132633100700000,NW 329,Residential,31477,0,31477,73646,0,105123
132633100800000,NW 329,Residential,31477,0,31477,88370,0,119847
132633100900000,NW 329,Residential,31477,0,31477,112749,0,144226
132633101000000,NW 329,Residential,31477,0,31477,96340,0,127817
132633101100000,NW 329,Residential,35344,0,35344,97517,0,132861
132633101200000,NW 329,Residential,33461,0,33461,94171,0,127632
132633101300000,NW 329,Residential,29100,0,29100,82856,0,111956
132633101400000,NW 329,Residential,29100,0,29100,90226,0,119326
132633101500000,NW 329,Residential,26675,0,26675,96270,0,122945
132633101600000,NW 329,Residential,29100,0,29100,94054,0,123154
132633101700000,NW 329,Residential,26675,0,26675,91175,0,117850
132633101800000,NW 329,Residential,29100,0,29100,88449,0,117549
132633101900000,NW 329,Residential,31283,0,31283,105208,0,136491
132633102000000,NW 329,Residential,26675,0,26675,83350,0,110025
132633102100000,NW 329,Residential,31283,0,31283,85032,0,116315
132633102200000,NW 329,Residential,26594,0,26594,83385,0,109979
132633102300000,NW 329,Residential,33934,0,33934,107778,0,141712
132633102400000,NW 329,Residential,28500,0,28500,95360,0,123860
132633200100000,NW 329,Residential,33067,0,33067,101100,0,134167
132633200200000,NW 329,Residential,30555,0,30555,91295,0,121850
132633200300000,NW 329,Residential,35137,0,35137,97815,0,132952
132633300100000,NW 329,Residential,32475,0,32475,98677,0,131152
132633300200000,NW 329,Residential,29181,0,29181,89458,0,118639
132633300300000,NW 329,Residential,26675,0,26675,80867,0,107542
132633300400000,NW 329,Residential,29100,0,29100,89387,0,118487
132633300500000,NW 329,Residential,31428,0,31428,97338,0,128766
132633300600000,NW 329,Residential,30313,0,30313,90221,0,120534
132633300700000,NW 329,Residential,30313,0,30313,95258,0,125571
132633300800000,NW 329,Residential,26675,0,26675,82693,0,109368
132633300900000,NW 329,Residential,29100,0,29100,101757,0,130857
132633301000000,NW 329,Residential,26675,0,26675,83549,0,110224
132633301100000,NW 329,Residential,26675,0,26675,93884,0,120559
132633301200000,NW 329,Residential,30025,0,30025,103618,0,133643
132633301300000,NW 329,Residential,29475,0,29475,105140,0,134615
132633301400000,NW 329,Residential,29400,0,29400,92224,0,121624
132633301500000,NW 329,Residential,29400,0,29400,98066,0,127466
132633301600000,NW 329,Residential,29400,0,29400,101227,0,130627
132633301700000,NW 329,Residential,29400,0,29400,93055,0,122455
132633301800000,NW 329,Residential,29400,0,29400,96834,0,126234
132633301900000,NW 329,Residential,30257,0,30257,95463,0,125720
132633302000000,NW 329,Residential,30257,0,30257,90842,0,121099
132633302100000,NW 329,Residential,29400,0,29400,98401,0,127801
132633302200000,NW 329,Residential,29400,0,29400,96476,0,125876
132633302300000,NW 329,Residential,29325,0,29325,79907,0,109232
132633302400000,NW 329,Residential,34080,0,34080,95427,0,129507
132633302500000,NW 329,Residential,31500,0,31500,101319,0,132819
132633400100000,NW 329,Residential,29400,0,29400,94714,0,124114
132633400200000,NW 329,Residential,31040,0,31040,95225,0,126265
132633400300000,NW 329,Residential,31040,0,31040,87300,0,118340
132633400400000,NW 329,Residential,31040,0,31040,90716,0,121756
132633400500000,NW 329,Residential,26749,0,26749,86229,0,112978
132633400600000,NW 329,Residential,26675,0,26675,96950,0,123625
132633400700000,NW 329,Residential,26675,0,26675,95476,0,122151
132633400800000,NW 329,Residential,26675,0,26675,81471,0,108146
132633400900000,NW 329,Residential,26675,0,26675,91340,0,118015
132633401000000,NW 329,Residential,26675,0,26675,94776,0,121451
132633401100000,NW 329,Residential,26675,0,26675,94099,0,120774
132633401200000,NW 329,Residential,26675,0,26675,91752,0,118427
132633401300000,NW 329,Residential,26675,0,26675,93588,0,120263
132633401400000,NW 329,Residential,26675,0,26675,109888,0,136563
132633401500000,NW 329,Residential,26675,0,26675,98212,0,124887
132633401600000,NW 329,Residential,31451,0,31451,99112,0,130563
132635100100000,NW 329,Residential,26190,0,26190,103305,0,129495
132635100200000,NW 329,Residential,27936,0,27936,87991,0,115927
132635100300000,NW 329,Residential,27936,0,27936,94547,0,122483
132635100400000,NW 329,Residential,27820,0,27820,93536,0,121356
132635100500000,NW 329,Residential,26123,0,26123,103479,0,129602
132635100600000,NW 329,Residential,26190,0,26190,89367,0,115557
132635100700000,NW 329,Residential,26190,0,26190,91092,0,117282
132635100800000,NW 329,Residential,26190,0,26190,100971,0,127161
132635100900000,NW 329,Residential,26190,0,26190,100058,0,126248
132635101000000,NW 329,Residential,26190,0,26190,116379,0,142569
132635101100000,NW 329,Residential,26190,0,26190,104666,0,130856
132635101200000,NW 329,Residential,26190,0,26190,106997,0,133187
132635101300000,NW 329,Residential,26190,0,26190,104040,0,130230
132635101400000,NW 329,Residential,26190,0,26190,105646,0,131836
132635101500000,NW 329,Residential,29091,0,29091,98889,0,127980
132635200100000,NW 329,Residential,33099,0,33099,95073,0,128172
132635200200000,NW 332,Residential,50639,0,50639,205942,0,256581
132635200300000,NW 329,Residential,34603,0,34603,98370,0,132973
132635300100000,NW 329,Residential,26190,0,26190,86305,0,112495
132635300200000,NW 329,Residential,28303,0,28303,73597,0,101900
132635300300000,NW 329,Residential,27936,0,27936,90889,0,118825
132635300400000,NW 329,Residential,27878,0,27878,84427,0,112305
132635300500000,NW 329,Residential,24074,0,24074,102485,0,126559
132635300600000,NW 329,Residential,24008,0,24008,96133,0,120141
132635300700000,NW 329,Residential,24008,0,24008,94088,0,118096
132635300800000,NW 329,Residential,24008,0,24008,97371,0,121379
132635300900000,NW 329,Residential,27980,0,27980,96946,0,124926
132635301000000,NW 329,Residential,27980,0,27980,97339,0,125319
132635301100000,NW 329,Residential,27980,0,27980,102170,0,130150
132635301200000,NW 329,Residential,27980,0,27980,98548,0,126528
132635301300000,NW 329,Residential,27980,0,27980,103836,0,131816
132635301400000,NW 329,Residential,27980,0,27980,102522,0,130502
132635301500000,NW 329,Residential,27980,0,27980,96452,0,124432
132635301600000,NW 329,Residential,27980,0,27980,96206,0,124186
132635301700000,NW 329,Residential,27980,0,27980,101710,0,129690
132635301800000,NW 329,Residential,28032,0,28032,74757,0,102789
132635301900000,NW 329,Residential,35139,0,35139,123812,0,158951
132635400500000,SW 407,Residential,20,0,20,0,0,20
132635502000000,SW 407,Residential,81600,0,81600,0,0,81600
132635502002000,BILLBOARD(BLL),Commercial,0,0,0,0,8737,8737
132637600100000,NW 329,Residential,32000,0,32000,92461,0,124461
132637600200000,NW 329,Residential,25933,0,25933,83064,0,108997
132637600300000,NW 329,Residential,30000,0,30000,100281,0,130281
132637600400000,NW 329,Residential,26000,0,26000,84060,0,110060
132637600500000,NW 329,Residential,29000,0,29000,100229,0,129229
132637600600000,NW 329,Residential,29067,0,29067,95081,0,124148
132637600700000,NW 329,Residential,27552,0,27552,85541,0,113093
132637600800000,NW 329,Residential,26190,0,26190,95326,0,121516
132637600900000,NW 329,Residential,26190,0,26190,92770,0,118960
132637601000000,NW 329,Residential,26190,0,26190,92673,0,118863
132637601100000,NW 329,Residential,26190,0,26190,92711,0,118901
132637601200000,NW 329,Residential,26190,0,26190,86813,0,113003
132637601300000,NW 329,Residential,26190,0,26190,91040,0,117230
132637601400000,NW 329,Residential,26190,0,26190,89755,0,115945
132637601500000,NW 329,Residential,26190,0,26190,92610,0,118800
132637601600000,NW 329,Residential,26190,0,26190,86024,0,112214
132637601700000,NW 329,Residential,26190,0,26190,82970,0,109160
132637601800000,NW 329,Residential,27447,0,27447,90906,0,118353
132637601900000,APARTMENT,Commercial,0,891837,891837,0,5408158,6299995
132637602000000,WAREHOUSE,Commercial,0,419688,419688,0,311616,731304
132637602002000,BILLBOARD(BLL),Commercial,0,0,0,0,4686,4686
132637602100000,VACANT LAND,Commercial,0,140873,140873,0,0,140873
132637700100000,NW 329,Residential,30966,0,30966,89956,0,120922
132637700200000,NW 329,Residential,32191,0,32191,92824,0,125015
132637700300000,NW 329,Residential,29100,0,29100,87122,0,116222
132637700400000,NW 329,Residential,29100,0,29100,102985,0,132085
132637700500000,NW 329,Residential,29100,0,29100,95734,0,124834
132637700600000,NW 329,Residential,29100,0,29100,101093,0,130193
132637700700000,NW 329,Residential,29100,0,29100,82892,0,111992
132637700800000,NW 329,Residential,29100,0,29100,90369,0,119469
132637700900000,NW 329,Residential,29100,0,29100,100240,0,129340
132637701000000,NW 329,Residential,29100,0,29100,98704,0,127804
132637701100000,NW 329,Residential,29100,0,29100,86145,0,115245
132637701200000,NW 329,Residential,29100,0,29100,100184,0,129284
132637701300000,NW 329,Residential,32314,0,32314,104055,0,136369
132637800100000,NW 329,Residential,29569,0,29569,89316,0,118885
132637800200000,NW 329,Residential,27936,0,27936,94911,0,122847
132637800300000,NW 329,Residential,26190,0,26190,95271,0,121461
132637800400000,NW 329,Residential,27936,0,27936,96882,0,124818
132637800500000,NW 329,Residential,27936,0,27936,86114,0,114050
132637800600000,NW 329,Residential,27936,0,27936,102168,0,130104
132637900100000,NW 329,Residential,29516,0,29516,100655,0,130171
132637900200000,NW 329,Residential,27936,0,27936,94113,0,122049
132637900300000,NW 329,Residential,26190,0,26190,84695,0,110885
132637900400000,NW 329,Residential,27936,0,27936,98140,0,126076
132637900500000,NW 329,Residential,27936,0,27936,81970,0,109906
132637900600000,NW 329,Residential,27936,0,27936,82894,0,110830
132637901000000,DAY CARE CENTER,Commercial,0,81421,81421,0,192386,273807
132640100100000,NW 329,Residential,30293,0,30293,111120,0,141413
132640100200000,NW 329,Residential,30000,0,30000,115911,0,145911
132640100300000,NW 329,Residential,30000,0,30000,123615,0,153615
132640100400000,NW 329,Residential,30000,0,30000,129308,0,159308
132640100500000,NW 329,Residential,30000,0,30000,114796,0,144796
132640100600000,NW 329,Residential,30823,0,30823,111332,0,142155
132640200100000,NW 329,Residential,30526,0,30526,104402,0,134928
132640200200000,NW 329,Residential,29936,0,29936,128888,0,158824
132640200300000,NW 329,Residential,31203,0,31203,116976,0,148179
132640200400000,NW 329,Residential,31255,0,31255,128417,0,159672
132640200500000,NW 329,Residential,31916,0,31916,113052,0,144968
132640200600000,NW 329,Residential,31200,0,31200,118449,0,149649
132640200700000,NW 329,Residential,31200,0,31200,105788,0,136988
132640200800000,NW 329,Residential,31200,0,31200,120708,0,151908
132640200900000,NW 329,Residential,30000,0,30000,109124,0,139124
132640201000000,NW 329,Residential,31200,0,31200,130857,0,162057
132640201100000,NW 329,Residential,30000,0,30000,128149,0,158149
132640201200000,NW 329,Residential,30000,0,30000,126143,0,156143
132640201300000,NW 329,Residential,30000,0,30000,115985,0,145985
132640201400000,NW 329,Residential,30000,0,30000,148138,0,178138
132640201500000,NW 329,Residential,31338,0,31338,130033,0,161371
132640300100000,NW 329,Residential,32727,0,32727,132417,0,165144
132640300200000,NW 329,Residential,33716,0,33716,145729,0,179445
132640300300000,NW 329,Residential,31680,0,31680,122408,0,154088
132640300400000,NW 329,Residential,33359,0,33359,118522,0,151881
132640300500000,NW 329,Residential,26525,0,26525,110690,0,137215
132640300600000,NW 329,Residential,25568,0,25568,106681,0,132249
132640300700000,NW 329,Residential,25703,0,25703,100270,0,125973
132640300800000,NW 329,Residential,29169,0,29169,109479,0,138648
132640300900000,NW 329,Residential,35016,0,35016,157365,0,192381
132640400100000,NW 329,Residential,29777,0,29777,143011,0,172788
132640400200000,NW 329,Residential,33512,0,33512,117942,0,151454
132640400300000,NW 329,Residential,32640,0,32640,108852,0,141492
132640400400000,NW 329,Residential,32640,0,32640,106596,0,139236
132640400500000,NW 329,Residential,32640,0,32640,105539,0,138179
132640400600000,NW 329,Residential,31960,0,31960,107070,0,139030
132640400700000,NW 329,Residential,31960,0,31960,112593,0,144553
132640400800000,NW 329,Residential,31960,0,31960,108742,0,140702
132640400900000,NW 329,Residential,32640,0,32640,122419,0,155059
132640401000000,NW 329,Residential,32640,0,32640,146347,0,178987
132640401100000,NW 329,Residential,32640,0,32640,109899,0,142539
132640500100000,NW 329,Residential,30051,0,30051,103898,0,133949
132640500200000,NW 329,Residential,30378,0,30378,136492,0,166870
132640500300000,NW 329,Residential,30096,0,30096,110851,0,140947
132640500400000,NW 329,Residential,30096,0,30096,124888,0,154984
132640500500000,NW 329,Residential,30096,0,30096,125984,0,156080
132640500600000,NW 329,Residential,30096,0,30096,132668,0,162764
132640500700000,NW 329,Residential,30096,0,30096,137213,0,167309
132640500800000,NW 329,Residential,30096,0,30096,129534,0,159630
132640500900000,NW 329,Residential,30096,0,30096,142991,0,173087
132640501000000,NW 329,Residential,30096,0,30096,130978,0,161074
132640501100000,NW 329,Residential,30096,0,30096,117949,0,148045
132640501200000,NW 329,Residential,30096,0,30096,111216,0,141312
132640501300000,NW 329,Residential,30096,0,30096,114812,0,144908
132640501400000,NW 329,Residential,30096,0,30096,119684,0,149780
132640501500000,NW 329,Residential,30096,0,30096,108583,0,138679
132640501600000,NW 329,Residential,30096,0,30096,125516,0,155612
132640501700000,NW 329,Residential,28512,0,28512,126633,0,155145
132640501800000,NW 329,Residential,30096,0,30096,125769,0,155865
132640600100000,NW 329,Residential,30356,0,30356,137404,0,167760
132640600200000,NW 329,Residential,39167,0,39167,125887,0,165054
132640600300000,NW 329,Residential,38220,0,38220,110517,0,148737
132640600400000,NW 329,Residential,35280,0,35280,124651,0,159931
132640600500000,NW 329,Residential,38220,0,38220,137400,0,175620
132640600600000,NW 329,Residential,36750,0,36750,106272,0,143022
132640600700000,NW 329,Residential,37730,0,37730,101349,0,139079
132640600800000,NW 329,Residential,37240,0,37240,110233,0,147473
132640600900000,NW 329,Residential,37240,0,37240,114837,0,152077
132640601000000,NW 329,Residential,37041,0,37041,89595,0,126636
132640601100000,NW 329,Residential,29792,0,29792,128980,0,158772
132640601200000,NW 329,Residential,29792,0,29792,168273,0,198065
132640601300000,NW 329,Residential,29792,0,29792,135394,0,165186
132640601400000,NW 329,Residential,29792,0,29792,138515,0,168307
132640601500000,NW 329,Residential,29792,0,29792,121679,0,151471
132640601600000,NW 329,Residential,29792,0,29792,117347,0,147139
132640601700000,NW 329,Residential,29792,0,29792,111066,0,140858
132640601800000,NW 329,Residential,29792,0,29792,122429,0,152221
132640700100000,NW 329,Residential,30046,0,30046,117742,0,147788
132640700200000,NW 329,Residential,32393,0,32393,108647,0,141040
132640700300000,NW 329,Residential,32090,0,32090,129533,0,161623
132640700400000,NW 329,Residential,29700,0,29700,151529,0,181229
132640700500000,NW 329,Residential,28423,0,28423,105088,0,133511
132640700600000,NW 329,Residential,27448,0,27448,126011,0,153459
132640700700000,NW 329,Residential,27448,0,27448,114239,0,141687
132640700800000,NW 329,Residential,27448,0,27448,112880,0,140328
132640700900000,NW 329,Residential,27448,0,27448,112152,0,139600
132640701000000,NW 329,Residential,27448,0,27448,131628,0,159076
132640701100000,NW 329,Residential,27448,0,27448,103391,0,130839
132640701200000,NW 329,Residential,27448,0,27448,98252,0,125700
132640701300000,NW 329,Residential,27448,0,27448,122410,0,149858
132640701400000,NW 329,Residential,27448,0,27448,110134,0,137582
132640701500000,NW 329,Residential,27448,0,27448,102739,0,130187
132640701600000,NW 329,Residential,28208,0,28208,104196,0,132404
132640701700000,NW 329,Residential,29184,0,29184,106552,0,135736
132640701800000,NW 329,Residential,29328,0,29328,121910,0,151238
132640800100000,APARTMENT,Commercial,0,28593,28593,0,286645,315238
132640800200000,NW 329,Residential,33061,0,33061,103683,0,136744
132640800300000,NW 329,Residential,26320,0,26320,108733,0,135053
132640800400000,NW 329,Residential,26320,0,26320,117712,0,144032
132640800500000,NW 329,Residential,27720,0,27720,98890,0,126610
132640800600000,NW 329,Residential,29120,0,29120,96799,0,125919
132640800700000,NW 329,Residential,24700,0,24700,134003,0,158703
132640800800000,NW 329,Residential,22989,0,22989,98155,0,121144
132640800900000,NW 329,Residential,22232,0,22232,108442,0,130674
132640801000000,NW 329,Residential,22344,0,22344,139410,0,161754
132640801100000,NW 329,Residential,23092,0,23092,106560,0,129652
132640801200000,NW 329,Residential,21008,0,21008,138945,0,159953
132640801300000,NW 329,Residential,22230,0,22230,96217,0,118447
132640801400000,NW 329,Residential,22504,0,22504,115150,0,137654
132640801500000,NW 329,Residential,22560,0,22560,113453,0,136013
132640801600000,NW 329,Residential,19176,0,19176,114301,0,133477
132640801700000,NW 329,Residential,19740,0,19740,124946,0,144686
132640801800000,APARTMENT,Commercial,0,24895,24895,0,314227,339122
132640900100000,NW 329,Residential,22494,0,22494,100698,0,123192
132640900200000,NW 329,Residential,21243,0,21243,146154,0,167397
132640900300000,NW 329,Residential,22116,0,22116,125429,0,147545
132640900400000,NW 329,Residential,23491,0,23491,155798,0,179289
132640900500000,NW 329,Residential,29488,0,29488,115320,0,144808
132640900600000,NW 329,Residential,29488,0,29488,120308,0,149796
132640900700000,NW 329,Residential,29488,0,29488,101712,0,131200
132640900800000,NW 329,Residential,29488,0,29488,104653,0,134141
132640900900000,NW 329,Residential,29184,0,29184,103359,0,132543
132640901000000,NW 329,Residential,21825,0,21825,101630,0,123455
132640901100000,NW 329,Residential,22116,0,22116,120495,0,142611
132640901200000,NW 329,Residential,22896,0,22896,112216,0,135112
132640901300000,NW 329,Residential,23317,0,23317,124289,0,147606
132641000100000,NW 329,Residential,22133,0,22133,119903,0,142036
132641000200000,NW 329,Residential,20593,0,20593,140686,0,161279
132641000300000,NW 329,Residential,22185,0,22185,99957,0,122142
132642600100000,NW 329,Residential,35578,0,35578,101360,0,136938
132642600200000,NW 329,Residential,32126,0,32126,117771,0,149897
132642600300000,NW 329,Residential,32126,0,32126,89095,0,121221
132642600400000,NW 329,Residential,32126,0,32126,108984,0,141110
132642600500000,NW 329,Residential,32126,0,32126,83528,0,115654
132642600600000,NW 329,Residential,32126,0,32126,93850,0,125976
132642600700000,NW 329,Residential,32126,0,32126,96338,0,128464
132642600800000,NW 329,Residential,32126,0,32126,93342,0,125468
132642600900000,NW 329,Residential,32126,0,32126,89198,0,121324
132642601000000,NW 329,Residential,32126,0,32126,83705,0,115831
132642601100000,NW 329,Residential,34158,0,34158,90400,0,124558
132642700100000,NW 321,Residential,34936,0,34936,146957,0,181893
132642700200000,NW 321,Residential,33792,0,33792,150793,0,184585
132642700300000,NW 321,Residential,33792,0,33792,144469,0,178261
132642700400000,NW 321,Residential,33737,0,33737,147751,0,181488
132642700500000,NW 321,Residential,37297,0,37297,151510,0,188807
132642700600000,NW 321,Residential,36808,0,36808,155351,0,192159
132642700700000,NW 321,Residential,33657,0,33657,155503,0,189160
132642700800000,NW 321,Residential,33792,0,33792,130451,0,164243
132642700900000,NW 321,Residential,33792,0,33792,145121,0,178913
132642701000000,NW 321,Residential,34560,0,34560,134789,0,169349
132642701100000,NW 321,Residential,36986,0,36986,125767,0,162753
132642701200000,NW 329,Residential,35932,0,35932,94499,0,130431
132642701300000,NW 329,Residential,32126,0,32126,92328,0,124454
132642701400000,NW 329,Residential,32126,0,32126,98131,0,130257
132642701500000,NW 329,Residential,32126,0,32126,101918,0,134044
132642701600000,NW 329,Residential,32126,0,32126,91289,0,123415
132642701700000,NW 329,Residential,32126,0,32126,84541,0,116667
132642701800000,NW 329,Residential,32126,0,32126,92191,0,124317
132642701900000,NW 329,Residential,32126,0,32126,95515,0,127641
132642702000000,NW 329,Residential,32126,0,32126,89784,0,121910
132642702100000,NW 329,Residential,35067,0,35067,97523,0,132590
132642702200000,CITY PROPERTY,Exempt,0,0,0,0,0,0
132642800100000,NW 329,Residential,35099,0,35099,111466,0,146565
132642800200000,NW 329,Residential,31680,0,31680,96761,0,128441
132642800300000,NW 329,Residential,34745,0,34745,109331,0,144076
132642800400000,NW 329,Residential,31664,0,31664,86861,0,118525
132642800500000,NW 329,Residential,31878,0,31878,94459,0,126337
132642800600000,NW 329,Residential,31878,0,31878,95786,0,127664
132642800700000,NW 329,Residential,31878,0,31878,97092,0,128970
132642800800000,NW 329,Residential,31878,0,31878,87045,0,118923
132642800900000,NW 329,Residential,31878,0,31878,88740,0,120618
132642801000000,NW 329,Residential,38066,0,38066,85759,0,123825
132642801100000,NW 329,Residential,27975,0,27975,100491,0,128466
132642801200000,NW 329,Residential,25344,0,25344,106910,0,132254
132642801300000,NW 329,Residential,27900,0,27900,96396,0,124296
132642801400000,NW 329,Residential,33369,0,33369,110552,0,143921
132642801500000,NW 329,Residential,31878,0,31878,100986,0,132864
132642801600000,NW 329,Residential,31878,0,31878,118854,0,150732
132642801700000,NW 329,Residential,31878,0,31878,99867,0,131745
132642801800000,NW 329,Residential,31878,0,31878,104346,0,136224
132642801900000,NW 329,Residential,31878,0,31878,100932,0,132810
132642802000000,NW 329,Residential,32084,0,32084,121017,0,153101
132642900100000,NW 329,Residential,35099,0,35099,95975,0,131074
132642900200000,NW 329,Residential,31680,0,31680,84494,0,116174
132642900300000,NW 329,Residential,34745,0,34745,81396,0,116141
132642900400000,NW 329,Residential,31664,0,31664,111113,0,142777
132642900500000,NW 329,Residential,31878,0,31878,100444,0,132322
132642900600000,NW 329,Residential,31878,0,31878,99037,0,130915
132642900700000,NW 329,Residential,31878,0,31878,86906,0,118784
132642900800000,NW 329,Residential,31878,0,31878,95068,0,126946
132642900900000,NW 329,Residential,31878,0,31878,84500,0,116378
132642901000000,NW 329,Residential,35165,0,35165,102748,0,137913
132642901100000,NW 329,Residential,27975,0,27975,117704,0,145679
132642901200000,NW 329,Residential,25344,0,25344,100077,0,125421
132642901300000,NW 329,Residential,27900,0,27900,103878,0,131778
132642901400000,NW 329,Residential,34244,0,34244,103620,0,137864
132642901500000,NW 329,Residential,31878,0,31878,92646,0,124524
132642901600000,NW 329,Residential,31878,0,31878,92586,0,124464
132642901700000,NW 329,Residential,31878,0,31878,91705,0,123583
132642901800000,NW 329,Residential,31878,0,31878,82413,0,114291
132642901900000,NW 329,Residential,31878,0,31878,88022,0,119900
132642902000000,NW 329,Residential,32084,0,32084,88529,0,120613
132643000100000,NW 329,Residential,27975,0,27975,119264,0,147239
132643000200000,NW 329,Residential,25344,0,25344,117593,0,142937
132643000300000,NW 329,Residential,27900,0,27900,90159,0,118059
132643000400000,NW 329,Residential,31664,0,31664,123734,0,155398
132643000500000,NW 329,Residential,31779,0,31779,106880,0,138659
132643000600000,NW 329,Residential,31779,0,31779,76063,0,107842
132643000700000,NW 329,Residential,31779,0,31779,99845,0,131624
132643000800000,NW 329,Residential,25423,0,25423,98246,0,123669
132643000900000,NW 329,Residential,25423,0,25423,99575,0,124998
132643001000000,NW 329,Residential,25423,0,25423,98764,0,124187
132643001100000,NW 329,Residential,25423,0,25423,145980,0,171403
132643100100000,NW 329,Residential,27975,0,27975,87829,0,115804
132643100200000,NW 329,Residential,25085,0,25085,96264,0,121349
132643100300000,NW 329,Residential,26721,0,26721,107819,0,134540
132643100400000,NW 329,Residential,30360,0,30360,93394,0,123754
132643100500000,NW 329,Residential,31185,0,31185,96525,0,127710
132643100600000,NW 329,Residential,31185,0,31185,89802,0,120987
132643100700000,NW 329,Residential,31185,0,31185,92650,0,123835
132643100800000,NW 329,Residential,32126,0,32126,83001,0,115127
132643100900000,NW 329,Residential,32126,0,32126,94984,0,127110
132643101000000,NW 329,Residential,32126,0,32126,120888,0,153014
132643101100000,NW 329,Residential,32216,0,32216,109698,0,141914
132643200100000,NW 329,Residential,26817,0,26817,93603,0,120420
132643200200000,NW 329,Residential,25476,0,25476,81548,0,107024
132643200300000,NW 329,Residential,26928,0,26928,96787,0,123715
132643200400000,NW 329,Residential,31977,0,31977,95119,0,127096
132643200500000,NW 329,Residential,32917,0,32917,108138,0,141055
132643200600000,NW 329,Residential,27225,0,27225,94412,0,121637
132643200700000,NW 329,Residential,31680,0,31680,94329,0,126009
132643200800000,NW 329,Residential,31185,0,31185,86506,0,117691
132643200900000,NW 329,Residential,31185,0,31185,89194,0,120379
132643201000000,NW 329,Residential,31185,0,31185,101116,0,132301
132643201100000,NW 329,Residential,30925,0,30925,96921,0,127846
132643300100000,NW 329,Residential,28499,0,28499,115782,0,144281
132643300200000,NW 329,Residential,24779,0,24779,93904,0,118683
132643300300000,NW 329,Residential,26434,0,26434,101850,0,128284
132643300400000,NW 329,Residential,34836,0,34836,94673,0,129509
132643300500000,NW 329,Residential,31680,0,31680,91813,0,123493
132643300600000,NW 329,Residential,29700,0,29700,100737,0,130437
132643300700000,NW 329,Residential,27225,0,27225,93858,0,121083
132643300800000,NW 329,Residential,32917,0,32917,96287,0,129204
132643300900000,NW 329,Residential,31680,0,31680,83745,0,115425
132643301000000,NW 329,Residential,31680,0,31680,90569,0,122249
132643301100000,NW 329,Residential,29700,0,29700,105044,0,134744
132643301200000,NW 329,Residential,31680,0,31680,95351,0,127031
132643301300000,NW 329,Residential,33284,0,33284,82835,0,116119
132643400100000,NW 329,Residential,27751,0,27751,108311,0,136062
132643400200000,NW 329,Residential,26400,0,26400,102070,0,128470
132643400300000,NW 329,Residential,32791,0,32791,95758,0,128549
132643400400000,NW 329,Residential,28280,0,28280,87824,0,116104
132643400500000,NW 329,Residential,28280,0,28280,96425,0,124705
132643400600000,NW 329,Residential,30300,0,30300,85772,0,116072
132643400700000,NW 329,Residential,30300,0,30300,90727,0,121027
132643400800000,NW 329,Residential,32320,0,32320,93983,0,126303
132643400900000,NW 329,Residential,30300,0,30300,94650,0,124950
132645100100000,NW 329,Residential,25423,0,25423,96841,0,122264
132645100200000,NW 329,Residential,31779,0,31779,101848,0,133627
132645100300000,NW 329,Residential,31779,0,31779,104553,0,136332
132645100400000,NW 329,Residential,31779,0,31779,103705,0,135484
132645100500000,NW 329,Residential,31779,0,31779,102200,0,133979
132645100600000,NW 329,Residential,31779,0,31779,77770,0,109549
132645100700000,NW 329,Residential,31779,0,31779,82785,0,114564
132645100800000,NW 329,Residential,31779,0,31779,97102,0,128881
132645100900000,NW 329,Residential,31779,0,31779,100752,0,132531
132645101000000,NW 329,Residential,33315,0,33315,99130,0,132445
132645101100000,NW 329,Residential,33280,0,33280,104691,0,137971
132645101200000,NW 329,Residential,35302,0,35302,107200,0,142502
132645101300000,NW 329,Residential,28467,0,28467,105888,0,134355
132645101400000,NW 329,Residential,26730,0,26730,107208,0,133938
132645101500000,NW 329,Residential,25423,0,25423,99614,0,125037
132645101600000,NW 329,Residential,25423,0,25423,123427,0,148850
132645101700000,NW 329,Residential,25423,0,25423,97836,0,123259
132645101800000,NW 329,Residential,25423,0,25423,96661,0,122084
132645101900000,NW 329,Residential,25423,0,25423,89348,0,114771
132645102000000,NW 329,Residential,25423,0,25423,99049,0,124472
132645102100000,NW 329,Residential,25423,0,25423,113709,0,139132
132645200100000,NW 329,Residential,32126,0,32126,74025,0,106151
132645200200000,NW 329,Residential,31185,0,31185,90354,0,121539
132645200300000,NW 329,Residential,31185,0,31185,96978,0,128163
132645200400000,NW 329,Residential,31185,0,31185,90551,0,121736
132645200500000,NW 329,Residential,31185,0,31185,95003,0,126188
132645200600000,NW 329,Residential,31185,0,31185,82891,0,114076
132645200700000,NW 329,Residential,31185,0,31185,96495,0,127680
132645200800000,NW 329,Residential,31185,0,31185,86261,0,117446
132645200900000,NW 329,Residential,31317,0,31317,89646,0,120963
132645201000000,NW 329,Residential,31139,0,31139,102905,0,134044
132645201100000,NW 329,Residential,31127,0,31127,92272,0,123399
132645201200000,NW 329,Residential,30106,0,30106,91188,0,121294
132645201300000,NW 329,Residential,29600,0,29600,83836,0,113436
132645201400000,NW 329,Residential,31121,0,31121,90979,0,122100
132645201500000,NW 329,Residential,34464,0,34464,110980,0,145444
132645201600000,NW 329,Residential,37158,0,37158,121545,0,158703
132645201700000,NW 329,Residential,34912,0,34912,110392,0,145304
132645201800000,NW 329,Residential,34171,0,34171,111460,0,145631
132645201900000,NW 329,Residential,33412,0,33412,88944,0,122356
132645202000000,NW 329,Residential,33412,0,33412,95737,0,129149
132645202100000,NW 329,Residential,32126,0,32126,104729,0,136855
132645202200000,NW 329,Residential,32126,0,32126,110081,0,142207
132645202300000,NW 329,Residential,32126,0,32126,101158,0,133284
132645202400000,NW 329,Residential,32126,0,32126,97891,0,130017
132645202500000,NW 329,Residential,32126,0,32126,94569,0,126695
132645300100000,NW 329,Residential,31185,0,31185,92701,0,123886
132645300200000,NW 329,Residential,29700,0,29700,102730,0,132430
132645300300000,NW 329,Residential,29700,0,29700,84655,0,114355
132645300400000,NW 329,Residential,32917,0,32917,86358,0,119275
132645300500000,NW 329,Residential,32917,0,32917,110063,0,142980
132645300600000,NW 329,Residential,31680,0,31680,93818,0,125498
132645300700000,NW 329,Residential,31680,0,31680,108004,0,139684
132645300800000,NW 329,Residential,31680,0,31680,83928,0,115608
132645300900000,NW 329,Residential,27225,0,27225,92774,0,119999
132645301000000,NW 329,Residential,32917,0,32917,103864,0,136781
132645301100000,NW 329,Residential,32917,0,32917,94931,0,127848
132645301200000,NW 329,Residential,29700,0,29700,107026,0,136726
132645301300000,NW 329,Residential,31680,0,31680,86901,0,118581
132645301400000,NW 329,Residential,33050,0,33050,96680,0,129730
132645301500000,NW 329,Residential,28043,0,28043,99277,0,127320
132645301600000,NW 329,Residential,30080,0,30080,101836,0,131916
132645301700000,NW 329,Residential,31960,0,31960,96636,0,128596
132645301800000,NW 329,Residential,48600,0,48600,123965,0,172565
132645301900000,NW 329,Residential,33743,0,33743,107954,0,141697
132645302000000,NW 329,Residential,31815,0,31815,101674,0,133489
132645302100000,NW 329,Residential,30545,0,30545,88755,0,119300
132645302200000,NW 329,Residential,29700,0,29700,88005,0,117705
132645302300000,NW 329,Residential,29845,0,29845,81409,0,111254
132645302400000,NW 329,Residential,31081,0,31081,87642,0,118723
132645302500000,NW 329,Residential,31185,0,31185,74451,0,105636
132645302600000,NW 329,Residential,31185,0,31185,80604,0,111789
132645302700000,NW 329,Residential,31185,0,31185,87269,0,118454
132645302800000,NW 329,Residential,31185,0,31185,90299,0,121484
132645302900000,NW 329,Residential,31185,0,31185,86378,0,117563
132645303000000,NW 329,Residential,31185,0,31185,99744,0,130929
132645400100000,NW 329,Residential,29700,0,29700,89762,0,119462
132645400200000,NW 329,Residential,29700,0,29700,86125,0,115825
132645400300000,NW 329,Residential,28710,0,28710,85559,0,114269
132645400400000,NW 329,Residential,29700,0,29700,90651,0,120351
132645400500000,NW 329,Residential,32917,0,32917,88523,0,121440
132645400600000,NW 329,Residential,27225,0,27225,93187,0,120412
132645400700000,NW 329,Residential,28512,0,28512,100451,0,128963
132645400800000,NW 329,Residential,28512,0,28512,93731,0,122243
132645400900000,NW 329,Residential,26730,0,26730,90417,0,117147
132645401000000,NW 329,Residential,24503,0,24503,90840,0,115343
132645401100000,NW 329,Residential,29626,0,29626,93766,0,123392
132645401200000,NW 329,Residential,30395,0,30395,94181,0,124576
132645401300000,NW 329,Residential,33548,0,33548,103779,0,137327
132645401400000,NW 329,Residential,27720,0,27720,86887,0,114607
132645401500000,NW 329,Residential,29700,0,29700,94537,0,124237
132645401600000,NW 329,Residential,27720,0,27720,85247,0,112967
132645401700000,NW 329,Residential,27720,0,27720,100632,0,128352
132645401800000,NW 329,Residential,29700,0,29700,102682,0,132382
132645401900000,NW 329,Residential,27720,0,27720,80078,0,107798
132645402000000,NW 329,Residential,27720,0,27720,87227,0,114947
132645402100000,NW 329,Residential,29700,0,29700,82232,0,111932
132645402200000,NW 329,Residential,27720,0,27720,82507,0,110227
132645500100000,NW 329,Residential,28280,0,28280,94157,0,122437
132645500200000,NW 329,Residential,32320,0,32320,90680,0,123000
132645500300000,NW 329,Residential,28280,0,28280,84814,0,113094
132645500400000,NW 329,Residential,30300,0,30300,85816,0,116116
132645500500000,NW 329,Residential,28560,0,28560,92065,0,120625
132645500600000,NW 329,Residential,27540,0,27540,83753,0,111293
132645500700000,NW 329,Residential,25704,0,25704,86164,0,111868
132645500800000,NW 329,Residential,25704,0,25704,84018,0,109722
132645500900000,NW 329,Residential,27540,0,27540,89342,0,116882
132645501000000,NW 329,Residential,25704,0,25704,86933,0,112637
132645501100000,NW 329,Residential,29179,0,29179,91706,0,120885
132645600100000,NW 329,Residential,50000,0,50000,108334,0,158334
132645600200000,STATE PROPERTY,Exempt,0,0,0,0,0,0
132645700100000,NW 329,Residential,29163,0,29163,90012,0,119175
132645700200000,NW 329,Residential,29140,0,29140,81355,0,110495
132645700300000,NW 329,Residential,27808,0,27808,96711,0,124519
132645700400000,NW 329,Residential,29280,0,29280,87340,0,116620
132645700500000,NW 329,Residential,32473,0,32473,107132,0,139605
132645700600000,NW 329,Residential,26954,0,26954,87011,0,113965
132645700700000,NW 329,Residential,26190,0,26190,98256,0,124446
132645700800000,NW 329,Residential,27936,0,27936,82493,0,110429
132645700900000,NW 329,Residential,26190,0,26190,91453,0,117643
132645701000000,NW 329,Residential,27155,0,27155,100580,0,127735
132645701100000,NW 329,Residential,38563,0,38563,71743,0,110306
132647600100000,NW 329,Residential,28733,0,28733,170851,0,199584
132647600200000,NW 329,Residential,20445,0,20445,120960,0,141405
132647600300000,NW 329,Residential,22185,0,22185,157991,0,180176
132647600400000,NW 329,Residential,20445,0,20445,134393,0,154838
132647700100000,NW 329,Residential,22572,0,22572,132224,0,154796
132647700200000,NW 329,Residential,22275,0,22275,133104,0,155379
132647700300000,CHURCH,Exempt,0,423576,423576,0,1129329,1552905
132647700400000,NW 329,Residential,29184,0,29184,121961,0,151145
132647700500000,NW 329,Residential,22275,0,22275,104304,0,126579
132647700600000,NW 329,Residential,22572,0,22572,122884,0,145456
132647800300000,CONVENIENCE STORE,Commercial,0,186300,186300,0,562813,749113
132647800400000,VACANT LAND,Commercial,0,84240,84240,0,0,84240
132647800500000,VACANT LAND,Commercial,0,83700,83700,0,0,83700
132647800600000,VACANT LAND,Commercial,0,85320,85320,0,0,85320
132710300100000,CITY PROPERTY,Exempt,0,0,0,0,0,0
132710300200000,NW 332,Residential,42218,0,42218,164163,0,206381
132710300300000,NW 332,Residential,44910,0,44910,147581,0,192491
132710300400000,NW 332,Residential,39713,0,39713,212488,0,252201
132710300500000,NW 332,Residential,39890,0,39890,200635,0,240525
132710300600000,NW 332,Residential,33861,0,33861,180708,0,214569
132710300700000,NW 332,Residential,40052,0,40052,212193,0,252245
132710300800000,NW 332,Residential,52725,0,52725,217658,0,270383
132710300900000,NW 332,Residential,46993,0,46993,200164,0,247157
132710301000000,NW 332,Residential,32585,0,32585,175771,0,208356
132710301100000,NW 332,Residential,36100,0,36100,199898,0,235998
132710301200000,NW 332,Residential,38000,0,38000,161264,0,199264
132710301300000,NW 332,Residential,31350,0,31350,204584,0,235934
132710301400000,NW 332,Residential,47011,0,47011,193186,0,240197
132710301500000,NW 332,Residential,32458,0,32458,196595,0,229053
132710301600000,NW 332,Residential,32918,0,32918,177594,0,210512
132710301700000,NW 332,Residential,31037,0,31037,171396,0,202433
132710301800000,NW 332,Residential,35739,0,35739,178615,0,214354
132710301900000,NW 332,Residential,32918,0,32918,173666,0,206584
132710302000000,NW 332,Residential,32918,0,32918,192672,0,225590
132710302100000,NW 332,Residential,31037,0,31037,160959,0,191996
132710302200000,NW 332,Residential,50003,0,50003,0,0,50003
132710302300000,NW 332,Residential,40533,0,40533,215013,0,255546
132710302400000,NW 332,Residential,44460,0,44460,188400,0,232860
132710302500000,NW 332,Residential,38380,0,38380,161687,0,200067
132710302600000,NW 332,Residential,38000,0,38000,172901,0,210901
132710302700000,NW 332,Residential,47500,0,47500,0,0,47500
132710400100000,NW 332,Residential,48811,0,48811,219875,0,268686
132710400200000,NW 332,Residential,36100,0,36100,206817,0,242917
132710400300000,NW 332,Residential,33250,0,33250,202478,0,235728
132710400400000,NW 332,Residential,39583,0,39583,212142,0,251725
132710400500000,NW 332,Residential,65304,0,65304,231657,0,296961
132710400600000,NW 332,Residential,61560,0,61560,234638,0,296198
132710400700000,CITY PROPERTY,Exempt,0,0,0,0,0,0
132710400800000,NW 332,Residential,49219,0,49219,205762,0,254981
132710400900000,NW 332,Residential,34722,0,34722,168579,0,203301
132710401000000,NW 332,Residential,37791,0,37791,194955,0,232746
132710401100000,NW 332,Residential,31350,0,31350,173874,0,205224
132710401200000,NW 332,Residential,41258,0,41258,177942,0,219200
132710401300000,NW 332,Residential,36417,0,36417,177638,0,214055
132710401400000,NW 332,Residential,37367,0,37367,7207,0,44574
132710401500000,NW 332,Residential,56291,0,56291,177383,0,233674
132710401800000,NW 332,Residential,38238,0,38238,165595,0,203833
132710401900000,NW 332,Residential,45363,0,45363,0,0,45363
132710500100000,NW 332,Residential,47500,0,47500,168190,0,215690
132710500200000,NW 332,Residential,47975,0,47975,179436,0,227411
132710600100000,NW 332,Residential,45125,0,45125,202395,0,247520
132710600200000,NW 332,Residential,31350,0,31350,178835,0,210185
132710600300000,NW 332,Residential,38000,0,38000,166267,0,204267
132710600400000,NW 332,Residential,30875,0,30875,231786,0,262661
132710600500000,NW 332,Residential,48171,0,48171,153898,0,202069
132710600600000,NW 332,Residential,47965,0,47965,132598,0,180563
132710600700000,NW 332,Residential,33250,0,33250,158082,0,191332
132710600800000,NW 332,Residential,31350,0,31350,169452,0,200802
132710600900000,NW 332,Residential,36100,0,36100,184661,0,220761
132710601000000,NW 332,Residential,44465,0,44465,180535,0,225000
132712600100000,NW 332,Residential,59000,0,59000,72288,0,131288
132712600300000,NW 332,Residential,39148,0,39148,146418,0,185566
132712600400000,NW 332,Residential,30802,0,30802,149418,0,180220
132712600500000,NW 332,Residential,34447,0,34447,143762,0,178209
132712600600000,NW 332,Residential,33051,0,33051,146643,0,179694
132712600800000,NW 332,Residential,37590,0,37590,163943,0,201533
132712600900000,NW 332,Residential,37590,0,37590,193919,0,231509
132712601000000,NW 332,Residential,33051,0,33051,181646,0,214697
132712601100000,NW 332,Residential,34447,0,34447,188402,0,222849
132712601200000,NW 332,Residential,33671,0,33671,167046,0,200717
132712601300000,NW 332,Residential,38976,0,38976,204710,0,243686
132712601400000,NW 332,Residential,38317,0,38317,158837,0,197154
132712700100000,NW 332,Residential,42959,0,42959,192615,0,235574
132712700200000,NW 332,Residential,41701,0,41701,178121,0,219822
132712700300000,NW 332,Residential,43320,0,43320,211574,0,254894
132712700400000,NW 332,Residential,41670,0,41670,187986,0,229656
132712700500000,NW 332,Residential,43298,0,43298,234104,0,277402
132712700600000,NW 332,Residential,43835,0,43835,144974,0,188809
132712700700000,NW 332,Residential,44403,0,44403,183040,0,227443
132712700800000,NW 332,Residential,40613,0,40613,155742,0,196355
132712700900000,NW 332,Residential,41154,0,41154,165164,0,206318
132712701000000,NW 332,Residential,43862,0,43862,188817,0,232679
132712701100000,NW 332,Residential,41154,0,41154,182523,0,223677
132712701200000,NW 332,Residential,31896,0,31896,179101,0,210997
132712701300000,NW 332,Residential,40294,0,40294,186689,0,226983
132712701400000,NW 332,Residential,34566,0,34566,184582,0,219148
132712701500000,NW 332,Residential,35457,0,35457,240436,0,275893
132712701600000,NW 332,Residential,35369,0,35369,174142,0,209511
132712701700000,NW 332,Residential,37132,0,37132,189719,0,226851
132712701800000,CITY PROPERTY,Exempt,0,0,0,0,0,0
132712701900000,NW 332,Residential,33056,0,33056,263373,0,296429
132712702000000,NW 332,Residential,34980,0,34980,202137,0,237117
132712702100000,NW 332,Residential,38504,0,38504,519477,0,557981
132712702200000,NW 332,Residential,38304,0,38304,271028,0,309332
132712702300000,NW 332,Residential,35346,0,35346,296201,0,331547
132712702400000,NW 332,Residential,13700,0,13700,0,0,13700
132712800100000,NW 332,Residential,33051,0,33051,146616,0,179667
132712800200000,NW 332,Residential,36472,0,36472,196400,0,232872
132712800300000,NW 332,Residential,37341,0,37341,174999,0,212340
132712800400000,NW 332,Residential,37628,0,37628,184244,0,221872
132712800500000,NW 332,Residential,38332,0,38332,171362,0,209694
132712800600000,NW 332,Residential,36495,0,36495,187154,0,223649
132712800800000,NW 332,Residential,33051,0,33051,165163,0,198214
132712800900000,NW 332,Residential,35414,0,35414,192712,0,228126
132712801000000,NW 332,Residential,39583,0,39583,178310,0,217893
132712801100000,NW 332,Residential,37428,0,37428,149347,0,186775
132712801200000,NW 332,Residential,36258,0,36258,181391,0,217649
132712801300000,NW 332,Residential,41614,0,41614,178415,0,220029
132712801400000,NW 332,Residential,39520,0,39520,225650,0,265170
132712801500000,NW 332,Residential,39531,0,39531,211021,0,250552
132712801600000,NW 332,Residential,38475,0,38475,148772,0,187247
132712801700000,NW 332,Residential,33725,0,33725,170775,0,204500
132712801800000,NW 332,Residential,31350,0,31350,190279,0,221629
132712801900000,NW 332,Residential,35150,0,35150,170642,0,205792
132712802000000,NW 332,Residential,33725,0,33725,200832,0,234557
132712802100000,NW 332,Residential,35969,0,35969,170064,0,206033
132712802200000,NW 332,Residential,38017,0,38017,200872,0,238889
132712802300000,NW 332,Residential,37049,0,37049,171593,0,208642
132712802400000,NW 332,Residential,33945,0,33945,152874,0,186819
132712802500000,NW 332,Residential,35150,0,35150,153262,0,188412
132712802600000,NW 332,Residential,33725,0,33725,154343,0,188068
132712802700000,NW 332,Residential,38419,0,38419,162508,0,200927
132712802800000,NW 332,Residential,34762,0,34762,200522,0,235284
132712802900000,NW 332,Residential,34710,0,34710,183954,0,218664
132712803000000,NW 332,Residential,34447,0,34447,140876,0,175323
132712900100000,NW 332,Residential,37483,0,37483,183882,0,221365
132712900200000,NW 332,Residential,37928,0,37928,185658,0,223586
132712900300000,NW 332,Residential,40456,0,40456,161232,0,201688
132712900400000,NW 332,Residential,35112,0,35112,150355,0,185467
132712900500000,NW 332,Residential,36614,0,36614,202254,0,238868
132712900600000,NW 332,Residential,34883,0,34883,224873,0,259756
132712900700000,NW 332,Residential,35999,0,35999,155276,0,191275
132712900800000,NW 332,Residential,39124,0,39124,164607,0,203731
132712900900000,NW 332,Residential,35395,0,35395,160122,0,195517
132712901000000,NW 332,Residential,38254,0,38254,169525,0,207779
132712901100000,NW 332,Residential,30576,0,30576,157271,0,187847
132712901200000,NW 332,Residential,32257,0,32257,205539,0,237796
132713000100000,NW 332,Residential,38756,0,38756,162486,0,201242
132713000200000,NW 332,Residential,33393,0,33393,162213,0,195606
132713000300000,NW 332,Residential,34295,0,34295,162938,0,197233
132713000400000,NW 332,Residential,32631,0,32631,197133,0,229764
132713000500000,NW 332,Residential,38350,0,38350,177811,0,216161
132713000600000,NW 332,Residential,39646,0,39646,180493,0,220139
132713000700000,NW 332,Residential,34029,0,34029,176547,0,210576
132713000800000,NW 332,Residential,31350,0,31350,151341,0,182691
132713000900000,NW 332,Residential,34352,0,34352,168356,0,202708
132713001000000,NW 332,Residential,35661,0,35661,173035,0,208696
132713001100000,NW 332,Residential,37814,0,37814,159666,0,197480
132713001200000,NW 332,Residential,38937,0,38937,202219,0,241156
132715100100000,NW 331,Residential,28267,0,28267,137354,0,165621
132715100200000,NW 331,Residential,30245,0,30245,116912,0,147157
132715100300000,NW 331,Residential,32252,0,32252,169086,0,201338
132715100400000,NW 332,Residential,37128,0,37128,173959,0,211087
132715100500000,NW 332,Residential,34224,0,34224,119145,0,153369
132715100600000,NW 332,Residential,33601,0,33601,150105,0,183706
132715200100000,NW 332,Residential,33773,0,33773,226683,0,260456
132715200200000,NW 332,Residential,38914,0,38914,293649,0,332563
132715200300000,NW 332,Residential,33341,0,33341,166891,0,200232
132715200400000,NW 332,Residential,32096,0,32096,165727,0,197823
132715200500000,NW 332,Residential,28651,0,28651,157276,0,185927
132715200600000,NW 332,Residential,28465,0,28465,187801,0,216266
132715200700000,NW 332,Residential,31540,0,31540,168300,0,199840
132715200800000,NW 332,Residential,32111,0,32111,155756,0,187867
132715200900000,NW 332,Residential,30864,0,30864,177692,0,208556
132715201000000,NW 332,Residential,28968,0,28968,161703,0,190671
132715201100000,NW 332,Residential,28560,0,28560,156183,0,184743
132715201200000,NW 332,Residential,30192,0,30192,179177,0,209369
132715201300000,NW 332,Residential,31575,0,31575,171254,0,202829
132715201400000,NW 332,Residential,30659,0,30659,160175,0,190834
132715201500000,NW 332,Residential,30210,0,30210,156782,0,186992
132715201600000,NW 332,Residential,31908,0,31908,166427,0,198335
132715201700000,NW 332,Residential,30370,0,30370,146191,0,176561
132715201800000,NW 332,Residential,35207,0,35207,148308,0,183515
132715201900000,NW 332,Residential,28195,0,28195,155444,0,183639
132715202000000,NW 332,Residential,31728,0,31728,165642,0,197370
132715202100000,NW 332,Residential,32822,0,32822,165647,0,198469
132715202200000,NW 332,Residential,32832,0,32832,152473,0,185305
132715202300000,NW 332,Residential,32812,0,32812,165034,0,197846
132715202400000,NW 332,Residential,33053,0,33053,165371,0,198424
132715202500000,NW 332,Residential,34095,0,34095,157092,0,191187
132715202600000,NW 332,Residential,37360,0,37360,199575,0,236935
132715202700000,NW 332,Residential,35768,0,35768,179880,0,215648
132715202800000,NW 332,Residential,34766,0,34766,147047,0,181813
132715202900000,NW 332,Residential,35224,0,35224,139698,0,174922
132715203000000,NW 332,Residential,34907,0,34907,159399,0,194306
132715203100000,NW 332,Residential,33984,0,33984,143593,0,177577
132715203200000,NW 332,Residential,35743,0,35743,161395,0,197138
132715300100000,NW 332,Residential,29816,0,29816,171260,0,201076
132715300200000,NW 332,Residential,27848,0,27848,160414,0,188262
132715300300000,NW 332,Residential,26400,0,26400,136081,0,162481
132715300400000,NW 332,Residential,28000,0,28000,149491,0,177491
132715300500000,NW 332,Residential,32571,0,32571,172801,0,205372
132715400100000,NW 331,Residential,31376,0,31376,172286,0,203662
132715400200000,NW 331,Residential,32616,0,32616,145999,0,178615
132715400300000,NW 332,Residential,32508,0,32508,133336,0,165844
132715400400000,NW 332,Residential,33647,0,33647,150545,0,184192
132715400500000,NW 332,Residential,32340,0,32340,183764,0,216104
132715500100000,NW 332,Residential,30260,0,30260,180020,0,210280
132715500200000,NW 332,Residential,30974,0,30974,146862,0,177836
132715500300000,NW 332,Residential,31920,0,31920,165355,0,197275
132715500400000,NW 332,Residential,31986,0,31986,137795,0,169781
132715500500000,NW 332,Residential,30235,0,30235,173747,0,203982
132715500600000,NW 332,Residential,31855,0,31855,176503,0,208358
132715500700000,NW 332,Residential,32300,0,32300,141874,0,174174
132715500800000,NW 332,Residential,30000,0,30000,168315,0,198315
132715500900000,NW 332,Residential,27960,0,27960,166655,0,194615
132715501000000,NW 332,Residential,29716,0,29716,176296,0,206012
132715501100000,NW 332,Residential,31874,0,31874,169044,0,200918
132715501200000,NW 332,Residential,32541,0,32541,189384,0,221925
132715501300000,NW 332,Residential,29801,0,29801,171025,0,200826
132715501400000,NW 332,Residential,33477,0,33477,169907,0,203384
132715501500000,NW 332,Residential,30598,0,30598,173718,0,204316
132715501600000,NW 332,Residential,28550,0,28550,142650,0,171200
132715501700000,NW 332,Residential,30386,0,30386,168669,0,199055
132715501800000,NW 332,Residential,28400,0,28400,142157,0,170557
132715501900000,NW 332,Residential,30000,0,30000,147356,0,177356
132715502000000,NW 332,Residential,28400,0,28400,164497,0,192897
132715502100000,NW 332,Residential,30000,0,30000,122749,0,152749
132715502200000,NW 332,Residential,32300,0,32300,180075,0,212375
132715502300000,NW 332,Residential,31572,0,31572,176312,0,207884
132715502400000,NW 332,Residential,29369,0,29369,165740,0,195109
132715502500000,NW 332,Residential,28560,0,28560,153853,0,182413
132715502600000,NW 332,Residential,30651,0,30651,205494,0,236145
132715502700000,NW 332,Residential,29210,0,29210,160875,0,190085
132715600100000,NW 332,Residential,32640,0,32640,184591,0,217231
132715600200000,NW 332,Residential,30672,0,30672,156841,0,187513
132715600300000,NW 332,Residential,29492,0,29492,180704,0,210196
132715600400000,NW 332,Residential,30943,0,30943,201051,0,231994
132715600500000,NW 332,Residential,33523,0,33523,145735,0,179258
132715700100000,NW 332,Residential,33379,0,33379,163029,0,196408
132715700200000,NW 332,Residential,29364,0,29364,180460,0,209824
132715700300000,NW 332,Residential,29766,0,29766,171398,0,201164
132715700400000,NW 332,Residential,27664,0,27664,181453,0,209117
132715700500000,NW 332,Residential,27720,0,27720,162893,0,190613
132715700600000,NW 332,Residential,31339,0,31339,142426,0,173765
132715700700000,NW 332,Residential,33660,0,33660,176931,0,210591
132715700800000,NW 332,Residential,34000,0,34000,173343,0,207343
132715700900000,NW 332,Residential,34710,0,34710,129842,0,164552
132715701000000,NW 332,Residential,35112,0,35112,149027,0,184139
132715701100000,NW 332,Residential,37671,0,37671,208248,0,245919
132715701200000,NW 332,Residential,31633,0,31633,150405,0,182038
132715701300000,NW 332,Residential,34344,0,34344,175444,0,209788
132715800100000,NW 332,Residential,35100,0,35100,151335,0,186435
132715800200000,NW 332,Residential,31416,0,31416,158693,0,190109
132715800300000,NW 332,Residential,33603,0,33603,136246,0,169849
132715800400000,NW 332,Residential,33921,0,33921,137497,0,171418
132715800500000,NW 332,Residential,29455,0,29455,161978,0,191433
132715800600000,NW 332,Residential,32180,0,32180,167422,0,199602
132715800700000,NW 332,Residential,34119,0,34119,171174,0,205293
132715800800000,NW 332,Residential,34075,0,34075,156628,0,190703
132715800900000,NW 332,Residential,32544,0,32544,168591,0,201135
132715801000000,NW 332,Residential,33600,0,33600,189945,0,223545
132715801100000,NW 332,Residential,29648,0,29648,168271,0,197919
132715801200000,NW 332,Exempt,0,29600,29600,0,163170,192770
132715801300000,NW 332,Residential,30124,0,30124,157768,0,187892
132715801400000,NW 332,Residential,34200,0,34200,167860,0,202060
132715900100000,NW 332,Residential,33987,0,33987,212541,0,246528
132717600100000,NW 331,Residential,24491,0,24491,119673,0,144164
132717600200000,NW 331,Residential,26000,0,26000,116796,0,142796
132717600300000,NW 331,Residential,30400,0,30400,132097,0,162497
132717600400000,NW 331,Residential,27600,0,27600,117260,0,144860
132717600500000,NW 331,Residential,28800,0,28800,131224,0,160024
132717600600000,NW 331,Residential,32800,0,32800,115278,0,148078
132717600700000,NW 331,Residential,33162,0,33162,132838,0,166000
132717600800000,NW 331,Residential,30400,0,30400,133548,0,163948
132717600900000,NW 331,Residential,30400,0,30400,133651,0,164051
132717601000000,NW 331,Residential,27392,0,27392,127674,0,155066
132717601100000,NW 331,Residential,31200,0,31200,112347,0,143547
132717601200000,NW 331,Residential,31200,0,31200,147800,0,179000
132717601300000,NW 331,Residential,31200,0,31200,144411,0,175611
132717601400000,NW 331,Residential,31200,0,31200,128745,0,159945
132717601500000,NW 331,Residential,31200,0,31200,132807,0,164007
132717601600000,NW 331,Residential,31200,0,31200,162294,0,193494
132717601700000,NW 331,Residential,32400,0,32400,147450,0,179850
132717700100000,NW 331,Residential,24654,0,24654,162808,0,187462
132717700200000,NW 331,Residential,30761,0,30761,141908,0,172669
132717700300000,NW 331,Residential,26534,0,26534,126165,0,152699
132717700400000,NW 331,Residential,28829,0,28829,122380,0,151209
132717700500000,NW 331,Residential,29104,0,29104,126408,0,155512
132717700600000,NW 331,Residential,28145,0,28145,149798,0,177943
132717700700000,NW 331,Residential,32533,0,32533,112533,0,145066
132717700800000,NW 331,Residential,28723,0,28723,127123,0,155846
132717700900000,NW 331,Residential,28130,0,28130,135328,0,163458
132717701000000,NW 331,Residential,27103,0,27103,126534,0,153637
132717701100000,NW 331,Residential,25476,0,25476,130692,0,156168
132717701200000,NW 331,Residential,28032,0,28032,154672,0,182704
132717701300000,NW 331,Residential,26220,0,26220,127400,0,153620
132717701400000,NW 331,Residential,28880,0,28880,131652,0,160532
132717701500000,NW 331,Residential,25976,0,25976,154362,0,180338
132717701600000,NW 331,Residential,30135,0,30135,147581,0,177716
132717800100000,NW 331,Residential,32282,0,32282,130236,0,162518
132717800200000,NW 331,Residential,25740,0,25740,127647,0,153387
132717800300000,NW 331,Residential,27444,0,27444,138182,0,165626
132717800400000,NW 331,Residential,27852,0,27852,128230,0,156082
132717800500000,NW 331,Residential,24444,0,24444,164554,0,188998
132717800600000,NW 331,Residential,25856,0,25856,158634,0,184490
132717800700000,NW 331,Residential,28522,0,28522,175690,0,204212
132717800800000,NW 331,Residential,26865,0,26865,134499,0,161364
132717800900000,NW 331,Residential,27740,0,27740,145459,0,173199
132717801000000,NW 331,Residential,26696,0,26696,142108,0,168804
132717801100000,NW 331,Residential,28097,0,28097,136151,0,164248
132717801200000,NW 331,Residential,27720,0,27720,136932,0,164652
132717801300000,NW 331,Residential,28684,0,28684,151128,0,179812
132717801400000,NW 331,Residential,27604,0,27604,159252,0,186856
132717801500000,NW 331,Residential,32060,0,32060,148329,0,180389
132717801600000,NW 332,Residential,31377,0,31377,150029,0,181406
132717801700000,NW 331,Residential,33040,0,33040,156824,0,189864
132717801800000,NW 331,Residential,32000,0,32000,123678,0,155678
132717801900000,NW 331,Residential,30911,0,30911,123539,0,154450
132717802000000,NW 331,Residential,26255,0,26255,137483,0,163738
132717802100000,NW 331,Residential,30496,0,30496,102297,0,132793
132717802200000,NW 331,Residential,30804,0,30804,124740,0,155544
132717802300000,NW 331,Residential,29042,0,29042,155029,0,184071
132717802400000,NW 331,Residential,25344,0,25344,142310,0,167654
132717802500000,NW 331,Residential,29184,0,29184,114147,0,143331
132717802600000,NW 331,Residential,25475,0,25475,130378,0,155853
132717802700000,NW 331,Residential,29617,0,29617,138436,0,168053
132717802800000,NW 331,Residential,26133,0,26133,112161,0,138294
132717802900000,NW 331,Residential,32114,0,32114,133422,0,165536
132717900100000,NW 331,Residential,30661,0,30661,133301,0,163962
132717900200000,NW 331,Residential,26509,0,26509,146162,0,172671
132717900300000,NW 331,Residential,26214,0,26214,133542,0,159756
132717900400000,NW 331,Residential,25394,0,25394,137604,0,162998
132717900500000,NW 331,Residential,26112,0,26112,130338,0,156450
132717900600000,NW 331,Residential,26112,0,26112,133900,0,160012
132717900700000,NW 331,Residential,29998,0,29998,130719,0,160717
132717900800000,NW 331,Residential,29184,0,29184,128952,0,158136
132717900900000,NW 331,Residential,29344,0,29344,124178,0,153522
132717901000000,NW 331,Residential,30921,0,30921,129997,0,160918
132717901100000,NW 331,Residential,30915,0,30915,152298,0,183213
132717901200000,NW 331,Residential,31261,0,31261,130218,0,161479
132717901300000,NW 332,Residential,30874,0,30874,132900,0,163774
132717901400000,NW 332,Residential,31353,0,31353,187102,0,218455
132717901500000,NW 332,Residential,31647,0,31647,116085,0,147732
132717901600000,NW 332,Residential,28000,0,28000,124523,0,152523
132717901700000,NW 332,Residential,35350,0,35350,145752,0,181102
132717901800000,NW 331,Residential,32130,0,32130,118374,0,150504
132717901900000,NW 331,Residential,29093,0,29093,141235,0,170328
132717902000000,NW 331,Residential,30400,0,30400,133048,0,163448
132717902100000,NW 331,Residential,33790,0,33790,130538,0,164328
132717902200000,NW 331,Residential,32915,0,32915,127281,0,160196
132717902300000,NW 331,Residential,29855,0,29855,143175,0,173030
132717902400000,NW 331,Residential,25030,0,25030,125193,0,150223
132717902500000,NW 331,Residential,30264,0,30264,132896,0,163160
132717902600000,NW 331,Residential,30580,0,30580,147939,0,178519
132717902700000,NW 331,Residential,28215,0,28215,120097,0,148312
132717902800000,NW 331,Residential,31920,0,31920,165986,0,197906
132717902900000,NW 331,Residential,30716,0,30716,123206,0,153922
132717903000000,NW 331,Residential,29365,0,29365,133560,0,162925
132717903100000,NW 331,Residential,29766,0,29766,132701,0,162467
132717903200000,NW 331,Residential,26125,0,26125,124272,0,150397
132717903300000,NW 331,Residential,30217,0,30217,142414,0,172631
132717903400000,NW 331,Residential,31731,0,31731,117831,0,149562
132717903500000,NW 331,Residential,30289,0,30289,133692,0,163981
132717903600000,NW 331,Residential,30818,0,30818,108442,0,139260
132717903700000,NW 331,Residential,31471,0,31471,115290,0,146761
132717903800000,NW 331,Residential,29400,0,29400,142688,0,172088
132717903900000,NW 331,Residential,31104,0,31104,158182,0,189286
132717904000000,NW 331,Residential,28800,0,28800,129472,0,158272
132717904100000,NW 331,Residential,30720,0,30720,139053,0,169773
132717904200000,NW 331,Residential,25344,0,25344,109444,0,134788
132717904300000,NW 331,Residential,25763,0,25763,126885,0,152648
132718000100000,NW 332,Residential,33170,0,33170,150591,0,183761
132718000200000,NW 332,Residential,28840,0,28840,166644,0,195484
132718000300000,NW 332,Residential,35073,0,35073,145849,0,180922
132718100100000,NW 331,Residential,30229,0,30229,129810,0,160039
132718100200000,NW 331,Residential,24768,0,24768,134932,0,159700
132718100300000,NW 331,Residential,25856,0,25856,129172,0,155028
132718100400000,NW 331,Residential,29754,0,29754,146868,0,176622
132718100500000,NW 331,Residential,24576,0,24576,122648,0,147224
132718100600000,NW 331,Residential,23000,0,23000,100840,0,123840
132718100700000,NW 331,Residential,29142,0,29142,132017,0,161159
132718100800000,NW 331,Residential,28684,0,28684,121978,0,150662
132718100900000,NW 331,Residential,30709,0,30709,126041,0,156750
132718101000000,NW 331,Residential,25075,0,25075,153433,0,178508
132718101100000,NW 331,Residential,29720,0,29720,129556,0,159276
132718200100000,NW 331,Residential,31680,0,31680,121817,0,153497
132718200200000,NW 331,Residential,30336,0,30336,161222,0,191558
132718200300000,NW 331,Residential,31284,0,31284,108695,0,139979
132718200400000,NW 331,Residential,31108,0,31108,122066,0,153174
132718200500000,NW 331,Residential,32096,0,32096,118175,0,150271
132718200600000,NW 332,Residential,35605,0,35605,126662,0,162267
132718200700000,NW 332,Residential,37719,0,37719,170135,0,207854
132718200800000,NW 332,Residential,34997,0,34997,176173,0,211170
132720100200000,NW 332,Residential,30020,0,30020,195337,0,225357
132720200100000,NW 332,Residential,37214,0,37214,198213,0,235427
132720200200000,NW 332,Residential,29785,0,29785,182784,0,212569
132720200300000,NW 332,Residential,30601,0,30601,163092,0,193693
132725200100000,NW 332,Residential,39900,0,39900,273044,0,312944
132725200200000,NW 332,Residential,39900,0,39900,339597,0,379497
132725200300000,NW 332,Residential,39900,0,39900,327960,0,367860
132725200400000,NW 332,Residential,39900,0,39900,182987,0,222887
132725200500000,NW 332,Residential,39900,0,39900,299745,0,339645
132725200600000,NW 332,Residential,39900,0,39900,320175,0,360075
132725200700000,NW 332,Residential,38000,0,38000,313235,0,351235
132725200800000,NW 332,Residential,42433,0,42433,225751,0,268184
132725200900000,NW 332,Residential,52693,0,52693,254629,0,307322
132725201000000,NW 332,Residential,850,0,850,0,0,850
132725300100000,NW 332,Residential,450,0,450,0,0,450
132725300200000,NW 332,Residential,48577,0,48577,328283,0,376860
132725300300000,NW 332,Residential,43106,0,43106,268952,0,312058
132725300400000,NW 332,Residential,100,0,100,0,0,100
132725400100000,NW 332,Residential,38760,0,38760,293242,0,332002
132725400200000,NW 332,Residential,38760,0,38760,216854,0,255614
132725400300000,NW 332,Residential,35853,0,35853,213657,0,249510
132725400400000,NW 332,Residential,35853,0,35853,7207,0,43060
132725400500000,NW 332,Residential,38760,0,38760,9459,0,48219
132725400600000,NW 332,Residential,33915,0,33915,182565,0,216480
132725400700000,NW 332,Residential,38760,0,38760,241150,0,279910
132725400800000,NW 332,Residential,34561,0,34561,0,0,34561
132725400900000,NW 332,Residential,38651,0,38651,0,0,38651
132725401000000,NW 332,Residential,39026,0,39026,207361,0,246387
132725401100000,NW 332,Residential,47175,0,47175,216555,0,263730
132725401200000,NW 332,Residential,613,0,613,0,0,613
132725401300000,NW 332,Residential,512,0,512,0,0,512
132725401400000,NW 332,Residential,499,0,499,0,0,499
132725401500000,NW 332,Residential,474,0,474,0,0,474
132725401600000,NW 332,Residential,472,0,472,0,0,472
132725401700000,NW 332,Residential,502,0,502,0,0,502
132725401800000,NW 332,Residential,490,0,490,0,0,490
132725401900000,NW 332,Residential,472,0,472,0,0,472
132725402000000,NW 332,Residential,515,0,515,0,0,515
132725402100000,NW 332,Residential,490,0,490,0,0,490
132725402200000,NW 332,Residential,40698,0,40698,192046,0,232744
132725402300000,NW 332,Residential,502,0,502,0,0,502
132725500100000,NW 332,Residential,650,0,650,0,0,650
132725500200000,CITY PROPERTY,Exempt,0,0,0,0,0,0
132725500300000,NW 332,Residential,2150,0,2150,0,0,2150
132725500400000,NW 332,Residential,41396,0,41396,374197,0,415593
132725500500000,NW 332,Residential,50517,0,50517,309483,0,360000
132725500600000,NW 332,Residential,41119,0,41119,294668,0,335787
132725500700000,NW 332,Residential,43912,0,43912,266359,0,310271
132725500800000,NW 332,Residential,57665,0,57665,274081,0,331746
132725500900000,NW 332,Residential,846,0,846,0,0,846
132725501000000,NW 332,Residential,262,0,262,0,0,262
132725600100000,NW 332,Residential,464,0,464,0,0,464
132725600200000,NW 332,Residential,494,0,494,0,0,494
132725600300000,NW 332,Residential,38760,0,38760,4054,0,42814
132725600400000,NW 332,Residential,494,0,494,0,0,494
132725600500000,NW 332,Residential,440,0,440,0,0,440
132725600600000,NW 332,Residential,470,0,470,0,0,470
132725600700000,NW 332,Residential,482,0,482,0,0,482
132725600800000,NW 332,Residential,38760,0,38760,206141,0,244901
132725600900000,NW 332,Residential,458,0,458,0,0,458
132725601000000,NW 332,Residential,539,0,539,0,0,539
132725601100000,NW 332,Residential,45410,0,45410,213790,0,259200
132725601200000,NW 332,Residential,45788,0,45788,223897,0,269685
132725601300000,NW 332,Residential,41363,0,41363,324379,0,365742
132725601400000,NW 332,Residential,497,0,497,0,0,497
132725601500000,NW 332,Residential,33915,0,33915,196250,0,230165
132725601600000,NW 332,Residential,564,0,564,0,0,564
132725601700000,NW 332,Residential,172,0,172,0,0,172
132725601800000,CITY PROPERTY,Exempt,0,0,0,0,0,0
132727600100000,NW 332,Residential,32000,0,32000,183336,0,215336
132727600200000,NW 332,Residential,32000,0,32000,190973,0,222973
132727600300000,NW 332,Residential,32000,0,32000,155658,0,187658
132727600400000,NW 332,Residential,32000,0,32000,213317,0,245317
132727600500000,NW 332,Residential,32280,0,32280,202818,0,235098
132727700100000,NW 332,Residential,36044,0,36044,171905,0,207949
132727700200000,NW 332,Residential,30000,0,30000,178391,0,208391
132727700300000,NW 332,Residential,30000,0,30000,170902,0,200902
132727700500000,NW 332,Residential,30000,0,30000,148084,0,178084
132727700600000,NW 332,Residential,30000,0,30000,177206,0,207206
132727700700000,NW 332,Residential,36044,0,36044,235900,0,271944
132727800100000,NW 332,Residential,34272,0,34272,198526,0,232798
132727800200000,NW 332,Residential,35402,0,35402,195836,0,231238
132727800300000,NW 332,Residential,36512,0,36512,174607,0,211119
132727900100000,NW 332,Residential,36044,0,36044,168816,0,204860
132727900200000,NW 332,Residential,30000,0,30000,178423,0,208423
132727900300000,NW 332,Residential,30000,0,30000,168451,0,198451
132727900400000,NW 332,Residential,30235,0,30235,159264,0,189499
132727900500000,NW 332,Residential,30001,0,30001,181133,0,211134
132727900600000,NW 332,Residential,33467,0,33467,190194,0,223661
132727900700000,NW 332,Residential,42475,0,42475,217171,0,259646
132727900800000,NW 332,Residential,42750,0,42750,212844,0,255594
132727900900000,NW 332,Residential,42750,0,42750,210830,0,253580
132727901000000,NW 332,Residential,38000,0,38000,248480,0,286480
132727901100000,NW 332,Residential,39900,0,39900,255304,0,295204
132727901200000,NW 332,Residential,38950,0,38950,230718,0,269668
132727901300000,NW 332,Residential,40176,0,40176,275935,0,316111
132727901400000,NW 332,Residential,38000,0,38000,317975,0,355975
132727901500000,NW 332,Residential,38000,0,38000,240851,0,278851
132727901600000,NW 332,Residential,38000,0,38000,249465,0,287465
132728000100000,NW 332,Residential,30289,0,30289,175472,0,205761
132728000200000,NW 332,Residential,30626,0,30626,176560,0,207186
132728000300000,NW 332,Residential,27894,0,27894,180870,0,208764
132728000400000,NW 332,Residential,30706,0,30706,192137,0,222843
132728000500000,NW 332,Residential,30601,0,30601,178705,0,209306
132728000600000,NW 332,Residential,30338,0,30338,169547,0,199885
132728000700000,NW 332,Residential,32027,0,32027,172248,0,204275
132728000800000,NW 332,Residential,29255,0,29255,175729,0,204984
132728000900000,NW 332,Residential,32576,0,32576,185721,0,218297
132728001000000,NW 332,Residential,30305,0,30305,169112,0,199417
132728001100000,NW 332,Residential,30033,0,30033,169496,0,199529
132728001200000,NW 332,Residential,30815,0,30815,178743,0,209558
132728001300000,NW 332,Residential,33104,0,33104,176634,0,209738
132728001400000,NW 332,Residential,38760,0,38760,262007,0,300767
132728001500000,NW 332,Residential,38760,0,38760,194855,0,233615
132728001600000,NW 332,Residential,55718,0,55718,435284,0,491002
132728001700000,NW 332,Residential,42152,0,42152,275325,0,317477
132728001800000,NW 332,Residential,40698,0,40698,220186,0,260884
132728001900000,NW 332,Residential,41509,0,41509,294247,0,335756
132728002000000,NW 332,Residential,34533,0,34533,327202,0,361735
132728002100000,NW 332,Residential,32640,0,32640,195346,0,227986
132728002200000,NW 332,Residential,34272,0,34272,255741,0,290013
132728002300000,NW 332,Residential,35904,0,35904,224373,0,260277
132728002400000,NW 332,Residential,35904,0,35904,226532,0,262436
132728002500000,NW 332,Residential,35904,0,35904,266910,0,302814
132728002600000,NW 332,Residential,35643,0,35643,200505,0,236148
132728002700000,NW 332,Residential,40800,0,40800,289523,0,330323
132728002800000,NW 332,Residential,613,0,613,0,0,613
132728100100000,NW 332,Residential,32157,0,32157,164350,0,196507
132728100200000,NW 332,Residential,32886,0,32886,211557,0,244443
132728100300000,NW 332,Residential,29584,0,29584,141508,0,171092
132728100400000,NW 332,Residential,31312,0,31312,172818,0,204130
132728100500000,NW 332,Residential,31173,0,31173,207019,0,238192
132728100600000,NW 332,Residential,31680,0,31680,183299,0,214979
132728100800000,NW 332,Residential,34353,0,34353,178912,0,213265
132728100900000,NW 332,Residential,34109,0,34109,235425,0,269534
132728101000000,NW 332,Residential,34109,0,34109,191767,0,225876
132728101100000,NW 332,Residential,34109,0,34109,197139,0,231248
132728101200000,NW 332,Residential,32558,0,32558,256772,0,289330
132728101300000,NW 332,Residential,32640,0,32640,166883,0,199523
132728101400000,NW 332,Residential,34015,0,34015,146280,0,180295
132728101500000,NW 332,Residential,462,0,462,0,0,462
132728101600000,NW 332,Residential,476,0,476,0,0,476
132728101700000,NW 332,Residential,476,0,476,0,0,476
132728200100000,NW 332,Residential,45866,0,45866,202681,0,248547
132728200200000,NW 332,Residential,581,0,581,0,0,581
132740100100000,NW 331,Residential,34030,0,34030,0,0,34030
132740100200000,NW 331,Residential,31200,0,31200,114601,0,145801
132740100300000,NW 331,Residential,31241,0,31241,126161,0,157402
132740100400000,NW 331,Residential,32211,0,32211,131497,0,163708
132740100500000,NW 331,Residential,27064,0,27064,161236,0,188300
132740100600000,NW 331,Residential,26505,0,26505,126790,0,153295
132740100700000,NW 331,Residential,30400,0,30400,146774,0,177174
132740100800000,NW 331,Residential,32105,0,32105,158936,0,191041
132740100900000,NW 331,Residential,35708,0,35708,132542,0,168250
132740101000000,NW 331,Residential,34784,0,34784,143875,0,178659
132740101100000,NW 331,Residential,29116,0,29116,141663,0,170779
132740101200000,NW 331,Residential,34272,0,34272,143192,0,177464
132740101300000,NW 331,Residential,31072,0,31072,161473,0,192545
132740101400000,NW 331,Residential,37962,0,37962,147658,0,185620
132740101500000,NW 331,Residential,36680,0,36680,146675,0,183355
132740101600000,NW 332,Residential,32850,0,32850,180276,0,213126
132740101700000,NW 332,Residential,33334,0,33334,189225,0,222559
132740101800000,NW 332,Residential,30704,0,30704,173681,0,204385
132740101900000,NW 332,Residential,30704,0,30704,218754,0,249458
132740102000000,NW 332,Residential,32400,0,32400,193961,0,226361
132740102100000,NW 332,Residential,33197,0,33197,207944,0,241141
132740102200000,NW 332,Residential,30704,0,30704,175927,0,206631
132740102300000,NW 332,Residential,33253,0,33253,211747,0,245000
132740102400000,NW 332,Residential,30704,0,30704,165247,0,195951
132740102500000,NW 332,Residential,33048,0,33048,193107,0,226155
132740102600000,NW 332,Residential,33600,0,33600,162460,0,196060
132740102700000,NW 332,Residential,32685,0,32685,173702,0,206387
132740102800000,NW 332,Residential,32685,0,32685,187874,0,220559
132740102900000,NW 332,Residential,31949,0,31949,169788,0,201737
132740103000000,NW 332,Residential,33048,0,33048,198782,0,231830
132740103100000,NW 332,Residential,33048,0,33048,187744,0,220792
132740103200000,NW 332,Residential,30688,0,30688,182930,0,213618
132740103400000,SCHOOL,Exempt,0,585090,585090,0,2086494,2671584
132740103500000,CITY PROPERTY,Exempt,0,0,0,0,0,0
132740200100000,NW 332,Residential,32980,0,32980,193894,0,226874
132740200200000,NW 332,Residential,31680,0,31680,174154,0,205834
132740200300000,NW 332,Residential,35134,0,35134,167098,0,202232
132740300100000,NW 332,Residential,32980,0,32980,206294,0,239274
132740300200000,NW 332,Residential,32476,0,32476,179493,0,211969
132740300300000,NW 332,Residential,9059,0,9059,0,0,9059
132740300400000,NW 332,Residential,31666,0,31666,170862,0,202528
132740300500000,NW 332,Residential,32980,0,32980,205165,0,238145
132740300600000,NW 332,Residential,31680,0,31680,175086,0,206766
132740400100000,NW 332,Residential,32335,0,32335,222129,0,254464
132740400200000,NW 332,Residential,29066,0,29066,165360,0,194426
132740400300000,NW 332,Residential,31902,0,31902,185913,0,217815
132740400400000,NW 332,Residential,1426,0,1426,0,0,1426
132740400500000,NW 332,Residential,3627,0,3627,0,0,3627
132740400600000,NW 332,Residential,31600,0,31600,182531,0,214131
132740400700000,NW 332,Residential,30553,0,30553,166220,0,196773
132740400800000,NW 332,Residential,31360,0,31360,175597,0,206957
132740400900000,NW 332,Residential,33209,0,33209,190795,0,224004
132740401000000,NW 332,Residential,31530,0,31530,167437,0,198967
132740500100000,NW 332,Residential,31957,0,31957,183600,0,215557
132740500200000,NW 332,Residential,32000,0,32000,167540,0,199540
132740500300000,NW 332,Residential,28044,0,28044,176409,0,204453
132740500400000,NW 332,Residential,30541,0,30541,164168,0,194709
132740500500000,NW 332,Residential,30984,0,30984,203319,0,234303
132740500600000,NW 332,Residential,1227,0,1227,0,0,1227
132742600100000,NW 332,Residential,34484,0,34484,170920,0,205404
132742600200000,NW 332,Residential,31984,0,31984,186617,0,218601
132742600300000,NW 332,Residential,31991,0,31991,168471,0,200462
132742600400000,NW 332,Residential,31088,0,31088,197131,0,228219
132742600500000,NW 332,Residential,32640,0,32640,183881,0,216521
132742600600000,NW 332,Residential,31008,0,31008,182492,0,213500
132742600700000,NW 332,Residential,32640,0,32640,205756,0,238396
132742600800000,NW 332,Residential,31008,0,31008,182424,0,213432
132742600900000,NW 332,Residential,31008,0,31008,217680,0,248688
132742601000000,NW 332,Residential,32640,0,32640,203028,0,235668
132742601100000,NW 332,Residential,31008,0,31008,165965,0,196973
132742601200000,NW 332,Residential,33452,0,33452,163179,0,196631
132742601300000,NW 332,Residential,33003,0,33003,178953,0,211956
132742601400000,NW 332,Residential,31063,0,31063,160138,0,191201
132742601500000,NW 332,Residential,33170,0,33170,193612,0,226782
132742700100000,CITY PROPERTY,Exempt,0,0,0,0,0,0
132742700200000,NW 332,Residential,45475,0,45475,232719,0,278194
132742700300000,NW 332,Residential,40626,0,40626,185147,0,225773
132742700400000,NW 332,Residential,40459,0,40459,186284,0,226743
132742700500000,NW 332,Residential,41895,0,41895,188669,0,230564
132742700600000,NW 332,Residential,41097,0,41097,171775,0,212872
132742700700000,NW 332,Residential,47701,0,47701,189691,0,237392
132742700800000,NW 332,Residential,44640,0,44640,194462,0,239102
132742700900000,NW 338,Residential,55268,0,55268,189732,0,245000
132742701000000,NW 338,Residential,52800,0,52800,187755,0,240555
132742701100000,NW 338,Residential,56100,0,56100,189204,0,245304
132742701200000,NW 338,Residential,52800,0,52800,195667,0,248467
132742701300000,NW 338,Residential,56100,0,56100,256790,0,312890
132742701400000,NW 338,Residential,52800,0,52800,208663,0,261463
132742701500000,NW 338,Residential,56100,0,56100,187995,0,244095
132742800100000,NW 332,Residential,32115,0,32115,161991,0,194106
132742800200000,NW 332,Residential,31385,0,31385,165094,0,196479
132742800300000,NW 332,Residential,32377,0,32377,207163,0,239540
132742800400000,NW 332,Residential,32300,0,32300,201548,0,233848
132742800500000,NW 332,Residential,30000,0,30000,166583,0,196583
132742800600000,NW 332,Residential,31920,0,31920,215344,0,247264
132742800700000,NW 332,Residential,30400,0,30400,179012,0,209412
132742800800000,NW 332,Residential,32000,0,32000,191745,0,223745
132742800900000,NW 332,Residential,32000,0,32000,187845,0,219845
132742801000000,NW 332,Residential,30400,0,30400,192849,0,223249
132742801100000,NW 332,Residential,33525,0,33525,206998,0,240523
132742801200000,NW 332,Residential,43481,0,43481,194722,0,238203
132742801300000,NW 332,Residential,38634,0,38634,184773,0,223407
132742801400000,NW 332,Residential,37558,0,37558,194368,0,231926
132742801500000,NW 332,Residential,42666,0,42666,171569,0,214235
132742801600000,NW 332,Residential,53222,0,53222,214626,0,267848
132742801700000,NW 332,Residential,33769,0,33769,242859,0,276628
132742801800000,NW 332,Residential,31172,0,31172,167354,0,198526
132742801900000,NW 332,Residential,32000,0,32000,190831,0,222831
132742802000000,NW 332,Residential,31200,0,31200,189449,0,220649
132742802100000,NW 332,Residential,32000,0,32000,196747,0,228747
132742802200000,NW 332,Residential,32000,0,32000,163925,0,195925
132742802300000,NW 332,Residential,31920,0,31920,216362,0,248282
132742802400000,NW 332,Residential,30400,0,30400,143261,0,173661
132742802500000,NW 332,Residential,31034,0,31034,177985,0,209019
132742802600000,NW 332,Residential,30483,0,30483,195330,0,225813
132742802700000,NW 332,Residential,32879,0,32879,186009,0,218888
132742900100000,NW 332,Residential,31467,0,31467,180335,0,211802
132742900200000,NW 332,Residential,33397,0,33397,203894,0,237291
132742900300000,NW 332,Residential,30612,0,30612,170465,0,201077
132742900400000,NW 332,Residential,31920,0,31920,194643,0,226563
132742900500000,NW 332,Residential,28800,0,28800,169849,0,198649
132742900600000,NW 332,Residential,32000,0,32000,202024,0,234024
132742900700000,NW 332,Residential,30400,0,30400,181653,0,212053
132742900800000,NW 332,Residential,31600,0,31600,162194,0,193794
132742900900000,NW 332,Residential,35054,0,35054,179471,0,214525
132742901000000,NW 332,Residential,35378,0,35378,202814,0,238192
132742901100000,NW 338,Residential,56101,0,56101,190837,0,246938
132742901200000,NW 332,Residential,373,0,373,0,0,373
132743000100000,NW 332,Residential,51096,0,51096,187975,0,239071
132743000200000,NW 332,Residential,46200,0,46200,196351,0,242551
132743000300000,NW 332,Residential,51520,0,51520,197556,0,249076
132743000400000,NW 338,Residential,51720,0,51720,176824,0,228544
132743000500000,NW 338,Residential,49500,0,49500,149394,0,198894
132743000600000,NW 338,Residential,53295,0,53295,212222,0,265517
132743000700000,NW 338,Residential,52800,0,52800,203852,0,256652
132743000800000,NW 338,Residential,49500,0,49500,170597,0,220097
132743000900000,NW 338,Residential,53295,0,53295,221452,0,274747
132743001000000,NW 338,Residential,52800,0,52800,190646,0,243446
132743001100000,NW 338,Residential,49950,0,49950,178472,0,228422
132743001200000,NW 338,Residential,49950,0,49950,135527,0,185477
132743001300000,NW 338,Residential,53147,0,53147,212478,0,265625
132743001400000,NW 338,Residential,53280,0,53280,223550,0,276830
132743001500000,NW 338,Residential,49284,0,49284,187843,0,237127
132743001600000,NW 338,Residential,53280,0,53280,202859,0,256139
132743001700000,NW 338,Residential,49284,0,49284,179885,0,229169
132743100100000,NW 338,Residential,55773,0,55773,229599,0,285372
132743100200000,NW 338,Residential,53922,0,53922,210099,0,264021
132743100300000,NW 338,Residential,54120,0,54120,223367,0,277487
132743100400000,NW 338,Residential,53295,0,53295,274638,0,327933
132743100500000,NW 338,Residential,53295,0,53295,229105,0,282400
132745100200000,NW 338,Residential,52668,0,52668,284017,0,336685
132745100300000,NW 332,Residential,54032,0,54032,222088,0,276120
132745200100000,NW 338,Residential,49950,0,49950,176332,0,226282
132745200200000,NW 338,Residential,52800,0,52800,212880,0,265680
132745200500000,NW 332,Residential,49057,0,49057,230034,0,279091
132745200600000,NW 332,Residential,50526,0,50526,227448,0,277974
132745300100000,NW 338,Residential,53288,0,53288,182864,0,236152
132745300300000,NW 332,Residential,140,0,140,0,0,140
132745300400000,NW 332,Residential,50021,0,50021,213929,0,263950
132745400100000,NW 332,Residential,48600,0,48600,286801,0,335401
132745400200000,NW 332,Residential,48000,0,48000,198383,0,246383
132745400300000,NW 332,Residential,42000,0,42000,171821,0,213821
132745400400000,NW 332,Residential,48000,0,48000,290938,0,338938
132745400500000,NW 332,Residential,42000,0,42000,171019,0,213019
132745400600000,NW 332,Residential,48000,0,48000,219404,0,267404
132745400700000,NW 332,Residential,46200,0,46200,182664,0,228864
132745400800000,NW 332,Residential,46800,0,46800,172967,0,219767
132745400900000,NW 332,Residential,48000,0,48000,198046,0,246046
132745401000000,NW 332,Residential,49208,0,49208,194905,0,244113
132745500100000,NW 332,Residential,50722,0,50722,228531,0,279253
132745500200000,NW 332,Residential,49086,0,49086,204416,0,253502
132745500300000,NW 332,Residential,39996,0,39996,179878,0,219874
132745500400000,NW 332,Residential,48480,0,48480,226801,0,275281
132745500500000,NW 332,Residential,48480,0,48480,236239,0,284719
132745500600000,NW 332,Residential,48480,0,48480,206645,0,255125
132745500700000,NW 332,Residential,39996,0,39996,165031,0,205027
132745500800000,NW 332,Residential,42420,0,42420,195318,0,237738
132745500900000,NW 332,Residential,48480,0,48480,216897,0,265377
132745501000000,NW 332,Residential,48501,0,48501,170863,0,219364
132745501100000,NW 332,Residential,48564,0,48564,279316,0,327880
132745501200000,NW 332,Residential,48165,0,48165,284591,0,332756
132745501300000,NW 332,Residential,46200,0,46200,194844,0,241044
132745501400000,NW 332,Residential,50100,0,50100,213764,0,263864
132745501500000,NW 332,Residential,50400,0,50400,226208,0,276608
132745501600000,NW 332,Residential,48000,0,48000,206868,0,254868
132745501700000,NW 332,Residential,49020,0,49020,206612,0,255632
132745501800000,NW 332,Residential,48600,0,48600,206298,0,254898
132745600100000,NW 332,Residential,50838,0,50838,172730,0,223568
132745600200000,NW 332,Residential,46800,0,46800,149695,0,196495
132745600300000,NW 332,Residential,51642,0,51642,180344,0,231986
132745600400000,NW 332,Residential,49498,0,49498,170780,0,220278
132745600500000,NW 332,Residential,50616,0,50616,191615,0,242231
132745600600000,NW 332,Residential,44601,0,44601,158327,0,202928
132745600700000,NW 332,Residential,50223,0,50223,178580,0,228803
132745600800000,NW 332,Residential,49457,0,49457,216410,0,265867
132745700100000,NW 332,Residential,50787,0,50787,258635,0,309422
132745700200000,NW 332,Residential,45144,0,45144,196061,0,241205
132745700300000,NW 332,Residential,49896,0,49896,197834,0,247730
132745700400000,NW 332,Residential,46629,0,46629,166188,0,212817
132745700500000,NW 332,Residential,50193,0,50193,284968,0,335161
132745700600000,NW 332,Residential,47520,0,47520,174196,0,221716
132745700700000,NW 332,Residential,47520,0,47520,268689,0,316209
132745700800000,NW 332,Residential,48632,0,48632,209481,0,258113
132747600100000,NW 332,Residential,36720,0,36720,0,0,36720
132747600200000,NW 332,Residential,34560,0,34560,0,0,34560
132747600300000,NW 332,Residential,34685,0,34685,0,0,34685
132747600400000,NW 332,Residential,33653,0,33653,159865,0,193518
132747600500000,NW 332,Residential,32585,0,32585,289220,0,321805
132747600600000,NW 332,Residential,32320,0,32320,240887,0,273207
132747600700000,NW 332,Residential,31507,0,31507,206135,0,237642
132747600800000,NW 332,Residential,30400,0,30400,194539,0,224939
132747600900000,NW 332,Residential,31599,0,31599,172842,0,204441
132747601000000,NW 332,Residential,33314,0,33314,204844,0,238158
132747700100000,NW 332,Residential,32014,0,32014,160142,0,192156
132747700200000,NW 332,Residential,30785,0,30785,199176,0,229961
132747700300000,NW 332,Residential,29299,0,29299,151856,0,181155
132747700400000,NW 332,Residential,32845,0,32845,158811,0,191656
132747800100000,NW 332,Residential,34272,0,34272,0,0,34272
132747800200000,NW 332,Residential,31855,0,31855,0,0,31855
132747800300000,NW 332,Residential,33419,0,33419,0,0,33419
132747800400000,NW 332,Residential,35021,0,35021,0,0,35021
132747800500000,NW 332,Residential,33004,0,33004,0,0,33004
132747800600000,NW 332,Residential,33040,0,33040,0,0,33040
132747800700000,NW 332,Residential,33920,0,33920,188105,0,222025
132747800800000,NW 332,Residential,31108,0,31108,175801,0,206909
132747800900000,NW 332,Residential,34668,0,34668,208974,0,243642
132747801000000,NW 332,Residential,33835,0,33835,161814,0,195649
132747801100000,NW 332,Residential,31708,0,31708,178174,0,209882
132747801200000,NW 332,Residential,32640,0,32640,161209,0,193849
132747801300000,WAREHOUSE,Commercial,0,431539,431539,0,643461,1075000
132747801400000,NW 332,Residential,31008,0,31008,171551,0,202559
132747801500000,NW 332,Residential,33275,0,33275,212380,0,245655
132747801700000,NW 332,Residential,36704,0,36704,186678,0,223382
132747801800000,NW 332,Residential,33279,0,33279,188956,0,222235
132747801900000,NW 332,Residential,32640,0,32640,193313,0,225953
132747802000000,NW 332,Residential,31008,0,31008,148690,0,179698
132747802100000,NW 332,Residential,32558,0,32558,191928,0,224486
132747802200000,NW 332,Residential,31008,0,31008,149796,0,180804
132747802300000,NW 332,Residential,28429,0,28429,193389,0,221818
132747802400000,NW 332,Residential,35345,0,35345,170360,0,205705
132747802500000,NW 332,Residential,36335,0,36335,206781,0,243116
132747802600000,NW 332,Residential,30096,0,30096,183511,0,213607
132747802700000,NW 332,Residential,31680,0,31680,212361,0,244041
132747802800000,NW 332,Residential,36130,0,36130,227221,0,263351
132747802900000,NW 332,Residential,33922,0,33922,191511,0,225433
132747803000000,NW 332,Residential,32467,0,32467,177485,0,209952
132747803100000,NW 332,Residential,32205,0,32205,194825,0,227030
132747803200000,NW 332,Residential,30879,0,30879,196211,0,227090
132747803300000,NW 332,Residential,31343,0,31343,185973,0,217316
132747803400000,NW 332,Residential,33213,0,33213,172900,0,206113
132747803500000,NW 332,Residential,33523,0,33523,168040,0,201563
132747803600000,NW 332,Residential,29322,0,29322,147494,0,176816
132747803700000,NW 332,Residential,30492,0,30492,207445,0,237937
132747803800000,NW 332,Residential,29753,0,29753,200868,0,230621
132747803900000,NW 332,Residential,30347,0,30347,171877,0,202224
132747804000000,NW 332,Residential,31020,0,31020,181257,0,212277
132747804100000,NW 332,Residential,32413,0,32413,209466,0,241879
132747804200000,SHOP,Commercial,0,304560,304560,0,573317,877877
132747804300000,NW 332,Residential,42500,0,42500,105892,0,148392
132747900100000,NW 332,Residential,34053,0,34053,168637,0,202690
132747900200000,NW 332,Residential,32267,0,32267,180553,0,212820
132747900300000,NW 332,Residential,33333,0,33333,187332,0,220665
132747900400000,NW 332,Residential,32459,0,32459,159217,0,191676
132747900500000,NW 332,Residential,35016,0,35016,210498,0,245514
132747900600000,NW 332,Residential,31825,0,31825,188915,0,220740
132747900700000,NW 332,Residential,30096,0,30096,222732,0,252828
132747900800000,NW 332,Residential,30096,0,30096,153430,0,183526
132747900900000,NW 332,Residential,29792,0,29792,187298,0,217090
132747901000000,NW 332,Residential,31954,0,31954,147810,0,179764
132747901100000,NW 332,Residential,30324,0,30324,159906,0,190230
133410100100000,BARS/LOUNGE,Commercial,0,316354,316354,0,199163,515517
133430100100000,SW 432,Ag Land,64013,0,64013,0,0,64013
133440100100000,SW 432,Ag Land,62507,0,62507,0,0,62507
133440100200000,SW 454,Residential,99000,0,99000,146448,0,245448
133442600100000,SW 432,Ag Land,68051,0,68051,0,0,68051
133445100100000,SW 432,Ag Land,29675,0,29675,0,0,29675
133447600100000,SW 432,Ag Land,43112,0,43112,0,0,43112
133447600200000,STATE PROPERTY,Other,0,0,0,0,0,0
133510100100000,RESTAURANT,Exempt,0,292032,292032,0,378963,670995
133510100200000,VACANT LAND,Commercial,0,129924,129924,0,0,129924
133510100300000,WAREHOUSE;MINI STORG,Commercial,0,294624,294624,0,746809,1041433
133510100400000,WAREHOUSE,Commercial,0,295272,295272,0,476077,771349
133510100500000,PRINTING,Industrial,0,222912,222912,0,1160904,1383816
133510100600000,AUTO REPAIR/SALES,Commercial,0,207900,207900,0,356070,563970
133510100700000,SHOP,Exempt,0,93312,93312,0,334181,427493
133510200100000,WAREHOUSE,Commercial,0,172368,172368,0,744998,917366
133510200200000,SHOP,Commercial,0,114696,114696,0,487256,601952
133510200300000,SHOP,Commercial,0,114696,114696,0,308624,423320
133510200400000,WAREHOUSE,Commercial,0,114696,114696,0,291717,406413
133510200500000,SHOP,Commercial,0,141162,141162,0,131304,272466
133510200600000,VACANT LAND,Commercial,0,153792,153792,0,0,153792
133510200700000,VACANT LAND,Commercial,0,115344,115344,0,0,115344
133510200800000,OFFICE,Commercial,0,138105,138105,0,71336,209441
133510200900000,WAREHOUSE,Commercial,0,145541,145541,0,384903,530444
133512600100000,AUTO REPAIR/SALES,Commercial,0,232200,232200,0,338517,570717
133512600200000,CONVERSION,Commercial,0,54000,54000,0,132808,186808
133512600300000,SW 407,Residential,48000,0,48000,130977,0,178977
133512600400000,WAREHOUSE,Commercial,0,54000,54000,0,180666,234666
133512600500000,EQUIPMENT MFG;INDUST,Industrial,0,383405,383405,0,1003204,1386609
133512600700000,SHOP,Commercial,0,351216,351216,0,257942,609158
133512600800000,SW 407,Ag Land,20988,0,20988,0,0,20988
133512600900000,FLAT PARKING,Industrial,0,21060,21060,0,0,21060
133512601000000,FRATERNAL,Exempt,0,166752,166752,0,190073,356825
133512601100000,VACANT LAND,Commercial,0,97686,97686,0,0,97686
133512601200000,SHOP,Commercial,0,187488,187488,0,94706,282194
133512601300000,SHOP,Commercial,0,67910,67910,0,159919,227829
133515100100000,SW 407,Ag Land,62169,0,62169,0,0,62169
133515100300000,WAREHOUSE,Commercial,0,225504,225504,0,180653,406157
133515100400000,SW 407,Residential,60250,0,60250,121747,0,181997
133517600100000,CITY PROPERTY,Exempt,0,0,0,0,0,0
133517600200000,SW 407,Ag Land,14183,0,14183,0,0,14183
133517600300000,AUTO REPAIR/SALES,Commercial,0,174528,174528,0,143024,317552
133517600400000,SW 407,Residential,54000,0,54000,87051,0,141051
133517600500000,WAREHOUSE;MINI STORG,Commercial,0,245052,245052,0,336962,582014
133517600600000,CENTRALLY ASSESSED,Other,0,0,0,0,0,0
133520100100000,SHOP,Commercial,0,217193,217193,0,254884,472077
133520100200000,SMALL RETAIL,Commercial,0,137214,137214,0,186055,323269
133520100300000,VACANT LAND,Commercial,0,10352,10352,0,0,10352
133520200100000,OFFICE,Commercial,0,91003,91003,0,281526,372529
133520200200000,WAREHOUSE,Commercial,0,90153,90153,0,55296,145449
133520200300000,OFFICE,Commercial,0,225990,225990,0,230732,456722
133520200400000,SHOP,Commercial,0,30715,30715,0,136049,166764
133520200500000,WAREHOUSE,Commercial,0,274752,274752,0,119397,394149
133520200600000,MFG HOME PARK,Commercial,0,48924,48924,0,26190,75114
133520200700000,SHOP,Commercial,0,151926,151926,0,227636,379562
133520200800000,CHURCH,Exempt,0,86400,86400,0,197162,283562
133522600100000,FLAT PARKING,Commercial,0,184356,184356,0,229824,414180
133522600200000,NW 332,Residential,54650,0,54650,133907,0,188557
133522600300000,NW 332,Residential,26892,0,26892,0,0,26892
133522600400000,CHURCH,Exempt,0,743580,743580,0,5374813,6118393
133527600100000,SW 407,Ag Land,31728,0,31728,0,0,31728
133527600200000,OFFICE,Commercial,0,1896480,1896480,0,498252,2394732
133530100100000,OFFICE,Commercial,0,3123576,3123576,0,2127715,5251291
133530100103000,MFG HOME PARK,Commercial,0,0,0,0,5776,5776
133530100103001,MFG HOME PARK,Commercial,0,0,0,0,4849,4849
133530100103002,MFG HOME PARK,Commercial,0,0,0,0,5051,5051
133530100103003,MFG HOME PARK,Commercial,0,0,0,0,7577,7577
133530100103004,MFG HOME PARK,Commercial,0,0,0,0,7122,7122
133530100103005,MFG HOME PARK,Commercial,0,0,0,0,6567,6567
133530100103006,MFG HOME PARK,Commercial,0,0,0,0,6567,6567
133530100103007,MFG HOME PARK,Commercial,0,0,0,0,5001,5001
133530100103008,MFG HOME PARK,Commercial,0,0,0,0,6567,6567
133530100103009,MFG HOME PARK,Commercial,0,0,0,0,5910,5910
133530100103010,MFG HOME PARK,Commercial,0,0,0,0,6716,6716
133530100103011,MFG HOME PARK,Commercial,0,0,0,0,6716,6716
133530100103012,MFG HOME PARK,Commercial,0,0,0,0,6716,6716
133530100103013,MFG HOME PARK,Commercial,0,0,0,0,7387,7387
133530100103014,MFG HOME PARK,Commercial,0,0,0,0,6716,6716
133530100103015,MFG HOME PARK,Commercial,0,0,0,0,8059,8059
133530100103016,MFG HOME PARK,Commercial,0,0,0,0,6044,6044
133530100103017,MFG HOME PARK,Commercial,0,0,0,0,7552,7552
133530100103018,MFG HOME PARK,Commercial,0,0,0,0,5228,5228
133530100103019,MFG HOME PARK,Commercial,0,0,0,0,7393,7393
133530100103020,MFG HOME PARK,Commercial,0,0,0,0,7552,7552
133530100103021,MFG HOME PARK,Commercial,0,0,0,0,6178,6178
133530100103022,MFG HOME PARK,Commercial,0,0,0,0,5228,5228
133530100103023,MFG HOME PARK,Commercial,0,0,0,0,4753,4753
133530100103024,MFG HOME PARK,Commercial,0,0,0,0,6178,6178
133530100103025,MFG HOME PARK,Commercial,0,0,0,0,6653,6653
133530100103026,MFG HOME PARK,Commercial,0,0,0,0,5228,5228
133530100103027,MFG HOME PARK,Commercial,0,0,0,0,5228,5228
133530100103028,MFG HOME PARK,Commercial,0,0,0,0,5069,5069
133530100103029,MFG HOME PARK,Commercial,0,0,0,0,7770,7770
133530100103030,MFG HOME PARK,Commercial,0,0,0,0,5935,5935
133530100103031,MFG HOME PARK,Commercial,0,0,0,0,5342,5342
133530100103032,MFG HOME PARK,Commercial,0,0,0,0,7715,7715
133530100103033,MFG HOME PARK,Commercial,0,0,0,0,5342,5342
133530100103034,MFG HOME PARK,Commercial,0,0,0,0,7122,7122
133530100103035,MFG HOME PARK,Commercial,0,0,0,0,5099,5099
133530100103036,MFG HOME PARK,Commercial,0,0,0,0,7313,7313
133530100103037,MFG HOME PARK,Commercial,0,0,0,0,5822,5822
133530100103038,MFG HOME PARK,Commercial,0,0,0,0,5455,5455
133530100103039,MFG HOME PARK,Commercial,0,0,0,0,7426,7426
133530100103040,MFG HOME PARK,Commercial,0,0,0,0,7426,7426
133530100103041,MFG HOME PARK,Commercial,0,0,0,0,6750,6750
133530100103042,MFG HOME PARK,Commercial,0,0,0,0,5569,5569
133530100103043,MFG HOME PARK,Commercial,0,0,0,0,5175,5175
133530100103044,MFG HOME PARK,Commercial,0,0,0,0,6075,6075
133530100103045,MFG HOME PARK,Commercial,0,0,0,0,7426,7426
133530100103046,MFG HOME PARK,Commercial,0,0,0,0,8775,8775
133530100103047,MFG HOME PARK,Commercial,0,0,0,0,5400,5400
133530100103048,MFG HOME PARK,Commercial,0,0,0,0,7313,7313
133530100103049,MFG HOME PARK,Commercial,0,0,0,0,6750,6750
133530100103050,MFG HOME PARK,Commercial,0,0,0,0,9281,9281
133530100103051,MFG HOME PARK,Commercial,0,0,0,0,6075,6075
133530100103052,MFG HOME PARK,Commercial,0,0,0,0,6581,6581
133530100103053,MFG HOME PARK,Commercial,0,0,0,0,8044,8044
133530100103054,MFG HOME PARK,Commercial,0,0,0,0,6750,6750
133530100103056,MFG HOME PARK,Commercial,0,0,0,0,5171,5171
133530100103057,MFG HOME PARK,Commercial,0,0,0,0,7312,7312
133530100103058,MFG HOME PARK,Commercial,0,0,0,0,7443,7443
133530100103059,MFG HOME PARK,Commercial,0,0,0,0,7496,7496
133530100103061,MFG HOME PARK,Commercial,0,0,0,0,7443,7443
133530100103062,MFG HOME PARK,Commercial,0,0,0,0,6947,6947
133530100103063,MFG HOME PARK,Commercial,0,0,0,0,5171,5171
133530100103064,MFG HOME PARK,Commercial,0,0,0,0,7678,7678
133530100103065,MFG HOME PARK,Commercial,0,0,0,0,6111,6111
133530100103066,MFG HOME PARK,Commercial,0,0,0,0,6451,6451
133530100103067,MFG HOME PARK,Commercial,0,0,0,0,5171,5171
133530100103068,MFG HOME PARK,Commercial,0,0,0,0,6750,6750
133530100103069,MFG HOME PARK,Commercial,0,0,0,0,9113,9113
133530100103070,MFG HOME PARK,Commercial,0,0,0,0,8100,8100
133530100103072,MFG HOME PARK,Commercial,0,0,0,0,6750,6750
133530100103073,MFG HOME PARK,Commercial,0,0,0,0,5879,5879
133530100103074,MFG HOME PARK,Commercial,0,0,0,0,9619,9619
133530100103075,MFG HOME PARK,Commercial,0,0,0,0,7426,7426
133530100103076,MFG HOME PARK,Commercial,0,0,0,0,5625,5625
133530100103077,MFG HOME PARK,Commercial,0,0,0,0,7426,7426
133530100103078,MFG HOME PARK,Commercial,0,0,0,0,11475,11475
133530100103079,MFG HOME PARK,Commercial,0,0,0,0,4510,4510
133530100103080,MFG HOME PARK,Commercial,0,0,0,0,9409,9409
133530100103082,MFG HOME PARK,Commercial,0,0,0,0,6750,6750
133530100103083,MFG HOME PARK,Commercial,0,0,0,0,4332,4332
133530100103084,MFG HOME PARK,Commercial,0,0,0,0,8438,8438
133530100103085,MFG HOME PARK,Commercial,0,0,0,0,6750,6750
133530100103086,MFG HOME PARK,Commercial,0,0,0,0,7600,7600
133530100103087,MFG HOME PARK,Commercial,0,0,0,0,7858,7858
133530100103088,MFG HOME PARK,Commercial,0,0,0,0,8227,8227
133530100103089,MFG HOME PARK,Commercial,0,0,0,0,4950,4950
133530100103091,MFG HOME PARK,Commercial,0,0,0,0,7216,7216
133530100103092,MFG HOME PARK,Commercial,0,0,0,0,8775,8775
133530100103093,MFG HOME PARK,Commercial,0,0,0,0,6757,6757
133530100103094,MFG HOME PARK,Commercial,0,0,0,0,6450,6450
133530100103095,MFG HOME PARK,Commercial,0,0,0,0,4410,4410
133530100103096,MFG HOME PARK,Commercial,0,0,0,0,8599,8599
133532600100000,WAREHOUSE,Commercial,0,537476,537476,0,413294,950770
133532600103000,MFG HOME PARK,Commercial,0,0,0,0,8775,8775
133532600103001,MFG HOME PARK,Commercial,0,0,0,0,6075,6075
133532600103002,MFG HOME PARK,Commercial,0,0,0,0,8438,8438
133532600103003,MFG HOME PARK,Commercial,0,0,0,0,7875,7875
133532600103004,MFG HOME PARK,Commercial,0,0,0,0,6413,6413
133532600103005,MFG HOME PARK,Commercial,0,0,0,0,8044,8044
133532600103006,MFG HOME PARK,Commercial,0,0,0,0,7313,7313
133532600103007,MFG HOME PARK,Commercial,0,0,0,0,5625,5625
133532600103008,MFG HOME PARK,Commercial,0,0,0,0,8775,8775
133532600103009,MFG HOME PARK,Commercial,0,0,0,0,8775,8775
133532600103022,MFG HOME PARK,Commercial,0,0,0,0,6013,6013
133532600103068,MFG HOME PARK,Commercial,0,0,0,0,7313,7313
133532600300000,SW 454,Residential,122550,0,122550,0,0,122550
133535100200000,SW 454,Residential,29750,0,29750,130828,0,160578
133535100300000,SW 454,Residential,29750,0,29750,131568,0,161318
133535100400000,SW 454,Residential,29750,0,29750,157160,0,186910
133535100500000,SW 454,Residential,29750,0,29750,130495,0,160245
133535100600000,SW 454,Residential,29750,0,29750,116534,0,146284
133535100700000,SW 454,Residential,29750,0,29750,117410,0,147160
133535100800000,SW 454,Residential,29750,0,29750,118010,0,147760
133535100900000,SW 454,Residential,30299,0,30299,115678,0,145977
133535101000000,SW 454,Residential,42046,0,42046,0,0,42046
133535101100000,SW 454,Residential,46842,0,46842,119690,0,166532
133535200100000,SW 454,Residential,30481,0,30481,232294,0,262775
133535200200000,SW 454,Residential,30706,0,30706,109506,0,140212
133535200300000,SW 454,Residential,32310,0,32310,172056,0,204366
133535200400000,SW 407,Residential,92840,0,92840,0,0,92840
133535200500000,SW 454,Residential,44313,0,44313,0,0,44313
133535200600000,SW 454,Residential,45747,0,45747,169233,0,214980
133535200700000,SW 454,Residential,29750,0,29750,0,0,29750
133535200800000,SW 454,Residential,29750,0,29750,135497,0,165247
133535200900000,SW 454,Residential,29750,0,29750,156462,0,186212
133535201000000,SW 454,Residential,29750,0,29750,168097,0,197847
133535201100000,SW 454,Residential,29750,0,29750,181569,0,211319
133535300100000,SW 454,Residential,29750,0,29750,120027,0,149777
133535300200000,SW 454,Residential,29750,0,29750,133039,0,162789
133535300300000,SW 454,Residential,31784,0,31784,116008,0,147792
133535400100000,SW 454,Residential,29750,0,29750,142499,0,172249
133535400200000,SW 454,Residential,29750,0,29750,33893,0,63643
133535400300000,SW 454,Residential,29750,0,29750,0,0,29750
133535400400000,SW 454,Residential,29750,0,29750,125571,0,155321
133535400500000,SW 454,Residential,29750,0,29750,0,0,29750
133535400600000,SW 454,Residential,33021,0,33021,136811,0,169832
133535400700000,SW 454,Residential,36855,0,36855,116109,0,152964
133535400800000,SW 454,Residential,37237,0,37237,130072,0,167309
133535400900000,SW 454,Residential,40460,0,40460,0,0,40460
133535401000000,SW 454,Residential,29750,0,29750,151585,0,181335
133535401100000,SW 454,Residential,29750,0,29750,147829,0,177579
133535401200000,SW 454,Residential,29750,0,29750,119566,0,149316
133535401300000,SW 454,Residential,29750,0,29750,0,0,29750
133535500100000,SW 454,Residential,29750,0,29750,157032,0,186782
133535500200000,SW 454,Residential,29750,0,29750,143545,0,173295
133535500300000,SW 454,Residential,29750,0,29750,0,0,29750
133535500400000,SW 454,Residential,29750,0,29750,0,0,29750
133535500500000,SW 454,Residential,29750,0,29750,0,0,29750
133535500600000,SW 454,Residential,31592,0,31592,0,0,31592
133535500700000,SW 454,Residential,30047,0,30047,127847,0,157894
133535500800000,SW 454,Residential,39667,0,39667,114354,0,154021
133535500900000,SW 454,Residential,50122,0,50122,161801,0,211923
133535501000000,SW 454,Residential,48896,0,48896,165499,0,214395
133535501100000,SW 454,Residential,44510,0,44510,127990,0,172500
133537600100000,SW 407,Ag Land,72780,0,72780,0,0,72780
133540100100000,SW 407,Ag Land,63412,0,63412,0,3324,66736
133540100102000,SW 407,Residential,0,0,0,12192,0,12192
133545100100000,SW 407,Ag Land,65187,0,65187,0,2365,67552
133545100200000,SW 407,Residential,74400,0,74400,160956,0,235356
133547600100000,SW 407,Ag Land,62015,0,62015,0,0,62015
133610100100000,RESTAURANT,Commercial,0,259524,259524,0,246124,505648
133610100200000,VACANT LAND,Commercial,0,599400,599400,0,0,599400
133610100300000,MISCELLANEOUS,Exempt,0,122715,122715,0,19872,142587
133610100302000,BILLBOARD(BLL),Commercial,0,0,0,0,11260,11260
133610100400000,OFFICE,Exempt,0,296568,296568,0,1269168,1565736
133610100500000,MFG HOME PARK,Commercial,0,258417,258417,0,330883,589300
133610100600000,VACANT LAND,Commercial,0,33614,33614,0,0,33614
133610100700000,MFG HOME PARK,Commercial,0,33502,33502,0,630,34132
133610100800000,OFFICE,Exempt,0,67003,67003,0,296712,363715
133610100900000,WAREHOUSE,Commercial,0,83430,83430,0,201488,284918
133610101000000,SMALL RETAIL,Commercial,0,116122,116122,0,249620,365742
133610101100000,FAST FOOD,Commercial,0,226152,226152,0,149950,376102
133610200100000,MISCELLANEOUS,Commercial,0,191808,191808,0,23311,215119
133610200300000,SW 407,Ag Land,13240,0,13240,0,0,13240
133610200400000,GROCERY STORE,Commercial,0,631800,631800,0,893132,1524932
133610200500000,WAREHOUSE,Commercial,0,115776,115776,0,61690,177466
133610200600000,AUTO REPAIR/SALES,Commercial,0,38880,38880,0,62769,101649
133610200700000,FITNESS CENTER,Commercial,0,265248,265248,0,600359,865607
133610200800000,VACANT LAND,Commercial,0,11059,11059,0,0,11059
133612600100000,AUTO REPAIR/SALES,Commercial,0,187650,187650,0,252565,440215
133612600200000,PRINTING,Industrial,0,156600,156600,0,570059,726659
133612600300000,HOTEL,Commercial,0,184950,184950,0,682050,867000
133612600400000,MFG HOME PARK,Commercial,0,395280,395280,0,244608,639888
133612600500000,WAREHOUSE,Commercial,0,372060,372060,0,225561,597621
133612600502000,BILLBOARD(BLL),Commercial,0,0,0,0,53440,53440
133612600600000,SW 407,Residential,50750,0,50750,63965,0,114715
133612700100000,SW 407,Ag Land,27694,0,27694,0,0,27694
133615100200000,OFFICE,Commercial,0,121478,121478,0,322247,443725
133615100400000,APARTMENT,Commercial,0,15953,15953,0,159540,175493
133615100500000,APARTMENT,Commercial,0,15900,15900,0,147898,163798
133615100600000,APARTMENT,Commercial,0,15900,15900,0,156695,172595
133615100700000,APARTMENT,Commercial,0,15900,15900,0,109286,125186
133615100800000,APARTMENT,Commercial,0,15848,15848,0,109286,125134
133615100900000,APARTMENT,Commercial,0,15795,15795,0,118528,134323
133615101000000,APARTMENT,Commercial,0,15795,15795,0,117343,133138
133615101800000,APARTMENT,Commercial,0,15396,15396,0,126755,142151
133615102100000,APARTMENT,Commercial,0,15396,15396,0,121620,137016
133615102200000,APARTMENT,Commercial,0,15396,15396,0,127849,143245
133615102300000,APARTMENT,Commercial,0,15396,15396,0,127693,143089
133615102400000,APARTMENT,Commercial,0,15396,15396,0,120326,135722
133615102700000,OFFICE; MEDICAL,Commercial,0,257850,257850,0,242150,500000
133615102800000,FITNESS CENTER,Commercial,0,162000,162000,0,701657,863657
133615200200000,WAREHOUSE,Commercial,0,121770,121770,0,398764,520534
133615200300000,OFFICE,Commercial,0,121770,121770,0,376716,498486
133615200401000,OFFICE,Commercial,0,16056,16056,0,55562,71618
133615200401001,OFFICE,Commercial,0,16056,16056,0,55562,71618
133615200401002,OFFICE,Commercial,0,16056,16056,0,55562,71618
133615200401003,OFFICE,Commercial,0,16056,16056,0,55562,71618
133615200401004,OFFICE; MEDICAL,Commercial,0,14580,14580,0,51427,66007
133615200401005,OFFICE; MEDICAL,Commercial,0,14277,14277,0,50723,65000
133615200401006,OFFICE,Commercial,0,14277,14277,0,52245,66522
133615200401007,OFFICE,Commercial,0,14277,14277,0,52245,66522
133615200500000,NBHD SHOPPING CENTER,Commercial,0,147571,147571,0,492610,640181
133615200600000,OFFICE,Exempt,0,243540,243540,0,692629,936169
133615200800000,OFFICE; MEDICAL,Commercial,0,76982,76982,0,192163,269145
133617600200000,GROCERY STORE,Commercial,0,1263708,1263708,0,8379814,9643522
133617600400000,RESTAURANT,Commercial,0,274428,274428,0,481040,755468
133617600500000,BRANCH BANK/CU,Commercial,0,450360,450360,0,986107,1436467
133617600700000,FAST FOOD,Commercial,0,298728,298728,0,539996,838724
133617600800000,VACANT LAND,Commercial,0,1739,1739,0,0,1739
133617600900000,AUTO REPAIR/SALES,Commercial,0,263412,263412,0,485771,749183
133617700200000,SMALL RETAIL,Exempt,0,275832,275832,0,675820,951652
133617700300000,BOWLING ALLEY,Commercial,0,345492,345492,0,813785,1159277
133617700400000,WAREHOUSE;MINI STORG,Commercial,0,268650,268650,0,726703,995353
133617700500000,OFFICE,Commercial,0,122580,122580,0,272448,395028
133620100100000,SHOP,Commercial,0,790992,790992,0,1397922,2188914
133620100200000,FLAT PARKING,Commercial,0,222264,222264,0,57000,279264
133620200100000,CARWASH,Commercial,0,229824,229824,0,339484,569308
133620200200000,WAREHOUSE;MINI STORG,Commercial,0,141178,141178,0,303972,445150
133620200300000,WAREHOUSE,Commercial,0,329130,329130,0,5770870,6100000
133620200400000,FEDERAL PROPERTY,Exempt,0,0,0,0,0,0
133622600100000,VACANT LAND,Commercial,0,404784,404784,0,0,404784
133622600200000,FLAT PARKING,Commercial,0,162000,162000,0,63714,225714
133622700200000,WAREHOUSE,Commercial,0,369144,369144,0,5891280,6260424
133622700300000,VACANT LAND,Commercial,0,269028,269028,0,0,269028
133625100200000,FLAT PARKING,Commercial,0,378054,378054,0,142180,520234
133625100300000,VACANT LAND,Commercial,0,587682,587682,0,0,587682
133627600200000,WAREHOUSE,Commercial,0,251046,251046,0,3815643,4066689
133627600301000,WAREHOUSE,Commercial,0,19440,19440,0,131536,150976
133627600301001,WAREHOUSE,Commercial,0,19440,19440,0,131536,150976
133627600301002,WAREHOUSE,Commercial,0,19440,19440,0,131536,150976
133627600301003,WAREHOUSE,Commercial,0,19440,19440,0,131536,150976
133627600301004,WAREHOUSE,Commercial,0,19440,19440,0,131536,150976
133627600301005,WAREHOUSE,Commercial,0,19440,19440,0,131536,150976
133627600301006,WAREHOUSE,Commercial,0,19440,19440,0,131536,150976
133627600301007,WAREHOUSE,Commercial,0,19440,19440,0,131536,150976
133627600301008,WAREHOUSE,Commercial,0,19440,19440,0,131536,150976
133627600301009,WAREHOUSE,Commercial,0,19440,19440,0,131536,150976
133627600301010,WAREHOUSE,Commercial,0,19440,19440,0,131536,150976
133627600301011,WAREHOUSE,Commercial,0,19440,19440,0,131536,150976
133627600400000,MATERIALS MFG;INDUST,Industrial,0,262872,262872,0,2240642,2503514
133627600500000,OFFICE; MEDICAL,Commercial,0,255744,255744,0,766479,1022223
133627600600000,VACANT LAND,Commercial,0,234954,234954,0,0,234954
133627600700000,VACANT LAND,Commercial,0,559440,559440,0,0,559440
133627600800000,NBHD SHOPPING CENTER,Commercial,0,446256,446256,0,537619,983875
133627600900000,OFFICE,Commercial,0,247104,247104,0,2866107,3113211
133630100100000,CONVENIENCE STORE,Commercial,0,254610,254610,0,342071,596681
133630100200000,SW 407,Ag Land,47498,0,47498,0,0,47498
133632600100000,MFG HOME PARK,Commercial,0,4398678,4398678,0,2901260,7299938
133632600103000,MFG HOME PARK,Commercial,0,0,0,0,7108,7108
133632600103001,MFG HOME PARK,Commercial,0,0,0,0,5910,5910
133632600103002,MFG HOME PARK,Commercial,0,0,0,0,5557,5557
133632600103003,MFG HOME PARK,Commercial,0,0,0,0,7439,7439
133632600103005,MFG HOME PARK,Commercial,0,0,0,0,6865,6865
133632600103006,MFG HOME PARK,Commercial,0,0,0,0,8714,8714
133632600103007,MFG HOME PARK,Commercial,0,0,0,0,6750,6750
133632600103008,MFG HOME PARK,Commercial,0,0,0,0,8903,8903
133632600103009,MFG HOME PARK,Commercial,0,0,0,0,6750,6750
133632600103010,MFG HOME PARK,Commercial,0,0,0,0,6750,6750
133632600103011,MFG HOME PARK,Commercial,0,0,0,0,5400,5400
133632600103012,MFG HOME PARK,Commercial,0,0,0,0,8775,8775
133632600103013,MFG HOME PARK,Commercial,0,0,0,0,6750,6750
133632600103014,MFG HOME PARK,Commercial,0,0,0,0,4950,4950
133632600103015,MFG HOME PARK,Commercial,0,0,0,0,5400,5400
133632600103016,MFG HOME PARK,Commercial,0,0,0,0,6188,6188
133632600103017,MFG HOME PARK,Commercial,0,0,0,0,3937,3937
133632600103018,MFG HOME PARK,Commercial,0,0,0,0,10238,10238
133632600103019,MFG HOME PARK,Commercial,0,0,0,0,8352,8352
133632600103020,MFG HOME PARK,Commercial,0,0,0,0,7850,7850
133632600103021,MFG HOME PARK,Commercial,0,0,0,0,9577,9577
133632600103022,MFG HOME PARK,Commercial,0,0,0,0,8100,8100
133632600103023,MFG HOME PARK,Commercial,0,0,0,0,7426,7426
133632600103024,MFG HOME PARK,Commercial,0,0,0,0,11756,11756
133632600103025,MFG HOME PARK,Commercial,0,0,0,0,6891,6891
133632600103026,MFG HOME PARK,Commercial,0,0,0,0,4500,4500
133637600100000,LG DISCOUNT/RETAIL,Commercial,0,672300,672300,0,826592,1498892
133637600200000,VACANT LAND,Commercial,0,27540,27540,0,0,27540
133637700200000,SW 407,Ag Land,8013,0,8013,0,0,8013
133640100500000,FLAT PARKING,Commercial,0,1002336,1002336,0,607152,1609488
133640100600000,DEPT/ANCHOR STORE,Commercial,0,622832,622832,0,2718190,3341022
133640100700000,BRANCH BANK/CU,Commercial,0,50350,50350,0,387313,437663
133640101001000,BRANCH BANK/CU,Commercial,0,570659,570659,0,339376,910035
133640101001004,NBHD SHOPPING CENTER,Commercial,0,750138,750138,0,326572,1076710
133640101001005,VACANT LAND,Commercial,0,261000,261000,0,0,261000
133640200400000,SW 420,Residential,30240,0,30240,93428,0,123668
133640200500000,SW 420,Residential,30240,0,30240,89672,0,119912
133640200600000,SW 420,Residential,30422,0,30422,87187,0,117609
133640200700000,VACANT LAND,Commercial,0,194835,194835,0,0,194835
133642600100000,LG DISCOUNT/RETAIL,Commercial,0,279072,279072,0,1160795,1439867
133642600200000,OFFICE,Commercial,0,80572,80572,0,259157,339729
133642600300000,BRANCH BANK/CU,Commercial,0,505440,505440,0,919783,1425223
133642700100000,LG DISCOUNT/RETAIL,Commercial,0,1056186,1056186,0,1765548,2821734
133642700102000,BILLBOARD(BLL),Commercial,0,0,0,0,57645,57645
133642700200000,OFFICE,Commercial,0,99360,99360,0,315628,414988
133642700300000,CARWASH,Commercial,0,218700,218700,0,373620,592320
133642700400000,OFFICE; MEDICAL,Commercial,0,145800,145800,0,493208,639008
133642700500000,FLAT PARKING,Commercial,0,248832,248832,0,1429,250261
133642700600000,LG DISCOUNT/RETAIL,Commercial,0,1069416,1069416,0,2877061,3946477
133642700700000,AUTO REPAIR/SALES,Commercial,0,286978,286978,0,260096,547074
133645100100000,OFFICE,Commercial,0,495644,495644,0,64356,560000
133645100200000,THEATER,Commercial,0,90000,90000,0,0,90000
133645200100000,NBHD SHOPPING CENTER,Commercial,0,235030,235030,0,785161,1020191
133645200102000,BILLBOARD(BLL),Commercial,0,0,0,0,53203,53203
133645300100000,LG DISCOUNT/RETAIL,Commercial,0,1596726,1596726,0,6545458,8142184
133647600200000,REG SHOPPING CENTER,Commercial,0,836573,836573,0,6315507,7152080
133647600300000,DEPT/ANCHOR STORE,Commercial,0,415221,415221,0,939233,1354454
133647600400000,DEPT/ANCHOR STORE,Commercial,0,1047855,1047855,0,2026172,3074027
133647600500000,FLAT PARKING,Commercial,0,340616,340616,0,62281,402897
133647600600000,FLAT PARKING,Commercial,0,28322,28322,0,5865,34187
133647600700000,DEPT/ANCHOR STORE,Commercial,0,922404,922404,0,1542997,2465401
133647600800000,BRANCH BANK/CU,Commercial,0,579960,579960,0,1314017,1893977
140132600200000,LG DISCOUNT/RETAIL,Commercial,0,498312,498312,0,758250,1256562
140132600300000,APARTMENT,Commercial,0,15057,15057,0,161209,176266
140132600400000,APARTMENT,Commercial,0,17802,17802,0,158654,176456
140132600600000,APARTMENT,Commercial,0,15576,15576,0,164352,179928
140132600700000,APARTMENT,Commercial,0,18309,18309,0,202998,221307
140132600800000,APARTMENT,Commercial,0,16359,16359,0,173134,189493
140132600900000,APARTMENT,Commercial,0,14211,14211,0,160669,174880
140132601100000,NE 115,Residential,8800,0,8800,0,0,8800
140132700300000,NBHD SHOPPING CENTER,Commercial,0,469800,469800,0,1252702,1722502
140132700401009,LG DISCOUNT/RETAIL,Commercial,0,124200,124200,0,552600,676800
140132700401010,LG DISCOUNT/RETAIL,Commercial,0,58320,58320,0,281706,340026
140132700401011,OFFICE,Commercial,0,163000,163000,0,911669,1074669
140132700401012,LG DISCOUNT/RETAIL,Commercial,0,69660,69660,0,118704,188364
140132700401013,FITNESS CENTER,Commercial,0,493560,493560,0,3119840,3613400
140132700401014,LG DISCOUNT/RETAIL,Commercial,0,122040,122040,0,429398,551438
140132700900000,VACANT LAND,Commercial,0,2169,2169,0,0,2169
140132701300000,FLAT PARKING,Commercial,0,56700,56700,0,16758,73458
140215100700000,SMALL RETAIL,Commercial,0,348300,348300,0,371006,719306
140215100800000,FLAT PARKING,Commercial,0,92880,92880,0,7875,100755
140215200200000,LG DISCOUNT/RETAIL,Commercial,0,1244808,1244808,0,3051113,4295921
140215200300000,SMALL RETAIL,Commercial,0,272160,272160,0,390115,662275
140215200400000,RESTAURANT,Commercial,0,266004,266004,0,374623,640627
140220100100000,CENTRALLY ASSESSED,Other,0,0,0,0,0,0
140220100200000,NE 115,Residential,6340,0,6340,8366,0,14706
140220100300000,NE 115,Residential,2440,0,2440,0,0,2440
140220100400000,NE 115,Residential,8980,0,8980,0,0,8980
140220200100000,NE 115,Residential,42050,0,42050,33125,0,75175
140220200200000,AUTO REPAIR/SALES,Commercial,0,44955,44955,0,49491,94446
140220200300000,NE 115,Residential,41875,0,41875,104366,0,146241
140220200400000,LG DISCOUNT/RETAIL,Commercial,0,790020,790020,0,714229,1504249
140220200500000,SMALL RETAIL,Commercial,0,271183,271183,0,177258,448441
140220200600000,NBHD SHOPPING CENTER,Commercial,0,385290,385290,0,816401,1201691
140220200700000,SHOP,Commercial,0,102400,102400,0,82650,185050
140220200702000,BILLBOARD(BLL),Commercial,0,0,0,0,10728,10728
140220200800000,AUTO REPAIR/SALES,Commercial,0,138996,138996,0,196424,335420
140220200900000,FLAT PARKING,Commercial,0,27796,27796,0,8491,36287
140220201000000,NE 115,Residential,28600,0,28600,113186,0,141786
140220300600000,OFFICE,Commercial,0,63156,63156,0,254578,317734
140220300700000,OFFICE; MEDICAL,Commercial,0,43764,43764,0,264465,308229
140220300800000,OFFICE,Commercial,0,63556,63556,0,177181,240737
140220300900000,OFFICE,Commercial,0,32999,32999,0,175681,208680
140220301000000,OFFICE,Commercial,0,112227,112227,0,439751,551978
140220301100000,LAUNDROMAT/CLEANERS,Commercial,0,70883,70883,0,163298,234181
140220301200000,DAY CARE CENTER,Commercial,0,66784,66784,0,196058,262842
140220301300000,HOTEL,Commercial,0,56595,56595,0,182489,239084
140220400300000,APARTMENT,Commercial,0,118692,118692,0,1640325,1759017
140220400400000,APARTMENT,Commercial,0,91962,91962,0,1335126,1427088
140220400500000,APARTMENT,Commercial,0,75924,75924,0,1301333,1377257
140222600200000,NE 164,Residential,28000,0,28000,226905,0,254905
140222600300000,NE 164,Residential,28000,0,28000,166067,0,194067
140222600400000,NE 164,Residential,30154,0,30154,199356,0,229510
140222600500000,NE 164,Residential,31540,0,31540,190775,0,222315
140222600600000,NE 164,Residential,57098,0,57098,337753,0,394851
140222700100000,NE 164,Residential,28280,0,28280,177645,0,205925
140222700200000,NE 164,Residential,28280,0,28280,158962,0,187242
140222700300000,NE 164,Residential,28560,0,28560,137550,0,166110
140222700400000,NE 164,Residential,31616,0,31616,202675,0,234291
140222701300000,NE 164,Residential,52692,0,52692,272067,0,324759
140222701400000,NE 164,Residential,45900,0,45900,225523,0,271423
140222701500000,NE 164,Residential,45450,0,45450,164621,0,210071
140222701800000,CENTRALLY ASSESSED,Other,0,0,0,0,0,0
140222703000000,LG DISCOUNT/RETAIL,Commercial,0,519032,519032,0,1063485,1582517
140222703100000,OFFICE,Commercial,0,179064,179064,0,505461,684525
140222703200000,NE 164,Residential,30953,0,30953,162540,0,193493
140222703300000,NE 164,Residential,28188,0,28188,233746,0,261934
140222703400000,NE 164,Residential,28253,0,28253,176260,0,204513
140222703500000,NE 164,Residential,28419,0,28419,175832,0,204251
140222703600000,NE 164,Residential,28351,0,28351,178666,0,207017
140222703700000,NE 164,Residential,30164,0,30164,157083,0,187247
140222800100000,WAREHOUSE,Commercial,0,435240,435240,0,963498,1398738
140222800200000,WAREHOUSE;MINI STORG,Commercial,0,627750,627750,0,527622,1155372
140222800202000,BILLBOARD(BLL),Commercial,0,0,0,0,47092,47092
140222800300000,NBHD SHOPPING CENTER,Commercial,0,258120,258120,0,886889,1145009
140222800400000,OFFICE,Commercial,0,443880,443880,0,1179841,1623721
140222800600000,CONVENIENCE STORE,Commercial,0,204120,204120,0,307283,511403
140222800700000,FLAT PARKING,Commercial,0,106920,106920,0,29076,135996
140222800900000,VACANT LAND,Commercial,0,190350,190350,0,0,190350
140222900100000,CENTRALLY ASSESSED,Other,0,0,0,0,0,0
140223000100000,NE 164,Residential,55932,0,55932,315056,0,370988
140225100100000,HIGH TECH/RESEARCH,Industrial,0,1278983,1278983,0,15857273,17136256
140225100200000,HIGH TECH/RESEARCH,Industrial,0,17122,17122,0,461205,478327
140225100300000,RESTAURANT,Commercial,0,845640,845640,0,1104360,1950000
140227600100000,FITNESS CENTER,Commercial,0,116930,116930,0,408070,525000
140227600200000,OFFICE,Commercial,0,111821,111821,0,425574,537395
140227600400000,SMALL RETAIL,Commercial,0,119016,119016,0,520646,639662
140227600500000,OFFICE,Commercial,0,86265,86265,0,212033,298298
140227600700000,SMALL RETAIL,Commercial,0,247050,247050,0,524445,771495
140227600800000,CARWASH,Commercial,0,522288,522288,0,412132,934420
140227600900000,RESTAURANT,Commercial,0,967680,967680,0,959868,1927548
140227601000000,SMALL RETAIL,Commercial,0,208073,208073,0,440714,648787
140227601100000,FAST FOOD,Commercial,0,761400,761400,0,515664,1277064
140227601200000,OFFICE,Commercial,0,105300,105300,0,200541,305841
140227601300000,OFFICE,Commercial,0,78393,78393,0,228255,306648
140227601400000,OFFICE,Commercial,0,83451,83451,0,223046,306497
140227601500000,SMALL RETAIL,Commercial,0,317682,317682,0,398650,716332
140227601600000,OFFICE,Commercial,0,113859,113859,0,680976,794835
140227601700000,OFFICE,Commercial,0,111821,111821,0,425575,537396
140227601900000,OFFICE,Commercial,0,172071,172071,0,427929,600000
140227602100000,VACANT LAND,Commercial,0,108000,108000,0,0,108000
140227602200000,DAY CARE CENTER,Commercial,0,341280,341280,0,2544780,2886060
140227602300000,VACANT LAND,Commercial,0,972,972,0,0,972
140227700100000,VACANT LAND,Commercial,0,665,665,0,0,665
140227700200000,WAREHOUSE;MINI STORG,Commercial,0,90720,90720,0,97134,187854
140227700300000,CHURCH,Exempt,0,381294,381294,0,4209209,4590503
140227700400000,WAREHOUSE,Commercial,0,219915,219915,0,4311,224226
140227700500000,SKATING RINK,Commercial,0,219915,219915,0,397259,617174
140227700600000,OFFICE,Commercial,0,382113,382113,0,648871,1030984
140227700800000,CONVENIENCE STORE,Commercial,0,563587,563587,0,457044,1020631
140227700900000,FLAT PARKING,Commercial,0,15120,15120,0,2538,17658
140227701800000,FLAT PARKING,Commercial,0,20,20,0,0,20
140230100100000,RESTAURANT,Commercial,0,874800,874800,0,675200,1550000
140230100200000,RESTAURANT,Commercial,0,891000,891000,0,1036355,1927355
140230100300000,RESTAURANT,Commercial,0,537840,537840,0,258441,796281
140230100400000,RESTAURANT,Commercial,0,466560,466560,0,384600,851160
140230100500000,FAST FOOD,Commercial,0,688824,688824,0,439692,1128516
140230100600000,FLAT PARKING,Commercial,0,1102,1102,0,0,1102
140230100700000,RESTAURANT,Commercial,0,626616,626616,0,617586,1244202
140230100800000,RESTAURANT,Commercial,0,509760,509760,0,572689,1082449
140230100900000,LG DISCOUNT/RETAIL,Commercial,0,1509300,1509300,0,6037787,7547087
140230101100000,FLAT PARKING,Commercial,0,1215702,1215702,0,300000,1515702
140230101200000,GROCERY STORE,Commercial,0,357696,357696,0,1926602,2284298
140230101300000,VACANT LAND,Commercial,0,4774,4774,0,0,4774
140230101400000,SMALL RETAIL,Commercial,0,262116,262116,0,948021,1210137
140232600100000,RESTAURANT,Commercial,0,1069200,1069200,0,680800,1750000
140232600200000,OFFICE,Commercial,0,500580,500580,0,647439,1148019
140232600300000,OFFICE,Commercial,0,362880,362880,0,567567,930447
140232600400000,NE 117,Residential,33000,0,33000,87289,0,120289
140232600500000,NE 117,Residential,33000,0,33000,85618,0,118618
140232600600000,CITY PROPERTY,Exempt,0,0,0,0,0,0
140232600700000,CITY PROPERTY,Exempt,0,0,0,0,0,0
140232600800000,NE 117,Residential,33000,0,33000,67216,0,100216
140232600900000,NE 117,Residential,36040,0,36040,93338,0,129378
140232601000000,NE 117,Residential,36000,0,36000,60993,0,96993
140232601100000,NE 117,Residential,36000,0,36000,157795,0,193795
140232601200000,NE 117,Residential,36000,0,36000,90991,0,126991
140232601300000,NE 117,Residential,35000,0,35000,85692,0,120692
140232601400000,NE 117,Residential,47500,0,47500,107425,0,154925
140232601500000,NE 117,Residential,46250,0,46250,97249,0,143499
140232601600000,NE 117,Residential,46755,0,46755,126262,0,173017
140232601700000,FUNERAL HOME,Commercial,0,682981,682981,0,357280,1040261
140232601800000,OFFICE,Commercial,0,102870,102870,0,1065256,1168126
140232601900000,OFFICE,Commercial,0,117288,117288,0,832390,949678
140232602000000,DEPT/ANCHOR STORE,Commercial,0,1375920,1375920,0,3224080,4600000
140232602100000,VACANT LAND,Commercial,0,6774,6774,0,0,6774
140235100100000,FUNERAL HOME,Exempt,0,3370680,3370680,0,2155583,5526263
140237600100000,FLAT PARKING,Commercial,0,22680,22680,0,1200,23880
140237600200000,FUNERAL HOME,Commercial,0,104544,104544,0,297094,401638
140237600300000,FUNERAL HOME,Commercial,0,297432,297432,0,1116083,1413515
140237600400000,LG DISCOUNT/RETAIL,Commercial,0,343764,343764,0,279522,623286
140237600500000,CITY PROPERTY,Exempt,0,0,0,0,0,0
140237700100000,OFFICE,Commercial,0,146146,146146,0,186494,332640
140237700200000,FLAT PARKING,Commercial,0,315252,315252,0,5886,321138
140237700300000,OFFICE; MEDICAL,Commercial,0,298080,298080,0,293940,592020
140237700400000,OFFICE; MEDICAL,Commercial,0,326160,326160,0,351689,677849
140237700500000,OFFICE,Commercial,0,100980,100980,0,183609,284589
140237700600000,OFFICE; MEDICAL,Commercial,0,126984,126984,0,91128,218112
140237700700000,NE 115,Residential,17727,0,17727,87563,0,105290
140237700800000,NE 115,Residential,20248,0,20248,52806,0,73054
140237700901000,OFFICE,Commercial,0,2683,2683,0,44147,46830
140237700901001,OFFICE,Commercial,0,1661,1661,0,27435,29096
140237700901002,OFFICE,Commercial,0,3322,3322,0,46193,49515
140237700901003,OFFICE,Commercial,0,1661,1661,0,27435,29096
140237700901004,OFFICE,Commercial,0,1661,1661,0,27435,29096
140237700901005,OFFICE,Commercial,0,639,639,0,10722,11361
140237700901006,OFFICE,Commercial,0,1661,1661,0,27435,29096
140237700901007,OFFICE,Commercial,0,1661,1661,0,27435,29096
140237700901052,OFFICE,Commercial,0,767,767,0,13487,14254
140237700901053,OFFICE,Commercial,0,639,639,0,19622,20261
140237701200000,NE 115,Residential,2064,0,2064,0,0,2064
140240100300000,LG DISCOUNT/RETAIL,Commercial,0,1520640,1520640,0,1539349,3059989
140240100400000,AUTO REPAIR/SALES,Commercial,0,383400,383400,0,319350,702750
140240100500000,AUTO REPAIR/SALES,Commercial,0,274284,274284,0,242838,517122
140240100502000,BILLBOARD(BLL),Commercial,0,0,0,0,52781,52781
140240100600000,NBHD SHOPPING CENTER,Commercial,0,246717,246717,0,432007,678724
140240100700000,FLAT PARKING,Commercial,0,33634,33634,0,4320,37954
140240100800000,FLAT PARKING,Commercial,0,5400,5400,0,0,5400
140240101200000,SMALL RETAIL,Commercial,0,536047,536047,0,795649,1331696
140240101300000,LG DISCOUNT/RETAIL,Commercial,0,1694520,1694520,0,2733629,4428149
140240200100000,NBHD SHOPPING CENTER,Commercial,0,777600,777600,0,1125148,1902748
140240200200000,LG DISCOUNT/RETAIL,Commercial,0,1862460,1862460,0,1959410,3821870
140240200300000,SMALL RETAIL,Commercial,0,217987,217987,0,504143,722130
140240200400000,SMALL RETAIL,Commercial,0,228506,228506,0,180340,408846
140240200402000,BILLBOARD(BLL),Commercial,0,0,0,0,11053,11053
140240200500000,CITY PROPERTY,Exempt,0,0,0,0,0,0
140240300400000,RESTAURANT,Commercial,0,428220,428220,0,122917,551137
140240301600000,OFFICE,Commercial,0,440640,440640,0,1039926,1480566
140240301700000,AUTO REPAIR/SALES,Commercial,0,225504,225504,0,314905,540409
140240400200000,NBHD SHOPPING CENTER,Commercial,0,630720,630720,0,1760469,2391189
140240400400000,RESTAURANT,Commercial,0,1137240,1137240,0,1340349,2477589
140240400500000,HOTEL,Commercial,0,359640,359640,0,466960,826600
140242600100000,DEPT/ANCHOR STORE,Commercial,0,1615140,1615140,0,3838419,5453559
140242600200000,FAST FOOD,Commercial,0,511920,511920,0,625244,1137164
140242600300000,REG SHOPPING CENTER,Commercial,0,2750220,2750220,0,27184898,29935118
140245100100000,RESTAURANT,Commercial,0,477792,477792,0,586197,1063989
140245100200000,SMALL RETAIL,Commercial,0,144993,144993,0,267757,412750
140245100300000,LG DISCOUNT/RETAIL,Commercial,0,1803060,1803060,0,4339634,6142694
140245100500000,OFFICE,Commercial,0,636012,636012,0,1092504,1728516
140245100600000,FAST FOOD,Commercial,0,210816,210816,0,316856,527672
140245100700000,SMALL RETAIL,Commercial,0,210816,210816,0,304018,514834
140245100800000,BARS/LOUNGE,Commercial,0,87615,87615,0,186420,274035
140245100900000,WAREHOUSE;MINI STORG,Commercial,0,139536,139536,0,107607,247143
140245101000000,NE 115,Residential,10420,0,10420,0,0,10420
140245101100000,NE 115,Residential,10000,0,10000,0,0,10000
140245101200000,WAREHOUSE;MINI STORG,Commercial,0,34776,34776,0,29001,63777
140245200100000,BRANCH BANK/CU,Commercial,0,108000,108000,0,307437,415437
140245200200000,BRANCH BANK/CU,Commercial,0,410400,410400,0,365055,775455
140245200300000,AUTO REPAIR/SALES,Commercial,0,196020,196020,0,460176,656196
140245200400000,SHOP,Exempt,0,21168,21168,0,176647,197815
140245300401001,OFFICE,Commercial,0,4216,4216,0,48467,52683
140245300500000,NE 115,Residential,30912,0,30912,167829,0,198741
140245300600000,NE 115,Residential,15572,0,15572,74509,0,90081
140245300700000,NE 115,Residential,2986,0,2986,0,0,2986
140245300800000,NE 115,Residential,111,0,111,0,0,111
140245300900000,NE 115,Residential,3993,0,3993,0,0,3993
140247600900000,VACANT LAND,Exempt,0,237800,237800,0,0,237800
140247601000000,LG DISCOUNT/RETAIL,Commercial,0,929556,929556,0,2296711,3226267
140247601300000,LG DISCOUNT/RETAIL,Commercial,0,1459620,1459620,0,4989874,6449494
140247601400000,LG DISCOUNT/RETAIL,Commercial,0,1330020,1330020,0,4420793,5750813
140310100100000,NE 110,Residential,19708,0,19708,82785,0,102493
140310100200000,NE 110,Residential,19176,0,19176,112861,0,132037
140310100300000,NE 110,Residential,19176,0,19176,130087,0,149263
140310100400000,NE 110,Residential,19176,0,19176,145679,0,164855
140310100500000,NE 110,Residential,19176,0,19176,108218,0,127394
140310100600000,NE 110,Residential,19176,0,19176,141592,0,160768
140310100700000,NE 110,Residential,22997,0,22997,127355,0,150352
140310100800000,NE 110,Residential,24190,0,24190,127145,0,151335
140310200100000,NE 110,Residential,18430,0,18430,127276,0,145706
140310200200000,NE 110,Residential,21257,0,21257,138649,0,159906
140310300300000,APARTMENT,Residential,13365,0,13365,103395,0,116760
140310300600000,APARTMENT,Commercial,0,16099,16099,0,145351,161450
140310300900000,CHURCH,Exempt,0,691200,691200,0,1158057,1849257
140310400400000,NBHD SHOPPING CENTER,Commercial,0,285120,285120,0,760596,1045716
140310400500000,NBHD SHOPPING CENTER,Commercial,0,411480,411480,0,756611,1168091
140310400600000,VACANT LAND,Commercial,0,302,302,0,0,302
140310400700000,BRANCH BANK/CU,Commercial,0,268920,268920,0,1013683,1282603
140312600100000,NE 110,Residential,23901,0,23901,125643,0,149544
140312600200000,NE 110,Residential,21632,0,21632,103728,0,125360
140312600300000,NE 110,Residential,21632,0,21632,113745,0,135377
140312600400000,NE 110,Residential,21632,0,21632,121295,0,142927
140312600500000,NE 110,Residential,21632,0,21632,109150,0,130782
140312600600000,NE 110,Residential,21777,0,21777,125463,0,147240
140312600700000,NE 110,Residential,23478,0,23478,102727,0,126205
140312700100000,NE 110,Residential,23296,0,23296,94685,0,117981
140312700200000,NE 110,Residential,20800,0,20800,102813,0,123613
140312800100000,NE 110,Residential,26141,0,26141,94866,0,121007
140312800200000,NE 110,Residential,22057,0,22057,116195,0,138252
140312800300000,NE 110,Residential,21168,0,21168,96805,0,117973
140312800400000,NE 110,Residential,21168,0,21168,112314,0,133482
140312800500000,NE 110,Residential,21168,0,21168,123784,0,144952
140312800600000,NE 110,Residential,21509,0,21509,119151,0,140660
140312800700000,NE 110,Residential,22661,0,22661,98580,0,121241
140312800800000,NE 110,Residential,22661,0,22661,44454,0,67115
140312800900000,NE 110,Residential,22482,0,22482,102434,0,124916
140312801000000,NE 110,Residential,22251,0,22251,85055,0,107306
140312801100000,NE 110,Residential,21470,0,21470,105019,0,126489
140312801200000,NE 110,Residential,21470,0,21470,107113,0,128583
140312801300000,NE 110,Residential,21660,0,21660,93790,0,115450
140312801400000,NE 110,Residential,22156,0,22156,105021,0,127177
140312801500000,NE 110,Residential,22321,0,22321,96987,0,119308
140312801600000,NE 110,Residential,25200,0,25200,135708,0,160908
140312900100000,NE 110,Residential,22440,0,22440,93463,0,115903
140312900200000,NE 110,Residential,20800,0,20800,93595,0,114395
140312900300000,NE 110,Residential,22348,0,22348,92167,0,114515
140312900400000,NE 110,Residential,22176,0,22176,117165,0,139341
140312900500000,NE 110,Residential,22440,0,22440,97756,0,120196
140313000100000,AUTO REPAIR/SALES,Commercial,0,135126,135126,0,171018,306144
140313000200000,SHOP,Commercial,0,269892,269892,0,275573,545465
140313000202000,BILLBOARD(BLL),Commercial,0,0,0,0,47667,47667
140313000300000,WAREHOUSE,Commercial,0,720360,720360,0,579640,1300000
140315100100000,HIGH TECH/RESEARCH,Industrial,0,2513802,2513802,0,16590907,19104709
140317600100000,ANTENNAS/TOWERS(BLL),Commercial,0,151632,151632,0,1153,152785
140320100100000,NE 111,Residential,20000,0,20000,95757,0,115757
140320200200000,LG DISCOUNT/RETAIL,Commercial,0,1109780,1109780,0,7309971,8419751
140320200300000,NBHD SHOPPING CENTER,Commercial,0,702216,702216,0,2640045,3342261
140320200400000,BRANCH BANK/CU,Commercial,0,459000,459000,0,763827,1222827
140320300100000,NE 111,Residential,20000,0,20000,104257,0,124257
140320300200000,NE 111,Residential,440,0,440,0,0,440
140320300300000,NE 111,Residential,21400,0,21400,95259,0,116659
140320400100000,CITY PROPERTY,Exempt,0,0,0,0,0,0
140320400200000,CONC/ASPH;INDUSTRIAL,Commercial,0,471960,471960,0,184634,656594
140320400300000,WAREHOUSE,Commercial,0,630720,630720,0,362507,993227
140320400302000,BILLBOARD(BLL),Commercial,0,0,0,0,27138,27138
140320500100000,WAREHOUSE,Commercial,0,310824,310824,0,2971797,3282621
140320500200000,FLAT PARKING,Commercial,0,22378,22378,0,38790,61168
140320500300000,SHOP,Commercial,0,371088,371088,0,1294819,1665907
140320500400000,VACANT LAND,Commercial,0,34425,34425,0,0,34425
140322600100000,SHOP,Commercial,0,107055,107055,0,145525,252580
140322600200000,VACANT LAND,Commercial,0,34992,34992,0,0,34992
140322600300000,VACANT LAND,Commercial,0,133920,133920,0,0,133920
140322600400000,OFFICE,Commercial,0,133920,133920,0,379351,513271
140322600500000,FLAT PARKING,Commercial,0,109080,109080,0,11188,120268
140322600600000,SMALL RETAIL,Commercial,0,228960,228960,0,594873,823833
140322600701000,VETERINARY CLINIC,Commercial,0,90720,90720,0,350339,441059
140322600701001,SMALL RETAIL,Commercial,0,25920,25920,0,103741,129661
140322600701002,SMALL RETAIL,Commercial,0,25920,25920,0,103741,129661
140322600701003,SMALL RETAIL,Commercial,0,25920,25920,0,103741,129661
140322600701004,SMALL RETAIL,Commercial,0,25920,25920,0,103741,129661
140322600800000,RESTAURANT,Commercial,0,302400,302400,0,620590,922990
140322700100000,OFFICE,Commercial,0,299160,299160,0,598235,897395
140322700200000,OFFICE,Commercial,0,430272,430272,0,1144425,1574697
140322700300000,FRATERNAL,Commercial,0,691740,691740,0,1076647,1768387
140322700400000,DAY CARE CENTER,Commercial,0,281880,281880,0,358862,640742
140322700500000,FAST FOOD,Commercial,0,297000,297000,0,698195,995195
140322800200000,WAREHOUSE,Exempt,0,836730,836730,0,1643689,2480419
140322800300000,CONVENIENCE STORE,Commercial,0,245932,245932,0,317859,563791
140322800400000,CENTRALLY ASSESSED,Other,0,0,0,0,0,0
140322800500000,WAREHOUSE,Commercial,0,1254960,1254960,0,4418784,5673744
140322800600000,BRANCH BANK/CU,Commercial,0,216000,216000,0,1159982,1375982
140325100100000,OFFICE,Commercial,0,388098,388098,0,3519610,3907708
140325100300000,HOTEL,Commercial,0,241920,241920,0,1930580,2172500
140325100400000,THEATER,Commercial,0,728730,728730,0,6179119,6907849
140325100500000,NBHD SHOPPING CENTER,Commercial,0,443880,443880,0,1490390,1934270
140325100600000,FLAT PARKING,Commercial,0,49950,49950,0,0,49950
140325100700000,OFFICE; MEDICAL,Commercial,0,644490,644490,0,4803345,5447835
140325100800000,BRANCH BANK/CU,Commercial,0,216000,216000,0,777154,993154
140325200100000,OFFICE,Commercial,0,152928,152928,0,484512,637440
140325200200000,OFFICE,Commercial,0,238464,238464,0,512997,751461
140325200300000,OFFICE,Commercial,0,247104,247104,0,505024,752128
140325200400000,RESTAURANT,Commercial,0,524880,524880,0,817317,1342197
140325200500000,HOTEL,Commercial,0,547884,547884,0,1952116,2500000
140325300100000,AUTO REPAIR/SALES,Commercial,0,319680,319680,0,315752,635432
140325300200000,OFFICE,Commercial,0,95472,95472,0,321178,416650
140325300300000,RESTAURANT,Commercial,0,288684,288684,0,447993,736677
140325300400000,FLAT PARKING,Commercial,0,123822,123822,0,46922,170744
140325300402000,BILLBOARD(BLL),Commercial,0,0,0,0,45553,45553
140325300500000,OFFICE,Commercial,0,114394,114394,0,557320,671714
140327600100000,WAREHOUSE,Commercial,0,360126,360126,0,1321737,1681863
140327600200000,MATERIALS MFG;INDUST,Industrial,0,371088,371088,0,1190771,1561859
140327600300000,FLAT PARKING,Commercial,0,400032,400032,0,145987,546019
140327600400000,HOTEL,Commercial,0,387072,387072,0,4946283,5333355
140327600500000,HOTEL,Commercial,0,366336,366336,0,4470356,4836692
140327600700000,HOTEL,Commercial,0,338688,338688,0,2526342,2865030
140327600800000,FLAT PARKING,Commercial,0,191808,191808,0,65239,257047
140327700100000,HOTEL,Commercial,0,202500,202500,0,876842,1079342
140327700200000,HIGH TECH/RESEARCH,Industrial,0,1013094,1013094,0,4245363,5258457
140327700300000,HOTEL,Commercial,0,882360,882360,0,8219007,9101367
140327700400000,FLAT PARKING,Commercial,0,115020,115020,0,14137,129157
140327700500000,OFFICE,Commercial,0,110769,110769,0,356877,467646
140327700502000,BILLBOARD(BLL),Commercial,0,0,0,0,55998,55998
140330100100000,SCHOOL,Exempt,0,0,0,0,0,0
140330100200000,CITY PROPERTY,Exempt,0,0,0,0,0,0
140332600100000,CITY PROPERTY,Exempt,0,0,0,0,0,0
140337600100000,SCHOOL,Exempt,0,149310,149310,0,203825,353135
140337600200000,NE 117,Residential,33739,0,33739,83232,0,116971
140337600300000,NE 117,Residential,32010,0,32010,91499,0,123509
140337600400000,NE 117,Residential,32010,0,32010,79402,0,111412
140337600500000,NE 117,Residential,32010,0,32010,77486,0,109496
140337600600000,NE 117,Residential,32010,0,32010,87207,0,119217
140337600700000,NE 117,Residential,32010,0,32010,86371,0,118381
140337600800000,NE 117,Residential,32010,0,32010,102174,0,134184
140337600900000,NE 117,Residential,32010,0,32010,91537,0,123547
140337601000000,NE 117,Residential,36596,0,36596,95305,0,131901
140337700100000,NE 117,Residential,34551,0,34551,61879,0,96430
140337700200000,NE 117,Residential,33756,0,33756,81459,0,115215
140337700300000,NE 117,Residential,33756,0,33756,64602,0,98358
140337700400000,NE 117,Residential,33756,0,33756,84311,0,118067
140337700500000,NE 117,Residential,33756,0,33756,87801,0,121557
140337700600000,NE 117,Residential,33756,0,33756,95449,0,129205
140337700700000,NE 117,Residential,32010,0,32010,88030,0,120040
140337700800000,NE 117,Residential,32010,0,32010,86298,0,118308
140337700900000,NE 117,Residential,32010,0,32010,79301,0,111311
140337701000000,NE 117,Residential,38070,0,38070,98322,0,136392
140337800100000,NE 117,Residential,36434,0,36434,111024,0,147458
140337800200000,NE 117,Residential,35264,0,35264,81019,0,116283
140337800300000,NE 117,Residential,33456,0,33456,66535,0,99991
140337800400000,NE 117,Residential,32100,0,32100,66594,0,98694
140337800500000,NE 117,Residential,32700,0,32700,65525,0,98225
140337800600000,NE 117,Residential,32100,0,32100,61991,0,94091
140337800700000,NE 117,Residential,31200,0,31200,70996,0,102196
140337800800000,NE 117,Residential,30888,0,30888,68982,0,99870
140337800900000,NE 117,Residential,32010,0,32010,81270,0,113280
140337801000000,NE 117,Residential,33174,0,33174,64606,0,97780
140337801100000,NE 117,Residential,32126,0,32126,86974,0,119100
140337801200000,NE 117,Residential,33756,0,33756,75522,0,109278
140337801300000,NE 117,Residential,32010,0,32010,96509,0,128519
140337801400000,NE 117,Residential,32010,0,32010,74926,0,106936
140337801500000,NE 117,Residential,32010,0,32010,79337,0,111347
140337801600000,NE 117,Residential,32010,0,32010,96767,0,128777
140337801700000,NE 117,Residential,32010,0,32010,81825,0,113835
140337801800000,NE 117,Residential,32708,0,32708,92318,0,125026
140337801900000,NE 117,Residential,33756,0,33756,86522,0,120278
140337802000000,NE 117,Residential,33756,0,33756,81123,0,114879
140337802100000,NE 117,Residential,33756,0,33756,88572,0,122328
140337802200000,NE 117,Residential,36289,0,36289,95500,0,131789
140337802300000,NE 117,Residential,34066,0,34066,87130,0,121196
140337802400000,NE 117,Residential,37810,0,37810,90854,0,128664
140337802500000,NE 117,Residential,33756,0,33756,89516,0,123272
140337802600000,NE 117,Residential,33756,0,33756,100995,0,134751
140337802700000,NE 117,Residential,33836,0,33836,95164,0,129000
140337802800000,NE 117,Residential,32708,0,32708,85476,0,118184
140337802900000,NE 117,Residential,32010,0,32010,92088,0,124098
140337803000000,NE 117,Residential,32010,0,32010,93866,0,125876
140337803100000,NE 117,Residential,32010,0,32010,65121,0,97131
140337803200000,NE 117,Residential,32010,0,32010,68055,0,100065
140337803300000,NE 117,Residential,32010,0,32010,84792,0,116802
140337803400000,NE 117,Residential,32534,0,32534,90322,0,122856
140337803500000,NE 117,Residential,32010,0,32010,89175,0,121185
140337803600000,NE 117,Residential,32010,0,32010,86094,0,118104
140337803700000,NE 117,Residential,33908,0,33908,93400,0,127308
140337803800000,NE 117,Residential,34094,0,34094,56167,0,90261
140337803900000,NE 117,Residential,35853,0,35853,80545,0,116398
140337804000000,NE 117,Residential,35937,0,35937,99691,0,135628
140337804100000,NE 117,Residential,34382,0,34382,101435,0,135817
140337804200000,NE 117,Residential,34382,0,34382,85316,0,119698
140337804300000,NE 117,Residential,33060,0,33060,102564,0,135624
140337804400000,NE 117,Residential,33408,0,33408,89294,0,122702
140337900100000,NE 117,Residential,34642,0,34642,35365,0,70007
140337900200000,NE 117,Residential,34920,0,34920,76747,0,111667
140337900300000,NE 117,Residential,34920,0,34920,83804,0,118724
140337900400000,NE 117,Residential,34920,0,34920,81726,0,116646
140337900500000,NE 117,Residential,34920,0,34920,103209,0,138129
140337900600000,NE 117,Residential,33756,0,33756,93467,0,127223
140337900700000,NE 117,Residential,33756,0,33756,94678,0,128434
140337900800000,NE 117,Residential,33756,0,33756,70273,0,104029
140337900900000,NE 117,Residential,36064,0,36064,82896,0,118960
140337901000000,NE 117,Residential,34400,0,34400,91873,0,126273
140337901100000,NE 117,Residential,36960,0,36960,65826,0,102786
140337901200000,NE 117,Residential,34832,0,34832,66254,0,101086
140337901300000,NE 117,Residential,33199,0,33199,69956,0,103155
140337901400000,NE 117,Residential,38160,0,38160,77532,0,115692
140337901500000,NE 117,Residential,38160,0,38160,79131,0,117291
140337901600000,NE 117,Residential,38160,0,38160,90166,0,128326
140337901700000,NE 117,Residential,38160,0,38160,80722,0,118882
140337901800000,NE 117,Residential,38160,0,38160,104632,0,142792
140337901900000,NE 117,Residential,38160,0,38160,84447,0,122607
140337902000000,CHURCH,Commercial,0,97065,97065,0,152133,249198
140337902100000,BRANCH BANK/CU,Commercial,0,380808,380808,0,2679345,3060153
140337902300000,FAST FOOD,Commercial,0,21546,21546,0,62362,83908
140337902400000,AUTO REPAIR/SALES,Commercial,0,153900,153900,0,205066,358966
140337902500000,SMALL RETAIL,Commercial,0,135324,135324,0,451718,587042
140337902600000,OFFICE,Commercial,0,243685,243685,0,673261,916946
140337902700000,NBHD SHOPPING CENTER,Commercial,0,123677,123677,0,659377,783054
140338000100000,NE 117,Residential,35455,0,35455,96609,0,132064
140338000200000,NE 117,Residential,34150,0,34150,76613,0,110763
140338000300000,NE 117,Residential,32832,0,32832,83954,0,116786
140338000400000,NE 117,Residential,32010,0,32010,90506,0,122516
140338000500000,NE 117,Residential,32010,0,32010,84348,0,116358
140338000600000,NE 117,Residential,31777,0,31777,88183,0,119960
140338000700000,NE 117,Residential,31777,0,31777,81686,0,113463
140338000800000,NE 117,Residential,31777,0,31777,76239,0,108016
140338000900000,NE 117,Residential,31777,0,31777,78944,0,110721
140338001000000,NE 117,Residential,31777,0,31777,78087,0,109864
140338001100000,NE 117,Residential,31777,0,31777,67704,0,99481
140338001200000,NE 117,Residential,31777,0,31777,83583,0,115360
140338001300000,NE 117,Residential,31777,0,31777,89145,0,120922
140338001400000,NE 117,Residential,31777,0,31777,92923,0,124700
140338001500000,NE 117,Residential,36289,0,36289,80634,0,116923
140338001600000,NE 117,Residential,34066,0,34066,79876,0,113942
140338001700000,NE 117,Residential,37810,0,37810,84214,0,122024
140338001800000,NE 117,Residential,31777,0,31777,82680,0,114457
140338001900000,NE 117,Residential,31777,0,31777,86896,0,118673
140338002000000,NE 117,Residential,31777,0,31777,86304,0,118081
140338002100000,NE 117,Residential,31777,0,31777,99238,0,131015
140338002200000,NE 117,Residential,31777,0,31777,76565,0,108342
140338002300000,NE 117,Residential,31777,0,31777,95835,0,127612
140338002400000,NE 117,Residential,31777,0,31777,77731,0,109508
140338002500000,NE 117,Residential,31777,0,31777,78858,0,110635
140338002600000,NE 117,Residential,31777,0,31777,97946,0,129723
140338002700000,NE 117,Residential,32010,0,32010,104802,0,136812
140338002800000,NE 117,Residential,32010,0,32010,82692,0,114702
140338002900000,NE 117,Residential,32623,0,32623,86069,0,118692
140338003000000,NE 117,Residential,32771,0,32771,79378,0,112149
140338100200000,AUTO REPAIR/SALES,Commercial,0,10935,10935,0,145429,156364
140338100300000,OFFICE,Commercial,0,34830,34830,0,66779,101609
140338100500000,OFFICE,Exempt,0,232500,232500,0,1033039,1265539
140340100100000,OFFICE,Commercial,0,1002510,1002510,0,1148398,2150908
140340200100000,NE 117,Residential,35316,0,35316,87679,0,122995
140340200200000,NE 117,Residential,36660,0,36660,116765,0,153425
140340200300000,NE 117,Residential,28200,0,28200,98329,0,126529
140340200400000,NE 117,Residential,28200,0,28200,93889,0,122089
140340200500000,NE 117,Residential,28200,0,28200,82470,0,110670
140340200600000,NE 117,Residential,28200,0,28200,80254,0,108454
140340200700000,NE 117,Residential,28200,0,28200,92565,0,120765
140340200800000,NE 117,Residential,28200,0,28200,84017,0,112217
140340200900000,NE 117,Residential,28200,0,28200,98433,0,126633
140340201000000,NE 117,Residential,33109,0,33109,97641,0,130750
140340201100000,NE 117,Residential,33691,0,33691,91581,0,125272
140340201200000,NE 117,Residential,28592,0,28592,115332,0,143924
140340201300000,NE 117,Residential,28500,0,28500,92161,0,120661
140340201400000,NE 117,Residential,33014,0,33014,86343,0,119357
140340201500000,NE 117,Residential,33250,0,33250,120818,0,154068
140340201600000,NE 117,Residential,26675,0,26675,84979,0,111654
140340201700000,NE 117,Residential,26675,0,26675,85572,0,112247
140340201800000,NE 117,Residential,28251,0,28251,88981,0,117232
140340201900000,NE 117,Residential,25200,0,25200,78564,0,103764
140340202000000,NE 117,Residential,26149,0,26149,100167,0,126316
140340202100000,NE 117,Residential,27160,0,27160,86116,0,113276
140340202200000,NE 117,Residential,27160,0,27160,76809,0,103969
140340202300000,NE 117,Residential,27160,0,27160,89671,0,116831
140340202400000,NE 117,Residential,27160,0,27160,94816,0,121976
140340202500000,NE 117,Residential,18634,0,18634,0,0,18634
140340202600000,NE 117,Residential,23674,0,23674,113620,0,137294
140340202700000,NE 117,Residential,29414,0,29414,89448,0,118862
140340202800000,NE 117,Residential,30720,0,30720,82617,0,113337
140340202900000,NE 117,Residential,31680,0,31680,87701,0,119381
140340203000000,NE 117,Residential,31680,0,31680,86539,0,118219
140340203100000,NE 117,Residential,31680,0,31680,86039,0,117719
140340203200000,NE 117,Residential,31680,0,31680,91324,0,123004
140340300100000,NE 117,Residential,35079,0,35079,93435,0,128514
140340300200000,NE 117,Residential,36425,0,36425,72115,0,108540
140340300300000,NE 117,Residential,28200,0,28200,90184,0,118384
140340300400000,NE 117,Residential,28200,0,28200,84846,0,113046
140340300500000,NE 117,Residential,28200,0,28200,94908,0,123108
140340300600000,NE 117,Residential,28200,0,28200,89911,0,118111
140340300700000,NE 117,Residential,28200,0,28200,84721,0,112921
140340300800000,NE 117,Residential,28200,0,28200,81373,0,109573
140340300900000,NE 117,Residential,28200,0,28200,82452,0,110652
140340301000000,NE 117,Residential,30300,0,30300,93080,0,123380
140340301100000,NE 117,Residential,33950,0,33950,93205,0,127155
140340301200000,NE 117,Residential,33777,0,33777,101672,0,135449
140340301300000,NE 117,Residential,34083,0,34083,95621,0,129704
140340301400000,NE 117,Residential,31680,0,31680,93181,0,124861
140340301500000,NE 117,Residential,31680,0,31680,85493,0,117173
140340301600000,NE 117,Residential,31680,0,31680,89298,0,120978
140340301700000,NE 117,Residential,31680,0,31680,81721,0,113401
140340301800000,NE 117,Residential,31680,0,31680,90869,0,122549
140340301900000,NE 117,Residential,31680,0,31680,86794,0,118474
140340302000000,NE 117,Residential,31435,0,31435,85065,0,116500
140340400100000,OFFICE,Commercial,0,118368,118368,0,269880,388248
140340400200000,NE 116,Residential,43600,0,43600,96316,0,139916
140340400300000,NE 116,Residential,43600,0,43600,60578,0,104178
140340400400000,NE 116,Residential,43600,0,43600,74962,0,118562
140340400500000,NE 116,Residential,43600,0,43600,64783,0,108383
140340400600000,NE 116,Residential,46750,0,46750,94953,0,141703
140340400700000,NE 116,Residential,50667,0,50667,91123,0,141790
140340400800000,NE 116,Exempt,0,54267,54267,0,76519,130786
140340400900000,NE 116,Residential,50850,0,50850,90368,0,141218
140340401000000,NE 116,Residential,53820,0,53820,103596,0,157416
140340401100000,NE 116,Residential,46816,0,46816,88749,0,135565
140340401200000,NE 116,Residential,47500,0,47500,87093,0,134593
140340401300000,CITY PROPERTY,Exempt,0,0,0,0,0,0
140340401400000,CITY PROPERTY,Exempt,0,0,0,0,0,0
140340500100000,CHURCH,Exempt,0,64800,64800,0,181283,246083
140340500200000,NE 116,Residential,43600,0,43600,86708,0,130308
140340500300000,NE 116,Residential,43600,0,43600,72486,0,116086
140340500400000,NE 116,Residential,43600,0,43600,85194,0,128794
140340500500000,NE 116,Residential,43600,0,43600,65057,0,108657
140340500600000,NE 116,Residential,43600,0,43600,74150,0,117750
140340500700000,NE 116,Residential,56689,0,56689,100397,0,157086
140340500800000,NE 116,Residential,54500,0,54500,115415,0,169915
140340500900000,NE 116,Residential,54500,0,54500,108239,0,162739
140340501000000,NE 116,Residential,54500,0,54500,110525,0,165025
140340501100000,NE 116,Residential,54500,0,54500,86942,0,141442
140340501200000,NE 116,Residential,54500,0,54500,112081,0,166581
140340600100000,NE 116,Residential,62863,0,62863,75919,0,138782
140340600200000,NE 116,Residential,65300,0,65300,109806,0,175106
140340600300000,NE 116,Residential,53500,0,53500,146547,0,200047
140340600400000,NE 116,Residential,69550,0,69550,106122,0,175672
140342600100000,NE 117,Residential,39592,0,39592,98943,0,138535
140342600200000,NE 117,Residential,25872,0,25872,67905,0,93777
140342600300000,NE 117,Residential,23760,0,23760,95246,0,119006
140342600400000,NE 117,Residential,36660,0,36660,75996,0,112656
140342600500000,NE 117,Residential,32902,0,32902,88672,0,121574
140342600600000,NE 117,Residential,35568,0,35568,70369,0,105937
140342600700000,NE 117,Residential,37624,0,37624,107063,0,144687
140342600800000,NE 117,Residential,32495,0,32495,84428,0,116923
140342600900000,NE 117,Residential,34000,0,34000,94550,0,128550
140342601000000,NE 117,Residential,33000,0,33000,85130,0,118130
140342601100000,NE 117,Residential,35705,0,35705,86138,0,121843
140342601200000,NE 117,Residential,30500,0,30500,87028,0,117528
140342601300000,NE 117,Residential,31763,0,31763,84545,0,116308
140342601400000,NE 117,Residential,31110,0,31110,100121,0,131231
140342601500000,NE 117,Residential,30195,0,30195,92274,0,122469
140342700100000,CHURCH,Exempt,0,703080,703080,0,323999,1027079
140342700200000,NE 117,Residential,38880,0,38880,108064,0,146944
140342700300000,NE 117,Residential,34560,0,34560,84442,0,119002
140342700400000,NE 117,Residential,39168,0,39168,83179,0,122347
140342700500000,NE 117,Residential,30333,0,30333,83021,0,113354
140342700600000,NE 117,Residential,29890,0,29890,79103,0,108993
140342700700000,NE 117,Residential,29617,0,29617,83730,0,113347
140342700800000,NE 117,Residential,29585,0,29585,96512,0,126097
140342700900000,NE 117,Residential,30195,0,30195,89246,0,119441
140342701000000,NE 117,Residential,31142,0,31142,86486,0,117628
140342701100000,NE 117,Residential,29813,0,29813,83873,0,113686
140342701200000,NE 117,Residential,31565,0,31565,78382,0,109947
140342701300000,NE 117,Residential,30625,0,30625,118687,0,149312
140342701400000,NE 117,Residential,36975,0,36975,93484,0,130459
140342701500000,NE 117,Residential,32177,0,32177,72326,0,104503
140342701600000,NE 117,Residential,33453,0,33453,68405,0,101858
140342701700000,NE 117,Residential,36416,0,36416,79959,0,116375
140342800100000,NE 117,Residential,36978,0,36978,90192,0,127170
140342800200000,NE 117,Residential,34920,0,34920,82865,0,117785
140342800300000,NE 117,Residential,34920,0,34920,79462,0,114382
140342800400000,NE 117,Residential,34920,0,34920,79913,0,114833
140342800500000,NE 117,Residential,34920,0,34920,98351,0,133271
140342800600000,NE 117,Residential,34920,0,34920,90731,0,125651
140342800700000,NE 117,Residential,34920,0,34920,83830,0,118750
140342800800000,NE 117,Residential,37248,0,37248,96729,0,133977
140342900100000,NE 117,Residential,35720,0,35720,90646,0,126366
140342900200000,NE 117,Residential,33170,0,33170,100072,0,133242
140342900300000,NE 117,Residential,33790,0,33790,86569,0,120359
140342900400000,NE 117,Residential,34467,0,34467,81067,0,115534
140342900500000,NE 117,Residential,33170,0,33170,75265,0,108435
140342900600000,NE 117,Residential,32067,0,32067,81818,0,113885
140342900700000,NE 117,Residential,30667,0,30667,77772,0,108439
140342900800000,NE 117,Residential,30360,0,30360,72859,0,103219
140342900900000,NE 117,Residential,29585,0,29585,63063,0,92648
140342901000000,NE 117,Residential,29725,0,29725,37275,0,67000
140342901100000,NE 117,Residential,29407,0,29407,81538,0,110945
140342901200000,NE 117,Residential,29423,0,29423,79421,0,108844
140342901300000,NE 117,Residential,29423,0,29423,74388,0,103811
140342901400000,NE 117,Residential,29423,0,29423,79041,0,108464
140342901500000,NE 117,Residential,29423,0,29423,74448,0,103871
140342901600000,NE 117,Residential,29423,0,29423,74679,0,104102
140342901700000,NE 117,Residential,29682,0,29682,75619,0,105301
140342901800000,NE 117,Residential,39168,0,39168,95249,0,134417
140342901900000,NE 117,Residential,34560,0,34560,96177,0,130737
140342902000000,NE 117,Residential,39168,0,39168,106462,0,145630
140342902100000,NE 117,Residential,27095,0,27095,76724,0,103819
140342902200000,NE 117,Residential,29585,0,29585,75352,0,104937
140342902300000,NE 117,Residential,30070,0,30070,85884,0,115954
140342902400000,NE 117,Residential,30070,0,30070,91515,0,121585
140342902500000,NE 117,Residential,30070,0,30070,88034,0,118104
140342902600000,NE 117,Residential,29908,0,29908,64744,0,94652
140342902700000,NE 117,Residential,29908,0,29908,79844,0,109752
140342902800000,NE 117,Residential,30543,0,30543,83529,0,114072
140342902900000,NE 117,Residential,30855,0,30855,118585,0,149440
140342903000000,NE 117,Residential,31815,0,31815,86531,0,118346
140342903100000,NE 117,Residential,33567,0,33567,81601,0,115168
140342903200000,NE 117,Residential,34517,0,34517,138851,0,173368
140342903300000,NE 117,Residential,34418,0,34418,108705,0,143123
140342903400000,NE 117,Residential,35720,0,35720,90787,0,126507
140342903500000,NE 117,Residential,26950,0,26950,84637,0,111587
140342903600000,NE 117,Residential,28875,0,28875,77249,0,106124
140342903700000,NE 117,Residential,28875,0,28875,76565,0,105440
140342903800000,NE 117,Residential,31033,0,31033,61465,0,92498
140342903900000,NE 117,Residential,35530,0,35530,84317,0,119847
140342904000000,NE 117,Residential,28500,0,28500,88097,0,116597
140343000100000,NE 117,Residential,31768,0,31768,71583,0,103351
140343000200000,NE 117,Residential,26675,0,26675,83074,0,109749
140343000300000,NE 117,Residential,26675,0,26675,85383,0,112058
140343000400000,NE 117,Residential,26675,0,26675,82317,0,108992
140343000500000,NE 117,Residential,29100,0,29100,86061,0,115161
140343000600000,NE 117,Residential,29100,0,29100,81317,0,110417
140343000700000,NE 117,Residential,29100,0,29100,103900,0,133000
140343000800000,NE 117,Residential,29100,0,29100,87601,0,116701
140343000900000,NE 117,Residential,29100,0,29100,82063,0,111163
140343001000000,NE 117,Residential,29100,0,29100,77478,0,106578
140343001100000,NE 117,Residential,29100,0,29100,80918,0,110018
140343001200000,NE 117,Residential,29100,0,29100,91267,0,120367
140343001300000,NE 117,Residential,29100,0,29100,80079,0,109179
140343001400000,NE 117,Residential,47580,0,47580,67056,0,114636
140343001500000,NE 117,Residential,27691,0,27691,77889,0,105580
140343001600000,NE 117,Residential,33479,0,33479,82562,0,116041
140343001700000,NE 117,Residential,28258,0,28258,74080,0,102338
140343001800000,NE 117,Residential,15750,0,15750,0,0,15750
140343001900000,NE 117,Residential,34106,0,34106,107962,0,142068
140343100100000,NE 117,Residential,35720,0,35720,75496,0,111216
140343100200000,NE 117,Residential,30393,0,30393,83890,0,114283
140343100300000,NE 117,Residential,29423,0,29423,87245,0,116668
140343100400000,NE 117,Residential,30393,0,30393,89340,0,119733
140343100500000,NE 117,Residential,30393,0,30393,92903,0,123296
140343100600000,NE 117,Residential,30393,0,30393,79850,0,110243
140343100700000,NE 117,Residential,30393,0,30393,89396,0,119789
140343100800000,NE 117,Residential,30393,0,30393,97558,0,127951
140343100900000,NE 117,Residential,30393,0,30393,90804,0,121197
140343101000000,NE 117,Residential,30393,0,30393,75916,0,106309
140343101100000,NE 117,Residential,30393,0,30393,97206,0,127599
140343101200000,NE 117,Residential,31881,0,31881,91842,0,123723
140343101300000,NE 117,Residential,39168,0,39168,84921,0,124089
140343101400000,NE 117,Residential,34560,0,34560,82098,0,116658
140343101500000,NE 117,Residential,39168,0,39168,101395,0,140563
140343101600000,NE 117,Residential,27742,0,27742,82852,0,110594
140343101700000,NE 117,Residential,31033,0,31033,78069,0,109102
140343101800000,NE 117,Residential,27930,0,27930,71737,0,99667
140343101900000,NE 117,Residential,28583,0,28583,95806,0,124389
140343102000000,NE 117,Residential,27930,0,27930,99927,0,127857
140343102100000,NE 117,Residential,28583,0,28583,106642,0,135225
140343102200000,NE 117,Residential,27930,0,27930,87268,0,115198
140343102300000,NE 117,Residential,31033,0,31033,96437,0,127470
140343102400000,NE 117,Residential,29400,0,29400,86108,0,115508
140343102500000,NE 117,Residential,35794,0,35794,92495,0,128289
140343102600000,NE 117,Residential,28200,0,28200,90308,0,118508
140343200100000,NE 117,Residential,37248,0,37248,89967,0,127215
140343200200000,NE 117,Residential,34338,0,34338,100455,0,134793
140343200300000,NE 117,Residential,34338,0,34338,92831,0,127169
140343200400000,NE 117,Residential,34338,0,34338,100688,0,135026
140343200500000,NE 117,Residential,34338,0,34338,91482,0,125820
140343200600000,NE 117,Residential,34338,0,34338,88114,0,122452
140343200700000,NE 117,Residential,34338,0,34338,104508,0,138846
140343200800000,NE 117,Residential,34338,0,34338,82038,0,116376
140343200900000,NE 117,Residential,34510,0,34510,91490,0,126000
140343201000000,NE 117,Residential,33745,0,33745,88480,0,122225
140343300100000,NE 117,Residential,31906,0,31906,87902,0,119808
140343300200000,NE 117,Residential,28453,0,28453,83571,0,112024
140343300300000,NE 117,Residential,28130,0,28130,92269,0,120399
140343300400000,NE 117,Residential,27968,0,27968,98847,0,126815
140343300500000,NE 117,Residential,27968,0,27968,84129,0,112097
140343300600000,NE 117,Residential,27968,0,27968,88039,0,116007
140343300700000,NE 117,Residential,27968,0,27968,86978,0,114946
140343300800000,NE 117,Residential,27322,0,27322,78265,0,105587
140343300900000,NE 117,Residential,36864,0,36864,93896,0,130760
140343301000000,NE 117,Residential,34560,0,34560,119588,0,154148
140343301100000,NE 117,Residential,36864,0,36864,90577,0,127441
140343301200000,NE 117,Residential,35114,0,35114,80625,0,115739
140343301300000,NE 117,Residential,36860,0,36860,94007,0,130867
140343301400000,NE 117,Residential,37597,0,37597,70998,0,108595
140343301500000,NE 117,Residential,37781,0,37781,84699,0,122480
140343301600000,NE 117,Residential,37631,0,37631,73185,0,110816
140343301700000,NE 117,Residential,28200,0,28200,86707,0,114907
140343400100000,NE 117,Residential,36230,0,36230,94407,0,130637
140343400200000,NE 117,Residential,38080,0,38080,92592,0,130672
140343400300000,NE 117,Residential,37300,0,37300,111416,0,148716
140343400400000,NE 117,Residential,37149,0,37149,100512,0,137661
140345100100000,NE 117,Residential,32939,0,32939,83959,0,116898
140345100200000,NE 117,Residential,31837,0,31837,63948,0,95785
140345100300000,NE 117,Residential,38220,0,38220,72460,0,110680
140345100400000,NE 117,Residential,35362,0,35362,83495,0,118857
140345100500000,NE 117,Residential,37653,0,37653,87936,0,125589
140345100600000,NE 117,Residential,31040,0,31040,92381,0,123421
140345200100000,NE 117,Residential,30080,0,30080,107479,0,137559
140345200200000,NE 117,Residential,34920,0,34920,84006,0,118926
140345200300000,NE 117,Residential,34920,0,34920,83515,0,118435
140345200400000,NE 117,Residential,34920,0,34920,79726,0,114646
140345200500000,NE 117,Residential,34920,0,34920,95452,0,130372
140345200600000,NE 117,Residential,34920,0,34920,95307,0,130227
140345200700000,NE 117,Residential,34920,0,34920,73642,0,108562
140345200800000,NE 117,Residential,34920,0,34920,91423,0,126343
140345200900000,NE 117,Residential,34920,0,34920,87602,0,122522
140345201000000,NE 117,Residential,34920,0,34920,93489,0,128409
140345201100000,NE 117,Residential,34920,0,34920,86400,0,121320
140345201200000,NE 117,Residential,34920,0,34920,94775,0,129695
140345201300000,NE 117,Residential,34920,0,34920,105598,0,140518
140345201400000,NE 117,Residential,34920,0,34920,101473,0,136393
140345201500000,NE 117,Residential,30080,0,30080,85901,0,115981
140345201600000,NE 117,Residential,22560,0,22560,86269,0,108829
140345300100000,NE 117,Residential,24064,0,24064,85751,0,109815
140345300200000,NE 117,Residential,32010,0,32010,77104,0,109114
140345300300000,NE 117,Residential,32010,0,32010,77012,0,109022
140345300400000,NE 117,Residential,32010,0,32010,77889,0,109899
140345300500000,NE 117,Residential,32010,0,32010,79922,0,111932
140345300600000,NE 117,Residential,32010,0,32010,87721,0,119731
140345300700000,NE 117,Residential,32010,0,32010,82893,0,114903
140345300800000,NE 117,Residential,32010,0,32010,109444,0,141454
140345300900000,NE 117,Residential,32010,0,32010,85957,0,117967
140345301000000,NE 117,Residential,32010,0,32010,70041,0,102051
140345301100000,NE 117,Residential,32010,0,32010,92168,0,124178
140345301200000,NE 117,Residential,32010,0,32010,88609,0,120619
140345301300000,NE 117,Residential,32010,0,32010,92040,0,124050
140345301400000,NE 117,Residential,32010,0,32010,70530,0,102540
140345301500000,NE 117,Residential,32010,0,32010,80435,0,112445
140345301600000,NE 117,Residential,32010,0,32010,85434,0,117444
140345301700000,NE 117,Residential,32010,0,32010,84799,0,116809
140345301800000,NE 117,Residential,24064,0,24064,69649,0,93713
140345301900000,NE 117,Residential,22560,0,22560,78981,0,101541
140345400100000,NE 117,Residential,37440,0,37440,83110,0,120550
140345400200000,NE 117,Residential,32100,0,32100,62992,0,95092
140345400300000,NE 117,Residential,32400,0,32400,60005,0,92405
140345400400000,NE 117,Residential,32400,0,32400,80473,0,112873
140345400500000,NE 117,Residential,32123,0,32123,61856,0,93979
140345400600000,NE 117,Residential,36622,0,36622,81268,0,117890
140345400700000,NE 117,Residential,34160,0,34160,72073,0,106233
140345500100000,NE 117,Residential,44070,0,44070,87938,0,132008
140345500200000,NE 117,Exempt,0,47514,47514,0,104112,151626
140345500300000,CHURCH,Exempt,0,172800,172800,0,85306,258106
140345500400000,NE 117,Residential,44840,0,44840,141993,0,186833
140345500500000,NE 117,Residential,23185,0,23185,82044,0,105229
140345500600000,NE 117,Residential,25355,0,25355,33861,0,59216
140345500700000,NE 117,Residential,32906,0,32906,105963,0,138869
140345500800000,NE 117,Residential,34425,0,34425,84440,0,118865
140345500900000,NE 117,Residential,31945,0,31945,93522,0,125467
140345501000000,NE 117,Residential,31200,0,31200,82519,0,113719
140345501100000,NE 117,Residential,31200,0,31200,118432,0,149632
140345501200000,NE 117,Residential,31320,0,31320,99097,0,130417
140345501300000,NE 117,Residential,31200,0,31200,88196,0,119396
140345501400000,NE 117,Residential,31200,0,31200,92437,0,123637
140345501500000,NE 117,Residential,31200,0,31200,110225,0,141425
140345501600000,NE 117,Residential,31200,0,31200,118017,0,149217
140345501700000,NE 117,Residential,31200,0,31200,58269,0,89469
140345501800000,NE 117,Residential,30368,0,30368,68860,0,99228
140345501900000,NE 117,Residential,42700,0,42700,92627,0,135327
140345502000000,NE 117,Residential,6092,0,6092,1099,0,7191
140345502100000,NE 117,Residential,36400,0,36400,77318,0,113718
140345502200000,NE 117,Residential,6234,0,6234,0,0,6234
140345502300000,NE 117,Residential,36811,0,36811,86357,0,123168
140345502400000,NE 117,Residential,42253,0,42253,95253,0,137506
140345502500000,NE 117,Residential,5450,0,5450,0,0,5450
140345502600000,NE 117,Residential,36400,0,36400,134258,0,170658
140345502700000,NE 117,Residential,36400,0,36400,99972,0,136372
140345502800000,NE 117,Residential,36400,0,36400,146364,0,182764
140345502900000,NE 117,Residential,36052,0,36052,146357,0,182409
140345600100000,NE 117,Residential,35109,0,35109,55526,0,90635
140345600200000,NE 117,Residential,33300,0,33300,88800,0,122100
140345600300000,NE 117,Residential,31280,0,31280,73241,0,104521
140345600400000,NE 117,Residential,38562,0,38562,161853,0,200415
140345600500000,NE 117,Residential,36604,0,36604,88116,0,124720
140345600600000,APARTMENT,Commercial,0,226800,226800,0,2073200,2300000
140345600700000,NE 117,Residential,45900,0,45900,111482,0,157382
140345600800000,NE 117,Residential,41111,0,41111,125767,0,166878
140345600900000,NE 117,Residential,42281,0,42281,123412,0,165693
140345601000000,NE 117,Residential,42281,0,42281,80805,0,123086
140345601100000,NE 117,Residential,42179,0,42179,96285,0,138464
140345601200000,NE 117,Residential,38360,0,38360,117187,0,155547
140345601300000,NE 117,Residential,44240,0,44240,102487,0,146727
140345601400000,NE 117,Residential,38164,0,38164,97892,0,136056
140345700100000,NE 117,Residential,48589,0,48589,80604,0,129193
140345700200000,NE 117,Residential,31200,0,31200,94162,0,125362
140345700300000,NE 117,Residential,31200,0,31200,92036,0,123236
140345700400000,NE 117,Residential,31200,0,31200,69972,0,101172
140345700500000,NE 117,Residential,31200,0,31200,69929,0,101129
140345700600000,NE 117,Residential,31200,0,31200,79016,0,110216
140345700700000,NE 117,Residential,31200,0,31200,101995,0,133195
140345700800000,NE 117,Residential,31200,0,31200,89127,0,120327
140345700900000,NE 117,Residential,31200,0,31200,114243,0,145443
140345701000000,NE 117,Residential,30403,0,30403,81403,0,111806
140345701100000,NE 116,Residential,24250,0,24250,46301,0,70551
140345701200000,NE 116,Residential,33984,0,33984,82783,0,116767
140345701300000,NE 116,Residential,46500,0,46500,82226,0,128726
140345701400000,NE 116,Residential,46500,0,46500,76258,0,122758
140345701500000,NE 116,Residential,46500,0,46500,96696,0,143196
140345701600000,NE 116,Residential,52161,0,52161,101124,0,153285
140345701700000,NE 116,Residential,50000,0,50000,95416,0,145416
140345701800000,NE 116,Residential,50000,0,50000,63617,0,113617
140345800100000,NE 116,Residential,46000,0,46000,78627,0,124627
140345800200000,NE 116,Residential,46000,0,46000,75407,0,121407
140345800300000,NE 116,Residential,46000,0,46000,83835,0,129835
140345800400000,NE 116,Residential,41630,0,41630,80745,0,122375
140347600100000,NE 116,Residential,53500,0,53500,93934,0,147434
140347600200000,NE 116,Residential,53500,0,53500,134114,0,187614
140347600300000,NE 116,Residential,53500,0,53500,111616,0,165116
140347600400000,NE 116,Residential,53500,0,53500,90604,0,144104
140347700100000,NE 116,Residential,74439,0,74439,171805,0,246244
140347700200000,NE 116,Residential,66342,0,66342,148242,0,214584
140347700300000,NE 116,Residential,53500,0,53500,133229,0,186729
140347700400000,NE 116,Residential,53500,0,53500,117538,0,171038
140347700500000,NE 116,Residential,53500,0,53500,84832,0,138332
140347700600000,NE 116,Residential,54092,0,54092,90139,0,144231
140347700700000,NE 116,Residential,55120,0,55120,93331,0,148451
140347700800000,NE 116,Residential,53500,0,53500,93877,0,147377
140347700900000,NE 116,Residential,53500,0,53500,77092,0,130592
140347701000000,NE 116,Residential,53500,0,53500,75003,0,128503
140347701100000,NE 116,Residential,53500,0,53500,74674,0,128174
140347800100000,NE 116,Residential,54500,0,54500,97910,0,152410
140347800200000,NE 116,Residential,58840,0,58840,90795,0,149635
140347800300000,NE 116,Residential,57770,0,57770,126430,0,184200
140347800400000,NE 116,Residential,58044,0,58044,85169,0,143213
140347900100000,NE 116,Residential,53500,0,53500,89247,0,142747
140347900200000,NE 116,Residential,53500,0,53500,106114,0,159614
140347900300000,NE 116,Residential,53500,0,53500,95568,0,149068
140347900400000,NE 116,Residential,48671,0,48671,119954,0,168625
140347900500000,NE 116,Residential,50690,0,50690,110256,0,160946
140347900600000,NE 116,Residential,56316,0,56316,219171,0,275487
140347900700000,NE 116,Residential,49683,0,49683,106186,0,155869
140347900800000,NE 116,Residential,56214,0,56214,81558,0,137772
140347900900000,NE 116,Residential,50661,0,50661,97762,0,148423
140347901000000,NE 116,Residential,53500,0,53500,67463,0,120963
140347901100000,NE 116,Residential,53500,0,53500,84568,0,138068
140347901200000,NE 116,Residential,53500,0,53500,107621,0,161121
140347901300000,NE 116,Residential,53500,0,53500,109841,0,163341
140347901400000,NE 116,Residential,55708,0,55708,74391,0,130099
140347901500000,NE 116,Residential,52384,0,52384,94277,0,146661
140347901600000,NE 116,Residential,53500,0,53500,73844,0,127344
140347901700000,NE 116,Residential,53500,0,53500,79888,0,133388
140347901800000,NE 116,Residential,53500,0,53500,62076,0,115576
140347901900000,NE 116,Residential,42800,0,42800,58887,0,101687
140348000100000,NE 116,Residential,59920,0,59920,95648,0,155568
140348000200000,NE 116,Residential,44110,0,44110,71509,0,115619
140348000300000,NE 116,Residential,54000,0,54000,94223,0,148223
140348000400000,NE 116,Residential,54000,0,54000,67632,0,121632
140348000500000,NE 116,Residential,54000,0,54000,110381,0,164381
140348000600000,NE 116,Residential,55256,0,55256,81165,0,136421
140348000700000,NE 116,Residential,56469,0,56469,147036,0,203505
140348000800000,NE 116,Residential,53500,0,53500,86461,0,139961
140348000900000,NE 116,Residential,53500,0,53500,84392,0,137892
140348001000000,NE 116,Residential,53500,0,53500,133064,0,186564
140348001100000,NE 116,Residential,53500,0,53500,62490,0,115990
140348001200000,NE 116,Residential,55708,0,55708,83335,0,139043
140348001300000,NE 116,Residential,56136,0,56136,86822,0,142958
140348001400000,NE 116,Residential,50503,0,50503,89040,0,139543
140348001500000,NE 116,Residential,57427,0,57427,103335,0,160762
140348001600000,NE 116,Residential,52725,0,52725,96251,0,148976
140348001700000,NE 116,Residential,52517,0,52517,132404,0,184921
140348001800000,NE 116,Residential,54000,0,54000,87238,0,141238
140348100100000,NE 116,Residential,54604,0,54604,76439,0,131043
140348100200000,NE 116,Residential,53500,0,53500,68526,0,122026
140348100300000,NE 116,Residential,53500,0,53500,83803,0,137303
140348100400000,NE 116,Residential,53500,0,53500,88382,0,141882
140348100500000,NE 116,Residential,53500,0,53500,68808,0,122308
140348100600000,NE 116,Residential,51765,0,51765,69355,0,121120
140348200100000,NE 116,Residential,54604,0,54604,74310,0,128914
140348200200000,NE 116,Residential,53500,0,53500,47930,0,101430
140348200300000,NE 116,Residential,53500,0,53500,93516,0,147016
140348200400000,NE 116,Residential,53500,0,53500,83486,0,136986
140348200500000,NE 116,Residential,53500,0,53500,61671,0,115171
140348200600000,NE 116,Residential,57290,0,57290,93929,0,151219
140410100200000,WAREHOUSE,Commercial,0,701514,701514,0,403278,1104792
140410100300000,CENTRALLY ASSESSED,Other,0,0,0,0,0,0
140410100400000,WAREHOUSE,Commercial,0,418500,418500,0,293150,711650
140410100500000,EQUIPMENT MFG;INDUST,Industrial,0,310176,310176,0,1638332,1948508
140410100600000,OFFICE,Commercial,0,453600,453600,0,339154,792754
140410100800000,OFFICE,Commercial,0,351648,351648,0,1811267,2162915
140410200100000,WAREHOUSE,Commercial,0,961049,961049,0,2997859,3958908
140410200200000,PAPER; INDUSTRIAL,Industrial,0,616226,616226,0,4089840,4706066
140412600100000,CENTRALLY ASSESSED,Other,0,0,0,0,0,0
140412600200000,SMALL RETAIL,Commercial,0,145508,145508,0,238390,383898
140412600300000,VETERINARY CLINIC,Commercial,0,103615,103615,0,183818,287433
140412600400000,SMALL RETAIL,Commercial,0,128226,128226,0,123036,251262
140412600500000,SMALL RETAIL,Commercial,0,180900,180900,0,139692,320592
140412600502000,BILLBOARD(BLL),Commercial,0,0,0,0,59861,59861
140412600600000,FLAT PARKING,Commercial,0,5962,5962,0,12800,18762
140412600700000,AUTO REPAIR/SALES,Commercial,0,97200,97200,0,242212,339412
140412600800000,FLAT PARKING,Commercial,0,77517,77517,0,9100,86617
140412600900000,SHOP,Commercial,0,75294,75294,0,153536,228830
140412601000000,FLAT PARKING,Commercial,0,7760,7760,0,17957,25717
140412601100000,OFFICE,Commercial,0,88492,88492,0,368269,456761
140412601200000,OFFICE,Commercial,0,157950,157950,0,544431,702381
140412601300000,VACANT LAND,Commercial,0,60000,60000,0,0,60000
140412601400000,RESTAURANT,Commercial,0,288900,288900,0,165047,453947
140412602500000,FLAT PARKING,Commercial,0,4212,4212,0,0,4212
140412900100000,SHOP,Commercial,0,491062,491062,0,629217,1120279
140412900200000,FLAT PARKING,Commercial,0,188592,188592,0,0,188592
140412900300000,VACANT LAND,Commercial,0,20,20,0,0,20
140413000100000,SMALL RETAIL,Commercial,0,280800,280800,0,107696,388496
140413000300000,SMALL RETAIL,Commercial,0,198450,198450,0,433529,631979
140413000400000,OFFICE,Commercial,0,114345,114345,0,172126,286471
140413000500000,OFFICE,Commercial,0,120285,120285,0,394496,514781
140413000600000,VACANT LAND,Commercial,0,20,20,0,0,20
140413000700000,VACANT LAND,Commercial,0,20,20,0,0,20
140413000800000,LG DISCOUNT/RETAIL,Commercial,0,868351,868351,0,2629032,3497383
140413100100000,LG DISCOUNT/RETAIL,Commercial,0,315900,315900,0,478154,794054
140413100200000,WAREHOUSE;MINI STORG,Commercial,0,137970,137970,0,161096,299066
140413100300000,FAST FOOD,Commercial,0,340200,340200,0,499048,839248
140413100400000,SMALL RETAIL,Commercial,0,253800,253800,0,281822,535622
140413100402000,BILLBOARD(BLL),Commercial,0,0,0,0,60721,60721
140413100500000,LG DISCOUNT/RETAIL,Commercial,0,226800,226800,0,297610,524410
140413100600000,SMALL RETAIL,Commercial,0,102623,102623,0,149397,252020
140413100602000,BILLBOARD(BLL),Commercial,0,0,0,0,29611,29611
140413100700000,WAREHOUSE,Commercial,0,86158,86158,0,156576,242734
140413100800000,VACANT LAND,Commercial,0,30793,30793,0,0,30793
140413101100000,OFFICE,Commercial,0,240300,240300,0,1053968,1294268
140413101200000,VACANT LAND,Commercial,0,20,20,0,0,20
140415100100000,VACANT LAND,Commercial,0,41796,41796,0,0,41796
140415100300000,CENTRALLY ASSESSED,Other,0,0,0,0,0,0
140415100302000,BILLBOARD(BLL),Commercial,0,0,0,0,16493,16493
140415200100000,GROCERY STORE,Commercial,0,935820,935820,0,4056983,4992803
140415200200000,AUTO REPAIR/SALES,Commercial,0,433350,433350,0,546362,979712
140415200301000,WAREHOUSE,Commercial,0,68310,68310,0,209457,277767
140415200301001,WAREHOUSE,Commercial,0,68310,68310,0,223588,291898
140415200301002,SHOP,Commercial,0,133650,133650,0,236146,369796
140415200400000,AUTO REPAIR/SALES,Commercial,0,305251,305251,0,355511,660762
140415300100000,NE 111,Residential,47875,0,47875,194207,0,242082
140415300200000,OFFICE; MEDICAL,Commercial,0,783540,783540,0,3103444,3886984
140415300300000,OFFICE; MEDICAL,Commercial,0,183600,183600,0,524245,707845
140417600100000,OFFICE,Commercial,0,131760,131760,0,371892,503652
140417600200000,OFFICE,Commercial,0,60480,60480,0,414312,474792
140417600400000,AUTO REPAIR/SALES,Commercial,0,938520,938520,0,3331424,4269944
140417600500000,FLAT PARKING,Commercial,0,629100,629100,0,10362,639462
140417600600000,AUTO REPAIR/SALES,Commercial,0,395280,395280,0,399262,794542
140417600700000,SHOP,Commercial,0,113416,113416,0,94903,208319
140417600800000,BRANCH BANK/CU,Commercial,0,281232,281232,0,447889,729121
140417601000000,FLAT PARKING,Commercial,0,13608,13608,0,21840,35448
140417700100000,AUTO REPAIR/SALES,Commercial,0,766260,766260,0,817302,1583562
140417700200000,SHOP,Commercial,0,238950,238950,0,319491,558441
140417700300000,FLAT PARKING,Commercial,0,49410,49410,0,0,49410
140417700400000,AUTO REPAIR/SALES,Commercial,0,219780,219780,0,385303,605083
140417800100000,HIGH TECH/RESEARCH,Industrial,0,619650,619650,0,1577351,2197001
140417800200000,NE 111,Residential,47550,0,47550,167036,0,214586
140420500100000,LG DISCOUNT/RETAIL,Commercial,0,515160,515160,0,1196038,1711198
140420500200000,FLAT PARKING,Commercial,0,1788,1788,0,18277,20065
140420500300000,APARTMENT,Commercial,0,18144,18144,0,293030,311174
140420500400000,APARTMENT,Commercial,0,18090,18090,0,287124,305214
140420500500000,APARTMENT,Residential,29087,0,29087,61913,0,91000
140420500700000,APARTMENT,Residential,24057,0,24057,292145,0,316202
140420500800000,APARTMENT,Commercial,0,24084,24084,0,260186,284270
140420500900000,APARTMENT,Commercial,0,403920,403920,0,4050429,4454349
140420501000000,SHOP,Commercial,0,40203,40203,0,71809,112012
140420501100000,RESTAURANT,Commercial,0,52596,52596,0,112449,165045
140420501200000,RESTAURANT,Commercial,0,112104,112104,0,117931,230035
140420501300000,OFFICE,Commercial,0,122024,122024,0,144511,266535
140420501400000,RESTAURANT,Commercial,0,197640,197640,0,227513,425153
140420501500000,BARS/LOUNGE,Commercial,0,124805,124805,0,172896,297701
140420600100000,APARTMENT,Residential,34265,0,34265,359568,0,393833
140420600200000,OFFICE,Commercial,0,52488,52488,0,160634,213122
140423100100000,HOTEL,Commercial,0,491400,491400,0,1047712,1539112
140423100200000,RESTAURANT,Commercial,0,307800,307800,0,373842,681642
140423100300000,SHOP,Commercial,0,183600,183600,0,480449,664049
140423100400000,EQUIPMENT MFG;INDUST,Industrial,0,337392,337392,0,1108282,1445674
140423100500000,SHOP,Commercial,0,147150,147150,0,636170,783320
140423100600000,CENTRALLY ASSESSED,Other,0,0,0,0,0,0
140423200100000,OFFICE,Commercial,0,142145,142145,0,250806,392951
140423200200000,SMALL RETAIL,Commercial,0,95863,95863,0,80996,176859
140423200300000,NBHD SHOPPING CENTER,Commercial,0,265075,265075,0,599773,864848
140425100100000,CITY PROPERTY,Exempt,0,0,0,0,0,0
140425200100000,CITY PROPERTY,Exempt,0,0,0,0,0,0
140427600300000,WAREHOUSE,Commercial,0,271296,271296,0,234484,505780
140427600400000,WAREHOUSE,Commercial,0,292680,292680,0,527613,820293
140427600500000,WAREHOUSE,Commercial,0,222750,222750,0,529132,751882
140427600600000,WAREHOUSE,Commercial,0,339012,339012,0,698579,1037591
140427600700000,WAREHOUSE,Commercial,0,210600,210600,0,674186,884786
140427600800000,WAREHOUSE,Commercial,0,86659,86659,0,156865,243524
140427600900000,SHOP,Commercial,0,97675,97675,0,371295,468970
140427601000000,MISCELLANEOUS,Commercial,0,432,432,0,3718,4150
140427601200000,CENTRALLY ASSESSED,Other,0,0,0,0,0,0
140427601300000,SHOP,Commercial,0,141264,141264,0,280275,421539
140427601400000,AUTO REPAIR/SALES,Commercial,0,315900,315900,0,420672,736572
140427700100000,NBHD SHOPPING CENTER,Commercial,0,308826,308826,0,774458,1083284
140427700200000,OFFICE,Commercial,0,51840,51840,0,204845,256685
140427700300000,NE 112,Residential,24300,0,24300,67372,0,91672
140427700400000,NE 112,Residential,10000,0,10000,42471,0,52471
140427700500000,NE 112,Residential,24525,0,24525,79343,0,103868
140427700600000,NE 112,Residential,30150,0,30150,66851,0,97001
140427700700000,NE 112,Residential,18057,0,18057,77705,0,95762
140427700800000,NE 112,Residential,18300,0,18300,63914,0,82214
140427700900000,NE 112,Residential,31350,0,31350,74903,0,106253
140427701000000,NE 112,Residential,19680,0,19680,101051,0,120731
140427701100000,CENTRALLY ASSESSED,Other,0,0,0,0,0,0
140427800100000,CHURCH,Exempt,0,91109,91109,0,113669,204778
140427800200000,NE 112,Residential,20750,0,20750,78663,0,99413
140427800300000,NE 112,Residential,19920,0,19920,57074,0,76994
140427800400000,NE 112,Residential,20140,0,20140,72486,0,92626
140427800500000,NE 112,Residential,18880,0,18880,39448,0,58328
140427800600000,NE 112,Residential,18880,0,18880,29427,0,48307
140427800700000,OFFICE,Commercial,0,359032,359032,0,108376,467408
140430100300000,SMALL RETAIL,Commercial,0,93015,93015,0,207868,300883
140430100400000,SHOP,Commercial,0,49572,49572,0,69600,119172
140430100500000,HOTEL,Commercial,0,154440,154440,0,755560,910000
140430100600000,SMALL RETAIL,Commercial,0,57953,57953,0,231468,289421
140430100700000,WAREHOUSE;MINI STORG,Commercial,0,174150,174150,0,122766,296916
140430100800000,AUTO REPAIR/SALES,Commercial,0,472500,472500,0,1267299,1739799
140430100900000,SMALL RETAIL,Commercial,0,200340,200340,0,225476,425816
140430101000000,AUTO REPAIR/SALES,Commercial,0,511515,511515,0,637980,1149495
140430101100000,SHOP,Commercial,0,50220,50220,0,180267,230487
140430101200000,CITY PROPERTY,Exempt,0,0,0,0,0,0
140430101300000,CENTRALLY ASSESSED,Other,0,0,0,0,0,0
140430101400000,CITY PROPERTY,Exempt,0,0,0,0,0,0
140430200100000,NE 120,Residential,30252,0,30252,134392,0,164644
140430200200000,NE 120,Residential,28000,0,28000,148589,0,176589
140430300100000,NE 120,Residential,32340,0,32340,159496,0,191836
140430300200000,NE 120,Residential,33280,0,33280,152485,0,185765
140432600100000,NE 120,Residential,30219,0,30219,142296,0,172515
140432600200000,NE 120,Residential,28785,0,28785,124986,0,153771
140432600300000,NE 120,Residential,29169,0,29169,126016,0,155185
140432600400000,NE 120,Residential,32435,0,32435,114509,0,146944
140432600500000,NE 120,Residential,33602,0,33602,108268,0,141870
140432600600000,NE 120,Residential,32311,0,32311,160597,0,192908
140432600700000,NE 120,Residential,32689,0,32689,161095,0,193784
140432601000000,NE 120,Residential,30600,0,30600,171618,0,202218
140432601100000,NE 120,Residential,2106,0,2106,0,0,2106
140432601200000,NE 120,Residential,29700,0,29700,139074,0,168774
140432601300000,NE 120,Residential,30528,0,30528,132431,0,162959
140432601400000,NE 120,Residential,33048,0,33048,176229,0,209277
140432601500000,NE 120,Residential,32000,0,32000,203597,0,235597
140432601600000,NE 120,Residential,30000,0,30000,154201,0,184201
140432601700000,NE 120,Residential,30000,0,30000,156322,0,186322
140432601800000,NE 120,Residential,30607,0,30607,125715,0,156322
140432601900000,NE 120,Residential,33507,0,33507,154438,0,187945
140432602000000,NE 120,Residential,33566,0,33566,145654,0,179220
140432602100000,NE 120,Residential,33152,0,33152,147350,0,180502
140432602200000,NE 120,Residential,32000,0,32000,175311,0,207311
140432700100000,NE 120,Residential,30756,0,30756,160825,0,191581
140432700200000,NE 120,Residential,32000,0,32000,154841,0,186841
140432700300000,NE 120,Residential,30000,0,30000,165127,0,195127
140432700400000,NE 120,Residential,28000,0,28000,151419,0,179419
140432700500000,NE 120,Residential,32000,0,32000,189821,0,221821
140432700600000,NE 120,Residential,34469,0,34469,179092,0,213561
140432700700000,NE 120,Residential,34800,0,34800,140398,0,175198
140432700800000,NE 120,Residential,33213,0,33213,123951,0,157164
140432700900000,NE 120,Residential,37332,0,37332,202356,0,239688
140432701000000,NE 120,Residential,32420,0,32420,158828,0,191248
140432701100000,NE 120,Residential,31820,0,31820,142847,0,174667
140432701200000,NE 120,Residential,31220,0,31220,153843,0,185063
140432701300000,NE 120,Residential,32340,0,32340,141984,0,174324
140432701400000,NE 120,Residential,31700,0,31700,145359,0,177059
140432701500000,NE 120,Residential,705,0,705,0,0,705
140432701600000,NE 120,Residential,33545,0,33545,215404,0,248949
140432701700000,NE 120,Residential,38907,0,38907,175178,0,214085
140432701800000,NE 120,Residential,28712,0,28712,139919,0,168631
140432701900000,NE 120,Residential,32340,0,32340,131519,0,163859
140432702000000,NE 120,Residential,26800,0,26800,145003,0,171803
140432702100000,NE 120,Residential,28916,0,28916,189188,0,218104
140432702200000,NE 120,Residential,26520,0,26520,130095,0,156615
140432702300000,NE 120,Residential,26395,0,26395,140974,0,167369
140432702400000,NE 120,Residential,28119,0,28119,128781,0,156900
140432702500000,NE 120,Residential,33512,0,33512,148524,0,182036
140432702600000,NE 120,Residential,27318,0,27318,152794,0,180112
140432702700000,NE 120,Residential,28560,0,28560,141418,0,169978
140432702800000,NE 120,Residential,28560,0,28560,163379,0,191939
140432702900000,NE 120,Residential,29620,0,29620,157909,0,187529
140432703000000,NE 120,Residential,33454,0,33454,143255,0,176709
140432703100000,NE 120,Residential,35148,0,35148,139467,0,174615
140432703200000,NE 120,Residential,34854,0,34854,145603,0,180457
140432703300000,NE 120,Residential,31902,0,31902,129911,0,161813
140432703400000,NE 120,Residential,28560,0,28560,128726,0,157286
140432703500000,NE 120,Residential,28560,0,28560,132684,0,161244
140432703600000,NE 120,Residential,26928,0,26928,141751,0,168679
140432703700000,NE 120,Residential,28215,0,28215,122317,0,150532
140432703800000,NE 120,Residential,30241,0,30241,141399,0,171640
140432703900000,NE 120,Residential,27160,0,27160,103018,0,130178
140432704000000,NE 120,Residential,27160,0,27160,116185,0,143345
140432704100000,NE 120,Residential,27160,0,27160,127989,0,155149
140432704200000,NE 120,Residential,27611,0,27611,103730,0,131341
140432800100000,NE 120,Residential,30492,0,30492,134897,0,165389
140432800200000,NE 120,Residential,29333,0,29333,124480,0,153813
140432800300000,NE 120,Residential,29851,0,29851,133441,0,163292
140432800400000,NE 120,Residential,26000,0,26000,98062,0,124062
140432800500000,NE 120,Residential,26000,0,26000,110052,0,136052
140432800600000,NE 120,Residential,26000,0,26000,107337,0,133337
140432800700000,NE 120,Residential,26000,0,26000,125947,0,151947
140432800800000,NE 120,Residential,26252,0,26252,113129,0,139381
140432900100000,NE 120,Residential,33048,0,33048,145751,0,178799
140432900200000,NE 120,Residential,32640,0,32640,157805,0,190445
140432900300000,NE 120,Residential,30300,0,30300,182483,0,212783
140432900400000,NE 120,Residential,32320,0,32320,135073,0,167393
140432900500000,NE 120,Residential,28000,0,28000,120674,0,148674
140432900600000,NE 120,Residential,32667,0,32667,0,0,32667
140432900800000,NE 120,Residential,28274,0,28274,179263,0,207537
140432900900000,NE 120,Residential,30138,0,30138,132274,0,162412
140435100100000,NE 121,Residential,30901,0,30901,98019,0,128920
140435100200000,NE 121,Residential,32130,0,32130,92214,0,124344
140435100300000,NE 121,Residential,32485,0,32485,87752,0,120237
140435100400000,NE 121,Residential,32314,0,32314,108124,0,140438
140435100500000,NE 121,Residential,31217,0,31217,121624,0,152841
140435100600000,NE 121,Residential,34807,0,34807,89398,0,124205
140435100700000,NE 121,Residential,32512,0,32512,91577,0,124089
140435100800000,NE 121,Residential,32237,0,32237,92639,0,124876
140435100900000,NE 121,Residential,32340,0,32340,110657,0,142997
140435101000000,NE 121,Residential,31084,0,31084,91547,0,122631
140435101100000,NE 121,Residential,30186,0,30186,93165,0,123351
140435101200000,NE 121,Residential,29788,0,29788,121376,0,151164
140435101300000,NE 121,Residential,30233,0,30233,79234,0,109467
140435200100000,NE 121,Residential,31479,0,31479,93571,0,125050
140435200200000,NE 121,Residential,32000,0,32000,141764,0,173764
140435200300000,NE 121,Residential,30000,0,30000,115220,0,145220
140435200400000,NE 121,Residential,32000,0,32000,113492,0,145492
140435200500000,NE 121,Residential,31851,0,31851,159246,0,191097
140435200600000,NE 121,Residential,30000,0,30000,128752,0,158752
140435200700000,NE 121,Residential,30559,0,30559,135592,0,166151
140435300100000,NE 121,Residential,30503,0,30503,127454,0,157957
140435300200000,NE 121,Residential,30000,0,30000,133564,0,163564
140435300300000,NE 121,Residential,31708,0,31708,121653,0,153361
140435300400000,NE 121,Residential,32776,0,32776,119576,0,152352
140435300500000,NE 121,Residential,33557,0,33557,122775,0,156332
140435300600000,NE 121,Residential,31913,0,31913,97755,0,129668
140435300700000,NE 121,Residential,32320,0,32320,94299,0,126619
140435300800000,NE 121,Residential,31924,0,31924,131944,0,163868
140435300900000,NE 121,Residential,30133,0,30133,103044,0,133177
140435301000000,NE 121,Residential,32695,0,32695,106295,0,138990
140435301100000,SCHOOL,Exempt,0,0,0,0,0,0
140435400100000,NE 121,Residential,28800,0,28800,106857,0,135657
140435400200000,NE 121,Residential,32732,0,32732,113221,0,145953
140435400300000,NE 121,Residential,36223,0,36223,118144,0,154367
140435400400000,NE 121,Residential,34634,0,34634,127761,0,162395
140435400500000,NE 121,Residential,37856,0,37856,158740,0,196596
140435400600000,NE 121,Residential,33818,0,33818,110895,0,144713
140435400700000,NE 121,Residential,35360,0,35360,149600,0,184960
140435400800000,NE 121,Residential,32694,0,32694,111669,0,144363
140435400900000,NE 121,Residential,29388,0,29388,89627,0,119015
140435401000000,NE 121,Residential,30420,0,30420,76465,0,106885
140435401100000,NE 121,Residential,29484,0,29484,89467,0,118951
140435401200000,NE 121,Residential,30420,0,30420,97054,0,127474
140435401300000,NE 121,Residential,29016,0,29016,91753,0,120769
140435401400000,NE 121,Residential,30186,0,30186,121378,0,151564
140435401500000,NE 121,Residential,31625,0,31625,90514,0,122139
140435401600000,NE 121,Residential,31875,0,31875,99575,0,131450
140435401700000,NE 121,Residential,31327,0,31327,87549,0,118876
140435401800000,NE 121,Residential,31936,0,31936,102150,0,134086
140435401900000,NE 121,Residential,32076,0,32076,116840,0,148916
140435500100000,NE 121,Residential,29198,0,29198,115458,0,144656
140435500200000,NE 121,Residential,30240,0,30240,101752,0,131992
140435500300000,NE 121,Residential,30600,0,30600,103535,0,134135
140435500400000,NE 121,Residential,30300,0,30300,97145,0,127445
140435500500000,NE 121,Residential,30346,0,30346,0,0,30346
140435500600000,NE 121,Residential,38942,0,38942,168669,0,207611
140435500700000,NE 121,Residential,28179,0,28179,103340,0,131519
140435500800000,NE 121,Residential,31229,0,31229,133100,0,164329
140435500900000,NE 121,Residential,32051,0,32051,113332,0,145383
140435501000000,NE 121,Residential,32130,0,32130,136257,0,168387
140435501100000,NE 121,Residential,33024,0,33024,144329,0,177353
140435501200000,NE 121,Residential,34238,0,34238,131954,0,166192
140435501300000,NE 121,Residential,30600,0,30600,110644,0,141244
140435501400000,NE 121,Residential,30569,0,30569,105040,0,135609
140435600100000,NE 121,Residential,32527,0,32527,109307,0,141834
140435600200000,NE 121,Residential,31920,0,31920,117828,0,149748
140435600300000,NE 121,Residential,29497,0,29497,139819,0,169316
140435600400000,NE 121,Residential,32320,0,32320,115304,0,147624
140435600500000,NE 121,Residential,32320,0,32320,127487,0,159807
140435600600000,NE 121,Residential,32320,0,32320,116533,0,148853
140435600700000,NE 121,Residential,32320,0,32320,152311,0,184631
140435600800000,NE 121,Residential,30866,0,30866,124222,0,155088
140435600900000,NE 121,Residential,32320,0,32320,131747,0,164067
140435601000000,NE 121,Residential,31373,0,31373,139322,0,170695
140435601100000,NE 121,Residential,32227,0,32227,144521,0,176748
140435601200000,NE 121,Residential,32000,0,32000,86797,0,118797
140435601300000,NE 121,Residential,31520,0,31520,120697,0,152217
140435601400000,NE 121,Residential,32320,0,32320,107657,0,139977
140435601500000,NE 121,Residential,32360,0,32360,113870,0,146230
140435601600000,NE 121,Residential,32724,0,32724,108826,0,141550
140435601700000,NE 121,Residential,33997,0,33997,121909,0,155906
140435700100000,NE 121,Residential,28800,0,28800,114507,0,143307
140435700200000,NE 121,Residential,28077,0,28077,104894,0,132971
140435700300000,NE 121,Residential,26520,0,26520,88759,0,115279
140435700400000,NE 121,Residential,28560,0,28560,83696,0,112256
140435700500000,NE 121,Residential,29338,0,29338,89212,0,118550
140435700600000,NE 121,Residential,31104,0,31104,85689,0,116793
140435700700000,NE 121,Residential,32628,0,32628,112527,0,145155
140435700800000,NE 121,Residential,24990,0,24990,84428,0,109418
140435700900000,NE 121,Residential,24990,0,24990,77877,0,102867
140435701000000,NE 121,Residential,24549,0,24549,82699,0,107248
140435701100000,NE 121,Residential,26460,0,26460,114338,0,140798
140437600100000,HOTEL,Commercial,0,470880,470880,0,2229120,2700000
140437600300000,FLAT PARKING,Commercial,0,27946,27946,0,10097,38043
140437600400000,CENTRALLY ASSESSED,Other,0,0,0,0,0,0
140437600500000,CITY PROPERTY,Exempt,0,0,0,0,0,0
140437601000000,APARTMENT,Commercial,0,24787,24787,0,175213,200000
140437700100000,NE 121,Residential,35475,0,35475,135747,0,171222
140437700200000,NE 121,Residential,30240,0,30240,159692,0,189932
140437700300000,NE 121,Residential,17113,0,17113,101815,0,118928
140437700400000,NE 121,Residential,11040,0,11040,87122,0,98162
140437700500000,NE 121,Residential,10848,0,10848,102585,0,113433
140437700600000,NE 121,Residential,16218,0,16218,103814,0,120032
140437701200000,NE 121,Residential,43306,0,43306,223486,0,266792
140437701300000,NE 121,Residential,39168,0,39168,212428,0,251596
140437701400000,NE 121,Residential,32000,0,32000,155747,0,187747
140437701500000,NE 121,Residential,30000,0,30000,175213,0,205213
140437701600000,NE 121,Residential,32000,0,32000,174570,0,206570
140437701700000,NE 121,Residential,20842,0,20842,145455,0,166297
140437701800000,NE 121,Residential,30000,0,30000,155149,0,185149
140437701900000,NE 121,Residential,32912,0,32912,204288,0,237200
140437702000000,NE 121,Residential,28560,0,28560,68423,0,96983
140437702100000,NE 121,Residential,25200,0,25200,64904,0,90104
140437702200000,NE 121,Residential,24903,0,24903,88789,0,113692
140437702300000,NE 121,Residential,26185,0,26185,97746,0,123931
140437702400000,NE 121,Residential,26552,0,26552,119694,0,146246
140437702500000,NE 121,Residential,27562,0,27562,118088,0,145650
140437702600000,NE 121,Residential,27930,0,27930,111532,0,139462
140437702700000,NE 121,Residential,26460,0,26460,110920,0,137380
140437702800000,NE 121,Residential,26460,0,26460,121602,0,148062
140437702900000,NE 121,Residential,26185,0,26185,115469,0,141654
140437703000000,NE 121,Residential,26185,0,26185,90907,0,117092
140437703100000,NE 121,Residential,25436,0,25436,74937,0,100373
140437800100000,NE 121,Residential,31492,0,31492,126520,0,158012
140437800200000,NE 121,Residential,32640,0,32640,139433,0,172073
140437800300000,NE 121,Residential,32640,0,32640,154118,0,186758
140437800400000,NE 121,Residential,34680,0,34680,156641,0,191321
140437800500000,NE 121,Residential,32640,0,32640,139911,0,172551
140437800600000,NE 121,Residential,30600,0,30600,137533,0,168133
140437800700000,NE 121,Residential,31144,0,31144,172483,0,203627
140437800800000,NE 121,Residential,34088,0,34088,184481,0,218569
140437800900000,NE 121,Residential,31122,0,31122,120106,0,151228
140437801000000,NE 121,Residential,30420,0,30420,102735,0,133155
140437801100000,NE 121,Residential,30233,0,30233,117734,0,147967
140437801200000,NE 121,Residential,30233,0,30233,89399,0,119632
140437801300000,NE 121,Residential,31255,0,31255,91636,0,122891
140437801400000,NE 121,Residential,40747,0,40747,181332,0,222079
140437801500000,NE 121,Residential,30000,0,30000,163920,0,193920
140437801600000,NE 121,Residential,34200,0,34200,197688,0,231888
140437801700000,NE 121,Residential,32716,0,32716,159551,0,192267
140437801800000,NE 121,Residential,33354,0,33354,163229,0,196583
140437801900000,NE 121,Residential,34290,0,34290,165571,0,199861
140440100100000,SCHOOL,Exempt,0,1042200,1042200,0,5992277,7034477
140440100400000,NE 118,Residential,34880,0,34880,136004,0,170884
140440100500000,NE 118,Residential,32427,0,32427,78037,0,110464
140440100700000,NE 118,Residential,30495,0,30495,53328,0,83823
140440100800000,NE 118,Residential,33197,0,33197,89275,0,122472
140440100900000,NE 118,Residential,31200,0,31200,83271,0,114471
140440101000000,NE 118,Residential,31200,0,31200,95087,0,126287
140440101100000,NE 118,Residential,31200,0,31200,79269,0,110469
140440101200000,NE 118,Residential,31200,0,31200,88132,0,119332
140440101300000,NE 118,Residential,32205,0,32205,105897,0,138102
140440101400000,NE 118,Residential,31200,0,31200,84693,0,115893
140440101500000,NE 118,Residential,31200,0,31200,106639,0,137839
140440101600000,NE 118,Residential,31200,0,31200,94990,0,126190
140440101700000,NE 118,Residential,31200,0,31200,87069,0,118269
140440101800000,NE 118,Residential,31200,0,31200,83575,0,114775
140440101900000,NE 118,Residential,31200,0,31200,93950,0,125150
140440102000000,NE 118,Residential,31200,0,31200,87065,0,118265
140440102100000,NE 118,Residential,31200,0,31200,81511,0,112711
140440102200000,NE 118,Residential,31200,0,31200,106041,0,137241
140440102300000,NE 118,Residential,31200,0,31200,103939,0,135139
140440102400000,NE 118,Residential,31200,0,31200,89251,0,120451
140440102500000,NE 118,Residential,31200,0,31200,94501,0,125701
140440102600000,NE 118,Exempt,0,34424,34424,0,118458,152882
140440102700000,NE 118,Residential,31240,0,31240,66333,0,97573
140440102800000,NE 118,Residential,52964,0,52964,151890,0,204854
140440200100000,NE 118,Residential,33484,0,33484,102090,0,135574
140440200200000,NE 118,Residential,31200,0,31200,79449,0,110649
140440200300000,NE 118,Residential,31200,0,31200,77324,0,108524
140440200400000,NE 118,Residential,31200,0,31200,74787,0,105987
140440200500000,NE 118,Residential,31200,0,31200,78828,0,110028
140440200600000,NE 118,Residential,31200,0,31200,71504,0,102704
140440200700000,NE 118,Residential,31200,0,31200,116248,0,147448
140440200800000,NE 118,Residential,31200,0,31200,87942,0,119142
140440200900000,NE 118,Residential,31200,0,31200,77089,0,108289
140440201000000,NE 118,Residential,31200,0,31200,86158,0,117358
140440201100000,NE 118,Residential,31200,0,31200,88298,0,119498
140440201200000,NE 118,Residential,31200,0,31200,87497,0,118697
140440201300000,NE 118,Residential,31200,0,31200,112209,0,143409
140440201400000,NE 118,Residential,31200,0,31200,85574,0,116774
140440201500000,NE 118,Residential,31200,0,31200,90099,0,121299
140440201600000,NE 118,Residential,31593,0,31593,74691,0,106284
140440201700000,NE 118,Residential,31200,0,31200,74138,0,105338
140440201800000,NE 118,Residential,31200,0,31200,81349,0,112549
140440201900000,NE 118,Residential,26750,0,26750,68859,0,95609
140440202000000,NE 118,Residential,34507,0,34507,106497,0,141004
140440202100000,NE 118,Residential,33186,0,33186,103577,0,136763
140440202200000,NE 118,Residential,32460,0,32460,89185,0,121645
140440202300000,NE 118,Residential,32040,0,32040,87585,0,119625
140440202400000,NE 118,Residential,31000,0,31000,91433,0,122433
140440202500000,NE 118,Residential,32400,0,32400,101150,0,133550
140440202600000,NE 118,Residential,30000,0,30000,84682,0,114682
140440202700000,NE 118,Residential,32300,0,32300,76066,0,108366
140440202800000,NE 118,Residential,31000,0,31000,66142,0,97142
140440202900000,NE 118,Residential,30000,0,30000,89220,0,119220
140440203000000,NE 118,Residential,31000,0,31000,84827,0,115827
140440203100000,NE 118,Residential,33858,0,33858,73105,0,106963
140440203200000,NE 118,Residential,34708,0,34708,78442,0,113150
140440203300000,NE 118,Residential,35062,0,35062,102036,0,137098
140440203400000,NE 118,Residential,33088,0,33088,87123,0,120211
140440203500000,NE 118,Residential,32709,0,32709,71452,0,104161
140440203600000,NE 118,Residential,34501,0,34501,119905,0,154406
140440203700000,NE 118,Residential,50500,0,50500,113550,0,164050
140440203900000,NE 118,Residential,30150,0,30150,93337,0,123487
140440204000000,NE 118,Residential,29324,0,29324,95933,0,125257
140440204100000,NE 118,Residential,27540,0,27540,91053,0,118593
140440204200000,NE 118,Residential,27540,0,27540,94345,0,121885
140440204300000,NE 118,Residential,27540,0,27540,92314,0,119854
140440204400000,NE 118,Residential,25239,0,25239,96892,0,122131
140440300100000,NE 118,Residential,27575,0,27575,105854,0,133429
140440300200000,NE 118,Residential,28152,0,28152,88000,0,116152
140440300300000,NE 118,Residential,34331,0,34331,108299,0,142630
140440300400000,NE 118,Residential,32100,0,32100,87460,0,119560
140440400100000,NE 118,Residential,34026,0,34026,102559,0,136585
140440400200000,NE 118,Residential,32635,0,32635,104642,0,137277
140440400300000,NE 118,Residential,32100,0,32100,70451,0,102551
140440400400000,NE 118,Residential,34240,0,34240,83751,0,117991
140440400500000,NE 118,Residential,29960,0,29960,94576,0,124536
140440400600000,NE 118,Residential,31800,0,31800,91978,0,123778
140440400700000,NE 118,Residential,30532,0,30532,88333,0,118865
140440600100000,AUTO REPAIR/SALES,Commercial,0,388800,388800,0,417817,806617
140440600200000,HOTEL,Commercial,0,541350,541350,0,2668453,3209803
140440600300000,NBHD SHOPPING CENTER,Commercial,0,492480,492480,0,1034718,1527198
140442700100000,NE 118,Residential,38985,0,38985,0,0,38985
140442700300000,AUTO REPAIR/SALES,Commercial,0,768960,768960,0,1391912,2160872
140442700400000,CHURCH,Exempt,0,171396,171396,0,4858632,5030028
140442700600000,NE 118,Residential,41040,0,41040,79234,0,120274
140442700700000,NE 118,Residential,50669,0,50669,76924,0,127593
140442700800000,NE 118,Residential,36223,0,36223,89172,0,125395
140442700900000,NE 118,Residential,50535,0,50535,95529,0,146064
140442701000000,FLAT PARKING,Commercial,0,384750,384750,0,0,384750
140442701100000,WAREHOUSE,Commercial,0,708048,708048,0,1016238,1724286
140445100100000,NE 118,Residential,34906,0,34906,84684,0,119590
140445100200000,NE 118,Residential,33668,0,33668,71332,0,105000
140445100300000,NE 118,Residential,34122,0,34122,77228,0,111350
140445100400000,NE 118,Residential,31020,0,31020,87881,0,118901
140445100500000,NE 118,Residential,31020,0,31020,84665,0,115685
140445100600000,NE 118,Residential,31020,0,31020,74465,0,105485
140445100700000,NE 118,Residential,31020,0,31020,90573,0,121593
140445100800000,NE 118,Residential,31020,0,31020,78100,0,109120
140445100900000,NE 118,Residential,31020,0,31020,78222,0,109242
140445101000000,NE 118,Residential,31020,0,31020,71991,0,103011
140445101100000,NE 118,Residential,31020,0,31020,74452,0,105472
140445101200000,NE 118,Residential,31020,0,31020,81889,0,112909
140445101300000,NE 118,Residential,31020,0,31020,84180,0,115200
140445101400000,NE 118,Residential,31020,0,31020,86147,0,117167
140445101500000,NE 118,Residential,36652,0,36652,91388,0,128040
140445101600000,NE 118,Residential,36241,0,36241,87239,0,123480
140445101700000,NE 118,Residential,36920,0,36920,99884,0,136804
140445101800000,NE 118,Residential,36052,0,36052,84688,0,120740
140445101900000,NE 118,Residential,41580,0,41580,107646,0,149226
140445200100000,NE 118,Residential,34849,0,34849,98906,0,133755
140445200200000,NE 118,Residential,31026,0,31026,94760,0,125786
140445200300000,NE 118,Residential,31155,0,31155,108466,0,139621
140445200400000,NE 118,Residential,31155,0,31155,104937,0,136092
140445200500000,NE 118,Residential,31929,0,31929,95230,0,127159
140445200600000,NE 118,Residential,33683,0,33683,87110,0,120793
140445200700000,NE 118,Residential,32340,0,32340,90973,0,123313
140445200800000,NE 118,Residential,30300,0,30300,82623,0,112923
140445200900000,NE 118,Residential,30255,0,30255,86210,0,116465
140445201000000,NE 118,Residential,30600,0,30600,79122,0,109722
140445201100000,NE 118,Residential,30600,0,30600,69044,0,99644
140445201200000,NE 118,Residential,30600,0,30600,88524,0,119124
140445201300000,NE 118,Residential,30600,0,30600,77754,0,108354
140445201400000,NE 118,Residential,30600,0,30600,75165,0,105765
140445201500000,NE 118,Residential,28913,0,28913,80984,0,109897
140445201600000,NE 118,Residential,28800,0,28800,78418,0,107218
140445201700000,NE 118,Residential,36121,0,36121,76947,0,113068
140445201800000,NE 118,Residential,35693,0,35693,79034,0,114727
140445201900000,NE 118,Residential,33660,0,33660,76848,0,110508
140445202000000,NE 118,Residential,33660,0,33660,77061,0,110721
140445202100000,NE 118,Residential,33660,0,33660,73123,0,106783
140445202200000,NE 118,Residential,33660,0,33660,91405,0,125065
140445202300000,NE 118,Residential,33660,0,33660,120611,0,154271
140445202400000,NE 118,Residential,33000,0,33000,103099,0,136099
140445202500000,NE 118,Residential,31680,0,31680,75906,0,107586
140445202600000,NE 118,Residential,33088,0,33088,88015,0,121103
140445202700000,NE 118,Residential,33067,0,33067,74163,0,107230
140445202800000,NE 118,Residential,31020,0,31020,74377,0,105397
140445202900000,NE 118,Residential,34639,0,34639,84870,0,119509
140445203000000,NE 118,Residential,34639,0,34639,81469,0,116108
140445300100000,NE 118,Residential,31639,0,31639,84653,0,116292
140445300200000,NE 118,Residential,31960,0,31960,103233,0,135193
140445300300000,NE 118,Residential,31960,0,31960,71495,0,103455
140445300400000,NE 118,Residential,31161,0,31161,107662,0,138823
140445400100000,NE 118,Residential,38157,0,38157,80159,0,118316
140445400200000,NE 118,Residential,41400,0,41400,68593,0,109993
140445400400000,SMALL RETAIL,Commercial,0,292572,292572,0,566322,858894
140445400500000,NE 118,Residential,33900,0,33900,101005,0,134905
140445400700000,NE 118,Residential,42234,0,42234,117946,0,160180
140445400800000,CHURCH,Exempt,0,648000,648000,0,490284,1138284
140445401100000,SMALL RETAIL,Commercial,0,54043,54043,0,48770,102813
140445401200000,SMALL RETAIL,Commercial,0,52877,52877,0,46701,99578
140445401300000,NE 118,Residential,30600,0,30600,0,0,30600
140445401400000,NE 118,Residential,28200,0,28200,91228,0,119428
140445401500000,NE 118,Residential,29550,0,29550,80614,0,110164
140445401600000,NE 118,Residential,26765,0,26765,106312,0,133077
140445401700000,NE 118,Residential,28050,0,28050,73524,0,101574
140445401800000,NE 118,Residential,27775,0,27775,79354,0,107129
140445401900000,NE 118,Residential,27775,0,27775,75438,0,103213
140445402000000,NE 118,Residential,30750,0,30750,51847,0,82597
140445402100000,OFFICE; MEDICAL,Commercial,0,254759,254759,0,569948,824707
140445500100000,FLAT PARKING,Commercial,0,78300,78300,0,9900,88200
140445500200000,FLAT PARKING,Commercial,0,45900,45900,0,9900,55800
140445500300000,AUTO REPAIR/SALES,Commercial,0,480600,480600,0,522709,1003309
140445500400000,NBHD SHOPPING CENTER,Commercial,0,265410,265410,0,878737,1144147
140445600100000,OFFICE,Commercial,0,52693,52693,0,235096,287789
140445600200000,NE 118,Residential,29974,0,29974,56796,0,86770
140445700100000,NE 118,Residential,34550,0,34550,83427,0,117977
140445700200000,NE 118,Residential,28581,0,28581,69613,0,98194
140445700300000,FAST FOOD,Commercial,0,166504,166504,0,66567,233071
140445700400000,FAST FOOD,Commercial,0,349920,349920,0,345821,695741
140445700500000,NE 118,Residential,29343,0,29343,77084,0,106427
140445700600000,NE 118,Residential,29343,0,29343,78780,0,108123
140445800100000,NBHD SHOPPING CENTER,Commercial,0,460080,460080,0,1536951,1997031
140445800200000,FLAT PARKING,Commercial,0,40037,40037,0,9094,49131
140445800400000,FAST FOOD,Commercial,0,138132,138132,0,48884,187016
140445800500000,CONVENIENCE STORE,Commercial,0,146340,146340,0,204099,350439
140445800600000,FLAT PARKING,Commercial,0,83430,83430,0,1800,85230
140445800700000,RESTAURANT,Commercial,0,141990,141990,0,76576,218566
140445800800000,RESTAURANT,Commercial,0,165794,165794,0,69983,235777
140445800900000,CITY PROPERTY,Exempt,0,0,0,0,0,0
140445801000000,SMALL RETAIL,Commercial,0,143100,143100,0,267107,410207
140447600100000,NE 118,Residential,25081,0,25081,56169,0,81250
140447600200000,NE 118,Residential,26420,0,26420,71245,0,97665
140447600300000,NE 118,Residential,25380,0,25380,61325,0,86705
140447600400000,NE 118,Residential,25380,0,25380,56111,0,81491
140447600500000,NE 118,Residential,25380,0,25380,60372,0,85752
140447600600000,NE 118,Residential,25380,0,25380,59353,0,84733
140447600700000,NE 118,Residential,25380,0,25380,62405,0,87785
140447600800000,NE 118,Residential,25380,0,25380,63437,0,88817
140447600900000,NE 118,Residential,25380,0,25380,60513,0,85893
140447601000000,NE 118,Residential,25380,0,25380,58670,0,84050
140447601100000,NE 118,Residential,25380,0,25380,71192,0,96572
140447601200000,NE 118,Residential,25380,0,25380,63076,0,88456
140447601300000,NE 118,Residential,25380,0,25380,58359,0,83739
140447601400000,NE 118,Residential,25380,0,25380,60051,0,85431
140447601500000,NE 118,Residential,25380,0,25380,56416,0,81796
140447601600000,NE 118,Residential,25380,0,25380,56419,0,81799
140447601700000,NE 118,Residential,25380,0,25380,59505,0,84885
140447601800000,NE 118,Residential,25380,0,25380,60183,0,85563
140447601900000,NE 118,Residential,25380,0,25380,58168,0,83548
140447602000000,NE 118,Residential,25380,0,25380,55977,0,81357
140447602100000,NE 118,Residential,28354,0,28354,59882,0,88236
140447602200000,NE 118,Residential,28452,0,28452,83136,0,111588
140447602300000,NE 118,Residential,25380,0,25380,55443,0,80823
140447602400000,NE 118,Residential,25380,0,25380,58903,0,84283
140447602500000,NE 118,Residential,25380,0,25380,63572,0,88952
140447602600000,NE 118,Residential,25380,0,25380,56825,0,82205
140447602700000,NE 118,Residential,25380,0,25380,71974,0,97354
140447602800000,NE 118,Residential,25380,0,25380,58644,0,84024
140447602900000,NE 118,Residential,25380,0,25380,51539,0,76919
140447603000000,NE 118,Residential,25380,0,25380,65442,0,90822
140447603100000,NE 118,Residential,25380,0,25380,57768,0,83148
140447603200000,NE 118,Residential,25380,0,25380,60047,0,85427
140447603300000,NE 118,Residential,25380,0,25380,54436,0,79816
140447603400000,NE 118,Residential,25380,0,25380,55995,0,81375
140447603500000,NE 118,Residential,25380,0,25380,74457,0,99837
140447603600000,NE 118,Residential,25380,0,25380,62751,0,88131
140447603700000,NE 118,Residential,25380,0,25380,60195,0,85575
140447603800000,NE 118,Residential,25380,0,25380,63078,0,88458
140447603900000,NE 118,Residential,25380,0,25380,66955,0,92335
140447604000000,NE 118,Residential,25380,0,25380,70925,0,96305
140447700100000,NE 118,Residential,27069,0,27069,59939,0,87008
140447700200000,NE 118,Residential,26183,0,26183,82298,0,108481
140447700300000,NE 118,Residential,25650,0,25650,62890,0,88540
140447700400000,NE 118,Residential,25650,0,25650,56851,0,82501
140447700500000,NE 118,Residential,31009,0,31009,75472,0,106481
140447700600000,NE 118,Residential,25650,0,25650,83664,0,109314
140447700700000,NE 118,Residential,25650,0,25650,61101,0,86751
140447700800000,NE 118,Residential,25650,0,25650,56504,0,82154
140447700900000,NE 118,Residential,25650,0,25650,62053,0,87703
140447701000000,NE 118,Residential,25650,0,25650,69163,0,94813
140447701100000,NE 118,Residential,25650,0,25650,61277,0,86927
140447701200000,NE 118,Residential,25650,0,25650,60160,0,85810
140447701300000,NE 118,Residential,25650,0,25650,64097,0,89747
140447701400000,NE 118,Residential,25650,0,25650,48111,0,73761
140447701500000,NE 118,Residential,25650,0,25650,63074,0,88724
140447701600000,NE 118,Residential,25650,0,25650,61342,0,86992
140447701700000,NE 118,Residential,25650,0,25650,67301,0,92951
140447701800000,NE 118,Residential,25650,0,25650,56665,0,82315
140447701900000,NE 118,Residential,25650,0,25650,67506,0,93156
140447702000000,NE 118,Residential,25650,0,25650,65037,0,90687
140447702100000,NE 118,Residential,26745,0,26745,82404,0,109149
140447702200000,NE 118,Residential,27667,0,27667,59736,0,87403
140447702300000,NE 118,Residential,25650,0,25650,60526,0,86176
140447702400000,NE 118,Residential,25650,0,25650,56127,0,81777
140447702500000,NE 118,Residential,25650,0,25650,60387,0,86037
140447702600000,NE 118,Residential,25650,0,25650,58531,0,84181
140447702700000,NE 118,Residential,25650,0,25650,50969,0,76619
140447702800000,NE 118,Residential,25650,0,25650,61782,0,87432
140447702900000,NE 118,Residential,25550,0,25550,61450,0,87000
140447703000000,NE 118,Residential,25650,0,25650,47213,0,72863
140447703100000,NE 118,Residential,25650,0,25650,54179,0,79829
140447703200000,NE 118,Residential,25650,0,25650,64022,0,89672
140447703300000,NE 118,Residential,25650,0,25650,54892,0,80542
140447703400000,NE 118,Residential,25650,0,25650,62152,0,87802
140447703500000,NE 118,Residential,25650,0,25650,58806,0,84456
140447703600000,NE 118,Residential,25650,0,25650,58533,0,84183
140447703700000,NE 118,Residential,25650,0,25650,65310,0,90960
140447703800000,NE 118,Residential,25650,0,25650,58684,0,84334
140447703900000,NE 118,Residential,26933,0,26933,59129,0,86062
140447704000000,NE 118,Residential,26505,0,26505,66895,0,93400
140447800100000,NE 118,Residential,26065,0,26065,80221,0,106286
140447800200000,NE 118,Residential,37615,0,37615,86736,0,124351
140447800300000,NE 118,Residential,36408,0,36408,90108,0,126516
140447800400000,NE 118,Residential,34892,0,34892,73705,0,108597
140447800500000,NE 118,Residential,34320,0,34320,74180,0,108500
140447800600000,NE 118,Residential,34530,0,34530,83967,0,118497
140447800700000,NE 118,Residential,32010,0,32010,89284,0,121294
140447800800000,CITY PROPERTY,Exempt,0,0,0,0,0,0
140447800900000,NE 118,Residential,34320,0,34320,85009,0,119329
140447801000000,CITY PROPERTY,Exempt,0,0,0,0,0,0
140447801200000,NE 118,Residential,25000,0,25000,0,0,25000
140447801300000,OFFICE,Commercial,0,152064,152064,0,655330,807394
140447801400000,NE 118,Residential,26734,0,26734,83528,0,110262
140447801500000,NE 118,Residential,25380,0,25380,48723,0,74103
140447801600000,NE 118,Residential,25380,0,25380,67168,0,92548
140447801700000,NE 118,Residential,25380,0,25380,66047,0,91427
140447801800000,NE 118,Residential,25380,0,25380,80245,0,105625
140447801900000,NE 118,Residential,25380,0,25380,61841,0,87221
140447802000000,NE 118,Residential,25380,0,25380,61858,0,87238
140447802100000,NE 118,Residential,25380,0,25380,65087,0,90467
140447802200000,NE 118,Residential,25380,0,25380,59604,0,84984
140447802300000,NE 118,Residential,25380,0,25380,61611,0,86991
140447802400000,NE 118,Residential,25380,0,25380,58276,0,83656
140447802500000,NE 118,Residential,25380,0,25380,54415,0,79795
140447802600000,NE 118,Residential,25380,0,25380,61672,0,87052
140447802700000,NE 118,Residential,25380,0,25380,64414,0,89794
140447802800000,CITY PROPERTY,Exempt,0,0,0,0,0,0
140447802900000,NE 118,Residential,26720,0,26720,82706,0,109426
140447803000000,NE 118,Residential,25380,0,25380,58619,0,83999
140447803100000,NE 118,Residential,25380,0,25380,81740,0,107120
140447803200000,NE 118,Residential,25380,0,25380,73032,0,98412
140447900100000,NE 118,Residential,28600,0,28600,97554,0,126154
140447900200000,NE 118,Residential,37847,0,37847,80823,0,118670
140447900300000,NE 118,Residential,34892,0,34892,82258,0,117150
140447900400000,NE 118,Residential,34892,0,34892,87360,0,122252
140447900500000,NE 118,Residential,34892,0,34892,82365,0,117257
140447900600000,NE 118,Residential,34892,0,34892,134669,0,169561
140447900700000,NE 118,Residential,34892,0,34892,76200,0,111092
140447900800000,NE 118,Residential,34892,0,34892,76047,0,110939
140447900900000,NE 118,Residential,34892,0,34892,81379,0,116271
140447901000000,NE 118,Residential,34892,0,34892,86238,0,121130
140447901100000,NE 118,Residential,34892,0,34892,82552,0,117444
140447901201000,OFFICE,Commercial,0,26460,26460,0,89263,115723
140447901201001,OFFICE,Commercial,0,26460,26460,0,89263,115723
140447901201002,OFFICE,Commercial,0,26460,26460,0,89263,115723
140447901201003,OFFICE,Commercial,0,26460,26460,0,90003,116463
140447901201004,OFFICE,Commercial,0,34020,34020,0,112971,146991
140447901201005,OFFICE,Commercial,0,34020,34020,0,112971,146991
140447901201006,OFFICE,Commercial,0,139860,139860,0,286742,426602
140447901301000,OFFICE,Commercial,0,26460,26460,0,88878,115338
140447901301001,OFFICE,Commercial,0,26460,26460,0,88147,114607
140447901301002,OFFICE,Commercial,0,26460,26460,0,89263,115723
140447901301003,OFFICE,Commercial,0,26460,26460,0,89263,115723
140447901400000,CHURCH,Exempt,0,369360,369360,0,227437,596797
140447901401000,OFFICE,Commercial,0,26460,26460,0,86525,112985
140447901401001,OFFICE,Commercial,0,26460,26460,0,90378,116838
140447901401002,OFFICE,Commercial,0,26460,26460,0,91257,117717
140447901401003,OFFICE,Commercial,0,26460,26460,0,92007,118467
140447901500000,APARTMENT,Commercial,0,30261,30261,0,147166,177427
140447901600000,APARTMENT,Residential,15757,0,15757,184389,0,200146
140447902000000,APARTMENT,Residential,52488,0,52488,740616,0,793104
140447902100000,APARTMENT,Commercial,0,13122,13122,0,123582,136704
140447902200000,APARTMENT,Commercial,0,17378,17378,0,186972,204350
140448000100000,NE 118,Residential,37480,0,37480,81766,0,119246
140448000200000,NE 118,Residential,34892,0,34892,78294,0,113186
140448000300000,NE 118,Residential,34892,0,34892,91004,0,125896
140448000400000,NE 118,Residential,34892,0,34892,85699,0,120591
140448000500000,NE 118,Residential,36036,0,36036,89064,0,125100
140448000600000,NE 118,Residential,33748,0,33748,87574,0,121322
140448000700000,NE 118,Residential,34892,0,34892,80601,0,115493
140448000800000,NE 118,Residential,34320,0,34320,93479,0,127799
140448000900000,NE 118,Residential,29172,0,29172,64376,0,93548
140448001000000,NE 118,Residential,35510,0,35510,85941,0,121451
140448001100000,NE 118,Residential,19800,0,19800,0,0,19800
140510600100000,CONVENIENCE STORE,Commercial,0,178848,178848,0,251061,429909
140510600200000,FLAT PARKING,Commercial,0,145152,145152,0,14083,159235
140510600300000,NBHD SHOPPING CENTER,Commercial,0,148191,148191,0,255784,403975
140510600400000,WAREHOUSE,Commercial,0,294300,294300,0,239928,534228
140510600501000,NBHD SHOPPING CENTER,Commercial,0,44280,44280,0,90448,134728
140510600501001,NBHD SHOPPING CENTER,Commercial,0,30240,30240,0,62359,92599
140510600501002,NBHD SHOPPING CENTER,Commercial,0,35640,35640,0,73469,109109
140510600501003,NBHD SHOPPING CENTER,Commercial,0,27540,27540,0,57692,85232
140510600501004,NBHD SHOPPING CENTER,Commercial,0,35640,35640,0,73469,109109
140510600501005,NBHD SHOPPING CENTER,Commercial,0,30240,30240,0,62359,92599
140510600501006,NBHD SHOPPING CENTER,Commercial,0,35640,35640,0,73469,109109
140510600501007,NBHD SHOPPING CENTER,Commercial,0,30240,30240,0,62359,92599
140510600501008,NBHD SHOPPING CENTER,Commercial,0,35640,35640,0,73469,109109
140510600501009,NBHD SHOPPING CENTER,Commercial,0,30240,30240,0,62359,92599
140510600501010,NBHD SHOPPING CENTER,Commercial,0,35640,35640,0,73469,109109
140510600501011,NBHD SHOPPING CENTER,Commercial,0,32940,32940,0,67914,100854
140510600501012,NBHD SHOPPING CENTER,Commercial,0,35640,35640,0,73469,109109
140510600501013,NBHD SHOPPING CENTER,Commercial,0,30240,30240,0,62359,92599
140510600501014,NBHD SHOPPING CENTER,Commercial,0,35640,35640,0,74243,109883
140510600501015,NBHD SHOPPING CENTER,Commercial,0,30240,30240,0,62932,93172
140510600501016,NBHD SHOPPING CENTER,Commercial,0,35640,35640,0,74148,109788
140510600501017,NBHD SHOPPING CENTER,Commercial,0,30240,30240,0,62359,92599
140510600501018,NBHD SHOPPING CENTER,Commercial,0,35640,35640,0,74148,109788
140510600501019,NBHD SHOPPING CENTER,Commercial,0,30240,30240,0,62359,92599
140510600501020,NBHD SHOPPING CENTER,Commercial,0,37800,37800,0,75425,113225
140510600501021,NBHD SHOPPING CENTER,Commercial,0,28080,28080,0,58581,86661
140510600501022,NBHD SHOPPING CENTER,Commercial,0,32940,32940,0,67914,100854
140510600501023,NBHD SHOPPING CENTER,Commercial,0,28620,28620,0,59049,87669
140510600501024,NBHD SHOPPING CENTER,Commercial,0,37260,37260,0,76777,114037
140510600600000,FAST FOOD,Commercial,0,590919,590919,0,584905,1175824
140510600700000,FLAT PARKING,Commercial,0,346249,346249,0,93073,439322
140510600900000,FAST FOOD,Commercial,0,579078,579078,0,686223,1265301
140510601000000,FLAT PARKING,Commercial,0,63136,63136,0,69597,132733
140510601100000,RESTAURANT,Commercial,0,672620,672620,0,448027,1120647
140510601200000,FAST FOOD,Commercial,0,268562,268562,0,461850,730412
140510601300000,FAST FOOD,Commercial,0,243371,243371,0,415021,658392
140512900100000,NBHD SHOPPING CENTER,Commercial,0,298710,298710,0,524447,823157
140512900200000,RESTAURANT,Commercial,0,246710,246710,0,350844,597554
140512900300000,FAST FOOD,Commercial,0,323352,323352,0,523043,846395
140512900400000,SMALL RETAIL,Commercial,0,348804,348804,0,509316,858120
140512900500000,BRANCH BANK/CU,Commercial,0,670686,670686,0,2158379,2829065
140512900900000,GROCERY STORE,Commercial,0,548705,548705,0,1017990,1566695
140512901200000,LG DISCOUNT/RETAIL,Commercial,0,1087659,1087659,0,6077937,7165596
140512901300000,VACANT LAND,Commercial,0,1688,1688,0,0,1688
140515100300000,VACANT LAND,Commercial,0,45842,45842,0,0,45842
140515100400000,CHURCH,Exempt,0,997002,997002,0,6946905,7943907
140517600300000,WAREHOUSE,Commercial,0,228105,228105,0,880927,1109032
140517600400000,WAREHOUSE,Commercial,0,270000,270000,0,505892,775892
140517600500000,WAREHOUSE,Commercial,0,217339,217339,0,657632,874971
140517600600000,VACANT LAND,Commercial,0,128823,128823,0,0,128823
140517600700000,DAY CARE CENTER,Commercial,0,101253,101253,0,391411,492664
140517600800000,FLAT PARKING,Commercial,0,132718,132718,0,0,132718
140517600900000,LG DISCOUNT/RETAIL,Commercial,0,965286,965286,0,4097229,5062515
140517601000000,LG DISCOUNT/RETAIL,Commercial,0,1145858,1145858,0,5604992,6750850
140517601100000,WAREHOUSE,Commercial,0,273725,273725,0,930939,1204664
140517601200000,VACANT LAND,Commercial,0,240720,240720,0,0,240720
140520800100000,NE 111,Residential,740,0,740,0,0,740
140520800200000,APARTMENT,Commercial,0,105840,105840,0,76070,181910
140520800300000,NE 168,Residential,60000,0,60000,131599,0,191599
140520800400000,APARTMENT,Exempt,0,73440,73440,0,679925,753365
140520800500000,APARTMENT,Exempt,0,29527,29527,0,247318,276845
140522700100000,CHURCH,Exempt,0,465264,465264,0,768960,1234224
140522700200000,NE 113,Residential,22563,0,22563,101205,0,123768
140522700300000,NE 113,Residential,22560,0,22560,117081,0,139641
140522700400000,NE 113,Residential,22800,0,22800,114124,0,136924
140522700500000,NE 113,Residential,22800,0,22800,106150,0,128950
140522700600000,NE 113,Residential,23040,0,23040,131964,0,155004
140522700700000,NE 113,Residential,22272,0,22272,102297,0,124569
140522700800000,NE 113,Residential,26214,0,26214,99833,0,126047
140522700900000,NE 113,Residential,26216,0,26216,98453,0,124669
140522701000000,NE 113,Residential,22560,0,22560,93778,0,116338
140522701100000,NE 113,Residential,22560,0,22560,92164,0,114724
140522701200000,NE 113,Residential,22560,0,22560,91957,0,114517
140522701300000,NE 113,Residential,24741,0,24741,93827,0,118568
140522800100000,CHURCH,Exempt,0,494640,494640,0,1920395,2415035
140522800200000,NE 113,Residential,24696,0,24696,122101,0,146797
140522800300000,NE 113,Residential,24020,0,24020,111729,0,135749
140522800400000,NE 113,Residential,23775,0,23775,107812,0,131587
140522800500000,NE 113,Residential,23775,0,23775,96420,0,120195
140522800600000,NE 113,Residential,23530,0,23530,116669,0,140199
140522800700000,NE 113,Residential,23530,0,23530,111502,0,135032
140522800800000,NE 113,Residential,23530,0,23530,108873,0,132403
140522800900000,NE 113,Residential,24530,0,24530,130414,0,154944
140522801000000,NE 113,Residential,25868,0,25868,124174,0,150042
140522801100000,NE 113,Residential,25536,0,25536,116681,0,142217
140522801200000,NE 113,Residential,23703,0,23703,104445,0,128148
140522801300000,NE 113,Residential,23530,0,23530,109194,0,132724
140522801400000,NE 113,Residential,23530,0,23530,93488,0,117018
140522900100000,NE 113,Residential,23436,0,23436,110375,0,133811
140522900200000,NE 113,Residential,25380,0,25380,107632,0,133012
140522900300000,NE 113,Residential,25380,0,25380,108825,0,134205
140522900400000,NE 113,Residential,22560,0,22560,92895,0,115455
140522900500000,NE 113,Residential,21933,0,21933,105389,0,127322
140522900600000,NE 113,Residential,23218,0,23218,112887,0,136105
140522900700000,NE 113,Residential,22560,0,22560,103241,0,125801
140522900800000,NE 113,Residential,22560,0,22560,102619,0,125179
140522900900000,NE 113,Residential,22560,0,22560,108284,0,130844
140522901000000,NE 113,Residential,22560,0,22560,104064,0,126624
140522901100000,NE 113,Residential,23436,0,23436,103673,0,127109
140523000100000,NE 113,Residential,25273,0,25273,112316,0,137589
140523000200000,NE 113,Residential,24510,0,24510,112737,0,137247
140523000300000,NE 113,Residential,24510,0,24510,104406,0,128916
140523000400000,NE 113,Residential,24510,0,24510,112763,0,137273
140523000500000,NE 113,Residential,24510,0,24510,103175,0,127685
140523000600000,NE 113,Residential,24510,0,24510,109106,0,133616
140523000700000,NE 113,Residential,24510,0,24510,111865,0,136375
140523000800000,NE 113,Residential,26784,0,26784,108379,0,135163
140523000900000,NE 113,Residential,24735,0,24735,109018,0,133753
140523001000000,NE 113,Residential,24735,0,24735,151544,0,176279
140523001100000,NE 113,Residential,27962,0,27962,100558,0,128520
140523001200000,NE 113,Residential,27789,0,27789,118694,0,146483
140523001300000,NE 113,Residential,25323,0,25323,106677,0,132000
140523001400000,NE 113,Residential,25500,0,25500,117055,0,142555
140523001500000,NE 113,Residential,25500,0,25500,110295,0,135795
140525100100000,NE 113,Residential,24785,0,24785,100120,0,124905
140525100200000,NE 113,Residential,22560,0,22560,98920,0,121480
140525100300000,NE 113,Residential,22560,0,22560,105156,0,127716
140525100400000,NE 113,Residential,22560,0,22560,88100,0,110660
140525100500000,NE 113,Residential,22560,0,22560,105635,0,128195
140525100600000,NE 113,Residential,22560,0,22560,105450,0,128010
140525100700000,NE 113,Residential,24417,0,24417,100583,0,125000
140525100800000,NE 113,Residential,24252,0,24252,100090,0,124342
140525100900000,NE 113,Residential,22560,0,22560,99385,0,121945
140525101000000,NE 113,Residential,22560,0,22560,102814,0,125374
140525101100000,NE 113,Residential,22560,0,22560,116614,0,139174
140525101200000,NE 113,Residential,22560,0,22560,93744,0,116304
140525101300000,NE 113,Residential,22560,0,22560,105097,0,127657
140525101400000,NE 113,Residential,24785,0,24785,105017,0,129802
140525101500000,NE 113,Residential,24741,0,24741,107394,0,132135
140525101600000,NE 113,Residential,22560,0,22560,99243,0,121803
140525101700000,NE 113,Residential,22560,0,22560,112863,0,135423
140525101800000,NE 113,Residential,22560,0,22560,105360,0,127920
140525101900000,NE 113,Residential,24741,0,24741,115888,0,140629
140525102000000,NE 113,Residential,24785,0,24785,118830,0,143615
140525102100000,NE 113,Residential,22560,0,22560,92888,0,115448
140525102200000,NE 113,Residential,22560,0,22560,97858,0,120418
140525102300000,NE 113,Residential,22560,0,22560,98971,0,121531
140525102400000,NE 113,Residential,22560,0,22560,105927,0,128487
140525102500000,NE 113,Residential,22560,0,22560,101777,0,124337
140525102600000,NE 113,Residential,24252,0,24252,109942,0,134194
140525102700000,NE 113,Residential,24252,0,24252,110837,0,135089
140525102800000,NE 113,Residential,24252,0,24252,89125,0,113377
140525102900000,NE 113,Residential,24252,0,24252,97964,0,122216
140525103000000,NE 113,Residential,24252,0,24252,109339,0,133591
140525103100000,NE 113,Residential,24252,0,24252,111012,0,135264
140525103200000,NE 113,Residential,23823,0,23823,118308,0,142131
140525103300000,NE 113,Residential,25305,0,25305,97963,0,123268
140525103400000,NE 113,Residential,23834,0,23834,121975,0,145809
140525103500000,NE 113,Residential,24252,0,24252,100523,0,124775
140525103600000,NE 113,Residential,23562,0,23562,99828,0,123390
140525200100000,NE 113,Residential,23603,0,23603,87161,0,110764
140525200200000,NE 113,Residential,22560,0,22560,106716,0,129276
140525200300000,NE 113,Residential,22560,0,22560,107139,0,129699
140525200400000,NE 113,Residential,22560,0,22560,106941,0,129501
140525200500000,NE 113,Residential,22560,0,22560,105195,0,127755
140525200600000,NE 113,Residential,23039,0,23039,128297,0,151336
140525200700000,NE 113,Residential,23039,0,23039,96111,0,119150
140525200800000,NE 113,Residential,22560,0,22560,106227,0,128787
140525200900000,NE 113,Residential,22560,0,22560,107776,0,130336
140525201000000,NE 113,Residential,22560,0,22560,113752,0,136312
140525201100000,NE 113,Residential,22560,0,22560,110381,0,132941
140525201200000,NE 113,Residential,23603,0,23603,102778,0,126381
140525300100000,NE 113,Residential,25500,0,25500,114342,0,139842
140525300200000,NE 113,Residential,25500,0,25500,96109,0,121609
140525300300000,NE 113,Residential,25500,0,25500,110134,0,135634
140525300400000,NE 113,Residential,27789,0,27789,103571,0,131360
140525300500000,NE 113,Residential,27744,0,27744,118352,0,146096
140525300600000,NE 113,Residential,27393,0,27393,120326,0,147719
140525300700000,NE 113,Residential,24735,0,24735,106825,0,131560
140525300800000,NE 113,Residential,24735,0,24735,97065,0,121800
140525300900000,NE 113,Residential,23280,0,23280,108180,0,131460
140525301000000,NE 113,Residential,23280,0,23280,107607,0,130887
140525301100000,NE 113,Residential,23280,0,23280,104182,0,127462
140525301200000,NE 113,Residential,23346,0,23346,96401,0,119747
140525301300000,NE 113,Residential,23214,0,23214,96335,0,119549
140525301400000,NE 113,Residential,25200,0,25200,120265,0,145465
140525301500000,NE 113,Residential,24000,0,24000,91381,0,115381
140525301600000,NE 113,Residential,24000,0,24000,101396,0,125396
140525301700000,NE 113,Residential,24000,0,24000,92821,0,116821
140525301800000,NE 113,Residential,24000,0,24000,85689,0,109689
140525301900000,NE 113,Residential,24000,0,24000,90139,0,114139
140525302000000,NE 113,Residential,24000,0,24000,93175,0,117175
140525302100000,NE 113,Residential,24000,0,24000,104883,0,128883
140525302200000,NE 113,Residential,25200,0,25200,105833,0,131033
140525302300000,NE 113,Residential,24000,0,24000,104674,0,128674
140525302400000,NE 113,Residential,24600,0,24600,102931,0,127531
140525302500000,NE 113,Residential,23400,0,23400,99744,0,123144
140525302600000,NE 113,Residential,24000,0,24000,76187,0,100187
140525302700000,NE 113,Residential,25862,0,25862,97772,0,123634
140525302800000,NE 113,Residential,27257,0,27257,99105,0,126362
140525302900000,NE 113,Residential,27393,0,27393,104492,0,131885
140525303000000,NE 113,Residential,27853,0,27853,109168,0,137021
140525303100000,NE 113,Residential,25862,0,25862,120677,0,146539
140525303200000,NE 113,Residential,24000,0,24000,108313,0,132313
140525303300000,NE 113,Residential,24000,0,24000,106515,0,130515
140525303400000,NE 113,Residential,24000,0,24000,90625,0,114625
140525303500000,NE 113,Residential,24000,0,24000,118499,0,142499
140525400100000,NE 113,Residential,23530,0,23530,123936,0,147466
140525400200000,NE 113,Residential,23530,0,23530,118074,0,141604
140525400300000,NE 113,Residential,23040,0,23040,109078,0,132118
140525400400000,NE 113,Residential,23309,0,23309,111482,0,134791
140525400500000,NE 113,Residential,22771,0,22771,88736,0,111507
140525400600000,NE 113,Residential,23040,0,23040,125908,0,148948
140525400700000,NE 113,Residential,23040,0,23040,86213,0,109253
140525400800000,NE 113,Residential,23280,0,23280,114101,0,137381
140525400900000,NE 113,Residential,23280,0,23280,110374,0,133654
140525401000000,NE 113,Residential,23280,0,23280,95183,0,118463
140525500100000,NE 113,Residential,22801,0,22801,101818,0,124619
140525500200000,NE 113,Residential,23039,0,23039,109854,0,132893
140525500300000,NE 113,Residential,22861,0,22861,111264,0,134125
140525500400000,NE 113,Residential,22861,0,22861,100099,0,122960
140525500500000,NE 113,Residential,23116,0,23116,108988,0,132104
140525500600000,NE 113,Residential,27141,0,27141,101474,0,128615
140525500700000,NE 113,Residential,22639,0,22639,99415,0,122054
140525500800000,NE 113,Residential,23354,0,23354,118581,0,141935
140525500900000,NE 113,Residential,22800,0,22800,102247,0,125047
140525600100000,NE 113,Residential,23925,0,23925,131632,0,155557
140525600200000,NE 113,Residential,24132,0,24132,125431,0,149563
140525600300000,NE 113,Residential,23206,0,23206,121727,0,144933
140525600400000,NE 113,Residential,23232,0,23232,111869,0,135101
140525600500000,NE 113,Residential,24276,0,24276,127206,0,151482
140525600600000,NE 113,Residential,28187,0,28187,117471,0,145658
140525600700000,NE 113,Residential,22988,0,22988,103618,0,126606
140525600800000,NE 113,Residential,22988,0,22988,116100,0,139088
140525600900000,NE 113,Residential,22988,0,22988,108467,0,131455
140525601000000,NE 113,Residential,22988,0,22988,111240,0,134228
140525601100000,NE 113,Residential,22988,0,22988,110639,0,133627
140525601200000,NE 113,Residential,22988,0,22988,118231,0,141219
140525601300000,NE 113,Residential,22988,0,22988,114525,0,137513
140525601400000,NE 113,Residential,23530,0,23530,110956,0,134486
140525601500000,NE 113,Residential,22988,0,22988,108639,0,131627
140525601600000,NE 113,Residential,22988,0,22988,109228,0,132216
140525601700000,NE 113,Residential,22988,0,22988,126223,0,149211
140525601800000,NE 113,Residential,22988,0,22988,112105,0,135093
140525601900000,NE 113,Residential,22885,0,22885,105497,0,128382
140525602000000,NE 113,Residential,24840,0,24840,113339,0,138179
140525602100000,NE 113,Residential,25222,0,25222,116998,0,142220
140525602200000,NE 113,Residential,24781,0,24781,113172,0,137953
140525602300000,NE 113,Residential,24149,0,24149,102060,0,126209
140525602400000,NE 113,Residential,24411,0,24411,112235,0,136646
140525602500000,NE 113,Residential,24265,0,24265,102223,0,126488
140525602600000,NE 113,Residential,24265,0,24265,124274,0,148539
140525602700000,NE 113,Residential,24265,0,24265,118245,0,142510
140525602800000,NE 113,Residential,24577,0,24577,99632,0,124209
140525602900000,NE 113,Residential,24444,0,24444,97633,0,122077
140525603000000,NE 113,Residential,23775,0,23775,111489,0,135264
140525603100000,NE 113,Residential,23775,0,23775,107352,0,131127
140525700100000,NE 113,Residential,24145,0,24145,168004,0,192149
140525700200000,NE 113,Residential,22560,0,22560,105387,0,127947
140525700300000,NE 113,Residential,22560,0,22560,89401,0,111961
140525700400000,NE 113,Residential,22560,0,22560,110903,0,133463
140525700500000,NE 113,Residential,22560,0,22560,94940,0,117500
140525700600000,NE 113,Residential,22560,0,22560,106106,0,128666
140525700700000,NE 113,Residential,22560,0,22560,109868,0,132428
140525700800000,NE 113,Residential,22560,0,22560,104220,0,126780
140525700900000,NE 113,Residential,22560,0,22560,104319,0,126879
140525701000000,NE 113,Residential,22560,0,22560,102643,0,125203
140525701100000,NE 113,Residential,22560,0,22560,108496,0,131056
140525701200000,NE 113,Residential,24252,0,24252,98820,0,123072
140525701300000,NE 113,Residential,23718,0,23718,99601,0,123319
140525701400000,NE 113,Residential,23775,0,23775,109478,0,133253
140525701500000,NE 113,Residential,23775,0,23775,123402,0,147177
140525701600000,NE 113,Residential,24512,0,24512,112670,0,137182
140525701700000,NE 113,Residential,24250,0,24250,117642,0,141892
140525701800000,NE 113,Residential,23775,0,23775,108072,0,131847
140525701900000,NE 113,Residential,23775,0,23775,118090,0,141865
140525702000000,NE 113,Residential,23775,0,23775,120857,0,144632
140525702100000,NE 113,Residential,24796,0,24796,99437,0,124233
140525702200000,NE 113,Residential,27972,0,27972,100154,0,128126
140525702300000,NE 113,Residential,25600,0,25600,118144,0,143744
140525702400000,NE 113,Residential,23530,0,23530,119740,0,143270
140525702500000,NE 113,Residential,23775,0,23775,110345,0,134120
140525702600000,NE 113,Residential,23775,0,23775,115989,0,139764
140525702700000,NE 113,Residential,24020,0,24020,113997,0,138017
140525702800000,NE 113,Residential,24020,0,24020,143082,0,167102
140525800100000,NE 113,Residential,25250,0,25250,124818,0,150068
140525800200000,NE 113,Residential,22560,0,22560,98333,0,120893
140525800300000,NE 113,Residential,22560,0,22560,96748,0,119308
140525800400000,NE 113,Residential,24064,0,24064,101905,0,125969
140525800500000,NE 113,Residential,24252,0,24252,103270,0,127522
140525900200000,NE 113,Residential,24095,0,24095,106372,0,130467
140525900300000,NE 113,Residential,24016,0,24016,106482,0,130498
140525900400000,NE 113,Residential,24265,0,24265,101601,0,125866
140525900500000,NE 113,Residential,24265,0,24265,101891,0,126156
140525900600000,NE 113,Residential,24265,0,24265,108375,0,132640
140525900700000,NE 113,Residential,24265,0,24265,113749,0,138014
140527600100000,MFG HOME PARK,Commercial,0,3363660,3363660,0,1829858,5193518
140530100100000,NE 123,Residential,16150,0,16150,9540,0,25690
140530100200000,NE 123,Residential,25835,0,25835,103912,0,129747
140530100300000,NE 123,Residential,25542,0,25542,119601,0,145143
140530100400000,NE 123,Residential,25542,0,25542,92878,0,118420
140530100500000,NE 123,Residential,25542,0,25542,104332,0,129874
140530100600000,NE 123,Residential,26390,0,26390,105971,0,132361
140530100700000,NE 123,Residential,26730,0,26730,105269,0,131999
140530100800000,NE 123,Residential,26730,0,26730,114223,0,140953
140530100900000,NE 123,Residential,27263,0,27263,97340,0,124603
140530101000000,NE 123,Residential,25542,0,25542,108623,0,134165
140530101100000,NE 123,Residential,25542,0,25542,116730,0,142272
140530101200000,NE 123,Residential,25542,0,25542,94929,0,120471
140530101300000,NE 123,Residential,27431,0,27431,105175,0,132606
140530101400000,NE 123,Residential,36204,0,36204,111446,0,147650
140530101500000,NE 123,Residential,32783,0,32783,118435,0,151218
140530101600000,NE 123,Residential,31928,0,31928,123003,0,154931
140530101700000,NE 123,Residential,31928,0,31928,107048,0,138976
140530101800000,NE 123,Residential,31928,0,31928,101556,0,133484
140530101900000,NE 123,Residential,31928,0,31928,138994,0,170922
140530102000000,NE 123,Residential,31928,0,31928,106676,0,138604
140530102100000,NE 123,Residential,31928,0,31928,114521,0,146449
140530102200000,NE 123,Residential,31928,0,31928,117355,0,149283
140530200100000,NE 123,Residential,26569,0,26569,101450,0,128019
140530200200000,NE 123,Residential,25800,0,25800,104616,0,130416
140530200300000,NE 123,Residential,25800,0,25800,97997,0,123797
140530200400000,NE 123,Residential,25800,0,25800,104745,0,130545
140530200500000,NE 123,Residential,25800,0,25800,119986,0,145786
140530200600000,NE 123,Residential,25800,0,25800,100515,0,126315
140530200700000,NE 123,Residential,25800,0,25800,107956,0,133756
140530200800000,NE 123,Residential,25800,0,25800,120125,0,145925
140530200900000,NE 123,Residential,25800,0,25800,119314,0,145114
140530300100000,NE 123,Residential,26316,0,26316,88619,0,114935
140530300200000,NE 123,Residential,26790,0,26790,113138,0,139928
140530300300000,NE 123,Residential,25284,0,25284,92875,0,118159
140530300400000,NE 123,Residential,26557,0,26557,113443,0,140000
140530300500000,NE 123,Residential,25490,0,25490,103000,0,128490
140530300600000,NE 123,Residential,26832,0,26832,88868,0,115700
140530300700000,NE 123,Residential,25490,0,25490,103160,0,128650
140530300800000,NE 123,Residential,24544,0,24544,96269,0,120813
140530300900000,NE 123,Residential,27664,0,27664,151296,0,178960
140530301000000,NE 123,Residential,25376,0,25376,136091,0,161467
140530301100000,NE 123,Residential,26874,0,26874,125809,0,152683
140530301200000,NE 123,Residential,24544,0,24544,112602,0,137146
140530301300000,NE 123,Residential,28080,0,28080,116024,0,144104
140530301400000,NE 123,Residential,24752,0,24752,103838,0,128590
140530301500000,NE 123,Residential,26832,0,26832,100042,0,126874
140530301600000,NE 123,Residential,26832,0,26832,127062,0,153894
140530301700000,NE 123,Residential,26832,0,26832,123103,0,149935
140530301800000,NE 123,Residential,26832,0,26832,105718,0,132550
140530400100000,NE 123,Residential,27603,0,27603,107571,0,135174
140530400200000,NE 123,Residential,26574,0,26574,120596,0,147170
140530400300000,NE 123,Residential,26866,0,26866,132727,0,159593
140530400400000,NE 123,Residential,26866,0,26866,120686,0,147552
140530400500000,NE 123,Residential,26866,0,26866,116711,0,143577
140530400600000,NE 123,Residential,26866,0,26866,112523,0,139389
140530400700000,NE 123,Residential,26906,0,26906,126088,0,152994
140530400800000,NE 123,Residential,26664,0,26664,95021,0,121685
140530400900000,NE 123,Residential,26058,0,26058,111755,0,137813
140530401000000,NE 123,Residential,26058,0,26058,105415,0,131473
140530401100000,NE 123,Residential,26058,0,26058,111920,0,137978
140530401200000,NE 123,Residential,26058,0,26058,100333,0,126391
140530401300000,NE 123,Residential,26058,0,26058,112506,0,138564
140530401400000,NE 123,Residential,26058,0,26058,96825,0,122883
140530401500000,NE 123,Residential,26058,0,26058,118264,0,144322
140532600100000,NE 123,Residential,24252,0,24252,129504,0,153756
140532600200000,NE 123,Residential,30723,0,30723,130738,0,161461
140532600300000,NE 123,Residential,32873,0,32873,125100,0,157973
140532600400000,NE 123,Residential,25026,0,25026,127174,0,152200
140532600500000,NE 123,Residential,24820,0,24820,106551,0,131371
140532600600000,NE 123,Residential,24265,0,24265,127805,0,152070
140532600700000,NE 123,Residential,27252,0,27252,133653,0,160905
140532600800000,NE 123,Residential,25407,0,25407,119758,0,145165
140532600900000,NE 113,Residential,24020,0,24020,86644,0,110664
140532601000000,NE 113,Residential,23775,0,23775,106141,0,129916
140532601100000,NE 113,Residential,23530,0,23530,90177,0,113707
140532601300000,NE 113,Residential,24020,0,24020,145882,0,169902
140532601400000,NE 123,Residential,36992,0,36992,188095,0,225087
140532601500000,NE 123,Residential,33399,0,33399,0,0,33399
140532601600000,NE 123,Residential,25740,0,25740,0,0,25740
140532601700000,NE 123,Residential,25604,0,25604,204396,0,230000
140532601800000,NE 123,Residential,27560,0,27560,153552,0,181112
140532601900000,NE 123,Residential,28340,0,28340,162820,0,191160
140532602000000,NE 123,Residential,28860,0,28860,143670,0,172530
140532602100000,NE 123,Residential,29491,0,29491,164738,0,194229
140532602200000,NE 123,Residential,33253,0,33253,145663,0,178916
140532602300000,NE 123,Residential,28653,0,28653,161955,0,190608
140535100100000,CITY PROPERTY,Exempt,0,0,0,0,0,0
140535900100000,NE 113,Residential,23530,0,23530,98944,0,122474
140537600100000,NE 123,Residential,25800,0,25800,110099,0,135899
140537600200000,NE 123,Residential,24020,0,24020,102904,0,126924
140537600300000,NE 123,Residential,26030,0,26030,109158,0,135188
140537600400000,NE 123,Residential,25800,0,25800,105307,0,131107
140537600500000,NE 123,Residential,26337,0,26337,90970,0,117307
140537600600000,NE 123,Residential,27904,0,27904,117555,0,145459
140537600700000,NE 123,Residential,27904,0,27904,105449,0,133353
140537600800000,NE 123,Residential,26015,0,26015,100600,0,126615
140537600900000,NE 123,Residential,25744,0,25744,109914,0,135658
140537601000000,NE 123,Residential,24956,0,24956,121341,0,146297
140537601100000,NE 123,Residential,26000,0,26000,109880,0,135880
140537601200000,NE 123,Residential,25836,0,25836,93121,0,118957
140537601300000,NE 123,Residential,26154,0,26154,128743,0,154897
140537601400000,NE 123,Residential,23040,0,23040,103402,0,126442
140537601500000,NE 123,Residential,23040,0,23040,121680,0,144720
140537601600000,NE 123,Residential,24576,0,24576,120895,0,145471
140537601700000,NE 123,Residential,24576,0,24576,115137,0,139713
140537601800000,NE 123,Residential,24576,0,24576,105918,0,130494
140537601900000,NE 123,Residential,24576,0,24576,98958,0,123534
140537602000000,NE 123,Residential,23922,0,23922,96666,0,120588
140537602100000,NE 123,Residential,10,0,10,0,0,10
140537700100000,NE 123,Residential,25168,0,25168,100420,0,125588
140537700200000,NE 123,Residential,26832,0,26832,104198,0,131030
140537700300000,NE 123,Residential,26696,0,26696,101624,0,128320
140537700400000,NE 123,Residential,27090,0,27090,108582,0,135672
140537700500000,NE 123,Residential,30949,0,30949,125852,0,156801
140537700600000,NE 123,Residential,28500,0,28500,129434,0,157934
140537700700000,NE 123,Residential,25800,0,25800,97379,0,123179
140537700800000,NE 123,Residential,25986,0,25986,99312,0,125298
140537700900000,NE 123,Residential,25168,0,25168,129231,0,154399
140537701000000,NE 123,Residential,28652,0,28652,126193,0,154845
140537800100000,NE 123,Residential,26914,0,26914,100678,0,127592
140537800200000,NE 123,Residential,26866,0,26866,116395,0,143261
140537800300000,NE 123,Residential,26600,0,26600,123443,0,150043
140537800400000,NE 123,Residential,26266,0,26266,120075,0,146341
140537800500000,NE 123,Residential,26148,0,26148,105402,0,131550
140537800600000,NE 123,Residential,25992,0,25992,125955,0,151947
140537800700000,NE 123,Residential,25650,0,25650,95574,0,121224
140537800800000,NE 123,Residential,24510,0,24510,124820,0,149330
140537800900000,NE 123,Residential,25591,0,25591,124074,0,149665
140537801000000,NE 123,Residential,26220,0,26220,130275,0,156495
140537801100000,NE 123,Residential,26600,0,26600,108790,0,135390
140537801200000,NE 123,Residential,26600,0,26600,112750,0,139350
140537801300000,NE 123,Residential,26600,0,26600,104021,0,130621
140537801400000,NE 123,Residential,26600,0,26600,110223,0,136823
140537801500000,NE 123,Residential,26600,0,26600,103445,0,130045
140537801600000,NE 123,Residential,26600,0,26600,89057,0,115657
140537801700000,NE 123,Residential,26600,0,26600,120158,0,146758
140537801800000,NE 123,Residential,26600,0,26600,108709,0,135309
140537801900000,NE 123,Residential,26642,0,26642,119052,0,145694
140537802000000,NE 123,Residential,24468,0,24468,85915,0,110383
140537802100000,NE 123,Residential,24510,0,24510,106772,0,131282
140537802200000,NE 123,Residential,24510,0,24510,106670,0,131180
140537802300000,NE 123,Residential,24510,0,24510,99840,0,124350
140537802400000,NE 123,Residential,24510,0,24510,95412,0,119922
140537802500000,NE 123,Residential,24510,0,24510,119773,0,144283
140537802600000,NE 123,Residential,24510,0,24510,88852,0,113362
140537802700000,NE 123,Residential,24510,0,24510,90538,0,115048
140537802800000,NE 123,Residential,24130,0,24130,142355,0,166485
140537802900000,NE 123,Residential,24130,0,24130,99811,0,123941
140537803000000,NE 123,Residential,24130,0,24130,95844,0,119974
140537803100000,NE 123,Residential,24172,0,24172,115891,0,140063
140537803200000,NE 123,Residential,24510,0,24510,113414,0,137924
140537803300000,NE 123,Residential,25650,0,25650,114452,0,140102
140537803400000,NE 123,Residential,25067,0,25067,107410,0,132477
140537803500000,NE 123,Residential,26582,0,26582,112941,0,139523
140537803600000,NE 123,Residential,26599,0,26599,103994,0,130593
140537803700000,NE 123,Residential,28225,0,28225,109377,0,137602
140537900100000,NE 123,Residential,31928,0,31928,125190,0,157118
140537900200000,NE 123,Residential,31928,0,31928,90037,0,121965
140537900300000,NE 123,Residential,33792,0,33792,130824,0,164616
140537900400000,NE 123,Residential,33120,0,33120,105829,0,138949
140537900500000,NE 123,Residential,32063,0,32063,121996,0,154059
140537900600000,NE 123,Residential,32952,0,32952,97561,0,130513
140537900700000,NE 123,Residential,32900,0,32900,87466,0,120366
140537900800000,NE 123,Residential,33396,0,33396,108604,0,142000
140537900900000,NE 123,Residential,32900,0,32900,97140,0,130040
140537901000000,NE 123,Residential,32900,0,32900,126660,0,159560
140537901100000,NE 123,Residential,32900,0,32900,98406,0,131306
140537901200000,NE 123,Residential,32900,0,32900,96144,0,129044
140537901300000,NE 123,Residential,32900,0,32900,125524,0,158424
140537901400000,NE 123,Residential,32900,0,32900,113335,0,146235
140537901500000,NE 123,Residential,32900,0,32900,123348,0,156248
140537901600000,NE 123,Residential,32900,0,32900,121795,0,154695
140537901700000,NE 123,Residential,30080,0,30080,105554,0,135634
140537901800000,NE 123,Residential,33983,0,33983,107145,0,141128
140538000100000,NE 123,Residential,5,0,5,0,0,5
140538000200000,NE 123,Residential,25737,0,25737,102677,0,128414
140538000300000,NE 123,Residential,25568,0,25568,147964,0,173532
140538000400000,NE 123,Residential,24440,0,24440,124714,0,149154
140538000500000,NE 123,Residential,26696,0,26696,118936,0,145632
140538000600000,NE 123,Residential,25568,0,25568,114378,0,139946
140538000700000,NE 123,Residential,25651,0,25651,121656,0,147307
140538000800000,NE 123,Residential,26655,0,26655,111082,0,137737
140538000900000,NE 123,Residential,24252,0,24252,108718,0,132970
140538001000000,NE 123,Residential,24252,0,24252,117020,0,141272
140538001100000,NE 123,Residential,24252,0,24252,112323,0,136575
140538001200000,NE 123,Residential,24252,0,24252,92369,0,116621
140538001300000,NE 123,Residential,24252,0,24252,105630,0,129882
140538001400000,NE 123,Residential,24252,0,24252,112207,0,136459
140538001500000,NE 123,Residential,24252,0,24252,114089,0,138341
140538001600000,NE 123,Residential,24293,0,24293,102505,0,126798
140538001700000,NE 123,Exempt,0,26235,26235,0,104454,130689
140538001800000,CHURCH,Exempt,0,480600,480600,0,212223,692823
140540100100000,NE 123,Residential,29029,0,29029,90845,0,119874
140540100200000,NE 123,Residential,19866,0,19866,85497,0,105363
140540100300000,NE 123,Residential,26488,0,26488,101679,0,128167
140540100400000,NE 123,Residential,28195,0,28195,120745,0,148940
140540100500000,NE 123,Residential,24151,0,24151,99876,0,124027
140540100600000,NE 123,Residential,27300,0,27300,105256,0,132556
140540200100000,CITY PROPERTY,Exempt,0,0,0,0,0,0
140540200200000,NE 123,Residential,26585,0,26585,115013,0,141598
140540200300000,NE 123,Residential,25370,0,25370,112547,0,137917
140540200400000,NE 123,Exempt,0,25542,25542,0,115436,140978
140540200500000,NE 123,Residential,25542,0,25542,132892,0,158434
140540200600000,NE 123,Residential,25542,0,25542,119884,0,145426
140540200700000,NE 123,Residential,25542,0,25542,119782,0,145324
140540200800000,NE 123,Residential,25542,0,25542,120040,0,145582
140540200900000,NE 123,Residential,25542,0,25542,113828,0,139370
140540201000000,NE 123,Residential,25542,0,25542,111262,0,136804
140540201100000,NE 123,Residential,25542,0,25542,104124,0,129666
140540201200000,NE 123,Residential,23562,0,23562,118854,0,142416
140540201300000,NE 123,Residential,26146,0,26146,130740,0,156886
140540201400000,NE 123,Residential,25202,0,25202,133117,0,158319
140540300100000,NE 123,Residential,28160,0,28160,129498,0,157658
140540300200000,NE 123,Residential,29376,0,29376,111186,0,140562
140540300300000,NE 123,Residential,28560,0,28560,129487,0,158047
140540300400000,NE 123,Residential,28560,0,28560,80068,0,108628
140540300500000,NE 123,Residential,28560,0,28560,119881,0,148441
140540300600000,NE 123,Residential,27948,0,27948,108592,0,136540
140540300700000,NE 123,Residential,26316,0,26316,104621,0,130937
140540300800000,NE 123,Residential,26316,0,26316,135359,0,161675
140540400100000,NE 123,Residential,26389,0,26389,112109,0,138498
140540400200000,NE 123,Residential,19305,0,19305,103024,0,122329
140540400300000,NE 123,Residential,19305,0,19305,107662,0,126967
140540400400000,NE 123,Residential,19305,0,19305,117940,0,137245
140540400500000,NE 123,Residential,19305,0,19305,96363,0,115668
140540400600000,NE 123,Residential,19305,0,19305,88953,0,108258
140540400700000,NE 123,Residential,19305,0,19305,113494,0,132799
140540400800000,NE 123,Residential,19305,0,19305,94279,0,113584
140540400900000,NE 123,Residential,19305,0,19305,105350,0,124655
140540401000000,NE 123,Residential,19305,0,19305,101281,0,120586
140540401100000,NE 123,Residential,25542,0,25542,107728,0,133270
140540401200000,NE 123,Residential,25542,0,25542,127773,0,153315
140540401300000,NE 123,Residential,27086,0,27086,110091,0,137177
140540401400000,NE 123,Residential,27086,0,27086,101971,0,129057
140540401500000,NE 123,Residential,27086,0,27086,114117,0,141203
140540401600000,NE 123,Residential,27086,0,27086,114815,0,141901
140540401700000,NE 123,Residential,26334,0,26334,102880,0,129214
140540500100000,NE 123,Residential,26792,0,26792,117600,0,144392
140540500200000,NE 123,Residential,26023,0,26023,97254,0,123277
140540500300000,NE 123,Residential,25800,0,25800,107961,0,133761
140540500400000,NE 123,Residential,25800,0,25800,112758,0,138558
140540500500000,NE 123,Residential,25800,0,25800,104160,0,129960
140540500600000,NE 123,Residential,25800,0,25800,91958,0,117758
140540500700000,NE 123,Residential,25800,0,25800,127638,0,153438
140540500800000,NE 123,Residential,25800,0,25800,111647,0,137447
140540500900000,NE 123,Residential,25800,0,25800,94392,0,120192
140540501000000,NE 123,Residential,25800,0,25800,104907,0,130707
140540501100000,NE 123,Residential,25800,0,25800,108138,0,133938
140540501200000,NE 123,Residential,25800,0,25800,125025,0,150825
140540501300000,NE 123,Residential,25556,0,25556,122159,0,147715
140542800200000,NE 125,Residential,29664,0,29664,216407,0,246071
140542800300000,NE 125,Residential,25298,0,25298,199149,0,224447
140542800400000,NE 125,Residential,24174,0,24174,238277,0,262451
140542800500000,NE 125,Residential,23256,0,23256,184752,0,208008
140542800600000,NE 125,Residential,22950,0,22950,202012,0,224962
140542800700000,NE 125,Residential,23256,0,23256,196799,0,220055
140542800800000,NE 125,Residential,22950,0,22950,234725,0,257675
140542800900000,NE 125,Residential,22950,0,22950,194209,0,217159
140542801000000,NE 125,Residential,23256,0,23256,223613,0,246869
140542900100000,NE 125,Residential,25075,0,25075,224127,0,249202
140542900200000,NE 125,Residential,23280,0,23280,207680,0,230960
140542900300000,NE 125,Residential,25143,0,25143,207970,0,233113
140542900400000,NE 125,Residential,22758,0,22758,175707,0,198465
140542900500000,NE 125,Residential,21600,0,21600,146079,0,167679
140542900600000,NE 125,Residential,23700,0,23700,190960,0,214660
140542900700000,NE 125,Residential,22200,0,22200,179825,0,202025
140542900800000,NE 125,Residential,21600,0,21600,169446,0,191046
140542900900000,NE 125,Residential,23700,0,23700,218544,0,242244
140542901000000,NE 125,Residential,22200,0,22200,186499,0,208699
140542901100000,NE 125,Residential,24000,0,24000,197540,0,221540
140542901200000,NE 125,Residential,24000,0,24000,191568,0,215568
140542901300000,NE 125,Residential,22800,0,22800,182293,0,205093
140542901400000,NE 125,Residential,22800,0,22800,214874,0,237674
140542901500000,NE 125,Residential,24000,0,24000,203169,0,227169
140542901600000,NE 125,Residential,22800,0,22800,200383,0,223183
140542901700000,NE 125,Residential,23632,0,23632,277398,0,301030
140543000100000,NE 125,Residential,27173,0,27173,200848,0,228021
140543000200000,NE 125,Residential,24385,0,24385,194593,0,218978
140543000300000,NE 125,Residential,24480,0,24480,179041,0,203521
140543000400000,NE 125,Residential,24480,0,24480,191798,0,216278
140543000500000,NE 125,Residential,24480,0,24480,171679,0,196159
140543000600000,NE 125,Residential,24480,0,24480,150750,0,175230
140543000700000,NE 125,Residential,24480,0,24480,196711,0,221191
140545100300000,CHURCH,Exempt,0,461376,461376,0,1396792,1858168
140545200200000,NE 125,Residential,23939,0,23939,195596,0,219535
140545200300000,NE 125,Residential,26006,0,26006,213066,0,239072
140545200400000,NE 125,Residential,25793,0,25793,212055,0,237848
140545200500000,NE 125,Residential,24371,0,24371,185205,0,209576
140545200600000,NE 125,Residential,22800,0,22800,192591,0,215391
140545200700000,NE 125,Residential,26350,0,26350,147118,0,173468
140545300100000,NE 125,Residential,25650,0,25650,234652,0,260302
140545300200000,NE 125,Residential,25650,0,25650,188375,0,214025
140545400100000,NE 125,Residential,24480,0,24480,180629,0,205109
140545400200000,NE 125,Residential,24480,0,24480,150603,0,175083
140545400300000,NE 125,Residential,23856,0,23856,177741,0,201597
140545400400000,NE 125,Residential,25725,0,25725,194686,0,220411
140545400500000,NE 125,Residential,26468,0,26468,187025,0,213493
140545400600000,NE 125,Residential,25288,0,25288,173558,0,198846
140545400700000,NE 125,Residential,23837,0,23837,157186,0,181023
140545400800000,NE 125,Residential,26177,0,26177,235782,0,261959
140545400900000,NE 125,Residential,25913,0,25913,217260,0,243173
140545500200000,CHURCH,Exempt,0,572400,572400,0,1921540,2493940
140547600100000,NE 123,Residential,26316,0,26316,119728,0,146044
140547600200000,NE 123,Residential,26316,0,26316,99060,0,125376
140547600300000,NE 123,Residential,26316,0,26316,122964,0,149280
140547600400000,NE 123,Residential,26316,0,26316,121975,0,148291
140547600500000,NE 123,Residential,26316,0,26316,120806,0,147122
140547600600000,NE 123,Residential,26316,0,26316,112267,0,138583
140547600700000,NE 123,Residential,26316,0,26316,114489,0,140805
140547600800000,NE 123,Residential,29249,0,29249,99576,0,128825
140547600900000,NE 123,Residential,29718,0,29718,109790,0,139508
140547601000000,NE 123,Residential,28682,0,28682,108791,0,137473
140547601100000,NE 123,Residential,25628,0,25628,108887,0,134515
140547601200000,NE 123,Exempt,0,26880,26880,0,113904,140784
140547601300000,NE 123,Residential,26880,0,26880,103342,0,130222
140547601400000,CITY PROPERTY,Exempt,0,0,0,0,0,0
140547601500000,CHURCH,Exempt,0,473472,473472,0,1474881,1948353
140547601600000,SCHOOL,Exempt,0,0,0,0,0,0
140547700100000,NE 123,Residential,25740,0,25740,116964,0,142704
140547700200000,NE 123,Residential,19305,0,19305,127049,0,146354
140547700300000,NE 123,Residential,19157,0,19157,103095,0,122252
140547700400000,NE 123,Residential,19157,0,19157,121600,0,140757
140547700500000,NE 123,Residential,19157,0,19157,94826,0,113983
140547700600000,NE 123,Residential,19157,0,19157,98168,0,117325
140547700700000,NE 123,Residential,19157,0,19157,95488,0,114645
140547700800000,NE 123,Residential,19157,0,19157,87839,0,106996
140547700900000,NE 123,Residential,20196,0,20196,97320,0,117516
140547701000000,NE 123,Residential,26384,0,26384,94031,0,120415
140547701100000,NE 123,Residential,25542,0,25542,104391,0,129933
140547701200000,NE 123,Residential,25542,0,25542,84736,0,110278
140547701300000,NE 123,Residential,25542,0,25542,89093,0,114635
140547701400000,NE 123,Residential,25542,0,25542,99077,0,124619
140547701500000,NE 123,Residential,25542,0,25542,92289,0,117831
140547701600000,NE 123,Residential,25542,0,25542,95458,0,121000
140547800100000,SCHOOL,Exempt,0,0,0,0,0,0
140610200100000,BRANCH BANK/CU,Commercial,0,523800,523800,0,1710118,2233918
140610200200000,FAST FOOD,Commercial,0,523800,523800,0,1122291,1646091
140610300100000,CONVENIENCE STORE,Commercial,0,354780,354780,0,528252,883032
140610300200000,NE 168,Residential,33740,0,33740,53065,0,86805
140612800100000,CHURCH,Exempt,0,69806,69806,0,39935,109741
140612800200000,NE 168,Residential,76800,0,76800,0,0,76800
140612800300000,NE 168,Residential,77350,0,77350,0,0,77350
140612900100000,NE 168,Ag Land,23922,0,23922,0,0,23922
140612900300000,SHOP,Commercial,0,105300,105300,0,232676,337976
140612900400000,NE 168,Residential,78300,0,78300,149762,0,228062
140612900500000,NE 168,Residential,8325,0,8325,0,0,8325
140615100100000,NE 168,Ag Land,12345,0,12345,0,3181,15526
140615200200000,NE 168,Ag Land,20681,0,20681,0,1255,21936
140615200300000,NE 168,Ag Land,973,0,973,0,0,973
140615200400000,STATE PROPERTY,Exempt,0,0,0,0,0,0
140617600100000,NE 168,Ag Land,19960,0,19960,0,0,19960
140617600300000,FAST FOOD,Commercial,0,356400,356400,0,669575,1025975
140617600400000,BRANCH BANK/CU,Commercial,0,526500,526500,0,548409,1074909
140617600500000,GROCERY STORE,Commercial,0,943662,943662,0,5628335,6571997
140617600800000,NBHD SHOPPING CENTER,Commercial,0,302400,302400,0,760680,1063080
140617600900000,NBHD SHOPPING CENTER,Commercial,0,577800,577800,0,1488465,2066265
140617601000000,VACANT LAND,Commercial,0,950,950,0,20,970
140617601100000,FLAT PARKING,Commercial,0,75600,75600,0,37558,113158
140617601400000,VACANT LAND,Commercial,0,434700,434700,0,0,434700
140617601500000,RESTAURANT,Commercial,0,407700,407700,0,939274,1346974
140620100200000,NE 168,Ag Dwelling,17507,0,17507,172859,1302,191668
140620100300000,NE 168,Residential,87150,0,87150,96482,0,183632
140620100400000,NE 168,Residential,80625,0,80625,102950,0,183575
140620100500000,NE 168,Residential,40320,0,40320,89509,0,129829
140620100600000,NE 168,Residential,48799,0,48799,101812,0,150611
140620100700000,NE 168,Residential,48262,0,48262,94720,0,142982
140620200100000,NE 168,Residential,64069,0,64069,81608,0,145677
140620200200000,NE 168,Ag Dwelling,1831,0,1831,99144,7229,108204
140620200300000,NE 168,Ag Land,3483,0,3483,0,0,3483
140620200400000,NE 168,Residential,64294,0,64294,0,0,64294
140620200500000,NE 168,Residential,64294,0,64294,148144,0,212438
140620200600000,NE 168,Residential,81525,0,81525,40529,0,122054
140620200700000,NE 168,Residential,68175,0,68175,123238,0,191413
140620200800000,NE 168,Residential,68175,0,68175,103212,0,171387
140620300100000,NE 168,Residential,57350,0,57350,0,0,57350
140620300200000,NE 168,Residential,75975,0,75975,64474,0,140449
140620300300000,NE 168,Residential,54850,0,54850,202725,0,257575
140620300400000,NE 168,Residential,52400,0,52400,136619,0,189019
140622600300000,NE 168,Residential,10350,0,10350,0,0,10350
140622600400000,NE 172,Residential,2800,0,2800,0,0,2800
140622600500000,NE 172,Residential,56100,0,56100,16237,0,72337
140622801200000,NE 168,Residential,2700,0,2700,0,0,2700
140623000100000,NE 172,Residential,44031,0,44031,157385,0,201416
140623000200000,NE 172,Residential,44319,0,44319,191919,0,236238
140623100100000,NE 172,Residential,39756,0,39756,130859,0,170615
140623100200000,NE 172,Residential,39015,0,39015,131903,0,170918
140623100300000,NE 172,Residential,39015,0,39015,130577,0,169592
140623100400000,NE 172,Residential,39015,0,39015,129453,0,168468
140623100500000,NE 172,Residential,39039,0,39039,128012,0,167051
140623100600000,NE 172,Residential,41367,0,41367,192397,0,233764
140623100700000,NE 172,Residential,41488,0,41488,149748,0,191236
140625100100000,NE 168,Ag Land,2811,0,2811,0,0,2811
140625100700000,NE 168,Ag Land,2068,0,2068,0,0,2068
140625200100000,OFFICE,Commercial,0,467424,467424,0,2524377,2991801
140627600100000,NE 168,Ag Land,22574,0,22574,0,0,22574
140627600200000,NE 168,Residential,45562,0,45562,56950,0,102512
140627600300000,CITY PROPERTY,Exempt,0,0,0,0,0,0
140627600400000,OFFICE,Commercial,0,441936,441936,0,4300789,4742725
140627600500000,OFFICE,Commercial,0,269568,269568,0,1215845,1485413
140627600600000,OFFICE; MEDICAL,Commercial,0,159840,159840,0,615227,775067
140630100100000,OFFICE,Commercial,0,241920,241920,0,928294,1170214
140630200100000,FLAT PARKING,Commercial,0,50868,50868,0,85117,135985
140630200200000,OFFICE,Commercial,0,583632,583632,0,12950757,13534389
140630200300000,NE 168,Ag Land,7437,0,7437,0,0,7437
140630200500000,NE 127,Residential,79100,0,79100,308788,0,387888
140630200600000,NE 127,Residential,85124,0,85124,331885,0,417009
140630200700000,NE 127,Residential,87552,0,87552,312448,0,400000
140630200800000,NE 127,Residential,96075,0,96075,316517,0,412592
140630200900000,NE 127,Residential,79411,0,79411,324601,0,404012
140630201000000,NE 127,Residential,81270,0,81270,285785,0,367055
140630201100000,NE 127,Residential,78240,0,78240,331361,0,409601
140630201200000,NE 127,Residential,81573,0,81573,326394,0,407967
140630201300000,NE 127,Residential,145,0,145,0,0,145
140630201400000,NE 127,Residential,67369,0,67369,306701,0,374070
140630201500000,NE 127,Residential,67461,0,67461,295220,0,362681
140630201600000,NE 127,Residential,71035,0,71035,308347,0,379382
140630201700000,NE 127,Residential,69508,0,69508,370099,0,439607
140630201800000,NE 127,Residential,67124,0,67124,325434,0,392558
140630201900000,NE 127,Residential,67238,0,67238,352556,0,419794
140630202000000,NE 127,Residential,87926,0,87926,373768,0,461694
140630202100000,NE 127,Residential,67660,0,67660,419375,0,487035
140630202200000,NE 127,Residential,69536,0,69536,330451,0,399987
140630202300000,NE 127,Residential,71324,0,71324,342511,0,413835
140630202400000,NE 127,Residential,57500,0,57500,0,0,57500
140630202500000,NE 127,Residential,64802,0,64802,371363,0,436165
140630202600000,NE 127,Residential,95285,0,95285,406897,0,502182
140630202700000,NE 127,Residential,91825,0,91825,282964,0,374789
140630300100000,NE 127,Residential,81605,0,81605,326754,0,408359
140630300200000,NE 127,Residential,91741,0,91741,296242,0,387983
140630300300000,NE 127,Residential,86205,0,86205,363574,0,449779
140630300400000,NE 127,Residential,88000,0,88000,291498,0,379498
140630300500000,NE 127,Residential,96507,0,96507,347478,0,443985
140630300600000,NE 127,Residential,92215,0,92215,271161,0,363376
140630300700000,NE 127,Residential,90862,0,90862,369710,0,460572
140630300800000,NE 127,Residential,109386,0,109386,398424,0,507810
140630300900000,NE 127,Residential,76868,0,76868,302874,0,379742
140630301000000,NE 127,Residential,74038,0,74038,0,0,74038
140632800100000,NE 161,Residential,1824,0,1824,0,0,1824
140632800200000,NE 161,Residential,45870,0,45870,227087,0,272957
140632800300000,NE 161,Residential,42500,0,42500,258100,0,300600
140633000100000,NE 161,Residential,948,0,948,0,0,948
140633000200000,NE 161,Residential,47798,0,47798,217656,0,265454
140635100100000,NE 128,Residential,110981,0,110981,429634,0,540615
140635100200000,NE 128,Residential,154043,0,154043,491800,0,645843
140635100300000,NE 128,Residential,154200,0,154200,614565,0,768765
140635100400000,NE 128,Residential,128346,0,128346,247997,0,376343
140635100500000,NE 128,Residential,155550,0,155550,349516,0,505066
140635100600000,NE 128,Residential,152550,0,152550,340285,0,492835
140635100700000,NE 128,Residential,141770,0,141770,363138,0,504908
140635100800000,NE 128,Residential,162750,0,162750,708837,0,871587
140635100900000,NE 128,Residential,148509,0,148509,316778,0,465287
140635101000000,NE 128,Residential,113430,0,113430,271179,0,384609
140635101100000,NE 128,Residential,154350,0,154350,531881,0,686231
140635101200000,NE 128,Residential,4800,0,4800,0,0,4800
140635101300000,NE 128,Residential,154800,0,154800,525565,0,680365
140635101400000,NE 128,Residential,151200,0,151200,458337,0,609537
140635101500000,NE 128,Residential,113732,0,113732,462679,0,576411
140635101600000,NE 128,Residential,117720,0,117720,334912,0,452632
140635101700000,NE 128,Residential,120752,0,120752,284457,0,405209
140635101800000,NE 128,Residential,155850,0,155850,405291,0,561141
140635101900000,NE 128,Residential,156900,0,156900,413709,0,570609
140635102000000,NE 128,Residential,143999,0,143999,335292,0,479291
140635102100000,NE 128,Residential,156392,0,156392,371698,0,528090
140635102200000,NE 128,Residential,114829,0,114829,419664,0,534493
140635102300000,NE 128,Residential,68963,0,68963,150670,0,219633
140635102400000,NE 128,Residential,69414,0,69414,111137,0,180551
140635102500000,NE 128,Residential,59840,0,59840,165057,0,224897
140635102600000,NE 128,Residential,68889,0,68889,68612,0,137501
140635200100000,NE 128,Residential,138355,0,138355,261645,0,400000
140635200200000,NE 128,Residential,143943,0,143943,642593,0,786536
140635200400000,NE 128,Residential,38619,0,38619,4196,0,42815
140635200500000,NE 128,Residential,38619,0,38619,65394,0,104013
140635200600000,NE 128,Residential,54332,0,54332,0,0,54332
140635200700000,NE 128,Residential,121308,0,121308,228692,0,350000
140637600100000,NE 127,Residential,57570,0,57570,277237,0,334807
140637600200000,NE 127,Residential,57817,0,57817,262183,0,320000
140637600300000,NE 127,Residential,57570,0,57570,274991,0,332561
140637600400000,NE 127,Residential,57570,0,57570,249851,0,307421
140637600500000,NE 127,Residential,72720,0,72720,306786,0,379506
140637600600000,NE 127,Residential,64387,0,64387,223067,0,287454
140637600700000,NE 127,Residential,60600,0,60600,267844,0,328444
140637600800000,NE 127,Residential,69721,0,69721,260279,0,330000
140637600900000,NE 127,Residential,65426,0,65426,232511,0,297937
140637601000000,NE 127,Residential,65484,0,65484,242799,0,308283
140637601100000,NE 127,Residential,71162,0,71162,292971,0,364133
140637601200000,NE 127,Residential,65510,0,65510,234550,0,300060
140637601300000,NE 127,Residential,59500,0,59500,216179,0,275679
140637601400000,NE 127,Residential,62849,0,62849,278536,0,341385
140637601500000,NE 127,Residential,66553,0,66553,329296,0,395849
140637601600000,NE 127,Residential,65313,0,65313,314352,0,379665
140637601700000,NE 127,Residential,71000,0,71000,328815,0,399815
140637601800000,NE 127,Residential,95918,0,95918,278759,0,374677
140637601900000,NE 127,Residential,88873,0,88873,206639,0,295512
140637602000000,NE 127,Residential,115700,0,115700,164586,0,280286
140637602100000,NE 127,Residential,110500,0,110500,151170,0,261670
140637602200000,NE 127,Residential,100600,0,100600,200622,0,301222
140637602300000,NE 127,Residential,74800,0,74800,102542,0,177342
140637602400000,NE 127,Residential,60250,0,60250,114798,0,175048
140637602500000,DAY CARE CENTER,Commercial,0,146475,146475,0,430006,576481
140637602600000,NE 127,Residential,66680,0,66680,386289,0,452969
140637602700000,NE 127,Residential,85,0,85,0,0,85
140637700100000,NE 127,Residential,75922,0,75922,193262,0,269184
140637700200000,NE 127,Residential,80199,0,80199,251907,0,332106
140637800100000,NE 127,Residential,79683,0,79683,282849,0,362532
140637800200000,NE 127,Residential,80109,0,80109,343905,0,424014
140637800300000,NE 127,Residential,79490,0,79490,222688,0,302178
140637800400000,NE 127,Residential,78540,0,78540,346699,0,425239
140637800500000,NE 127,Residential,78540,0,78540,336521,0,415061
140637800600000,NE 127,Residential,101795,0,101795,244035,0,345830
140637800700000,NE 127,Residential,73920,0,73920,209002,0,282922
140637800800000,NE 127,Residential,69942,0,69942,281284,0,351226
140637800900000,NE 127,Residential,71832,0,71832,274860,0,346692
140637801000000,NE 127,Residential,73092,0,73092,184580,0,257672
140637801100000,NE 127,Residential,68363,0,68363,263101,0,331464
140637801200000,NE 127,Residential,72832,0,72832,284657,0,357489
140637801300000,NE 127,Residential,74060,0,74060,173070,0,247130
140637801400000,NE 127,Residential,69724,0,69724,259476,0,329200
140637801500000,NE 127,Residential,68782,0,68782,263281,0,332063
140637801600000,NE 127,Residential,68340,0,68340,257715,0,326055
140637801700000,NE 127,Residential,70928,0,70928,280545,0,351473
140637801800000,NE 127,Residential,67575,0,67575,245398,0,312973
140637801900000,NE 127,Residential,70676,0,70676,343369,0,414045
140637802000000,NE 127,Residential,72733,0,72733,403934,0,476667
140642600100000,NE 127,Ag Land,17912,0,17912,0,0,17912
140642600200000,OFFICE,Commercial,0,354240,354240,0,871133,1225373
140642700100000,OFFICE,Commercial,0,347976,347976,0,17152024,17500000
140645100100000,OFFICE,Commercial,0,1046952,1046952,0,10833816,11880768
140645100200000,FLAT PARKING,Commercial,0,84888,84888,0,99370,184258
140645100300000,OFFICE,Commercial,0,21384,21384,0,5104946,5126330
140710100100000,BRANCH BANK/CU,Commercial,0,292032,292032,0,557968,850000
140710100200000,RESTAURANT,Commercial,0,267840,267840,0,428515,696355
140710100300000,OFFICE,Commercial,0,307800,307800,0,896171,1203971
140710100400000,OFFICE,Commercial,0,191160,191160,0,952398,1143558
140710100500000,OFFICE,Commercial,0,445878,445878,0,1496704,1942582
140710100600000,FLAT PARKING,Commercial,0,39690,39690,0,29938,69628
140710100700000,OFFICE,Commercial,0,171720,171720,0,711457,883177
140710100800000,OFFICE; MEDICAL,Commercial,0,84672,84672,0,297612,382284
140710100900000,OFFICE,Commercial,0,76608,76608,0,230979,307587
140710101000000,OFFICE,Commercial,0,317520,317520,0,632991,950511
140710101001000,OFFICE; MEDICAL,Commercial,0,124200,124200,0,535464,659664
140710101001001,OFFICE,Commercial,0,124200,124200,0,597084,721284
140710200100000,VACANT LAND,Commercial,0,948834,948834,0,0,948834
140710200200000,OFFICE,Commercial,0,274752,274752,0,905845,1180597
140710200300000,OFFICE,Commercial,0,117126,117126,0,401312,518438
140710200400000,OFFICE; MEDICAL,Commercial,0,127818,127818,0,315165,442983
140710300100000,OFFICE,Commercial,0,309420,309420,0,1107222,1416642
140710300200000,OFFICE,Exempt,0,170381,170381,0,731096,901477
140710300300000,OFFICE,Commercial,0,446688,446688,0,2015433,2462121
140712600100000,CHURCH,Exempt,0,683640,683640,0,396962,1080602
140712600200000,NE 140,Residential,48377,0,48377,96089,0,144466
140712700400000,NE 140,Residential,50150,0,50150,164006,0,214156
140712700500000,NE 140,Residential,50015,0,50015,171167,0,221182
140712800700000,NE 140,Residential,44550,0,44550,129191,0,173741
140712800800000,NE 140,Residential,45450,0,45450,83907,0,129357
140712800900000,NE 140,Residential,44175,0,44175,102062,0,146237
140715100700000,NE 140,Residential,45500,0,45500,178593,0,224093
140715100800000,NE 140,Residential,45500,0,45500,154562,0,200062
140715300200000,NE 140,Residential,45150,0,45150,143692,0,188842
140715400100000,VACANT LAND,Commercial,0,250031,250031,0,0,250031
140717600100000,OFFICE,Commercial,0,90407,90407,0,347905,438312
140717600200000,OFFICE,Commercial,0,97200,97200,0,356558,453758
140717600300000,OFFICE,Commercial,0,77246,77246,0,374073,451319
140717600600000,OFFICE; MEDICAL,Commercial,0,186300,186300,0,615960,802260
140717600800000,OFFICE,Commercial,0,62245,62245,0,351811,414056
140717600900000,FLAT PARKING,Commercial,0,126360,126360,0,12384,138744
140717700100000,OFFICE,Commercial,0,186300,186300,0,534084,720384
140717800100000,OFFICE,Commercial,0,124092,124092,0,585648,709740
140717800200000,OFFICE,Commercial,0,362016,362016,0,885966,1247982
140717900900000,NE 138,Residential,73614,0,73614,0,0,73614
140717901000000,NE 138,Residential,55982,0,55982,356099,0,412081
140717901100000,NE 138,Residential,77163,0,77163,289665,0,366828
140717901200000,NE 138,Residential,68508,0,68508,300905,0,369413
140717901300000,NE 138,Residential,70632,0,70632,322916,0,393548
140717901400000,NE 138,Residential,80039,0,80039,301807,0,381846
140718000100000,OFFICE; MEDICAL,Commercial,0,230850,230850,0,541136,771986
140718000400000,OFFICE; MEDICAL,Commercial,0,331560,331560,0,211626,543186
140718000700000,NE 138,Residential,57570,0,57570,286793,0,344363
140718000800000,NE 138,Residential,51859,0,51859,0,0,51859
140718000900000,NE 138,Residential,54605,0,54605,264516,0,319121
140718001000000,OFFICE; MEDICAL,Commercial,0,140940,140940,0,619946,760886
140718001100000,OFFICE,Commercial,0,453519,453519,0,1127041,1580560
140718001400000,OFFICE; MEDICAL,Commercial,0,264060,264060,0,546455,810515
140718001500000,NE 138,Residential,62900,0,62900,0,0,62900
140718001600000,NE 138,Residential,74112,0,74112,270863,0,344975
140720100100000,NE 140,Residential,28950,0,28950,138066,0,167016
140720100200000,NE 140,Residential,28980,0,28980,166042,0,195022
140720100300000,NE 140,Residential,29389,0,29389,147418,0,176807
140720100400000,NE 140,Residential,26780,0,26780,154211,0,180991
140720100500000,NE 140,Residential,26780,0,26780,127856,0,154636
140720100600000,NE 140,Residential,26520,0,26520,141945,0,168465
140720100700000,NE 140,Residential,27200,0,27200,151665,0,178865
140720100800000,NE 140,Residential,28156,0,28156,154850,0,183006
140720100900000,NE 140,Residential,28154,0,28154,147102,0,175256
140720101000000,NE 140,Residential,27820,0,27820,129400,0,157220
140720101100000,NE 140,Residential,27560,0,27560,159284,0,186844
140720101200000,NE 140,Residential,32136,0,32136,189773,0,221909
140720101300000,NE 140,Residential,29952,0,29952,170022,0,199974
140720101400000,NE 140,Residential,30223,0,30223,168182,0,198405
140720101500000,NE 140,Residential,30106,0,30106,161238,0,191344
140720101600000,NE 140,Residential,20929,0,20929,141707,0,162636
140720101700000,NE 140,Residential,22266,0,22266,160536,0,182802
140720101800000,NE 140,Residential,19344,0,19344,144409,0,163753
140720101900000,NE 140,Residential,24779,0,24779,159156,0,183935
140720102000000,NE 140,Residential,23888,0,23888,180016,0,203904
140720102100000,NE 140,Residential,2355,0,2355,0,0,2355
140720102200000,NE 140,Residential,27596,0,27596,143625,0,171221
140720102300000,NE 140,Residential,22660,0,22660,166602,0,189262
140720102400000,NE 140,Residential,23540,0,23540,149399,0,172939
140720102500000,NE 140,Residential,23022,0,23022,141978,0,165000
140720102600000,NE 140,Residential,23540,0,23540,170631,0,194171
140720102700000,NE 140,Residential,25060,0,25060,154960,0,180020
140720102800000,NE 140,Residential,28347,0,28347,158416,0,186763
140720102900000,NE 140,Residential,28401,0,28401,176772,0,205173
140720103000000,NE 140,Residential,25900,0,25900,164026,0,189926
140720103100000,NE 158,Residential,36214,0,36214,214214,0,250428
140720103200000,NE 158,Residential,34096,0,34096,231865,0,265961
140720103300000,NE 158,Residential,32640,0,32640,232703,0,265343
140720103400000,NE 158,Residential,30608,0,30608,196294,0,226902
140720103500000,NE 158,Residential,31624,0,31624,218926,0,250550
140720103600000,NE 158,Residential,31624,0,31624,206555,0,238179
140720103700000,NE 158,Residential,31624,0,31624,184886,0,216510
140720103800000,NE 158,Residential,31624,0,31624,191587,0,223211
140720103900000,NE 158,Residential,33136,0,33136,199861,0,232997
140720104000000,NE 140,Residential,3500,0,3500,0,0,3500
140720104100000,NE 158,Residential,25678,0,25678,200101,0,225779
140720104200000,NE 158,Residential,27132,0,27132,255995,0,283127
140720104300000,NE 158,Residential,25574,0,25574,253461,0,279035
140720200200000,NE 140,Residential,4400,0,4400,0,0,4400
140720200300000,NE 140,Residential,16200,0,16200,136565,0,152765
140720200400000,NE 140,Residential,6720,0,6720,110107,0,116827
140720200500000,NE 140,Residential,7216,0,7216,113992,0,121208
140720200600000,NE 140,Residential,7488,0,7488,121833,0,129321
140720200700000,NE 140,Residential,7296,0,7296,130251,0,137547
140720200800000,NE 140,Residential,12827,0,12827,132355,0,145182
140720200900000,NE 140,Residential,4000,0,4000,0,0,4000
140720201000000,NE 140,Residential,13500,0,13500,138889,0,152389
140720201100000,NE 140,Residential,6240,0,6240,104274,0,110514
140720201200000,NE 140,Residential,6952,0,6952,112105,0,119057
140720201300000,NE 140,Residential,7488,0,7488,123082,0,130570
140720201400000,NE 140,Residential,7392,0,7392,128512,0,135904
140720201500000,NE 140,Residential,14040,0,14040,130856,0,144896
140720201600000,NE 140,Residential,27648,0,27648,159996,0,187644
140720201700000,NE 140,Residential,27548,0,27548,155673,0,183221
140720201800000,NE 140,Residential,21120,0,21120,137841,0,158961
140720201900000,NE 140,Residential,25161,0,25161,163033,0,188194
140720202000000,NE 140,Residential,21763,0,21763,142972,0,164735
140720202100000,NE 140,Residential,20253,0,20253,149700,0,169953
140720202200000,NE 140,Residential,25207,0,25207,141130,0,166337
140720202300000,NE 140,Residential,23796,0,23796,150221,0,174017
140720202400000,NE 140,Residential,27412,0,27412,137892,0,165304
140720202500000,NE 140,Residential,21460,0,21460,138587,0,160047
140720202600000,NE 140,Residential,25931,0,25931,146260,0,172191
140720202700000,NE 140,Residential,17712,0,17712,147817,0,165529
140720202800000,NE 140,Residential,25476,0,25476,133393,0,158869
140720202900000,NE 140,Residential,25595,0,25595,164606,0,190201
140720203000000,NE 140,Residential,28043,0,28043,152281,0,180324
140720203100000,NE 140,Residential,24600,0,24600,143773,0,168373
140720203200000,NE 140,Residential,27360,0,27360,156999,0,184359
140720203300000,NE 140,Residential,23040,0,23040,145336,0,168376
140720203400000,NE 140,Residential,20736,0,20736,132438,0,153174
140720203500000,NE 140,Residential,22079,0,22079,145797,0,167876
140720203600000,NE 140,Residential,26960,0,26960,134370,0,161330
140720203700000,NE 140,Residential,23781,0,23781,140231,0,164012
140720203800000,NE 140,Residential,23296,0,23296,127472,0,150768
140720203900000,NE 140,Residential,23040,0,23040,145005,0,168045
140720204000000,NE 140,Residential,24444,0,24444,141239,0,165683
140720204100000,NE 140,Residential,22666,0,22666,133880,0,156546
140720204200000,NE 140,Residential,27904,0,27904,160917,0,188821
140720204300000,NE 140,Residential,25024,0,25024,156523,0,181547
140720204400000,NE 158,Residential,20382,0,20382,200503,0,220885
140720204500000,NE 158,Residential,19280,0,19280,187882,0,207162
140720204700000,NE 158,Residential,19280,0,19280,242806,0,262086
140720204800000,NE 158,Residential,19280,0,19280,223180,0,242460
140720204900000,NE 158,Residential,20389,0,20389,236645,0,257034
140720205000000,NE 158,Residential,20403,0,20403,242460,0,262863
140720205100000,NE 158,Residential,19280,0,19280,208256,0,227536
140720205200000,NE 158,Residential,19280,0,19280,248081,0,267361
140720205300000,NE 158,Residential,19280,0,19280,255994,0,275274
140720205400000,NE 158,Residential,19280,0,19280,229493,0,248773
140720205500000,NE 158,Residential,20418,0,20418,261122,0,281540
140720205600000,NE 158,Residential,27790,0,27790,262654,0,290444
140720205700000,NE 158,Residential,19280,0,19280,245294,0,264574
140720205800000,NE 158,Residential,19280,0,19280,244567,0,263847
140720205900000,NE 158,Residential,27800,0,27800,250295,0,278095
140720206000000,NE 158,Residential,25696,0,25696,256005,0,281701
140720206100000,NE 158,Residential,21370,0,21370,251893,0,273263
140720206200000,NE 158,Residential,25440,0,25440,216600,0,242040
140720206300000,NE 158,Residential,26282,0,26282,255141,0,281423
140722600300000,NE 158,Residential,38640,0,38640,178732,0,217372
140722600400000,NE 158,Residential,39200,0,39200,149785,0,188985
140722600500000,NE 158,Residential,37620,0,37620,215489,0,253109
140722600600000,NE 158,Residential,37620,0,37620,198109,0,235729
140722600700000,NE 158,Residential,37620,0,37620,190025,0,227645
140722600800000,NE 158,Residential,39600,0,39600,209111,0,248711
140722600900000,NE 158,Residential,39600,0,39600,182264,0,221864
140722601000000,NE 158,Residential,39600,0,39600,206181,0,245781
140722601100000,NE 158,Residential,40392,0,40392,214833,0,255225
140722601200000,NE 158,Residential,40392,0,40392,209477,0,249869
140722601300000,NE 158,Residential,40005,0,40005,197096,0,237101
140722601400000,NE 158,Residential,44512,0,44512,203793,0,248305
140722601500000,NE 158,Residential,38780,0,38780,190837,0,229617
140722601600000,NE 158,Residential,31232,0,31232,0,0,31232
140722601700000,NE 158,Residential,39118,0,39118,218638,0,257756
140722601800000,NE 158,Residential,37620,0,37620,199588,0,237208
140722601900000,NE 158,Residential,37620,0,37620,242397,0,280017
140722602000000,NE 158,Residential,37620,0,37620,203092,0,240712
140722602100000,NE 158,Residential,37620,0,37620,211770,0,249390
140722602200000,NE 158,Residential,37620,0,37620,216223,0,253843
140722602300000,NE 158,Residential,39320,0,39320,216583,0,255903
140722602400000,NE 158,Residential,33482,0,33482,182484,0,215966
140722602500000,NE 158,Residential,33482,0,33482,204322,0,237804
140722602600000,NE 158,Residential,35640,0,35640,214830,0,250470
140722602700000,NE 158,Residential,32579,0,32579,157357,0,189936
140722602800000,NE 158,Residential,30454,0,30454,81144,0,111598
140722602900000,NE 158,Residential,1650,0,1650,0,0,1650
140722603000000,NE 158,Residential,5,0,5,0,0,5
140722603100000,NE 158,Residential,34240,0,34240,141889,0,176129
140722603200000,NE 158,Residential,33863,0,33863,163603,0,197466
140722603300000,NE 158,Residential,34008,0,34008,157353,0,191361
140722603400000,NE 158,Residential,34240,0,34240,172346,0,206586
140722603500000,NE 158,Residential,30940,0,30940,180083,0,211023
140722603600000,NE 158,Residential,32421,0,32421,161182,0,193603
140722603700000,NE 158,Residential,1900,0,1900,0,0,1900
140722603800000,NE 158,Residential,22715,0,22715,225435,0,248150
140722603900000,NE 158,Residential,23312,0,23312,226354,0,249666
140722604000000,NE 158,Residential,23312,0,23312,217595,0,240907
140722604100000,NE 158,Residential,23312,0,23312,236122,0,259434
140722604200000,NE 158,Residential,23312,0,23312,235049,0,258361
140722604300000,NE 158,Residential,23312,0,23312,251456,0,274768
140722604400000,NE 158,Residential,23312,0,23312,231669,0,254981
140722604500000,NE 158,Residential,23312,0,23312,258337,0,281649
140722604600000,NE 158,Residential,23312,0,23312,234463,0,257775
140722604700000,NE 158,Residential,23312,0,23312,237481,0,260793
140722604800000,NE 158,Residential,23312,0,23312,236189,0,259501
140722604900000,NE 158,Residential,23312,0,23312,250292,0,273604
140722605000000,NE 158,Residential,23312,0,23312,233826,0,257138
140722605100000,NE 158,Residential,22560,0,22560,230361,0,252921
140722605200000,NE 158,Residential,22016,0,22016,211957,0,233973
140722605300000,NE 158,Residential,22304,0,22304,211631,0,233935
140722605400000,NE 158,Residential,25110,0,25110,230991,0,256101
140722605500000,NE 158,Residential,25608,0,25608,243936,0,269544
140722605600000,NE 158,Residential,25095,0,25095,197823,0,222918
140722605700000,NE 158,Residential,25200,0,25200,239943,0,265143
140722605800000,NE 158,Residential,24304,0,24304,235199,0,259503
140722700100000,NE 158,Residential,28672,0,28672,133521,0,162193
140722700200000,NE 158,Residential,33981,0,33981,181804,0,215785
140722700300000,NE 158,Residential,32400,0,32400,204254,0,236654
140722700400000,NE 158,Residential,32700,0,32700,171286,0,203986
140722700500000,NE 158,Residential,32700,0,32700,200004,0,232704
140722700600000,NE 158,Residential,32700,0,32700,225462,0,258162
140722700700000,NE 158,Residential,32700,0,32700,176205,0,208905
140722700800000,NE 158,Residential,37060,0,37060,168023,0,205083
140722700900000,NE 158,Residential,32400,0,32400,219899,0,252299
140722701000000,NE 158,Residential,38407,0,38407,214321,0,252728
140722701100000,NE 158,Residential,39974,0,39974,225152,0,265126
140722701200000,NE 158,Residential,40320,0,40320,227563,0,267883
140722701300000,NE 158,Residential,36252,0,36252,197833,0,234085
140722701400000,NE 158,Residential,34240,0,34240,184626,0,218866
140722701500000,NE 158,Residential,34560,0,34560,203285,0,237845
140722701600000,NE 158,Residential,34560,0,34560,211513,0,246073
140722701700000,NE 158,Residential,34560,0,34560,216587,0,251147
140722701800000,NE 158,Residential,34560,0,34560,209041,0,243601
140722701900000,NE 158,Residential,34560,0,34560,193123,0,227683
140722702000000,NE 158,Residential,35415,0,35415,194112,0,229527
140722702100000,NE 158,Residential,35418,0,35418,222606,0,258024
140722702200000,NE 158,Residential,32151,0,32151,184789,0,216940
140722702300000,NE 158,Residential,32670,0,32670,208979,0,241649
140722702400000,NE 158,Residential,33796,0,33796,197683,0,231479
140722702500000,NE 158,Residential,33117,0,33117,197798,0,230915
140722702600000,NE 158,Residential,34445,0,34445,173972,0,208417
140722702700000,NE 158,Residential,30796,0,30796,136786,0,167582
140722702800000,NE 158,Residential,29120,0,29120,145203,0,174323
140722702900000,NE 158,Residential,29120,0,29120,143669,0,172789
140722703000000,NE 158,Residential,29120,0,29120,142084,0,171204
140722703100000,NE 158,Residential,29120,0,29120,140426,0,169546
140722703200000,NE 158,Residential,29120,0,29120,133727,0,162847
140722703300000,NE 158,Residential,29120,0,29120,130466,0,159586
140722703400000,NE 158,Residential,29120,0,29120,141471,0,170591
140722703500000,NE 158,Residential,29120,0,29120,114057,0,143177
140722703600000,NE 158,Residential,29120,0,29120,132928,0,162048
140722800200000,NE 158,Residential,20544,0,20544,248933,0,269477
140722800300000,NE 158,Residential,20544,0,20544,199069,0,219613
140722800400000,NE 158,Residential,20544,0,20544,250182,0,270726
140722800500000,NE 158,Residential,20544,0,20544,214823,0,235367
140722800600000,NE 158,Residential,20544,0,20544,244422,0,264966
140722800700000,NE 158,Residential,28046,0,28046,242897,0,270943
140725100100000,NE 158,Residential,27973,0,27973,155821,0,183794
140725100200000,NE 158,Residential,32400,0,32400,170603,0,203003
140725100300000,NE 158,Residential,32400,0,32400,157179,0,189579
140725100400000,NE 158,Residential,32400,0,32400,175731,0,208131
140725100500000,NE 158,Residential,32400,0,32400,151005,0,183405
140725100600000,NE 158,Residential,36562,0,36562,168828,0,205390
140725100700000,NE 158,Residential,34272,0,34272,159926,0,194198
140725100800000,NE 158,Residential,36687,0,36687,165657,0,202344
140725100900000,NE 158,Residential,35802,0,35802,181375,0,217177
140725101000000,NE 158,Residential,39780,0,39780,164396,0,204176
140725101100000,NE 158,Residential,35802,0,35802,233487,0,269289
140725101200000,NE 158,Residential,35661,0,35661,210986,0,246647
140725101300000,NE 158,Residential,32860,0,32860,199267,0,232127
140725101400000,NE 158,Residential,32855,0,32855,166978,0,199833
140725101500000,NE 158,Residential,37368,0,37368,211781,0,249149
140725101600000,NE 158,Residential,37260,0,37260,191215,0,228475
140725200100000,NE 158,Residential,32284,0,32284,154267,0,186551
140725200200000,NE 158,Residential,30200,0,30200,0,0,30200
140725200300000,NE 158,Residential,21950,0,21950,0,0,21950
140725200400000,NE 158,Residential,34660,0,34660,198131,0,232791
140725200500000,NE 158,Residential,32929,0,32929,171238,0,204167
140725200600000,NE 140,Residential,350,0,350,0,0,350
140725200700000,NE 158,Residential,35360,0,35360,206202,0,241562
140725200800000,NE 158,Residential,35031,0,35031,217498,0,252529
140725200900000,NE 158,Residential,32548,0,32548,215638,0,248186
140725201000000,NE 158,Residential,32548,0,32548,189618,0,222166
140725201100000,NE 158,Residential,32471,0,32471,213240,0,245711
140725201200000,NE 158,Residential,34745,0,34745,237463,0,272208
140725201300000,NE 158,Residential,35083,0,35083,226956,0,262039
140725201400000,NE 158,Residential,39923,0,39923,225281,0,265204
140725201500000,NE 158,Residential,32056,0,32056,0,0,32056
140725201600000,NE 158,Residential,31210,0,31210,179942,0,211152
140725201700000,NE 158,Residential,29713,0,29713,192794,0,222507
140725201800000,NE 158,Residential,29304,0,29304,164933,0,194237
140725201900000,NE 158,Residential,29240,0,29240,151420,0,180660
140725202000000,NE 158,Residential,29397,0,29397,164327,0,193724
140725202100000,NE 158,Residential,30387,0,30387,176536,0,206923
140725202200000,NE 158,Residential,30240,0,30240,137796,0,168036
140725202300000,NE 158,Residential,30240,0,30240,165927,0,196167
140725202400000,NE 158,Residential,30240,0,30240,161209,0,191449
140725202500000,NE 158,Residential,31200,0,31200,166227,0,197427
140725202600000,NE 158,Residential,29952,0,29952,200625,0,230577
140725202700000,NE 158,Residential,30240,0,30240,179948,0,210188
140725202800000,NE 158,Residential,30240,0,30240,203297,0,233537
140725202900000,NE 158,Residential,30240,0,30240,198278,0,228518
140725203000000,NE 158,Residential,34073,0,34073,214239,0,248312
140725203100000,NE 158,Residential,35475,0,35475,198415,0,233890
140725203200000,NE 158,Residential,33320,0,33320,174223,0,207543
140725203300000,NE 158,Residential,28512,0,28512,184732,0,213244
140725203400000,NE 158,Residential,30823,0,30823,178567,0,209390
140725203500000,NE 158,Residential,30031,0,30031,167052,0,197083
140725203600000,NE 158,Residential,32170,0,32170,158948,0,191118
140725203700000,NE 158,Residential,31200,0,31200,205591,0,236791
140725203800000,NE 158,Residential,31200,0,31200,170320,0,201520
140725203900000,NE 158,Residential,31200,0,31200,171284,0,202484
140725204000000,NE 158,Residential,31200,0,31200,185673,0,216873
140725204100000,NE 158,Residential,31200,0,31200,173978,0,205178
140725204200000,NE 158,Residential,31575,0,31575,159173,0,190748
140727600100000,NE 158,Residential,35749,0,35749,199630,0,235379
140727600200000,NE 158,Residential,32265,0,32265,201593,0,233858
140727600300000,NE 158,Residential,32265,0,32265,209310,0,241575
140727600400000,NE 158,Residential,32265,0,32265,182860,0,215125
140727600500000,NE 158,Residential,32265,0,32265,226753,0,259018
140727600600000,NE 158,Residential,32538,0,32538,210961,0,243499
140727600700000,NE 158,Residential,32960,0,32960,195151,0,228111
140727600800000,NE 158,Residential,34629,0,34629,186809,0,221438
140727600900000,NE 158,Residential,35129,0,35129,219976,0,255105
140727601000000,NE 158,Residential,39326,0,39326,260857,0,300183
140727601100000,NE 158,Residential,39400,0,39400,0,0,39400
140727601200000,NE 158,Residential,65300,0,65300,0,0,65300
140727601300000,NE 158,Residential,32688,0,32688,177900,0,210588
140727601400000,NE 158,Residential,34240,0,34240,230285,0,264525
140727601500000,NE 158,Residential,34240,0,34240,184609,0,218849
140727601600000,NE 158,Residential,34240,0,34240,173969,0,208209
140727601700000,NE 158,Residential,35020,0,35020,174481,0,209501
140727601800000,NE 158,Residential,35020,0,35020,187858,0,222878
140727601900000,NE 158,Residential,35020,0,35020,187081,0,222101
140727602000000,NE 158,Residential,35020,0,35020,172136,0,207156
140727602100000,NE 158,Residential,38629,0,38629,166590,0,205219
140727602200000,NE 158,Residential,40460,0,40460,210409,0,250869
140727602300000,NE 158,Residential,41600,0,41600,217471,0,259071
140727602400000,NE 158,Residential,43333,0,43333,180322,0,223655
140727602500000,NE 158,Residential,44200,0,44200,180821,0,225021
140727602600000,NE 158,Residential,44200,0,44200,225306,0,269506
140727602700000,NE 158,Residential,44893,0,44893,241105,0,285998
140727602800000,NE 158,Residential,47668,0,47668,187605,0,235273
140727602900000,NE 158,Residential,44428,0,44428,0,0,44428
140727603000000,NE 158,Residential,44836,0,44836,192296,0,237132
140727603100000,NE 158,Residential,44081,0,44081,222308,0,266389
140727603200000,NE 158,Residential,45125,0,45125,250382,0,295507
140727603300000,NE 158,Residential,38500,0,38500,218089,0,256589
140727603400000,NE 158,Residential,39220,0,39220,186827,0,226047
140727603500000,NE 158,Residential,42293,0,42293,201694,0,243987
140727603600000,NE 158,Residential,39000,0,39000,183456,0,222456
140727603700000,NE 158,Residential,39000,0,39000,173173,0,212173
140727603800000,NE 158,Residential,38454,0,38454,180270,0,218724
140727603900000,NE 158,Residential,36528,0,36528,170571,0,207099
140727604000000,NE 158,Residential,35333,0,35333,162990,0,198323
140727604100000,NE 158,Residential,38023,0,38023,183680,0,221703
140727604200000,NE 158,Residential,30218,0,30218,161018,0,191236
140727604300000,NE 158,Residential,30900,0,30900,172134,0,203034
140727604400000,NE 158,Residential,30900,0,30900,212619,0,243519
140727604500000,NE 158,Residential,30900,0,30900,189399,0,220299
140727604600000,NE 158,Residential,30900,0,30900,173855,0,204755
140727604700000,NE 158,Residential,36055,0,36055,202164,0,238219
140730100100000,NE 158,Residential,35020,0,35020,160334,0,195354
140730100200000,NE 140,Residential,54600,0,54600,0,0,54600
140730100300000,NE 158,Residential,34240,0,34240,196856,0,231096
140730100400000,NE 158,Residential,37078,0,37078,171682,0,208760
140730100500000,NE 158,Residential,35855,0,35855,185755,0,221610
140730100600000,NE 158,Residential,36196,0,36196,250955,0,287151
140730100700000,NE 158,Residential,34768,0,34768,166859,0,201627
140730100800000,NE 158,Residential,33921,0,33921,180356,0,214277
140730100900000,NE 158,Residential,32832,0,32832,165186,0,198018
140730101000000,NE 158,Residential,29242,0,29242,178567,0,207809
140730101100000,NE 158,Residential,29664,0,29664,179908,0,209572
140730101200000,NE 158,Residential,33502,0,33502,186704,0,220206
140730101300000,NE 158,Residential,37667,0,37667,203904,0,241571
140730101400000,NE 158,Residential,38626,0,38626,172005,0,210631
140730101500000,NE 158,Residential,34259,0,34259,172522,0,206781
140730101600000,NE 158,Residential,36630,0,36630,173012,0,209642
140730101700000,NE 158,Residential,34564,0,34564,164603,0,199167
140730200100000,NE 158,Residential,30600,0,30600,179497,0,210097
140730200200000,NE 158,Residential,37139,0,37139,229487,0,266626
140730200300000,NE 158,Residential,38923,0,38923,262426,0,301349
140730200400000,NE 158,Residential,37080,0,37080,228609,0,265689
140730200500000,NE 158,Residential,38000,0,38000,237825,0,275825
140730200600000,NE 158,Residential,30096,0,30096,168194,0,198290
140730200700000,NE 158,Residential,30600,0,30600,215838,0,246438
140730200800000,NE 158,Residential,30076,0,30076,233269,0,263345
140730200900000,NE 158,Residential,29252,0,29252,199688,0,228940
140730201000000,NE 158,Residential,29376,0,29376,235605,0,264981
140730201100000,NE 158,Residential,31909,0,31909,237180,0,269089
140730201200000,NE 158,Residential,30600,0,30600,185977,0,216577
140730300100000,NE 158,Residential,34641,0,34641,200499,0,235140
140730300200000,NE 158,Residential,36084,0,36084,168611,0,204695
140730300300000,NE 158,Residential,34627,0,34627,182274,0,216901
140730300400000,NE 158,Residential,49530,0,49530,213519,0,263049
140730400100000,NE 158,Residential,49088,0,49088,133251,0,182339
140730400200000,NE 158,Residential,47730,0,47730,203442,0,251172
140730400300000,NE 158,Residential,42527,0,42527,239866,0,282393
140730400400000,NE 158,Residential,41348,0,41348,255019,0,296367
140730400500000,NE 140,Residential,18800,0,18800,0,0,18800
140730400600000,NE 158,Residential,49046,0,49046,218435,0,267481
140730400700000,NE 158,Residential,49046,0,49046,207022,0,256068
140730400800000,NE 158,Residential,37547,0,37547,194359,0,231906
140730400900000,NE 158,Residential,29100,0,29100,0,0,29100
140730401000000,NE 158,Residential,55531,0,55531,297351,0,352882
140730401100000,NE 158,Residential,6150,0,6150,0,0,6150
140730401200000,NE 158,Residential,15659,0,15659,208070,0,223729
140730401300000,NE 158,Residential,10933,0,10933,160004,0,170937
140730401400000,NE 158,Residential,13160,0,13160,166562,0,179722
140730401500000,NE 158,Residential,16572,0,16572,177899,0,194471
140730401600000,NE 158,Residential,15452,0,15452,188241,0,203693
140730401800000,NE 158,Residential,8000,0,8000,0,0,8000
140730500100000,NE 158,Residential,36036,0,36036,205039,0,241075
140732600100000,NE 158,Residential,30600,0,30600,188342,0,218942
140732600200000,NE 158,Residential,31240,0,31240,237281,0,268521
140732600300000,NE 158,Residential,35809,0,35809,236183,0,271992
140732600400000,NE 158,Residential,37168,0,37168,294986,0,332154
140732600500000,NE 158,Residential,38362,0,38362,212325,0,250687
140732600600000,NE 158,Residential,38375,0,38375,216205,0,254580
140732700100000,NE 158,Residential,40186,0,40186,215436,0,255622
140732700200000,NE 158,Residential,102650,0,102650,0,0,102650
140732700300000,NE 158,Residential,34849,0,34849,179932,0,214781
140732700400000,NE 158,Residential,35613,0,35613,217097,0,252710
140732700500000,NE 158,Residential,14375,0,14375,180652,0,195027
140732700600000,NE 158,Residential,11454,0,11454,151224,0,162678
140732700700000,NE 158,Residential,13155,0,13155,175470,0,188625
140732700800000,NE 158,Residential,16380,0,16380,194445,0,210825
140732700900000,NE 158,Residential,17550,0,17550,184356,0,201906
140732701000000,NE 158,Residential,14900,0,14900,0,0,14900
140732701100000,NE 158,Residential,15405,0,15405,171759,0,187164
140732701200000,NE 140,Residential,11060,0,11060,188047,0,199107
140732701300000,NE 158,Residential,14025,0,14025,177001,0,191026
140732701400000,NE 158,Residential,16730,0,16730,174340,0,191070
140732701500000,NE 158,Residential,17733,0,17733,185891,0,203624
140732701600000,NE 158,Residential,15795,0,15795,189758,0,205553
140732701700000,NE 158,Residential,11060,0,11060,155933,0,166993
140732701800000,NE 158,Residential,12375,0,12375,180807,0,193182
140732701900000,NE 158,Residential,15010,0,15010,181707,0,196717
140732702000000,NE 158,Residential,14933,0,14933,174691,0,189624
140732702100000,NE 158,Residential,16042,0,16042,194350,0,210392
140732702200000,NE 158,Residential,15603,0,15603,177880,0,193483
140732702300000,NE 158,Residential,12375,0,12375,174378,0,186753
140732702400000,NE 158,Residential,11060,0,11060,165868,0,176928
140732702500000,NE 158,Residential,15938,0,15938,174691,0,190629
140732702600000,NE 158,Residential,16973,0,16973,202448,0,219421
140732702700000,NE 158,Residential,14897,0,14897,176416,0,191313
140732702800000,NE 158,Residential,12540,0,12540,188502,0,201042
140732702900000,NE 158,Residential,10780,0,10780,163263,0,174043
140732703000000,NE 158,Residential,16720,0,16720,213269,0,229989
140732703100000,NE 158,Residential,38170,0,38170,208168,0,246338
140732703200000,NE 158,Residential,38439,0,38439,192836,0,231275
140732703300000,NE 158,Residential,36720,0,36720,217721,0,254441
140732800100000,NE 158,Residential,38624,0,38624,215049,0,253673
140732800200000,NE 158,Residential,7950,0,7950,0,0,7950
140732800300000,NE 158,Residential,37092,0,37092,248865,0,285957
140732800400000,NE 158,Residential,34690,0,34690,230292,0,264982
140732800500000,NE 158,Residential,36432,0,36432,232578,0,269010
140732800600000,NE 140,Residential,1900,0,1900,0,0,1900
140732800700000,NE 140,Residential,850,0,850,0,0,850
140735100100000,NE 151,Residential,333000,0,333000,0,0,333000
140735100200000,NE 151,Residential,7000,0,7000,0,0,7000
140737600100000,CITY PROPERTY,Exempt,0,0,0,0,0,0
140740100100000,NE 138,Residential,70123,0,70123,243831,0,313954
140740100200000,NE 138,Residential,63650,0,63650,273523,0,337173
140740100300000,NE 138,Residential,78390,0,78390,281557,0,359947
140740100400000,NE 138,Residential,80852,0,80852,307138,0,387990
140740100500000,NE 138,Residential,97170,0,97170,362062,0,459232
140740100600000,NE 138,Residential,75600,0,75600,297607,0,373207
140740100700000,NE 138,Residential,103600,0,103600,347493,0,451093
140740100800000,NE 138,Residential,114700,0,114700,355925,0,470625
140740100900000,NE 157,Residential,70800,0,70800,230769,0,301569
140740101000000,NE 157,Residential,71020,0,71020,294238,0,365258
140740101100000,NE 157,Residential,64516,0,64516,202337,0,266853
140740101200000,NE 157,Residential,125000,0,125000,275976,0,400976
140740101300000,NE 157,Residential,103530,0,103530,200499,0,304029
140740101400000,NE 157,Residential,109610,0,109610,308197,0,417807
140740101500000,NE 157,Residential,114480,0,114480,305321,0,419801
140740101600000,NE 157,Residential,111860,0,111860,274082,0,385942
140740101700000,NE 157,Residential,108290,0,108290,0,0,108290
140740101900000,NE 157,Residential,73220,0,73220,232859,0,306079
140740102000000,NE 157,Residential,53234,0,53234,0,0,53234
140740102100000,NE 157,Residential,72458,0,72458,350793,0,423251
140740102200000,NE 157,Residential,75600,0,75600,427705,0,503305
140740102300000,NE 157,Residential,100500,0,100500,316987,0,417487
140740102400000,NE 157,Residential,100200,0,100200,325938,0,426138
140740102500000,NE 138,Residential,65325,0,65325,299152,0,364477
140740102600000,NE 138,Residential,56227,0,56227,428080,0,484307
140740102700000,NE 138,Residential,53104,0,53104,0,0,53104
140740102800000,NE 157,Residential,67320,0,67320,295103,0,362423
140740102900000,NE 157,Residential,66482,0,66482,213370,0,279852
140740103000000,NE 157,Residential,76028,0,76028,227395,0,303423
140740103100000,NE 157,Residential,65450,0,65450,239468,0,304918
140740103200000,NE 157,Residential,64900,0,64900,327652,0,392552
140740103300000,NE 157,Residential,58580,0,58580,297499,0,356079
140740103400000,NE 138,Residential,67667,0,67667,260766,0,328433
140740103500000,NE 138,Residential,59547,0,59547,289170,0,348717
140740103600000,CENTRALLY ASSESSED,Other,0,0,0,0,0,0
140742600200000,NE 157,Residential,50250,0,50250,0,0,50250
140742600300000,NE 157,Residential,39100,0,39100,0,0,39100
140742600400000,NE 157,Residential,45100,0,45100,0,0,45100
140742600500000,NE 157,Residential,55050,0,55050,0,0,55050
140742700100000,NE 158,Residential,74360,0,74360,240563,0,314923
140742700200000,NE 158,Residential,35711,0,35711,162383,0,198094
140742700300000,NE 158,Residential,37400,0,37400,199438,0,236838
140742700400000,NE 158,Residential,35374,0,35374,233558,0,268932
140742700500000,NE 158,Residential,34209,0,34209,187791,0,222000
140742700600000,NE 158,Residential,54608,0,54608,211966,0,266574
140742700700000,NE 158,Residential,65380,0,65380,193347,0,258727
140742700800000,NE 158,Residential,106735,0,106735,195724,0,302459
140742700900000,NE 158,Residential,49905,0,49905,208406,0,258311
140742701000000,NE 158,Residential,49884,0,49884,238607,0,288491
140742701100000,NE 158,Residential,49376,0,49376,232865,0,282241
140745100100000,CITY PROPERTY,Exempt,0,0,0,0,0,0
140810100100000,NE 134,Residential,29236,0,29236,127927,0,157163
140810100200000,NE 134,Residential,25830,0,25830,123066,0,148896
140810100300000,NE 134,Residential,23765,0,23765,142024,0,165789
140810100400000,NE 134,Residential,23765,0,23765,111832,0,135597
140810100500000,NE 134,Residential,27352,0,27352,125985,0,153337
140810100600000,NE 134,Residential,34047,0,34047,123060,0,157107
140810100700000,NE 134,Residential,30870,0,30870,102759,0,133629
140810100800000,NE 134,Residential,34342,0,34342,125780,0,160122
140810100900000,NE 134,Residential,33708,0,33708,107228,0,140936
140810101000000,NE 134,Residential,36112,0,36112,132294,0,168406
140810101100000,NE 134,Residential,34884,0,34884,122007,0,156891
140810101200000,NE 134,Residential,34884,0,34884,136203,0,171087
140810101300000,NE 134,Residential,34884,0,34884,106885,0,141769
140810101400000,NE 134,Residential,33836,0,33836,125319,0,159155
140810101500000,NE 134,Residential,31482,0,31482,109552,0,141034
140810101600000,NE 134,Residential,31137,0,31137,90344,0,121481
140810101700000,NE 134,Residential,32602,0,32602,81957,0,114559
140810200100000,NE 134,Residential,26082,0,26082,113975,0,140057
140810200200000,NE 134,Residential,24784,0,24784,127497,0,152281
140810200300000,NE 134,Residential,24784,0,24784,92074,0,116858
140810200400000,NE 134,Residential,25463,0,25463,103061,0,128524
140810200500000,CHURCH,Exempt,0,99187,99187,0,351000,450187
140810200600000,CHURCH,Exempt,0,108518,108518,0,15173,123691
140810200700000,NE 134,Residential,25725,0,25725,116384,0,142109
140810200800000,NE 134,Residential,27930,0,27930,123844,0,151774
140810200900000,NE 134,Residential,27930,0,27930,114789,0,142719
140810201000000,NE 134,Residential,27645,0,27645,104457,0,132102
140810201100000,NE 134,Residential,31101,0,31101,108709,0,139810
140810201200000,CHURCH,Exempt,0,100397,100397,0,12420,112817
140810201300000,NE 134,Residential,27160,0,27160,99500,0,126660
140810201400000,NE 134,Residential,27160,0,27160,105232,0,132392
140810201500000,NE 134,Residential,27160,0,27160,97701,0,124861
140810201600000,NE 134,Residential,27822,0,27822,96241,0,124063
140810300100000,NE 134,Residential,36130,0,36130,118928,0,155058
140810300200000,NE 134,Residential,34959,0,34959,120478,0,155437
140810300300000,NE 134,Residential,26933,0,26933,101818,0,128751
140810300400000,NE 134,Residential,27607,0,27607,119566,0,147173
140810300500000,NE 134,Residential,27607,0,27607,109844,0,137451
140810300600000,NE 134,Residential,28280,0,28280,89490,0,117770
140810300700000,NE 134,Residential,27720,0,27720,109448,0,137168
140810300800000,NE 134,Residential,27440,0,27440,91056,0,118496
140810300900000,NE 134,Residential,28160,0,28160,103220,0,131380
140810301000000,NE 134,Residential,28302,0,28302,120466,0,148768
140810301100000,NE 134,Residential,29302,0,29302,107968,0,137270
140810301200000,NE 134,Residential,36215,0,36215,143864,0,180079
140810301300000,NE 134,Residential,33709,0,33709,106514,0,140223
140810301400000,NE 134,Residential,33576,0,33576,120347,0,153923
140810301500000,NE 134,Residential,32275,0,32275,124911,0,157186
140810301600000,NE 134,Residential,33699,0,33699,94489,0,128188
140810301700000,NE 134,Residential,32943,0,32943,114102,0,147045
140810301800000,NE 134,Residential,32149,0,32149,130655,0,162804
140810301900000,NE 134,Residential,33523,0,33523,134385,0,167908
140810400100000,NE 134,Residential,31346,0,31346,143543,0,174889
140810400200000,NE 134,Residential,28785,0,28785,97303,0,126088
140810400300000,NE 134,Residential,28500,0,28500,140558,0,169058
140810400400000,NE 134,Residential,28215,0,28215,115785,0,144000
140810400500000,NE 134,Residential,27930,0,27930,114035,0,141965
140810400600000,NE 134,Residential,29988,0,29988,97448,0,127436
140810400700000,NE 134,Residential,27645,0,27645,107809,0,135454
140810400800000,NE 134,Residential,27645,0,27645,122634,0,150279
140810400900000,NE 134,Residential,27645,0,27645,105724,0,133369
140810401000000,NE 134,Residential,27298,0,27298,111610,0,138908
140810401100000,NE 134,Residential,32327,0,32327,127535,0,159862
140810401200000,NE 134,Residential,32063,0,32063,139910,0,171973
140810401300000,NE 134,Residential,31725,0,31725,136965,0,168690
140810401400000,NE 134,Residential,32063,0,32063,140621,0,172684
140810401500000,NE 134,Residential,33048,0,33048,118977,0,152025
140810401600000,NE 134,Residential,32738,0,32738,119344,0,152082
140810401700000,NE 134,Residential,33075,0,33075,120695,0,153770
140810401800000,NE 134,Residential,33075,0,33075,105142,0,138217
140810401900000,NE 134,Residential,31742,0,31742,125846,0,157588
140810402000000,NE 134,Residential,32915,0,32915,143829,0,176744
140810500100000,NE 134,Residential,29988,0,29988,124697,0,154685
140810500200000,NE 134,Residential,31742,0,31742,105073,0,136815
140810500300000,NE 134,Residential,31742,0,31742,133891,0,165633
140810500400000,NE 134,Residential,32062,0,32062,100946,0,133008
140810500500000,NE 134,Residential,32384,0,32384,118129,0,150513
140810500600000,NE 134,Residential,32837,0,32837,139105,0,171942
140810500700000,NE 134,Residential,32773,0,32773,131669,0,164442
140810500800000,NE 134,Residential,33542,0,33542,94576,0,128118
140810500900000,NE 134,Residential,31365,0,31365,149516,0,180881
140810501000000,NE 134,Residential,32746,0,32746,113487,0,146233
140810501100000,NE 134,Residential,34379,0,34379,140161,0,174540
140810501200000,NE 134,Residential,32438,0,32438,122426,0,154864
140810501300000,NE 134,Residential,34812,0,34812,129622,0,164434
140810501400000,NE 134,Residential,34007,0,34007,127390,0,161397
140810501500000,NE 134,Residential,31634,0,31634,131858,0,163492
140810501600000,NE 134,Residential,32506,0,32506,117678,0,150184
140810501700000,NE 134,Residential,32738,0,32738,116346,0,149084
140810501800000,NE 134,Residential,30919,0,30919,89667,0,120586
140810501900000,NE 134,Residential,32738,0,32738,109531,0,142269
140810502000000,NE 134,Residential,33393,0,33393,91038,0,124431
140810600100000,NE 134,Residential,33345,0,33345,117213,0,150558
140810600200000,NE 134,Residential,35568,0,35568,97680,0,133248
140810600300000,NE 134,Residential,34827,0,34827,103745,0,138572
140810600400000,NE 134,Residential,35611,0,35611,90458,0,126069
140810600500000,NE 134,Residential,34425,0,34425,102889,0,137314
140810600600000,NE 134,Residential,33611,0,33611,123984,0,157595
140810600700000,NE 134,Residential,34474,0,34474,97212,0,131686
140810600800000,NE 134,Residential,34003,0,34003,121409,0,155412
140810600900000,NE 134,Residential,34354,0,34354,96447,0,130801
140810601000000,NE 134,Residential,34616,0,34616,137142,0,171758
140810601100000,NE 134,Residential,34561,0,34561,123623,0,158184
140810601200000,NE 134,Residential,34140,0,34140,129499,0,163639
140810601300000,NE 134,Residential,34132,0,34132,162184,0,196316
140810601400000,NE 134,Residential,33997,0,33997,134006,0,168003
140810601500000,NE 134,Residential,34769,0,34769,122279,0,157048
140810601600000,NE 134,Residential,33787,0,33787,112563,0,146350
140810601700000,NE 134,Residential,36057,0,36057,105241,0,141298
140810601800000,NE 134,Residential,36932,0,36932,126071,0,163003
140810601900000,NE 134,Residential,34399,0,34399,86546,0,120945
140810602000000,NE 134,Residential,35494,0,35494,112352,0,147846
140810602100000,NE 134,Residential,33589,0,33589,113210,0,146799
140810602200000,NE 134,Residential,30645,0,30645,124302,0,154947
140810700100000,NE 134,Residential,35703,0,35703,121618,0,157321
140810700200000,NE 134,Residential,33801,0,33801,119749,0,153550
140810700300000,NE 134,Residential,33345,0,33345,112839,0,146184
140810700400000,NE 134,Residential,33885,0,33885,126810,0,160695
140810700500000,NE 134,Residential,32751,0,32751,140425,0,173176
140812600100000,NE 134,Residential,25994,0,25994,124092,0,150086
140812600200000,NE 134,Residential,28800,0,28800,144318,0,173118
140812600300000,NE 134,Residential,28500,0,28500,142212,0,170712
140812600400000,NE 134,Residential,30438,0,30438,115837,0,146275
140812600500000,NE 134,Residential,29408,0,29408,147060,0,176468
140812700100000,NE 134,Residential,28512,0,28512,144240,0,172752
140812700200000,NE 134,Residential,33372,0,33372,146600,0,179972
140812700300000,NE 134,Residential,33048,0,33048,117811,0,150859
140812700400000,NE 134,Residential,33247,0,33247,156156,0,189403
140812700500000,NE 134,Residential,29424,0,29424,130636,0,160060
140812700600000,NE 134,Residential,32307,0,32307,132255,0,164562
140812700700000,NE 134,Residential,30417,0,30417,142365,0,172782
140812700800000,NE 134,Residential,31188,0,31188,122987,0,154175
140812700900000,NE 134,Residential,31595,0,31595,145409,0,177004
140812701000000,NE 134,Residential,31464,0,31464,134144,0,165608
140812701100000,NE 134,Residential,30315,0,30315,146943,0,177258
140812701200000,NE 134,Residential,32400,0,32400,125157,0,157557
140812701300000,NE 134,Residential,27398,0,27398,114652,0,142050
140812701400000,NE 134,Residential,28699,0,28699,128722,0,157421
140812701500000,NE 134,Residential,30615,0,30615,127513,0,158128
140812701600000,NE 134,Residential,30703,0,30703,139644,0,170347
140812701700000,NE 134,Residential,29243,0,29243,139322,0,168565
140812701800000,NE 134,Residential,27779,0,27779,124681,0,152460
140812800100000,NE 134,Residential,32062,0,32062,148521,0,180583
140812800200000,NE 134,Residential,35373,0,35373,136573,0,171946
140812800300000,NE 134,Residential,31742,0,31742,170002,0,201744
140812800400000,NE 134,Residential,34140,0,34140,146554,0,180694
140812800500000,NE 134,Residential,33372,0,33372,136138,0,169510
140812800600000,NE 134,Residential,34344,0,34344,127955,0,162299
140812800700000,NE 134,Residential,34155,0,34155,127875,0,162030
140812800800000,NE 134,Residential,39154,0,39154,199771,0,238925
140812800900000,NE 134,Residential,36085,0,36085,203538,0,239623
140812801000000,NE 134,Residential,36360,0,36360,169372,0,205732
140812801100000,NE 134,Residential,37723,0,37723,173090,0,210813
140812801200000,NE 134,Residential,37296,0,37296,139601,0,176897
140812801300000,NE 134,Residential,36720,0,36720,158270,0,194990
140812801400000,NE 134,Residential,35027,0,35027,144399,0,179426
140812801500000,NE 134,Residential,32671,0,32671,124987,0,157658
140812900100000,NE 134,Residential,35613,0,35613,173246,0,208859
140812900200000,NE 134,Residential,32492,0,32492,165506,0,197998
140812900300000,NE 134,Residential,34200,0,34200,142837,0,177037
140812900400000,NE 134,Residential,34200,0,34200,160122,0,194322
140812900500000,NE 134,Residential,34200,0,34200,175860,0,210060
140812900600000,NE 134,Residential,34545,0,34545,175538,0,210083
140812900700000,NE 134,Residential,35754,0,35754,150263,0,186017
140812900800000,NE 134,Residential,36905,0,36905,178190,0,215095
140812900900000,NE 134,Residential,32763,0,32763,160606,0,193369
140812901000000,NE 134,Residential,32850,0,32850,162151,0,195001
140812901100000,NE 134,Residential,32850,0,32850,163866,0,196716
140812901200000,NE 134,Residential,32850,0,32850,147310,0,180160
140812901300000,NE 134,Residential,32850,0,32850,150192,0,183042
140813000100000,NE 134,Residential,33698,0,33698,118498,0,152196
140813000200000,NE 134,Residential,36360,0,36360,145117,0,181477
140813000300000,NE 134,Residential,36360,0,36360,171403,0,207763
140813000400000,NE 134,Residential,36360,0,36360,185097,0,221457
140813000500000,NE 134,Residential,35198,0,35198,175293,0,210491
140813000600000,NE 134,Residential,39907,0,39907,186477,0,226384
140813000700000,NE 134,Residential,42768,0,42768,217961,0,260729
140813000800000,NE 135,Residential,47143,0,47143,267200,0,314343
140813000900000,NE 135,Residential,45818,0,45818,205601,0,251419
140813001000000,NE 135,Residential,45315,0,45315,302027,0,347342
140813001100000,NE 135,Residential,45552,0,45552,319953,0,365505
140813001200000,NE 135,Residential,42573,0,42573,256546,0,299119
140813001300000,NE 135,Residential,43935,0,43935,185533,0,229468
140813001400000,NE 135,Residential,38833,0,38833,190776,0,229609
140813001500000,NE 135,Residential,39440,0,39440,216467,0,255907
140813001600000,NE 135,Residential,39558,0,39558,221820,0,261378
140813001700000,NE 135,Residential,39888,0,39888,193238,0,233126
140813001800000,NE 134,Residential,35975,0,35975,145375,0,181350
140813001900000,NE 134,Residential,34104,0,34104,137746,0,171850
140813002000000,NE 134,Residential,33027,0,33027,135193,0,168220
140813002100000,NE 134,Residential,37440,0,37440,187235,0,224675
140813002200000,NE 134,Residential,37179,0,37179,139804,0,176983
140813002300000,NE 134,Residential,33920,0,33920,183391,0,217311
140813002400000,NE 134,Residential,35226,0,35226,177858,0,213084
140813002500000,NE 134,Residential,36360,0,36360,202852,0,239212
140813002600000,NE 134,Residential,39244,0,39244,141270,0,180514
140813002700000,NE 134,Residential,39936,0,39936,178085,0,218021
140813100100000,NE 134,Residential,32482,0,32482,138938,0,171420
140813100200000,NE 134,Residential,32818,0,32818,135598,0,168416
140813100300000,NE 134,Residential,31256,0,31256,121737,0,152993
140813100400000,NE 134,Residential,33197,0,33197,150416,0,183613
140813100500000,NE 134,Residential,32705,0,32705,137342,0,170047
140813100600000,NE 134,Residential,38803,0,38803,157709,0,196512
140813100700000,NE 134,Residential,35113,0,35113,160300,0,195413
140813100800000,NE 134,Residential,36474,0,36474,168037,0,204511
140813100900000,NE 134,Residential,31977,0,31977,153889,0,185866
140813101000000,NE 134,Residential,34552,0,34552,183670,0,218222
140813101100000,NE 134,Residential,32636,0,32636,141911,0,174547
140813200100000,NE 134,Residential,31752,0,31752,133441,0,165193
140813200200000,NE 134,Residential,33858,0,33858,118390,0,152248
140813200300000,NE 134,Residential,32119,0,32119,123850,0,155969
140813200400000,NE 134,Residential,32589,0,32589,132414,0,165003
140813200500000,NE 134,Residential,31050,0,31050,129415,0,160465
140813200600000,NE 134,Residential,31742,0,31742,138944,0,170686
140813200700000,NE 135,Residential,39218,0,39218,187066,0,226284
140813200800000,NE 135,Residential,43757,0,43757,207049,0,250806
140813200900000,NE 135,Residential,39583,0,39583,229437,0,269020
140813201000000,NE 135,Residential,41487,0,41487,228714,0,270201
140813201100000,NE 135,Residential,45897,0,45897,247318,0,293215
140813201200000,NE 135,Residential,43541,0,43541,241193,0,284734
140813201300000,NE 135,Residential,45381,0,45381,197619,0,243000
140813201400000,NE 135,Residential,43120,0,43120,204178,0,247298
140813201500000,NE 135,Residential,43925,0,43925,278796,0,322721
140813201600000,NE 135,Residential,46876,0,46876,220296,0,267172
140813201700000,NE 135,Residential,42613,0,42613,306895,0,349508
140813201800000,NE 135,Residential,34650,0,34650,262586,0,297236
140813201900000,NE 135,Residential,41629,0,41629,301405,0,343034
140813202000000,NE 135,Residential,47522,0,47522,245925,0,293447
140813202100000,NE 135,Residential,46425,0,46425,296687,0,343112
140813202200000,NE 134,Residential,42793,0,42793,204681,0,247474
140813202300000,NE 134,Residential,44922,0,44922,223655,0,268577
140813202400000,NE 134,Residential,40850,0,40850,201537,0,242387
140813202500000,NE 134,Residential,37203,0,37203,198087,0,235290
140813202600000,NE 134,Residential,35350,0,35350,205509,0,240859
140813202700000,NE 134,Residential,34875,0,34875,150298,0,185173
140815100100000,NE 134,Residential,39643,0,39643,211237,0,250880
140815100200000,NE 134,Residential,39643,0,39643,209714,0,249357
140815100300000,NE 134,Residential,42753,0,42753,194916,0,237669
140815100400000,NE 135,Residential,61631,0,61631,336361,0,397992
140815100500000,NE 135,Residential,48675,0,48675,266543,0,315218
140815100600000,NE 135,Residential,48905,0,48905,237752,0,286657
140815100700000,NE 135,Residential,51984,0,51984,263287,0,315271
140815100800000,NE 135,Residential,53083,0,53083,328470,0,381553
140815200100000,NE 135,Residential,85050,0,85050,231054,0,316104
140815200200000,NE 135,Residential,48841,0,48841,229021,0,277862
140815200300000,NE 135,Residential,46885,0,46885,231567,0,278452
140815200400000,NE 135,Residential,44092,0,44092,251818,0,295910
140815200500000,NE 135,Residential,44415,0,44415,210746,0,255161
140815200600000,NE 135,Residential,50613,0,50613,248191,0,298804
140815200700000,NE 135,Residential,48790,0,48790,242931,0,291721
140815200800000,NE 135,Residential,48150,0,48150,207162,0,255312
140815200900000,NE 135,Residential,51604,0,51604,189062,0,240666
140815201000000,NE 135,Residential,52873,0,52873,220260,0,273133
140815201100000,NE 135,Residential,58603,0,58603,301682,0,360285
140815201200000,NE 135,Residential,53148,0,53148,252871,0,306019
140815201300000,NE 135,Residential,54320,0,54320,246354,0,300674
140815201400000,NE 135,Residential,49600,0,49600,247704,0,297304
140815201500000,NE 135,Residential,49200,0,49200,237623,0,286823
140815201600000,NE 135,Residential,52885,0,52885,247701,0,300586
140815201700000,NE 135,Residential,53410,0,53410,246890,0,300300
140815201800000,NE 135,Residential,47769,0,47769,239232,0,287001
140815201900000,NE 135,Residential,48828,0,48828,261080,0,309908
140815202000000,NE 135,Residential,49774,0,49774,230122,0,279896
140815202100000,NE 135,Residential,47401,0,47401,209400,0,256801
140815202200000,NE 136,Residential,65135,0,65135,292977,0,358112
140815202300000,NE 136,Residential,60420,0,60420,338909,0,399329
140815202400000,NE 136,Residential,58144,0,58144,291375,0,349519
140815202500000,NE 136,Residential,64418,0,64418,285691,0,350109
140815202600000,NE 136,Residential,65911,0,65911,322323,0,388234
140815202700000,NE 136,Residential,92350,0,92350,332721,0,425071
140815202800000,NE 136,Residential,74240,0,74240,390636,0,464876
140815202900000,NE 136,Residential,67800,0,67800,327541,0,395341
140815203000000,NE 136,Residential,65400,0,65400,303429,0,368829
140815203100000,NE 136,Residential,59875,0,59875,305455,0,365330
140815203200000,NE 136,Residential,48417,0,48417,220491,0,268908
140815203300000,NE 136,Residential,49272,0,49272,254790,0,304062
140815203400000,NE 136,Residential,50818,0,50818,249527,0,300345
140815203500000,NE 136,Residential,76500,0,76500,265061,0,341561
140815203600000,NE 136,Residential,85000,0,85000,264780,0,349780
140815203700000,NE 136,Residential,52929,0,52929,302045,0,354974
140815203800000,NE 136,Residential,44439,0,44439,297735,0,342174
140817600100000,NE 134,Residential,32483,0,32483,166916,0,199399
140817600200000,NE 134,Residential,32942,0,32942,133148,0,166090
140817600300000,NE 134,Residential,31699,0,31699,134975,0,166674
140817600400000,NE 134,Residential,30654,0,30654,158171,0,188825
140817600500000,NE 134,Residential,30234,0,30234,137078,0,167312
140817600600000,NE 134,Residential,30060,0,30060,138685,0,168745
140817600700000,NE 134,Residential,33817,0,33817,142005,0,175822
140817600800000,NE 134,Residential,30060,0,30060,141985,0,172045
140817600900000,NE 134,Residential,30060,0,30060,158219,0,188279
140817601000000,NE 134,Residential,30060,0,30060,163316,0,193376
140817601100000,NE 134,Residential,30182,0,30182,157367,0,187549
140817700100000,NE 134,Residential,29916,0,29916,109109,0,139025
140817700200000,NE 134,Residential,36644,0,36644,109009,0,145653
140817700300000,NE 134,Residential,37166,0,37166,117665,0,154831
140817700400000,NE 134,Residential,33354,0,33354,126096,0,159450
140817700500000,NE 134,Residential,36960,0,36960,157923,0,194883
140817700600000,NE 134,Residential,35269,0,35269,105067,0,140336
140817700700000,NE 134,Residential,36540,0,36540,145314,0,181854
140817700800000,NE 134,Residential,33068,0,33068,126113,0,159181
140817700900000,NE 134,Residential,32604,0,32604,155934,0,188538
140817701000000,NE 134,Residential,34398,0,34398,153714,0,188112
140817701100000,NE 134,Residential,40709,0,40709,134554,0,175263
140817701200000,NE 134,Residential,39724,0,39724,153368,0,193092
140817701300000,NE 134,Residential,32484,0,32484,108930,0,141414
140817701400000,NE 134,Residential,32393,0,32393,119386,0,151779
140817701500000,NE 134,Residential,30195,0,30195,107024,0,137219
140817701600000,NE 134,Residential,28598,0,28598,109412,0,138010
140817701700000,NE 134,Residential,29258,0,29258,138004,0,167262
140817800100000,NE 134,Residential,34992,0,34992,103760,0,138752
140817800200000,NE 134,Residential,34194,0,34194,124061,0,158255
140817800300000,NE 134,Residential,37968,0,37968,126296,0,164264
140817800400000,NE 134,Residential,35303,0,35303,126196,0,161499
140817800500000,NE 134,Residential,33372,0,33372,174582,0,207954
140817800600000,NE 134,Residential,34542,0,34542,108366,0,142908
140817800700000,NE 135,Residential,64050,0,64050,285391,0,349441
140817800800000,NE 135,Residential,75250,0,75250,268802,0,344052
140817800900000,NE 134,Residential,47977,0,47977,217051,0,265028
140817801000000,NE 134,Residential,32960,0,32960,157942,0,190902
140817801100000,NE 134,Residential,32640,0,32640,190453,0,223093
140817801200000,NE 134,Residential,43231,0,43231,197118,0,240349
140817801300000,NE 134,Residential,39830,0,39830,163520,0,203350
140817801400000,NE 134,Residential,34749,0,34749,115456,0,150205
140817801500000,NE 134,Residential,34898,0,34898,114767,0,149665
140817801600000,NE 134,Residential,37064,0,37064,162864,0,199928
140817801700000,NE 134,Residential,34157,0,34157,99995,0,134152
140817801800000,NE 134,Residential,36146,0,36146,122584,0,158730
140817900100000,NE 134,Residential,45423,0,45423,163958,0,209381
140817900200000,NE 134,Residential,39089,0,39089,151007,0,190096
140817900300000,NE 134,Residential,38375,0,38375,163888,0,202263
140817900400000,NE 134,Residential,37853,0,37853,126917,0,164770
140817900700000,NE 134,Residential,38587,0,38587,179739,0,218326
140818000100000,NE 134,Residential,38784,0,38784,159713,0,198497
140818000200000,NE 134,Residential,38343,0,38343,168457,0,206800
140818000300000,NE 134,Residential,53106,0,53106,140158,0,193264
140818000400000,NE 134,Residential,39217,0,39217,139146,0,178363
140818000500000,NE 134,Residential,36403,0,36403,161713,0,198116
140818000600000,NE 134,Residential,35910,0,35910,106701,0,142611
140818000700000,NE 134,Residential,43398,0,43398,229915,0,273313
140818000800000,NE 134,Residential,31680,0,31680,183477,0,215157
140818000900000,NE 134,Residential,31807,0,31807,0,0,31807
140818001200000,CENTRALLY ASSESSED,Other,0,0,0,0,0,0
140818001300000,CITY PROPERTY,Exempt,0,0,0,0,0,0
140818100100000,NE 135,Residential,48208,0,48208,155640,0,203848
140818100200000,NE 135,Residential,44408,0,44408,180915,0,225323
140818100300000,NE 135,Residential,44167,0,44167,182468,0,226635
140818100400000,NE 135,Residential,52148,0,52148,183877,0,236025
140818100500000,NE 135,Residential,77000,0,77000,235811,0,312811
140818100600000,NE 135,Residential,64743,0,64743,241318,0,306061
140818100700000,NE 135,Residential,51520,0,51520,213162,0,264682
140818100800000,NE 135,Residential,73905,0,73905,309411,0,383316
140818100900000,NE 135,Residential,64424,0,64424,195284,0,259708
140818101000000,NE 135,Residential,64565,0,64565,211572,0,276137
140818101100000,NE 135,Residential,57306,0,57306,213910,0,271216
140818101200000,NE 135,Residential,63220,0,63220,203992,0,267212
140818200500000,NE 134,Residential,34729,0,34729,151474,0,186203
140818200600000,NE 134,Residential,34884,0,34884,162007,0,196891
140820100100000,NE 139,Residential,22450,0,22450,0,0,22450
140820100200000,NE 139,Residential,29030,0,29030,143499,0,172529
140820100300000,NE 139,Residential,27471,0,27471,129584,0,157055
140820100400000,NE 139,Residential,27677,0,27677,146854,0,174531
140820100500000,NE 139,Residential,29016,0,29016,127544,0,156560
140820100600000,NE 139,Residential,26412,0,26412,126611,0,153023
140820100700000,NE 139,Residential,25296,0,25296,132025,0,157321
140820100800000,NE 139,Residential,24056,0,24056,141868,0,165924
140820100900000,NE 139,Residential,23736,0,23736,147264,0,171000
140820101000000,NE 139,Residential,23312,0,23312,138062,0,161374
140820101100000,NE 139,Residential,26320,0,26320,118662,0,144982
140820101400000,NE 139,Residential,15166,0,15166,173549,0,188715
140820101500000,NE 139,Residential,10318,0,10318,188381,0,198699
140820101600000,NE 139,Residential,21016,0,21016,156797,0,177813
140820101700000,NE 139,Residential,9387,0,9387,123648,0,133035
140820101800000,NE 139,Residential,15750,0,15750,122396,0,138146
140820101900000,NE 139,Residential,16302,0,16302,133687,0,149989
140820102000000,NE 139,Residential,9387,0,9387,122035,0,131422
140820102300000,NE 139,Residential,13728,0,13728,162075,0,175803
140820102400000,NE 139,Residential,12348,0,12348,175377,0,187725
140820102600000,NE 139,Residential,28500,0,28500,164881,0,193381
140820103900000,NE 139,Residential,16647,0,16647,158086,0,174733
140820104000000,NE 139,Residential,10317,0,10317,153452,0,163769
140820104100000,NE 139,Residential,26320,0,26320,120279,0,146599
140820104200000,NE 139,Residential,29030,0,29030,138768,0,167798
140820104300000,NE 139,Residential,25269,0,25269,169153,0,194422
140820104400000,NE 139,Residential,25192,0,25192,152263,0,177455
140820104500000,NE 139,Residential,27776,0,27776,169201,0,196977
140820104600000,NE 139,Residential,27776,0,27776,169834,0,197610
140820104700000,NE 139,Residential,27776,0,27776,173620,0,201396
140820104800000,NE 139,Residential,25792,0,25792,153107,0,178899
140820104900000,NE 139,Residential,26598,0,26598,172044,0,198642
140820105000000,NE 139,Residential,26320,0,26320,146323,0,172643
140820105100000,NE 139,Residential,26320,0,26320,139550,0,165870
140820105200000,NE 139,Residential,29400,0,29400,200232,0,229632
140820105300000,NE 139,Residential,29513,0,29513,144164,0,173677
140820105400000,NE 139,Residential,28667,0,28667,139537,0,168204
140820105500000,NE 139,Residential,28248,0,28248,147187,0,175435
140820105600000,NE 139,Residential,27071,0,27071,137929,0,165000
140820105700000,NE 139,Residential,28373,0,28373,160434,0,188807
140820105800000,NE 139,Residential,28971,0,28971,162828,0,191799
140820105900000,NE 139,Residential,27136,0,27136,165778,0,192914
140820106000000,NE 139,Residential,28036,0,28036,140909,0,168945
140820106100000,NE 139,Residential,22242,0,22242,117758,0,140000
140820106200000,NE 139,Residential,29914,0,29914,174069,0,203983
140820106300000,NE 139,Residential,27611,0,27611,170717,0,198328
140820106400000,NE 139,Residential,30189,0,30189,166292,0,196481
140820106500000,NE 139,Residential,29433,0,29433,137197,0,166630
140820106600000,NE 139,Residential,28776,0,28776,129611,0,158387
140820106700000,NE 139,Residential,30174,0,30174,135896,0,166070
140820106800000,NE 139,Residential,28764,0,28764,124765,0,153529
140820106900000,NE 139,Residential,28319,0,28319,126681,0,155000
140820107000000,NE 139,Residential,28280,0,28280,157172,0,185452
140820107100000,NE 139,Residential,28621,0,28621,138005,0,166626
140820107200000,NE 139,Residential,50438,0,50438,0,0,50438
140820107300000,NE 139,Residential,41817,0,41817,242478,0,284295
140820107400000,NE 139,Residential,39220,0,39220,232034,0,271254
140820107500000,NE 139,Residential,40838,0,40838,213208,0,254046
140820107600000,NE 139,Residential,36537,0,36537,212788,0,249325
140820107700000,NE 139,Residential,36320,0,36320,194798,0,231118
140820107800000,NE 139,Residential,36719,0,36719,206211,0,242930
140820107900000,NE 139,Residential,37893,0,37893,215250,0,253143
140820108000000,NE 139,Residential,35520,0,35520,210347,0,245867
140820108100000,NE 139,Residential,38220,0,38220,239519,0,277739
140820108200000,NE 139,Residential,39215,0,39215,218877,0,258092
140820108300000,NE 139,Residential,41807,0,41807,211069,0,252876
140820108400000,NE 139,Residential,42244,0,42244,214548,0,256792
140820108500000,NE 139,Residential,39990,0,39990,224609,0,264599
140820108600000,NE 139,Residential,39835,0,39835,214594,0,254429
140820108700000,NE 139,Residential,40058,0,40058,235679,0,275737
140820108800000,NE 139,Residential,39480,0,39480,193835,0,233315
140820108900000,NE 139,Residential,39480,0,39480,246338,0,285818
140820109000000,NE 139,Residential,39480,0,39480,193899,0,233379
140820109100000,NE 139,Residential,43986,0,43986,206904,0,250890
140820109200000,NE 135,Residential,135,0,135,0,0,135
140820109300000,NE 139,Residential,42778,0,42778,190266,0,233044
140820109400000,NE 139,Residential,42300,0,42300,224013,0,266313
140820109500000,NE 139,Residential,42075,0,42075,199798,0,241873
140820109600000,NE 139,Residential,42793,0,42793,226062,0,268855
140820109700000,NE 139,Residential,41807,0,41807,189216,0,231023
140820109800000,NE 139,Residential,42457,0,42457,192543,0,235000
140820109900000,NE 139,Residential,40660,0,40660,247606,0,288266
140820110000000,NE 139,Residential,42423,0,42423,173577,0,216000
140820110100000,NE 139,Residential,42864,0,42864,197733,0,240597
140820110200000,NE 139,Residential,43005,0,43005,172647,0,215652
140820110400000,CHURCH,Exempt,0,475416,475416,0,3549303,4024719
140820200100000,NE 135,Residential,44042,0,44042,293855,0,337897
140820200200000,NE 135,Residential,41876,0,41876,281219,0,323095
140820200300000,NE 135,Residential,44585,0,44585,280157,0,324742
140820200400000,NE 135,Residential,42962,0,42962,201617,0,244579
140820200500000,NE 135,Residential,40480,0,40480,236864,0,277344
140820300100000,NE 136,Residential,38882,0,38882,131896,0,170778
140820300200000,NE 136,Residential,37331,0,37331,154068,0,191399
140822602400000,CITY PROPERTY,Exempt,0,0,0,0,0,0
140822801000000,NE 140,Residential,11100,0,11100,0,0,11100
140825100100000,NE 138,Residential,10944,0,10944,0,0,10944
140825100200000,NE 138,Residential,61850,0,61850,138120,0,199970
140825100300000,NE 138,Residential,50530,0,50530,169459,0,219989
140825100400000,NE 138,Residential,48750,0,48750,142844,0,191594
140825100500000,NE 138,Residential,55250,0,55250,205558,0,260808
140825100600000,NE 138,Residential,43700,0,43700,218524,0,262224
140825100700000,NE 138,Residential,51733,0,51733,231306,0,283039
140825100800000,NE 138,Residential,44640,0,44640,285773,0,330413
140825100900000,NE 138,Residential,48180,0,48180,203121,0,251301
140825101000000,NE 138,Residential,49434,0,49434,131539,0,180973
140825101100000,NE 138,Residential,45125,0,45125,217421,0,262546
140825101200000,NE 138,Residential,46550,0,46550,181294,0,227844
140825101300000,NE 138,Residential,46550,0,46550,239021,0,285571
140825101400000,NE 138,Residential,49000,0,49000,187322,0,236322
140825101500000,NE 138,Residential,51649,0,51649,221222,0,272871
140825101600000,NE 138,Residential,48672,0,48672,178222,0,226894
140825101700000,NE 138,Residential,124297,0,124297,264501,0,388798
140825101800000,NE 138,Residential,63469,0,63469,231474,0,294943
140825101900000,NE 138,Residential,76550,0,76550,267227,0,343777
140825102000000,NE 138,Residential,76600,0,76600,298434,0,375034
140825102100000,NE 138,Residential,53309,0,53309,271516,0,324825
140825102200000,NE 138,Residential,52635,0,52635,210376,0,263011
140825102300000,NE 138,Residential,75400,0,75400,262255,0,337655
140825102400000,NE 138,Residential,54589,0,54589,191809,0,246398
140825102500000,NE 138,Residential,49908,0,49908,200663,0,250571
140825102600000,NE 138,Residential,46550,0,46550,187085,0,233635
140825102700000,NE 138,Residential,46550,0,46550,195903,0,242453
140825102800000,NE 138,Residential,51943,0,51943,203615,0,255558
140825102900000,NE 138,Residential,44820,0,44820,170802,0,215622
140825103000000,NE 138,Residential,52552,0,52552,143663,0,196215
140825103100000,NE 138,Residential,60638,0,60638,224362,0,285000
140825103200000,NE 138,Residential,49340,0,49340,275660,0,325000
140825103300000,NE 138,Residential,75500,0,75500,221391,0,296891
140825103400000,NE 138,Residential,48577,0,48577,260339,0,308916
140825103500000,NE 138,Residential,48195,0,48195,312431,0,360626
140825103600000,NE 138,Residential,51276,0,51276,233283,0,284559
140825103700000,NE 138,Residential,56962,0,56962,206922,0,263884
140825103800000,NE 138,Residential,56850,0,56850,222499,0,279349
140825103900000,NE 138,Residential,61785,0,61785,295158,0,356943
140825104000000,NE 138,Residential,20,0,20,0,0,20
140825104100000,NE 138,Residential,20,0,20,0,0,20
140825104200000,NE 138,Residential,20,0,20,0,0,20
140825200100000,NE 138,Residential,47923,0,47923,193651,0,241574
140825200300000,NE 138,Residential,47500,0,47500,155966,0,203466
140825200400000,NE 138,Residential,47500,0,47500,163959,0,211459
140825200500000,NE 138,Residential,47500,0,47500,132912,0,180412
140825300700000,NE 138,Residential,78,0,78,0,0,78
140825400100000,NE 138,Residential,51500,0,51500,282489,0,333989
140825400200000,NE 138,Residential,51300,0,51300,272110,0,323410
140825400300000,NE 138,Residential,50850,0,50850,293264,0,344114
140825400400000,NE 138,Residential,52200,0,52200,297286,0,349486
140825400500000,NE 138,Residential,56952,0,56952,278006,0,334958
140825400600000,NE 138,Residential,55781,0,55781,302871,0,358652
140825400700000,NE 138,Residential,47500,0,47500,244514,0,292014
140827600100000,NE 136,Residential,38467,0,38467,146655,0,185122
140827600200000,NE 136,Residential,37629,0,37629,131626,0,169255
140827600300000,NE 136,Residential,38326,0,38326,129444,0,167770
140827600400000,NE 136,Residential,39064,0,39064,137987,0,177051
140827600500000,NE 136,Residential,39108,0,39108,146828,0,185936
140827600600000,NE 136,Residential,37843,0,37843,135049,0,172892
140827600700000,NE 136,Residential,38610,0,38610,137243,0,175853
140827600800000,NE 136,Residential,38873,0,38873,144771,0,183644
140827600900000,NE 136,Residential,37660,0,37660,152988,0,190648
140827601000000,NE 136,Residential,37500,0,37500,141886,0,179386
140827601100000,NE 136,Residential,39312,0,39312,137419,0,176731
140827601200000,NE 136,Residential,38313,0,38313,122927,0,161240
140827601300000,NE 136,Residential,37406,0,37406,148798,0,186204
140827601400000,NE 136,Residential,40893,0,40893,131596,0,172489
140827601500000,NE 136,Residential,34508,0,34508,126822,0,161330
140827601600000,NE 136,Residential,35167,0,35167,134778,0,169945
140827601700000,NE 136,Residential,36167,0,36167,150055,0,186222
140827601800000,NE 136,Residential,35855,0,35855,152157,0,188012
140827601900000,NE 136,Residential,36550,0,36550,138398,0,174948
140827602000000,NE 136,Residential,35687,0,35687,135947,0,171634
140827602100000,NE 136,Residential,36966,0,36966,132288,0,169254
140827602200000,NE 136,Residential,36880,0,36880,136155,0,173035
140827602300000,NE 136,Residential,37125,0,37125,158143,0,195268
140827602400000,NE 136,Residential,38800,0,38800,151401,0,190201
140827602500000,NE 136,Residential,39162,0,39162,165761,0,204923
140827602600000,NE 136,Residential,37561,0,37561,145975,0,183536
140827602700000,NE 136,Residential,38874,0,38874,147676,0,186550
140827602800000,NE 136,Residential,34880,0,34880,132995,0,167875
140827602900000,NE 136,Residential,35243,0,35243,145799,0,181042
140827603000000,NE 136,Residential,38475,0,38475,157774,0,196249
140827603100000,NE 136,Residential,38430,0,38430,152877,0,191307
140827603200000,NE 136,Residential,36400,0,36400,142494,0,178894
140827603300000,NE 136,Residential,35182,0,35182,156270,0,191452
140827700100000,NE 136,Residential,37998,0,37998,140405,0,178403
140827700200000,NE 136,Residential,37998,0,37998,160286,0,198284
140827700300000,NE 136,Residential,37500,0,37500,134567,0,172067
140827700400000,NE 136,Residential,37516,0,37516,122045,0,159561
140827700500000,NE 136,Residential,37842,0,37842,132311,0,170153
140827700600000,NE 136,Residential,40185,0,40185,135977,0,176162
140827700700000,NE 136,Residential,37500,0,37500,146243,0,183743
140827800100000,NE 136,Residential,40196,0,40196,144525,0,184721
140827800200000,NE 136,Residential,40168,0,40168,131251,0,171419
140827800300000,NE 136,Residential,40712,0,40712,159277,0,199989
140827800400000,NE 136,Residential,41412,0,41412,139966,0,181378
140827800500000,NE 136,Residential,40097,0,40097,125630,0,165727
140827800600000,NE 136,Residential,41959,0,41959,134520,0,176479
140827800700000,NE 136,Residential,39105,0,39105,124685,0,163790
140827800800000,NE 136,Residential,39610,0,39610,123357,0,162967
140827800900000,NE 136,Residential,39558,0,39558,177670,0,217228
140827801000000,NE 136,Residential,41648,0,41648,158794,0,200442
140827801100000,NE 136,Residential,41819,0,41819,146894,0,188713
140827801200000,NE 136,Residential,44471,0,44471,163335,0,207806
140827801300000,NE 136,Residential,46410,0,46410,178787,0,225197
140827801400000,NE 136,Residential,41809,0,41809,148002,0,189811
140827801500000,NE 136,Residential,42997,0,42997,154953,0,197950
140827801600000,NE 136,Residential,43173,0,43173,141350,0,184523
140827801700000,NE 136,Residential,40422,0,40422,162407,0,202829
140827801800000,NE 136,Residential,40779,0,40779,138995,0,179774
140827801900000,NE 136,Residential,36600,0,36600,131758,0,168358
140827802000000,NE 136,Residential,39487,0,39487,137292,0,176779
140827802100000,NE 136,Residential,40664,0,40664,150767,0,191431
140827802200000,NE 136,Residential,40978,0,40978,133206,0,174184
140827802300000,NE 136,Residential,41960,0,41960,177212,0,219172
140827802400000,NE 136,Residential,37718,0,37718,139387,0,177105
140827802500000,NE 136,Residential,39238,0,39238,145781,0,185019
140827802600000,NE 136,Residential,42067,0,42067,155150,0,197217
140827802700000,NE 136,Residential,45120,0,45120,142299,0,187419
140827802800000,NE 136,Residential,45570,0,45570,158359,0,203929
140827802900000,NE 136,Residential,46050,0,46050,152730,0,198780
140827803000000,NE 136,Residential,45690,0,45690,138942,0,184632
140827803100000,NE 136,Residential,1200,0,1200,0,0,1200
140827900100000,NE 136,Residential,51370,0,51370,291214,0,342584
140828000100000,NE 136,Residential,47320,0,47320,199591,0,246911
140828000200000,NE 136,Residential,46611,0,46611,226384,0,272995
140828000300000,NE 136,Residential,48357,0,48357,260362,0,308719
140828000400000,NE 136,Residential,37206,0,37206,157525,0,194731
140828000500000,NE 136,Residential,36813,0,36813,136212,0,173025
140828000600000,NE 136,Residential,41007,0,41007,150336,0,191343
140828000700000,NE 136,Residential,39346,0,39346,148448,0,187794
140828000800000,NE 136,Residential,42997,0,42997,169072,0,212069
140828000900000,NE 136,Residential,43125,0,43125,173450,0,216575
140828001000000,NE 136,Residential,40116,0,40116,179660,0,219776
140828001100000,NE 136,Residential,40836,0,40836,145202,0,186038
140828001200000,NE 136,Residential,39924,0,39924,126089,0,166013
140828001300000,NE 136,Residential,41850,0,41850,159003,0,200853
140828001400000,NE 136,Residential,42187,0,42187,157769,0,199956
140830100100000,NE 137,Residential,61820,0,61820,206512,0,268332
140830100200000,NE 136,Residential,52741,0,52741,186014,0,238755
140830100300000,NE 137,Residential,54981,0,54981,218093,0,273074
140830100400000,NE 137,Residential,32520,0,32520,167281,0,199801
140830100700000,NE 137,Residential,64020,0,64020,289209,0,353229
140830100900000,NE 167,Residential,76454,0,76454,309488,0,385942
140830101000000,NE 167,Residential,69041,0,69041,304589,0,373630
140830101100000,NE 167,Residential,68322,0,68322,378909,0,447231
140830101200000,NE 167,Residential,71229,0,71229,350739,0,421968
140830101300000,NE 167,Residential,73401,0,73401,365434,0,438835
140830101400000,NE 167,Residential,72069,0,72069,346787,0,418856
140830101500000,NE 167,Residential,86402,0,86402,291509,0,377911
140830101600000,NE 167,Residential,73442,0,73442,346654,0,420096
140830101700000,NE 167,Residential,88061,0,88061,367909,0,455970
140830101800000,NE 149,Residential,5138,0,5138,0,0,5138
140830101900000,NE 149,Residential,5004,0,5004,0,0,5004
140830102000000,NE 149,Residential,5004,0,5004,0,0,5004
140830102100000,NE 149,Residential,4253,0,4253,0,0,4253
140830102200000,NE 149,Residential,3628,0,3628,0,0,3628
140830102300000,NE 149,Residential,3252,0,3252,0,0,3252
140830102400000,NE 149,Residential,3628,0,3628,0,0,3628
140830102600000,NE 149,Residential,6129,0,6129,0,0,6129
140830102700000,NE 149,Residential,5004,0,5004,0,0,5004
140830102800000,NE 149,Residential,4754,0,4754,0,0,4754
140830102900000,NE 149,Residential,4754,0,4754,0,0,4754
140830103000000,NE 149,Residential,4503,0,4503,0,0,4503
140830103100000,NE 149,Residential,99910,0,99910,323316,0,423226
140830103200000,NE 149,Residential,3850,0,3850,0,0,3850
140830103300000,NE 149,Residential,25200,0,25200,0,0,25200
140830103400000,NE 137,Residential,84525,0,84525,309253,0,393778
140830200100000,NE 137,Residential,49511,0,49511,192433,0,241944
140830200200000,NE 137,Residential,55685,0,55685,182764,0,238449
140830200300000,NE 137,Residential,58352,0,58352,302425,0,360777
140830200400000,NE 137,Residential,70276,0,70276,320109,0,390385
140830200500000,NE 137,Residential,57288,0,57288,269393,0,326681
140830200600000,NE 137,Residential,60366,0,60366,185591,0,245957
140830200700000,NE 137,Residential,62016,0,62016,210718,0,272734
140830200800000,NE 137,Residential,60336,0,60336,266583,0,326919
140830200900000,NE 137,Residential,49895,0,49895,169812,0,219707
140830201000000,NE 137,Residential,55105,0,55105,189542,0,244647
140830201100000,NE 137,Residential,54388,0,54388,178299,0,232687
140830201200000,NE 137,Residential,54945,0,54945,191277,0,246222
140830300100000,NE 137,Residential,61123,0,61123,229891,0,291014
140830300200000,NE 137,Residential,60900,0,60900,247218,0,308118
140830300300000,NE 137,Residential,63825,0,63825,247697,0,311522
140830300400000,NE 137,Residential,65151,0,65151,293404,0,358555
140830300500000,NE 137,Residential,63990,0,63990,235284,0,299274
140830300600000,NE 137,Residential,60833,0,60833,218759,0,279592
140830300700000,NE 167,Residential,104558,0,104558,510153,0,614711
140830300800000,NE 167,Residential,92800,0,92800,323503,0,416303
140830300900000,NE 167,Residential,75582,0,75582,336272,0,411854
140830301000000,NE 167,Residential,98325,0,98325,315718,0,414043
140830301100000,NE 167,Residential,89390,0,89390,355584,0,444974
140830301200000,NE 167,Residential,83448,0,83448,365135,0,448583
140830301300000,NE 167,Residential,83362,0,83362,346978,0,430340
140830301400000,NE 167,Residential,86402,0,86402,350083,0,436485
140832600100000,NE 137,Residential,68995,0,68995,388971,0,457966
140832600200000,NE 137,Residential,68818,0,68818,347390,0,416208
140832600300000,NE 137,Residential,78150,0,78150,265080,0,343230
140832600400000,NE 138,Residential,65875,0,65875,241015,0,306890
140832600500000,NE 138,Residential,64062,0,64062,247872,0,311934
140832600600000,NE 138,Residential,60560,0,60560,208420,0,268980
140832600700000,NE 138,Residential,64260,0,64260,349380,0,413640
140832600800000,NE 138,Residential,61680,0,61680,329088,0,390768
140832600900000,NE 138,Residential,67680,0,67680,286992,0,354672
140832601000000,NE 138,Residential,62320,0,62320,263829,0,326149
140832601100000,NE 138,Residential,54702,0,54702,339474,0,394176
140832601200000,NE 138,Residential,58032,0,58032,290742,0,348774
140832601300000,NE 138,Residential,51012,0,51012,189371,0,240383
140832601400000,NE 138,Residential,56407,0,56407,270780,0,327187
140832601500000,NE 138,Residential,55526,0,55526,302230,0,357756
140832601600000,NE 138,Residential,100600,0,100600,264843,0,365443
140832601800000,NE 137,Residential,77200,0,77200,270634,0,347834
140832601900000,NE 137,Residential,30380,0,30380,0,0,30380
140832602000000,NE 137,Residential,78250,0,78250,222441,0,300691
140832602100000,NE 137,Residential,77200,0,77200,238184,0,315384
140832602300000,NE 167,Residential,91123,0,91123,444775,0,535898
140832602400000,NE 167,Residential,78826,0,78826,526619,0,605445
140832602500000,NE 167,Residential,99450,0,99450,329452,0,428902
140832602600000,NE 167,Residential,86895,0,86895,0,0,86895
140832602700000,CITY PROPERTY,Exempt,0,0,0,0,0,0
140832602800000,NE 167,Residential,74814,0,74814,339236,0,414050
140832700100000,NE 138,Residential,62152,0,62152,345722,0,407874
140835100100000,NE 167,Residential,71504,0,71504,0,0,71504
140835100200000,NE 167,Residential,81081,0,81081,407243,0,488324
140835100300000,NE 167,Residential,88036,0,88036,427461,0,515497
140835100400000,NE 167,Residential,73400,0,73400,422679,0,496079
140835200200000,NE 167,Residential,154100,0,154100,918554,0,1072654
140835200300000,NE 167,Residential,71198,0,71198,539193,0,610391
140835200400000,NE 167,Residential,92988,0,92988,376129,0,469117
140835200500000,NE 167,Residential,88919,0,88919,416588,0,505507
140835200600000,NE 167,Residential,102240,0,102240,380651,0,482891
140835200700000,NE 167,Residential,90293,0,90293,326868,0,417161
140835200800000,NE 167,Residential,53409,0,53409,0,0,53409
140835200900000,NE 167,Residential,59129,0,59129,331193,0,390322
140835201000000,NE 167,Residential,88585,0,88585,280753,0,369338
140835201100000,NE 167,Residential,87675,0,87675,263939,0,351614
140835201200000,CENTRALLY ASSESSED,Other,0,0,0,0,0,0
140835201300000,NE 167,Residential,77616,0,77616,410743,0,488359
140835201400000,NE 167,Residential,82971,0,82971,452612,0,535583
140835201500000,NE 167,Residential,129363,0,129363,393594,0,522957
140835201600000,NE 167,Residential,131000,0,131000,458135,0,589135
140835201700000,NE 167,Residential,206350,0,206350,534812,0,741162
140835201800000,NE 167,Residential,122944,0,122944,484622,0,607566
140835201900000,NE 167,Residential,98428,0,98428,491125,0,589553
140835202000000,NE 167,Residential,95558,0,95558,472699,0,568257
140837600100000,CITY PROPERTY,Exempt,0,0,0,0,0,0
140837600500000,NE 167,Residential,113227,0,113227,350102,0,463329
140837600600000,NE 167,Residential,81354,0,81354,322466,0,403820
140837600700000,NE 167,Residential,80535,0,80535,353699,0,434234
140837600800000,NE 167,Residential,71938,0,71938,0,0,71938
140837600900000,NE 167,Residential,82000,0,82000,308369,0,390369
140837601000000,NE 167,Residential,74631,0,74631,346227,0,420858
140837601100000,NE 167,Residential,75717,0,75717,310579,0,386296
140837601200000,NE 167,Residential,64855,0,64855,0,0,64855
140837601300000,NE 149,Residential,136710,0,136710,252773,0,389483
140837601400000,NE 149,Residential,8070,0,8070,0,0,8070
140837601500000,NE 149,Residential,7532,0,7532,0,0,7532
140837601600000,NE 149,Residential,8070,0,8070,0,0,8070
140837601700000,NE 149,Residential,9049,0,9049,0,0,9049
140837700100000,NE 167,Residential,60775,0,60775,345284,0,406059
140837700200000,NE 167,Residential,73173,0,73173,332339,0,405512
140837700300000,NE 167,Residential,74725,0,74725,341405,0,416130
140837700600000,NE 149,Residential,2995,0,2995,0,0,2995
140837700900000,NE 167,Residential,57420,0,57420,313489,0,370909
140837701000000,NE 167,Residential,68580,0,68580,324200,0,392780
140837701300000,NE 167,Residential,58608,0,58608,357779,0,416387
140837701600000,NE 167,Residential,37248,0,37248,0,0,37248
140840100100000,NE 135,Residential,22194,0,22194,152498,0,174692
140840100200000,NE 135,Residential,24150,0,24150,125235,0,149385
140840100300000,NE 135,Residential,24150,0,24150,99934,0,124084
140840100400000,NE 135,Residential,24150,0,24150,127025,0,151175
140840100500000,NE 135,Residential,25760,0,25760,121704,0,147464
140840100600000,NE 135,Residential,25760,0,25760,124593,0,150353
140840100700000,NE 135,Residential,27600,0,27600,112902,0,140502
140840100800000,NE 135,Residential,25507,0,25507,111859,0,137366
140840100900000,NE 135,Residential,24782,0,24782,129038,0,153820
140840101000000,NE 135,Residential,24150,0,24150,127371,0,151521
140840101100000,NE 135,Residential,25760,0,25760,101889,0,127649
140840101200000,NE 135,Residential,24150,0,24150,108943,0,133093
140840101300000,NE 135,Residential,24150,0,24150,132125,0,156275
140840101400000,NE 135,Residential,24150,0,24150,115055,0,139205
140840101500000,NE 135,Residential,25105,0,25105,110293,0,135398
140840200100000,NE 135,Residential,28679,0,28679,115428,0,144107
140840200200000,NE 135,Residential,28697,0,28697,127081,0,155778
140840200300000,NE 135,Residential,61950,0,61950,0,0,61950
140840200400000,NE 135,Residential,32908,0,32908,148786,0,181694
140840200500000,NE 135,Residential,31617,0,31617,142613,0,174230
140840200600000,NE 135,Residential,30683,0,30683,124551,0,155234
140840200700000,NE 135,Residential,32083,0,32083,115863,0,147946
140840200800000,NE 135,Residential,32480,0,32480,170117,0,202597
140840200900000,NE 135,Residential,29211,0,29211,146422,0,175633
140840201000000,NE 135,Residential,30428,0,30428,142993,0,173421
140840201100000,NE 135,Residential,30013,0,30013,156817,0,186830
140840201200000,NE 135,Residential,29750,0,29750,124141,0,153891
140840201300000,NE 135,Residential,29353,0,29353,122886,0,152239
140840201400000,NE 135,Residential,29393,0,29393,111295,0,140688
140840201500000,NE 135,Residential,27014,0,27014,134853,0,161867
140840201600000,NE 135,Residential,28600,0,28600,147672,0,176272
140840201700000,NE 135,Residential,26096,0,26096,133787,0,159883
140840201800000,NE 135,Residential,28359,0,28359,142025,0,170384
140840300100000,NE 135,Residential,24878,0,24878,102098,0,126976
140840300200000,NE 135,Residential,24675,0,24675,111777,0,136452
140840300300000,NE 135,Residential,27038,0,27038,123302,0,150340
140840300400000,NE 135,Residential,27212,0,27212,148387,0,175599
140840300500000,NE 135,Residential,29452,0,29452,146178,0,175630
140840300600000,NE 135,Residential,29717,0,29717,113674,0,143391
140840300700000,NE 135,Residential,29592,0,29592,133848,0,163440
140840300800000,NE 135,Residential,27515,0,27515,118204,0,145719
140840300900000,NE 135,Residential,28102,0,28102,130256,0,158358
140840301000000,NE 135,Residential,27189,0,27189,115053,0,142242
140840301100000,NE 135,Residential,25561,0,25561,116671,0,142232
140840301200000,NE 135,Residential,31841,0,31841,115277,0,147118
140840301300000,NE 135,Residential,32116,0,32116,129460,0,161576
140840301400000,NE 135,Residential,32116,0,32116,139088,0,171204
140840301500000,NE 135,Residential,31862,0,31862,138833,0,170695
140840301600000,NE 135,Residential,31862,0,31862,137033,0,168895
140840301700000,NE 135,Residential,31865,0,31865,139800,0,171665
140840301800000,NE 135,Residential,26034,0,26034,149930,0,175964
140840301900000,NE 135,Residential,29699,0,29699,147286,0,176985
140840302000000,NE 135,Residential,31108,0,31108,133933,0,165041
140840302100000,NE 135,Residential,23436,0,23436,138831,0,162267
140840302200000,NE 135,Residential,27927,0,27927,136845,0,164772
140840302300000,NE 135,Residential,26160,0,26160,108489,0,134649
140840302400000,NE 135,Residential,24750,0,24750,104758,0,129508
140840302500000,NE 135,Residential,19813,0,19813,119455,0,139268
140840302600000,NE 135,Residential,24355,0,24355,120067,0,144422
140840400100000,NE 135,Residential,30692,0,30692,102938,0,133630
140840400200000,NE 135,Residential,27370,0,27370,117499,0,144869
140840400300000,NE 135,Residential,31267,0,31267,126955,0,158222
140840400400000,NE 135,Residential,32585,0,32585,168614,0,201199
140840400500000,NE 135,Residential,31609,0,31609,129112,0,160721
140840400600000,NE 135,Residential,31235,0,31235,147358,0,178593
140840400700000,NE 135,Residential,32862,0,32862,148340,0,181202
140840400800000,NE 135,Residential,34257,0,34257,151143,0,185400
140840400900000,NE 135,Residential,30801,0,30801,119172,0,149973
140840401000000,NE 135,Residential,32820,0,32820,140044,0,172864
140840401100000,NE 135,Residential,32504,0,32504,142272,0,174776
140840401200000,NE 135,Residential,31331,0,31331,111011,0,142342
140840401300000,NE 135,Residential,36750,0,36750,219804,0,256554
140842600100000,NE 135,Residential,93300,0,93300,0,0,93300
140842600200000,NE 135,Residential,176950,0,176950,0,0,176950
140842600300000,NE 135,Residential,34510,0,34510,148680,0,183190
140842600400000,NE 135,Residential,31145,0,31145,172073,0,203218
140842600500000,NE 135,Residential,33220,0,33220,147938,0,181158
140842600600000,NE 135,Residential,35094,0,35094,153371,0,188465
140842600700000,NE 135,Residential,33220,0,33220,137862,0,171082
140842600800000,NE 135,Residential,34857,0,34857,194288,0,229145
140842600900000,NE 135,Residential,32050,0,32050,152406,0,184456
140845100100000,NE 135,Residential,26142,0,26142,146742,0,172884
140845100200000,NE 135,Residential,29050,0,29050,138894,0,167944
140845100300000,NE 135,Residential,27720,0,27720,149463,0,177183
140845200100000,NE 135,Residential,36109,0,36109,128445,0,164554
140845200200000,NE 135,Residential,34252,0,34252,219040,0,253292
140845200300000,NE 135,Residential,29155,0,29155,167784,0,196939
140845200400000,NE 135,Residential,31150,0,31150,162257,0,193407
140845200500000,NE 135,Residential,30210,0,30210,139880,0,170090
140845200600000,NE 135,Residential,32035,0,32035,133452,0,165487
140845200700000,NE 135,Residential,33453,0,33453,149626,0,183079
140845200800000,NE 135,Residential,30940,0,30940,193758,0,224698
140845200900000,NE 135,Residential,30702,0,30702,157765,0,188467
140845201000000,NE 135,Residential,32427,0,32427,165469,0,197896
140845201100000,NE 135,Residential,34791,0,34791,166155,0,200946
140845201200000,NE 135,Residential,32760,0,32760,170219,0,202979
140845201300000,NE 135,Residential,32664,0,32664,163492,0,196156
140845201400000,NE 135,Residential,31487,0,31487,149126,0,180613
140845201500000,NE 135,Residential,47650,0,47650,181367,0,229017
140845201600000,NE 149,Residential,37468,0,37468,161009,0,198477
140845201700000,NE 149,Residential,29211,0,29211,180397,0,209608
140845201800000,NE 149,Residential,29211,0,29211,180783,0,209994
140845201900000,NE 135,Residential,38114,0,38114,140969,0,179083
140845202000000,NE 135,Residential,32505,0,32505,171647,0,204152
140845202100000,NE 135,Residential,32725,0,32725,185795,0,218520
140845202200000,NE 135,Residential,32907,0,32907,155459,0,188366
140845202300000,NE 135,Residential,45350,0,45350,176508,0,221858
140845202400000,NE 135,Residential,32997,0,32997,155049,0,188046
140845202500000,NE 135,Residential,31327,0,31327,135625,0,166952
140845202600000,NE 135,Residential,31059,0,31059,121524,0,152583
140845202700000,NE 135,Residential,32319,0,32319,134806,0,167125
140845202800000,NE 135,Residential,33165,0,33165,158662,0,191827
140845202900000,NE 135,Residential,30527,0,30527,159492,0,190019
140845300100000,NE 135,Residential,33495,0,33495,154952,0,188447
140845300200000,NE 135,Residential,88550,0,88550,0,0,88550
140845300300000,NE 135,Residential,47275,0,47275,161640,0,208915
140845300400000,NE 135,Residential,46550,0,46550,189132,0,235682
140845300500000,NE 135,Residential,47000,0,47000,145814,0,192814
140845300600000,NE 149,Residential,49823,0,49823,202876,0,252699
140845300700000,NE 149,Residential,27543,0,27543,195574,0,223117
140845300800000,NE 135,Residential,30048,0,30048,185501,0,215549
140845300900000,NE 135,Residential,34650,0,34650,160206,0,194856
140845301000000,NE 135,Residential,34587,0,34587,161256,0,195843
140845301100000,NE 135,Residential,34486,0,34486,192889,0,227375
140845301200000,NE 135,Residential,28558,0,28558,158628,0,187186
140845301300000,NE 135,Residential,35700,0,35700,172205,0,207905
140845301400000,NE 135,Residential,45475,0,45475,162680,0,208155
140845301500000,NE 135,Residential,35224,0,35224,156447,0,191671
140845301600000,NE 135,Residential,32830,0,32830,146149,0,178979
140845301700000,NE 135,Residential,32205,0,32205,153726,0,185931
140845301800000,NE 135,Residential,30940,0,30940,161280,0,192220
140845301900000,NE 135,Residential,31535,0,31535,164053,0,195588
140845302000000,NE 135,Residential,31833,0,31833,167372,0,199205
140845302100000,NE 135,Residential,32428,0,32428,136626,0,169054
140845302200000,NE 135,Residential,33023,0,33023,152858,0,185881
140845302300000,NE 135,Residential,33618,0,33618,154604,0,188222
140847600100000,NE 135,Residential,95700,0,95700,135268,0,230968
140847600200000,NE 135,Residential,29162,0,29162,132800,0,161962
140847600300000,NE 135,Residential,29453,0,29453,141208,0,170661
140847600400000,NE 135,Residential,30048,0,30048,131446,0,161494
140847600500000,NE 135,Residential,31462,0,31462,122439,0,153901
140847600600000,NE 135,Residential,33226,0,33226,126407,0,159633
140847600700000,NE 135,Residential,34335,0,34335,135506,0,169841
140847600800000,NE 135,Residential,28167,0,28167,0,0,28167
140847600900000,NE 135,Residential,31582,0,31582,119589,0,151171
140847601000000,NE 135,Residential,32246,0,32246,116204,0,148450
140847601100000,NE 135,Residential,31640,0,31640,105694,0,137334
140847601200000,NE 135,Residential,31261,0,31261,149516,0,180777
140847601300000,NE 135,Residential,31533,0,31533,127177,0,158710
140847601400000,NE 135,Residential,31809,0,31809,140612,0,172421
140847601500000,NE 135,Residential,31659,0,31659,151453,0,183112
140847601600000,NE 135,Residential,32787,0,32787,173145,0,205932
140847601700000,NE 135,Residential,33278,0,33278,126954,0,160232
140847601800000,NE 135,Residential,31594,0,31594,154982,0,186576
140847601900000,NE 135,Residential,31327,0,31327,144978,0,176305
140847602000000,NE 135,Residential,31327,0,31327,123074,0,154401
140847602100000,NE 135,Residential,31424,0,31424,141206,0,172630
140847602200000,NE 135,Residential,32103,0,32103,149514,0,181617
140847602300000,NE 135,Residential,31832,0,31832,132206,0,164038
140847602400000,NE 135,Residential,32694,0,32694,166013,0,198707
140847602500000,NE 135,Residential,32012,0,32012,149250,0,181262
140847602600000,NE 135,Residential,31594,0,31594,162738,0,194332
140847602700000,NE 135,Residential,31785,0,31785,146447,0,178232
140847602800000,NE 135,Residential,29155,0,29155,117160,0,146315
140847602900000,NE 135,Residential,29155,0,29155,139962,0,169117
140847603000000,NE 135,Residential,24908,0,24908,141940,0,166848
140847603100000,NE 135,Residential,3525,0,3525,0,0,3525
140847700100000,NE 135,Residential,29654,0,29654,142784,0,172438
140847700200000,NE 135,Residential,27160,0,27160,149457,0,176617
140847700300000,NE 135,Residential,28905,0,28905,136955,0,165860
140847700400000,NE 135,Residential,31546,0,31546,146947,0,178493
140847700500000,NE 135,Residential,46125,0,46125,125487,0,171612
140847700600000,NE 135,Residential,45225,0,45225,203263,0,248488
140847700700000,NE 135,Residential,34650,0,34650,144142,0,178792
140847700800000,NE 135,Residential,32725,0,32725,142180,0,174905
140847700900000,NE 135,Residential,31135,0,31135,127204,0,158339
140847701000000,NE 135,Residential,29248,0,29248,140208,0,169456
140847701100000,NE 135,Residential,27189,0,27189,140943,0,168132
140847701200000,NE 135,Residential,35897,0,35897,149833,0,185730
140847701300000,NE 135,Residential,37775,0,37775,154899,0,192674
140847701400000,NE 135,Residential,35593,0,35593,147715,0,183308
140847701500000,NE 135,Residential,29453,0,29453,143892,0,173345
140847701600000,NE 135,Residential,26775,0,26775,140870,0,167645
140910100100000,NE 132,Residential,30120,0,30120,77671,0,107791
140910100200000,NE 132,Residential,24240,0,24240,79546,0,103786
140910100300000,NE 132,Residential,23432,0,23432,65218,0,88650
140910100400000,OFFICE; MEDICAL,Commercial,0,64800,64800,0,195702,260502
140910100500000,OFFICE,Commercial,0,129254,129254,0,352675,481929
140910100600000,APARTMENT,Exempt,0,61560,61560,0,978949,1040509
140910100800000,APARTMENT,Commercial,0,69660,69660,0,930340,1000000
140910101100000,SCHOOL,Exempt,0,0,0,0,0,0
140910101200000,NE 132,Residential,29510,0,29510,87128,0,116638
140910101300000,NE 132,Residential,31050,0,31050,99230,0,130280
140910101400000,NE 132,Residential,31050,0,31050,91487,0,122537
140910101500000,NE 132,Residential,31050,0,31050,86894,0,117944
140910101600000,NE 132,Residential,31050,0,31050,97175,0,128225
140910101700000,NE 132,Residential,31050,0,31050,87205,0,118255
140910101800000,NE 132,Residential,31050,0,31050,94319,0,125369
140910101900000,NE 132,Residential,31050,0,31050,114379,0,145429
140910102000000,NE 132,Residential,31050,0,31050,85653,0,116703
140910102100000,NE 132,Residential,31050,0,31050,120890,0,151940
140910102200000,NE 132,Residential,31050,0,31050,119606,0,150656
140910102300000,NE 132,Residential,31050,0,31050,107068,0,138118
140910102400000,NE 132,Residential,31050,0,31050,119022,0,150072
140910102500000,APARTMENT,Commercial,0,104112,104112,0,1102499,1206611
140910200100000,APARTMENT,Commercial,0,863460,863460,0,13559300,14422760
140910200200000,NE 132,Residential,33000,0,33000,95148,0,128148
140910200300000,NE 132,Residential,30000,0,30000,109092,0,139092
140910200400000,NE 132,Residential,33000,0,33000,105236,0,138236
140910200500000,NE 132,Residential,33000,0,33000,82196,0,115196
140910200600000,NE 132,Residential,33000,0,33000,88496,0,121496
140910200700000,NE 132,Residential,33000,0,33000,74067,0,107067
140910200800000,NE 132,Residential,33000,0,33000,78121,0,111121
140910200900000,NE 132,Residential,33000,0,33000,90262,0,123262
140910201000000,NE 132,Residential,33000,0,33000,84456,0,117456
140910201100000,NE 132,Residential,33000,0,33000,88882,0,121882
140910201200000,NE 132,Residential,36795,0,36795,103743,0,140538
140910300100000,NE 132,Residential,33972,0,33972,84651,0,118623
140910300200000,NE 132,Residential,33000,0,33000,83469,0,116469
140910300300000,NE 132,Residential,33000,0,33000,77291,0,110291
140910300400000,NE 132,Residential,33000,0,33000,76234,0,109234
140910300500000,NE 132,Residential,33000,0,33000,95437,0,128437
140910300600000,NE 132,Residential,33000,0,33000,91567,0,124567
140910300700000,NE 132,Residential,33000,0,33000,148046,0,181046
140910300800000,NE 132,Residential,33000,0,33000,79265,0,112265
140910300900000,NE 132,Residential,33000,0,33000,109307,0,142307
140910301000000,NE 132,Residential,33000,0,33000,96147,0,129147
140910301100000,NE 132,Residential,33000,0,33000,77679,0,110679
140910301200000,NE 132,Residential,33000,0,33000,86480,0,119480
140910301300000,NE 132,Residential,31900,0,31900,79940,0,111840
140910301400000,NE 132,Residential,33000,0,33000,86410,0,119410
140910301500000,NE 132,Residential,33000,0,33000,83991,0,116991
140910301600000,NE 132,Residential,33000,0,33000,80723,0,113723
140910301700000,NE 132,Residential,33000,0,33000,98118,0,131118
140910301800000,NE 132,Residential,33000,0,33000,115964,0,148964
140910301900000,NE 132,Residential,30000,0,30000,79449,0,109449
140910302000000,NE 132,Residential,33000,0,33000,99604,0,132604
140910302100000,NE 132,Residential,33000,0,33000,78570,0,111570
140910302200000,NE 132,Residential,32028,0,32028,79961,0,111989
140912600100000,BRANCH BANK/CU,Commercial,0,184896,184896,0,428805,613701
140912600200000,LG DISCOUNT/RETAIL,Commercial,0,761400,761400,0,1499019,2260419
140912600300000,RESTAURANT,Commercial,0,340200,340200,0,219898,560098
140912600400000,NBHD SHOPPING CENTER,Commercial,0,97470,97470,0,484101,581571
140912600500000,SMALL RETAIL,Commercial,0,305235,305235,0,490879,796114
140912600600000,NE 132,Residential,40314,0,40314,115995,0,156309
140912600700000,NE 132,Residential,35530,0,35530,91748,0,127278
140912600800000,NE 132,Residential,33000,0,33000,104885,0,137885
140912600900000,NE 132,Residential,33000,0,33000,73400,0,106400
140912601000000,NE 132,Residential,33000,0,33000,92165,0,125165
140912601100000,SMALL RETAIL,Commercial,0,34020,34020,0,116315,150335
140912601200000,OFFICE,Commercial,0,41368,41368,0,132491,173859
140912601300000,OFFICE,Commercial,0,30026,30026,0,162979,193005
140912601400000,VETERINARY CLINIC,Commercial,0,45360,45360,0,206301,251661
140912601500000,FITNESS CENTER,Commercial,0,178200,178200,0,386587,564787
140912700100000,CONVENIENCE STORE,Commercial,0,248184,248184,0,294420,542604
140912700200000,AUTO REPAIR/SALES,Commercial,0,174420,174420,0,72626,247046
140912700300000,SMALL RETAIL,Commercial,0,108456,108456,0,96121,204577
140912700400000,SMALL RETAIL,Commercial,0,105216,105216,0,99523,204739
140912700700000,CENTRALLY ASSESSED,Other,0,0,0,0,0,0
140912700800000,SMALL RETAIL,Commercial,0,86594,86594,0,86779,173373
140912700900000,BARS/LOUNGE,Commercial,0,60756,60756,0,116314,177070
140912701000000,RESTAURANT,Commercial,0,284310,284310,0,212347,496657
140912701100000,RESTAURANT,Commercial,0,209520,209520,0,202325,411845
140912701200000,LAUNDROMAT/CLEANERS,Commercial,0,94562,94562,0,178531,273093
140912701300000,FAST FOOD,Commercial,0,193860,193860,0,369102,562962
140912701400000,NBHD SHOPPING CENTER,Commercial,0,361800,361800,0,547357,909157
140912701500000,LAUNDROMAT/CLEANERS,Commercial,0,130108,130108,0,65140,195248
140912701600000,LG DISCOUNT/RETAIL,Commercial,0,313200,313200,0,234859,548059
140912800100000,NE 132,Residential,33000,0,33000,85019,0,118019
140912800200000,NE 132,Residential,33000,0,33000,95422,0,128422
140912800300000,NE 132,Residential,33000,0,33000,81715,0,114715
140912800400000,NE 132,Residential,33000,0,33000,74967,0,107967
140912800500000,NE 132,Residential,35653,0,35653,91499,0,127152
140912800600000,NE 132,Residential,33642,0,33642,72899,0,106541
140912800700000,NE 132,Residential,33000,0,33000,75329,0,108329
140912800800000,NE 132,Residential,31900,0,31900,79589,0,111489
140912800900000,NE 132,Residential,33000,0,33000,80064,0,113064
140912801000000,NE 132,Residential,31900,0,31900,88703,0,120603
140912900100000,NE 133,Residential,146,0,146,0,0,146
140915100100000,NE 132,Residential,33000,0,33000,94933,0,127933
140915100200000,NE 132,Residential,33000,0,33000,82271,0,115271
140915100300000,NE 132,Residential,29333,0,29333,110683,0,140016
140915100400000,NE 132,Residential,17271,0,17271,83579,0,100850
140915100500000,NE 132,Residential,16920,0,16920,90681,0,107601
140915100600000,NE 132,Residential,16920,0,16920,81938,0,98858
140915100700000,NE 132,Residential,16826,0,16826,82583,0,99409
140915100800000,NE 132,Residential,32450,0,32450,91132,0,123582
140915100900000,NE 132,Residential,31900,0,31900,78871,0,110771
140915101000000,NE 132,Residential,31900,0,31900,80746,0,112646
140915102000000,CENTRALLY ASSESSED,Other,0,0,0,0,0,0
140915200100000,OFFICE,Commercial,0,159181,159181,0,357111,516292
140915200200000,OFFICE,Commercial,0,116122,116122,0,50345,166467
140915200300000,OFFICE,Commercial,0,118563,118563,0,365018,483581
140915200500000,NE 132,Residential,20007,0,20007,47371,0,67378
140915200600000,NE 132,Residential,20880,0,20880,67738,0,88618
140915200700000,APARTMENT,Commercial,0,25272,25272,0,206075,231347
140915200800000,OFFICE,Commercial,0,45360,45360,0,75233,120593
140915200900000,OFFICE; MEDICAL,Commercial,0,150336,150336,0,536894,687230
140915201000000,NE 132,Residential,21895,0,21895,72195,0,94090
140915201100000,BRANCH BANK/CU,Commercial,0,100980,100980,0,220693,321673
140915201200000,OFFICE,Commercial,0,98820,98820,0,258018,356838
140915201300000,OFFICE,Commercial,0,95580,95580,0,310876,406456
140915201400000,NE 132,Residential,18550,0,18550,57105,0,75655
140915300100000,NE 132,Residential,32670,0,32670,77832,0,110502
140915300200000,NE 132,Residential,32670,0,32670,103319,0,135989
140915300300000,NE 132,Residential,31944,0,31944,91724,0,123668
140915300400000,NE 132,Residential,43124,0,43124,79291,0,122415
140915300500000,NE 132,Residential,24000,0,24000,58137,0,82137
140915300600000,NE 132,Residential,23100,0,23100,109608,0,132708
140915300700000,NE 132,Residential,33550,0,33550,84375,0,117925
140915300800000,NE 132,Residential,33000,0,33000,72574,0,105574
140915300900000,NE 132,Residential,33000,0,33000,103103,0,136103
140915400100000,NE 132,Residential,33290,0,33290,75710,0,109000
140915400200000,NE 132,Residential,33000,0,33000,83699,0,116699
140915400300000,NE 132,Residential,33000,0,33000,92486,0,125486
140915400400000,NE 132,Residential,33000,0,33000,76598,0,109598
140915400500000,NE 132,Residential,32120,0,32120,72500,0,104620
140915400600000,NE 132,Residential,26191,0,26191,51364,0,77555
140915400700000,NE 132,Residential,25650,0,25650,63165,0,88815
140915400800000,NE 132,Residential,25650,0,25650,55044,0,80694
140915400900000,NE 132,Residential,25650,0,25650,99061,0,124711
140915401000000,NE 132,Residential,25650,0,25650,66197,0,91847
140915500100000,NE 132,Residential,27000,0,27000,90431,0,117431
140915500200000,NE 132,Residential,27000,0,27000,79623,0,106623
140915500300000,NE 132,Residential,27000,0,27000,54637,0,81637
140915500400000,NE 132,Residential,26235,0,26235,62758,0,88993
140915500500000,NE 132,Residential,16088,0,16088,61175,0,77263
140915500600000,DAY CARE CENTER,Commercial,0,71780,71780,0,73967,145747
140915500700000,NE 132,Residential,29063,0,29063,55395,0,84458
140915600100000,EQUIPMENT MFG;INDUST,Industrial,0,201244,201244,0,366648,567892
140915600102000,ANTENNAS/TOWERS(BLL),Commercial,0,0,0,0,185679,185679
140915600200000,SMALL RETAIL,Commercial,0,96120,96120,0,121012,217132
140915700100000,NE 132,Residential,25380,0,25380,60125,0,85505
140915700200000,NE 132,Residential,25648,0,25648,56335,0,81983
140915700300000,OFFICE,Commercial,0,114480,114480,0,293298,407778
140917600100000,NE 132,Residential,32899,0,32899,93204,0,126103
140917600200000,NE 132,Residential,32670,0,32670,92937,0,125607
140917600300000,NE 132,Residential,33000,0,33000,86512,0,119512
140917600400000,NE 132,Residential,33000,0,33000,112833,0,145833
140917600500000,NE 132,Residential,33000,0,33000,123940,0,156940
140917600600000,NE 132,Residential,33000,0,33000,84687,0,117687
140917600700000,NE 132,Residential,33000,0,33000,82470,0,115470
140917600800000,NE 132,Residential,33000,0,33000,77428,0,110428
140917600900000,NE 132,Residential,33000,0,33000,71139,0,104139
140917601000000,NE 132,Residential,33000,0,33000,96279,0,129279
140917601100000,NE 132,Residential,33000,0,33000,80209,0,113209
140917601200000,NE 132,Residential,31900,0,31900,94838,0,126738
140917601300000,NE 132,Residential,32285,0,32285,99096,0,131381
140917601400000,NE 132,Residential,33000,0,33000,82846,0,115846
140917601500000,NE 132,Residential,33000,0,33000,85551,0,118551
140917601600000,NE 132,Residential,33000,0,33000,90362,0,123362
140917601700000,NE 132,Residential,33000,0,33000,88460,0,121460
140917601800000,NE 132,Residential,33000,0,33000,81467,0,114467
140917601900000,NE 132,Residential,33000,0,33000,91101,0,124101
140917602000000,NE 132,Residential,32670,0,32670,85670,0,118340
140917602100000,NE 132,Residential,32670,0,32670,110584,0,143254
140917602200000,NE 132,Residential,35140,0,35140,91383,0,126523
140917700100000,CHURCH,Exempt,0,196560,196560,0,153453,350013
140917700200000,NE 132,Residential,36944,0,36944,103086,0,140030
140917700300000,NE 132,Residential,34496,0,34496,110448,0,144944
140917700400000,NE 132,Residential,35200,0,35200,86616,0,121816
140917700500000,NE 132,Residential,35200,0,35200,118155,0,153355
140917700600000,NE 132,Residential,59657,0,59657,99741,0,159398
140917700700000,NE 132,Residential,21375,0,21375,63278,0,84653
140917700800000,NE 132,Residential,23085,0,23085,58791,0,81876
140917700900000,NE 132,Residential,23085,0,23085,53733,0,76818
140917701000000,NE 132,Residential,23085,0,23085,51007,0,74092
140917701100000,NE 132,Residential,23085,0,23085,56009,0,79094
140917701200000,NE 132,Residential,23085,0,23085,65299,0,88384
140917701300000,NE 132,Residential,22804,0,22804,52002,0,74806
140917800100000,NE 132,Residential,37897,0,37897,76068,0,113965
140917800200000,NE 132,Residential,36432,0,36432,96091,0,132523
140917800300000,NE 132,Residential,35228,0,35228,98666,0,133894
140917800400000,NE 132,Residential,33772,0,33772,102263,0,136035
140917800500000,NE 132,Residential,33862,0,33862,89021,0,122883
140917800600000,NE 132,Residential,33396,0,33396,89106,0,122502
140917800700000,NE 132,Residential,32670,0,32670,108376,0,141046
140917800800000,NE 132,Residential,32670,0,32670,100583,0,133253
140917800900000,NE 132,Residential,32670,0,32670,80104,0,112774
140917801000000,NE 132,Residential,32670,0,32670,94100,0,126770
140917801100000,NE 132,Residential,32670,0,32670,76364,0,109034
140917801200000,NE 132,Residential,32670,0,32670,78541,0,111211
140917801300000,NE 132,Residential,32670,0,32670,93276,0,125946
140917801400000,NE 132,Residential,32670,0,32670,86107,0,118777
140917801500000,NE 132,Residential,33000,0,33000,87578,0,120578
140917801600000,NE 132,Residential,33000,0,33000,106777,0,139777
140917801700000,NE 132,Residential,33000,0,33000,89037,0,122037
140917801800000,NE 132,Residential,33000,0,33000,102060,0,135060
140917801900000,NE 132,Residential,33000,0,33000,88314,0,121314
140917802000000,NE 132,Residential,33000,0,33000,77708,0,110708
140917802100000,NE 132,Residential,33000,0,33000,70305,0,103305
140917802200000,NE 132,Residential,33000,0,33000,79391,0,112391
140917802300000,NE 132,Residential,33000,0,33000,74576,0,107576
140917802400000,NE 132,Residential,33660,0,33660,71706,0,105366
140917802500000,NE 132,Residential,34320,0,34320,96927,0,131247
140917802600000,NE 132,Residential,34650,0,34650,74493,0,109143
140917802700000,NE 132,Residential,34980,0,34980,95577,0,130557
140917802800000,NE 132,Residential,34376,0,34376,78091,0,112467
140917802900000,NE 132,Residential,32670,0,32670,70928,0,103598
140917803000000,NE 132,Residential,32340,0,32340,86532,0,118872
140917803100000,NE 132,Residential,32670,0,32670,89901,0,122571
140917900100000,NE 132,Residential,33532,0,33532,89319,0,122851
140917900200000,NE 132,Residential,33000,0,33000,83710,0,116710
140917900300000,NE 132,Residential,33000,0,33000,73613,0,106613
140917900400000,NE 132,Residential,33000,0,33000,92039,0,125039
140917900500000,NE 132,Residential,33000,0,33000,86661,0,119661
140917900600000,NE 132,Residential,33000,0,33000,81594,0,114594
140917900700000,NE 132,Residential,33000,0,33000,83424,0,116424
140917900800000,NE 132,Residential,33000,0,33000,87332,0,120332
140917900900000,NE 132,Residential,33000,0,33000,78484,0,111484
140917901000000,NE 132,Residential,33000,0,33000,82297,0,115297
140917901100000,NE 132,Residential,33000,0,33000,85511,0,118511
140917901200000,NE 132,Residential,33000,0,33000,80136,0,113136
140917901300000,NE 132,Residential,33000,0,33000,95458,0,128458
140917901400000,NE 132,Residential,33000,0,33000,88816,0,121816
140917901500000,NE 132,Residential,33000,0,33000,91500,0,124500
140917901600000,NE 132,Residential,25736,0,25736,63510,0,89246
140917901700000,NE 132,Residential,25650,0,25650,60903,0,86553
140917901800000,NE 132,Residential,25650,0,25650,58514,0,84164
140917901900000,NE 132,Residential,25650,0,25650,58911,0,84561
140917902000000,NE 132,Residential,21375,0,21375,97208,0,118583
140917902100000,NE 132,Residential,23513,0,23513,86187,0,109700
140917902200000,NE 132,Residential,34628,0,34628,68020,0,102648
140917902300000,NE 132,Residential,25650,0,25650,87119,0,112769
140917902400000,NE 132,Residential,25650,0,25650,81654,0,107304
140917902500000,NE 132,Residential,25650,0,25650,61590,0,87240
140917902600000,NE 132,Residential,25650,0,25650,62659,0,88309
140917902700000,NE 132,Residential,25650,0,25650,53088,0,78738
140917902800000,NE 132,Residential,25650,0,25650,58979,0,84629
140917902900000,NE 132,Residential,24239,0,24239,62967,0,87206
140918000100000,NE 132,Residential,26043,0,26043,56439,0,82482
140918000200000,NE 132,Residential,25380,0,25380,56920,0,82300
140918000300000,NE 132,Residential,25944,0,25944,77185,0,103129
140918000400000,NE 132,Residential,28130,0,28130,61660,0,89790
140918100100000,NE 132,Residential,25380,0,25380,58989,0,84369
140918100200000,NE 132,Residential,25380,0,25380,67731,0,93111
140918100300000,NE 132,Residential,25380,0,25380,62683,0,88063
140918100400000,NE 132,Residential,25380,0,25380,66663,0,92043
140918100500000,NE 132,Residential,25380,0,25380,68315,0,93695
140918100600000,NE 132,Residential,25380,0,25380,59777,0,85157
140918100700000,NE 132,Residential,25380,0,25380,56335,0,81715
140918100800000,NE 132,Residential,25380,0,25380,66527,0,91907
140918100900000,NE 132,Residential,25380,0,25380,51122,0,76502
140918101000000,NE 132,Residential,25380,0,25380,62696,0,88076
140918101100000,NE 132,Residential,25380,0,25380,77984,0,103364
140918101200000,NE 132,Residential,25380,0,25380,61570,0,86950
140918101300000,NE 132,Residential,25380,0,25380,56668,0,82048
140918101400000,NE 132,Residential,25380,0,25380,64009,0,89389
140918101500000,NE 132,Residential,25380,0,25380,53788,0,79168
140918101600000,NE 132,Residential,25380,0,25380,61499,0,86879
140918101700000,NE 132,Residential,25380,0,25380,48600,0,73980
140918101800000,NE 132,Residential,25621,0,25621,60343,0,85964
140918101900000,NE 132,Residential,25659,0,25659,56869,0,82528
140918102000000,NE 132,Residential,25659,0,25659,96311,0,121970
140918102100000,NE 132,Residential,25621,0,25621,60819,0,86440
140918102200000,NE 132,Residential,25380,0,25380,47763,0,73143
140918102300000,NE 132,Residential,25380,0,25380,64406,0,89786
140918102400000,NE 132,Residential,25380,0,25380,63394,0,88774
140918102500000,NE 132,Residential,25380,0,25380,60608,0,85988
140918102600000,NE 132,Residential,25380,0,25380,62978,0,88358
140918102700000,NE 132,Residential,25380,0,25380,61896,0,87276
140918102800000,NE 132,Residential,25380,0,25380,69958,0,95338
140918102900000,NE 132,Residential,25380,0,25380,68989,0,94369
140918103000000,NE 132,Residential,25380,0,25380,57480,0,82860
140918103100000,NE 132,Residential,25380,0,25380,61080,0,86460
140918103200000,NE 132,Residential,25380,0,25380,55478,0,80858
140918103300000,NE 132,Residential,25380,0,25380,54769,0,80149
140918103400000,NE 132,Residential,25380,0,25380,67055,0,92435
140918103500000,NE 132,Residential,25380,0,25380,51309,0,76689
140918103600000,NE 132,Residential,25380,0,25380,59759,0,85139
140918103700000,NE 132,Residential,25380,0,25380,65815,0,91195
140918103800000,NE 132,Residential,25380,0,25380,90814,0,116194
140918200100000,NE 132,Residential,26043,0,26043,60331,0,86374
140918200200000,NE 132,Residential,25380,0,25380,64330,0,89710
140918200300000,NE 132,Residential,25380,0,25380,61631,0,87011
140918200400000,NE 132,Residential,25380,0,25380,57193,0,82573
140918200500000,NE 132,Residential,25380,0,25380,61941,0,87321
140918200600000,NE 132,Residential,25380,0,25380,53935,0,79315
140918200700000,NE 132,Residential,25380,0,25380,60515,0,85895
140918200800000,NE 132,Residential,25380,0,25380,60866,0,86246
140918200900000,NE 132,Residential,25380,0,25380,60097,0,85477
140918201000000,NE 132,Residential,25380,0,25380,52264,0,77644
140918201100000,NE 132,Residential,25380,0,25380,66623,0,92003
140918201200000,NE 132,Residential,25380,0,25380,58932,0,84312
140918201300000,NE 132,Residential,25380,0,25380,52785,0,78165
140918201400000,NE 132,Residential,25380,0,25380,66564,0,91944
140918201500000,NE 132,Residential,25380,0,25380,82921,0,108301
140918201600000,NE 132,Residential,25380,0,25380,67071,0,92451
140918201700000,NE 132,Residential,25380,0,25380,69209,0,94589
140918201800000,NE 132,Residential,25380,0,25380,63478,0,88858
140918201900000,NE 132,Residential,25380,0,25380,54750,0,80130
140918202000000,NE 132,Residential,25380,0,25380,55727,0,81107
140918202100000,NE 132,Residential,25380,0,25380,60066,0,85446
140918202200000,NE 132,Residential,25380,0,25380,55936,0,81316
140920100100000,NE 133,Residential,25617,0,25617,111746,0,137363
140920100200000,NE 133,Residential,24419,0,24419,89143,0,113562
140920100300000,NE 133,Residential,24419,0,24419,88651,0,113070
140920100400000,NE 133,Residential,25704,0,25704,105345,0,131049
140920100500000,NE 133,Residential,27310,0,27310,107703,0,135013
140920100600000,NE 133,Residential,27132,0,27132,102280,0,129412
140920100700000,NE 133,Residential,26561,0,26561,118236,0,144797
140920100800000,NE 133,Residential,27310,0,27310,107295,0,134605
140920100900000,NE 133,Residential,25436,0,25436,98301,0,123737
140920101000000,NE 133,Residential,24414,0,24414,97720,0,122134
140920101100000,NE 133,Residential,31676,0,31676,109488,0,141164
140920101200000,NE 133,Residential,32738,0,32738,116820,0,149558
140920101300000,NE 133,Residential,32738,0,32738,110352,0,143090
140920101400000,NE 133,Residential,32738,0,32738,102405,0,135143
140920101500000,NE 133,Residential,33174,0,33174,115468,0,148642
140920101600000,NE 133,Residential,33174,0,33174,113905,0,147079
140920101700000,NE 133,Residential,32738,0,32738,124218,0,156956
140920101800000,NE 133,Residential,30555,0,30555,119297,0,149852
140920101900000,NE 133,Residential,30555,0,30555,120513,0,151068
140920102000000,NE 133,Residential,30555,0,30555,107701,0,138256
140920102100000,NE 133,Residential,30555,0,30555,109407,0,139962
140920102200000,NE 133,Residential,31541,0,31541,110005,0,141546
140920102300000,NE 133,Residential,31907,0,31907,114896,0,146803
140920102400000,NE 133,Residential,33860,0,33860,122756,0,156616
140920102500000,NE 133,Residential,29750,0,29750,96538,0,126288
140920102600000,NE 133,Residential,31185,0,31185,110018,0,141203
140920102700000,NE 133,Residential,31185,0,31185,107633,0,138818
140920102800000,NE 133,Residential,31185,0,31185,117002,0,148187
140920102900000,NE 133,Residential,32447,0,32447,104974,0,137421
140920103000000,NE 133,Residential,31815,0,31815,95474,0,127289
140920103100000,NE 133,Residential,30128,0,30128,106279,0,136407
140920103200000,NE 133,Residential,30713,0,30713,94605,0,125318
140920103300000,NE 133,Residential,31590,0,31590,97869,0,129459
140920103400000,NE 133,Residential,31883,0,31883,94592,0,126475
140920103500000,NE 133,Residential,34155,0,34155,104297,0,138452
140920103600000,NE 133,Residential,28958,0,28958,104437,0,133395
140920103700000,NE 133,Residential,31356,0,31356,124863,0,156219
140920103800000,NE 133,Residential,30732,0,30732,93007,0,123739
140920103900000,NE 133,Residential,30136,0,30136,106166,0,136302
140920200100000,NE 133,Residential,35647,0,35647,110664,0,146311
140920200200000,NE 133,Residential,31540,0,31540,104110,0,135650
140920200300000,NE 133,Residential,31725,0,31725,96474,0,128199
140920200400000,NE 133,Residential,33068,0,33068,151052,0,184120
140920200500000,NE 133,Residential,31725,0,31725,126859,0,158584
140920200600000,NE 133,Residential,35013,0,35013,117909,0,152922
140920200700000,NE 133,Residential,32168,0,32168,98155,0,130323
140920200800000,NE 133,Residential,33180,0,33180,134301,0,167481
140920200900000,NE 133,Residential,34254,0,34254,123181,0,157435
140920201000000,NE 133,Residential,32592,0,32592,97591,0,130183
140920201100000,NE 133,Residential,29928,0,29928,104872,0,134800
140920201200000,NE 133,Residential,31380,0,31380,99510,0,130890
140920201300000,NE 133,Residential,30555,0,30555,118890,0,149445
140920201400000,NE 133,Residential,30555,0,30555,101602,0,132157
140920201500000,NE 133,Residential,30555,0,30555,102955,0,133510
140920201600000,NE 133,Residential,31635,0,31635,103434,0,135069
140920201700000,NE 133,Residential,32018,0,32018,129882,0,161900
140920201800000,NE 133,Residential,31667,0,31667,117020,0,148687
140920201900000,NE 133,Residential,32818,0,32818,98382,0,131200
140920202000000,NE 133,Residential,30294,0,30294,116299,0,146593
140920202100000,NE 133,Residential,30294,0,30294,106969,0,137263
140920202200000,NE 133,Residential,30294,0,30294,115975,0,146269
140920202300000,NE 133,Residential,30870,0,30870,113103,0,143973
140920202400000,NE 133,Residential,30870,0,30870,109734,0,140604
140920202500000,NE 133,Residential,31239,0,31239,116906,0,148145
140920202600000,NE 133,Residential,29610,0,29610,109423,0,139033
140920202700000,NE 133,Residential,27965,0,27965,94681,0,122646
140920300100000,NE 133,Residential,30878,0,30878,132485,0,163363
140920300200000,NE 133,Residential,32128,0,32128,93045,0,125173
140920300300000,NE 133,Residential,30555,0,30555,97248,0,127803
140920300400000,NE 133,Residential,30555,0,30555,110903,0,141458
140920300500000,NE 133,Residential,32400,0,32400,91275,0,123675
140920300600000,NE 133,Residential,33886,0,33886,99207,0,133093
140920300700000,NE 133,Residential,32401,0,32401,104017,0,136418
140920300800000,NE 133,Residential,33244,0,33244,120245,0,153489
140920300900000,NE 133,Residential,32490,0,32490,124634,0,157124
140920301000000,NE 133,Residential,32994,0,32994,119009,0,152003
140920301100000,NE 133,Residential,33037,0,33037,118298,0,151335
140920301200000,NE 133,Residential,32913,0,32913,83841,0,116754
140920301300000,NE 133,Residential,32582,0,32582,115012,0,147594
140920301400000,NE 133,Residential,32015,0,32015,106935,0,138950
140920301500000,NE 133,Residential,31210,0,31210,127662,0,158872
140920301600000,NE 133,Residential,33546,0,33546,125090,0,158636
140920301700000,NE 133,Residential,36067,0,36067,106633,0,142700
140920301800000,NE 133,Residential,33392,0,33392,105174,0,138566
140920400100000,NE 133,Residential,31160,0,31160,114671,0,145831
140920400200000,NE 133,Residential,29246,0,29246,112403,0,141649
140920400300000,NE 133,Residential,29246,0,29246,93737,0,122983
140920400400000,NE 133,Residential,29246,0,29246,97064,0,126310
140920400500000,NE 133,Residential,30770,0,30770,89905,0,120675
140920400600000,NE 133,Exempt,0,31952,31952,0,114100,146052
140920400700000,NE 133,Residential,32251,0,32251,115752,0,148003
140920400800000,NE 133,Residential,31059,0,31059,96800,0,127859
140920400900000,NE 133,Residential,30750,0,30750,94302,0,125052
140920401000000,NE 133,Residential,31865,0,31865,104667,0,136532
140920401100000,NE 133,Residential,31536,0,31536,105844,0,137380
140920401200000,NE 133,Residential,29682,0,29682,106081,0,135763
140920401300000,NE 133,Residential,29391,0,29391,74859,0,104250
140920401400000,NE 133,Residential,30826,0,30826,97631,0,128457
140920401500000,NE 133,Residential,31579,0,31579,108136,0,139715
140920401600000,NE 133,Residential,29682,0,29682,87742,0,117424
140920401700000,NE 133,Residential,33157,0,33157,112896,0,146053
140920401800000,NE 133,Residential,31812,0,31812,129805,0,161617
140920401900000,NE 133,Residential,30798,0,30798,88473,0,119271
140920402000000,NE 133,Residential,27323,0,27323,85545,0,112868
140920402100000,NE 133,Residential,29529,0,29529,107313,0,136842
140920402200000,NE 133,Residential,28958,0,28958,104574,0,133532
140920402300000,NE 133,Residential,28665,0,28665,113752,0,142417
140920402400000,NE 133,Residential,29397,0,29397,94161,0,123558
140920402500000,NE 133,Residential,30870,0,30870,90562,0,121432
140920402600000,NE 133,Residential,30240,0,30240,100729,0,130969
140920402700000,NE 133,Residential,31410,0,31410,95323,0,126733
140920402800000,NE 133,Residential,30863,0,30863,79612,0,110475
140920500100000,NE 133,Residential,30816,0,30816,99861,0,130677
140920500200000,NE 133,Residential,31085,0,31085,125740,0,156825
140920500300000,NE 133,Residential,29682,0,29682,114037,0,143719
140920500400000,NE 133,Residential,28373,0,28373,108622,0,136995
140920500500000,NE 133,Residential,29512,0,29512,86531,0,116043
140920500600000,NE 133,Residential,29682,0,29682,100960,0,130642
140920500700000,NE 133,Residential,28373,0,28373,92165,0,120538
140920500800000,NE 133,Residential,28373,0,28373,110526,0,138899
140920500900000,NE 133,Residential,30034,0,30034,140823,0,170857
140920501000000,NE 133,Residential,32701,0,32701,109585,0,142286
140920501100000,NE 133,Residential,32724,0,32724,88373,0,121097
140920501200000,NE 133,Residential,31541,0,31541,102049,0,133590
140920501300000,NE 133,Residential,31906,0,31906,116245,0,148151
140920501400000,NE 133,Residential,32112,0,32112,107679,0,139791
140920600100000,NE 133,Residential,32340,0,32340,110342,0,142682
140920600200000,NE 133,Residential,33285,0,33285,97119,0,130404
140920600300000,NE 133,Residential,30900,0,30900,93392,0,124292
140922600100000,NE 133,Residential,23961,0,23961,85559,0,109520
140922600200000,NE 133,Residential,24990,0,24990,102661,0,127651
140922600300000,NE 133,Residential,24990,0,24990,95687,0,120677
140922600400000,NE 133,Residential,24990,0,24990,101557,0,126547
140922600500000,NE 133,Residential,24990,0,24990,88691,0,113681
140922600600000,NE 133,Residential,34769,0,34769,112260,0,147029
140922600700000,NE 133,Residential,33915,0,33915,86553,0,120468
140922600800000,NE 133,Residential,35329,0,35329,122810,0,158139
140922600900000,NE 133,Residential,30555,0,30555,96630,0,127185
140922601000000,NE 133,Residential,29900,0,29900,96499,0,126399
140922601100000,NE 133,Residential,31210,0,31210,105065,0,136275
140922601200000,NE 133,Residential,30555,0,30555,115818,0,146373
140922601300000,NE 133,Residential,31915,0,31915,97847,0,129762
140922700100000,NE 133,Residential,34425,0,34425,97424,0,131849
140922700200000,NE 133,Residential,27039,0,27039,127761,0,154800
140922700300000,NE 133,Residential,25480,0,25480,121033,0,146513
140922700400000,NE 133,Residential,24998,0,24998,126608,0,151606
140922700500000,NE 133,Residential,25712,0,25712,147412,0,173124
140922700600000,NE 133,Residential,34761,0,34761,111103,0,145864
140922700700000,NE 133,Residential,36982,0,36982,122247,0,159229
140922700800000,NE 133,Residential,35113,0,35113,141328,0,176441
140922700900000,NE 133,Residential,36490,0,36490,141011,0,177501
140922701000000,NE 133,Residential,33416,0,33416,138703,0,172119
140922701100000,NE 133,Residential,32089,0,32089,113588,0,145677
140922701200000,NE 133,Residential,32471,0,32471,100390,0,132861
140922701300000,NE 133,Residential,28925,0,28925,105895,0,134820
140922701400000,NE 133,Residential,35806,0,35806,119595,0,155401
140922701500000,NE 133,Residential,31765,0,31765,119027,0,150792
140922800100000,NE 133,Residential,32728,0,32728,98642,0,131370
140922800200000,NE 133,Residential,26472,0,26472,122787,0,149259
140922800300000,NE 133,Residential,35133,0,35133,146121,0,181254
140922800400000,NE 133,Residential,35589,0,35589,131423,0,167012
140922800500000,NE 133,Residential,34509,0,34509,124158,0,158667
140922800600000,NE 133,Residential,34425,0,34425,109365,0,143790
140922800700000,NE 133,Residential,35100,0,35100,125233,0,160333
140922800800000,NE 133,Residential,33412,0,33412,116113,0,149525
140922800900000,NE 133,Residential,35317,0,35317,142721,0,178038
140922801000000,NE 133,Residential,37066,0,37066,124137,0,161203
140922801100000,NE 133,Residential,29482,0,29482,110505,0,139987
140922801200000,NE 133,Residential,28958,0,28958,81952,0,110910
140922801300000,NE 133,Residential,34116,0,34116,122825,0,156941
140922801400000,NE 133,Residential,30936,0,30936,102302,0,133238
140922801500000,NE 133,Residential,29917,0,29917,117087,0,147004
140922801600000,NE 133,Residential,32957,0,32957,121605,0,154562
140922801700000,NE 133,Residential,35089,0,35089,109059,0,144148
140922801800000,NE 133,Residential,35509,0,35509,116547,0,152056
140922801900000,NE 133,Residential,35036,0,35036,122631,0,157667
140922802000000,NE 133,Residential,34580,0,34580,142022,0,176602
140922802100000,NE 133,Residential,33392,0,33392,109559,0,142951
140922802200000,NE 133,Residential,32760,0,32760,113500,0,146260
140922802300000,NE 133,Residential,34425,0,34425,124721,0,159146
140922802400000,NE 133,Residential,37323,0,37323,137113,0,174436
140922802500000,NE 133,Residential,35662,0,35662,137387,0,173049
140922802600000,NE 133,Residential,33680,0,33680,108557,0,142237
140922802700000,NE 133,Residential,31815,0,31815,150180,0,181995
140922802800000,NE 133,Residential,36949,0,36949,126721,0,163670
140922802900000,NE 133,Residential,34838,0,34838,106581,0,141419
140922803000000,NE 133,Residential,30555,0,30555,121056,0,151611
140922803100000,NE 133,Residential,33174,0,33174,123521,0,156695
140922803200000,NE 133,Residential,33174,0,33174,141657,0,174831
140922900100000,NE 133,Residential,28315,0,28315,100433,0,128748
140922900200000,NE 133,Residential,28958,0,28958,82226,0,111184
140922900300000,NE 133,Residential,28958,0,28958,85892,0,114850
140922900400000,NE 133,Residential,28958,0,28958,96068,0,125026
140922900500000,NE 133,Residential,28958,0,28958,98572,0,127530
140922900600000,NE 133,Residential,30054,0,30054,101900,0,131954
140922900700000,NE 133,Residential,30054,0,30054,86632,0,116686
140922900800000,NE 133,Residential,30054,0,30054,101407,0,131461
140922900900000,NE 133,Residential,30685,0,30685,123784,0,154469
140923000100000,NE 133,Residential,29932,0,29932,81261,0,111193
140923000200000,NE 133,Residential,30555,0,30555,94639,0,125194
140923000300000,NE 133,Residential,30870,0,30870,96345,0,127215
140923000400000,NE 133,Residential,31656,0,31656,122351,0,154007
140923000500000,NE 133,Residential,32445,0,32445,98326,0,130771
140923000600000,NE 133,Residential,32445,0,32445,135648,0,168093
140923000700000,NE 133,Residential,31668,0,31668,88551,0,120219
140923000800000,NE 133,Residential,29183,0,29183,110674,0,139857
140923000900000,NE 133,Residential,31020,0,31020,109018,0,140038
140923001000000,NE 133,Residential,30906,0,30906,112465,0,143371
140923001100000,NE 133,Residential,33025,0,33025,133076,0,166101
140923001200000,NE 133,Residential,32729,0,32729,106131,0,138860
140923001300000,NE 133,Residential,29988,0,29988,112348,0,142336
140923001400000,NE 133,Residential,31360,0,31360,123530,0,154890
140923001500000,NE 133,Residential,32130,0,32130,87888,0,120018
140923001600000,NE 133,Residential,32130,0,32130,104508,0,136638
140923100100000,NE 133,Residential,32878,0,32878,95925,0,128803
140923100200000,NE 133,Residential,28958,0,28958,100025,0,128983
140923100300000,NE 133,Residential,28958,0,28958,99865,0,128823
140923100400000,NE 133,Residential,32188,0,32188,107667,0,139855
140923200100000,NE 133,Residential,34366,0,34366,94489,0,128855
140923200200000,NE 133,Residential,31500,0,31500,110770,0,142270
140923200300000,NE 133,Residential,29155,0,29155,109861,0,139016
140923200400000,NE 133,Residential,34633,0,34633,94204,0,128837
140923200500000,NE 133,Residential,31800,0,31800,104019,0,135819
140923200600000,NE 133,Residential,31298,0,31298,82197,0,113495
140923200700000,NE 133,Residential,31590,0,31590,95560,0,127150
140923200800000,NE 133,Residential,33345,0,33345,87640,0,120985
140923200900000,NE 133,Residential,30420,0,30420,128117,0,158537
140923201000000,NE 133,Residential,30420,0,30420,92518,0,122938
140923300100000,NE 133,Residential,31528,0,31528,100469,0,131997
140923300200000,NE 133,Residential,35923,0,35923,112259,0,148182
140923300300000,NE 133,Residential,34884,0,34884,133210,0,168094
140923300400000,NE 133,Residential,34504,0,34504,110921,0,145425
140923300500000,NE 133,Residential,33907,0,33907,112311,0,146218
140923300600000,NE 133,Residential,35431,0,35431,118769,0,154200
140923300700000,NE 133,Residential,34559,0,34559,107161,0,141720
140923300800000,NE 133,Residential,33442,0,33442,113686,0,147128
140923300900000,NE 133,Residential,33393,0,33393,126331,0,159724
140923301000000,NE 133,Residential,34155,0,34155,117597,0,151752
140923301100000,NE 133,Residential,32148,0,32148,117727,0,149875
140923301200000,NE 133,Residential,30118,0,30118,98854,0,128972
140923301300000,NE 133,Residential,34483,0,34483,108414,0,142897
140923301400000,NE 133,Residential,30555,0,30555,109289,0,139844
140923301500000,NE 133,Residential,30555,0,30555,111068,0,141623
140923301600000,NE 133,Residential,30555,0,30555,118731,0,149286
140923301700000,NE 133,Residential,32225,0,32225,124127,0,156352
140923301800000,NE 133,Residential,31185,0,31185,98905,0,130090
140923301900000,NE 133,Residential,28958,0,28958,102241,0,131199
140923302000000,NE 133,Residential,28958,0,28958,110989,0,139947
140923302100000,NE 133,Residential,28958,0,28958,114981,0,143939
140923400100000,NE 133,Residential,30600,0,30600,109293,0,139893
140923400200000,NE 133,Residential,32400,0,32400,122895,0,155295
140923400300000,NE 133,Residential,31500,0,31500,101877,0,133377
140923400400000,NE 133,Residential,27000,0,27000,97283,0,124283
140923400500000,NE 133,Residential,32300,0,32300,126525,0,158825
140925100100000,NE 133,Residential,34081,0,34081,105511,0,139592
140925200100000,NE 133,Residential,33345,0,33345,94768,0,128113
140925200200000,NE 133,Residential,34320,0,34320,114037,0,148357
140925200300000,NE 133,Residential,32917,0,32917,104702,0,137619
140925200400000,NE 133,Residential,33791,0,33791,103270,0,137061
140925200500000,NE 133,Residential,31258,0,31258,90529,0,121787
140925200600000,NE 133,Residential,34234,0,34234,116098,0,150332
140925200700000,NE 133,Residential,35894,0,35894,115680,0,151574
140925200800000,NE 133,Residential,37908,0,37908,112440,0,150348
140925200900000,NE 133,Residential,39621,0,39621,121974,0,161595
140925201000000,NE 133,Residential,36598,0,36598,114919,0,151517
140925201100000,NE 133,Residential,34571,0,34571,98272,0,132843
140925201200000,NE 133,Residential,34150,0,34150,125220,0,159370
140925201300000,NE 133,Residential,34876,0,34876,117007,0,151883
140925201400000,NE 133,Residential,34288,0,34288,106413,0,140701
140925201500000,NE 133,Residential,37125,0,37125,121054,0,158179
140925201600000,NE 133,Residential,41040,0,41040,118099,0,159139
140925201700000,NE 133,Residential,41876,0,41876,118548,0,160424
140925201800000,NE 133,Residential,44839,0,44839,159547,0,204386
140925201900000,NE 133,Residential,44348,0,44348,127704,0,172052
140925202000000,NE 133,Residential,45441,0,45441,124052,0,169493
140925202100000,NE 133,Residential,45562,0,45562,199849,0,245411
140925202200000,NE 133,Residential,35193,0,35193,181652,0,216845
140925202300000,NE 133,Residential,38913,0,38913,138313,0,177226
140925202400000,NE 133,Residential,36433,0,36433,124362,0,160795
140925202500000,NE 133,Residential,40014,0,40014,144935,0,184949
140925202600000,NE 133,Residential,39672,0,39672,159869,0,199541
140925202700000,NE 133,Residential,40365,0,40365,152072,0,192437
140925202800000,NE 133,Residential,35946,0,35946,134809,0,170755
140925202900000,NE 133,Residential,32062,0,32062,133820,0,165882
140925203000000,NE 133,Residential,31881,0,31881,128681,0,160562
140925203100000,NE 133,Residential,30353,0,30353,125876,0,156229
140925203200000,NE 133,Residential,33846,0,33846,115458,0,149304
140925203300000,NE 133,Residential,32119,0,32119,131870,0,163989
140925203400000,NE 133,Residential,33813,0,33813,115095,0,148908
140925300100000,NE 133,Residential,34920,0,34920,107519,0,142439
140925300200000,NE 133,Residential,32445,0,32445,103618,0,136063
140925300300000,NE 133,Residential,32174,0,32174,113685,0,145859
140925300400000,NE 133,Residential,36674,0,36674,151721,0,188395
140925300500000,NE 133,Residential,33700,0,33700,121386,0,155086
140925300600000,NE 133,Residential,34020,0,34020,115495,0,149515
140925300700000,NE 133,Residential,33453,0,33453,122336,0,155789
140925300800000,NE 133,Residential,33815,0,33815,115612,0,149427
140925300900000,NE 133,Residential,33815,0,33815,105448,0,139263
140925301000000,NE 133,Residential,41059,0,41059,277278,0,318337
140925301100000,NE 133,Residential,36701,0,36701,99163,0,135864
140925301200000,NE 133,Residential,34700,0,34700,108596,0,143296
140925301300000,NE 133,Residential,36555,0,36555,111827,0,148382
140925301400000,NE 133,Residential,35016,0,35016,122729,0,157745
140925301500000,NE 133,Residential,33882,0,33882,119744,0,153626
140925301600000,NE 133,Residential,34330,0,34330,113169,0,147499
140925400100000,NE 133,Residential,34425,0,34425,115747,0,150172
140925400200000,NE 133,Residential,44550,0,44550,180351,0,224901
140925400300000,NE 133,Residential,34425,0,34425,141652,0,176077
140925400400000,NE 133,Residential,34200,0,34200,100923,0,135123
140925400500000,NE 133,Residential,33210,0,33210,121368,0,154578
140925400600000,NE 133,Residential,35802,0,35802,135359,0,171161
140925400700000,NE 133,Residential,37950,0,37950,128232,0,166182
140925400800000,NE 133,Residential,37915,0,37915,124179,0,162094
140925400900000,NE 133,Residential,35829,0,35829,125161,0,160990
140925401000000,NE 133,Residential,38070,0,38070,126182,0,164252
140925401100000,NE 133,Residential,37167,0,37167,129938,0,167105
140925401200000,NE 133,Residential,41313,0,41313,137520,0,178833
140925401300000,NE 133,Residential,66150,0,66150,233508,0,299658
140925401400000,NE 133,Residential,38137,0,38137,111494,0,149631
140925401500000,NE 133,Residential,38316,0,38316,110454,0,148770
140925401600000,NE 133,Residential,31188,0,31188,127404,0,158592
140925401700000,NE 133,Residential,38652,0,38652,131008,0,169660
140925401800000,NE 133,Residential,39780,0,39780,129565,0,169345
140925401900000,NE 133,Residential,35038,0,35038,113473,0,148511
140925402000000,NE 133,Residential,40095,0,40095,123240,0,163335
140925402100000,NE 133,Residential,42294,0,42294,140509,0,182803
140925402200000,NE 133,Residential,43092,0,43092,100538,0,143630
140925402300000,NE 133,Residential,41850,0,41850,144517,0,186367
140925402400000,NE 133,Residential,42300,0,42300,133308,0,175608
140925402500000,NE 133,Residential,43680,0,43680,161696,0,205376
140925500100000,NE 133,Residential,33075,0,33075,126354,0,159429
140925500200000,NE 133,Residential,32351,0,32351,125704,0,158055
140925500300000,NE 133,Residential,35226,0,35226,125249,0,160475
140925500400000,NE 133,Residential,32516,0,32516,159302,0,191818
140925500500000,NE 133,Residential,34884,0,34884,121801,0,156685
140925500600000,NE 133,Residential,34425,0,34425,138410,0,172835
140925500700000,NE 133,Residential,34884,0,34884,148462,0,183346
140925500800000,NE 133,Residential,34884,0,34884,107718,0,142602
140925500900000,NE 133,Residential,34884,0,34884,141475,0,176359
140925501000000,NE 133,Residential,34783,0,34783,131512,0,166295
140925600100000,NE 133,Residential,40832,0,40832,121144,0,161976
140925600200000,NE 133,Residential,37936,0,37936,157711,0,195647
140925600300000,NE 133,Residential,37898,0,37898,110262,0,148160
140925600400000,NE 133,Residential,37705,0,37705,118277,0,155982
140925600500000,NE 133,Residential,32130,0,32130,107558,0,139688
140925600600000,NE 133,Residential,39792,0,39792,130418,0,170210
140925600700000,NE 133,Residential,39895,0,39895,174671,0,214566
140927600100000,NE 133,Residential,31273,0,31273,96684,0,127957
140927600200000,NE 133,Residential,29680,0,29680,90383,0,120063
140927600300000,NE 133,Residential,30573,0,30573,103127,0,133700
140927600400000,NE 133,Residential,31005,0,31005,102785,0,133790
140927600500000,NE 133,Residential,31005,0,31005,96571,0,127576
140927600600000,NE 133,Residential,31005,0,31005,98877,0,129882
140927600700000,NE 133,Residential,31005,0,31005,113831,0,144836
140927600800000,NE 133,Residential,31005,0,31005,95456,0,126461
140927600900000,NE 133,Residential,31005,0,31005,102812,0,133817
140927601000000,NE 133,Residential,382,0,382,0,0,382
140927700100000,NE 133,Residential,32999,0,32999,100550,0,133549
140927700200000,NE 133,Residential,31269,0,31269,103192,0,134461
140927700300000,NE 133,Residential,32400,0,32400,111424,0,143824
140927700400000,NE 133,Residential,30991,0,30991,101003,0,131994
140927700500000,NE 133,Residential,30328,0,30328,109542,0,139870
140927700600000,NE 133,Residential,30240,0,30240,99916,0,130156
140927700700000,NE 133,Residential,30240,0,30240,95492,0,125732
140927700800000,NE 133,Residential,30240,0,30240,98826,0,129066
140927700900000,NE 133,Residential,28958,0,28958,110834,0,139792
140927701000000,NE 133,Residential,28958,0,28958,101158,0,130116
140927701100000,NE 133,Residential,28958,0,28958,124967,0,153925
140927701200000,NE 133,Residential,28958,0,28958,107278,0,136236
140927701300000,NE 133,Residential,28958,0,28958,86873,0,115831
140927701400000,NE 133,Residential,28614,0,28614,109684,0,138298
140927800100000,NE 133,Residential,29301,0,29301,121310,0,150611
140927800200000,NE 133,Residential,27063,0,27063,92448,0,119511
140927900100000,NE 133,Residential,34611,0,34611,117775,0,152386
140927900200000,NE 133,Residential,29232,0,29232,141513,0,170745
140927900300000,NE 133,Residential,31597,0,31597,96816,0,128413
140927900400000,NE 133,Residential,32054,0,32054,93869,0,125923
140927900500000,NE 133,Residential,32182,0,32182,94849,0,127031
140927900600000,NE 133,Residential,28958,0,28958,90701,0,119659
140927900700000,NE 133,Residential,27349,0,27349,84384,0,111733
140927900800000,NE 133,Residential,28958,0,28958,84462,0,113420
140927900900000,NE 133,Residential,28958,0,28958,92103,0,121061
140927901000000,NE 133,Residential,28958,0,28958,98312,0,127270
140927901100000,NE 133,Residential,28958,0,28958,124737,0,153695
140927901200000,NE 133,Residential,27349,0,27349,111749,0,139098
140927901300000,NE 133,Residential,28958,0,28958,102213,0,131171
140927901400000,NE 133,Residential,29301,0,29301,99854,0,129155
140927901500000,NE 133,Residential,29973,0,29973,88906,0,118879
140927901600000,NE 133,Residential,28858,0,28858,95127,0,123985
140927901700000,NE 133,Residential,30555,0,30555,102513,0,133068
140927901800000,NE 133,Residential,30555,0,30555,99782,0,130337
140927901900000,NE 133,Residential,30555,0,30555,103073,0,133628
140927902000000,NE 133,Residential,30555,0,30555,93612,0,124167
140927902100000,NE 133,Residential,30555,0,30555,100034,0,130589
140927902200000,NE 133,Residential,30682,0,30682,106394,0,137076
140927902300000,NE 133,Residential,33097,0,33097,108448,0,141545
140927902400000,NE 133,Residential,32265,0,32265,123970,0,156235
140927902500000,NE 133,Residential,31876,0,31876,112923,0,144799
140927902600000,NE 133,Residential,31185,0,31185,99232,0,130417
140927902700000,NE 133,Residential,34593,0,34593,119577,0,154170
140928000100000,NE 133,Residential,28614,0,28614,95001,0,123615
140928000200000,NE 133,Residential,29341,0,29341,134955,0,164296
140928000300000,NE 133,Residential,31864,0,31864,108162,0,140026
140928000400000,NE 133,Residential,33232,0,33232,105888,0,139120
140928000500000,NE 133,Residential,34702,0,34702,124766,0,159468
140928000600000,NE 133,Residential,30555,0,30555,111245,0,141800
140928000700000,NE 133,Residential,32738,0,32738,106964,0,139702
140928000800000,NE 133,Residential,30919,0,30919,107480,0,138399
140928000900000,NE 133,Residential,32738,0,32738,110773,0,143511
140928001000000,NE 133,Residential,32738,0,32738,116877,0,149615
140928001100000,NE 133,Residential,34556,0,34556,130336,0,164892
140928100100000,NE 133,Residential,32815,0,32815,98717,0,131532
140928100200000,NE 133,Residential,31185,0,31185,89439,0,120624
140928100300000,NE 133,Residential,30870,0,30870,108139,0,139009
140928100400000,NE 133,Residential,32544,0,32544,101403,0,133947
140928100500000,NE 133,Residential,31464,0,31464,104917,0,136381
140928100600000,NE 133,Residential,30132,0,30132,105555,0,135687
140928100700000,NE 133,Residential,32422,0,32422,99589,0,132011
140928100800000,NE 133,Residential,31355,0,31355,105466,0,136821
140928100900000,NE 133,Residential,31742,0,31742,87267,0,119009
140928101000000,NE 133,Residential,31742,0,31742,104344,0,136086
140928101100000,NE 133,Residential,32980,0,32980,117299,0,150279
140928101200000,NE 133,Residential,30870,0,30870,104868,0,135738
140928101300000,NE 133,Residential,31421,0,31421,95640,0,127061
140928101400000,NE 133,Residential,33075,0,33075,107095,0,140170
140928101500000,NE 133,Residential,34992,0,34992,113485,0,148477
140928101600000,NE 133,Residential,34668,0,34668,120968,0,155636
140928101700000,NE 133,Residential,35274,0,35274,130326,0,165600
140928101800000,NE 133,Residential,32730,0,32730,106842,0,139572
140928101900000,NE 133,Residential,31703,0,31703,104291,0,135994
140928102000000,NE 133,Residential,31519,0,31519,112563,0,144082
140928102100000,NE 133,Residential,31500,0,31500,106917,0,138417
140928102200000,NE 133,Residential,30433,0,30433,117745,0,148178
140928102300000,NE 133,Residential,33248,0,33248,110356,0,143604
140928102400000,NE 133,Residential,33482,0,33482,111907,0,145389
140928102500000,NE 133,Residential,32384,0,32384,86925,0,119309
140928200100000,NE 133,Residential,33041,0,33041,107952,0,140993
140928200200000,NE 133,Residential,31005,0,31005,80419,0,111424
140928200300000,NE 133,Residential,32020,0,32020,54340,0,86360
140928200400000,NE 133,Residential,32020,0,32020,91869,0,123889
140928200500000,NE 133,Residential,34303,0,34303,96422,0,130725
140928200600000,NE 133,Residential,33432,0,33432,106495,0,139927
140928200900000,NE 133,Residential,45696,0,45696,108663,0,154359
140928300100000,NE 133,Residential,32400,0,32400,90006,0,122406
140928300200000,NE 133,Residential,32135,0,32135,118578,0,150713
140928300300000,NE 133,Residential,31864,0,31864,109496,0,141360
140928300400000,NE 133,Residential,31500,0,31500,113652,0,145152
140928300500000,NE 133,Residential,34884,0,34884,113926,0,148810
140928300600000,NE 133,Residential,33721,0,33721,115491,0,149212
140928300700000,NE 133,Residential,31686,0,31686,109230,0,140916
140928300800000,NE 133,Residential,33915,0,33915,109267,0,143182
140928300900000,NE 133,Residential,33385,0,33385,107180,0,140565
140928301000000,NE 133,Residential,34200,0,34200,145666,0,179866
140928301100000,NE 133,Residential,35611,0,35611,118515,0,154126
140928301200000,NE 133,Residential,37278,0,37278,106362,0,143640
140928301300000,NE 133,Residential,35568,0,35568,123671,0,159239
140928301400000,NE 133,Residential,35234,0,35234,114188,0,149422
140928301500000,NE 133,Residential,34200,0,34200,132053,0,166253
140928301600000,NE 133,Residential,33025,0,33025,116873,0,149898
140928301700000,NE 133,Residential,33666,0,33666,99702,0,133368
140928301800000,NE 133,Residential,33666,0,33666,105578,0,139244
140928301900000,NE 133,Residential,32704,0,32704,118615,0,151319
140928302000000,NE 133,Residential,33772,0,33772,114434,0,148206
140928302100000,NE 133,Residential,32323,0,32323,104997,0,137320
140928302200000,NE 133,Residential,33382,0,33382,116163,0,149545
140928302300000,NE 133,Residential,33174,0,33174,91030,0,124204
140928400100000,NE 133,Residential,35694,0,35694,116866,0,152560
140928400200000,NE 133,Residential,36450,0,36450,106521,0,142971
140928400300000,NE 133,Residential,34627,0,34627,101622,0,136249
140928400400000,NE 133,Residential,34627,0,34627,141479,0,176106
140928400500000,NE 133,Residential,34627,0,34627,108468,0,143095
140928400600000,NE 133,Residential,34627,0,34627,129161,0,163788
140928400700000,NE 133,Residential,33874,0,33874,110731,0,144605
140928400800000,NE 133,Residential,33048,0,33048,122765,0,155813
140928400900000,NE 133,Residential,34627,0,34627,123382,0,158009
140928401000000,NE 133,Residential,40540,0,40540,122913,0,163453
140928401100000,NE 133,Residential,39996,0,39996,130859,0,170855
140928401200000,NE 133,Residential,41400,0,41400,117914,0,159314
140928401300000,NE 133,Residential,37834,0,37834,124152,0,161986
140928401400000,NE 133,Residential,39502,0,39502,116346,0,155848
140928401500000,NE 133,Residential,40969,0,40969,129129,0,170098
140930100100000,APARTMENT,Commercial,0,488160,488160,0,3883224,4371384
140930100200000,NE 147,Residential,24939,0,24939,0,0,24939
140930100300000,NE 147,Residential,38400,0,38400,107072,0,145472
140930100400000,NE 147,Residential,40200,0,40200,146923,0,187123
140930100500000,NE 147,Residential,25392,0,25392,0,0,25392
140930100600000,NE 147,Residential,39600,0,39600,147793,0,187393
140930100700000,NE 147,Residential,19788,0,19788,0,0,19788
140930200100000,NE 147,Residential,42075,0,42075,103211,0,145286
140930200200000,NE 147,Residential,30398,0,30398,102404,0,132802
140930200300000,NE 147,Residential,32665,0,32665,103332,0,135997
140930200400000,NE 147,Residential,38376,0,38376,103200,0,141576
140930200500000,NE 147,Residential,39577,0,39577,125457,0,165034
140930200600000,NE 147,Residential,26153,0,26153,66861,0,93014
140930200700000,NE 147,Residential,27936,0,27936,106419,0,134355
140930200800000,NE 147,Residential,34422,0,34422,119859,0,154281
140930200900000,NE 147,Residential,16422,0,16422,142939,0,159361
140930201000000,NE 147,Residential,35770,0,35770,90409,0,126179
140930201100000,NE 147,Residential,36096,0,36096,85251,0,121347
140930201200000,NE 147,Residential,31815,0,31815,104289,0,136104
140930201300000,NE 147,Residential,30420,0,30420,80652,0,111072
140930201400000,NE 147,Residential,29925,0,29925,82458,0,112383
140930201500000,NE 147,Residential,32020,0,32020,69494,0,101514
140930201600000,CITY PROPERTY,Exempt,0,0,0,0,0,0
140930201700000,NE 147,Residential,36923,0,36923,161951,0,198874
140930201800000,NE 147,Residential,36360,0,36360,156778,0,193138
140930201900000,NE 147,Residential,36360,0,36360,137545,0,173905
140930202000000,NE 147,Residential,36360,0,36360,135451,0,171811
140930202100000,NE 147,Residential,36360,0,36360,138154,0,174514
140930202200000,NE 147,Residential,36112,0,36112,131470,0,167582
140930202300000,NE 147,Residential,38750,0,38750,183838,0,222588
140930202400000,NE 147,Residential,37791,0,37791,127415,0,165206
140930202500000,NE 147,Residential,38454,0,38454,154441,0,192895
140930202600000,NE 147,Residential,36978,0,36978,122287,0,159265
140930202700000,NE 147,Residential,37133,0,37133,157312,0,194445
140930202800000,NE 147,Residential,36765,0,36765,162475,0,199240
140930202900000,NE 147,Residential,36765,0,36765,132716,0,169481
140930203000000,NE 147,Residential,38090,0,38090,136259,0,174349
140930203100000,NE 147,Residential,35802,0,35802,133965,0,169767
140930203200000,NE 147,Residential,43850,0,43850,55283,0,99133
140930203300000,NE 147,Residential,55803,0,55803,272241,0,328044
140930203400000,NE 147,Residential,60333,0,60333,254131,0,314464
140930203500000,NE 147,Residential,41175,0,41175,60778,0,101953
140930203600000,NE 147,Residential,20400,0,20400,78905,0,99305
140930203700000,NE 147,Residential,25070,0,25070,164077,0,189147
140930203800000,NE 147,Residential,25200,0,25200,148419,0,173619
140930203900000,NE 147,Residential,24960,0,24960,116731,0,141691
140930204000000,NE 147,Residential,24240,0,24240,150442,0,174682
140930204100000,NE 147,Residential,21275,0,21275,94872,0,116147
140930204200000,NE 147,Residential,21691,0,21691,129899,0,151590
140932600100000,NE 147,Residential,40545,0,40545,94043,0,134588
140932600200000,NE 146,Residential,37674,0,37674,135968,0,173642
140932700100000,NE 147,Residential,58032,0,58032,150353,0,208385
140932700200000,NE 147,Residential,57406,0,57406,168845,0,226251
140932700300000,NE 147,Residential,32368,0,32368,101300,0,133668
140932700400000,NE 147,Residential,31173,0,31173,133199,0,164372
140932700500000,NE 147,Residential,29235,0,29235,0,0,29235
140932700600000,NE 147,Residential,31036,0,31036,110558,0,141594
140932701000000,NE 147,Residential,19100,0,19100,97352,0,116452
140932701100000,NE 147,Residential,27060,0,27060,123248,0,150308
140932701200000,NE 147,Residential,17762,0,17762,85794,0,103556
140932701300000,NE 147,Residential,20160,0,20160,78407,0,98567
140932701400000,NE 147,Residential,23380,0,23380,139106,0,162486
140932701500000,NE 147,Residential,21141,0,21141,75170,0,96311
140932701600000,NE 147,Residential,38347,0,38347,126119,0,164466
140932701700000,NE 147,Residential,27964,0,27964,67807,0,95771
140932701800000,NE 147,Residential,24705,0,24705,193124,0,217829
140932701900000,NE 147,Residential,24589,0,24589,124882,0,149471
140932702000000,NE 147,Residential,38547,0,38547,59835,0,98382
140932702100000,NE 145,Residential,35880,0,35880,227311,0,263191
140932702300000,NE 147,Residential,27979,0,27979,122918,0,150897
140932800100000,NE 147,Residential,24266,0,24266,96087,0,120353
140932800200000,NE 147,Residential,26160,0,26160,35254,0,61414
140932800300000,NE 147,Residential,37178,0,37178,71696,0,108874
140932800400000,NE 147,Residential,30317,0,30317,139275,0,169592
140932800500000,NE 147,Residential,31620,0,31620,166732,0,198352
140932800600000,NE 147,Residential,24180,0,24180,109151,0,133331
140932800700000,NE 147,Residential,30480,0,30480,124809,0,155289
140932800800000,NE 147,Residential,30960,0,30960,110148,0,141108
140932800900000,NE 147,Residential,40425,0,40425,59068,0,99493
140932801000000,NE 147,Residential,40500,0,40500,121284,0,161784
140932801100000,NE 147,Residential,42275,0,42275,118894,0,161169
140932801200000,NE 147,Residential,27885,0,27885,120753,0,148638
140932801300000,NE 147,Residential,26250,0,26250,107289,0,133539
140932801400000,NE 147,Residential,24747,0,24747,150215,0,174962
140932801500000,NE 147,Residential,21421,0,21421,146137,0,167558
140932801600000,NE 147,Residential,23031,0,23031,116139,0,139170
140932801700000,NE 147,Residential,22800,0,22800,116854,0,139654
140932801800000,NE 147,Residential,26353,0,26353,124591,0,150944
140932801900000,NE 147,Residential,22374,0,22374,127259,0,149633
140932802000000,NE 147,Residential,26220,0,26220,223225,0,249445
140932802100000,NE 147,Residential,28017,0,28017,183343,0,211360
140932802200000,NE 147,Residential,37442,0,37442,47171,0,84613
140932802300000,NE 147,Residential,28381,0,28381,167592,0,195973
140932802400000,NE 147,Residential,40525,0,40525,88268,0,128793
140932802500000,NE 147,Residential,34744,0,34744,48934,0,83678
140932802600000,NE 147,Residential,40100,0,40100,240091,0,280191
140932802700000,NE 147,Residential,40075,0,40075,261136,0,301211
140932802800000,NE 147,Residential,35670,0,35670,109056,0,144726
140932802900000,NE 147,Residential,39600,0,39600,123745,0,163345
140932803000000,NE 147,Residential,39000,0,39000,49789,0,88789
140932803100000,NE 147,Residential,23985,0,23985,95484,0,119469
140932803400000,NE 147,Residential,1131,0,1131,0,0,1131
140935100100000,NE 147,Residential,20706,0,20706,101287,0,121993
140935100200000,NE 147,Residential,35910,0,35910,106938,0,142848
140935100300000,NE 147,Residential,39906,0,39906,128792,0,168698
140935100400000,NE 147,Residential,23085,0,23085,98198,0,121283
140935100500000,NE 147,Residential,22572,0,22572,132387,0,154959
140935100600000,NE 147,Residential,22800,0,22800,143882,0,166682
140935100700000,NE 147,Residential,22800,0,22800,113848,0,136648
140935100800000,NE 147,Residential,22572,0,22572,129848,0,152420
140935100900000,NE 147,Residential,22116,0,22116,108175,0,130291
140935101000000,NE 147,Residential,20766,0,20766,129304,0,150070
140935101100000,NE 147,Residential,41075,0,41075,44186,0,85261
140935101200000,NE 147,Residential,40825,0,40825,397506,0,438331
140935101300000,NE 147,Residential,22192,0,22192,0,0,22192
140935101400000,NE 147,Residential,21517,0,21517,0,0,21517
140935101500000,NE 147,Residential,15300,0,15300,37165,0,52465
140935101600000,NE 147,Residential,16950,0,16950,0,0,16950
140935101700000,NE 147,Residential,20340,0,20340,79361,0,99701
140935101800000,NE 147,Residential,18656,0,18656,71819,0,90475
140935101900000,NE 147,Residential,15300,0,15300,92183,0,107483
140935102000000,NE 147,Residential,15300,0,15300,105030,0,120330
140935102100000,NE 147,Residential,4200,0,4200,0,0,4200
140935102200000,NE 147,Residential,42475,0,42475,185503,0,227978
140935102300000,NE 147,Residential,42725,0,42725,51811,0,94536
140935102400000,NE 147,Residential,43300,0,43300,105695,0,148995
140935102500000,NE 147,Residential,30000,0,30000,112359,0,142359
140935102600000,NE 147,Residential,30094,0,30094,77388,0,107482
140935102700000,NE 147,Residential,42175,0,42175,79910,0,122085
140935102800000,NE 147,Residential,42380,0,42380,0,0,42380
140935102900000,NE 147,Residential,33789,0,33789,0,0,33789
140935103000000,NE 147,Residential,25025,0,25025,0,0,25025
140935200100000,NE 147,Residential,29971,0,29971,133974,0,163945
140935200200000,NE 147,Residential,24184,0,24184,83951,0,108135
140935200300000,NE 147,Residential,41328,0,41328,230170,0,271498
140935200400000,NE 147,Residential,26451,0,26451,98756,0,125207
140935200500000,NE 147,Residential,25800,0,25800,131433,0,157233
140935200600000,NE 147,Residential,25800,0,25800,114597,0,140397
140935200700000,NE 147,Residential,27997,0,27997,96043,0,124040
140935300100000,NE 147,Residential,23184,0,23184,193668,0,216852
140935300200000,NE 147,Residential,38250,0,38250,111690,0,149940
140935300300000,NE 147,Residential,21120,0,21120,0,0,21120
140935300500000,NE 147,Residential,21615,0,21615,91894,0,113509
140935300600000,NE 147,Residential,29925,0,29925,50290,0,80215
140935301000000,NE 147,Residential,16538,0,16538,55920,0,72458
140935301100000,NE 147,Residential,24883,0,24883,98832,0,123715
140935301200000,NE 147,Residential,29606,0,29606,62502,0,92108
140935301400000,NE 147,Residential,26670,0,26670,111047,0,137717
140935301500000,NE 147,Residential,26880,0,26880,103625,0,130505
140935301600000,NE 147,Residential,27648,0,27648,103700,0,131348
140935301700000,NE 147,Residential,17415,0,17415,36762,0,54177
140935301800000,NE 147,Residential,25880,0,25880,107020,0,132900
140935301900000,NE 147,Residential,26865,0,26865,99376,0,126241
140935302000000,NE 147,Residential,26585,0,26585,106022,0,132607
140935302100000,NE 147,Residential,25549,0,25549,587,0,26136
140935302200000,NE 147,Residential,32562,0,32562,110072,0,142634
140937600100000,NE 147,Residential,40575,0,40575,99730,0,140305
140937600200000,NE 147,Residential,33800,0,33800,87861,0,121661
140937600300000,NE 147,Residential,31360,0,31360,59646,0,91006
140937600400000,NE 147,Residential,30480,0,30480,144702,0,175182
140937600500000,NE 147,Residential,22860,0,22860,79471,0,102331
140937600600000,NE 147,Residential,36195,0,36195,47408,0,83603
140937600700000,NE 147,Residential,19500,0,19500,43861,0,63361
140937600800000,NE 147,Residential,24060,0,24060,87553,0,111613
140937600900000,NE 147,Residential,28560,0,28560,81473,0,110033
140937601000000,NE 147,Residential,22995,0,22995,92200,0,115195
140937601100000,NE 147,Residential,20280,0,20280,77774,0,98054
140937601200000,NE 147,Residential,19790,0,19790,90212,0,110002
140937601300000,NE 147,Residential,18720,0,18720,86811,0,105531
140937601400000,NE 147,Residential,19305,0,19305,97695,0,117000
140937601500000,NE 147,Residential,18000,0,18000,86118,0,104118
140937601600000,NE 147,Residential,18000,0,18000,90862,0,108862
140937601700000,NE 147,Residential,18900,0,18900,84754,0,103654
140937601800000,NE 147,Residential,18850,0,18850,107324,0,126174
140937601900000,NE 147,Residential,5265,0,5265,0,0,5265
140937700100000,NE 147,Residential,20490,0,20490,140062,0,160552
140937700200000,NE 147,Residential,20827,0,20827,122545,0,143372
140937700300000,NE 147,Residential,17919,0,17919,113491,0,131410
140937700400000,NE 147,Residential,19157,0,19157,92991,0,112148
140937700500000,NE 147,Residential,20927,0,20927,116219,0,137146
140937700600000,NE 147,Residential,20790,0,20790,119146,0,139936
140937700700000,NE 147,Residential,20790,0,20790,123919,0,144709
140937700800000,NE 147,Residential,21261,0,21261,119977,0,141238
140937700900000,NE 147,Residential,21885,0,21885,102102,0,123987
140937701000000,NE 147,Residential,20265,0,20265,104603,0,124868
140937701100000,NE 147,Residential,19157,0,19157,105140,0,124297
140937701200000,NE 147,Residential,19157,0,19157,107310,0,126467
140937701300000,NE 147,Residential,23851,0,23851,129056,0,152907
140937701400000,NE 147,Residential,22626,0,22626,116503,0,139129
140937701500000,NE 147,Residential,19355,0,19355,140270,0,159625
140937701600000,NE 147,Residential,17087,0,17087,129308,0,146395
140937701700000,NE 147,Residential,27056,0,27056,102925,0,129981
140937701800000,NE 147,Residential,45500,0,45500,114070,0,159570
140937701900000,NE 147,Residential,43275,0,43275,51693,0,94968
140937702000000,NE 147,Residential,20116,0,20116,63741,0,83857
140937702100000,NE 147,Residential,21293,0,21293,104264,0,125557
140937702200000,NE 147,Residential,38749,0,38749,134709,0,173458
140937702300000,NE 147,Residential,31446,0,31446,119882,0,151328
140937702400000,NE 147,Residential,22863,0,22863,76659,0,99522
140937702500000,NE 147,Residential,14974,0,14974,72459,0,87433
140937702600000,NE 147,Residential,14985,0,14985,58464,0,73449
140937702700000,NE 147,Residential,18315,0,18315,58193,0,76508
140937702800000,NE 147,Residential,18315,0,18315,43145,0,61460
140937702900000,NE 147,Residential,25704,0,25704,93959,0,119663
140937703000000,NE 147,Residential,23617,0,23617,78510,0,102127
140937703100000,NE 147,Residential,36695,0,36695,193063,0,229758
140937703200000,NE 147,Residential,21797,0,21797,124656,0,146453
140937703300000,NE 147,Residential,22950,0,22950,122076,0,145026
140937703400000,NE 147,Residential,22950,0,22950,144894,0,167844
140937703500000,NE 147,Residential,22950,0,22950,130780,0,153730
140937703600000,NE 147,Residential,22950,0,22950,121175,0,144125
140937703700000,NE 147,Residential,22950,0,22950,132822,0,155772
140937703800000,NE 147,Residential,23720,0,23720,128439,0,152159
140937703900000,NE 147,Residential,23940,0,23940,122263,0,146203
140937704000000,NE 147,Residential,4700,0,4700,0,0,4700
140937704100000,NE 147,Residential,24885,0,24885,184614,0,209499
140937704200000,NE 147,Residential,24210,0,24210,144047,0,168257
140937704300000,NE 147,Residential,26481,0,26481,154735,0,181216
140937704400000,NE 147,Residential,22711,0,22711,131430,0,154141
140937704500000,NE 147,Residential,23072,0,23072,145783,0,168855
140937704600000,NE 147,Residential,23072,0,23072,139661,0,162733
140937704700000,NE 147,Residential,22873,0,22873,137081,0,159954
140937704800000,NE 147,Residential,22476,0,22476,138373,0,160849
140937704900000,NE 147,Residential,22497,0,22497,124857,0,147354
140937800100000,NE 147,Residential,14553,0,14553,13003,0,27556
140937800200000,NE 147,Residential,12615,0,12615,101726,0,114341
140937800300000,NE 147,Residential,18300,0,18300,90277,0,108577
140937800400000,NE 147,Residential,18300,0,18300,88340,0,106640
140937800500000,NE 147,Residential,18300,0,18300,99131,0,117431
140937800600000,NE 147,Residential,18300,0,18300,81841,0,100141
140937800700000,NE 147,Residential,18300,0,18300,126805,0,145105
140937800800000,NE 147,Residential,18000,0,18000,90788,0,108788
140937800900000,NE 147,Residential,18000,0,18000,88368,0,106368
140937801000000,NE 147,Residential,18000,0,18000,112655,0,130655
140937803200000,NE 147,Residential,31487,0,31487,174713,0,206200
140937803300000,NE 147,Residential,31944,0,31944,83619,0,115563
140937803500000,NE 147,Residential,21465,0,21465,68665,0,90130
140937900100000,NE 147,Residential,19500,0,19500,98996,0,118496
140937900200000,NE 147,Residential,18000,0,18000,78485,0,96485
140937900300000,NE 147,Residential,19500,0,19500,75190,0,94690
140937900400000,NE 147,Residential,18000,0,18000,91163,0,109163
140937900500000,NE 147,Residential,20800,0,20800,79307,0,100107
140937900600000,NE 147,Residential,18772,0,18772,94955,0,113727
140937900700000,NE 147,Residential,18000,0,18000,97294,0,115294
140937900800000,NE 147,Residential,18525,0,18525,101380,0,119905
140937900900000,NE 147,Residential,18000,0,18000,81454,0,99454
140937901000000,NE 147,Residential,18525,0,18525,101515,0,120040
140938000100000,NE 147,Residential,22890,0,22890,56000,0,78890
140938000200000,NE 147,Residential,28554,0,28554,135767,0,164321
140938000300000,NE 147,Residential,35422,0,35422,163402,0,198824
140938000400000,NE 147,Residential,25294,0,25294,59158,0,84452
140938000500000,NE 147,Residential,23408,0,23408,107618,0,131026
140938000600000,NE 147,Residential,16120,0,16120,42322,0,58442
140940100100000,NE 131,Residential,12870,0,12870,107553,0,120423
140940100200000,NE 131,Residential,19012,0,19012,97914,0,116926
140940100300000,NE 131,Residential,14625,0,14625,32281,0,46906
140940100400000,NE 131,Residential,14625,0,14625,119377,0,134002
140940100500000,NE 131,Residential,16088,0,16088,88884,0,104972
140940100600000,NE 131,Residential,13163,0,13163,98866,0,112029
140940100700000,NE 131,Residential,14625,0,14625,108250,0,122875
140940100800000,NE 131,Residential,14625,0,14625,96991,0,111616
140940100900000,NE 131,Residential,29000,0,29000,132036,0,161036
140940101000000,NE 131,Residential,16530,0,16530,80470,0,97000
140940101100000,NE 131,Residential,12180,0,12180,62770,0,74950
140940101200000,NE 131,Residential,12180,0,12180,57460,0,69640
140940101300000,NE 131,Residential,16240,0,16240,67092,0,83332
140940101400000,NE 131,Residential,14500,0,14500,74715,0,89215
140940101500000,NE 131,Residential,14500,0,14500,87755,0,102255
140940101600000,NE 131,Residential,17572,0,17572,107428,0,125000
140940101700000,NE 131,Residential,17400,0,17400,55503,0,72903
140940101800000,NE 131,Residential,14500,0,14500,50240,0,64740
140940101900000,NE 131,Residential,14500,0,14500,77994,0,92494
140940102000000,NE 131,Residential,14500,0,14500,77442,0,91942
140940102100000,NE 131,Residential,12125,0,12125,34471,0,46596
140940102200000,NE 131,Residential,16875,0,16875,115546,0,132421
140940102300000,NE 131,Residential,19597,0,19597,47241,0,66838
140940200100000,NE 131,Residential,9326,0,9326,37049,0,46375
140940200200000,NE 131,Residential,14375,0,14375,62903,0,77278
140940200300000,NE 131,Residential,14375,0,14375,83675,0,98050
140940200400000,NE 131,Residential,14375,0,14375,38797,0,53172
140940200500000,NE 131,Residential,14375,0,14375,52343,0,66718
140940200600000,NE 131,Residential,14375,0,14375,55222,0,69597
140940200700000,NE 131,Residential,14375,0,14375,93620,0,107995
140940200800000,NE 131,Residential,14375,0,14375,64344,0,78719
140940200900000,NE 131,Residential,14375,0,14375,34328,0,48703
140940201000000,NE 131,Residential,14375,0,14375,53926,0,68301
140940201100000,NE 131,Residential,14375,0,14375,29102,0,43477
140940201200000,NE 131,Residential,18687,0,18687,91148,0,109835
140940201300000,NE 131,Residential,18687,0,18687,100533,0,119220
140940201400000,NE 131,Residential,14375,0,14375,65954,0,80329
140940201500000,NE 131,Residential,14375,0,14375,111545,0,125920
140940201600000,NE 131,Residential,14375,0,14375,47507,0,61882
140940201700000,NE 131,Residential,14375,0,14375,63724,0,78099
140940201800000,NE 131,Residential,18550,0,18550,111834,0,130384
140940201900000,NE 131,Residential,15400,0,15400,90911,0,106311
140940300100000,NE 131,Residential,18000,0,18000,74395,0,92395
140940300200000,NE 131,Residential,16359,0,16359,111309,0,127668
140940300300000,NE 131,Residential,16359,0,16359,95999,0,112358
140940300400000,NE 131,Residential,17280,0,17280,99776,0,117056
140940300500000,NE 131,Residential,26937,0,26937,130854,0,157791
140940300600000,NE 131,Residential,14250,0,14250,52427,0,66677
140940300700000,NE 131,Residential,14125,0,14125,99738,0,113863
140940300800000,NE 131,Residential,21187,0,21187,59905,0,81092
140940300900000,NE 131,Residential,16809,0,16809,48353,0,65162
140940301000000,NE 131,Residential,17920,0,17920,115759,0,133679
140940301200000,NE 131,Residential,14000,0,14000,0,0,14000
140940301300000,FLAT PARKING,Commercial,0,91692,91692,0,12285,103977
140940301400000,NE 131,Residential,14125,0,14125,0,0,14125
140940301500000,NE 131,Residential,16830,0,16830,96059,0,112889
140940301600000,NE 131,Residential,16500,0,16500,122161,0,138661
140940301700000,NE 131,Residential,16500,0,16500,99008,0,115508
140940302000000,NE 131,Residential,21562,0,21562,79653,0,101215
140940302100000,NE 131,Residential,14375,0,14375,131954,0,146329
140940302200000,NE 131,Residential,14375,0,14375,95270,0,109645
140940302300000,NE 131,Residential,14375,0,14375,72113,0,86488
140940302400000,NE 131,Residential,18687,0,18687,97453,0,116140
140940302500000,NE 131,Residential,14375,0,14375,49303,0,63678
140940302600000,NE 131,Residential,14375,0,14375,93425,0,107800
140940302700000,NE 131,Residential,14375,0,14375,32025,0,46400
140940302800000,NE 131,Residential,18687,0,18687,74869,0,93556
140940302900000,NE 131,Residential,18687,0,18687,90151,0,108838
140940303000000,NE 131,Residential,18687,0,18687,65903,0,84590
140940303100000,NE 131,Residential,18687,0,18687,68468,0,87155
140940303200000,NE 131,Residential,16129,0,16129,41884,0,58013
140940400100000,GROCERY STORE,Commercial,0,948834,948834,0,2048646,2997480
140940400200000,NE 131,Residential,12650,0,12650,52304,0,64954
140940400300000,NE 131,Residential,16100,0,16100,73606,0,89706
140940400400000,NE 131,Residential,17812,0,17812,57188,0,75000
140940400500000,NE 131,Residential,16625,0,16625,116075,0,132700
140940400600000,NE 131,Residential,16650,0,16650,0,0,16650
140940400700000,NE 131,Residential,16650,0,16650,62905,0,79555
140940400800000,NE 131,Residential,13200,0,13200,76081,0,89281
140940400900000,NE 131,Residential,14375,0,14375,57624,0,71999
140940401000000,NE 131,Residential,11875,0,11875,63981,0,75856
140940401100000,NE 131,Residential,14000,0,14000,66410,0,80410
140940401200000,NE 131,Residential,14000,0,14000,73717,0,87717
140940401400000,OFFICE; MEDICAL,Commercial,0,207360,207360,0,429968,637328
140940401500000,NE 131,Residential,14375,0,14375,85707,0,100082
140940401600000,NE 131,Residential,14375,0,14375,79561,0,93936
140940401700000,NE 131,Residential,14375,0,14375,60420,0,74795
140940401800000,NE 131,Residential,14375,0,14375,0,0,14375
140940401900000,NE 131,Residential,14375,0,14375,0,0,14375
140942600100000,FLAT PARKING,Commercial,0,102816,102816,0,11334,114150
140942600200000,OFFICE,Commercial,0,116640,116640,0,303686,420326
140942600300000,NE 132,Residential,18600,0,18600,115005,0,133605
140942600400000,NE 131,Residential,16815,0,16815,93149,0,109964
140942600500000,NE 132,Residential,17325,0,17325,73517,0,90842
140942600600000,RESTAURANT,Commercial,0,123690,123690,0,89429,213119
140942600700000,SMALL RETAIL,Commercial,0,26849,26849,0,41849,68698
140942600800000,LG DISCOUNT/RETAIL,Commercial,0,526500,526500,0,784733,1311233
140942600900000,OFFICE,Commercial,0,27672,27672,0,61167,88839
140942601000000,CONVENIENCE STORE,Commercial,0,364500,364500,0,199831,564331
140942601100000,LAUNDROMAT/CLEANERS,Commercial,0,105235,105235,0,188393,293628
140942601200000,OFFICE,Commercial,0,257904,257904,0,413841,671745
140942700100000,NE 132,Residential,16537,0,16537,101678,0,118215
140942700200000,NE 132,Residential,16950,0,16950,64814,0,81764
140942700300000,NE 132,Residential,18058,0,18058,62439,0,80497
140942700400000,NE 132,Residential,13000,0,13000,44830,0,57830
140942700500000,NE 132,Residential,12750,0,12750,0,0,12750
140942700600000,OFFICE; MEDICAL,Commercial,0,107571,107571,0,155029,262600
140942800100000,WAREHOUSE,Commercial,0,187326,187326,0,452948,640274
140942900100000,AUTO REPAIR/SALES,Commercial,0,83203,83203,0,29853,113056
140942900200000,RESTAURANT,Commercial,0,147111,147111,0,146074,293185
140942900300000,RESTAURANT,Commercial,0,156492,156492,0,87457,243949
140942900400000,AUTO REPAIR/SALES,Commercial,0,259200,259200,0,175007,434207
140943000100000,VACANT LAND,Commercial,0,38048,38048,0,0,38048
140945100100000,OFFICE,Commercial,0,198323,198323,0,474666,672989
140945100200000,OFFICE,Commercial,0,109573,109573,0,330040,439613
140945100300000,OFFICE; MEDICAL,Commercial,0,83529,83529,0,112867,196396
140945100401000,OFFICE; MEDICAL,Commercial,0,92880,92880,0,240781,333661
140945100401001,OFFICE,Commercial,0,92880,92880,0,364974,457854
140945100500000,NE 146,Residential,16928,0,16928,38424,0,55352
140945100600000,NE 146,Residential,22448,0,22448,26226,0,48674
140945100700000,SMALL RETAIL,Commercial,0,235440,235440,0,355180,590620
140945100800000,DAY CARE CENTER,Commercial,0,261360,261360,0,251354,512714
140945100900000,NE 146,Residential,19775,0,19775,61435,0,81210
140945101000000,NE 146,Residential,16120,0,16120,48048,0,64168
140945101100000,NE 146,Residential,27363,0,27363,82287,0,109650
140945101200000,NE 146,Residential,19988,0,19988,87168,0,107156
140945101400000,CENTRALLY ASSESSED,Other,0,0,0,0,0,0
140945200100000,CITY PROPERTY,Exempt,0,0,0,0,0,0
140945200200000,NE 146,Residential,8779,0,8779,0,0,8779
140945200300000,NE 147,Residential,10632,0,10632,92865,0,103497
140945200400000,NE 147,Residential,15250,0,15250,89283,0,104533
140945200500000,NE 147,Residential,15250,0,15250,91867,0,107117
140945200600000,NE 147,Residential,15250,0,15250,79990,0,95240
140945200700000,NE 147,Residential,15250,0,15250,83595,0,98845
140945200800000,NE 147,Residential,15250,0,15250,97479,0,112729
140945200900000,NE 147,Residential,15000,0,15000,109174,0,124174
140945201100000,NE 147,Residential,25200,0,25200,83048,0,108248
140947600100000,OFFICE,Commercial,0,476442,476442,0,615993,1092435
140947700200000,SMALL RETAIL,Commercial,0,500645,500645,0,579984,1080629
140947700500000,NE 146,Residential,10688,0,10688,31113,0,41801
140947700600000,NE 146,Residential,9500,0,9500,65355,0,74855
140947700700000,NE 146,Residential,10450,0,10450,40308,0,50758
140947700800000,NE 146,Residential,13063,0,13063,18615,0,31678
140947700900000,OFFICE; MEDICAL,Commercial,0,293760,293760,0,1166281,1460041
140947701100000,NE 146,Residential,15750,0,15750,29814,0,45564
140947701200000,NE 146,Residential,15625,0,15625,0,0,15625
140947701300000,NE 146,Residential,44090,0,44090,134759,0,178849
140947701400000,NE 146,Residential,28898,0,28898,166366,0,195264
140947701500000,NE 146,Residential,20616,0,20616,90389,0,111005
140947701600000,NE 146,Residential,20520,0,20520,74310,0,94830
140947701700000,NE 146,Residential,20520,0,20520,75145,0,95665
140947701800000,NE 146,Residential,20520,0,20520,82426,0,102946
140947701900000,NE 146,Residential,20520,0,20520,80600,0,101120
140947702000000,NE 146,Residential,20520,0,20520,80993,0,101513
140947702100000,NE 146,Residential,12125,0,12125,82593,0,94718
140947702200000,APARTMENT,Commercial,0,17694,17694,0,142306,160000
140947702300000,NE 146,Residential,13426,0,13426,105898,0,119324
140947702400000,NE 146,Residential,12375,0,12375,73510,0,85885
140947702500000,NE 146,Residential,12625,0,12625,73642,0,86267
140947702600000,NE 146,Residential,14794,0,14794,70532,0,85326
140947702700000,NE 146,Residential,21187,0,21187,61852,0,83039
140947702800000,NE 146,Residential,17500,0,17500,100017,0,117517
140947702900000,NE 146,Residential,12875,0,12875,75828,0,88703
140947703000000,NE 146,Residential,12750,0,12750,63333,0,76083
140947703100000,NE 146,Residential,12750,0,12750,39531,0,52281
140947703200000,NE 146,Residential,20825,0,20825,109345,0,130170
140947703300000,NE 146,Residential,18000,0,18000,74098,0,92098
140947703400000,NE 146,Residential,21175,0,21175,71654,0,92829
140947800200000,NE 146,Residential,13388,0,13388,60384,0,73772
140947800300000,NE 146,Residential,13655,0,13655,73207,0,86862
140947800400000,NE 146,Residential,11875,0,11875,45740,0,57615
140947800500000,NE 146,Residential,11875,0,11875,60257,0,72132
140947800600000,NE 146,Residential,11875,0,11875,34974,0,46849
140947800700000,CONVENIENCE STORE,Commercial,0,383940,383940,0,695934,1079874
140947801300000,NE 146,Residential,17010,0,17010,0,0,17010
140947801500000,NE 146,Residential,18900,0,18900,61746,0,80646
140947801600000,NE 146,Residential,22437,0,22437,64119,0,86556
140947801700000,NE 146,Residential,22035,0,22035,44018,0,66053
140947801800000,NE 146,Residential,22035,0,22035,51858,0,73893
140947801900000,NE 146,Residential,20638,0,20638,129895,0,150533
140947802000000,NE 146,Residential,20638,0,20638,68633,0,89271
140947802100000,NE 146,Residential,22225,0,22225,92314,0,114539
140947802200000,NE 146,Residential,25400,0,25400,61412,0,86812
140947802300000,NE 146,Residential,16828,0,16828,57957,0,74785
140947802400000,NE 146,Residential,14335,0,14335,0,0,14335
140947802500000,CONVENIENCE STORE,Commercial,0,157286,157286,0,179162,336448
140947802600000,NE 146,Residential,27270,0,27270,77632,0,104902
140947802700000,NE 146,Residential,22725,0,22725,60828,0,83553
140947802800000,NE 146,Residential,36360,0,36360,87242,0,123602
140947802900000,NE 146,Residential,31815,0,31815,59591,0,91406
140947803000000,NE 146,Residential,20976,0,20976,83984,0,104960
140947803100000,NE 146,Residential,21204,0,21204,100282,0,121486
140947803200000,NE 146,Residential,21432,0,21432,80354,0,101786
140947803300000,NE 146,Residential,24138,0,24138,134323,0,158461
140947803400000,NE 146,Residential,21660,0,21660,83713,0,105373
140947803500000,NE 146,Residential,22042,0,22042,83259,0,105301
140947803600000,NE 146,Residential,22504,0,22504,95546,0,118050
140947803700000,NE 146,Residential,27160,0,27160,91655,0,118815
140947803800000,NE 146,Residential,28255,0,28255,99733,0,127988
140947900200000,NE 143,Residential,15108,0,15108,63820,0,78928
140947900300000,NE 143,Residential,15300,0,15300,65771,0,81071
140947900400000,NE 143,Residential,13760,0,13760,70829,0,84589
140947900500000,NE 143,Residential,14967,0,14967,99317,0,114284
140947900600000,NE 143,Residential,17280,0,17280,81720,0,99000
140947900700000,NE 143,Residential,15595,0,15595,72964,0,88559
140947900800000,NE 143,Residential,20400,0,20400,42033,0,62433
140947900900000,NE 143,Residential,24240,0,24240,66624,0,90864
140948000100000,NE 143,Residential,25926,0,25926,80268,0,106194
140948000200000,NE 143,Residential,24948,0,24948,110641,0,135589
140948000300000,NE 143,Residential,17856,0,17856,82672,0,100528
140948000400000,NE 143,Residential,24525,0,24525,162312,0,186837
140948000500000,NE 143,Residential,26676,0,26676,114396,0,141072
140948000600000,NE 143,Residential,20475,0,20475,101604,0,122079
140948000700000,NE 143,Residential,13685,0,13685,84172,0,97857
140948000800000,NE 143,Residential,15000,0,15000,78528,0,93528
140948000900000,NE 143,Residential,24858,0,24858,82083,0,106941
140948001000000,NE 143,Residential,10875,0,10875,67767,0,78642
140948001100000,NE 143,Residential,23400,0,23400,96682,0,120082
140948001200000,CHURCH,Exempt,0,16034,16034,0,7080,23114
140948001300000,NE 143,Residential,29998,0,29998,141550,0,171548
140948001400000,NE 143,Residential,20400,0,20400,99646,0,120046
140948001500000,NE 143,Residential,18768,0,18768,89873,0,108641
140948001600000,NE 143,Residential,26112,0,26112,103851,0,129963
140948001700000,NE 143,Residential,27669,0,27669,86068,0,113737
140948001800000,NE 143,Residential,28560,0,28560,93257,0,121817
140948001900000,NE 143,Residential,29451,0,29451,130219,0,159670
141010100100000,NE 130,Residential,29507,0,29507,81716,0,111223
141010100200000,NE 130,Residential,30264,0,30264,94701,0,124965
141010100300000,NE 130,Residential,27063,0,27063,61088,0,88151
141010100400000,NE 130,Residential,26190,0,26190,79564,0,105754
141010100500000,NE 130,Residential,23280,0,23280,94642,0,117922
141010100600000,NE 130,Residential,23280,0,23280,83572,0,106852
141010100700000,NE 130,Residential,23280,0,23280,98844,0,122124
141010100800000,NE 130,Residential,23280,0,23280,69408,0,92688
141010100900000,NE 130,Residential,23280,0,23280,75447,0,98727
141010101000000,NE 130,Residential,23280,0,23280,79327,0,102607
141010101100000,NE 130,Residential,23280,0,23280,83223,0,106503
141010101200000,NE 130,Residential,24880,0,24880,81021,0,105901
141010200100000,NE 130,Residential,26190,0,26190,70046,0,96236
141010200200000,NE 130,Residential,28372,0,28372,93613,0,121985
141010200300000,NE 130,Residential,23280,0,23280,71481,0,94761
141010200400000,NE 130,Residential,23280,0,23280,77733,0,101013
141010200500000,NE 130,Residential,23280,0,23280,66675,0,89955
141010200600000,NE 130,Residential,23280,0,23280,76772,0,100052
141010300100000,NE 130,Residential,25972,0,25972,93771,0,119743
141010300200000,NE 130,Residential,25972,0,25972,75320,0,101292
141010300300000,NE 130,Residential,26190,0,26190,94306,0,120496
141010300400000,NE 130,Residential,26190,0,26190,72279,0,98469
141010300500000,NE 130,Residential,26190,0,26190,65875,0,92065
141010400100000,NE 130,Residential,28518,0,28518,106086,0,134604
141010400200000,NE 130,Residential,26190,0,26190,69010,0,95200
141010400300000,NE 130,Residential,26190,0,26190,89136,0,115326
141010400400000,NE 130,Residential,23280,0,23280,106284,0,129564
141010400500000,NE 130,Residential,23280,0,23280,98296,0,121576
141010400600000,NE 130,Residential,26190,0,26190,73427,0,99617
141010400700000,NE 130,Residential,23280,0,23280,78894,0,102174
141010400800000,NE 130,Residential,23280,0,23280,78889,0,102169
141010400900000,NE 130,Residential,23280,0,23280,62544,0,85824
141010401000000,NE 130,Residential,23280,0,23280,98846,0,122126
141010401100000,NE 130,Residential,23280,0,23280,66369,0,89649
141010401200000,NE 130,Residential,23280,0,23280,70112,0,93392
141010401300000,NE 130,Residential,24880,0,24880,69112,0,93992
141010401400000,NE 130,Residential,29294,0,29294,65280,0,94574
141010401500000,NE 130,Residential,29294,0,29294,46537,0,75831
141010401600000,NE 130,Residential,29100,0,29100,55911,0,85011
141010401700000,NE 130,Residential,29682,0,29682,60809,0,90491
141010401800000,NE 130,Residential,29449,0,29449,60401,0,89850
141010401900000,NE 130,Residential,29100,0,29100,86352,0,115452
141010402000000,NE 130,Residential,29682,0,29682,77833,0,107515
141010402100000,NE 130,Residential,29100,0,29100,44994,0,74094
141010402200000,NE 130,Residential,29539,0,29539,95544,0,125083
141010402300000,NE 130,Residential,28800,0,28800,73516,0,102316
141010402400000,NE 130,Residential,24192,0,24192,56237,0,80429
141010402500000,NE 130,Residential,34368,0,34368,83197,0,117565
141010500100000,NE 130,Residential,24880,0,24880,92081,0,116961
141010500200000,NE 130,Residential,23280,0,23280,103224,0,126504
141010500300000,NE 130,Residential,23280,0,23280,83690,0,106970
141010500400000,NE 130,Residential,23280,0,23280,86933,0,110213
141010500500000,NE 130,Residential,23280,0,23280,96181,0,119461
141010500600000,NE 130,Residential,25920,0,25920,68052,0,93972
141010500700000,NE 130,Residential,25920,0,25920,59560,0,85480
141010500800000,NE 130,Residential,23280,0,23280,105117,0,128397
141010500900000,NE 130,Residential,23280,0,23280,83857,0,107137
141010501000000,NE 130,Residential,23280,0,23280,100100,0,123380
141010501100000,NE 130,Residential,23280,0,23280,87922,0,111202
141010501200000,NE 130,Residential,23280,0,23280,92260,0,115540
141010501300000,NE 130,Residential,23280,0,23280,71967,0,95247
141010501400000,NE 130,Residential,26190,0,26190,81509,0,107699
141010600100000,NE 130,Residential,30264,0,30264,81669,0,111933
141010600200000,NE 130,Residential,28371,0,28371,82394,0,110765
141010600300000,NE 130,Residential,27761,0,27761,75452,0,103213
141010600400000,NE 130,Residential,28779,0,28779,64866,0,93645
141010600500000,NE 130,Residential,32432,0,32432,109023,0,141455
141010600600000,NE 130,Residential,37867,0,37867,75591,0,113458
141010600700000,NE 130,Residential,34920,0,34920,59101,0,94021
141010600800000,NE 130,Residential,34920,0,34920,33505,0,68425
141010600900000,NE 130,Residential,34920,0,34920,87749,0,122669
141010601000000,NE 130,Residential,26190,0,26190,61457,0,87647
141010700100000,NE 130,Residential,32340,0,32340,131636,0,163976
141010700200000,NE 130,Residential,34650,0,34650,107881,0,142531
141010700300000,NE 130,Residential,35763,0,35763,67234,0,102997
141010700400000,NE 130,Residential,35910,0,35910,84128,0,120038
141010700500000,NE 130,Residential,34020,0,34020,75065,0,109085
141010700600000,NE 130,Residential,34020,0,34020,67250,0,101270
141010700700000,NE 130,Residential,35910,0,35910,91820,0,127730
141010700800000,NE 130,Residential,34020,0,34020,55494,0,89514
141010700900000,NE 130,Residential,34020,0,34020,56564,0,90584
141010701000000,NE 130,Residential,35568,0,35568,59474,0,95042
141010701100000,NE 130,Residential,35474,0,35474,75836,0,111310
141010701200000,NE 130,Residential,24057,0,24057,80188,0,104245
141010701300000,NE 130,Residential,23760,0,23760,78220,0,101980
141010701400000,NE 130,Residential,23760,0,23760,55750,0,79510
141010701500000,NE 130,Residential,23760,0,23760,90518,0,114278
141010701600000,NE 130,Residential,23760,0,23760,53140,0,76900
141010701700000,NE 130,Residential,23760,0,23760,38975,0,62735
141010701800000,NE 130,Residential,23760,0,23760,75440,0,99200
141010701900000,NE 130,Residential,25245,0,25245,94925,0,120170
141010702000000,NE 130,Residential,23760,0,23760,72161,0,95921
141010702100000,NE 130,Residential,23760,0,23760,45109,0,68869
141010702200000,NE 130,Residential,23760,0,23760,65125,0,88885
141010702300000,NE 130,Residential,23760,0,23760,89636,0,113396
141010702400000,NE 130,Residential,28512,0,28512,99021,0,127533
141010702500000,NE 130,Residential,24057,0,24057,64050,0,88107
141010800100000,NE 130,Residential,37128,0,37128,60732,0,97860
141010800200000,NE 130,Residential,29490,0,29490,83539,0,113029
141010800300000,NE 130,Residential,27810,0,27810,96747,0,124557
141010800400000,NE 130,Residential,27810,0,27810,93192,0,121002
141010800500000,NE 130,Residential,27810,0,27810,105354,0,133164
141010800600000,NE 130,Residential,24240,0,24240,63501,0,87741
141010800700000,NE 130,Residential,24240,0,24240,61085,0,85325
141010800800000,NE 130,Residential,24513,0,24513,23987,0,48500
141010800900000,NE 130,Residential,24240,0,24240,64807,0,89047
141010801000000,NE 130,Residential,30600,0,30600,95372,0,125972
141010801100000,NE 130,Residential,31416,0,31416,97332,0,128748
141010801200000,NE 130,Residential,33936,0,33936,63484,0,97420
141010801300000,NE 130,Residential,26316,0,26316,90805,0,117121
141010900100000,NE 130,Residential,30547,0,30547,95262,0,125809
141010900200000,NE 130,Residential,27810,0,27810,50023,0,77833
141010900300000,NE 130,Residential,27270,0,27270,64671,0,91941
141010900400000,NE 130,Residential,27270,0,27270,53972,0,81242
141010900500000,NE 130,Residential,27270,0,27270,58859,0,86129
141010900600000,NE 130,Residential,6600,0,6600,0,0,6600
141010900700000,NE 130,Residential,26190,0,26190,55791,0,81981
141010900800000,NE 130,Residential,27354,0,27354,53443,0,80797
141010900900000,NE 130,Residential,25026,0,25026,68208,0,93234
141010901000000,NE 130,Residential,24240,0,24240,103562,0,127802
141010901100000,NE 130,Residential,24240,0,24240,78938,0,103178
141010901200000,NE 130,Residential,24240,0,24240,72113,0,96353
141010901300000,NE 130,Residential,24240,0,24240,100436,0,124676
141010901400000,NE 130,Residential,29309,0,29309,66833,0,96142
141011000100000,NE 130,Residential,38784,0,38784,74828,0,113612
141011000200000,NE 130,Residential,34920,0,34920,79637,0,114557
141011000300000,NE 130,Residential,37102,0,37102,79092,0,116194
141011000400000,NE 130,Residential,24240,0,24240,65605,0,89845
141011000500000,NE 130,Residential,24240,0,24240,92567,0,116807
141011000600000,NE 130,Residential,24240,0,24240,70324,0,94564
141011000700000,NE 130,Residential,24240,0,24240,93335,0,117575
141011000800000,NE 130,Residential,24240,0,24240,111798,0,136038
141011000900000,NE 130,Residential,36666,0,36666,70938,0,107604
141011001000000,NE 130,Residential,37714,0,37714,66320,0,104034
141011001100000,NE 130,Residential,24240,0,24240,87692,0,111932
141011001200000,NE 130,Residential,24240,0,24240,66283,0,90523
141011001300000,NE 130,Residential,38784,0,38784,99556,0,138340
141011001400000,NE 130,Residential,36360,0,36360,73367,0,109727
141011001500000,NE 130,Residential,36360,0,36360,86315,0,122675
141011001600000,NE 130,Residential,38784,0,38784,55077,0,93861
141011100100000,NE 130,Residential,36855,0,36855,71168,0,108023
141011100200000,NE 130,Residential,36855,0,36855,75557,0,112412
141011100300000,NE 130,Residential,33936,0,33936,82004,0,115940
141011100400000,NE 130,Residential,42420,0,42420,65263,0,107683
141011100500000,NE 130,Residential,42420,0,42420,77147,0,119567
141011100700000,NE 130,Residential,24240,0,24240,53777,0,78017
141011100800000,NE 130,Residential,24240,0,24240,60324,0,84564
141011100900000,NE 130,Residential,24240,0,24240,68082,0,92322
141011101000000,NE 130,Residential,24240,0,24240,75885,0,100125
141011101100000,NE 130,Residential,38784,0,38784,72472,0,111256
141011101200000,NE 130,Residential,24240,0,24240,63972,0,88212
141011101300000,NE 130,Residential,36360,0,36360,92534,0,128894
141011101400000,NE 130,Residential,36360,0,36360,92595,0,128955
141011101500000,NE 130,Residential,24240,0,24240,51484,0,75724
141011101600000,NE 130,Residential,36360,0,36360,80593,0,116953
141011200100000,NE 130,Residential,24240,0,24240,93918,0,118158
141011200200000,NE 130,Residential,32400,0,32400,77207,0,109607
141011200300000,NE 130,Residential,32400,0,32400,82750,0,115150
141011200400000,NE 130,Residential,24240,0,24240,78198,0,102438
141011200500000,NE 130,Residential,24240,0,24240,44165,0,68405
141011200600000,NE 130,Residential,32724,0,32724,57454,0,90178
141011200700000,NE 130,Residential,27876,0,27876,54900,0,82776
141011200800000,NE 130,Residential,32724,0,32724,62563,0,95287
141011200900000,NE 130,Residential,27876,0,27876,48822,0,76698
141011201000000,NE 130,Residential,32400,0,32400,55594,0,87994
141011201100000,NE 130,Residential,32400,0,32400,63952,0,96352
141011201200000,NE 130,Residential,24240,0,24240,56906,0,81146
141011201300000,NE 130,Residential,24240,0,24240,96137,0,120377
141011201400000,NE 130,Residential,36360,0,36360,63654,0,100014
141011201500000,NE 130,Residential,36360,0,36360,90504,0,126864
141011201600000,NE 130,Residential,38784,0,38784,83198,0,121982
141011201700000,NE 130,Residential,15150,0,15150,0,0,15150
141011201800000,NE 130,Residential,40299,0,40299,88835,0,129134
141011300100000,NE 130,Residential,38784,0,38784,81078,0,119862
141011300200000,NE 130,Residential,37537,0,37537,81435,0,118972
141011300300000,NE 130,Residential,36191,0,36191,82539,0,118730
141011300400000,NE 130,Residential,36360,0,36360,100908,0,137268
141011300500000,NE 130,Residential,36360,0,36360,94953,0,131313
141011300600000,NE 130,Residential,36360,0,36360,104428,0,140788
141011300700000,NE 130,Residential,33330,0,33330,83734,0,117064
141011300900000,NE 130,Residential,38669,0,38669,84354,0,123023
141011301000000,NE 130,Residential,32364,0,32364,88932,0,121296
141011301100000,NE 130,Residential,38784,0,38784,84908,0,123692
141011301200000,NE 130,Residential,38784,0,38784,118373,0,157157
141011301300000,NE 130,Residential,32724,0,32724,60001,0,92725
141011301400000,NE 130,Residential,27876,0,27876,78473,0,106349
141011301500000,NE 130,Residential,32724,0,32724,66461,0,99185
141011301600000,NE 130,Residential,27876,0,27876,48011,0,75887
141012600100000,GOLF COURSE,Commercial,0,356400,356400,0,291278,647678
141015100100000,NE 131,Residential,32360,0,32360,42720,0,75080
141015100200000,NE 131,Residential,32565,0,32565,39129,0,71694
141015100300000,NE 131,Residential,30846,0,30846,57580,0,88426
141015100400000,NE 131,Residential,31428,0,31428,47869,0,79297
141015100500000,NE 131,Residential,28518,0,28518,46883,0,75401
141015100600000,NE 131,Residential,31428,0,31428,51395,0,82823
141015100700000,NE 131,Residential,30846,0,30846,58349,0,89195
141015100800000,NE 131,Residential,31428,0,31428,66457,0,97885
141015100900000,NE 131,Residential,28518,0,28518,63700,0,92218
141015101000000,NE 131,Residential,31428,0,31428,61788,0,93216
141015101100000,NE 131,Residential,30846,0,30846,56116,0,86962
141015101200000,NE 131,Residential,33174,0,33174,71244,0,104418
141015101300000,NE 131,Residential,35568,0,35568,69871,0,105439
141015101400000,NE 131,Residential,32754,0,32754,58839,0,91593
141015101500000,NE 131,Residential,33048,0,33048,61708,0,94756
141015101600000,NE 131,Residential,29988,0,29988,57498,0,87486
141015101700000,NE 131,Residential,32724,0,32724,55155,0,87879
141015101800000,NE 131,Residential,31800,0,31800,78243,0,110043
141015101900000,NE 131,Residential,32076,0,32076,68132,0,100208
141015102000000,NE 131,Residential,29106,0,29106,54649,0,83755
141015102100000,NE 131,Residential,31752,0,31752,62637,0,94389
141015102200000,NE 131,Residential,30846,0,30846,66103,0,96949
141015200100000,NE 131,Residential,33326,0,33326,63839,0,97165
141015200200000,NE 131,Residential,35400,0,35400,68831,0,104231
141015200300000,NE 131,Residential,36000,0,36000,58675,0,94675
141015200400000,NE 131,Residential,33600,0,33600,53750,0,87350
141015200500000,NE 131,Residential,36000,0,36000,77247,0,113247
141015200600000,NE 131,Residential,33600,0,33600,50224,0,83824
141015200700000,NE 131,Residential,36000,0,36000,84182,0,120182
141015200800000,NE 131,Residential,33600,0,33600,54118,0,87718
141015200900000,NE 131,Residential,36000,0,36000,67713,0,103713
141015201000000,NE 131,Residential,36000,0,36000,82898,0,118898
141015201100000,NE 131,Residential,34746,0,34746,74397,0,109143
141015201200000,NE 131,Residential,34200,0,34200,52930,0,87130
141015201300000,NE 131,Residential,31800,0,31800,55155,0,86955
141015201400000,NE 131,Residential,32400,0,32400,56426,0,88826
141015201500000,NE 131,Residential,29400,0,29400,45823,0,75223
141015201600000,NE 131,Residential,32400,0,32400,43726,0,76126
141015201700000,NE 131,Residential,31800,0,31800,66769,0,98569
141015201800000,NE 131,Residential,32400,0,32400,53487,0,85887
141015201900000,NE 131,Residential,29400,0,29400,50321,0,79721
141015202000000,NE 131,Residential,32400,0,32400,54762,0,87162
141015202100000,NE 131,Residential,31800,0,31800,52423,0,84223
141015300100000,NE 131,Residential,34244,0,34244,68005,0,102249
141015300200000,NE 131,Residential,32232,0,32232,88476,0,120708
141015300300000,NE 131,Residential,32076,0,32076,63470,0,95546
141015300400000,NE 131,Residential,32076,0,32076,63582,0,95658
141015300500000,NE 131,Residential,30888,0,30888,57027,0,87915
141015300600000,NE 131,Residential,31482,0,31482,76483,0,107965
141015300700000,NE 131,Residential,29700,0,29700,55602,0,85302
141015300800000,NE 131,Residential,32076,0,32076,69124,0,101200
141015300900000,NE 131,Residential,31482,0,31482,59978,0,91460
141015301000000,NE 131,Residential,29700,0,29700,46297,0,75997
141015301100000,NE 131,Residential,31482,0,31482,63605,0,95087
141015301200000,NE 131,Residential,33858,0,33858,64595,0,98453
141015301300000,NE 131,Residential,35046,0,35046,58927,0,93973
141015301400000,NE 131,Residential,33264,0,33264,49747,0,83011
141015301500000,NE 131,Residential,35640,0,35640,61828,0,97468
141015301600000,NE 131,Residential,35640,0,35640,61290,0,96930
141015301700000,NE 131,Residential,33264,0,33264,57730,0,90994
141015301800000,NE 131,Residential,35640,0,35640,78327,0,113967
141015301900000,NE 131,Residential,35640,0,35640,86752,0,122392
141015302000000,NE 131,Residential,35640,0,35640,68320,0,103960
141015302100000,NE 131,Residential,33264,0,33264,66860,0,100124
141015400100000,NE 131,Residential,31897,0,31897,61311,0,93208
141015400200000,NE 131,Residential,43751,0,43751,104749,0,148500
141015400300000,NE 131,Residential,44676,0,44676,88577,0,133253
141015400400000,NE 131,Residential,44676,0,44676,103582,0,148258
141015400500000,NE 131,Residential,44238,0,44238,97074,0,141312
141015400600000,NE 131,Residential,43800,0,43800,123376,0,167176
141015400700000,NE 131,Residential,43800,0,43800,94768,0,138568
141015400800000,NE 131,Residential,43362,0,43362,103633,0,146995
141015400900000,NE 131,Residential,44100,0,44100,127367,0,171467
141015401000000,NE 131,Residential,30780,0,30780,57914,0,88694
141015401100000,NE 131,Residential,30210,0,30210,53611,0,83821
141015401200000,NE 131,Residential,30780,0,30780,51922,0,82702
141015401300000,NE 131,Residential,30780,0,30780,70249,0,101029
141015401400000,NE 131,Residential,28500,0,28500,62971,0,91471
141015401500000,NE 131,Residential,30780,0,30780,58077,0,88857
141015401600000,NE 131,Residential,30210,0,30210,71183,0,101393
141015401700000,NE 131,Residential,28500,0,28500,55060,0,83560
141015401800000,NE 131,Residential,30780,0,30780,64263,0,95043
141015401900000,NE 131,Exempt,0,29640,29640,0,54430,84070
141015500100000,NE 131,Residential,35000,0,35000,73759,0,108759
141015500200000,NE 131,Residential,35000,0,35000,81375,0,116375
141015500300000,NE 131,Residential,35000,0,35000,114179,0,149179
141015500400000,NE 131,Residential,35000,0,35000,114057,0,149057
141015500500000,NE 131,Residential,35000,0,35000,87453,0,122453
141015500600000,NE 131,Residential,23050,0,23050,52520,0,75570
141015500700000,NE 131,Residential,23450,0,23450,50724,0,74174
141015500800000,NE 131,Residential,23500,0,23500,50984,0,74484
141015500900000,NE 131,Residential,35000,0,35000,48752,0,83752
141015501000000,NE 131,Residential,35000,0,35000,115440,0,150440
141015501100000,NE 131,Residential,35000,0,35000,107463,0,142463
141015501200000,NE 131,Residential,35000,0,35000,56816,0,91816
141015501300000,NE 131,Residential,35000,0,35000,36360,0,71360
141015501400000,NE 131,Residential,35000,0,35000,81931,0,116931
141015501500000,NE 131,Residential,35000,0,35000,66448,0,101448
141015600100000,NE 131,Residential,35000,0,35000,84245,0,119245
141015600200000,NE 131,Residential,35000,0,35000,76629,0,111629
141015600300000,NE 131,Residential,35000,0,35000,69989,0,104989
141015600400000,NE 131,Residential,35000,0,35000,103665,0,138665
141015600500000,NE 131,Residential,35000,0,35000,97701,0,132701
141015600600000,NE 131,Residential,35000,0,35000,65729,0,100729
141015600700000,NE 131,Residential,35000,0,35000,103234,0,138234
141015600800000,NE 131,Residential,32500,0,32500,89185,0,121685
141015600900000,NE 131,Residential,37500,0,37500,103893,0,141393
141015601000000,NE 131,Residential,35000,0,35000,83378,0,118378
141015601100000,NE 131,Residential,35000,0,35000,70752,0,105752
141015601200000,NE 131,Residential,17500,0,17500,43520,0,61020
141015601300000,NE 131,Residential,17500,0,17500,47704,0,65204
141015700100000,NE 131,Residential,24000,0,24000,98180,0,122180
141015700200000,NE 131,Residential,40500,0,40500,104916,0,145416
141015700400000,NE 131,Residential,22500,0,22500,0,0,22500
141015700500000,NE 131,Residential,22500,0,22500,91758,0,114258
141015700600000,NE 131,Residential,38792,0,38792,114522,0,153314
141015700700000,NE 131,Residential,37875,0,37875,120391,0,158266
141015700800000,NE 131,Residential,38000,0,38000,111935,0,149935
141015700900000,NE 131,Residential,38000,0,38000,69481,0,107481
141015701000000,NE 131,Residential,38000,0,38000,71390,0,109390
141015800100000,NE 131,Residential,26250,0,26250,62139,0,88389
141015800200000,NE 131,Residential,26250,0,26250,79565,0,105815
141015800300000,NE 131,Residential,17500,0,17500,32755,0,50255
141015800400000,NE 131,Residential,35000,0,35000,62885,0,97885
141015800500000,NE 131,Residential,35000,0,35000,68969,0,103969
141015800600000,NE 131,Residential,35000,0,35000,77415,0,112415
141015800700000,NE 131,Residential,22500,0,22500,58293,0,80793
141015800800000,NE 131,Residential,25000,0,25000,36907,0,61907
141015800900000,NE 131,Residential,22500,0,22500,52425,0,74925
141015801000000,NE 131,Residential,35000,0,35000,66802,0,101802
141015801100000,NE 131,Residential,35000,0,35000,77492,0,112492
141015801200000,NE 131,Residential,35000,0,35000,59762,0,94762
141015801300000,NE 131,Residential,35000,0,35000,57279,0,92279
141015801400000,NE 131,Residential,35000,0,35000,89347,0,124347
141015801500000,NE 131,Residential,35000,0,35000,89260,0,124260
141015801600000,NE 131,Residential,35000,0,35000,70368,0,105368
141015900100000,NE 131,Residential,35000,0,35000,59647,0,94647
141015900200000,NE 131,Residential,35000,0,35000,85038,0,120038
141015900300000,NE 131,Residential,35000,0,35000,77825,0,112825
141015900400000,NE 131,Residential,36125,0,36125,38727,0,74852
141015900500000,NE 131,Residential,20000,0,20000,49345,0,69345
141015900600000,NE 131,Residential,25000,0,25000,74706,0,99706
141015900700000,NE 131,Residential,17500,0,17500,37837,0,55337
141015900800000,CITY PROPERTY,Exempt,0,0,0,0,0,0
141015900900000,NE 131,Residential,22750,0,22750,32268,0,55018
141015901000000,NE 131,Residential,22750,0,22750,39700,0,62450
141015901100000,NE 131,Residential,36400,0,36400,98602,0,135002
141015901200000,NE 131,Residential,38111,0,38111,112123,0,150234
141015901300000,NE 131,Residential,35000,0,35000,101101,0,136101
141015901400000,NE 131,Residential,35000,0,35000,81771,0,116771
141015901500000,NE 131,Residential,35000,0,35000,58807,0,93807
141015901600000,NE 131,Residential,35000,0,35000,60596,0,95596
141015901700000,NE 131,Residential,35000,0,35000,48329,0,83329
141015901800000,NE 131,Residential,35000,0,35000,72477,0,107477
141017600100000,NE 129,Residential,24030,0,24030,76455,0,100485
141017600200000,NE 129,Residential,31500,0,31500,28118,0,59618
141017600300000,NE 129,Residential,32130,0,32130,108057,0,140187
141017600400000,NE 129,Residential,34650,0,34650,93238,0,127888
141017600500000,NE 129,Residential,43647,0,43647,106373,0,150020
141017600600000,NE 129,Residential,40950,0,40950,106827,0,147777
141017600700000,NE 129,Residential,35910,0,35910,72143,0,108053
141017600800000,NE 129,Residential,33390,0,33390,86392,0,119782
141017600900000,NE 129,Residential,31500,0,31500,53646,0,85146
141017601000000,NE 129,Residential,28050,0,28050,89520,0,117570
141017601100000,NE 129,Residential,27600,0,27600,71973,0,99573
141017601200000,NE 129,Residential,23000,0,23000,73892,0,96892
141017601300000,NE 129,Residential,23000,0,23000,98323,0,121323
141017601400000,NE 129,Residential,33600,0,33600,74106,0,107706
141017601500000,NE 129,Residential,33600,0,33600,76145,0,109745
141017601600000,NE 129,Residential,35700,0,35700,100760,0,136460
141017601700000,NE 129,Residential,31500,0,31500,89495,0,120995
141017601800000,NE 129,Residential,33387,0,33387,102460,0,135847
141017601900000,NE 129,Residential,27200,0,27200,74164,0,101364
141017602000000,NE 129,Residential,24638,0,24638,75562,0,100200
141017602100000,NE 129,Residential,22028,0,22028,68448,0,90476
141017602200000,NE 129,Residential,24030,0,24030,43470,0,67500
141017700100000,SCHOOL,Exempt,0,0,0,0,0,0
141017800100000,NE 129,Residential,31918,0,31918,120285,0,152203
141017800200000,NE 129,Residential,31280,0,31280,68784,0,100064
141017800300000,NE 129,Residential,31500,0,31500,113160,0,144660
141017800400000,NE 129,Residential,31500,0,31500,104745,0,136245
141017800500000,NE 129,Residential,31500,0,31500,82177,0,113677
141017800600000,NE 129,Residential,31500,0,31500,110732,0,142232
141017800700000,NE 129,Residential,31500,0,31500,109330,0,140830
141017800800000,NE 129,Residential,31341,0,31341,62911,0,94252
141017800900000,NE 129,Residential,31500,0,31500,67032,0,98532
141017801000000,NE 129,Residential,30258,0,30258,89937,0,120195
141017801100000,NE 129,Residential,32742,0,32742,133743,0,166485
141017801200000,NE 129,Residential,31500,0,31500,77603,0,109103
141017801300000,NE 129,Residential,31500,0,31500,102967,0,134467
141017801400000,NE 129,Residential,31500,0,31500,74111,0,105611
141017801500000,NE 129,Residential,31500,0,31500,81684,0,113184
141017801600000,NE 129,Residential,31500,0,31500,116841,0,148341
141017801700000,NE 129,Residential,31500,0,31500,82447,0,113947
141017801800000,NE 129,Residential,31500,0,31500,64033,0,95533
141017801900000,NE 129,Residential,23000,0,23000,76967,0,99967
141017802000000,NE 129,Residential,34883,0,34883,104486,0,139369
141017802100000,NE 129,Residential,25088,0,25088,116953,0,142041
141017802200000,NE 129,Residential,25585,0,25585,90152,0,115737
141017900100000,NE 131,Residential,35000,0,35000,99931,0,134931
141017900200000,NE 131,Residential,35000,0,35000,77993,0,112993
141017900300000,NE 131,Residential,35000,0,35000,83046,0,118046
141017900400000,NE 131,Residential,26250,0,26250,79906,0,106156
141017900500000,NE 131,Residential,26250,0,26250,86095,0,112345
141017900600000,NE 131,Residential,35000,0,35000,85221,0,120221
141017900700000,NE 131,Residential,17500,0,17500,59430,0,76930
141017900800000,NE 131,Residential,17500,0,17500,66608,0,84108
141017900900000,NE 131,Residential,35000,0,35000,71428,0,106428
141017901000000,NE 131,Residential,17500,0,17500,67955,0,85455
141017901100000,NE 131,Residential,42000,0,42000,105649,0,147649
141017901200000,NE 131,Residential,35000,0,35000,91987,0,126987
141017901300000,NE 131,Residential,17500,0,17500,59265,0,76765
141017901400000,NE 131,Residential,26250,0,26250,51161,0,77411
141017901500000,NE 131,Residential,26250,0,26250,74392,0,100642
141017901600000,NE 131,Residential,17500,0,17500,51161,0,68661
141017901700000,NE 131,Residential,32500,0,32500,51247,0,83747
141017901800000,NE 131,Residential,20000,0,20000,39378,0,59378
141017901900000,NE 131,Residential,35000,0,35000,67702,0,102702
141018000100000,NE 129,Residential,21000,0,21000,50720,0,71720
141018000200000,NE 129,Residential,22050,0,22050,72451,0,94501
141018000300000,NE 129,Residential,32760,0,32760,73277,0,106037
141018000400000,NE 129,Residential,21000,0,21000,41402,0,62402
141018000500000,NE 129,Residential,21000,0,21000,106473,0,127473
141018000600000,NE 129,Residential,26250,0,26250,78474,0,104724
141018000700000,NE 129,Residential,26250,0,26250,50532,0,76782
141018000800000,NE 129,Residential,26250,0,26250,75685,0,101935
141018000900000,NE 129,Residential,26250,0,26250,91856,0,118106
141018001000000,NE 129,Residential,21000,0,21000,83560,0,104560
141018001100000,NE 129,Residential,21000,0,21000,98759,0,119759
141018001200000,NE 129,Residential,31500,0,31500,88868,0,120368
141018001300000,NE 129,Residential,31500,0,31500,99917,0,131417
141018001400000,NE 129,Residential,21000,0,21000,52127,0,73127
141018001500000,NE 129,Residential,21000,0,21000,58243,0,79243
141018001600000,NE 129,Residential,21000,0,21000,49404,0,70404
141018001700000,NE 129,Residential,21000,0,21000,71246,0,92246
141018001800000,NE 129,Residential,21000,0,21000,68872,0,89872
141018001900000,NE 129,Residential,23625,0,23625,57067,0,80692
141018002000000,NE 129,Residential,33469,0,33469,71229,0,104698
141018002100000,NE 129,Residential,26250,0,26250,61747,0,87997
141018002200000,NE 129,Residential,26250,0,26250,94239,0,120489
141018002300000,NE 129,Residential,31500,0,31500,81959,0,113459
141018002400000,NE 129,Residential,23625,0,23625,93230,0,116855
141018002500000,NE 129,Residential,23625,0,23625,69421,0,93046
141018002600000,NE 129,Residential,36750,0,36750,76678,0,113428
141018100100000,NE 131,Residential,35000,0,35000,73813,0,108813
141018100200000,NE 131,Residential,35000,0,35000,140004,0,175004
141018100300000,NE 131,Residential,24333,0,24333,87864,0,112197
141018100400000,NE 131,Residential,22167,0,22167,71197,0,93364
141018100500000,NE 131,Residential,23500,0,23500,71196,0,94696
141018100600000,NE 131,Residential,35000,0,35000,76879,0,111879
141018100700000,NE 131,Residential,35000,0,35000,112613,0,147613
141018100800000,NE 131,Residential,35000,0,35000,80396,0,115396
141018100900000,NE 131,Residential,35000,0,35000,47185,0,82185
141018101000000,NE 131,Residential,23330,0,23330,68909,0,92239
141018101100000,NE 131,Residential,23330,0,23330,68582,0,91912
141018101200000,NE 131,Residential,28330,0,28330,60339,0,88669
141018101300000,NE 131,Residential,30000,0,30000,86918,0,116918
141018101400000,NE 131,Residential,35000,0,35000,73405,0,108405
141018101500000,NE 131,Residential,29165,0,29165,61247,0,90412
141018101600000,NE 131,Residential,29165,0,29165,78480,0,107645
141018101700000,NE 131,Residential,29165,0,29165,58427,0,87592
141018101800000,NE 131,Residential,35000,0,35000,64956,0,99956
141018101900000,NE 131,Residential,17500,0,17500,52379,0,69879
141020100100000,GOLF COURSE,Commercial,0,320047,320047,0,305368,625415
141020200100000,CONVENIENCE STORE,Commercial,0,80568,80568,0,203387,283955
141020200200000,SMALL RETAIL,Commercial,0,66528,66528,0,173056,239584
141020200300000,OFFICE,Commercial,0,117504,117504,0,470490,587994
141022600100000,OFFICE; MEDICAL,Commercial,0,59616,59616,0,193649,253265
141022600200000,NE 132,Residential,40838,0,40838,82977,0,123815
141022600300000,NE 132,Residential,35640,0,35640,84417,0,120057
141022600400000,NE 132,Residential,16830,0,16830,80429,0,97259
141022600500000,NE 132,Residential,36979,0,36979,57246,0,94225
141022600600000,NE 132,Residential,33840,0,33840,103815,0,137655
141022600700000,NE 132,Residential,36981,0,36981,109658,0,146639
141022600800000,NE 132,Residential,42075,0,42075,94587,0,136662
141022600900000,NE 132,Residential,38114,0,38114,96285,0,134399
141022601000000,NE 132,Residential,30410,0,30410,89998,0,120408
141022601100000,NE 132,Residential,33580,0,33580,92026,0,125606
141022601200000,NE 132,Residential,37345,0,37345,87166,0,124511
141022601300000,NE 132,Residential,34411,0,34411,114722,0,149133
141022601400000,APARTMENT,Commercial,0,30132,30132,0,369679,399811
141022601500000,FLAT PARKING,Commercial,0,105408,105408,0,40710,146118
141022700100000,NE 132,Residential,32928,0,32928,87667,0,120595
141022700200000,NE 132,Residential,32670,0,32670,95270,0,127940
141022700300000,NE 132,Residential,28840,0,28840,111849,0,140689
141022700400000,NE 132,Residential,43715,0,43715,147893,0,191608
141022700500000,NE 132,Residential,45357,0,45357,83981,0,129338
141022700600000,NE 132,Residential,32670,0,32670,102645,0,135315
141022700700000,NE 132,Residential,28350,0,28350,73314,0,101664
141022701000000,NE 132,Residential,26730,0,26730,99042,0,125772
141022701100000,NE 132,Residential,26957,0,26957,99768,0,126725
141022701200000,NE 132,Residential,30240,0,30240,105140,0,135380
141022701300000,NE 132,Residential,28343,0,28343,102900,0,131243
141022701400000,NE 132,Residential,39847,0,39847,126970,0,166817
141022701500000,NE 132,Residential,37950,0,37950,161572,0,199522
141022701600000,NE 132,Residential,37950,0,37950,89933,0,127883
141022701700000,NE 132,Residential,37950,0,37950,110779,0,148729
141022701800000,NE 132,Residential,38280,0,38280,104510,0,142790
141022701900000,NE 132,Residential,38940,0,38940,91798,0,130738
141022702000000,NE 132,Residential,33557,0,33557,93807,0,127364
141022702100000,NE 132,Residential,34320,0,34320,81297,0,115617
141022702200000,NE 132,Residential,34320,0,34320,113681,0,148001
141022702300000,NE 132,Residential,34320,0,34320,84525,0,118845
141022702400000,NE 132,Residential,38324,0,38324,90642,0,128966
141022702500000,NE 132,Residential,37180,0,37180,101980,0,139160
141022702600000,NE 132,Residential,32604,0,32604,93790,0,126394
141022702700000,NE 132,Residential,49252,0,49252,92609,0,141861
141022800100000,NE 132,Residential,60950,0,60950,91196,0,152146
141022800200000,NE 132,Residential,28759,0,28759,80629,0,109388
141022800300000,NE 132,Residential,31680,0,31680,78835,0,110515
141022800400000,NE 132,Residential,31680,0,31680,89302,0,120982
141022800500000,NE 132,Residential,30624,0,30624,93216,0,123840
141022800600000,NE 132,Residential,30624,0,30624,71967,0,102591
141022800700000,NE 132,Residential,27701,0,27701,86468,0,114169
141022800800000,NE 132,Residential,22141,0,22141,84764,0,106905
141022900100000,NE 132,Residential,33110,0,33110,102648,0,135758
141022900200000,NE 132,Residential,33330,0,33330,99651,0,132981
141022900300000,NE 132,Residential,31123,0,31123,87247,0,118370
141022900400000,NE 132,Residential,34011,0,34011,108586,0,142597
141022900500000,NE 132,Residential,33941,0,33941,91422,0,125363
141022900600000,NE 132,Residential,34202,0,34202,101653,0,135855
141022900700000,NE 132,Residential,34277,0,34277,99461,0,133738
141022900800000,NE 132,Residential,34277,0,34277,76874,0,111151
141022900900000,NE 132,Residential,34277,0,34277,90097,0,124374
141022901000000,NE 132,Residential,34558,0,34558,101857,0,136415
141022901100000,NE 132,Residential,34950,0,34950,101669,0,136619
141022901200000,NE 132,Residential,34782,0,34782,79329,0,114111
141022901300000,NE 132,Residential,34782,0,34782,94614,0,129396
141022901400000,NE 132,Residential,34782,0,34782,83401,0,118183
141022901500000,NE 132,Residential,34782,0,34782,93574,0,128356
141022901600000,NE 132,Residential,34782,0,34782,87106,0,121888
141022901700000,NE 132,Residential,35567,0,35567,82231,0,117798
141022901800000,NE 132,Residential,34631,0,34631,80997,0,115628
141022901900000,NE 132,Residential,35306,0,35306,96286,0,131592
141022902000000,NE 132,Residential,34320,0,34320,71680,0,106000
141022902100000,NE 132,Residential,36960,0,36960,61053,0,98013
141022902200000,NE 132,Residential,38204,0,38204,92428,0,130632
141023000100000,NE 132,Residential,55224,0,55224,110150,0,165374
141023000200000,NE 132,Residential,31715,0,31715,101551,0,133266
141023000300000,NE 132,Residential,38662,0,38662,79844,0,118506
141023000400000,NE 132,Residential,28093,0,28093,86998,0,115091
141023000500000,NE 132,Residential,28440,0,28440,85287,0,113727
141023000600000,NE 132,Residential,28704,0,28704,84517,0,113221
141023000700000,NE 132,Residential,28915,0,28915,99699,0,128614
141023000800000,NE 132,Residential,32480,0,32480,97114,0,129594
141023000900000,NE 132,Residential,24964,0,24964,85036,0,110000
141023001000000,NE 132,Residential,22387,0,22387,100218,0,122605
141023001100000,NE 132,Residential,22046,0,22046,78610,0,100656
141023100100000,NE 132,Residential,31372,0,31372,72609,0,103981
141023100200000,NE 132,Residential,31680,0,31680,66980,0,98660
141023100300000,NE 132,Residential,31680,0,31680,74906,0,106586
141023100400000,NE 132,Residential,31680,0,31680,80531,0,112211
141023100500000,NE 132,Residential,31680,0,31680,96513,0,128193
141023100600000,NE 132,Residential,33247,0,33247,86945,0,120192
141023100700000,NE 132,Residential,32616,0,32616,58279,0,90895
141023100800000,NE 132,Residential,32933,0,32933,95730,0,128663
141023100900000,NE 132,Residential,22560,0,22560,74992,0,97552
141023101000000,NE 132,Residential,22560,0,22560,53865,0,76425
141023101100000,NE 132,Residential,24750,0,24750,46139,0,70889
141023200100000,NE 132,Residential,34320,0,34320,81331,0,115651
141023200200000,NE 132,Residential,34320,0,34320,74816,0,109136
141023200300000,NE 132,Residential,34267,0,34267,85331,0,119598
141023200400000,NE 132,Residential,32683,0,32683,91432,0,124115
141023200500000,NE 132,Residential,33792,0,33792,114417,0,148209
141023200600000,NE 132,Residential,31680,0,31680,83667,0,115347
141023200700000,NE 132,Residential,33792,0,33792,89004,0,122796
141023200800000,NE 132,Residential,32736,0,32736,99015,0,131751
141023200900000,NE 132,Residential,32736,0,32736,76716,0,109452
141023201000000,NE 132,Residential,32736,0,32736,98946,0,131682
141023201100000,NE 132,Residential,32472,0,32472,85348,0,117820
141023201200000,NE 132,Residential,33052,0,33052,106936,0,139988
141023201300000,NE 132,Residential,29343,0,29343,99586,0,128929
141023201400000,NE 132,Residential,29343,0,29343,95922,0,125265
141023201500000,NE 132,Residential,29343,0,29343,92015,0,121358
141023201600000,NE 132,Residential,29343,0,29343,90563,0,119906
141023201700000,NE 132,Residential,29343,0,29343,104602,0,133945
141023201800000,NE 132,Residential,29343,0,29343,69171,0,98514
141023201900000,NE 132,Residential,29343,0,29343,86361,0,115704
141023202000000,NE 132,Residential,29343,0,29343,81112,0,110455
141023202100000,NE 132,Residential,29343,0,29343,85825,0,115168
141023202200000,NE 132,Residential,29343,0,29343,73002,0,102345
141023202300000,NE 132,Exempt,0,33013,33013,0,118637,151650
141023300100000,NE 132,Residential,30456,0,30456,67089,0,97545
141023300200000,NE 132,Residential,29610,0,29610,57542,0,87152
141023300300000,NE 132,Residential,32359,0,32359,74339,0,106698
141023300400000,NE 132,Residential,26100,0,26100,48698,0,74798
141023400100000,NE 132,Residential,29695,0,29695,57862,0,87557
141023400200000,NE 132,Residential,38525,0,38525,72167,0,110692
141023400300000,NE 132,Residential,30690,0,30690,73997,0,104687
141023400400000,NE 132,Residential,40755,0,40755,87146,0,127901
141023400500000,NE 132,Residential,32010,0,32010,71335,0,103345
141023400600000,NE 132,Residential,31882,0,31882,134267,0,166149
141023400700000,NE 132,Residential,34612,0,34612,79677,0,114289
141023400800000,NE 132,Residential,31020,0,31020,82814,0,113834
141023400900000,NE 132,Residential,31020,0,31020,92122,0,123142
141023401000000,NE 132,Residential,31020,0,31020,73956,0,104976
141023401100000,NE 132,Residential,34496,0,34496,98713,0,133209
141023401200000,NE 132,Residential,32724,0,32724,88986,0,121710
141025100100000,GOLF COURSE,Commercial,0,45441,45441,0,40025,85466
141025100200000,NE 132,Residential,33516,0,33516,72182,0,105698
141025100300000,NE 132,Residential,27440,0,27440,63707,0,91147
141025100400000,NE 132,Residential,33264,0,33264,61566,0,94830
141025100500000,NE 132,Residential,34650,0,34650,63639,0,98289
141025100600000,NE 132,Residential,30600,0,30600,66177,0,96777
141025100700000,NE 132,Residential,30282,0,30282,64601,0,94883
141025100800000,NE 132,Residential,32738,0,32738,71823,0,104561
141025100900000,NE 132,Residential,32738,0,32738,66238,0,98976
141025101000000,NE 132,Exempt,0,32738,32738,0,52104,84842
141025101100000,NE 132,Residential,32738,0,32738,74134,0,106872
141025101200000,NE 132,Residential,33369,0,33369,66090,0,99459
141025101300000,NE 132,Residential,32760,0,32760,83795,0,116555
141025101400000,NE 132,Residential,33264,0,33264,65960,0,99224
141025101500000,NE 132,Residential,31590,0,31590,52451,0,84041
141025101600000,NE 131,Residential,29700,0,29700,72199,0,101899
141025101700000,NE 131,Residential,29700,0,29700,71461,0,101161
141025101800000,NE 131,Residential,33660,0,33660,69298,0,102958
141025200100000,NE 132,Residential,24000,0,24000,59288,0,83288
141025200200000,NE 132,Residential,24750,0,24750,46742,0,71492
141025200300000,NE 132,Residential,24750,0,24750,46702,0,71452
141025200400000,NE 132,Residential,24750,0,24750,48310,0,73060
141025200500000,NE 132,Residential,24750,0,24750,56912,0,81662
141025200600000,NE 132,Residential,24750,0,24750,51961,0,76711
141025200700000,NE 132,Residential,24750,0,24750,48559,0,73309
141025200800000,NE 132,Residential,24750,0,24750,50632,0,75382
141025200900000,NE 132,Residential,24750,0,24750,46604,0,71354
141025201000000,NE 132,Residential,24750,0,24750,41081,0,65831
141025201100000,NE 132,Residential,24750,0,24750,50206,0,74956
141025201200000,NE 132,Residential,25650,0,25650,69919,0,95569
141025201300000,NE 132,Residential,32359,0,32359,69282,0,101641
141025201400000,NE 132,Residential,29610,0,29610,57345,0,86955
141025201500000,NE 132,Residential,30701,0,30701,61299,0,92000
141025201600000,NE 132,Residential,24000,0,24000,43052,0,67052
141025201700000,NE 132,Residential,24000,0,24000,44189,0,68189
141025201800000,NE 132,Residential,24000,0,24000,77880,0,101880
141025201900000,NE 132,Residential,24000,0,24000,86949,0,110949
141025202000000,NE 132,Residential,24263,0,24263,29237,0,53500
141025202100000,NE 132,Residential,26000,0,26000,49891,0,75891
141025202200000,NE 132,Residential,24000,0,24000,68015,0,92015
141025202300000,NE 132,Residential,24000,0,24000,45794,0,69794
141025202400000,NE 132,Residential,24000,0,24000,54379,0,78379
141025202500000,NE 132,Residential,24000,0,24000,63241,0,87241
141025300100000,NE 132,Residential,25380,0,25380,55814,0,81194
141025300200000,NE 132,Residential,37218,0,37218,77174,0,114392
141025300300000,NE 132,Residential,32912,0,32912,96457,0,129369
141025300400000,NE 132,Residential,27495,0,27495,49116,0,76611
141025300500000,NE 132,Residential,27495,0,27495,66852,0,94347
141025300600000,NE 132,Residential,25380,0,25380,46172,0,71552
141025300700000,NE 132,Residential,30679,0,30679,56791,0,87470
141025300800000,NE 132,Residential,29295,0,29295,47671,0,76966
141025300900000,NE 132,Residential,31697,0,31697,66339,0,98036
141025301000000,NE 132,Residential,27788,0,27788,61688,0,89476
141025301100000,NE 132,Residential,25245,0,25245,46130,0,71375
141025301200000,NE 132,Residential,25380,0,25380,51282,0,76662
141025400100000,NE 132,Residential,24840,0,24840,59930,0,84770
141025400200000,NE 132,Residential,28518,0,28518,50715,0,79233
141025400300000,NE 132,Residential,24008,0,24008,43980,0,67988
141025400400000,NE 132,Residential,26190,0,26190,42828,0,69018
141025400500000,NE 132,Residential,26190,0,26190,46204,0,72394
141025400600000,NE 132,Residential,26190,0,26190,67687,0,93877
141025400700000,NE 132,Residential,26190,0,26190,47702,0,73892
141025400800000,NE 132,Residential,26190,0,26190,46795,0,72985
141025400900000,NE 132,Residential,28000,0,28000,105484,0,133484
141025401000000,NE 132,Residential,34178,0,34178,103472,0,137650
141025401100000,NE 132,Residential,26190,0,26190,110674,0,136864
141025401200000,NE 132,Residential,24008,0,24008,130755,0,154763
141025401300000,NE 132,Residential,26190,0,26190,80675,0,106865
141025401400000,NE 132,Residential,26190,0,26190,106070,0,132260
141025401500000,NE 132,Residential,27495,0,27495,81899,0,109394
141025401600000,NE 132,Residential,26313,0,26313,70966,0,97279
141025401700000,NE 132,Residential,25380,0,25380,74624,0,100004
141025500100000,NE 132,Residential,36045,0,36045,81339,0,117384
141025500200000,NE 132,Residential,36000,0,36000,57269,0,93269
141025500300000,NE 132,Residential,33075,0,33075,70416,0,103491
141025500400000,NE 132,Residential,34155,0,34155,63156,0,97311
141025500500000,NE 132,Residential,36450,0,36450,66553,0,103003
141025500600000,NE 132,Residential,23280,0,23280,47461,0,70741
141025500700000,NE 132,Residential,25200,0,25200,62894,0,88094
141025500800000,NE 132,Residential,24240,0,24240,53481,0,77721
141025500900000,NE 132,Residential,24159,0,24159,83457,0,107616
141025501000000,NE 132,Residential,23280,0,23280,48046,0,71326
141025501100000,NE 132,Residential,23280,0,23280,89741,0,113021
141025501200000,NE 132,Residential,24240,0,24240,45489,0,69729
141025501300000,NE 132,Residential,27071,0,27071,62553,0,89624
141025501400000,NE 131,Residential,35522,0,35522,89485,0,125007
141025501500000,NE 131,Residential,29700,0,29700,81838,0,111538
141025501600000,NE 131,Residential,29700,0,29700,71094,0,100794
141025501700000,NE 131,Residential,29700,0,29700,74485,0,104185
141025501800000,NE 131,Residential,29700,0,29700,69476,0,99176
141025501900000,NE 131,Residential,29700,0,29700,65317,0,95017
141025502000000,NE 131,Residential,29700,0,29700,69407,0,99107
141025502100000,NE 131,Residential,29700,0,29700,70599,0,100299
141025502200000,NE 131,Residential,29700,0,29700,90248,0,119948
141025502300000,NE 131,Residential,29700,0,29700,92332,0,122032
141025502400000,NE 132,Residential,27540,0,27540,47890,0,75430
141025502500000,NE 132,Residential,29952,0,29952,79564,0,109516
141025502600000,NE 132,Residential,36115,0,36115,60308,0,96423
141025502700000,NE 132,Residential,29970,0,29970,57995,0,87965
141025502800000,NE 132,Residential,28936,0,28936,46275,0,75211
141025502900000,NE 132,Residential,27027,0,27027,51975,0,79002
141025503000000,NE 132,Residential,30450,0,30450,51325,0,81775
141025503100000,NE 132,Residential,33784,0,33784,52384,0,86168
141025503200000,NE 132,Residential,29187,0,29187,47573,0,76760
141025503300000,NE 132,Residential,29952,0,29952,63716,0,93668
141025503400000,NE 132,Residential,37395,0,37395,49504,0,86899
141025600100000,NE 132,Residential,30070,0,30070,99846,0,129916
141025600200000,NE 132,Residential,28665,0,28665,50804,0,79469
141025600300000,NE 132,Residential,29581,0,29581,62880,0,92461
141025600400000,NE 132,Residential,25110,0,25110,48320,0,73430
141025600500000,NE 132,Residential,26064,0,26064,57817,0,83881
141025600600000,NE 132,Residential,27846,0,27846,71194,0,99040
141025600700000,NE 132,Residential,28704,0,28704,43163,0,71867
141025600800000,NE 132,Residential,26730,0,26730,66673,0,93403
141025600900000,NE 132,Residential,25920,0,25920,43929,0,69849
141025601000000,NE 132,Residential,29952,0,29952,58920,0,88872
141025601100000,NE 132,Residential,25389,0,25389,108777,0,134166
141025601200000,NE 132,Residential,27437,0,27437,94277,0,121714
141025601300000,NE 132,Residential,27852,0,27852,80368,0,108220
141025601400000,NE 132,Residential,31661,0,31661,117984,0,149645
141025601500000,NE 132,Residential,24703,0,24703,81831,0,106534
141025601600000,NE 132,Residential,27241,0,27241,80491,0,107732
141025601700000,NE 132,Residential,31304,0,31304,114707,0,146011
141025601800000,DAY CARE CENTER,Commercial,0,27341,27341,0,115442,142783
141025601900000,NE 132,Residential,29329,0,29329,88378,0,117707
141025602000000,NE 132,Residential,27550,0,27550,103457,0,131007
141025602100000,NE 132,Residential,27151,0,27151,64003,0,91154
141025602200000,NE 132,Residential,28186,0,28186,69217,0,97403
141025602300000,NE 132,Residential,27533,0,27533,65533,0,93066
141025700100000,NE 132,Residential,29610,0,29610,63202,0,92812
141025700200000,NE 132,Residential,27918,0,27918,56203,0,84121
141025700300000,NE 132,Residential,32075,0,32075,92925,0,125000
141025700400000,NE 132,Residential,30467,0,30467,128253,0,158720
141025700500000,NE 132,Residential,34112,0,34112,84313,0,118425
141025700600000,NE 132,Residential,39824,0,39824,205483,0,245307
141025700700000,NE 132,Residential,36353,0,36353,129483,0,165836
141025700800000,NE 132,Residential,30740,0,30740,48727,0,79467
141025700900000,NE 132,Residential,26010,0,26010,67121,0,93131
141025701000000,NE 132,Residential,27693,0,27693,82909,0,110602
141025701100000,NE 132,Residential,30210,0,30210,66331,0,96541
141027600100000,GOLF COURSE,Commercial,0,528601,528601,0,2921094,3449695
141027600200000,NE 131,Residential,24750,0,24750,61250,0,86000
141027600300000,NE 131,Residential,24750,0,24750,91502,0,116252
141027600400000,NE 131,Residential,32175,0,32175,104409,0,136584
141027600500000,NE 131,Residential,32175,0,32175,86522,0,118697
141027600600000,NE 131,Residential,32175,0,32175,133777,0,165952
141027600700000,NE 131,Residential,31705,0,31705,102079,0,133784
141027600800000,NE 131,Residential,29700,0,29700,110956,0,140656
141027600900000,NE 131,Residential,29700,0,29700,92979,0,122679
141027601000000,NE 131,Residential,38610,0,38610,128216,0,166826
141027601100000,NE 131,Residential,33660,0,33660,83361,0,117021
141027601200000,NE 131,Residential,37125,0,37125,119173,0,156298
141027601300000,NE 131,Residential,29700,0,29700,74987,0,104687
141027601400000,NE 131,Residential,29700,0,29700,87390,0,117090
141027601500000,NE 131,Residential,29700,0,29700,91291,0,120991
141027601600000,NE 131,Residential,29700,0,29700,61368,0,91068
141027601700000,NE 131,Residential,29700,0,29700,57697,0,87397
141027601800000,NE 131,Residential,29700,0,29700,74371,0,104071
141027601900000,NE 131,Residential,30598,0,30598,63597,0,94195
141030100100000,NE 131,Residential,18311,0,18311,46835,0,65146
141030100200000,NE 131,Residential,22725,0,22725,69055,0,91780
141030100300000,NE 131,Residential,35200,0,35200,60864,0,96064
141030100400000,NE 131,Residential,26765,0,26765,57158,0,83923
141030100500000,NE 131,Residential,27270,0,27270,68724,0,95994
141030100600000,NE 131,Residential,28280,0,28280,91606,0,119886
141030100700000,NE 131,Residential,38885,0,38885,64391,0,103276
141030100800000,NE 131,Residential,40400,0,40400,83684,0,124084
141030100900000,NE 131,Residential,32320,0,32320,64882,0,97202
141030101000000,NE 131,Residential,32320,0,32320,38432,0,70752
141030101100000,NE 131,Residential,39600,0,39600,82268,0,121868
141030101200000,NE 131,Residential,40400,0,40400,79326,0,119726
141030101300000,NE 131,Residential,40400,0,40400,109580,0,149980
141030101400000,NE 131,Residential,40400,0,40400,99604,0,140004
141030101500000,NE 131,Residential,32320,0,32320,163667,0,195987
141030101600000,NE 131,Residential,40000,0,40000,103348,0,143348
141030101700000,NE 131,Residential,32320,0,32320,51649,0,83969
141030101800000,NE 131,Residential,32320,0,32320,70063,0,102383
141030101900000,NE 131,Residential,32320,0,32320,54953,0,87273
141030102000000,NE 131,Residential,32960,0,32960,36961,0,69921
141030102100000,NE 131,Residential,40000,0,40000,77582,0,117582
141030102200000,NE 131,Residential,40000,0,40000,85196,0,125196
141030102300000,NE 131,Residential,34424,0,34424,107648,0,142072
141030102400000,NE 131,Residential,32724,0,32724,76711,0,109435
141030102500000,NE 131,Residential,18584,0,18584,76143,0,94727
141030102600000,NE 131,Residential,21816,0,21816,92143,0,113959
141030102700000,NE 131,Residential,21412,0,21412,73516,0,94928
141030102800000,NE 131,Residential,34560,0,34560,115383,0,149943
141030102900000,NE 131,Residential,21054,0,21054,90466,0,111520
141030103000000,NE 131,Residential,19346,0,19346,109563,0,128909
141030103100000,NE 131,Residential,24240,0,24240,79011,0,103251
141030103200000,NE 131,Residential,17672,0,17672,47220,0,64892
141030103300000,NE 131,Residential,17672,0,17672,47424,0,65096
141030200100000,NE 131,Residential,40400,0,40400,119208,0,159608
141030200200000,NE 131,Residential,40400,0,40400,87376,0,127776
141030200300000,NE 131,Residential,21816,0,21816,85823,0,107639
141030200400000,NE 131,Residential,32320,0,32320,73599,0,105919
141030300100000,CENTRALLY ASSESSED,Other,0,0,0,0,0,0
141030300200000,NE 131,Residential,16000,0,16000,45106,0,61106
141030300300000,NE 131,Residential,24000,0,24000,84625,0,108625
141030300400000,NE 131,Residential,32000,0,32000,46140,0,78140
141030300500000,NE 131,Residential,32000,0,32000,109087,0,141087
141030300600000,NE 131,Residential,32000,0,32000,113444,0,145444
141030300700000,NE 131,Residential,32000,0,32000,81452,0,113452
141030300800000,NE 131,Residential,32000,0,32000,62722,0,94722
141030300900000,NE 131,Residential,32000,0,32000,88637,0,120637
141030301000000,NE 131,Residential,33280,0,33280,73040,0,106320
141030301200000,NE 131,Residential,28560,0,28560,58348,0,86908
141030301300000,NE 131,Residential,32640,0,32640,93237,0,125877
141030301400000,NE 131,Residential,32188,0,32188,149812,0,182000
141030301500000,NE 131,Residential,38080,0,38080,121056,0,159136
141030301600000,NE 131,Residential,32000,0,32000,108328,0,140328
141030301700000,NE 131,Residential,31360,0,31360,101439,0,132799
141030301800000,NE 131,Residential,30400,0,30400,111993,0,142393
141030301900000,NE 131,Residential,32000,0,32000,101441,0,133441
141030302000000,NE 131,Residential,32000,0,32000,100432,0,132432
141030302100000,NE 131,Residential,32000,0,32000,110499,0,142499
141030302200000,NE 131,Residential,32000,0,32000,92324,0,124324
141030302300000,NE 131,Residential,24000,0,24000,102093,0,126093
141030302400000,NE 131,Residential,24000,0,24000,84092,0,108092
141030302500000,NE 131,Residential,16000,0,16000,47099,0,63099
141030302600000,NE 131,Residential,24000,0,24000,78246,0,102246
141030302700000,NE 131,Residential,35640,0,35640,80243,0,115883
141030302800000,NE 131,Residential,19612,0,19612,135798,0,155410
141030302900000,NE 131,Residential,19608,0,19608,140807,0,160415
141030400100000,NE 131,Residential,21280,0,21280,56799,0,78079
141030400200000,NE 131,Residential,32640,0,32640,93854,0,126494
141030400300000,NE 131,Residential,31360,0,31360,92334,0,123694
141030400400000,NE 131,Residential,21280,0,21280,37006,0,58286
141030400500000,NE 131,Residential,21280,0,21280,44885,0,66165
141030400600000,NE 131,Residential,21280,0,21280,53609,0,74889
141030500100000,NE 131,Residential,21280,0,21280,55189,0,76469
141030500200000,NE 131,Residential,28000,0,28000,230689,0,258689
141030500300000,NE 131,Residential,20000,0,20000,63466,0,83466
141030500400000,NE 131,Residential,16000,0,16000,80120,0,96120
141030500500000,NE 131,Residential,20680,0,20680,85820,0,106500
141030500600000,NE 131,Residential,20680,0,20680,91678,0,112358
141030500700000,NE 131,Residential,20000,0,20000,105017,0,125017
141030500800000,NE 131,Exempt,0,31360,31360,0,118584,149944
141030500900000,NE 131,Residential,23520,0,23520,107596,0,131116
141030501000000,NE 131,Residential,23520,0,23520,86627,0,110147
141030501100000,NE 131,Residential,23520,0,23520,89246,0,112766
141030501200000,NE 131,Residential,23520,0,23520,79603,0,103123
141030501300000,NE 131,Residential,24000,0,24000,114549,0,138549
141030501400000,NE 131,Residential,19760,0,19760,77981,0,97741
141030501500000,NE 131,Residential,19600,0,19600,74153,0,93753
141030501600000,NE 131,Residential,28160,0,28160,95497,0,123657
141030501700000,NE 131,Residential,32000,0,32000,81666,0,113666
141030501800000,NE 131,Residential,34560,0,34560,54795,0,89355
141030501900000,NE 131,Residential,28160,0,28160,56353,0,84513
141030502000000,NE 131,Residential,32000,0,32000,60800,0,92800
141030502100000,NE 131,Residential,17280,0,17280,54193,0,71473
141030502200000,NE 131,Residential,17280,0,17280,41751,0,59031
141030502300000,NE 131,Residential,32640,0,32640,84093,0,116733
141030502400000,NE 131,Residential,32000,0,32000,69906,0,101906
141030502500000,NE 131,Residential,32640,0,32640,126531,0,159171
141030502600000,NE 131,Residential,32640,0,32640,96956,0,129596
141030502700000,NE 131,Residential,16320,0,16320,57402,0,73722
141030502800000,NE 131,Residential,16320,0,16320,47185,0,63505
141030502900000,NE 131,Residential,32640,0,32640,99157,0,131797
141030503000000,NE 131,Residential,20000,0,20000,98929,0,118929
141030503100000,NE 131,Residential,36960,0,36960,86461,0,123421
141030503200000,NE 131,Residential,16000,0,16000,39168,0,55168
141030503300000,NE 131,Residential,16000,0,16000,53260,0,69260
141030503400000,NE 131,Residential,32000,0,32000,67863,0,99863
141030503500000,NE 131,Residential,21280,0,21280,61460,0,82740
141030503600000,NE 131,Residential,21280,0,21280,37787,0,59067
141030503700000,NE 131,Residential,21280,0,21280,35695,0,56975
141030600100000,NE 131,Residential,29828,0,29828,100172,0,130000
141030600200000,NE 131,Residential,20800,0,20800,80001,0,100801
141030600300000,NE 131,Residential,19200,0,19200,32295,0,51495
141030600400000,NE 131,Residential,32000,0,32000,45594,0,77594
141030700100000,NE 131,Residential,22693,0,22693,71964,0,94657
141030700200000,NE 131,Residential,20400,0,20400,93956,0,114356
141030700300000,NE 131,Residential,32640,0,32640,121590,0,154230
141030700400000,NE 131,Residential,32640,0,32640,89245,0,121885
141030700500000,NE 131,Residential,32640,0,32640,124010,0,156650
141030700600000,NE 131,Residential,24480,0,24480,59433,0,83913
141030700700000,NE 131,Residential,24480,0,24480,58025,0,82505
141030700800000,NE 131,Residential,33605,0,33605,104211,0,137816
141030700900000,NE 131,Residential,16672,0,16672,45309,0,61981
141030701000000,NE 131,Residential,14280,0,14280,38176,0,52456
141030701100000,NE 131,Residential,14280,0,14280,67727,0,82007
141030701200000,NE 131,Residential,28560,0,28560,55999,0,84559
141030701300000,NE 131,Residential,28560,0,28560,55603,0,84163
141030701400000,NE 131,Residential,28560,0,28560,87197,0,115757
141030701500000,NE 131,Residential,28560,0,28560,68498,0,97058
141030701600000,NE 131,Residential,17850,0,17850,142454,0,160304
141030701700000,NE 131,Residential,21467,0,21467,99472,0,120939
141030701800000,NE 131,Residential,22080,0,22080,89954,0,112034
141030701900000,NE 131,Residential,22080,0,22080,96299,0,118379
141030702000000,NE 131,Residential,22080,0,22080,94061,0,116141
141030800100000,NE 131,Residential,32640,0,32640,84471,0,117111
141030800200000,NE 131,Residential,21746,0,21746,43742,0,65488
141030800300000,NE 131,Residential,16320,0,16320,47123,0,63443
141030800400000,NE 131,Residential,32640,0,32640,57016,0,89656
141030800500000,NE 131,Residential,32640,0,32640,75740,0,108380
141030800600000,NE 131,Residential,16320,0,16320,53033,0,69353
141030800700000,NE 131,Residential,16320,0,16320,26631,0,42951
141030800800000,NE 131,Residential,16320,0,16320,21404,0,37724
141030800900000,NE 131,Residential,14280,0,14280,51662,0,65942
141030801000000,NE 131,Residential,14280,0,14280,82050,0,96330
141030801100000,NE 131,Residential,14280,0,14280,39743,0,54023
141030801200000,NE 131,Residential,14280,0,14280,49441,0,63721
141030801300000,NE 131,Residential,14280,0,14280,52663,0,66943
141030801400000,NE 131,Residential,14280,0,14280,42374,0,56654
141030801500000,NE 131,Residential,14280,0,14280,60908,0,75188
141030801600000,NE 131,Residential,14280,0,14280,46999,0,61279
141030801700000,NE 131,Residential,19028,0,19028,62848,0,81876
141030801800000,NE 131,Residential,28560,0,28560,84720,0,113280
141030900100000,NE 131,Residential,16320,0,16320,48910,0,65230
141030900200000,NE 131,Residential,16320,0,16320,52728,0,69048
141030900300000,NE 131,Residential,30400,0,30400,117510,0,147910
141030900400000,NE 131,Residential,30240,0,30240,53002,0,83242
141030900500000,NE 131,Residential,14280,0,14280,65573,0,79853
141030900600000,NE 131,Residential,14280,0,14280,67478,0,81758
141032600100000,NE 131,Residential,40400,0,40400,91396,0,131796
141032600200000,NE 131,Residential,40000,0,40000,103695,0,143695
141032600300000,NE 131,Residential,40400,0,40400,103992,0,144392
141032600400000,NE 131,Residential,40000,0,40000,90122,0,130122
141032600500000,NE 131,Residential,39600,0,39600,99853,0,139453
141032600600000,NE 131,Residential,40800,0,40800,79675,0,120475
141032600700000,NE 131,Residential,40800,0,40800,90492,0,131292
141032600800000,NE 131,Residential,40800,0,40800,86155,0,126955
141032600900000,NE 131,Residential,37600,0,37600,62000,0,99600
141032601000000,NE 131,Residential,30400,0,30400,57520,0,87920
141032601100000,NE 131,Residential,18459,0,18459,50862,0,69321
141032601200000,CHURCH,Exempt,0,71366,71366,0,0,71366
141032601300000,CHURCH,Exempt,0,31752,31752,0,60534,92286
141032601400000,NE 131,Residential,17675,0,17675,65589,0,83264
141032601500000,NE 131,Residential,32000,0,32000,99490,0,131490
141032601600000,NE 131,Residential,32800,0,32800,55540,0,88340
141032601700000,NE 131,Residential,17600,0,17600,78261,0,95861
141032601800000,NE 131,Residential,17600,0,17600,71161,0,88761
141032601900000,NE 131,Residential,32000,0,32000,74438,0,106438
141032602000000,NE 131,Residential,32000,0,32000,73835,0,105835
141032602100000,NE 131,Residential,32000,0,32000,104939,0,136939
141032602200000,NE 131,Residential,32960,0,32960,102015,0,134975
141032602300000,NE 131,Residential,20200,0,20200,63241,0,83441
141032602400000,NE 131,Residential,24240,0,24240,123454,0,147694
141032602500000,NE 131,Residential,20200,0,20200,59520,0,79720
141032602600000,NE 131,Residential,32640,0,32640,57044,0,89684
141032602700000,NE 131,Residential,21412,0,21412,67911,0,89323
141032602800000,NE 131,Residential,21412,0,21412,82035,0,103447
141032700100000,NE 131,Residential,14409,0,14409,91607,0,106016
141032700200000,NE 132,Residential,31652,0,31652,110886,0,142538
141032700300000,NE 131,Residential,14850,0,14850,62544,0,77394
141032700400000,NE 131,Residential,13500,0,13500,104558,0,118058
141032700500000,NE 131,Residential,13500,0,13500,64338,0,77838
141032700600000,NE 131,Residential,14799,0,14799,46592,0,61391
141032700700000,NE 131,Residential,13187,0,13187,88991,0,102178
141032700800000,NE 131,Residential,14292,0,14292,88512,0,102804
141032800100000,NE 131,Residential,32000,0,32000,105375,0,137375
141032800200000,NE 131,Residential,34000,0,34000,66960,0,100960
141032800300000,NE 131,Residential,30000,0,30000,48096,0,78096
141032800400000,NE 131,Residential,21200,0,21200,89828,0,111028
141032800500000,NE 131,Residential,21200,0,21200,85260,0,106460
141032800600000,NE 131,Residential,21600,0,21600,68932,0,90532
141032800700000,NE 131,Residential,32000,0,32000,78681,0,110681
141032800800000,NE 131,Residential,32000,0,32000,101286,0,133286
141032800900000,NE 131,Residential,32000,0,32000,85482,0,117482
141032801000000,NE 131,Residential,32000,0,32000,113998,0,145998
141032801100000,NE 131,Residential,16320,0,16320,53393,0,69713
141032801200000,NE 131,Residential,16320,0,16320,75831,0,92151
141032801300000,NE 131,Residential,33280,0,33280,85758,0,119038
141032801400000,NE 131,Residential,24640,0,24640,0,0,24640
141032801500000,NE 131,Residential,16100,0,16100,81309,0,97409
141032801600000,NE 131,Residential,21188,0,21188,86413,0,107601
141032801700000,NE 131,Residential,18850,0,18850,102602,0,121452
141032801800000,NE 131,Residential,20650,0,20650,70047,0,90697
141032801900000,NE 131,Residential,30720,0,30720,114225,0,144945
141032802000000,NE 131,Residential,31360,0,31360,114225,0,145585
141032802100000,NE 131,Residential,16000,0,16000,87728,0,103728
141032802200000,NE 131,Residential,24000,0,24000,68632,0,92632
141032802300000,NE 131,Residential,24000,0,24000,69225,0,93225
141032802400000,NE 131,Residential,32000,0,32000,64805,0,96805
141032802500000,NE 131,Residential,32000,0,32000,93873,0,125873
141032802600000,NE 131,Residential,21600,0,21600,110843,0,132443
141032802700000,NE 131,Residential,21200,0,21200,91042,0,112242
141032802800000,NE 131,Residential,21200,0,21200,78142,0,99342
141032802900000,NE 131,Residential,24000,0,24000,95865,0,119865
141032803000000,NE 131,Residential,24000,0,24000,101007,0,125007
141032803100000,NE 131,Residential,24000,0,24000,114293,0,138293
141032803200000,NE 131,Residential,24000,0,24000,76239,0,100239
141032900100000,NE 131,Residential,13200,0,13200,71713,0,84913
141032900200000,NE 131,Residential,12720,0,12720,97026,0,109746
141032900300000,NE 131,Residential,12240,0,12240,93809,0,106049
141032900400000,NE 131,Residential,12960,0,12960,58701,0,71661
141032900500000,NE 131,Residential,9450,0,9450,0,0,9450
141032900600000,OFFICE,Commercial,0,127008,127008,0,588683,715691
141033000100000,NE 131,Residential,20800,0,20800,108197,0,128997
141033000200000,NE 131,Residential,24000,0,24000,100392,0,124392
141033000300000,NE 131,Residential,24000,0,24000,113269,0,137269
141033000400000,NE 131,Residential,19640,0,19640,88084,0,107724
141033000500000,NE 131,Residential,19400,0,19400,61601,0,81001
141033000600000,NE 131,Residential,26320,0,26320,78329,0,104649
141033000700000,NE 131,Residential,25200,0,25200,74894,0,100094
141033000800000,NE 131,Residential,19000,0,19000,74804,0,93804
141033000900000,NE 131,Residential,24000,0,24000,82409,0,106409
141033001000000,NE 131,Residential,32000,0,32000,89349,0,121349
141033001100000,NE 131,Residential,32000,0,32000,100048,0,132048
141033001200000,NE 131,Residential,31360,0,31360,112793,0,144153
141033001300000,NE 131,Residential,32000,0,32000,107816,0,139816
141033001400000,NE 131,Residential,32000,0,32000,85444,0,117444
141033001500000,NE 131,Residential,30041,0,30041,21631,0,51672
141033001600000,NE 131,Residential,18025,0,18025,49993,0,68018
141033001700000,NE 131,Residential,21350,0,21350,52776,0,74126
141033001800000,APARTMENT,Residential,17334,0,17334,287666,0,305000
141033001900000,APARTMENT,Residential,13176,0,13176,166278,0,179454
141033002000000,APARTMENT,Residential,10206,0,10206,152742,0,162948
141033002100000,NE 131,Residential,14000,0,14000,28398,0,42398
141033002300000,NE 131,Residential,29400,0,29400,102353,0,131753
141033002500000,NE 131,Residential,14000,0,14000,27311,0,41311
141033002600000,NE 131,Residential,37600,0,37600,125211,0,162811
141033002700000,NE 131,Residential,26400,0,26400,38691,0,65091
141033002800000,NE 131,Residential,32640,0,32640,34198,0,66838
141033002900000,NE 131,Residential,32000,0,32000,57911,0,89911
141033003000000,NE 131,Residential,32000,0,32000,42999,0,74999
141033003100000,NE 131,Residential,24000,0,24000,61824,0,85824
141033003200000,NE 131,Residential,20800,0,20800,54521,0,75321
141033003300000,NE 131,Residential,22560,0,22560,95570,0,118130
141033003400000,NE 131,Residential,29400,0,29400,50525,0,79925
141033003500000,NE 131,Residential,32960,0,32960,82402,0,115362
141033003600000,NE 131,Residential,32000,0,32000,97896,0,129896
141033003700000,NE 131,Residential,32000,0,32000,87592,0,119592
141033003800000,NE 131,Residential,12800,0,12800,55634,0,68434
141033100100000,NE 131,Residential,30400,0,30400,78354,0,108754
141033100200000,NE 131,Residential,16320,0,16320,77146,0,93466
141033100300000,NE 131,Residential,16320,0,16320,70377,0,86697
141033100400000,NE 131,Residential,30076,0,30076,116031,0,146107
141033100500000,NE 131,Residential,16320,0,16320,67514,0,83834
141033100600000,NE 131,Residential,16320,0,16320,64456,0,80776
141033100700000,NE 131,Residential,33600,0,33600,99500,0,133100
141033100800000,NE 131,Residential,16800,0,16800,45246,0,62046
141033100900000,NE 131,Residential,16320,0,16320,56509,0,72829
141033101000000,NE 131,Residential,32000,0,32000,132402,0,164402
141033101100000,NE 131,Residential,33590,0,33590,143172,0,176762
141033101200000,NE 131,Residential,32640,0,32640,106707,0,139347
141033101300000,NE 131,Residential,32640,0,32640,83111,0,115751
141033101400000,NE 131,Residential,28160,0,28160,91603,0,119763
141033101600000,NE 131,Residential,24320,0,24320,47842,0,72162
141033101700000,LG DISCOUNT/RETAIL,Commercial,0,554040,554040,0,371435,925475
141033101800000,NE 131,Residential,30800,0,30800,66334,0,97134
141033102000000,NE 131,Residential,31080,0,31080,51794,0,82874
141033102100000,NE 131,Residential,28560,0,28560,95479,0,124039
141033102200000,NE 131,Residential,28560,0,28560,77722,0,106282
141033102300000,NE 131,Residential,25199,0,25199,51459,0,76658
141033102400000,NE 131,Residential,29120,0,29120,37921,0,67041
141033102500000,NE 131,Residential,14280,0,14280,67525,0,81805
141033102600000,NE 131,Residential,28560,0,28560,61668,0,90228
141033102700000,NE 131,Residential,29382,0,29382,70257,0,99639
141033102800000,NE 131,Residential,28560,0,28560,78086,0,106646
141033102900000,NE 131,Residential,30240,0,30240,68482,0,98722
141035100100000,NE 143,Residential,23331,0,23331,119125,0,142456
141035100200000,NE 143,Residential,15708,0,15708,93476,0,109184
141035100300000,NE 143,Residential,15708,0,15708,76743,0,92451
141035100400000,NE 143,Residential,15708,0,15708,66514,0,82222
141035100500000,NE 143,Residential,27720,0,27720,110281,0,138001
141035100600000,NE 143,Residential,28182,0,28182,63188,0,91370
141035100700000,NE 143,Residential,35228,0,35228,92453,0,127681
141035100800000,NE 143,Residential,29164,0,29164,109446,0,138610
141035100900000,NE 143,Residential,29164,0,29164,119374,0,148538
141035101000000,NE 143,Residential,35228,0,35228,82475,0,117703
141035101100000,NE 143,Residential,28182,0,28182,91018,0,119200
141035101200000,NE 143,Residential,28182,0,28182,99693,0,127875
141035101300000,NE 143,Residential,24717,0,24717,40465,0,65182
141035101400000,NE 143,Residential,23562,0,23562,45206,0,68768
141035101500000,NE 143,Residential,23331,0,23331,69021,0,92352
141035101600000,NE 143,Residential,27720,0,27720,78335,0,106055
141035101700000,NE 143,Residential,28182,0,28182,68555,0,96737
141035101800000,NE 143,Residential,30744,0,30744,97783,0,128527
141035101900000,NE 143,Residential,4389,0,4389,0,0,4389
141035102000000,NE 143,Residential,4620,0,4620,0,0,4620
141035102100000,NE 143,Residential,3465,0,3465,0,0,3465
141035102200000,NE 143,Residential,6064,0,6064,0,0,6064
141035102300000,NE 143,Residential,6064,0,6064,0,0,6064
141035102400000,NE 143,Residential,28000,0,28000,239037,0,267037
141035102500000,NE 143,Residential,24800,0,24800,94455,0,119255
141035102600000,NE 143,Residential,26664,0,26664,120375,0,147039
141035200100000,NE 143,Residential,27428,0,27428,112427,0,139855
141035200200000,NE 143,Residential,32208,0,32208,78929,0,111137
141035200400000,NE 143,Residential,32208,0,32208,144171,0,176379
141035200500000,NE 143,Residential,3300,0,3300,0,0,3300
141035200600000,NE 143,Residential,3300,0,3300,0,0,3300
141035200700000,NE 143,Residential,26840,0,26840,95698,0,122538
141035200800000,NE 143,Residential,26840,0,26840,103385,0,130225
141035200900000,NE 143,Residential,4620,0,4620,0,0,4620
141035201000000,NE 143,Residential,6930,0,6930,0,0,6930
141035201100000,NE 143,Residential,31424,0,31424,85479,0,116903
141035201200000,NE 143,Residential,34560,0,34560,72396,0,106956
141035201300000,NE 143,Residential,4560,0,4560,0,0,4560
141035201400000,NE 143,Residential,28800,0,28800,100881,0,129681
141035201500000,NE 143,Residential,30976,0,30976,75411,0,106387
141035201600000,NE 143,Residential,29280,0,29280,89851,0,119131
141035201700000,NE 143,Residential,29280,0,29280,95290,0,124570
141035201800000,NE 143,Residential,29280,0,29280,88477,0,117757
141035201900000,NE 143,Residential,28800,0,28800,96416,0,125216
141035202000000,OFFICE,Commercial,0,53266,53266,0,409935,463201
141035202100000,NE 143,Residential,24240,0,24240,53994,0,78234
141035202200000,NE 143,Residential,24240,0,24240,122043,0,146283
141035202300000,NE 143,Residential,24240,0,24240,91856,0,116096
141035202400000,NE 143,Residential,33330,0,33330,77588,0,110918
141035202500000,NE 143,Residential,22220,0,22220,81296,0,103516
141035202600000,NE 143,Residential,16830,0,16830,57861,0,74691
141035202700000,NE 143,Residential,16830,0,16830,34219,0,51049
141035202800000,NE 143,Residential,34433,0,34433,116567,0,151000
141035202900000,NE 143,Residential,27600,0,27600,117917,0,145517
141035203000000,NE 143,Residential,18622,0,18622,0,0,18622
141035203100000,NE 143,Residential,26866,0,26866,65605,0,92471
141035300100000,NE 143,Residential,21223,0,21223,107772,0,128995
141035300200000,NE 143,Residential,19920,0,19920,111867,0,131787
141035300300000,NE 143,Residential,29293,0,29293,114814,0,144107
141035300400000,NE 143,Residential,25086,0,25086,114724,0,139810
141035300500000,NE 143,Residential,25931,0,25931,108578,0,134509
141035300600000,NE 143,Residential,24240,0,24240,79625,0,103865
141035300700000,NE 143,Residential,24240,0,24240,100002,0,124242
141035300800000,NE 143,Residential,29088,0,29088,98584,0,127672
141035300900000,NE 143,Residential,36026,0,36026,119467,0,155493
141035301000000,NE 143,Residential,33752,0,33752,125858,0,159610
141035301100000,NE 143,Residential,36225,0,36225,152201,0,188426
141035301200000,NE 143,Residential,35350,0,35350,129759,0,165109
141035301300000,NE 143,Residential,35350,0,35350,100036,0,135386
141035301400000,NE 143,Residential,35397,0,35397,100280,0,135677
141035301500000,NE 143,Residential,35350,0,35350,121222,0,156572
141035301600000,NE 143,Residential,33121,0,33121,139879,0,173000
141035301700000,NE 143,Residential,35288,0,35288,114803,0,150091
141035301800000,NE 143,Residential,28709,0,28709,111475,0,140184
141035400100000,NE 143,Residential,24981,0,24981,88432,0,113413
141035400200000,NE 143,Residential,24240,0,24240,127215,0,151455
141035400300000,NE 143,Residential,30704,0,30704,130435,0,161139
141035400400000,NE 143,Residential,29189,0,29189,90116,0,119305
141035400500000,NE 143,Residential,24240,0,24240,107094,0,131334
141035400600000,NE 143,Residential,24240,0,24240,77431,0,101671
141035400700000,NE 143,Residential,24240,0,24240,90988,0,115228
141035400800000,NE 143,Residential,34728,0,34728,123988,0,158716
141035400900000,NE 143,Residential,33559,0,33559,72632,0,106191
141035401000000,NE 143,Residential,30300,0,30300,63063,0,93363
141035401100000,NE 143,Residential,30300,0,30300,106632,0,136932
141035401200000,NE 143,Residential,26260,0,26260,61963,0,88223
141035401300000,NE 143,Residential,26260,0,26260,85562,0,111822
141035401400000,NE 143,Residential,26260,0,26260,51152,0,77412
141035401500000,NE 143,Residential,26765,0,26765,60025,0,86790
141035401600000,NE 143,Residential,26260,0,26260,62771,0,89031
141035401700000,NE 143,Residential,26765,0,26765,81288,0,108053
141035401800000,NE 143,Residential,26260,0,26260,66913,0,93173
141035401900000,NE 143,Residential,26193,0,26193,79335,0,105528
141035500100000,NE 143,Residential,31310,0,31310,100314,0,131624
141035500200000,NE 143,Residential,32825,0,32825,132360,0,165185
141035500300000,NE 143,Residential,35981,0,35981,104850,0,140831
141035500400000,NE 143,Residential,35981,0,35981,88347,0,124328
141035500500000,NE 143,Residential,36234,0,36234,113108,0,149342
141035500600000,NE 143,Residential,36627,0,36627,152373,0,189000
141035500700000,NE 143,Residential,35981,0,35981,124182,0,160163
141035500800000,NE 143,Residential,33330,0,33330,109890,0,143220
141035500900000,NE 143,Residential,37047,0,37047,152822,0,189869
141035501000000,NE 143,Residential,35087,0,35087,104647,0,139734
141035501100000,NE 143,Residential,27270,0,27270,93393,0,120663
141035501200000,NE 143,Residential,27270,0,27270,102860,0,130130
141035501300000,NE 143,Residential,24240,0,24240,52801,0,77041
141035501400000,NE 143,Residential,24240,0,24240,55290,0,79530
141035501500000,NE 143,Residential,27270,0,27270,81299,0,108569
141035501600000,NE 143,Residential,24240,0,24240,59594,0,83834
141035501700000,NE 143,Residential,27270,0,27270,73530,0,100800
141035501800000,NE 143,Residential,30300,0,30300,73183,0,103483
141035501900000,NE 143,Residential,30300,0,30300,68434,0,98734
141035502000000,NE 143,Residential,31226,0,31226,98834,0,130060
141035502100000,NE 143,Residential,29824,0,29824,105422,0,135246
141035502200000,NE 143,Residential,27270,0,27270,85760,0,113030
141035502300000,NE 143,Residential,27357,0,27357,96110,0,123467
141035502400000,NE 143,Residential,27270,0,27270,83114,0,110384
141035502500000,NE 143,Residential,27270,0,27270,82472,0,109742
141035502600000,NE 143,Residential,27270,0,27270,130710,0,157980
141035502700000,NE 143,Residential,27385,0,27385,82725,0,110110
141035502800000,NE 143,Residential,27270,0,27270,91142,0,118412
141035502900000,NE 143,Residential,27270,0,27270,97277,0,124547
141035503000000,NE 143,Residential,33224,0,33224,119402,0,152626
141035503100000,NE 143,Residential,33430,0,33430,103576,0,137006
141035503200000,NE 143,Residential,31815,0,31815,92796,0,124611
141035503300000,NE 143,Residential,34087,0,34087,159820,0,193907
141035503400000,NE 143,Residential,34087,0,34087,75482,0,109569
141035503500000,NE 143,Residential,34087,0,34087,126632,0,160719
141035503600000,NE 143,Residential,22725,0,22725,83809,0,106534
141035503700000,NE 143,Residential,22725,0,22725,64926,0,87651
141035503800000,NE 143,Residential,34951,0,34951,104261,0,139212
141037600100000,NE 142,Residential,16663,0,16663,113398,0,130061
141037600200000,NE 143,Residential,3430,0,3430,0,0,3430
141037600300000,NE 143,Residential,6370,0,6370,0,0,6370
141037600400000,NE 143,Residential,6930,0,6930,0,0,6930
141037700100000,NE 143,Residential,22591,0,22591,60085,0,82676
141037700200000,NE 143,Residential,21210,0,21210,134553,0,155763
141037700300000,NE 143,Residential,20267,0,20267,100324,0,120591
141037700400000,NE 143,Residential,28395,0,28395,127066,0,155461
141037700500000,NE 143,Residential,21952,0,21952,105246,0,127198
141037700600000,NE 143,Residential,21210,0,21210,87443,0,108653
141037700700000,NE 143,Residential,21666,0,21666,92901,0,114567
141037700800000,NE 143,Residential,25121,0,25121,82777,0,107898
141037700900000,NE 143,Residential,24240,0,24240,89990,0,114230
141037701000000,NE 143,Residential,24664,0,24664,144834,0,169498
141037701100000,NE 143,Residential,29170,0,29170,532,0,29702
141037701200000,NE 143,Residential,14088,0,14088,46970,0,61058
141037701300000,NE 143,Residential,2730,0,2730,35874,0,38604
141037701400000,NE 143,Residential,21420,0,21420,45021,0,66441
141037701500000,NE 143,Residential,19959,0,19959,96160,0,116119
141037800100000,NE 143,Residential,19615,0,19615,57250,0,76865
141037800200000,NE 143,Residential,15908,0,15908,64289,0,80197
141037800300000,NE 143,Residential,17675,0,17675,53269,0,70944
141037800400000,NE 143,Residential,15908,0,15908,59199,0,75107
141037800500000,NE 143,Residential,17675,0,17675,61068,0,78743
141037800600000,NE 143,Residential,20402,0,20402,57190,0,77592
141037800700000,NE 143,Residential,23853,0,23853,65947,0,89800
141037800800000,NE 143,Residential,23907,0,23907,90897,0,114804
141037800900000,NE 143,Residential,24960,0,24960,93429,0,118389
141037801000000,NE 143,Residential,29863,0,29863,66355,0,96218
141037801100000,NE 143,Residential,24426,0,24426,74487,0,98913
141037801200000,NE 143,Residential,24992,0,24992,73941,0,98933
141037801300000,NE 143,Residential,25164,0,25164,60308,0,85472
141037801400000,NE 143,Residential,22725,0,22725,51651,0,74376
141037801500000,NE 143,Residential,20453,0,20453,56131,0,76584
141037801600000,NE 143,Residential,22725,0,22725,70618,0,93343
141037801700000,NE 143,Residential,20453,0,20453,65948,0,86401
141037801800000,NE 143,Residential,26231,0,26231,63883,0,90114
141037900100000,NE 143,Residential,19718,0,19718,78539,0,98257
141037900200000,NE 143,Residential,24010,0,24010,62421,0,86431
141037900300000,NE 143,Residential,19400,0,19400,125252,0,144652
141037900400000,NE 143,Residential,31817,0,31817,77683,0,109500
141038000100000,CHURCH,Commercial,0,100440,100440,0,177501,277941
141038000200000,NE 143,Residential,35075,0,35075,59087,0,94162
141038000300000,NE 143,Residential,21052,0,21052,114552,0,135604
141038000400000,NE 143,Residential,20200,0,20200,101976,0,122176
141038000500000,NE 143,Residential,19348,0,19348,105849,0,125197
141038000600000,NE 143,Residential,21052,0,21052,89320,0,110372
141038000700000,NE 143,Residential,20200,0,20200,76627,0,96827
141038000800000,NE 143,Residential,19348,0,19348,107773,0,127121
141038000900000,CHURCH,Exempt,0,7560,7560,0,0,7560
141038100100000,NE 143,Residential,25152,0,25152,81160,0,106312
141038100200000,NE 143,Residential,20453,0,20453,56349,0,76802
141038100300000,NE 143,Residential,22725,0,22725,52757,0,75482
141038100400000,NE 143,Residential,20453,0,20453,56993,0,77446
141038100500000,NE 143,Residential,22725,0,22725,51674,0,74399
141038100600000,NE 143,Residential,26197,0,26197,60405,0,86602
141038100700000,NE 143,Residential,25500,0,25500,58834,0,84334
141038100800000,NE 143,Residential,26100,0,26100,57674,0,83774
141038100900000,NE 143,Residential,21750,0,21750,52638,0,74388
141038101000000,NE 143,Residential,20680,0,20680,48411,0,69091
141038101100000,NE 143,Residential,25149,0,25149,59077,0,84226
141038101200000,NE 143,Residential,21856,0,21856,74837,0,96693
141038101300000,NE 143,Residential,21856,0,21856,79367,0,101223
141038101400000,NE 143,Residential,21856,0,21856,81524,0,103380
141038101500000,NE 143,Residential,25566,0,25566,160938,0,186504
141038101600000,NE 143,Residential,26506,0,26506,105560,0,132066
141038101700000,NE 143,Residential,22309,0,22309,60841,0,83150
141038101800000,NE 143,Residential,20200,0,20200,58008,0,78208
141038101900000,NE 143,Residential,18180,0,18180,49710,0,67890
141038102000000,NE 143,Residential,20200,0,20200,60841,0,81041
141038102100000,NE 143,Residential,18180,0,18180,52010,0,70190
141038102200000,NE 143,Residential,23287,0,23287,53932,0,77219
141038200100000,NE 143,Residential,25088,0,25088,174600,0,199688
141038200200000,NE 143,Residential,24240,0,24240,59259,0,83499
141038200300000,NE 143,Residential,24240,0,24240,108348,0,132588
141038200400000,NE 143,Residential,24240,0,24240,127392,0,151632
141038200500000,NE 143,Residential,24590,0,24590,75926,0,100516
141038200600000,NE 143,Residential,25088,0,25088,77451,0,102539
141038200700000,NE 143,Residential,24240,0,24240,76983,0,101223
141038200800000,NE 143,Residential,24240,0,24240,78880,0,103120
141038200900000,NE 143,Residential,24240,0,24240,78996,0,103236
141038201000000,NE 143,Residential,24590,0,24590,105484,0,130074
141038201100000,NE 143,Residential,32741,0,32741,75023,0,107764
141038201200000,NE 143,Residential,30300,0,30300,130075,0,160375
141038201300000,NE 143,Residential,30300,0,30300,86998,0,117298
141038201400000,NE 143,Residential,30300,0,30300,96121,0,126421
141038201500000,NE 143,Residential,29546,0,29546,98454,0,128000
141038201600000,NE 143,Residential,32741,0,32741,103535,0,136276
141038201700000,NE 143,Residential,30300,0,30300,94445,0,124745
141038201800000,NE 143,Residential,30300,0,30300,123472,0,153772
141038201900000,NE 143,Residential,30300,0,30300,90217,0,120517
141038202000000,NE 143,Residential,29290,0,29290,96975,0,126265
141038300100000,NE 143,Residential,27196,0,27196,75255,0,102451
141038300200000,NE 143,Residential,25048,0,25048,106250,0,131298
141038300300000,NE 143,Residential,25048,0,25048,82356,0,107404
141038300400000,NE 143,Residential,24240,0,24240,77616,0,101856
141038300500000,NE 143,Residential,21008,0,21008,42496,0,63504
141038300600000,NE 143,Residential,25086,0,25086,78290,0,103376
141038300700000,NE 143,Residential,24240,0,24240,78394,0,102634
141038300800000,NE 143,Residential,24240,0,24240,93222,0,117462
141038300900000,NE 143,Residential,24240,0,24240,67267,0,91507
141038301000000,NE 143,Residential,24542,0,24542,86413,0,110955
141038301100000,NE 143,Residential,31357,0,31357,120276,0,151633
141038301200000,NE 143,Residential,34840,0,34840,117160,0,152000
141038301300000,NE 143,Residential,30300,0,30300,101577,0,131877
141038301400000,NE 143,Residential,35981,0,35981,129409,0,165390
141038301500000,NE 143,Residential,37557,0,37557,105528,0,143085
141038301600000,NE 143,Residential,32825,0,32825,134701,0,167526
141038301700000,NE 143,Residential,35350,0,35350,114686,0,150036
141038301800000,NE 143,Residential,30300,0,30300,116658,0,146958
141038301900000,NE 143,Residential,30999,0,30999,98407,0,129406
141038400100000,NE 143,Residential,31310,0,31310,120335,0,151645
141038400200000,NE 143,Residential,30300,0,30300,123257,0,153557
141038400300000,NE 143,Residential,30300,0,30300,112555,0,142855
141038400400000,NE 143,Residential,30300,0,30300,88907,0,119207
141038400500000,NE 143,Residential,30637,0,30637,90233,0,120870
141038400600000,NE 143,Residential,31310,0,31310,87297,0,118607
141038400700000,NE 143,Residential,30300,0,30300,72781,0,103081
141038400800000,NE 143,Residential,30300,0,30300,120316,0,150616
141038400900000,NE 143,Residential,30300,0,30300,85834,0,116134
141038401000000,NE 143,Residential,30637,0,30637,88200,0,118837
141038401100000,NE 143,Residential,29361,0,29361,103946,0,133307
141038401200000,NE 143,Residential,27270,0,27270,118415,0,145685
141038401300000,NE 143,Residential,27270,0,27270,117219,0,144489
141038401400000,NE 143,Residential,27270,0,27270,108895,0,136165
141038401500000,NE 143,Residential,26331,0,26331,127688,0,154019
141038401600000,NE 143,Residential,29361,0,29361,114993,0,144354
141038401700000,NE 143,Residential,27270,0,27270,145440,0,172710
141038401800000,NE 143,Residential,26638,0,26638,145751,0,172389
141038401900000,NE 143,Residential,27809,0,27809,127191,0,155000
141038402000000,NE 143,Residential,26118,0,26118,145482,0,171600
141038500100000,NE 143,Residential,31310,0,31310,90876,0,122186
141038500200000,NE 143,Residential,30300,0,30300,115146,0,145446
141038500300000,NE 143,Residential,34144,0,34144,108656,0,142800
141038500400000,NE 143,Residential,35350,0,35350,113995,0,149345
141038500500000,NE 143,Residential,36213,0,36213,155131,0,191344
141038500600000,NE 143,Residential,35350,0,35350,102574,0,137924
141038500700000,NE 143,Residential,30300,0,30300,93792,0,124092
141038500800000,NE 143,Residential,36360,0,36360,118980,0,155340
141038500900000,NE 143,Residential,30586,0,30586,121906,0,152492
141038501000000,NE 143,Residential,28209,0,28209,97125,0,125334
141038501100000,NE 143,Residential,27270,0,27270,87356,0,114626
141038501200000,NE 143,Residential,27270,0,27270,109879,0,137149
141038501300000,NE 143,Residential,27270,0,27270,100417,0,127687
141038501400000,NE 143,Residential,27479,0,27479,98004,0,125483
141038501500000,NE 143,Residential,28179,0,28179,95516,0,123695
141038501600000,NE 143,Residential,27270,0,27270,86105,0,113375
141038501700000,NE 143,Residential,27270,0,27270,103910,0,131180
141038501800000,NE 143,Residential,27270,0,27270,130616,0,157886
141038501900000,NE 143,Residential,27944,0,27944,95421,0,123365
141040100100000,NE 129,Residential,21353,0,21353,89477,0,110830
141040100200000,NE 129,Residential,40660,0,40660,77693,0,118353
141040100300000,NE 129,Residential,40660,0,40660,37119,0,77779
141040100400000,NE 129,Residential,21400,0,21400,50208,0,71608
141040100500000,NE 129,Residential,21400,0,21400,46458,0,67858
141040100600000,NE 129,Residential,21400,0,21400,58127,0,79527
141040100700000,NE 129,Residential,21400,0,21400,89158,0,110558
141040100800000,NE 129,Residential,23005,0,23005,55020,0,78025
141040100900000,NE 129,Residential,19795,0,19795,49171,0,68966
141040101000000,NE 129,Residential,21400,0,21400,75143,0,96543
141040101100000,NE 129,Residential,21400,0,21400,76344,0,97744
141040101200000,NE 129,Residential,32800,0,32800,53903,0,86703
141040101300000,NE 129,Residential,33763,0,33763,73208,0,106971
141040101400000,NE 129,Residential,32100,0,32100,51378,0,83478
141040101500000,NE 129,Residential,26750,0,26750,67507,0,94257
141040101600000,NE 129,Residential,26750,0,26750,90314,0,117064
141040101700000,NE 129,Residential,40765,0,40765,98485,0,139250
141040101800000,NE 129,Residential,21400,0,21400,62685,0,84085
141040101900000,NE 129,Residential,21400,0,21400,69147,0,90547
141040102000000,NE 129,Residential,21400,0,21400,65647,0,87047
141040102100000,NE 129,Residential,21400,0,21400,59246,0,80646
141040102200000,NE 129,Residential,22470,0,22470,68857,0,91327
141040102300000,NE 129,Residential,20330,0,20330,74142,0,94472
141040102400000,NE 129,Residential,32100,0,32100,73667,0,105767
141040102500000,CONVERSION,Commercial,0,11826,11826,0,56614,68440
141040102600000,NE 129,Residential,23715,0,23715,104242,0,127957
141040102700000,NE 129,Residential,19125,0,19125,87799,0,106924
141040102800000,NE 129,Residential,19710,0,19710,82264,0,101974
141040102900000,NE 129,Residential,19710,0,19710,52468,0,72178
141040200100000,NE 129,Residential,22950,0,22950,64790,0,87740
141040200200000,NE 129,Residential,21400,0,21400,73534,0,94934
141040200300000,NE 129,Residential,21400,0,21400,83526,0,104926
141040200400000,NE 129,Residential,32100,0,32100,83762,0,115862
141040200500000,NE 129,Residential,42800,0,42800,59961,0,102761
141040200600000,NE 129,Residential,32100,0,32100,112471,0,144571
141040200700000,NE 129,Residential,24250,0,24250,52270,0,76520
141040200800000,NE 129,Residential,24250,0,24250,55859,0,80109
141040200900000,NE 129,Residential,21250,0,21250,84801,0,106051
141040201000000,NE 129,Residential,21400,0,21400,54904,0,76304
141040201100000,NE 129,Residential,21400,0,21400,85831,0,107231
141040201200000,NE 129,Residential,40660,0,40660,77315,0,117975
141040201300000,NE 129,Residential,37450,0,37450,62998,0,100448
141040201400000,NE 129,Residential,43335,0,43335,114962,0,158297
141040201500000,NE 129,Residential,40660,0,40660,100359,0,141019
141040201600000,NE 129,Residential,40660,0,40660,105864,0,146524
141040201700000,NE 129,Residential,35600,0,35600,89804,0,125404
141040201800000,NE 129,Residential,27375,0,27375,73154,0,100529
141040201900000,NE 129,Residential,22950,0,22950,55863,0,78813
141040202000000,NE 129,Residential,22950,0,22950,58656,0,81606
141040202100000,NE 129,Residential,25500,0,25500,93002,0,118502
141040300100000,NE 129,Residential,30386,0,30386,93617,0,124003
141040300200000,NE 129,Residential,21400,0,21400,111675,0,133075
141040300300000,NE 129,Residential,21400,0,21400,108004,0,129404
141040300400000,NE 129,Residential,21400,0,21400,88972,0,110372
141040300500000,NE 129,Residential,21400,0,21400,78869,0,100269
141040300600000,NE 129,Residential,21400,0,21400,64524,0,85924
141040300700000,NE 129,Residential,21400,0,21400,60897,0,82297
141040300800000,NE 129,Residential,32100,0,32100,79611,0,111711
141040300900000,NE 129,Residential,26750,0,26750,57099,0,83849
141040301000000,NE 129,Residential,26750,0,26750,56444,0,83194
141040301100000,NE 129,Residential,26750,0,26750,88638,0,115388
141040301200000,NE 129,Residential,23500,0,23500,71445,0,94945
141040301300000,NE 129,Residential,28200,0,28200,71096,0,99296
141040301500000,NE 129,Residential,33200,0,33200,78426,0,111626
141040301600000,NE 129,Residential,28355,0,28355,82333,0,110688
141040301700000,NE 129,Residential,28890,0,28890,73883,0,102773
141040301800000,NE 129,Residential,28355,0,28355,68881,0,97236
141040301900000,NE 129,Residential,21400,0,21400,85322,0,106722
141040302000000,NE 129,Residential,21400,0,21400,85033,0,106433
141040302100000,NE 129,Residential,40660,0,40660,107527,0,148187
141040302200000,NE 129,Residential,21400,0,21400,69146,0,90546
141040302300000,NE 129,Residential,21400,0,21400,68047,0,89447
141040302400000,NE 129,Residential,40553,0,40553,66447,0,107000
141040302500000,NE 129,Residential,24638,0,24638,78661,0,103299
141040302600000,NE 129,Residential,36135,0,36135,90018,0,126153
141040302700000,NE 129,Residential,30386,0,30386,77532,0,107918
141040302900000,NE 129,Residential,50967,0,50967,76445,0,127412
141040400100000,NE 129,Residential,35600,0,35600,109846,0,145446
141040400200000,NE 129,Residential,21400,0,21400,54304,0,75704
141040400300000,NE 129,Residential,21400,0,21400,118772,0,140172
141040400400000,NE 129,Residential,22738,0,22738,68245,0,90983
141040400500000,NE 129,Residential,20063,0,20063,97808,0,117871
141040400600000,NE 129,Residential,40660,0,40660,83714,0,124374
141040400700000,NE 129,Residential,21400,0,21400,61140,0,82540
141040401000000,NE 129,Residential,21400,0,21400,45942,0,67342
141040401100000,NE 129,Residential,21400,0,21400,56433,0,77833
141040401200000,NE 129,Residential,21400,0,21400,69258,0,90658
141040401300000,NE 129,Residential,31025,0,31025,85091,0,116116
141040401400000,NE 129,Residential,34000,0,34000,74396,0,108396
141040401500000,NE 129,Residential,26750,0,26750,58928,0,85678
141040401600000,NE 129,Residential,26750,0,26750,66590,0,93340
141040401700000,NE 129,Residential,32100,0,32100,63640,0,95740
141040401800000,NE 129,Residential,21400,0,21400,88804,0,110204
141040401900000,NE 129,Residential,21400,0,21400,60104,0,81504
141040402000000,NE 129,Residential,21400,0,21400,65203,0,86603
141040402100000,NE 129,Residential,21400,0,21400,66951,0,88351
141040402200000,NE 129,Residential,40660,0,40660,81541,0,122201
141040402300000,NE 129,Residential,34000,0,34000,70725,0,104725
141040402500000,NE 129,Residential,32704,0,32704,106308,0,139012
141040402600000,NE 129,Residential,40660,0,40660,96064,0,136724
141040500100000,NE 129,Residential,34000,0,34000,69854,0,103854
141040500200000,NE 129,Residential,23850,0,23850,111016,0,134866
141040500300000,NE 129,Residential,18550,0,18550,94092,0,112642
141040500400000,NE 129,Residential,21200,0,21200,78953,0,100153
141040500500000,NE 129,Residential,21200,0,21200,78788,0,99988
141040500600000,NE 129,Residential,31800,0,31800,86109,0,117909
141040500700000,NE 129,Residential,42400,0,42400,79959,0,122359
141040500800000,NE 129,Residential,21200,0,21200,106934,0,128134
141040500900000,NE 129,Residential,31800,0,31800,82577,0,114377
141040501000000,NE 129,Residential,31800,0,31800,36878,0,68678
141040501100000,NE 129,Residential,40280,0,40280,88696,0,128976
141040501200000,NE 129,Residential,25440,0,25440,75713,0,101153
141040501300000,NE 129,Residential,25440,0,25440,71920,0,97360
141040501400000,NE 129,Residential,16960,0,16960,67835,0,84795
141040501500000,NE 129,Residential,16960,0,16960,66687,0,83647
141040501600000,NE 129,Residential,20352,0,20352,74306,0,94658
141040501700000,NE 129,Residential,30528,0,30528,105064,0,135592
141040501800000,NE 129,Residential,29680,0,29680,68381,0,98061
141040501900000,NE 129,Residential,21200,0,21200,82931,0,104131
141040502000000,NE 129,Residential,16960,0,16960,99909,0,116869
141040502100000,NE 129,Residential,33920,0,33920,108410,0,142330
141040502200000,NE 129,Residential,15680,0,15680,62958,0,78638
141040502300000,NE 129,Residential,15680,0,15680,81959,0,97639
141040502400000,NE 129,Residential,13140,0,13140,52440,0,65580
141040502500000,NE 129,Residential,26280,0,26280,72025,0,98305
141040600100000,NE 129,Residential,18600,0,18600,68606,0,87206
141040600200000,NE 129,Residential,18600,0,18600,67550,0,86150
141040600300000,NE 129,Residential,21200,0,21200,68256,0,89456
141040600400000,NE 129,Residential,21200,0,21200,69060,0,90260
141040600500000,NE 129,Residential,28896,0,28896,88089,0,116985
141040600600000,NE 129,Residential,23850,0,23850,9819,0,33669
141040600700000,NE 129,Residential,31800,0,31800,49015,0,80815
141040600800000,NE 129,Residential,40280,0,40280,112249,0,152529
141040600900000,NE 129,Residential,29150,0,29150,73411,0,102561
141040601000000,NE 129,Residential,27560,0,27560,82181,0,109741
141040601100000,NE 129,Residential,28090,0,28090,103466,0,131556
141040601200000,NE 129,Residential,33920,0,33920,43481,0,77401
141040601300000,NE 129,Residential,33920,0,33920,64233,0,98153
141040601400000,NE 129,Residential,33920,0,33920,98148,0,132068
141040601500000,NE 129,Residential,33920,0,33920,84549,0,118469
141040601600000,NE 129,Residential,33920,0,33920,108954,0,142874
141040601700000,NE 129,Residential,33920,0,33920,104591,0,138511
141040601800000,NE 129,Residential,25280,0,25280,71401,0,96681
141040601900000,NE 129,Residential,32850,0,32850,79417,0,112267
141040602000000,NE 129,Residential,21535,0,21535,54718,0,76253
141042600100000,NE 129,Residential,29200,0,29200,58496,0,87696
141042600200000,NE 129,Residential,40660,0,40660,98393,0,139053
141042600300000,NE 129,Residential,40660,0,40660,63981,0,104641
141042600400000,NE 129,Residential,28355,0,28355,118394,0,146749
141042600500000,NE 129,Residential,28355,0,28355,96814,0,125169
141042600600000,NE 129,Residential,28890,0,28890,64384,0,93274
141042600700000,NE 129,Residential,40660,0,40660,68149,0,108809
141042600800000,NE 129,Residential,40660,0,40660,73038,0,113698
141042600900000,NE 129,Residential,26750,0,26750,69077,0,95827
141042601000000,NE 129,Residential,29425,0,29425,66051,0,95476
141042601100000,NE 129,Residential,29425,0,29425,65528,0,94953
141042601200000,NE 129,Residential,34800,0,34800,56041,0,90841
141042601300000,NE 129,Residential,29200,0,29200,91296,0,120496
141042601400000,NE 129,Residential,38325,0,38325,55205,0,93530
141042700100000,NE 129,Residential,34000,0,34000,75103,0,109103
141042700200000,NE 129,Residential,40660,0,40660,43964,0,84624
141042700300000,NE 129,Residential,21400,0,21400,62245,0,83645
141042700400000,NE 129,Residential,21400,0,21400,60157,0,81557
141042700500000,NE 129,Residential,40660,0,40660,56703,0,97363
141042700600000,NE 129,Residential,40660,0,40660,85465,0,126125
141042700700000,HIGH TECH/RESEARCH,Industrial,0,692300,692300,0,3434650,4126950
141042700800000,NE 129,Residential,21400,0,21400,32773,0,54173
141042700900000,NE 129,Residential,24075,0,24075,61208,0,85283
141042701000000,NE 129,Residential,40125,0,40125,99706,0,139831
141042701100000,NE 129,Residential,40660,0,40660,50390,0,91050
141042701200000,NE 129,Residential,34800,0,34800,88815,0,123615
141042701300000,NE 129,Residential,34800,0,34800,46201,0,81001
141042701400000,NE 129,Residential,40800,0,40800,74369,0,115169
141042701500000,NE 129,Residential,31025,0,31025,67581,0,98606
141042800100000,NE 129,Residential,34800,0,34800,80999,0,115799
141042800200000,NE 129,Residential,21200,0,21200,65363,0,86563
141042800300000,NE 129,Residential,21200,0,21200,62429,0,83629
141042800400000,NE 129,Residential,20140,0,20140,75205,0,95345
141042800500000,NE 129,Residential,22260,0,22260,97436,0,119696
141042800600000,NE 129,Residential,34450,0,34450,105891,0,140341
141042800700000,NE 129,Residential,37762,0,37762,88657,0,126419
141042800800000,NE 129,Residential,33920,0,33920,109880,0,143800
141042800900000,NE 129,Residential,33920,0,33920,75073,0,108993
141042801000000,NE 129,Residential,33920,0,33920,50835,0,84755
141042801100000,NE 129,Residential,16960,0,16960,59173,0,76133
141042801200000,NE 129,Residential,16960,0,16960,63471,0,80431
141042801300000,NE 129,Residential,27840,0,27840,78115,0,105955
141042801400000,NE 129,Residential,27375,0,27375,118494,0,145869
141042801500000,NE 129,Residential,27375,0,27375,82132,0,109507
141045100800000,NE 142,Residential,35628,0,35628,123739,0,159367
141045100900000,NE 142,Residential,30803,0,30803,123080,0,153883
141045101000000,NE 142,Residential,33412,0,33412,133637,0,167049
141045101100000,NE 142,Residential,33413,0,33413,131643,0,165056
141045101200000,NE 142,Residential,40096,0,40096,162954,0,203050
141045200100000,NE 142,Residential,19282,0,19282,103796,0,123078
141045200200000,NE 142,Residential,19824,0,19824,106718,0,126542
141045200300000,NE 142,Residential,29239,0,29239,109075,0,138314
141045200400000,NE 142,Residential,28200,0,28200,80950,0,109150
141045200500000,NE 142,Residential,28199,0,28199,100801,0,129000
141045200600000,NE 142,Residential,28499,0,28499,109370,0,137869
141045200700000,NE 142,Residential,28500,0,28500,91492,0,119992
141045200800000,NE 142,Residential,28800,0,28800,99228,0,128028
141045200900000,NE 142,Residential,28800,0,28800,90105,0,118905
141045201000000,NE 142,Residential,28800,0,28800,107904,0,136704
141045201100000,NE 142,Residential,33410,0,33410,139155,0,172565
141045201200000,NE 142,Residential,32380,0,32380,117620,0,150000
141045201300000,NE 142,Residential,30095,0,30095,127183,0,157278
141045201400000,NE 142,Residential,30869,0,30869,77492,0,108361
141045201500000,NE 142,Residential,28800,0,28800,84736,0,113536
141045201600000,NE 142,Residential,28800,0,28800,92200,0,121000
141045201700000,NE 142,Residential,28800,0,28800,85944,0,114744
141045201800000,NE 142,Residential,28500,0,28500,91690,0,120190
141045201900000,NE 142,Residential,27867,0,27867,103514,0,131381
141045300100000,NE 142,Residential,29824,0,29824,107078,0,136902
141045300200000,NE 142,Residential,29767,0,29767,105514,0,135281
141045300300000,NE 142,Residential,28500,0,28500,107050,0,135550
141045300400000,NE 142,Residential,28501,0,28501,117757,0,146258
141045300500000,NE 142,Residential,28500,0,28500,98440,0,126940
141045300600000,NE 142,Residential,28501,0,28501,112421,0,140922
141045300700000,NE 142,Residential,28500,0,28500,102749,0,131249
141045300800000,NE 142,Residential,26125,0,26125,122300,0,148425
141045300900000,NE 142,Residential,30875,0,30875,105865,0,136740
141045301000000,NE 142,Residential,22800,0,22800,82258,0,105058
141045301100000,NE 142,Residential,22800,0,22800,96868,0,119668
141045301200000,NE 142,Residential,22801,0,22801,96667,0,119468
141045301300000,NE 142,Residential,22800,0,22800,81945,0,104745
141045301400000,NE 142,Residential,28499,0,28499,108798,0,137297
141045301500000,NE 142,Residential,28500,0,28500,94397,0,122897
141045301600000,NE 142,Residential,28501,0,28501,74358,0,102859
141045301700000,NE 142,Residential,28500,0,28500,108273,0,136773
141045301800000,NE 142,Residential,28500,0,28500,105512,0,134012
141045301900000,NE 142,Residential,28500,0,28500,80103,0,108603
141045302000000,NE 142,Residential,28500,0,28500,94268,0,122768
141045400100000,NE 142,Residential,29717,0,29717,106408,0,136125
141045400200000,NE 142,Residential,33969,0,33969,106009,0,139978
141045400300000,NE 142,Residential,30300,0,30300,102040,0,132340
141045400400000,NE 142,Residential,30000,0,30000,114695,0,144695
141045400500000,NE 142,Residential,30000,0,30000,90717,0,120717
141045400600000,NE 142,Residential,29700,0,29700,82931,0,112631
141045400700000,NE 142,Residential,29700,0,29700,107208,0,136908
141045400800000,NE 142,Residential,29401,0,29401,75977,0,105378
141045400900000,NE 142,Residential,27053,0,27053,96021,0,123074
141045401000000,NE 142,Residential,23547,0,23547,105988,0,129535
141045401100000,NE 142,Residential,22799,0,22799,72249,0,95048
141045401200000,NE 142,Residential,22801,0,22801,74699,0,97500
141045401300000,NE 142,Residential,22800,0,22800,87473,0,110273
141045401400000,NE 142,Residential,28501,0,28501,82101,0,110602
141045401500000,NE 142,Residential,28501,0,28501,73801,0,102302
141045401600000,NE 142,Residential,28501,0,28501,78185,0,106686
141045401700000,NE 142,Residential,28500,0,28500,97576,0,126076
141045401800000,NE 142,Residential,28501,0,28501,88414,0,116915
141045401900000,NE 142,Residential,28500,0,28500,74998,0,103498
141045402000000,NE 142,Residential,28500,0,28500,114981,0,143481
141045500100000,NE 142,Residential,29375,0,29375,158949,0,188324
141045500200000,NE 142,Residential,30294,0,30294,173549,0,203843
141045500300000,NE 142,Residential,23761,0,23761,83203,0,106964
141045500400000,NE 142,Residential,27719,0,27719,120198,0,147917
141045500500000,NE 142,Residential,27721,0,27721,102791,0,130512
141045500600000,NE 142,Residential,27720,0,27720,105095,0,132815
141045500700000,NE 142,Residential,27721,0,27721,102790,0,130511
141045500800000,NE 142,Residential,23760,0,23760,110161,0,133921
141045500900000,NE 142,Residential,23760,0,23760,90190,0,113950
141045501000000,NE 142,Residential,23759,0,23759,79134,0,102893
141045501100000,NE 142,Residential,23760,0,23760,90739,0,114499
141045501200000,NE 142,Residential,28182,0,28182,102721,0,130903
141045501300000,NE 142,Residential,30805,0,30805,90101,0,120906
141045501400000,NE 142,Residential,29700,0,29700,79366,0,109066
141045501500000,NE 142,Residential,29700,0,29700,80817,0,110517
141045501600000,NE 142,Residential,29700,0,29700,104789,0,134489
141045501700000,NE 142,Residential,29700,0,29700,82026,0,111726
141045501800000,NE 142,Residential,34650,0,34650,79342,0,113992
141045501900000,NE 142,Residential,34650,0,34650,119902,0,154552
141045502000000,NE 142,Residential,34650,0,34650,88510,0,123160
141045502100000,NE 142,Residential,34650,0,34650,124465,0,159115
141045502200000,NE 142,Residential,29700,0,29700,93963,0,123663
141045502300000,NE 142,Residential,35640,0,35640,102761,0,138401
141045502400000,NE 142,Residential,38828,0,38828,156233,0,195061
141045600600000,NE 142,Residential,26267,0,26267,141104,0,167371
141045600700000,NE 142,Residential,31185,0,31185,125588,0,156773
141045600800000,NE 142,Residential,31185,0,31185,127180,0,158365
141045600900000,NE 142,Residential,29403,0,29403,117202,0,146605
141045601000000,NE 142,Residential,32075,0,32075,124801,0,156876
141045700100000,NE 142,Residential,38355,0,38355,184338,0,222693
141045700200000,NE 142,Residential,34651,0,34651,121178,0,155829
141045700300000,NE 142,Residential,35269,0,35269,147745,0,183014
141045700400000,NE 142,Residential,34650,0,34650,121924,0,156574
141045700500000,NE 142,Residential,29700,0,29700,91690,0,121390
141045700600000,NE 142,Residential,34649,0,34649,97883,0,132532
141045700700000,NE 142,Residential,34650,0,34650,102522,0,137172
141045700800000,NE 142,Residential,34650,0,34650,113794,0,148444
141045700900000,NE 142,Residential,29700,0,29700,103922,0,133622
141045701000000,NE 142,Residential,29699,0,29699,90809,0,120508
141045701100000,NE 142,Residential,26730,0,26730,80217,0,106947
141045701200000,NE 142,Residential,31566,0,31566,88871,0,120437
141045701300000,NE 142,Residential,35615,0,35615,119655,0,155270
141045701400000,NE 142,Residential,33858,0,33858,173929,0,207787
141045701500000,NE 142,Residential,28958,0,28958,94422,0,123380
141045701600000,NE 142,Residential,31185,0,31185,115323,0,146508
141045701700000,NE 142,Residential,31185,0,31185,90113,0,121298
141045701800000,NE 142,Residential,31185,0,31185,102707,0,133892
141045701900000,NE 142,Residential,31185,0,31185,103597,0,134782
141045702000000,NE 142,Residential,33413,0,33413,135035,0,168448
141045702100000,NE 142,Residential,33859,0,33859,152237,0,186096
141045702200000,NE 142,Residential,33392,0,33392,121608,0,155000
141045702300000,NE 142,Residential,33596,0,33596,115461,0,149057
141045800100000,NE 142,Residential,33414,0,33414,121552,0,154966
141045800200000,NE 142,Residential,33413,0,33413,109334,0,142747
141045800300000,NE 142,Residential,33413,0,33413,125770,0,159183
141045800400000,NE 142,Residential,33250,0,33250,118233,0,151483
141045800500000,NE 142,Residential,31198,0,31198,116429,0,147627
141047600100000,NE 141,Residential,15520,0,15520,54133,0,69653
141047600200000,NE 141,Residential,21600,0,21600,81469,0,103069
141047600300000,NE 141,Residential,21600,0,21600,110475,0,132075
141047600400000,NE 141,Residential,26190,0,26190,113463,0,139653
141047600500000,NE 141,Residential,26190,0,26190,91961,0,118151
141047600600000,NE 141,Residential,27511,0,27511,118243,0,145754
141047600700000,NE 141,Residential,24869,0,24869,56794,0,81663
141047700100000,NE 141,Residential,26190,0,26190,60692,0,86882
141047700200000,NE 141,Residential,15520,0,15520,53939,0,69459
141047700300000,NE 141,Residential,23400,0,23400,72703,0,96103
141047700400000,NE 141,Residential,19800,0,19800,96495,0,116295
141047700500000,NE 141,Residential,17460,0,17460,56994,0,74454
141047700600000,NE 141,Residential,17460,0,17460,47010,0,64470
141047700700000,NE 141,Residential,17460,0,17460,58240,0,75700
141047700800000,NE 141,Residential,26190,0,26190,71366,0,97556
141047700900000,NE 141,Residential,26190,0,26190,70569,0,96759
141047701000000,NE 141,Residential,17460,0,17460,60810,0,78270
141047701100000,NE 141,Residential,17460,0,17460,53346,0,70806
141047701200000,NE 141,Residential,17460,0,17460,59935,0,77395
141047701300000,NE 141,Residential,26190,0,26190,77638,0,103828
141047701400000,NE 141,Residential,26190,0,26190,74126,0,100316
141047701500000,NE 141,Residential,26190,0,26190,72871,0,99061
141047800100000,NE 141,Residential,24000,0,24000,101838,0,125838
141047800200000,NE 141,Residential,24000,0,24000,92569,0,116569
141047800300000,NE 141,Residential,28238,0,28238,93249,0,121487
141047800400000,NE 141,Residential,18987,0,18987,73216,0,92203
141047800500000,NE 141,Residential,22725,0,22725,50278,0,73003
141047800600000,NE 141,Residential,22725,0,22725,86648,0,109373
141047800700000,NE 141,Residential,22725,0,22725,83878,0,106603
141047800800000,NE 141,Residential,23407,0,23407,65923,0,89330
141047800900000,NE 141,Residential,26190,0,26190,56126,0,82316
141047801000000,NE 141,Residential,26190,0,26190,65747,0,91937
141047801100000,NE 141,Residential,26190,0,26190,101468,0,127658
141047801200000,NE 141,Residential,21825,0,21825,110241,0,132066
141047900100000,NE 141,Residential,22560,0,22560,84975,0,107535
141047900200000,NE 141,Residential,20680,0,20680,88557,0,109237
141047900300000,NE 141,Residential,21600,0,21600,59304,0,80904
141047900400000,NE 141,Residential,21600,0,21600,82978,0,104578
141047900500000,NE 141,Residential,21600,0,21600,80657,0,102257
141047900600000,NE 141,Residential,18630,0,18630,80810,0,99440
141047900700000,NE 141,Residential,17050,0,17050,77127,0,94177
141047900800000,NE 141,Residential,16650,0,16650,62863,0,79513
141048000700000,NE 142,Residential,37124,0,37124,174738,0,211862
141048000800000,NE 142,Residential,37125,0,37125,137162,0,174287
141048000900000,NE 142,Residential,33660,0,33660,151033,0,184693
141048001000000,NE 142,Residential,37530,0,37530,160289,0,197819
141048100100000,NE 141,Residential,16151,0,16151,58707,0,74858
141048100200000,NE 141,Residential,28984,0,28984,66607,0,95591
141048100300000,NE 141,Residential,22087,0,22087,85906,0,107993
141048100400000,NE 141,Residential,26190,0,26190,88781,0,114971
141048100500000,NE 141,Residential,26190,0,26190,80280,0,106470
141048100600000,NE 141,Residential,26190,0,26190,129685,0,155875
141048100700000,NE 141,Residential,26190,0,26190,78166,0,104356
141048200100000,NE 141,Residential,26190,0,26190,47044,0,73234
141048200200000,NE 141,Residential,17460,0,17460,69374,0,86834
141048200300000,NE 141,Residential,17460,0,17460,52319,0,69779
141048200400000,NE 141,Residential,17460,0,17460,50032,0,67492
141048200500000,NE 141,Residential,26190,0,26190,84069,0,110259
141048200600000,NE 141,Residential,26190,0,26190,66945,0,93135
141048200700000,NE 141,Residential,31428,0,31428,66495,0,97923
141048200800000,NE 141,Residential,26190,0,26190,91907,0,118097
141048200900000,NE 141,Residential,26190,0,26190,66711,0,92901
141048201000000,NE 141,Residential,26190,0,26190,46945,0,73135
141048201100000,NE 141,Residential,17460,0,17460,56766,0,74226
141048201200000,NE 141,Residential,15278,0,15278,50444,0,65722
141048201300000,NE 141,Residential,19643,0,19643,66152,0,85795
141048201400000,NE 141,Residential,26190,0,26190,118449,0,144639
141048201500000,NE 141,Residential,26190,0,26190,78948,0,105138
141048300100000,NE 141,Residential,26190,0,26190,92337,0,118527
141048300200000,NE 141,Residential,22500,0,22500,102473,0,124973
141048300300000,NE 141,Residential,22500,0,22500,75205,0,97705
141048300400000,NE 141,Residential,22500,0,22500,65476,0,87976
141048300500000,NE 141,Residential,22500,0,22500,88953,0,111453
141048300600000,NE 141,Residential,22500,0,22500,78013,0,100513
141048300700000,NE 141,Residential,22500,0,22500,97631,0,120131
141048300800000,NE 141,Residential,22500,0,22500,49925,0,72425
141048300900000,NE 141,Residential,16245,0,16245,49701,0,65946
141048301000000,NE 141,Residential,16245,0,16245,67953,0,84198
141048301100000,NE 141,Residential,26190,0,26190,75716,0,101906
141048301200000,NE 141,Residential,26190,0,26190,114099,0,140289
141048301300000,NE 141,Residential,26190,0,26190,90701,0,116891
141048301400000,NE 141,Residential,26190,0,26190,89517,0,115707
141048301500000,NE 141,Residential,26190,0,26190,63642,0,89832
141048301600000,NE 141,Residential,26190,0,26190,53379,0,79569
141048400100000,NE 141,Residential,21600,0,21600,88234,0,109834
141048400200000,NE 141,Residential,29160,0,29160,65544,0,94704
141048400300000,NE 141,Residential,29160,0,29160,96132,0,125292
141048400400000,NE 141,Residential,21600,0,21600,78679,0,100279
141048400500000,NE 141,Residential,21600,0,21600,94941,0,116541
141048400600000,NE 141,Residential,17280,0,17280,66573,0,83853
141048400700000,NE 141,Residential,17280,0,17280,81803,0,99083
141048400800000,NE 141,Residential,18187,0,18187,68817,0,87004
141048500100000,NE 141,Residential,14400,0,14400,0,0,14400
141048500200000,NE 141,Residential,14400,0,14400,10200,0,24600
141048500300000,FLAT PARKING,Commercial,0,17626,17626,0,30000,47626
141048600100000,NE 141,Residential,15520,0,15520,72708,0,88228
141048600200000,NE 141,Residential,26190,0,26190,108729,0,134919
141048600300000,NE 141,Residential,26190,0,26190,64166,0,90356
141048600400000,NE 141,Residential,26190,0,26190,100744,0,126934
141048600500000,CHURCH,Exempt,0,34992,34992,0,78679,113671
141048600600000,NE 141,Residential,24444,0,24444,82502,0,106946
141048600700000,NE 141,Residential,19400,0,19400,123400,0,142800
141048600800000,NE 141,Residential,15520,0,15520,68399,0,83919
141048600900000,NE 141,Residential,15520,0,15520,71216,0,86736
141048601000000,NE 141,Residential,15520,0,15520,65438,0,80958
141048601100000,NE 141,Residential,15520,0,15520,53024,0,68544
141048601200000,NE 141,Residential,15520,0,15520,57875,0,73395
141048700100000,NE 141,Residential,26190,0,26190,60554,0,86744
141048700200000,NE 141,Residential,21717,0,21717,76212,0,97929
141048700300000,NE 141,Residential,31559,0,31559,97046,0,128605
141048700400000,NE 141,Residential,22500,0,22500,84211,0,106711
141048700500000,NE 141,Residential,22500,0,22500,66398,0,88898
141048700600000,NE 141,Residential,22500,0,22500,77917,0,100417
141048700700000,NE 141,Residential,18000,0,18000,49984,0,67984
141048700800000,NE 141,Residential,16650,0,16650,50176,0,66826
141048700900000,NE 141,Residential,16470,0,16470,44715,0,61185
141048701000000,NE 141,Residential,26190,0,26190,64131,0,90321
141048701100000,NE 141,Residential,26190,0,26190,102383,0,128573
141048701200000,NE 141,Residential,26190,0,26190,64108,0,90298
141048701300000,NE 141,Residential,26190,0,26190,103155,0,129345
141048701400000,NE 141,Residential,26190,0,26190,68606,0,94796
141048800100000,NE 141,Residential,21600,0,21600,59741,0,81341
141048800200000,NE 141,Residential,21600,0,21600,86527,0,108127
141048800300000,NE 141,Residential,21600,0,21600,102321,0,123921
141048800400000,NE 141,Residential,21600,0,21600,83086,0,104686
141048800500000,NE 141,Residential,23328,0,23328,88394,0,111722
141048800600000,NE 141,Residential,27083,0,27083,140069,0,167152
141048900100000,NE 142,Residential,33135,0,33135,134632,0,167767
141048900200000,NE 142,Residential,32670,0,32670,142452,0,175122
141048900300000,NE 142,Residential,33413,0,33413,138004,0,171417
141048900400000,NE 142,Residential,33413,0,33413,123534,0,156947
141048900500000,NE 142,Residential,33413,0,33413,135078,0,168491
141048900600000,NE 142,Residential,28958,0,28958,129605,0,158563
141048900700000,NE 142,Residential,28959,0,28959,117811,0,146770
141048900800000,NE 142,Residential,31186,0,31186,88561,0,119747
141048900900000,NE 142,Residential,28958,0,28958,111716,0,140674
141048901000000,NE 142,Residential,29414,0,29414,105015,0,134429
141110100100000,NE 115,Residential,133420,0,133420,607187,0,740607
141110100200000,NE 115,Residential,110000,0,110000,202325,0,312325
141110100300000,NE 115,Exempt,0,295200,295200,0,0,295200
141110100400000,NE 115,Residential,30520,0,30520,0,0,30520
141110100500000,NE 115,Residential,122820,0,122820,445699,0,568519
141110100600000,NE 115,Residential,120800,0,120800,322617,0,443417
141110100700000,NE 115,Residential,102721,0,102721,322279,0,425000
141112800300000,APARTMENT,Commercial,0,16815,16815,0,141609,158424
141120100100000,AUTO REPAIR/SALES,Commercial,0,1076976,1076976,0,1762139,2839115
141120100200000,AUTO REPAIR/SALES,Commercial,0,123984,123984,0,77118,201102
141120100300000,APARTMENT,Residential,17496,0,17496,156267,0,173763
141120100400000,APARTMENT,Commercial,0,17496,17496,0,138504,156000
141120100500000,APARTMENT,Commercial,0,17496,17496,0,156369,173865
141120100600000,APARTMENT,Residential,17496,0,17496,100137,0,117633
141120100700000,APARTMENT,Residential,17431,0,17431,155005,0,172436
141120100800000,APARTMENT,Residential,17237,0,17237,145763,0,163000
141120100900000,APARTMENT,Commercial,0,17480,17480,0,138520,156000
141120200100000,OFFICE,Commercial,0,473040,473040,0,628502,1101542
141120200200000,APARTMENT,Commercial,0,81540,81540,0,343460,425000
141120200300000,BRANCH BANK/CU,Commercial,0,308614,308614,0,996300,1304914
141120200400000,OFFICE,Commercial,0,181440,181440,0,513483,694923
141120300200000,APARTMENT,Commercial,0,20457,20457,0,167021,187478
141120300800000,APARTMENT,Commercial,0,20898,20898,0,197060,217958
141120400200000,SE 201,Residential,365,0,365,0,0,365
141120400400000,APARTMENT,Exempt,0,48546,48546,0,1292387,1340933
141120400600000,CENTRALLY ASSESSED,Other,0,0,0,0,0,0
141120400700000,RESTAURANT,Commercial,0,528120,528120,0,573567,1101687
141120400800000,AUTO REPAIR/SALES,Commercial,0,70567,70567,0,65953,136520
141120400900000,WAREHOUSE,Commercial,0,264600,264600,0,125936,390536
141120400902000,BILLBOARD(BLL),Commercial,0,0,0,0,19318,19318
141120401000000,SMALL RETAIL,Commercial,0,172800,172800,0,120182,292982
141120401100000,RESTAURANT,Commercial,0,156600,156600,0,216038,372638
141120401300000,WAREHOUSE,Commercial,0,179280,179280,0,337736,517016
141120401400000,FLAT PARKING,Commercial,0,10109,10109,0,0,10109
141120401500000,AUTO REPAIR/SALES,Commercial,0,564300,564300,0,799147,1363447
141120401600000,CENTRALLY ASSESSED,Other,0,0,0,0,0,0
141120401700000,CENTRALLY ASSESSED,Other,0,0,0,0,0,0
141122600100000,NE 129,Residential,35580,0,35580,96591,0,132171
141122600200000,NE 129,Residential,35021,0,35021,115749,0,150770
141122600300000,NE 129,Residential,35021,0,35021,98901,0,133922
141122600400000,NE 129,Residential,35021,0,35021,99888,0,134909
141122600500000,NE 129,Residential,35021,0,35021,93525,0,128546
141122600600000,NE 129,Residential,35021,0,35021,114188,0,149209
141122600700000,NE 129,Residential,34543,0,34543,121329,0,155872
141122700100000,NE 129,Residential,41870,0,41870,82980,0,124850
141122700200000,NE 129,Residential,36288,0,36288,102553,0,138841
141122700300000,NE 129,Residential,36288,0,36288,34814,0,71102
141122700400000,NE 129,Residential,34020,0,34020,122152,0,156172
141122700500000,NE 129,Residential,37044,0,37044,104574,0,141618
141122700600000,NE 129,Residential,41580,0,41580,105251,0,146831
141122700700000,CHURCH,Exempt,0,243000,243000,0,1554189,1797189
141122700800000,NE 129,Residential,37791,0,37791,127844,0,165635
141122700900000,NE 129,Residential,34338,0,34338,111107,0,145445
141122701000000,NE 129,Residential,31539,0,31539,106102,0,137641
141122701100000,NE 129,Residential,31464,0,31464,83233,0,114697
141122701200000,NE 129,Residential,31464,0,31464,83541,0,115005
141122701300000,NE 129,Residential,31464,0,31464,105250,0,136714
141122701400000,NE 129,Residential,31637,0,31637,96208,0,127845
141122701500000,NE 129,Residential,29602,0,29602,91289,0,120891
141122701600000,NE 129,Residential,31464,0,31464,119227,0,150691
141122701700000,NE 129,Residential,32568,0,32568,111283,0,143851
141122701800000,NE 129,Residential,31176,0,31176,69858,0,101034
141122701900000,NE 129,Residential,32703,0,32703,113340,0,146043
141122702000000,NE 129,Residential,34312,0,34312,68820,0,103132
141122702100000,NE 129,Residential,34398,0,34398,111928,0,146326
141122800100000,AUTO REPAIR/SALES,Commercial,0,190179,190179,0,96905,287084
141122800200000,OFFICE,Commercial,0,52101,52101,0,368635,420736
141122800300000,NE 129,Residential,22320,0,22320,0,0,22320
141122800400000,NE 129,Residential,22320,0,22320,64230,0,86550
141122800500000,NE 129,Residential,22320,0,22320,52967,0,75287
141122800600000,NE 129,Residential,22320,0,22320,53109,0,75429
141122800700000,NE 129,Residential,26064,0,26064,133696,0,159760
141122800800000,NE 129,Residential,25920,0,25920,49082,0,75002
141122800900000,NE 129,Residential,25440,0,25440,45311,0,70751
141122801000000,NE 129,Residential,24480,0,24480,64687,0,89167
141122801100000,NE 129,Residential,24000,0,24000,50697,0,74697
141122801200000,NE 129,Residential,23280,0,23280,51211,0,74491
141122801300000,NE 129,Residential,23478,0,23478,75388,0,98866
141122801400000,NE 129,Residential,26092,0,26092,62688,0,88780
141122801500000,NE 129,Residential,27156,0,27156,80573,0,107729
141122801600000,NE 129,Residential,26786,0,26786,69468,0,96254
141122801700000,NE 129,Residential,25920,0,25920,58192,0,84112
141122801800000,NE 129,Residential,25920,0,25920,102430,0,128350
141122801900000,NE 129,Residential,25493,0,25493,64242,0,89735
141122802000000,NE 129,Residential,24939,0,24939,58343,0,83282
141122802100000,NE 129,Residential,26830,0,26830,69237,0,96067
141122802200000,NE 129,Residential,25682,0,25682,70054,0,95736
141122802300000,NE 129,Residential,26568,0,26568,63665,0,90233
141122802400000,NE 129,Residential,27132,0,27132,64691,0,91823
141122802500000,NE 129,Residential,26732,0,26732,69318,0,96050
141122802600000,NE 129,Residential,21870,0,21870,52538,0,74408
141122802700000,NE 129,Residential,22680,0,22680,74099,0,96779
141122802800000,NE 129,Residential,24300,0,24300,60485,0,84785
141122802900000,NE 129,Residential,29100,0,29100,74582,0,103682
141122803000000,NE 129,Residential,28687,0,28687,89209,0,117896
141122803100000,NE 129,Residential,26932,0,26932,68131,0,95063
141122803200000,NE 129,Residential,25680,0,25680,42107,0,67787
141122803300000,NE 129,Residential,25740,0,25740,48789,0,74529
141122803400000,OFFICE,Commercial,0,43465,43465,0,103955,147420
141122803500000,BARS/LOUNGE,Commercial,0,181980,181980,0,118020,300000
141122900100000,NE 130,Residential,27183,0,27183,98029,0,125212
141122900200000,NE 130,Residential,29088,0,29088,89235,0,118323
141122900300000,NE 130,Residential,29088,0,29088,86273,0,115361
141122900400000,NE 130,Residential,25149,0,25149,39140,0,64289
141122900500000,NE 130,Residential,23520,0,23520,100200,0,123720
141122900600000,NE 130,Residential,23520,0,23520,1319,0,24839
141122900700000,NE 130,Residential,23520,0,23520,52246,0,75766
141122900800000,NE 130,Residential,23520,0,23520,82936,0,106456
141122900900000,NE 130,Residential,23520,0,23520,66868,0,90388
141122901000000,NE 130,Residential,23520,0,23520,78140,0,101660
141122901100000,NE 130,Residential,23520,0,23520,65580,0,89100
141122901300000,NE 130,Residential,34776,0,34776,93389,0,128165
141123000100000,NE 129,Residential,21973,0,21973,75441,0,97414
141123000200000,NE 129,Residential,27977,0,27977,71981,0,99958
141123000300000,NE 129,Residential,28013,0,28013,57800,0,85813
141123000400000,NE 129,Residential,28633,0,28633,84607,0,113240
141123000500000,NE 129,Residential,28917,0,28917,70145,0,99062
141123000600000,NE 129,Residential,29200,0,29200,62377,0,91577
141123000700000,NE 129,Residential,26932,0,26932,85478,0,112410
141123000800000,NE 129,Residential,28620,0,28620,52306,0,80926
141123000900000,NE 129,Residential,28697,0,28697,66451,0,95148
141123001000000,NE 129,Residential,27753,0,27753,68293,0,96046
141123001100000,NE 129,Residential,25088,0,25088,64815,0,89903
141123001200000,NE 129,Residential,26190,0,26190,61685,0,87875
141123001300000,NE 129,Residential,25920,0,25920,64993,0,90913
141123001400000,NE 129,Residential,21056,0,21056,42413,0,63469
141123001500000,NE 129,Residential,22320,0,22320,63329,0,85649
141123001600000,NE 129,Residential,22080,0,22080,60080,0,82160
141123001700000,NE 129,Residential,30301,0,30301,71419,0,101720
141123001800000,NE 129,Residential,25272,0,25272,61033,0,86305
141123001900000,NE 129,Residential,25038,0,25038,61925,0,86963
141123002000000,NE 129,Residential,24610,0,24610,54193,0,78803
141123002100000,NE 129,Residential,27510,0,27510,59050,0,86560
141123002200000,NE 129,Residential,28016,0,28016,47636,0,75652
141123002300000,NE 129,Residential,27744,0,27744,73626,0,101370
141123002400000,NE 129,Residential,27540,0,27540,75573,0,103113
141123002500000,NE 129,Residential,29750,0,29750,95056,0,124806
141123002600000,NE 129,Residential,30720,0,30720,84362,0,115082
141123002700000,NE 129,Residential,31480,0,31480,12916,0,44396
141123002800000,NE 129,Residential,20747,0,20747,67349,0,88096
141123002900000,OFFICE,Commercial,0,48762,48762,0,55637,104399
141123100100000,OFFICE,Commercial,0,36491,36491,0,72109,108600
141123100200000,NE 129,Residential,21114,0,21114,76310,0,97424
141123100300000,NE 129,Residential,17712,0,17712,61344,0,79056
141123100400000,NE 129,Residential,26752,0,26752,58527,0,85279
141123100500000,NE 129,Residential,26642,0,26642,81301,0,107943
141123100600000,NE 129,Residential,27360,0,27360,73342,0,100702
141123100700000,NE 129,Residential,16008,0,16008,0,0,16008
141123100800000,NE 129,Residential,21484,0,21484,63844,0,85328
141123100900000,NE 129,Residential,21840,0,21840,54492,0,76332
141123101000000,NE 129,Residential,24660,0,24660,55353,0,80013
141123101100000,NE 129,Residential,28512,0,28512,56888,0,85400
141123101200000,NE 129,Residential,29434,0,29434,71854,0,101288
141123101300000,NE 129,Residential,26332,0,26332,46538,0,72870
141123101400000,NE 129,Residential,33581,0,33581,65236,0,98817
141123101500000,NE 129,Residential,24514,0,24514,50872,0,75386
141123101600000,NE 129,Residential,29135,0,29135,67043,0,96178
141123101700000,NE 129,Residential,30240,0,30240,91493,0,121733
141123101800000,NE 129,Residential,16200,0,16200,89924,0,106124
141123101900000,NE 129,Residential,20210,0,20210,96991,0,117201
141123102000000,NE 129,Residential,19800,0,19800,77385,0,97185
141123102100000,NE 129,Residential,19400,0,19400,63863,0,83263
141123102200000,NE 129,Residential,22600,0,22600,106430,0,129030
141123102300000,NE 129,Residential,25200,0,25200,109919,0,135119
141123102400000,NE 129,Residential,20250,0,20250,62586,0,82836
141123102500000,NE 129,Residential,19000,0,19000,64883,0,83883
141123102600000,NE 129,Residential,14371,0,14371,112184,0,126555
141123102700000,NE 129,Residential,23087,0,23087,76346,0,99433
141123102800000,NE 129,Residential,24750,0,24750,64146,0,88896
141123102900000,NE 129,Residential,21231,0,21231,61325,0,82556
141123103000000,OFFICE,Commercial,0,67617,67617,0,87820,155437
141123200100000,NE 130,Residential,23520,0,23520,67864,0,91384
141123200200000,NE 130,Residential,23520,0,23520,60962,0,84482
141123200300000,NE 130,Residential,30576,0,30576,104839,0,135415
141123200400000,NE 130,Residential,23520,0,23520,88392,0,111912
141123200500000,NE 130,Residential,23520,0,23520,77403,0,100923
141123200600000,NE 130,Residential,30576,0,30576,88349,0,118925
141123200700000,NE 130,Residential,28224,0,28224,60445,0,88669
141123200800000,NE 130,Residential,27885,0,27885,72144,0,100029
141123200900000,NE 130,Residential,24300,0,24300,81176,0,105476
141123201000000,NE 130,Residential,27641,0,27641,94038,0,121679
141123201100000,NE 130,Residential,27641,0,27641,98624,0,126265
141123201200000,NE 130,Residential,26687,0,26687,98313,0,125000
141123201300000,NE 130,Residential,28665,0,28665,79886,0,108551
141123201400000,NE 130,Residential,28665,0,28665,85870,0,114535
141123201500000,NE 130,Residential,23520,0,23520,41581,0,65101
141123201600000,NE 130,Residential,23520,0,23520,87292,0,110812
141123201700000,NE 130,Residential,23520,0,23520,72388,0,95908
141123300100000,RESTAURANT,Commercial,0,165295,165295,0,166228,331523
141125100100000,NBHD SHOPPING CENTER,Commercial,0,837000,837000,0,3428176,4265176
141125100200000,SMALL RETAIL,Commercial,0,47628,47628,0,81630,129258
141125100300000,FLAT PARKING,Commercial,0,182250,182250,0,15225,197475
141125100400000,LG DISCOUNT/RETAIL,Commercial,0,71306,71306,0,639159,710465
141125200100000,OFFICE; MEDICAL,Commercial,0,194247,194247,0,651850,846097
141125200200000,NE 129,Residential,24255,0,24255,98958,0,123213
141125200300000,NE 129,Residential,26250,0,26250,56741,0,82991
141125200400000,NE 129,Residential,26250,0,26250,64733,0,90983
141125200500000,NE 129,Residential,26250,0,26250,67897,0,94147
141125200600000,NE 129,Residential,26250,0,26250,81411,0,107661
141125200700000,NE 129,Residential,26250,0,26250,85988,0,112238
141125200800000,NE 129,Residential,26250,0,26250,138380,0,164630
141125200900000,NE 129,Residential,26250,0,26250,101586,0,127836
141125201000000,NE 129,Residential,26250,0,26250,89281,0,115531
141125201100000,NE 129,Residential,26250,0,26250,76580,0,102830
141125201200000,NE 129,Residential,26250,0,26250,77405,0,103655
141125201300000,NE 129,Residential,26250,0,26250,84654,0,110904
141125201400000,NE 129,Residential,26250,0,26250,80371,0,106621
141125201500000,NE 129,Residential,26250,0,26250,65206,0,91456
141125201600000,NE 129,Residential,25760,0,25760,75203,0,100963
141125201700000,NE 129,Residential,25047,0,25047,76254,0,101301
141125201800000,NE 129,Residential,22707,0,22707,73726,0,96433
141125201900000,NE 129,Residential,24012,0,24012,70782,0,94794
141125202000000,NE 129,Exempt,0,26484,26484,0,79146,105630
141125202100000,NE 129,Residential,25300,0,25300,76641,0,101941
141125202200000,NE 129,Residential,26250,0,26250,83433,0,109683
141125202300000,NE 129,Residential,26250,0,26250,65146,0,91396
141125202400000,NE 129,Residential,26250,0,26250,75247,0,101497
141125202500000,NE 129,Residential,26250,0,26250,96137,0,122387
141125202600000,NE 129,Residential,26250,0,26250,84220,0,110470
141125202700000,NE 129,Residential,26250,0,26250,61638,0,87888
141125202800000,NE 129,Residential,26250,0,26250,117442,0,143692
141125202900000,NE 129,Residential,44625,0,44625,113574,0,158199
141125203000000,NE 129,Residential,42735,0,42735,117908,0,160643
141125203100000,NE 129,Residential,21368,0,21368,106951,0,128319
141125203200000,FLAT PARKING,Commercial,0,23209,23209,0,3600,26809
141125203300000,OFFICE,Commercial,0,44712,44712,0,181535,226247
141125203400000,SMALL RETAIL,Commercial,0,61965,61965,0,109099,171064
141125203500000,OFFICE,Commercial,0,65636,65636,0,134943,200579
141125300100000,CHURCH,Exempt,0,164700,164700,0,455548,620248
141125300200000,APARTMENT,Commercial,0,39042,39042,0,851140,890182
141125300300000,NE 129,Residential,26250,0,26250,84099,0,110349
141125300400000,NE 129,Residential,42191,0,42191,84432,0,126623
141125300500000,NE 129,Residential,42000,0,42000,76302,0,118302
141125300600000,NE 129,Residential,42000,0,42000,73941,0,115941
141125300700000,NE 129,Residential,42000,0,42000,80436,0,122436
141125300800000,NE 129,Residential,35600,0,35600,87795,0,123395
141125300900000,NE 129,Residential,21353,0,21353,80337,0,101690
141125301000000,NE 129,Residential,21353,0,21353,102363,0,123716
141125301100000,NE 129,Residential,24475,0,24475,65476,0,89951
141125301200000,NE 129,Residential,24475,0,24475,100508,0,124983
141125301300000,NE 129,Residential,6400,0,6400,0,0,6400
141125301400000,NE 129,Residential,22250,0,22250,100649,0,122899
141125301500000,NE 129,Residential,31500,0,31500,92436,0,123936
141125301600000,NE 129,Residential,44625,0,44625,143396,0,188021
141125301700000,NE 129,Residential,42000,0,42000,148056,0,190056
141125301800000,NE 129,Residential,42000,0,42000,155052,0,197052
141125301900000,APARTMENT,Commercial,0,25515,25515,0,143560,169075
141125302000000,CHURCH,Exempt,0,45360,45360,0,20370,65730
141125302100000,OFFICE,Commercial,0,156803,156803,0,726844,883647
141125302400000,CHURCH,Exempt,0,81518,81518,0,16234,97752
141125400100000,SE 201,Residential,16425,0,16425,88145,0,104570
141125400200000,SE 201,Residential,16425,0,16425,84919,0,101344
141125400300000,SE 201,Residential,13140,0,13140,76986,0,90126
141125400400000,AUTO REPAIR/SALES,Commercial,0,136080,136080,0,277039,413119
141125401000000,SE 201,Residential,16470,0,16470,69123,0,85593
141125401100000,SE 201,Residential,17568,0,17568,88339,0,105907
141125401200000,SE 201,Residential,17640,0,17640,82140,0,99780
141125401300000,SE 201,Residential,17640,0,17640,58804,0,76444
141125401400000,SE 201,Residential,17640,0,17640,53521,0,71161
141125401500000,SE 201,Residential,17640,0,17640,65954,0,83594
141125401600000,SE 201,Residential,17640,0,17640,73342,0,90982
141125401700000,SE 201,Residential,17640,0,17640,79423,0,97063
141125401800000,SE 201,Residential,17640,0,17640,74932,0,92572
141125401900000,SE 201,Residential,17640,0,17640,76151,0,93791
141125402000000,NBHD SHOPPING CENTER,Commercial,0,145152,145152,0,469784,614936
141125402100000,BRANCH BANK/CU,Commercial,0,124200,124200,0,627872,752072
141125500100000,BRANCH BANK/CU,Commercial,0,359100,359100,0,441102,800202
141125500200000,NE 129,Residential,36750,0,36750,108908,0,145658
141125500300000,NE 129,Residential,31500,0,31500,80262,0,111762
141125500400000,NE 129,Residential,26250,0,26250,108255,0,134505
141125500500000,NE 129,Residential,26250,0,26250,98489,0,124739
141125500600000,CONVERSION,Commercial,0,16330,16330,0,46837,63167
141125500700000,NE 129,Residential,42000,0,42000,85917,0,127917
141125500800000,NE 129,Residential,27825,0,27825,92008,0,119833
141125500900000,NE 129,Residential,28350,0,28350,83173,0,111523
141125501000000,NE 129,Residential,27825,0,27825,91821,0,119646
141125501100000,NE 129,Residential,21000,0,21000,60008,0,81008
141125501200000,NE 129,Residential,21000,0,21000,68337,0,89337
141125501300000,NE 129,Residential,18630,0,18630,78735,0,97365
141125501400000,NE 129,Residential,17280,0,17280,87926,0,105206
141125501500000,NE 129,Residential,26676,0,26676,68972,0,95648
141125501600000,NE 129,Residential,25380,0,25380,84761,0,110141
141125501700000,NE 129,Residential,18900,0,18900,43776,0,62676
141125501800000,NE 129,Residential,18900,0,18900,90740,0,109640
141125501900000,NE 129,Residential,28350,0,28350,89738,0,118088
141125502000000,NE 129,Residential,18900,0,18900,63336,0,82236
141125502100000,NE 129,Residential,26932,0,26932,80265,0,107197
141125502200000,NE 129,Residential,23625,0,23625,89929,0,113554
141125502300000,NE 129,Residential,21263,0,21263,67797,0,89060
141125502400000,NE 129,Residential,21263,0,21263,79828,0,101091
141125502500000,NE 129,Residential,16538,0,16538,78712,0,95250
141125502600000,NE 129,Residential,16538,0,16538,77512,0,94050
141127600200000,APARTMENT,Residential,32940,0,32940,102060,0,135000
141127600300000,SE 201,Residential,18200,0,18200,80510,0,98710
141127600400000,VACANT LAND,Commercial,0,10395,10395,0,0,10395
141127600500000,VACANT LAND,Commercial,0,44604,44604,0,0,44604
141127600600000,SE 201,Residential,33796,0,33796,56715,0,90511
141127600700000,SE 201,Residential,22816,0,22816,46257,0,69073
141127600800000,SE 201,Residential,20281,0,20281,78565,0,98846
141127600900000,SE 201,Residential,20281,0,20281,67466,0,87747
141127601000000,SE 201,Residential,20281,0,20281,47740,0,68021
141127601100000,SE 201,Residential,20091,0,20091,74365,0,94456
141127601200000,SE 201,Residential,20091,0,20091,62727,0,82818
141127601300000,SE 201,Residential,20091,0,20091,70519,0,90610
141127601400000,SE 201,Residential,20369,0,20369,80595,0,100964
141127601700000,SE 201,Residential,31471,0,31471,111166,0,142637
141127601800000,SE 201,Residential,27918,0,27918,73619,0,101537
141127601900000,SE 201,Residential,25245,0,25245,73141,0,98386
141127602000000,SE 201,Residential,25245,0,25245,56195,0,81440
141127602100000,SE 201,Residential,25245,0,25245,75813,0,101058
141127602200000,SE 201,Residential,32447,0,32447,90931,0,123378
141127602400000,APARTMENT,Residential,473580,0,473580,3823578,0,4297158
141127602500000,SE 201,Residential,26978,0,26978,62051,0,89029
141127602600000,SE 201,Residential,28890,0,28890,57912,0,86802
141127602700000,SE 201,Residential,32168,0,32168,78526,0,110694
141127602800000,SE 201,Residential,36835,0,36835,70453,0,107288
141127602900000,SE 201,Residential,31298,0,31298,68225,0,99523
141127603000000,SE 201,Residential,26347,0,26347,48653,0,75000
141127603100000,SE 201,Residential,31298,0,31298,98670,0,129968
141127603200000,CITY PROPERTY,Exempt,0,0,0,0,0,0
141127603300000,SE 201,Residential,23064,0,23064,78772,0,101836
141127603400000,SE 201,Residential,29104,0,29104,116373,0,145477
141127603500000,VACANT LAND,Commercial,0,4687,4687,0,0,4687
141127603600000,APARTMENT,Commercial,0,262980,262980,0,2948552,3211532
141130100100000,SE 201,Residential,29376,0,29376,103961,0,133337
141130100200000,SE 201,Residential,29376,0,29376,122907,0,152283
141130100300000,SE 201,Residential,29376,0,29376,123004,0,152380
141130100400000,SE 201,Residential,29376,0,29376,78684,0,108060
141130100500000,SE 201,Residential,18360,0,18360,51433,0,69793
141130100600000,SE 201,Residential,18360,0,18360,35055,0,53415
141130100700000,SE 201,Residential,29376,0,29376,86620,0,115996
141130100800000,SE 201,Residential,29376,0,29376,60073,0,89449
141130100900000,SE 201,Residential,18360,0,18360,84572,0,102932
141130101000000,SE 201,Residential,18360,0,18360,55877,0,74237
141130101100000,SE 201,Residential,29376,0,29376,77025,0,106401
141130101200000,SE 201,Residential,29376,0,29376,74749,0,104125
141130101300000,SE 201,Residential,29376,0,29376,80720,0,110096
141130101400000,SE 201,Residential,29376,0,29376,101253,0,130629
141130101500000,SE 201,Residential,29376,0,29376,138925,0,168301
141130101600000,SE 201,Residential,32130,0,32130,93508,0,125638
141130101700000,SE 201,Residential,27540,0,27540,88706,0,116246
141130101800000,SE 201,Residential,29376,0,29376,62517,0,91893
141130101900000,SE 201,Residential,29107,0,29107,95893,0,125000
141130102000000,SE 201,Residential,29376,0,29376,103162,0,132538
141130102100000,SE 201,Residential,29376,0,29376,83078,0,112454
141130102200000,SE 201,Residential,29376,0,29376,57297,0,86673
141130102300000,SE 201,Residential,29376,0,29376,93689,0,123065
141130102400000,SE 201,Residential,32130,0,32130,98502,0,130632
141130102500000,SE 201,Residential,27540,0,27540,56531,0,84071
141130102600000,SE 201,Residential,23328,0,23328,77806,0,101134
141130102700000,SE 201,Residential,22995,0,22995,80665,0,103660
141130200100000,VACANT LAND,Commercial,0,8067,8067,0,0,8067
141130200300000,SE 201,Residential,28458,0,28458,108731,0,137189
141130200400000,SE 201,Residential,40392,0,40392,131383,0,171775
141130300100000,APARTMENT,Commercial,0,22239,22239,0,232557,254796
141130300200000,SE 201,Residential,19089,0,19089,75906,0,94995
141130300300000,SE 201,Residential,18711,0,18711,79380,0,98091
141130300400000,SE 201,Residential,30240,0,30240,75251,0,105491
141130300500000,SE 201,Residential,28350,0,28350,72278,0,100628
141130300600000,SE 201,Residential,30240,0,30240,105258,0,135498
141130300700000,SE 201,Residential,18900,0,18900,48345,0,67245
141130300800000,SE 201,Residential,18900,0,18900,64232,0,83132
141130300900000,SE 201,Residential,30534,0,30534,56931,0,87465
141130301000000,SE 201,Residential,18900,0,18900,37790,0,56690
141130301100000,SE 201,Residential,18900,0,18900,55883,0,74783
141130301200000,SE 201,Residential,30240,0,30240,76060,0,106300
141130301300000,SE 201,Residential,30240,0,30240,90078,0,120318
141130301400000,SE 201,Residential,30240,0,30240,65193,0,95433
141130301500000,SE 201,Residential,30240,0,30240,77494,0,107734
141130301600000,WAREHOUSE,Commercial,0,152550,152550,0,228744,381294
141130301700000,WAREHOUSE,Commercial,0,68429,68429,0,235994,304423
141130301800000,WAREHOUSE,Commercial,0,248400,248400,0,287664,536064
141130400100000,VACANT LAND,Commercial,0,5443,5443,0,0,5443
141130400200000,WAREHOUSE,Commercial,0,82755,82755,0,71687,154442
141130400300000,APARTMENT,Commercial,0,13903,13903,0,127060,140963
141130400400000,CONVERSION,Commercial,0,3266,3266,0,121628,124894
141130400600000,VACANT LAND,Commercial,0,8942,8942,0,0,8942
141130500100000,CEMETERY,Exempt,0,0,0,0,0,0
141130500200000,CENTRALLY ASSESSED,Other,0,0,0,0,0,0
141130500300000,SHOP,Commercial,0,53603,53603,0,146854,200457
141130500400000,WAREHOUSE,Commercial,0,241758,241758,0,719062,960820
141130500500000,FLAT PARKING,Commercial,0,8473,8473,0,2988,11461
141130500600000,CITY PROPERTY,Exempt,0,0,0,0,0,0
141130500700000,CITY PROPERTY,Exempt,0,0,0,0,0,0
141130500800000,CITY PROPERTY,Exempt,0,0,0,0,0,0
141130500900000,SE 201,Residential,34668,0,34668,110395,0,145063
141132600100000,SE 201,Residential,18360,0,18360,61202,0,79562
141132600200000,SE 201,Residential,18360,0,18360,78149,0,96509
141132600300000,SE 201,Residential,18360,0,18360,53890,0,72250
141132600400000,SE 201,Residential,18360,0,18360,54689,0,73049
141132600500000,OFFICE; MEDICAL,Commercial,0,279288,279288,0,616419,895707
141132600600000,APARTMENT,Commercial,0,20536,20536,0,118785,139321
141132600700000,APARTMENT,Commercial,0,20339,20339,0,111994,132333
141132600800000,SE 201,Residential,18360,0,18360,53214,0,71574
141132601000000,SE 201,Residential,29376,0,29376,112991,0,142367
141132700100000,CONVENIENCE STORE,Commercial,0,308772,308772,0,513684,822456
141132700200000,NE 129,Residential,38520,0,38520,87752,0,126272
141132700300000,NE 129,Residential,38520,0,38520,90581,0,129101
141132700400000,NE 129,Residential,19260,0,19260,81009,0,100269
141132700500000,NE 129,Residential,19260,0,19260,95934,0,115194
141132700600000,NE 129,Residential,38520,0,38520,110231,0,148751
141132700700000,SCHOOL,Exempt,0,77220,77220,0,614502,691722
141132700800000,NE 129,Residential,24030,0,24030,75281,0,99311
141132700900000,NE 129,Residential,25380,0,25380,62282,0,87662
141132701000000,NE 129,Residential,21150,0,21150,76687,0,97837
141132701100000,NE 129,Residential,24075,0,24075,65985,0,90060
141132701200000,NE 129,Residential,24075,0,24075,100372,0,124447
141132701300000,NE 129,Residential,21150,0,21150,77846,0,98996
141132701400000,NE 129,Residential,24075,0,24075,65136,0,89211
141132701500000,NE 129,Residential,24075,0,24075,83326,0,107401
141132701600000,NE 129,Residential,24075,0,24075,79938,0,104013
141132701700000,NE 129,Residential,24075,0,24075,83021,0,107096
141132701800000,NE 129,Residential,24075,0,24075,63526,0,87601
141132701900000,NE 129,Residential,24075,0,24075,70961,0,95036
141132702000000,NE 129,Residential,18297,0,18297,68183,0,86480
141132702100000,CONVERSION,Commercial,0,12587,12587,0,96263,108850
141132702200000,NE 129,Residential,15991,0,15991,58697,0,74688
141132702300000,NE 129,Residential,14896,0,14896,71655,0,86551
141132702400000,VACANT LAND,Commercial,0,49896,49896,0,0,49896
141132702500000,CONVERSIONS; NON-APT,Commercial,0,91109,91109,0,88420,179529
141132800100000,SE 201,Residential,18540,0,18540,50813,0,69353
141132800200000,SE 201,Residential,27810,0,27810,97658,0,125468
141132800300000,SE 201,Residential,27853,0,27853,50246,0,78099
141132800400000,SE 201,Residential,18540,0,18540,61277,0,79817
141132800500000,SE 201,Residential,18540,0,18540,69733,0,88273
141132800600000,AUTO REPAIR/SALES,Commercial,0,108199,108199,0,58562,166761
141132800700000,BARS/LOUNGE,Commercial,0,66100,66100,0,58192,124292
141132800702000,BILLBOARD(BLL),Commercial,0,0,0,0,17528,17528
141132800800000,OFFICE; MEDICAL,Commercial,0,62001,62001,0,160977,222978
141132800900000,FAST FOOD,Commercial,0,97978,97978,0,143849,241827
141132801000000,SE 201,Residential,16560,0,16560,0,0,16560
141132801100000,SE 201,Residential,28890,0,28890,22650,0,51540
141132801200000,SE 201,Residential,28890,0,28890,34319,0,63209
141132801300000,SE 201,Residential,19260,0,19260,69699,0,88959
141132801400000,SE 201,Residential,19260,0,19260,75105,0,94365
141132801500000,SE 201,Residential,19260,0,19260,79172,0,98432
141132900100000,AUTO REPAIR/SALES,Commercial,0,47552,47552,0,42223,89775
141132900200000,SMALL RETAIL,Commercial,0,4196,4196,0,74775,78971
141132900300000,VACANT LAND,Commercial,0,1618,1618,0,0,1618
141132900400000,NE 129,Residential,18630,0,18630,79398,0,98028
141132900500000,NE 129,Residential,38520,0,38520,51678,0,90198
141132900600000,NE 129,Residential,38520,0,38520,107725,0,146245
141132900700000,NE 129,Residential,24075,0,24075,84499,0,108574
141132900800000,NE 129,Residential,24075,0,24075,55314,0,79389
141132900900000,CHURCH,Exempt,0,78840,78840,0,660450,739290
141132901000000,NE 129,Residential,30977,0,30977,78218,0,109195
141132901100000,NE 129,Residential,38520,0,38520,128467,0,166987
141132901200000,NE 129,Residential,33120,0,33120,99219,0,132339
141132901300000,NE 129,Residential,22338,0,22338,64711,0,87049
141132901400000,NE 129,Residential,18068,0,18068,88334,0,106402
141132901500000,NE 129,Residential,34560,0,34560,68921,0,103481
141132901600000,NE 129,Residential,25520,0,25520,88058,0,113578
141132901700000,VACANT LAND,Exempt,0,9180,9180,0,3600,12780
141132901800000,NE 129,Exempt,0,19260,19260,0,75521,94781
141132901900000,NE 129,Residential,38520,0,38520,80492,0,119012
141132902000000,FLAT PARKING,Exempt,0,47952,47952,0,19116,67068
141132902100000,NE 129,Residential,27720,0,27720,84469,0,112189
141132902200000,CONVERSION,Commercial,0,12960,12960,0,62951,75911
141132902600000,RESTAURANT,Commercial,0,174960,174960,0,182729,357689
141132902602000,FAST FOOD,Commercial,0,0,0,0,39872,39872
141132902700000,NBHD SHOPPING CENTER,Commercial,0,259200,259200,0,559687,818887
141133000100000,SE 201,Residential,28890,0,28890,36263,0,65153
141133000200000,FLAT PARKING,Commercial,0,35770,35770,0,1890,37660
141133000300000,FLAT PARKING,Commercial,0,35770,35770,0,1890,37660
141133000400000,WAREHOUSE,Commercial,0,23328,23328,0,21325,44653
141133000500000,OFFICE,Commercial,0,131090,131090,0,210700,341790
141133000600000,SMALL RETAIL,Commercial,0,108770,108770,0,181965,290735
141133000700000,SMALL RETAIL,Commercial,0,63206,63206,0,50360,113566
141133000800000,SMALL RETAIL,Commercial,0,87483,87483,0,99541,187024
141133000900000,BARS/LOUNGE,Commercial,0,39074,39074,0,171571,210645
141133001000000,BARS/LOUNGE,Commercial,0,39074,39074,0,113715,152789
141133001100000,SMALL RETAIL,Commercial,0,53654,53654,0,71089,124743
141133001200000,SMALL RETAIL,Commercial,0,20801,20801,0,115989,136790
141133001300000,SMALL RETAIL,Commercial,0,220050,220050,0,442121,662171
141133100100000,AUTO REPAIR/SALES,Commercial,0,60329,60329,0,120961,181290
141133100200000,VETERINARY CLINIC,Commercial,0,22453,22453,0,67399,89852
141133100300000,SMALL RETAIL,Commercial,0,15034,15034,0,83412,98446
141133100400000,NE 129,Residential,18428,0,18428,83400,0,101828
141133100500000,NE 129,Residential,18630,0,18630,66032,0,84662
141133100600000,NE 129,Residential,40986,0,40986,109227,0,150213
141133100700000,CONVERSION,Commercial,0,15293,15293,0,53663,68956
141133100800000,NE 129,Residential,17883,0,17883,78960,0,96843
141133100900000,NE 129,Residential,22896,0,22896,65427,0,88323
141133101000000,NE 129,Residential,24804,0,24804,123163,0,147967
141133101100000,NE 129,Residential,35664,0,35664,119336,0,155000
141133101200000,NE 129,Residential,39123,0,39123,90795,0,129918
141133101300000,NE 129,Residential,23490,0,23490,71023,0,94513
141133101400000,NE 129,Residential,20367,0,20367,81186,0,101553
141133101500000,NE 129,Residential,29440,0,29440,71554,0,100994
141133101900000,APARTMENT,Commercial,0,17788,17788,0,426321,444109
141133102000000,APARTMENT,Commercial,0,19391,19391,0,208210,227601
141133102100000,APARTMENT,Commercial,0,18517,18517,0,222581,241098
141133102200000,NE 129,Residential,20520,0,20520,80314,0,100834
141133102300000,NE 129,Residential,25080,0,25080,133579,0,158659
141133102400000,NE 129,Residential,22800,0,22800,90224,0,113024
141133102500000,APARTMENT,Commercial,0,37364,37364,0,372636,410000
141133102600000,FAST FOOD,Commercial,0,284256,284256,0,441553,725809
141133102700000,CARWASH,Commercial,0,80190,80190,0,213014,293204
141133102800000,FRATERNAL,Exempt,0,52618,52618,0,186342,238960
141135100100000,WAREHOUSE,Commercial,0,147150,147150,0,139420,286570
141135100200000,SMALL RETAIL,Commercial,0,154023,154023,0,231011,385034
141135100300000,OFFICE,Commercial,0,358748,358748,0,734505,1093253
141135100400000,SMALL RETAIL,Commercial,0,117074,117074,0,225895,342969
141135200100000,CONVENIENCE STORE,Commercial,0,82717,82717,0,69149,151866
141135200200000,NE 141,Residential,36000,0,36000,75721,0,111721
141135200300000,NE 141,Residential,22000,0,22000,77027,0,99027
141135200400000,NE 141,Residential,22000,0,22000,62670,0,84670
141135200500000,NE 141,Residential,22000,0,22000,72563,0,94563
141135200600000,NE 141,Residential,22000,0,22000,47655,0,69655
141135200700000,NE 141,Residential,22000,0,22000,83690,0,105690
141135200800000,NE 141,Residential,22000,0,22000,65016,0,87016
141135200900000,NE 141,Residential,22000,0,22000,62065,0,84065
141135201000000,NE 141,Residential,22000,0,22000,55128,0,77128
141135201100000,NE 141,Residential,22000,0,22000,79805,0,101805
141135201200000,APARTMENT,Commercial,0,11236,11236,0,120906,132142
141135201300000,APARTMENT,Commercial,0,11402,11402,0,133098,144500
141135201400000,APARTMENT,Commercial,0,18643,18643,0,350935,369578
141135201500000,APARTMENT,Commercial,0,26215,26215,0,300458,326673
141135201600000,NE 141,Residential,24750,0,24750,53649,0,78399
141135201700000,NE 141,Residential,24750,0,24750,56506,0,81256
141135201800000,NE 141,Residential,24750,0,24750,80757,0,105507
141135201900000,NE 141,Residential,24750,0,24750,62834,0,87584
141135202000000,NE 141,Residential,24750,0,24750,68639,0,93389
141135202100000,NE 141,Residential,24750,0,24750,80018,0,104768
141135202400000,WAREHOUSE,Commercial,0,62208,62208,0,132537,194745
141135202500000,NE 141,Residential,17460,0,17460,80022,0,97482
141135202600000,NE 141,Residential,21825,0,21825,98173,0,119998
141135202700000,LAUNDROMAT/CLEANERS,Commercial,0,40824,40824,0,46517,87341
141135202800000,BARS/LOUNGE,Commercial,0,40824,40824,0,43670,84494
141135202802000,BILLBOARD(BLL),Commercial,0,0,0,0,20513,20513
141135202900000,AUTO REPAIR/SALES,Commercial,0,175214,175214,0,59435,234649
141135203000000,FLAT PARKING,Commercial,0,143273,143273,0,7170,150443
141135300100000,OFFICE,Commercial,0,141588,141588,0,290278,431866
141135300200000,WAREHOUSE,Commercial,0,43546,43546,0,943381,986927
141135300300000,CITY PROPERTY,Exempt,0,0,0,0,0,0
141135300400000,SHOP,Commercial,0,17147,17147,0,34494,51641
141135300500000,CITY PROPERTY,Exempt,0,0,0,0,0,0
141135300600000,SMALL RETAIL,Commercial,0,25272,25272,0,93449,118721
141135300700000,SMALL RETAIL,Commercial,0,145411,145411,0,141444,286855
141135300800000,VACANT LAND,Commercial,0,510975,510975,0,0,510975
141135300900000,VACANT LAND,Commercial,0,19845,19845,0,0,19845
141135301000000,VACANT LAND,Commercial,0,24435,24435,0,0,24435
141135301100000,VACANT LAND,Commercial,0,7560,7560,0,0,7560
141135301102000,BILLBOARD(BLL),Commercial,0,0,0,0,27073,27073
141135301200000,WAREHOUSE,Commercial,0,432486,432486,0,1096059,1528545
141135301300000,VACANT LAND,Commercial,0,86400,86400,0,0,86400
141135400100000,WAREHOUSE,Commercial,0,34182,34182,0,159549,193731
141135400200000,WAREHOUSE,Commercial,0,27540,27540,0,155232,182772
141135400300000,SMALL RETAIL,Commercial,0,12830,12830,0,97107,109937
141135400400000,SE 201,Residential,5950,0,5950,28695,0,34645
141135400500000,AUTO REPAIR/SALES,Commercial,0,41990,41990,0,66638,108628
141135400600000,VACANT LAND,Commercial,0,50389,50389,0,100,50489
141135400700000,OFFICE,Commercial,0,17496,17496,0,102319,119815
141135400800000,WAREHOUSE,Commercial,0,33242,33242,0,49490,82732
141135400900000,PRINTING,Industrial,0,41990,41990,0,176142,218132
141135401000000,SMALL RETAIL,Commercial,0,129470,129470,0,155801,285271
141137600100000,WAREHOUSE,Exempt,0,39690,39690,0,74057,113747
141137600200000,SE 201,Residential,14700,0,14700,48813,0,63513
141137600300000,CEMETERY,Exempt,0,0,0,0,0,0
141137600400000,CITY PROPERTY,Exempt,0,0,0,0,0,0
141137600500000,CITY PROPERTY,Exempt,0,0,0,0,0,0
141137600600000,CITY PROPERTY,Exempt,0,0,0,0,0,0
141137600700000,SE 201,Residential,14400,0,14400,69198,0,83598
141137600800000,SE 201,Residential,14400,0,14400,61369,0,75769
141137600900000,SE 201,Residential,14400,0,14400,53703,0,68103
141137601000000,SE 201,Residential,14400,0,14400,83854,0,98254
141137601100000,SE 201,Residential,14400,0,14400,49666,0,64066
141137601200000,SE 201,Residential,14400,0,14400,83078,0,97478
141137601300000,SE 201,Residential,14400,0,14400,80076,0,94476
141137601400000,SE 201,Residential,14400,0,14400,79383,0,93783
141137601500000,SE 201,Residential,18864,0,18864,58134,0,76998
141137601600000,SE 201,Residential,18405,0,18405,75531,0,93936
141137601700000,SE 201,Residential,16950,0,16950,77953,0,94903
141137700100000,SE 201,Residential,11979,0,11979,80433,0,92412
141137700200000,SE 201,Residential,12900,0,12900,54344,0,67244
141137700300000,SE 201,Residential,18648,0,18648,42052,0,60700
141137700400000,WAREHOUSE,Commercial,0,374652,374652,0,397926,772578
141137700500000,WAREHOUSE,Commercial,0,20736,20736,0,74388,95124
141137701500000,SE 201,Residential,18934,0,18934,88343,0,107277
141137800100000,SE 201,Residential,10278,0,10278,23012,0,33290
141137800200000,SE 201,Residential,14118,0,14118,78449,0,92567
141137800300000,SE 201,Residential,14250,0,14250,39910,0,54160
141137800400000,SE 201,Residential,14400,0,14400,37853,0,52253
141137800500000,SE 201,Residential,14400,0,14400,57325,0,71725
141137800600000,SE 201,Residential,14400,0,14400,58087,0,72487
141137800700000,SE 201,Residential,14400,0,14400,33778,0,48178
141137800800000,SE 201,Residential,14400,0,14400,82661,0,97061
141137800900000,SE 201,Residential,15341,0,15341,74473,0,89814
141137801000000,SE 201,Residential,15501,0,15501,81986,0,97487
141137801100000,SE 201,Residential,9600,0,9600,36447,0,46047
141137801200000,SE 201,Residential,9600,0,9600,40674,0,50274
141137801300000,SE 201,Residential,16320,0,16320,34532,0,50852
141137801400000,SE 201,Residential,19844,0,19844,75137,0,94981
141137801500000,SE 201,Residential,9828,0,9828,0,0,9828
141137801600000,SE 201,Residential,10368,0,10368,88255,0,98623
141137801700000,SE 201,Residential,8820,0,8820,0,0,8820
141137801800000,SE 201,Residential,14550,0,14550,52442,0,66992
141137801900000,SE 201,Residential,14400,0,14400,93801,0,108201
141137802000000,SE 201,Residential,14400,0,14400,62646,0,77046
141137802100000,SE 201,Residential,14400,0,14400,35271,0,49671
141137802200000,SE 201,Residential,14400,0,14400,67525,0,81925
141137802300000,SE 201,Residential,14400,0,14400,59860,0,74260
141137802400000,SE 201,Residential,14400,0,14400,43641,0,58041
141137802500000,SE 201,Residential,14400,0,14400,70191,0,84591
141137802600000,SE 201,Residential,11808,0,11808,57430,0,69238
141137802700000,SE 201,Residential,16815,0,16815,21996,0,38811
141137802800000,SE 201,Residential,16405,0,16405,29296,0,45701
141137900100000,SE 201,Residential,14280,0,14280,66924,0,81204
141137900200000,SE 201,Residential,14400,0,14400,50579,0,64979
141137900300000,SE 201,Residential,14400,0,14400,55297,0,69697
141137900400000,SE 201,Residential,14400,0,14400,32201,0,46601
141137900500000,SE 201,Residential,14400,0,14400,66773,0,81173
141137900600000,SE 201,Residential,14400,0,14400,55088,0,69488
141137900700000,SE 201,Residential,14400,0,14400,91225,0,105625
141137900800000,SE 201,Residential,14400,0,14400,79734,0,94134
141137900900000,SE 201,Residential,14400,0,14400,53001,0,67401
141137901000000,SE 201,Residential,14400,0,14400,96875,0,111275
141137901100000,SE 201,Residential,14400,0,14400,82130,0,96530
141137901200000,SE 201,Residential,14400,0,14400,63329,0,77729
141137901300000,SE 201,Residential,14400,0,14400,45072,0,59472
141137901400000,SE 201,Residential,14400,0,14400,68608,0,83008
141137901500000,SE 201,Residential,14100,0,14100,37291,0,51391
141137901600000,SE 201,Residential,12750,0,12750,36824,0,49574
141137901700000,SE 201,Residential,8640,0,8640,44978,0,53618
141137901800000,SE 201,Residential,8640,0,8640,43715,0,52355
141137901900000,SE 201,Residential,8640,0,8640,42249,0,50889
141137902000000,SE 201,Residential,11383,0,11383,60586,0,71969
141137902100000,SE 201,Residential,8986,0,8986,28800,0,37786
141137902200000,SE 201,Residential,8040,0,8040,36260,0,44300
141137902300000,SE 201,Residential,17388,0,17388,0,0,17388
141137902400000,SE 201,Residential,13663,0,13663,106462,0,120125
141137902500000,SE 201,Residential,18137,0,18137,76031,0,94168
141137902600000,SE 201,Residential,22260,0,22260,83825,0,106085
141137902700000,SE 201,Residential,16854,0,16854,91346,0,108200
141137902800000,SE 201,Residential,12720,0,12720,65365,0,78085
141137902900000,SE 201,Residential,15900,0,15900,67887,0,83787
141137903000000,SE 201,Residential,18126,0,18126,61833,0,79959
141137903100000,SE 201,Residential,15821,0,15821,128094,0,143915
141137903200000,SE 201,Residential,15980,0,15980,51679,0,67659
141137903300000,SE 201,Residential,22260,0,22260,69774,0,92034
141137903400000,SE 201,Residential,16059,0,16059,57635,0,73694
141137903500000,SE 201,Residential,16059,0,16059,60502,0,76561
141137903600000,SE 201,Residential,16059,0,16059,69722,0,85781
141137903700000,SE 201,Residential,16059,0,16059,73933,0,89992
141137903800000,SE 201,Residential,19109,0,19109,76866,0,95975
141137903900000,SE 201,Residential,13134,0,13134,63689,0,76823
141137904000000,SE 201,Residential,13650,0,13650,55484,0,69134
141137904100000,SE 201,Residential,13361,0,13361,65229,0,78590
141137904200000,SE 201,Residential,15300,0,15300,90255,0,105555
141138000100000,APARTMENT,Commercial,0,35802,35802,0,357374,393176
141138000200000,SE 201,Residential,17955,0,17955,62617,0,80572
141138000300000,SE 201,Residential,17325,0,17325,93185,0,110510
141138000400000,SE 201,Residential,11970,0,11970,75374,0,87344
141138000500000,SE 201,Residential,20004,0,20004,73267,0,93271
141138000600000,SE 201,Residential,14489,0,14489,83424,0,97913
141138000700000,SE 201,Residential,14156,0,14156,82180,0,96336
141138000800000,SE 201,Residential,14339,0,14339,77798,0,92137
141138000900000,SE 201,Residential,18393,0,18393,80607,0,99000
141138001000000,APARTMENT,Commercial,0,13851,13851,0,216111,229962
141138001100000,SE 201,Residential,15600,0,15600,84992,0,100592
141138001200000,APARTMENT,Residential,38341,0,38341,476659,0,515000
141138001300000,SE 201,Residential,22226,0,22226,39131,0,61357
141138001400000,SE 201,Residential,20800,0,20800,49959,0,70759
141138001500000,SE 201,Residential,20800,0,20800,63851,0,84651
141138001700000,CITY PROPERTY,Exempt,0,0,0,0,0,0
141138001800000,CITY PROPERTY,Exempt,0,0,0,0,0,0
141138100100000,SE 201,Residential,11700,0,11700,72974,0,84674
141138100200000,AUTO REPAIR/SALES,Commercial,0,55404,55404,0,198579,253983
141138100300000,SHOP,Commercial,0,30472,30472,0,143781,174253
141138100400000,WAREHOUSE,Commercial,0,49864,49864,0,181045,230909
141138100500000,SE 201,Residential,10400,0,10400,0,0,10400
141138100600000,WAREHOUSE,Commercial,0,185760,185760,0,610987,796747
141138100700000,OFFICE,Commercial,0,19699,19699,0,98781,118480
141138100800000,AUTO REPAIR/SALES,Commercial,0,18732,18732,0,53281,72013
141138100900000,APARTMENT,Commercial,0,31435,31435,0,268565,300000
141140200600000,SE 202,Residential,34578,0,34578,249112,0,283690
141142601200000,CEMETERY,Exempt,0,0,0,0,0,0
141142601300000,CEMETERY,Exempt,0,0,0,0,0,0
141145100100000,SE 202,Residential,37638,0,37638,65216,0,102854
141145100200000,SE 202,Residential,30240,0,30240,49609,0,79849
141145100300000,SE 202,Residential,30000,0,30000,87634,0,117634
141145100400000,SE 202,Residential,46390,0,46390,171105,0,217495
141145100500000,SE 202,Residential,38812,0,38812,113634,0,152446
141145100600000,SE 202,Residential,45575,0,45575,114255,0,159830
141145100700000,SE 202,Residential,45393,0,45393,150079,0,195472
141145100800000,SE 202,Residential,30895,0,30895,107717,0,138612
141145100900000,SE 202,Residential,29499,0,29499,89054,0,118553
141145101000000,SE 202,Residential,42322,0,42322,142430,0,184752
141145101100000,SE 202,Residential,23310,0,23310,100865,0,124175
141145101200000,SE 202,Residential,32400,0,32400,116347,0,148747
141145200100000,CEMETERY,Exempt,0,0,0,0,0,0
141145200200000,SE 202,Residential,35568,0,35568,73516,0,109084
141145200300000,SE 202,Residential,25536,0,25536,81184,0,106720
141145200400000,SE 202,Residential,25833,0,25833,98318,0,124151
141145200700000,SE 202,Residential,15840,0,15840,111135,0,126975
141145200800000,SE 202,Residential,25440,0,25440,113650,0,139090
141145300100000,SE 202,Residential,39991,0,39991,108304,0,148295
141145300500000,SE 202,Residential,20384,0,20384,134486,0,154870
141145300600000,SE 202,Residential,19260,0,19260,122921,0,142181
141145400100000,SE 202,Residential,16252,0,16252,0,0,16252
141145400200000,SE 202,Residential,11880,0,11880,62670,0,74550
141145500100000,SE 202,Residential,105200,0,105200,199809,0,305009
141145500200000,SE 244,Residential,46404,0,46404,407877,0,454281
141145500300000,SE 244,Residential,58114,0,58114,315058,0,373172
141145500400000,SE 244,Residential,111751,0,111751,296624,0,408375
141145500500000,SE 244,Residential,88574,0,88574,364650,0,453224
141145500600000,SE 244,Residential,81735,0,81735,364799,0,446534
141145500700000,SE 244,Residential,66202,0,66202,288576,0,354778
141145500800000,SE 244,Residential,67952,0,67952,282492,0,350444
141145600100000,SE 202,Residential,85902,0,85902,127203,0,213105
141145700100000,SE 202,Residential,16800,0,16800,0,0,16800
141145700200000,SE 202,Residential,23520,0,23520,33229,0,56749
141145700300000,SE 202,Residential,16800,0,16800,70681,0,87481
141145700400000,SE 202,Residential,31500,0,31500,62817,0,94317
141145700500000,SE 202,Residential,25200,0,25200,50338,0,75538
141145700600000,SE 202,Residential,17098,0,17098,76514,0,93612
141145700700000,CITY PROPERTY,Exempt,0,0,0,0,0,0
141147600100000,SE 202,Residential,6509,0,6509,58657,0,65166
141147600200000,SE 202,Residential,24000,0,24000,114791,0,138791
141147600300000,SE 202,Residential,24000,0,24000,94682,0,118682
141147600400000,SE 202,Residential,24480,0,24480,80415,0,104895
141147600500000,SE 202,Residential,24960,0,24960,95658,0,120618
141147600600000,SE 202,Residential,24960,0,24960,148972,0,173932
141147600700000,SE 202,Residential,30600,0,30600,103428,0,134028
141147600800000,SE 202,Residential,3905,0,3905,0,0,3905
141147600900000,SE 202,Residential,24000,0,24000,68471,0,92471
141147700100000,SE 202,Residential,12000,0,12000,110105,0,122105
141147700200000,SE 202,Residential,30600,0,30600,109620,0,140220
141147700300000,SE 202,Residential,32148,0,32148,171610,0,203758
141147700400000,SE 202,Residential,27281,0,27281,182821,0,210102
141147700500000,SE 202,Residential,23712,0,23712,227612,0,251324
141147700600000,SE 202,Residential,2033,0,2033,3667,0,5700
141147800100000,SE 202,Residential,35139,0,35139,174821,0,209960
141147800200000,SE 202,Residential,18000,0,18000,82226,0,100226
141147800300000,SE 202,Residential,18000,0,18000,84799,0,102799
141147800400000,SE 202,Residential,24000,0,24000,89459,0,113459
141147800500000,SE 202,Residential,41730,0,41730,117598,0,159328
141147800600000,CENTRALLY ASSESSED,Other,0,0,0,0,0,0
141147800700000,CENTRALLY ASSESSED,Other,0,0,0,0,0,0
141147800800000,CENTRALLY ASSESSED,Other,0,0,0,0,0,0
141147900100000,SE 202,Residential,27183,0,27183,106475,0,133658
141147900200000,SE 202,Residential,15600,0,15600,79069,0,94669
141147900300000,SE 202,Residential,15600,0,15600,79620,0,95220
141147900400000,SE 202,Residential,24000,0,24000,109471,0,133471
141147900500000,SE 202,Residential,16800,0,16800,106261,0,123061
141147900600000,SE 202,Residential,16800,0,16800,0,0,16800
141147900700000,SE 202,Residential,28341,0,28341,61843,0,90184
141147900800000,SE 202,Residential,30994,0,30994,117012,0,148006
141147900900000,SE 202,Residential,18624,0,18624,61448,0,80072
141147901000000,SE 202,Residential,23280,0,23280,129324,0,152604
141147901100000,SE 202,Residential,9894,0,9894,0,0,9894
141147901200000,SE 202,Residential,19788,0,19788,98198,0,117986
141147901300000,SE 202,Residential,5202,0,5202,1987,0,7189
141147901400000,SE 202,Residential,24480,0,24480,118739,0,143219
141147901500000,SE 202,Residential,34473,0,34473,84843,0,119316
141147901600000,SE 202,Residential,16368,0,16368,123399,0,139767
141147901700000,SE 202,Residential,21756,0,21756,96672,0,118428
141147901800000,SE 202,Residential,25029,0,25029,73931,0,98960
141147901900000,SE 202,Residential,20800,0,20800,108588,0,129388
141147902000000,SE 202,Residential,16720,0,16720,51703,0,68423
141147902100000,SE 202,Residential,15828,0,15828,101289,0,117117
141147902200000,SE 202,Residential,7661,0,7661,0,0,7661
141147902300000,SE 202,Residential,4219,0,4219,0,0,4219
141147902400000,SE 202,Residential,8624,0,8624,0,0,8624
141147902500000,SE 202,Residential,4402,0,4402,0,0,4402
141147902600000,SE 202,Residential,8811,0,8811,134251,0,143062
141147903000000,SE 202,Residential,8323,0,8323,0,0,8323
141147903100000,SE 202,Residential,12441,0,12441,0,0,12441
141147903200000,SE 202,Residential,16965,0,16965,180131,0,197096
141147903400000,SE 202,Residential,3600,0,3600,0,0,3600
141147903500000,SE 202,Residential,3600,0,3600,0,0,3600
141147903600000,SE 202,Residential,23400,0,23400,47632,0,71032
141147903700000,SE 202,Residential,23478,0,23478,94793,0,118271
141148000100000,SE 202,Residential,28160,0,28160,118180,0,146340
141148000200000,SE 202,Residential,51271,0,51271,92730,0,144001
141148000300000,SE 202,Residential,39858,0,39858,155026,0,194884
141148000400000,SE 202,Residential,24480,0,24480,114505,0,138985
141148000500000,SE 202,Residential,15624,0,15624,0,0,15624
141148000600000,SE 202,Residential,29012,0,29012,92988,0,122000
141148100100000,SE 202,Residential,45650,0,45650,68435,0,114085
141148100200000,SE 244,Residential,40220,0,40220,0,0,40220
141148100300000,SE 244,Residential,100045,0,100045,209955,0,310000
141148100400000,SE 244,Residential,20000,0,20000,0,0,20000
141148100600000,SE 244,Residential,103520,0,103520,411071,0,514591
141148100700000,SE 244,Residential,39196,0,39196,0,0,39196
141148100800000,SE 244,Residential,31038,0,31038,0,0,31038
141148100900000,SE 244,Residential,50797,0,50797,0,0,50797
141148101000000,SE 244,Residential,55345,0,55345,370744,0,426089
141148101100000,SE 244,Residential,71214,0,71214,293663,0,364877
141148101200000,SE 244,Residential,89081,0,89081,379173,0,468254
141148101300000,SE 244,Residential,93685,0,93685,350313,0,443998
141148101400000,SE 244,Residential,87664,0,87664,361793,0,449457
141148101500000,SE 244,Residential,84047,0,84047,299826,0,383873
141148101600000,SE 244,Residential,101214,0,101214,345855,0,447069
141148101700000,SE 244,Residential,77195,0,77195,241286,0,318481
141148101800000,SE 244,Residential,102566,0,102566,493163,0,595729
141148101900000,SE 244,Residential,39220,0,39220,286777,0,325997
141148102000000,SE 244,Residential,69370,0,69370,375831,0,445201
141148102100000,SE 244,Residential,60452,0,60452,292634,0,353086
141148102400000,SE 244,Residential,91260,0,91260,331914,0,423174
141148102500000,SE 244,Residential,47950,0,47950,0,0,47950
141148102600000,SE 244,Residential,45753,0,45753,344401,0,390154
141235100600000,SE 202,Residential,34704,0,34704,135969,0,170673
141235100800000,SE 202,Residential,28595,0,28595,129980,0,158575
141235100900000,SE 202,Residential,27692,0,27692,91081,0,118773
141235101000000,SE 202,Residential,43926,0,43926,151276,0,195202
141235200600000,SE 202,Residential,42405,0,42405,104939,0,147344
141235200700000,SE 202,Residential,42330,0,42330,120216,0,162546
141235200800000,SE 202,Residential,53550,0,53550,156538,0,210088
141235200900000,SE 202,Residential,74600,0,74600,122911,0,197511
141235201000000,SE 202,Residential,59940,0,59940,124101,0,184041
141322601500000,SE 202,Residential,159200,0,159200,461410,0,620610
141322601600000,SE 202,Residential,152900,0,152900,543864,0,696764
141330102100000,SE 211,Residential,100650,0,100650,236306,0,336956
141332600900000,CITY PROPERTY,Exempt,0,0,0,0,0,0
141332601000000,CHURCH,Exempt,0,389394,389394,0,2467650,2857044
141332601100000,CHURCH,Exempt,0,302400,302400,0,1719187,2021587
141335100100000,SE 211,Residential,49000,0,49000,0,0,49000
141335100200000,SE 211,Residential,48853,0,48853,330608,0,379461
141335100300000,SE 211,Residential,51362,0,51362,229079,0,280441
141335100400000,SE 211,Residential,65220,0,65220,0,0,65220
141335100500000,SE 211,Residential,64770,0,64770,417416,0,482186
141335100600000,SE 211,Residential,61958,0,61958,0,0,61958
141335100700000,SE 211,Residential,48853,0,48853,0,0,48853
141335100800000,SE 211,Residential,49000,0,49000,222604,0,271604
141335100900000,SE 211,Residential,59042,0,59042,156883,0,215925
141335101000000,SE 211,Residential,59051,0,59051,184309,0,243360
141335101100000,CHURCH,Exempt,0,139507,139507,0,413751,553258
141335101600000,SE 211,Residential,105150,0,105150,201829,0,306979
141335101800000,SE 211,Residential,99850,0,99850,342073,0,441923
141335101900000,SE 211,Residential,62417,0,62417,235391,0,297808
141335102000000,SE 211,Residential,145907,0,145907,247828,0,393735
141335102100000,SE 211,Residential,137679,0,137679,420699,0,558378
141335102200000,SE 211,Residential,141680,0,141680,299490,0,441170
141335102300000,SE 211,Residential,145288,0,145288,376273,0,521561
141335102400000,SE 211,Residential,136447,0,136447,325636,0,462083
141335102500000,SE 211,Residential,141781,0,141781,168219,0,310000
141335200100000,SE 211,Residential,55400,0,55400,154617,0,210017
141335200400000,SE 211,Residential,55400,0,55400,172421,0,227821
141335200500000,SE 211,Residential,59596,0,59596,178679,0,238275
141335200600000,SE 211,Residential,51400,0,51400,150160,0,201560
141335200700000,SE 211,Residential,59400,0,59400,163556,0,222956
141337600100000,SE 210,Residential,131200,0,131200,345379,0,476579
141337600200000,SE 210,Residential,100800,0,100800,73386,0,174186
141337600300000,SE 210,Residential,101500,0,101500,85019,0,186519
141337600500000,SE 210,Residential,198600,0,198600,645796,0,844396
141337600600000,SE 210,Residential,194529,0,194529,632471,0,827000
141337600700000,SE 210,Residential,192900,0,192900,571763,0,764663
141337601000000,SE 210,Residential,39235,0,39235,208121,0,247356
141337601100000,SE 210,Residential,38528,0,38528,220409,0,258937
141337601200000,SE 210,Residential,40637,0,40637,203354,0,243991
141337601300000,SE 210,Residential,42299,0,42299,216594,0,258893
141337601400000,SE 210,Residential,43353,0,43353,202289,0,245642
141337601500000,SE 210,Residential,44965,0,44965,228040,0,273005
141337601600000,SE 210,Residential,39350,0,39350,175303,0,214653
141337601700000,SE 210,Residential,43697,0,43697,256322,0,300019
141337601800000,SE 210,Residential,45711,0,45711,219369,0,265080
141337601900000,SE 210,Residential,40534,0,40534,224878,0,265412
141337602000000,CITY PROPERTY,Exempt,0,0,0,0,0,0
141337602100000,CITY PROPERTY,Exempt,0,0,0,0,0,0
141337700100000,SE 210,Residential,37892,0,37892,184576,0,222468
141337700200000,SE 210,Residential,35998,0,35998,187018,0,223016
141337700300000,SE 210,Residential,35864,0,35864,181165,0,217029
141337700400000,SE 210,Residential,38745,0,38745,204482,0,243227
141337700500000,SE 210,Residential,41944,0,41944,176914,0,218858
141337700600000,SE 210,Residential,44356,0,44356,229120,0,273476
141340100300000,SE 244,Residential,5900,0,5900,0,0,5900
141340200300000,SE 209,Residential,94870,0,94870,210375,0,305245
141340200400000,SE 209,Residential,94420,0,94420,329834,0,424254
141345100100000,SE 209,Residential,58077,0,58077,146491,0,204568
141345100200000,SE 209,Residential,59430,0,59430,171737,0,231167
141345100300000,SE 209,Residential,81515,0,81515,161761,0,243276
141345100500000,SE 209,Residential,84567,0,84567,174812,0,259379
141345100600000,SE 209,Residential,90050,0,90050,140826,0,230876
141345100700000,SE 209,Residential,84908,0,84908,147463,0,232371
141345100800000,SE 209,Residential,56500,0,56500,141546,0,198046
141345100900000,SE 209,Residential,56500,0,56500,162086,0,218586
141345101000000,SE 209,Residential,56501,0,56501,137574,0,194075
141345101100000,SE 209,Residential,47999,0,47999,125458,0,173457
141345101200000,SE 209,Residential,47999,0,47999,142415,0,190414
141345101300000,SE 209,Residential,54500,0,54500,137767,0,192267
141345200100000,SE 209,Residential,45282,0,45282,169516,0,214798
141345200200000,SE 209,Residential,42000,0,42000,150713,0,192713
141345200300000,SE 209,Residential,42000,0,42000,144806,0,186806
141345200400000,SE 209,Residential,42501,0,42501,176726,0,219227
141345200500000,SE 209,Residential,40500,0,40500,118210,0,158710
141345200600000,SE 209,Residential,40000,0,40000,114062,0,154062
141345200700000,SE 209,Residential,39999,0,39999,130243,0,170242
141345200800000,SE 209,Residential,44467,0,44467,108467,0,152934
141345300100000,SE 209,Residential,62900,0,62900,178528,0,241428
141345300200000,SE 209,Residential,82694,0,82694,209414,0,292108
141345300300000,SE 209,Residential,65119,0,65119,175394,0,240513
141345300400000,SE 209,Residential,67833,0,67833,145284,0,213117
141345300500000,SE 209,Residential,64301,0,64301,128364,0,192665
141345300600000,SE 209,Residential,65625,0,65625,176403,0,242028
141345300700000,SE 209,Residential,67679,0,67679,178409,0,246088
141345300800000,SE 209,Residential,63599,0,63599,194742,0,258341
141345300900000,SE 209,Residential,64473,0,64473,185878,0,250351
141345301000000,SE 209,Residential,61997,0,61997,122883,0,184880
141345301100000,SE 209,Residential,49854,0,49854,172313,0,222167
141345301200000,SE 209,Residential,52155,0,52155,163455,0,215610
141345301300000,SE 209,Residential,37270,0,37270,198376,0,235646
141345301400000,SE 209,Residential,42004,0,42004,152597,0,194601
141345301500000,SE 209,Residential,42677,0,42677,201290,0,243967
141345301600000,SE 209,Residential,41638,0,41638,172410,0,214048
141345301700000,SE 209,Residential,41149,0,41149,141145,0,182294
141345301800000,SE 209,Residential,42613,0,42613,149986,0,192599
141345301900000,SE 209,Residential,45210,0,45210,196772,0,241982
141345302000000,SE 209,Residential,45451,0,45451,172460,0,217911
141345302100000,SE 209,Residential,41035,0,41035,136896,0,177931
141345302200000,SE 209,Residential,38962,0,38962,131858,0,170820
141345302300000,SE 209,Residential,38950,0,38950,158875,0,197825
141345302400000,SE 209,Residential,42450,0,42450,149361,0,191811
141345302500000,SE 209,Residential,48925,0,48925,159913,0,208838
141345302600000,SE 209,Residential,38442,0,38442,153423,0,191865
141345302700000,SE 209,Residential,39527,0,39527,125035,0,164562
141345302800000,SE 209,Residential,41410,0,41410,152764,0,194174
141345302900000,SE 209,Residential,41650,0,41650,160157,0,201807
141345303000000,SE 209,Residential,43262,0,43262,136950,0,180212
141345303100000,SE 209,Residential,40999,0,40999,175032,0,216031
141345303200000,SE 209,Residential,45933,0,45933,187082,0,233015
141345303300000,SE 209,Residential,49300,0,49300,199669,0,248969
141345303400000,SE 209,Residential,44083,0,44083,171676,0,215759
141345303500000,SE 209,Residential,58672,0,58672,203387,0,262059
141345303600000,SE 209,Residential,56990,0,56990,180150,0,237140
141345303700000,SE 209,Residential,59274,0,59274,210570,0,269844
141345400100000,CITY PROPERTY,Exempt,0,0,0,0,0,0
141347700100000,SE 209,Residential,88766,0,88766,200639,0,289405
141347700200000,SE 209,Residential,81822,0,81822,219845,0,301667
141347700300000,SE 209,Residential,90000,0,90000,86600,0,176600
141347700400000,SE 209,Residential,91300,0,91300,116551,0,207851
141347700500000,SE 209,Residential,90800,0,90800,149059,0,239859
141347700600000,SE 209,Residential,84612,0,84612,148351,0,232963
141347700700000,SE 209,Residential,58036,0,58036,164969,0,223005
141347700800000,SE 209,Residential,90005,0,90005,189014,0,279019
141347700900000,SE 209,Residential,90050,0,90050,136122,0,226172
141347701000000,SE 209,Residential,90800,0,90800,166696,0,257496
141347701100000,SE 209,Residential,91050,0,91050,202214,0,293264
141347701200000,SE 209,Residential,73445,0,73445,125757,0,199202
141347701300000,SE 209,Residential,68413,0,68413,129996,0,198409
141347701400000,SE 209,Residential,61415,0,61415,144782,0,206197
141347701500000,SE 209,Residential,68425,0,68425,165588,0,234013
141347701600000,SE 209,Residential,82331,0,82331,106659,0,188990
141347701700000,SE 209,Residential,90150,0,90150,128976,0,219126
141347701800000,SE 209,Residential,90399,0,90399,181244,0,271643
141347701900000,SE 209,Residential,96350,0,96350,247518,0,343868
141347702000000,SE 209,Residential,54385,0,54385,107784,0,162169
141347800100000,SE 209,Residential,90250,0,90250,163522,0,253772
141347800200000,SE 209,Residential,86255,0,86255,199209,0,285464
141347800300000,SE 209,Residential,90050,0,90050,191376,0,281426
141347800400000,SE 209,Residential,61051,0,61051,210012,0,271063
141347800500000,SE 209,Residential,55980,0,55980,213950,0,269930
141410100100000,HOTEL,Commercial,0,1352095,1352095,0,3942816,5294911
141420100100000,CITY PROPERTY,Exempt,0,0,0,0,0,0
141420100200000,CITY PROPERTY,Exempt,0,0,0,0,0,0
141420100300000,SE 201,Residential,24603,0,24603,69622,0,94225
141420100400000,SE 201,Residential,30282,0,30282,86915,0,117197
141420100500000,SE 201,Residential,26265,0,26265,81157,0,107422
141420100600000,SE 201,Residential,20600,0,20600,55836,0,76436
141420100700000,SE 201,Residential,20600,0,20600,132584,0,153184
141420100800000,APARTMENT,Commercial,0,13182,13182,0,110724,123906
141420100900000,SE 201,Residential,22400,0,22400,106208,0,128608
141420101000000,SE 201,Residential,30000,0,30000,85036,0,115036
141420101100000,SE 201,Residential,33250,0,33250,112906,0,146156
141420101200000,SE 201,Residential,27500,0,27500,65675,0,93175
141420101300000,SE 201,Residential,31725,0,31725,89405,0,121130
141420101400000,SE 201,Residential,37879,0,37879,140590,0,178469
141420200100000,SE 201,Residential,12114,0,12114,80257,0,92371
141420200200000,APARTMENT,Commercial,0,49680,49680,0,907537,957217
141420200300000,APARTMENT,Commercial,0,43047,43047,0,456953,500000
141420200400000,SE 201,Residential,20000,0,20000,105402,0,125402
141420200500000,SE 201,Residential,23520,0,23520,67001,0,90521
141420200600000,SE 201,Residential,23520,0,23520,64356,0,87876
141420200700000,APARTMENT,Commercial,0,33696,33696,0,590304,624000
141420200800000,SE 201,Residential,20000,0,20000,123218,0,143218
141420200900000,SE 201,Residential,23840,0,23840,114670,0,138510
141420201000000,SE 201,Residential,17800,0,17800,77265,0,95065
141420201100000,SE 201,Residential,13400,0,13400,80122,0,93522
141420300100000,VACANT LAND,Commercial,0,2743,2743,0,0,2743
141420300200000,SE 203,Residential,148500,0,148500,623301,0,771801
141420300300000,SE 201,Residential,31798,0,31798,147704,0,179502
141420300400000,SE 201,Residential,24250,0,24250,105507,0,129757
141420300500000,SE 201,Residential,25500,0,25500,110189,0,135689
141420300600000,SE 201,Residential,23460,0,23460,121474,0,144934
141420300700000,CONVERSION,Residential,27063,0,27063,0,0,27063
141420300800000,SE 201,Residential,20400,0,20400,102852,0,123252
141420300900000,SE 201,Residential,21278,0,21278,93933,0,115211
141420301000000,SE 201,Residential,26873,0,26873,90884,0,117757
141420301100000,SE 201,Residential,29154,0,29154,74740,0,103894
141420301200000,SE 201,Residential,22644,0,22644,141020,0,163664
141420301300000,SE 201,Residential,16072,0,16072,120064,0,136136
141420301400000,SE 201,Residential,15680,0,15680,99964,0,115644
141420301500000,SE 201,Residential,15680,0,15680,112818,0,128498
141420301600000,SE 201,Residential,23912,0,23912,137721,0,161633
141420301700000,SE 201,Residential,23912,0,23912,66025,0,89937
141420301800000,SE 201,Residential,19600,0,19600,85141,0,104741
141420301900000,SE 201,Residential,20384,0,20384,119717,0,140101
141420302000000,SE 201,Residential,16072,0,16072,78286,0,94358
141420302100000,SE 201,Residential,15680,0,15680,82340,0,98020
141420302200000,SE 201,Residential,32548,0,32548,114796,0,147344
141420302300000,SE 201,Residential,21702,0,21702,67446,0,89148
141420302400000,SE 203,Residential,66960,0,66960,143822,0,210782
141420302500000,SE 203,Residential,75888,0,75888,183402,0,259290
141420302600000,SE 203,Residential,95100,0,95100,274545,0,369645
141420302700000,SE 203,Residential,131100,0,131100,297300,0,428400
141420302800000,SE 203,Residential,139300,0,139300,534250,0,673550
141420400100000,SE 203,Residential,65025,0,65025,121460,0,186485
141420400200000,SE 203,Residential,41580,0,41580,86639,0,128219
141420400300000,SE 203,Residential,51540,0,51540,0,0,51540
141420400400000,SE 203,Residential,44520,0,44520,136469,0,180989
141420400500000,SE 203,Residential,42000,0,42000,124260,0,166260
141420400600000,SE 203,Residential,33120,0,33120,146732,0,179852
141420400700000,SE 203,Residential,73842,0,73842,126375,0,200217
141420400800000,SE 203,Residential,55965,0,55965,140079,0,196044
141420400900000,SE 203,Residential,54203,0,54203,113964,0,168167
141420401000000,SE 203,Residential,51675,0,51675,130320,0,181995
141420401100000,SE 203,Residential,51404,0,51404,122896,0,174300
141420401200000,SE 203,Residential,52163,0,52163,116855,0,169018
141420401300000,SE 203,Residential,51188,0,51188,114049,0,165237
141420401400000,SE 203,Residential,61100,0,61100,130123,0,191223
141420401500000,SE 203,Residential,60435,0,60435,121163,0,181598
141420500100000,SE 203,Residential,44980,0,44980,103515,0,148495
141420500200000,SE 203,Residential,46375,0,46375,127503,0,173878
141420500300000,SE 203,Residential,49050,0,49050,100909,0,149959
141420500400000,SE 203,Residential,49500,0,49500,148857,0,198357
141420500500000,SE 203,Residential,46350,0,46350,95073,0,141423
141420500600000,SE 203,Residential,47424,0,47424,95496,0,142920
141420500700000,SE 203,Residential,29963,0,29963,94634,0,124597
141420500800000,SE 203,Residential,30260,0,30260,96306,0,126566
141420500900000,SE 203,Residential,22440,0,22440,88032,0,110472
141420501000000,SE 203,Residential,22440,0,22440,80893,0,103333
141422600100000,FLAT PARKING,Commercial,0,39739,39739,0,7906,47645
141422600200000,FLAT PARKING,Commercial,0,78246,78246,0,8610,86856
141422600300000,LG DISCOUNT/RETAIL,Commercial,0,430920,430920,0,800075,1230995
141422600400000,FLAT PARKING,Commercial,0,140616,140616,0,17220,157836
141422600500000,SE 201,Residential,26160,0,26160,94518,0,120678
141422600600000,FLAT PARKING,Commercial,0,12474,12474,0,1722,14196
141422700100000,CONVENIENCE STORE,Commercial,0,203634,203634,0,233003,436637
141422700200000,FLAT PARKING,Commercial,0,13738,13738,0,2035,15773
141422700300000,SMALL RETAIL,Commercial,0,11081,11081,0,58269,69350
141422700400000,VACANT LAND,Commercial,0,17788,17788,0,0,17788
141422700800000,OFFICE,Commercial,0,391500,391500,0,2224044,2615544
141422700900000,SMALL RETAIL,Commercial,0,190350,190350,0,643790,834140
141422701000000,OFFICE,Commercial,0,410400,410400,0,1069662,1480062
141422701100000,NE 141,Residential,15792,0,15792,63841,0,79633
141422701200000,NE 141,Residential,18432,0,18432,69091,0,87523
141422701300000,NE 141,Residential,31752,0,31752,92532,0,124284
141422701400000,SMALL RETAIL,Commercial,0,25272,25272,0,144945,170217
141422701500000,FLAT PARKING,Commercial,0,52920,52920,0,3517,56437
141422701600000,SMALL RETAIL,Commercial,0,58590,58590,0,134861,193451
141422701700000,SMALL RETAIL,Commercial,0,48600,48600,0,147994,196594
141422701800000,AUTO REPAIR/SALES,Commercial,0,121500,121500,0,88959,210459
141422800200000,NE 141,Residential,31200,0,31200,102459,0,133659
141422800300000,NE 141,Residential,31200,0,31200,71340,0,102540
141422800400000,NE 141,Residential,31200,0,31200,78861,0,110061
141422800500000,NE 141,Residential,31200,0,31200,117875,0,149075
141422800600000,NE 141,Residential,31200,0,31200,76739,0,107939
141422800700000,NE 141,Residential,31200,0,31200,74329,0,105529
141422800800000,NE 141,Residential,31200,0,31200,97592,0,128792
141422800900000,NE 141,Residential,31200,0,31200,95220,0,126420
141422801000000,NE 141,Residential,30900,0,30900,64411,0,95311
141422801100000,NE 141,Residential,30900,0,30900,71610,0,102510
141422801200000,NE 141,Residential,30900,0,30900,62759,0,93659
141422801300000,NE 141,Residential,29664,0,29664,46813,0,76477
141422801400000,NE 141,Residential,30282,0,30282,76290,0,106572
141422801500000,NE 141,Residential,30194,0,30194,68877,0,99071
141422801600000,NE 141,Residential,25650,0,25650,62484,0,88134
141422801700000,NE 141,Residential,30323,0,30323,81085,0,111408
141422801800000,APARTMENT,Commercial,0,11820,11820,0,116156,127976
141422801900000,NE 141,Residential,36239,0,36239,72396,0,108635
141422802000000,OFFICE,Commercial,0,46537,46537,0,168367,214904
141422802200000,APARTMENT,Commercial,0,21870,21870,0,113394,135264
141422802300000,APARTMENT,Commercial,0,25920,25920,0,130384,156304
141422802601000,OFFICE; MEDICAL,Commercial,0,77760,77760,0,329849,407609
141422802601001,OFFICE; MEDICAL,Commercial,0,77760,77760,0,344940,422700
141422900100000,SE 201,Residential,24024,0,24024,91078,0,115102
141422900200000,SE 201,Residential,11088,0,11088,73515,0,84603
141422900300000,SE 201,Residential,19404,0,19404,64023,0,83427
141422900400000,SMALL RETAIL,Commercial,0,128045,128045,0,267934,395979
141422900700000,OFFICE,Commercial,0,220320,220320,0,138720,359040
141422900900000,SE 201,Residential,10080,0,10080,69058,0,79138
141422901000000,SE 201,Residential,10080,0,10080,0,0,10080
141422901100000,SE 201,Residential,6405,0,6405,0,0,6405
141422901200000,SE 201,Residential,8685,0,8685,0,0,8685
141422901300000,SE 201,Residential,18643,0,18643,83301,0,101944
141422901400000,SE 201,Residential,17600,0,17600,92424,0,110024
141422901500000,SE 201,Residential,17600,0,17600,75264,0,92864
141422901600000,SE 201,Residential,22400,0,22400,41020,0,63420
141422901700000,OFFICE,Commercial,0,143100,143100,0,428441,571541
141422901800000,OFFICE; MEDICAL,Commercial,0,205200,205200,0,363967,569167
141422901900000,FLAT PARKING,Commercial,0,77760,77760,0,6912,84672
141423000100000,SE 204,Residential,7350,0,7350,89900,0,97250
141423000200000,SE 204,Residential,7350,0,7350,63471,0,70821
141423000300000,SE 204,Residential,6300,0,6300,47426,0,53726
141423000400000,SE 204,Residential,8400,0,8400,73042,0,81442
141423000500000,SE 204,Residential,12669,0,12669,67079,0,79748
141423000600000,SE 204,Residential,7933,0,7933,79709,0,87642
141423000700000,SE 204,Residential,14503,0,14503,30497,0,45000
141423000800000,SE 204,Residential,16168,0,16168,77897,0,94065
141423000900000,SE 204,Residential,21320,0,21320,97874,0,119194
141423001000000,SE 204,Residential,22200,0,22200,51291,0,73491
141423001100000,SE 204,Residential,26272,0,26272,92061,0,118333
141423001200000,SE 204,Residential,24000,0,24000,92003,0,116003
141423001300000,SE 204,Residential,24000,0,24000,106520,0,130520
141423001400000,SE 204,Residential,14880,0,14880,96628,0,111508
141423001500000,SE 204,Residential,24000,0,24000,126408,0,150408
141423001600000,SE 204,Residential,320,0,320,0,0,320
141423001700000,SE 204,Residential,12000,0,12000,28354,0,40354
141423001800000,SE 204,Residential,16000,0,16000,73355,0,89355
141423100200000,NE 154,Residential,22618,0,22618,71899,0,94517
141423100300000,NE 154,Residential,20592,0,20592,90940,0,111532
141423100400000,NE 154,Residential,20377,0,20377,73539,0,93916
141423100500000,NE 154,Residential,27288,0,27288,79528,0,106816
141423100600000,NE 154,Residential,23760,0,23760,80868,0,104628
141423100700000,NE 154,Residential,23760,0,23760,78009,0,101769
141423100800000,NE 154,Residential,23760,0,23760,109591,0,133351
141423100900000,NE 154,Residential,23760,0,23760,100238,0,123998
141423101000000,NE 154,Residential,23760,0,23760,96635,0,120395
141423101100000,NE 154,Residential,20400,0,20400,100159,0,120559
141423101200000,NE 154,Residential,20400,0,20400,62467,0,82867
141423101300000,CONVERSION,Commercial,0,12312,12312,0,96760,109072
141423101400000,OFFICE,Commercial,0,99462,99462,0,107578,207040
141423200100000,NE 154,Residential,30672,0,30672,86023,0,116695
141423200200000,NE 154,Residential,15246,0,15246,74546,0,89792
141423200300000,NE 154,Residential,14640,0,14640,73025,0,87665
141423200400000,NE 154,Residential,32640,0,32640,106249,0,138889
141423200500000,NE 154,Residential,31533,0,31533,88465,0,119998
141423200600000,NE 154,Residential,30600,0,30600,92704,0,123304
141423200700000,NE 154,Residential,30600,0,30600,108180,0,138780
141423200800000,NE 154,Residential,30600,0,30600,89301,0,119901
141423200900000,NE 154,Residential,30600,0,30600,85661,0,116261
141423201000000,NE 154,Residential,30600,0,30600,102660,0,133260
141423201100000,NE 154,Residential,30600,0,30600,111947,0,142547
141423201200000,NE 154,Residential,30600,0,30600,132874,0,163474
141423201300000,NE 154,Residential,30600,0,30600,119352,0,149952
141423201400000,NE 154,Residential,30600,0,30600,118531,0,149131
141423201500000,NE 154,Residential,30600,0,30600,114807,0,145407
141425100100000,SE 204,Residential,18240,0,18240,103554,0,121794
141425100200000,SE 204,Residential,20400,0,20400,84581,0,104981
141425100300000,SE 204,Residential,14880,0,14880,79970,0,94850
141425100400000,SE 204,Residential,19920,0,19920,95929,0,115849
141425200100000,NE 154,Residential,20400,0,20400,117579,0,137979
141425200200000,NE 154,Residential,23760,0,23760,89630,0,113390
141425200300000,NE 154,Residential,23760,0,23760,96608,0,120368
141425200400000,NE 154,Residential,23760,0,23760,98645,0,122405
141425200500000,NE 154,Residential,23760,0,23760,98749,0,122509
141425200600000,NE 154,Residential,23950,0,23950,71548,0,95498
141425200700000,NE 154,Residential,23950,0,23950,139525,0,163475
141425200800000,NE 154,Residential,23760,0,23760,82770,0,106530
141425200900000,NE 154,Residential,23950,0,23950,107679,0,131629
141425201000000,NE 154,Residential,26872,0,26872,122162,0,149034
141425201100000,NE 154,Residential,27015,0,27015,115026,0,142041
141425201200000,NE 154,Residential,23760,0,23760,77696,0,101456
141425201300000,NE 154,Residential,23760,0,23760,90815,0,114575
141425201400000,NE 154,Residential,23760,0,23760,77675,0,101435
141425201500000,NE 154,Residential,23760,0,23760,117184,0,140944
141425201600000,NE 154,Residential,25200,0,25200,87097,0,112297
141425201700000,NE 154,Residential,26242,0,26242,107018,0,133260
141425201800000,NE 154,Residential,16560,0,16560,98289,0,114849
141425201900000,NE 154,Residential,23268,0,23268,97839,0,121107
141425202000000,NE 154,Residential,10389,0,10389,91123,0,101512
141425202100000,NE 154,Residential,14304,0,14304,131145,0,145449
141425202200000,NE 154,Residential,20400,0,20400,129812,0,150212
141425202300000,NE 154,Residential,20400,0,20400,125332,0,145732
141425202400000,NE 154,Residential,20400,0,20400,119310,0,139710
141425202500000,NE 154,Residential,20400,0,20400,101336,0,121736
141425202600000,NE 154,Residential,24480,0,24480,100430,0,124910
141425202700000,NE 154,Residential,16320,0,16320,68557,0,84877
141425202800000,NE 154,Residential,20547,0,20547,166020,0,186567
141425202900000,NE 154,Residential,20547,0,20547,121733,0,142280
141425203000000,NE 154,Residential,20400,0,20400,122778,0,143178
141425203100000,NE 154,Residential,20400,0,20400,94065,0,114465
141425203200000,NE 154,Residential,20400,0,20400,98318,0,118718
141425300100000,NE 154,Residential,24480,0,24480,122825,0,147305
141425300200000,NE 154,Residential,30600,0,30600,94626,0,125226
141425300300000,NE 154,Residential,30600,0,30600,89900,0,120500
141425300400000,NE 154,Residential,30600,0,30600,88969,0,119569
141425300500000,NE 154,Residential,30600,0,30600,74633,0,105233
141425300600000,NE 154,Residential,30600,0,30600,111526,0,142126
141425300700000,NE 154,Residential,30600,0,30600,114512,0,145112
141425300800000,NE 154,Residential,30600,0,30600,112495,0,143095
141425300900000,NE 154,Residential,30600,0,30600,103543,0,134143
141425301000000,NE 154,Residential,30600,0,30600,100127,0,130727
141425301100000,NE 154,Residential,15840,0,15840,71202,0,87042
141425301200000,NE 154,Residential,16080,0,16080,75611,0,91691
141425301300000,NE 154,Residential,28773,0,28773,107628,0,136401
141425301400000,NE 154,Residential,24480,0,24480,94215,0,118695
141425301500000,NE 154,Residential,24480,0,24480,114341,0,138821
141425301600000,NE 154,Residential,24480,0,24480,82955,0,107435
141425301700000,NE 154,Residential,24480,0,24480,89284,0,113764
141425301800000,NE 154,Residential,24480,0,24480,77920,0,102400
141425301900000,NE 154,Residential,24480,0,24480,91528,0,116008
141425302000000,NE 154,Residential,24480,0,24480,90871,0,115351
141425302100000,NE 154,Residential,24480,0,24480,87513,0,111993
141425302200000,NE 154,Residential,24480,0,24480,93752,0,118232
141425302300000,NE 154,Residential,24480,0,24480,120631,0,145111
141425302400000,NE 154,Residential,24480,0,24480,73048,0,97528
141425302500000,NE 154,Residential,24480,0,24480,100401,0,124881
141425400100000,SE 204,Residential,19200,0,19200,125363,0,144563
141425400200000,SE 204,Residential,24000,0,24000,96871,0,120871
141425400300000,SE 204,Residential,24000,0,24000,118839,0,142839
141425400400000,SE 204,Residential,28000,0,28000,116739,0,144739
141425400500000,SE 204,Residential,20000,0,20000,118367,0,138367
141425400600000,SE 204,Residential,18000,0,18000,94359,0,112359
141425400700000,SE 204,Residential,15580,0,15580,55793,0,71373
141425400800000,SE 204,Residential,15800,0,15800,47471,0,63271
141425400900000,SE 204,Residential,19403,0,19403,76825,0,96228
141425401000000,SE 204,Residential,19600,0,19600,83169,0,102769
141425401100000,SE 204,Residential,23520,0,23520,65333,0,88853
141425401200000,SE 204,Residential,30000,0,30000,75732,0,105732
141425401300000,SE 204,Residential,30000,0,30000,79485,0,109485
141425401400000,SE 204,Residential,30000,0,30000,91959,0,121959
141425401500000,SE 204,Residential,30000,0,30000,105942,0,135942
141425401600000,SE 204,Residential,30000,0,30000,83680,0,113680
141425401700000,SE 204,Residential,20000,0,20000,76798,0,96798
141425401800000,SE 204,Residential,32000,0,32000,88068,0,120068
141425401900000,SE 204,Residential,17050,0,17050,84050,0,101100
141425500100000,SE 204,Residential,30000,0,30000,126474,0,156474
141425500200000,SE 204,Residential,30000,0,30000,136153,0,166153
141425500300000,SE 204,Residential,15000,0,15000,102744,0,117744
141425500400000,SE 204,Residential,15000,0,15000,68456,0,83456
141425500500000,SE 204,Residential,30000,0,30000,75036,0,105036
141425500600000,SE 204,Residential,30000,0,30000,85124,0,115124
141425500700000,SE 204,Residential,30000,0,30000,119461,0,149461
141425500800000,SE 204,Residential,32000,0,32000,119434,0,151434
141425500900000,SE 204,Residential,20000,0,20000,57861,0,77861
141425501000000,SE 204,Residential,16512,0,16512,89287,0,105799
141425501100000,SE 204,Residential,16093,0,16093,81664,0,97757
141425501200000,SE 204,Residential,14075,0,14075,53839,0,67914
141425501300000,SE 204,Residential,13440,0,13440,73767,0,87207
141425501400000,SE 204,Residential,14615,0,14615,77104,0,91719
141425501500000,SE 204,Residential,16104,0,16104,82543,0,98647
141425501600000,SE 204,Residential,30000,0,30000,92187,0,122187
141425501700000,SE 204,Residential,30000,0,30000,96002,0,126002
141425501800000,SE 204,Residential,30000,0,30000,97474,0,127474
141425501900000,SE 204,Residential,30000,0,30000,98614,0,128614
141425502000000,SE 204,Residential,30000,0,30000,103325,0,133325
141425502100000,SE 204,Residential,30000,0,30000,110569,0,140569
141425502200000,SE 204,Residential,30000,0,30000,87358,0,117358
141425502300000,SE 204,Residential,20000,0,20000,43414,0,63414
141425502400000,SE 204,Residential,20000,0,20000,61621,0,81621
141425502500000,SE 204,Residential,20000,0,20000,81310,0,101310
141425600100000,SE 204,Residential,20000,0,20000,69411,0,89411
141425600200000,SE 204,Residential,20000,0,20000,99293,0,119293
141425600300000,SE 204,Residential,20000,0,20000,32462,0,52462
141425600400000,SE 204,Residential,30000,0,30000,91077,0,121077
141425600500000,SE 204,Residential,30000,0,30000,97769,0,127769
141425600600000,SE 204,Residential,31500,0,31500,140937,0,172437
141425600700000,SE 204,Residential,25000,0,25000,84140,0,109140
141425600800000,SE 204,Residential,30000,0,30000,89236,0,119236
141425600900000,SE 204,Residential,30000,0,30000,86567,0,116567
141425601000000,SE 204,Residential,30000,0,30000,59794,0,89794
141425601100000,SE 204,Residential,24896,0,24896,104104,0,129000
141425601200000,SE 204,Residential,23965,0,23965,109025,0,132990
141425601300000,SE 204,Residential,14551,0,14551,70862,0,85413
141425601400000,SE 204,Residential,13184,0,13184,45036,0,58220
141425601500000,SE 204,Residential,19240,0,19240,64736,0,83976
141425601600000,SE 204,Residential,22185,0,22185,111415,0,133600
141425601700000,SE 204,Residential,22500,0,22500,93083,0,115583
141425601800000,SE 204,Residential,22500,0,22500,99178,0,121678
141425601900000,SE 204,Residential,22500,0,22500,138086,0,160586
141425602000000,SE 204,Residential,25000,0,25000,100663,0,125663
141425602100000,SE 204,Residential,27500,0,27500,102036,0,129536
141425602200000,SE 204,Residential,30000,0,30000,86802,0,116802
141425602300000,SE 204,Residential,30000,0,30000,141659,0,171659
141425602400000,SE 204,Residential,31025,0,31025,87395,0,118420
141425602500000,SE 204,Residential,23500,0,23500,121029,0,144529
141425602600000,SE 204,Residential,22500,0,22500,108733,0,131233
141425602700000,SE 204,Residential,22500,0,22500,97145,0,119645
141425602800000,SE 204,Residential,22500,0,22500,104727,0,127227
141425602900000,SE 204,Residential,22500,0,22500,105499,0,127999
141425700600000,SCHOOL,Exempt,0,727488,727488,0,3470821,4198309
141425800100000,NE 154,Residential,22848,0,22848,119412,0,142260
141425800200000,NE 154,Residential,15840,0,15840,63542,0,79382
141425800300000,NE 154,Residential,19800,0,19800,66187,0,85987
141425800400000,NE 154,Residential,24480,0,24480,88009,0,112489
141425800500000,NE 154,Residential,24480,0,24480,105403,0,129883
141425800600000,NE 154,Residential,24480,0,24480,84605,0,109085
141425800700000,NE 154,Residential,24480,0,24480,135543,0,160023
141425800800000,NE 154,Residential,24480,0,24480,96507,0,120987
141425800900000,NE 154,Residential,24480,0,24480,69407,0,93887
141427600100000,SE 203,Residential,63345,0,63345,179331,0,242676
141427700100000,SE 203,Residential,40915,0,40915,134878,0,175793
141427700200000,SE 203,Residential,43350,0,43350,109633,0,152983
141427700300000,SE 203,Residential,79891,0,79891,163946,0,243837
141427700400000,SE 203,Residential,40400,0,40400,78378,0,118778
141427700500000,SE 203,Residential,39600,0,39600,94199,0,133799
141427700600000,SE 203,Residential,39847,0,39847,125335,0,165182
141427700700000,SE 203,Residential,39600,0,39600,107750,0,147350
141427700800000,SE 203,Residential,40800,0,40800,103995,0,144795
141427700900000,SE 203,Residential,44693,0,44693,198465,0,243158
141427701000000,SE 203,Residential,43500,0,43500,136162,0,179662
141427701100000,SE 203,Residential,44188,0,44188,141276,0,185464
141427701200000,SE 203,Residential,44115,0,44115,134318,0,178433
141427701300000,SE 203,Residential,44548,0,44548,146187,0,190735
141427701400000,SE 203,Residential,20,0,20,0,0,20
141427800100000,SE 203,Residential,55900,0,55900,130840,0,186740
141427800200000,SE 203,Residential,52593,0,52593,107741,0,160334
141427800300000,SE 203,Residential,49350,0,49350,137628,0,186978
141427800400000,SE 203,Residential,49899,0,49899,134708,0,184607
141427800500000,SE 203,Residential,54625,0,54625,121845,0,176470
141427800600000,SE 203,Residential,56745,0,56745,161280,0,218025
141427800700000,SE 203,Residential,59045,0,59045,162293,0,221338
141427800800000,SE 203,Residential,62258,0,62258,167227,0,229485
141427800900000,SE 203,Residential,65178,0,65178,231582,0,296760
141427801000000,SE 203,Residential,56375,0,56375,170403,0,226778
141427801100000,SE 203,Residential,56325,0,56325,138919,0,195244
141427801200000,SE 203,Residential,56250,0,56250,193297,0,249547
141427801300000,SE 203,Residential,56250,0,56250,147695,0,203945
141427801400000,SE 203,Residential,56250,0,56250,221247,0,277497
141427801500000,SE 203,Residential,56250,0,56250,119416,0,175666
141427900100000,SE 203,Residential,54270,0,54270,136220,0,190490
141427900200000,SE 203,Residential,61155,0,61155,158071,0,219226
141427900300000,SE 203,Residential,41160,0,41160,166603,0,207763
141427900400000,SE 203,Residential,40800,0,40800,113385,0,154185
141427900500000,SE 203,Residential,40824,0,40824,145671,0,186495
141427900600000,SE 203,Residential,40776,0,40776,158040,0,198816
141427900700000,SE 203,Residential,36960,0,36960,120147,0,157107
141427900800000,SE 203,Residential,38800,0,38800,109460,0,148260
141427900900000,SE 203,Residential,38160,0,38160,117983,0,156143
141427901000000,SE 203,Residential,41400,0,41400,105654,0,147054
141427901100000,SE 203,Residential,49339,0,49339,117041,0,166380
141427901200000,SE 203,Residential,40740,0,40740,127179,0,167919
141427901300000,SE 203,Residential,39950,0,39950,122595,0,162545
141427901400000,SE 203,Residential,46313,0,46313,97379,0,143692
141427901500000,SE 203,Residential,46800,0,46800,110000,0,156800
141427901600000,SE 203,Residential,47288,0,47288,173795,0,221083
141427901700000,SE 203,Residential,45293,0,45293,70733,0,116026
141427901800000,SE 203,Residential,44625,0,44625,84634,0,129259
141427901900000,SE 203,Residential,45063,0,45063,88938,0,134001
141427902000000,SE 203,Residential,45500,0,45500,93784,0,139284
141427902100000,SE 203,Residential,45938,0,45938,117709,0,163647
141427902200000,SE 203,Residential,46375,0,46375,102283,0,148658
141427902300000,SE 203,Residential,46375,0,46375,126665,0,173040
141428000100000,SE 203,Residential,75153,0,75153,224660,0,299813
141428000200000,SE 203,Residential,51752,0,51752,228573,0,280325
141428000300000,SE 203,Residential,52475,0,52475,121715,0,174190
141428000400000,SE 203,Residential,52500,0,52500,101673,0,154173
141428000500000,SE 203,Residential,51200,0,51200,171801,0,223001
141428000600000,SE 203,Residential,53700,0,53700,208000,0,261700
141428000700000,SE 203,Residential,78712,0,78712,227203,0,305915
141428000800000,SE 203,Residential,84084,0,84084,194792,0,278876
141428000900000,SE 203,Residential,84262,0,84262,302223,0,386485
141428100100000,SE 203,Residential,51700,0,51700,115997,0,167697
141428100200000,SE 203,Residential,43165,0,43165,110601,0,153766
141428100300000,SE 203,Residential,39525,0,39525,100065,0,139590
141428100400000,SE 203,Residential,38827,0,38827,91282,0,130109
141428100500000,SE 203,Residential,39013,0,39013,113993,0,153006
141428100600000,SE 203,Residential,36895,0,36895,95627,0,132522
141428100700000,SE 203,Residential,38465,0,38465,109564,0,148029
141428100800000,SE 203,Residential,37588,0,37588,104107,0,141695
141428100900000,SE 203,Residential,33120,0,33120,103009,0,136129
141428101000000,SE 203,Residential,32305,0,32305,129230,0,161535
141428101100000,SE 203,Residential,32660,0,32660,86824,0,119484
141428101200000,SE 203,Residential,36720,0,36720,138136,0,174856
141428101300000,SE 203,Residential,23650,0,23650,105635,0,129285
141428101400000,SE 203,Residential,25850,0,25850,76514,0,102364
141428101500000,SE 203,Residential,42542,0,42542,103788,0,146330
141428101600000,SE 203,Residential,46802,0,46802,93820,0,140622
141428101700000,SE 203,Residential,43937,0,43937,119030,0,162967
141428101800000,SE 203,Residential,37835,0,37835,110770,0,148605
141428101900000,SE 203,Residential,37288,0,37288,117257,0,154545
141428102000000,SE 203,Residential,37680,0,37680,93835,0,131515
141428102100000,SE 203,Residential,37200,0,37200,122563,0,159763
141428102200000,SE 203,Residential,36813,0,36813,102294,0,139107
141428102300000,SE 203,Residential,37600,0,37600,89958,0,127558
141428102400000,SE 203,Residential,51700,0,51700,109807,0,161507
141428102500000,SE 203,Residential,38775,0,38775,118690,0,157465
141428102600000,SE 203,Residential,38775,0,38775,120030,0,158805
141428200100000,SE 203,Residential,66150,0,66150,338722,0,404872
141428200200000,SE 203,Residential,73848,0,73848,231703,0,305551
141428200300000,SE 203,Residential,97402,0,97402,369356,0,466758
141428200400000,SE 203,Residential,93480,0,93480,197251,0,290731
141428200500000,SE 203,Residential,83967,0,83967,202796,0,286763
141428200600000,SE 203,Residential,108360,0,108360,276592,0,384952
141428200700000,SE 203,Residential,75544,0,75544,209456,0,285000
141428200800000,SE 203,Residential,75600,0,75600,274251,0,349851
141428200900000,SE 203,Residential,48600,0,48600,179494,0,228094
141428201000000,SE 203,Residential,46710,0,46710,165994,0,212704
141428201100000,SE 203,Residential,55105,0,55105,173184,0,228289
141428201200000,SE 203,Residential,43725,0,43725,129774,0,173499
141428201300000,SE 203,Residential,42263,0,42263,123853,0,166116
141428201400000,SE 203,Residential,38480,0,38480,118994,0,157474
141428201500000,SE 203,Residential,37740,0,37740,70851,0,108591
141428201600000,SE 203,Residential,37370,0,37370,100099,0,137469
141428201700000,SE 203,Residential,37240,0,37240,106369,0,143609
141428201800000,SE 203,Residential,37050,0,37050,80345,0,117395
141428201900000,SE 203,Residential,42300,0,42300,108411,0,150711
141428300100000,SE 203,Residential,41600,0,41600,88933,0,130533
141428300200000,SE 203,Residential,28665,0,28665,62196,0,90861
141428300300000,SE 203,Residential,34010,0,34010,75200,0,109210
141428300400000,SE 203,Residential,37620,0,37620,102511,0,140131
141428300500000,SE 203,Residential,37588,0,37588,102244,0,139832
141428300600000,SE 203,Residential,49743,0,49743,110246,0,159989
141428300700000,SE 203,Residential,41860,0,41860,90357,0,132217
141428300800000,SE 203,Residential,30708,0,30708,79794,0,110502
141430100100000,SE 203,Residential,111900,0,111900,329192,0,441092
141430100200000,SCHOOL,Exempt,0,0,0,0,0,0
141432600100000,SE 208,Residential,32700,0,32700,104989,0,137689
141432600200000,VACANT LAND,Residential,30600,0,30600,136318,0,166918
141432600202000,ANTENNAS/TOWERS(BLL),Commercial,0,0,0,0,13572,13572
141432600300000,SE 208,Residential,32700,0,32700,90406,0,123106
141432600400000,SE 208,Residential,32700,0,32700,98844,0,131544
141432600500000,SE 208,Residential,34360,0,34360,161530,0,195890
141432600600000,SE 208,Residential,35000,0,35000,143019,0,178019
141432600700000,SE 208,Residential,35640,0,35640,168961,0,204601
141432600800000,SE 208,Residential,40131,0,40131,156956,0,197087
141432600900000,SE 208,Residential,39600,0,39600,130655,0,170255
141432601000000,SE 208,Residential,39069,0,39069,151430,0,190499
141432601100000,SE 208,Residential,34360,0,34360,103121,0,137481
141432601200000,SE 208,Residential,35000,0,35000,94218,0,129218
141432601300000,SE 208,Residential,35640,0,35640,139626,0,175266
141432700100000,SE 208,Residential,35633,0,35633,189126,0,224759
141432700200000,SE 208,Residential,31500,0,31500,105868,0,137368
141432700300000,SE 208,Residential,31500,0,31500,83387,0,114887
141432800100000,NE 154,Residential,40000,0,40000,0,0,40000
141432800300000,OFFICE,Commercial,0,218700,218700,0,82709,301409
141432800400000,VACANT LAND,Commercial,0,54540,54540,0,0,54540
141432800500000,OFFICE,Commercial,0,120032,120032,0,184157,304189
141432900100000,CHURCH,Exempt,0,32724,32724,0,21373,54097
141432900200000,SE 208,Exempt,0,70200,70200,0,186178,256378
141432900300000,SE 208,Residential,70200,0,70200,201880,0,272080
141432900400000,SE 208,Residential,70200,0,70200,199004,0,269204
141432900500000,SE 208,Residential,70200,0,70200,237421,0,307621
141432900600000,SE 208,Residential,69000,0,69000,0,0,69000
141432900700000,SE 208,Residential,109200,0,109200,222724,0,331924
141432900800000,SE 208,Residential,43307,0,43307,0,0,43307
141432900900000,VACANT LAND,Commercial,0,19029,19029,0,0,19029
141432901000000,APARTMENT,Residential,517320,0,517320,18806897,0,19324217
141432901400000,CHURCH,Exempt,0,101520,101520,0,1326868,1428388
141432901501000,VACANT LAND,Commercial,0,18808,18808,0,0,18808
141435201500000,SE 218,Residential,116000,0,116000,220161,0,336161
141435400100000,SE 207,Residential,26500,0,26500,47863,0,74363
141435400200000,SE 207,Residential,24000,0,24000,102029,0,126029
141435400300000,SE 207,Residential,38987,0,38987,83467,0,122454
141435400400000,SE 207,Residential,42613,0,42613,91934,0,134547
141435400500000,SE 207,Residential,43200,0,43200,88583,0,131783
141435500100000,SE 218,Residential,88000,0,88000,204911,0,292911
141435500200000,SE 218,Residential,49711,0,49711,223511,0,273222
141435500300000,SE 218,Residential,58432,0,58432,169042,0,227474
141437600100000,SE 207,Residential,90050,0,90050,173302,0,263352
141437600200000,SE 207,Residential,82350,0,82350,133728,0,216078
141437600300000,SE 207,Residential,64050,0,64050,147704,0,211754
141437600400000,SE 207,Residential,64050,0,64050,197450,0,261500
141437600500000,SE 207,Residential,56682,0,56682,159945,0,216627
141437600600000,SE 207,Residential,25300,0,25300,79554,0,104854
141437600700000,SE 207,Residential,31815,0,31815,103592,0,135407
141437600800000,SE 207,Residential,28280,0,28280,70032,0,98312
141437600900000,SE 207,Residential,32825,0,32825,136672,0,169497
141437601000000,SE 207,Residential,33132,0,33132,115678,0,148810
141437601100000,SE 207,Residential,31415,0,31415,71494,0,102909
141437601200000,SE 207,Residential,31415,0,31415,97392,0,128807
141437601300000,SE 207,Residential,37698,0,37698,158783,0,196481
141437601400000,SE 207,Residential,35342,0,35342,115562,0,150904
141437601500000,SE 207,Residential,34776,0,34776,192690,0,227466
141437700100000,SE 207,Residential,23397,0,23397,142918,0,166315
141437700200000,SE 207,Residential,48111,0,48111,114857,0,162968
141437700300000,SE 207,Residential,38174,0,38174,117413,0,155587
141437700400000,SE 207,Residential,25000,0,25000,104542,0,129542
141437700500000,SE 207,Residential,20000,0,20000,68318,0,88318
141437700600000,SE 207,Residential,20000,0,20000,77576,0,97576
141437700700000,SE 207,Residential,20000,0,20000,77828,0,97828
141437700800000,SE 207,Residential,20000,0,20000,68236,0,88236
141437700900000,SE 207,Residential,20000,0,20000,83275,0,103275
141437701000000,SE 207,Residential,25000,0,25000,61081,0,86081
141437701100000,SE 207,Residential,25000,0,25000,89118,0,114118
141437701200000,SE 207,Residential,25000,0,25000,78033,0,103033
141437701300000,SE 207,Residential,20000,0,20000,77564,0,97564
141437701400000,SE 207,Residential,20000,0,20000,75403,0,95403
141437701500000,SE 207,Residential,25000,0,25000,63927,0,88927
141437701600000,SE 207,Residential,28000,0,28000,57098,0,85098
141437800100000,SE 207,Residential,70190,0,70190,162837,0,233027
141437800200000,SE 207,Residential,25000,0,25000,67398,0,92398
141437800400000,SE 207,Residential,35000,0,35000,88624,0,123624
141437800500000,SE 207,Residential,25000,0,25000,79441,0,104441
141437800600000,SE 207,Residential,35000,0,35000,126645,0,161645
141437800700000,SE 207,Residential,18200,0,18200,59405,0,77605
141437800800000,SE 207,Residential,21750,0,21750,64523,0,86273
141437800900000,SE 207,Residential,21750,0,21750,66258,0,88008
141437801000000,SE 207,Residential,25000,0,25000,75298,0,100298
141437801100000,SE 207,Residential,25000,0,25000,76127,0,101127
141437801200000,SE 207,Residential,25000,0,25000,80315,0,105315
141437801300000,SE 207,Residential,27000,0,27000,107695,0,134695
141437900100000,SE 207,Residential,36720,0,36720,117836,0,154556
141437900200000,SE 207,Residential,30300,0,30300,91636,0,121936
141437900300000,SE 207,Residential,30300,0,30300,76134,0,106434
141437900400000,SE 207,Residential,31200,0,31200,61301,0,92501
141437900500000,SE 207,Residential,41003,0,41003,71000,0,112003
141437900600000,SE 207,Residential,36360,0,36360,196189,0,232549
141437900700000,SE 207,Residential,52380,0,52380,87489,0,139869
141437900800000,SE 207,Residential,33950,0,33950,83479,0,117429
141437900900000,SE 207,Residential,34821,0,34821,126213,0,161034
141438000100000,SE 207,Residential,31101,0,31101,99903,0,131004
141438000200000,SE 207,Residential,31101,0,31101,120164,0,151265
141438000300000,SE 207,Residential,25250,0,25250,83402,0,108652
141438000400000,SE 207,Residential,25250,0,25250,84621,0,109871
141438000500000,SE 207,Residential,35350,0,35350,92827,0,128177
141438000600000,SE 207,Residential,25250,0,25250,94864,0,120114
141438000700000,SE 207,Residential,25250,0,25250,52968,0,78218
141438000800000,SE 207,Residential,25250,0,25250,114281,0,139531
141438000900000,SE 207,Residential,34340,0,34340,89444,0,123784
141438001000000,SE 207,Residential,37875,0,37875,141993,0,179868
141438001100000,SE 207,Residential,32137,0,32137,83925,0,116062
141438001200000,SE 207,Residential,32194,0,32194,74054,0,106248
141438001300000,SE 207,Residential,29357,0,29357,68769,0,98126
141438001400000,SE 207,Residential,29290,0,29290,71287,0,100577
141438001500000,SE 207,Residential,29290,0,29290,102499,0,131789
141438100100000,SE 207,Residential,25000,0,25000,117889,0,142889
141438100200000,SE 207,Residential,25000,0,25000,65777,0,90777
141438100300000,SE 207,Residential,25000,0,25000,80552,0,105552
141438100400000,SE 207,Residential,25000,0,25000,83449,0,108449
141438100500000,SE 207,Residential,25000,0,25000,65868,0,90868
141438100600000,SE 207,Residential,25000,0,25000,65722,0,90722
141438100700000,SE 207,Residential,25000,0,25000,67177,0,92177
141438100800000,SE 207,Residential,25000,0,25000,64407,0,89407
141438100900000,SE 207,Residential,25000,0,25000,63010,0,88010
141438101000000,SE 207,Residential,25000,0,25000,67876,0,92876
141438101100000,SE 207,Residential,35000,0,35000,115211,0,150211
141438101200000,SE 207,Residential,35000,0,35000,155224,0,190224
141438101300000,SE 207,Residential,25000,0,25000,87550,0,112550
141438101400000,SE 207,Residential,25000,0,25000,62128,0,87128
141438101500000,SE 207,Residential,25000,0,25000,67410,0,92410
141438101600000,SE 207,Residential,25000,0,25000,115168,0,140168
141438101700000,SE 207,Residential,25000,0,25000,77768,0,102768
141438101800000,SE 207,Residential,25000,0,25000,72215,0,97215
141438101900000,SE 207,Residential,25000,0,25000,81634,0,106634
141438102000000,SE 207,Residential,25000,0,25000,108202,0,133202
141438200100000,SE 207,Residential,25000,0,25000,84547,0,109547
141438200200000,SE 207,Residential,25000,0,25000,127240,0,152240
141438200300000,SE 207,Residential,32800,0,32800,153178,0,185978
141438200400000,SE 207,Residential,32000,0,32000,147366,0,179366
141438200500000,SE 207,Residential,32062,0,32062,110826,0,142888
141438200600000,SE 207,Residential,33425,0,33425,154610,0,188035
141438200700000,SE 207,Residential,28125,0,28125,67795,0,95920
141438200800000,SE 207,Residential,32500,0,32500,151184,0,183684
141438200900000,SE 207,Residential,27300,0,27300,113223,0,140523
141438201000000,SE 207,Residential,29074,0,29074,100285,0,129359
141438201100000,SE 207,Residential,25000,0,25000,74907,0,99907
141438201200000,SE 207,Residential,25000,0,25000,63422,0,88422
141438201300000,SE 207,Residential,25000,0,25000,42730,0,67730
141438201400000,SE 207,Residential,25000,0,25000,75338,0,100338
141438201500000,SE 207,Residential,25000,0,25000,68427,0,93427
141438201600000,SE 207,Residential,25000,0,25000,76536,0,101536
141438201700000,SE 207,Residential,25000,0,25000,74802,0,99802
141438201800000,SE 207,Residential,25000,0,25000,82541,0,107541
141438300100000,SE 207,Residential,100510,0,100510,126964,0,227474
141438300200000,SE 207,Residential,76700,0,76700,240142,0,316842
141438300300000,SE 207,Residential,100300,0,100300,154883,0,255183
141438300400000,SE 207,Residential,64165,0,64165,130507,0,194672
141438300500000,SE 207,Residential,56500,0,56500,113016,0,169516
141438300600000,SE 207,Residential,56500,0,56500,133941,0,190441
141438300700000,SE 207,Residential,56500,0,56500,94618,0,151118
141438300800000,SE 207,Residential,28250,0,28250,62556,0,90806
141438300900000,SE 207,Residential,28250,0,28250,80240,0,108490
141438301000000,SE 207,Residential,28250,0,28250,55247,0,83497
141438301100000,SE 207,Residential,28250,0,28250,72531,0,100781
141438301200000,SE 207,Residential,28250,0,28250,55442,0,83692
141438301300000,SE 207,Residential,32205,0,32205,74468,0,106673
141438301400000,SE 207,Residential,32544,0,32544,62336,0,94880
141438301500000,SE 207,Residential,26500,0,26500,93885,0,120385
141440100100000,SE 211,Residential,6280,0,6280,0,0,6280
141440100200000,SE 211,Residential,175500,0,175500,455028,0,630528
141440100300000,SE 211,Residential,160500,0,160500,328680,0,489180
141440100400000,SE 211,Residential,162000,0,162000,317955,0,479955
141440100500000,SE 211,Residential,103400,0,103400,285408,0,388808
141440100600000,SE 211,Residential,75075,0,75075,267090,0,342165
141440100700000,SE 211,Residential,82338,0,82338,299835,0,382173
141440100800000,SE 211,Residential,85020,0,85020,275312,0,360332
141440100900000,SE 211,Residential,85902,0,85902,376406,0,462308
141440101000000,SE 211,Residential,83046,0,83046,269171,0,352217
141440101100000,SE 211,Residential,155250,0,155250,246275,0,401525
141440101200000,SE 211,Residential,153900,0,153900,139017,0,292917
141440101300000,SE 211,Residential,153150,0,153150,155969,0,309119
141440101400000,SE 211,Residential,82800,0,82800,194841,0,277641
141440101500000,SE 211,Residential,82650,0,82650,235458,0,318108
141440101600000,SE 211,Residential,84150,0,84150,234794,0,318944
141440101700000,SE 211,Residential,83850,0,83850,252743,0,336593
141440101800000,SE 211,Residential,94050,0,94050,300859,0,394909
141440101900000,SE 211,Residential,175500,0,175500,236103,0,411603
141440102000000,SE 211,Residential,3600,0,3600,0,0,3600
141440102100000,SE 211,Residential,20,0,20,0,0,20
141440200100000,SE 211,Residential,113295,0,113295,124018,0,237313
141440200200000,SE 211,Residential,20,0,20,0,0,20
141442600100000,SE 206,Residential,52688,0,52688,224393,0,277081
141442600200000,SE 206,Residential,53760,0,53760,124867,0,178627
141442600300000,SE 206,Residential,85429,0,85429,224097,0,309526
141442600400000,SE 206,Residential,87768,0,87768,161855,0,249623
141442600500000,SE 206,Residential,77190,0,77190,186596,0,263786
141442600600000,SE 206,Residential,50867,0,50867,233455,0,284322
141442600700000,SE 206,Residential,49817,0,49817,205647,0,255464
141442600800000,SE 206,Residential,53350,0,53350,191389,0,244739
141442600900000,SE 206,Residential,45900,0,45900,160484,0,206384
141442601000000,SE 206,Residential,48150,0,48150,168191,0,216341
141442601100000,SE 206,Residential,48925,0,48925,125378,0,174303
141442601200000,SE 206,Residential,51000,0,51000,145534,0,196534
141442601300000,SE 206,Residential,51000,0,51000,141660,0,192660
141442601400000,SE 206,Residential,54708,0,54708,170392,0,225100
141442700100000,SE 203,Residential,99816,0,99816,336371,0,436187
141442700200000,SE 203,Residential,58938,0,58938,190726,0,249664
141442700300000,SE 203,Residential,61813,0,61813,118153,0,179966
141442700400000,SE 203,Residential,44508,0,44508,126212,0,170720
141442700500000,SE 203,Residential,39600,0,39600,172253,0,211853
141442800100000,SE 206,Residential,52938,0,52938,151139,0,204077
141442800200000,SE 206,Residential,79407,0,79407,159072,0,238479
141442800300000,SE 206,Residential,76860,0,76860,159397,0,236257
141442800400000,SE 206,Residential,68489,0,68489,182187,0,250676
141442800500000,SE 206,Residential,78192,0,78192,163580,0,241772
141442800600000,SE 206,Residential,52003,0,52003,141021,0,193024
141442800700000,SE 206,Residential,50666,0,50666,145140,0,195806
141442800800000,SE 206,Residential,50065,0,50065,138985,0,189050
141442800900000,SE 206,Residential,48925,0,48925,87741,0,136666
141442801000000,SE 206,Residential,49559,0,49559,152948,0,202507
141442801100000,SE 206,Residential,52316,0,52316,159621,0,211937
141442900100000,SE 206,Residential,56385,0,56385,133268,0,189653
141442900200000,SE 206,Residential,50000,0,50000,170281,0,220281
141442900300000,SE 206,Residential,50000,0,50000,156256,0,206256
141442900400000,SE 206,Residential,47667,0,47667,139932,0,187599
141442900500000,SE 206,Residential,48825,0,48825,168371,0,217196
141442900600000,SE 206,Residential,47260,0,47260,99487,0,146747
141442900700000,SE 206,Residential,45167,0,45167,154004,0,199171
141442900800000,SE 206,Residential,50307,0,50307,153215,0,203522
141442900900000,SE 206,Residential,50309,0,50309,169525,0,219834
141442901000000,SE 206,Residential,50490,0,50490,176303,0,226793
141442901100000,SE 206,Residential,52352,0,52352,135280,0,187632
141442901200000,SE 206,Residential,49254,0,49254,165503,0,214757
141442901300000,SE 206,Residential,52500,0,52500,156040,0,208540
141442901400000,SE 206,Residential,47520,0,47520,130410,0,177930
141442901500000,SE 206,Residential,50400,0,50400,103007,0,153407
141442901600000,SE 206,Residential,44455,0,44455,52760,0,97215
141442901700000,SE 206,Residential,42717,0,42717,131017,0,173734
141442901800000,SE 206,Residential,54083,0,54083,131287,0,185370
141442901900000,SE 206,Residential,47853,0,47853,157508,0,205361
141442902000000,SE 206,Residential,48753,0,48753,132862,0,181615
141442902100000,SE 206,Residential,46550,0,46550,144418,0,190968
141442902200000,SE 206,Residential,44550,0,44550,102606,0,147156
141442902300000,SE 206,Residential,56928,0,56928,139566,0,196494
141442902400000,SE 206,Residential,54080,0,54080,192547,0,246627
141442902500000,SE 206,Residential,50674,0,50674,129354,0,180028
141442902600000,SE 206,Residential,20,0,20,0,0,20
141443000100000,SE 206,Residential,53536,0,53536,205961,0,259497
141443000200000,SE 206,Residential,55200,0,55200,144328,0,199528
141443000300000,SE 206,Residential,55200,0,55200,198022,0,253222
141443000400000,SE 206,Exempt,0,53900,53900,0,150803,204703
141443000500000,SE 206,Residential,47975,0,47975,111194,0,159169
141443000600000,SE 206,Residential,51883,0,51883,196626,0,248509
141443000700000,SE 206,Residential,46973,0,46973,186969,0,233942
141443000800000,SE 206,Residential,52618,0,52618,162219,0,214837
141443000900000,SE 206,Residential,52013,0,52013,148762,0,200775
141443001000000,SE 206,Residential,54586,0,54586,148106,0,202692
141443001100000,SE 206,Residential,47139,0,47139,182861,0,230000
141445100100000,SE 211,Residential,160000,0,160000,254683,0,414683
141445100200000,SE 211,Residential,132500,0,132500,355945,0,488445
141445100300000,CITY PROPERTY,Exempt,0,0,0,0,0,0
141445100400000,SE 211,Residential,181100,0,181100,531092,0,712192
141445200100000,CITY PROPERTY,Exempt,0,0,0,0,0,0
141445200200000,SE 211,Residential,96000,0,96000,270333,0,366333
141445200300000,SE 211,Residential,109300,0,109300,266655,0,375955
141445200400000,CITY PROPERTY,Exempt,0,0,0,0,0,0
141447600100000,SE 211,Residential,7300,0,7300,0,0,7300
141447600200000,SE 211,Residential,76875,0,76875,556981,0,633856
141447600300000,SE 211,Residential,61500,0,61500,214489,0,275989
141447600400000,SE 211,Residential,62000,0,62000,244820,0,306820
141447600500000,SE 211,Residential,77393,0,77393,206771,0,284164
141447600600000,SE 211,Residential,178650,0,178650,348445,0,527095
141447600700000,SE 211,Residential,101700,0,101700,511293,0,612993
141447600800000,SE 211,Residential,103700,0,103700,246301,0,350001
141447600900000,SE 211,Residential,103600,0,103600,317920,0,421520
141447601000000,SE 211,Residential,105700,0,105700,272326,0,378026
141447601100000,SE 211,Residential,73080,0,73080,148839,0,221919
141447601200000,SE 211,Residential,10800,0,10800,0,0,10800
141447601300000,SE 211,Residential,106200,0,106200,61599,0,167799
141447601400000,SE 211,Residential,15000,0,15000,0,0,15000
141447601500000,SE 211,Residential,100000,0,100000,353056,0,453056
141447601600000,SE 211,Residential,100000,0,100000,325917,0,425917
141447601700000,SE 211,Residential,80148,0,80148,348367,0,428515
141447601800000,SE 211,Residential,86181,0,86181,187241,0,273422
141447601900000,SE 211,Residential,76380,0,76380,160906,0,237286
141447602000000,SE 211,Residential,93704,0,93704,301296,0,395000
141447602100000,SE 211,Residential,101600,0,101600,236265,0,337865
141447602200000,SE 211,Residential,5471,0,5471,0,0,5471
141447602300000,SE 211,Residential,100100,0,100100,341579,0,441679
141447602400000,SE 211,Residential,20,0,20,0,0,20
141447602500000,SE 211,Residential,20,0,20,0,0,20
141447700100000,SE 211,Residential,76046,0,76046,249730,0,325776
141447700200000,SE 211,Residential,2080,0,2080,0,0,2080
141447800100000,SE 211,Residential,249960,0,249960,450256,0,700216
141447800200000,SE 212,Residential,126150,0,126150,672901,0,799051
141447800300000,SE 212,Residential,128450,0,128450,339846,0,468296
141447800400000,CITY PROPERTY,Exempt,0,0,0,0,0,0
141510100100000,CENTRALLY ASSESSED,Other,0,0,0,0,0,0
141510100200000,NE 141,Residential,26166,0,26166,103066,0,129232
141510100300000,NE 141,Residential,26520,0,26520,105209,0,131729
141510100400000,NE 141,Residential,26520,0,26520,118916,0,145436
141510100500000,NE 141,Residential,24480,0,24480,98220,0,122700
141510100600000,NE 141,Residential,24480,0,24480,80538,0,105018
141510100700000,NE 141,Residential,24480,0,24480,117163,0,141643
141510100800000,NE 141,Residential,24480,0,24480,87339,0,111819
141510100900000,NE 141,Residential,26520,0,26520,84726,0,111246
141510101000000,NE 141,Residential,26520,0,26520,115139,0,141659
141510101100000,NE 141,Residential,26520,0,26520,104362,0,130882
141510101200000,NE 141,Residential,26520,0,26520,93940,0,120460
141510101300000,NE 141,Residential,26520,0,26520,95072,0,121592
141510101400000,NE 141,Residential,25990,0,25990,100081,0,126071
141510101500000,SCHOOL,Exempt,0,0,0,0,0,0
141510200100000,NE 141,Residential,27824,0,27824,94615,0,122439
141510200200000,NE 141,Residential,26150,0,26150,111871,0,138021
141510200300000,NE 141,Residential,26520,0,26520,98465,0,124985
141510200400000,NE 141,Residential,32681,0,32681,134237,0,166918
141510200500000,NE 141,Residential,31951,0,31951,103049,0,135000
141510200600000,NE 141,Residential,33705,0,33705,105340,0,139045
141510200700000,NE 141,Residential,32588,0,32588,127438,0,160026
141510200800000,NE 141,Residential,25248,0,25248,144461,0,169709
141510200900000,NE 141,Residential,26525,0,26525,123511,0,150036
141510201000000,NE 141,Residential,26525,0,26525,93729,0,120254
141510201100000,NE 141,Residential,28600,0,28600,128289,0,156889
141510201200000,NE 141,Residential,27300,0,27300,129159,0,156459
141510201300000,NE 141,Residential,25740,0,25740,104748,0,130488
141510201400000,NE 141,Residential,23660,0,23660,114324,0,137984
141510201500000,NE 141,Residential,29388,0,29388,124345,0,153733
141510201600000,NE 141,Residential,25813,0,25813,105605,0,131418
141510201700000,NE 141,Residential,25994,0,25994,129180,0,155174
141510201800000,NE 141,Residential,27560,0,27560,103562,0,131122
141510201900000,NE 141,Residential,28263,0,28263,130108,0,158371
141510202000000,NE 141,Residential,29648,0,29648,131048,0,160696
141510202100000,NE 141,Residential,26208,0,26208,129583,0,155791
141510202200000,NE 141,Residential,26520,0,26520,97541,0,124061
141510300100000,NE 142,Residential,30519,0,30519,127231,0,157750
141510300200000,NE 142,Residential,29056,0,29056,130547,0,159603
141510300300000,NE 142,Residential,33159,0,33159,131504,0,164663
141510300400000,NE 142,Residential,29648,0,29648,100625,0,130273
141510300500000,NE 142,Residential,29773,0,29773,115718,0,145491
141510300600000,NE 142,Residential,26927,0,26927,96983,0,123910
141510300700000,NE 142,Residential,28644,0,28644,114057,0,142701
141510300800000,NE 142,Residential,33184,0,33184,95936,0,129120
141510300900000,NE 142,Residential,31201,0,31201,119725,0,150926
141510301000000,NE 142,Residential,32100,0,32100,118513,0,150613
141510301100000,NE 142,Residential,31500,0,31500,122673,0,154173
141510400100000,SCHOOL,Exempt,0,0,0,0,0,0
141510400200000,NE 154,Residential,24240,0,24240,98213,0,122453
141510400300000,NE 154,Residential,24480,0,24480,91551,0,116031
141510400400000,NE 154,Residential,30600,0,30600,122001,0,152601
141510400500000,NE 154,Residential,30600,0,30600,105286,0,135886
141510500100000,NE 154,Residential,30000,0,30000,102658,0,132658
141510500200000,NE 154,Residential,26460,0,26460,97965,0,124425
141510500300000,NE 154,Residential,26190,0,26190,97780,0,123970
141510500400000,NE 154,Residential,9300,0,9300,0,0,9300
141510500500000,NE 154,Residential,28903,0,28903,137691,0,166594
141510500600000,NE 154,Residential,22080,0,22080,78089,0,100169
141510500700000,NE 154,Residential,25956,0,25956,67552,0,93508
141510500800000,NE 154,Residential,32136,0,32136,150245,0,182381
141510500900000,NE 154,Residential,24720,0,24720,114925,0,139645
141510501000000,NE 154,Residential,24720,0,24720,87264,0,111984
141510501100000,NE 154,Residential,25440,0,25440,106500,0,131940
141510501200000,NE 154,Residential,25440,0,25440,83516,0,108956
141510501300000,NE 154,Residential,25440,0,25440,83164,0,108604
141510501400000,NE 154,Residential,25440,0,25440,99500,0,124940
141510501500000,NE 154,Residential,25440,0,25440,97647,0,123087
141510501600000,NE 154,Residential,25440,0,25440,97026,0,122466
141510501700000,NE 154,Residential,24000,0,24000,99675,0,123675
141510600100000,NE 154,Residential,27621,0,27621,71122,0,98743
141510700100000,NE 142,Residential,26400,0,26400,97952,0,124352
141510700200000,NE 142,Residential,22800,0,22800,148623,0,171423
141510700300000,NE 142,Residential,24000,0,24000,136326,0,160326
141510700400000,NE 142,Residential,24000,0,24000,121193,0,145193
141510700500000,NE 142,Residential,24000,0,24000,96902,0,120902
141510700600000,NE 142,Residential,24000,0,24000,82577,0,106577
141510700700000,NE 142,Residential,24000,0,24000,103268,0,127268
141510700800000,NE 142,Residential,25999,0,25999,65367,0,91366
141510700900000,NE 154,Residential,24000,0,24000,115586,0,139586
141510701000000,NE 154,Residential,24000,0,24000,83474,0,107474
141510701100000,NE 154,Residential,30000,0,30000,69371,0,99371
141510701200000,NE 154,Residential,30000,0,30000,81134,0,111134
141510701300000,NE 154,Residential,30000,0,30000,58702,0,88702
141510701400000,NE 154,Residential,30000,0,30000,78628,0,108628
141510701500000,NE 154,Residential,30000,0,30000,80069,0,110069
141510701600000,NE 154,Residential,30000,0,30000,83685,0,113685
141510701700000,NE 154,Residential,31477,0,31477,97164,0,128641
141510701800000,NE 154,Residential,28302,0,28302,79462,0,107764
141510701900000,NE 154,Residential,21798,0,21798,87934,0,109732
141510702000000,NE 154,Residential,31790,0,31790,97138,0,128928
141510800100000,NE 142,Residential,35244,0,35244,110336,0,145580
141510800200000,NE 142,Residential,28959,0,28959,86254,0,115213
141510800300000,NE 142,Residential,29255,0,29255,77884,0,107139
141510800400000,NE 142,Residential,29255,0,29255,82596,0,111851
141510800500000,NE 142,Residential,28364,0,28364,88509,0,116873
141510800600000,NE 142,Residential,28364,0,28364,129545,0,157909
141510800700000,NE 142,Residential,31050,0,31050,63831,0,94881
141510800800000,NE 142,Residential,26000,0,26000,74418,0,100418
141510800900000,NE 142,Residential,24000,0,24000,124627,0,148627
141510801000000,NE 142,Residential,24000,0,24000,113397,0,137397
141510801100000,NE 142,Residential,25995,0,25995,97807,0,123802
141510801200000,NE 142,Residential,22367,0,22367,79046,0,101413
141510900100000,NE 142,Residential,31275,0,31275,63006,0,94281
141510900200000,NE 142,Residential,30000,0,30000,80901,0,110901
141510900300000,NE 154,Residential,24000,0,24000,77157,0,101157
141512600100000,NE 142,Residential,35269,0,35269,145075,0,180344
141512600200000,NE 142,Residential,34949,0,34949,118872,0,153821
141512600300000,NE 142,Residential,31104,0,31104,120419,0,151523
141512600400000,NE 142,Residential,31105,0,31105,115444,0,146549
141512600500000,NE 142,Residential,31104,0,31104,120590,0,151694
141512600600000,NE 142,Residential,27625,0,27625,105752,0,133377
141512600700000,NE 142,Residential,28768,0,28768,126495,0,155263
141512600800000,NE 142,Residential,28980,0,28980,117763,0,146743
141512600900000,NE 142,Residential,27560,0,27560,104209,0,131769
141512601000000,NE 142,Residential,27820,0,27820,116984,0,144804
141512601100000,NE 142,Residential,29520,0,29520,115438,0,144958
141512700100000,NE 142,Exempt,0,31027,31027,0,108454,139481
141512700200000,NE 142,Residential,34164,0,34164,147747,0,181911
141512700300000,NE 142,Residential,31356,0,31356,126428,0,157784
141512700400000,NE 142,Residential,28273,0,28273,114634,0,142907
141512700500000,NE 142,Residential,35908,0,35908,110128,0,146036
141512700600000,NE 142,Residential,33628,0,33628,113636,0,147264
141512700700000,NE 142,Residential,28733,0,28733,129489,0,158222
141512700800000,NE 142,Residential,26466,0,26466,99142,0,125608
141512700900000,NE 142,Residential,28355,0,28355,100627,0,128982
141512701000000,NE 142,Residential,29465,0,29465,124660,0,154125
141512701100000,NE 142,Residential,29542,0,29542,93589,0,123131
141512701200000,NE 142,Residential,29251,0,29251,104279,0,133530
141512701300000,NE 142,Residential,28332,0,28332,119113,0,147445
141512701400000,NE 142,Residential,33167,0,33167,121147,0,154314
141512701500000,NE 142,Residential,31250,0,31250,91269,0,122519
141512701600000,NE 142,Residential,31249,0,31249,97270,0,128519
141512701700000,NE 142,Residential,31563,0,31563,75511,0,107074
141512701800000,NE 142,Residential,30300,0,30300,94590,0,124890
141512701900000,NE 142,Residential,31563,0,31563,69872,0,101435
141512702000000,NE 142,Residential,31875,0,31875,106446,0,138321
141512702100000,NE 142,Residential,34156,0,34156,117870,0,152026
141512702200000,NE 142,Residential,27029,0,27029,80922,0,107951
141512702300000,NE 142,Residential,30900,0,30900,107178,0,138078
141512702400000,NE 142,Residential,30213,0,30213,69639,0,99852
141512702500000,NE 142,Residential,30160,0,30160,96112,0,126272
141512702600000,NE 142,Residential,30160,0,30160,110248,0,140408
141512702700000,NE 142,Residential,30975,0,30975,69619,0,100594
141512800100000,NE 142,Residential,28364,0,28364,91628,0,119992
141512800200000,NE 142,Residential,28078,0,28078,82964,0,111042
141512800300000,NE 142,Residential,35476,0,35476,144282,0,179758
141512800400000,NE 142,Residential,36450,0,36450,88638,0,125088
141512800500000,NE 142,Residential,28875,0,28875,80689,0,109564
141512800600000,NE 142,Residential,33300,0,33300,79422,0,112722
141512900100000,NE 142,Residential,28747,0,28747,109360,0,138107
141512900200000,NE 142,Residential,28583,0,28583,127056,0,155639
141512900300000,NE 142,Residential,28583,0,28583,96384,0,124967
141512900400000,NE 142,Residential,29890,0,29890,107764,0,137654
141512900500000,NE 142,Residential,28419,0,28419,81724,0,110143
141512900600000,NE 142,Residential,28420,0,28420,63603,0,92023
141512900700000,NE 142,Residential,28257,0,28257,76948,0,105205
141512900800000,NE 142,Residential,29236,0,29236,111328,0,140564
141512900900000,NE 142,Residential,26950,0,26950,71259,0,98209
141512901000000,NE 142,Residential,26950,0,26950,71438,0,98388
141512901100000,NE 142,Residential,26949,0,26949,81731,0,108680
141512901200000,NE 142,Residential,26951,0,26951,69076,0,96027
141512901300000,NE 142,Residential,26675,0,26675,94447,0,121122
141512901400000,NE 142,Residential,33255,0,33255,99035,0,132290
141513000100000,NE 142,Residential,32667,0,32667,70877,0,103544
141513000200000,NE 142,Residential,30625,0,30625,64832,0,95457
141513000300000,NE 142,Residential,30624,0,30624,66878,0,97502
141513000400000,NE 142,Residential,30626,0,30626,71374,0,102000
141513000500000,NE 142,Residential,29400,0,29400,103326,0,132726
141513000600000,NE 142,Residential,30625,0,30625,71518,0,102143
141513000700000,NE 142,Residential,30625,0,30625,106105,0,136730
141513000800000,NE 142,Residential,30625,0,30625,95926,0,126551
141513000900000,NE 142,Residential,29890,0,29890,86277,0,116167
141513001000000,NE 142,Residential,26950,0,26950,73247,0,100197
141513001100000,NE 142,Residential,26950,0,26950,70146,0,97096
141513001200000,NE 142,Residential,26950,0,26950,79921,0,106871
141513001300000,NE 142,Residential,26949,0,26949,61156,0,88105
141513001400000,NE 142,Residential,26951,0,26951,43926,0,70877
141513001500000,NE 142,Residential,26950,0,26950,99349,0,126299
141513001600000,NE 142,Residential,26950,0,26950,48652,0,75602
141513001700000,NE 142,Residential,26950,0,26950,59539,0,86489
141513001800000,NE 142,Residential,26951,0,26951,75942,0,102893
141513001900000,NE 142,Residential,32013,0,32013,97813,0,129826
141513100100000,NE 142,Residential,27650,0,27650,100178,0,127828
141513100200000,NE 142,Residential,27150,0,27150,64103,0,91253
141513100300000,NE 142,Residential,27150,0,27150,74040,0,101190
141513100400000,NE 142,Residential,27150,0,27150,74054,0,101204
141513100500000,NE 142,Residential,27151,0,27151,81478,0,108629
141513100600000,NE 142,Residential,27150,0,27150,64720,0,91870
141513100700000,NE 142,Residential,27150,0,27150,84645,0,111795
141513100800000,NE 142,Residential,27150,0,27150,82649,0,109799
141513100900000,NE 142,Residential,27150,0,27150,81450,0,108600
141513101000000,NE 142,Residential,27150,0,27150,93446,0,120596
141513101100000,NE 142,Residential,27149,0,27149,75625,0,102774
141513101200000,NE 142,Residential,27151,0,27151,75199,0,102350
141513101300000,NE 142,Residential,27500,0,27500,81670,0,109170
141513101400000,NE 142,Residential,27500,0,27500,88586,0,116086
141513101500000,NE 142,Residential,27500,0,27500,89850,0,117350
141513101600000,NE 142,Residential,27500,0,27500,73306,0,100806
141513101700000,NE 142,Residential,27500,0,27500,67164,0,94664
141513101800000,NE 142,Residential,27500,0,27500,88562,0,116062
141513101900000,NE 142,Residential,27499,0,27499,83191,0,110690
141513102000000,NE 142,Residential,27501,0,27501,86364,0,113865
141513102100000,NE 142,Residential,30000,0,30000,81543,0,111543
141513200100000,CHURCH,Exempt,0,39426,39426,0,232398,271824
141513200200000,NE 142,Residential,28200,0,28200,70439,0,98639
141513200300000,NE 142,Residential,30065,0,30065,85491,0,115556
141513200400000,NE 142,Residential,30226,0,30226,87573,0,117799
141513200500000,NE 142,Residential,27500,0,27500,76379,0,103879
141513200600000,NE 142,Residential,27500,0,27500,71876,0,99376
141513200700000,NE 142,Residential,27499,0,27499,73257,0,100756
141513200800000,NE 142,Residential,27499,0,27499,78252,0,105751
141513200900000,NE 142,Residential,27500,0,27500,84790,0,112290
141513201000000,NE 142,Residential,28900,0,28900,50891,0,79791
141513201100000,NE 142,Residential,30300,0,30300,70283,0,100583
141513201200000,NE 142,Residential,28499,0,28499,82578,0,111077
141513201300000,NE 142,Residential,28500,0,28500,91325,0,119825
141513201400000,NE 142,Residential,27800,0,27800,113664,0,141464
141513201500000,NE 142,Residential,28650,0,28650,52830,0,81480
141513201600000,NE 142,Residential,28967,0,28967,72518,0,101485
141513201700000,NE 142,Residential,29633,0,29633,79260,0,108893
141513201800000,NE 142,Residential,27500,0,27500,74241,0,101741
141513201900000,NE 142,Residential,27500,0,27500,85421,0,112921
141513202000000,NE 142,Residential,27500,0,27500,90214,0,117714
141513202100000,NE 142,Residential,27500,0,27500,110028,0,137528
141513202200000,NE 142,Residential,27499,0,27499,67991,0,95490
141513202300000,NE 142,Residential,27388,0,27388,82216,0,109604
141513202400000,NE 142,Residential,28200,0,28200,71760,0,99960
141513300100000,NE 142,Residential,34584,0,34584,58317,0,92901
141513300200000,NE 142,Residential,28699,0,28699,60952,0,89651
141513300300000,NE 142,Residential,27731,0,27731,62557,0,90288
141513300400000,NE 142,Residential,29500,0,29500,83349,0,112849
141513300500000,NE 142,Residential,33150,0,33150,68064,0,101214
141513300600000,NE 142,Residential,32110,0,32110,66861,0,98971
141513300700000,NE 142,Residential,30301,0,30301,94381,0,124682
141513300800000,NE 142,Residential,30901,0,30901,65959,0,96860
141513300900000,NE 142,Residential,28800,0,28800,76454,0,105254
141513301000000,NE 142,Residential,31315,0,31315,89423,0,120738
141513301100000,NE 142,Residential,29655,0,29655,58908,0,88563
141513301200000,NE 142,Residential,30225,0,30225,96270,0,126495
141513301300000,NE 142,Residential,30000,0,30000,79245,0,109245
141513301400000,NE 142,Residential,31027,0,31027,78941,0,109968
141513301500000,NE 142,Residential,29733,0,29733,88348,0,118081
141513301600000,NE 142,Residential,27730,0,27730,82920,0,110650
141513301700000,NE 142,Residential,27866,0,27866,70697,0,98563
141513400100000,NE 142,Residential,30000,0,30000,85150,0,115150
141513400200000,NE 142,Residential,30000,0,30000,85269,0,115269
141513400300000,NE 142,Residential,30000,0,30000,72794,0,102794
141515100100000,NE 142,Residential,30000,0,30000,85307,0,115307
141515100200000,NE 142,Residential,30000,0,30000,77957,0,107957
141515100300000,NE 142,Residential,30000,0,30000,69145,0,99145
141515100400000,NE 142,Residential,30001,0,30001,76867,0,106868
141515100500000,NE 142,Residential,30001,0,30001,72306,0,102307
141515100600000,NE 142,Residential,30000,0,30000,89236,0,119236
141515100700000,NE 142,Residential,31549,0,31549,90361,0,121910
141515100800000,NE 142,Residential,25833,0,25833,76068,0,101901
141515100900000,NE 142,Residential,27500,0,27500,77650,0,105150
141515101000000,NE 142,Residential,27500,0,27500,71395,0,98895
141515101100000,NE 142,Residential,27500,0,27500,92584,0,120084
141515101200000,NE 142,Residential,27500,0,27500,86757,0,114257
141515101300000,NE 142,Residential,27500,0,27500,87798,0,115298
141515101400000,NE 142,Residential,28001,0,28001,102056,0,130057
141515101500000,NE 142,Residential,32082,0,32082,85473,0,117555
141515101600000,NE 154,Residential,31850,0,31850,79189,0,111039
141515101700000,NE 154,Residential,28200,0,28200,89985,0,118185
141515101800000,NE 154,Residential,31800,0,31800,89357,0,121157
141515101900000,NE 154,Residential,33495,0,33495,86799,0,120294
141515102000000,NE 154,Residential,27930,0,27930,51482,0,79412
141515102100000,CITY PROPERTY,Exempt,0,0,0,0,0,0
141515102200000,NE 154,Residential,37027,0,37027,122375,0,159402
141515102300000,NE 154,Residential,31848,0,31848,117263,0,149111
141515102400000,NE 154,Residential,25800,0,25800,79631,0,105431
141515200100000,NE 142,Residential,27501,0,27501,99675,0,127176
141515200200000,NE 142,Residential,27501,0,27501,82455,0,109956
141515200300000,NE 142,Residential,27501,0,27501,95090,0,122591
141515200400000,NE 142,Residential,28625,0,28625,62219,0,90844
141515200500000,NE 142,Residential,28334,0,28334,75259,0,103593
141515200600000,NE 142,Residential,31225,0,31225,91786,0,123011
141515200700000,NE 142,Residential,31225,0,31225,81344,0,112569
141515200800000,NE 142,Residential,31050,0,31050,78815,0,109865
141515200900000,NE 142,Residential,32534,0,32534,107333,0,139867
141515201000000,NE 142,Residential,27500,0,27500,70797,0,98297
141515201100000,NE 142,Residential,27499,0,27499,78177,0,105676
141515201200000,NE 142,Residential,27500,0,27500,72320,0,99820
141515201300000,NE 142,Residential,28966,0,28966,77431,0,106397
141515201400000,NE 142,Residential,28325,0,28325,74348,0,102673
141515300100000,NE 142,Residential,28650,0,28650,88174,0,116824
141515300200000,NE 142,Residential,31403,0,31403,122725,0,154128
141515400100000,NE 154,Residential,30520,0,30520,87265,0,117785
141515400200000,NE 154,Residential,32292,0,32292,121887,0,154179
141515400300000,NE 154,Residential,31040,0,31040,93129,0,124169
141515400400000,NE 154,Residential,31212,0,31212,77380,0,108592
141515400500000,NE 154,Residential,32130,0,32130,67544,0,99674
141515400600000,NE 154,Residential,30922,0,30922,62105,0,93027
141515400700000,NE 154,Residential,29640,0,29640,57482,0,87122
141515400800000,NE 154,Residential,30447,0,30447,73791,0,104238
141515400900000,NE 154,Residential,26970,0,26970,48010,0,74980
141515401000000,NE 154,Residential,26190,0,26190,55684,0,81874
141515401100000,NE 154,Residential,28493,0,28493,104531,0,133024
141515401200000,NE 154,Residential,30816,0,30816,93461,0,124277
141515401300000,NE 154,Residential,30816,0,30816,120129,0,150945
141515401400000,NE 154,Residential,25680,0,25680,93678,0,119358
141515401500000,NE 154,Residential,25680,0,25680,87040,0,112720
141515401600000,NE 154,Residential,25440,0,25440,80971,0,106411
141515401700000,NE 154,Residential,25200,0,25200,86969,0,112169
141515401800000,NE 154,Residential,25200,0,25200,90490,0,115690
141515401900000,NE 154,Residential,24960,0,24960,83311,0,108271
141515402000000,NE 154,Residential,24720,0,24720,69339,0,94059
141515402100000,NE 154,Residential,24720,0,24720,71821,0,96541
141515402200000,NE 154,Residential,24480,0,24480,68167,0,92647
141515402300000,NE 154,Residential,24240,0,24240,79466,0,103706
141515402400000,NE 154,Residential,24240,0,24240,97773,0,122013
141515500100000,NE 154,Residential,26568,0,26568,71873,0,98441
141515500200000,NE 154,Residential,24360,0,24360,112287,0,136647
141515500300000,NE 154,Residential,25800,0,25800,72135,0,97935
141515500400000,NE 154,Residential,25800,0,25800,111037,0,136837
141515500500000,NE 154,Residential,25800,0,25800,90254,0,116054
141515500600000,NE 154,Residential,25800,0,25800,93721,0,119521
141515500700000,NE 154,Residential,26000,0,26000,84969,0,110969
141515500800000,NE 154,Residential,31000,0,31000,71337,0,102337
141515500900000,NE 154,Residential,28152,0,28152,132910,0,161062
141515501000000,NE 154,Residential,27472,0,27472,143580,0,171052
141515600100000,NE 154,Residential,27200,0,27200,86679,0,113879
141515600200000,NE 154,Residential,24200,0,24200,98470,0,122670
141515600300000,NE 154,Residential,24000,0,24000,69801,0,93801
141515600400000,NE 154,Residential,26020,0,26020,74242,0,100262
141515700100000,NE 154,Residential,31800,0,31800,33915,0,65715
141515700200000,NE 154,Residential,26553,0,26553,56689,0,83242
141515700300000,NE 154,Residential,26520,0,26520,77020,0,103540
141515700400000,NE 154,Residential,27144,0,27144,72460,0,99604
141515700500000,NE 154,Residential,24960,0,24960,75259,0,100219
141515700600000,NE 154,Residential,24960,0,24960,80210,0,105170
141515700700000,NE 154,Residential,27280,0,27280,59367,0,86647
141515700800000,NE 154,Residential,27000,0,27000,57817,0,84817
141515700900000,NE 154,Residential,29712,0,29712,74390,0,104102
141515701000000,NE 154,Residential,33936,0,33936,92531,0,126467
141515701100000,NE 154,Residential,24480,0,24480,81274,0,105754
141515701200000,NE 154,Residential,24720,0,24720,88170,0,112890
141515701300000,NE 154,Residential,24960,0,24960,86039,0,110999
141515701400000,NE 154,Residential,24960,0,24960,79210,0,104170
141515701500000,NE 154,Residential,25200,0,25200,96663,0,121863
141517600100000,NE 154,Residential,30600,0,30600,115311,0,145911
141517600200000,NE 154,Residential,24480,0,24480,98131,0,122611
141517600300000,NE 154,Residential,24480,0,24480,115492,0,139972
141517600400000,NE 154,Residential,24480,0,24480,86107,0,110587
141517600500000,NE 154,Residential,24480,0,24480,94064,0,118544
141517600600000,NE 154,Residential,24480,0,24480,98072,0,122552
141517600700000,NE 154,Residential,24480,0,24480,102305,0,126785
141517600800000,NE 154,Residential,24480,0,24480,91391,0,115871
141517600900000,NE 154,Residential,24480,0,24480,80184,0,104664
141517601000000,NE 154,Residential,24480,0,24480,77256,0,101736
141517601100000,NE 154,Residential,21127,0,21127,89754,0,110881
141517601200000,NE 154,Residential,16800,0,16800,64611,0,81411
141517601300000,NE 154,Residential,20160,0,20160,88102,0,108262
141517601400000,NE 154,Residential,20400,0,20400,84007,0,104407
141517601500000,NE 154,Residential,28320,0,28320,82444,0,110764
141517601600000,NE 154,Residential,24189,0,24189,90614,0,114803
141517601700000,NE 154,Residential,30600,0,30600,96224,0,126824
141517601800000,NE 154,Residential,30600,0,30600,107811,0,138411
141517601900000,NE 154,Residential,30600,0,30600,108581,0,139181
141517602000000,NE 154,Residential,30600,0,30600,75356,0,105956
141517602100000,NE 154,Residential,30600,0,30600,97129,0,127729
141517602200000,NE 154,Residential,30600,0,30600,154773,0,185373
141517602300000,NE 154,Residential,30600,0,30600,108558,0,139158
141517700100000,NE 154,Residential,25440,0,25440,119864,0,145304
141517700200000,NE 154,Residential,24720,0,24720,90639,0,115359
141517700300000,NE 154,Residential,24720,0,24720,91627,0,116347
141517700400000,NE 154,Residential,24720,0,24720,93999,0,118719
141517700500000,NE 154,Residential,24720,0,24720,62452,0,87172
141517700600000,NE 154,Residential,24720,0,24720,77198,0,101918
141517700700000,NE 154,Residential,24720,0,24720,89270,0,113990
141517700800000,NE 154,Residential,24720,0,24720,104245,0,128965
141517700900000,NE 154,Residential,24720,0,24720,107057,0,131777
141517701000000,NE 154,Residential,25440,0,25440,107576,0,133016
141517701100000,NE 154,Residential,25440,0,25440,103922,0,129362
141517701200000,NE 154,Residential,25440,0,25440,90280,0,115720
141517701300000,NE 154,Residential,25440,0,25440,108138,0,133578
141517701400000,NE 154,Residential,25440,0,25440,122755,0,148195
141517701500000,NE 154,Residential,25440,0,25440,94488,0,119928
141517701600000,NE 154,Residential,25440,0,25440,103168,0,128608
141517701700000,NE 154,Residential,25440,0,25440,99511,0,124951
141517800100000,NE 154,Residential,21120,0,21120,83198,0,104318
141517800200000,NE 154,Residential,23040,0,23040,70842,0,93882
141517800300000,NE 154,Residential,24402,0,24402,103638,0,128040
141517800400000,NE 154,Residential,20640,0,20640,65621,0,86261
141517800500000,NE 154,Residential,18960,0,18960,80192,0,99152
141517800600000,NE 154,Residential,29640,0,29640,71605,0,101245
141517800700000,NE 154,Residential,25020,0,25020,118668,0,143688
141517800800000,NE 154,Residential,21120,0,21120,74195,0,95315
141517800900000,NE 154,Residential,19920,0,19920,84777,0,104697
141517900100000,NE 154,Residential,24000,0,24000,54462,0,78462
141517900200000,NE 154,Residential,30000,0,30000,69873,0,99873
141517900300000,NE 154,Residential,30000,0,30000,87310,0,117310
141517900400000,NE 154,Residential,30000,0,30000,82460,0,112460
141517900500000,NE 154,Residential,30000,0,30000,81958,0,111958
141517900600000,NE 154,Residential,24000,0,24000,90855,0,114855
141518000100000,NE 154,Residential,30600,0,30600,91962,0,122562
141518000200000,NE 154,Residential,23107,0,23107,75519,0,98626
141518000300000,NE 154,Residential,23940,0,23940,56688,0,80628
141518100100000,NE 154,Residential,21600,0,21600,83589,0,105189
141518100200000,NE 154,Residential,19496,0,19496,68890,0,88386
141518100300000,NE 154,Residential,20064,0,20064,71053,0,91117
141518100400000,NE 154,Residential,30600,0,30600,66576,0,97176
141518100500000,NE 154,Residential,30600,0,30600,92404,0,123004
141518100600000,NE 154,Residential,24480,0,24480,91335,0,115815
141518100700000,NE 154,Residential,24480,0,24480,68968,0,93448
141518100800000,NE 154,Residential,30600,0,30600,95636,0,126236
141518100900000,NE 154,Residential,30600,0,30600,165481,0,196081
141518101000000,NE 154,Residential,30600,0,30600,127638,0,158238
141518101100000,NE 154,Residential,30600,0,30600,102018,0,132618
141518101200000,NE 154,Residential,31375,0,31375,106371,0,137746
141518101300000,NE 154,Residential,26255,0,26255,72327,0,98582
141518101400000,NE 154,Residential,24480,0,24480,67795,0,92275
141518101500000,NE 154,Residential,24480,0,24480,68309,0,92789
141518101600000,NE 154,Residential,24480,0,24480,69999,0,94479
141518101700000,NE 154,Residential,24480,0,24480,69410,0,93890
141518200100000,NE 154,Residential,26567,0,26567,90282,0,116849
141518200200000,NE 154,Residential,25854,0,25854,71594,0,97448
141518200300000,NE 154,Residential,22410,0,22410,69969,0,92379
141518200400000,NE 154,Residential,17640,0,17640,71129,0,88769
141518200500000,NE 154,Residential,22383,0,22383,77837,0,100220
141518200600000,NE 154,Residential,16800,0,16800,65763,0,82563
141518200700000,NE 154,Residential,24480,0,24480,88123,0,112603
141518200800000,NE 154,Residential,24480,0,24480,86888,0,111368
141518200900000,NE 154,Residential,24480,0,24480,93660,0,118140
141518201000000,NE 154,Residential,24480,0,24480,106664,0,131144
141518201100000,NE 154,Residential,24480,0,24480,92502,0,116982
141518201200000,NE 154,Residential,24480,0,24480,85735,0,110215
141518201300000,NE 154,Residential,24480,0,24480,112362,0,136842
141518201400000,NE 154,Residential,24480,0,24480,83834,0,108314
141518201500000,NE 154,Residential,24480,0,24480,102805,0,127285
141518201600000,NE 154,Residential,25650,0,25650,91092,0,116742
141518201700000,NE 154,Residential,26373,0,26373,81248,0,107621
141518201800000,NE 154,Residential,21240,0,21240,94107,0,115347
141518201900000,NE 154,Residential,28595,0,28595,88582,0,117177
141518202000000,NE 154,Residential,30600,0,30600,105389,0,135989
141518202100000,NE 154,Residential,30600,0,30600,123600,0,154200
141518202200000,NE 154,Residential,30600,0,30600,131878,0,162478
141518202300000,NE 154,Residential,30600,0,30600,112387,0,142987
141518202400000,NE 154,Residential,27540,0,27540,0,0,27540
141518202500000,NE 154,Residential,27540,0,27540,68532,0,96072
141518202600000,NE 154,Residential,30600,0,30600,107055,0,137655
141518202700000,NE 154,Residential,30600,0,30600,130826,0,161426
141518300100000,NE 154,Residential,21742,0,21742,77381,0,99123
141518300200000,NE 154,Residential,21840,0,21840,93099,0,114939
141518300300000,NE 154,Residential,23970,0,23970,76590,0,100560
141518300400000,NE 154,Residential,24939,0,24939,77750,0,102689
141518300500000,NE 154,Residential,23970,0,23970,85679,0,109649
141518300600000,NE 154,Residential,24000,0,24000,98839,0,122839
141518300700000,NE 154,Residential,24000,0,24000,73710,0,97710
141518300800000,NE 154,Residential,24000,0,24000,64470,0,88470
141518300900000,NE 154,Residential,24000,0,24000,91355,0,115355
141518301000000,NE 154,Residential,24000,0,24000,78508,0,102508
141518301100000,NE 154,Residential,24000,0,24000,88515,0,112515
141518301200000,NE 154,Residential,24000,0,24000,105626,0,129626
141518301300000,NE 154,Residential,24000,0,24000,121476,0,145476
141518301400000,NE 154,Residential,29880,0,29880,103339,0,133219
141518301500000,NE 154,Residential,20160,0,20160,111487,0,131647
141518301600000,NE 154,Residential,20160,0,20160,106217,0,126377
141518301700000,NE 154,Residential,18468,0,18468,84626,0,103094
141518301800000,NE 154,Residential,26861,0,26861,107815,0,134676
141518301900000,NE 154,Residential,24000,0,24000,102176,0,126176
141518302000000,NE 154,Residential,24000,0,24000,83367,0,107367
141518302100000,NE 154,Residential,24000,0,24000,80015,0,104015
141518302200000,NE 154,Residential,24000,0,24000,84209,0,108209
141518302300000,NE 154,Residential,24000,0,24000,105449,0,129449
141518302400000,NE 154,Residential,24000,0,24000,107250,0,131250
141518302500000,NE 154,Residential,24000,0,24000,77860,0,101860
141518302600000,NE 154,Residential,24000,0,24000,90131,0,114131
141518302700000,NE 154,Residential,24000,0,24000,81470,0,105470
141518302800000,NE 154,Residential,24000,0,24000,104056,0,128056
141518400100000,NE 154,Residential,30920,0,30920,98580,0,129500
141518400200000,NE 154,Residential,23117,0,23117,68972,0,92089
141518400300000,NE 154,Residential,31298,0,31298,112102,0,143400
141518400400000,NE 154,Residential,23440,0,23440,111060,0,134500
141518400500000,NE 154,Residential,24000,0,24000,70726,0,94726
141518400600000,NE 154,Residential,24000,0,24000,97670,0,121670
141518400700000,NE 154,Residential,24000,0,24000,89906,0,113906
141518400800000,NE 154,Residential,24000,0,24000,112157,0,136157
141518400900000,NE 154,Residential,24000,0,24000,108483,0,132483
141518401000000,NE 154,Residential,24000,0,24000,108275,0,132275
141518401100000,NE 154,Residential,24000,0,24000,112994,0,136994
141518401200000,NE 154,Residential,24720,0,24720,92038,0,116758
141518401300000,NE 154,Residential,25440,0,25440,96088,0,121528
141518401400000,NE 154,Residential,33600,0,33600,122793,0,156393
141518401500000,NE 154,Residential,24000,0,24000,82980,0,106980
141518401600000,NE 154,Residential,24000,0,24000,108513,0,132513
141518401700000,NE 154,Residential,24000,0,24000,82303,0,106303
141518401800000,NE 154,Residential,24000,0,24000,96526,0,120526
141518401900000,NE 154,Residential,24000,0,24000,121936,0,145936
141518402000000,NE 154,Residential,24000,0,24000,77250,0,101250
141518402100000,NE 154,Residential,24000,0,24000,79692,0,103692
141518402200000,NE 154,Residential,24000,0,24000,99389,0,123389
141518500100000,NE 154,Residential,44741,0,44741,117596,0,162337
141518500200000,NE 154,Residential,27560,0,27560,133562,0,161122
141518500300000,NE 154,Residential,26529,0,26529,129831,0,156360
141518500400000,NE 154,Residential,29552,0,29552,112917,0,142469
141518500500000,NE 154,Residential,21489,0,21489,129579,0,151068
141518500600000,NE 154,Residential,20453,0,20453,110028,0,130481
141518600100000,NE 154,Residential,25472,0,25472,99859,0,125331
141518600200000,NE 154,Residential,27090,0,27090,77792,0,104882
141518600300000,NE 154,Residential,26832,0,26832,114418,0,141250
141518600400000,NE 154,Residential,26574,0,26574,99645,0,126219
141518600500000,NE 154,Residential,26316,0,26316,111245,0,137561
141518600600000,NE 154,Residential,27149,0,27149,79263,0,106412
141518600700000,NE 154,Residential,36000,0,36000,124108,0,160108
141518600800000,NE 154,Residential,23760,0,23760,106374,0,130134
141518600900000,NE 154,Residential,23520,0,23520,111466,0,134986
141518601000000,NE 154,Residential,23280,0,23280,90706,0,113986
141518601100000,NE 154,Residential,23040,0,23040,101669,0,124709
141518601200000,NE 154,Residential,22560,0,22560,82899,0,105459
141518601300000,NE 154,Residential,22320,0,22320,83568,0,105888
141518601400000,NE 154,Residential,23114,0,23114,76824,0,99938
141518601500000,NE 154,Residential,25392,0,25392,85510,0,110902
141518601600000,NE 154,Residential,22320,0,22320,78918,0,101238
141518601700000,NE 154,Residential,22560,0,22560,80280,0,102840
141518601800000,NE 154,Residential,23040,0,23040,78365,0,101405
141518601900000,NE 154,Residential,23280,0,23280,85601,0,108881
141518602000000,NE 154,Residential,35280,0,35280,117957,0,153237
141518602100000,NE 154,Residential,26057,0,26057,83845,0,109902
141518602200000,NE 154,Residential,28600,0,28600,79199,0,107799
141518602300000,NE 154,Residential,25452,0,25452,84128,0,109580
141518602400000,NE 154,Residential,25704,0,25704,90437,0,116141
141518602500000,NE 154,Residential,26208,0,26208,135325,0,161533
141518602600000,NE 154,Residential,25421,0,25421,136851,0,162272
141518602700000,NE 154,Residential,27600,0,27600,105656,0,133256
141518602800000,NE 154,Residential,23280,0,23280,104439,0,127719
141518602900000,NE 154,Residential,29410,0,29410,136456,0,165866
141518603000000,NE 154,Residential,23435,0,23435,101195,0,124630
141518700100000,NE 154,Residential,23400,0,23400,92369,0,115769
141518700200000,NE 154,Residential,21060,0,21060,76067,0,97127
141518700300000,NE 154,Residential,21330,0,21330,67814,0,89144
141518700400000,NE 154,Residential,19656,0,19656,81050,0,100706
141518700500000,NE 154,Residential,19656,0,19656,90440,0,110096
141518700600000,NE 154,Residential,24000,0,24000,95298,0,119298
141518700700000,NE 154,Residential,26400,0,26400,98226,0,124626
141518700800000,NE 154,Residential,27200,0,27200,136104,0,163304
141518700900000,NE 154,Residential,27472,0,27472,83483,0,110955
141518701000000,NE 154,Residential,27472,0,27472,84269,0,111741
141518701100000,NE 154,Residential,27472,0,27472,124905,0,152377
141518701200000,NE 154,Residential,27472,0,27472,93040,0,120512
141518800100000,NE 154,Residential,22886,0,22886,67462,0,90348
141518800200000,NE 154,Residential,22645,0,22645,114347,0,136992
141518800300000,NE 154,Residential,22404,0,22404,94650,0,117054
141518800400000,NE 154,Residential,22108,0,22108,72303,0,94411
141518800500000,NE 154,Residential,28210,0,28210,103269,0,131479
141520100200000,NE 142,Residential,33169,0,33169,106395,0,139564
141520100300000,NE 142,Residential,34497,0,34497,110497,0,144994
141520100400000,NE 142,Residential,28786,0,28786,98976,0,127762
141520100500000,NE 142,Residential,23912,0,23912,76371,0,100283
141520200100000,NE 142,Residential,33417,0,33417,103854,0,137271
141520200200000,NE 142,Residential,25623,0,25623,86091,0,111714
141520200300000,NE 142,Residential,27000,0,27000,95766,0,122766
141520200400000,NE 142,Residential,27270,0,27270,81546,0,108816
141520200500000,NE 142,Residential,27810,0,27810,85297,0,113107
141520200600000,NE 142,Residential,28350,0,28350,109277,0,137627
141520200700000,NE 142,Residential,28620,0,28620,92655,0,121275
141520200800000,NE 142,Residential,29160,0,29160,101840,0,131000
141520200900000,NE 142,Residential,29430,0,29430,83941,0,113371
141520201000000,NE 142,Residential,29699,0,29699,75548,0,105247
141520201100000,NE 142,Residential,32467,0,32467,81552,0,114019
141520201200000,NE 142,Residential,32760,0,32760,111557,0,144317
141520201300000,NE 142,Residential,32106,0,32106,110485,0,142591
141520201400000,NE 142,Residential,32640,0,32640,146187,0,178827
141520201500000,NE 142,Residential,34681,0,34681,128610,0,163291
141520201600000,NE 142,Residential,30738,0,30738,154177,0,184915
141520201700000,NE 142,Residential,26532,0,26532,74939,0,101471
141520201800000,NE 142,Residential,28080,0,28080,94352,0,122432
141520201900000,NE 142,Residential,28861,0,28861,136769,0,165630
141520202000000,NE 142,Residential,29067,0,29067,68460,0,97527
141520202100000,NE 142,Residential,28656,0,28656,107199,0,135855
141520202200000,NE 142,Residential,28125,0,28125,133118,0,161243
141520202300000,NE 142,Residential,27596,0,27596,119220,0,146816
141520202400000,NE 142,Residential,27064,0,27064,146962,0,174026
141520202500000,NE 142,Residential,26799,0,26799,121406,0,148205
141520202600000,NE 142,Residential,26799,0,26799,79930,0,106729
141520202700000,NE 142,Residential,26534,0,26534,93260,0,119794
141520202800000,NE 142,Residential,24533,0,24533,91883,0,116416
141520202900000,NE 142,Residential,24778,0,24778,97081,0,121859
141520203000000,NE 142,Residential,28347,0,28347,112147,0,140494
141520300100000,NE 142,Residential,32258,0,32258,93744,0,126002
141520300200000,NE 142,Residential,22998,0,22998,82434,0,105432
141520300300000,NE 142,Residential,22997,0,22997,87948,0,110945
141520300400000,NE 142,Residential,22971,0,22971,108334,0,131305
141520300500000,NE 142,Residential,26717,0,26717,86588,0,113305
141520300600000,NE 142,Residential,23467,0,23467,79093,0,102560
141520300700000,NE 142,Residential,23702,0,23702,89293,0,112995
141520300800000,NE 142,Residential,23702,0,23702,89623,0,113325
141520300900000,NE 142,Residential,23701,0,23701,118476,0,142177
141520301000000,NE 142,Residential,23701,0,23701,111916,0,135617
141520301100000,NE 142,Residential,23467,0,23467,117909,0,141376
141520301200000,NE 142,Residential,23466,0,23466,124055,0,147521
141520301300000,NE 142,Residential,26970,0,26970,132167,0,159137
141520301400000,NE 142,Residential,27441,0,27441,94087,0,121528
141520301500000,NE 142,Residential,25349,0,25349,100769,0,126118
141520301600000,NE 142,Residential,24956,0,24956,131727,0,156683
141520301700000,NE 142,Residential,25991,0,25991,138261,0,164252
141520301800000,NE 142,Residential,31555,0,31555,102471,0,134026
141520301900000,NE 142,Residential,22421,0,22421,103352,0,125773
141520302000000,NE 142,Residential,22848,0,22848,100009,0,122857
141520302100000,NE 142,Residential,23940,0,23940,99247,0,123187
141520302200000,NE 142,Residential,31622,0,31622,148796,0,180418
141520302300000,NE 142,Residential,33884,0,33884,103371,0,137255
141520302400000,NE 142,Residential,31387,0,31387,103445,0,134832
141520302500000,NE 142,Residential,25588,0,25588,83120,0,108708
141520302600000,NE 142,Residential,25476,0,25476,92126,0,117602
141520302700000,NE 142,Residential,25740,0,25740,73695,0,99435
141520302800000,NE 142,Residential,25219,0,25219,79306,0,104525
141520302900000,NE 142,Residential,23680,0,23680,102242,0,125922
141520303000000,NE 142,Residential,23280,0,23280,76909,0,100189
141520303100000,NE 142,Residential,23280,0,23280,82642,0,105922
141520303200000,NE 142,Residential,23520,0,23520,84561,0,108081
141520303300000,NE 142,Residential,22633,0,22633,68669,0,91302
141520400100000,NE 142,Residential,29812,0,29812,115353,0,145165
141520400200000,NE 142,Residential,24480,0,24480,107609,0,132089
141520400300000,NE 142,Residential,23759,0,23759,143423,0,167182
141520400400000,NE 142,Residential,23040,0,23040,98778,0,121818
141520400500000,NE 142,Residential,23902,0,23902,86663,0,110565
141520400600000,NE 142,Residential,23520,0,23520,103141,0,126661
141520400700000,NE 142,Residential,20814,0,20814,59714,0,80528
141520400800000,NE 142,Residential,29580,0,29580,117999,0,147579
141520400900000,NE 142,Residential,26000,0,26000,99970,0,125970
141520401000000,NE 142,Residential,25480,0,25480,136682,0,162162
141520401100000,NE 142,Residential,22800,0,22800,78804,0,101604
141520401200000,NE 142,Residential,23520,0,23520,84818,0,108338
141520401300000,NE 142,Residential,24240,0,24240,86519,0,110759
141520401400000,NE 142,Residential,24720,0,24720,93122,0,117842
141520401500000,NE 142,Residential,29344,0,29344,96134,0,125478
141522600100000,NE 145,Residential,36857,0,36857,130356,0,167213
141522600200000,NE 145,Residential,39780,0,39780,121864,0,161644
141522600300000,NE 145,Residential,27929,0,27929,105831,0,133760
141522600400000,NE 145,Residential,32504,0,32504,122496,0,155000
141522600500000,NE 145,Residential,35557,0,35557,128443,0,164000
141522600600000,NE 145,Residential,36000,0,36000,162947,0,198947
141522600700000,NE 145,Residential,36000,0,36000,159844,0,195844
141522600800000,NE 145,Residential,35100,0,35100,174833,0,209933
141522600900000,NE 145,Residential,34632,0,34632,147642,0,182274
141522601000000,NE 145,Residential,34425,0,34425,122238,0,156663
141522601100000,NE 145,Residential,30750,0,30750,128187,0,158937
141522601300000,NE 145,Residential,37800,0,37800,115462,0,153262
141522601400000,NE 145,Residential,37979,0,37979,105875,0,143854
141522601500000,NE 145,Residential,25110,0,25110,84260,0,109370
141522601600000,NE 145,Residential,32100,0,32100,79886,0,111986
141522601700000,NE 145,Residential,36413,0,36413,147067,0,183480
141522601800000,NE 145,Residential,27500,0,27500,125817,0,153317
141522601900000,NE 145,Residential,27500,0,27500,94890,0,122390
141522602100000,NE 144,Residential,34680,0,34680,129660,0,164340
141522602200000,NE 144,Residential,33475,0,33475,97445,0,130920
141522602300000,NE 144,Residential,35157,0,35157,130127,0,165284
141522602400000,NE 144,Residential,29500,0,29500,87115,0,116615
141522602500000,NE 144,Residential,32833,0,32833,141684,0,174517
141522602600000,NE 144,Residential,32165,0,32165,135405,0,167570
141522602700000,NE 144,Residential,29964,0,29964,157036,0,187000
141522602800000,NE 144,Residential,34707,0,34707,128590,0,163297
141522602900000,NE 144,Residential,33528,0,33528,125630,0,159158
141522603000000,NE 144,Residential,28400,0,28400,142416,0,170816
141522603100000,NE 144,Residential,26395,0,26395,138225,0,164620
141522603200000,NE 145,Residential,43775,0,43775,183472,0,227247
141522700100000,NE 145,Residential,37745,0,37745,146750,0,184495
141522700200000,NE 144,Residential,29253,0,29253,113747,0,143000
141522700300000,NE 144,Residential,31552,0,31552,131741,0,163293
141522700400000,NE 144,Residential,31293,0,31293,135750,0,167043
141522700500000,NE 144,Residential,35094,0,35094,148889,0,183983
141522700600000,NE 144,Residential,33500,0,33500,99327,0,132827
141522700700000,NE 144,Residential,32167,0,32167,121700,0,153867
141522700800000,NE 144,Residential,32167,0,32167,138798,0,170965
141522700900000,NE 144,Residential,32167,0,32167,110423,0,142590
141522701000000,NE 144,Residential,30850,0,30850,99220,0,130070
141522701100000,NE 144,Residential,34751,0,34751,119952,0,154703
141522701200000,NE 145,Residential,32069,0,32069,144251,0,176320
141522701300000,NE 145,Residential,31601,0,31601,181984,0,213585
141522701400000,NE 145,Residential,27160,0,27160,148173,0,175333
141522701500000,NE 145,Residential,28000,0,28000,164258,0,192258
141522701600000,NE 145,Residential,30267,0,30267,88521,0,118788
141522800100000,NE 145,Residential,45333,0,45333,133535,0,178868
141522800200000,NE 144,Residential,43875,0,43875,124443,0,168318
141522800300000,NE 144,Residential,43307,0,43307,130036,0,173343
141522800400000,NE 144,Residential,35075,0,35075,116720,0,151795
141522800500000,NE 144,Residential,35018,0,35018,155062,0,190080
141522800600000,NE 144,Residential,33630,0,33630,145647,0,179277
141522800700000,NE 144,Residential,40470,0,40470,92901,0,133371
141522800800000,NE 144,Residential,19575,0,19575,120080,0,139655
141522800900000,NE 145,Residential,21600,0,21600,100934,0,122534
141522801000000,NE 145,Residential,24250,0,24250,92233,0,116483
141522801100000,NE 145,Residential,25398,0,25398,94654,0,120052
141522801200000,NE 145,Residential,25500,0,25500,105297,0,130797
141522801300000,NE 145,Residential,25500,0,25500,102101,0,127601
141522801400000,NE 145,Residential,25500,0,25500,86054,0,111554
141522801500000,NE 145,Residential,29073,0,29073,84547,0,113620
141522801600000,NE 145,Residential,28000,0,28000,91028,0,119028
141522801700000,NE 145,Residential,25500,0,25500,102392,0,127892
141522801800000,NE 145,Residential,25500,0,25500,104478,0,129978
141522801900000,NE 145,Residential,25500,0,25500,97502,0,123002
141522802000000,NE 145,Residential,25500,0,25500,111882,0,137382
141522802100000,NE 145,Residential,25500,0,25500,81047,0,106547
141522802200000,NE 145,Residential,25500,0,25500,79803,0,105303
141522802300000,NE 145,Residential,24750,0,24750,107697,0,132447
141522802400000,NE 145,Residential,30947,0,30947,92282,0,123229
141522802700000,NE 145,Residential,27986,0,27986,124974,0,152960
141522802800000,NE 145,Residential,33825,0,33825,112314,0,146139
141522802900000,NE 145,Residential,21800,0,21800,98529,0,120329
141522803000000,NE 145,Residential,21600,0,21600,87642,0,109242
141522803100000,NE 145,Residential,32400,0,32400,98524,0,130924
141522803400000,NE 145,Residential,29613,0,29613,112238,0,141851
141522803500000,NE 145,Residential,31100,0,31100,88053,0,119153
141522900100000,NE 145,Residential,36048,0,36048,99995,0,136043
141522900200000,NE 145,Residential,20800,0,20800,89988,0,110788
141522900300000,NE 145,Residential,20800,0,20800,78013,0,98813
141522900400000,NE 145,Residential,20800,0,20800,99125,0,119925
141522900500000,NE 145,Residential,26000,0,26000,136987,0,162987
141522900600000,NE 145,Residential,26000,0,26000,97276,0,123276
141522900700000,NE 145,Residential,26000,0,26000,87002,0,113002
141522900800000,NE 145,Residential,26000,0,26000,83963,0,109963
141522900900000,NE 145,Residential,26000,0,26000,104423,0,130423
141522901000000,NE 145,Residential,26000,0,26000,123226,0,149226
141523000100000,NE 145,Residential,38916,0,38916,103590,0,142506
141523000200000,NE 145,Residential,19817,0,19817,88065,0,107882
141523000300000,NE 145,Residential,22475,0,22475,42116,0,64591
141523000400000,NE 145,Residential,25740,0,25740,50289,0,76029
141523000500000,NE 145,Residential,25922,0,25922,83681,0,109603
141523000600000,NE 145,Residential,26640,0,26640,124453,0,151093
141523000700000,NE 145,Residential,27685,0,27685,123060,0,150745
141523000800000,NE 145,Residential,27930,0,27930,89454,0,117384
141523000900000,NE 145,Residential,33820,0,33820,142434,0,176254
141523001000000,NE 145,Residential,23850,0,23850,66854,0,90704
141523001100000,NE 145,Residential,28730,0,28730,131042,0,159772
141523001200000,NE 145,Residential,25500,0,25500,74954,0,100454
141523001300000,NE 145,Residential,36375,0,36375,113046,0,149421
141523001400000,NE 145,Residential,27950,0,27950,64949,0,92899
141523100100000,NE 145,Residential,26000,0,26000,85060,0,111060
141523100200000,NE 145,Residential,26000,0,26000,65518,0,91518
141523100300000,NE 145,Residential,26000,0,26000,124885,0,150885
141523100400000,NE 145,Residential,26000,0,26000,80908,0,106908
141523100500000,NE 145,Residential,26000,0,26000,60945,0,86945
141523100600000,NE 145,Residential,26000,0,26000,71285,0,97285
141523100700000,NE 145,Residential,31200,0,31200,69821,0,101021
141523100800000,NE 145,Residential,26000,0,26000,58659,0,84659
141525100100000,NE 146,Residential,22725,0,22725,80781,0,103506
141525100200000,NE 146,Residential,25425,0,25425,97908,0,123333
141525100300000,NE 146,Residential,18180,0,18180,81150,0,99330
141525100400000,NE 146,Residential,25812,0,25812,84755,0,110567
141525200100000,NE 145,Residential,35295,0,35295,106314,0,141609
141525200200000,NE 145,Residential,26540,0,26540,67804,0,94344
141525200300000,NE 145,Residential,25186,0,25186,114595,0,139781
141525200400000,NE 145,Residential,22950,0,22950,81187,0,104137
141525200500000,NE 145,Exempt,0,29290,29290,0,70442,99732
141525200600000,NE 145,Residential,27540,0,27540,82088,0,109628
141525200700000,NE 145,Residential,26928,0,26928,96603,0,123531
141525200800000,NE 145,Residential,26000,0,26000,84786,0,110786
141525200900000,NE 145,Residential,25317,0,25317,102769,0,128086
141525201000000,NE 145,Residential,33957,0,33957,99289,0,133246
141525201100000,NE 145,Residential,30777,0,30777,81887,0,112664
141525201200000,NE 145,Residential,26404,0,26404,75146,0,101550
141525201300000,NE 145,Exempt,0,27582,27582,0,104544,132126
141525201400000,NE 145,Residential,30816,0,30816,91178,0,121994
141525300100000,NE 145,Residential,27250,0,27250,75911,0,103161
141525300200000,NE 145,Residential,33820,0,33820,81873,0,115693
141525300300000,NE 145,Residential,34883,0,34883,119179,0,154062
141525300400000,NE 145,Residential,35295,0,35295,78975,0,114270
141525300500000,NE 145,Residential,35597,0,35597,86470,0,122067
141525300600000,NE 145,Residential,35685,0,35685,120584,0,156269
141525300700000,NE 145,Residential,36733,0,36733,94309,0,131042
141525300800000,NE 145,Residential,36480,0,36480,77496,0,113976
141525300900000,NE 145,Residential,32205,0,32205,78759,0,110964
141525301000000,NE 145,Residential,32745,0,32745,43596,0,76341
141525301100000,NE 145,Residential,32230,0,32230,66658,0,98888
141525301200000,NE 145,Residential,32700,0,32700,76067,0,108767
141525301300000,NE 145,Residential,36551,0,36551,112613,0,149164
141525301400000,NE 145,Residential,32940,0,32940,103060,0,136000
141525301500000,NE 145,Residential,30179,0,30179,79296,0,109475
141525301600000,NE 145,Residential,29585,0,29585,88704,0,118289
141525301700000,NE 145,Residential,24250,0,24250,98011,0,122261
141525301800000,NE 145,Residential,24250,0,24250,31724,0,55974
141525301900000,NE 145,Residential,41040,0,41040,79696,0,120736
141525302000000,NE 145,Residential,23200,0,23200,84577,0,107777
141525302100000,NE 145,Residential,39200,0,39200,121483,0,160683
141525302200000,NE 145,Residential,36822,0,36822,135134,0,171956
141525302300000,NE 145,Residential,31519,0,31519,88337,0,119856
141525302400000,NE 145,Residential,35227,0,35227,65733,0,100960
141525302500000,NE 145,Residential,33600,0,33600,124688,0,158288
141525302600000,NE 145,Residential,24935,0,24935,64338,0,89273
141525302700000,NE 145,Residential,25200,0,25200,43853,0,69053
141525302800000,NE 145,Residential,27750,0,27750,58983,0,86733
141525302900000,NE 145,Residential,23375,0,23375,68928,0,92303
141525303000000,NE 145,Residential,26160,0,26160,74238,0,100398
141525303100000,NE 145,Residential,32436,0,32436,163067,0,195503
141525303200000,NE 145,Residential,38520,0,38520,113505,0,152025
141525303300000,NE 145,Residential,30240,0,30240,75903,0,106143
141525303400000,NE 145,Residential,27500,0,27500,117079,0,144579
141525303500000,NE 145,Residential,29150,0,29150,182317,0,211467
141525303600000,NE 145,Residential,29680,0,29680,70571,0,100251
141525303700000,NE 145,Residential,27750,0,27750,77054,0,104804
141525400100000,NE 145,Residential,32985,0,32985,61823,0,94808
141525400200000,NE 145,Residential,30611,0,30611,44183,0,74794
141525400300000,NE 145,Residential,31200,0,31200,58527,0,89727
141525400400000,NE 145,Residential,31373,0,31373,67085,0,98458
141525400500000,NE 145,Residential,33820,0,33820,33260,0,67080
141525400600000,NE 145,Residential,26767,0,26767,69472,0,96239
141525400700000,NE 145,Residential,28560,0,28560,98754,0,127314
141525400800000,NE 145,Residential,36489,0,36489,81916,0,118405
141525400900000,SCHOOL,Exempt,0,0,0,0,0,0
141525401000000,NE 145,Residential,33799,0,33799,96872,0,130671
141525401100000,NE 145,Residential,25380,0,25380,107810,0,133190
141525401200000,NE 145,Residential,28253,0,28253,94424,0,122677
141525401300000,NE 145,Residential,26500,0,26500,113491,0,139991
141525401400000,NE 145,Residential,29280,0,29280,108420,0,137700
141525401500000,NE 145,Residential,35490,0,35490,126493,0,161983
141525500100000,NE 146,Residential,22500,0,22500,114993,0,137493
141525500200000,NE 146,Residential,14850,0,14850,70540,0,85390
141525500300000,NE 146,Residential,15300,0,15300,58356,0,73656
141525500400000,NE 146,Residential,14850,0,14850,52827,0,67677
141525500500000,NE 146,Residential,22500,0,22500,62770,0,85270
141525500600000,NE 146,Residential,22500,0,22500,49065,0,71565
141525500700000,NE 146,Residential,15840,0,15840,57842,0,73682
141525500800000,NE 146,Residential,23000,0,23000,91593,0,114593
141525500900000,NE 146,Residential,21750,0,21750,59781,0,81531
141525501000000,NE 146,Residential,19600,0,19600,92919,0,112519
141525501100000,NE 146,Residential,19000,0,19000,120855,0,139855
141525501200000,NE 146,Residential,23250,0,23250,74556,0,97806
141525501300000,NE 146,Residential,23000,0,23000,91841,0,114841
141525501400000,NE 146,Residential,22500,0,22500,106839,0,129339
141525501500000,NE 146,Residential,22500,0,22500,66521,0,89021
141525501600000,NE 146,Residential,22500,0,22500,130775,0,153275
141525501700000,NE 146,Residential,22500,0,22500,87854,0,110354
141525501800000,NE 146,Residential,22500,0,22500,75248,0,97748
141525600100000,NE 146,Residential,15800,0,15800,67284,0,83084
141525600200000,NE 146,Residential,16600,0,16600,82372,0,98972
141525600300000,NE 146,Residential,25000,0,25000,79270,0,104270
141525600400000,NE 146,Residential,25000,0,25000,86884,0,111884
141525600500000,NE 146,Residential,25000,0,25000,102590,0,127590
141525600600000,NE 146,Residential,25000,0,25000,92660,0,117660
141525600700000,NE 146,Residential,25000,0,25000,86090,0,111090
141525600800000,NE 146,Residential,25000,0,25000,77167,0,102167
141525600900000,NE 146,Residential,25000,0,25000,82045,0,107045
141525601000000,NE 146,Residential,25000,0,25000,110553,0,135553
141525601100000,NE 146,Residential,21000,0,21000,60993,0,81993
141525601200000,NE 146,Residential,23250,0,23250,102000,0,125250
141525601300000,NE 146,Residential,19600,0,19600,72581,0,92181
141525601400000,NE 146,Residential,15200,0,15200,91493,0,106693
141525601500000,NE 146,Residential,20750,0,20750,85457,0,106207
141525601600000,NE 146,Residential,21750,0,21750,107481,0,129231
141525601700000,NE 146,Residential,25000,0,25000,82822,0,107822
141525601800000,NE 146,Residential,25000,0,25000,62380,0,87380
141525601900000,NE 146,Residential,25000,0,25000,58832,0,83832
141525602000000,NE 146,Residential,25000,0,25000,89186,0,114186
141525602100000,NE 146,Residential,25000,0,25000,82955,0,107955
141525602200000,NE 146,Residential,25000,0,25000,72300,0,97300
141525602300000,NE 146,Residential,25000,0,25000,80699,0,105699
141525602400000,NE 146,Residential,25000,0,25000,80022,0,105022
141525602500000,NE 146,Residential,25000,0,25000,84526,0,109526
141525602600000,NE 146,Residential,25000,0,25000,78238,0,103238
141525602700000,NE 146,Residential,25000,0,25000,67414,0,92414
141525602800000,NE 146,Residential,24750,0,24750,120586,0,145336
141525602900000,NE 146,Residential,19400,0,19400,92825,0,112225
141525603000000,NE 146,Residential,25250,0,25250,114112,0,139362
141525603100000,NE 146,Residential,21500,0,21500,81107,0,102607
141527600100000,SCHOOL,Exempt,0,476874,476874,0,1263358,1740232
141527600200000,CHURCH,Commercial,0,2404620,2404620,0,18595914,21000534
141527601200000,NE 145,Residential,38377,0,38377,169273,0,207650
141527602000000,NE 145,Residential,36758,0,36758,202105,0,238863
141527700100000,NE 146,Residential,23430,0,23430,70558,0,93988
141527700200000,NE 146,Residential,22500,0,22500,53006,0,75506
141527700300000,NE 146,Residential,22500,0,22500,62868,0,85368
141527700400000,NE 146,Residential,22500,0,22500,65676,0,88176
141527700500000,NE 146,Residential,22500,0,22500,67373,0,89873
141527700600000,NE 146,Residential,22500,0,22500,56108,0,78608
141527700700000,NE 146,Residential,22500,0,22500,68000,0,90500
141527700800000,NE 146,Residential,22500,0,22500,66053,0,88553
141527700900000,NE 146,Residential,22500,0,22500,70007,0,92507
141527701000000,NE 146,Residential,22500,0,22500,74174,0,96674
141527701100000,NE 146,Residential,22500,0,22500,80629,0,103129
141527701200000,NE 146,Residential,22500,0,22500,68333,0,90833
141527701300000,NE 146,Residential,22500,0,22500,47251,0,69751
141527701400000,NE 146,Residential,22500,0,22500,67234,0,89734
141527701500000,NE 146,Residential,22500,0,22500,48526,0,71026
141527701600000,NE 146,Residential,22500,0,22500,45275,0,67775
141527701700000,NE 146,Residential,22500,0,22500,60087,0,82587
141527701800000,NE 146,Residential,22500,0,22500,60512,0,83012
141527701900000,NE 146,Residential,22500,0,22500,53118,0,75618
141527702000000,NE 146,Residential,22500,0,22500,61746,0,84246
141527702100000,NE 146,Residential,22500,0,22500,31300,0,53800
141527702200000,NE 146,Residential,22500,0,22500,37210,0,59710
141527702300000,NE 146,Residential,22500,0,22500,61734,0,84234
141527702400000,NE 146,Residential,22500,0,22500,47281,0,69781
141527702500000,NE 146,Residential,22500,0,22500,36928,0,59428
141527702600000,NE 146,Residential,24799,0,24799,53730,0,78529
141530100100000,EQUIPMENT MFG;INDUST,Industrial,0,139903,139903,0,16384,156287
141530100200000,WAREHOUSE,Commercial,0,72900,72900,0,71793,144693
141530100300000,SHOP,Industrial,0,68040,68040,0,104567,172607
141530100400000,WAREHOUSE,Commercial,0,45360,45360,0,26679,72039
141530100500000,VACANT LAND,Commercial,0,23220,23220,0,0,23220
141530100600000,WAREHOUSE,Commercial,0,23220,23220,0,26025,49245
141530100700000,WAREHOUSE,Commercial,0,23220,23220,0,11305,34525
141530100800000,WAREHOUSE,Commercial,0,23220,23220,0,5438,28658
141530100900000,OFFICE,Commercial,0,23220,23220,0,28343,51563
141530101000000,WAREHOUSE,Commercial,0,23220,23220,0,13562,36782
141530101100000,CITY PROPERTY,Exempt,0,0,0,0,0,0
141530101200000,FLAT PARKING,Industrial,0,55566,55566,0,0,55566
141530200100000,EQUIPMENT MFG;INDUST,Industrial,0,644178,644178,0,1945822,2590000
141530300100000,FLAT PARKING,Industrial,0,19748,19748,0,17345,37093
141530300200000,EQUIPMENT MFG;INDUST,Industrial,0,97605,97605,0,66653,164258
141530400100000,NE 154,Residential,25220,0,25220,90738,0,115958
141530400200000,NE 154,Residential,25220,0,25220,62314,0,87534
141530400300000,NE 154,Residential,26562,0,26562,72094,0,98656
141530500100000,NE 155,Residential,22000,0,22000,66544,0,88544
141530500200000,NE 155,Residential,25740,0,25740,70323,0,96063
141530500300000,NE 155,Residential,26180,0,26180,58688,0,84868
141530500400000,NE 155,Residential,22990,0,22990,69321,0,92311
141530500600000,NE 155,Residential,20000,0,20000,72275,0,92275
141530500700000,OFFICE,Commercial,0,68040,68040,0,358744,426784
141530501000000,NE 155,Residential,20000,0,20000,52717,0,72717
141530501100000,NE 155,Residential,23800,0,23800,55518,0,79318
141530501200000,NE 155,Residential,13200,0,13200,52098,0,65298
141530501300000,NE 155,Residential,12800,0,12800,58157,0,70957
141530501400000,NE 155,Residential,20000,0,20000,77890,0,97890
141530501500000,NE 155,Residential,20000,0,20000,62325,0,82325
141530501600000,NE 155,Residential,20000,0,20000,113758,0,133758
141530501700000,NE 155,Residential,20000,0,20000,62742,0,82742
141530501800000,NE 155,Residential,20000,0,20000,64691,0,84691
141530501900000,NE 155,Residential,20000,0,20000,56167,0,76167
141532600100000,NE 146,Residential,22050,0,22050,99774,0,121824
141532600200000,NE 146,Residential,21065,0,21065,0,0,21065
141532600300000,NE 146,Residential,30000,0,30000,62287,0,92287
141532600400000,NE 146,Residential,30000,0,30000,69231,0,99231
141532600500000,NE 146,Residential,30000,0,30000,94144,0,124144
141532600600000,NE 146,Residential,30000,0,30000,66368,0,96368
141532600700000,NE 146,Residential,30000,0,30000,75107,0,105107
141532600800000,NE 146,Residential,15000,0,15000,62426,0,77426
141532600900000,NE 146,Residential,15000,0,15000,61532,0,76532
141532601000000,NE 146,Residential,15000,0,15000,66849,0,81849
141532601100000,NE 146,Residential,15000,0,15000,68091,0,83091
141532601200000,NE 146,Residential,20000,0,20000,71328,0,91328
141532601300000,NE 146,Residential,20000,0,20000,54523,0,74523
141532601400000,NE 146,Residential,20000,0,20000,76820,0,96820
141532601500000,NE 146,Residential,20000,0,20000,51915,0,71915
141532601600000,NE 146,Residential,20000,0,20000,53988,0,73988
141532601700000,NE 146,Residential,20000,0,20000,54532,0,74532
141532601800000,SHOP,Commercial,0,283608,283608,0,260914,544522
141532700100000,NE 146,Residential,30000,0,30000,71645,0,101645
141532700200000,NE 146,Residential,21193,0,21193,62189,0,83382
141532700300000,NE 146,Residential,20200,0,20200,80831,0,101031
141532700400000,NE 146,Residential,20200,0,20200,60671,0,80871
141532700500000,NE 146,Residential,20200,0,20200,92672,0,112872
141532700600000,NE 146,Residential,20200,0,20200,76214,0,96414
141532700700000,NE 146,Residential,20200,0,20200,77559,0,97759
141532700800000,NE 146,Residential,15982,0,15982,71747,0,87729
141532700900000,NE 146,Residential,16450,0,16450,68130,0,84580
141532701000000,NE 146,Residential,16200,0,16200,86806,0,103006
141532701100000,NE 146,Residential,16384,0,16384,88078,0,104462
141532701200000,NE 146,Residential,20200,0,20200,55617,0,75817
141532701300000,NE 146,Residential,20200,0,20200,85907,0,106107
141532701400000,NE 146,Residential,20200,0,20200,68906,0,89106
141532701500000,NE 146,Residential,20200,0,20200,66206,0,86406
141532701600000,NE 146,Residential,20200,0,20200,74034,0,94234
141532701700000,NE 146,Residential,19459,0,19459,75447,0,94906
141532701800000,NE 146,Residential,30000,0,30000,64007,0,94007
141532701900000,NE 146,Residential,20000,0,20000,62931,0,82931
141532702000000,NE 146,Residential,22500,0,22500,89420,0,111920
141532702100000,NE 146,Residential,17500,0,17500,76002,0,93502
141532702200000,NE 146,Residential,30000,0,30000,77802,0,107802
141532800100000,NE 146,Residential,16510,0,16510,72032,0,88542
141532800200000,NE 146,Residential,19000,0,19000,67413,0,86413
141532800300000,NE 146,Residential,21742,0,21742,88800,0,110542
141532800400000,NE 146,Residential,19000,0,19000,34558,0,53558
141532800500000,NE 146,Residential,19000,0,19000,72907,0,91907
141532800600000,NE 146,Residential,19000,0,19000,60314,0,79314
141532800700000,NE 146,Residential,19000,0,19000,71452,0,90452
141532800800000,NE 146,Residential,19000,0,19000,73711,0,92711
141532800900000,NE 146,Residential,22800,0,22800,57028,0,79828
141532801000000,NE 146,Residential,22800,0,22800,115102,0,137902
141532801100000,NE 146,Residential,19000,0,19000,82678,0,101678
141532801200000,NE 146,Residential,19000,0,19000,55491,0,74491
141532801300000,NE 146,Residential,12350,0,12350,113297,0,125647
141532801400000,NE 146,Residential,12350,0,12350,0,0,12350
141532801500000,NE 146,Residential,26329,0,26329,69631,0,95960
141532801600000,NE 146,Residential,19716,0,19716,91489,0,111205
141532801700000,NE 146,Residential,15200,0,15200,64722,0,79922
141532801800000,NE 146,Residential,15200,0,15200,67834,0,83034
141532801900000,NE 146,Residential,15200,0,15200,58339,0,73539
141532802000000,NE 146,Residential,15200,0,15200,56196,0,71396
141532802100000,NE 146,Residential,15200,0,15200,56504,0,71704
141532802200000,NE 146,Residential,15200,0,15200,70410,0,85610
141532802300000,NE 146,Residential,15200,0,15200,56356,0,71556
141532802400000,NE 146,Residential,15200,0,15200,47741,0,62941
141532802500000,NE 146,Residential,15200,0,15200,44304,0,59504
141532802600000,NE 146,Residential,15200,0,15200,79026,0,94226
141532802700000,NE 146,Residential,15200,0,15200,14466,0,29666
141532802800000,NE 146,Residential,15200,0,15200,45012,0,60212
141532802900000,NE 146,Residential,15200,0,15200,74544,0,89744
141532803000000,NE 146,Residential,15200,0,15200,52355,0,67555
141532900100000,NE 146,Residential,25000,0,25000,80988,0,105988
141532900200000,NE 146,Residential,20933,0,20933,65772,0,86705
141532900300000,NE 146,Residential,20000,0,20000,83830,0,103830
141532900400000,NE 146,Residential,20000,0,20000,61374,0,81374
141532900500000,NE 146,Residential,20000,0,20000,62809,0,82809
141532900600000,NE 146,Residential,20000,0,20000,56246,0,76246
141532900700000,NE 146,Residential,20000,0,20000,72806,0,92806
141532900800000,NE 146,Residential,21767,0,21767,60357,0,82124
141532900900000,NE 146,Residential,21270,0,21270,64144,0,85414
141532901000000,NE 146,Residential,20000,0,20000,70884,0,90884
141532901100000,NE 146,Residential,20000,0,20000,57756,0,77756
141532901200000,NE 146,Residential,20000,0,20000,65684,0,85684
141532901300000,NE 146,Residential,20000,0,20000,55258,0,75258
141532901400000,NE 146,Residential,25394,0,25394,54846,0,80240
141532901500000,NE 146,Residential,30000,0,30000,115294,0,145294
141532901600000,NE 146,Residential,30000,0,30000,78649,0,108649
141532901700000,NE 146,Residential,20000,0,20000,79844,0,99844
141532901800000,NE 146,Residential,20000,0,20000,67242,0,87242
141532901900000,NE 146,Residential,25000,0,25000,74540,0,99540
141533000100000,CENTRALLY ASSESSED,Other,0,0,0,0,0,0
141533000900000,SHOP,Commercial,0,27216,27216,0,42464,69680
141533001000000,FLAT PARKING,Commercial,0,25272,25272,0,7200,32472
141533100100000,EQUIPMENT MFG;INDUST,Industrial,0,19124,19124,0,225876,245000
141533100200000,NE 146,Residential,25092,0,25092,62376,0,87468
141533100300000,NE 146,Residential,20400,0,20400,46126,0,66526
141533100400000,NE 146,Residential,20400,0,20400,53202,0,73602
141533100500000,NE 146,Residential,20400,0,20400,85773,0,106173
141533100600000,NE 146,Residential,20400,0,20400,62149,0,82549
141533100700000,NE 146,Residential,21027,0,21027,61577,0,82604
141533100800000,EQUIPMENT MFG;INDUST,Industrial,0,51354,51354,0,613646,665000
141533200200000,NE 146,Residential,20837,0,20837,78622,0,99459
141533200300000,NE 146,Residential,19000,0,19000,76131,0,95131
141533200400000,NE 146,Residential,19000,0,19000,85643,0,104643
141533200500000,NE 146,Residential,19000,0,19000,81660,0,100660
141533200600000,NE 146,Residential,19000,0,19000,95354,0,114354
141533200700000,NE 146,Residential,19000,0,19000,74552,0,93552
141533200800000,NE 146,Residential,19000,0,19000,93879,0,112879
141533200900000,NE 146,Residential,19000,0,19000,79139,0,98139
141533201000000,NE 146,Residential,19000,0,19000,73855,0,92855
141533201100000,NE 146,Residential,19000,0,19000,92884,0,111884
141533201200000,NE 146,Residential,19000,0,19000,78077,0,97077
141533201300000,NE 146,Residential,19000,0,19000,54747,0,73747
141533201400000,NE 146,Residential,19000,0,19000,62369,0,81369
141533201500000,NE 146,Residential,19000,0,19000,61213,0,80213
141533300100000,NE 146,Residential,14998,0,14998,69966,0,84964
141533301600000,NE 146,Residential,14040,0,14040,63208,0,77248
141533301700000,NE 146,Residential,14040,0,14040,49175,0,63215
141533301800000,NE 146,Residential,14917,0,14917,63207,0,78124
141533301900000,NE 146,Residential,17199,0,17199,72399,0,89598
141533302000000,NE 146,Residential,14040,0,14040,55965,0,70005
141533302100000,NE 146,Residential,14040,0,14040,50261,0,64301
141533302200000,NE 146,Residential,18252,0,18252,60850,0,79102
141535100100000,WAREHOUSE,Commercial,0,151200,151200,0,71229,222429
141535100200000,VACANT LAND,Commercial,0,1944,1944,0,0,1944
141535100300000,RESTAURANT,Commercial,0,36288,36288,0,50924,87212
141535100400000,FLAT PARKING,Commercial,0,18144,18144,0,2940,21084
141535200200000,CENTRALLY ASSESSED,Other,0,0,0,0,0,0
141535200400000,SMALL RETAIL,Commercial,0,137565,137565,0,997779,1135344
141535200500000,CENTRALLY ASSESSED,Other,0,0,0,0,0,0
141535200700000,WAREHOUSE,Commercial,0,113400,113400,0,147058,260458
141535200800000,VACANT LAND,Commercial,0,33048,33048,0,0,33048
141535300100000,FLAT PARKING,Industrial,0,9850,9850,0,7803,17653
141535300200000,NE 146,Residential,19000,0,19000,72344,0,91344
141535300300000,NE 146,Residential,19000,0,19000,58159,0,77159
141535300400000,NE 146,Residential,19000,0,19000,54820,0,73820
141535300500000,BARS/LOUNGE,Commercial,0,18873,18873,0,26760,45633
141535400100000,NE 156,Residential,7000,0,7000,63347,0,70347
141535400200000,NE 156,Residential,7665,0,7665,57666,0,65331
141535400300000,NE 156,Residential,7665,0,7665,46912,0,54577
141535400400000,WAREHOUSE,Commercial,0,45911,45911,0,45858,91769
141535400500000,VACANT LAND,Commercial,0,11794,11794,0,0,11794
141535400800000,OFFICE,Commercial,0,101520,101520,0,230405,331925
141535401000000,WAREHOUSE,Commercial,0,32539,32539,0,2097,34636
141535401100000,WAREHOUSE,Commercial,0,6869,6869,0,9925,16794
141535401200000,FLAT PARKING,Commercial,0,10342,10342,0,2480,12822
141535401300000,BARS/LOUNGE,Commercial,0,8372,8372,0,60693,69065
141535401400000,SMALL RETAIL,Commercial,0,15759,15759,0,87980,103739
141535401500000,OFFICE,Commercial,0,126630,126630,0,633603,760233
141535401600000,NE 156,Residential,13500,0,13500,72644,0,86144
141535401700000,NE 156,Residential,8375,0,8375,59215,0,67590
141535500100000,FOOD GRADE;INDUST,Industrial,0,510997,510997,0,3489003,4000000
141535600100000,NE 156,Residential,8925,0,8925,54000,0,62925
141535600200000,NE 156,Residential,9450,0,9450,71577,0,81027
141535600300000,NE 156,Residential,7560,0,7560,53696,0,61256
141535600400000,NE 156,Residential,7560,0,7560,56858,0,64418
141535600500000,NE 156,Residential,12897,0,12897,96090,0,108987
141535600600000,NE 156,Residential,12350,0,12350,66633,0,78983
141535600700000,NE 156,Residential,12350,0,12350,64360,0,76710
141535600800000,NE 156,Residential,10000,0,10000,66833,0,76833
141535600900000,NE 156,Residential,13000,0,13000,65502,0,78502
141535601000000,NE 156,Residential,12587,0,12587,79771,0,92358
141535601100000,NE 156,Residential,12587,0,12587,56159,0,68746
141535601200000,NE 156,Residential,12587,0,12587,79500,0,92087
141535601300000,NE 156,Residential,6700,0,6700,42803,0,49503
141535601400000,CONVERSION,Commercial,0,8965,8965,0,56256,65221
141535601500000,NE 156,Residential,14290,0,14290,77436,0,91726
141535601600000,NE 156,Residential,15105,0,15105,61722,0,76827
141535601700000,NE 156,Residential,15105,0,15105,114969,0,130074
141535601800000,NE 156,Residential,14820,0,14820,44027,0,58847
141535601900000,NE 156,Residential,14820,0,14820,68915,0,83735
141535602000000,NE 156,Residential,14820,0,14820,83583,0,98403
141535602100000,CONVERSION,Commercial,0,11794,11794,0,42750,54544
141535602200000,NE 156,Residential,525,0,525,0,0,525
141535700100000,FLAT PARKING,Industrial,0,664,664,0,0,664
141535700200000,NE 156,Residential,13515,0,13515,93760,0,107275
141535700300000,NE 156,Residential,13260,0,13260,84603,0,97863
141535700400000,APARTMENT,Commercial,0,14276,14276,0,157348,171624
141535700500000,NE 156,Residential,13860,0,13860,15672,0,29532
141535800100000,NE 156,Residential,14820,0,14820,52330,0,67150
141535800200000,NE 156,Residential,15105,0,15105,80073,0,95178
141535800300000,CONVERSION,Commercial,0,12020,12020,0,63932,75952
141535800400000,NE 156,Residential,15105,0,15105,78465,0,93570
141535800500000,NE 156,Residential,11027,0,11027,49661,0,60688
141535800600000,NE 156,Exempt,0,4703,4703,0,43745,48448
141535800700000,NE 156,Residential,4577,0,4577,50060,0,54637
141535800800000,NE 156,Residential,2635,0,2635,1637,0,4272
141535800900000,NE 156,Residential,11827,0,11827,57107,0,68934
141535801000000,CONVERSION,Commercial,0,12020,12020,0,50941,62961
141535801100000,NE 156,Residential,12587,0,12587,44692,0,57279
141535900100000,FLAT PARKING,Commercial,0,19440,19440,0,0,19440
141535900102000,FAST FOOD,Commercial,0,0,0,0,44078,44078
141535900200000,NE 156,Residential,6200,0,6200,55754,0,61954
141535900300000,NE 156,Residential,7750,0,7750,46194,0,53944
141535900400000,NE 156,Residential,6975,0,6975,52275,0,59250
141535900500000,NE 156,Residential,6975,0,6975,65857,0,72832
141535900600000,APARTMENT,Residential,13608,0,13608,128665,0,142273
141535900700000,NE 156,Residential,7500,0,7500,51221,0,58721
141535900800000,NE 156,Residential,7500,0,7500,48787,0,56287
141535900900000,NE 156,Residential,12750,0,12750,50099,0,62849
141535901000000,NE 156,Residential,12750,0,12750,66136,0,78886
141535901100000,NE 156,Residential,12750,0,12750,24786,0,37536
141535901200000,NE 156,Residential,7500,0,7500,66882,0,74382
141535901300000,NE 156,Residential,7500,0,7500,53351,0,60851
141535901400000,NE 156,Residential,7500,0,7500,58360,0,65860
141535901500000,NE 156,Residential,7500,0,7500,48316,0,55816
141535901600000,CONVERSION,Commercial,0,13608,13608,0,32118,45726
141535901700000,NE 156,Residential,11569,0,11569,69430,0,80999
141535901800000,NE 156,Residential,6200,0,6200,62297,0,68497
141535901900000,NE 156,Residential,7500,0,7500,61844,0,69344
141535902000000,NE 156,Residential,7500,0,7500,53228,0,60728
141535902100000,NE 156,Residential,7500,0,7500,66594,0,74094
141535902200000,NE 156,Residential,7500,0,7500,66863,0,74363
141535902300000,NE 156,Residential,7500,0,7500,63258,0,70758
141535902400000,NE 156,Residential,12750,0,12750,75747,0,88497
141535902500000,NE 156,Residential,10000,0,10000,50660,0,60660
141535902600000,NE 156,Residential,10000,0,10000,53800,0,63800
141535902700000,NE 156,Residential,8000,0,8000,62681,0,70681
141535902800000,NE 156,Residential,13600,0,13600,85721,0,99321
141536000100000,NE 156,Residential,6200,0,6200,61189,0,67389
141536000200000,OFFICE,Commercial,0,3888,3888,0,53284,57172
141536000300000,NE 156,Residential,4050,0,4050,63227,0,67277
141536000400000,NE 156,Residential,8750,0,8750,61673,0,70423
141536000500000,NE 156,Residential,7200,0,7200,73747,0,80947
141536000600000,NE 156,Residential,12500,0,12500,56544,0,69044
141536000700000,NE 156,Residential,10000,0,10000,90003,0,100003
141537600100000,NE 155,Residential,20000,0,20000,62696,0,82696
141537600200000,NE 155,Residential,20000,0,20000,73560,0,93560
141537600300000,NE 155,Residential,20000,0,20000,60167,0,80167
141537600400000,NE 155,Residential,24000,0,24000,95426,0,119426
141537600500000,NE 155,Residential,20000,0,20000,93156,0,113156
141537600600000,NE 155,Residential,20000,0,20000,82312,0,102312
141537600700000,NE 155,Residential,26400,0,26400,130422,0,156822
141537600800000,NE 155,Residential,16000,0,16000,83557,0,99557
141537600900000,NE 155,Residential,9240,0,9240,61166,0,70406
141537601000000,NE 155,Residential,9240,0,9240,50326,0,59566
141537601100000,NE 155,Residential,9240,0,9240,84439,0,93679
141537601200000,NE 155,Residential,9240,0,9240,71564,0,80804
141537601300000,APARTMENT,Commercial,0,16403,16403,0,258084,274487
141537601400000,CONVERSION,Commercial,0,11948,11948,0,106681,118629
141537601500000,NE 155,Residential,15000,0,15000,49758,0,64758
141537601600000,NE 155,Residential,15000,0,15000,71243,0,86243
141537601700000,NE 155,Residential,20000,0,20000,71185,0,91185
141537601800000,NE 155,Residential,16000,0,16000,71209,0,87209
141537601900000,NE 155,Residential,18000,0,18000,81244,0,99244
141537602000000,NE 155,Residential,22100,0,22100,101373,0,123473
141537602100000,NE 155,Residential,20000,0,20000,61492,0,81492
141537700100000,NE 155,Residential,20000,0,20000,80524,0,100524
141537700200000,NE 155,Residential,20000,0,20000,56345,0,76345
141537700300000,NE 155,Residential,20000,0,20000,77831,0,97831
141537700400000,NE 155,Residential,20000,0,20000,73816,0,93816
141537700500000,NE 155,Residential,20000,0,20000,50711,0,70711
141537700600000,NE 155,Residential,18028,0,18028,65638,0,83666
141537700700000,NE 155,Residential,16600,0,16600,57760,0,74360
141537700800000,NE 155,Residential,11400,0,11400,53673,0,65073
141537700900000,NE 155,Residential,20000,0,20000,71001,0,91001
141537701000000,NE 155,Residential,20000,0,20000,71311,0,91311
141537701100000,NE 155,Residential,20000,0,20000,71105,0,91105
141537800100000,NE 155,Residential,16560,0,16560,117812,0,134372
141537800200000,NE 155,Residential,10560,0,10560,24082,0,34642
141537800300000,NE 155,Residential,10560,0,10560,38543,0,49103
141537800400000,NE 155,Residential,9240,0,9240,48539,0,57779
141537800500000,NE 155,Residential,9125,0,9125,39173,0,48298
141537800600000,NE 155,Residential,9125,0,9125,40534,0,49659
141537800700000,NE 155,Residential,12500,0,12500,43190,0,55690
141537800800000,NE 155,Residential,12500,0,12500,41336,0,53836
141537800900000,NE 155,Residential,12750,0,12750,47562,0,60312
141537801000000,NE 155,Residential,12750,0,12750,78956,0,91706
141537801100000,NE 155,Residential,13200,0,13200,69411,0,82611
141537801200000,NE 155,Residential,10375,0,10375,22167,0,32542
141537801300000,NE 155,Residential,10375,0,10375,76224,0,86599
141537801400000,NE 155,Residential,13200,0,13200,74988,0,88188
141537801500000,APARTMENT,Commercial,0,8100,8100,0,116177,124277
141537801600000,NE 155,Residential,13200,0,13200,63308,0,76508
141537801700000,CONVERSION,Commercial,0,21870,21870,0,60053,81923
141537802100000,NE 155,Residential,18360,0,18360,103516,0,121876
141537802200000,NE 155,Residential,18720,0,18720,144479,0,163199
141537802300000,NE 155,Residential,14162,0,14162,113918,0,128080
141537802400000,NE 155,Residential,14162,0,14162,120114,0,134276
141537900100000,SHOP,Commercial,0,105300,105300,0,280300,385600
141537900200000,WAREHOUSE,Commercial,0,38880,38880,0,85902,124782
141537900300000,VACANT LAND,Commercial,0,2430,2430,0,0,2430
141537900400000,SHOP,Commercial,0,75330,75330,0,195913,271243
141538000100000,NE 155,Residential,20400,0,20400,74265,0,94665
141538000200000,NE 155,Residential,20400,0,20400,66831,0,87231
141538000300000,NE 155,Residential,20400,0,20400,64454,0,84854
141538000400000,NE 155,Residential,20400,0,20400,69832,0,90232
141538000500000,NE 155,Residential,17600,0,17600,40253,0,57853
141538000600000,NE 155,Residential,17600,0,17600,53452,0,71052
141538000700000,APARTMENT,Commercial,0,13446,13446,0,101228,114674
141538000800000,CONVERSION,Commercial,0,18954,18954,0,123597,142551
141538000900000,NE 155,Residential,24480,0,24480,158898,0,183378
141538100100000,NE 155,Residential,19500,0,19500,126368,0,145868
141538100200000,NE 155,Residential,18000,0,18000,139697,0,157697
141538100300000,NE 155,Residential,15000,0,15000,67590,0,82590
141538100400000,NE 155,Residential,15000,0,15000,61601,0,76601
141538100500000,NE 155,Residential,15000,0,15000,86224,0,101224
141538100600000,NE 155,Residential,15000,0,15000,67944,0,82944
141538100700000,NE 156,Residential,15000,0,15000,77806,0,92806
141538100800000,CONVERSION,Commercial,0,11340,11340,0,40709,52049
141538100900000,CONVERSION,Commercial,0,11340,11340,0,78233,89573
141538101000000,NE 155,Residential,15000,0,15000,71382,0,86382
141538101100000,NE 155,Residential,14100,0,14100,54942,0,69042
141538101200000,NE 155,Residential,10500,0,10500,55162,0,65662
141538101300000,NE 155,Residential,6510,0,6510,56689,0,63199
141538101400000,NE 155,Residential,6510,0,6510,58010,0,64520
141538101500000,NE 155,Residential,7980,0,7980,69092,0,77072
141538101600000,NE 156,Residential,10695,0,10695,85556,0,96251
141538101700000,NE 155,Residential,8040,0,8040,65034,0,73074
141538101800000,NE 155,Residential,8040,0,8040,65182,0,73222
141538101900000,NE 155,Residential,11010,0,11010,74911,0,85921
141538102000000,NE 155,Residential,15595,0,15595,83933,0,99528
141538102100000,APARTMENT,Commercial,0,14580,14580,0,208717,223297
141538102200000,NE 155,Residential,15000,0,15000,78626,0,93626
141538102300000,NE 155,Residential,15300,0,15300,94551,0,109851
141538102400000,NE 155,Residential,15000,0,15000,99562,0,114562
141538102500000,NE 155,Residential,15000,0,15000,86727,0,101727
141538102600000,NE 155,Residential,15000,0,15000,81150,0,96150
141538200100000,NE 156,Residential,8778,0,8778,67713,0,76491
141538200200000,NE 156,Residential,8778,0,8778,44111,0,52889
141538200300000,NE 156,Residential,5040,0,5040,45992,0,51032
141538200400000,NE 156,Residential,14820,0,14820,78701,0,93521
141538300100000,NE 155,Residential,10650,0,10650,101954,0,112604
141538300200000,NE 155,Residential,8813,0,8813,90149,0,98962
141538300300000,NE 155,Residential,6480,0,6480,47708,0,54188
141538300400000,NE 155,Residential,6480,0,6480,71021,0,77501
141538300500000,NE 155,Residential,9300,0,9300,77554,0,86854
141538300600000,NE 155,Residential,9000,0,9000,62148,0,71148
141538300700000,NE 155,Residential,10500,0,10500,59675,0,70175
141538300800000,NE 155,Residential,10500,0,10500,68871,0,79371
141538300900000,NE 155,Residential,15000,0,15000,92374,0,107374
141538301000000,CONVERSION,Commercial,0,11340,11340,0,60801,72141
141538301100000,NE 155,Residential,15000,0,15000,75933,0,90933
141538301200000,NE 155,Residential,9900,0,9900,74128,0,84028
141538301300000,NE 155,Residential,9900,0,9900,69032,0,78932
141538301400000,NE 155,Residential,10200,0,10200,57281,0,67481
141538301500000,APARTMENT,Commercial,0,11340,11340,0,162473,173813
141538301600000,NE 155,Residential,15000,0,15000,59696,0,74696
141538301700000,NE 155,Residential,9300,0,9300,71322,0,80622
141538301800000,NE 155,Residential,9300,0,9300,62216,0,71516
141538301900000,NE 155,Residential,13200,0,13200,62462,0,75662
141538302000000,NE 155,Residential,7920,0,7920,79150,0,87070
141538302100000,CHURCH,Exempt,0,45144,45144,0,569104,614248
141538302200000,NE 155,Residential,12000,0,12000,68950,0,80950
141538302300000,NE 155,Residential,12000,0,12000,70316,0,82316
141538302400000,NE 155,Residential,15300,0,15300,134876,0,150176
141538302500000,NE 155,Residential,15000,0,15000,78983,0,93983
141538302600000,CONVERSION,Commercial,0,11340,11340,0,59827,71167
141538302700000,NE 155,Residential,15000,0,15000,52191,0,67191
141538400100000,NE 156,Residential,10250,0,10250,53373,0,63623
141538400200000,NE 156,Residential,8400,0,8400,79323,0,87723
141538400300000,NE 156,Residential,8400,0,8400,56768,0,65168
141538400400000,NE 156,Residential,7560,0,7560,36434,0,43994
141538400500000,NE 156,Residential,7560,0,7560,54832,0,62392
141538400600000,NE 156,Residential,14820,0,14820,74622,0,89442
141538400700000,NE 156,Residential,14820,0,14820,70301,0,85121
141538400800000,NE 156,Residential,10500,0,10500,67527,0,78027
141538400900000,NE 156,Residential,10500,0,10500,84253,0,94753
141538401000000,NE 156,Residential,10200,0,10200,31657,0,41857
141538401100000,NE 156,Residential,12587,0,12587,47044,0,59631
141538401200000,NE 156,Residential,12419,0,12419,81081,0,93500
141538401300000,NE 156,Residential,13000,0,13000,0,0,13000
141538401400000,NE 156,Residential,12350,0,12350,71884,0,84234
141538401500000,NE 156,Residential,12350,0,12350,73712,0,86062
141538401600000,NE 156,Residential,12350,0,12350,80805,0,93155
141538500100000,APARTMENT,Commercial,0,22680,22680,0,249954,272634
141538500200000,CONVERSION,Commercial,0,5103,5103,0,70662,75765
141538500300000,NE 155,Residential,11250,0,11250,88067,0,99317
141538500400000,NE 155,Residential,9900,0,9900,84898,0,94798
141538500500000,NE 155,Residential,10200,0,10200,73801,0,84001
141538500600000,NE 155,Residential,9900,0,9900,84498,0,94398
141538500700000,NE 155,Residential,15000,0,15000,61762,0,76762
141538500800000,NE 155,Residential,15000,0,15000,77435,0,92435
141538500900000,NE 155,Residential,15000,0,15000,91627,0,106627
141538501000000,NE 155,Residential,15000,0,15000,102056,0,117056
141538501100000,NE 155,Residential,15000,0,15000,86662,0,101662
141538501200000,NE 155,Residential,15000,0,15000,74169,0,89169
141538501300000,NE 155,Residential,15000,0,15000,65187,0,80187
141538501400000,NE 155,Residential,15000,0,15000,52379,0,67379
141538501500000,NE 155,Residential,12500,0,12500,88272,0,100772
141538501600000,NE 155,Residential,12500,0,12500,53233,0,65733
141538501700000,NE 155,Residential,12500,0,12500,0,0,12500
141538501800000,NE 155,Residential,10000,0,10000,50300,0,60300
141538501900000,NE 155,Residential,12750,0,12750,58148,0,70898
141538600100000,NE 156,Residential,10374,0,10374,91939,0,102313
141538600200000,NE 156,Residential,8232,0,8232,58358,0,66590
141538600300000,NE 156,Residential,9408,0,9408,78083,0,87491
141538600400000,NE 156,Residential,8645,0,8645,61450,0,70095
141538600500000,NE 156,Residential,12350,0,12350,69316,0,81666
141538600600000,NE 156,Residential,12350,0,12350,77188,0,89538
141538600700000,NE 156,Residential,12350,0,12350,57857,0,70207
141538600800000,NE 156,Residential,12375,0,12375,47625,0,60000
141538600900000,NE 156,Residential,12350,0,12350,61507,0,73857
141538601000000,NE 156,Residential,13000,0,13000,58173,0,71173
141540100100000,NE 154,Residential,23800,0,23800,99926,0,123726
141540100200000,NE 154,Residential,26176,0,26176,88673,0,114849
141540100300000,NE 154,Residential,23825,0,23825,121407,0,145232
141540100400000,NE 154,Residential,31256,0,31256,189696,0,220952
141540100500000,NE 154,Residential,28776,0,28776,149445,0,178221
141540100600000,NE 154,Residential,9275,0,9275,51457,0,60732
141540100700000,NE 154,Residential,30240,0,30240,79661,0,109901
141540100800000,NE 154,Residential,39258,0,39258,220242,0,259500
141540100900000,NE 154,Residential,25627,0,25627,104608,0,130235
141540200100000,NE 154,Residential,24240,0,24240,119425,0,143665
141540200200000,NE 154,Residential,30652,0,30652,109611,0,140263
141540200300000,NE 154,Residential,27000,0,27000,83671,0,110671
141540200400000,NE 154,Residential,30192,0,30192,118917,0,149109
141540300100000,NE 154,Residential,27257,0,27257,142374,0,169631
141540300200000,NE 154,Residential,27918,0,27918,114529,0,142447
141540300300000,NE 154,Residential,27876,0,27876,88708,0,116584
141540300400000,NE 154,Residential,30576,0,30576,94805,0,125381
141540300500000,NE 154,Residential,26162,0,26162,86235,0,112397
141540300600000,NE 154,Residential,26038,0,26038,89155,0,115193
141540300700000,NE 154,Residential,30282,0,30282,122621,0,152903
141540300800000,NE 154,Residential,26945,0,26945,66402,0,93347
141540300900000,NE 154,Residential,24720,0,24720,75057,0,99777
141540301000000,NE 154,Residential,34608,0,34608,151171,0,185779
141540301100000,NE 154,Residential,24240,0,24240,82726,0,106966
141540301200000,NE 154,Residential,24000,0,24000,85667,0,109667
141540301300000,NE 154,Residential,24000,0,24000,77431,0,101431
141540301400000,NE 154,Residential,23775,0,23775,108126,0,131901
141540301500000,NE 154,Residential,23367,0,23367,93173,0,116540
141540301600000,NE 154,Residential,23126,0,23126,86487,0,109613
141540301700000,NE 154,Residential,27918,0,27918,106272,0,134190
141540301800000,NE 154,Residential,22080,0,22080,74279,0,96359
141540301900000,NE 154,Residential,22320,0,22320,66970,0,89290
141540302000000,NE 154,Residential,22560,0,22560,84025,0,106585
141540302100000,NE 154,Residential,31104,0,31104,102082,0,133186
141540302200000,NE 154,Residential,31428,0,31428,135489,0,166917
141540302300000,NE 154,Residential,26264,0,26264,80213,0,106477
141540302400000,NE 154,Residential,24532,0,24532,91586,0,116118
141540302500000,NE 154,Residential,24592,0,24592,59047,0,83639
141540302600000,NE 154,Residential,25160,0,25160,67013,0,92173
141540302700000,NE 154,Residential,25360,0,25360,121734,0,147094
141540302800000,NE 154,Residential,25614,0,25614,131207,0,156821
141540302900000,NE 154,Residential,26220,0,26220,99462,0,125682
141540303000000,NE 154,Residential,26275,0,26275,76999,0,103274
141540303100000,NE 154,Residential,24720,0,24720,72153,0,96873
141540303200000,NE 154,Residential,25584,0,25584,101242,0,126826
141540303300000,NE 154,Residential,25584,0,25584,63016,0,88600
141540303400000,NE 154,Residential,25132,0,25132,62499,0,87631
141540303500000,NE 154,Residential,25704,0,25704,59527,0,85231
141540400100000,SCHOOL,Exempt,0,0,0,0,0,0
141540400200000,NE 154,Residential,29128,0,29128,86430,0,115558
141540400300000,NE 154,Residential,28200,0,28200,71523,0,99723
141540500100000,NE 154,Residential,25286,0,25286,58915,0,84201
141540500200000,NE 154,Residential,15244,0,15244,14756,0,30000
141540500300000,NE 154,Residential,32818,0,32818,107909,0,140727
141540500400000,NE 154,Residential,36115,0,36115,114374,0,150489
141540500500000,CHURCH,Exempt,0,382644,382644,0,578741,961385
141540500600000,NE 154,Residential,19600,0,19600,100538,0,120138
141540500700000,NE 154,Residential,20667,0,20667,79998,0,100665
141540500800000,NE 154,Residential,24444,0,24444,86056,0,110500
141540600100000,NE 154,Residential,18239,0,18239,70491,0,88730
141540600200000,NE 154,Residential,20400,0,20400,89716,0,110116
141540600300000,NE 154,Residential,20400,0,20400,70066,0,90466
141540600400000,NE 154,Residential,17640,0,17640,68268,0,85908
141540600500000,NE 154,Residential,17430,0,17430,68159,0,85589
141540600600000,NE 154,Residential,19680,0,19680,72356,0,92036
141540600700000,NE 154,Residential,19200,0,19200,72020,0,91220
141540600800000,NE 154,Residential,31663,0,31663,97277,0,128940
141540600900000,NE 154,Residential,30962,0,30962,117122,0,148084
141540601000000,NE 154,Residential,32076,0,32076,125504,0,157580
141540601100000,NE 154,Residential,33174,0,33174,121798,0,154972
141540601200000,NE 154,Residential,33600,0,33600,129413,0,163013
141540601300000,NE 154,Residential,22221,0,22221,125097,0,147318
141540601400000,NE 154,Residential,31080,0,31080,94405,0,125485
141540601500000,NE 154,Residential,31080,0,31080,109973,0,141053
141540601600000,NE 154,Residential,40680,0,40680,151463,0,192143
141540601700000,NE 154,Residential,36960,0,36960,144762,0,181722
141540601800000,NE 154,Residential,26642,0,26642,87916,0,114558
141540601900000,NE 154,Residential,26400,0,26400,116483,0,142883
141540602000000,NE 154,Residential,24480,0,24480,106901,0,131381
141540602100000,NE 154,Residential,35964,0,35964,113785,0,149749
141540602200000,NE 154,Residential,23232,0,23232,77240,0,100472
141540602300000,NE 154,Residential,23232,0,23232,99682,0,122914
141540602400000,NE 154,Residential,23232,0,23232,89588,0,112820
141540602500000,NE 154,Residential,23232,0,23232,75308,0,98540
141540602700000,APARTMENT,Commercial,0,40932,40932,0,9867,50799
141540602800000,APARTMENT,Residential,39042,0,39042,760958,0,800000
141540602900000,NE 154,Residential,28728,0,28728,104684,0,133412
141540603000000,NE 154,Residential,23158,0,23158,84458,0,107616
141540603100000,NE 154,Residential,22284,0,22284,90343,0,112627
141540603200000,NE 154,Residential,19508,0,19508,55198,0,74706
141540603300000,APARTMENT,Commercial,0,67338,67338,0,1636743,1704081
141540603400000,NE 154,Residential,17600,0,17600,55414,0,73014
141540700100000,NE 154,Residential,24624,0,24624,151663,0,176287
141540700200000,NE 154,Residential,18240,0,18240,77366,0,95606
141540700300000,NE 154,Residential,28500,0,28500,86615,0,115115
141540700400000,NE 154,Residential,30600,0,30600,76095,0,106695
141540700500000,NE 154,Residential,22950,0,22950,79290,0,102240
141540700600000,NE 154,Residential,19800,0,19800,60364,0,80164
141540700700000,NE 154,Residential,26928,0,26928,99865,0,126793
141540700800000,NE 154,Residential,21120,0,21120,81647,0,102767
141540700900000,NE 154,Residential,24480,0,24480,83797,0,108277
141540701000000,NE 154,Residential,24480,0,24480,108337,0,132817
141540701100000,NE 154,Residential,21120,0,21120,102473,0,123593
141540800100000,SE 218,Residential,45540,0,45540,157079,0,202619
141542600100000,NE 154,Residential,30388,0,30388,90336,0,120724
141542600200000,NE 154,Residential,30096,0,30096,127271,0,157367
141542600300000,NE 154,Residential,28000,0,28000,88573,0,116573
141542600400000,NE 154,Residential,32150,0,32150,84020,0,116170
141542600500000,NE 154,Residential,24000,0,24000,90019,0,114019
141542600600000,NE 154,Residential,30000,0,30000,94603,0,124603
141542600700000,NE 154,Residential,32130,0,32130,80695,0,112825
141542600800000,NE 154,Residential,25200,0,25200,82550,0,107750
141542600900000,NE 154,Residential,24480,0,24480,73504,0,97984
141542601000000,NE 154,Residential,24480,0,24480,70910,0,95390
141542601100000,NE 154,Residential,32699,0,32699,64960,0,97659
141542700100000,SCHOOL,Exempt,0,0,0,0,0,0
141542800100000,NE 154,Residential,31772,0,31772,97560,0,129332
141542800200000,NE 154,Residential,30258,0,30258,133772,0,164030
141542800300000,NE 154,Residential,24480,0,24480,69214,0,93694
141542800400000,NE 154,Residential,24480,0,24480,90733,0,115213
141542800500000,NE 154,Residential,24480,0,24480,88780,0,113260
141542800600000,NE 154,Residential,25217,0,25217,83237,0,108454
141542800700000,NE 154,Residential,22800,0,22800,77169,0,99969
141542800800000,NE 154,Residential,20520,0,20520,77353,0,97873
141542900100000,NE 154,Residential,30904,0,30904,96136,0,127040
141542900200000,NE 154,Residential,30197,0,30197,168981,0,199178
141542900300000,NE 154,Residential,29016,0,29016,79069,0,108085
141542900400000,NE 154,Residential,29016,0,29016,78242,0,107258
141542900500000,NE 154,Residential,29016,0,29016,92025,0,121041
141542900600000,NE 154,Residential,29016,0,29016,81673,0,110689
141542900700000,NE 154,Residential,29016,0,29016,98435,0,127451
141542900800000,NE 154,Residential,29016,0,29016,92187,0,121203
141542900900000,NE 154,Residential,29016,0,29016,89233,0,118249
141542901000000,NE 154,Residential,29016,0,29016,125133,0,154149
141542901100000,NE 154,Residential,29016,0,29016,84829,0,113845
141542901200000,NE 154,Residential,29016,0,29016,97422,0,126438
141542901300000,NE 154,Residential,29016,0,29016,89118,0,118134
141542901400000,NE 154,Residential,31107,0,31107,130447,0,161554
141542901500000,NE 154,Residential,30325,0,30325,88090,0,118415
141542901600000,NE 154,Residential,29016,0,29016,103381,0,132397
141542901700000,NE 154,Residential,29016,0,29016,100576,0,129592
141542901800000,NE 154,Residential,29016,0,29016,67935,0,96951
141542901900000,NE 154,Residential,29016,0,29016,103618,0,132634
141542902000000,NE 154,Residential,29016,0,29016,90755,0,119771
141542902100000,NE 154,Residential,29016,0,29016,97962,0,126978
141542902200000,NE 154,Residential,29016,0,29016,73850,0,102866
141542902300000,NE 154,Residential,29016,0,29016,125280,0,154296
141542902400000,NE 154,Residential,29016,0,29016,75014,0,104030
141542902500000,NE 154,Residential,29016,0,29016,73982,0,102998
141542902600000,NE 154,Residential,29016,0,29016,96804,0,125820
141543000100000,NE 154,Residential,31071,0,31071,104584,0,135655
141543000200000,NE 154,Residential,30365,0,30365,75889,0,106254
141543000300000,NE 154,Residential,29016,0,29016,78174,0,107190
141543000400000,NE 154,Residential,29016,0,29016,81959,0,110975
141543000500000,NE 154,Residential,29016,0,29016,93168,0,122184
141543000600000,NE 154,Residential,29016,0,29016,93167,0,122183
141543000700000,NE 154,Residential,29016,0,29016,96291,0,125307
141543000800000,NE 154,Residential,29016,0,29016,105423,0,134439
141543000900000,NE 154,Residential,29016,0,29016,99355,0,128371
141543001000000,NE 154,Residential,29016,0,29016,105511,0,134527
141543001100000,NE 154,Residential,29016,0,29016,116388,0,145404
141543001200000,NE 154,Residential,29016,0,29016,84014,0,113030
141543001300000,NE 154,Residential,29016,0,29016,94045,0,123061
141543001400000,NE 154,Residential,31109,0,31109,108832,0,139941
141543001500000,NE 154,Residential,30327,0,30327,79401,0,109728
141543001600000,NE 154,Residential,29016,0,29016,91953,0,120969
141543001700000,NE 154,Residential,29016,0,29016,88749,0,117765
141543001800000,NE 154,Residential,29016,0,29016,88941,0,117957
141543001900000,NE 154,Residential,29066,0,29066,82488,0,111554
141543002000000,NE 154,Residential,29016,0,29016,93682,0,122698
141543002100000,NE 154,Residential,29016,0,29016,78507,0,107523
141543002200000,NE 154,Residential,29016,0,29016,84851,0,113867
141543002300000,NE 154,Residential,29016,0,29016,96852,0,125868
141543002400000,NE 154,Residential,29016,0,29016,99157,0,128173
141543002500000,NE 154,Residential,29016,0,29016,82998,0,112014
141543002600000,NE 154,Residential,29016,0,29016,139991,0,169007
141543100100000,NE 154,Residential,36133,0,36133,86942,0,123075
141543100200000,NE 154,Residential,30502,0,30502,94153,0,124655
141543100300000,NE 154,Residential,29016,0,29016,79719,0,108735
141543100400000,NE 154,Residential,29016,0,29016,83249,0,112265
141543100500000,NE 154,Residential,29016,0,29016,101658,0,130674
141543100600000,NE 154,Residential,29016,0,29016,72302,0,101318
141543100700000,NE 154,Residential,29016,0,29016,91484,0,120500
141543100800000,NE 154,Residential,29016,0,29016,88156,0,117172
141543100900000,NE 154,Residential,29016,0,29016,89742,0,118758
141543101000000,NE 154,Residential,29016,0,29016,99940,0,128956
141543101100000,NE 154,Residential,29016,0,29016,87700,0,116716
141543101200000,NE 154,Residential,29016,0,29016,85415,0,114431
141543101300000,NE 154,Residential,29016,0,29016,73115,0,102131
141543101400000,NE 154,Residential,31109,0,31109,101841,0,132950
141543101500000,NE 154,Residential,30327,0,30327,87426,0,117753
141543101600000,NE 154,Residential,29016,0,29016,78094,0,107110
141543101700000,NE 154,Residential,29016,0,29016,95931,0,124947
141543101800000,NE 154,Residential,29016,0,29016,76896,0,105912
141543101900000,NE 154,Residential,29016,0,29016,103563,0,132579
141543102000000,NE 154,Residential,29016,0,29016,85103,0,114119
141543102100000,NE 154,Residential,29137,0,29137,55863,0,85000
141543102200000,NE 154,Residential,29016,0,29016,104829,0,133845
141543102300000,NE 154,Residential,29016,0,29016,87177,0,116193
141543102400000,NE 154,Residential,29016,0,29016,88969,0,117985
141543102500000,NE 154,Residential,29314,0,29314,104255,0,133569
141543200100000,NE 154,Residential,29774,0,29774,87183,0,116957
141543200200000,NE 154,Residential,25220,0,25220,83730,0,108950
141543200300000,NE 154,Residential,25220,0,25220,91063,0,116283
141543200400000,NE 154,Residential,25220,0,25220,113408,0,138628
141543200500000,NE 154,Residential,25220,0,25220,77247,0,102467
141543200600000,NE 154,Residential,25220,0,25220,105090,0,130310
141543200700000,NE 154,Residential,25220,0,25220,83801,0,109021
141543200800000,NE 154,Residential,25220,0,25220,108590,0,133810
141543200900000,NE 154,Residential,24714,0,24714,104286,0,129000
141543201000000,NE 154,Residential,25220,0,25220,103480,0,128700
141543201100000,NE 154,Residential,27108,0,27108,127395,0,154503
141543201200000,NE 154,Residential,30333,0,30333,97912,0,128245
141543201300000,NE 154,Residential,29016,0,29016,99338,0,128354
141543201400000,NE 154,Residential,29016,0,29016,82272,0,111288
141543201500000,NE 154,Residential,29016,0,29016,91289,0,120305
141543201600000,NE 154,Residential,29016,0,29016,102252,0,131268
141543201700000,NE 154,Residential,29016,0,29016,99343,0,128359
141543201800000,NE 154,Residential,29016,0,29016,100492,0,129508
141543201900000,NE 154,Residential,29016,0,29016,69041,0,98057
141543202000000,NE 154,Residential,29016,0,29016,69983,0,98999
141543202100000,NE 154,Residential,29016,0,29016,85380,0,114396
141543202200000,NE 154,Residential,29016,0,29016,98664,0,127680
141543202300000,NE 154,Residential,29016,0,29016,90036,0,119052
141543300100000,NE 154,Residential,30600,0,30600,107164,0,137764
141543300200000,NE 154,Residential,30600,0,30600,79528,0,110128
141543300300000,NE 154,Residential,30600,0,30600,91492,0,122092
141543300400000,NE 154,Residential,30600,0,30600,91410,0,122010
141543300500000,NE 154,Residential,30600,0,30600,72755,0,103355
141543300600000,NE 154,Residential,30600,0,30600,133845,0,164445
141543300700000,NE 154,Residential,30600,0,30600,104806,0,135406
141543300800000,NE 154,Residential,30600,0,30600,94754,0,125354
141543300900000,NE 154,Residential,30600,0,30600,106723,0,137323
141543301000000,NE 154,Residential,30600,0,30600,101052,0,131652
141543301100000,NE 154,Residential,30600,0,30600,109284,0,139884
141543301200000,NE 154,Residential,24480,0,24480,90788,0,115268
141543301300000,NE 154,Residential,24480,0,24480,71226,0,95706
141543301400000,NE 154,Residential,24480,0,24480,82954,0,107434
141543301500000,NE 154,Residential,24480,0,24480,95095,0,119575
141543301600000,NE 154,Residential,24480,0,24480,84973,0,109453
141543301700000,NE 154,Residential,30600,0,30600,91394,0,121994
141543301800000,NE 154,Residential,30600,0,30600,87761,0,118361
141543301900000,NE 154,Residential,33813,0,33813,156631,0,190444
141543302000000,NE 154,Residential,34272,0,34272,136416,0,170688
141543302100000,NE 154,Residential,33813,0,33813,138934,0,172747
141543302200000,NE 154,Residential,39780,0,39780,128184,0,167964
141543302300000,NE 154,Residential,30600,0,30600,123537,0,154137
141543302400000,NE 154,Residential,30600,0,30600,106637,0,137237
141543302500000,NE 154,Residential,27540,0,27540,140695,0,168235
141543302600000,NE 154,Residential,31977,0,31977,126320,0,158297
141543302700000,NE 154,Residential,30600,0,30600,141477,0,172077
141543302800000,NE 154,Residential,30600,0,30600,104466,0,135066
141543302900000,NE 154,Residential,29988,0,29988,91945,0,121933
141543303000000,NE 154,Residential,31212,0,31212,93140,0,124352
141543400100000,NE 155,Residential,22990,0,22990,61634,0,84624
141543400200000,NE 155,Residential,15400,0,15400,57715,0,73115
141543400300000,NE 155,Residential,22000,0,22000,66094,0,88094
141543500100000,NE 154,Residential,32400,0,32400,80885,0,113285
141543500200000,NE 154,Residential,32400,0,32400,210380,0,242780
141543500300000,NE 154,Residential,30600,0,30600,85732,0,116332
141543500400000,NE 154,Residential,30600,0,30600,109210,0,139810
141545100100000,NE 154,Residential,18360,0,18360,90971,0,109331
141545100200000,NE 154,Residential,18360,0,18360,68282,0,86642
141545100300000,NE 154,Residential,18360,0,18360,82054,0,100414
141545100400000,NE 154,Residential,30414,0,30414,106266,0,136680
141545100500000,NE 154,Residential,30600,0,30600,61131,0,91731
141545100600000,NE 154,Residential,30502,0,30502,129498,0,160000
141545100700000,NE 154,Residential,30600,0,30600,137005,0,167605
141545100800000,NE 154,Residential,32700,0,32700,93563,0,126263
141545100900000,NE 154,Residential,30600,0,30600,150339,0,180939
141545101000000,NE 154,Residential,30998,0,30998,135982,0,166980
141545101100000,NE 154,Residential,30600,0,30600,95283,0,125883
141545101200000,NE 154,Residential,30600,0,30600,152317,0,182917
141545101300000,NE 154,Residential,30600,0,30600,71005,0,101605
141545101400000,APARTMENT,Commercial,0,36558,36558,0,363442,400000
141545101500000,APARTMENT,Residential,36558,0,36558,363442,0,400000
141545101600000,APARTMENT,Commercial,0,11745,11745,0,131037,142782
141545101700000,CONVERSION,Commercial,0,13041,13041,0,59022,72063
141545101800000,NE 154,Residential,14398,0,14398,59253,0,73651
141545101900000,NE 154,Residential,15298,0,15298,58963,0,74261
141545102000000,NE 154,Residential,19888,0,19888,62635,0,82523
141545102100000,NE 154,Residential,18286,0,18286,94814,0,113100
141545102200000,NE 154,Residential,20700,0,20700,99880,0,120580
141545102300000,NE 154,Residential,22950,0,22950,97748,0,120698
141545102400000,NE 154,Residential,22950,0,22950,77820,0,100770
141545102500000,NE 154,Residential,18360,0,18360,79035,0,97395
141545102600000,NE 154,Residential,18360,0,18360,65906,0,84266
141545200100000,NE 154,Residential,30600,0,30600,112555,0,143155
141545200200000,NE 154,Residential,30600,0,30600,105184,0,135784
141545200300000,NE 154,Residential,30600,0,30600,77291,0,107891
141545200400000,NE 154,Residential,30600,0,30600,81227,0,111827
141545200500000,NE 154,Residential,30600,0,30600,90444,0,121044
141545200600000,NE 154,Residential,26400,0,26400,74795,0,101195
141545200700000,NE 154,Residential,22000,0,22000,101008,0,123008
141545200800000,NE 154,Residential,22000,0,22000,96121,0,118121
141545200900000,NE 154,Residential,25500,0,25500,90219,0,115719
141545201000000,NE 154,Residential,38250,0,38250,122591,0,160841
141545201100000,NE 154,Residential,30600,0,30600,97548,0,128148
141545201200000,NE 154,Residential,30600,0,30600,84117,0,114717
141545300100000,NE 155,Residential,28125,0,28125,127348,0,155473
141545300200000,NE 155,Residential,22500,0,22500,82531,0,105031
141545300300000,NE 155,Residential,20000,0,20000,74065,0,94065
141545300400000,NE 155,Residential,20000,0,20000,67094,0,87094
141545400100000,NE 155,Residential,79443,0,79443,130477,0,209920
141545400200000,NE 155,Residential,24120,0,24120,65124,0,89244
141545400300000,NE 155,Residential,22356,0,22356,103393,0,125749
141545400400000,NE 155,Residential,18468,0,18468,78673,0,97141
141545400500000,NE 155,Residential,19125,0,19125,85104,0,104229
141545400600000,NE 155,Residential,18768,0,18768,100113,0,118881
141545400700000,NE 155,Exempt,0,20400,20400,0,64311,84711
141545400800000,NE 155,Residential,22848,0,22848,55574,0,78422
141545400900000,NE 155,Residential,22848,0,22848,108309,0,131157
141545401000000,NE 155,Residential,21318,0,21318,96544,0,117862
141545401100000,NE 155,Residential,22760,0,22760,176402,0,199162
141545401200000,NE 155,Residential,26796,0,26796,115530,0,142326
141545500400000,FLAT PARKING,Commercial,0,11178,11178,0,12118,23296
141545500500000,CENTRALLY ASSESSED,Other,0,0,0,0,0,0
141545500600000,FLAT PARKING,Commercial,0,16414,16414,0,7296,23710
141545500700000,VACANT LAND,Commercial,0,10799,10799,0,0,10799
141545500800000,VACANT LAND,Commercial,0,10799,10799,0,0,10799
141545500900000,VACANT LAND,Commercial,0,10799,10799,0,0,10799
141545501000000,FLAT PARKING,Commercial,0,14364,14364,0,2628,16992
141545501100000,FLAT PARKING,Commercial,0,14364,14364,0,628,14992
141545501200000,OFFICE,Exempt,0,24300,24300,0,33023,57323
141545501300000,FLAT PARKING,Commercial,0,24857,24857,0,3200,28057
141545501400000,OFFICE,Commercial,0,316872,316872,0,1062389,1379261
141545501500000,VACANT LAND,Commercial,0,142560,142560,0,0,142560
141545501600000,SR/NURSING/ASSTD LIV,Commercial,0,82080,82080,0,1801460,1883540
141545600100000,NE 155,Residential,22000,0,22000,89414,0,111414
141545600200000,NE 155,Residential,22000,0,22000,75920,0,97920
141545600300000,NE 155,Residential,28314,0,28314,106454,0,134768
141545600400000,NE 155,Residential,19992,0,19992,107006,0,126998
141545600500000,NE 155,Residential,15680,0,15680,65064,0,80744
141545600700000,NE 155,Residential,13800,0,13800,66914,0,80714
141545600800000,NE 155,Residential,20400,0,20400,67770,0,88170
141545600900000,NE 155,Residential,21600,0,21600,67011,0,88611
141545601000000,NE 155,Residential,20400,0,20400,71143,0,91543
141545601100000,NE 155,Residential,21000,0,21000,110741,0,131741
141545601200000,APARTMENT,Commercial,0,13365,13365,0,95966,109331
141545601300000,NE 155,Residential,20800,0,20800,112764,0,133564
141545601400000,APARTMENT,Commercial,0,12960,12960,0,113362,126322
141545601500000,CONVERSION,Commercial,0,13365,13365,0,95896,109261
141545601600000,CONVERSION,Commercial,0,10935,10935,0,62145,73080
141545601700000,NE 155,Residential,18400,0,18400,50459,0,68859
141545601800000,NE 155,Residential,12400,0,12400,59349,0,71749
141545601900000,NE 155,Residential,8424,0,8424,52100,0,60524
141545602000000,NE 155,Residential,10032,0,10032,33842,0,43874
141545602100000,NE 155,Residential,15840,0,15840,45642,0,61482
141545602200000,NE 155,Residential,13464,0,13464,58612,0,72076
141545602300000,CONVERSION,Commercial,0,9720,9720,0,68669,78389
141545602400000,APARTMENT,Commercial,0,29160,29160,0,217452,246612
141545602500000,APARTMENT,Commercial,0,27540,27540,0,310384,337924
141545602700000,APARTMENT,Commercial,0,13365,13365,0,144449,157814
141545603100000,APARTMENT,Commercial,0,21222,21222,0,186729,207951
141545603200000,NE 155,Residential,25500,0,25500,76400,0,101900
141545603300000,NE 155,Residential,26010,0,26010,90463,0,116473
141545603400000,NE 155,Residential,25500,0,25500,86650,0,112150
141545603500000,OFFICE,Commercial,0,220320,220320,0,127707,348027
141545603600000,FLAT PARKING,Commercial,0,102330,102330,0,27442,129772
141545603700000,FUNERAL HOME,Commercial,0,204660,204660,0,207382,412042
141545603800000,APARTMENT,Commercial,0,40932,40932,0,426302,467234
141545603900000,BRANCH BANK/CU,Commercial,0,507600,507600,0,2392400,2900000
141545604000000,NE 155,Residential,6600,0,6600,78066,0,84666
141545604100000,NE 155,Residential,7700,0,7700,64370,0,72070
141545604200000,NE 155,Residential,7700,0,7700,78806,0,86506
141545604300000,NE 155,Residential,8800,0,8800,75824,0,84624
141545700100000,SE 218,Residential,18492,0,18492,70531,0,89023
141545700200000,SE 218,Residential,16542,0,16542,92714,0,109256
141545700300000,CONVERSION,Exempt,0,40327,40327,0,61257,101584
141545700400000,OFFICE; MEDICAL,Commercial,0,252720,252720,0,551202,803922
141545700500000,SE 218,Residential,44000,0,44000,165882,0,209882
141545700600000,SE 218,Residential,18000,0,18000,93217,0,111217
141545700700000,SE 218,Residential,18000,0,18000,85464,0,103464
141545800100000,SE 218,Residential,12450,0,12450,41412,0,53862
141545800200000,SE 218,Residential,10800,0,10800,31801,0,42601
141545800300000,OFFICE; MEDICAL,Commercial,0,120960,120960,0,197377,318337
141545800400000,CONVERSION,Commercial,0,32886,32886,0,163916,196802
141545800700000,SE 218,Residential,15000,0,15000,97151,0,112151
141547600100000,SE 218,Residential,51367,0,51367,144205,0,195572
141547600200000,SE 218,Residential,172497,0,172497,0,0,172497
141547600400000,OFFICE,Commercial,0,294300,294300,0,2093280,2387580
141547600500000,OFFICE; MEDICAL,Commercial,0,345600,345600,0,759829,1105429
141547600600000,OFFICE; MEDICAL,Commercial,0,60238,60238,0,144643,204881
141547600700000,FLAT PARKING,Commercial,0,37390,37390,0,6840,44230
141547600800000,SE 218,Residential,20858,0,20858,118438,0,139296
141547600900000,SE 218,Residential,18675,0,18675,91228,0,109903
141547601000000,SE 218,Residential,18675,0,18675,93263,0,111938
141547601100000,SE 218,Residential,14525,0,14525,80843,0,95368
141547601200000,SE 218,Residential,16600,0,16600,80019,0,96619
141547601300000,SE 218,Residential,14525,0,14525,99500,0,114025
141547601400000,SE 218,Residential,17637,0,17637,105647,0,123284
141547700100000,OFFICE,Commercial,0,99792,99792,0,370110,469902
141547800100000,NE 154,Residential,18400,0,18400,103827,0,122227
141547800200000,NE 154,Residential,26928,0,26928,132979,0,159907
141547800300000,NE 154,Residential,26928,0,26928,93984,0,120912
141547800400000,NE 154,Residential,21120,0,21120,112686,0,133806
141547800500000,NE 154,Residential,26928,0,26928,110977,0,137905
141547800600000,OFFICE,Commercial,0,198450,198450,0,311364,509814
141547800700000,OFFICE; MEDICAL,Commercial,0,165780,165780,0,252122,417902
141547800800000,NE 154,Residential,24651,0,24651,65744,0,90395
141547800900000,OFFICE; MEDICAL,Commercial,0,477630,477630,0,1104558,1582188
141547801000000,NE 154,Residential,18400,0,18400,107338,0,125738
141547900100000,NE 154,Residential,20925,0,20925,70747,0,91672
141547900200000,NE 154,Residential,21375,0,21375,117445,0,138820
141548000100000,SE 218,Residential,119250,0,119250,322308,0,441558
141548000200000,LITERARY/LIBRARY/ART,Exempt,0,1420200,1420200,0,1383252,2803452
141548000300000,SE 218,Residential,16600,0,16600,109034,0,125634
141548000400000,SE 218,Residential,16600,0,16600,73326,0,89926
141548000500000,SE 218,Residential,16310,0,16310,78683,0,94993
141548000600000,SE 218,Residential,16600,0,16600,93424,0,110024
141548000700000,SE 218,Residential,16600,0,16600,69436,0,86036
141548000800000,SE 218,Residential,16600,0,16600,80190,0,96790
141548000900000,SE 218,Residential,17742,0,17742,83574,0,101316
141548001000000,SE 218,Residential,21442,0,21442,102348,0,123790
141548001100000,SE 218,Residential,99150,0,99150,461651,0,560801
141548001200000,SE 218,Exempt,0,60000,60000,0,201524,261524
141548100100000,SE 218,Residential,18576,0,18576,89005,0,107581
141548100200000,SE 218,Residential,14424,0,14424,86150,0,100574
141548100300000,SE 218,Residential,15840,0,15840,93843,0,109683
141548100400000,SE 218,Residential,16200,0,16200,84937,0,101137
141548100500000,SE 218,Residential,16821,0,16821,93144,0,109965
141548100600000,SE 218,Residential,16821,0,16821,108843,0,125664
141548100700000,SE 218,Residential,18058,0,18058,104497,0,122555
141548200100000,SE 218,Residential,84832,0,84832,165168,0,250000
141548200200000,SE 218,Residential,43055,0,43055,367259,0,410314
141548200300000,SE 218,Residential,41558,0,41558,207717,0,249275
141548200400000,SE 218,Residential,17621,0,17621,104281,0,121902
141548200500000,SE 218,Residential,17149,0,17149,104827,0,121976
141548200600000,SE 218,Residential,31366,0,31366,208634,0,240000
141548200700000,SE 218,Residential,54496,0,54496,171346,0,225842
141610100100000,CHURCH,Exempt,0,31565,31565,0,114473,146038
141610100200000,NE 145,Residential,33059,0,33059,99941,0,133000
141610100300000,NE 145,Residential,33915,0,33915,105900,0,139815
141610100400000,NE 145,Residential,33920,0,33920,91946,0,125866
141610100500000,NE 145,Residential,31376,0,31376,100524,0,131900
141610100600000,NE 145,Residential,36653,0,36653,54741,0,91394
141610100700000,NE 145,Residential,25250,0,25250,65875,0,91125
141610100800000,NE 145,Residential,25250,0,25250,94888,0,120138
141610100900000,NE 145,Residential,25250,0,25250,91361,0,116611
141610101000000,NE 145,Residential,25250,0,25250,88441,0,113691
141610101100000,NE 145,Residential,25250,0,25250,82136,0,107386
141610101200000,NE 145,Residential,25250,0,25250,50713,0,75963
141610101300000,NE 145,Residential,25688,0,25688,64510,0,90198
141610200200000,NE 145,Residential,20600,0,20600,84479,0,105079
141610200300000,NE 145,Residential,20600,0,20600,114716,0,135316
141610200400000,NE 145,Residential,20518,0,20518,94449,0,114967
141610200500000,NE 145,Residential,20600,0,20600,59374,0,79974
141610200600000,NE 145,Residential,20600,0,20600,70596,0,91196
141610200700000,NE 145,Residential,31360,0,31360,75533,0,106893
141610200800000,NE 145,Residential,31360,0,31360,60348,0,91708
141610200900000,NE 145,Residential,33792,0,33792,109571,0,143363
141610201000000,NE 145,Residential,28979,0,28979,87091,0,116070
141610201100000,NE 145,Residential,29767,0,29767,48903,0,78670
141610201200000,NE 145,Residential,31765,0,31765,107477,0,139242
141610201300000,NE 145,Residential,25440,0,25440,118524,0,143964
141610201400000,NE 145,Residential,19953,0,19953,49068,0,69021
141610201500000,NE 145,Residential,19861,0,19861,97837,0,117698
141610201600000,NE 145,Residential,19861,0,19861,88186,0,108047
141610201700000,NE 145,Residential,24625,0,24625,104586,0,129211
141610201800000,NE 145,Residential,25179,0,25179,146324,0,171503
141610201900000,NE 145,Residential,23520,0,23520,100213,0,123733
141610202000000,NE 145,Residential,23520,0,23520,86428,0,109948
141610202100000,NE 145,Residential,35282,0,35282,104122,0,139404
141610202200000,NE 145,Residential,27744,0,27744,83724,0,111468
141610202300000,NE 145,Residential,29120,0,29120,0,0,29120
141610300100000,NE 145,Residential,20600,0,20600,51262,0,71862
141610300200000,NE 145,Residential,20600,0,20600,65763,0,86363
141610300300000,NE 145,Residential,20600,0,20600,98880,0,119480
141610300400000,NE 145,Residential,20600,0,20600,75236,0,95836
141610300500000,NE 145,Residential,21012,0,21012,63326,0,84338
141610300600000,NE 145,Residential,17400,0,17400,47329,0,64729
141610300700000,NE 145,Residential,15400,0,15400,49257,0,64657
141610300800000,NE 145,Residential,19968,0,19968,69091,0,89059
141610300900000,NE 145,Residential,20384,0,20384,69868,0,90252
141610301000000,AUTO REPAIR/SALES,Commercial,0,110295,110295,0,49753,160048
141610301100000,NE 145,Residential,28560,0,28560,94422,0,122982
141610301200000,NE 145,Residential,32256,0,32256,48966,0,81222
141610301300000,NE 145,Residential,30720,0,30720,84008,0,114728
141610301400000,NE 145,Residential,30720,0,30720,111482,0,142202
141610301500000,NE 145,Residential,32890,0,32890,120240,0,153130
141610301600000,NE 145,Residential,24480,0,24480,106766,0,131246
141610301700000,NE 145,Residential,24480,0,24480,94014,0,118494
141610301800000,NE 145,Residential,24480,0,24480,73502,0,97982
141610301900000,NE 145,Residential,20400,0,20400,79527,0,99927
141610302000000,NE 145,Residential,25039,0,25039,102345,0,127384
141610302100000,NE 145,Residential,26052,0,26052,93866,0,119918
141610302200000,NE 145,Residential,25920,0,25920,88616,0,114536
141610302300000,NE 145,Residential,22540,0,22540,88255,0,110795
141610302400000,NE 145,Residential,21149,0,21149,91531,0,112680
141610302600000,NE 145,Residential,30184,0,30184,138490,0,168674
141610303100000,NE 145,Residential,24000,0,24000,79309,0,103309
141610400100000,NE 145,Residential,26024,0,26024,83888,0,109912
141610400200000,NE 145,Residential,25250,0,25250,97343,0,122593
141610400300000,NE 145,Residential,25250,0,25250,52746,0,77996
141610400400000,NE 145,Residential,25250,0,25250,97690,0,122940
141610400500000,NE 145,Residential,25250,0,25250,113295,0,138545
141610400600000,NE 145,Residential,25250,0,25250,86110,0,111360
141610400700000,NE 145,Residential,25250,0,25250,88217,0,113467
141610400800000,NE 145,Residential,25250,0,25250,81906,0,107156
141610400900000,NE 145,Residential,33974,0,33974,78689,0,112663
141610401000000,NE 145,Residential,27840,0,27840,79486,0,107326
141610401100000,APARTMENT,Commercial,0,18225,18225,0,271775,290000
141610401200000,NE 145,Residential,27376,0,27376,98398,0,125774
141610401300000,NE 145,Residential,31821,0,31821,90626,0,122447
141610401400000,NE 145,Residential,23460,0,23460,99782,0,123242
141610401500000,NE 145,Residential,23460,0,23460,65334,0,88794
141610401600000,NE 145,Residential,17800,0,17800,91467,0,109267
141610401700000,APARTMENT,Commercial,0,197640,197640,0,1225503,1423143
141610500100000,NE 145,Residential,33207,0,33207,82054,0,115261
141610500200000,NE 145,Residential,35316,0,35316,67831,0,103147
141610500600000,NE 145,Residential,23450,0,23450,64266,0,87716
141610600100000,NE 145,Residential,25075,0,25075,119727,0,144802
141610600200000,NE 145,Residential,22447,0,22447,108801,0,131248
141610600300000,NE 145,Residential,19600,0,19600,94442,0,114042
141610600400000,NE 145,Residential,19600,0,19600,76137,0,95737
141610600500000,NE 145,Residential,19600,0,19600,88348,0,107948
141610600600000,NE 145,Residential,24960,0,24960,101856,0,126816
141610600700000,NE 145,Residential,26400,0,26400,52882,0,79282
141610600800000,NE 145,Residential,30940,0,30940,99302,0,130242
141610600900000,NE 145,Residential,28829,0,28829,91429,0,120258
141610601100000,NE 145,Residential,42669,0,42669,78034,0,120703
141610601200000,NE 145,Residential,24720,0,24720,75263,0,99983
141610601300000,NE 145,Residential,23520,0,23520,75232,0,98752
141610601400000,NE 145,Residential,23520,0,23520,89741,0,113261
141610700100000,NE 145,Residential,22176,0,22176,90098,0,112274
141610700200000,NE 145,Residential,18432,0,18432,83843,0,102275
141610700300000,NE 145,Residential,17040,0,17040,90052,0,107092
141610700400000,NE 145,Residential,24304,0,24304,80667,0,104971
141610700500000,NE 145,Residential,21948,0,21948,99879,0,121827
141610700600000,NE 145,Residential,28570,0,28570,53802,0,82372
141610700700000,APARTMENT,Commercial,0,72900,72900,0,547100,620000
141610700800000,NE 145,Residential,22120,0,22120,93280,0,115400
141610700900000,NE 145,Residential,22120,0,22120,93376,0,115496
141610701000000,NE 145,Residential,23700,0,23700,103739,0,127439
141610701100000,NE 145,Residential,19800,0,19800,83320,0,103120
141612600100000,AUTO REPAIR/SALES,Commercial,0,67081,67081,0,34582,101663
141612600200000,NBHD SHOPPING CENTER,Commercial,0,202824,202824,0,393782,596606
141612600300000,DAY CARE CENTER,Commercial,0,78365,78365,0,109342,187707
141612600400000,NE 146,Residential,35109,0,35109,116033,0,151142
141612600900000,NE 146,Residential,33800,0,33800,141889,0,175689
141612601100000,OFFICE; MEDICAL,Commercial,0,159408,159408,0,226012,385420
141612601200000,NE 146,Residential,28682,0,28682,57897,0,86579
141612601300000,NE 146,Residential,29654,0,29654,55484,0,85138
141612601400000,APARTMENT,Commercial,0,9720,9720,0,158344,168064
141612601700000,NE 146,Residential,13320,0,13320,30704,0,44024
141612601800000,APARTMENT,Residential,48600,0,48600,660861,0,709461
141612601900000,SMALL RETAIL,Commercial,0,28080,28080,0,79635,107715
141612602000000,WAREHOUSE,Commercial,0,30240,30240,0,69284,99524
141612602100000,APARTMENT,Commercial,0,10260,10260,0,148982,159242
141612602200000,APARTMENT,Commercial,0,9720,9720,0,157833,167553
141612700100000,NE 147,Residential,31226,0,31226,117123,0,148349
141612700200000,NE 147,Residential,30202,0,30202,143558,0,173760
141612700300000,NE 147,Residential,31266,0,31266,124133,0,155399
141612700400000,NE 147,Residential,31266,0,31266,132358,0,163624
141612700500000,NE 147,Residential,31266,0,31266,127326,0,158592
141612700600000,NE 147,Residential,31824,0,31824,162541,0,194365
141612800100000,APARTMENT,Residential,16794,0,16794,110163,0,126957
141612800200000,NE 146,Residential,36325,0,36325,0,0,36325
141612800300000,NE 146,Residential,27477,0,27477,0,0,27477
141612800400000,NE 146,Residential,29022,0,29022,0,0,29022
141615100100000,NE 146,Residential,25800,0,25800,0,0,25800
141615100200000,NE 146,Residential,25800,0,25800,0,0,25800
141615100300000,VACANT LAND,Commercial,0,143100,143100,0,0,143100
141615100400000,NE 146,Residential,26054,0,26054,73892,0,99946
141615100600000,OFFICE; MEDICAL,Commercial,0,101628,101628,0,246518,348146
141615100800000,NE 146,Residential,35208,0,35208,109862,0,145070
141615100900000,NE 146,Residential,31678,0,31678,70854,0,102532
141615200100000,CITY PROPERTY,Exempt,0,0,0,0,0,0
141615300100000,NE 146,Residential,18389,0,18389,58626,0,77015
141615300200000,NE 146,Residential,16000,0,16000,34011,0,50011
141615300300000,NE 146,Residential,16000,0,16000,78321,0,94321
141615300400000,NE 146,Residential,16000,0,16000,76251,0,92251
141615300500000,NE 146,Residential,28800,0,28800,58735,0,87535
141615300600000,NE 146,Residential,14596,0,14596,80404,0,95000
141615300700000,NE 146,Residential,16834,0,16834,66238,0,83072
141615300800000,NE 146,Residential,16000,0,16000,70109,0,86109
141615300900000,NE 146,Residential,16000,0,16000,96051,0,112051
141615301000000,NE 146,Residential,16000,0,16000,84516,0,100516
141615301100000,NE 146,Residential,16000,0,16000,50769,0,66769
141615301200000,NE 146,Residential,16000,0,16000,58622,0,74622
141615301300000,NE 146,Residential,16000,0,16000,47624,0,63624
141615301400000,NE 146,Residential,16000,0,16000,66796,0,82796
141615301500000,NE 146,Residential,16000,0,16000,67852,0,83852
141615301600000,NE 146,Residential,13200,0,13200,47234,0,60434
141615301700000,NE 146,Residential,15066,0,15066,35496,0,50562
141615301800000,NE 146,Residential,23250,0,23250,51479,0,74729
141615301900000,OFFICE,Commercial,0,27216,27216,0,72942,100158
141615302000000,SMALL RETAIL,Commercial,0,24192,24192,0,51809,76001
141615302100000,WAREHOUSE,Commercial,0,24192,24192,0,25362,49554
141615302200000,NE 146,Residential,16000,0,16000,60149,0,76149
141615302300000,NE 146,Residential,13200,0,13200,59147,0,72347
141615302400000,NE 146,Residential,13600,0,13600,59296,0,72896
141615302500000,NE 146,Residential,13200,0,13200,40823,0,54023
141615302600000,NE 146,Residential,24000,0,24000,91109,0,115109
141615302700000,NE 146,Residential,16000,0,16000,57256,0,73256
141615500200000,NE 146,Residential,24400,0,24400,48645,0,73045
141615500300000,NE 146,Residential,30192,0,30192,39420,0,69612
141615500400000,NE 146,Residential,21312,0,21312,52620,0,73932
141615500500000,NE 146,Residential,17760,0,17760,67927,0,85687
141615500600000,NE 146,Residential,17920,0,17920,30758,0,48678
141615500700000,NE 146,Residential,21504,0,21504,91695,0,113199
141615500800000,NE 146,Residential,21696,0,21696,65961,0,87657
141615500900000,NE 146,Residential,7000,0,7000,0,0,7000
141615501000000,NE 146,Residential,14360,0,14360,50831,0,65191
141615501100000,NE 146,Residential,16800,0,16800,79998,0,96798
141615501200000,NE 146,Residential,27244,0,27244,55764,0,83008
141615501300000,NE 146,Residential,18753,0,18753,0,0,18753
141615501400000,NE 146,Residential,24238,0,24238,0,0,24238
141617600100000,NE 145,Residential,34362,0,34362,57353,0,91715
141617600200000,VACANT LAND,Commercial,0,1134,1134,0,140,1274
141617600300000,NE 145,Residential,34720,0,34720,59164,0,93884
141617600400000,APARTMENT,Commercial,0,202500,202500,0,1358928,1561428
141617600500000,NE 145,Residential,29265,0,29265,53053,0,82318
141617600600000,NE 145,Residential,5105,0,5105,75313,0,80418
141617600800000,NE 145,Residential,22000,0,22000,84550,0,106550
141617600900000,NE 145,Residential,22000,0,22000,89177,0,111177
141617601000000,NE 145,Residential,22000,0,22000,67299,0,89299
141617601200000,NE 145,Residential,24480,0,24480,89005,0,113485
141617601300000,NE 145,Residential,24480,0,24480,67044,0,91524
141617601400000,NE 145,Residential,32640,0,32640,84600,0,117240
141617601500000,APARTMENT,Commercial,0,42768,42768,0,667749,710517
141617601600000,NE 145,Residential,25320,0,25320,84699,0,110019
141617601700000,NE 145,Residential,29760,0,29760,111376,0,141136
141617601800000,CONVERSION,Commercial,0,14885,14885,0,74965,89850
141617601900000,NE 145,Residential,24065,0,24065,109487,0,133552
141617602000000,NE 145,Residential,24813,0,24813,93733,0,118546
141617602100000,COUNTY PROPERTY,Exempt,0,0,0,0,0,0
141617602200000,SCHOOL,Exempt,0,0,0,0,0,0
141617700100000,NE 145,Residential,23460,0,23460,116251,0,139711
141617700200000,NE 145,Residential,33685,0,33685,111158,0,144843
141617700300000,NE 145,Residential,19002,0,19002,92831,0,111833
141617700400000,CONVERSION,Commercial,0,16211,16211,0,62908,79119
141617700500000,NE 145,Residential,25536,0,25536,73828,0,99364
141617800100000,NE 145,Residential,21334,0,21334,61075,0,82409
141617800200000,NE 145,Residential,15246,0,15246,54541,0,69787
141617800300000,NE 145,Residential,16112,0,16112,81012,0,97124
141617800400000,NE 145,Residential,14380,0,14380,54737,0,69117
141617800500000,NE 145,Residential,15246,0,15246,48963,0,64209
141617800600000,NE 145,Residential,15246,0,15246,103254,0,118500
141617800700000,NE 145,Residential,18043,0,18043,67299,0,85342
141617900100000,NE 145,Residential,23760,0,23760,85948,0,109708
141617900300000,NE 145,Residential,18176,0,18176,74895,0,93071
141617900400000,APARTMENT,Residential,32292,0,32292,425122,0,457414
141617900500000,WAREHOUSE;MINI STORG,Residential,36045,0,36045,88029,0,124074
141617900600000,NE 145,Residential,27216,0,27216,81482,0,108698
141617900700000,APARTMENT,Residential,35370,0,35370,557400,0,592770
141618000100000,NE 145,Residential,16719,0,16719,63362,0,80081
141618000200000,NE 145,Residential,15554,0,15554,76416,0,91970
141618000300000,NE 145,Residential,15554,0,15554,71796,0,87350
141618000400000,NE 145,Residential,15554,0,15554,55478,0,71032
141618000500000,NE 145,Residential,15554,0,15554,61631,0,77185
141618000600000,NE 145,Residential,15554,0,15554,32613,0,48167
141618000700000,NE 145,Residential,21437,0,21437,123035,0,144472
141618000800000,NE 145,Residential,19264,0,19264,69122,0,88386
141618000900000,NE 145,Residential,22097,0,22097,82837,0,104934
141618001000000,NE 145,Residential,15554,0,15554,56051,0,71605
141618001100000,NE 145,Residential,15554,0,15554,53980,0,69534
141618001200000,NE 145,Residential,15554,0,15554,45775,0,61329
141618001300000,NE 145,Residential,15554,0,15554,46477,0,62031
141618001400000,NE 145,Residential,15554,0,15554,59859,0,75413
141618001500000,NE 145,Residential,14777,0,14777,59966,0,74743
141618100100000,NE 145,Residential,27242,0,27242,73056,0,100298
141618100200000,APARTMENT,Commercial,0,77220,77220,0,1178636,1255856
141618100300000,NE 145,Residential,25498,0,25498,95822,0,121320
141618100400000,NE 145,Residential,31320,0,31320,87912,0,119232
141618100500000,NE 145,Residential,21600,0,21600,86613,0,108213
141618200100000,NE 145,Residential,15986,0,15986,66525,0,82511
141618200200000,NE 145,Residential,15554,0,15554,43811,0,59365
141618200300000,NE 145,Residential,15554,0,15554,76046,0,91600
141618200400000,NE 145,Residential,15554,0,15554,84453,0,100007
141618200500000,NE 145,Residential,15554,0,15554,56247,0,71801
141618200600000,NE 145,Residential,15554,0,15554,46006,0,61560
141618200700000,NE 145,Residential,15554,0,15554,50838,0,66392
141618200800000,NE 145,Residential,16909,0,16909,57427,0,74336
141618200900000,NE 145,Residential,19981,0,19981,49958,0,69939
141618201000000,NE 145,Residential,14014,0,14014,62530,0,76544
141618201100000,NE 145,Residential,15554,0,15554,53071,0,68625
141618201200000,NE 145,Residential,15554,0,15554,61189,0,76743
141618201300000,NE 145,Residential,15554,0,15554,65725,0,81279
141618201400000,NE 145,Residential,15554,0,15554,63955,0,79509
141618201500000,NE 145,Residential,10888,0,10888,69163,0,80051
141618201600000,NE 145,Residential,9829,0,9829,0,0,9829
141618300100000,NE 145,Residential,26006,0,26006,98733,0,124739
141618300200000,NE 145,Residential,18403,0,18403,44512,0,62915
141618300300000,NE 145,Residential,34446,0,34446,52554,0,87000
141618300400000,NE 145,Residential,30000,0,30000,70027,0,100027
141618300500000,NE 145,Residential,27667,0,27667,99775,0,127442
141618300600000,NE 145,Residential,27076,0,27076,81675,0,108751
141618300700000,NE 145,Residential,26482,0,26482,90558,0,117040
141618300800000,NE 145,Residential,22289,0,22289,108031,0,130320
141618300900000,NE 145,Residential,20976,0,20976,93195,0,114171
141618301000000,NE 145,Residential,20976,0,20976,62051,0,83027
141618301100000,NE 145,Residential,20976,0,20976,105254,0,126230
141618301200000,CHURCH,Exempt,0,16686,16686,0,67975,84661
141618301300000,NE 145,Residential,23112,0,23112,129674,0,152786
141618301400000,NE 145,Residential,23654,0,23654,75282,0,98936
141618301500000,NE 145,Residential,22207,0,22207,72793,0,95000
141618400100000,NE 145,Residential,15262,0,15262,63814,0,79076
141618400200000,NE 145,Residential,15554,0,15554,40213,0,55767
141618400300000,NE 145,Residential,15554,0,15554,82121,0,97675
141618400400000,NE 145,Residential,15554,0,15554,96286,0,111840
141618400500000,NE 145,Residential,15554,0,15554,83153,0,98707
141618400600000,NE 145,Residential,15258,0,15258,22537,0,37795
141618400700000,NE 145,Residential,15554,0,15554,40789,0,56343
141618400800000,NE 145,Residential,13636,0,13636,55315,0,68951
141618400900000,NE 145,Residential,11595,0,11595,36901,0,48496
141618401200000,OFFICE,Commercial,0,71996,71996,0,131935,203931
141618401300000,AUTO REPAIR/SALES,Commercial,0,28091,28091,0,34997,63088
141618401400000,NE 145,Residential,20532,0,20532,81759,0,102291
141618401500000,NE 145,Residential,10025,0,10025,0,0,10025
141618401600000,NE 145,Residential,20281,0,20281,97924,0,118205
141618401700000,NE 145,Residential,20720,0,20720,58584,0,79304
141618401800000,NE 145,Residential,20655,0,20655,82212,0,102867
141618401900000,NE 145,Residential,20976,0,20976,73439,0,94415
141620100100000,NE 147,Residential,28248,0,28248,90907,0,119155
141620100200000,NE 147,Residential,28928,0,28928,75045,0,103973
141620100300000,NE 147,Residential,28928,0,28928,115230,0,144158
141620100400000,NE 147,Residential,28928,0,28928,123053,0,151981
141620100500000,NE 147,Residential,28928,0,28928,80384,0,109312
141620100600000,NE 147,Residential,28928,0,28928,100777,0,129705
141620100700000,NE 147,Residential,29024,0,29024,106663,0,135687
141620100800000,NE 147,Residential,29920,0,29920,86519,0,116439
141620100900000,NE 147,Residential,29232,0,29232,136643,0,165875
141620101000000,NE 147,Residential,31559,0,31559,156594,0,188153
141620101100000,NE 147,Residential,39312,0,39312,118934,0,158246
141620101200000,APARTMENT,Commercial,0,20684,20684,0,138409,159093
141620200100000,NE 147,Residential,27259,0,27259,127417,0,154676
141620200200000,NE 147,Residential,18432,0,18432,104520,0,122952
141620200300000,NE 147,Residential,20544,0,20544,101266,0,121810
141620200400000,NE 147,Residential,19968,0,19968,114679,0,134647
141620200500000,NE 147,Residential,19008,0,19008,81812,0,100820
141620200600000,NE 147,Residential,18432,0,18432,94151,0,112583
141620200700000,NE 147,Residential,20116,0,20116,112172,0,132288
141620200800000,NE 147,Residential,8602,0,8602,0,0,8602
141620200900000,NE 147,Residential,32413,0,32413,89720,0,122133
141620201000000,NE 147,Residential,27783,0,27783,81693,0,109476
141620201100000,NE 147,Residential,27783,0,27783,90917,0,118700
141620201200000,NE 147,Residential,27783,0,27783,80757,0,108540
141620201300000,NE 147,Residential,27783,0,27783,91047,0,118830
141620201400000,NE 147,Residential,27783,0,27783,79304,0,107087
141620201500000,NE 147,Residential,27783,0,27783,87745,0,115528
141620201600000,NE 147,Residential,28067,0,28067,98863,0,126930
141620201700000,NE 147,Residential,28917,0,28917,87789,0,116706
141620201800000,NE 147,Residential,28776,0,28776,85789,0,114565
141620201900000,NE 147,Residential,32301,0,32301,128691,0,160992
141620202000000,NE 147,Residential,30495,0,30495,114950,0,145445
141620202100000,NE 147,Residential,32781,0,32781,107106,0,139887
141620202200000,NE 147,Residential,31930,0,31930,122691,0,154621
141620202300000,NE 147,Residential,31200,0,31200,92492,0,123692
141620202400000,NE 147,Residential,30282,0,30282,103849,0,134131
141620202500000,NE 147,Residential,30991,0,30991,108709,0,139700
141620202600000,NE 147,Residential,31680,0,31680,98059,0,129739
141620202700000,NE 147,Residential,31680,0,31680,98622,0,130302
141620202800000,NE 147,Residential,31719,0,31719,124232,0,155951
141620202900000,NE 147,Residential,33430,0,33430,92528,0,125958
141620203000000,NE 147,Residential,34627,0,34627,102856,0,137483
141620203100000,NE 147,Residential,32752,0,32752,118647,0,151399
141620203200000,NE 147,Residential,33060,0,33060,120508,0,153568
141620203300000,NE 147,Residential,31741,0,31741,99105,0,130846
141620203400000,NE 147,Residential,32566,0,32566,84616,0,117182
141620203500000,NE 147,Residential,28841,0,28841,88972,0,117813
141620203600000,NE 147,Residential,24056,0,24056,106596,0,130652
141620203700000,NE 147,Residential,24056,0,24056,86242,0,110298
141620203800000,NE 147,Residential,26720,0,26720,85444,0,112164
141620300100000,SCHOOL,Exempt,0,192429,192429,0,637735,830164
141620400100000,NE 147,Residential,26624,0,26624,99598,0,126222
141620400200000,NE 147,Residential,36300,0,36300,100973,0,137273
141620400300000,NE 147,Residential,33705,0,33705,121193,0,154898
141620400400000,NE 147,Residential,35316,0,35316,119466,0,154782
141620400500000,NE 147,Residential,39404,0,39404,129790,0,169194
141620400600000,NE 147,Residential,36873,0,36873,109155,0,146028
141620400700000,NE 147,Residential,37942,0,37942,128680,0,166622
141620400800000,NE 147,Residential,39390,0,39390,102327,0,141717
141620400900000,NE 147,Residential,37872,0,37872,102458,0,140330
141620401000000,NE 147,Residential,35880,0,35880,116479,0,152359
141620401100000,NE 147,Residential,34304,0,34304,108557,0,142861
141620401200000,NE 147,Residential,35788,0,35788,103956,0,139744
141620401300000,NE 147,Residential,39658,0,39658,102737,0,142395
141620401400000,NE 147,Residential,40025,0,40025,112871,0,152896
141620401500000,NE 147,Residential,39220,0,39220,134352,0,173572
141620401600000,NE 147,Residential,39981,0,39981,123463,0,163444
141620401700000,NE 147,Residential,31485,0,31485,120605,0,152090
141620401800000,NE 147,Residential,29488,0,29488,102575,0,132063
141620401900000,NE 147,Residential,33174,0,33174,107969,0,141143
141620500100000,NE 147,Residential,31104,0,31104,114846,0,145950
141620500200000,NE 147,Residential,39867,0,39867,123937,0,163804
141620500300000,NE 147,Residential,40763,0,40763,110350,0,151113
141620500400000,NE 147,Residential,42019,0,42019,111257,0,153276
141620500500000,NE 147,Residential,42942,0,42942,110708,0,153650
141620500600000,NE 147,Residential,40392,0,40392,153056,0,193448
141620500700000,NE 147,Residential,40838,0,40838,101275,0,142113
141620500800000,NE 147,Residential,39615,0,39615,113334,0,152949
141620500900000,NE 147,Residential,40500,0,40500,151693,0,192193
141620501000000,NE 147,Residential,39204,0,39204,136625,0,175829
141620501100000,NE 147,Residential,40014,0,40014,137237,0,177251
141620501200000,NE 147,Residential,35955,0,35955,117928,0,153883
141620501300000,NE 147,Residential,32972,0,32972,110351,0,143323
141620501400000,NE 147,Residential,32634,0,32634,114695,0,147329
141620501500000,NE 147,Residential,36450,0,36450,121217,0,157667
141620501600000,NE 147,Residential,39828,0,39828,114678,0,154506
141620501700000,NE 147,Residential,35789,0,35789,113400,0,149189
141620501800000,NE 147,Residential,21512,0,21512,163720,0,185232
141620501900000,NE 147,Residential,24696,0,24696,7409,0,32105
141620502000000,NE 147,Residential,39690,0,39690,145568,0,185258
141620502100000,NE 147,Residential,37926,0,37926,155153,0,193079
141620502200000,NE 147,Residential,39300,0,39300,173076,0,212376
141620502300000,NE 147,Residential,38862,0,38862,144434,0,183296
141620502400000,NE 147,Residential,40660,0,40660,136840,0,177500
141620502500000,NE 147,Residential,35496,0,35496,140593,0,176089
141620502600000,NE 147,Residential,31815,0,31815,141854,0,173669
141620502700000,NE 147,Residential,34500,0,34500,139104,0,173604
141620502800000,NE 147,Residential,37508,0,37508,133632,0,171140
141620502900000,NE 147,Residential,37026,0,37026,122776,0,159802
141620503000000,NE 147,Residential,33152,0,33152,146761,0,179913
141620503100000,NE 147,Residential,29488,0,29488,129854,0,159342
141620503200000,NE 147,Residential,29488,0,29488,147153,0,176641
141620600100000,NE 147,Residential,30080,0,30080,123552,0,153632
141620600200000,NE 147,Residential,27788,0,27788,125499,0,153287
141620600300000,NE 147,Residential,29520,0,29520,117725,0,147245
141620600400000,NE 147,Residential,29700,0,29700,113689,0,143389
141620600500000,NE 147,Residential,32040,0,32040,144757,0,176797
141620600600000,NE 147,Residential,40767,0,40767,131030,0,171797
141620600700000,NE 147,Residential,34742,0,34742,152541,0,187283
141620600800000,NE 147,Residential,40698,0,40698,167413,0,208111
141620600900000,NE 147,Residential,41409,0,41409,150394,0,191803
141620601000000,NE 147,Residential,40630,0,40630,135513,0,176143
141620601100000,NE 147,Residential,38543,0,38543,130533,0,169076
141620601200000,NE 147,Residential,40184,0,40184,104816,0,145000
141620601300000,NE 148,Residential,40637,0,40637,151632,0,192269
141622600100000,NE 147,Residential,32100,0,32100,127257,0,159357
141622600200000,NE 147,Residential,32400,0,32400,108323,0,140723
141622600300000,NE 147,Residential,32700,0,32700,175502,0,208202
141622600400000,NE 147,Residential,33136,0,33136,141055,0,174191
141622600500000,NE 147,Residential,35992,0,35992,172059,0,208051
141622600600000,NE 147,Residential,31603,0,31603,107766,0,139369
141622600700000,NE 147,Residential,34314,0,34314,129003,0,163317
141622600800000,NE 147,Residential,34238,0,34238,126419,0,160657
141622600900000,NE 147,Residential,29700,0,29700,132839,0,162539
141622601000000,NE 147,Residential,35616,0,35616,127944,0,163560
141622601100000,NE 147,Residential,27913,0,27913,151777,0,179690
141622601200000,NE 147,Residential,30995,0,30995,100777,0,131772
141622601300000,NE 147,Residential,33120,0,33120,154008,0,187128
141622601400000,NE 147,Residential,37890,0,37890,127082,0,164972
141622601500000,NE 147,Residential,52250,0,52250,93860,0,146110
141622601600000,NE 147,Residential,40938,0,40938,162076,0,203014
141622601700000,NE 147,Residential,41992,0,41992,113378,0,155370
141622601800000,NE 147,Residential,48413,0,48413,119896,0,168309
141622601900000,NE 147,Residential,39520,0,39520,227724,0,267244
141622602000000,NE 147,Residential,33427,0,33427,165999,0,199426
141622602100000,NE 147,Residential,30084,0,30084,119908,0,149992
141622602200000,NE 147,Residential,31240,0,31240,173871,0,205111
141622602300000,NE 147,Residential,31497,0,31497,130515,0,162012
141622602400000,NE 147,Residential,30280,0,30280,131388,0,161668
141622602500000,NE 147,Residential,26438,0,26438,104366,0,130804
141622602600000,NE 147,Residential,26977,0,26977,96868,0,123845
141622602700000,NE 147,Residential,26977,0,26977,103342,0,130319
141622602800000,NE 147,Residential,26794,0,26794,96389,0,123183
141622602900000,NE 147,Residential,28320,0,28320,70820,0,99140
141622603000000,NE 147,Residential,24099,0,24099,95049,0,119148
141622603100000,NE 147,Residential,200,0,200,0,0,200
141622603200000,NE 147,Residential,29,0,29,0,0,29
141623100100000,NE 147,Residential,35515,0,35515,115553,0,151068
141623100200000,NE 147,Residential,33197,0,33197,134643,0,167840
141623100300000,NE 147,Residential,33163,0,33163,115345,0,148508
141623100400000,NE 147,Residential,34211,0,34211,146123,0,180334
141623100500000,NE 147,Residential,37485,0,37485,152539,0,190024
141623100600000,NE 147,Residential,37926,0,37926,134229,0,172155
141625100100000,NE 147,Residential,37842,0,37842,139009,0,176851
141625100200000,CITY PROPERTY,Exempt,0,0,0,0,0,0
141625100400000,CARWASH,Commercial,0,65262,65262,0,68308,133570
141625100500000,OFFICE,Commercial,0,79110,79110,0,143808,222918
141627600100000,APARTMENT,Commercial,0,20897,20897,0,143726,164623
141627600400000,VACANT LAND,Commercial,0,74520,74520,0,0,74520
141627600500000,BRANCH BANK/CU,Commercial,0,247752,247752,0,865671,1113423
141627700100000,NE 147,Residential,27440,0,27440,129453,0,156893
141627700200000,NE 147,Residential,33681,0,33681,136102,0,169783
141627700300000,NE 147,Residential,29253,0,29253,127617,0,156870
141627700400000,NE 147,Residential,25507,0,25507,143210,0,168717
141627700500000,NE 147,Residential,41176,0,41176,151212,0,192388
141627700600000,NE 147,Residential,39847,0,39847,124353,0,164200
141627700700000,NE 147,Residential,43890,0,43890,134574,0,178464
141627700800000,NE 147,Residential,36288,0,36288,141450,0,177738
141627700900000,NE 147,Residential,35550,0,35550,150961,0,186511
141627701000000,NE 148,Residential,45389,0,45389,195981,0,241370
141627701100000,NE 148,Residential,34098,0,34098,0,0,34098
141627701200000,NE 148,Residential,37950,0,37950,162444,0,200394
141627701300000,NE 148,Residential,33120,0,33120,160267,0,193387
141627701400000,NE 148,Residential,38936,0,38936,189903,0,228839
141627701500000,NE 148,Residential,35511,0,35511,171312,0,206823
141627701600000,NE 148,Residential,18540,0,18540,153477,0,172017
141627701700000,NE 148,Residential,18720,0,18720,154092,0,172812
141627800200000,NE 148,Residential,19392,0,19392,135900,0,155292
141627800300000,NE 148,Residential,20196,0,20196,139429,0,159625
141627800400000,NE 148,Residential,19125,0,19125,134290,0,153415
141627800500000,NE 148,Residential,18695,0,18695,131051,0,149746
141627800600000,NE 148,Residential,17680,0,17680,137241,0,154921
141627800700000,NE 148,Residential,19032,0,19032,133845,0,152877
141627800800000,NE 148,Residential,38934,0,38934,143810,0,182744
141627800900000,NE 148,Residential,40086,0,40086,167159,0,207245
141627801000000,NE 148,Residential,43512,0,43512,214731,0,258243
141627801100000,NE 148,Residential,42923,0,42923,188777,0,231700
141627801200000,NE 148,Residential,40013,0,40013,169142,0,209155
141627801300000,NE 148,Residential,44550,0,44550,150131,0,194681
141627801400000,NE 148,Residential,43605,0,43605,140697,0,184302
141627801500000,NE 148,Residential,41658,0,41658,151911,0,193569
141627801600000,VACANT LAND,Commercial,0,261000,261000,0,0,261000
141627801700000,VACANT LAND,Commercial,0,1663,1663,0,0,1663
141627801800000,OFFICE,Commercial,0,303588,303588,0,1835860,2139448
141630100100000,CITY PROPERTY,Exempt,0,0,0,0,0,0
141630100200000,WAREHOUSE,Commercial,0,345168,345168,0,1050944,1396112
141630100300000,WAREHOUSE,Commercial,0,320544,320544,0,1773043,2093587
141630100400000,CITY PROPERTY,Exempt,0,0,0,0,0,0
141630100500000,PAPER; INDUSTRIAL,Industrial,0,493236,493236,0,3426738,3919974
141630100600000,CENTRALLY ASSESSED,Other,0,0,0,0,0,0
141630200100000,CENTRALLY ASSESSED,Other,0,0,0,0,0,0
141632600100000,CITY PROPERTY,Exempt,0,0,0,0,0,0
141632600400000,CITY PROPERTY,Exempt,0,0,0,0,0,0
141632600600000,CITY PROPERTY,Exempt,0,0,0,0,0,0
141632600700000,CITY PROPERTY,Exempt,0,0,0,0,0,0
141632600900000,CENTRALLY ASSESSED,Other,0,0,0,0,0,0
141632601400000,FOOD GRADE;INDUST,Industrial,0,135000,135000,0,829765,964765
141632601500000,FOOD GRADE;INDUST,Industrial,0,232038,232038,0,874158,1106196
141632601600000,WAREHOUSE,Commercial,0,443988,443988,0,853635,1297623
141635100100000,VACANT LAND,Industrial,0,20250,20250,0,0,20250
141635100200000,CITY PROPERTY,Exempt,0,0,0,0,0,0
141635100400000,CENTRALLY ASSESSED,Other,0,0,0,0,0,0
141637600100000,FLAT PARKING,Commercial,0,16961,16961,0,24000,40961
141637600102000,BILLBOARD(BLL),Commercial,0,0,0,0,8737,8737
141637600200000,CENTRALLY ASSESSED,Other,0,0,0,0,0,0
141637700100000,CITY PROPERTY,Exempt,0,0,0,0,0,0
141637700200000,OFFICE,Commercial,0,45524,45524,0,261814,307338
141637700600000,SHOP,Commercial,0,214650,214650,0,780185,994835
141637700700000,CENTRALLY ASSESSED,Other,0,0,0,0,0,0
141637700800000,CENTRALLY ASSESSED,Other,0,0,0,0,0,0
141637700900000,SHOP,Commercial,0,304344,304344,0,944487,1248831
141640100100000,CITY PROPERTY,Exempt,0,0,0,0,0,0
141640200100000,NE 145,Residential,24480,0,24480,107285,0,131765
141640200200000,APARTMENT,Commercial,0,9819,9819,0,80939,90758
141640200300000,NE 145,Residential,18180,0,18180,83084,0,101264
141640200400000,NE 145,Residential,19089,0,19089,65038,0,84127
141640200500000,NE 145,Residential,19089,0,19089,50883,0,69972
141640200600000,NE 145,Residential,30011,0,30011,56028,0,86039
141640200700000,NE 145,Residential,30011,0,30011,46529,0,76540
141640200800000,NE 145,Residential,29695,0,29695,83370,0,113065
141640200900000,NE 145,Residential,25272,0,25272,98337,0,123609
141640201000000,NE 145,Residential,24300,0,24300,56445,0,80745
141640201100000,NE 145,Residential,31882,0,31882,69387,0,101269
141640201200000,NE 145,Residential,30278,0,30278,46655,0,76933
141640201300000,NE 145,Residential,16674,0,16674,92691,0,109365
141640201400000,NE 145,Residential,18360,0,18360,67658,0,86018
141640201500000,NE 145,Residential,23520,0,23520,84854,0,108374
141640201600000,NE 145,Residential,19600,0,19600,103319,0,122919
141640201700000,NE 145,Residential,15680,0,15680,75326,0,91006
141640201800000,NE 145,Residential,15680,0,15680,78064,0,93744
141640201900000,NE 145,Residential,25056,0,25056,223790,0,248846
141640202000000,NE 145,Residential,17400,0,17400,86807,0,104207
141640202100000,NE 145,Residential,26914,0,26914,105371,0,132285
141640202200000,NE 145,Residential,26417,0,26417,65917,0,92334
141640202300000,NE 145,Residential,26417,0,26417,76205,0,102622
141640202400000,NE 145,Residential,27907,0,27907,89183,0,117090
141640202500000,NE 145,Residential,23803,0,23803,72954,0,96757
141640202600000,NE 145,Residential,26676,0,26676,95477,0,122153
141640202700000,NE 145,Residential,26676,0,26676,98610,0,125286
141640202800000,NE 145,Residential,26112,0,26112,131339,0,157451
141640300100000,NE 145,Residential,27540,0,27540,77122,0,104662
141640300200000,SMALL RETAIL,Commercial,0,25056,25056,0,40019,65075
141640300300000,NE 145,Residential,16480,0,16480,43203,0,59683
141640300400000,NE 145,Residential,16480,0,16480,0,0,16480
141640300500000,NE 145,Residential,16480,0,16480,53517,0,69997
141640300600000,NE 145,Residential,16480,0,16480,0,0,16480
141640300700000,NE 145,Residential,16480,0,16480,70011,0,86491
141640300800000,NE 145,Residential,16480,0,16480,96462,0,112942
141640300900000,NE 145,Residential,16480,0,16480,61660,0,78140
141640301000000,NE 145,Residential,16480,0,16480,82799,0,99279
141640301100000,NE 145,Residential,16480,0,16480,43677,0,60157
141640301200000,NE 145,Residential,16423,0,16423,62577,0,79000
141640301300000,NE 145,Residential,16480,0,16480,81364,0,97844
141640301400000,NE 145,Residential,12360,0,12360,66935,0,79295
141640301500000,NE 145,Residential,12360,0,12360,60024,0,72384
141640301600000,NE 145,Residential,16480,0,16480,68148,0,84628
141640301700000,NE 145,Residential,15360,0,15360,59336,0,74696
141640301800000,NE 145,Residential,20506,0,20506,75763,0,96269
141640301900000,NE 145,Residential,15800,0,15800,64330,0,80130
141640302000000,NE 145,Residential,17984,0,17984,34799,0,52783
141640302100000,NE 145,Residential,17984,0,17984,68502,0,86486
141640302200000,NE 145,Residential,27810,0,27810,95419,0,123229
141640302300000,NE 145,Residential,13905,0,13905,74141,0,88046
141640302400000,NE 145,Residential,13905,0,13905,61482,0,75387
141640302500000,NE 145,Residential,27810,0,27810,87797,0,115607
141640302600000,NE 145,Residential,18540,0,18540,43938,0,62478
141640302700000,NE 145,Residential,18540,0,18540,82444,0,100984
141640302800000,NE 145,Residential,18540,0,18540,56995,0,75535
141640302900000,NE 145,Residential,18540,0,18540,55262,0,73802
141640303000000,NE 145,Residential,18540,0,18540,109367,0,127907
141640303100000,NE 145,Residential,18540,0,18540,104690,0,123230
141640303200000,NE 145,Residential,18540,0,18540,62705,0,81245
141640303300000,NE 145,Residential,18540,0,18540,75996,0,94536
141640303400000,NE 145,Residential,18540,0,18540,73798,0,92338
141640400100000,NE 145,Residential,20731,0,20731,70502,0,91233
141640400200000,NE 145,Residential,16856,0,16856,141165,0,158021
141640400300000,NE 145,Residential,17091,0,17091,77493,0,94584
141640400400000,NE 145,Residential,19992,0,19992,77914,0,97906
141640400500000,NE 145,Residential,19680,0,19680,67369,0,87049
141640400600000,NE 145,Residential,19680,0,19680,67853,0,87533
141640400700000,NE 145,Residential,17460,0,17460,79790,0,97250
141640400800000,NE 145,Residential,19440,0,19440,64440,0,83880
141640400900000,NE 145,Residential,29792,0,29792,84833,0,114625
141640401000000,NE 145,Residential,29831,0,29831,76805,0,106636
141640401100000,NE 145,Residential,19620,0,19620,87123,0,106743
141640401200000,NE 145,Residential,19620,0,19620,104475,0,124095
141640401300000,NE 145,Residential,19620,0,19620,72965,0,92585
141640401400000,NE 145,Residential,19865,0,19865,79245,0,99110
141640401500000,NE 145,Residential,19620,0,19620,71570,0,91190
141640401600000,NE 145,Residential,17460,0,17460,77090,0,94550
141640401700000,NE 145,Residential,17460,0,17460,60225,0,77685
141640401800000,NE 145,Residential,17266,0,17266,60270,0,77536
141640401900000,NE 145,Residential,17072,0,17072,71094,0,88166
141640402000000,SMALL RETAIL,Commercial,0,71397,71397,0,115384,186781
141640402100000,NE 145,Residential,17440,0,17440,45435,0,62875
141640402200000,NE 145,Residential,28050,0,28050,81685,0,109735
141640402300000,NE 145,Residential,17440,0,17440,43140,0,60580
141640402400000,NE 145,Residential,17440,0,17440,74976,0,92416
141640402500000,NE 145,Residential,17876,0,17876,101756,0,119632
141640402600000,NE 145,Residential,18007,0,18007,92386,0,110393
141640402700000,NE 145,Residential,17440,0,17440,120056,0,137496
141640402800000,NE 145,Residential,17440,0,17440,114169,0,131609
141640402900000,NE 145,Residential,20160,0,20160,57726,0,77886
141640500100000,NE 145,Residential,11610,0,11610,29454,0,41064
141640500200000,NE 145,Residential,16500,0,16500,75106,0,91606
141640500300000,NE 145,Residential,9720,0,9720,52255,0,61975
141640500400000,NE 145,Residential,16198,0,16198,72114,0,88312
141640500500000,NE 145,Residential,16480,0,16480,66781,0,83261
141640500600000,NE 145,Residential,16480,0,16480,68534,0,85014
141640500700000,NE 145,Residential,16480,0,16480,67818,0,84298
141640500800000,NE 145,Residential,16480,0,16480,91848,0,108328
141640500900000,NE 145,Residential,16480,0,16480,70928,0,87408
141640501000000,NE 145,Residential,16480,0,16480,72986,0,89466
141640501100000,NE 145,Residential,16480,0,16480,81545,0,98025
141640501200000,NE 145,Residential,16480,0,16480,68234,0,84714
141640501300000,NE 145,Residential,16480,0,16480,36593,0,53073
141640501400000,NE 145,Residential,16480,0,16480,65745,0,82225
141640501500000,NE 145,Residential,16480,0,16480,83379,0,99859
141640501600000,NE 145,Residential,16480,0,16480,87637,0,104117
141640501700000,NE 145,Residential,14560,0,14560,61690,0,76250
141640501800000,NE 145,Residential,30996,0,30996,75095,0,106091
141640501900000,NE 145,Residential,17784,0,17784,75819,0,93603
141640502000000,NE 145,Residential,21060,0,21060,124910,0,145970
141640502100000,NE 145,Residential,21060,0,21060,90068,0,111128
141640502200000,NE 145,Residential,21060,0,21060,75399,0,96459
141640502300000,NE 145,Residential,21060,0,21060,84355,0,105415
141640502400000,NE 145,Residential,28080,0,28080,132557,0,160637
141640502500000,NE 145,Residential,28080,0,28080,82554,0,110634
141640502600000,NE 145,Residential,28080,0,28080,69712,0,97792
141640502700000,NE 145,Residential,13352,0,13352,50782,0,64134
141642600100000,BARS/LOUNGE,Commercial,0,48384,48384,0,75160,123544
141642600200000,NE 146,Residential,16000,0,16000,62144,0,78144
141642600300000,NE 146,Residential,16000,0,16000,48772,0,64772
141642600400000,NE 146,Residential,16000,0,16000,50167,0,66167
141642600500000,NE 146,Residential,15040,0,15040,44628,0,59668
141642600600000,NE 146,Residential,16000,0,16000,59770,0,75770
141642600700000,NE 146,Residential,16000,0,16000,48790,0,64790
141642600800000,NE 146,Residential,16000,0,16000,52324,0,68324
141642600900000,NE 146,Residential,16000,0,16000,55590,0,71590
141642601000000,NE 146,Residential,16000,0,16000,53392,0,69392
141642601100000,NE 146,Residential,16000,0,16000,55188,0,71188
141642601200000,NE 146,Residential,16000,0,16000,52808,0,68808
141642601300000,NE 146,Residential,16000,0,16000,89480,0,105480
141642601400000,NE 146,Residential,16000,0,16000,30255,0,46255
141642601500000,NE 146,Residential,16000,0,16000,56768,0,72768
141642601600000,NE 146,Residential,16000,0,16000,49601,0,65601
141642601700000,NE 146,Residential,16000,0,16000,65113,0,81113
141642601800000,NE 146,Residential,16000,0,16000,67888,0,83888
141642601900000,NE 146,Residential,4800,0,4800,40614,0,45414
141642602000000,NE 146,Residential,11200,0,11200,50335,0,61535
141642602100000,NE 146,Residential,16000,0,16000,79980,0,95980
141642602200000,NE 146,Residential,16000,0,16000,58642,0,74642
141642602300000,NE 146,Residential,16000,0,16000,53595,0,69595
141642602400000,NE 146,Residential,16000,0,16000,65760,0,81760
141642602500000,NE 146,Residential,16000,0,16000,32135,0,48135
141642602600000,NE 146,Residential,16000,0,16000,61150,0,77150
141642602700000,NE 146,Residential,16000,0,16000,66213,0,82213
141642602800000,NE 146,Residential,16000,0,16000,53930,0,69930
141642602900000,NE 146,Residential,16000,0,16000,52667,0,68667
141642603000000,NE 146,Residential,16000,0,16000,48155,0,64155
141642603100000,NE 146,Residential,16000,0,16000,51423,0,67423
141642603200000,NE 146,Residential,16000,0,16000,52385,0,68385
141642603300000,NE 146,Residential,15040,0,15040,49154,0,64194
141642603400000,NE 146,Residential,16000,0,16000,51056,0,67056
141642700100000,NE 146,Residential,16000,0,16000,54244,0,70244
141642700200000,MATERIALS MFG;INDUST,Industrial,0,87210,87210,0,641231,728441
141642700300000,NE 146,Residential,19200,0,19200,30372,0,49572
141642700400000,NE 146,Residential,16000,0,16000,68406,0,84406
141642700500000,NE 146,Residential,13520,0,13520,61803,0,75323
141642700600000,NE 146,Residential,16000,0,16000,51336,0,67336
141642700700000,NE 146,Residential,16000,0,16000,110913,0,126913
141642700800000,NE 146,Residential,16000,0,16000,36146,0,52146
141642800100000,FLAT PARKING,Commercial,0,21873,21873,0,0,21873
141642800200000,NE 146,Residential,16480,0,16480,89578,0,106058
141642800300000,SHOP,Commercial,0,20347,20347,0,99419,119766
141642800400000,WAREHOUSE,Commercial,0,18144,18144,0,42199,60343
141642800500000,VETERINARY CLINIC,Commercial,0,48185,48185,0,108559,156744
141642800600000,NE 146,Residential,14391,0,14391,61690,0,76081
141642800700000,NE 146,Residential,12000,0,12000,26680,0,38680
141642800800000,NE 146,Residential,12000,0,12000,44904,0,56904
141642800900000,WAREHOUSE,Commercial,0,20347,20347,0,86731,107078
141642801000000,MATERIALS MFG;INDUST,Industrial,0,34290,34290,0,6240,40530
141642900100000,CONVERSION,Commercial,0,9072,9072,0,64462,73534
141642900200000,NE 146,Residential,16686,0,16686,74639,0,91325
141642900300000,NE 146,Residential,18833,0,18833,68785,0,87618
141642900400000,NE 146,Residential,16557,0,16557,27844,0,44401
141642900500000,NE 146,Residential,16480,0,16480,61830,0,78310
141642900600000,NE 146,Residential,16686,0,16686,66330,0,83016
141642900700000,NE 146,Residential,16000,0,16000,47037,0,63037
141642900800000,NE 146,Residential,19200,0,19200,54987,0,74187
141642900900000,NE 146,Residential,13520,0,13520,41856,0,55376
141642901000000,NE 146,Residential,16000,0,16000,62086,0,78086
141642901100000,NE 146,Residential,16000,0,16000,76888,0,92888
141642901200000,NE 146,Residential,16000,0,16000,40149,0,56149
141643000100000,SHOP,Commercial,0,28003,28003,0,54176,82179
141643000200000,NE 146,Residential,16435,0,16435,38565,0,55000
141643000300000,WAREHOUSE,Commercial,0,18144,18144,0,40297,58441
141643000400000,NE 146,Residential,12000,0,12000,32185,0,44185
141643000600000,WAREHOUSE,Commercial,0,69764,69764,0,192079,261843
141643000700000,NE 146,Residential,12000,0,12000,28319,0,40319
141643000800000,NE 146,Residential,12000,0,12000,23834,0,35834
141643000900000,SHOP,Commercial,0,41559,41559,0,107942,149501
141643100100000,NE 146,Residential,16020,0,16020,93420,0,109440
141643100200000,NE 146,Residential,16020,0,16020,54807,0,70827
141643100500000,NE 146,Residential,16000,0,16000,64137,0,80137
141643100600000,NE 146,Residential,19200,0,19200,45062,0,64262
141643100700000,NE 146,Residential,16000,0,16000,56586,0,72586
141643100800000,NE 146,Residential,16000,0,16000,51086,0,67086
141643100900000,NE 146,Residential,16000,0,16000,69105,0,85105
141643101000000,NE 146,Residential,16000,0,16000,93531,0,109531
141643101100000,NE 146,Residential,19200,0,19200,75836,0,95036
141643101200000,NE 146,Residential,16000,0,16000,62231,0,78231
141643101300000,NE 146,Residential,16000,0,16000,57471,0,73471
141643101400000,NE 146,Residential,16000,0,16000,37089,0,53089
141643101500000,NE 146,Residential,16000,0,16000,64938,0,80938
141643101600000,NE 146,Residential,16000,0,16000,68978,0,84978
141643101900000,NE 146,Residential,16000,0,16000,47379,0,63379
141643102000000,NE 146,Residential,16000,0,16000,52603,0,68603
141643102100000,NE 146,Residential,16000,0,16000,106971,0,122971
141643102200000,NE 146,Residential,16000,0,16000,86418,0,102418
141643102300000,NE 146,Residential,16000,0,16000,50364,0,66364
141643102400000,NE 146,Residential,16000,0,16000,56313,0,72313
141643102500000,NE 146,Residential,16000,0,16000,62678,0,78678
141643102600000,NE 146,Residential,16000,0,16000,57403,0,73403
141643102700000,NE 146,Residential,16000,0,16000,94147,0,110147
141643102800000,NE 146,Residential,19200,0,19200,61830,0,81030
141643200100000,NE 146,Residential,18000,0,18000,66673,0,84673
141643200200000,NE 146,Residential,16200,0,16200,61332,0,77532
141643200300000,NE 146,Residential,16000,0,16000,82511,0,98511
141643200400000,NE 146,Residential,17590,0,17590,66595,0,84185
141643200500000,NE 146,Residential,19553,0,19553,41592,0,61145
141643200600000,NE 146,Residential,16000,0,16000,47490,0,63490
141643200700000,NE 146,Residential,16200,0,16200,74849,0,91049
141643200800000,NE 146,Residential,16000,0,16000,68750,0,84750
141643200900000,NE 146,Residential,16000,0,16000,50645,0,66645
141643201000000,NE 146,Residential,16000,0,16000,60742,0,76742
141643201100000,NE 146,Residential,14920,0,14920,60539,0,75459
141643201200000,NE 146,Residential,18000,0,18000,62831,0,80831
141643300100000,WAREHOUSE,Commercial,0,29296,29296,0,72147,101443
141643300200000,SHOP,Commercial,0,15552,15552,0,71993,87545
141643300300000,SHOP,Commercial,0,38880,38880,0,85744,124624
141643300400000,NE 146,Residential,11190,0,11190,43120,0,54310
141643300500000,NE 146,Residential,12000,0,12000,57913,0,69913
141643300600000,NE 146,Residential,17077,0,17077,91077,0,108154
141643300700000,SHOP,Commercial,0,128909,128909,0,124403,253312
141643300800000,VACANT LAND,Commercial,0,7966,7966,0,0,7966
141643300900000,VACANT LAND,Commercial,0,24274,24274,0,0,24274
141643400100000,NE 146,Residential,19200,0,19200,45136,0,64336
141643400200000,OFFICE; MEDICAL,Commercial,0,155520,155520,0,899039,1054559
141643400300000,NE 146,Residential,16000,0,16000,47913,0,63913
141643400400000,NE 146,Residential,16000,0,16000,0,0,16000
141643400500000,NE 146,Residential,20072,0,20072,0,0,20072
141645100100000,CONVERSION,Commercial,0,8951,8951,0,65548,74499
141645100200000,NE 146,Residential,16000,0,16000,50908,0,66908
141645200100000,NE 146,Residential,16000,0,16000,31584,0,47584
141645300100000,NE 146,Residential,14440,0,14440,58275,0,72715
141645300200000,NE 146,Residential,14040,0,14040,56190,0,70230
141645300300000,NE 146,Residential,15120,0,15120,44718,0,59838
141645300400000,NE 146,Residential,14000,0,14000,52039,0,66039
141645300500000,NE 146,Residential,16000,0,16000,64926,0,80926
141645300600000,NE 146,Residential,16000,0,16000,22225,0,38225
141645300700000,NE 146,Residential,16000,0,16000,45645,0,61645
141645300800000,NE 146,Residential,16000,0,16000,57342,0,73342
141645300900000,NE 146,Residential,16000,0,16000,63310,0,79310
141645301000000,NE 146,Residential,16000,0,16000,54463,0,70463
141645301100000,NE 146,Residential,16000,0,16000,51404,0,67404
141645301200000,NE 146,Residential,16000,0,16000,40387,0,56387
141645301300000,NE 146,Residential,16000,0,16000,44458,0,60458
141645301400000,NE 146,Residential,16000,0,16000,110776,0,126776
141645301500000,NE 146,Residential,16000,0,16000,47156,0,63156
141645301600000,NE 146,Residential,16000,0,16000,35727,0,51727
141645301700000,NE 146,Residential,16000,0,16000,68310,0,84310
141645301800000,NE 146,Residential,16000,0,16000,49340,0,65340
141645301900000,NE 146,Residential,18400,0,18400,55612,0,74012
141645302000000,NE 146,Residential,6480,0,6480,33227,0,39707
141645302100000,BARS/LOUNGE,Commercial,0,30240,30240,0,104674,134914
141645302200000,NE 146,Residential,16000,0,16000,87644,0,103644
141645302300000,NE 146,Residential,16000,0,16000,78388,0,94388
141645302400000,NE 146,Residential,16000,0,16000,54951,0,70951
141645302500000,NE 146,Residential,16000,0,16000,49467,0,65467
141645302600000,NE 146,Residential,16000,0,16000,48163,0,64163
141645302700000,NE 146,Residential,16000,0,16000,61080,0,77080
141645302800000,NE 146,Residential,16000,0,16000,58963,0,74963
141645302900000,NE 146,Residential,16000,0,16000,60243,0,76243
141645303000000,NE 146,Residential,16000,0,16000,63673,0,79673
141645303100000,NE 146,Residential,16000,0,16000,47918,0,63918
141645303200000,NE 146,Residential,16000,0,16000,79086,0,95086
141645303300000,NE 146,Residential,16000,0,16000,73448,0,89448
141645303400000,NE 146,Residential,16000,0,16000,43816,0,59816
141645303500000,NE 146,Residential,16000,0,16000,61250,0,77250
141645400100000,NE 146,Residential,18000,0,18000,60328,0,78328
141645400200000,NE 146,Residential,18360,0,18360,92346,0,110706
141645400300000,NE 146,Residential,21216,0,21216,109351,0,130567
141645400400000,NE 146,Residential,21012,0,21012,46407,0,67419
141645400500000,WAREHOUSE;MINI STORG,Commercial,0,19987,19987,0,60826,80813
141645400600000,WAREHOUSE;MINI STORG,Commercial,0,10935,10935,0,72049,82984
141645400700000,NE 146,Residential,18000,0,18000,45284,0,63284
141645400800000,NE 146,Residential,18000,0,18000,72842,0,90842
141645400900000,NE 146,Residential,16000,0,16000,67142,0,83142
141645401000000,NE 146,Residential,16000,0,16000,49108,0,65108
141645401100000,NE 146,Residential,16000,0,16000,54419,0,70419
141645401200000,NE 146,Residential,18000,0,18000,56328,0,74328
141645500100000,NE 146,Residential,18000,0,18000,85116,0,103116
141645500200000,VACANT LAND,Commercial,0,20898,20898,0,0,20898
141645500300000,WAREHOUSE,Commercial,0,10449,10449,0,37818,48267
141645500400000,NE 146,Residential,18000,0,18000,78307,0,96307
141645500500000,NE 146,Residential,18000,0,18000,66472,0,84472
141645500600000,NE 146,Residential,16000,0,16000,57685,0,73685
141645500700000,CONVERSION,Commercial,0,18144,18144,0,38687,56831
141645500800000,NE 146,Residential,8000,0,8000,0,0,8000
141645600100000,AUTO REPAIR/SALES,Commercial,0,54432,54432,0,34941,89373
141645600200000,NE 146,Residential,17100,0,17100,44859,0,61959
141645600300000,CITY PROPERTY,Exempt,0,0,0,0,0,0
141645600400000,NE 146,Residential,6000,0,6000,0,0,6000
141645600500000,NE 146,Residential,6000,0,6000,0,0,6000
141645600600000,NE 146,Residential,12000,0,12000,27265,0,39265
141645600700000,NE 146,Residential,12000,0,12000,36517,0,48517
141645600800000,NE 146,Residential,14790,0,14790,41633,0,56423
141645600900000,NE 146,Residential,23200,0,23200,46020,0,69220
141645601000000,NE 146,Residential,16000,0,16000,41225,0,57225
141645601100000,NE 146,Residential,16000,0,16000,53389,0,69389
141645601200000,NE 146,Residential,16000,0,16000,57105,0,73105
141645601300000,NE 146,Residential,16000,0,16000,52451,0,68451
141645700100000,NE 146,Residential,14107,0,14107,34678,0,48785
141645700200000,NE 146,Residential,15624,0,15624,46574,0,62198
141645700300000,NE 146,Residential,5000,0,5000,0,0,5000
141645700400000,NE 146,Residential,5976,0,5976,19335,0,25311
141645700500000,NE 146,Residential,9878,0,9878,0,0,9878
141645700600000,CENTRALLY ASSESSED,Other,0,0,0,0,0,0
141645800100000,WAREHOUSE,Commercial,0,95198,95198,0,95017,190215
141645800200000,WAREHOUSE,Commercial,0,52488,52488,0,97433,149921
141645900100000,CITY PROPERTY,Exempt,0,0,0,0,0,0
141645900200000,CITY PROPERTY,Exempt,0,0,0,0,0,0
141645900300000,CITY PROPERTY,Exempt,0,0,0,0,0,0
141645900400000,CITY PROPERTY,Exempt,0,0,0,0,0,0
141645900500000,CITY PROPERTY,Exempt,0,0,0,0,0,0
141645900600000,OFFICE,Commercial,0,31071,31071,0,33956,65027
141645900700000,CITY PROPERTY,Exempt,0,0,0,0,0,0
141645900800000,CITY PROPERTY,Exempt,0,0,0,0,0,0
141645900900000,CITY PROPERTY,Exempt,0,0,0,0,0,0
141645901000000,SMALL RETAIL,Commercial,0,26531,26531,0,59669,86200
141645901100000,SHOP,Commercial,0,67735,67735,0,240353,308088
141645901200000,MATERIALS MFG;INDUST,Industrial,0,39269,39269,0,13275,52544
141645901300000,CITY PROPERTY,Exempt,0,0,0,0,0,0
141645901400000,CENTRALLY ASSESSED,Other,0,0,0,0,0,0
141645901500000,CENTRALLY ASSESSED,Other,0,0,0,0,0,0
141645901600000,CENTRALLY ASSESSED,Other,0,0,0,0,0,0
141645901700000,CENTRALLY ASSESSED,Other,0,0,0,0,0,0
141647600100000,NE 146,Residential,10220,0,10220,43613,0,53833
141647600200000,NE 146,Residential,10360,0,10360,46119,0,56479
141647600300000,NE 146,Residential,11076,0,11076,43446,0,54522
141647600400000,NE 146,Residential,7384,0,7384,0,0,7384
141647600500000,NE 146,Residential,16000,0,16000,43306,0,59306
141647600600000,NE 146,Residential,16000,0,16000,53834,0,69834
141647600700000,NE 146,Residential,16000,0,16000,45183,0,61183
141647600800000,NE 146,Residential,15840,0,15840,40760,0,56600
141647600900000,NE 146,Residential,15840,0,15840,54203,0,70043
141647601000000,NE 146,Residential,15840,0,15840,0,0,15840
141647601100000,NE 146,Residential,19008,0,19008,62627,0,81635
141647601200000,NE 146,Residential,15680,0,15680,29650,0,45330
141647601300000,NE 146,Residential,15680,0,15680,44732,0,60412
141647601400000,NE 146,Residential,15680,0,15680,0,0,15680
141647601500000,NE 146,Residential,15520,0,15520,55100,0,70620
141647601600000,NE 146,Residential,15520,0,15520,42196,0,57716
141647601700000,NE 146,Residential,15360,0,15360,42787,0,58147
141647601800000,NE 146,Residential,15360,0,15360,53814,0,69174
141647601900000,VACANT LAND,Commercial,0,14375,14375,0,0,14375
141647602000000,FLAT PARKING,Commercial,0,13635,13635,0,5016,18651
141647602100000,FLAT PARKING,Commercial,0,12825,12825,0,4674,17499
141647602200000,FLAT PARKING,Commercial,0,11610,11610,0,2220,13830
141647602300000,WAREHOUSE,Commercial,0,126090,126090,0,282856,408946
141647700100000,NE 146,Residential,12164,0,12164,54041,0,66205
141647700200000,NE 146,Residential,11340,0,11340,53009,0,64349
141647700300000,NE 146,Residential,13580,0,13580,66129,0,79709
141647700400000,NE 146,Residential,21888,0,21888,112811,0,134699
141647700500000,NE 146,Residential,16000,0,16000,89936,0,105936
141647700600000,NE 146,Residential,16000,0,16000,83011,0,99011
141647700700000,NE 146,Residential,16000,0,16000,77358,0,93358
141647700800000,NE 146,Residential,16000,0,16000,61451,0,77451
141647700900000,NE 146,Residential,16000,0,16000,83857,0,99857
141647701000000,NE 146,Residential,16000,0,16000,83737,0,99737
141647701100000,NE 146,Residential,16000,0,16000,85976,0,101976
141647701200000,NE 146,Residential,16000,0,16000,63752,0,79752
141647701300000,NE 146,Residential,16000,0,16000,88985,0,104985
141647701400000,NE 146,Residential,16000,0,16000,72316,0,88316
141647701500000,NE 146,Residential,16000,0,16000,67325,0,83325
141647701600000,NE 146,Residential,16000,0,16000,72948,0,88948
141647701700000,NE 146,Residential,16000,0,16000,77426,0,93426
141647701800000,NE 146,Residential,16000,0,16000,64218,0,80218
141647701900000,NE 146,Residential,16000,0,16000,70691,0,86691
141647702000000,NE 146,Residential,16000,0,16000,56885,0,72885
141647702100000,NE 146,Residential,16000,0,16000,83967,0,99967
141647702200000,NE 146,Residential,16000,0,16000,108737,0,124737
141647702300000,NE 146,Residential,16000,0,16000,72787,0,88787
141647702400000,NE 146,Residential,14080,0,14080,53213,0,67293
141647702500000,NE 146,Residential,14763,0,14763,41752,0,56515
141647702600000,NE 146,Residential,12960,0,12960,46950,0,59910
141647702900000,NE 146,Residential,11760,0,11760,42833,0,54593
141647703000000,NE 146,Residential,15729,0,15729,42836,0,58565
141647703100000,NE 146,Residential,11200,0,11200,46807,0,58007
141647703200000,NE 146,Residential,16000,0,16000,50878,0,66878
141647703300000,NE 146,Residential,16000,0,16000,49158,0,65158
141647703400000,NE 146,Residential,16000,0,16000,0,0,16000
141647703500000,NE 146,Residential,16000,0,16000,25379,0,41379
141647703600000,NE 146,Residential,16000,0,16000,46783,0,62783
141647703700000,NE 146,Residential,19200,0,19200,60014,0,79214
141647703800000,NE 146,Residential,16000,0,16000,51721,0,67721
141647703900000,NE 146,Residential,16000,0,16000,54975,0,70975
141647704000000,NE 146,Residential,16000,0,16000,57769,0,73769
141647704100000,NE 146,Residential,16000,0,16000,58355,0,74355
141647704200000,NE 146,Residential,16000,0,16000,66592,0,82592
141647704300000,NE 146,Residential,16000,0,16000,61024,0,77024
141647704400000,NE 146,Residential,16000,0,16000,55874,0,71874
141647704500000,NE 146,Residential,16000,0,16000,61921,0,77921
141647704600000,NE 146,Residential,16000,0,16000,26569,0,42569
141647704700000,NE 146,Residential,16000,0,16000,52137,0,68137
141647704800000,NE 146,Residential,14400,0,14400,0,0,14400
141647704900000,NE 146,Residential,11200,0,11200,71853,0,83053
141647705000000,NE 146,Residential,11620,0,11620,66471,0,78091
141647800100000,NE 145,Residential,17460,0,17460,63244,0,80704
141647900100000,NE 145,Residential,24570,0,24570,66679,0,91249
141647900200000,NE 145,Residential,14150,0,14150,66189,0,80339
141647900300000,NE 145,Residential,14400,0,14400,74355,0,88755
141647900400000,NE 145,Residential,14560,0,14560,75941,0,90501
141648000100000,NE 146,Residential,29070,0,29070,95957,0,125027
141648000200000,NE 146,Residential,16114,0,16114,62237,0,78351
141648000300000,NE 146,Residential,19800,0,19800,86276,0,106076
141648000400000,NE 146,Residential,23594,0,23594,87289,0,110883
141648000500000,NE 146,Residential,18854,0,18854,76146,0,95000
141648000600000,NE 146,Residential,19260,0,19260,79584,0,98844
141648000700000,NE 146,Residential,28649,0,28649,90317,0,118966
141648000800000,NE 146,Residential,28649,0,28649,68701,0,97350
141648000900000,NE 146,Residential,18634,0,18634,33086,0,51720
141648001000000,NE 146,Residential,28890,0,28890,84888,0,113778
141648001100000,NE 146,Residential,28890,0,28890,67138,0,96028
141648001200000,NE 146,Residential,19260,0,19260,57489,0,76749
141648001300000,NE 146,Residential,18441,0,18441,75349,0,93790
141648001400000,NE 146,Residential,18779,0,18779,54683,0,73462
141648001500000,NE 146,Residential,18779,0,18779,75341,0,94120
141648001600000,NE 146,Residential,19260,0,19260,62251,0,81511
141648001700000,NE 146,Residential,28577,0,28577,85709,0,114286
141648001800000,NE 146,Residential,28577,0,28577,87238,0,115815
141648001900000,NE 146,Residential,18128,0,18128,57085,0,75213
141648002000000,NE 146,Residential,19440,0,19440,73940,0,93380
141648002100000,NE 146,Residential,19440,0,19440,94794,0,114234
141648002200000,NE 146,Residential,22627,0,22627,84885,0,107512
141648002300000,NE 146,Residential,21440,0,21440,43560,0,65000
141648002400000,NE 146,Residential,21600,0,21600,68429,0,90029
141648002500000,NE 146,Residential,21480,0,21480,57275,0,78755
141648002600000,NE 146,Residential,16000,0,16000,79391,0,95391
141648002700000,NE 146,Residential,16000,0,16000,76657,0,92657
141648002800000,NE 146,Residential,24000,0,24000,80728,0,104728
141648002900000,NE 146,Residential,17280,0,17280,63552,0,80832
141648003000000,NE 146,Residential,17280,0,17280,78532,0,95812
141648003100000,NE 146,Residential,16114,0,16114,89218,0,105332
141648003200000,NE 146,Residential,25402,0,25402,78248,0,103650
141648003300000,NE 146,Residential,25402,0,25402,60112,0,85514
141648003400000,CONVERSION,Commercial,0,16918,16918,0,97357,114275
141648003500000,NE 146,Residential,25252,0,25252,46467,0,71719
141648003600000,NE 146,Residential,16392,0,16392,97141,0,113533
141648003700000,NE 146,Residential,17120,0,17120,72438,0,89558
141648003800000,NE 146,Residential,17120,0,17120,49440,0,66560
141648003900000,NE 146,Residential,16136,0,16136,77262,0,93398
141648004000000,NE 146,Residential,17120,0,17120,35257,0,52377
141648004100000,NE 146,Residential,17120,0,17120,61433,0,78553
141648004200000,NE 146,Residential,17120,0,17120,73484,0,90604
141648004300000,NE 146,Residential,17120,0,17120,67700,0,84820
141648004400000,NE 146,Residential,17120,0,17120,67941,0,85061
141648004500000,NE 146,Residential,21400,0,21400,91617,0,113017
141648004600000,NE 146,Residential,18960,0,18960,71913,0,90873
141648100100000,NE 146,Residential,26420,0,26420,82462,0,108882
141648100200000,NE 146,Residential,11340,0,11340,60984,0,72324
141648100300000,NE 146,Residential,12480,0,12480,65452,0,77932
141648100400000,NE 146,Residential,16160,0,16160,63041,0,79201
141648100500000,NE 146,Residential,16160,0,16160,44497,0,60657
141648100600000,NE 146,Residential,16160,0,16160,71532,0,87692
141648100700000,NE 146,Residential,16160,0,16160,59097,0,75257
141648100800000,NE 146,Residential,15831,0,15831,79298,0,95129
141648100900000,NE 146,Residential,16160,0,16160,94729,0,110889
141648101000000,NE 146,Residential,16160,0,16160,59515,0,75675
141648101100000,NE 146,Residential,27149,0,27149,50750,0,77899
141648101200000,NE 146,Residential,15756,0,15756,54565,0,70321
141648101300000,NE 146,Residential,16160,0,16160,49827,0,65987
141648101400000,NE 146,Residential,16160,0,16160,68380,0,84540
141648101500000,NE 146,Residential,24240,0,24240,64644,0,88884
141648101600000,NE 146,Residential,23836,0,23836,80700,0,104536
141648101700000,NE 146,Residential,23755,0,23755,91664,0,115419
141648101800000,NE 146,Residential,23755,0,23755,95226,0,118981
141648101900000,NE 146,Residential,15594,0,15594,70229,0,85823
141648102000000,FLAT PARKING,Commercial,0,53610,53610,0,3139,56749
141648102100000,NE 146,Residential,21600,0,21600,39600,0,61200
141648102200000,NE 146,Residential,21600,0,21600,49776,0,71376
141648102300000,NE 146,Residential,21600,0,21600,91862,0,113462
141648102400000,NE 146,Residential,20400,0,20400,62064,0,82464
141648102500000,NE 146,Residential,27425,0,27425,47245,0,74670
141648102600000,NE 146,Residential,13712,0,13712,59725,0,73437
141648102700000,NE 146,Residential,13712,0,13712,70292,0,84004
141648102800000,NE 146,Residential,27518,0,27518,76482,0,104000
141648102900000,NE 146,Residential,27518,0,27518,76297,0,103815
141648103000000,NE 146,Residential,27612,0,27612,72020,0,99632
141648103100000,NE 146,Residential,27612,0,27612,122498,0,150110
141648103200000,NE 146,Residential,17784,0,17784,55622,0,73406
141648103300000,NE 146,Residential,18720,0,18720,50356,0,69076
141648103400000,NE 146,Residential,18720,0,18720,62502,0,81222
141648103500000,NE 146,Residential,28080,0,28080,93826,0,121906
141648103600000,NE 146,Residential,27810,0,27810,61197,0,89007
141648103700000,NE 146,Residential,27810,0,27810,69512,0,97322
141648103800000,NE 146,Residential,27810,0,27810,94136,0,121946
141648103900000,NE 146,Residential,27810,0,27810,55947,0,83757
141648104000000,NE 146,Residential,27810,0,27810,73698,0,101508
141648200100000,NE 146,Residential,29120,0,29120,82405,0,111525
141648200200000,NE 146,Residential,25568,0,25568,2160,0,27728
141648200300000,NE 146,Residential,25500,0,25500,98713,0,124213
141648200400000,NE 146,Residential,24000,0,24000,87225,0,111225
141648200500000,WAREHOUSE,Commercial,0,13025,13025,0,62542,75567
141648200600000,NE 146,Residential,23520,0,23520,0,0,23520
141648200700000,NE 146,Residential,18099,0,18099,54573,0,72672
141648200800000,NE 146,Residential,16975,0,16975,53439,0,70414
141648200900000,AUTO REPAIR/SALES,Commercial,0,32264,32264,0,31023,63287
141710100200000,NE 135,Residential,67950,0,67950,869263,0,937213
141710100300000,NE 135,Residential,43120,0,43120,184501,0,227621
141710100400000,NE 135,Residential,40375,0,40375,235603,0,275978
141710100500000,NE 135,Residential,35696,0,35696,0,0,35696
141710100600000,NE 149,Residential,37350,0,37350,0,0,37350
141710100700000,NE 149,Residential,20,0,20,0,0,20
141710101400000,NE 149,Residential,20,0,20,0,0,20
141710200300000,FEDERAL PROPERTY,Exempt,0,0,0,0,0,0
141712600100000,NE 135,Residential,41275,0,41275,0,0,41275
141712600200000,NE 149,Residential,39957,0,39957,0,0,39957
141712600300000,NE 149,Residential,40766,0,40766,196416,0,237182
141712600400000,NE 149,Residential,41472,0,41472,196841,0,238313
141712600500000,NE 149,Residential,43372,0,43372,169619,0,212991
141712600600000,NE 149,Residential,38480,0,38480,251338,0,289818
141712600700000,NE 149,Residential,63270,0,63270,0,0,63270
141712600900000,NE 149,Residential,40759,0,40759,273129,0,313888
141712601100000,NE 149,Residential,35853,0,35853,284590,0,320443
141712601200000,NE 149,Residential,49184,0,49184,218847,0,268031
141712601300000,NE 149,Residential,8150,0,8150,0,0,8150
141712601400000,NE 149,Residential,487,0,487,0,0,487
141712601500000,NE 149,Residential,8287,0,8287,0,0,8287
141712601600000,NE 135,Residential,36300,0,36300,277728,0,314028
141712700100000,NE 149,Residential,73920,0,73920,361170,0,435090
141712700200000,NE 149,Residential,74970,0,74970,349005,0,423975
141712700300000,NE 149,Residential,73949,0,73949,241051,0,315000
141712700400000,NE 149,Residential,70560,0,70560,281928,0,352488
141712700500000,NE 149,Residential,63756,0,63756,320952,0,384708
141712700600000,NE 149,Residential,46453,0,46453,218801,0,265254
141712700700000,NE 149,Residential,46283,0,46283,202126,0,248409
141712700800000,NE 149,Residential,46283,0,46283,217922,0,264205
141712700900000,NE 149,Residential,46750,0,46750,237899,0,284649
141712701000000,NE 149,Residential,52773,0,52773,230657,0,283430
141712701100000,NE 149,Residential,43956,0,43956,242398,0,286354
141712701200000,NE 149,Residential,61180,0,61180,271377,0,332557
141712701300000,NE 149,Residential,37502,0,37502,0,0,37502
141712701400000,NE 149,Residential,47333,0,47333,157255,0,204588
141712701500000,NE 149,Residential,90319,0,90319,181640,0,271959
141712701700000,NE 149,Residential,72765,0,72765,249859,0,322624
141712701800000,NE 149,Residential,72803,0,72803,208205,0,281008
141712701900000,NE 149,Residential,144621,0,144621,705379,0,850000
141712702000000,NE 149,Residential,58598,0,58598,472056,0,530654
141712702100000,NE 149,Residential,79352,0,79352,217149,0,296501
141712702200000,NE 149,Residential,6260,0,6260,0,0,6260
141712702300000,NE 149,Residential,100300,0,100300,347578,0,447878
141712702400000,NE 149,Residential,10870,0,10870,0,0,10870
141712702500000,NE 149,Residential,75290,0,75290,212119,0,287409
141712702600000,NE 149,Residential,76261,0,76261,301394,0,377655
141712702800000,NE 149,Residential,50456,0,50456,0,0,50456
141712702900000,NE 149,Residential,69557,0,69557,202253,0,271810
141712703000000,NE 149,Residential,70331,0,70331,185027,0,255358
141712703100000,NE 149,Residential,39031,0,39031,234543,0,273574
141712703200000,NE 149,Residential,60515,0,60515,216689,0,277204
141712703300000,NE 149,Residential,43218,0,43218,252949,0,296167
141712703400000,NE 149,Residential,71176,0,71176,262349,0,333525
141712703500000,NE 149,Residential,69889,0,69889,233173,0,303062
141712703600000,NE 149,Residential,46750,0,46750,170565,0,217315
141712703700000,NE 149,Residential,41710,0,41710,197242,0,238952
141712703800000,NE 149,Residential,37632,0,37632,222069,0,259701
141712703900000,NE 149,Residential,36279,0,36279,180059,0,216338
141712704000000,NE 149,Residential,15881,0,15881,0,0,15881
141712800100000,NE 149,Residential,49555,0,49555,213615,0,263170
141712800200000,NE 149,Residential,49516,0,49516,196499,0,246015
141712800300000,NE 149,Residential,73901,0,73901,329147,0,403048
141712800400000,NE 149,Residential,74881,0,74881,316688,0,391569
141712800500000,NE 149,Residential,77162,0,77162,321060,0,398222
141715100100000,NE 149,Residential,4200,0,4200,0,0,4200
141715200100000,NE 149,Residential,58557,0,58557,0,0,58557
141715200200000,NE 149,Residential,78477,0,78477,194242,0,272719
141715300100000,CITY PROPERTY,Exempt,0,0,0,0,0,0
141717600300000,NE 149,Residential,13537,0,13537,0,0,13537
141717700100000,WAREHOUSE,Commercial,0,269879,269879,0,186865,456744
141717700200000,FLAT PARKING,Commercial,0,8910,8910,0,9600,18510
141717700300000,WAREHOUSE,Commercial,0,79056,79056,0,364222,443278
141717700400000,WAREHOUSE,Commercial,0,41614,41614,0,51235,92849
141717800100000,FLAT PARKING,Commercial,0,2873,2873,0,0,2873
141717800200000,CITY PROPERTY,Exempt,0,0,0,0,0,0
141720100200000,NE 149,Residential,79934,0,79934,347331,0,427265
141720100300000,NE 149,Residential,69958,0,69958,343345,0,413303
141720100400000,NE 149,Residential,76425,0,76425,323465,0,399890
141720100600000,NE 149,Residential,118050,0,118050,456458,0,574508
141720100700000,NE 149,Residential,78481,0,78481,273454,0,351935
141720100900000,NE 167,Residential,35000,0,35000,0,0,35000
141720101000000,NE 167,Residential,37000,0,37000,256446,0,293446
141720101100000,NE 167,Residential,91550,0,91550,318998,0,410548
141720200100000,NE 149,Residential,38000,0,38000,0,0,38000
141720200600000,NE 167,Residential,74060,0,74060,0,0,74060
141720200700000,NE 167,Residential,70056,0,70056,0,0,70056
141720300100000,CITY PROPERTY,Exempt,0,0,0,0,0,0
141720300200000,CITY PROPERTY,Exempt,0,0,0,0,0,0
141722600100000,CITY PROPERTY,Exempt,0,0,0,0,0,0
141725100100000,NW 301,Residential,18387,0,18387,48963,0,67350
141725100200000,NW 301,Residential,21215,0,21215,62416,0,83631
141725100300000,NW 301,Residential,33320,0,33320,0,0,33320
141725100400000,CITY PROPERTY,Exempt,0,0,0,0,0,0
141725100500000,CITY PROPERTY,Exempt,0,0,0,0,0,0
141725100600000,NW 301,Residential,24804,0,24804,39312,0,64116
141725100700000,NW 301,Residential,20670,0,20670,48071,0,68741
141725100800000,NW 301,Residential,27904,0,27904,131922,0,159826
141725100900000,NW 301,Residential,27030,0,27030,96352,0,123382
141725101000000,NW 301,Residential,31164,0,31164,98622,0,129786
141725101100000,NW 301,Residential,25200,0,25200,130841,0,156041
141725101200000,CITY PROPERTY,Exempt,0,0,0,0,0,0
141725200100000,CITY PROPERTY,Exempt,0,0,0,0,0,0
141725200200000,CITY PROPERTY,Exempt,0,0,0,0,0,0
141725200300000,NW 303,Residential,18075,0,18075,179136,0,197211
141725200400000,NW 303,Residential,14996,0,14996,205409,0,220405
141725200500000,NW 303,Residential,15016,0,15016,205197,0,220213
141725200600000,NW 303,Residential,16988,0,16988,205714,0,222702
141725200700000,NW 303,Residential,17200,0,17200,204124,0,221324
141725200800000,NW 303,Residential,14900,0,14900,202716,0,217616
141725200900000,NW 303,Residential,15000,0,15000,199756,0,214756
141725201000000,NW 303,Residential,15000,0,15000,207882,0,222882
141725201100000,NW 303,Residential,15000,0,15000,204839,0,219839
141725201200000,NW 303,Residential,15372,0,15372,203650,0,219022
141725201300000,NW 303,Residential,31496,0,31496,221913,0,253409
141725201400000,NW 303,Residential,15123,0,15123,197714,0,212837
141725201500000,NW 303,Residential,21493,0,21493,189211,0,210704
141725201600000,NW 303,Residential,13851,0,13851,203415,0,217266
141725201700000,NW 303,Residential,17136,0,17136,204686,0,221822
141725201800000,NW 303,Residential,16560,0,16560,178129,0,194689
141725201900000,NW 303,Residential,24400,0,24400,198232,0,222632
141725202000000,NW 303,Residential,27208,0,27208,220699,0,247907
141725202100000,NW 303,Residential,15120,0,15120,182707,0,197827
141725202200000,NW 303,Residential,15120,0,15120,178972,0,194092
141725202300000,NW 303,Residential,15120,0,15120,201052,0,216172
141725202400000,NW 303,Residential,33624,0,33624,241389,0,275013
141725202500000,NW 303,Residential,43241,0,43241,230759,0,274000
141725202600000,NW 303,Residential,18364,0,18364,194713,0,213077
141725202700000,NW 301,Residential,38619,0,38619,146003,0,184622
141725202800000,NW 301,Residential,30164,0,30164,2046,0,32210
141725202900000,NW 301,Residential,22923,0,22923,0,0,22923
141725203000000,NW 301,Residential,4096,0,4096,0,0,4096
141725203100000,NW 301,Residential,32770,0,32770,0,0,32770
141725203200000,NW 301,Residential,29520,0,29520,55490,0,85010
141725203300000,NW 301,Residential,38376,0,38376,94569,0,132945
141725203400000,NW 301,Residential,29520,0,29520,81328,0,110848
141725203500000,NW 301,Residential,29520,0,29520,78365,0,107885
141725203600000,NW 301,Residential,29520,0,29520,64372,0,93892
141725203700000,NW 301,Residential,19449,0,19449,58551,0,78000
141725203800000,NW 301,Residential,17534,0,17534,0,0,17534
141725203900000,NW 301,Residential,31200,0,31200,95091,0,126291
141725204000000,NW 301,Residential,31200,0,31200,62970,0,94170
141725204100000,NW 301,Residential,27000,0,27000,86476,0,113476
141725204200000,NW 301,Residential,27000,0,27000,72477,0,99477
141725204300000,NW 301,Residential,18000,0,18000,55071,0,73071
141725204400000,NW 301,Residential,25500,0,25500,56043,0,81543
141725204500000,NW 301,Residential,31512,0,31512,80184,0,111696
141727600200000,CITY PROPERTY,Exempt,0,0,0,0,0,0
141730100100000,CITY PROPERTY,Exempt,0,0,0,0,0,0
141732600100000,CITY PROPERTY,Exempt,0,0,0,0,0,0
141735100100000,NW 307,Residential,42420,0,42420,177419,0,219839
141735100200000,NW 307,Residential,38400,0,38400,171654,0,210054
141735100300000,NW 307,Residential,38880,0,38880,168059,0,206939
141735100400000,NW 307,Residential,42000,0,42000,178053,0,220053
141735100500000,NW 307,Residential,42000,0,42000,148072,0,190072
141735100600000,NW 307,Residential,42082,0,42082,149304,0,191386
141735100700000,NW 307,Residential,42900,0,42900,178408,0,221308
141735100800000,NW 307,Residential,38720,0,38720,176665,0,215385
141735100900000,NW 307,Residential,37074,0,37074,213888,0,250962
141735101000000,NW 307,Residential,43000,0,43000,210019,0,253019
141735101100000,NW 307,Residential,42853,0,42853,184014,0,226867
141735101200000,NW 307,Residential,43860,0,43860,148597,0,192457
141735101300000,NW 307,Residential,33487,0,33487,162094,0,195581
141735101400000,NW 307,Residential,42000,0,42000,175426,0,217426
141735101500000,NW 307,Residential,44400,0,44400,172975,0,217375
141735101600000,NW 307,Residential,43700,0,43700,151606,0,195306
141735101700000,NW 307,Residential,37762,0,37762,182841,0,220603
141735101800000,NW 307,Residential,33253,0,33253,131219,0,164472
141735101900000,NW 307,Residential,33135,0,33135,178861,0,211996
141735102000000,NW 307,Residential,33018,0,33018,113704,0,146722
141735102100000,NW 307,Residential,33250,0,33250,127267,0,160517
141735102200000,NW 307,Residential,33250,0,33250,315,0,33565
141735102300000,NW 307,Residential,35091,0,35091,158607,0,193698
141735102400000,NW 307,Residential,33705,0,33705,160170,0,193875
141735102500000,NW 307,Residential,33063,0,33063,141961,0,175024
141735102600000,NW 307,Residential,39174,0,39174,155222,0,194396
141735102700000,NW 307,Residential,40495,0,40495,215860,0,256355
141735102800000,NW 307,Residential,35019,0,35019,124221,0,159240
141735102900000,NW 307,Residential,35280,0,35280,131031,0,166311
141735103000000,NW 307,Residential,33600,0,33600,142258,0,175858
141735103100000,NW 307,Residential,36000,0,36000,141203,0,177203
141735103200000,NW 307,Residential,35280,0,35280,123600,0,158880
141735200100000,NW 307,Residential,35496,0,35496,192509,0,228005
141735200200000,NW 307,Residential,33182,0,33182,128284,0,161466
141735200300000,NW 307,Residential,33609,0,33609,152391,0,186000
141735200400000,NW 307,Residential,33182,0,33182,145113,0,178295
141735200500000,NW 307,Residential,33182,0,33182,175247,0,208429
141735200600000,NW 307,Residential,35250,0,35250,152178,0,187428
141735200700000,NW 307,Residential,36000,0,36000,151538,0,187538
141735200800000,NW 307,Residential,34790,0,34790,174315,0,209105
141735200900000,NW 307,Residential,39608,0,39608,160951,0,200559
141735201000000,NW 307,Residential,38833,0,38833,160784,0,199617
141735201100000,NW 307,Residential,42840,0,42840,176080,0,218920
141735201200000,NW 307,Residential,43690,0,43690,165662,0,209352
141735201300000,NW 307,Residential,40899,0,40899,171112,0,212011
141735201400000,NW 307,Residential,36000,0,36000,151977,0,187977
141735201500000,NW 307,Residential,33701,0,33701,140760,0,174461
141735201600000,NW 307,Residential,36456,0,36456,134007,0,170463
141735201700000,NW 307,Residential,39675,0,39675,165752,0,205427
141735201800000,NW 307,Residential,38640,0,38640,158159,0,196799
141735201900000,NW 307,Residential,37605,0,37605,199117,0,236722
141735202000000,NW 307,Residential,40519,0,40519,158614,0,199133
141735202100000,NW 307,Residential,39958,0,39958,141780,0,181738
141735202200000,NW 307,Residential,35250,0,35250,119605,0,154855
141735202300000,NW 307,Residential,33182,0,33182,125883,0,159065
141735202400000,NW 307,Residential,33182,0,33182,125323,0,158505
141735202500000,NW 307,Residential,33182,0,33182,129852,0,163034
141735202600000,NW 307,Residential,33182,0,33182,121417,0,154599
141735202700000,NW 307,Residential,35496,0,35496,122405,0,157901
141735300100000,NW 307,Residential,35203,0,35203,117207,0,152410
141735300200000,NW 307,Residential,34560,0,34560,132845,0,167405
141735300300000,NW 307,Residential,34560,0,34560,127787,0,162347
141735300400000,NW 307,Residential,35520,0,35520,146035,0,181555
141735300500000,NW 307,Residential,33600,0,33600,134594,0,168194
141735300600000,NW 307,Residential,34560,0,34560,150938,0,185498
141735300700000,NW 307,Residential,34560,0,34560,166200,0,200760
141735300800000,NW 307,Residential,34560,0,34560,163861,0,198421
141735300900000,NW 307,Residential,34560,0,34560,172955,0,207515
141735301000000,NW 307,Residential,34560,0,34560,170839,0,205399
141735301100000,NW 307,Residential,34610,0,34610,142780,0,177390
141740200200000,CITY PROPERTY,Exempt,0,0,0,0,0,0
141745100100000,NW 310,Residential,28203,0,28203,27278,0,55481
141745100200000,NW 310,Residential,29070,0,29070,34568,0,63638
141745100300000,CITY PROPERTY,Exempt,0,0,0,0,0,0
141745100400000,NW 310,Residential,25970,0,25970,0,0,25970
141745100500000,CITY PROPERTY,Exempt,0,0,0,0,0,0
141745100600000,NW 310,Residential,40800,0,40800,0,0,40800
141745100700000,NW 310,Residential,24428,0,24428,66542,0,90970
141745100800000,NW 310,Residential,35575,0,35575,0,0,35575
141745100900000,NW 310,Residential,29808,0,29808,47880,0,77688
141745101000000,NW 310,Residential,48400,0,48400,76966,0,125366
141745101100000,NW 310,Residential,29040,0,29040,38719,0,67759
141745101200000,NW 310,Residential,28314,0,28314,51730,0,80044
141745101300000,NW 310,Residential,36300,0,36300,46206,0,82506
141745101400000,NW 310,Residential,51750,0,51750,36723,0,88473
141745101500000,NW 310,Residential,13996,0,13996,39501,0,53497
141745200100000,CITY PROPERTY,Exempt,0,0,0,0,0,0
141745200200000,CITY PROPERTY,Exempt,0,0,0,0,0,0
141745200300000,NW 310,Residential,12420,0,12420,45521,0,57941
141745200400000,CITY PROPERTY,Exempt,0,0,0,0,0,0
141745200700000,CITY PROPERTY,Exempt,0,0,0,0,0,0
141745200800000,CITY PROPERTY,Exempt,0,0,0,0,0,0
141745200900000,CITY PROPERTY,Exempt,0,0,0,0,0,0
141745201000000,CITY PROPERTY,Exempt,0,0,0,0,0,0
141745201100000,CITY PROPERTY,Exempt,0,0,0,0,0,0
141745201200000,CITY PROPERTY,Exempt,0,0,0,0,0,0
141745201300000,NW 310,Residential,13828,0,13828,36096,0,49924
141745201400000,CITY PROPERTY,Exempt,0,0,0,0,0,0
141745201500000,CITY PROPERTY,Exempt,0,0,0,0,0,0
141745201700000,NW 310,Residential,22583,0,22583,0,0,22583
141745201800000,NW 310,Ag Land,664,0,664,0,53746,54410
141745201900000,NW 310,Residential,15551,0,15551,41248,0,56799
141745202000000,NW 310,Residential,12862,0,12862,44652,0,57514
141745202100000,CITY PROPERTY,Exempt,0,0,0,0,0,0
141745202200000,NW 310,Residential,9312,0,9312,49363,0,58675
141745202300000,CITY PROPERTY,Exempt,0,0,0,0,0,0
141745202400000,CITY PROPERTY,Exempt,0,0,0,0,0,0
141745202500000,NW 310,Residential,5000,0,5000,0,0,5000
141745202600000,NW 310,Residential,10309,0,10309,36580,0,46889
141745202700000,NW 310,Residential,10089,0,10089,29792,0,39881
141745202800000,NW 310,Ag Land,174,0,174,0,0,174
141745300100000,CITY PROPERTY,Exempt,0,0,0,0,0,0
141745300200000,CITY PROPERTY,Exempt,0,0,0,0,0,0
141745300300000,NW 310,Residential,21000,0,21000,70784,0,91784
141745300400000,NW 310,Residential,18915,0,18915,77379,0,96294
141745300500000,CITY PROPERTY,Exempt,0,0,0,0,0,0
141745300600000,CITY PROPERTY,Exempt,0,0,0,0,0,0
141745300700000,NW 310,Residential,16125,0,16125,0,0,16125
141745300800000,CITY PROPERTY,Exempt,0,0,0,0,0,0
141745300900000,CITY PROPERTY,Exempt,0,0,0,0,0,0
141745301000000,CITY PROPERTY,Exempt,0,0,0,0,0,0
141745301100000,NW 310,Residential,16125,0,16125,0,0,16125
141745301200000,CITY PROPERTY,Exempt,0,0,0,0,0,0
141745301300000,CITY PROPERTY,Exempt,0,0,0,0,0,0
141745301400000,NW 310,Residential,16125,0,16125,0,0,16125
141745301500000,CITY PROPERTY,Exempt,0,0,0,0,0,0
141745301600000,CITY PROPERTY,Exempt,0,0,0,0,0,0
141745301700000,NW 310,Residential,15000,0,15000,0,0,15000
141747600100000,CITY PROPERTY,Exempt,0,0,0,0,0,0
141747600200000,CITY PROPERTY,Exempt,0,0,0,0,0,0
141747600300000,NW 310,Residential,31590,0,31590,43397,0,74987
141747600400000,CITY PROPERTY,Exempt,0,0,0,0,0,0
141747600500000,CITY PROPERTY,Exempt,0,0,0,0,0,0
141747600600000,NW 310,Residential,54404,0,54404,73684,0,128088
141810100100000,CITY PROPERTY,Exempt,0,0,0,0,0,0
141810100200000,APARTMENT,Commercial,0,428112,428112,0,3715337,4143449
141810300100000,APARTMENT,Commercial,0,286200,286200,0,3369734,3655934
141812600100000,APARTMENT,Commercial,0,40905,40905,0,322901,363806
141812600200000,APARTMENT,Commercial,0,407160,407160,0,3807259,4214419
141812600300000,APARTMENT,Commercial,0,348840,348840,0,3560055,3908895
141815100100000,NW 303,Residential,35280,0,35280,106105,0,141385
141815100200000,NW 303,Residential,13621,0,13621,79206,0,92827
141815100300000,NW 303,Residential,12736,0,12736,67971,0,80707
141815100400000,NW 303,Residential,13314,0,13314,73197,0,86511
141815100500000,NW 303,Residential,12582,0,12582,96770,0,109352
141815100600000,NW 303,Residential,12867,0,12867,102234,0,115101
141815100700000,NW 303,Residential,12977,0,12977,100561,0,113538
141815100800000,NW 303,Residential,12813,0,12813,100907,0,113720
141815100900000,NW 303,Residential,13031,0,13031,100576,0,113607
141815101000000,NW 303,Residential,16124,0,16124,106584,0,122708
141815101100000,NW 303,Residential,15882,0,15882,106373,0,122255
141815101200000,NW 303,Residential,13711,0,13711,117243,0,130954
141815101300000,NW 303,Residential,15863,0,15863,110007,0,125870
141815101400000,NW 303,Residential,31131,0,31131,136260,0,167391
141815101500000,NW 303,Residential,31220,0,31220,155776,0,186996
141815101600000,NW 303,Residential,14087,0,14087,138083,0,152170
141815101700000,NW 303,Residential,14193,0,14193,131204,0,145397
141815101800000,NW 303,Residential,25099,0,25099,112134,0,137233
141815101900000,NW 303,Residential,25099,0,25099,107602,0,132701
141815102000000,NW 303,Residential,25071,0,25071,61307,0,86378
141815102100000,NW 303,Residential,25099,0,25099,117831,0,142930
141815102200000,NW 303,Residential,26247,0,26247,113169,0,139416
141815102300000,NW 303,Residential,26628,0,26628,98038,0,124666
141815102400000,NW 303,Residential,24948,0,24948,121426,0,146374
141815102500000,NW 303,Residential,24948,0,24948,133867,0,158815
141815102600000,NW 303,Residential,24948,0,24948,121661,0,146609
141815102700000,NW 303,Residential,24948,0,24948,117858,0,142806
141815102800000,NW 303,Residential,24896,0,24896,131999,0,156895
141815102900000,NW 303,Residential,28597,0,28597,131764,0,160361
141815103000000,NW 303,Residential,29135,0,29135,146927,0,176062
141815103100000,NW 303,Residential,26371,0,26371,132117,0,158488
141815103200000,NW 303,Residential,27016,0,27016,129595,0,156611
141815103300000,NW 303,Residential,25778,0,25778,159552,0,185330
141815103400000,NW 303,Residential,27210,0,27210,145220,0,172430
141815103500000,NW 303,Residential,25724,0,25724,123225,0,148949
141815103600000,NW 303,Residential,27939,0,27939,67418,0,95357
141815103700000,NW 303,Residential,29106,0,29106,51469,0,80575
141815103800000,NW 303,Residential,29106,0,29106,3018,0,32124
141815103900000,NW 303,Residential,28350,0,28350,169229,0,197579
141815104000000,NW 303,Residential,26460,0,26460,170849,0,197309
141815104100000,NW 303,Residential,26460,0,26460,174689,0,201149
141815104200000,NW 303,Residential,26119,0,26119,187333,0,213452
141815104300000,NW 303,Residential,30686,0,30686,187078,0,217764
141815104400000,NW 303,Residential,21840,0,21840,13939,0,35779
141815104500000,NW 303,Residential,33843,0,33843,166528,0,200371
141815104600000,NW 303,Residential,33509,0,33509,274610,0,308119
141815104700000,NW 303,Residential,30205,0,30205,158776,0,188981
141815104800000,NW 303,Residential,26095,0,26095,192532,0,218627
141815104900000,NW 303,Residential,26460,0,26460,192434,0,218894
141815105000000,NW 303,Residential,26460,0,26460,159622,0,186082
141815105100000,NW 303,Residential,28350,0,28350,151835,0,180185
141815105200000,NW 303,Residential,63150,0,63150,84541,0,147691
141815105300000,CITY PROPERTY,Exempt,0,0,0,0,0,0
141817600100000,CITY PROPERTY,Exempt,0,0,0,0,0,0
141820100100000,ANTENNAS/TOWERS(BLL),Commercial,0,13414,13414,0,23746,37160
141820100200000,CITY PROPERTY,Exempt,0,0,0,0,0,0
141820200600000,SCHOOL,Exempt,0,0,0,0,0,0
141820300100000,NW 302,Residential,63200,0,63200,65115,0,128315
141822600100000,CITY PROPERTY,Exempt,0,0,0,0,0,0
141822600200000,NW 302,Residential,5000,0,5000,0,0,5000
141822600300000,NW 302,Residential,38899,0,38899,96597,0,135496
141822600400000,CITY PROPERTY,Exempt,0,0,0,0,0,0
141822600500000,CITY PROPERTY,Exempt,0,0,0,0,0,0
141822600700000,CITY PROPERTY,Exempt,0,0,0,0,0,0
141822700200000,NW 302,Residential,28153,0,28153,0,0,28153
141822700300000,NW 302,Residential,12712,0,12712,52974,0,65686
141822700400000,NW 302,Ag Land,2517,0,2517,0,0,2517
141822800100000,CITY PROPERTY,Exempt,0,0,0,0,0,0
141825100200000,NW 302,Ag Dwelling,18744,0,18744,46028,0,64772
141825100300000,NW 302,Residential,64087,0,64087,26580,0,90667
141827600100000,NW 302,Residential,42728,0,42728,103117,0,145845
141827600200000,NW 302,Residential,27846,0,27846,133605,0,161451
141827600500000,CHURCH,Exempt,0,228000,228000,0,751017,979017
141827600600000,CHURCH,Exempt,0,508248,508248,0,6716,514964
141827700300000,CHURCH,Exempt,0,479866,479866,0,456098,935964
141830100100000,NW 308,Residential,16913,0,16913,105686,0,122599
141830100200000,NW 308,Residential,17820,0,17820,122304,0,140124
141830100300000,NW 308,Residential,17531,0,17531,133328,0,150859
141830100400000,NW 302,Residential,60650,0,60650,60865,0,121515
141830100500000,NW 308,Residential,17093,0,17093,105368,0,122461
141830100600000,NW 308,Residential,17820,0,17820,135413,0,153233
141830100700000,NW 308,Residential,19883,0,19883,118634,0,138517
141830100800000,NW 308,Residential,22035,0,22035,110139,0,132174
141830200100000,APARTMENT,Residential,304668,0,304668,2968558,0,3273226
141830200200000,VACANT LAND,Commercial,0,40856,40856,0,0,40856
141830200300000,NW 302,Residential,55000,0,55000,0,0,55000
141830300100000,NW 308,Residential,22685,0,22685,118962,0,141647
141830300200000,NW 308,Residential,21153,0,21153,108251,0,129404
141832600100000,NW 302,Ag Land,18010,0,18010,0,0,18010
141832600200000,NW 302,Residential,62500,0,62500,0,0,62500
141835100100000,NW 302,Residential,62500,0,62500,0,0,62500
141835100400000,NW 302,Residential,30900,0,30900,78571,0,109471
141835100500000,NW 302,Residential,88000,0,88000,0,0,88000
141835100600000,NW 302,Residential,112500,0,112500,54520,0,167020
141835200100000,NW 308,Residential,72000,0,72000,0,0,72000
141835200200000,NW 308,Residential,65250,0,65250,177524,0,242774
141837600200000,NW 336,Residential,30080,0,30080,227378,0,257458
141837600300000,NW 336,Residential,34881,0,34881,252688,0,287569
141837600400000,NW 336,Residential,40950,0,40950,181606,0,222556
141837600500000,NW 336,Residential,36996,0,36996,193640,0,230636
141837600600000,NW 336,Residential,39353,0,39353,224885,0,264238
141837600700000,NW 336,Residential,42000,0,42000,258140,0,300140
141837600800000,NW 336,Residential,43600,0,43600,214354,0,257954
141837600900000,NW 336,Residential,41600,0,41600,254007,0,295607
141837601000000,NW 336,Residential,43661,0,43661,239853,0,283514
141837601100000,NW 336,Residential,41853,0,41853,200823,0,242676
141837601200000,NW 336,Residential,40511,0,40511,195804,0,236315
141837601300000,NW 336,Residential,40614,0,40614,204422,0,245036
141837601400000,NW 308,Residential,27560,0,27560,41108,0,68668
141837601500000,NW 308,Residential,24681,0,24681,39869,0,64550
141837601600000,NW 308,Residential,2361,0,2361,0,0,2361
141837601700000,NW 308,Residential,25373,0,25373,63553,0,88926
141837601800000,NW 308,Residential,26640,0,26640,64182,0,90822
141837601900000,NW 308,Residential,23450,0,23450,0,0,23450
141837602000000,NW 308,Residential,25620,0,25620,66667,0,92287
141837602100000,NW 308,Residential,24240,0,24240,110246,0,134486
141837700100000,NW 336,Residential,39672,0,39672,195741,0,235413
141837700200000,NW 336,Residential,35774,0,35774,194595,0,230369
141837700300000,NW 336,Residential,52257,0,52257,235627,0,287884
141837700600000,NW 336,Residential,31838,0,31838,196224,0,228062
141837700700000,NW 336,Residential,38056,0,38056,235337,0,273393
141837700800000,NW 336,Residential,37760,0,37760,180282,0,218042
141837700900000,NW 336,Residential,35520,0,35520,267726,0,303246
141837701000000,NW 336,Residential,36469,0,36469,180466,0,216935
141837701100000,NW 336,Residential,38347,0,38347,216653,0,255000
141837701200000,NW 308,Residential,25232,0,25232,66835,0,92067
141837701300000,NW 308,Residential,2697,0,2697,0,0,2697
141837701400000,NW 308,Residential,2323,0,2323,0,0,2323
141837701500000,NW 308,Residential,2047,0,2047,0,0,2047
141837701600000,NW 308,Residential,1969,0,1969,0,0,1969
141837701700000,NW 308,Residential,2154,0,2154,0,0,2154
141837701800000,NW 308,Residential,29120,0,29120,111627,0,140747
141837800100000,NW 302,Residential,50850,0,50850,0,0,50850
141837900100000,NW 336,Residential,44182,0,44182,281684,0,325866
141837900200000,NW 336,Residential,42457,0,42457,251753,0,294210
141837900300000,NW 336,Residential,47092,0,47092,254052,0,301144
141837900400000,NW 336,Residential,44502,0,44502,0,0,44502
141837900500000,NW 336,Residential,42000,0,42000,216590,0,258590
141837900600000,NW 336,Residential,40400,0,40400,237216,0,277616
141837900700000,NW 336,Residential,38400,0,38400,224692,0,263092
141837900800000,NW 336,Residential,35374,0,35374,216831,0,252205
141837900900000,NW 336,Residential,34651,0,34651,180040,0,214691
141837901000000,NW 336,Residential,33728,0,33728,158843,0,192571
141837901100000,NW 308,Residential,28080,0,28080,131743,0,159823
141837901200000,NW 308,Residential,29600,0,29600,121683,0,151283
141837901300000,NW 308,Residential,31169,0,31169,127263,0,158432
141837901400000,NW 308,Residential,31435,0,31435,120858,0,152293
141837901500000,NW 308,Residential,31435,0,31435,134687,0,166122
141837901600000,NW 308,Residential,31702,0,31702,142850,0,174552
141837901700000,NW 308,Residential,32396,0,32396,138448,0,170844
141837901800000,NW 308,Residential,34432,0,34432,145093,0,179525
141837901900000,NW 308,Residential,31181,0,31181,134367,0,165548
141837902000000,NW 308,Residential,33012,0,33012,115567,0,148579
141838000100000,NW 336,Residential,31590,0,31590,171952,0,203542
141838000200000,NW 336,Residential,36987,0,36987,243146,0,280133
141838000300000,NW 336,Residential,36160,0,36160,226441,0,262601
141838000400000,NW 336,Residential,35840,0,35840,261163,0,297003
141838000500000,NW 336,Residential,35200,0,35200,240467,0,275667
141838000600000,NW 336,Residential,34240,0,34240,215060,0,249300
141838000700000,NW 308,Residential,31528,0,31528,125874,0,157402
141838000800000,NW 308,Residential,31386,0,31386,120170,0,151556
141838000900000,NW 308,Residential,34175,0,34175,111825,0,146000
141838001000000,NW 308,Residential,31793,0,31793,114858,0,146651
141838001100000,NW 308,Residential,27930,0,27930,116913,0,144843
141838001200000,NW 308,Residential,27930,0,27930,115376,0,143306
141838001300000,NW 308,Residential,27664,0,27664,119224,0,146888
141838001400000,NW 308,Residential,27664,0,27664,137851,0,165515
141838100100000,NW 308,Residential,28310,0,28310,122569,0,150879
141838100200000,NW 308,Residential,27720,0,27720,117701,0,145421
141838100300000,NW 308,Residential,28642,0,28642,147444,0,176086
141838100400000,NW 308,Residential,27751,0,27751,134153,0,161904
141838100500000,NW 308,Residential,26836,0,26836,143230,0,170066
141838100600000,NW 308,Residential,27424,0,27424,133902,0,161326
141838100700000,NW 308,Residential,27941,0,27941,129387,0,157328
141838100800000,NW 308,Residential,26928,0,26928,142979,0,169907
141840100200000,NW 302,Residential,38145,0,38145,62409,0,100554
141840100500000,NW 307,Residential,37972,0,37972,119897,0,157869
141840100600000,NW 307,Residential,37500,0,37500,137725,0,175225
141840100700000,NW 307,Residential,37500,0,37500,129454,0,166954
141840100800000,NW 307,Residential,37500,0,37500,113321,0,150821
141840100900000,NW 307,Residential,30,0,30,0,0,30
141840101000000,NW 307,Residential,44362,0,44362,136548,0,180910
141840101100000,NW 307,Residential,52306,0,52306,210014,0,262320
141840101200000,NW 307,Residential,56169,0,56169,174782,0,230951
141840101300000,NW 307,Residential,49135,0,49135,167737,0,216872
141840101400000,NW 307,Residential,44921,0,44921,187590,0,232511
141840101500000,NW 307,Residential,45949,0,45949,147972,0,193921
141840101600000,NW 307,Residential,44780,0,44780,191506,0,236286
141840101700000,CITY PROPERTY,Exempt,0,0,0,0,0,0
141840102100000,CITY PROPERTY,Exempt,0,0,0,0,0,0
141840102200000,NW 302,Residential,42542,0,42542,151650,0,194192
141840102300000,NW 302,Residential,42542,0,42542,142726,0,185268
141840102400000,NW 302,Residential,103520,0,103520,174970,0,278490
141840102500000,NW 302,Residential,54900,0,54900,114097,0,168997
141840102600000,NW 302,Residential,136572,0,136572,146942,0,283514
141840200100000,NW 302,Residential,25658,0,25658,141039,0,166697
141840200200000,NW 302,Residential,66500,0,66500,138346,0,204846
141840200300000,NW 302,Residential,40055,0,40055,87011,0,127066
141840200400000,NW 302,Residential,40700,0,40700,8770,0,49470
141840200500000,NW 302,Residential,33467,0,33467,24359,0,57826
141840200600000,NW 302,Residential,87900,0,87900,0,0,87900
141840200700000,NW 302,Residential,64700,0,64700,164041,0,228741
141840200800000,NW 302,Residential,22275,0,22275,58867,0,81142
141840200900000,NW 302,Residential,22846,0,22846,93434,0,116280
141840201000000,NW 302,Residential,24481,0,24481,111461,0,135942
141840201100000,NW 302,Residential,24480,0,24480,112861,0,137341
141840201200000,NW 302,Residential,26010,0,26010,94227,0,120237
141840300100000,NW 307,Residential,46200,0,46200,163458,0,209658
141840300200000,NW 307,Residential,42435,0,42435,162309,0,204744
141840300300000,NW 307,Residential,41073,0,41073,151121,0,192194
141840300400000,NW 307,Residential,41600,0,41600,173549,0,215149
141840300500000,NW 307,Residential,43926,0,43926,159261,0,203187
141840300600000,NW 307,Residential,43926,0,43926,164668,0,208594
141840300700000,NW 307,Residential,41597,0,41597,170438,0,212035
141840300800000,NW 307,Residential,40484,0,40484,149614,0,190098
141840400100000,NW 307,Residential,38368,0,38368,172138,0,210506
141840400200000,NW 307,Residential,37500,0,37500,149692,0,187192
141840400300000,NW 307,Residential,35250,0,35250,152020,0,187270
141840400400000,NW 307,Residential,37296,0,37296,121638,0,158934
141840400500000,NW 307,Residential,42405,0,42405,154558,0,196963
141840400600000,NW 307,Residential,42638,0,42638,191224,0,233862
141842600200000,NW 302,Residential,34560,0,34560,47460,0,82020
141842600300000,NW 302,Residential,21120,0,21120,0,0,21120
141842600400000,NW 302,Residential,71200,0,71200,39904,0,111104
141842600500000,NW 302,Residential,35174,0,35174,60604,0,95778
141842600600000,NW 302,Residential,54516,0,54516,121130,0,175646
141842600700000,NW 308,Residential,30408,0,30408,134327,0,164735
141842600800000,NW 308,Residential,30359,0,30359,142055,0,172414
141842600900000,NW 308,Residential,33395,0,33395,221168,0,254563
141842601000000,NW 308,Residential,33395,0,33395,205804,0,239199
141842601100000,NW 308,Residential,33275,0,33275,218728,0,252003
141842601200000,NW 308,Residential,48400,0,48400,265892,0,314292
141842601300000,NW 308,Residential,72350,0,72350,82391,0,154741
141842601400000,NW 352,Residential,169,0,169,0,0,169
141842601500000,NW 352,Residential,37730,0,37730,31568,0,69298
141842601600000,NW 352,Residential,37125,0,37125,31227,0,68352
141842601700000,NW 352,Residential,180,0,180,0,0,180
141842601800000,NW 352,Residential,225,0,225,0,0,225
141842601900000,NW 352,Residential,332,0,332,0,0,332
141842602000000,NW 352,Residential,250,0,250,0,0,250
141842602100000,NW 352,Residential,180,0,180,0,0,180
141842602200000,NW 352,Residential,151,0,151,0,0,151
141842602300000,NW 352,Residential,127,0,127,0,0,127
141842602400000,NW 352,Residential,127,0,127,0,0,127
141842602500000,NW 352,Residential,37500,0,37500,4455,0,41955
141842602600000,NW 352,Residential,37500,0,37500,4455,0,41955
141842602700000,NW 352,Residential,37500,0,37500,4455,0,41955
141842602800000,NW 352,Residential,128,0,128,0,0,128
141842602900000,NW 352,Residential,129,0,129,0,0,129
141842603000000,NW 352,Residential,129,0,129,0,0,129
141842603100000,NW 352,Residential,129,0,129,0,0,129
141842603200000,NW 352,Residential,132,0,132,0,0,132
141842603300000,NW 352,Residential,140,0,140,0,0,140
141842603400000,NW 352,Residential,143,0,143,0,0,143
141842603500000,NW 352,Residential,148,0,148,0,0,148
141842603600000,NW 352,Residential,185,0,185,0,0,185
141842603700000,NW 352,Residential,220,0,220,0,0,220
141842603800000,NW 352,Residential,305,0,305,0,0,305
141842603900000,NW 352,Residential,337,0,337,0,0,337
141842604000000,NW 352,Residential,220,0,220,0,0,220
141842604100000,NW 352,Residential,170,0,170,0,0,170
141842604200000,NW 352,Residential,143,0,143,0,0,143
141842604300000,NW 352,Residential,130,0,130,0,0,130
141842604400000,NW 352,Residential,175,0,175,0,0,175
141842604500000,NW 302,Ag Land,4457,0,4457,0,0,4457
141842800100000,NW 352,Residential,146,0,146,0,0,146
141842800200000,NW 352,Residential,128,0,128,0,0,128
141842800300000,NW 352,Residential,122,0,122,0,0,122
141842800400000,NW 352,Residential,133,0,133,0,0,133
141842800500000,NW 352,Residential,129,0,129,0,0,129
141842800600000,NW 352,Residential,127,0,127,0,0,127
141842800700000,NW 352,Residential,130,0,130,0,0,130
141842800800000,NW 352,Residential,132,0,132,0,0,132
141842800900000,NW 352,Residential,137,0,137,0,0,137
141842801000000,NW 352,Residential,122,0,122,0,0,122
141842801100000,NW 352,Residential,44389,0,44389,10395,0,54784
141842801200000,NW 352,Residential,37125,0,37125,4455,0,41580
141842801300000,NW 352,Residential,37500,0,37500,4455,0,41955
141842801400000,NW 352,Residential,37875,0,37875,4455,0,42330
141842801500000,NW 352,Residential,37875,0,37875,4455,0,42330
141842801800000,NW 352,Residential,119,0,119,0,0,119
141842801900000,NW 352,Residential,118,0,118,0,0,118
141842802000000,NW 352,Residential,119,0,119,0,0,119
141842802100000,NW 352,Residential,121,0,121,0,0,121
141842900100000,NW 352,Residential,142,0,142,0,0,142
141842900200000,NW 352,Residential,173,0,173,0,0,173
141842900300000,NW 352,Residential,253,0,253,0,0,253
141842900400000,NW 352,Residential,299,0,299,0,0,299
141842900500000,NW 352,Residential,199,0,199,0,0,199
141842900600000,NW 352,Residential,133,0,133,0,0,133
141842900700000,NW 352,Residential,127,0,127,0,0,127
141842900800000,NW 352,Residential,120,0,120,0,0,120
141842900900000,NW 352,Residential,123,0,123,0,0,123
141842901000000,NW 352,Residential,118,0,118,0,0,118
141842901100000,NW 352,Residential,127,0,127,0,0,127
141842901200000,NW 352,Residential,136,0,136,0,0,136
141842901300000,NW 352,Residential,120,0,120,0,0,120
141842901400000,NW 352,Residential,31680,0,31680,10395,0,42075
141842901500000,NW 352,Residential,32340,0,32340,4455,0,36795
141842901600000,NW 352,Residential,117,0,117,0,0,117
141842901700000,NW 352,Residential,98,0,98,0,0,98
141842901800000,NW 352,Residential,116,0,116,0,0,116
141842901900000,NW 352,Residential,162,0,162,0,0,162
141842902000000,NW 352,Residential,169,0,169,0,0,169
141842902100000,NW 352,Residential,150,0,150,0,0,150
141842902200000,NW 352,Residential,36000,0,36000,4455,0,40455
141842902300000,NW 352,Residential,125,0,125,0,0,125
141842902400000,NW 352,Residential,37500,0,37500,4455,0,41955
141842902500000,NW 352,Residential,125,0,125,0,0,125
141842902600000,NW 352,Residential,125,0,125,0,0,125
141842902700000,NW 352,Residential,37500,0,37500,4455,0,41955
141842902800000,NW 352,Residential,37500,0,37500,37148,0,74648
141842902900000,NW 352,Residential,125,0,125,0,0,125
141842903000000,NW 352,Residential,125,0,125,0,0,125
141842903100000,NW 352,Residential,129,0,129,0,0,129
141842903200000,NW 302,Ag Land,1361,0,1361,0,0,1361
141845100100000,NW 302,Residential,155000,0,155000,0,0,155000
141845100300000,NW 302,Residential,155000,0,155000,124469,0,279469
141847600200000,NW 307,Residential,51208,0,51208,127518,0,178726
141847600300000,NW 307,Residential,42287,0,42287,201065,0,243352
141847600400000,NW 307,Residential,40112,0,40112,157197,0,197309
141847600500000,NW 307,Residential,41463,0,41463,167078,0,208541
141847600700000,NW 308,Residential,21645,0,21645,115885,0,137530
141847600800000,NW 308,Residential,32350,0,32350,106237,0,138587
141847600900000,NW 308,Residential,30525,0,30525,91434,0,121959
141847601000000,NW 308,Residential,27540,0,27540,120530,0,148070
141847601100000,NW 308,Residential,22530,0,22530,138211,0,160741
141847601200000,NW 308,Residential,27631,0,27631,117562,0,145193
141847601300000,NW 307,Residential,41623,0,41623,155892,0,197515
141847601400000,NW 307,Residential,40800,0,40800,144971,0,185771
141847601500000,NW 307,Residential,43600,0,43600,147932,0,191532
141847601600000,NW 307,Residential,41735,0,41735,149319,0,191054
141847601700000,NW 307,Residential,40328,0,40328,152015,0,192343
141847601800000,NW 307,Residential,41333,0,41333,144631,0,185964
141847601900000,NW 307,Residential,40136,0,40136,156819,0,196955
141847602000000,NW 307,Residential,43400,0,43400,204323,0,247723
141847602100000,NW 307,Residential,36160,0,36160,145882,0,182042
141847602200000,NW 307,Residential,41572,0,41572,148970,0,190542
141847602300000,NW 307,Residential,41830,0,41830,142129,0,183959
141847602400000,NW 307,Residential,38070,0,38070,141064,0,179134
141847602500000,NW 307,Residential,40731,0,40731,199946,0,240677
141847602600000,NW 307,Residential,43664,0,43664,163382,0,207046
141847602700000,NW 302,Residential,34974,0,34974,280887,0,315861
141847602800000,NW 302,Residential,34974,0,34974,224584,0,259558
141847602900000,NW 302,Residential,30577,0,30577,108399,0,138976
141847603000000,CITY PROPERTY,Exempt,0,0,0,0,0,0
141847700100000,NW 302,Residential,101250,0,101250,48722,0,149972
141847700300000,NW 308,Residential,24480,0,24480,116641,0,141121
141847700400000,NW 308,Residential,22451,0,22451,124690,0,147141
141847700500000,NW 308,Residential,22486,0,22486,90698,0,113184
141847700600000,NW 308,Residential,23932,0,23932,119934,0,143866
141847700700000,NW 308,Residential,21450,0,21450,85660,0,107110
141847700800000,NW 308,Residential,21840,0,21840,45220,0,67060
141847700900000,NW 308,Residential,22260,0,22260,138386,0,160646
141847701000000,NW 308,Residential,22563,0,22563,133504,0,156067
141847701100000,NW 308,Residential,20763,0,20763,104952,0,125715
141847701200000,NW 308,Residential,21000,0,21000,114173,0,135173
141847701300000,NW 302,Residential,94900,0,94900,0,0,94900
141847701400000,NW 302,Residential,39176,0,39176,248411,0,287587
141847701500000,NW 302,Residential,40878,0,40878,265140,0,306018
141847701600000,NW 302,Residential,34928,0,34928,261154,0,296082
141847701700000,NW 302,Residential,55997,0,55997,279985,0,335982
141847701800000,NW 302,Residential,53494,0,53494,230281,0,283775
141847701900000,NW 302,Residential,56364,0,56364,311032,0,367396
141847702000000,NW 302,Residential,51449,0,51449,0,0,51449
141847800100000,NW 307,Residential,43055,0,43055,151226,0,194281
141847800200000,NW 307,Residential,42166,0,42166,177071,0,219237
141847800300000,NW 307,Residential,41692,0,41692,154532,0,196224
141847800400000,NW 307,Residential,42432,0,42432,171019,0,213451
141847800500000,NW 307,Residential,40656,0,40656,176556,0,217212
141847800600000,NW 307,Residential,44921,0,44921,103829,0,148750
141847800700000,NW 308,Residential,18834,0,18834,99831,0,118665
141847800800000,NW 308,Residential,18600,0,18600,83017,0,101617
141847800900000,NW 308,Residential,23900,0,23900,131934,0,155834
141910100100000,NW 308,Residential,24444,0,24444,100806,0,125250
141910100200000,NW 308,Residential,24624,0,24624,119542,0,144166
141910100300000,NW 308,Residential,24624,0,24624,96158,0,120782
141910100400000,NW 308,Residential,24655,0,24655,117105,0,141760
141910100500000,NW 308,Residential,22800,0,22800,97617,0,120417
141910100600000,NW 308,Residential,29981,0,29981,90288,0,120269
141910100700000,NW 308,Residential,24716,0,24716,103369,0,128085
141910100800000,NW 308,Residential,30347,0,30347,86805,0,117152
141910200100000,NW 308,Residential,16600,0,16600,0,0,16600
141910200300000,NW 308,Residential,50100,0,50100,0,0,50100
141910200400000,NW 308,Residential,24189,0,24189,116521,0,140710
141910200500000,NW 308,Residential,23688,0,23688,104627,0,128315
141910200600000,NW 308,Residential,24354,0,24354,102299,0,126653
141910200700000,NW 308,Residential,26072,0,26072,133144,0,159216
141910200800000,NW 308,Residential,24440,0,24440,87045,0,111485
141910200900000,NW 308,Residential,24407,0,24407,109060,0,133467
141910201000000,NW 308,Residential,25037,0,25037,83847,0,108884
141910201100000,NW 308,Residential,23688,0,23688,107586,0,131274
141910201200000,NW 308,Residential,23184,0,23184,111026,0,134210
141910201300000,NW 308,Residential,26800,0,26800,105608,0,132408
141910201400000,NW 308,Residential,23442,0,23442,270,0,23712
141910300100000,NW 308,Residential,26362,0,26362,106520,0,132882
141910300200000,NW 308,Residential,26600,0,26600,94182,0,120782
141910300300000,NW 308,Residential,25920,0,25920,92799,0,118719
141910300400000,NW 308,Residential,24000,0,24000,106711,0,130711
141910300500000,NW 308,Residential,24265,0,24265,116628,0,140893
141910300600000,NW 308,Residential,26676,0,26676,61619,0,88295
141910300700000,NW 308,Residential,25492,0,25492,88432,0,113924
141910300800000,NW 308,Residential,24816,0,24816,121275,0,146091
141910300900000,NW 308,Residential,24504,0,24504,108132,0,132636
141910301000000,NW 308,Residential,25654,0,25654,109051,0,134705
141910301100000,NW 308,Residential,23635,0,23635,104365,0,128000
141910301200000,NW 308,Residential,24252,0,24252,109907,0,134159
141910301300000,NW 308,Residential,24252,0,24252,113312,0,137564
141910301400000,NW 308,Residential,24252,0,24252,101474,0,125726
141910301500000,NW 308,Residential,24252,0,24252,100181,0,124433
141910301600000,NW 308,Residential,25477,0,25477,104430,0,129907
141910301800000,NW 308,Residential,24864,0,24864,111078,0,135942
141910301900000,NW 308,Residential,36733,0,36733,114658,0,151391
141910302000000,NW 308,Residential,24703,0,24703,103162,0,127865
141910302100000,NW 308,Residential,28017,0,28017,103967,0,131984
141910302200000,NW 308,Residential,29229,0,29229,97521,0,126750
141910302300000,NW 308,Residential,25920,0,25920,111203,0,137123
141910302400000,NW 308,Residential,29487,0,29487,101868,0,131355
141910302500000,NW 308,Residential,26288,0,26288,124961,0,151249
141910302600000,NW 308,Residential,27090,0,27090,102897,0,129987
141910302700000,NW 308,Residential,24252,0,24252,100898,0,125150
141910302800000,NW 308,Residential,24252,0,24252,104590,0,128842
141910302900000,NW 308,Residential,24252,0,24252,116928,0,141180
141910303000000,NW 308,Residential,24504,0,24504,95312,0,119816
141910303100000,NW 308,Residential,28216,0,28216,93360,0,121576
141910303200000,NW 308,Residential,28210,0,28210,89935,0,118145
141910400100000,NW 308,Residential,23980,0,23980,97418,0,121398
141910400200000,NW 308,Residential,23980,0,23980,105349,0,129329
141910400300000,NW 308,Residential,24308,0,24308,95967,0,120275
141910400400000,NW 308,Residential,25680,0,25680,51952,0,77632
141910400500000,NW 308,Residential,27860,0,27860,112837,0,140697
141910400600000,NW 308,Residential,43982,0,43982,107366,0,151348
141910400700000,NW 308,Residential,27853,0,27853,113236,0,141089
141910400800000,NW 308,Residential,26917,0,26917,145534,0,172451
141910400900000,NW 308,Residential,24056,0,24056,131619,0,155675
141910401000000,NW 308,Residential,24056,0,24056,115418,0,139474
141910401100000,NW 308,Residential,24056,0,24056,111975,0,136031
141910401200000,NW 308,Residential,24056,0,24056,117111,0,141167
141910401300000,NW 308,Residential,24056,0,24056,105101,0,129157
141910401400000,NW 308,Residential,24056,0,24056,98318,0,122374
141910401500000,NW 308,Residential,24494,0,24494,102855,0,127349
141910401600000,NW 308,Residential,25785,0,25785,119026,0,144811
141910401700000,NW 308,Residential,24056,0,24056,88542,0,112598
141910401800000,NW 308,Residential,24056,0,24056,96267,0,120323
141910401900000,NW 308,Residential,24056,0,24056,97450,0,121506
141910402000000,NW 308,Residential,24056,0,24056,101177,0,125233
141910402100000,NW 308,Residential,24056,0,24056,101493,0,125549
141910402200000,NW 308,Residential,24056,0,24056,112493,0,136549
141910402300000,NW 308,Residential,24056,0,24056,83239,0,107295
141910402400000,NW 308,Residential,30981,0,30981,124088,0,155069
141910500100000,NW 308,Residential,39552,0,39552,131115,0,170667
141910500200000,NW 308,Residential,39780,0,39780,108201,0,147981
141910500300000,NW 308,Residential,8650,0,8650,0,0,8650
141910500400000,NW 308,Residential,40230,0,40230,115622,0,155852
141910500500000,NW 308,Exempt,0,21210,21210,0,0,21210
141910500600000,NW 308,Residential,54240,0,54240,129835,0,184075
141910500700000,NW 308,Residential,33148,0,33148,104223,0,137371
141910500800000,NW 308,Residential,25816,0,25816,108358,0,134174
141910500900000,NW 308,Residential,24056,0,24056,97905,0,121961
141910501000000,NW 308,Residential,24056,0,24056,105019,0,129075
141910501100000,NW 308,Residential,24056,0,24056,104106,0,128162
141910501200000,NW 308,Residential,24056,0,24056,128744,0,152800
141910501300000,NW 308,Residential,24056,0,24056,135,0,24191
141910501400000,NW 308,Residential,24056,0,24056,130806,0,154862
141910501500000,NW 308,Residential,24056,0,24056,129107,0,153163
141910501600000,NW 308,Residential,24056,0,24056,121432,0,145488
141910501700000,NW 308,Residential,25977,0,25977,125199,0,151176
141912600100000,NW 308,Residential,37009,0,37009,214879,0,251888
141912600200000,NW 308,Residential,39413,0,39413,234247,0,273660
141912600300000,NW 308,Residential,38410,0,38410,244693,0,283103
141912600400000,NW 308,Residential,34569,0,34569,195695,0,230264
141912600500000,NW 308,Residential,36186,0,36186,230082,0,266268
141912600600000,NW 308,Residential,38090,0,38090,263241,0,301331
141912600700000,NW 308,Residential,35881,0,35881,206408,0,242289
141912600800000,NW 308,Residential,36701,0,36701,188153,0,224854
141912600900000,NW 308,Residential,27898,0,27898,128448,0,156346
141912601000000,NW 308,Residential,27963,0,27963,119468,0,147431
141912601100000,NW 308,Residential,27727,0,27727,110388,0,138115
141912601200000,NW 308,Residential,27878,0,27878,91567,0,119445
141912601300000,NW 308,Residential,27793,0,27793,86456,0,114249
141912601400000,NW 308,Residential,28307,0,28307,107755,0,136062
141912601500000,NW 308,Residential,28275,0,28275,105961,0,134236
141912601600000,NW 308,Residential,27508,0,27508,73976,0,101484
141912601700000,NW 308,Residential,28177,0,28177,80910,0,109087
141912601800000,NW 308,Residential,26460,0,26460,91201,0,117661
141912601900000,NW 308,Residential,23429,0,23429,73301,0,96730
141912700100000,NW 308,Residential,41313,0,41313,193923,0,235236
141912700200000,NW 338,Residential,30866,0,30866,167462,0,198328
141912700300000,NW 338,Residential,30862,0,30862,138684,0,169546
141912700400000,NW 338,Residential,30862,0,30862,166542,0,197404
141912700500000,NW 338,Residential,30861,0,30861,125537,0,156398
141912700600000,NW 338,Residential,28414,0,28414,156932,0,185346
141912700700000,NW 338,Residential,28414,0,28414,127465,0,155879
141912700800000,NW 338,Residential,28413,0,28413,132822,0,161235
141912700900000,NW 338,Residential,28693,0,28693,140347,0,169040
141912701000000,NW 338,Residential,28693,0,28693,119419,0,148112
141912701100000,NW 338,Residential,28693,0,28693,154783,0,183476
141912701200000,NW 338,Residential,28693,0,28693,142297,0,170990
141912701300000,NW 338,Residential,28692,0,28692,157046,0,185738
141912701400000,NW 338,Residential,29127,0,29127,157907,0,187034
141912701500000,NW 338,Residential,30302,0,30302,145200,0,175502
141912701600000,NW 338,Residential,26400,0,26400,192121,0,218521
141912701700000,NW 338,Residential,26400,0,26400,151057,0,177457
141912701800000,NW 308,Residential,25536,0,25536,102446,0,127982
141912701900000,NW 308,Residential,25774,0,25774,94304,0,120078
141912702000000,NW 308,Residential,19627,0,19627,113658,0,133285
141912702100000,NW 308,Residential,18375,0,18375,96851,0,115226
141912702200000,NW 308,Residential,23152,0,23152,92690,0,115842
141912702300000,NW 308,Residential,22694,0,22694,84788,0,107482
141912702400000,NW 308,Residential,23893,0,23893,137356,0,161249
141912702500000,NW 308,Residential,23657,0,23657,98404,0,122061
141912702600000,NW 308,Residential,25705,0,25705,100056,0,125761
141912702700000,NW 308,Residential,26112,0,26112,100866,0,126978
141912702800000,NW 308,Residential,26520,0,26520,69341,0,95861
141912702900000,NW 308,Residential,26600,0,26600,101745,0,128345
141912703000000,NW 308,Residential,26785,0,26785,95607,0,122392
141912703100000,NW 308,Residential,26785,0,26785,91009,0,117794
141912703200000,NW 308,Residential,26022,0,26022,85052,0,111074
141912703300000,NW 308,Residential,25536,0,25536,72342,0,97878
141912703400000,NW 308,Residential,25976,0,25976,83296,0,109272
141912703500000,NW 308,Residential,25898,0,25898,90426,0,116324
141912703600000,NW 308,Residential,68350,0,68350,229208,0,297558
141912703700000,NW 308,Residential,25085,0,25085,106480,0,131565
141912703800000,NW 308,Residential,25556,0,25556,92729,0,118285
141912703900000,NW 308,Residential,26763,0,26763,103835,0,130598
141912704000000,NW 308,Residential,26347,0,26347,95948,0,122295
141912704100000,NW 308,Residential,26346,0,26346,95299,0,121645
141912704200000,NW 308,Residential,26509,0,26509,102078,0,128587
141912704300000,NW 308,Residential,25688,0,25688,90669,0,116357
141912704400000,NW 308,Residential,26346,0,26346,112377,0,138723
141912704500000,NW 308,Residential,26088,0,26088,89034,0,115122
141912704600000,NW 308,Residential,26519,0,26519,106588,0,133107
141912704700000,NW 308,Residential,26613,0,26613,112631,0,139244
141912704800000,NW 308,Residential,26710,0,26710,93617,0,120327
141912704900000,NW 308,Residential,26710,0,26710,80597,0,107307
141912705000000,NW 308,Residential,27160,0,27160,103953,0,131113
141912705100000,NW 308,Residential,27269,0,27269,90871,0,118140
141912705200000,NW 308,Residential,26457,0,26457,116060,0,142517
141912705300000,NW 308,Residential,26674,0,26674,104801,0,131475
141912705400000,NW 308,Residential,26965,0,26965,103097,0,130062
141912705500000,NW 308,Residential,26921,0,26921,95448,0,122369
141912705600000,NW 308,Residential,35966,0,35966,184269,0,220235
141912705700000,NW 308,Residential,35255,0,35255,208854,0,244109
141912705800000,NW 308,Residential,36777,0,36777,204951,0,241728
141912705900000,NW 308,Residential,34932,0,34932,195855,0,230787
141912706000000,NW 308,Residential,36453,0,36453,258101,0,294554
141912706100000,NW 308,Residential,36133,0,36133,187090,0,223223
141912706200000,NW 308,Residential,42662,0,42662,244572,0,287234
141912800100000,NW 338,Residential,28379,0,28379,134871,0,163250
141912800200000,NW 308,Residential,26344,0,26344,142332,0,168676
141912800300000,NW 308,Residential,25536,0,25536,120068,0,145604
141912800400000,NW 308,Residential,24960,0,24960,121095,0,146055
141912800500000,NW 308,Residential,26112,0,26112,136447,0,162559
141912800600000,NW 308,Residential,26320,0,26320,116985,0,143305
141912800700000,NW 308,Residential,26320,0,26320,99801,0,126121
141912800800000,NW 308,Residential,26320,0,26320,116589,0,142909
141912800900000,NW 308,Residential,26320,0,26320,103449,0,129769
141912801000000,NW 308,Residential,26320,0,26320,123616,0,149936
141912801100000,NW 308,Residential,26320,0,26320,114375,0,140695
141912801200000,NW 308,Residential,26320,0,26320,109263,0,135583
141912801300000,NW 308,Residential,26320,0,26320,123610,0,149930
141912801400000,NW 308,Residential,26320,0,26320,113894,0,140214
141912801500000,NW 338,Residential,29023,0,29023,129459,0,158482
141912801600000,NW 338,Residential,28376,0,28376,130517,0,158893
141912801700000,NW 338,Residential,28376,0,28376,147723,0,176099
141912801800000,NW 338,Residential,28376,0,28376,161717,0,190093
141912801900000,NW 338,Residential,28376,0,28376,162561,0,190937
141912802000000,NW 338,Residential,28376,0,28376,176291,0,204667
141912802100000,NW 338,Residential,28376,0,28376,162344,0,190720
141912802200000,NW 338,Residential,28376,0,28376,156043,0,184419
141912802300000,NW 338,Residential,28376,0,28376,166269,0,194645
141912802400000,NW 338,Residential,28376,0,28376,155198,0,183574
141912802500000,NW 338,Residential,28376,0,28376,141457,0,169833
141912802600000,NW 338,Residential,28376,0,28376,141715,0,170091
141912900100000,NW 308,Residential,27193,0,27193,133529,0,160722
141912900200000,NW 308,Residential,26730,0,26730,121638,0,148368
141912900300000,NW 308,Residential,26730,0,26730,121965,0,148695
141912900400000,NW 308,Residential,26730,0,26730,150599,0,177329
141912900500000,NW 308,Residential,25026,0,25026,134682,0,159708
141912900600000,NW 308,Residential,25026,0,25026,102260,0,127286
141912900700000,NW 308,Residential,25026,0,25026,95455,0,120481
141912900800000,NW 308,Residential,25026,0,25026,81566,0,106592
141912900900000,NW 308,Residential,25026,0,25026,103786,0,128812
141912901000000,NW 308,Residential,25026,0,25026,80235,0,105261
141912901100000,NW 308,Residential,25026,0,25026,108174,0,133200
141912901200000,NW 308,Residential,25026,0,25026,111167,0,136193
141912901300000,NW 308,Residential,25026,0,25026,88198,0,113224
141912901400000,NW 308,Residential,25026,0,25026,104638,0,129664
141912901500000,NW 308,Residential,25026,0,25026,90247,0,115273
141912901600000,NW 308,Residential,25026,0,25026,102166,0,127192
141912901700000,NW 308,Residential,25309,0,25309,113417,0,138726
141912901800000,NW 308,Residential,24275,0,24275,110442,0,134717
141915100100000,NW 306,Residential,38846,0,38846,119400,0,158246
141915100200000,NW 306,Residential,32304,0,32304,56263,0,88567
141915100300000,NW 306,Residential,56970,0,56970,152520,0,209490
141915100400000,NW 306,Residential,28018,0,28018,119501,0,147519
141915100500000,NW 306,Residential,25970,0,25970,116782,0,142752
141915100600000,NW 306,Residential,25970,0,25970,117589,0,143559
141915100700000,NW 306,Residential,26215,0,26215,116655,0,142870
141915100800000,NW 306,Residential,26460,0,26460,97957,0,124417
141915100900000,NW 306,Residential,26950,0,26950,105498,0,132448
141915101000000,NW 306,Residential,27685,0,27685,113869,0,141554
141915101100000,NW 306,Residential,27668,0,27668,108031,0,135699
141915101200000,NW 306,Residential,23219,0,23219,118426,0,141645
141915101300000,NW 306,Residential,23310,0,23310,93270,0,116580
141915101400000,NW 306,Residential,24780,0,24780,119390,0,144170
141915101500000,NW 306,Residential,26525,0,26525,101133,0,127658
141915101600000,NW 306,Residential,28175,0,28175,97565,0,125740
141915101700000,NW 306,Residential,32928,0,32928,120577,0,153505
141915200100000,NW 306,Residential,23938,0,23938,92559,0,116497
141915200200000,NW 306,Residential,21840,0,21840,84620,0,106460
141915200300000,NW 306,Residential,24938,0,24938,106033,0,130971
141915200400000,NW 306,Residential,26250,0,26250,84034,0,110284
141915200500000,NW 306,Residential,26250,0,26250,77955,0,104205
141915200600000,NW 306,Residential,26040,0,26040,65406,0,91446
141915200700000,NW 306,Residential,26040,0,26040,62667,0,88707
141915200800000,NW 306,Residential,26040,0,26040,70134,0,96174
141915200900000,NW 308,Residential,29363,0,29363,72050,0,101413
141915201000000,NW 308,Residential,23345,0,23345,96281,0,119626
141915201100000,NW 308,Residential,23042,0,23042,93051,0,116093
141915201200000,NW 308,Residential,20790,0,20790,88729,0,109519
141915201300000,NW 308,Residential,22349,0,22349,105626,0,127975
141915201400000,NW 308,Residential,22973,0,22973,126987,0,149960
141915201500000,NW 308,Residential,22973,0,22973,118461,0,141434
141915201600000,NW 308,Residential,23353,0,23353,102170,0,125523
141915201700000,NW 308,Residential,28342,0,28342,145121,0,173463
141915201800000,NW 308,Residential,24722,0,24722,106366,0,131088
141915201900000,NW 308,Residential,26957,0,26957,96815,0,123772
141915202000000,NW 308,Residential,26412,0,26412,92842,0,119254
141915202100000,NW 308,Residential,24768,0,24768,98220,0,122988
141915202200000,NW 308,Residential,24768,0,24768,100936,0,125704
141915202300000,NW 308,Residential,24445,0,24445,97847,0,122292
141915202400000,NW 306,Residential,63600,0,63600,209033,0,272633
141915202500000,NW 308,Residential,26362,0,26362,113326,0,139688
141915202600000,NW 308,Residential,25034,0,25034,116189,0,141223
141915202700000,NW 308,Residential,25478,0,25478,126159,0,151637
141915202800000,NW 308,Residential,27580,0,27580,130777,0,158357
141915202900000,NW 308,Residential,28485,0,28485,118146,0,146631
141915203000000,NW 308,Residential,28159,0,28159,127657,0,155816
141915203100000,NW 308,Residential,27160,0,27160,104192,0,131352
141915203200000,NW 308,Residential,27160,0,27160,96592,0,123752
141915203300000,NW 308,Residential,27160,0,27160,99348,0,126508
141915203400000,NW 308,Residential,26995,0,26995,112223,0,139218
141915203500000,NW 308,Residential,26880,0,26880,126576,0,153456
141915203600000,NW 308,Residential,26880,0,26880,117531,0,144411
141915203700000,NW 341,Residential,34182,0,34182,195291,0,229473
141915203800000,NW 341,Residential,34182,0,34182,151562,0,185744
141915203900000,NW 341,Residential,33648,0,33648,150972,0,184620
141915204000000,NW 341,Residential,34032,0,34032,166792,0,200824
141915204100000,NW 341,Residential,32560,0,32560,0,0,32560
141915204200000,NW 341,Residential,40195,0,40195,216760,0,256955
141915204300000,NW 341,Residential,35978,0,35978,222994,0,258972
141915204400000,NW 341,Residential,33764,0,33764,0,0,33764
141915204500000,NW 341,Residential,32967,0,32967,254916,0,287883
141915204600000,NW 341,Residential,40061,0,40061,207027,0,247088
141915204700000,NW 341,Residential,34426,0,34426,0,0,34426
141915204800000,NW 341,Residential,33293,0,33293,0,0,33293
141915204900000,NW 341,Residential,29723,0,29723,201930,0,231653
141915205000000,NW 306,Residential,33844,0,33844,96352,0,130196
141915205100000,NW 306,Residential,29055,0,29055,111381,0,140436
141915205200000,NW 306,Residential,29689,0,29689,114582,0,144271
141915205300000,NW 306,Residential,28476,0,28476,117990,0,146466
141915205400000,NW 306,Residential,28665,0,28665,111030,0,139695
141915205500000,NW 306,Residential,28910,0,28910,106016,0,134926
141915205600000,NW 306,Residential,34969,0,34969,85192,0,120161
141915205700000,NW 306,Residential,30637,0,30637,139208,0,169845
141915205800000,NW 306,Residential,21271,0,21271,93552,0,114823
141915205900000,NW 306,Residential,27283,0,27283,78804,0,106087
141915206000000,NW 306,Residential,27268,0,27268,80924,0,108192
141915206100000,NW 306,Residential,23373,0,23373,87730,0,111103
141915300100000,NW 308,Residential,26328,0,26328,98611,0,124939
141915300200000,NW 308,Residential,25544,0,25544,105253,0,130797
141915300300000,NW 308,Residential,26342,0,26342,99282,0,125624
141915300400000,NW 308,Residential,26994,0,26994,112021,0,139015
141915400100000,NW 308,Residential,26362,0,26362,99298,0,125660
141915400200000,NW 308,Residential,25735,0,25735,97924,0,123659
141915400300000,NW 308,Residential,25624,0,25624,101940,0,127564
141915400400000,NW 308,Residential,26352,0,26352,112933,0,139285
141915400500000,NW 308,Residential,26624,0,26624,118186,0,144810
141915400600000,NW 308,Residential,23761,0,23761,94804,0,118565
141915400700000,NW 308,Residential,24945,0,24945,102088,0,127033
141915400800000,NW 308,Residential,24444,0,24444,136102,0,160546
141915400900000,NW 308,Residential,25525,0,25525,133251,0,158776
141915401000000,NW 308,Residential,27455,0,27455,143657,0,171112
141915401100000,NW 308,Residential,27518,0,27518,131306,0,158824
141915401200000,NW 308,Residential,27535,0,27535,132655,0,160190
141915401300000,NW 308,Residential,29131,0,29131,132424,0,161555
141915401400000,NW 308,Residential,26531,0,26531,130940,0,157471
141915401500000,NW 308,Residential,26272,0,26272,105144,0,131416
141915401600000,NW 308,Residential,25034,0,25034,107772,0,132806
141915500100000,NW 341,Residential,37200,0,37200,205338,0,242538
141915500200000,NW 341,Residential,34235,0,34235,186461,0,220696
141915500300000,NW 341,Residential,34235,0,34235,163397,0,197632
141915500400000,NW 341,Residential,34235,0,34235,185786,0,220021
141915500500000,NW 341,Residential,34235,0,34235,167572,0,201807
141915500600000,NW 341,Residential,29375,0,29375,0,0,29375
141915500700000,NW 341,Residential,30456,0,30456,0,0,30456
141915500800000,NW 341,Residential,28764,0,28764,198142,0,226906
141915500900000,NW 341,Residential,33840,0,33840,210941,0,244781
141915501000000,NW 341,Residential,37200,0,37200,167311,0,204511
141917600100000,NW 306,Residential,43190,0,43190,104942,0,148132
141917600200000,NW 306,Residential,43050,0,43050,214207,0,257257
141917600300000,NW 306,Residential,23949,0,23949,68193,0,92142
141917600400000,NW 306,Residential,23949,0,23949,94688,0,118637
141917600500000,NW 306,Residential,23949,0,23949,79385,0,103334
141917600600000,NW 306,Residential,23949,0,23949,79121,0,103070
141917600700000,NW 306,Residential,42665,0,42665,69311,0,111976
141917600800000,NW 306,Residential,33529,0,33529,95159,0,128688
141917600900000,NW 306,Residential,49805,0,49805,55075,0,104880
141917601000000,NW 306,Residential,23741,0,23741,96880,0,120621
141917601100000,NW 306,Residential,5233,0,5233,0,0,5233
141917601200000,NW 306,Residential,24157,0,24157,74753,0,98910
141917601300000,NW 306,Residential,26163,0,26163,105444,0,131607
141917601400000,NW 306,Residential,26163,0,26163,52232,0,78395
141917601500000,NW 306,Residential,24255,0,24255,98817,0,123072
141917601600000,NW 306,Residential,22358,0,22358,81831,0,104189
141917601700000,NW 306,Residential,22354,0,22354,89511,0,111865
141917601800000,NW 306,Residential,22354,0,22354,92381,0,114735
141917601900000,NW 306,Residential,24435,0,24435,89524,0,113959
141917602000000,NW 306,Residential,63850,0,63850,139762,0,203612
141917602100000,NW 306,Residential,80600,0,80600,82316,0,162916
141917602200000,NW 306,Residential,74950,0,74950,0,0,74950
141917602300000,NW 306,Residential,45175,0,45175,156514,0,201689
141917602400000,NW 306,Residential,20700,0,20700,1539,0,22239
141917602500000,NW 306,Residential,19698,0,19698,97673,0,117371
141917602600000,NW 306,Residential,61950,0,61950,212082,0,274032
141917602700000,NW 313,Residential,38261,0,38261,249378,0,287639
141917602800000,NW 313,Residential,37800,0,37800,192726,0,230526
141917602900000,NW 313,Residential,38497,0,38497,218831,0,257328
141917603000000,NW 313,Residential,52819,0,52819,283516,0,336335
141917603100000,NW 313,Residential,46852,0,46852,249706,0,296558
141917603200000,NW 313,Residential,36248,0,36248,322424,0,358672
141917603300000,NW 313,Residential,33600,0,33600,257576,0,291176
141917603400000,NW 313,Residential,33600,0,33600,237746,0,271346
141917603500000,NW 313,Residential,39173,0,39173,277635,0,316808
141917603600000,NW 306,Residential,78750,0,78750,239603,0,318353
141917603700000,NW 306,Residential,3540,0,3540,0,0,3540
141917603800000,NW 306,Residential,7150,0,7150,0,0,7150
141917700100000,NW 306,Residential,34468,0,34468,36334,0,70802
141920100100000,NW 308,Residential,24521,0,24521,110709,0,135230
141920100200000,NW 308,Residential,25088,0,25088,117902,0,142990
141920100300000,NW 308,Residential,25088,0,25088,116281,0,141369
141920100400000,NW 308,Residential,25088,0,25088,120131,0,145219
141920100500000,NW 308,Residential,25088,0,25088,119166,0,144254
141920100600000,NW 308,Residential,25088,0,25088,120686,0,145774
141920100700000,NW 308,Residential,25088,0,25088,125766,0,150854
141920100800000,NW 308,Residential,25062,0,25062,132133,0,157195
141920100900000,NW 308,Residential,29400,0,29400,124783,0,154183
141920101000000,NW 308,Residential,26460,0,26460,106476,0,132936
141920101100000,NW 308,Residential,25284,0,25284,97386,0,122670
141920101200000,NW 308,Residential,26460,0,26460,117524,0,143984
141920101300000,NW 308,Residential,26460,0,26460,88350,0,114810
141920101400000,NW 308,Residential,26177,0,26177,119530,0,145707
141920101500000,NW 308,Residential,25284,0,25284,106551,0,131835
141920101600000,NW 308,Residential,25284,0,25284,107931,0,133215
141920101700000,NW 308,Residential,25787,0,25787,95753,0,121540
141920101800000,NW 308,Residential,24751,0,24751,95211,0,119962
141920101900000,NW 308,Residential,25633,0,25633,103277,0,128910
141920200100000,NW 308,Residential,26147,0,26147,103334,0,129481
141920200200000,NW 308,Residential,27124,0,27124,133295,0,160419
141920200300000,NW 308,Residential,27234,0,27234,132082,0,159316
141920200400000,NW 308,Residential,28534,0,28534,109848,0,138382
141920200500000,NW 308,Residential,36870,0,36870,126827,0,163697
141920200600000,NW 308,Residential,26533,0,26533,123524,0,150057
141920200700000,NW 308,Residential,26775,0,26775,110523,0,137298
141920200800000,NW 308,Residential,26226,0,26226,134363,0,160589
141920200900000,NW 308,Residential,26226,0,26226,120855,0,147081
141920201000000,NW 308,Residential,26316,0,26316,122733,0,149049
141920201100000,NW 308,Residential,25284,0,25284,128653,0,153937
141920201200000,NW 308,Residential,25026,0,25026,116685,0,141711
141920201300000,NW 308,Residential,25026,0,25026,135626,0,160652
141920201400000,NW 308,Residential,25026,0,25026,99534,0,124560
141920201500000,NW 308,Residential,25026,0,25026,141305,0,166331
141920201600000,NW 308,Residential,25026,0,25026,127483,0,152509
141920201700000,NW 308,Residential,25026,0,25026,109154,0,134180
141920201800000,NW 308,Residential,25026,0,25026,108070,0,133096
141920201900000,NW 308,Residential,25026,0,25026,114160,0,139186
141920202000000,NW 308,Residential,24488,0,24488,107231,0,131719
141920202100000,APARTMENT,Commercial,0,39334,39334,0,371483,410817
141920202200000,APARTMENT,Residential,38992,0,38992,276008,0,315000
141920202300000,APARTMENT,Residential,34452,0,34452,255707,0,290159
141920202400000,APARTMENT,Residential,54540,0,54540,602459,0,656999
141920202600000,NW 308,Residential,20160,0,20160,90198,0,110358
141920202700000,NW 308,Residential,20167,0,20167,88198,0,108365
141920202800000,NW 308,Residential,25320,0,25320,94858,0,120178
141920202900000,NW 308,Residential,25800,0,25800,93871,0,119671
141920203000000,NW 308,Residential,25800,0,25800,93866,0,119666
141920203100000,NW 308,Residential,26712,0,26712,98603,0,125315
141920203200000,NW 308,Residential,27000,0,27000,116318,0,143318
141920203300000,NW 308,Residential,27000,0,27000,115224,0,142224
141920203400000,NW 308,Residential,25800,0,25800,99338,0,125138
141920203500000,NW 308,Residential,27000,0,27000,103979,0,130979
141920203600000,NW 308,Residential,27000,0,27000,105945,0,132945
141920203700000,NW 308,Residential,25587,0,25587,134829,0,160416
141920203800000,NW 308,Residential,25600,0,25600,132802,0,158402
141920203900000,NW 308,Residential,26640,0,26640,139556,0,166196
141920204000000,NW 308,Residential,33384,0,33384,179177,0,212561
141920204100000,NW 308,Residential,26961,0,26961,137742,0,164703
141920204200000,NW 308,Residential,29155,0,29155,119744,0,148899
141920204400000,NW 308,Residential,64650,0,64650,154995,0,219645
141920300100000,NW 308,Residential,28350,0,28350,125325,0,153675
141920300200000,NW 308,Residential,28984,0,28984,122818,0,151802
141920300300000,NW 308,Residential,28194,0,28194,113029,0,141223
141920300400000,NW 308,Residential,28638,0,28638,105527,0,134165
141920300500000,NW 308,Residential,27606,0,27606,114168,0,141774
141920300600000,NW 308,Residential,29807,0,29807,107033,0,136840
141920300700000,NW 308,Residential,24768,0,24768,107094,0,131862
141920300800000,NW 308,Residential,24768,0,24768,105026,0,129794
141920300900000,NW 308,Residential,24768,0,24768,106178,0,130946
141920301000000,NW 308,Residential,24768,0,24768,107941,0,132709
141920301100000,NW 308,Residential,24768,0,24768,117443,0,142211
141920301200000,NW 308,Residential,24768,0,24768,115373,0,140141
141920301300000,NW 308,Residential,24768,0,24768,110556,0,135324
141920301400000,NW 308,Residential,24768,0,24768,119992,0,144760
141920301500000,NW 308,Residential,25023,0,25023,104111,0,129134
141920301600000,NW 308,Residential,26042,0,26042,113396,0,139438
141920301700000,NW 308,Residential,24768,0,24768,107986,0,132754
141920301800000,NW 308,Residential,24768,0,24768,121615,0,146383
141920301900000,NW 308,Residential,24768,0,24768,120304,0,145072
141920302000000,NW 308,Residential,24768,0,24768,115886,0,140654
141920302100000,NW 308,Residential,28762,0,28762,128524,0,157286
141920302200000,NW 308,Residential,29131,0,29131,113935,0,143066
141920302300000,NW 308,Residential,31500,0,31500,122433,0,153933
141920302400000,NW 308,Residential,29181,0,29181,118069,0,147250
141920302500000,NW 308,Residential,25542,0,25542,109767,0,135309
141920302600000,NW 308,Residential,25542,0,25542,105454,0,130996
141920302700000,NW 308,Residential,25542,0,25542,119412,0,144954
141920302800000,NW 308,Residential,25542,0,25542,114565,0,140107
141920302900000,NW 308,Residential,25542,0,25542,109312,0,134854
141920303000000,NW 308,Residential,25542,0,25542,129856,0,155398
141920303100000,NW 308,Residential,25828,0,25828,121319,0,147147
141920303200000,NW 308,Residential,26729,0,26729,115426,0,142155
141920303300000,NW 308,Residential,25284,0,25284,108411,0,133695
141920303400000,NW 308,Residential,25284,0,25284,112278,0,137562
141920303500000,NW 308,Residential,25284,0,25284,110548,0,135832
141920303600000,NW 308,Residential,25284,0,25284,115129,0,140413
141920303700000,NW 308,Residential,25284,0,25284,126237,0,151521
141920303800000,NW 308,Residential,25284,0,25284,120457,0,145741
141920303900000,NW 308,Residential,25284,0,25284,120755,0,146039
141920304000000,NW 308,Residential,28953,0,28953,110648,0,139601
141920304100000,NW 308,Residential,27580,0,27580,154992,0,182572
141920304200000,NW 308,Residential,30742,0,30742,139417,0,170159
141920304300000,NW 308,Residential,28413,0,28413,130720,0,159133
141920400100000,APARTMENT,Residential,39366,0,39366,285634,0,325000
141920400200000,APARTMENT,Residential,20669,0,20669,134331,0,155000
141920400300000,APARTMENT,Residential,40303,0,40303,199697,0,240000
141922600100000,NW 308,Residential,27540,0,27540,105761,0,133301
141922600200000,NW 308,Residential,27632,0,27632,124328,0,151960
141922600300000,NW 308,Residential,27618,0,27618,120774,0,148392
141922600400000,NW 308,Residential,27832,0,27832,89259,0,117091
141922600500000,NW 308,Residential,31282,0,31282,100632,0,131914
141922600600000,NW 308,Residential,25284,0,25284,112827,0,138111
141922600700000,NW 308,Residential,25284,0,25284,119549,0,144833
141922600800000,NW 308,Residential,25284,0,25284,106709,0,131993
141922600900000,NW 308,Residential,25284,0,25284,106324,0,131608
141922601000000,NW 308,Residential,25284,0,25284,103464,0,128748
141922601100000,NW 308,Residential,25284,0,25284,92033,0,117317
141922601200000,NW 308,Residential,25284,0,25284,93177,0,118461
141922601300000,NW 308,Residential,25284,0,25284,101186,0,126470
141922601400000,NW 308,Residential,25284,0,25284,91269,0,116553
141922601500000,NW 308,Residential,25561,0,25561,92319,0,117880
141922601600000,NW 308,Residential,26405,0,26405,115164,0,141569
141922601700000,NW 308,Residential,25800,0,25800,119027,0,144827
141922601800000,NW 308,Residential,25800,0,25800,107582,0,133382
141922601900000,NW 308,Residential,25800,0,25800,109573,0,135373
141922602000000,NW 308,Residential,25800,0,25800,107693,0,133493
141922602100000,NW 308,Residential,25800,0,25800,116638,0,142438
141922602200000,NW 308,Residential,25800,0,25800,102031,0,127831
141922602300000,NW 308,Residential,25800,0,25800,102565,0,128365
141922602400000,NW 308,Residential,25800,0,25800,103538,0,129338
141922602500000,NW 308,Residential,26058,0,26058,103139,0,129197
141922602600000,NW 308,Residential,28832,0,28832,87818,0,116650
141922602700000,NW 308,Residential,27370,0,27370,116468,0,143838
141922700100000,NW 308,Residential,24530,0,24530,104329,0,128859
141922700200000,NW 308,Residential,29290,0,29290,108956,0,138246
141922700300000,NW 308,Residential,22372,0,22372,111718,0,134090
141922700400000,NW 308,Residential,23312,0,23312,94975,0,118287
141922700500000,NW 308,Residential,23312,0,23312,81557,0,104869
141922700600000,NW 308,Residential,24252,0,24252,109793,0,134045
141922700700000,NW 308,Residential,24252,0,24252,110161,0,134413
141922700800000,NW 308,Residential,24252,0,24252,83464,0,107716
141922700900000,NW 308,Residential,24510,0,24510,93070,0,117580
141922701000000,NW 308,Residential,24510,0,24510,82898,0,107408
141922701100000,NW 308,Residential,24510,0,24510,85099,0,109609
141922701200000,NW 308,Residential,24510,0,24510,102434,0,126944
141922701300000,NW 308,Residential,26220,0,26220,90518,0,116738
141922701400000,NW 308,Residential,25080,0,25080,96410,0,121490
141922701500000,NW 308,Residential,26170,0,26170,129961,0,156131
141922701600000,NW 308,Residential,26729,0,26729,117905,0,144634
141922701700000,NW 308,Residential,26320,0,26320,104027,0,130347
141922701800000,NW 308,Residential,25944,0,25944,113793,0,139737
141922701900000,NW 308,Residential,24252,0,24252,89942,0,114194
141922702000000,NW 308,Residential,24252,0,24252,96234,0,120486
141922702100000,NW 308,Residential,24252,0,24252,84394,0,108646
141922702200000,NW 308,Residential,24252,0,24252,105050,0,129302
141922702300000,NW 308,Residential,24252,0,24252,90877,0,115129
141922702400000,NW 308,Residential,24252,0,24252,90994,0,115246
141922702500000,NW 308,Residential,24252,0,24252,107547,0,131799
141922702600000,NW 308,Residential,24252,0,24252,96609,0,120861
141922702700000,NW 308,Residential,24252,0,24252,135641,0,159893
141922702800000,NW 308,Residential,24252,0,24252,115283,0,139535
141922800100000,NW 308,Residential,25634,0,25634,122107,0,147741
141922800200000,NW 308,Residential,26006,0,26006,95994,0,122000
141922800300000,NW 308,Residential,25439,0,25439,88046,0,113485
141922800400000,NW 308,Residential,26316,0,26316,95988,0,122304
141922800500000,NW 308,Residential,26755,0,26755,104012,0,130767
141922800600000,NW 308,Residential,25802,0,25802,120001,0,145803
141922800700000,NW 308,Residential,25026,0,25026,91880,0,116906
141922800800000,NW 308,Residential,26140,0,26140,106078,0,132218
141922800900000,NW 308,Residential,27520,0,27520,82480,0,110000
141922801000000,NW 308,Residential,20957,0,20957,106543,0,127500
141922801100000,NW 308,Residential,25560,0,25560,104440,0,130000
141922801200000,NW 308,Residential,25181,0,25181,114177,0,139358
141922801300000,NW 308,Residential,25181,0,25181,94183,0,119364
141922801400000,NW 308,Residential,25181,0,25181,90263,0,115444
141922801500000,NW 308,Residential,25026,0,25026,103330,0,128356
141922801600000,NW 308,Residential,25841,0,25841,97720,0,123561
141922801700000,NW 308,Residential,29145,0,29145,111918,0,141063
141922801800000,NW 308,Residential,27409,0,27409,108217,0,135626
141922801900000,NW 308,Residential,25830,0,25830,114354,0,140184
141922802000000,NW 308,Residential,25981,0,25981,103341,0,129322
141922802100000,NW 308,Residential,25981,0,25981,89829,0,115810
141922802200000,NW 308,Residential,25981,0,25981,93746,0,119727
141922802300000,NW 308,Residential,26264,0,26264,89690,0,115954
141922802400000,NW 308,Residential,30860,0,30860,83545,0,114405
141922802500000,NW 308,Residential,30736,0,30736,77440,0,108176
141922802600000,NW 308,Residential,29328,0,29328,83402,0,112730
141922802700000,NW 308,Residential,28388,0,28388,79181,0,107569
141922802800000,NW 308,Residential,28921,0,28921,107785,0,136706
141922802900000,NW 308,Residential,25988,0,25988,99018,0,125006
141922803000000,NW 308,Residential,20983,0,20983,116559,0,137542
141922803100000,NW 308,Residential,20668,0,20668,92825,0,113493
141922803200000,NW 308,Residential,24146,0,24146,82944,0,107090
141922803300000,NW 308,Residential,24416,0,24416,139065,0,163481
141922803400000,NW 308,Residential,24321,0,24321,82023,0,106344
141922803500000,NW 308,Residential,24321,0,24321,122062,0,146383
141922803600000,NW 308,Residential,24321,0,24321,102231,0,126552
141922803700000,NW 308,Residential,30520,0,30520,92886,0,123406
141922803800000,CITY PROPERTY,Exempt,0,0,0,0,0,0
141923000100000,NW 308,Residential,25026,0,25026,103036,0,128062
141923000200000,NW 308,Residential,26896,0,26896,105582,0,132478
141923000300000,NW 308,Residential,25230,0,25230,100558,0,125788
141923000400000,NW 308,Residential,25659,0,25659,97234,0,122893
141923000500000,NW 308,Residential,26397,0,26397,81603,0,108000
141923000600000,NW 308,Residential,27832,0,27832,101412,0,129244
141923000700000,NW 308,Residential,25542,0,25542,107804,0,133346
141923000800000,NW 308,Residential,24768,0,24768,96160,0,120928
141923000900000,NW 308,Residential,24570,0,24570,98073,0,122643
141923001000000,NW 308,Residential,25026,0,25026,103753,0,128779
141923001100000,NW 308,Residential,25026,0,25026,99262,0,124288
141923001200000,NW 308,Residential,25026,0,25026,106299,0,131325
141923001300000,NW 308,Residential,25026,0,25026,98385,0,123411
141923100100000,APARTMENT,Commercial,0,16560,16560,0,130906,147466
141923200100000,NW 308,Residential,28500,0,28500,101099,0,129599
141923200200000,NW 308,Residential,28500,0,28500,99897,0,128397
141923200300000,NW 308,Residential,28500,0,28500,105825,0,134325
141923200400000,NW 308,Residential,28500,0,28500,102732,0,131232
141923200500000,NW 308,Residential,27072,0,27072,108876,0,135948
141923200600000,NW 308,Residential,24500,0,24500,75857,0,100357
141923200700000,NW 308,Residential,26162,0,26162,138155,0,164317
141923200800000,NW 308,Residential,28175,0,28175,79465,0,107640
141925100100000,NW 314,Residential,24358,0,24358,100929,0,125287
141925100200000,NW 314,Residential,32825,0,32825,88907,0,121732
141925100300000,NW 314,Residential,30527,0,30527,95155,0,125682
141925100400000,NW 314,Residential,29680,0,29680,103767,0,133447
141925100500000,NW 314,Residential,27195,0,27195,103252,0,130447
141925100600000,NW 314,Residential,34644,0,34644,108928,0,143572
141925100700000,NW 314,Residential,50610,0,50610,99970,0,150580
141925100800000,NW 314,Residential,34153,0,34153,100260,0,134413
141925100900000,NW 314,Residential,32554,0,32554,169078,0,201632
141925101000000,NW 314,Residential,31538,0,31538,111612,0,143150
141925101200000,NW 314,Residential,21117,0,21117,86572,0,107689
141925101300000,NW 314,Residential,32498,0,32498,50530,0,83028
141925101400000,NW 314,Residential,32799,0,32799,65740,0,98539
141925101500000,NW 314,Residential,33868,0,33868,127857,0,161725
141925101600000,NW 314,Residential,30138,0,30138,92474,0,122612
141925101700000,NW 314,Residential,33669,0,33669,100941,0,134610
141925101800000,NW 314,Residential,27132,0,27132,88540,0,115672
141925101900000,NW 314,Residential,27216,0,27216,53452,0,80668
141925102000000,NW 314,Residential,22000,0,22000,92365,0,114365
141925102100000,NW 314,Residential,25966,0,25966,74857,0,100823
141925102200000,NW 314,Residential,26703,0,26703,92967,0,119670
141925102300000,NW 314,Residential,29040,0,29040,71753,0,100793
141925102400000,NW 314,Residential,28800,0,28800,86690,0,115490
141925102500000,NW 314,Residential,51382,0,51382,54352,0,105734
141925102600000,NW 314,Residential,26790,0,26790,66650,0,93440
141925102700000,NW 314,Residential,26741,0,26741,129185,0,155926
141925102800000,NW 314,Residential,28560,0,28560,122905,0,151465
141925102900000,NW 314,Residential,22624,0,22624,80967,0,103591
141925103000000,NW 314,Residential,22624,0,22624,88554,0,111178
141925103100000,NW 314,Residential,22624,0,22624,59635,0,82259
141925103200000,NW 314,Residential,22624,0,22624,78695,0,101319
141925103300000,NW 314,Residential,50050,0,50050,75813,0,125863
141925103400000,NW 314,Residential,26572,0,26572,104474,0,131046
141925200100000,NW 314,Residential,30854,0,30854,147898,0,178752
141925200200000,NW 314,Residential,26302,0,26302,64402,0,90704
141925200300000,NW 314,Residential,23205,0,23205,95694,0,118899
141925200400000,NW 314,Exempt,0,23205,23205,0,99982,123187
141925200500000,NW 314,Residential,23205,0,23205,82439,0,105644
141925200600000,NW 314,Residential,23205,0,23205,103611,0,126816
141925200700000,NW 314,Residential,24500,0,24500,89743,0,114243
141925200800000,NW 314,Residential,24500,0,24500,95278,0,119778
141925200900000,NW 314,Residential,24500,0,24500,93639,0,118139
141925201000000,NW 314,Residential,22995,0,22995,93980,0,116975
141925201100000,NW 314,Residential,7724,0,7724,276,0,8000
141925201300000,NW 314,Residential,54929,0,54929,124069,0,178998
141925201400000,NW 314,Residential,42952,0,42952,57624,0,100576
141925201500000,NW 314,Residential,28462,0,28462,57081,0,85543
141925201600000,NW 314,Residential,30131,0,30131,73439,0,103570
141925201700000,NW 314,Residential,31783,0,31783,115499,0,147282
141925201800000,NW 314,Residential,24157,0,24157,49009,0,73166
141925201900000,NW 314,Residential,30377,0,30377,63169,0,93546
141925202000000,NW 314,Residential,28171,0,28171,110585,0,138756
141925202100000,NW 314,Residential,31572,0,31572,112141,0,143713
141925202200000,NW 314,Residential,31515,0,31515,134082,0,165597
141925202300000,NW 314,Residential,35783,0,35783,67690,0,103473
141925202400000,NW 314,Residential,21604,0,21604,106311,0,127915
141925202500000,NW 314,Residential,20398,0,20398,92198,0,112596
141925202600000,NW 314,Residential,23134,0,23134,83729,0,106863
141925202700000,NW 314,Residential,23205,0,23205,94772,0,117977
141925202800000,NW 314,Residential,31973,0,31973,79444,0,111417
141925202900000,NW 314,Residential,53050,0,53050,24314,0,77364
141925203000000,NW 314,Residential,32000,0,32000,254,0,32254
141925203100000,NW 314,Residential,18900,0,18900,185480,0,204380
141925203200000,NW 314,Residential,41511,0,41511,97061,0,138572
141925203300000,NW 314,Residential,37192,0,37192,79980,0,117172
141925203400000,NW 314,Residential,46350,0,46350,67764,0,114114
141925203500000,NW 314,Residential,30235,0,30235,85136,0,115371
141927600100000,NW 308,Residential,45136,0,45136,54176,0,99312
141927600300000,NW 308,Residential,19845,0,19845,15625,0,35470
141927600400000,NW 308,Residential,17766,0,17766,68150,0,85916
141927600500000,NW 308,Residential,29016,0,29016,50658,0,79674
141927600600000,NW 308,Residential,20141,0,20141,122712,0,142853
141927600700000,APARTMENT,Commercial,0,16892,16892,0,151194,168086
141927600800000,APARTMENT,Commercial,0,20756,20756,0,180599,201355
141927600900000,NW 308,Residential,24890,0,24890,105146,0,130036
141927601000000,NW 308,Residential,30188,0,30188,92459,0,122647
141927601100000,NW 308,Residential,24675,0,24675,90638,0,115313
141927601200000,NW 308,Residential,23448,0,23448,90068,0,113516
141927601300000,NW 308,Residential,27245,0,27245,131921,0,159166
141927601400000,NW 308,Residential,26790,0,26790,100222,0,127012
141927601500000,NW 308,Residential,29431,0,29431,77054,0,106485
141927601600000,NW 308,Residential,24617,0,24617,111617,0,136234
141927601700000,NW 308,Residential,24888,0,24888,110343,0,135231
141927700100000,NW 308,Residential,22844,0,22844,88141,0,110985
141927700200000,NW 308,Residential,22747,0,22747,125926,0,148673
141927700300000,NW 308,Residential,23263,0,23263,96768,0,120031
141927700400000,NW 308,Residential,26340,0,26340,94356,0,120696
141927700500000,NW 308,Residential,27581,0,27581,54964,0,82545
141927700600000,NW 308,Residential,31824,0,31824,128984,0,160808
141927700700000,NW 308,Residential,27609,0,27609,95462,0,123071
141927700800000,NW 308,Residential,24508,0,24508,92882,0,117390
141927700900000,NW 308,Residential,25764,0,25764,103714,0,129478
141927701000000,NW 308,Residential,25748,0,25748,88721,0,114469
141927701100000,NW 308,Residential,25866,0,25866,83794,0,109660
141927701200000,NW 308,Residential,26135,0,26135,100030,0,126165
141927701300000,NW 308,Residential,25792,0,25792,109008,0,134800
141927701400000,NW 308,Residential,25792,0,25792,104116,0,129908
141927701500000,NW 308,Residential,26711,0,26711,100811,0,127522
141927800100000,NW 308,Residential,27083,0,27083,131051,0,158134
141927800200000,NW 308,Residential,31361,0,31361,137169,0,168530
141927900100000,NW 308,Residential,24608,0,24608,123588,0,148196
141927900200000,NW 308,Residential,82450,0,82450,0,0,82450
141927900300000,NW 308,Residential,83333,0,83333,219277,0,302610
141927900400000,NW 308,Residential,22565,0,22565,95301,0,117866
141927900500000,NW 308,Residential,22560,0,22560,98022,0,120582
141927900600000,NW 308,Residential,22560,0,22560,114804,0,137364
141927900700000,NW 308,Residential,22560,0,22560,100086,0,122646
141927900800000,NW 308,Residential,22853,0,22853,103313,0,126166
141927900900000,NW 308,Residential,22751,0,22751,83068,0,105819
141927901000000,NW 308,Residential,22560,0,22560,102387,0,124947
141927901100000,NW 308,Residential,22560,0,22560,94955,0,117515
141927901200000,NW 308,Residential,22560,0,22560,86708,0,109268
141927901300000,NW 308,Residential,22688,0,22688,95033,0,117721
141927901400000,NW 308,Residential,25023,0,25023,85459,0,110482
141927901500000,NW 308,Residential,24816,0,24816,96559,0,121375
141927901600000,NW 308,Residential,24816,0,24816,93503,0,118319
141927901700000,NW 308,Residential,24816,0,24816,94626,0,119442
141927901800000,NW 308,Residential,24946,0,24946,105183,0,130129
141927901900000,NW 308,Residential,22678,0,22678,88398,0,111076
141927902000000,NW 308,Residential,22560,0,22560,80876,0,103436
141927902100000,NW 308,Residential,22560,0,22560,89951,0,112511
141927902200000,NW 308,Residential,22560,0,22560,84662,0,107222
141927902300000,NW 308,Residential,22846,0,22846,79575,0,102421
141927902400000,SCHOOL,Exempt,0,0,0,0,0,0
141927902500000,NW 308,Residential,29425,0,29425,149650,0,179075
141927902600000,NW 308,Residential,27445,0,27445,179192,0,206637
141927902700000,NW 308,Residential,28566,0,28566,141023,0,169589
141927902800000,NW 308,Residential,28566,0,28566,144537,0,173103
141927902900000,NW 308,Residential,28566,0,28566,147182,0,175748
141927903000000,NW 308,Residential,27659,0,27659,116996,0,144655
141927903100000,NW 308,Residential,22955,0,22955,99376,0,122331
141927903200000,NW 308,Residential,23280,0,23280,105249,0,128529
141927903300000,NW 308,Residential,23280,0,23280,111127,0,134407
141927903400000,NW 308,Residential,23280,0,23280,109747,0,133027
141927903500000,NW 308,Residential,23280,0,23280,126981,0,150261
141928000100000,NW 308,Residential,29260,0,29260,144611,0,173871
141928000200000,NW 308,Residential,30589,0,30589,209577,0,240166
141928100100000,NW 308,Residential,29695,0,29695,185745,0,215440
141930100100000,NW 308,Residential,29743,0,29743,149858,0,179601
141930100200000,NW 308,Residential,31634,0,31634,173964,0,205598
141930100300000,NW 308,Residential,33322,0,33322,145498,0,178820
141930100400000,NW 308,Residential,34793,0,34793,182534,0,217327
141930100500000,NW 308,Residential,23520,0,23520,137561,0,161081
141930100600000,NW 308,Residential,37634,0,37634,99019,0,136653
141930100700000,NW 308,Residential,37961,0,37961,50235,0,88196
141930100800000,NW 308,Residential,38288,0,38288,63611,0,101899
141930100900000,NW 308,Residential,38288,0,38288,79153,0,117441
141930101000000,NW 308,Residential,63550,0,63550,238854,0,302404
141930101100000,NW 308,Residential,38288,0,38288,91596,0,129884
141930101200000,NW 308,Residential,39011,0,39011,117181,0,156192
141930101300000,NW 308,Residential,30683,0,30683,85683,0,116366
141930101400000,NW 308,Residential,27741,0,27741,130733,0,158474
141930101500000,NW 308,Residential,27300,0,27300,100603,0,127903
141930101600000,NW 308,Residential,29274,0,29274,118466,0,147740
141930200100000,NW 308,Residential,21132,0,21132,120024,0,141156
141930200200000,NW 308,Residential,24561,0,24561,97953,0,122514
141930200300000,NW 308,Residential,24561,0,24561,107225,0,131786
141930200400000,NW 308,Residential,24561,0,24561,106132,0,130693
141930200500000,NW 308,Residential,24399,0,24399,100989,0,125388
141930200600000,NW 308,Residential,52957,0,52957,62341,0,115298
141930200700000,NW 308,Residential,23086,0,23086,117457,0,140543
141930200800000,NW 308,Residential,24798,0,24798,113442,0,138240
141930200900000,NW 308,Residential,24931,0,24931,96366,0,121297
141930201000000,NW 308,Residential,30623,0,30623,126848,0,157471
141930201100000,NW 308,Residential,31864,0,31864,152174,0,184038
141930201200000,NW 308,Residential,31521,0,31521,62897,0,94418
141930201300000,NW 308,Residential,31621,0,31621,62893,0,94514
141930201400000,NW 308,Residential,27767,0,27767,100242,0,128009
141930201500000,NW 308,Residential,28747,0,28747,112202,0,140949
141930201600000,NW 308,Residential,27245,0,27245,108439,0,135684
141930201700000,NW 308,Residential,27443,0,27443,97459,0,124902
141930201800000,NW 308,Residential,27229,0,27229,130674,0,157903
141930201900000,NW 308,Residential,26166,0,26166,96343,0,122509
141930202000000,NW 308,Residential,27254,0,27254,110322,0,137576
141930202100000,NW 308,Residential,30192,0,30192,173274,0,203466
141930202200000,NW 308,Residential,61650,0,61650,63844,0,125494
141930202300000,NW 308,Residential,58425,0,58425,69062,0,127487
141930202400000,NW 308,Residential,27232,0,27232,65616,0,92848
141930202500000,NW 308,Residential,25148,0,25148,46429,0,71577
141930202600000,NW 308,Residential,27306,0,27306,91480,0,118786
141930202700000,NW 308,Residential,37730,0,37730,43450,0,81180
141930202800000,NW 308,Residential,24239,0,24239,105864,0,130103
141930300100000,NW 308,Residential,24807,0,24807,123399,0,148206
141930300200000,NW 308,Residential,24807,0,24807,122214,0,147021
141930300300000,NW 308,Residential,24807,0,24807,126374,0,151181
141930300400000,NW 308,Residential,25345,0,25345,109655,0,135000
141930300500000,NW 308,Residential,24807,0,24807,118315,0,143122
141930300600000,NW 308,Residential,25389,0,25389,118936,0,144325
141930300700000,NW 323,Residential,31945,0,31945,159822,0,191767
141930300800000,NW 323,Residential,33035,0,33035,153276,0,186311
141930300900000,NW 323,Residential,28218,0,28218,119988,0,148206
141930301000000,NW 323,Residential,28200,0,28200,0,0,28200
141930301100000,NW 323,Residential,34448,0,34448,136640,0,171088
141930301200000,NW 323,Residential,33008,0,33008,133554,0,166562
141930301300000,NW 323,Residential,33132,0,33132,129411,0,162543
141930301400000,NW 323,Residential,31912,0,31912,141655,0,173567
141930301500000,NW 323,Residential,32797,0,32797,139934,0,172731
141930400100000,NW 323,Residential,32997,0,32997,116534,0,149531
141930400200000,NW 308,Residential,29400,0,29400,73517,0,102917
141930400300000,NW 308,Residential,29048,0,29048,65656,0,94704
141930400400000,NW 308,Residential,26013,0,26013,81363,0,107376
141930400500000,NW 308,Residential,26000,0,26000,104969,0,130969
141930400600000,NW 308,Residential,26000,0,26000,92034,0,118034
141930400700000,NW 308,Residential,26000,0,26000,106972,0,132972
141930400800000,NW 308,Residential,22572,0,22572,108677,0,131249
141930400900000,NW 308,Residential,22572,0,22572,105026,0,127598
141930401000000,NW 308,Residential,22572,0,22572,103129,0,125701
141930401100000,NW 308,Residential,22572,0,22572,106801,0,129373
141930401200000,NW 308,Residential,22536,0,22536,102449,0,124985
141930401300000,NW 308,Residential,30366,0,30366,0,0,30366
141930401400000,NW 308,Residential,31350,0,31350,0,0,31350
141930401500000,NW 323,Residential,29743,0,29743,119112,0,148855
141930401600000,NW 323,Residential,29760,0,29760,119485,0,149245
141930500100000,NW 323,Residential,30825,0,30825,176948,0,207773
141930500200000,NW 323,Residential,30455,0,30455,108457,0,138912
141930500300000,NW 323,Residential,29056,0,29056,122111,0,151167
141930500400000,NW 323,Residential,30400,0,30400,133790,0,164190
141930500500000,NW 323,Residential,30400,0,30400,144453,0,174853
141930500600000,NW 323,Residential,30400,0,30400,130155,0,160555
141930500700000,NW 323,Residential,30400,0,30400,115174,0,145574
141930500800000,NW 323,Residential,30381,0,30381,125644,0,156025
141930500900000,NW 308,Residential,23554,0,23554,96172,0,119726
141930501000000,NW 308,Residential,24172,0,24172,97025,0,121197
141930600100000,NW 308,Residential,20888,0,20888,101087,0,121975
141930600200000,NW 308,Residential,21560,0,21560,114765,0,136325
141932600100000,NW 308,Residential,31002,0,31002,107058,0,138060
141932700100000,NW 314,Residential,26565,0,26565,70858,0,97423
141932700200000,NW 314,Residential,30030,0,30030,120178,0,150208
141932800100000,NW 314,Residential,31131,0,31131,72087,0,103218
141932800200000,NW 314,Residential,28003,0,28003,86836,0,114839
141932800300000,NW 314,Residential,28813,0,28813,131370,0,160183
141932800400000,NW 314,Residential,28105,0,28105,53190,0,81295
141932900100000,NW 308,Residential,27767,0,27767,140295,0,168062
141932900200000,NW 314,Residential,26347,0,26347,178676,0,205023
141932900300000,NW 314,Residential,27972,0,27972,135636,0,163608
141932900400000,NW 314,Residential,30323,0,30323,104805,0,135128
141932900500000,NW 314,Residential,29307,0,29307,160075,0,189382
141932900600000,NW 314,Residential,28783,0,28783,139494,0,168277
141932900700000,NW 308,Residential,39619,0,39619,101225,0,140844
141932900800000,NW 308,Residential,34934,0,34934,22250,0,57184
141932900900000,NW 308,Residential,31080,0,31080,46635,0,77715
141933000200000,NW 314,Residential,39060,0,39060,84487,0,123547
141933000300000,NW 314,Residential,35000,0,35000,103962,0,138962
141933000400000,NW 314,Residential,24620,0,24620,32299,0,56919
141933000500000,NW 314,Residential,26478,0,26478,84475,0,110953
141933000600000,NW 314,Residential,24513,0,24513,102735,0,127248
141933000700000,NW 314,Residential,35131,0,35131,111655,0,146786
141933000800000,NW 314,Residential,28238,0,28238,105549,0,133787
141933000900000,NW 314,Residential,26701,0,26701,118643,0,145344
141933001000000,NW 314,Residential,30398,0,30398,169653,0,200051
141933001100000,NW 314,Residential,32875,0,32875,101270,0,134145
141933001200000,NW 314,Residential,32485,0,32485,208356,0,240841
141933001300000,NW 314,Residential,24000,0,24000,94727,0,118727
141933001400000,NW 314,Residential,25334,0,25334,85699,0,111033
141933001500000,NW 314,Residential,24563,0,24563,104692,0,129255
141933001600000,NW 314,Residential,24067,0,24067,85374,0,109441
141933001700000,NW 314,Residential,25536,0,25536,95566,0,121102
141933001800000,NW 314,Residential,26330,0,26330,83390,0,109720
141933001900000,NW 314,Residential,5242,0,5242,0,0,5242
141933002000000,NW 314,Residential,5564,0,5564,0,0,5564
141933002100000,NW 314,Residential,4440,0,4440,0,0,4440
141933002200000,NW 314,Residential,25763,0,25763,130079,0,155842
141933002300000,NW 314,Residential,30517,0,30517,95913,0,126430
141933002400000,NW 314,Residential,26676,0,26676,97549,0,124225
141933002500000,NW 314,Residential,24000,0,24000,103793,0,127793
141933002600000,NW 314,Residential,24000,0,24000,107633,0,131633
141933002700000,NW 314,Residential,24000,0,24000,92412,0,116412
141933002800000,NW 314,Residential,31640,0,31640,96945,0,128585
141933003100000,NW 314,Residential,31191,0,31191,77198,0,108389
141933003200000,NW 314,Residential,26520,0,26520,107980,0,134500
141933003300000,NW 314,Residential,31378,0,31378,116588,0,147966
141933003400000,NW 314,Residential,28816,0,28816,94722,0,123538
141933003500000,NW 314,Residential,36453,0,36453,130076,0,166529
141933003600000,NW 314,Residential,42325,0,42325,63285,0,105610
141933003700000,NW 314,Residential,36000,0,36000,197006,0,233006
141933003800000,NW 314,Residential,34320,0,34320,56535,0,90855
141933003900000,NW 314,Residential,29814,0,29814,139186,0,169000
141933004000000,NW 314,Residential,32562,0,32562,0,0,32562
141933004100000,NW 314,Residential,32300,0,32300,107224,0,139524
141933100100000,NW 314,Residential,26008,0,26008,91435,0,117443
141933100200000,NW 314,Residential,27152,0,27152,112738,0,139890
141933100300000,NW 314,Residential,26045,0,26045,86739,0,112784
141933100400000,NW 314,Residential,32130,0,32130,83643,0,115773
141933100500000,NW 314,Residential,43686,0,43686,0,0,43686
141933100600000,NW 314,Residential,26000,0,26000,75287,0,101287
141933100700000,NW 314,Residential,26000,0,26000,77343,0,103343
141933100800000,NW 314,Residential,26000,0,26000,86872,0,112872
141933100900000,NW 314,Residential,26000,0,26000,95543,0,121543
141933101000000,NW 314,Residential,24000,0,24000,78818,0,102818
141933200100000,NW 308,Residential,26600,0,26600,102633,0,129233
141933200200000,NW 308,Residential,26588,0,26588,108865,0,135453
141933200300000,NW 314,Residential,29400,0,29400,79246,0,108646
141933200400000,NW 314,Residential,30016,0,30016,81984,0,112000
141933200500000,NW 314,Residential,42595,0,42595,113873,0,156468
141933200600000,NW 314,Residential,28890,0,28890,124212,0,153102
141933200700000,NW 314,Residential,26000,0,26000,63669,0,89669
141933200800000,NW 314,Residential,39000,0,39000,88517,0,127517
141933200900000,NW 314,Residential,42490,0,42490,116697,0,159187
141933201000000,NW 314,Residential,33280,0,33280,95374,0,128654
141933201100000,NW 314,Residential,39000,0,39000,84459,0,123459
141933201200000,NW 314,Residential,34149,0,34149,83068,0,117217
141933201300000,NW 314,Residential,24507,0,24507,103879,0,128386
141933201400000,NW 314,Residential,24400,0,24400,91183,0,115583
141933201500000,NW 314,Residential,24400,0,24400,98142,0,122542
141933201600000,NW 314,Residential,26370,0,26370,99110,0,125480
141933201700000,NW 314,Residential,25116,0,25116,107954,0,133070
141933201800000,NW 314,Residential,24156,0,24156,97372,0,121528
141933201900000,NW 314,Residential,24156,0,24156,81674,0,105830
141933202000000,NW 314,Residential,24156,0,24156,84953,0,109109
141933202100000,NW 314,Residential,24156,0,24156,82903,0,107059
141933202200000,NW 314,Residential,26205,0,26205,80225,0,106430
141933202300000,NW 314,Residential,28000,0,28000,160496,0,188496
141933202400000,NW 314,Residential,26320,0,26320,128663,0,154983
141933202500000,NW 308,Residential,22996,0,22996,103167,0,126163
141933202600000,NW 308,Residential,22572,0,22572,99336,0,121908
141933300100000,NW 308,Residential,21560,0,21560,92348,0,113908
141933300200000,NW 308,Residential,22004,0,22004,93825,0,115829
141933300300000,NW 314,Residential,27720,0,27720,105404,0,133124
141933300400000,NW 314,Residential,27720,0,27720,107919,0,135639
141933300500000,NW 314,Residential,25895,0,25895,103954,0,129849
141933300600000,NW 314,Residential,24156,0,24156,73571,0,97727
141933300700000,NW 314,Residential,24156,0,24156,94179,0,118335
141933300800000,NW 314,Residential,24156,0,24156,99117,0,123273
141933300900000,NW 314,Residential,24156,0,24156,81653,0,105809
141933301000000,NW 314,Residential,24973,0,24973,93427,0,118400
141935100300000,CHURCH,Exempt,0,1708,1708,0,0,1708
141935100400000,NW 322,Residential,1525,0,1525,0,0,1525
141935101100000,FUNERAL HOME,Commercial,0,335340,335340,0,387542,722882
141935101200000,NW 324,Residential,2530,0,2530,1016,0,3546
141935101300000,NW 324,Residential,26795,0,26795,119492,0,146287
141935101400000,NW 324,Residential,25200,0,25200,97897,0,123097
141935101500000,NW 324,Residential,25200,0,25200,112569,0,137769
141935101600000,NW 324,Residential,24906,0,24906,125094,0,150000
141935101700000,NW 324,Residential,24727,0,24727,110840,0,135567
141935101800000,APARTMENT,Commercial,0,30977,30977,0,146033,177010
141935101900000,NW 324,Residential,24913,0,24913,102520,0,127433
141935102000000,NW 324,Residential,23280,0,23280,109680,0,132960
141935102100000,NW 324,Residential,23280,0,23280,127726,0,151006
141935102200000,NW 324,Residential,23040,0,23040,93632,0,116672
141935102300000,NW 324,Residential,24939,0,24939,42061,0,67000
141935102400000,NW 324,Residential,24363,0,24363,102567,0,126930
141935102500000,NW 324,Residential,23040,0,23040,97620,0,120660
141935102600000,NW 324,Residential,23280,0,23280,80682,0,103962
141935102700000,NW 324,Residential,23280,0,23280,85141,0,108421
141935102800000,NW 324,Residential,24337,0,24337,78324,0,102661
141935102900000,APARTMENT,Commercial,0,20139,20139,0,116600,136739
141935103000000,APARTMENT,Commercial,0,17524,17524,0,114664,132188
141935103100000,OFFICE,Commercial,0,51876,51876,0,216975,268851
141935103200000,NW 324,Residential,23994,0,23994,101605,0,125599
141935103300000,NW 324,Residential,23280,0,23280,85284,0,108564
141935103400000,NW 324,Residential,23280,0,23280,100101,0,123381
141935103500000,NW 324,Residential,23280,0,23280,99082,0,122362
141935103600000,NW 324,Residential,24050,0,24050,105954,0,130004
141935103800000,CHURCH,Exempt,0,494208,494208,0,783535,1277743
141935200100000,SR/NURSING/ASSTD LIV,Commercial,0,307949,307949,0,3366694,3674643
141935200200000,SR/NURSING/ASSTD LIV,Commercial,0,336960,336960,0,3614087,3951047
141935200300000,NW 324,Residential,56737,0,56737,129469,0,186206
141935200400000,SR/NURSING/ASSTD LIV,Commercial,0,355104,355104,0,2578973,2934077
141935200500000,NW 324,Residential,31351,0,31351,73530,0,104881
141935200600000,SHOP,Commercial,0,160186,160186,0,348711,508897
141935200700000,CONVENIENCE STORE,Commercial,0,256284,256284,0,601094,857378
141935200800000,CHURCH,Exempt,0,806760,806760,0,429812,1236572
141935200900000,NW 324,Residential,29441,0,29441,122501,0,151942
141935201000000,OFFICE,Commercial,0,160186,160186,0,794196,954382
141935201100000,OFFICE,Commercial,0,171245,171245,0,791818,963063
141935201200000,MISCELLANEOUS,Commercial,0,80196,80196,0,14396,94592
141937600100000,NW 322,Residential,25753,0,25753,99864,0,125617
141937600200000,NW 323,Residential,30746,0,30746,172546,0,203292
141937600300000,NW 323,Residential,31744,0,31744,154193,0,185937
141937600400000,NW 323,Residential,31944,0,31944,137720,0,169664
141937600500000,NW 323,Residential,32864,0,32864,126349,0,159213
141937600600000,NW 323,Residential,32956,0,32956,152581,0,185537
141937600700000,NW 323,Residential,37664,0,37664,141310,0,178974
141937600800000,NW 323,Residential,31659,0,31659,150086,0,181745
141937600900000,NW 323,Residential,35182,0,35182,185941,0,221123
141937601000000,NW 323,Residential,37054,0,37054,186961,0,224015
141937601100000,NW 323,Residential,30659,0,30659,165788,0,196447
141937601200000,NW 323,Residential,28224,0,28224,157987,0,186211
141937601300000,NW 323,Residential,34301,0,34301,140546,0,174847
141937601400000,NW 323,Residential,94650,0,94650,216273,0,310923
141937601500000,NW 323,Residential,34259,0,34259,181735,0,215994
141937601600000,NW 323,Residential,34381,0,34381,155807,0,190188
141937601700000,NW 323,Residential,33962,0,33962,139478,0,173440
141937601800000,NW 323,Residential,33640,0,33640,137493,0,171133
141937601900000,NW 323,Residential,32680,0,32680,158537,0,191217
141937602000000,NW 323,Residential,28030,0,28030,174597,0,202627
141937602100000,NW 323,Residential,30045,0,30045,139991,0,170036
141937602200000,NW 323,Residential,32023,0,32023,135989,0,168012
141937602300000,NW 323,Residential,28281,0,28281,174135,0,202416
141937602400000,NW 322,Residential,25287,0,25287,97540,0,122827
141937602500000,NW 322,Residential,25371,0,25371,102317,0,127688
141937602600000,NW 323,Residential,28534,0,28534,124057,0,152591
141937602700000,NW 323,Residential,32995,0,32995,132205,0,165200
141937602800000,NW 323,Residential,32203,0,32203,140635,0,172838
141937602900000,NW 323,Residential,32292,0,32292,131332,0,163624
141937603000000,NW 323,Residential,31087,0,31087,125910,0,156997
141937603100000,NW 323,Residential,30871,0,30871,138315,0,169186
141937603200000,NW 323,Residential,30492,0,30492,122701,0,153193
141937603300000,NW 323,Residential,31040,0,31040,126880,0,157920
141937603400000,NW 323,Residential,31360,0,31360,128070,0,159430
141937603500000,NW 323,Residential,31680,0,31680,144780,0,176460
141937603600000,NW 323,Residential,31040,0,31040,110953,0,141993
141937603700000,NW 323,Residential,31040,0,31040,126240,0,157280
141937603800000,NW 323,Residential,31040,0,31040,127690,0,158730
141937700100000,NW 322,Residential,23921,0,23921,111314,0,135235
141937700200000,NW 322,Residential,23668,0,23668,101470,0,125138
141937700300000,NW 322,Residential,25303,0,25303,104162,0,129465
141937700400000,NW 322,Residential,23668,0,23668,87972,0,111640
141937700500000,NW 322,Residential,25303,0,25303,121516,0,146819
141937700600000,NW 322,Residential,23668,0,23668,106658,0,130326
141937700700000,NW 322,Residential,23668,0,23668,92735,0,116403
141937700800000,NW 322,Residential,23668,0,23668,94549,0,118217
141937701000000,NW 322,Residential,23668,0,23668,105856,0,129524
141937701100000,NW 322,Residential,24092,0,24092,100427,0,124519
141937701200000,NW 322,Residential,35248,0,35248,96750,0,131998
141937800100000,NW 323,Residential,30080,0,30080,137767,0,167847
141937800200000,NW 323,Residential,29328,0,29328,117286,0,146614
141937800300000,NW 323,Residential,29328,0,29328,122284,0,151612
141937800400000,NW 323,Residential,29640,0,29640,145578,0,175218
141937800500000,NW 323,Residential,29952,0,29952,167854,0,197806
141937800600000,NW 323,Residential,30264,0,30264,155627,0,185891
141937800700000,NW 323,Residential,31266,0,31266,142845,0,174111
141937800800000,NW 323,Residential,30968,0,30968,147485,0,178453
141937800900000,NW 323,Residential,31733,0,31733,149607,0,181340
141937801000000,NW 323,Residential,33280,0,33280,170605,0,203885
141937801100000,NW 323,Residential,32969,0,32969,130380,0,163349
141937801200000,NW 323,Residential,33600,0,33600,131449,0,165049
141937801300000,NW 323,Exempt,0,32272,32272,0,143848,176120
141937801400000,NW 322,Residential,25446,0,25446,95790,0,121236
141937801500000,NW 322,Residential,26673,0,26673,87793,0,114466
141937900100000,NW 322,Residential,22295,0,22295,77713,0,100008
141937900200000,NW 322,Residential,22295,0,22295,73855,0,96150
141937900300000,NW 322,Residential,23436,0,23436,87557,0,110993
141937900400000,NW 322,Residential,23436,0,23436,72234,0,95670
141937900500000,NW 322,Residential,24039,0,24039,88729,0,112768
141937900600000,NW 322,Residential,25443,0,25443,93114,0,118557
141937900700000,NW 322,Residential,25695,0,25695,121680,0,147375
141937900800000,NW 322,Residential,26460,0,26460,98578,0,125038
141937900900000,NW 322,Residential,26816,0,26816,119951,0,146767
141937901000000,NW 322,Residential,24710,0,24710,94056,0,118766
141937901100000,NW 322,Residential,24816,0,24816,104374,0,129190
141937901200000,NW 322,Residential,25128,0,25128,89574,0,114702
141937901300000,NW 322,Residential,24502,0,24502,91799,0,116301
141937901400000,NW 322,Residential,25792,0,25792,77004,0,102796
141937901500000,NW 322,Residential,24010,0,24010,81776,0,105786
141937901600000,NW 322,Residential,22295,0,22295,101388,0,123683
141937901700000,NW 322,Residential,24010,0,24010,94007,0,118017
141937901800000,NW 322,Residential,25725,0,25725,87895,0,113620
141937901900000,NW 322,Residential,25200,0,25200,89535,0,114735
141937902000000,NW 322,Residential,24570,0,24570,74215,0,98785
141937902100000,NW 322,Residential,24336,0,24336,74652,0,98988
141937902200000,NW 322,Residential,25143,0,25143,111855,0,136998
141937902300000,NW 322,Residential,25200,0,25200,119114,0,144314
141937902400000,NW 322,Residential,25365,0,25365,74781,0,100146
141938000100000,NW 322,Residential,26229,0,26229,110256,0,136485
141938000200000,NW 322,Residential,24570,0,24570,79853,0,104423
141938000300000,NW 322,Residential,24852,0,24852,80377,0,105229
141938000400000,NW 322,Residential,23206,0,23206,93214,0,116420
141938000500000,NW 322,Residential,22848,0,22848,111209,0,134057
141938000600000,NW 322,Residential,22901,0,22901,84510,0,107411
141938000700000,NW 322,Residential,27300,0,27300,95389,0,122689
141938000800000,NW 322,Residential,25944,0,25944,97086,0,123030
141938000900000,NW 322,Residential,42206,0,42206,117237,0,159443
141938001000000,NW 322,Residential,25920,0,25920,95267,0,121187
141938001100000,NW 322,Residential,27305,0,27305,100498,0,127803
141938001200000,NW 322,Residential,27359,0,27359,94095,0,121454
141938001300000,NW 322,Residential,24478,0,24478,98082,0,122560
141938001400000,NW 322,Residential,22560,0,22560,89258,0,111818
141938001500000,NW 322,Residential,22800,0,22800,84138,0,106938
141938001600000,NW 322,Residential,23520,0,23520,85297,0,108817
141938001700000,NW 322,Residential,24618,0,24618,88684,0,113302
141938001800000,NW 322,Residential,22295,0,22295,92508,0,114803
141938001900000,NW 322,Residential,22295,0,22295,69047,0,91342
141938002000000,NW 322,Residential,22295,0,22295,92134,0,114429
141938002100000,NW 322,Residential,22295,0,22295,74525,0,96820
141938002200000,NW 322,Residential,22295,0,22295,89832,0,112127
141938002300000,NW 322,Residential,22295,0,22295,85347,0,107642
141938002400000,NW 322,Residential,23330,0,23330,75658,0,98988
141938002500000,NW 322,Residential,35666,0,35666,77332,0,112998
141938002600000,NW 322,Residential,22862,0,22862,84585,0,107447
141938002700000,NW 322,Residential,40653,0,40653,103032,0,143685
141940100100000,CITY PROPERTY,Exempt,0,0,0,0,0,0
141940100200000,NW 313,Residential,38400,0,38400,223491,0,261891
141940100300000,NW 313,Residential,32195,0,32195,219114,0,251309
141940100400000,NW 313,Residential,31973,0,31973,240437,0,272410
141940100500000,NW 313,Residential,36593,0,36593,216851,0,253444
141940100600000,NW 313,Residential,40949,0,40949,275171,0,316120
141940100700000,NW 313,Residential,37518,0,37518,269622,0,307140
141940100800000,NW 313,Residential,41312,0,41312,260688,0,302000
141940100900000,NW 313,Residential,40054,0,40054,292731,0,332785
141940101000000,NW 313,Residential,39924,0,39924,232505,0,272429
141940101100000,NW 313,Residential,46122,0,46122,245644,0,291766
141940101200000,NW 313,Residential,45562,0,45562,235875,0,281437
141940101300000,NW 313,Residential,45573,0,45573,217324,0,262897
141940101400000,NW 313,Residential,48466,0,48466,256534,0,305000
141940101500000,NW 313,Residential,41168,0,41168,235280,0,276448
141940101600000,NW 313,Residential,35700,0,35700,250119,0,285819
141940101700000,NW 313,Residential,34320,0,34320,110444,0,144764
141940101800000,NW 313,Residential,45696,0,45696,145255,0,190951
141940101900000,NW 313,Residential,38760,0,38760,120635,0,159395
141940102000000,NW 313,Residential,67040,0,67040,149302,0,216342
141940102100000,NW 313,Residential,40698,0,40698,105059,0,145757
141940102200000,NW 313,Residential,29640,0,29640,131891,0,161531
141940102300000,NW 313,Residential,30152,0,30152,126482,0,156634
141942600100000,NW 313,Residential,38206,0,38206,88843,0,127049
141942600200000,NW 313,Residential,27706,0,27706,117130,0,144836
141942600300000,NW 313,Residential,23205,0,23205,91224,0,114429
141942600400000,NW 313,Residential,24798,0,24798,119633,0,144431
141942600500000,NW 313,Residential,25253,0,25253,103915,0,129168
141942600600000,NW 313,Residential,43819,0,43819,38006,0,81825
141942600700000,NW 313,Residential,24379,0,24379,0,0,24379
141942600800000,NW 313,Residential,27527,0,27527,138272,0,165799
141942600900000,NW 313,Residential,33385,0,33385,57426,0,90811
141942601000000,NW 313,Residential,29400,0,29400,118096,0,147496
141942601100000,NW 313,Residential,30975,0,30975,129179,0,160154
141942601200000,NW 313,Residential,50710,0,50710,94932,0,145642
141942601300000,NW 313,Residential,30085,0,30085,89869,0,119954
141942601400000,NW 313,Residential,31518,0,31518,108726,0,140244
141942601500000,NW 313,Residential,39039,0,39039,104443,0,143482
141942700100000,NW 313,Residential,35640,0,35640,50793,0,86433
141942700200000,NW 313,Residential,48200,0,48200,58228,0,106428
141942700300000,NW 313,Residential,34116,0,34116,78017,0,112133
141942700400000,NW 313,Residential,51600,0,51600,138288,0,189888
141942700500000,NW 313,Residential,39060,0,39060,520,0,39580
141942700600000,NW 313,Residential,60550,0,60550,125167,0,185717
141942700700000,NW 313,Residential,60300,0,60300,97364,0,157664
141942700800000,NW 313,Residential,37217,0,37217,125892,0,163109
141942700900000,NW 313,Residential,34336,0,34336,102128,0,136464
141942701000000,NW 313,Residential,32760,0,32760,57439,0,90199
141942701100000,NW 313,Residential,31024,0,31024,202270,0,233294
141942701200000,NW 313,Residential,28189,0,28189,141811,0,170000
141942701300000,NW 313,Residential,28420,0,28420,127043,0,155463
141942701400000,NW 308,Residential,30166,0,30166,0,0,30166
141942701500000,NW 308,Residential,15162,0,15162,0,0,15162
141942701600000,NW 308,Residential,33755,0,33755,135599,0,169354
141942701700000,NW 313,Residential,33271,0,33271,149945,0,183216
141942701800000,NW 313,Residential,25438,0,25438,170871,0,196309
141942701900000,NW 313,Residential,24330,0,24330,104551,0,128881
141942702000000,NW 313,Residential,20518,0,20518,0,0,20518
141942702100000,NW 313,Residential,20160,0,20160,0,0,20160
141942702200000,NW 308,Residential,20790,0,20790,108594,0,129384
141942800100000,NW 313,Residential,41623,0,41623,141766,0,183389
141942800200000,NW 313,Residential,25956,0,25956,113900,0,139856
141942800300000,NW 313,Residential,45433,0,45433,103248,0,148681
141942800400000,NW 313,Residential,42546,0,42546,106662,0,149208
141942800500000,NW 313,Residential,31083,0,31083,83370,0,114453
141942800600000,NW 313,Residential,29686,0,29686,91912,0,121598
141942800700000,NW 313,Residential,30492,0,30492,95281,0,125773
141942800800000,NW 313,Residential,46150,0,46150,98140,0,144290
141942800900000,NW 313,Residential,43286,0,43286,39149,0,82435
141942801000000,NW 313,Residential,32602,0,32602,112247,0,144849
141942801100000,NW 313,Residential,30479,0,30479,134557,0,165036
141942801200000,NW 313,Residential,39263,0,39263,122873,0,162136
141942801300000,NW 313,Residential,31914,0,31914,127608,0,159522
141942801400000,NW 313,Residential,28413,0,28413,113777,0,142190
141942801500000,NW 313,Residential,29307,0,29307,63584,0,92891
141942801600000,NW 313,Residential,31480,0,31480,225346,0,256826
141942801700000,NW 313,Residential,27440,0,27440,102318,0,129758
141942900100000,NW 313,Residential,22068,0,22068,130389,0,152457
141942900200000,NW 308,Residential,20136,0,20136,129488,0,149624
141942900300000,NW 308,Residential,22973,0,22973,77225,0,100198
141942900400000,NW 308,Residential,25749,0,25749,69851,0,95600
141942900500000,NW 313,Residential,25222,0,25222,99301,0,124523
141942900600000,NW 313,Residential,21056,0,21056,100237,0,121293
141942900700000,NW 313,Residential,22176,0,22176,96738,0,118914
141943000100000,NW 308,Residential,26418,0,26418,139792,0,166210
141943000200000,NW 308,Residential,24807,0,24807,131117,0,155924
141943000300000,NW 308,Residential,24807,0,24807,122316,0,147123
141943000400000,NW 323,Residential,32747,0,32747,142161,0,174908
141943000500000,NW 323,Residential,33164,0,33164,172495,0,205659
141943000600000,NW 323,Residential,33592,0,33592,0,0,33592
141943000700000,NW 313,Residential,27506,0,27506,118043,0,145549
141943000800000,NW 313,Residential,28495,0,28495,119339,0,147834
141943000900000,NW 313,Residential,28994,0,28994,128992,0,157986
141945100100000,NW 313,Residential,32278,0,32278,108339,0,140617
141945100200000,NW 313,Residential,30361,0,30361,105916,0,136277
141945100300000,NW 313,Residential,31122,0,31122,97789,0,128911
141945100400000,NW 322,Residential,32257,0,32257,107687,0,139944
141945100500000,NW 322,Residential,30141,0,30141,112521,0,142662
141945100600000,NW 322,Residential,22400,0,22400,104307,0,126707
141945100700000,NW 322,Residential,21933,0,21933,113043,0,134976
141945100800000,NW 322,Residential,24811,0,24811,84954,0,109765
141945100900000,NW 322,Residential,25312,0,25312,79747,0,105059
141945101000000,NW 322,Residential,24663,0,24663,118934,0,143597
141945101100000,NW 322,Residential,50000,0,50000,187609,0,237609
141945200100000,NW 313,Residential,33784,0,33784,94015,0,127799
141945200200000,NW 313,Residential,31500,0,31500,94388,0,125888
141945200300000,NW 313,Residential,28093,0,28093,116754,0,144847
141945200400000,NW 313,Residential,28993,0,28993,146952,0,175945
141945200500000,NW 313,Residential,26849,0,26849,82433,0,109282
141945200600000,NW 322,Residential,28613,0,28613,150382,0,178995
141945200700000,NW 322,Residential,26215,0,26215,0,0,26215
141945200800000,NW 322,Residential,41639,0,41639,56883,0,98522
141945200900000,NW 322,Residential,28552,0,28552,103255,0,131807
141945201000000,NW 322,Residential,29180,0,29180,99949,0,129129
141945201100000,NW 313,Residential,41920,0,41920,79926,0,121846
141945300100000,NW 322,Residential,30510,0,30510,84289,0,114799
141945300200000,NW 322,Residential,27930,0,27930,84916,0,112846
141945300300000,NW 322,Residential,28938,0,28938,88958,0,117896
141945300400000,NW 322,Residential,27685,0,27685,112718,0,140403
141945300500000,NW 322,Residential,27440,0,27440,77028,0,104468
141945300600000,NW 322,Residential,27504,0,27504,137319,0,164823
141945300700000,NW 322,Residential,31298,0,31298,135254,0,166552
141945300800000,NW 322,Residential,29568,0,29568,114231,0,143799
141945300900000,NW 322,Residential,26880,0,26880,123602,0,150482
141945301000000,NW 322,Residential,26880,0,26880,97734,0,124614
141945301100000,NW 322,Residential,28575,0,28575,112963,0,141538
141945301200000,NW 323,Residential,32879,0,32879,138938,0,171817
141945301300000,NW 323,Residential,31620,0,31620,139248,0,170868
141945301400000,NW 323,Residential,31620,0,31620,135365,0,166985
141945301500000,NW 323,Residential,31620,0,31620,135485,0,167105
141945301600000,NW 323,Residential,32075,0,32075,141539,0,173614
141945301700000,NW 323,Residential,36337,0,36337,144611,0,180948
141945301800000,NW 323,Residential,36749,0,36749,146430,0,183179
141945301900000,NW 323,Residential,38719,0,38719,150022,0,188741
141945302000000,NW 323,Residential,34218,0,34218,151808,0,186026
141945302100000,NW 323,Residential,33627,0,33627,146324,0,179951
141945302200000,NW 323,Residential,28777,0,28777,129006,0,157783
141945302300000,NW 323,Residential,29328,0,29328,132731,0,162059
141945302400000,NW 323,Residential,30080,0,30080,129675,0,159755
141945400100000,NW 323,Residential,31040,0,31040,145015,0,176055
141945400200000,NW 323,Residential,31040,0,31040,141940,0,172980
141945400300000,NW 323,Residential,31040,0,31040,144432,0,175472
141945400400000,NW 323,Residential,30400,0,30400,131052,0,161452
141945400500000,NW 323,Residential,30400,0,30400,112410,0,142810
141945400600000,NW 323,Residential,32948,0,32948,128503,0,161451
141945400700000,NW 323,Residential,33657,0,33657,151392,0,185049
141945400800000,NW 323,Residential,31041,0,31041,0,0,31041
141945400900000,NW 323,Residential,31040,0,31040,130994,0,162034
141945401000000,NW 323,Residential,31040,0,31040,114645,0,145685
141945500100000,NW 322,Residential,49240,0,49240,82676,0,131916
141945500200000,NW 322,Residential,48360,0,48360,0,0,48360
141945500300000,CITY PROPERTY,Exempt,0,0,0,0,0,0
141945500400000,NW 322,Residential,42706,0,42706,119920,0,162626
141945600100000,NW 322,Residential,29978,0,29978,121890,0,151868
141945600200000,NW 322,Residential,22560,0,22560,118264,0,140824
141945600300000,NW 322,Residential,25004,0,25004,107466,0,132470
141945600400000,NW 322,Residential,24705,0,24705,91701,0,116406
141945600500000,NW 322,Residential,24864,0,24864,109257,0,134121
141945600600000,NW 322,Residential,24651,0,24651,100393,0,125044
141945600700000,NW 322,Residential,25133,0,25133,135307,0,160440
141945600800000,NW 322,Residential,24598,0,24598,140587,0,165185
141945600900000,NW 322,Residential,25088,0,25088,115102,0,140190
141945601000000,NW 322,Residential,24354,0,24354,112624,0,136978
141945601100000,NW 322,Residential,23558,0,23558,102228,0,125786
141945601200000,NW 322,Residential,23995,0,23995,112481,0,136476
141945601300000,NW 322,Residential,24624,0,24624,84645,0,109269
141945601400000,NW 322,Residential,25142,0,25142,81413,0,106555
141945601500000,NW 322,Residential,25142,0,25142,91431,0,116573
141945601600000,NW 322,Residential,24541,0,24541,95405,0,119946
141945601700000,CITY PROPERTY,Exempt,0,0,0,0,0,0
141945601800000,NW 322,Residential,29680,0,29680,76521,0,106201
141945601900000,NW 322,Residential,22750,0,22750,92710,0,115460
141945602000000,NW 322,Residential,26775,0,26775,91464,0,118239
141945602100000,NW 322,Residential,38274,0,38274,102002,0,140276
141945602200000,NW 322,Residential,39019,0,39019,102242,0,141261
141945602300000,NW 322,Residential,28560,0,28560,98486,0,127046
141945700100000,NW 322,Residential,25659,0,25659,87054,0,112713
141945700200000,NW 322,Residential,24909,0,24909,65747,0,90656
141945700300000,NW 322,Residential,24909,0,24909,106416,0,131325
141945700400000,NW 322,Residential,34138,0,34138,109389,0,143527
141945700500000,NW 322,Residential,24909,0,24909,87393,0,112302
141945700600000,NW 322,Residential,22295,0,22295,75512,0,97807
141945700700000,NW 322,Residential,21609,0,21609,71467,0,93076
141947600100000,NW 312,Residential,26192,0,26192,108053,0,134245
141947600200000,NW 312,Residential,25650,0,25650,108548,0,134198
141947600300000,NW 312,Residential,26836,0,26836,137649,0,164485
141947600400000,NW 312,Residential,29120,0,29120,127074,0,156194
141947600500000,NW 312,Residential,26316,0,26316,132471,0,158787
141947600600000,NW 312,Residential,26316,0,26316,145748,0,172064
141947600700000,NW 312,Residential,29361,0,29361,142991,0,172352
141947600800000,NW 312,Residential,30843,0,30843,144157,0,175000
141947600900000,NW 312,Residential,28744,0,28744,116577,0,145321
141947601000000,NW 312,Residential,29030,0,29030,134745,0,163775
141947601100000,NW 312,Residential,29006,0,29006,133821,0,162827
141947601200000,NW 312,Residential,27090,0,27090,147337,0,174427
141947601300000,NW 312,Residential,27090,0,27090,111367,0,138457
141947601400000,NW 312,Residential,27090,0,27090,119129,0,146219
141947601500000,NW 312,Residential,27090,0,27090,131041,0,158131
141947601600000,NW 312,Residential,25908,0,25908,66544,0,92452
141947601700000,NW 312,Residential,26561,0,26561,94509,0,121070
141947601800000,NW 322,Residential,28560,0,28560,84920,0,113480
141947601900000,NW 322,Residential,28672,0,28672,85108,0,113780
141947602000000,NW 322,Residential,41720,0,41720,69131,0,110851
141947602100000,CHURCH,Exempt,0,229500,229500,0,212738,442238
141947700100000,NW 322,Residential,50400,0,50400,115562,0,165962
141947700200000,NW 322,Residential,50400,0,50400,126717,0,177117
141947700300000,CHURCH,Exempt,0,416286,416286,0,462193,878479
141947800100000,NW 322,Residential,42315,0,42315,150413,0,192728
141947800200000,NW 322,Residential,35781,0,35781,57154,0,92935
141947800300000,NW 322,Residential,49200,0,49200,73025,0,122225
141947800400000,NW 322,Residential,28140,0,28140,89366,0,117506
141947800500000,NW 322,Residential,32830,0,32830,76972,0,109802
141947800600000,NW 322,Residential,26282,0,26282,88963,0,115245
141947800700000,NW 322,Residential,24476,0,24476,100496,0,124972
141947800800000,NW 322,Residential,25253,0,25253,90750,0,116003
141947800900000,NW 322,Residential,29672,0,29672,108479,0,138151
141947801000000,NW 322,Residential,26224,0,26224,107499,0,133723
141947801100000,NW 322,Residential,33939,0,33939,68774,0,102713
141947900100000,CITY PROPERTY,Exempt,0,0,0,0,0,0
141947900200000,NW 322,Residential,65250,0,65250,140848,0,206098
141947900300000,NW 322,Residential,46425,0,46425,145719,0,192144
141947900400000,NW 322,Residential,43750,0,43750,73520,0,117270
141947900500000,NW 322,Residential,28498,0,28498,112000,0,140498
141947900600000,NW 322,Residential,30412,0,30412,65972,0,96384
141947900700000,NW 322,Residential,26211,0,26211,145422,0,171633
141947900800000,NW 322,Residential,26211,0,26211,101414,0,127625
141947900900000,NW 322,Residential,27563,0,27563,145554,0,173117
141947901000000,NW 322,Residential,31237,0,31237,60665,0,91902
141947901100000,NW 322,Residential,41326,0,41326,96738,0,138064
142010100100000,CITY PROPERTY,Exempt,0,0,0,0,0,0
142010100200000,NW 310,Residential,32000,0,32000,0,0,32000
142010100300000,NW 310,Residential,38800,0,38800,0,0,38800
142010100400000,CITY PROPERTY,Exempt,0,0,0,0,0,0
142010100500000,NW 310,Residential,43470,0,43470,0,0,43470
142010100600000,CITY PROPERTY,Exempt,0,0,0,0,0,0
142010100700000,NW 310,Residential,32093,0,32093,0,0,32093
142010100800000,NW 310,Residential,14976,0,14976,37068,0,52044
142010100900000,NW 310,Residential,10920,0,10920,24902,0,35822
142010101000000,NW 310,Residential,10193,0,10193,19833,0,30026
142010101100000,CITY PROPERTY,Exempt,0,0,0,0,0,0
142010101200000,NW 310,Residential,39567,0,39567,58253,0,97820
142010200100000,CITY PROPERTY,Exempt,0,0,0,0,0,0
142010200200000,CITY PROPERTY,Exempt,0,0,0,0,0,0
142010300100000,CITY PROPERTY,Exempt,0,0,0,0,0,0
142010300200000,NW 310,Residential,13686,0,13686,0,0,13686
142010300300000,CITY PROPERTY,Exempt,0,0,0,0,0,0
142010300400000,CITY PROPERTY,Exempt,0,0,0,0,0,0
142010300500000,CITY PROPERTY,Exempt,0,0,0,0,0,0
142010300600000,CITY PROPERTY,Exempt,0,0,0,0,0,0
142010300700000,NW 310,Residential,19800,0,19800,0,0,19800
142010300800000,CITY PROPERTY,Exempt,0,0,0,0,0,0
142010300900000,CITY PROPERTY,Exempt,0,0,0,0,0,0
142010301000000,CITY PROPERTY,Exempt,0,0,0,0,0,0
142010301100000,CITY PROPERTY,Exempt,0,0,0,0,0,0
142010301200000,CITY PROPERTY,Exempt,0,0,0,0,0,0
142010301300000,CITY PROPERTY,Exempt,0,0,0,0,0,0
142010301400000,CITY PROPERTY,Exempt,0,0,0,0,0,0
142010301500000,CITY PROPERTY,Exempt,0,0,0,0,0,0
142010400100000,CITY PROPERTY,Exempt,0,0,0,0,0,0
142010400200000,NW 310,Residential,11880,0,11880,43158,0,55038
142010400300000,CITY PROPERTY,Exempt,0,0,0,0,0,0
142010400400000,CITY PROPERTY,Exempt,0,0,0,0,0,0
142010400500000,CITY PROPERTY,Exempt,0,0,0,0,0,0
142010400600000,CITY PROPERTY,Exempt,0,0,0,0,0,0
142010400700000,CITY PROPERTY,Exempt,0,0,0,0,0,0
142010400800000,CITY PROPERTY,Exempt,0,0,0,0,0,0
142010400900000,NW 310,Residential,19800,0,19800,0,0,19800
142010401000000,NW 310,Residential,10740,0,10740,0,0,10740
142010401100000,CITY PROPERTY,Exempt,0,0,0,0,0,0
142010401200000,CITY PROPERTY,Exempt,0,0,0,0,0,0
142010401300000,CITY PROPERTY,Exempt,0,0,0,0,0,0
142010401400000,CITY PROPERTY,Exempt,0,0,0,0,0,0
142010401500000,CITY PROPERTY,Exempt,0,0,0,0,0,0
142010401600000,CITY PROPERTY,Exempt,0,0,0,0,0,0
142010401700000,CITY PROPERTY,Exempt,0,0,0,0,0,0
142010401800000,CITY PROPERTY,Exempt,0,0,0,0,0,0
142010401900000,CITY PROPERTY,Exempt,0,0,0,0,0,0
142010402000000,NW 310,Residential,11880,0,11880,0,0,11880
142010402100000,CITY PROPERTY,Exempt,0,0,0,0,0,0
142010402200000,CITY PROPERTY,Exempt,0,0,0,0,0,0
142010402300000,CITY PROPERTY,Exempt,0,0,0,0,0,0
142010402400000,CITY PROPERTY,Exempt,0,0,0,0,0,0
142010500100000,CITY PROPERTY,Exempt,0,0,0,0,0,0
142010500200000,CITY PROPERTY,Exempt,0,0,0,0,0,0
142010500300000,CITY PROPERTY,Exempt,0,0,0,0,0,0
142010500400000,CITY PROPERTY,Exempt,0,0,0,0,0,0
142010500500000,CITY PROPERTY,Exempt,0,0,0,0,0,0
142010500600000,CITY PROPERTY,Exempt,0,0,0,0,0,0
142010500700000,CITY PROPERTY,Exempt,0,0,0,0,0,0
142010500800000,NW 310,Residential,11880,0,11880,36681,0,48561
142010500900000,NW 310,Residential,9750,0,9750,0,0,9750
142010501000000,CITY PROPERTY,Exempt,0,0,0,0,0,0
142010501100000,CITY PROPERTY,Exempt,0,0,0,0,0,0
142010501200000,CITY PROPERTY,Exempt,0,0,0,0,0,0
142010501300000,CITY PROPERTY,Exempt,0,0,0,0,0,0
142010501400000,SMALL RETAIL,Commercial,0,5832,5832,0,39128,44960
142010501500000,CITY PROPERTY,Exempt,0,0,0,0,0,0
142010501600000,NW 310,Residential,7820,0,7820,0,0,7820
142010501700000,CITY PROPERTY,Exempt,0,0,0,0,0,0
142010501800000,CITY PROPERTY,Exempt,0,0,0,0,0,0
142010501900000,CITY PROPERTY,Exempt,0,0,0,0,0,0
142010502000000,CITY PROPERTY,Exempt,0,0,0,0,0,0
142010502100000,CITY PROPERTY,Exempt,0,0,0,0,0,0
142010502200000,CITY PROPERTY,Exempt,0,0,0,0,0,0
142010502300000,CITY PROPERTY,Exempt,0,0,0,0,0,0
142010502400000,CITY PROPERTY,Exempt,0,0,0,0,0,0
142010502500000,CITY PROPERTY,Exempt,0,0,0,0,0,0
142010502600000,CITY PROPERTY,Exempt,0,0,0,0,0,0
142010502700000,CITY PROPERTY,Exempt,0,0,0,0,0,0
142010502800000,CITY PROPERTY,Exempt,0,0,0,0,0,0
142012600100000,NW 310,Residential,12866,0,12866,48045,0,60911
142012600200000,CITY PROPERTY,Exempt,0,0,0,0,0,0
142012600300000,CITY PROPERTY,Exempt,0,0,0,0,0,0
142012600400000,CITY PROPERTY,Exempt,0,0,0,0,0,0
142012600500000,CITY PROPERTY,Exempt,0,0,0,0,0,0
142012600600000,CITY PROPERTY,Exempt,0,0,0,0,0,0
142012600700000,CITY PROPERTY,Exempt,0,0,0,0,0,0
142012600800000,CITY PROPERTY,Exempt,0,0,0,0,0,0
142012600900000,NW 310,Residential,15168,0,15168,51744,0,66912
142012601000000,NW 310,Residential,12967,0,12967,0,0,12967
142012601100000,NW 310,Residential,12830,0,12830,40259,0,53089
142012601200000,CITY PROPERTY,Exempt,0,0,0,0,0,0
142012601300000,CITY PROPERTY,Exempt,0,0,0,0,0,0
142012601400000,CITY PROPERTY,Exempt,0,0,0,0,0,0
142012601500000,NW 310,Residential,11880,0,11880,39573,0,51453
142012601600000,NW 310,Residential,11880,0,11880,39112,0,50992
142012601700000,NW 310,Residential,11880,0,11880,38964,0,50844
142012700100000,NW 310,Residential,16994,0,16994,58668,0,75662
142012700200000,NW 310,Residential,21409,0,21409,53178,0,74587
142012700300000,NW 310,Residential,22275,0,22275,54802,0,77077
142012700400000,NW 310,Residential,21681,0,21681,59449,0,81130
142012700500000,NW 310,Residential,22288,0,22288,57865,0,80153
142012700600000,NW 310,Residential,15408,0,15408,0,0,15408
142012700700000,CITY PROPERTY,Exempt,0,0,0,0,0,0
142012700800000,NW 310,Residential,24806,0,24806,0,0,24806
142012700900000,NW 310,Residential,14884,0,14884,59722,0,74606
142012701000000,NW 310,Residential,14884,0,14884,38794,0,53678
142012701100000,CITY PROPERTY,Exempt,0,0,0,0,0,0
142012701200000,NW 310,Residential,14884,0,14884,0,0,14884
142012701300000,CITY PROPERTY,Exempt,0,0,0,0,0,0
142012701400000,NW 310,Residential,14884,0,14884,43191,0,58075
142012800100000,NW 310,Residential,21658,0,21658,62089,0,83747
142012800200000,NW 310,Residential,20658,0,20658,68887,0,89545
142012800300000,NW 310,Residential,26656,0,26656,63477,0,90133
142012800400000,NW 310,Residential,23086,0,23086,71210,0,94296
142012800500000,NW 310,Residential,21437,0,21437,60123,0,81560
142012800600000,NW 310,Residential,22426,0,22426,76286,0,98712
142012800700000,NW 310,Residential,22587,0,22587,61069,0,83656
142012800800000,NW 310,Residential,21654,0,21654,60271,0,81925
142012800900000,CITY PROPERTY,Exempt,0,0,0,0,0,0
142012801000000,NW 310,Residential,21437,0,21437,94083,0,115520
142012801100000,NW 310,Residential,23086,0,23086,64059,0,87145
142012801200000,NW 310,Residential,23324,0,23324,61942,0,85266
142012900100000,NW 310,Residential,27166,0,27166,88382,0,115548
142012900200000,FRATERNAL,Commercial,0,130747,130747,0,122096,252843
142012900300000,NW 304,Residential,30800,0,30800,117397,0,148197
142012900400000,NW 304,Residential,28875,0,28875,93576,0,122451
142012900500000,NW 304,Residential,28875,0,28875,90389,0,119264
142012900600000,NW 304,Residential,28875,0,28875,110846,0,139721
142012900700000,NW 304,Residential,28875,0,28875,115575,0,144450
142012900800000,NW 304,Residential,28613,0,28613,121697,0,150310
142012900900000,NW 304,Residential,28350,0,28350,87088,0,115438
142012901000000,NW 304,Residential,22470,0,22470,88043,0,110513
142012901100000,NW 304,Residential,21889,0,21889,91925,0,113814
142012901200000,NW 304,Residential,23520,0,23520,108541,0,132061
142012901300000,NW 304,Residential,20748,0,20748,81350,0,102098
142012901400000,NW 304,Residential,18200,0,18200,58880,0,77080
142012901500000,NW 310,Residential,24467,0,24467,79035,0,103502
142012901600000,NW 310,Residential,22400,0,22400,74020,0,96420
142012901700000,NW 310,Residential,22400,0,22400,70206,0,92606
142012901800000,NW 310,Residential,22400,0,22400,67540,0,89940
142012901900000,NW 310,Residential,22400,0,22400,82177,0,104577
142012902000000,NW 310,Residential,25448,0,25448,65772,0,91220
142012902100000,NW 310,Residential,26194,0,26194,76984,0,103178
142012902200000,NW 310,Residential,26194,0,26194,67919,0,94113
142012902300000,NW 310,Residential,27558,0,27558,67324,0,94882
142012902400000,NW 310,Residential,29394,0,29394,67720,0,97114
142012902500000,NW 310,Residential,29394,0,29394,69342,0,98736
142012902600000,NW 310,Residential,29394,0,29394,69911,0,99305
142012902700000,NW 310,Residential,31096,0,31096,68554,0,99650
142012902800000,NW 304,Residential,27540,0,27540,109438,0,136978
142012902900000,NW 304,Residential,27810,0,27810,81822,0,109632
142012903000000,NW 310,Residential,31704,0,31704,87183,0,118887
142012903100000,NW 310,Residential,24000,0,24000,74186,0,98186
142012903200000,NW 310,Residential,25740,0,25740,70204,0,95944
142012903300000,NW 304,Residential,5408,0,5408,0,0,5408
142013000100000,CITY PROPERTY,Exempt,0,0,0,0,0,0
142013000200000,CITY PROPERTY,Exempt,0,0,0,0,0,0
142013000300000,NW 310,Residential,15444,0,15444,37015,0,52459
142013000400000,CITY PROPERTY,Exempt,0,0,0,0,0,0
142013000500000,NW 310,Residential,11880,0,11880,20475,0,32355
142013000600000,CITY PROPERTY,Exempt,0,0,0,0,0,0
142013000700000,NW 310,Residential,11880,0,11880,39810,0,51690
142013000800000,NW 310,Residential,11880,0,11880,32592,0,44472
142013000900000,CITY PROPERTY,Exempt,0,0,0,0,0,0
142013001000000,NW 310,Residential,11880,0,11880,42408,0,54288
142013001100000,NW 310,Residential,11880,0,11880,40701,0,52581
142013001200000,CITY PROPERTY,Exempt,0,0,0,0,0,0
142013001300000,NW 310,Residential,12780,0,12780,45272,0,58052
142013001400000,NW 310,Residential,13978,0,13978,19211,0,33189
142013001500000,NW 310,Residential,13104,0,13104,0,0,13104
142013001600000,NW 310,Residential,11880,0,11880,40652,0,52532
142013001700000,CITY PROPERTY,Exempt,0,0,0,0,0,0
142013001800000,CITY PROPERTY,Exempt,0,0,0,0,0,0
142013001900000,CITY PROPERTY,Exempt,0,0,0,0,0,0
142013002000000,CITY PROPERTY,Exempt,0,0,0,0,0,0
142013002100000,CITY PROPERTY,Exempt,0,0,0,0,0,0
142013002200000,CITY PROPERTY,Exempt,0,0,0,0,0,0
142013002300000,CITY PROPERTY,Exempt,0,0,0,0,0,0
142013002400000,CITY PROPERTY,Exempt,0,0,0,0,0,0
142013002500000,CITY PROPERTY,Exempt,0,0,0,0,0,0
142013002600000,NW 310,Residential,11880,0,11880,36477,0,48357
142013002700000,NW 310,Residential,11880,0,11880,50339,0,62219
142013002800000,CITY PROPERTY,Exempt,0,0,0,0,0,0
142013002900000,NW 310,Residential,14750,0,14750,0,0,14750
142013100100000,NW 310,Residential,16038,0,16038,46156,0,62194
142013100200000,NW 310,Residential,17592,0,17592,61443,0,79035
142013100300000,NW 310,Residential,17820,0,17820,52111,0,69931
142013100400000,NW 310,Residential,17820,0,17820,47444,0,65264
142013100500000,NW 310,Residential,17820,0,17820,59756,0,77576
142013100600000,CITY PROPERTY,Exempt,0,0,0,0,0,0
142013100700000,NW 310,Residential,17820,0,17820,45849,0,63669
142013100800000,NW 310,Residential,17820,0,17820,32913,0,50733
142013100900000,NW 310,Residential,21785,0,21785,42868,0,64653
142013101000000,NW 310,Residential,21235,0,21235,47551,0,68786
142013101100000,NW 310,Residential,15444,0,15444,49113,0,64557
142013101200000,NW 310,Residential,13330,0,13330,50796,0,64126
142013101300000,CITY PROPERTY,Exempt,0,0,0,0,0,0
142013101400000,NW 310,Residential,14850,0,14850,55815,0,70665
142013101500000,CITY PROPERTY,Exempt,0,0,0,0,0,0
142013101600000,NW 310,Residential,19800,0,19800,0,0,19800
142013101700000,NW 310,Residential,14850,0,14850,53960,0,68810
142013101800000,NW 310,Residential,14850,0,14850,53763,0,68613
142013101900000,NW 310,Residential,14850,0,14850,37591,0,52441
142013102000000,CITY PROPERTY,Exempt,0,0,0,0,0,0
142013102100000,NW 310,Residential,19800,0,19800,0,0,19800
142013102200000,NW 310,Residential,14850,0,14850,62106,0,76956
142013102300000,NW 310,Residential,14850,0,14850,44483,0,59333
142013102400000,CITY PROPERTY,Exempt,0,0,0,0,0,0
142013102500000,CITY PROPERTY,Exempt,0,0,0,0,0,0
142013102600000,NW 310,Residential,14850,0,14850,60962,0,75812
142013102700000,NW 310,Residential,14750,0,14750,0,0,14750
142013200100000,CITY PROPERTY,Exempt,0,0,0,0,0,0
142013200200000,NW 310,Residential,20949,0,20949,73366,0,94315
142013200300000,NW 310,Residential,19992,0,19992,76769,0,96761
142013200400000,NW 310,Residential,19992,0,19992,59900,0,79892
142013200500000,NW 310,Residential,20196,0,20196,69586,0,89782
142013200600000,NW 310,Residential,20196,0,20196,63764,0,83960
142013200700000,NW 310,Residential,20196,0,20196,55353,0,75549
142013200800000,NW 310,Residential,20400,0,20400,59223,0,79623
142013200900000,NW 310,Residential,21250,0,21250,63870,0,85120
142013201000000,CITY PROPERTY,Exempt,0,0,0,0,0,0
142013201100000,NW 310,Residential,21194,0,21194,83979,0,105173
142013201200000,NW 310,Residential,18360,0,18360,60002,0,78362
142013201300000,NW 310,Residential,18360,0,18360,48243,0,66603
142013201400000,NW 310,Residential,18360,0,18360,68983,0,87343
142013201500000,NW 310,Residential,18360,0,18360,54197,0,72557
142013201600000,NW 310,Residential,18711,0,18711,58676,0,77387
142013201700000,NW 310,Residential,20604,0,20604,57268,0,77872
142013201800000,NW 310,Residential,20400,0,20400,50670,0,71070
142013201900000,NW 310,Residential,20400,0,20400,50569,0,70969
142013202000000,NW 310,Residential,20196,0,20196,52092,0,72288
142013202100000,CITY PROPERTY,Exempt,0,0,0,0,0,0
142013202200000,NW 310,Residential,19992,0,19992,68139,0,88131
142013202300000,NW 310,Residential,19788,0,19788,55625,0,75413
142013202400000,NW 310,Residential,19788,0,19788,49654,0,69442
142015100100000,CONVENIENCE STORE,Commercial,0,55296,55296,0,333517,388813
142015100200000,CITY PROPERTY,Exempt,0,0,0,0,0,0
142015100300000,CITY PROPERTY,Exempt,0,0,0,0,0,0
142015100400000,NW 310,Residential,14961,0,14961,39128,0,54089
142015100500000,NW 310,Residential,15088,0,15088,108308,0,123396
142015100600000,CITY PROPERTY,Exempt,0,0,0,0,0,0
142015100700000,NW 310,Residential,16513,0,16513,56643,0,73156
142015100800000,NW 310,Residential,16431,0,16431,69190,0,85621
142015100900000,NW 310,Residential,17559,0,17559,66956,0,84515
142015101000000,CHURCH,Exempt,0,162000,162000,0,263440,425440
142015101100000,NW 310,Residential,19608,0,19608,54112,0,73720
142015101200000,NW 310,Residential,11970,0,11970,34076,0,46046
142015101300000,NW 310,Residential,5000,0,5000,0,0,5000
142015101400000,NW 310,Residential,9801,0,9801,32882,0,42683
142015101500000,NW 310,Residential,13365,0,13365,37208,0,50573
142015101600000,NW 310,Exempt,0,16335,16335,0,68021,84356
142015101700000,CHURCH,Exempt,0,92205,92205,0,10800,103005
142015200100000,NW 310,Residential,15760,0,15760,0,0,15760
142015200200000,NW 310,Residential,15790,0,15790,49290,0,65080
142015200300000,CITY PROPERTY,Exempt,0,0,0,0,0,0
142015200400000,NW 310,Residential,15790,0,15790,44169,0,59959
142015200500000,NW 310,Residential,16081,0,16081,46922,0,63003
142015200600000,NW 310,Residential,15980,0,15980,52937,0,68917
142015200700000,NW 310,Residential,15328,0,15328,45537,0,60865
142015200800000,NW 310,Residential,18800,0,18800,66022,0,84822
142015200900000,NW 310,Residential,18200,0,18200,68460,0,86660
142015201000000,NW 310,Residential,22225,0,22225,65023,0,87248
142015201100000,NW 310,Residential,21978,0,21978,68678,0,90656
142015201200000,NW 310,Residential,18130,0,18130,64111,0,82241
142015201300000,NW 310,Residential,17513,0,17513,65671,0,83184
142015201400000,NW 310,Residential,17513,0,17513,67961,0,85474
142015201500000,NW 310,Residential,17807,0,17807,65087,0,82894
142015201600000,NW 310,Residential,13566,0,13566,27603,0,41169
142015201700000,NW 310,Residential,14212,0,14212,38849,0,53061
142015201800000,NW 310,Residential,13566,0,13566,62163,0,75729
142015201900000,NW 310,Residential,13566,0,13566,58172,0,71738
142015202000000,NW 310,Residential,22222,0,22222,82505,0,104727
142015202100000,NW 310,Residential,18074,0,18074,64248,0,82322
142015202200000,NW 310,Residential,17513,0,17513,64903,0,82416
142015202300000,NW 310,Residential,17513,0,17513,79568,0,97081
142015202400000,NW 310,Residential,17795,0,17795,68897,0,86692
142015202500000,NW 310,Residential,19780,0,19780,71132,0,90912
142015202600000,NW 310,Residential,20281,0,20281,83792,0,104073
142015202700000,NW 310,Residential,14089,0,14089,0,0,14089
142015202800000,NW 310,Residential,16324,0,16324,57470,0,73794
142015202900000,CITY PROPERTY,Exempt,0,0,0,0,0,0
142015203000000,NW 310,Residential,15980,0,15980,48154,0,64134
142015300100000,NW 310,Residential,15883,0,15883,49898,0,65781
142015300200000,NW 310,Residential,15790,0,15790,48167,0,63957
142015300300000,NW 310,Residential,20196,0,20196,54601,0,74797
142015300400000,NW 310,Residential,15790,0,15790,53310,0,69100
142015300500000,NW 310,Residential,16074,0,16074,45463,0,61537
142015300600000,NW 310,Residential,18048,0,18048,58900,0,76948
142015300700000,NW 310,Residential,17669,0,17669,53944,0,71613
142015300800000,NW 310,Residential,22155,0,22155,79907,0,102062
142015300900000,NW 310,Residential,21412,0,21412,81192,0,102604
142015301000000,NW 310,Residential,26121,0,26121,79332,0,105453
142015301100000,NW 310,Residential,26570,0,26570,82075,0,108645
142015301200000,NW 310,Residential,20604,0,20604,100621,0,121225
142015301300000,NW 310,Residential,20604,0,20604,72407,0,93011
142015301400000,NW 310,Residential,23813,0,23813,82816,0,106629
142015301500000,NW 310,Residential,17453,0,17453,63887,0,81340
142015301600000,NW 310,Residential,15960,0,15960,48635,0,64595
142015301700000,NW 310,Residential,22876,0,22876,63168,0,86044
142015301800000,NW 310,Residential,21280,0,21280,57242,0,78522
142015301900000,NW 310,Residential,16720,0,16720,46271,0,62991
142015302000000,NW 310,Residential,15960,0,15960,75068,0,91028
142015302100000,NW 310,Residential,18509,0,18509,65731,0,84240
142015302200000,NW 310,Residential,17513,0,17513,68322,0,85835
142015302300000,NW 310,Residential,17513,0,17513,66952,0,84465
142015302400000,NW 310,Residential,17780,0,17780,56434,0,74214
142015302500000,NW 310,Residential,21978,0,21978,75052,0,97030
142015302600000,NW 310,Residential,22528,0,22528,65244,0,87772
142015302700000,NW 310,Residential,18200,0,18200,71305,0,89505
142015302800000,NW 310,Residential,18500,0,18500,88060,0,106560
142015302900000,NW 310,Residential,9779,0,9779,0,0,9779
142015303000000,NW 310,Residential,15980,0,15980,48867,0,64847
142015400100000,NW 310,Residential,21413,0,21413,66331,0,87744
142015400200000,NW 310,Residential,20680,0,20680,47427,0,68107
142015400300000,NW 310,Residential,24200,0,24200,52204,0,76404
142015400400000,NW 310,Residential,23892,0,23892,54471,0,78363
142015400500000,NW 310,Residential,30477,0,30477,70191,0,100668
142015400600000,NW 310,Residential,21744,0,21744,76052,0,97796
142015400700000,NW 310,Residential,22248,0,22248,72150,0,94398
142015400800000,NW 310,Residential,22823,0,22823,77765,0,100588
142015400900000,NW 310,Residential,24308,0,24308,63888,0,88196
142015401000000,NW 310,Residential,17982,0,17982,55137,0,73119
142015401100000,NW 310,Residential,27644,0,27644,82204,0,109848
142015401200000,NW 310,Residential,27188,0,27188,72334,0,99522
142015401300000,NW 310,Residential,17982,0,17982,86985,0,104967
142015401400000,NW 310,Residential,16720,0,16720,47032,0,63752
142015401500000,NW 310,Residential,19000,0,19000,70597,0,89597
142015401600000,NW 310,Residential,16720,0,16720,41531,0,58251
142015401700000,NW 310,Residential,15960,0,15960,44389,0,60349
142015401800000,NW 310,Residential,16720,0,16720,37144,0,53864
142015401900000,NW 310,Residential,15960,0,15960,44513,0,60473
142015402000000,NW 310,Residential,21781,0,21781,95024,0,116805
142015402100000,NW 310,Residential,20604,0,20604,69867,0,90471
142015402200000,NW 310,Residential,20604,0,20604,77420,0,98024
142015402300000,NW 310,Residential,20790,0,20790,79268,0,100058
142015402400000,NW 310,Residential,26367,0,26367,71766,0,98133
142015402500000,NW 310,Residential,25686,0,25686,71345,0,97031
142015402600000,NW 310,Residential,21816,0,21816,76176,0,97992
142015402700000,NW 310,Residential,22188,0,22188,76298,0,98486
142015500100000,NW 310,Residential,14553,0,14553,48060,0,62613
142015500200000,NW 310,Residential,14553,0,14553,47312,0,61865
142015500300000,NW 310,Residential,11583,0,11583,57778,0,69361
142015500400000,NW 310,Residential,11286,0,11286,62659,0,73945
142015500500000,NW 310,Residential,11286,0,11286,39190,0,50476
142015500600000,NW 310,Residential,11286,0,11286,37370,0,48656
142015500700000,NW 310,Residential,11286,0,11286,51534,0,62820
142015500800000,NW 310,Residential,11286,0,11286,41662,0,52948
142015500900000,NW 310,Residential,18533,0,18533,32509,0,51042
142015501000000,NW 310,Residential,14850,0,14850,61867,0,76717
142015501100000,CITY PROPERTY,Exempt,0,0,0,0,0,0
142015501200000,NW 310,Residential,9800,0,9800,0,0,9800
142015501300000,NW 310,Residential,5000,0,5000,0,0,5000
142015501400000,NW 310,Residential,5000,0,5000,0,0,5000
142015501500000,CITY PROPERTY,Exempt,0,0,0,0,0,0
142015501600000,CITY PROPERTY,Exempt,0,0,0,0,0,0
142015501700000,CITY PROPERTY,Exempt,0,0,0,0,0,0
142015501800000,CITY PROPERTY,Exempt,0,0,0,0,0,0
142015501900000,CITY PROPERTY,Exempt,0,0,0,0,0,0
142015502000000,CITY PROPERTY,Exempt,0,0,0,0,0,0
142015600100000,CITY PROPERTY,Exempt,0,0,0,0,0,0
142015600200000,NW 310,Exempt,0,6979,6979,0,0,6979
142015600300000,NW 310,Exempt,0,11487,11487,0,28520,40007
142015600400000,FRATERNAL,Exempt,0,51011,51011,0,22553,73564
142015600500000,NW 310,Residential,14726,0,14726,71499,0,86225
142015600600000,NW 310,Residential,9572,0,9572,0,0,9572
142015600700000,NW 310,Residential,9572,0,9572,71283,0,80855
142015600800000,NW 310,Residential,14726,0,14726,68375,0,83101
142015600900000,NW 310,Residential,21542,0,21542,75628,0,97170
142015601000000,CITY PROPERTY,Exempt,0,0,0,0,0,0
142015601100000,NW 310,Residential,13464,0,13464,55728,0,69192
142015601200000,NW 310,Residential,13464,0,13464,33314,0,46778
142015601300000,NW 310,Residential,16830,0,16830,46587,0,63417
142015601400000,NW 310,Residential,13296,0,13296,47604,0,60900
142015601500000,NW 310,Residential,13296,0,13296,45366,0,58662
142015601600000,NW 310,Residential,13296,0,13296,79815,0,93111
142015601700000,NW 310,Residential,10637,0,10637,0,0,10637
142015601800000,NW 310,Residential,14726,0,14726,109001,0,123727
142015700100000,NW 310,Residential,14432,0,14432,36364,0,50796
142015700200000,NW 310,Residential,19404,0,19404,95083,0,114487
142015700300000,NW 310,Residential,11906,0,11906,65312,0,77218
142015700400000,NW 310,Residential,14652,0,14652,32163,0,46815
142015700500000,NW 310,Residential,19800,0,19800,59078,0,78878
142015700600000,NW 310,Residential,19800,0,19800,67376,0,87176
142015700700000,NW 310,Residential,19800,0,19800,58130,0,77930
142015700800000,NW 310,Residential,19800,0,19800,33874,0,53674
142015700900000,NW 310,Residential,19800,0,19800,75271,0,95071
142015701000000,NW 310,Residential,19800,0,19800,66140,0,85940
142015701100000,NW 310,Residential,19800,0,19800,86182,0,105982
142015701200000,NW 310,Residential,14726,0,14726,50747,0,65473
142015701300000,CITY PROPERTY,Exempt,0,0,0,0,0,0
142015701400000,NW 310,Residential,14726,0,14726,47031,0,61757
142015701500000,NW 310,Residential,14726,0,14726,61779,0,76505
142015701600000,NW 310,Residential,14726,0,14726,0,0,14726
142015701700000,NW 310,Residential,14726,0,14726,60074,0,74800
142015701800000,NW 310,Residential,5000,0,5000,0,0,5000
142015701900000,NW 310,Residential,18779,0,18779,0,0,18779
142015800100000,NW 310,Residential,19404,0,19404,64699,0,84103
142015800200000,NW 310,Residential,19992,0,19992,81053,0,101045
142015800300000,NW 310,Residential,29566,0,29566,70377,0,99943
142015800400000,NW 310,Residential,20400,0,20400,73822,0,94222
142015800500000,NW 310,Residential,20400,0,20400,72662,0,93062
142015800600000,NW 310,Residential,20400,0,20400,49987,0,70387
142015800700000,NW 310,Residential,20400,0,20400,52258,0,72658
142015800800000,NW 310,Residential,20400,0,20400,58173,0,78573
142015800900000,NW 310,Residential,20400,0,20400,61248,0,81648
142015801000000,NW 310,Residential,20400,0,20400,60493,0,80893
142015801100000,NW 310,Residential,19800,0,19800,53166,0,72966
142015801200000,NW 310,Residential,19800,0,19800,49052,0,68852
142015801300000,NW 310,Residential,19800,0,19800,62450,0,82250
142015801400000,NW 310,Residential,19800,0,19800,57789,0,77589
142015801500000,NW 310,Residential,19800,0,19800,50428,0,70228
142015801600000,NW 310,Residential,19800,0,19800,19758,0,39558
142015801700000,NW 310,Residential,19800,0,19800,59092,0,78892
142015801800000,NW 310,Residential,27482,0,27482,84928,0,112410
142017600100000,CITY PROPERTY,Exempt,0,0,0,0,0,0
142017600200000,CITY PROPERTY,Exempt,0,0,0,0,0,0
142017600300000,CITY PROPERTY,Exempt,0,0,0,0,0,0
142017600400000,CITY PROPERTY,Exempt,0,0,0,0,0,0
142017600500000,CITY PROPERTY,Exempt,0,0,0,0,0,0
142017600600000,CITY PROPERTY,Exempt,0,0,0,0,0,0
142017600700000,CITY PROPERTY,Exempt,0,0,0,0,0,0
142017600800000,CITY PROPERTY,Exempt,0,0,0,0,0,0
142017600900000,CITY PROPERTY,Exempt,0,0,0,0,0,0
142017601000000,NW 310,Residential,5000,0,5000,0,0,5000
142017601100000,CITY PROPERTY,Exempt,0,0,0,0,0,0
142017601200000,CITY PROPERTY,Exempt,0,0,0,0,0,0
142017601300000,CITY PROPERTY,Exempt,0,0,0,0,0,0
142017601400000,CITY PROPERTY,Exempt,0,0,0,0,0,0
142017601500000,CITY PROPERTY,Exempt,0,0,0,0,0,0
142017601600000,CITY PROPERTY,Exempt,0,0,0,0,0,0
142017700100000,CITY PROPERTY,Exempt,0,0,0,0,0,0
142017700200000,NW 310,Residential,17820,0,17820,0,0,17820
142017700300000,CITY PROPERTY,Exempt,0,0,0,0,0,0
142017700400000,NW 310,Residential,15444,0,15444,20613,0,36057
142017700500000,CITY PROPERTY,Exempt,0,0,0,0,0,0
142017700600000,CITY PROPERTY,Exempt,0,0,0,0,0,0
142017700700000,CITY PROPERTY,Exempt,0,0,0,0,0,0
142017700800000,CITY PROPERTY,Exempt,0,0,0,0,0,0
142017700900000,CITY PROPERTY,Exempt,0,0,0,0,0,0
142017701000000,NW 310,Residential,7325,0,7325,0,0,7325
142017701100000,NW 310,Residential,3465,0,3465,0,0,3465
142017701200000,CITY PROPERTY,Exempt,0,0,0,0,0,0
142017701300000,CITY PROPERTY,Exempt,0,0,0,0,0,0
142017800100000,CITY PROPERTY,Exempt,0,0,0,0,0,0
142017800200000,CITY PROPERTY,Exempt,0,0,0,0,0,0
142017800300000,CITY PROPERTY,Exempt,0,0,0,0,0,0
142017800400000,CITY PROPERTY,Exempt,0,0,0,0,0,0
142017800500000,CITY PROPERTY,Exempt,0,0,0,0,0,0
142017800600000,NW 310,Residential,5000,0,5000,0,0,5000
142017800700000,CITY PROPERTY,Exempt,0,0,0,0,0,0
142017800800000,CITY PROPERTY,Exempt,0,0,0,0,0,0
142017800900000,CITY PROPERTY,Exempt,0,0,0,0,0,0
142017801000000,CITY PROPERTY,Exempt,0,0,0,0,0,0
142017801100000,NW 310,Residential,5000,0,5000,3,0,5003
142017801200000,CITY PROPERTY,Exempt,0,0,0,0,0,0
142017801300000,CITY PROPERTY,Exempt,0,0,0,0,0,0
142017801400000,CITY PROPERTY,Exempt,0,0,0,0,0,0
142017900100000,CITY PROPERTY,Exempt,0,0,0,0,0,0
142017900200000,NW 310,Residential,10048,0,10048,0,0,10048
142017900300000,CITY PROPERTY,Exempt,0,0,0,0,0,0
142017900400000,CITY PROPERTY,Exempt,0,0,0,0,0,0
142017900500000,CITY PROPERTY,Exempt,0,0,0,0,0,0
142017900600000,CITY PROPERTY,Exempt,0,0,0,0,0,0
142017900700000,CITY PROPERTY,Exempt,0,0,0,0,0,0
142017900800000,CITY PROPERTY,Exempt,0,0,0,0,0,0
142017900900000,NW 310,Residential,10395,0,10395,64018,0,74413
142017901000000,CITY PROPERTY,Exempt,0,0,0,0,0,0
142017901100000,NW 310,Residential,9800,0,9800,0,0,9800
142017901200000,NW 310,Residential,19800,0,19800,0,0,19800
142017901300000,CITY PROPERTY,Exempt,0,0,0,0,0,0
142018000100000,CITY PROPERTY,Exempt,0,0,0,0,0,0
142018000200000,CITY PROPERTY,Exempt,0,0,0,0,0,0
142018000300000,CITY PROPERTY,Exempt,0,0,0,0,0,0
142018000400000,CITY PROPERTY,Exempt,0,0,0,0,0,0
142018000500000,NW 310,Residential,8662,0,8662,0,0,8662
142018000600000,NW 310,Residential,8662,0,8662,0,0,8662
142018000700000,CITY PROPERTY,Exempt,0,0,0,0,0,0
142018000800000,CITY PROPERTY,Exempt,0,0,0,0,0,0
142018000900000,CITY PROPERTY,Exempt,0,0,0,0,0,0
142018001000000,CITY PROPERTY,Exempt,0,0,0,0,0,0
142018001100000,CITY PROPERTY,Exempt,0,0,0,0,0,0
142018001200000,CITY PROPERTY,Exempt,0,0,0,0,0,0
142018001300000,CITY PROPERTY,Exempt,0,0,0,0,0,0
142018001400000,CITY PROPERTY,Exempt,0,0,0,0,0,0
142018100100000,CITY PROPERTY,Exempt,0,0,0,0,0,0
142018100200000,CITY PROPERTY,Exempt,0,0,0,0,0,0
142018100300000,NW 310,Residential,5000,0,5000,0,0,5000
142018100400000,CITY PROPERTY,Exempt,0,0,0,0,0,0
142018100500000,CITY PROPERTY,Exempt,0,0,0,0,0,0
142018100600000,NW 310,Residential,9800,0,9800,0,0,9800
142018100700000,CITY PROPERTY,Exempt,0,0,0,0,0,0
142018100800000,CITY PROPERTY,Exempt,0,0,0,0,0,0
142018100900000,CITY PROPERTY,Exempt,0,0,0,0,0,0
142018101000000,CITY PROPERTY,Exempt,0,0,0,0,0,0
142018101100000,CITY PROPERTY,Exempt,0,0,0,0,0,0
142018101200000,CITY PROPERTY,Exempt,0,0,0,0,0,0
142018101300000,NW 310,Residential,17325,0,17325,0,0,17325
142018101400000,CITY PROPERTY,Exempt,0,0,0,0,0,0
142018200100000,CITY PROPERTY,Exempt,0,0,0,0,0,0
142018200200000,CITY PROPERTY,Exempt,0,0,0,0,0,0
142018200300000,CITY PROPERTY,Exempt,0,0,0,0,0,0
142018200400000,NW 310,Residential,11880,0,11880,40061,0,51941
142018200500000,CITY PROPERTY,Exempt,0,0,0,0,0,0
142018200600000,NW 310,Residential,5000,0,5000,0,0,5000
142018200700000,CITY PROPERTY,Exempt,0,0,0,0,0,0
142018200800000,CITY PROPERTY,Exempt,0,0,0,0,0,0
142018200900000,NW 310,Residential,9800,0,9800,0,0,9800
142018201000000,NW 310,Residential,2800,0,2800,0,0,2800
142018201100000,NW 310,Residential,12750,0,12750,26669,0,39419
142018201200000,CITY PROPERTY,Exempt,0,0,0,0,0,0
142018201300000,NW 310,Residential,14850,0,14850,43593,0,58443
142018201400000,CITY PROPERTY,Exempt,0,0,0,0,0,0
142018201500000,CITY PROPERTY,Exempt,0,0,0,0,0,0
142018201600000,NW 310,Residential,14850,0,14850,0,0,14850
142018300100000,NW 310,Residential,19800,0,19800,0,0,19800
142018300200000,CITY PROPERTY,Exempt,0,0,0,0,0,0
142018300300000,NW 310,Residential,12275,0,12275,0,0,12275
142018300400000,CITY PROPERTY,Exempt,0,0,0,0,0,0
142018300500000,CITY PROPERTY,Exempt,0,0,0,0,0,0
142018300600000,NW 310,Residential,14850,0,14850,77363,0,92213
142018300700000,NW 310,Residential,14850,0,14850,35984,0,50834
142018300800000,NW 310,Residential,14850,0,14850,46236,0,61086
142018300900000,CENTRALLY ASSESSED,Other,0,0,0,0,0,0
142018301000000,CITY PROPERTY,Exempt,0,0,0,0,0,0
142018301100000,NW 310,Residential,14850,0,14850,40297,0,55147
142018301200000,NW 310,Residential,14850,0,14850,36242,0,51092
142018301300000,NW 310,Residential,5000,0,5000,0,0,5000
142018301400000,NW 310,Residential,14850,0,14850,53442,0,68292
142018400100000,CITY PROPERTY,Exempt,0,0,0,0,0,0
142018400200000,CITY PROPERTY,Exempt,0,0,0,0,0,0
142018400300000,CITY PROPERTY,Exempt,0,0,0,0,0,0
142018400400000,NW 310,Residential,7325,0,7325,0,0,7325
142018400500000,CITY PROPERTY,Exempt,0,0,0,0,0,0
142018400600000,CITY PROPERTY,Exempt,0,0,0,0,0,0
142018400700000,CITY PROPERTY,Exempt,0,0,0,0,0,0
142018400800000,CITY PROPERTY,Exempt,0,0,0,0,0,0
142018400900000,CITY PROPERTY,Exempt,0,0,0,0,0,0
142018401000000,CITY PROPERTY,Exempt,0,0,0,0,0,0
142018401100000,CITY PROPERTY,Exempt,0,0,0,0,0,0
142018401200000,CITY PROPERTY,Exempt,0,0,0,0,0,0
142018401300000,CITY PROPERTY,Exempt,0,0,0,0,0,0
142018401400000,CITY PROPERTY,Exempt,0,0,0,0,0,0
142018401500000,CITY PROPERTY,Exempt,0,0,0,0,0,0
142018401600000,CITY PROPERTY,Exempt,0,0,0,0,0,0
142018401700000,CITY PROPERTY,Exempt,0,0,0,0,0,0
142018401800000,CITY PROPERTY,Exempt,0,0,0,0,0,0
142018401900000,CITY PROPERTY,Exempt,0,0,0,0,0,0
142018500100000,CITY PROPERTY,Exempt,0,0,0,0,0,0
142018500200000,NW 310,Residential,5000,0,5000,0,0,5000
142018500300000,NW 310,Residential,18000,0,18000,0,0,18000
142018500400000,CITY PROPERTY,Exempt,0,0,0,0,0,0
142018500500000,NW 310,Residential,9800,0,9800,0,0,9800
142018500600000,CITY PROPERTY,Exempt,0,0,0,0,0,0
142018500700000,CITY PROPERTY,Exempt,0,0,0,0,0,0
142018500800000,CITY PROPERTY,Exempt,0,0,0,0,0,0
142018500900000,CITY PROPERTY,Exempt,0,0,0,0,0,0
142018501000000,CITY PROPERTY,Exempt,0,0,0,0,0,0
142018501100000,CITY PROPERTY,Exempt,0,0,0,0,0,0
142018501200000,NW 310,Residential,14553,0,14553,39766,0,54319
142018501300000,CITY PROPERTY,Exempt,0,0,0,0,0,0
142018501400000,CITY PROPERTY,Exempt,0,0,0,0,0,0
142018501500000,CITY PROPERTY,Exempt,0,0,0,0,0,0
142018501600000,NW 310,Residential,10395,0,10395,30350,0,40745
142018501700000,CITY PROPERTY,Exempt,0,0,0,0,0,0
142018501800000,CITY PROPERTY,Exempt,0,0,0,0,0,0
142018600100000,NW 310,Residential,10350,0,10350,37670,0,48020
142018600200000,NW 310,Residential,9744,0,9744,36109,0,45853
142018600300000,NW 310,Residential,5000,0,5000,0,0,5000
142018600400000,NW 310,Residential,13800,0,13800,0,0,13800
142018600500000,CITY PROPERTY,Exempt,0,0,0,0,0,0
142018600600000,CITY PROPERTY,Exempt,0,0,0,0,0,0
142018600700000,NW 310,Residential,14850,0,14850,55095,0,69945
142018600800000,CITY PROPERTY,Exempt,0,0,0,0,0,0
142018600900000,NW 310,Residential,14850,0,14850,16123,0,30973
142018601000000,CITY PROPERTY,Exempt,0,0,0,0,0,0
142018601100000,NW 310,Residential,5940,0,5940,0,0,5940
142018601200000,CITY PROPERTY,Exempt,0,0,0,0,0,0
142018601300000,CITY PROPERTY,Exempt,0,0,0,0,0,0
142018601400000,NW 310,Residential,14850,0,14850,63202,0,78052
142018601500000,NW 310,Residential,14850,0,14850,52064,0,66914
142018601600000,CITY PROPERTY,Exempt,0,0,0,0,0,0
142018601700000,CITY PROPERTY,Exempt,0,0,0,0,0,0
142018601800000,NW 310,Residential,14850,0,14850,68252,0,83102
142018601900000,NW 310,Residential,14850,0,14850,70744,0,85594
142018602000000,CITY PROPERTY,Exempt,0,0,0,0,0,0
142018602100000,CITY PROPERTY,Exempt,0,0,0,0,0,0
142018700100000,NW 310,Residential,9800,0,9800,0,0,9800
142018700200000,NW 310,Residential,5000,0,5000,0,0,5000
142018700300000,CITY PROPERTY,Exempt,0,0,0,0,0,0
142018700400000,NW 310,Residential,11880,0,11880,55228,0,67108
142018700500000,CITY PROPERTY,Exempt,0,0,0,0,0,0
142018700600000,CITY PROPERTY,Exempt,0,0,0,0,0,0
142018700700000,NW 310,Residential,5000,0,5000,0,0,5000
142018700800000,NW 310,Residential,5000,0,5000,0,0,5000
142018700900000,NW 310,Residential,9899,0,9899,38690,0,48589
142018701000000,CITY PROPERTY,Exempt,0,0,0,0,0,0
142018701100000,NW 310,Residential,16335,0,16335,64700,0,81035
142018701200000,NW 310,Residential,14850,0,14850,49301,0,64151
142018701300000,CITY PROPERTY,Exempt,0,0,0,0,0,0
142018701400000,CITY PROPERTY,Exempt,0,0,0,0,0,0
142018701500000,CITY PROPERTY,Exempt,0,0,0,0,0,0
142018701600000,NW 310,Residential,11880,0,11880,42026,0,53906
142018701700000,CITY PROPERTY,Exempt,0,0,0,0,0,0
142018701800000,NW 310,Residential,7425,0,7425,0,0,7425
142018701900000,NW 310,Residential,14850,0,14850,31364,0,46214
142018702000000,NW 310,Residential,14850,0,14850,54128,0,68978
142018702100000,NW 310,Residential,14850,0,14850,0,0,14850
142020100100000,NW 304,Residential,28704,0,28704,69207,0,97911
142020100200000,NW 304,Residential,18900,0,18900,57257,0,76157
142020100300000,NW 304,Residential,16800,0,16800,86953,0,103753
142020100400000,NW 304,Residential,18200,0,18200,172374,0,190574
142020100500000,NW 304,Residential,18550,0,18550,71841,0,90391
142020100600000,NW 304,Residential,18900,0,18900,104392,0,123292
142020100700000,NW 304,Residential,18900,0,18900,67772,0,86672
142020100900000,NW 304,Residential,22400,0,22400,134792,0,157192
142020101000000,NW 304,Residential,22575,0,22575,89719,0,112294
142020101100000,NW 304,Residential,22575,0,22575,98170,0,120745
142020101200000,NW 304,Residential,22575,0,22575,87673,0,110248
142020101300000,NW 304,Residential,22400,0,22400,88658,0,111058
142020101400000,NW 304,Residential,22225,0,22225,63926,0,86151
142020101500000,NW 304,Residential,21875,0,21875,90157,0,112032
142020101600000,NW 304,Residential,21525,0,21525,75693,0,97218
142020101700000,NW 304,Residential,29645,0,29645,91424,0,121069
142020101800000,NW 304,Residential,20300,0,20300,66684,0,86984
142020101900000,NW 304,Residential,22890,0,22890,45584,0,68474
142020102000000,NW 304,Residential,27809,0,27809,113828,0,141637
142020102100000,NW 304,Residential,24980,0,24980,0,0,24980
142020200300000,NW 304,Residential,28175,0,28175,106278,0,134453
142020200400000,NW 304,Residential,15575,0,15575,86129,0,101704
142020200500000,NW 304,Residential,25777,0,25777,117909,0,143686
142020200600000,NW 304,Residential,29558,0,29558,144274,0,173832
142020200700000,NW 304,Residential,28169,0,28169,39098,0,67267
142020300100000,NW 304,Residential,68300,0,68300,64778,0,133078
142020300200000,NW 304,Residential,95608,0,95608,84392,0,180000
142020300300000,NW 304,Residential,54400,0,54400,90702,0,145102
142020300400000,NW 304,Residential,32078,0,32078,147442,0,179520
142020300500000,NW 304,Residential,54300,0,54300,93739,0,148039
142020300600000,NW 304,Residential,1750,0,1750,0,0,1750
142020300700000,NW 304,Residential,1750,0,1750,0,0,1750
142020300800000,NW 304,Residential,26936,0,26936,99963,0,126899
142020300900000,NW 304,Residential,26208,0,26208,97164,0,123372
142020301000000,NW 304,Residential,26208,0,26208,82891,0,109099
142020301100000,NW 304,Residential,30744,0,30744,91942,0,122686
142020301200000,NW 304,Residential,55650,0,55650,259415,0,315065
142020301300000,NW 304,Residential,22932,0,22932,14614,0,37546
142020400100000,NW 304,Residential,26985,0,26985,94086,0,121071
142020400200000,NW 304,Residential,27508,0,27508,158130,0,185638
142020400300000,NW 304,Residential,30536,0,30536,135124,0,165660
142020400400000,NW 304,Residential,18375,0,18375,101637,0,120012
142020400500000,NW 304,Residential,32188,0,32188,104457,0,136645
142020400600000,NW 304,Residential,235,0,235,0,0,235
142020400700000,NW 304,Residential,21663,0,21663,60353,0,82016
142020400800000,NW 304,Residential,21420,0,21420,94659,0,116079
142020400900000,NW 304,Residential,12992,0,12992,0,0,12992
142020401000000,NW 304,Residential,26163,0,26163,82107,0,108270
142020401100000,NW 304,Residential,25463,0,25463,111468,0,136931
142020401200000,NW 304,Residential,17500,0,17500,85992,0,103492
142020401300000,NW 304,Residential,17675,0,17675,99280,0,116955
142020401400000,NW 304,Residential,18200,0,18200,66323,0,84523
142020401500000,NW 304,Residential,19250,0,19250,58859,0,78109
142020401600000,NW 304,Residential,19250,0,19250,49216,0,68466
142020401700000,NW 304,Residential,23765,0,23765,106454,0,130219
142020401800000,NW 304,Residential,21168,0,21168,107137,0,128305
142020401900000,NW 304,Residential,21049,0,21049,131680,0,152729
142020402000000,NW 304,Residential,21355,0,21355,87931,0,109286
142020402100000,NW 304,Residential,18693,0,18693,105182,0,123875
142020402200000,NW 304,Residential,19833,0,19833,92901,0,112734
142020402500000,NW 304,Residential,27392,0,27392,125744,0,153136
142020402600000,NW 304,Residential,24948,0,24948,95881,0,120829
142020402700000,APARTMENT,Commercial,0,127440,127440,0,872560,1000000
142022600100000,NW 304,Residential,166040,0,166040,0,0,166040
142022600200000,NW 304,Residential,33950,0,33950,285208,0,319158
142022600300000,NW 304,Residential,38332,0,38332,231024,0,269356
142022600400000,NW 304,Residential,35420,0,35420,165601,0,201021
142022600500000,NW 304,Residential,57696,0,57696,155838,0,213534
142022700100000,NW 304,Residential,45377,0,45377,112442,0,157819
142022700200000,NW 304,Residential,51650,0,51650,161745,0,213395
142022700300000,NW 304,Residential,4455,0,4455,0,0,4455
142022700400000,NW 304,Residential,49000,0,49000,90353,0,139353
142022700500000,NW 304,Residential,39340,0,39340,95995,0,135335
142022700600000,NW 304,Residential,178,0,178,0,0,178
142022700700000,NW 304,Residential,1095,0,1095,0,0,1095
142022700800000,NW 304,Residential,18500,0,18500,86008,0,104508
142022700900000,NW 304,Residential,19950,0,19950,0,0,19950
142022701000000,NW 304,Residential,18125,0,18125,120262,0,138387
142022701100000,NW 304,Residential,35490,0,35490,134282,0,169772
142022701300000,NW 304,Residential,26705,0,26705,144670,0,171375
142022701400000,NW 304,Residential,40920,0,40920,94326,0,135246
142022701500000,NW 304,Residential,38570,0,38570,206005,0,244575
142022701600000,NW 304,Residential,36540,0,36540,220763,0,257303
142022701700000,NW 304,Residential,36540,0,36540,190011,0,226551
142022701800000,NW 304,Residential,37374,0,37374,142512,0,179886
142022701900000,NW 304,Residential,35000,0,35000,110371,0,145371
142022702000000,NW 304,Residential,34644,0,34644,154380,0,189024
142022702100000,NW 304,Residential,73200,0,73200,78345,0,151545
142022702200000,NW 304,Residential,40200,0,40200,73280,0,113480
142022702300000,NW 304,Residential,30069,0,30069,122434,0,152503
142022702400000,NW 304,Residential,41160,0,41160,96406,0,137566
142025100300000,NW 304,Residential,19901,0,19901,86550,0,106451
142025100400000,NW 304,Residential,19285,0,19285,95181,0,114466
142025100500000,NW 304,Residential,19285,0,19285,104384,0,123669
142025100600000,NW 304,Residential,19488,0,19488,94352,0,113840
142025100700000,NW 304,Residential,19488,0,19488,91235,0,110723
142025200100000,NW 304,Residential,25437,0,25437,99759,0,125196
142025200200000,NW 304,Residential,21446,0,21446,117241,0,138687
142025200300000,NW 304,Residential,21446,0,21446,114595,0,136041
142025200400000,NW 304,Residential,21221,0,21221,112551,0,133772
142025200500000,NW 304,Residential,25311,0,25311,84036,0,109347
142025200600000,SR/NURSING/ASSTD LIV,Exempt,0,342427,342427,0,4374203,4716630
142025200800000,DAY CARE CENTER,Exempt,0,297216,297216,0,764898,1062114
142025300100000,VACANT LAND,Commercial,0,12636,12636,0,0,12636
142027600100000,NW 304,Residential,29106,0,29106,93203,0,122309
142027600200000,NW 304,Residential,20370,0,20370,81026,0,101396
142027600300000,NW 304,Residential,20370,0,20370,76039,0,96409
142027600400000,NW 304,Residential,20370,0,20370,91282,0,111652
142027600500000,NW 304,Residential,20370,0,20370,126437,0,146807
142027600600000,NW 304,Residential,20370,0,20370,97722,0,118092
142027600700000,NW 304,Residential,20370,0,20370,132175,0,152545
142027600800000,NW 304,Residential,25208,0,25208,113120,0,138328
142027600900000,NW 304,Residential,28009,0,28009,114324,0,142333
142027601000000,NW 304,Residential,34883,0,34883,97325,0,132208
142027601100000,NW 304,Residential,37064,0,37064,141664,0,178728
142027601200000,NW 304,Residential,30744,0,30744,127728,0,158472
142027601300000,NW 304,Residential,28688,0,28688,101479,0,130167
142027601400000,NW 304,Residential,29890,0,29890,109688,0,139578
142027601700000,NW 304,Residential,23086,0,23086,113950,0,137036
142027601800000,NW 304,Residential,23765,0,23765,94318,0,118083
142027601900000,NW 304,Residential,22124,0,22124,88924,0,111048
142027602000000,NW 304,Residential,22124,0,22124,86423,0,108547
142027602100000,NW 304,Residential,22124,0,22124,81525,0,103649
142027602200000,NW 304,Residential,22523,0,22523,90318,0,112841
142027602300000,NW 304,Residential,24255,0,24255,92292,0,116547
142027602400000,NW 304,Residential,24500,0,24500,86919,0,111419
142027602500000,NW 304,Residential,22750,0,22750,82588,0,105338
142027602600000,NW 304,Residential,22978,0,22978,85402,0,108380
142027602700000,NW 304,Residential,22369,0,22369,83910,0,106279
142027602800000,NW 304,Residential,23438,0,23438,81864,0,105302
142027602900000,NW 304,Residential,27417,0,27417,78122,0,105539
142027603000000,NW 304,Residential,26810,0,26810,148650,0,175460
142027603100000,NW 304,Residential,24055,0,24055,79622,0,103677
142027603200000,NW 304,Residential,21420,0,21420,88342,0,109762
142027603300000,NW 304,Residential,21420,0,21420,87625,0,109045
142027603400000,NW 304,Residential,21420,0,21420,100970,0,122390
142027603500000,NW 304,Residential,21420,0,21420,75488,0,96908
142027603600000,NW 304,Residential,21420,0,21420,91279,0,112699
142027603700000,NW 304,Residential,21420,0,21420,91472,0,112892
142027603800000,NW 304,Residential,22122,0,22122,87882,0,110004
142027700100000,CITY PROPERTY,Exempt,0,0,0,0,0,0
142027700200000,NW 304,Residential,22068,0,22068,90200,0,112268
142027700300000,NW 304,Residential,22068,0,22068,98969,0,121037
142027700400000,NW 304,Residential,26787,0,26787,109137,0,135924
142027700500000,CITY PROPERTY,Exempt,0,0,0,0,0,0
142027700600000,SCHOOL,Exempt,0,0,0,0,0,0
142027700700000,NW 304,Residential,24990,0,24990,135000,0,159990
142027700800000,NW 304,Residential,19459,0,19459,0,0,19459
142027700900000,NW 304,Residential,25480,0,25480,136405,0,161885
142027701000000,NW 304,Residential,25042,0,25042,134005,0,159047
142027701100000,NW 304,Residential,21952,0,21952,94463,0,116415
142027701200000,NW 304,Residential,21336,0,21336,84128,0,105464
142027701300000,NW 304,Residential,21672,0,21672,97506,0,119178
142027701400000,NW 304,Residential,21672,0,21672,90677,0,112349
142027701500000,NW 304,Residential,21672,0,21672,93182,0,114854
142027701600000,NW 304,Residential,21446,0,21446,93320,0,114766
142027800100000,SCHOOL,Exempt,0,0,0,0,0,0
142027800200000,SCHOOL,Exempt,0,0,0,0,0,0
142027800300000,APARTMENT,Residential,873180,0,873180,12390307,0,13263487
142030100100000,NW 311,Residential,16000,0,16000,63309,0,79309
142030100200000,NW 311,Residential,20976,0,20976,87192,0,108168
142030100300000,NW 311,Residential,19872,0,19872,68329,0,88201
142030100400000,NW 311,Residential,19872,0,19872,75617,0,95489
142030100500000,NW 311,Residential,19872,0,19872,55062,0,74934
142030100600000,NW 311,Residential,19872,0,19872,54457,0,74329
142030100700000,NW 311,Residential,19872,0,19872,56203,0,76075
142030100800000,NW 311,Residential,19872,0,19872,61615,0,81487
142030100900000,NW 311,Residential,19872,0,19872,54667,0,74539
142030101000000,NW 311,Residential,20829,0,20829,68937,0,89766
142030101100000,NW 311,Residential,25920,0,25920,76058,0,101978
142030101200000,NW 311,Residential,20800,0,20800,92190,0,112990
142030101300000,NW 311,Residential,16000,0,16000,80766,0,96766
142030101400000,NW 311,Residential,27200,0,27200,90085,0,117285
142030101500000,NW 311,Residential,16000,0,16000,86690,0,102690
142030101600000,NW 311,Residential,16000,0,16000,56423,0,72423
142030101700000,NW 311,Residential,16000,0,16000,55370,0,71370
142030101800000,NW 311,Residential,16000,0,16000,65304,0,81304
142030101900000,NW 311,Residential,16000,0,16000,64613,0,80613
142030200100000,NW 311,Residential,23104,0,23104,0,0,23104
142030200200000,NW 311,Residential,22593,0,22593,0,0,22593
142030200300000,NW 312,Residential,21600,0,21600,82762,0,104362
142030200400000,NW 312,Residential,25569,0,25569,94252,0,119821
142030200500000,NW 312,Residential,29430,0,29430,97488,0,126918
142030200600000,NW 312,Residential,30240,0,30240,113950,0,144190
142030200700000,NW 312,Residential,30395,0,30395,92491,0,122886
142030200800000,NW 312,Residential,26208,0,26208,84744,0,110952
142030200900000,NW 312,Residential,26208,0,26208,113465,0,139673
142030201000000,NW 312,Residential,24804,0,24804,100051,0,124855
142030201100000,NW 312,Residential,27612,0,27612,88271,0,115883
142030201200000,NW 312,Residential,26208,0,26208,101738,0,127946
142030201300000,NW 312,Residential,26208,0,26208,108223,0,134431
142030201400000,NW 312,Residential,28080,0,28080,94659,0,122739
142030201500000,NW 312,Residential,28080,0,28080,104738,0,132818
142030201600000,NW 312,Residential,28080,0,28080,100308,0,128388
142030201700000,NW 311,Residential,33858,0,33858,98359,0,132217
142030201800000,NW 311,Residential,33858,0,33858,107682,0,141540
142030201900000,NW 311,Residential,32405,0,32405,78685,0,111090
142030202000000,NW 311,Residential,27600,0,27600,65229,0,92829
142030202100000,NW 311,Residential,33060,0,33060,122431,0,155491
142030202200000,NW 311,Residential,27600,0,27600,99874,0,127474
142030202300000,NW 311,Residential,27600,0,27600,71319,0,98919
142030202400000,NW 311,Residential,24840,0,24840,0,0,24840
142030202500000,NW 311,Residential,24840,0,24840,0,0,24840
142030202600000,NW 311,Residential,50199,0,50199,0,0,50199
142030202800000,SR/NURSING/ASSTD LIV,Exempt,0,113940,113940,0,1851114,1965054
142030202900000,SR/NURSING/ASSTD LIV,Exempt,0,8370,8370,0,0,8370
142030203000000,NW 311,Residential,18216,0,18216,60257,0,78473
142030203100000,NW 311,Residential,18624,0,18624,0,0,18624
142030203200000,NW 311,Residential,19552,0,19552,0,0,19552
142030300100000,NW 311,Residential,16497,0,16497,60052,0,76549
142030300200000,NW 311,Residential,16320,0,16320,55974,0,72294
142030300300000,NW 311,Residential,16320,0,16320,49378,0,65698
142030300400000,NW 311,Residential,16320,0,16320,76257,0,92577
142030300500000,NW 311,Residential,16320,0,16320,62175,0,78495
142030300600000,NW 311,Residential,16320,0,16320,64254,0,80574
142030300700000,NW 311,Residential,16320,0,16320,60629,0,76949
142030300800000,NW 311,Residential,16320,0,16320,60907,0,77227
142030300900000,NW 311,Residential,16480,0,16480,38879,0,55359
142030301000000,NW 311,Residential,16480,0,16480,79258,0,95738
142030301100000,NW 311,Residential,16480,0,16480,64783,0,81263
142030301200000,NW 311,Residential,16480,0,16480,58570,0,75050
142030301300000,NW 311,Residential,16480,0,16480,70613,0,87093
142030301400000,NW 311,Residential,16480,0,16480,70826,0,87306
142030301500000,NW 311,Residential,16123,0,16123,49593,0,65716
142030301600000,NW 311,Residential,16320,0,16320,58535,0,74855
142030301700000,NW 311,Residential,16320,0,16320,72722,0,89042
142030301800000,NW 311,Residential,16320,0,16320,55773,0,72093
142030301900000,NW 311,Residential,16320,0,16320,68616,0,84936
142030302000000,NW 311,Residential,16320,0,16320,82580,0,98900
142030302100000,NW 311,Residential,16320,0,16320,67466,0,83786
142030302200000,NW 311,Residential,16320,0,16320,85453,0,101773
142030302300000,NW 311,Residential,16320,0,16320,62972,0,79292
142030302400000,NW 311,Residential,16320,0,16320,53594,0,69914
142030302500000,NW 311,Residential,16320,0,16320,51815,0,68135
142030302600000,NW 311,Residential,16320,0,16320,60088,0,76408
142030302700000,NW 311,Residential,16320,0,16320,61343,0,77663
142030302800000,CITY PROPERTY,Exempt,0,0,0,0,0,0
142030302900000,NW 311,Residential,16800,0,16800,59157,0,75957
142030303000000,NW 311,Residential,12160,0,12160,53972,0,66132
142030303100000,NW 311,Residential,12160,0,12160,74571,0,86731
142030400100000,NW 312,Residential,25088,0,25088,97883,0,122971
142030400200000,NW 312,Residential,21816,0,21816,100437,0,122253
142030400300000,NW 312,Residential,23836,0,23836,93137,0,116973
142030400400000,NW 312,Residential,23836,0,23836,93946,0,117782
142030500100000,NW 311,Residential,16480,0,16480,84262,0,100742
142030500200000,NW 311,Residential,16480,0,16480,73167,0,89647
142030500300000,NW 311,Residential,16480,0,16480,72645,0,89125
142030500400000,NW 311,Residential,16480,0,16480,76266,0,92746
142030500500000,NW 311,Residential,16320,0,16320,64404,0,80724
142030500600000,NW 311,Residential,16320,0,16320,65761,0,82081
142030500700000,NW 311,Residential,16320,0,16320,48777,0,65097
142030500800000,NW 311,Residential,16320,0,16320,70094,0,86414
142030500900000,NW 311,Residential,19584,0,19584,76890,0,96474
142030501000000,NW 311,Residential,19584,0,19584,93350,0,112934
142030501100000,NW 311,Residential,16320,0,16320,68869,0,85189
142030501200000,NW 311,Residential,16160,0,16160,87582,0,103742
142030501300000,NW 311,Residential,21008,0,21008,68347,0,89355
142030501400000,NW 311,Residential,19872,0,19872,80296,0,100168
142030501500000,NW 311,Residential,19790,0,19790,73674,0,93464
142030501600000,NW 311,Residential,19590,0,19590,59370,0,78960
142030501700000,NW 311,Residential,14560,0,14560,68005,0,82565
142030501800000,NW 311,Residential,14560,0,14560,46048,0,60608
142030501900000,NW 311,Residential,14560,0,14560,66738,0,81298
142030502000000,NW 311,Residential,14560,0,14560,45609,0,60169
142030502100000,NW 311,Residential,14560,0,14560,62454,0,77014
142030502200000,NW 311,Residential,14560,0,14560,54692,0,69252
142030502300000,CITY PROPERTY,Exempt,0,0,0,0,0,0
142030502400000,NW 311,Residential,14560,0,14560,57314,0,71874
142030502500000,NW 311,Residential,14560,0,14560,83575,0,98135
142030502600000,NW 311,Residential,14560,0,14560,61556,0,76116
142030502700000,CITY PROPERTY,Exempt,0,0,0,0,0,0
142030502800000,NW 311,Residential,20967,0,20967,71433,0,92400
142030600100000,NW 312,Residential,25088,0,25088,110226,0,135314
142030600200000,NW 312,Residential,21168,0,21168,88113,0,109281
142030600300000,NW 312,Residential,22176,0,22176,85903,0,108079
142030600400000,NW 312,Residential,21384,0,21384,110912,0,132296
142030600500000,NW 312,Residential,20839,0,20839,98520,0,119359
142032600100000,NW 312,Residential,24404,0,24404,79727,0,104131
142032600200000,NW 312,Residential,26520,0,26520,120908,0,147428
142032600300000,NW 312,Residential,29376,0,29376,124488,0,153864
142032600400000,NW 312,Residential,25349,0,25349,88326,0,113675
142032600500000,NW 312,Residential,24960,0,24960,95473,0,120433
142032600600000,NW 312,Residential,27120,0,27120,101433,0,128553
142032600700000,NW 312,Residential,25680,0,25680,93914,0,119594
142032600800000,NW 312,Residential,23970,0,23970,107960,0,131930
142032600900000,NW 312,Residential,32425,0,32425,127749,0,160174
142032601000000,NW 312,Residential,24133,0,24133,108398,0,132531
142032601100000,NW 312,Residential,24000,0,24000,88427,0,112427
142032601200000,NW 312,Residential,24000,0,24000,93920,0,117920
142032601300000,NW 312,Residential,24000,0,24000,102512,0,126512
142032601400000,NW 312,Residential,24768,0,24768,91870,0,116638
142032700100000,NW 312,Residential,63550,0,63550,123277,0,186827
142032700200000,NW 312,Residential,31718,0,31718,104177,0,135895
142032700300000,NW 312,Residential,27901,0,27901,98870,0,126771
142032700400000,NW 312,Residential,25220,0,25220,109971,0,135191
142032700500000,NW 312,Residential,27677,0,27677,106883,0,134560
142032700600000,NW 312,Residential,28777,0,28777,99616,0,128393
142032700700000,NW 312,Residential,29837,0,29837,96979,0,126816
142032700800000,NW 312,Residential,27179,0,27179,109035,0,136214
142032701000000,NW 312,Residential,26700,0,26700,105058,0,131758
142032701100000,NW 312,Residential,26668,0,26668,109412,0,136080
142032701200000,NW 312,Residential,28120,0,28120,102389,0,130509
142032701300000,NW 312,Residential,28747,0,28747,99146,0,127893
142032702100000,NW 312,Residential,23467,0,23467,102479,0,125946
142032800100000,NW 312,Residential,23823,0,23823,107987,0,131810
142032800200000,NW 312,Residential,24000,0,24000,107142,0,131142
142032800300000,NW 312,Residential,24000,0,24000,99430,0,123430
142032800400000,NW 312,Residential,24000,0,24000,114773,0,138773
142032800500000,NW 312,Residential,24000,0,24000,89766,0,113766
142032800600000,NW 312,Residential,24000,0,24000,83764,0,107764
142032800700000,NW 312,Residential,24000,0,24000,89197,0,113197
142032800800000,NW 312,Residential,24000,0,24000,104797,0,128797
142032800900000,NW 312,Residential,24000,0,24000,94900,0,118900
142032801000000,NW 312,Residential,24000,0,24000,85293,0,109293
142032801100000,NW 312,Residential,24000,0,24000,99571,0,123571
142032801200000,NW 312,Residential,24000,0,24000,102407,0,126407
142032801300000,NW 312,Residential,24000,0,24000,90927,0,114927
142032801400000,NW 312,Residential,24000,0,24000,104490,0,128490
142032801500000,NW 312,Residential,25600,0,25600,101751,0,127351
142032801600000,NW 312,Residential,25600,0,25600,86010,0,111610
142032801700000,NW 312,Residential,25600,0,25600,71699,0,97299
142032801800000,NW 312,Residential,25600,0,25600,105793,0,131393
142032801900000,NW 312,Residential,25600,0,25600,106148,0,131748
142032802000000,NW 312,Residential,28000,0,28000,108191,0,136191
142032802100000,NW 312,Residential,28000,0,28000,105295,0,133295
142032900100000,NW 312,Residential,25700,0,25700,109073,0,134773
142032900200000,NW 312,Residential,26520,0,26520,101951,0,128471
142032900300000,NW 312,Residential,26520,0,26520,114750,0,141270
142032900400000,NW 312,Residential,26539,0,26539,84902,0,111441
142032900500000,NW 312,Residential,28955,0,28955,97489,0,126444
142032900600000,NW 312,Residential,28400,0,28400,90295,0,118695
142032900700000,NW 312,Residential,26787,0,26787,84274,0,111061
142032900800000,NW 312,Residential,28496,0,28496,100079,0,128575
142032900900000,NW 312,Residential,29702,0,29702,78348,0,108050
142032901000000,NW 312,Residential,29430,0,29430,89598,0,119028
142032901100000,NW 312,Residential,29430,0,29430,77066,0,106496
142032901200000,NW 312,Residential,31280,0,31280,93525,0,124805
142033000100000,NW 312,Residential,25480,0,25480,93765,0,119245
142033000200000,NW 312,Residential,29161,0,29161,99673,0,128834
142033000300000,NW 312,Residential,27440,0,27440,101714,0,129154
142033000400000,NW 312,Residential,26160,0,26160,75758,0,101918
142033000500000,NW 312,Residential,26400,0,26400,129014,0,155414
142033000600000,NW 312,Residential,29380,0,29380,84644,0,114024
142033000700000,NW 312,Residential,28340,0,28340,94184,0,122524
142033000800000,NW 312,Residential,28000,0,28000,94960,0,122960
142033000900000,NW 312,Residential,28000,0,28000,93228,0,121228
142033001000000,NW 312,Residential,28000,0,28000,95414,0,123414
142033001100000,NW 312,Residential,27720,0,27720,92364,0,120084
142033001200000,NW 312,Residential,27701,0,27701,104766,0,132467
142033001300000,NW 312,Residential,27160,0,27160,102620,0,129780
142033001400000,NW 312,Residential,30652,0,30652,93463,0,124115
142033001500000,NW 312,Residential,29165,0,29165,105950,0,135115
142033001600000,NW 312,Residential,25600,0,25600,95545,0,121145
142033001700000,NW 312,Residential,25600,0,25600,109006,0,134606
142033001800000,NW 312,Residential,25344,0,25344,99406,0,124750
142033001900000,NW 312,Residential,29200,0,29200,117931,0,147131
142033002000000,NW 312,Residential,30368,0,30368,94170,0,124538
142033002100000,NW 312,Residential,29349,0,29349,93940,0,123289
142033002200000,NW 312,Residential,30766,0,30766,106165,0,136931
142033002300000,NW 312,Residential,29397,0,29397,101551,0,130948
142033002400000,NW 312,Residential,26000,0,26000,99833,0,125833
142033002500000,NW 312,Residential,27744,0,27744,113731,0,141475
142033002600000,NW 312,Residential,28928,0,28928,73695,0,102623
142033002700000,NW 312,Residential,29136,0,29136,106078,0,135214
142033002800000,NW 312,Residential,27120,0,27120,108512,0,135632
142033002900000,NW 312,Residential,26400,0,26400,109770,0,136170
142033003000000,NW 312,Residential,28672,0,28672,88682,0,117354
142033100100000,NW 312,Residential,30396,0,30396,77197,0,107593
142033100200000,NW 312,Residential,29845,0,29845,104663,0,134508
142033100300000,NW 312,Residential,22116,0,22116,84017,0,106133
142033100400000,NW 312,Residential,23280,0,23280,84728,0,108008
142033100500000,NW 312,Residential,23280,0,23280,111986,0,135266
142033100600000,NW 312,Residential,23280,0,23280,88743,0,112023
142033100700000,NW 312,Residential,23280,0,23280,84746,0,108026
142033100800000,NW 312,Residential,23280,0,23280,90255,0,113535
142033100900000,NW 312,Residential,23280,0,23280,86567,0,109847
142033101000000,NW 312,Residential,23280,0,23280,90394,0,113674
142033101100000,NW 312,Residential,23280,0,23280,82106,0,105386
142033101200000,NW 312,Residential,23280,0,23280,99488,0,122768
142033101300000,NW 312,Residential,24832,0,24832,98822,0,123654
142033101400000,NW 312,Residential,24832,0,24832,79764,0,104596
142033101500000,NW 312,Residential,24832,0,24832,90183,0,115015
142033101600000,NW 312,Residential,24832,0,24832,67653,0,92485
142033101700000,NW 312,Residential,24832,0,24832,85914,0,110746
142033101800000,NW 312,Residential,27160,0,27160,99167,0,126327
142033101900000,NW 312,Residential,27160,0,27160,88387,0,115547
142033102000000,NW 312,Residential,28000,0,28000,82269,0,110269
142033102100000,NW 312,Residential,28239,0,28239,88906,0,117145
142033102200000,NW 312,Residential,27160,0,27160,86301,0,113461
142033102300000,NW 312,Residential,27160,0,27160,91362,0,118522
142033102400000,NW 312,Residential,27160,0,27160,85385,0,112545
142033102500000,NW 312,Residential,27160,0,27160,85431,0,112591
142033102600000,NW 312,Residential,24444,0,24444,116158,0,140602
142033102700000,NW 312,Residential,24444,0,24444,98593,0,123037
142033102800000,NW 312,Residential,23280,0,23280,103044,0,126324
142033102900000,NW 312,Residential,23280,0,23280,89738,0,113018
142033103000000,NW 312,Residential,23280,0,23280,96703,0,119983
142033103100000,NW 312,Residential,23280,0,23280,86546,0,109826
142033103200000,NW 312,Residential,21560,0,21560,114073,0,135633
142033200100000,NW 312,Residential,29675,0,29675,90341,0,120016
142033200200000,NW 312,Residential,30977,0,30977,93909,0,124886
142033200300000,NW 312,Residential,28195,0,28195,99657,0,127852
142033200400000,NW 312,Residential,29400,0,29400,101475,0,130875
142033200500000,NW 312,Residential,29640,0,29640,101158,0,130798
142033200600000,NW 312,Residential,28718,0,28718,115837,0,144555
142033200700000,NW 312,Residential,25160,0,25160,83449,0,108609
142033200800000,NW 312,Residential,25440,0,25440,95611,0,121051
142033200900000,NW 312,Residential,25920,0,25920,97932,0,123852
142033201000000,NW 312,Residential,29205,0,29205,128499,0,157704
142035100100000,APARTMENT,Commercial,0,184680,184680,0,1229286,1413966
142035100200000,NW 312,Residential,29184,0,29184,95341,0,124525
142035100300000,NW 312,Residential,24000,0,24000,89338,0,113338
142035100400000,NW 312,Residential,24000,0,24000,83526,0,107526
142035100500000,NW 312,Residential,24000,0,24000,114203,0,138203
142035100600000,NW 312,Residential,24000,0,24000,108567,0,132567
142035100700000,NW 312,Residential,24000,0,24000,92110,0,116110
142035100800000,NW 312,Residential,25317,0,25317,94248,0,119565
142035100900000,NW 312,Residential,25625,0,25625,84229,0,109854
142035101800000,APARTMENT,Commercial,0,122580,122580,0,1381213,1503793
142035101900000,NW 312,Residential,26624,0,26624,128609,0,155233
142035102000000,NW 312,Residential,20188,0,20188,92039,0,112227
142035102100000,NW 312,Residential,23760,0,23760,84397,0,108157
142035102200000,NW 312,Residential,17607,0,17607,160809,0,178416
142035102300000,NW 312,Residential,23760,0,23760,103021,0,126781
142035102400000,NW 312,Residential,23760,0,23760,93313,0,117073
142035102500000,NW 312,Residential,23760,0,23760,121641,0,145401
142035102600000,NW 312,Residential,30969,0,30969,116320,0,147289
142035102700000,NW 312,Residential,479,0,479,0,0,479
142035102800000,NW 312,Residential,28200,0,28200,122454,0,150654
142035102900000,NW 312,Residential,19176,0,19176,123093,0,142269
142035103000000,NW 312,Residential,930,0,930,0,0,930
142035103100000,NW 312,Residential,51527,0,51527,238473,0,290000
142035200100000,NW 312,Residential,28613,0,28613,97972,0,126585
142035200200000,NW 312,Residential,27720,0,27720,72983,0,100703
142035200300000,NW 312,Residential,28280,0,28280,70055,0,98335
142035200400000,NW 312,Residential,28560,0,28560,90911,0,119471
142035200500000,NW 312,Residential,28560,0,28560,108613,0,137173
142035200600000,NW 312,Residential,28682,0,28682,74797,0,103479
142035200700000,NW 312,Residential,29387,0,29387,93834,0,123221
142035200800000,NW 312,Residential,26069,0,26069,109825,0,135894
142035200900000,NW 312,Residential,25433,0,25433,91281,0,116714
142035201000000,NW 312,Residential,23280,0,23280,88102,0,111382
142035201100000,NW 312,Residential,23433,0,23433,90864,0,114297
142035201200000,NW 312,Residential,24827,0,24827,78708,0,103535
142035201300000,NW 312,Residential,28292,0,28292,96782,0,125074
142035201400000,NW 312,Residential,28280,0,28280,77160,0,105440
142035201500000,NW 312,Residential,28280,0,28280,90233,0,118513
142035201600000,NW 312,Residential,29484,0,29484,95095,0,124579
142035300100000,NW 312,Residential,28000,0,28000,102720,0,130720
142035300200000,NW 312,Residential,28000,0,28000,81754,0,109754
142035300300000,NW 312,Residential,28000,0,28000,94716,0,122716
142035300400000,NW 312,Residential,28000,0,28000,79869,0,107869
142035300500000,NW 312,Residential,28120,0,28120,85802,0,113922
142035300600000,NW 312,Residential,29682,0,29682,76976,0,106658
142035400100000,APARTMENT,Commercial,0,13761,13761,0,110130,123891
142035400200000,NW 312,Residential,19012,0,19012,87862,0,106874
142035400300000,NW 312,Residential,20923,0,20923,110997,0,131920
142035501000000,NW 312,Residential,29316,0,29316,109283,0,138599
142035501100000,NW 312,Residential,23040,0,23040,72046,0,95086
142035501200000,NW 312,Residential,23040,0,23040,82868,0,105908
142035501300000,NW 312,Residential,23040,0,23040,90108,0,113148
142035501400000,NW 312,Residential,29100,0,29100,91099,0,120199
142035501500000,NW 312,Residential,29400,0,29400,97084,0,126484
142035501600000,NW 312,Residential,25600,0,25600,93470,0,119070
142035501700000,NW 312,Residential,25976,0,25976,106985,0,132961
142035600100000,NW 312,Residential,244,0,244,0,0,244
142035700100000,APARTMENT,Commercial,0,36666,36666,0,429107,465773
142035700200000,APARTMENT,Commercial,0,40905,40905,0,368653,409558
142035700300000,CITY PROPERTY,Exempt,0,0,0,0,0,0
142035700400000,NW 322,Residential,26705,0,26705,85536,0,112241
142035700500000,CITY PROPERTY,Exempt,0,0,0,0,0,0
142035700600000,NW 322,Residential,40757,0,40757,122731,0,163488
142035700700000,NW 322,Residential,30625,0,30625,77774,0,108399
142035700800000,NW 322,Residential,24745,0,24745,88406,0,113151
142035700900000,NW 322,Residential,23520,0,23520,81123,0,104643
142035701000000,NW 322,Residential,23280,0,23280,80395,0,103675
142035701100000,NW 322,Residential,29582,0,29582,97885,0,127467
142035701200000,NW 322,Residential,30660,0,30660,86782,0,117442
142035701300000,NW 322,Residential,28800,0,28800,78208,0,107008
142035701400000,NW 322,Residential,28453,0,28453,73296,0,101749
142035701500000,NW 322,Residential,24480,0,24480,85653,0,110133
142035701600000,NW 322,Residential,24360,0,24360,60619,0,84979
142035701700000,NW 322,Residential,26536,0,26536,78075,0,104611
142035701800000,NW 322,Residential,25920,0,25920,72265,0,98185
142035701900000,NW 322,Residential,26160,0,26160,52131,0,78291
142035702000000,NW 322,Residential,26400,0,26400,79628,0,106028
142035800100000,NW 322,Residential,22100,0,22100,66645,0,88745
142035800200000,NW 322,Residential,22560,0,22560,71844,0,94404
142035800300000,NW 322,Residential,22560,0,22560,80041,0,102601
142035800400000,NW 322,Residential,22560,0,22560,76344,0,98904
142035800500000,NW 322,Residential,22560,0,22560,65097,0,87657
142035800600000,NW 322,Residential,22560,0,22560,82854,0,105414
142035800700000,NW 322,Residential,23855,0,23855,103840,0,127695
142035800800000,NW 322,Residential,19967,0,19967,81058,0,101025
142035800900000,NW 322,Residential,19740,0,19740,90911,0,110651
142035801000000,NW 322,Residential,19740,0,19740,76460,0,96200
142035801100000,NW 322,Residential,19740,0,19740,86165,0,105905
142035801200000,NW 322,Residential,19740,0,19740,75642,0,95382
142035801300000,NW 322,Residential,19740,0,19740,88797,0,108537
142035801400000,NW 322,Residential,21385,0,21385,76462,0,97847
142037600100000,NW 311,Residential,20418,0,20418,77036,0,97454
142037600200000,NW 311,Residential,19796,0,19796,63749,0,83545
142037600300000,NW 311,Residential,12250,0,12250,59591,0,71841
142037600400000,NW 311,Residential,12250,0,12250,41374,0,53624
142037600500000,NW 311,Residential,14000,0,14000,74457,0,88457
142037600600000,NW 311,Residential,14000,0,14000,43262,0,57262
142037600700000,CITY PROPERTY,Exempt,0,0,0,0,0,0
142037600800000,NW 311,Residential,19600,0,19600,53978,0,73578
142037600900000,NW 311,Residential,14000,0,14000,59357,0,73357
142037601000000,NW 311,Residential,14000,0,14000,64693,0,78693
142037601100000,NW 311,Residential,13860,0,13860,55956,0,69816
142037601200000,NW 311,Residential,13860,0,13860,59697,0,73557
142037601300000,NW 311,Residential,19404,0,19404,84312,0,103716
142037601400000,NW 311,Residential,16982,0,16982,56632,0,73614
142037700100000,NW 311,Residential,28433,0,28433,83237,0,111670
142037700200000,NW 312,Residential,29136,0,29136,103370,0,132506
142037700300000,NW 312,Residential,29280,0,29280,80225,0,109505
142037700400000,NW 312,Residential,30973,0,30973,121582,0,152555
142037700500000,NW 312,Residential,29520,0,29520,93291,0,122811
142037700600000,NW 312,Residential,26400,0,26400,104407,0,130807
142037700700000,NW 312,Residential,27060,0,27060,103147,0,130207
142037700800000,NW 312,Residential,29520,0,29520,109290,0,138810
142037700900000,NW 312,Residential,29295,0,29295,102946,0,132241
142037701000000,NW 312,Residential,34648,0,34648,93970,0,128618
142037701100000,NW 312,Residential,29036,0,29036,101310,0,130346
142037701200000,NW 312,Residential,28798,0,28798,97482,0,126280
142037701300000,NW 312,Residential,29544,0,29544,101196,0,130740
142037701400000,NW 312,Residential,23590,0,23590,110258,0,133848
142037701500000,NW 312,Residential,23280,0,23280,93258,0,116538
142037701600000,NW 312,Residential,25973,0,25973,92949,0,118922
142037701700000,NW 312,Residential,28120,0,28120,88576,0,116696
142037701800000,NW 311,Residential,34227,0,34227,122452,0,156679
142037701900000,NW 311,Residential,25235,0,25235,62728,0,87963
142037702000000,NW 311,Residential,20703,0,20703,96886,0,117589
142037702100000,NW 311,Residential,23888,0,23888,108942,0,132830
142037702200000,NW 311,Residential,24000,0,24000,79832,0,103832
142037702300000,NW 311,Residential,24000,0,24000,83944,0,107944
142037702400000,NW 311,Residential,24000,0,24000,56420,0,80420
142037702500000,NW 311,Residential,24000,0,24000,63396,0,87396
142037702600000,NW 311,Residential,24000,0,24000,52202,0,76202
142037702700000,NW 311,Residential,24000,0,24000,78303,0,102303
142037702800000,NW 311,Residential,24240,0,24240,77135,0,101375
142037702900000,NW 311,Residential,24480,0,24480,67107,0,91587
142037703000000,NW 311,Residential,24720,0,24720,54057,0,78777
142037703100000,NW 311,Residential,28600,0,28600,91601,0,120201
142037703200000,NW 311,Residential,24960,0,24960,65303,0,90263
142037703300000,NW 311,Residential,27300,0,27300,82143,0,109443
142037800100000,NW 312,Residential,23538,0,23538,100205,0,123743
142037800300000,NW 312,Residential,22346,0,22346,124862,0,147208
142037800400000,NW 312,Residential,2942,0,2942,0,0,2942
142037900100000,NW 312,Residential,22560,0,22560,99250,0,121810
142037900200000,NW 312,Residential,51,0,51,0,0,51
142037900300000,NW 312,Residential,23760,0,23760,105490,0,129250
142037900400000,NW 312,Residential,23760,0,23760,137994,0,161754
142037900500000,NW 312,Residential,27720,0,27720,92368,0,120088
142037900600000,NW 312,Residential,28000,0,28000,107388,0,135388
142037900700000,NW 312,Residential,27040,0,27040,109735,0,136775
142037900800000,NW 312,Residential,26784,0,26784,94338,0,121122
142037900900000,NW 312,Residential,29392,0,29392,100749,0,130141
142037901000000,NW 312,Residential,29088,0,29088,94100,0,123188
142038000100000,NW 311,Residential,14440,0,14440,102392,0,116832
142038000200000,NW 311,Residential,19600,0,19600,68021,0,87621
142038000300000,NW 311,Residential,18900,0,18900,49464,0,68364
142038000400000,NW 311,Residential,18900,0,18900,73753,0,92653
142038000500000,NW 311,Residential,14000,0,14000,72586,0,86586
142038000600000,NW 311,Residential,19600,0,19600,70655,0,90255
142038000700000,NW 311,Residential,27300,0,27300,79013,0,106313
142038000800000,NW 311,Residential,14000,0,14000,47370,0,61370
142038000900000,NW 311,Residential,19600,0,19600,58351,0,77951
142038001000000,NW 311,Residential,14000,0,14000,47565,0,61565
142038001100000,NW 311,Residential,19798,0,19798,78881,0,98679
142038001200000,NW 311,Residential,15000,0,15000,54733,0,69733
142038001300000,NW 311,Residential,11900,0,11900,63813,0,75713
142038001500000,NW 311,Residential,12861,0,12861,50184,0,63045
142038001600000,NW 311,Residential,19981,0,19981,84433,0,104414
142038001700000,NW 311,Residential,16000,0,16000,61857,0,77857
142038001800000,NW 311,Residential,16000,0,16000,74491,0,90491
142038001900000,NW 311,Residential,16000,0,16000,67346,0,83346
142038002000000,NW 311,Residential,16000,0,16000,72855,0,88855
142038002100000,NW 311,Residential,14000,0,14000,58447,0,72447
142038002200000,NW 311,Residential,16000,0,16000,68432,0,84432
142038002300000,NW 311,Residential,16000,0,16000,56310,0,72310
142038002400000,NW 311,Residential,19200,0,19200,63774,0,82974
142038002500000,NW 311,Residential,18700,0,18700,72495,0,91195
142038002600000,NW 311,Residential,16000,0,16000,68350,0,84350
142038002700000,NW 311,Residential,16000,0,16000,65865,0,81865
142038002800000,NW 311,Residential,16000,0,16000,73351,0,89351
142038002900000,NW 311,Residential,15560,0,15560,69782,0,85342
142038100100000,NW 311,Residential,16440,0,16440,60569,0,77009
142038100200000,NW 311,Residential,16000,0,16000,54110,0,70110
142038100300000,NW 311,Residential,16000,0,16000,71329,0,87329
142038100400000,NW 311,Residential,14000,0,14000,74601,0,88601
142038100500000,CITY PROPERTY,Exempt,0,0,0,0,0,0
142038100600000,NW 311,Residential,16000,0,16000,68008,0,84008
142038100700000,NW 311,Residential,16000,0,16000,73215,0,89215
142038100800000,NW 311,Residential,16000,0,16000,57308,0,73308
142038100900000,NW 311,Residential,14000,0,14000,58425,0,72425
142038101000000,NW 311,Residential,16000,0,16000,81610,0,97610
142038101100000,NW 311,Residential,16000,0,16000,65784,0,81784
142038101200000,NW 311,Residential,16000,0,16000,80378,0,96378
142038101300000,NW 311,Residential,16000,0,16000,79611,0,95611
142038101400000,NW 311,Residential,16000,0,16000,59601,0,75601
142038101500000,NW 311,Residential,14651,0,14651,63908,0,78559
142038101600000,NW 311,Residential,14781,0,14781,77830,0,92611
142038101700000,NW 311,Residential,17220,0,17220,67909,0,85129
142038101800000,NW 311,Residential,18900,0,18900,81840,0,100740
142038101900000,NW 311,Residential,14317,0,14317,79556,0,93873
142038102000000,NW 311,Residential,14000,0,14000,62401,0,76401
142038102100000,NW 311,Residential,16000,0,16000,57812,0,73812
142038102200000,NW 311,Residential,16000,0,16000,67117,0,83117
142038102300000,NW 311,Residential,16000,0,16000,66622,0,82622
142038102400000,NW 311,Residential,16000,0,16000,73471,0,89471
142038102500000,NW 311,Residential,16000,0,16000,60586,0,76586
142038102600000,NW 311,Residential,16000,0,16000,87621,0,103621
142038102700000,NW 311,Residential,16000,0,16000,66562,0,82562
142038102800000,NW 311,Residential,15560,0,15560,53576,0,69136
142038102900000,NW 311,Residential,17600,0,17600,74988,0,92588
142038103000000,NW 311,Residential,17600,0,17600,63370,0,80970
142038103100000,NW 311,Residential,17600,0,17600,75823,0,93423
142038103200000,NW 311,Residential,17600,0,17600,90581,0,108181
142038103300000,NW 311,Residential,17600,0,17600,84569,0,102169
142038200100000,NW 311,Residential,17600,0,17600,84810,0,102410
142038200200000,NW 311,Residential,17600,0,17600,69111,0,86711
142038200300000,NW 311,Residential,17600,0,17600,78474,0,96074
142038200400000,NW 311,Residential,19200,0,19200,55049,0,74249
142038200500000,NW 311,Residential,16000,0,16000,81978,0,97978
142038200600000,NW 311,Residential,16440,0,16440,79237,0,95677
142038200700000,NW 311,Residential,16000,0,16000,71026,0,87026
142038200800000,NW 311,Residential,16000,0,16000,50117,0,66117
142038200900000,NW 311,Residential,16000,0,16000,55861,0,71861
142038201000000,NW 311,Residential,16000,0,16000,71466,0,87466
142038201100000,NW 311,Residential,16000,0,16000,72504,0,88504
142038201200000,NW 311,Residential,16000,0,16000,71465,0,87465
142038201300000,NW 311,Residential,16000,0,16000,77821,0,93821
142038201400000,NW 311,Residential,18000,0,18000,56938,0,74938
142038201500000,NW 311,Residential,17765,0,17765,76417,0,94182
142038201600000,NW 311,Residential,12180,0,12180,46664,0,58844
142038201700000,NW 311,Residential,12600,0,12600,69322,0,81922
142038201800000,NW 311,Residential,19224,0,19224,78081,0,97305
142038201900000,NW 311,Residential,19550,0,19550,57372,0,76922
142038202000000,NW 311,Residential,16000,0,16000,0,0,16000
142038202100000,NW 311,Residential,16000,0,16000,47480,0,63480
142038202200000,NW 311,Residential,16000,0,16000,59335,0,75335
142038202300000,NW 311,Residential,16000,0,16000,60399,0,76399
142038202400000,NW 311,Residential,16000,0,16000,57325,0,73325
142038202500000,NW 311,Residential,17560,0,17560,91915,0,109475
142038202600000,NW 311,Residential,14000,0,14000,82725,0,96725
142038202700000,NW 311,Residential,17600,0,17600,73891,0,91491
142038202800000,NW 311,Residential,15840,0,15840,0,0,15840
142038202900000,NW 311,Residential,17600,0,17600,75735,0,93335
142038203000000,NW 311,Residential,16000,0,16000,65343,0,81343
142038203100000,NW 311,Residential,19200,0,19200,66938,0,86138
142038300100000,NW 311,Residential,16669,0,16669,62186,0,78855
142038300200000,NW 311,Residential,16450,0,16450,74589,0,91039
142038300300000,NW 311,Residential,14280,0,14280,37159,0,51439
142038300400000,NW 311,Residential,21210,0,21210,58425,0,79635
142038300500000,NW 311,Residential,15283,0,15283,63651,0,78934
142038300600000,NW 311,Residential,15633,0,15633,61017,0,76650
142038300700000,NW 311,Residential,16632,0,16632,69334,0,85966
142038300800000,NW 311,Residential,15957,0,15957,60277,0,76234
142038300900000,NW 311,Residential,18111,0,18111,55086,0,73197
142038301000000,NW 311,Residential,20503,0,20503,66237,0,86740
142038301100000,NW 311,Residential,18207,0,18207,30874,0,49081
142038301200000,NW 311,Residential,21728,0,21728,64965,0,86693
142038301300000,NW 311,Residential,16000,0,16000,35302,0,51302
142038301400000,NW 311,Residential,20400,0,20400,63058,0,83458
142038301500000,NW 311,Residential,20400,0,20400,55929,0,76329
142038301600000,NW 311,Residential,21326,0,21326,77844,0,99170
142038301700000,NW 311,Residential,21000,0,21000,30377,0,51377
142038301800000,NW 311,Residential,12460,0,12460,54594,0,67054
142038400100000,APARTMENT,Commercial,0,33826,33826,0,291744,325570
142040100100000,CITY PROPERTY,Exempt,0,0,0,0,0,0
142040100200000,CITY PROPERTY,Exempt,0,0,0,0,0,0
142040100300000,CITY PROPERTY,Exempt,0,0,0,0,0,0
142040100400000,CITY PROPERTY,Exempt,0,0,0,0,0,0
142040100500000,NW 317,Residential,7920,0,7920,0,0,7920
142040100600000,CITY PROPERTY,Exempt,0,0,0,0,0,0
142040100700000,CITY PROPERTY,Exempt,0,0,0,0,0,0
142040100800000,WAREHOUSE;MINI STORG,Commercial,0,10327,10327,0,16628,26955
142040100900000,CITY PROPERTY,Exempt,0,0,0,0,0,0
142040101000000,CITY PROPERTY,Exempt,0,0,0,0,0,0
142040200100000,CITY PROPERTY,Exempt,0,0,0,0,0,0
142040200200000,CITY PROPERTY,Exempt,0,0,0,0,0,0
142040200300000,CITY PROPERTY,Exempt,0,0,0,0,0,0
142040200400000,CITY PROPERTY,Exempt,0,0,0,0,0,0
142040200500000,CITY PROPERTY,Exempt,0,0,0,0,0,0
142040200600000,CITY PROPERTY,Exempt,0,0,0,0,0,0
142040200700000,CITY PROPERTY,Exempt,0,0,0,0,0,0
142040200800000,CITY PROPERTY,Exempt,0,0,0,0,0,0
142040200900000,CITY PROPERTY,Exempt,0,0,0,0,0,0
142040201000000,CITY PROPERTY,Exempt,0,0,0,0,0,0
142040201100000,CITY PROPERTY,Exempt,0,0,0,0,0,0
142040201200000,CITY PROPERTY,Exempt,0,0,0,0,0,0
142040201300000,CITY PROPERTY,Exempt,0,0,0,0,0,0
142040201400000,CITY PROPERTY,Exempt,0,0,0,0,0,0
142040201500000,CITY PROPERTY,Exempt,0,0,0,0,0,0
142040201600000,CITY PROPERTY,Exempt,0,0,0,0,0,0
142040201700000,CITY PROPERTY,Exempt,0,0,0,0,0,0
142040201800000,CITY PROPERTY,Exempt,0,0,0,0,0,0
142040201900000,CITY PROPERTY,Exempt,0,0,0,0,0,0
142040202000000,CITY PROPERTY,Exempt,0,0,0,0,0,0
142040202200000,NW 317,Residential,10296,0,10296,42620,0,52916
142040202300000,CITY PROPERTY,Exempt,0,0,0,0,0,0
142040300100000,CITY PROPERTY,Exempt,0,0,0,0,0,0
142040300200000,NW 317,Residential,7500,0,7500,0,0,7500
142040300300000,CITY PROPERTY,Exempt,0,0,0,0,0,0
142040300400000,CITY PROPERTY,Exempt,0,0,0,0,0,0
142040300500000,CITY PROPERTY,Exempt,0,0,0,0,0,0
142040300600000,CITY PROPERTY,Exempt,0,0,0,0,0,0
142040300700000,CITY PROPERTY,Exempt,0,0,0,0,0,0
142040300800000,NW 317,Residential,5000,0,5000,0,0,5000
142040300900000,VACANT LAND,Commercial,0,3758,3758,0,0,3758
142040301100000,CITY PROPERTY,Exempt,0,0,0,0,0,0
142040301200000,CITY PROPERTY,Exempt,0,0,0,0,0,0
142040301400000,NW 317,Residential,9000,0,9000,0,0,9000
142040301500000,CITY PROPERTY,Exempt,0,0,0,0,0,0
142040301600000,CITY PROPERTY,Exempt,0,0,0,0,0,0
142040301700000,NW 317,Residential,9000,0,9000,31474,0,40474
142040301800000,NW 317,Residential,7500,0,7500,0,0,7500
142040301900000,CITY PROPERTY,Exempt,0,0,0,0,0,0
142040400100000,NW 310,Residential,12994,0,12994,59008,0,72002
142040400200000,CITY PROPERTY,Exempt,0,0,0,0,0,0
142040400300000,NW 310,Residential,10915,0,10915,35125,0,46040
142040400400000,NW 310,Residential,7276,0,7276,47951,0,55227
142040400600000,CITY PROPERTY,Exempt,0,0,0,0,0,0
142040400700000,NW 310,Residential,5000,0,5000,0,0,5000
142040400800000,CITY PROPERTY,Exempt,0,0,0,0,0,0
142040400900000,CITY PROPERTY,Exempt,0,0,0,0,0,0
142040401000000,CITY PROPERTY,Exempt,0,0,0,0,0,0
142040401100000,CITY PROPERTY,Exempt,0,0,0,0,0,0
142040401200000,CITY PROPERTY,Exempt,0,0,0,0,0,0
142040401300000,CITY PROPERTY,Exempt,0,0,0,0,0,0
142040401400000,NW 310,Residential,12994,0,12994,48085,0,61079
142040401500000,NW 310,Residential,17325,0,17325,64960,0,82285
142040401600000,CITY PROPERTY,Exempt,0,0,0,0,0,0
142040401700000,CITY PROPERTY,Exempt,0,0,0,0,0,0
142040500100000,NW 310,Residential,12994,0,12994,34949,0,47943
142040500200000,NW 310,Residential,5000,0,5000,0,0,5000
142040500300000,NW 310,Residential,12600,0,12600,47154,0,59754
142040500400000,CITY PROPERTY,Exempt,0,0,0,0,0,0
142040500500000,NW 310,Residential,5000,0,5000,0,0,5000
142040500600000,CITY PROPERTY,Exempt,0,0,0,0,0,0
142040500700000,NW 310,Residential,11137,0,11137,0,0,11137
142040500800000,RESTAURANT,Commercial,0,36858,36858,0,158581,195439
142040500900000,VACANT LAND,Commercial,0,10000,10000,0,0,10000
142040501000000,CITY PROPERTY,Exempt,0,0,0,0,0,0
142040501100000,CITY PROPERTY,Exempt,0,0,0,0,0,0
142040501200000,NW 310,Residential,12994,0,12994,37561,0,50555
142040501300000,CITY PROPERTY,Exempt,0,0,0,0,0,0
142040501400000,NW 310,Residential,12994,0,12994,28410,0,41404
142040501500000,NW 310,Residential,12994,0,12994,34334,0,47328
142040501600000,NW 310,Residential,12994,0,12994,35104,0,48098
142040600100000,WAREHOUSE,Commercial,0,188217,188217,0,1084269,1272486
142040600200000,CITY PROPERTY,Exempt,0,0,0,0,0,0
142040600300000,CITY PROPERTY,Exempt,0,0,0,0,0,0
142040600400000,NW 310,Residential,2970,0,2970,0,0,2970
142040600500000,CITY PROPERTY,Exempt,0,0,0,0,0,0
142040600600000,NW 310,Residential,5000,0,5000,0,0,5000
142040600700000,NW 310,Residential,7325,0,7325,0,0,7325
142040600800000,NW 310,Residential,12994,0,12994,35339,0,48333
142040600900000,CITY PROPERTY,Exempt,0,0,0,0,0,0
142040601000000,NW 310,Residential,5000,0,5000,0,0,5000
142040601100000,CITY PROPERTY,Exempt,0,0,0,0,0,0
142040601200000,CITY PROPERTY,Exempt,0,0,0,0,0,0
142040601300000,CITY PROPERTY,Exempt,0,0,0,0,0,0
142040601400000,NW 310,Residential,12994,0,12994,0,0,12994
142040601500000,CITY PROPERTY,Exempt,0,0,0,0,0,0
142040601600000,CITY PROPERTY,Exempt,0,0,0,0,0,0
142040602400000,NW 317,Exempt,0,0,0,0,0,0
142040602500000,CITY PROPERTY,Exempt,0,0,0,0,0,0
142040602600000,CITY PROPERTY,Exempt,0,0,0,0,0,0
142040602700000,CITY PROPERTY,Exempt,0,0,0,0,0,0
142040602800000,CITY PROPERTY,Exempt,0,0,0,0,0,0
142040602900000,CITY PROPERTY,Exempt,0,0,0,0,0,0
142040700100000,NW 310,Residential,0,0,0,0,0,0
142040700200000,CITY PROPERTY,Exempt,0,0,0,0,0,0
142040700300000,CITY PROPERTY,Exempt,0,0,0,0,0,0
142040700400000,CITY PROPERTY,Exempt,0,0,0,0,0,0
142040700500000,CITY PROPERTY,Exempt,0,0,0,0,0,0
142040700600000,NW 310,Residential,14850,0,14850,49791,0,64641
142040700700000,CITY PROPERTY,Exempt,0,0,0,0,0,0
142040700800000,CITY PROPERTY,Exempt,0,0,0,0,0,0
142040700900000,CITY PROPERTY,Exempt,0,0,0,0,0,0
142040701000000,CITY PROPERTY,Exempt,0,0,0,0,0,0
142040701100000,CITY PROPERTY,Exempt,0,0,0,0,0,0
142040701200000,NW 310,Residential,4830,0,4830,0,0,4830
142040701300000,CITY PROPERTY,Exempt,0,0,0,0,0,0
142040701400000,NW 310,Residential,7796,0,7796,0,0,7796
142040701500000,NW 310,Residential,7796,0,7796,0,0,7796
142040701600000,CITY PROPERTY,Exempt,0,0,0,0,0,0
142040701700000,NW 310,Residential,5000,0,5000,0,0,5000
142040701800000,NW 310,Residential,12994,0,12994,42112,0,55106
142040701900000,CITY PROPERTY,Exempt,0,0,0,0,0,0
142040800100000,CITY PROPERTY,Exempt,0,0,0,0,0,0
142040800200000,CITY PROPERTY,Exempt,0,0,0,0,0,0
142040800300000,CITY PROPERTY,Exempt,0,0,0,0,0,0
142040800400000,CITY PROPERTY,Exempt,0,0,0,0,0,0
142040800500000,CITY PROPERTY,Exempt,0,0,0,0,0,0
142040800600000,CITY PROPERTY,Exempt,0,0,0,0,0,0
142040800700000,NW 317,Residential,5750,0,5750,0,0,5750
142040800800000,CITY PROPERTY,Exempt,0,0,0,0,0,0
142040800900000,CITY PROPERTY,Exempt,0,0,0,0,0,0
142040801000000,CITY PROPERTY,Exempt,0,0,0,0,0,0
142040801100000,COUNTY PROPERTY,Exempt,0,0,0,0,0,0
142040801200000,NW 317,Residential,4575,0,4575,0,0,4575
142040801300000,NW 317,Residential,4392,0,4392,0,0,4392
142040801400000,NW 317,Residential,5000,0,5000,0,0,5000
142040801500000,NW 317,Residential,3264,0,3264,0,0,3264
142040801600000,CITY PROPERTY,Exempt,0,0,0,0,0,0
142040801700000,CITY PROPERTY,Exempt,0,0,0,0,0,0
142040901700000,CITY PROPERTY,Exempt,0,0,0,0,0,0
142040901800000,CITY PROPERTY,Exempt,0,0,0,0,0,0
142040901900000,NW 310,Residential,12994,0,12994,56134,0,69128
142040902000000,NW 310,Residential,12994,0,12994,0,0,12994
142040902100000,NW 310,Residential,9281,0,9281,44678,0,53959
142040902200000,CITY PROPERTY,Exempt,0,0,0,0,0,0
142040902300000,NW 310,Residential,9281,0,9281,36146,0,45427
142041000100000,CITY PROPERTY,Exempt,0,0,0,0,0,0
142041000200000,NW 310,Residential,10395,0,10395,0,0,10395
142041000300000,CITY PROPERTY,Exempt,0,0,0,0,0,0
142041000400000,CITY PROPERTY,Exempt,0,0,0,0,0,0
142041000500000,NW 310,Residential,14850,0,14850,0,0,14850
142041000600000,CITY PROPERTY,Exempt,0,0,0,0,0,0
142041000700000,CITY PROPERTY,Exempt,0,0,0,0,0,0
142041000800000,NW 310,Residential,11695,0,11695,55075,0,66770
142041000900000,CITY PROPERTY,Exempt,0,0,0,0,0,0
142041001000000,CITY PROPERTY,Exempt,0,0,0,0,0,0
142041001100000,NW 310,Residential,5000,0,5000,0,0,5000
142041001200000,CITY PROPERTY,Exempt,0,0,0,0,0,0
142041001300000,NW 310,Residential,11695,0,11695,50133,0,61828
142041001400000,CITY PROPERTY,Exempt,0,0,0,0,0,0
142041001500000,CITY PROPERTY,Exempt,0,0,0,0,0,0
142041100100000,NW 317,Residential,5000,0,5000,20050,0,25050
142041100200000,CITY PROPERTY,Exempt,0,0,0,0,0,0
142041100300000,CITY PROPERTY,Exempt,0,0,0,0,0,0
142041100400000,CITY PROPERTY,Exempt,0,0,0,0,0,0
142041100500000,CENTRALLY ASSESSED,Other,0,0,0,0,0,0
142042600100000,NW 310,Residential,14850,0,14850,63846,0,78696
142042600200000,NW 310,Residential,14850,0,14850,59996,0,74846
142042600300000,CITY PROPERTY,Exempt,0,0,0,0,0,0
142042600400000,CITY PROPERTY,Exempt,0,0,0,0,0,0
142042600500000,NW 310,Residential,14850,0,14850,33480,0,48330
142042600600000,NW 310,Residential,14850,0,14850,60220,0,75070
142042600700000,NW 310,Residential,2970,0,2970,0,0,2970
142042600800000,SMALL RETAIL,Commercial,0,44348,44348,0,48265,92613
142042600900000,AUTO REPAIR/SALES,Commercial,0,15552,15552,0,42731,58283
142042601000000,CONVERSION,Commercial,0,7776,7776,0,69682,77458
142042601100000,FLAT PARKING,Commercial,0,10000,10000,0,0,10000
142042601200000,CITY PROPERTY,Exempt,0,0,0,0,0,0
142042601300000,NW 310,Residential,14850,0,14850,52030,0,66880
142042601400000,NW 310,Residential,14850,0,14850,55633,0,70483
142042601500000,NW 310,Residential,14850,0,14850,44262,0,59112
142042700100000,NW 310,Residential,14850,0,14850,45523,0,60373
142042700200000,NW 310,Residential,14850,0,14850,41583,0,56433
142042700300000,NW 310,Residential,14850,0,14850,62622,0,77472
142042700400000,NW 310,Residential,14850,0,14850,35305,0,50155
142042700500000,NW 310,Residential,14850,0,14850,0,0,14850
142042700600000,NW 310,Residential,14850,0,14850,65765,0,80615
142042700700000,NW 310,Residential,14850,0,14850,33213,0,48063
142042700800000,CITY PROPERTY,Exempt,0,0,0,0,0,0
142042700900000,NW 310,Residential,14850,0,14850,35914,0,50764
142042701000000,NW 310,Residential,14850,0,14850,84669,0,99519
142042701100000,NW 310,Residential,7425,0,7425,35157,0,42582
142042701200000,NW 310,Residential,7425,0,7425,38372,0,45797
142042701300000,NW 310,Residential,14850,0,14850,26501,0,41351
142042701400000,NW 310,Residential,14850,0,14850,35301,0,50151
142042701500000,NW 310,Residential,14850,0,14850,37756,0,52606
142042701600000,NW 310,Residential,14850,0,14850,35136,0,49986
142042701700000,NW 310,Residential,14850,0,14850,37578,0,52428
142042800100000,CITY PROPERTY,Exempt,0,0,0,0,0,0
142042800200000,NW 310,Residential,15592,0,15592,46222,0,61814
142042800300000,CITY PROPERTY,Exempt,0,0,0,0,0,0
142042800400000,NW 310,Residential,11880,0,11880,35886,0,47766
142042800500000,NW 310,Residential,5000,0,5000,0,0,5000
142042800600000,NW 310,Residential,14850,0,14850,35996,0,50846
142042800700000,NW 310,Residential,14850,0,14850,40613,0,55463
142042800800000,CITY PROPERTY,Exempt,0,0,0,0,0,0
142042800900000,NW 310,Residential,5000,0,5000,0,0,5000
142042801000000,NW 310,Residential,9800,0,9800,0,0,9800
142042801100000,NW 310,Residential,14850,0,14850,35010,0,49860
142042801200000,NW 310,Residential,14850,0,14850,48000,0,62850
142042801300000,NW 310,Residential,14850,0,14850,35148,0,49998
142042801400000,NW 310,Residential,14850,0,14850,61531,0,76381
142042801500000,NW 310,Residential,5000,0,5000,0,0,5000
142042801600000,NW 310,Residential,14850,0,14850,36989,0,51839
142042900100000,NW 310,Residential,14850,0,14850,0,0,14850
142042900200000,NW 310,Residential,20400,0,20400,37719,0,58119
142042900300000,NW 310,Residential,20400,0,20400,81775,0,102175
142042900400000,NW 310,Residential,20400,0,20400,54892,0,75292
142042900500000,NW 310,Residential,20400,0,20400,65657,0,86057
142042900600000,NW 310,Residential,20400,0,20400,51320,0,71720
142042900700000,NW 310,Residential,20400,0,20400,59342,0,79742
142042900800000,NW 310,Residential,20400,0,20400,53648,0,74048
142042900900000,NW 310,Residential,18360,0,18360,0,0,18360
142042901000000,CITY PROPERTY,Exempt,0,0,0,0,0,0
142042901100000,NW 310,Residential,14850,0,14850,34293,0,49143
142042901200000,NW 310,Residential,14850,0,14850,38860,0,53710
142042901300000,NW 310,Residential,14850,0,14850,55178,0,70028
142042901400000,CITY PROPERTY,Exempt,0,0,0,0,0,0
142042901500000,NW 310,Residential,14850,0,14850,59896,0,74746
142042901600000,NW 310,Residential,14850,0,14850,60792,0,75642
142043000100000,CITY PROPERTY,Exempt,0,0,0,0,0,0
142043000200000,NW 310,Residential,14850,0,14850,32446,0,47296
142043000300000,NW 310,Residential,14850,0,14850,33276,0,48126
142043000400000,CITY PROPERTY,Exempt,0,0,0,0,0,0
142043000500000,CITY PROPERTY,Exempt,0,0,0,0,0,0
142043000600000,NW 310,Residential,14850,0,14850,50060,0,64910
142043000700000,NW 310,Residential,14850,0,14850,47488,0,62338
142043001100000,CITY PROPERTY,Exempt,0,0,0,0,0,0
142043001200000,NW 310,Residential,14850,0,14850,0,0,14850
142043001300000,NW 310,Residential,7425,0,7425,26166,0,33591
142043001400000,NW 310,Residential,7425,0,7425,0,0,7425
142043001500000,NW 310,Residential,14850,0,14850,32826,0,47676
142043001600000,NW 310,Residential,5000,0,5000,0,0,5000
142043001700000,NW 310,Residential,9801,0,9801,46311,0,56112
142043001800000,CITY PROPERTY,Exempt,0,0,0,0,0,0
142043001900000,CITY PROPERTY,Exempt,0,0,0,0,0,0
142043002000000,NW 310,Residential,23760,0,23760,47958,0,71718
142043100100000,NW 310,Residential,14850,0,14850,39211,0,54061
142043100200000,CITY PROPERTY,Exempt,0,0,0,0,0,0
142043100300000,NW 310,Residential,14850,0,14850,45387,0,60237
142043100400000,NW 310,Residential,14850,0,14850,20865,0,35715
142043100500000,NW 310,Residential,14850,0,14850,59887,0,74737
142043100600000,NW 310,Residential,14850,0,14850,51385,0,66235
142043100700000,NW 310,Residential,14850,0,14850,44762,0,59612
142043100800000,NW 310,Residential,14850,0,14850,0,0,14850
142043100900000,NW 310,Residential,14850,0,14850,44928,0,59778
142043101000000,NW 310,Residential,14850,0,14850,48404,0,63254
142043101100000,CITY PROPERTY,Exempt,0,0,0,0,0,0
142043101200000,CITY PROPERTY,Exempt,0,0,0,0,0,0
142043101300000,NW 310,Residential,9800,0,9800,0,0,9800
142043101400000,NW 310,Residential,14850,0,14850,23908,0,38758
142043101500000,NW 310,Residential,14850,0,14850,46495,0,61345
142043101600000,NW 310,Residential,14850,0,14850,39864,0,54714
142043200100000,NW 310,Residential,5000,0,5000,0,0,5000
142043200200000,NW 310,Residential,14850,0,14850,65745,0,80595
142043200300000,NW 310,Residential,14850,0,14850,32677,0,47527
142043200400000,NW 310,Residential,14850,0,14850,53349,0,68199
142043200500000,CITY PROPERTY,Exempt,0,0,0,0,0,0
142043200600000,CITY PROPERTY,Exempt,0,0,0,0,0,0
142043200700000,NW 310,Residential,14850,0,14850,45911,0,60761
142043200800000,NW 310,Residential,14850,0,14850,41764,0,56614
142043200900000,NW 310,Residential,14850,0,14850,48518,0,63368
142043201000000,NW 310,Residential,5450,0,5450,27172,0,32622
142043201100000,NW 310,Residential,11092,0,11092,70315,0,81407
142043201200000,CITY PROPERTY,Exempt,0,0,0,0,0,0
142043201300000,NW 310,Residential,14850,0,14850,49497,0,64347
142043201400000,NW 310,Residential,9800,0,9800,0,0,9800
142043201500000,NW 310,Residential,5000,0,5000,0,0,5000
142043201600000,CITY PROPERTY,Exempt,0,0,0,0,0,0
142043201700000,CITY PROPERTY,Exempt,0,0,0,0,0,0
142043300100000,CITY PROPERTY,Exempt,0,0,0,0,0,0
142043300200000,NW 310,Residential,15300,0,15300,27807,0,43107
142043300300000,NW 310,Residential,15300,0,15300,44195,0,59495
142043300400000,NW 310,Residential,15300,0,15300,88474,0,103774
142043300500000,NW 310,Residential,15300,0,15300,39591,0,54891
142043300600000,NW 310,Residential,15300,0,15300,71082,0,86382
142043300700000,CITY PROPERTY,Exempt,0,0,0,0,0,0
142043300800000,NW 310,Residential,12000,0,12000,42638,0,54638
142043300900000,NW 310,Residential,12000,0,12000,49537,0,61537
142043301000000,NW 310,Residential,13855,0,13855,46555,0,60410
142043301100000,NW 310,Residential,5790,0,5790,0,0,5790
142043301200000,NW 310,Residential,16706,0,16706,43085,0,59791
142043301300000,NW 310,Residential,14850,0,14850,44796,0,59646
142043301400000,NW 310,Residential,14850,0,14850,52209,0,67059
142043301500000,NW 310,Residential,14850,0,14850,54910,0,69760
142043301600000,NW 310,Residential,14850,0,14850,21002,0,35852
142043400100000,NW 310,Residential,14850,0,14850,68683,0,83533
142043400200000,CITY PROPERTY,Exempt,0,0,0,0,0,0
142043400300000,CITY PROPERTY,Exempt,0,0,0,0,0,0
142043400400000,CITY PROPERTY,Exempt,0,0,0,0,0,0
142043400500000,NW 310,Residential,9800,0,9800,0,0,9800
142043400600000,NW 310,Residential,14850,0,14850,49608,0,64458
142043400700000,CITY PROPERTY,Exempt,0,0,0,0,0,0
142043400800000,NW 310,Residential,11880,0,11880,0,0,11880
142043400900000,SMALL RETAIL,Commercial,0,12442,12442,0,8986,21428
142043401000000,CITY PROPERTY,Exempt,0,0,0,0,0,0
142043401100000,NW 310,Residential,14850,0,14850,36673,0,51523
142043401200000,APARTMENT,Commercial,0,6739,6739,0,56455,63194
142043401300000,APARTMENT,Commercial,0,6739,6739,0,58033,64772
142043401400000,CITY PROPERTY,Exempt,0,0,0,0,0,0
142043500100000,CITY PROPERTY,Exempt,0,0,0,0,0,0
142043500200000,NW 310,Residential,12994,0,12994,31988,0,44982
142043500300000,NW 310,Residential,12994,0,12994,55087,0,68081
142043500400000,NW 310,Residential,12994,0,12994,41290,0,54284
142043500500000,NW 310,Residential,5000,0,5000,0,0,5000
142043500600000,NW 310,Residential,7325,0,7325,0,0,7325
142043500700000,NW 310,Residential,12994,0,12994,45452,0,58446
142043500800000,NW 310,Residential,10395,0,10395,43722,0,54117
142043500900000,NW 310,Residential,5840,0,5840,0,0,5840
142043501000000,CITY PROPERTY,Exempt,0,0,0,0,0,0
142043501100000,NW 310,Residential,14850,0,14850,21632,0,36482
142043501200000,CITY PROPERTY,Exempt,0,0,0,0,0,0
142043501300000,CITY PROPERTY,Exempt,0,0,0,0,0,0
142043501400000,CITY PROPERTY,Exempt,0,0,0,0,0,0
142043501500000,NW 310,Residential,5000,0,5000,0,0,5000
142043600100000,NW 310,Residential,5000,0,5000,0,0,5000
142043600200000,NW 310,Residential,14850,0,14850,38434,0,53284
142043600300000,CITY PROPERTY,Exempt,0,0,0,0,0,0
142043600400000,NW 310,Residential,5000,0,5000,0,0,5000
142043600500000,NW 310,Residential,14850,0,14850,62161,0,77011
142043600600000,NW 310,Residential,14850,0,14850,0,0,14850
142043600700000,CITY PROPERTY,Exempt,0,0,0,0,0,0
142043600800000,CITY PROPERTY,Exempt,0,0,0,0,0,0
142043600900000,NW 310,Residential,10395,0,10395,64078,0,74473
142043601000000,NW 310,Residential,12994,0,12994,51910,0,64904
142043601100000,NW 310,Residential,12994,0,12994,28004,0,40998
142043601200000,NW 310,Residential,5000,0,5000,0,0,5000
142043601300000,NW 310,Residential,12994,0,12994,54110,0,67104
142043601400000,NW 310,Residential,12994,0,12994,48409,0,61403
142043700100000,CITY PROPERTY,Exempt,0,0,0,0,0,0
142043700200000,NW 310,Residential,15300,0,15300,34949,0,50249
142043700300000,NW 310,Residential,10400,0,10400,0,0,10400
142043700400000,NW 310,Residential,15300,0,15300,39522,0,54822
142043700500000,NW 310,Residential,15300,0,15300,64468,0,79768
142043700600000,NW 310,Residential,9945,0,9945,0,0,9945
142043700700000,NW 310,Residential,9945,0,9945,37185,0,47130
142043700800000,NW 310,Residential,12240,0,12240,26623,0,38863
142043700900000,CITY PROPERTY,Exempt,0,0,0,0,0,0
142043701000000,CITY PROPERTY,Exempt,0,0,0,0,0,0
142043701100000,NW 310,Residential,9800,0,9800,0,0,9800
142043701200000,CITY PROPERTY,Exempt,0,0,0,0,0,0
142043701300000,NW 310,Residential,14850,0,14850,34363,0,49213
142043701400000,CITY PROPERTY,Exempt,0,0,0,0,0,0
142045100100000,NW 311,Residential,9975,0,9975,47287,0,57262
142045100200000,NW 311,Residential,5000,0,5000,0,0,5000
142045100300000,NW 311,Residential,7980,0,7980,46304,0,54284
142045100400000,NW 311,Residential,8208,0,8208,56464,0,64672
142045100500000,NW 311,Residential,5000,0,5000,0,0,5000
142045100600000,NW 311,Residential,5000,0,5000,0,0,5000
142045100700000,CITY PROPERTY,Exempt,0,0,0,0,0,0
142045100800000,NW 311,Residential,18000,0,18000,77897,0,95897
142045100900000,NW 311,Residential,5000,0,5000,0,0,5000
142045200100000,NW 311,Residential,5552,0,5552,21069,0,26621
142045200200000,NW 311,Residential,10200,0,10200,42362,0,52562
142045200300000,NW 311,Residential,12000,0,12000,48812,0,60812
142045200400000,NW 311,Residential,12000,0,12000,61268,0,73268
142045200500000,NW 311,Residential,7455,0,7455,17991,0,25446
142045200600000,NW 311,Residential,8520,0,8520,39835,0,48355
142045200700000,NW 311,Residential,12000,0,12000,47619,0,59619
142045200800000,NW 311,Residential,12000,0,12000,31687,0,43687
142045200900000,NW 311,Residential,12000,0,12000,31264,0,43264
142045201000000,NW 311,Residential,12000,0,12000,70508,0,82508
142045300100000,NW 311,Residential,13600,0,13600,44201,0,57801
142045300200000,NW 311,Residential,13600,0,13600,65077,0,78677
142045300300000,NW 311,Residential,13600,0,13600,50894,0,64494
142045300400000,NW 311,Residential,13600,0,13600,52028,0,65628
142045300500000,NW 311,Residential,13600,0,13600,47947,0,61547
142045300600000,NW 311,Residential,13600,0,13600,32105,0,45705
142045300700000,NW 311,Residential,13600,0,13600,50894,0,64494
142045300800000,NW 311,Residential,13600,0,13600,58923,0,72523
142045400100000,NW 311,Residential,19754,0,19754,61344,0,81098
142045400200000,NW 311,Residential,13600,0,13600,70744,0,84344
142045400300000,NW 311,Residential,9656,0,9656,36899,0,46555
142045400400000,NW 311,Residential,8211,0,8211,52899,0,61110
142045500100000,NW 311,Residential,11400,0,11400,48794,0,60194
142045500200000,NW 311,Residential,12000,0,12000,46618,0,58618
142045500300000,NW 311,Residential,12000,0,12000,44528,0,56528
142045500400000,CITY PROPERTY,Exempt,0,0,0,0,0,0
142045500500000,CITY PROPERTY,Exempt,0,0,0,0,0,0
142045500600000,NW 311,Residential,10800,0,10800,54911,0,65711
142045500700000,NW 311,Residential,10800,0,10800,42353,0,53153
142045500800000,NW 311,Residential,5000,0,5000,0,0,5000
142045500900000,NW 311,Residential,7980,0,7980,44832,0,52812
142045501000000,CITY PROPERTY,Exempt,0,0,0,0,0,0
142045501100000,NW 311,Residential,8400,0,8400,43300,0,51700
142045501200000,NW 311,Residential,8400,0,8400,53753,0,62153
142045501300000,NW 311,Residential,12000,0,12000,70158,0,82158
142045501400000,NW 311,Residential,12000,0,12000,65312,0,77312
142045501500000,CITY PROPERTY,Exempt,0,0,0,0,0,0
142045501600000,CITY PROPERTY,Exempt,0,0,0,0,0,0
142045501700000,CITY PROPERTY,Exempt,0,0,0,0,0,0
142045501800000,NW 311,Residential,14544,0,14544,54421,0,68965
142045501900000,SMALL RETAIL,Commercial,0,3416,3416,0,18687,22103
142045502000000,CITY PROPERTY,Exempt,0,0,0,0,0,0
142045502100000,NW 311,Residential,10260,0,10260,51083,0,61343
142045600100000,NW 311,Residential,8400,0,8400,45543,0,53943
142045600200000,NW 311,Residential,8400,0,8400,46650,0,55050
142045600300000,NW 311,Residential,12000,0,12000,70759,0,82759
142045600400000,NW 311,Residential,12000,0,12000,76171,0,88171
142045600500000,NW 311,Residential,12000,0,12000,42923,0,54923
142045600600000,NW 311,Residential,12000,0,12000,34469,0,46469
142045600700000,NW 311,Residential,12000,0,12000,70651,0,82651
142045600800000,NW 311,Residential,12000,0,12000,57075,0,69075
142045600900000,NW 311,Residential,12000,0,12000,46193,0,58193
142045601000000,NW 311,Residential,12000,0,12000,34757,0,46757
142045601100000,NW 311,Residential,12000,0,12000,59923,0,71923
142045601200000,NW 311,Residential,12000,0,12000,50111,0,62111
142045601300000,NW 311,Residential,12000,0,12000,69473,0,81473
142045601400000,CITY PROPERTY,Exempt,0,0,0,0,0,0
142045601500000,CITY PROPERTY,Exempt,0,0,0,0,0,0
142045601600000,CITY PROPERTY,Exempt,0,0,0,0,0,0
142045601700000,CITY PROPERTY,Exempt,0,0,0,0,0,0
142045700100000,NW 311,Residential,9520,0,9520,39322,0,48842
142045700200000,NW 311,Residential,9520,0,9520,55608,0,65128
142045700300000,NW 311,Residential,13600,0,13600,59395,0,72995
142045700400000,NW 311,Residential,13600,0,13600,60071,0,73671
142045700500000,NW 311,Residential,13600,0,13600,44275,0,57875
142045700600000,NW 311,Residential,13600,0,13600,50848,0,64448
142045700700000,NW 311,Residential,9520,0,9520,42477,0,51997
142045700800000,NW 311,Residential,9520,0,9520,58897,0,68417
142045700900000,NW 311,Residential,9044,0,9044,45689,0,54733
142045701000000,NW 311,Residential,9044,0,9044,49872,0,58916
142045701100000,NW 311,Residential,13600,0,13600,62378,0,75978
142045701200000,CITY PROPERTY,Exempt,0,0,0,0,0,0
142045701300000,NW 311,Residential,13600,0,13600,95210,0,108810
142045701400000,NW 311,Residential,13600,0,13600,75952,0,89552
142045701500000,NW 311,Residential,6000,0,6000,0,0,6000
142045701600000,NW 311,Residential,13600,0,13600,59991,0,73591
142045701700000,NW 311,Residential,19040,0,19040,55943,0,74983
142045701800000,NW 311,Residential,7913,0,7913,43656,0,51569
142045701900000,NW 311,Residential,9310,0,9310,76950,0,86260
142045702000000,NW 311,Residential,7913,0,7913,28006,0,35919
142045702100000,NW 311,Residential,7913,0,7913,61040,0,68953
142045800100000,NW 311,Residential,10234,0,10234,80603,0,90837
142045800200000,NW 311,Residential,9520,0,9520,46171,0,55691
142045800300000,CITY PROPERTY,Exempt,0,0,0,0,0,0
142045800400000,NW 311,Residential,13600,0,13600,51438,0,65038
142045800500000,NW 311,Residential,13600,0,13600,88468,0,102068
142045800600000,NW 311,Residential,14620,0,14620,68724,0,83344
142045800700000,NW 311,Residential,13600,0,13600,41894,0,55494
142045800800000,NW 311,Residential,13600,0,13600,59353,0,72953
142045800900000,NW 311,Residential,9401,0,9401,48483,0,57884
142045801000000,NW 311,Residential,9401,0,9401,47262,0,56663
142045900100000,CITY PROPERTY,Exempt,0,0,0,0,0,0
142045900200000,CITY PROPERTY,Exempt,0,0,0,0,0,0
142045900300000,NW 311,Residential,15000,0,15000,63596,0,78596
142045900400000,NW 311,Residential,6000,0,6000,0,0,6000
142045900500000,CITY PROPERTY,Exempt,0,0,0,0,0,0
142045900600000,NW 311,Residential,13500,0,13500,49062,0,62562
142045900700000,CITY PROPERTY,Exempt,0,0,0,0,0,0
142045900800000,NW 311,Residential,5000,0,5000,0,0,5000
142045900900000,NW 311,Residential,12000,0,12000,59851,0,71851
142045901000000,CITY PROPERTY,Exempt,0,0,0,0,0,0
142045901100000,CONVERSION,Commercial,0,5400,5400,0,0,5400
142045901200000,NW 311,Residential,5000,0,5000,0,0,5000
142045901300000,NW 311,Residential,5000,0,5000,0,0,5000
142045901400000,CONVERSION,Commercial,0,6804,6804,0,72756,79560
142045901500000,NW 311,Residential,10000,0,10000,0,0,10000
142045901600000,NW 311,Residential,7440,0,7440,41910,0,49350
142046000100000,NW 311,Residential,10641,0,10641,26328,0,36969
142046000200000,NW 311,Residential,5000,0,5000,0,0,5000
142046000300000,CITY PROPERTY,Exempt,0,0,0,0,0,0
142046000400000,NW 311,Residential,12000,0,12000,57799,0,69799
142046000500000,NW 311,Residential,12000,0,12000,60823,0,72823
142046000600000,CITY PROPERTY,Exempt,0,0,0,0,0,0
142046000700000,CITY PROPERTY,Exempt,0,0,0,0,0,0
142046000800000,NW 311,Residential,6510,0,6510,54731,0,61241
142046000900000,NW 311,Residential,5000,0,5000,0,0,5000
142046001000000,NW 311,Residential,8400,0,8400,40011,0,48411
142046001100000,CITY PROPERTY,Exempt,0,0,0,0,0,0
142046001200000,NW 311,Residential,18000,0,18000,57713,0,75713
142046001300000,NW 311,Residential,12000,0,12000,0,0,12000
142046001400000,NW 311,Residential,12000,0,12000,46673,0,58673
142046001500000,NW 311,Residential,12000,0,12000,44940,0,56940
142046001600000,NW 311,Residential,9120,0,9120,58143,0,67263
142046001700000,NW 311,Residential,8100,0,8100,51079,0,59179
142046001800000,CITY PROPERTY,Exempt,0,0,0,0,0,0
142046001900000,NW 311,Residential,10639,0,10639,63582,0,74221
142046100100000,NW 311,Residential,9520,0,9520,70806,0,80326
142046100200000,NW 311,Residential,9520,0,9520,69590,0,79110
142046100300000,NW 311,Residential,13600,0,13600,67994,0,81594
142046100400000,NW 311,Residential,13600,0,13600,82867,0,96467
142046100500000,NW 311,Residential,13600,0,13600,77010,0,90610
142046100600000,NW 311,Residential,13600,0,13600,63970,0,77570
142046100700000,NW 311,Residential,13600,0,13600,62115,0,75715
142046100800000,NW 311,Residential,13600,0,13600,61334,0,74934
142046100900000,NW 311,Residential,13600,0,13600,66481,0,80081
142046101000000,NW 311,Residential,13600,0,13600,38888,0,52488
142046101100000,NW 311,Residential,5000,0,5000,0,0,5000
142046101200000,NW 311,Residential,13600,0,13600,86277,0,99877
142046101300000,NW 311,Residential,5000,0,5000,0,0,5000
142046101400000,NW 311,Residential,13600,0,13600,76721,0,90321
142046101500000,NW 311,Residential,13600,0,13600,64817,0,78417
142046101600000,NW 311,Residential,13600,0,13600,57113,0,70713
142046101700000,NW 311,Residential,9044,0,9044,67484,0,76528
142046101800000,NW 311,Residential,5000,0,5000,0,0,5000
142046200100000,NW 311,Residential,14620,0,14620,55118,0,69738
142046200200000,NW 311,Residential,13600,0,13600,69326,0,82926
142046200300000,NW 311,Residential,13600,0,13600,44667,0,58267
142046200400000,NW 311,Residential,14280,0,14280,65682,0,79962
142046200500000,NW 311,Residential,13600,0,13600,52143,0,65743
142046200600000,NW 311,Residential,13600,0,13600,60539,0,74139
142046200700000,NW 311,Residential,15164,0,15164,65983,0,81147
142046200800000,NW 311,Residential,10234,0,10234,75104,0,85338
142046200900000,NW 311,Residential,9401,0,9401,57619,0,67020
142046300100000,CONVERSION,Commercial,0,8334,8334,0,56414,64748
142046300200000,NW 311,Residential,12000,0,12000,44178,0,56178
142046300300000,CITY PROPERTY,Exempt,0,0,0,0,0,0
142046300400000,NW 311,Residential,12000,0,12000,46797,0,58797
142046300500000,NW 311,Residential,12000,0,12000,68255,0,80255
142046300600000,NW 311,Residential,12000,0,12000,46723,0,58723
142046300700000,NW 311,Residential,8760,0,8760,53583,0,62343
142046300800000,NW 311,Residential,8775,0,8775,54545,0,63320
142046300900000,NW 311,Residential,10500,0,10500,68087,0,78587
142046301000000,NW 311,Residential,10500,0,10500,41591,0,52091
142046301100000,CONVERSION,Commercial,0,6804,6804,0,50986,57790
142046301200000,CONVERSION,Commercial,0,6804,6804,0,61285,68089
142046301300000,NW 311,Residential,6562,0,6562,37072,0,43634
142046301400000,NW 311,Residential,6562,0,6562,40798,0,47360
142046301500000,NW 311,Residential,10500,0,10500,52759,0,63259
142046301600000,CITY PROPERTY,Exempt,0,0,0,0,0,0
142046301700000,BARS/LOUNGE,Commercial,0,10121,10121,0,97470,107591
142046301800000,NW 311,Residential,7350,0,7350,51158,0,58508
142046301900000,NW 311,Residential,5512,0,5512,40736,0,46248
142046302000000,NW 311,Residential,5972,0,5972,29857,0,35829
142046400100000,NW 311,Residential,9520,0,9520,41179,0,50699
142046400200000,NW 311,Residential,13600,0,13600,80233,0,93833
142046400300000,NW 311,Residential,13600,0,13600,86697,0,100297
142046400400000,NW 311,Residential,13600,0,13600,54388,0,67988
142046400500000,NW 311,Residential,13600,0,13600,58354,0,71954
142046400600000,NW 311,Residential,13600,0,13600,45529,0,59129
142046400700000,NW 311,Residential,13600,0,13600,63384,0,76984
142046400800000,NW 311,Residential,13600,0,13600,73365,0,86965
142046400900000,NW 311,Residential,13600,0,13600,70702,0,84302
142046401000000,NW 311,Residential,13600,0,13600,63979,0,77579
142046401100000,CITY PROPERTY,Exempt,0,0,0,0,0,0
142046401200000,NW 311,Residential,13600,0,13600,64062,0,77662
142046401300000,NW 311,Residential,13600,0,13600,75519,0,89119
142046401400000,NW 311,Residential,13600,0,13600,73408,0,87008
142046401500000,NW 311,Residential,10710,0,10710,65495,0,76205
142046500100000,NW 311,Residential,20400,0,20400,69453,0,89853
142046500200000,NW 311,Residential,20400,0,20400,77888,0,98288
142046500300000,NW 311,Residential,13600,0,13600,96496,0,110096
142046500400000,NW 311,Residential,5000,0,5000,0,0,5000
142046500500000,CONVERSION,Commercial,0,4039,4039,0,61751,65790
142046500600000,SMALL RETAIL,Commercial,0,13608,13608,0,46109,59717
142046500700000,NW 311,Residential,13600,0,13600,48800,0,62400
142046500800000,NW 311,Residential,13600,0,13600,66652,0,80252
142046500900000,NW 311,Residential,13600,0,13600,63657,0,77257
142046501000000,NW 311,Residential,21760,0,21760,76048,0,97808
142046501100000,NW 311,Residential,13600,0,13600,69061,0,82661
142046501200000,NW 311,Residential,13600,0,13600,53554,0,67154
142046501300000,NW 311,Residential,13600,0,13600,55403,0,69003
142046501400000,NW 311,Residential,13600,0,13600,64822,0,78422
142046600100000,NW 311,Residential,17200,0,17200,79801,0,97001
142046600200000,NW 311,Residential,16000,0,16000,113371,0,129371
142046600300000,NW 311,Residential,16000,0,16000,89626,0,105626
142046600400000,NW 311,Residential,16000,0,16000,73139,0,89139
142046600500000,NW 311,Residential,17200,0,17200,81948,0,99148
142046600600000,NW 311,Residential,16000,0,16000,79944,0,95944
142046600700000,NW 311,Residential,16000,0,16000,86113,0,102113
142046600800000,NW 311,Residential,16000,0,16000,66061,0,82061
142047600100000,CITY PROPERTY,Exempt,0,0,0,0,0,0
142047600200000,CITY PROPERTY,Exempt,0,0,0,0,0,0
142047600300000,CITY PROPERTY,Exempt,0,0,0,0,0,0
142047600400000,NW 317,Residential,4020,0,4020,0,0,4020
142047600500000,CITY PROPERTY,Exempt,0,0,0,0,0,0
142047600600000,NW 317,Residential,4020,0,4020,0,0,4020
142047600700000,CITY PROPERTY,Exempt,0,0,0,0,0,0
142047600800000,NW 317,Residential,4824,0,4824,31317,0,36141
142047600900000,CITY PROPERTY,Exempt,0,0,0,0,0,0
142047601000000,CITY PROPERTY,Exempt,0,0,0,0,0,0
142047601100000,CITY PROPERTY,Exempt,0,0,0,0,0,0
142047601200000,NW 317,Residential,1206,0,1206,0,0,1206
142047601300000,NW 317,Residential,5000,0,5000,0,0,5000
142047601400000,CITY PROPERTY,Exempt,0,0,0,0,0,0
142047700100000,CITY PROPERTY,Exempt,0,0,0,0,0,0
142047700200000,NW 317,Residential,8223,0,8223,0,0,8223
142047700300000,NW 317,Residential,6750,0,6750,0,0,6750
142047700400000,CITY PROPERTY,Exempt,0,0,0,0,0,0
142047800100000,FEED/ADDITIVE;INDUST,Industrial,0,278424,278424,0,1625855,1904279
142047900100000,NW 317,Residential,10500,0,10500,37634,0,48134
142047900200000,NW 317,Residential,7455,0,7455,34813,0,42268
142047900300000,CITY PROPERTY,Exempt,0,0,0,0,0,0
142047900400000,NW 317,Residential,10500,0,10500,41145,0,51645
142047900500000,NW 317,Residential,10500,0,10500,0,0,10500
142047900600000,NW 317,Residential,7455,0,7455,49159,0,56614
142047900700000,CITY PROPERTY,Exempt,0,0,0,0,0,0
142047900800000,NW 317,Residential,5000,0,5000,0,0,5000
142047901100000,CITY PROPERTY,Exempt,0,0,0,0,0,0
142047901200000,NW 317,Residential,16542,0,16542,49056,0,65598
142047901300000,NW 317,Residential,7455,0,7455,35429,0,42884
142047901400000,CITY PROPERTY,Exempt,0,0,0,0,0,0
142048000100000,CITY PROPERTY,Exempt,0,0,0,0,0,0
142048000200000,CITY PROPERTY,Exempt,0,0,0,0,0,0
142048000300000,CITY PROPERTY,Exempt,0,0,0,0,0,0
142048000400000,CITY PROPERTY,Exempt,0,0,0,0,0,0
142048000500000,NW 317,Residential,5000,0,5000,0,0,5000
142048000600000,CITY PROPERTY,Exempt,0,0,0,0,0,0
142048000700000,NW 317,Residential,5000,0,5000,0,0,5000
142048000800000,CITY PROPERTY,Exempt,0,0,0,0,0,0
142048000900000,NW 317,Residential,5000,0,5000,0,0,5000
142048001100000,CITY PROPERTY,Exempt,0,0,0,0,0,0
142048001200000,NW 317,Residential,6000,0,6000,0,0,6000
142048001300000,CITY PROPERTY,Exempt,0,0,0,0,0,0
142048001400000,CITY PROPERTY,Exempt,0,0,0,0,0,0
142048001500000,VACANT LAND,Commercial,0,9072,9072,0,0,9072
142048001600000,CITY PROPERTY,Exempt,0,0,0,0,0,0
142048001700000,CITY PROPERTY,Exempt,0,0,0,0,0,0
142048001800000,CITY PROPERTY,Exempt,0,0,0,0,0,0
142048100100000,FLAT PARKING,Commercial,0,6237,6237,0,7488,13725
142048100200000,SHOP,Industrial,0,72657,72657,0,178278,250935
142048100300000,CITY PROPERTY,Exempt,0,0,0,0,0,0
142048100400000,NW 317,Residential,6014,0,6014,22868,0,28882
142048100500000,CITY PROPERTY,Exempt,0,0,0,0,0,0
142048100600000,CITY PROPERTY,Exempt,0,0,0,0,0,0
142048100700000,NW 317,Residential,9000,0,9000,20601,0,29601
142048100800000,NW 317,Residential,9000,0,9000,36634,0,45634
142048100900000,NW 317,Residential,9000,0,9000,38455,0,47455
142048101000000,NW 317,Residential,5000,0,5000,0,0,5000
142048101100000,CITY PROPERTY,Exempt,0,0,0,0,0,0
142048101200000,NW 317,Residential,7245,0,7245,0,0,7245
142048101300000,NW 317,Residential,7245,0,7245,0,0,7245
142048101400000,NW 317,Residential,7245,0,7245,0,0,7245
142048101500000,CITY PROPERTY,Exempt,0,0,0,0,0,0
142048101600000,NW 317,Residential,6,0,6,0,0,6
142048200100000,CITY PROPERTY,Exempt,0,0,0,0,0,0
142048200200000,NW 317,Residential,5000,0,5000,0,0,5000
142048200300000,NW 317,Residential,10500,0,10500,55067,0,65567
142048200400000,CITY PROPERTY,Exempt,0,0,0,0,0,0
142048200500000,CITY PROPERTY,Exempt,0,0,0,0,0,0
142048200600000,NW 317,Residential,5000,0,5000,0,0,5000
142048200700000,NW 317,Residential,11400,0,11400,52011,0,63411
142048200800000,NW 317,Residential,10260,0,10260,45798,0,56058
142048200900000,NW 317,Residential,5000,0,5000,0,0,5000
142048201000000,CITY PROPERTY,Exempt,0,0,0,0,0,0
142048201100000,NW 317,Residential,5670,0,5670,14497,0,20167
142048201200000,NW 317,Residential,2976,0,2976,0,0,2976
142048201300000,NW 317,Residential,5000,0,5000,0,0,5000
142048201400000,NW 317,Residential,5000,0,5000,0,0,5000
142048201500000,NW 317,Residential,9000,0,9000,0,0,9000
142048201600000,CITY PROPERTY,Exempt,0,0,0,0,0,0
142048201700000,CITY PROPERTY,Exempt,0,0,0,0,0,0
142048201800000,NW 317,Residential,9000,0,9000,44585,0,53585
142048201900000,NW 317,Residential,9000,0,9000,36674,0,45674
142048300100000,CITY PROPERTY,Exempt,0,0,0,0,0,0
142048300200000,CITY PROPERTY,Exempt,0,0,0,0,0,0
142048300300000,CITY PROPERTY,Exempt,0,0,0,0,0,0
142048300400000,NW 317,Residential,4800,0,4800,0,0,4800
142048300500000,CONVERSION,Commercial,0,4536,4536,0,25910,30446
142048300600000,CITY PROPERTY,Exempt,0,0,0,0,0,0
142048300700000,CITY PROPERTY,Exempt,0,0,0,0,0,0
142048300800000,CITY PROPERTY,Exempt,0,0,0,0,0,0
142048300900000,CITY PROPERTY,Exempt,0,0,0,0,0,0
142048301000000,CITY PROPERTY,Exempt,0,0,0,0,0,0
142048301100000,MATERIALS MFG;INDUST,Industrial,0,88495,88495,0,48825,137320
142048301200000,CITY PROPERTY,Exempt,0,0,0,0,0,0
142048400100000,CITY PROPERTY,Exempt,0,0,0,0,0,0
142048400200000,NW 317,Residential,7312,0,7312,0,0,7312
142048400300000,NW 317,Exempt,0,9000,9000,0,46023,55023
142048400400000,NW 317,Residential,9000,0,9000,29735,0,38735
142048400500000,CITY PROPERTY,Exempt,0,0,0,0,0,0
142048400600000,NW 317,Residential,8550,0,8550,49332,0,57882
142048400700000,CITY PROPERTY,Exempt,0,0,0,0,0,0
142048400800000,CITY PROPERTY,Exempt,0,0,0,0,0,0
142048400900000,CITY PROPERTY,Exempt,0,0,0,0,0,0
142048401000000,NW 317,Residential,5598,0,5598,0,0,5598
142048401100000,FEED/ADDITIVE;INDUST,Industrial,0,21514,21514,0,9960,31474
142048401200000,NW 317,Residential,6675,0,6675,0,0,6675
142048401300000,NW 317,Residential,9900,0,9900,0,0,9900
142048401400000,NW 317,Residential,9000,0,9000,0,0,9000
142048401500000,CITY PROPERTY,Exempt,0,0,0,0,0,0
142048401800000,FLAT PARKING,Commercial,0,48384,48384,0,10452,58836
142048401900000,NW 317,Residential,9000,0,9000,0,0,9000
142048402000000,BARS/LOUNGE,Commercial,0,43546,43546,0,229699,273245
142048402100000,NW 317,Residential,5000,0,5000,0,0,5000
142048402200000,NW 317,Residential,19200,0,19200,87627,0,106827
142048500300000,SCHOOL,Exempt,0,0,0,0,0,0
142048500400000,CONVENIENCE STORE,Commercial,0,88180,88180,0,215415,303595
142048500500000,OFFICE,Commercial,0,72576,72576,0,168655,241231
142048500600000,CITY PROPERTY,Exempt,0,0,0,0,0,0
142048500700000,CITY PROPERTY,Exempt,0,0,0,0,0,0
142048500800000,SCHOOL,Exempt,0,0,0,0,0,0
142048600200000,CITY PROPERTY,Exempt,0,0,0,0,0,0
142048600300000,CITY PROPERTY,Exempt,0,0,0,0,0,0
142048600400000,CITY PROPERTY,Exempt,0,0,0,0,0,0
142048600500000,NW 317,Residential,6000,0,6000,0,0,6000
142048600600000,CITY PROPERTY,Exempt,0,0,0,0,0,0
142048600700000,CITY PROPERTY,Exempt,0,0,0,0,0,0
142048600800000,CITY PROPERTY,Exempt,0,0,0,0,0,0
142048600900000,CITY PROPERTY,Exempt,0,0,0,0,0,0
142048601000000,CITY PROPERTY,Exempt,0,0,0,0,0,0
142048601100000,CITY PROPERTY,Exempt,0,0,0,0,0,0
142048601200000,CITY PROPERTY,Exempt,0,0,0,0,0,0
142048601300000,NW 317,Residential,5000,0,5000,0,0,5000
142048601400000,NW 317,Residential,3426,0,3426,42268,0,45694
142048601500000,CITY PROPERTY,Exempt,0,0,0,0,0,0
142048601600000,CITY PROPERTY,Exempt,0,0,0,0,0,0
142048601700000,CITY PROPERTY,Exempt,0,0,0,0,0,0
142048601800000,CITY PROPERTY,Exempt,0,0,0,0,0,0
142048601900000,CITY PROPERTY,Exempt,0,0,0,0,0,0
142048602300000,BARS/LOUNGE,Commercial,0,36288,36288,0,129305,165593
142048700100000,CONVERSION,Commercial,0,4180,4180,0,58641,62821
142048700200000,NW 317,Residential,9000,0,9000,62045,0,71045
142048700300000,NW 317,Residential,9000,0,9000,64107,0,73107
142048700400000,CITY PROPERTY,Exempt,0,0,0,0,0,0
142048700500000,NW 317,Residential,9000,0,9000,60029,0,69029
142048700600000,NW 317,Residential,5000,0,5000,0,0,5000
142048700700000,NW 317,Residential,9000,0,9000,68797,0,77797
142048700800000,NW 317,Residential,6300,0,6300,41162,0,47462
142048700900000,NW 317,Residential,4725,0,4725,35020,0,39745
142048701000000,NW 317,Residential,4725,0,4725,42102,0,46827
142048701100000,NW 317,Residential,6480,0,6480,34089,0,40569
142048701200000,CITY PROPERTY,Exempt,0,0,0,0,0,0
142048701300000,CITY PROPERTY,Exempt,0,0,0,0,0,0
142048701400000,NW 317,Residential,5563,0,5563,38815,0,44378
142048701500000,CITY PROPERTY,Exempt,0,0,0,0,0,0
142048701600000,NW 317,Residential,4324,0,4324,33461,0,37785
142048701700000,CITY PROPERTY,Exempt,0,0,0,0,0,0
142048701800000,CITY PROPERTY,Exempt,0,0,0,0,0,0
142048701900000,CITY PROPERTY,Exempt,0,0,0,0,0,0
142048702000000,NW 317,Residential,5427,0,5427,31432,0,36859
142048800100000,WAREHOUSE,Commercial,0,18712,18712,0,30426,49138
142048800200000,EQUIPMENT MFG;INDUST,Industrial,0,36315,36315,0,11063,47378
142048800300000,NW 317,Residential,5000,0,5000,0,0,5000
142048800400000,NW 317,Residential,5000,0,5000,0,0,5000
142048800500000,CONVENIENCE STORE,Commercial,0,46445,46445,0,173345,219790
142048900100000,VACANT LAND,Commercial,0,14731,14731,0,0,14731
142048900200000,WAREHOUSE,Commercial,0,53343,53343,0,102789,156132
142048900300000,FLAT PARKING,Commercial,0,18144,18144,0,0,18144
142048900400000,FLAT PARKING,Commercial,0,36288,36288,0,0,36288
142048900500000,FLAT PARKING,Commercial,0,36288,36288,0,2000,38288
142048900600000,BARS/LOUNGE,Commercial,0,65318,65318,0,176626,241944
142048900700000,EQUIPMENT MFG;INDUST,Industrial,0,123660,123660,0,344524,468184
142110100100000,VACANT LAND,Exempt,0,10996,10996,0,0,10996
142110100200000,NE 156,Residential,10582,0,10582,52989,0,63571
142110100300000,SHOP,Commercial,0,17496,17496,0,79671,97167
142110100400000,WAREHOUSE,Commercial,0,160618,160618,0,296289,456907
142110100500000,SHOP,Commercial,0,48539,48539,0,92007,140546
142110200100000,SMALL RETAIL,Commercial,0,39690,39690,0,117090,156780
142110200200000,WAREHOUSE,Commercial,0,57669,57669,0,158558,216227
142110200300000,SMALL RETAIL,Commercial,0,49922,49922,0,114176,164098
142110200400000,SHOP,Commercial,0,40257,40257,0,59935,100192
142110200500000,SHOP,Commercial,0,31169,31169,0,76126,107295
142110300100000,SHOP,Commercial,0,36288,36288,0,133473,169761
142110300200000,WAREHOUSE,Commercial,0,20412,20412,0,70147,90559
142110300300000,FLAT PARKING,Commercial,0,13608,13608,0,1598,15206
142110300400000,FLAT PARKING,Commercial,0,13608,13608,0,2580,16188
142110300500000,OFFICE,Commercial,0,27216,27216,0,145855,173071
142110300600000,OFFICE,Exempt,0,161482,161482,0,319160,480642
142110300602000,BILLBOARD(BLL),Commercial,0,0,0,0,43126,43126
142110400100000,VACANT LAND,Commercial,0,38832,38832,0,0,38832
142110400102000,BILLBOARD(BLL),Commercial,0,0,0,0,8418,8418
142110400200000,FLAT PARKING,Commercial,0,27216,27216,0,6000,33216
142110400300000,WAREHOUSE,Commercial,0,31752,31752,0,35672,67424
142110500100000,EDUCATIONAL/COLLEGE,Exempt,0,18144,18144,0,1120,19264
142110500200000,NE 156,Exempt,0,10000,10000,629,62885,73514
142110500300000,NE 156,Residential,10000,0,10000,2790,0,12790
142110500400000,NE 156,Residential,10000,0,10000,55731,0,65731
142110500500000,NE 156,Residential,6500,0,6500,5031,0,11531
142110500600000,NE 156,Residential,5400,0,5400,0,0,5400
142110500700000,NE 156,Residential,5400,0,5400,0,0,5400
142110500800000,NE 156,Exempt,0,10000,10000,99,60550,70649
142110500900000,NE 156,Residential,10000,0,10000,53949,0,63949
142110501000000,APARTMENT,Exempt,0,18144,18144,0,234532,252676
142110501100000,AUTO REPAIR/SALES,Commercial,0,29691,29691,0,69853,99544
142110501200000,OFFICE,Exempt,0,5326,5326,0,33660,38986
142110501300000,APARTMENT,Exempt,0,266112,266112,0,248755,514867
142110600100000,VACANT LAND,Commercial,0,4700,4700,0,0,4700
142110600200000,VACANT LAND,Commercial,0,27498,27498,0,0,27498
142110600300000,BARS/LOUNGE,Commercial,0,44064,44064,0,108267,152331
142110600400000,SMALL RETAIL,Commercial,0,17626,17626,0,69567,87193
142110600500000,SMALL RETAIL,Commercial,0,17626,17626,0,56478,74104
142110600600000,AUTO REPAIR/SALES,Commercial,0,57283,57283,0,80838,138121
142110600700000,CENTRALLY ASSESSED,Other,0,0,0,0,0,0
142110700100000,NBHD SHOPPING CENTER,Commercial,0,285120,285120,0,263869,548989
142110700200000,CENTRALLY ASSESSED,Other,0,0,0,0,0,0
142110700300000,CENTRALLY ASSESSED,Other,0,0,0,0,0,0
142110700400000,CENTRALLY ASSESSED,Other,0,0,0,0,0,0
142110700500000,CENTRALLY ASSESSED,Other,0,0,0,0,0,0
142110700600000,EDUCATIONAL/COLLEGE,Exempt,0,34353,34353,0,0,34353
142110700602000,BILLBOARD(BLL),Commercial,0,0,0,0,8418,8418
142110800100000,SCHOOL,Exempt,0,444960,444960,0,4119228,4564188
142112600100000,WAREHOUSE,Commercial,0,9720,9720,0,9751,19471
142112600200000,CENTRALLY ASSESSED,Other,0,0,0,0,0,0
142112600300000,CENTRALLY ASSESSED,Other,0,0,0,0,0,0
142112600400000,CENTRALLY ASSESSED,Other,0,0,0,0,0,0
142112700100000,CENTRALLY ASSESSED,Other,0,0,0,0,0,0
142112700200000,CENTRALLY ASSESSED,Other,0,0,0,0,0,0
142112700300000,CENTRALLY ASSESSED,Other,0,0,0,0,0,0
142112800100000,CENTRALLY ASSESSED,Other,0,0,0,0,0,0
142115100100000,CENTRALLY ASSESSED,Other,0,0,0,0,0,0
142115200100000,CENTRALLY ASSESSED,Other,0,0,0,0,0,0
142115200200000,CENTRALLY ASSESSED,Other,0,0,0,0,0,0
142115200300000,FOOD GRADE;INDUST,Industrial,0,11599,11599,0,345919,357518
142115200500000,CENTRALLY ASSESSED,Other,0,0,0,0,0,0
142115200600000,CENTRALLY ASSESSED,Other,0,0,0,0,0,0
142115300100000,CENTRALLY ASSESSED,Other,0,0,0,0,0,0
142117600100000,SCHOOL,Exempt,0,2378160,2378160,0,22654723,25032883
142117700100000,HOSPITAL,Exempt,0,969840,969840,0,19495423,20465263
142117700102000,BILLBOARD(BLL),Commercial,0,0,0,0,50003,50003
142117700200000,CITY PROPERTY,Exempt,0,0,0,0,0,0
142117800100000,HOSPITAL,Commercial,0,1083240,1083240,0,84707690,85790930
142120100100000,CENTRALLY ASSESSED,Other,0,0,0,0,0,0
142120100200000,VACANT LAND,Ag Land,2764,0,2764,0,0,2764
142122600100000,CENTRALLY ASSESSED,Other,0,0,0,0,0,0
142125100100000,CITY PROPERTY,Exempt,0,0,0,0,0,0
142125100200000,NW 310,Residential,8910,0,8910,28323,0,37233
142125100300000,CITY PROPERTY,Exempt,0,0,0,0,0,0
142125100400000,CITY PROPERTY,Exempt,0,0,0,0,0,0
142125100500000,CITY PROPERTY,Exempt,0,0,0,0,0,0
142125100600000,CITY PROPERTY,Exempt,0,0,0,0,0,0
142125100700000,CITY PROPERTY,Exempt,0,0,0,0,0,0
142125100800000,CITY PROPERTY,Exempt,0,0,0,0,0,0
142125100900000,CITY PROPERTY,Exempt,0,0,0,0,0,0
142125101000000,CITY PROPERTY,Exempt,0,0,0,0,0,0
142125101100000,CITY PROPERTY,Exempt,0,0,0,0,0,0
142125200100000,CITY PROPERTY,Exempt,0,0,0,0,0,0
142125200200000,CITY PROPERTY,Exempt,0,0,0,0,0,0
142125200300000,CITY PROPERTY,Exempt,0,0,0,0,0,0
142125200400000,CITY PROPERTY,Exempt,0,0,0,0,0,0
142125200500000,CITY PROPERTY,Exempt,0,0,0,0,0,0
142125200600000,CITY PROPERTY,Exempt,0,0,0,0,0,0
142125200700000,CITY PROPERTY,Exempt,0,0,0,0,0,0
142125200800000,NW 310,Residential,11210,0,11210,0,0,11210
142125200900000,CITY PROPERTY,Exempt,0,0,0,0,0,0
142125201000000,CITY PROPERTY,Exempt,0,0,0,0,0,0
142125201100000,CITY PROPERTY,Exempt,0,0,0,0,0,0
142125201200000,CITY PROPERTY,Exempt,0,0,0,0,0,0
142125201300000,CITY PROPERTY,Exempt,0,0,0,0,0,0
142125201400000,CITY PROPERTY,Exempt,0,0,0,0,0,0
142125201500000,CITY PROPERTY,Exempt,0,0,0,0,0,0
142125201600000,CITY PROPERTY,Exempt,0,0,0,0,0,0
142125201700000,CITY PROPERTY,Exempt,0,0,0,0,0,0
142125201800000,CITY PROPERTY,Exempt,0,0,0,0,0,0
142127600100000,VACANT LAND,Ag Land,7837,0,7837,0,0,7837
142127600200000,VACANT LAND,Ag Land,1449,0,1449,0,0,1449
142127600300000,WAREHOUSE,Commercial,0,171963,171963,0,590612,762575
142127600400000,VACANT LAND,Commercial,0,17739,17739,0,0,17739
142130100100000,CENTRALLY ASSESSED,Other,0,0,0,0,0,0
142130100200000,VACANT LAND,Industrial,0,4711,4711,0,0,4711
142130100300000,CENTRALLY ASSESSED,Other,0,0,0,0,0,0
142130100400000,CENTRALLY ASSESSED,Other,0,0,0,0,0,0
142130100500000,CENTRALLY ASSESSED,Other,0,0,0,0,0,0
142130100600000,CENTRALLY ASSESSED,Other,0,0,0,0,0,0
142130200100000,FOOD GRADE;INDUST,Industrial,0,26038,26038,0,45725,71763
142130200200000,CENTRALLY ASSESSED,Other,0,0,0,0,0,0
142130400100000,CENTRALLY ASSESSED,Other,0,0,0,0,0,0
142130400200000,CENTRALLY ASSESSED,Other,0,0,0,0,0,0
142130400300000,CENTRALLY ASSESSED,Other,0,0,0,0,0,0
142130400400000,FOOD GRADE;INDUST,Industrial,0,10157,10157,0,306222,316379
142130500100000,CENTRALLY ASSESSED,Other,0,0,0,0,0,0
142130500200000,CENTRALLY ASSESSED,Other,0,0,0,0,0,0
142130600100000,FOOD GRADE;INDUST,Industrial,0,716353,716353,0,7715072,8431425
142132600100000,SHOP,Commercial,0,98010,98010,0,183348,281358
142132600200000,WAREHOUSE,Commercial,0,19440,19440,0,11163,30603
142132600300000,WAREHOUSE,Commercial,0,30375,30375,0,27078,57453
142132600400000,CITY PROPERTY,Exempt,0,0,0,0,0,0
142132600500000,WAREHOUSE,Commercial,0,6000,6000,0,0,6000
142132600600000,CITY PROPERTY,Exempt,0,0,0,0,0,0
142132600700000,CITY PROPERTY,Exempt,0,0,0,0,0,0
142132600800000,CITY PROPERTY,Exempt,0,0,0,0,0,0
142132600900000,SHOP,Commercial,0,34263,34263,0,0,34263
142132601000000,NW 317,Residential,5000,0,5000,0,0,5000
142132601100000,CITY PROPERTY,Exempt,0,0,0,0,0,0
142132601200000,NW 317,Residential,5000,0,5000,0,0,5000
142132601300000,WAREHOUSE,Commercial,0,29889,29889,0,143988,173877
142132700100000,WAREHOUSE,Commercial,0,240408,240408,0,1365904,1606312
142135100100000,CITY PROPERTY,Exempt,0,0,0,0,0,0
142135200100000,CITY PROPERTY,Exempt,0,0,0,0,0,0
142135200200000,WAREHOUSE,Commercial,0,206388,206388,0,647237,853625
142135200300000,MISCELLANEOUS,Exempt,0,162000,162000,0,0,162000
142135200400000,OFFICE,Exempt,0,127980,127980,0,884625,1012605
142135300100000,HOTEL,Commercial,0,127170,127170,0,1046493,1173663
142135400100000,MATERIALS MFG;INDUST,Industrial,0,113400,113400,0,305518,418918
142135500100000,FLAT PARKING,Industrial,0,8683,8683,0,0,8683
142135500200000,VACANT LAND,Commercial,0,4763,4763,0,0,4763
142135600100000,VACANT LAND,Industrial,0,109508,109508,0,0,109508
142135600200000,VACANT LAND,Industrial,0,10368,10368,0,0,10368
142137600100000,FOOD GRADE;INDUST,Industrial,0,22621,22621,0,1158677,1181298
142137600200000,FOOD GRADE;INDUST,Industrial,0,4158,4158,0,5475,9633
142137600300000,FOOD GRADE;INDUST,Industrial,0,4374,4374,0,23191,27565
142137700100000,CITY PROPERTY,Exempt,0,0,0,0,0,0
142137700102000,CITY PROPERTY,Exempt,0,0,0,0,0,0
142137800100000,CITY PROPERTY,Exempt,0,0,0,0,0,0
142137800102000,CITY PROPERTY,Exempt,0,0,0,0,0,0
142137800200000,CITY PROPERTY,Exempt,0,0,0,0,0,0
142137800300000,CITY PROPERTY,Exempt,0,0,0,0,0,0
142137800302000,MISCELLANEOUS,Commercial,0,0,0,0,20,20
142137800401000,SMALL RET; CTRL CR,Commercial,0,91930,91930,0,845201,937131
142137800401001,APARTMENT; CNTRL CR,Commercial,0,91930,91930,0,2699677,2791607
142137800500000,CITY PROPERTY,Exempt,0,0,0,0,0,0
142137800502000,MISCELLANEOUS,Commercial,0,0,0,0,20,20
142137900100000,BRNCH BK/CR; CTRL CR,Commercial,0,580608,580608,0,2838566,3419174
142137900200000,FLAT PARKING,Commercial,0,58725,58725,0,4320,63045
142137900300000,FLAT PARKING,Commercial,0,37395,37395,0,5500,42895
142137900501000,OFFICE; CTRL CR,Commercial,0,8000,8000,0,63678,71678
142137900501001,OFFICE; CTRL CR,Commercial,0,8000,8000,0,156544,164544
142137900501002,OFFICE; CTRL CR,Commercial,0,8000,8000,0,14904,22904
142137900501003,OFFICE; CTRL CR,Commercial,0,8000,8000,0,97757,105757
142137900501004,OFFICE; CTRL CR,Commercial,0,8640,8640,0,242109,250749
142137900501005,OFFICE; CTRL CR,Commercial,0,8000,8000,0,195399,203399
142138000100000,CITY PROPERTY,Exempt,0,0,0,0,0,0
142138100100000,FLAT PARKING,Commercial,0,374976,374976,0,15038,390014
142138100200000,SMALL RET; CTRL CR,Commercial,0,97978,97978,0,36151,134129
142138100300000,SMALL RET; CTRL CR,Commercial,0,32659,32659,0,51591,84250
142138100400000,RESTAURANT; CTRL CR,Commercial,0,84672,84672,0,171001,255673
142138100500000,OFFICE; CTRL CR,Commercial,0,38016,38016,0,82191,120207
142138100600000,OFFICE; CTRL CR,Commercial,0,103680,103680,0,469157,572837
142138100700000,RESTAURANT; CTRL CR,Commercial,0,26784,26784,0,47804,74588
142138100800000,RESTAURANT; CTRL CR,Commercial,0,26784,26784,0,49251,76035
142138100900000,OFFICE; CTRL CR,Commercial,0,69120,69120,0,257909,327029
142138101000000,OFFICE; CTRL CR,Commercial,0,103680,103680,0,511706,615386
142138101100000,OFFICE; CTRL CR,Commercial,0,82944,82944,0,369450,452394
142138101200000,OFFICE; CTRL CR,Commercial,0,120960,120960,0,413244,534204
142138101300000,BRNCH BK/CR; CTRL CR,Commercial,0,133056,133056,0,542006,675062
142138101400000,MISCELLANEOUS,Commercial,0,0,0,0,20,20
142138200100000,OFFICE; CTRL CR,Commercial,0,399425,399425,0,2865360,3264785
142138200200000,OFFICE; CTRL CR,Commercial,0,302400,302400,0,905734,1208134
142138200300000,OFFICE; CTRL CR,Commercial,0,60480,60480,0,211524,272004
142138200400000,OFFICE; CTRL CR,Commercial,0,217728,217728,0,561097,778825
142138200402000,BILLBOARD(BLL),Commercial,0,0,0,0,4182,4182
142138200500000,OFFICE; CTRL CR,Commercial,0,244339,244339,0,885331,1129670
142140100100000,RESTAURANT,Commercial,0,81648,81648,0,105825,187473
142140100200000,OFFICE,Commercial,0,81648,81648,0,402239,483887
142140100300000,FLAT PARKING,Commercial,0,81648,81648,0,12768,94416
142140100400000,FLAT PARKING,Commercial,0,45360,45360,0,14784,60144
142140100500000,FLAT PARKING,Commercial,0,45360,45360,0,0,45360
142140300100000,PARKING STRUCTURE,Commercial,0,272160,272160,0,2837841,3110001
142140400100000,HOSPITAL,Exempt,0,90720,90720,0,0,90720
142140400200000,OFFICE; MEDICAL,Commercial,0,414720,414720,0,5222951,5637671
142140400300000,OFFICE,Exempt,0,127008,127008,0,0,127008
142140400400000,FLAT PARKING,Exempt,0,45360,45360,0,7728,53088
142140400500000,VACANT LAND,Commercial,0,326079,326079,0,0,326079
142140400600000,VACANT LAND,Commercial,0,30087,30087,0,0,30087
142140500100000,OFFICE; CTRL CR,Commercial,0,30240,30240,0,213639,243879
142140500200000,FLAT PARKING,Commercial,0,26536,26536,0,2160,28696
142140500300000,FLAT PARKING,Commercial,0,26536,26536,0,1064,27600
142140500500000,VACANT LAND,Commercial,0,37044,37044,0,0,37044
142140500600000,LAUNDROMAT/CLEANERS,Commercial,0,94349,94349,0,187688,282037
142140500602000,BILLBOARD(BLL),Commercial,0,0,0,0,25188,25188
142140500700000,FLAT PARKING,Exempt,0,297756,297756,0,34520,332276
142140500800000,FLAT PARKING,Commercial,0,24343,24343,0,2576,26919
142140500900000,OFFICE; CTRL CR,Commercial,0,151200,151200,0,342265,493465
142140501000000,OFFICE,Exempt,0,78926,78926,0,576145,655071
142140501100000,FLAT PARKING,Exempt,0,78926,78926,0,6496,85422
142140501200000,FLAT PARKING,Exempt,0,78926,78926,0,6496,85422
142140501300000,OFFICE,Exempt,0,78926,78926,0,1079836,1158762
142140501400000,BARS/LOUNGE; CTRL CR,Commercial,0,78926,78926,0,93744,172670
142140501500000,LAUNDROMAT/CLEANERS,Commercial,0,78926,78926,0,133293,212219
142140501600000,FLAT PARKING,Commercial,0,78926,78926,0,8620,87546
142140501700000,FLAT PARKING,Commercial,0,78926,78926,0,5600,84526
142140501800000,OFFICE; CTRL CR,Commercial,0,45490,45490,0,195672,241162
142140501900000,FLAT PARKING,Commercial,0,25855,25855,0,3086,28941
142140502000000,CITY PROPERTY,Exempt,0,0,0,0,0,0
142140600100000,FLAT PARKING,Exempt,0,336960,336960,0,37372,374332
142140600200000,CHURCH,Exempt,0,362880,362880,0,3439442,3802322
142140600400000,OFFICE; MED; CTRL CR,Commercial,0,249628,249628,0,9450372,9700000
142140700200000,OFFICE,Exempt,0,208602,208602,0,159534,368136
142140700300000,APARTMENT; CNTRL CR,Commercial,0,32724,32724,0,448318,481042
142140700400000,FRATERNAL,Exempt,0,473785,473785,0,2914803,3388588
142140700700000,FLAT PARKING,Exempt,0,143640,143640,0,40432,184072
142140700800000,OFFICE; MED; CTRL CR,Commercial,0,254016,254016,0,565620,819636
142140700900000,FUNERAL HOME,Commercial,0,140211,140211,0,441185,581396
142140701000000,SMALL RET; CTRL CR,Commercial,0,31054,31054,0,257143,288197
142140701100000,FLAT PARKING,Commercial,0,81490,81490,0,6280,87770
142140800100000,VACANT LAND,Commercial,0,190512,190512,0,0,190512
142140800200000,AUTO REP/SAL;CTRL CR,Commercial,0,166320,166320,0,107646,273966
142140800400000,FLAT PARKING,Commercial,0,133056,133056,0,10040,143096
142140800500000,FLAT PARKING,Commercial,0,199584,199584,0,24528,224112
142140800600000,SMALL RET; CTRL CR,Commercial,0,127008,127008,0,0,127008
142140900100000,AUTO REP/SAL;CTRL CR,Commercial,0,136080,136080,0,54131,190211
142140900200000,AUTO REP/SAL;CTRL CR,Commercial,0,136080,136080,0,212468,348548
142140900300000,AUTO REP/SAL;CTRL CR,Commercial,0,60750,60750,0,157351,218101
142140900400000,AUTO REP/SAL;CTRL CR,Commercial,0,60750,60750,0,18489,79239
142140900500000,SMALL RET; CTRL CR,Commercial,0,121500,121500,0,240836,362336
142140900600000,PRINTING,Industrial,0,61396,61396,0,202002,263398
142140900900000,SMALL RET; CTRL CR,Commercial,0,40739,40739,0,54403,95142
142140901000000,FLAT PARKING,Commercial,0,19710,19710,0,4453,24163
142140901100000,RESTAURANT; CTRL CR,Commercial,0,12717,12717,0,85790,98507
142140901200000,SMALL RET; CTRL CR,Commercial,0,70492,70492,0,191757,262249
142140901300000,CONVERSION,Commercial,0,13316,13316,0,122339,135655
142140901400000,PRINTING,Industrial,0,31298,31298,0,43030,74328
142140901500000,CONVERSION,Commercial,0,14580,14580,0,60097,74677
142140901600000,CONVERSION,Commercial,0,14580,14580,0,129973,144553
142140901700000,CHURCH,Exempt,0,145800,145800,0,666773,812573
142140901800000,SMALL RET; CTRL CR,Commercial,0,48951,48951,0,114228,163179
142140901802000,BILLBOARD(BLL),Commercial,0,0,0,0,17434,17434
142141000100000,CHURCH,Exempt,0,169344,169344,0,1312911,1482255
142141000200000,CONVERSION,Commercial,0,17010,17010,0,142534,159544
142142600100000,CENTRALLY ASSESSED,Other,0,0,0,0,0,0
142142700100000,SHOP,Commercial,0,69304,69304,0,370879,440183
142142700200000,WAREHOUSE,Commercial,0,61560,61560,0,308128,369688
142142700300000,FOOD GRADE;INDUST,Industrial,0,40662,40662,0,203713,244375
142142800200000,FOOD GRADE;INDUST,Industrial,0,378265,378265,0,2975808,3354073
142142900100000,OFFICE; MED; CTRL CR,Commercial,0,272160,272160,0,1320195,1592355
142142900200000,BRNCH BK/CR; CTRL CR,Commercial,0,498974,498974,0,2501026,3000000
142143000100000,FRATERNAL,Commercial,0,156492,156492,0,173671,330163
142143000200000,FLAT PARKING,Commercial,0,118571,118571,0,13600,132171
142143100100000,FAST FOOD,Commercial,0,299376,299376,0,400363,699739
142143100200000,WAREHOUSE,Exempt,0,108864,108864,0,570258,679122
142143100300000,FLAT PARKING,Commercial,0,54432,54432,0,7910,62342
142143100400000,FLAT PARKING,Commercial,0,54432,54432,0,6400,60832
142143100500000,FLAT PARKING,Commercial,0,54432,54432,0,7910,62342
142143100600000,FLAT PARKING,Commercial,0,124740,124740,0,13875,138615
142143100700000,FLAT PARKING,Commercial,0,74844,74844,0,4800,79644
142143200100000,FRATERNAL,Exempt,0,270151,270151,0,2155957,2426108
142143300100000,CHURCH,Exempt,0,121176,121176,0,582807,703983
142143300200000,FLAT PARKING,Exempt,0,33048,33048,0,0,33048
142143400100000,FLAT PARKING,Commercial,0,200731,200731,0,22642,223373
142143500100000,SMALL RET; CTRL CR,Commercial,0,134006,134006,0,208520,342526
142145100100000,LG DISCOUNT/RETAIL,Commercial,0,78105,78105,0,152355,230460
142145100300000,WAREHOUSE,Exempt,0,369623,369623,0,637741,1007364
142145100400000,WAREHOUSE; CTRL CR,Commercial,0,63504,63504,0,101387,164891
142145100500000,SMALL RET; CTRL CR,Commercial,0,43394,43394,0,118564,161958
142145100600000,WAREHOUSE; CTRL CR,Commercial,0,43394,43394,0,79826,123220
142145100700000,BARS/LOUNGE; CTRL CR,Commercial,0,37573,37573,0,95276,132849
142145100800000,FLAT PARKING,Commercial,0,51549,51549,0,9547,61096
142145200201000,OFFICE; CTRL CR,Commercial,0,121414,121414,0,1253997,1375411
142145200201001,BRNCH BK/CR; CTRL CR,Commercial,0,134719,134719,0,1896539,2031258
142145200201002,OFFICE; CTRL CR,Commercial,0,121414,121414,0,1347807,1469221
142145200201003,OFFICE; CTRL CR,Commercial,0,121420,121420,0,1347807,1469227
142145200300000,CHURCH,Exempt,0,117936,117936,0,104266,222202
142145300100000,WAREHOUSE; CTRL CR,Commercial,0,63504,63504,0,307219,370723
142145300200000,OFFICE,Exempt,0,95256,95256,0,613863,709119
142145400100000,OFFICE; CTRL CR,Commercial,0,96768,96768,0,561448,658216
142145400200000,PARKING STRUCTURE,Commercial,0,498960,498960,0,974636,1473596
142145400300000,OFFICE,Other,0,0,0,0,0,0
142145500100000,OFFICE; CTRL CR,Commercial,0,140778,140778,0,405688,546466
142145500200000,CITY PROPERTY,Exempt,0,0,0,0,0,0
142145500300000,CITY PROPERTY,Exempt,0,0,0,0,0,0
142145600100000,OFFICE; CTRL CR,Commercial,0,233101,233101,0,2466899,2700000
142145600200000,PARKING STRUCTURE,Commercial,0,96768,96768,0,83562,180330
142145600300000,OFFICE; CTRL CR,Commercial,0,120960,120960,0,1620777,1741737
142145600400000,OFFICE; CTRL CR,Commercial,0,127008,127008,0,450856,577864
142145600500000,PARKING STRUCTURE,Commercial,0,145152,145152,0,115632,260784
142145700100000,OFFICE; CTRL CR,Commercial,0,81648,81648,0,1198204,1279852
142145700200000,AUTO REP/SAL;CTRL CR,Commercial,0,153014,153014,0,142938,295952
142145700300000,OFFICE; CTRL CR,Commercial,0,75437,75437,0,174563,250000
142145700400000,OFFICE; CTRL CR,Commercial,0,166320,166320,0,862123,1028443
142145700500000,FLAT PARKING,Commercial,0,99792,99792,0,9910,109702
142145700600000,FLAT PARKING,Commercial,0,81648,81648,0,8230,89878
142145700700000,AUTO REP/SAL;CTRL CR,Commercial,0,133678,133678,0,266322,400000
142145700800000,SMALL RET; CTRL CR,Commercial,0,40824,40824,0,142692,183516
142145800100000,CHURCH,Exempt,0,42336,42336,0,3680,46016
142145800200000,CHURCH,Exempt,0,148176,148176,0,2521842,2670018
142145900100000,CITY PROPERTY,Exempt,0,0,0,0,0,0
142145900200000,BARS/LOUNGE; CTRL CR,Commercial,0,81648,81648,0,301823,383471
142145900300000,FLAT PARKING,Commercial,0,40824,40824,0,3360,44184
142145900400000,SMALL RET; CTRL CR,Commercial,0,40824,40824,0,122785,163609
142145900500000,CITY PROPERTY,Exempt,0,0,0,0,0,0
142145900600000,FLAT PARKING,Commercial,0,81648,81648,0,8000,89648
142145900700000,CITY PROPERTY,Exempt,0,72576,72576,0,0,72576
142146000100000,CITY PROPERTY,Exempt,0,0,0,0,0,0
142146000200000,CITY PROPERTY,Exempt,0,0,0,0,0,0
142146000300000,FLAT PARKING,Commercial,0,145152,145152,0,15840,160992
142146000400000,THEATER,Exempt,0,189798,189798,0,450954,640752
142146000500000,OFFICE; CTRL CR,Exempt,0,99883,99883,0,312207,412090
142146000600000,PARKING STRUCTURE,Commercial,0,229824,229824,0,1812735,2042559
142146000700000,BRNCH BK/CR; CTRL CR,Commercial,0,96768,96768,0,0,96768
142146000800000,BRNCH BK/CR; CTRL CR,Commercial,0,40824,40824,0,0,40824
142146000900000,BRNCH BK/CR; CTRL CR,Commercial,0,40824,40824,0,0,40824
142146001000000,BRNCH BK/CR; CTRL CR,Commercial,0,45360,45360,0,0,45360
142146001100000,BARS/LOUNGE; CTRL CR,Commercial,0,26611,26611,0,118838,145449
142146100100000,CITY PROPERTY,Exempt,0,0,0,0,0,0
142146200100000,FLAT PARKING,Commercial,0,112252,112252,0,65784,178036
142146200200000,FLAT PARKING,Commercial,0,23095,23095,0,5382,28477
142146200300000,OFFICE; CTRL CR,Commercial,0,49041,49041,0,119926,168967
142146200400000,FLAT PARKING,Commercial,0,90478,90478,0,11995,102473
142146200500000,BARS/LOUNGE; CTRL CR,Commercial,0,55883,55883,0,210746,266629
142146200600000,OFFICE; CTRL CR,Commercial,0,275184,275184,0,323283,598467
142146200700000,OFFICE; CTRL CR,Commercial,0,290304,290304,0,861488,1151792
142146200800000,THEATER,Commercial,0,79834,79834,0,27020,106854
142146200900000,FLAT PARKING,Commercial,0,79834,79834,0,15200,95034
142146300100000,BRNCH BK/CR; CTRL CR,Commercial,0,263723,263723,0,3521010,3784733
142146300200000,BRNCH BK/CR; CTRL CR,Commercial,0,183239,183239,0,1733416,1916655
142146400100000,OFFICE; CTRL CR,Commercial,0,93312,93312,0,717429,810741
142146400200000,SMALL RET; CTRL CR,Commercial,0,62208,62208,0,67031,129239
142146400300000,OFFICE; CTRL CR,Commercial,0,40044,40044,0,90732,130776
142146400400000,OFFICE; CTRL CR,Commercial,0,125762,125762,0,447041,572803
142146400500000,SMALL RET; CTRL CR,Commercial,0,108878,108878,0,492340,601218
142146400600000,VACANT LAND,Commercial,0,4666,4666,0,350,5016
142146400800000,SMALL RET; CTRL CR,Commercial,0,48384,48384,0,103701,152085
142146400900000,OFFICE; CTRL CR,Commercial,0,362880,362880,0,362241,725121
142146401001000,SMALL RET; CTRL CR,Commercial,0,29662,29662,0,170732,200394
142146401001001,OFFICE; CTRL CR,Commercial,0,32608,32608,0,154151,186759
142146401001002,OFFICE; CTRL CR,Commercial,0,36231,36231,0,166019,202250
142146401001003,OFFICE; CTRL CR,Commercial,0,36231,36231,0,2391,38622
142147600100000,OFFICE,Exempt,0,184464,184464,0,324669,509133
142147600200000,OFFICE; MED; CTRL CR,Commercial,0,142501,142501,0,632499,775000
142147600400000,RESTAURANT; CTRL CR,Commercial,0,45360,45360,0,162186,207546
142147600600000,SMALL RET; CTRL CR,Commercial,0,145152,145152,0,280309,425461
142147600700000,OFFICE; MED; CTRL CR,Commercial,0,224640,224640,0,1309514,1534154
142147700100000,SHOP,Commercial,0,27579,27579,0,42251,69830
142147700200000,FLAT PARKING,Commercial,0,11340,11340,0,2100,13440
142147800100000,SMALL RET; CTRL CR,Commercial,0,54432,54432,0,502457,556889
142147800200000,WAREHOUSE; CTRL CR,Commercial,0,24840,24840,0,87780,112620
142147800300000,AUTO REP/SAL;CTRL CR,Commercial,0,62257,62257,0,43850,106107
142147800302000,BILLBOARD(BLL),Commercial,0,0,0,0,10390,10390
142147800400000,FLAT PARKING,Commercial,0,46834,46834,0,8673,55507
142147800500000,BARS/LOUNGE; CTRL CR,Commercial,0,46834,46834,0,36014,82848
142147800600000,SMALL RET; CTRL CR,Commercial,0,63504,63504,0,356515,420019
142147800700000,FLAT PARKING,Commercial,0,63504,63504,0,6720,70224
142147800800000,FLAT PARKING,Commercial,0,54432,54432,0,5040,59472
142147800900000,FLAT PARKING,Commercial,0,54432,54432,0,6720,61152
142147801000000,SMALL RET; CTRL CR,Commercial,0,54432,54432,0,194819,249251
142147801100000,SMALL RET; CTRL CR,Commercial,0,54432,54432,0,160764,215196
142147900100000,CONVERSION,Commercial,0,14580,14580,0,112954,127534
142147900200000,FLAT PARKING,Exempt,0,248832,248832,0,77304,326136
142147900300000,SE 238,Residential,15300,0,15300,44689,0,59989
142147900400000,FLAT PARKING,Exempt,0,38880,38880,0,0,38880
142148000100000,CONVERSION,Commercial,0,6440,6440,0,52364,58804
142148000200000,CONVERSION,Commercial,0,10530,10530,0,64170,74700
142148000300000,CONVERSION,Commercial,0,5832,5832,0,97295,103127
142148000400000,FLAT PARKING,Commercial,0,31104,31104,0,5760,36864
142148000500000,SMALL RETAIL,Exempt,0,90720,90720,0,259603,350323
142148000600000,SMALL RET; CTRL CR,Commercial,0,9256,9256,0,34394,43650
142148000700000,SMALL RET; CTRL CR,Commercial,0,9049,9049,0,34627,43676
142148000800000,SMALL RET; CTRL CR,Commercial,0,9054,9054,0,38436,47490
142148000900000,SMALL RET; CTRL CR,Commercial,0,9097,9097,0,33238,42335
142148001000000,SMALL RET; CTRL CR,Commercial,0,9101,9101,0,33238,42339
142148001100000,SMALL RET; CTRL CR,Commercial,0,9097,9097,0,39633,48730
142148001200000,SMALL RET; CTRL CR,Commercial,0,18325,18325,0,38113,56438
142148001300000,FLAT PARKING,Commercial,0,54550,54550,0,5312,59862
142148001400000,FLAT PARKING,Commercial,0,88906,88906,0,20580,109486
142148001500000,CONVERSION,Commercial,0,12020,12020,0,190395,202415
142148001600000,SE 238,Residential,8578,0,8578,24831,0,33409
142148100100000,FLAT PARKING,Commercial,0,181440,181440,0,14877,196317
142148100300000,SMALL RET; CTRL CR,Commercial,0,22680,22680,0,105052,127732
142148100400000,FLAT PARKING,Commercial,0,31752,31752,0,1296,33048
142148100500000,FLAT PARKING,Commercial,0,81648,81648,0,6300,87948
142148100600000,CHURCH,Exempt,0,105840,105840,0,277917,383757
142148200100000,OFFICE; MED; CTRL CR,Commercial,0,125453,125453,0,777150,902603
142148200300000,FLAT PARKING,Exempt,0,23501,23501,0,4275,27776
142148300100000,OFFICE; MED; CTRL CR,Commercial,0,145152,145152,0,402009,547161
142148300200000,FLAT PARKING,Exempt,0,90720,90720,0,16560,107280
142148300300000,FLAT PARKING,Exempt,0,54432,54432,0,5985,60417
142148300600000,HOSPITAL,Exempt,0,36288,36288,0,12610,48898
142148300700000,VACANT LAND,Exempt,0,4941,4941,0,0,4941
142148300800000,VACANT LAND,Exempt,0,4941,4941,0,0,4941
142148300900000,VACANT LAND,Exempt,0,18922,18922,0,0,18922
142148400200000,CENTRALLY ASSESSED,Other,0,0,0,0,0,0
142148400300000,CENTRALLY ASSESSED,Other,0,0,0,0,0,0
142148400400000,CENTRALLY ASSESSED,Other,0,0,0,0,0,0
142148400500000,CENTRALLY ASSESSED,Other,0,0,0,0,0,0
142148400600000,SE 238,Residential,4425,0,4425,27783,0,32208
142148400700000,SE 238,Residential,4425,0,4425,27637,0,32062
142148400800000,FLAT PARKING,Commercial,0,19008,19008,0,4400,23408
142148400900000,CENTRALLY ASSESSED,Other,0,0,0,0,0,0
142148401000000,VACANT LAND,Commercial,0,13608,13608,0,0,13608
142148401200000,OFFICE; CTRL CR,Commercial,0,72576,72576,0,122527,195103
142148500100000,OFFICE; MED; CTRL CR,Commercial,0,628290,628290,0,11134289,11762579
142148500200000,APARTMENT; CNTRL CR,Commercial,0,20380,20380,0,384053,404433
142148600200000,CONVERSION,Commercial,0,4860,4860,0,45758,50618
142148600700000,AUTO REP/SAL;CTRL CR,Commercial,0,27216,27216,0,58736,85952
142148600800000,FLAT PARKING,Commercial,0,70070,70070,0,14550,84620
142148600900000,CHURCH,Exempt,0,10368,10368,0,43039,53407
142148601100000,FLAT PARKING,Commercial,0,66407,66407,0,29682,96089
142148601300000,OFFICE; MED; CTRL CR,Commercial,0,121500,121500,0,2065917,2187417
142148700100000,SMALL RET; CTRL CR,Commercial,0,23328,23328,0,66117,89445
142148700200000,FLAT PARKING,Exempt,0,49248,49248,0,9200,58448
142148700300000,OFFICE,Exempt,0,181440,181440,0,550797,732237
142148700400000,VACANT LAND,Exempt,0,36288,36288,0,0,36288
142148700500000,CONVERSION,Exempt,0,18144,18144,0,88333,106477
142148700600000,WAREHOUSE; CTRL CR,Commercial,0,54432,54432,0,140661,195093
142148800100000,OFFICE,Exempt,0,68040,68040,0,927666,995706
142148800200000,FLAT PARKING,Exempt,0,63504,63504,0,5760,69264
142148800300000,FLAT PARKING,Exempt,0,63504,63504,0,5760,69264
142148800400000,OFFICE,Exempt,0,136080,136080,0,1302784,1438864
142148800500000,FLAT PARKING,Exempt,0,22680,22680,0,4332,27012
142148900100000,FLAT PARKING,Commercial,0,49594,49594,0,16296,65890
142148900300000,BARS/LOUNGE; CTRL CR,Commercial,0,45360,45360,0,90806,136166
142148900400000,FLAT PARKING,Commercial,0,60480,60480,0,13921,74401
142148900500000,SMALL RET; CTRL CR,Commercial,0,30240,30240,0,62140,92380
142148900600000,FLAT PARKING,Commercial,0,22680,22680,0,6384,29064
142148900700000,SHOP,Commercial,0,22680,22680,0,48846,71526
142148900800000,BRNCH BK/CR; CTRL CR,Commercial,0,45360,45360,0,219406,264766
142148900900000,VACANT LAND,Commercial,0,12960,12960,0,0,12960
142148901000000,SHOP,Commercial,0,72576,72576,0,47823,120399
142148901300000,VACANT LAND,Commercial,0,22982,22982,0,0,22982
142210100100000,SE 248,Residential,74900,0,74900,221092,0,295992
142210100200000,SE 248,Residential,95762,0,95762,138254,0,234016
142210100300000,SE 248,Residential,75600,0,75600,236841,0,312441
142210100400000,SE 248,Residential,147550,0,147550,212653,0,360203
142210100500000,SE 248,Residential,84750,0,84750,270465,0,355215
142210100600000,SE 248,Residential,82500,0,82500,207299,0,289799
142210100700000,SE 248,Residential,73600,0,73600,180761,0,254361
142210100800000,SE 248,Residential,63000,0,63000,202761,0,265761
142210100900000,SE 248,Residential,92085,0,92085,152041,0,244126
142210200100000,SE 248,Residential,82476,0,82476,142524,0,225000
142210200200000,SE 248,Residential,91000,0,91000,330089,0,421089
142210200300000,SE 248,Residential,130839,0,130839,567004,0,697843
142210200400000,SE 248,Residential,124320,0,124320,322197,0,446517
142210200500000,SE 248,Residential,74592,0,74592,248156,0,322748
142210200600000,SE 248,Residential,66600,0,66600,267988,0,334588
142210200700000,SE 248,Residential,69143,0,69143,221304,0,290447
142210200800000,SE 248,Residential,92171,0,92171,348107,0,440278
142210200900000,SE 248,Residential,85053,0,85053,160304,0,245357
142210201000000,SE 248,Residential,87733,0,87733,166355,0,254088
142210201100000,SE 248,Residential,81408,0,81408,292636,0,374044
142210201200000,SE 248,Residential,58240,0,58240,262889,0,321129
142210201300000,SE 248,Residential,68134,0,68134,112411,0,180545
142210201400000,SE 248,Residential,74523,0,74523,183832,0,258355
142210201500000,SE 248,Residential,49451,0,49451,136016,0,185467
142210201600000,SE 248,Residential,103600,0,103600,386056,0,489656
142210201700000,SE 248,Residential,87387,0,87387,113967,0,201354
142210201800000,SE 248,Residential,70512,0,70512,184181,0,254693
142210201900000,SE 248,Residential,110288,0,110288,320533,0,430821
142210202000000,SE 248,Residential,89719,0,89719,372281,0,462000
142210300100000,SE 248,Residential,95040,0,95040,257603,0,352643
142210300200000,SE 248,Residential,54000,0,54000,205459,0,259459
142210300300000,SE 248,Residential,54000,0,54000,202071,0,256071
142210300400000,SE 248,Residential,103000,0,103000,303884,0,406884
142210300500000,SE 248,Residential,132450,0,132450,240781,0,373231
142210400100000,SE 248,Exempt,0,141450,141450,0,504385,645835
142210400200000,SE 248,Residential,52400,0,52400,296198,0,348598
142210400300000,SE 248,Residential,52380,0,52380,148561,0,200941
142210400400000,SE 248,Residential,21560,0,21560,129331,0,150891
142210400500000,SE 248,Residential,39263,0,39263,197247,0,236510
142210400600000,SE 248,Residential,24000,0,24000,146443,0,170443
142210400700000,SE 248,Residential,24000,0,24000,158409,0,182409
142210400800000,SE 248,Residential,28280,0,28280,177562,0,205842
142210400900000,SE 248,Residential,24480,0,24480,142178,0,166658
142210401000000,SE 248,Residential,61135,0,61135,132584,0,193719
142210401100000,SE 248,Residential,59281,0,59281,140719,0,200000
142210401200000,SE 248,Residential,50880,0,50880,151721,0,202601
142210401300000,SE 248,Residential,55035,0,55035,160224,0,215259
142210401400000,SE 248,Residential,51360,0,51360,100311,0,151671
142210401500000,SE 248,Residential,122944,0,122944,231773,0,354717
142210401600000,SE 248,Residential,141413,0,141413,684587,0,826000
142210401700000,SE 248,Residential,140850,0,140850,410479,0,551329
142210500100000,SE 216,Residential,49756,0,49756,92618,0,142374
142210600100000,SE 216,Residential,45934,0,45934,96179,0,142113
142210600200000,SE 216,Residential,20958,0,20958,119474,0,140432
142210600300000,SE 216,Residential,48000,0,48000,145946,0,193946
142210600400000,SE 216,Residential,48000,0,48000,137494,0,185494
142210600500000,SE 216,Residential,48000,0,48000,120951,0,168951
142210600600000,SE 216,Residential,51200,0,51200,115883,0,167083
142210600700000,SE 216,Residential,48000,0,48000,110350,0,158350
142210600800000,SE 216,Residential,40000,0,40000,113129,0,153129
142210600900000,SE 216,Residential,56000,0,56000,136167,0,192167
142210601000000,SE 216,Residential,48000,0,48000,122119,0,170119
142210601100000,SE 216,Residential,48000,0,48000,106377,0,154377
142210601200000,SE 216,Residential,48000,0,48000,126809,0,174809
142210601300000,SE 216,Residential,48000,0,48000,145433,0,193433
142210601400000,SE 216,Residential,48000,0,48000,145299,0,193299
142210601500000,SE 216,Residential,32000,0,32000,114316,0,146316
142210601600000,SE 216,Residential,32000,0,32000,104436,0,136436
142210601700000,SE 216,Residential,44000,0,44000,106785,0,150785
142210601800000,SE 216,Residential,39240,0,39240,114554,0,153794
142210601900000,SE 216,Residential,36520,0,36520,109690,0,146210
142210602000000,SE 216,Residential,12450,0,12450,98581,0,111031
142210900100000,SE 231,Residential,12500,0,12500,63350,0,75850
142210900800000,NE 156,Residential,18000,0,18000,53505,0,71505
142212600100000,SE 218,Residential,19500,0,19500,144604,0,164104
142212600200000,SE 218,Residential,19500,0,19500,183835,0,203335
142212600300000,SE 218,Residential,18000,0,18000,0,0,18000
142212600400000,SE 218,Residential,18000,0,18000,184589,0,202589
142212600500000,SE 218,Residential,18000,0,18000,174764,0,192764
142212600600000,SE 218,Residential,18000,0,18000,199196,0,217196
142212600700000,SE 218,Residential,18000,0,18000,203968,0,221968
142212600800000,SE 218,Residential,18000,0,18000,0,0,18000
142212600900000,SE 218,Residential,18000,0,18000,246089,0,264089
142212601000000,SE 218,Residential,18000,0,18000,138497,0,156497
142212601100000,SE 218,Residential,18000,0,18000,207650,0,225650
142212601200000,SE 218,Residential,18000,0,18000,146301,0,164301
142212601300000,SE 218,Residential,18000,0,18000,161969,0,179969
142212601400000,SE 218,Residential,18000,0,18000,156904,0,174904
142212601500000,SE 218,Residential,18000,0,18000,141683,0,159683
142212601600000,SE 218,Residential,18000,0,18000,181966,0,199966
142212601700000,SE 218,Residential,18000,0,18000,126761,0,144761
142212601800000,SE 218,Residential,18000,0,18000,141686,0,159686
142212601900000,SE 218,Residential,18000,0,18000,148762,0,166762
142212602000000,SE 218,Residential,18000,0,18000,146671,0,164671
142212700100000,SE 218,Residential,30000,0,30000,281062,0,311062
142212700200000,SE 218,Residential,25574,0,25574,269702,0,295276
142212700300000,SE 218,Residential,25720,0,25720,228780,0,254500
142212700600000,SE 218,Residential,18000,0,18000,109290,0,127290
142212700700000,OFFICE,Commercial,0,54432,54432,0,75006,129438
142212700800000,SE 218,Residential,18000,0,18000,172952,0,190952
142212700900000,SE 218,Residential,18000,0,18000,127009,0,145009
142212701000000,SE 218,Residential,18000,0,18000,209249,0,227249
142212701100000,SE 218,Residential,18000,0,18000,164207,0,182207
142212701200000,OFFICE; MEDICAL,Commercial,0,207900,207900,0,948936,1156836
142212800100000,OFFICE,Commercial,0,63180,63180,0,125220,188400
142212900100000,SE 217,Residential,13680,0,13680,100458,0,114138
142212900200000,SE 217,Residential,21623,0,21623,101204,0,122827
142212900300000,SE 217,Residential,11856,0,11856,101448,0,113304
142212900400000,SE 217,Residential,7826,0,7826,116095,0,123921
142212900500000,SE 217,Residential,12600,0,12600,93038,0,105638
142212900600000,SE 217,Residential,30736,0,30736,115571,0,146307
142212900700000,SE 217,Residential,23200,0,23200,99877,0,123077
142212900800000,SE 217,Residential,16431,0,16431,88569,0,105000
142212900900000,SE 217,Residential,24000,0,24000,112052,0,136052
142212901000000,SE 217,Residential,9920,0,9920,91407,0,101327
142213000100000,SE 218,Residential,15300,0,15300,111691,0,126991
142213000200000,SE 218,Residential,15300,0,15300,95839,0,111139
142213000300000,SE 218,Residential,15300,0,15300,89865,0,105165
142213000400000,SE 218,Residential,15300,0,15300,76372,0,91672
142213000500000,SE 218,Residential,15300,0,15300,72183,0,87483
142213000600000,SE 218,Residential,18000,0,18000,103710,0,121710
142213000700000,SE 218,Residential,15300,0,15300,101590,0,116890
142213000800000,SE 218,Residential,15300,0,15300,44597,0,59897
142213000900000,CONVERSION,Commercial,0,13608,13608,0,72566,86174
142213001000000,SE 218,Residential,15300,0,15300,121991,0,137291
142213001100000,SE 218,Residential,15300,0,15300,156862,0,172162
142213001200000,SE 218,Residential,15300,0,15300,132396,0,147696
142213001300000,SE 218,Residential,15300,0,15300,85710,0,101010
142213001400000,SE 218,Residential,15300,0,15300,107595,0,122895
142213001500000,SE 218,Residential,15300,0,15300,103092,0,118392
142213001600000,SE 218,Residential,15300,0,15300,93929,0,109229
142213100100000,SE 222,Exempt,0,17136,17136,0,202077,219213
142213100200000,BRANCH BANK/CU,Commercial,0,208170,208170,0,958001,1166171
142213100300000,OFFICE,Commercial,0,163296,163296,0,1012406,1175702
142213100400000,FLAT PARKING,Commercial,0,54432,54432,0,5632,60064
142213100500000,SE 218,Residential,16800,0,16800,123177,0,139977
142213100600000,SE 218,Residential,15000,0,15000,84396,0,99396
142213100700000,SE 218,Residential,15300,0,15300,90283,0,105583
142213100800000,SE 218,Residential,15300,0,15300,110353,0,125653
142213100900000,SE 218,Residential,15300,0,15300,172436,0,187736
142213101000000,SE 218,Residential,15675,0,15675,102014,0,117689
142213101100000,SE 218,Residential,15675,0,15675,143700,0,159375
142213200100000,SE 231,Residential,12500,0,12500,130706,0,143206
142213200400000,SE 217,Residential,7634,0,7634,64768,0,72402
142213200500000,SE 217,Residential,8468,0,8468,84798,0,93266
142213200600000,SE 217,Residential,6228,0,6228,81506,0,87734
142213300100000,SE 217,Residential,19920,0,19920,115466,0,135386
142213300200000,SE 217,Residential,24000,0,24000,114153,0,138153
142213300300000,SE 217,Residential,16000,0,16000,129287,0,145287
142213300400000,SE 217,Residential,16000,0,16000,101512,0,117512
142213300500000,SE 217,Residential,16000,0,16000,91273,0,107273
142213300600000,SE 217,Residential,24000,0,24000,44559,0,68559
142213300700000,SE 217,Residential,24000,0,24000,92194,0,116194
142213300800000,SE 217,Residential,21120,0,21120,160566,0,181686
142213300900000,SE 217,Residential,6200,0,6200,89751,0,95951
142213301000000,SE 217,Residential,7440,0,7440,96240,0,103680
142213301100000,SE 217,Residential,12600,0,12600,120042,0,132642
142213301200000,SE 217,Residential,7500,0,7500,76352,0,83852
142213301300000,SE 217,Residential,7500,0,7500,76492,0,83992
142213301400000,SE 217,Residential,9700,0,9700,89917,0,99617
142213301500000,SE 217,Residential,300,0,300,3425,0,3725
142213301600000,SE 217,Residential,10000,0,10000,84515,0,94515
142213301700000,SE 217,Residential,10000,0,10000,115673,0,125673
142213301800000,SE 217,Residential,10000,0,10000,96131,0,106131
142213301900000,SE 217,Residential,11250,0,11250,108350,0,119600
142213302000000,SE 217,Residential,8750,0,8750,86593,0,95343
142213302100000,SE 217,Residential,12450,0,12450,114271,0,126721
142213302200000,SE 217,Residential,12400,0,12400,88744,0,101144
142213302300000,SE 217,Residential,12400,0,12400,115357,0,127757
142213400100000,SE 217,Residential,8671,0,8671,68712,0,77383
142213400200000,SE 217,Residential,8568,0,8568,70455,0,79023
142213400300000,SE 217,Residential,8311,0,8311,51935,0,60246
142213400700000,SE 217,Residential,6600,0,6600,60167,0,66767
142213400800000,SE 217,Residential,10000,0,10000,96056,0,106056
142213400900000,SE 217,Residential,10000,0,10000,80368,0,90368
142213401000000,SE 217,Residential,11050,0,11050,128400,0,139450
142213401100000,SE 217,Residential,8752,0,8752,83343,0,92095
142213401200000,SE 217,Residential,4375,0,4375,66972,0,71347
142213500100000,SE 231,Residential,8400,0,8400,87203,0,95603
142213500200000,SE 231,Residential,6650,0,6650,30715,0,37365
142213500300000,SE 231,Residential,6650,0,6650,32870,0,39520
142213500400000,CONVERSION,Commercial,0,9072,9072,0,57455,66527
142213500500000,CONVERSION,Commercial,0,27216,27216,0,192973,220189
142213500600000,CONVERSION,Exempt,0,9072,9072,0,109969,119041
142213500700000,SE 231,Residential,12500,0,12500,45474,0,57974
142213500800000,SE 231,Residential,10000,0,10000,86015,0,96015
142213500900000,CONVERSION,Commercial,0,9072,9072,0,73723,82795
142213501000000,SE 231,Residential,12000,0,12000,57375,0,69375
142213501100000,SE 231,Residential,12000,0,12000,74041,0,86041
142213501200000,SE 231,Residential,12000,0,12000,66209,0,78209
142213501300000,SE 231,Residential,12000,0,12000,69423,0,81423
142213501400000,SE 231,Residential,12000,0,12000,88545,0,100545
142213501500000,CONVERSION,Commercial,0,9072,9072,0,63969,73041
142213501600000,SE 231,Residential,8400,0,8400,72400,0,80800
142213600100000,SE 217,Residential,10582,0,10582,83649,0,94231
142213600200000,SE 217,Residential,9300,0,9300,106984,0,116284
142213600300000,SE 217,Residential,12500,0,12500,97623,0,110123
142213600400000,SE 217,Residential,10000,0,10000,100700,0,110700
142213600500000,SE 217,Residential,10000,0,10000,99083,0,109083
142213600600000,SE 217,Residential,10000,0,10000,94863,0,104863
142213600700000,SE 217,Residential,10000,0,10000,100746,0,110746
142213600800000,SE 217,Residential,10000,0,10000,98011,0,108011
142213600900000,SE 217,Residential,12075,0,12075,94603,0,106678
142213601000000,SE 217,Residential,9690,0,9690,70281,0,79971
142213601100000,SE 217,Residential,8755,0,8755,80346,0,89101
142213700100000,SE 217,Residential,9669,0,9669,92798,0,102467
142213700200000,SE 217,Residential,9380,0,9380,78482,0,87862
142213700300000,SE 217,Residential,12750,0,12750,83429,0,96179
142213700400000,SE 217,Residential,10000,0,10000,69639,0,79639
142213700500000,SE 217,Residential,12500,0,12500,56603,0,69103
142213700600000,SE 217,Residential,11250,0,11250,73040,0,84290
142213700700000,SE 217,Residential,10398,0,10398,78195,0,88593
142213700800000,SE 217,Residential,8925,0,8925,88780,0,97705
142213700900000,SE 217,Residential,10374,0,10374,57981,0,68355
142213800100000,SE 217,Residential,8617,0,8617,40664,0,49281
142213800200000,SE 217,Residential,9009,0,9009,39911,0,48920
142215100100000,SE 217,Residential,9300,0,9300,89225,0,98525
142215100200000,SE 217,Residential,10582,0,10582,98648,0,109230
142215100300000,SE 217,Residential,10000,0,10000,115040,0,125040
142215100400000,SE 217,Residential,10000,0,10000,100772,0,110772
142215100500000,SE 217,Residential,10000,0,10000,110825,0,120825
142215100600000,SE 217,Residential,10000,0,10000,96780,0,106780
142215100700000,SE 217,Residential,10000,0,10000,95247,0,105247
142215100800000,SE 217,Residential,10000,0,10000,84111,0,94111
142215100900000,SE 217,Residential,12240,0,12240,125581,0,137821
142215101000000,SE 217,Residential,8925,0,8925,78361,0,87286
142215101100000,SE 217,Residential,9690,0,9690,98700,0,108390
142215200100000,SE 217,Residential,8000,0,8000,79888,0,87888
142215200200000,SE 217,Residential,590,0,590,0,0,590
142215200300000,SE 217,Residential,9927,0,9927,87667,0,97594
142215200400000,SE 217,Residential,9703,0,9703,70017,0,79720
142215200500000,SE 217,Residential,10000,0,10000,90417,0,100417
142215200600000,SE 217,Residential,10000,0,10000,63941,0,73941
142215200700000,SE 217,Residential,10000,0,10000,71445,0,81445
142215200800000,SE 217,Residential,10000,0,10000,76831,0,86831
142215200900000,SE 217,Residential,12500,0,12500,90803,0,103303
142215201000000,SE 217,Residential,7905,0,7905,71103,0,79008
142215201100000,SE 217,Residential,9690,0,9690,77795,0,87485
142215300100000,SE 217,Residential,10640,0,10640,75006,0,85646
142215300200000,SE 217,Residential,7000,0,7000,81527,0,88527
142215300300000,SE 217,Residential,7000,0,7000,86092,0,93092
142215300400000,SE 217,Residential,10000,0,10000,39491,0,49491
142215300500000,SE 217,Residential,8889,0,8889,79522,0,88411
142215300600000,SE 217,Residential,8925,0,8925,91321,0,100246
142215300700000,SE 217,Residential,10943,0,10943,31430,0,42373
142215300800000,SE 217,Residential,8707,0,8707,62450,0,71157
142215400100000,CONVERSION,Commercial,0,13608,13608,0,167730,181338
142215400200000,SE 217,Residential,12000,0,12000,103845,0,115845
142215400300000,SE 217,Residential,10500,0,10500,116051,0,126551
142215400400000,SE 217,Residential,10000,0,10000,114330,0,124330
142215400500000,SE 217,Residential,10000,0,10000,109308,0,119308
142215400600000,SE 217,Residential,12750,0,12750,109972,0,122722
142215400700000,SE 217,Residential,10000,0,10000,115007,0,125007
142215400800000,SE 217,Residential,6125,0,6125,64916,0,71041
142215400900000,SE 217,Residential,7875,0,7875,68788,0,76663
142215401000000,SE 217,Residential,7600,0,7600,68588,0,76188
142215401100000,SE 217,Residential,5700,0,5700,70768,0,76468
142215401200000,SE 217,Residential,6650,0,6650,59581,0,66231
142215401300000,SE 217,Residential,6650,0,6650,67021,0,73671
142215401400000,SE 217,Residential,7875,0,7875,86281,0,94156
142215401500000,SE 217,Residential,6125,0,6125,61948,0,68073
142215401600000,SE 217,Residential,10000,0,10000,82701,0,92701
142215401700000,SE 217,Residential,10000,0,10000,98920,0,108920
142215401800000,SE 217,Residential,10000,0,10000,89235,0,99235
142215401900000,SE 217,Residential,7500,0,7500,70543,0,78043
142215402000000,SE 217,Residential,12500,0,12500,118963,0,131463
142215402100000,SE 217,Residential,10000,0,10000,67478,0,77478
142215402200000,SE 217,Residential,10000,0,10000,118325,0,128325
142215402300000,SE 217,Residential,5590,0,5590,75184,0,80774
142215402400000,SE 217,Residential,5250,0,5250,61776,0,67026
142215402500000,SE 217,Residential,5580,0,5580,72545,0,78125
142215402600000,SE 217,Residential,7440,0,7440,60168,0,67608
142215402700000,SE 217,Residential,7440,0,7440,92113,0,99553
142215500100000,SE 217,Residential,8100,0,8100,119053,0,127153
142215500200000,SE 217,Residential,7530,0,7530,93988,0,101518
142215500300000,SE 217,Residential,10000,0,10000,68128,0,78128
142215500400000,SE 217,Residential,10000,0,10000,95369,0,105369
142215500500000,SE 217,Residential,10000,0,10000,61221,0,71221
142215500600000,SE 217,Residential,10000,0,10000,99465,0,109465
142215500700000,SE 217,Residential,10000,0,10000,90144,0,100144
142215500800000,SE 217,Residential,7300,0,7300,49326,0,56626
142215500900000,SE 217,Residential,7300,0,7300,90110,0,97410
142215501000000,SE 217,Residential,6175,0,6175,49683,0,55858
142215501100000,SE 217,Residential,6175,0,6175,49377,0,55552
142215501200000,SE 217,Residential,6125,0,6125,62310,0,68435
142215501300000,SE 217,Residential,6125,0,6125,59586,0,65711
142215501400000,SE 217,Residential,7000,0,7000,58137,0,65137
142215501500000,SE 217,Residential,5250,0,5250,53456,0,58706
142215501600000,SE 217,Residential,7500,0,7500,73642,0,81142
142215501700000,SE 217,Residential,10000,0,10000,63277,0,73277
142215501800000,SE 217,Residential,10000,0,10000,87180,0,97180
142215501900000,SE 217,Residential,10000,0,10000,78006,0,88006
142215502000000,SE 217,Residential,10000,0,10000,84928,0,94928
142215502100000,SE 217,Residential,10000,0,10000,66362,0,76362
142215502200000,SE 217,Residential,5688,0,5688,63643,0,69331
142215502300000,SE 217,Residential,5688,0,5688,54022,0,59710
142215502400000,SE 217,Residential,5863,0,5863,58208,0,64071
142215502500000,SE 217,Residential,5863,0,5863,55703,0,61566
142215502600000,SE 217,Residential,6500,0,6500,64854,0,71354
142215502700000,SE 217,Residential,6665,0,6665,51980,0,58645
142215600100000,APARTMENT,Commercial,0,19278,19278,0,173089,192367
142215600200000,SE 231,Residential,10000,0,10000,85627,0,95627
142215600300000,SE 231,Residential,10000,0,10000,83895,0,93895
142215600400000,SE 231,Residential,10000,0,10000,72007,0,82007
142215600500000,SE 231,Residential,10000,0,10000,80344,0,90344
142215600600000,SE 231,Residential,10000,0,10000,72346,0,82346
142215600700000,APARTMENT,Commercial,0,13608,13608,0,155808,169416
142215600800000,SE 231,Residential,7000,0,7000,84963,0,91963
142215600900000,SE 231,Residential,9125,0,9125,67358,0,76483
142215601000000,SE 231,Residential,12450,0,12450,18833,0,31283
142215601100000,SE 231,Residential,9409,0,9409,72441,0,81850
142215601200000,CONVERSION,Residential,9800,0,9800,105106,0,114906
142215601300000,SE 231,Residential,10000,0,10000,87198,0,97198
142215601400000,SE 231,Residential,10000,0,10000,102299,0,112299
142215601500000,SE 231,Residential,10000,0,10000,65659,0,75659
142215601600000,SE 231,Residential,10000,0,10000,68941,0,78941
142215601700000,SE 231,Residential,9669,0,9669,66545,0,76214
142215601800000,SE 231,Residential,5863,0,5863,54974,0,60837
142215601900000,SE 231,Residential,5863,0,5863,56620,0,62483
142215700100000,CHURCH,Exempt,0,11340,11340,0,294829,306169
142215700200000,SE 217,Residential,10000,0,10000,89465,0,99465
142215700300000,SE 217,Residential,10000,0,10000,106114,0,116114
142215700400000,SE 217,Residential,10000,0,10000,95409,0,105409
142215700500000,SE 217,Residential,12500,0,12500,87438,0,99938
142215700600000,SE 217,Residential,10000,0,10000,134346,0,144346
142215700700000,SE 217,Residential,10000,0,10000,90606,0,100606
142215700800000,SE 217,Residential,7000,0,7000,67182,0,74182
142215700900000,SE 217,Residential,5250,0,5250,73939,0,79189
142215701000000,FLAT PARKING,Exempt,0,0,0,0,0,0
142215701100000,SCHOOL,Exempt,0,0,0,0,0,0
142215701200000,SE 217,Residential,5038,0,5038,53048,0,58086
142215701300000,SE 217,Residential,9307,0,9307,82567,0,91874
142215701400000,SE 217,Residential,7500,0,7500,63793,0,71293
142215701500000,SE 217,Residential,7500,0,7500,73613,0,81113
142215701600000,SE 217,Residential,10000,0,10000,98918,0,108918
142215701700000,SE 217,Residential,10000,0,10000,86251,0,96251
142215701800000,SE 217,Residential,10000,0,10000,86057,0,96057
142215701900000,SE 217,Residential,10000,0,10000,93897,0,103897
142215702000000,SE 217,Residential,10000,0,10000,76715,0,86715
142215702100000,SE 217,Residential,10000,0,10000,97875,0,107875
142215702200000,SE 217,Residential,5250,0,5250,88971,0,94221
142215702300000,SE 217,Residential,5250,0,5250,84125,0,89375
142215702400000,SE 217,Residential,6510,0,6510,59691,0,66201
142215702500000,SE 217,Residential,6510,0,6510,61720,0,68230
142215800100000,SCHOOL,Exempt,0,0,0,0,0,0
142215900100000,SE 231,Residential,5931,0,5931,52362,0,58293
142215900200000,SE 231,Residential,5931,0,5931,48657,0,54588
142215900300000,SE 231,Residential,10000,0,10000,70999,0,80999
142215900400000,SE 231,Residential,15000,0,15000,67599,0,82599
142215900500000,SE 231,Residential,12750,0,12750,75345,0,88095
142215900600000,SE 231,Residential,10000,0,10000,93938,0,103938
142215900700000,SE 231,Residential,10000,0,10000,115087,0,125087
142215900800000,SE 231,Residential,7905,0,7905,68759,0,76664
142215900900000,SE 231,Residential,6200,0,6200,60209,0,66409
142215901000000,SE 231,Residential,6200,0,6200,62940,0,69140
142215901100000,SE 216,Residential,17000,0,17000,41114,0,58114
142215901200000,CONVERSION,Commercial,0,11794,11794,0,15836,27630
142215901300000,CHURCH,Exempt,0,13608,13608,0,448,14056
142215901400000,CHURCH,Exempt,0,13608,13608,0,0,13608
142215901500000,CHURCH,Exempt,0,28350,28350,0,841342,869692
142215901600000,SE 231,Residential,5444,0,5444,62772,0,68216
142215901700000,SE 231,Residential,5444,0,5444,58390,0,63834
142216000100000,SE 217,Residential,5360,0,5360,81960,0,87320
142216000200000,SE 217,Residential,6050,0,6050,81658,0,87708
142216000300000,SE 217,Residential,8315,0,8315,108531,0,116846
142216000400000,SE 217,Residential,9773,0,9773,82744,0,92517
142216000500000,SE 217,Residential,8500,0,8500,97248,0,105748
142216000600000,SE 217,Residential,8500,0,8500,66372,0,74872
142216000700000,SE 217,Residential,8000,0,8000,92637,0,100637
142216000800000,SE 217,Residential,10000,0,10000,105567,0,115567
142216000900000,SE 217,Residential,10000,0,10000,86201,0,96201
142216001000000,SE 217,Residential,10000,0,10000,69252,0,79252
142216001100000,SE 217,Residential,5250,0,5250,55608,0,60858
142216001200000,SE 217,Residential,5250,0,5250,64639,0,69889
142216001300000,SE 217,Residential,5425,0,5425,69516,0,74941
142216001400000,SE 217,Residential,5425,0,5425,73292,0,78717
142216001500000,SE 217,Residential,5425,0,5425,61480,0,66905
142216001600000,SE 217,Residential,5425,0,5425,71710,0,77135
142216001700000,SE 217,Residential,8925,0,8925,113424,0,122349
142216001800000,SE 217,Residential,10000,0,10000,129084,0,139084
142216001900000,SE 217,Residential,9000,0,9000,99388,0,108388
142216002000000,SE 217,Residential,11000,0,11000,94883,0,105883
142216002100000,SE 217,Residential,10000,0,10000,86372,0,96372
142216002200000,SE 217,Residential,10000,0,10000,77331,0,87331
142216002300000,SE 217,Residential,10000,0,10000,99226,0,109226
142216002400000,SE 217,Residential,10000,0,10000,118049,0,128049
142216002500000,SE 217,Residential,9900,0,9900,90715,0,100615
142216002600000,SE 217,Residential,7300,0,7300,107637,0,114937
142216002700000,SE 217,Residential,10260,0,10260,83854,0,94114
142216002800000,SE 217,Residential,7560,0,7560,74022,0,81582
142216002900000,SE 217,Residential,8091,0,8091,90833,0,98924
142216100100000,CONVERSION,Commercial,0,7371,7371,0,37904,45275
142216100200000,SE 217,Residential,10000,0,10000,75179,0,85179
142216100300000,SE 217,Residential,10000,0,10000,64321,0,74321
142216100400000,SE 217,Residential,10000,0,10000,112115,0,122115
142216100500000,SE 217,Residential,10000,0,10000,77276,0,87276
142216100600000,SE 217,Residential,10000,0,10000,63623,0,73623
142216100700000,SE 217,Residential,10000,0,10000,40803,0,50803
142216100800000,SE 217,Residential,7843,0,7843,51866,0,59709
142216100900000,SE 217,Residential,6200,0,6200,47600,0,53800
142216101000000,SE 217,Residential,6200,0,6200,68854,0,75054
142216101100000,SE 217,Residential,5475,0,5475,61427,0,66902
142216101200000,SE 217,Residential,12867,0,12867,79306,0,92173
142216101300000,SE 217,Residential,10000,0,10000,77287,0,87287
142216101400000,SE 217,Residential,10000,0,10000,90684,0,100684
142216101500000,SE 217,Residential,10000,0,10000,57754,0,67754
142216101600000,SE 217,Residential,10000,0,10000,119425,0,129425
142216101700000,SE 217,Residential,8750,0,8750,100859,0,109609
142216101800000,SE 217,Residential,12644,0,12644,105704,0,118348
142216101900000,SE 217,Residential,8099,0,8099,98346,0,106445
142216102000000,SE 217,Residential,6820,0,6820,71426,0,78246
142216102100000,SE 217,Residential,5940,0,5940,77735,0,83675
142216102200000,SE 217,Residential,5863,0,5863,82228,0,88091
142216102300000,SE 217,Residential,5863,0,5863,71612,0,77475
142216200100000,SE 231,Residential,8564,0,8564,99401,0,107965
142216200200000,SE 231,Residential,10000,0,10000,44265,0,54265
142216200300000,SE 231,Residential,10000,0,10000,64306,0,74306
142216200400000,SE 231,Residential,10000,0,10000,57880,0,67880
142216200500000,SE 231,Residential,10000,0,10000,51964,0,61964
142216200600000,SE 231,Residential,10000,0,10000,41149,0,51149
142216200700000,SE 231,Residential,10000,0,10000,63819,0,73819
142216200800000,SE 231,Residential,8925,0,8925,59725,0,68650
142216200900000,SE 231,Residential,5425,0,5425,49065,0,54490
142216201000000,SE 231,Residential,5425,0,5425,58725,0,64150
142216201100000,SE 231,Residential,7750,0,7750,56317,0,64067
142216201200000,SE 231,Residential,10582,0,10582,100697,0,111279
142216201300000,SE 231,Residential,12750,0,12750,72976,0,85726
142216201400000,CONVERSION,Commercial,0,13608,13608,0,69796,83404
142216201500000,SE 231,Exempt,0,10000,10000,0,85635,95635
142216201600000,SE 231,Residential,10000,0,10000,86951,0,96951
142216201700000,SE 231,Residential,10000,0,10000,73643,0,83643
142216201800000,SE 231,Residential,9112,0,9112,92340,0,101452
142216201900000,SE 231,Residential,6198,0,6198,56927,0,63125
142216202000000,SE 231,Residential,5863,0,5863,46841,0,52704
142216202100000,SE 231,Residential,6500,0,6500,38497,0,44997
142216202200000,SE 231,Residential,6634,0,6634,42982,0,49616
142217600100000,SE 216,Residential,33440,0,33440,127716,0,161156
142217600200000,SE 216,Residential,38400,0,38400,102517,0,140917
142217700100000,SE 216,Residential,31217,0,31217,90593,0,121810
142217700200000,SE 216,Residential,30000,0,30000,155090,0,185090
142217700300000,SE 216,Residential,30000,0,30000,147707,0,177707
142217700400000,SE 216,Residential,30000,0,30000,139487,0,169487
142217700500000,SE 216,Residential,30000,0,30000,145953,0,175953
142217700600000,SE 216,Residential,30000,0,30000,108029,0,138029
142217700700000,SE 216,Residential,30000,0,30000,138684,0,168684
142217700800000,SE 216,Residential,37500,0,37500,190645,0,228145
142217700900000,SE 216,Residential,32500,0,32500,165599,0,198099
142217701000000,SE 216,Residential,30000,0,30000,143017,0,173017
142217701100000,SE 216,Residential,30000,0,30000,115768,0,145768
142217701200000,SE 216,Residential,30000,0,30000,125974,0,155974
142217701300000,SE 216,Residential,30000,0,30000,111359,0,141359
142217701400000,SE 216,Residential,30000,0,30000,128349,0,158349
142217701500000,SE 216,Residential,30000,0,30000,110251,0,140251
142217701600000,SE 216,Residential,30000,0,30000,101786,0,131786
142217701700000,SE 216,Residential,30000,0,30000,117494,0,147494
142217701800000,SE 216,Residential,30000,0,30000,127432,0,157432
142217800100000,SE 216,Residential,17549,0,17549,93694,0,111243
142217800200000,SE 216,Residential,19381,0,19381,92828,0,112209
142217800300000,SE 216,Residential,18500,0,18500,92113,0,110613
142217800400000,SE 216,Residential,20500,0,20500,118802,0,139302
142217800500000,SE 216,Residential,20000,0,20000,103751,0,123751
142217800600000,SE 216,Residential,20000,0,20000,79735,0,99735
142217800700000,SE 216,Residential,19000,0,19000,93316,0,112316
142217800800000,SE 216,Residential,19000,0,19000,102131,0,121131
142217800900000,SE 216,Residential,19000,0,19000,102121,0,121121
142217801000000,SE 216,Residential,17000,0,17000,70412,0,87412
142217801100000,SE 216,Residential,18287,0,18287,122560,0,140847
142217801200000,SE 216,Residential,16800,0,16800,93832,0,110632
142217801300000,SE 216,Residential,13300,0,13300,75904,0,89204
142217801400000,SE 216,Residential,13300,0,13300,91521,0,104821
142217801500000,SE 216,Residential,13300,0,13300,90277,0,103577
142217801600000,SE 216,Residential,14000,0,14000,92407,0,106407
142217801700000,SE 216,Residential,14000,0,14000,69736,0,83736
142217801800000,SE 216,Residential,20000,0,20000,85102,0,105102
142217801900000,SE 216,Residential,20000,0,20000,94185,0,114185
142217802000000,SE 216,Residential,20000,0,20000,80761,0,100761
142217802100000,SE 216,Residential,15000,0,15000,49067,0,64067
142217802200000,SE 216,Residential,20000,0,20000,84853,0,104853
142217802300000,SE 216,Residential,20000,0,20000,91329,0,111329
142217802400000,SE 216,Residential,20000,0,20000,91872,0,111872
142217802500000,SE 216,Residential,20475,0,20475,109778,0,130253
142217802600000,SE 216,Residential,20000,0,20000,84042,0,104042
142217802700000,SE 216,Residential,14000,0,14000,55459,0,69459
142217802800000,SE 216,Residential,14117,0,14117,89040,0,103157
142217802900000,SE 216,Residential,17395,0,17395,98573,0,115968
142217803000000,SE 216,Residential,16575,0,16575,61683,0,78258
142217900100000,SE 216,Residential,17000,0,17000,97455,0,114455
142217900200000,SE 216,Residential,17000,0,17000,77074,0,94074
142217900300000,SE 216,Residential,20000,0,20000,99793,0,119793
142217900400000,SE 216,Residential,20000,0,20000,120363,0,140363
142217900500000,SE 216,Residential,17500,0,17500,93512,0,111012
142217900600000,SE 216,Residential,17500,0,17500,82438,0,99938
142217900700000,SE 216,Residential,20000,0,20000,100241,0,120241
142217900800000,SE 216,Residential,22500,0,22500,112932,0,135432
142217900900000,SE 216,Residential,22500,0,22500,98396,0,120896
142217901000000,SE 216,Residential,20000,0,20000,95359,0,115359
142217901100000,SE 216,Residential,22100,0,22100,81656,0,103756
142217901200000,SE 216,Residential,19000,0,19000,82242,0,101242
142217901300000,SE 216,Residential,24000,0,24000,102573,0,126573
142217901400000,SE 216,Residential,7980,0,7980,85187,0,93167
142217901500000,SE 216,Residential,7980,0,7980,84850,0,92830
142217901600000,SE 216,Residential,14000,0,14000,92054,0,106054
142217901700000,SE 216,Residential,14000,0,14000,92490,0,106490
142217901800000,SE 216,Residential,20000,0,20000,92278,0,112278
142217901900000,SE 216,Residential,20000,0,20000,84608,0,104608
142217902000000,SE 216,Residential,20000,0,20000,99665,0,119665
142217902100000,SE 216,Residential,20000,0,20000,90507,0,110507
142217902200000,SE 216,Residential,20000,0,20000,86048,0,106048
142217902300000,SE 216,Residential,20000,0,20000,93652,0,113652
142217902400000,SE 216,Residential,20000,0,20000,53270,0,73270
142217902500000,SE 216,Residential,20000,0,20000,103398,0,123398
142217902600000,SE 216,Residential,20000,0,20000,50916,0,70916
142217902700000,SE 216,Residential,20000,0,20000,82451,0,102451
142217902800000,SE 216,Residential,19250,0,19250,66004,0,85254
142217902900000,SE 216,Residential,14000,0,14000,73708,0,87708
142217903000000,SE 216,Residential,14000,0,14000,74168,0,88168
142217903100000,SE 216,Residential,13300,0,13300,80965,0,94265
142217903200000,SE 216,Residential,15050,0,15050,83035,0,98085
142217903300000,SE 216,Residential,15958,0,15958,90845,0,106803
142218000100000,SE 216,Residential,13067,0,13067,91660,0,104727
142218000200000,SE 216,Residential,14000,0,14000,75369,0,89369
142218000300000,SE 216,Residential,20000,0,20000,81309,0,101309
142218000400000,SE 216,Residential,20000,0,20000,80858,0,100858
142218000500000,SE 216,Residential,20000,0,20000,72089,0,92089
142218000600000,SE 216,Residential,20000,0,20000,94174,0,114174
142218000700000,SE 216,Residential,20000,0,20000,101889,0,121889
142218000800000,SE 216,Residential,20000,0,20000,60526,0,80526
142218000900000,SE 216,Residential,20000,0,20000,82174,0,102174
142218001000000,SE 216,Residential,20000,0,20000,28864,0,48864
142218001100000,SE 216,Residential,21250,0,21250,106324,0,127574
142218001200000,SE 216,Residential,14000,0,14000,83763,0,97763
142218001300000,SE 216,Residential,14000,0,14000,0,0,14000
142218001400000,SE 216,Residential,8000,0,8000,0,0,8000
142218001500000,SE 216,Residential,13300,0,13300,83937,0,97237
142218001600000,SE 216,Residential,13300,0,13300,80412,0,93712
142218001700000,SE 216,Residential,13300,0,13300,73539,0,86839
142218001800000,SE 216,Residential,14000,0,14000,86252,0,100252
142218001900000,SE 216,Residential,14000,0,14000,86173,0,100173
142218002000000,SE 216,Residential,20000,0,20000,78610,0,98610
142218002100000,SE 216,Residential,20000,0,20000,65940,0,85940
142218002200000,SE 216,Residential,17500,0,17500,75674,0,93174
142218002300000,SE 216,Residential,17500,0,17500,73968,0,91468
142218002400000,SE 216,Residential,20000,0,20000,67947,0,87947
142218002500000,SE 216,Residential,20000,0,20000,74757,0,94757
142218002600000,SE 216,Residential,20000,0,20000,60691,0,80691
142218002700000,SE 216,Residential,20000,0,20000,72303,0,92303
142218002800000,SE 216,Residential,20000,0,20000,96026,0,116026
142218002900000,SE 216,Residential,16780,0,16780,89968,0,106748
142218003000000,SE 216,Residential,16210,0,16210,92776,0,108986
142218003100000,SE 216,Residential,16567,0,16567,84987,0,101554
142218003200000,SE 216,Residential,12425,0,12425,73898,0,86323
142218003300000,SE 216,Residential,12600,0,12600,72918,0,85518
142218003400000,SE 216,Residential,14000,0,14000,87786,0,101786
142218003500000,SE 216,Residential,13650,0,13650,68540,0,82190
142218100100000,SE 216,Residential,18000,0,18000,96834,0,114834
142218100200000,SE 216,Residential,18000,0,18000,101628,0,119628
142218100300000,SE 216,Residential,20000,0,20000,96166,0,116166
142218100400000,SE 216,Residential,20000,0,20000,86608,0,106608
142218100500000,SE 216,Residential,20000,0,20000,91380,0,111380
142218100600000,SE 216,Residential,20000,0,20000,78766,0,98766
142218100700000,SE 216,Residential,20000,0,20000,85564,0,105564
142218100800000,SE 216,Residential,20000,0,20000,79969,0,99969
142218100900000,SE 216,Residential,20000,0,20000,88693,0,108693
142218101000000,SE 216,Residential,20000,0,20000,67881,0,87881
142218101100000,SE 216,Residential,20000,0,20000,91086,0,111086
142218101200000,SE 216,Residential,20000,0,20000,98975,0,118975
142218101300000,SE 216,Residential,19865,0,19865,89338,0,109203
142218101400000,SE 216,Residential,13954,0,13954,63825,0,77779
142218101500000,SE 216,Residential,13580,0,13580,76420,0,90000
142218101600000,SE 216,Residential,7980,0,7980,84682,0,92662
142218101700000,SE 216,Residential,7980,0,7980,77596,0,85576
142218101800000,SE 216,Residential,7980,0,7980,84454,0,92434
142218101900000,SE 216,Residential,18000,0,18000,84669,0,102669
142218102000000,SE 216,Residential,18000,0,18000,75290,0,93290
142218102100000,SE 216,Residential,20000,0,20000,85587,0,105587
142218102200000,SE 216,Residential,20000,0,20000,93021,0,113021
142218102300000,SE 216,Residential,20000,0,20000,90730,0,110730
142218102400000,SE 216,Residential,20000,0,20000,90546,0,110546
142218102500000,SE 216,Residential,20000,0,20000,101893,0,121893
142218102600000,SE 216,Residential,20000,0,20000,80910,0,100910
142218102700000,SE 216,Residential,20000,0,20000,99798,0,119798
142218102800000,SE 216,Residential,20000,0,20000,101989,0,121989
142218102900000,SE 216,Residential,20000,0,20000,98996,0,118996
142218103000000,SE 216,Residential,20000,0,20000,102051,0,122051
142218103100000,SE 216,Residential,20000,0,20000,76265,0,96265
142218103200000,SE 216,Residential,14000,0,14000,89165,0,103165
142218103300000,SE 216,Residential,14000,0,14000,89713,0,103713
142218103400000,SE 216,Residential,13300,0,13300,80335,0,93635
142218103500000,SE 216,Residential,13300,0,13300,97054,0,110354
142218103600000,SE 216,Residential,13300,0,13300,96392,0,109692
142218200100000,SE 216,Residential,16338,0,16338,66692,0,83030
142218200200000,SE 216,Residential,18000,0,18000,76590,0,94590
142218200300000,SE 216,Residential,20000,0,20000,89636,0,109636
142218200400000,SE 216,Residential,20000,0,20000,73299,0,93299
142218200500000,SE 216,Residential,20000,0,20000,68406,0,88406
142218200600000,SE 216,Residential,20000,0,20000,83122,0,103122
142218200700000,SE 216,Residential,20000,0,20000,102230,0,122230
142218200800000,SE 216,Residential,20000,0,20000,86487,0,106487
142218200900000,SE 216,Residential,20000,0,20000,99292,0,119292
142218201000000,SE 216,Residential,20000,0,20000,84490,0,104490
142218201100000,SE 216,Residential,20900,0,20900,80728,0,101628
142218201200000,SE 216,Residential,20900,0,20900,96246,0,117146
142218201300000,SE 216,Residential,14200,0,14200,76536,0,90736
142218201400000,SE 216,Residential,14164,0,14164,103375,0,117539
142218201500000,SE 216,Residential,13650,0,13650,86445,0,100095
142218201600000,SE 216,Residential,13650,0,13650,83469,0,97119
142218201700000,SE 216,Residential,17220,0,17220,93058,0,110278
142218201800000,SE 216,Residential,16359,0,16359,85598,0,101957
142218201900000,SE 216,Residential,16974,0,16974,100658,0,117632
142218202000000,SE 216,Residential,20000,0,20000,99812,0,119812
142218202100000,SE 216,Residential,20000,0,20000,83502,0,103502
142218202200000,SE 216,Residential,19950,0,19950,89316,0,109266
142218202300000,SE 216,Residential,20000,0,20000,111573,0,131573
142218202400000,SE 216,Residential,20000,0,20000,93298,0,113298
142218202500000,SE 216,Residential,20900,0,20900,97272,0,118172
142218202600000,SE 216,Residential,20000,0,20000,87579,0,107579
142218202700000,SE 216,Residential,20000,0,20000,103432,0,123432
142218202800000,SE 216,Residential,20000,0,20000,96640,0,116640
142218202900000,SE 216,Residential,20000,0,20000,97883,0,117883
142218203000000,SE 216,Residential,18560,0,18560,91922,0,110482
142218203100000,SE 216,Residential,18061,0,18061,135488,0,153549
142218203200000,SE 216,Residential,14245,0,14245,57669,0,71914
142218203300000,SE 216,Residential,13825,0,13825,98869,0,112694
142218300100000,SE 216,Residential,14880,0,14880,84472,0,99352
142218300200000,CHURCH,Exempt,0,18144,18144,0,131243,149387
142218300300000,SE 216,Exempt,0,11340,11340,0,60791,72131
142218300400000,SE 216,Residential,25000,0,25000,76853,0,101853
142218300500000,SE 216,Residential,21250,0,21250,79987,0,101237
142218300600000,SE 216,Residential,21250,0,21250,69835,0,91085
142218300700000,SE 216,Residential,20000,0,20000,94158,0,114158
142218300800000,SE 216,Residential,20000,0,20000,93622,0,113622
142218300900000,SE 216,Residential,20000,0,20000,93501,0,113501
142218301000000,SE 216,Residential,20000,0,20000,78007,0,98007
142218301100000,SE 216,Residential,14000,0,14000,87488,0,101488
142218301200000,SE 216,Residential,14000,0,14000,91961,0,105961
142218301300000,SE 216,Residential,7980,0,7980,94906,0,102886
142218301400000,SE 216,Residential,7980,0,7980,96997,0,104977
142218301500000,SE 216,Residential,7980,0,7980,78995,0,86975
142218301600000,SE 216,Residential,7980,0,7980,84037,0,92017
142218301700000,SE 216,Residential,14000,0,14000,105944,0,119944
142218301800000,SE 216,Residential,14000,0,14000,75040,0,89040
142218301900000,SE 216,Residential,20000,0,20000,60641,0,80641
142218302000000,SE 216,Residential,20000,0,20000,111841,0,131841
142218302100000,SE 216,Residential,20000,0,20000,92190,0,112190
142218302200000,SE 216,Residential,20250,0,20250,96040,0,116290
142218302300000,SE 216,Residential,20000,0,20000,77579,0,97579
142218302400000,SE 216,Residential,17500,0,17500,66267,0,83767
142218302500000,SE 216,Residential,20000,0,20000,86177,0,106177
142218302600000,SE 216,Residential,21250,0,21250,101171,0,122421
142218302700000,SE 216,Residential,21250,0,21250,81943,0,103193
142218302800000,SE 216,Residential,22500,0,22500,93409,0,115909
142218302900000,SE 216,Residential,14000,0,14000,70985,0,84985
142218303000000,SE 216,Residential,14000,0,14000,97904,0,111904
142218303100000,SE 216,Residential,13300,0,13300,99011,0,112311
142218303200000,SE 216,Residential,13300,0,13300,88227,0,101527
142218303300000,SE 216,Residential,13300,0,13300,101106,0,114406
142218303400000,SE 216,Residential,15390,0,15390,84728,0,100118
142220100100000,APARTMENT,Commercial,0,24300,24300,0,146010,170310
142220100200000,NE 155,Residential,12750,0,12750,78279,0,91029
142220100300000,NE 155,Residential,12750,0,12750,46317,0,59067
142220100400000,NE 155,Residential,10200,0,10200,62006,0,72206
142220100500000,NE 155,Residential,10200,0,10200,66957,0,77157
142220100600000,NE 155,Residential,10200,0,10200,77729,0,87929
142220100700000,NE 155,Residential,10200,0,10200,67843,0,78043
142220100800000,NE 155,Residential,10200,0,10200,86219,0,96419
142220100900000,NE 155,Residential,13005,0,13005,73559,0,86564
142220101000000,NE 155,Residential,10200,0,10200,64552,0,74752
142220101100000,NE 155,Residential,5400,0,5400,73627,0,79027
142220101200000,NE 155,Residential,6885,0,6885,32859,0,39744
142220101300000,CONVERSION,Commercial,0,8100,8100,0,55442,63542
142220101400000,CONVERSION,Commercial,0,8100,8100,0,65303,73403
142220101500000,OFFICE; MEDICAL,Commercial,0,186030,186030,0,684430,870460
142220101600000,OFFICE; MEDICAL,Commercial,0,278100,278100,0,1484367,1762467
142220200100000,NE 155,Residential,12500,0,12500,83964,0,96464
142220200200000,NE 155,Residential,12500,0,12500,80283,0,92783
142220200300000,NE 155,Residential,12500,0,12500,63658,0,76158
142220200400000,NE 155,Residential,10000,0,10000,80653,0,90653
142220200500000,NE 155,Residential,5250,0,5250,50017,0,55267
142220200600000,NE 155,Residential,5250,0,5250,40459,0,45709
142220200700000,NE 155,Residential,5425,0,5425,55609,0,61034
142220200800000,NE 155,Residential,5425,0,5425,64634,0,70059
142220200900000,NE 155,Residential,12500,0,12500,91626,0,104126
142220300100000,NE 156,Residential,6569,0,6569,65169,0,71738
142220300200000,NE 156,Residential,7483,0,7483,54100,0,61583
142220300300000,NE 156,Residential,7483,0,7483,51141,0,58624
142220300400000,NE 156,Residential,6844,0,6844,55899,0,62743
142220300500000,NE 156,Residential,6844,0,6844,53323,0,60167
142220300600000,NE 156,Residential,2903,0,2903,30908,0,33811
142220300700000,NE 156,Residential,5160,0,5160,48779,0,53939
142220300800000,NE 156,Residential,6767,0,6767,71610,0,78377
142220300900000,NE 156,Residential,10305,0,10305,13736,0,24041
142220301000000,NE 156,Residential,8606,0,8606,84380,0,92986
142220301100000,CONVERSION,Commercial,0,12150,12150,0,41350,53500
142220301200000,NE 156,Residential,12750,0,12750,47179,0,59929
142220301300000,NE 156,Residential,12750,0,12750,53794,0,66544
142220301400000,CONVERSION,Commercial,0,12150,12150,0,66010,78160
142220301500000,NE 156,Residential,12750,0,12750,84373,0,97123
142220301600000,NE 156,Residential,12750,0,12750,74259,0,87009
142220301700000,NE 156,Residential,12750,0,12750,62937,0,75687
142220302000000,NE 156,Residential,10200,0,10200,92934,0,103134
142220302100000,NE 156,Residential,12750,0,12750,94222,0,106972
142220302200000,NE 156,Residential,12750,0,12750,67893,0,80643
142220302300000,NE 156,Residential,12750,0,12750,67636,0,80386
142220302400000,NE 156,Residential,12750,0,12750,83762,0,96512
142220302500000,NE 156,Residential,12750,0,12750,86681,0,99431
142220302600000,CONVERSION,Commercial,0,12150,12150,0,80984,93134
142220302700000,NE 156,Residential,9461,0,9461,49634,0,59095
142220302800000,NE 156,Residential,9461,0,9461,53747,0,63208
142220302900000,NE 156,Residential,6210,0,6210,55306,0,61516
142220303100000,NE 156,Residential,13200,0,13200,103965,0,117165
142220303200000,LAUNDROMAT/CLEANERS,Commercial,0,33968,33968,0,199427,233395
142220400100000,NE 156,Residential,13000,0,13000,60804,0,73804
142220400200000,NE 156,Residential,12350,0,12350,65151,0,77501
142220400300000,CONVERSION,Commercial,0,11794,11794,0,67120,78914
142220400400000,CONVERSION,Commercial,0,11794,11794,0,55022,66816
142220400500000,NE 156,Residential,12587,0,12587,57260,0,69847
142220400600000,NE 156,Residential,12587,0,12587,58357,0,70944
142220400700000,NE 156,Residential,12587,0,12587,67742,0,80329
142220400800000,NE 156,Residential,11329,0,11329,51552,0,62881
142220400900000,NE 156,Residential,5094,0,5094,49707,0,54801
142220401000000,NE 156,Residential,4275,0,4275,46371,0,50646
142220401100000,NE 156,Residential,5700,0,5700,68716,0,74416
142220401200000,NE 156,Residential,8811,0,8811,74246,0,83057
142220401300000,NE 156,Residential,12587,0,12587,58311,0,70898
142220401400000,NE 156,Residential,12587,0,12587,79133,0,91720
142220401500000,NE 156,Residential,12587,0,12587,106387,0,118974
142220500100000,CITY PROPERTY,Exempt,0,0,0,0,0,0
142220500200000,NE 156,Residential,4113,0,4113,63590,0,67703
142220500300000,NE 156,Residential,4113,0,4113,60113,0,64226
142220500400000,NE 156,Residential,12350,0,12350,81250,0,93600
142220600100000,SE 231,Residential,6013,0,6013,47639,0,53652
142220600200000,SE 231,Residential,3263,0,3263,45620,0,48883
142220600300000,SE 231,Residential,8400,0,8400,35166,0,43566
142220600400000,SE 231,Residential,11460,0,11460,60889,0,72349
142220600500000,APARTMENT,Commercial,0,9072,9072,0,73965,83037
142220600600000,SE 231,Residential,27216,0,27216,65806,0,93022
142220600700000,SE 231,Residential,9000,0,9000,35590,0,44590
142220600801000,OFFICE,Commercial,0,58800,58800,0,253631,312431
142220600801001,OFFICE,Commercial,0,58800,58800,0,251898,310698
142220600900000,OFFICE; MEDICAL,Commercial,0,127008,127008,0,173384,300392
142220601000000,CONVERSION,Commercial,0,4536,4536,0,57868,62404
142220601100000,SE 231,Residential,7000,0,7000,73270,0,80270
142220601200000,SE 231,Residential,10000,0,10000,90831,0,100831
142220601300000,SE 231,Residential,10000,0,10000,75758,0,85758
142220601400000,SE 231,Residential,7500,0,7500,56819,0,64319
142220601500000,SE 231,Residential,7500,0,7500,80935,0,88435
142220601600000,SE 231,Residential,10000,0,10000,39844,0,49844
142220601700000,SE 231,Residential,10000,0,10000,67137,0,77137
142220601800000,SE 231,Residential,10000,0,10000,70860,0,80860
142220601900000,SE 231,Residential,10000,0,10000,79936,0,89936
142220602000000,SE 231,Residential,10000,0,10000,87297,0,97297
142220602100000,SE 231,Residential,12500,0,12500,54365,0,66865
142220700100000,OFFICE; MEDICAL,Commercial,0,545940,545940,0,2531717,3077657
142220700200000,APARTMENT,Commercial,0,12150,12150,0,76308,88458
142220700300000,NE 156,Residential,12750,0,12750,60550,0,73300
142220700400000,NE 156,Residential,4650,0,4650,60590,0,65240
142220700500000,NE 156,Residential,4650,0,4650,55044,0,59694
142220700600000,NE 156,Residential,6200,0,6200,67518,0,73718
142220700700000,NE 156,Residential,8140,0,8140,79344,0,87484
142220700800000,CONVERSION,Commercial,0,6480,6480,0,46932,53412
142220700900000,VACANT LAND,Commercial,0,6966,6966,0,0,6966
142220701000000,CONVERSION,Commercial,0,6480,6480,0,49878,56358
142220701100000,SMALL RETAIL,Commercial,0,69120,69120,0,57571,126691
142220701200000,RESTAURANT,Commercial,0,97200,97200,0,104945,202145
142220701300000,FLAT PARKING,Commercial,0,51840,51840,0,11280,63120
142220701400000,OFFICE,Commercial,0,48600,48600,0,140172,188772
142220800100000,NE 156,Residential,6200,0,6200,46864,0,53064
142220800200000,NE 156,Residential,7501,0,7501,42499,0,50000
142220800300000,NE 156,Residential,11000,0,11000,72420,0,83420
142220800400000,CONVERSION,Commercial,0,14580,14580,0,48296,62876
142220800500000,NE 156,Residential,13770,0,13770,71592,0,85362
142220800600000,NE 156,Residential,12750,0,12750,56066,0,68816
142220800700000,NE 156,Residential,12750,0,12750,86909,0,99659
142220800800000,NE 156,Residential,12500,0,12500,78309,0,90809
142220800900000,NE 156,Residential,12750,0,12750,91830,0,104580
142220801000000,NE 156,Residential,10000,0,10000,87717,0,97717
142220801100000,NE 156,Residential,10000,0,10000,71580,0,81580
142220801200000,CONVERSION,Commercial,0,9072,9072,0,19012,28084
142220801300000,NE 156,Residential,10000,0,10000,80235,0,90235
142220801400000,NE 156,Residential,10000,0,10000,51051,0,61051
142220801500000,NE 156,Residential,9849,0,9849,70151,0,80000
142220801600000,NE 156,Residential,8925,0,8925,46759,0,55684
142220801700000,CONVERSION,Commercial,0,10935,10935,0,46901,57836
142220801800000,NE 156,Residential,6600,0,6600,53589,0,60189
142220801900000,NE 156,Exempt,0,6600,6600,0,74386,80986
142220802000000,NE 156,Residential,6200,0,6200,78126,0,84326
142220900200000,SE 231,Residential,10000,0,10000,51595,0,61595
142220900300000,SE 231,Residential,10000,0,10000,57557,0,67557
142220900400000,SE 231,Residential,11220,0,11220,54552,0,65772
142220900500000,SE 231,Residential,6200,0,6200,52248,0,58448
142220900600000,SE 231,Residential,8680,0,8680,61095,0,69775
142220900700000,APARTMENT,Commercial,0,6804,6804,0,96864,103668
142221000100000,CONVERSION,Commercial,0,15552,15552,0,95546,111098
142221000200000,SE 231,Residential,6600,0,6600,54817,0,61417
142221000300000,SE 231,Residential,7500,0,7500,48743,0,56243
142221100100000,CONVERSION,Commercial,0,13608,13608,0,70809,84417
142221100200000,CONVENIENCE STORE,Commercial,0,90720,90720,0,226252,316972
142221100300000,FLAT PARKING,Commercial,0,36288,36288,0,12348,48636
142221100400000,SMALL RETAIL,Commercial,0,36288,36288,0,104123,140411
142221100500000,FAST FOOD,Commercial,0,127008,127008,0,218382,345390
142221100600000,CONVERSION,Commercial,0,3402,3402,0,67025,70427
142221100700000,VACANT LAND,Commercial,0,36288,36288,0,0,36288
142221100800000,SE 231,Residential,12750,0,12750,103686,0,116436
142221100900000,CONVERSION,Commercial,0,13608,13608,0,67988,81596
142221101000000,CONVERSION,Commercial,0,13608,13608,0,80669,94277
142221200100000,SE 231,Residential,1500,0,1500,0,0,1500
142221200200000,SE 231,Residential,2778,0,2778,0,0,2778
142221200300000,SMALL RETAIL,Commercial,0,23311,23311,0,48798,72109
142221200400000,SE 231,Residential,11349,0,11349,48288,0,59637
142221200500000,SMALL RETAIL,Commercial,0,40990,40990,0,133512,174502
142221200600000,SMALL RETAIL,Commercial,0,31752,31752,0,103804,135556
142221200700000,SMALL RETAIL,Commercial,0,31752,31752,0,96994,128746
142221200800000,SMALL RETAIL,Commercial,0,21168,21168,0,65303,86471
142221300100000,GROCERY STORE,Commercial,0,613656,613656,0,1158544,1772200
142221300500000,FLAT PARKING,Commercial,0,55728,55728,0,5175,60903
142221300600000,FAST FOOD,Commercial,0,388800,388800,0,608425,997225
142221300700000,FLAT PARKING,Commercial,0,32400,32400,0,10000,42400
142221300800000,FLAT PARKING,Commercial,0,32400,32400,0,3000,35400
142221300900000,CONVERSION,Commercial,0,7290,7290,0,73712,81002
142221301000000,SMALL RETAIL,Commercial,0,8100,8100,0,83693,91793
142221301100000,CITY PROPERTY,Exempt,0,0,0,0,0,0
142221301200000,SMALL RETAIL,Commercial,0,97200,97200,0,245514,342714
142221301300000,SMALL RETAIL,Commercial,0,22680,22680,0,61689,84369
142221301400000,SMALL RETAIL,Commercial,0,22680,22680,0,64958,87638
142221301500000,SMALL RETAIL,Commercial,0,45360,45360,0,115925,161285
142222600100000,NE 156,Residential,5425,0,5425,73572,0,78997
142222600200000,NE 156,Residential,5425,0,5425,67886,0,73311
142222600300000,NE 156,Residential,4650,0,4650,65583,0,70233
142222600400000,NE 156,Residential,12500,0,12500,79491,0,91991
142222600500000,NE 156,Residential,10000,0,10000,75691,0,85691
142222600600000,NE 156,Residential,10000,0,10000,75657,0,85657
142222600700000,NE 156,Residential,7500,0,7500,75763,0,83263
142222600800000,NE 156,Residential,7500,0,7500,74168,0,81668
142222600900000,NE 156,Residential,7500,0,7500,76363,0,83863
142222601000000,NE 156,Residential,7500,0,7500,67458,0,74958
142222601100000,NE 156,Residential,7500,0,7500,62157,0,69657
142222601200000,NE 156,Residential,7500,0,7500,47699,0,55199
142222601300000,NE 156,Residential,10000,0,10000,64239,0,74239
142222601400000,NE 156,Residential,7000,0,7000,54934,0,61934
142222601500000,NE 156,Residential,7000,0,7000,69608,0,76608
142222601600000,NE 156,Residential,6650,0,6650,59707,0,66357
142222601700000,NE 156,Residential,6650,0,6650,62999,0,69649
142222601800000,NE 156,Residential,7000,0,7000,72041,0,79041
142222601900000,CONVERSION,Commercial,0,12960,12960,0,49062,62022
142222602000000,NE 156,Residential,12500,0,12500,29622,0,42122
142222602100000,NE 156,Residential,8500,0,8500,77030,0,85530
142222602200000,NE 156,Residential,6500,0,6500,73374,0,79874
142222602300000,NE 156,Residential,7500,0,7500,66859,0,74359
142222602400000,NE 156,Residential,8750,0,8750,87241,0,95991
142222602500000,NE 156,Residential,8750,0,8750,59148,0,67898
142222602600000,NE 156,Residential,10000,0,10000,53214,0,63214
142222602700000,NE 156,Residential,10000,0,10000,75398,0,85398
142222602800000,NE 156,Residential,7500,0,7500,80693,0,88193
142222602900000,NE 156,Residential,7500,0,7500,58358,0,65858
142222603000000,NE 156,Residential,7500,0,7500,60245,0,67745
142222603100000,NE 156,Residential,7500,0,7500,52506,0,60006
142222603200000,NE 156,Residential,7500,0,7500,60284,0,67784
142222603300000,NE 156,Residential,7500,0,7500,64858,0,72358
142222700100000,NE 156,Residential,7500,0,7500,69817,0,77317
142222700200000,NE 156,Residential,7500,0,7500,57329,0,64829
142222700300000,NE 156,Residential,7500,0,7500,48576,0,56076
142222700400000,NE 156,Residential,5283,0,5283,58630,0,63913
142222700500000,NE 156,Residential,8517,0,8517,54442,0,62959
142222700600000,NE 156,Residential,4805,0,4805,52450,0,57255
142222800100000,EDUCATIONAL/COLLEGE,Exempt,0,443988,443988,0,393386,837374
142222900100000,NE 156,Residential,12000,0,12000,64139,0,76139
142223000100000,NE 156,Residential,7350,0,7350,43577,0,50927
142223000200000,NE 156,Residential,9500,0,9500,83418,0,92918
142223000300000,NE 156,Residential,10000,0,10000,85383,0,95383
142223000400000,NE 156,Residential,8625,0,8625,60314,0,68939
142223000500000,NE 156,Residential,8563,0,8563,63489,0,72052
142223000600000,SCHOOL,Exempt,0,0,0,0,0,0
142223000700000,SCHOOL,Exempt,0,0,0,0,0,0
142223000800000,CITY PROPERTY,Exempt,0,0,0,0,0,0
142223000900000,SCHOOL,Exempt,0,0,0,0,0,0
142223001000000,NE 156,Residential,7500,0,7500,56134,0,63634
142223001100000,NE 156,Residential,10000,0,10000,90924,0,100924
142223001200000,NE 156,Residential,12750,0,12750,123343,0,136093
142223100100000,NE 156,Residential,13077,0,13077,73527,0,86604
142223100200000,NE 156,Residential,12750,0,12750,79189,0,91939
142223100300000,NE 156,Residential,12750,0,12750,68651,0,81401
142223100400000,NE 156,Residential,12750,0,12750,63867,0,76617
142223100500000,NE 156,Residential,9307,0,9307,58456,0,67763
142223100600000,NE 156,Residential,5115,0,5115,73723,0,78838
142223100700000,NE 156,Residential,5038,0,5038,78734,0,83772
142223100800000,NE 156,Residential,6125,0,6125,69940,0,76065
142223100900000,NE 156,Residential,6125,0,6125,71630,0,77755
142223101000000,NE 156,Residential,9800,0,9800,58671,0,68471
142223101100000,NE 156,Residential,9609,0,9609,89191,0,98800
142223101200000,NE 156,Residential,10000,0,10000,68823,0,78823
142223200100000,APARTMENT,Exempt,0,9720,9720,0,84037,93757
142223200200000,NE 156,Exempt,0,6200,6200,0,74157,80357
142223200300000,VACANT LAND,Exempt,0,13608,13608,0,0,13608
142223200400000,NE 156,Exempt,0,36288,36288,0,104778,141066
142223200500000,NE 156,Exempt,0,7500,7500,0,68548,76048
142223200600000,NE 156,Exempt,0,7500,7500,0,52430,59930
142223200700000,NE 156,Residential,7500,0,7500,61174,0,68674
142223200800000,NE 156,Exempt,0,7500,7500,0,54675,62175
142223200900000,VACANT LAND,Exempt,0,18144,18144,0,0,18144
142223201000000,NE 156,Residential,7500,0,7500,62725,0,70225
142223201100000,VACANT LAND,Exempt,0,18144,18144,0,0,18144
142223201200000,VACANT LAND,Exempt,0,18144,18144,0,0,18144
142223201300000,VACANT LAND,Exempt,0,17626,17626,0,0,17626
142223201400000,VACANT LAND,Exempt,0,11146,11146,0,0,11146
142223201500000,VACANT LAND,Exempt,0,4536,4536,0,0,4536
142223201600000,VACANT LAND,Exempt,0,8294,8294,0,0,8294
142223201700000,NE 156,Residential,9025,0,9025,59739,0,68764
142223201800000,CONVERSION,Commercial,0,13608,13608,0,65619,79227
142223201900000,NE 156,Residential,15000,0,15000,95700,0,110700
142223202000000,NE 156,Residential,10000,0,10000,95012,0,105012
142223202100000,VACANT LAND,Exempt,0,18144,18144,0,0,18144
142223202200000,CITY PROPERTY,Exempt,0,0,0,0,0,0
142223202300000,CITY PROPERTY,Exempt,0,0,0,0,0,0
142223202400000,VACANT LAND,Exempt,0,6804,6804,0,0,6804
142223202500000,NE 156,Residential,7500,0,7500,81908,0,89408
142223202600000,VACANT LAND,Exempt,0,7350,7350,0,0,7350
142223202700000,VACANT LAND,Exempt,0,7350,7350,0,0,7350
142223300100000,VACANT LAND,Exempt,0,9126,9126,0,0,9126
142223300200000,VACANT LAND,Exempt,0,6845,6845,0,0,6845
142223300300000,EDUCATIONAL/COLLEGE,Exempt,0,19440,19440,0,0,19440
142223300400000,VACANT LAND,Exempt,0,26163,26163,0,0,26163
142223400100000,VACANT LAND,Exempt,0,6804,6804,0,0,6804
142223400200000,VACANT LAND,Exempt,0,6804,6804,0,0,6804
142223400300000,VACANT LAND,Exempt,0,5163,5163,0,0,5163
142223400400000,VACANT LAND,Exempt,0,12096,12096,0,0,12096
142223400500000,NE 156,Residential,6650,0,6650,66411,0,73061
142223400600000,SMALL RETAIL,Commercial,0,9072,9072,0,34416,43488
142223400700000,VACANT LAND,Exempt,0,6700,6700,0,0,6700
142223400800000,NE 156,Residential,10000,0,10000,62207,0,72207
142223400900000,VACANT LAND,Exempt,0,18144,18144,0,0,18144
142223401000000,VACANT LAND,Exempt,0,24192,24192,0,0,24192
142223401100000,NE 156,Residential,10000,0,10000,88278,0,98278
142223401200000,VACANT LAND,Exempt,0,9800,9800,0,0,9800
142223401300000,VACANT LAND,Exempt,0,86022,86022,0,0,86022
142223401600000,NE 156,Residential,7363,0,7363,74257,0,81620
142223402000000,VACANT LAND,Exempt,0,72576,72576,0,0,72576
142223402100000,NE 156,Residential,12750,0,12750,87040,0,99790
142223402200000,NE 156,Residential,12750,0,12750,84595,0,97345
142223402300000,CONVERSION,Commercial,0,13608,13608,0,52041,65649
142223402400000,VACANT LAND,Exempt,0,9800,9800,0,0,9800
142223402500000,VACANT LAND,Exempt,0,9526,9526,0,0,9526
142223402600000,VACANT LAND,Exempt,0,22982,22982,0,0,22982
142223402700000,NE 156,Residential,5250,0,5250,56455,0,61705
142223500100000,NE 156,Residential,10000,0,10000,55610,0,65610
142225100100000,CONVENIENCE STORE,Commercial,0,314496,314496,0,377898,692394
142225100200000,VACANT LAND,Exempt,0,72576,72576,0,3294,75870
142225100400000,VACANT LAND,Exempt,0,36288,36288,0,0,36288
142225101000000,OFFICE; MEDICAL,Commercial,0,16848,16848,0,112591,129439
142225101100000,SMALL RETAIL,Commercial,0,38880,38880,0,43318,82198
142225101200000,CONVERSION,Commercial,0,13608,13608,0,100458,114066
142225101400000,OFFICE,Commercial,0,183859,183859,0,512184,696043
142225101600000,FLAT PARKING,Commercial,0,36288,36288,0,12400,48688
142225101700000,EDUCATIONAL/COLLEGE,Exempt,0,72576,72576,0,0,72576
142225300100000,APARTMENT,Exempt,0,1191510,1191510,0,3847054,5038564
142225300200000,HOTEL,Exempt,0,290304,290304,0,1014392,1304696
142225300300000,APARTMENT,Exempt,0,266112,266112,0,1194091,1460203
142225300400000,FLAT PARKING,Exempt,0,181440,181440,0,15120,196560
142225300500000,FLAT PARKING,Commercial,0,48384,48384,0,5808,54192
142225300600000,FAST FOOD,Commercial,0,169344,169344,0,355820,525164
142225300700000,OFFICE,Commercial,0,108864,108864,0,165341,274205
142225301000000,SMALL RETAIL,Commercial,0,72576,72576,0,169179,241755
142225301100000,FLAT PARKING,Commercial,0,36288,36288,0,2700,38988
142225400100000,FAST FOOD,Commercial,0,145152,145152,0,460160,605312
142225400200000,RESTAURANT,Commercial,0,81907,81907,0,99755,181662
142225400300000,OFFICE,Commercial,0,31622,31622,0,182491,214113
142225400400000,APARTMENT,Commercial,0,31752,31752,0,1168248,1200000
142225500100000,CONVERSION,Commercial,0,8165,8165,0,73440,81605
142225500200000,OFFICE; MEDICAL,Commercial,0,14515,14515,0,133177,147692
142225500300000,RESTAURANT,Commercial,0,217728,217728,0,497302,715030
142225500400000,RESTAURANT,Commercial,0,108864,108864,0,215165,324029
142225500500000,CARWASH,Commercial,0,108864,108864,0,102299,211163
142225500502000,BILLBOARD(BLL),Commercial,0,0,0,0,33280,33280
142225500600000,AUTO REPAIR/SALES,Commercial,0,181440,181440,0,80210,261650
142225500700000,OFFICE; MEDICAL,Commercial,0,90720,90720,0,331297,422017
142225500800000,OFFICE,Commercial,0,90720,90720,0,323570,414290
142225500900000,OFFICE,Exempt,0,90720,90720,0,344041,434761
142225600100000,APARTMENT,Commercial,0,14288,14288,0,298843,313131
142225600200000,APARTMENT,Commercial,0,12928,12928,0,190853,203781
142225601200000,CONVERSION,Commercial,0,9072,9072,0,51939,61011
142225601300000,CONVERSION,Commercial,0,12474,12474,0,68683,81157
142225601400000,CONVERSION,Commercial,0,11340,11340,0,58419,69759
142225601500000,SE 232,Exempt,0,12500,12500,0,49209,61709
142225601600000,CHURCH,Exempt,0,24192,24192,0,5170,29362
142225601800000,CHURCH,Exempt,0,370980,370980,0,3198234,3569214
142225601900000,VACANT LAND,Commercial,0,12442,12442,0,4463,16905
142225700100000,OFFICE; MEDICAL,Commercial,0,136080,136080,0,908122,1044202
142225700200000,SMALL RETAIL,Commercial,0,90720,90720,0,108750,199470
142225700202000,BILLBOARD(BLL),Commercial,0,0,0,0,33803,33803
142225700300000,APARTMENT,Commercial,0,27216,27216,0,543523,570739
142225700400000,FLAT PARKING,Commercial,0,60480,60480,0,5600,66080
142225700500000,OFFICE,Commercial,0,120960,120960,0,97066,218026
142225700600000,SMALL RETAIL,Commercial,0,72576,72576,0,254216,326792
142225700700000,SMALL RETAIL,Commercial,0,52690,52690,0,230368,283058
142225700800000,OFFICE,Commercial,0,44078,44078,0,149231,193309
142225700900000,OFFICE,Commercial,0,36288,36288,0,93894,130182
142225701000000,SMALL RETAIL,Commercial,0,60480,60480,0,94448,154928
142225701100000,SE 231,Residential,18600,0,18600,143536,0,162136
142225701200000,FLAT PARKING,Commercial,0,36288,36288,0,11256,47544
142225800100000,FLAT PARKING,Commercial,0,108864,108864,0,8700,117564
142227600100000,CONVERSION,Commercial,0,13608,13608,0,205713,219321
142227600200000,SE 231,Residential,10000,0,10000,71476,0,81476
142227600300000,SE 231,Residential,10000,0,10000,73241,0,83241
142227600400000,SE 231,Residential,10000,0,10000,55973,0,65973
142227600500000,SE 231,Residential,7905,0,7905,54352,0,62257
142227600600000,SE 231,Residential,6975,0,6975,57501,0,64476
142227600700000,SE 231,Residential,5425,0,5425,53648,0,59073
142227600800000,CONVERSION,Commercial,0,18144,18144,0,78479,96623
142227600900000,SE 231,Residential,18000,0,18000,103326,0,121326
142227700100000,OFFICE,Commercial,0,36288,36288,0,150892,187180
142227700200000,CONVERSION,Exempt,0,36288,36288,0,141171,177459
142227700300000,CONVERSION,Commercial,0,13608,13608,0,81839,95447
142227700400000,SMALL RETAIL,Commercial,0,21168,21168,0,65303,86471
142227700500000,SMALL RETAIL,Commercial,0,84672,84672,0,81721,166393
142227700600000,VACANT LAND,Commercial,0,22000,22000,0,0,22000
142227700700000,SMALL RETAIL,Commercial,0,36832,36832,0,72707,109539
142227700800000,SMALL RETAIL,Commercial,0,31752,31752,0,98662,130414
142227700900000,OFFICE,Commercial,0,31752,31752,0,76612,108364
142227701000000,SMALL RETAIL,Commercial,0,90720,90720,0,282745,373465
142227701100000,OFFICE,Commercial,0,166579,166579,0,497924,664503
142227800100000,CITY PROPERTY,Exempt,0,0,0,0,0,0
142227900100000,SE 231,Residential,10200,0,10200,64917,0,75117
142227900200000,SE 231,Residential,8099,0,8099,52285,0,60384
142227900300000,SE 231,Exempt,0,5425,5425,0,68766,74191
142227900400000,SE 231,Residential,5425,0,5425,45285,0,50710
142227900500000,SE 231,Residential,5503,0,5503,64798,0,70301
142227900600000,SE 231,Residential,5425,0,5425,70116,0,75541
142227900700000,SE 231,Residential,7500,0,7500,0,0,7500
142227900800000,SE 231,Residential,7500,0,7500,42699,0,50199
142227900900000,SE 231,Residential,12483,0,12483,52517,0,65000
142227901000000,SE 231,Residential,12750,0,12750,27617,0,40367
142227901100000,SE 231,Residential,12750,0,12750,82344,0,95094
142227901200000,CONVERSION,Commercial,0,6804,6804,0,45336,52140
142227901300000,SE 231,Residential,7500,0,7500,44710,0,52210
142227901400000,CONVERSION,Commercial,0,13608,13608,0,80281,93889
142227901500000,CONVERSION,Commercial,0,13608,13608,0,73645,87253
142227901600000,SE 231,Residential,7657,0,7657,74563,0,82220
142227901700000,SE 231,Residential,12300,0,12300,58237,0,70537
142227901800000,CONVERSION,Commercial,0,13608,13608,0,62566,76174
142227901900000,SE 231,Residential,7500,0,7500,63744,0,71244
142227902000000,SE 231,Residential,7500,0,7500,58242,0,65742
142227902100000,SE 231,Residential,12750,0,12750,65627,0,78377
142227902200000,SE 231,Residential,12750,0,12750,93731,0,106481
142227902300000,CONVERSION,Commercial,0,13608,13608,0,76438,90046
142227902400000,SE 231,Residential,12750,0,12750,47974,0,60724
142228000100000,OFFICE; MEDICAL,Commercial,0,72576,72576,0,268373,340949
142228000200000,SMALL RETAIL,Commercial,0,3686,3686,0,31403,35089
142228000300000,CONVERSION,Commercial,0,3686,3686,0,34249,37935
142228000400000,SMALL RETAIL,Commercial,0,30240,30240,0,94457,124697
142228000500000,SMALL RETAIL,Commercial,0,18900,18900,0,57736,76636
142228000600000,CONVERSION,Commercial,0,7938,7938,0,55639,63577
142228000700000,RESTAURANT,Commercial,0,96768,96768,0,90714,187482
142228000800000,FLAT PARKING,Commercial,0,72576,72576,0,19680,92256
142228000900000,FLAT PARKING,Commercial,0,22680,22680,0,8400,31080
142228001000000,FLAT PARKING,Commercial,0,13608,13608,0,4800,18408
142228001100000,CONVERSION,Exempt,0,36288,36288,0,94332,130620
142228100100000,SE 231,Residential,5250,0,5250,85238,0,90488
142228100200000,SE 231,Residential,5250,0,5250,73028,0,78278
142228100300000,SE 231,Residential,10000,0,10000,82865,0,92865
142228100400000,SE 231,Residential,9821,0,9821,38807,0,48628
142228100500000,SE 231,Residential,9967,0,9967,44374,0,54341
142228100600000,SE 231,Residential,12750,0,12750,70980,0,83730
142228100700000,SE 231,Residential,11250,0,11250,83578,0,94828
142228100800000,SE 231,Residential,11250,0,11250,65168,0,76418
142228100900000,SE 231,Residential,12500,0,12500,79913,0,92413
142228101000000,SE 231,Residential,10000,0,10000,71120,0,81120
142228101100000,SE 231,Residential,10151,0,10151,61934,0,72085
142228101200000,SE 231,Residential,9440,0,9440,85486,0,94926
142228101300000,CONVERSION,Commercial,0,4253,4253,0,53123,57376
142228101400000,CONVERSION,Commercial,0,6736,6736,0,64343,71079
142228101500000,SE 231,Residential,11400,0,11400,73552,0,84952
142228101600000,SE 231,Residential,14227,0,14227,60773,0,75000
142228101700000,SE 231,Residential,5700,0,5700,61350,0,67050
142228101800000,SE 231,Residential,7700,0,7700,36342,0,44042
142228101900000,SE 231,Residential,12350,0,12350,79856,0,92206
142228102000000,APARTMENT,Commercial,0,13608,13608,0,94893,108501
142228102100000,SE 231,Residential,10000,0,10000,75337,0,85337
142228102200000,SE 231,Residential,10000,0,10000,66198,0,76198
142228102300000,SE 231,Residential,10000,0,10000,66499,0,76499
142228102400000,SE 231,Residential,7500,0,7500,61961,0,69461
142228102500000,SE 231,Residential,7500,0,7500,61625,0,69125
142228102600000,SE 231,Residential,7500,0,7500,44090,0,51590
142228102700000,SE 231,Residential,7500,0,7500,39997,0,47497
142228102800000,CONVERSION,Commercial,0,13608,13608,0,102268,115876
142228102900000,SE 231,Residential,4928,0,4928,66141,0,71069
142228103000000,SE 231,Residential,6023,0,6023,68339,0,74362
142228103100000,SE 231,Residential,5115,0,5115,58838,0,63953
142228103200000,SE 231,Residential,5115,0,5115,57149,0,62264
142228103300000,SE 231,Residential,5270,0,5270,65075,0,70345
142228103400000,SE 231,Residential,5580,0,5580,50732,0,56312
142228200100000,CITY PROPERTY,Exempt,0,0,0,0,0,0
142228300100000,SE 231,Residential,5250,0,5250,44427,0,49677
142228300200000,SE 231,Residential,5425,0,5425,45798,0,51223
142228300300000,SE 231,Residential,5425,0,5425,24193,0,29618
142228300400000,APARTMENT,Commercial,0,6350,6350,0,41261,47611
142228300500000,CONVERSION,Commercial,0,9526,9526,0,70562,80088
142228300600000,CONVERSION,Commercial,0,11340,11340,0,59585,70925
142228300700000,SE 231,Residential,7500,0,7500,38010,0,45510
142228300800000,SE 231,Residential,7500,0,7500,62182,0,69682
142228300900000,CONVERSION,Commercial,0,13608,13608,0,48711,62319
142228301000000,CONVERSION,Commercial,0,9072,9072,0,42975,52047
142228301100000,FLAT PARKING,Exempt,0,48384,48384,0,14440,62824
142228301200000,CONVERSION,Commercial,0,13608,13608,0,46735,60343
142228301300000,SE 231,Residential,12750,0,12750,109535,0,122285
142228301400000,FLAT PARKING,Exempt,0,72576,72576,0,14640,87216
142228301500000,FLAT PARKING,Exempt,0,36288,36288,0,9243,45531
142228301600000,CONVERSION,Commercial,0,9072,9072,0,63974,73046
142228301700000,SE 231,Residential,10000,0,10000,0,0,10000
142228301800000,SE 231,Residential,10000,0,10000,41255,0,51255
142228301900000,SE 231,Residential,7500,0,7500,46952,0,54452
142228302000000,SE 231,Residential,7890,0,7890,58634,0,66524
142228302100000,SE 231,Residential,14880,0,14880,73179,0,88059
142228302200000,SE 231,Residential,5250,0,5250,57443,0,62693
142228400100000,SE 231,Residential,9675,0,9675,38125,0,47800
142228400200000,SE 231,Residential,8225,0,8225,35307,0,43532
142228400300000,SE 231,Residential,7500,0,7500,46221,0,53721
142228400400000,SE 231,Residential,7000,0,7000,45161,0,52161
142228400500000,SE 231,Residential,10500,0,10500,45353,0,55853
142228400600000,SE 231,Residential,12750,0,12750,82565,0,95315
142228400700000,SE 231,Residential,10000,0,10000,72456,0,82456
142228400800000,SE 231,Residential,10000,0,10000,65182,0,75182
142228400900000,SE 231,Residential,10000,0,10000,42496,0,52496
142228401000000,SE 231,Residential,10000,0,10000,62282,0,72282
142228401100000,SE 231,Residential,10000,0,10000,48772,0,58772
142228401200000,CONVERSION,Commercial,0,9072,9072,0,68018,77090
142228401300000,SE 231,Residential,12750,0,12750,42480,0,55230
142228401400000,SE 231,Residential,5250,0,5250,74578,0,79828
142228401500000,SE 231,Residential,5250,0,5250,52749,0,57999
142228401600000,SE 231,Exempt,0,5425,5425,0,42540,47965
142228401700000,SE 231,Residential,5425,0,5425,41978,0,47403
142228401800000,SE 231,Residential,5532,0,5532,44685,0,50217
142228401900000,SE 231,Residential,5425,0,5425,46646,0,52071
142228402000000,SE 231,Residential,5250,0,5250,48670,0,53920
142228402100000,SE 231,Residential,5250,0,5250,49563,0,54813
142228402200000,SE 231,Residential,12750,0,12750,60497,0,73247
142228402300000,SE 231,Residential,7500,0,7500,62778,0,70278
142228402400000,SE 231,Residential,7500,0,7500,85511,0,93011
142228402500000,SE 231,Residential,7500,0,7500,52296,0,59796
142228402600000,SE 231,Residential,8750,0,8750,71784,0,80534
142228402700000,SE 231,Residential,8750,0,8750,52763,0,61513
142228402800000,SE 231,Residential,10000,0,10000,87051,0,97051
142228402900000,SE 231,Residential,10000,0,10000,64256,0,74256
142228403000000,SE 231,Residential,10000,0,10000,58459,0,68459
142228403100000,CONVERSION,Commercial,0,9072,9072,0,50276,59348
142228403200000,SE 231,Residential,10119,0,10119,49532,0,59651
142228403300000,SE 231,Residential,10000,0,10000,66125,0,76125
142228403400000,SE 231,Residential,6750,0,6750,58467,0,65217
142228403500000,SE 231,Residential,8750,0,8750,94849,0,103599
142228403600000,SE 231,Residential,5425,0,5425,50453,0,55878
142228403700000,SE 231,Residential,5425,0,5425,50558,0,55983
142228403800000,SE 231,Residential,6975,0,6975,36974,0,43949
142228500100000,CONVERSION,Commercial,0,7517,7517,0,80544,88061
142228500200000,SE 231,Residential,8175,0,8175,59192,0,67367
142228500300000,SE 231,Residential,12625,0,12625,16930,0,29555
142228500400000,SE 231,Residential,12350,0,12350,49195,0,61545
142228500500000,SE 231,Residential,7500,0,7500,55436,0,62936
142228500600000,SE 231,Residential,4937,0,4937,43149,0,48086
142228500700000,SE 231,Residential,7756,0,7756,17434,0,25190
142228500800000,SE 231,Residential,7350,0,7350,32505,0,39855
142228500900000,SE 231,Residential,6471,0,6471,40395,0,46866
142228501000000,SE 231,Residential,6608,0,6608,30496,0,37104
142228501100000,SE 231,Residential,7260,0,7260,19336,0,26596
142228501200000,APARTMENT,Commercial,0,8751,8751,0,136537,145288
142228501300000,SE 231,Residential,6490,0,6490,26661,0,33151
142228501400000,SE 231,Residential,4042,0,4042,0,0,4042
142228501500000,SE 231,Residential,10000,0,10000,43965,0,53965
142228501600000,SE 231,Residential,10000,0,10000,40790,0,50790
142228501700000,SE 231,Residential,7500,0,7500,36681,0,44181
142228501800000,SE 231,Residential,7500,0,7500,46584,0,54084
142228501900000,SE 231,Residential,10000,0,10000,18101,0,28101
142228502000000,SE 231,Residential,10000,0,10000,31065,0,41065
142228502100000,SE 231,Residential,12500,0,12500,53734,0,66234
142228502200000,SE 231,Residential,12190,0,12190,27515,0,39705
142228502300000,CONVERSION,Commercial,0,6026,6026,0,82402,88428
142228502400000,SE 231,Residential,6200,0,6200,0,0,6200
142228502500000,SE 231,Residential,6200,0,6200,39396,0,45596
142228502600000,SE 231,Residential,5580,0,5580,40411,0,45991
142230100100000,CONVERSION,Commercial,0,5511,5511,0,61444,66955
142230100200000,CONVERSION,Commercial,0,5511,5511,0,61900,67411
142230100300000,SE 231,Residential,10000,0,10000,54067,0,64067
142230100400000,SE 231,Residential,10000,0,10000,84730,0,94730
142230100500000,CONVERSION,Commercial,0,13608,13608,0,48712,62320
142230100600000,SE 231,Residential,10000,0,10000,55027,0,65027
142230100700000,SE 231,Residential,10000,0,10000,62447,0,72447
142230100800000,SE 231,Residential,10000,0,10000,78260,0,88260
142230100900000,SE 231,Residential,10000,0,10000,61764,0,71764
142230101000000,SE 231,Residential,10000,0,10000,16272,0,26272
142230101100000,SE 231,Residential,10000,0,10000,73063,0,83063
142230101200000,SE 231,Residential,10000,0,10000,85649,0,95649
142230101300000,SE 231,Residential,10000,0,10000,37770,0,47770
142230101400000,SE 231,Residential,10000,0,10000,55289,0,65289
142230101500000,SE 231,Residential,10000,0,10000,77596,0,87596
142230101600000,SE 231,Residential,9307,0,9307,68798,0,78105
142230101700000,SE 231,Residential,5038,0,5038,26148,0,31186
142230101800000,SE 231,Residential,5038,0,5038,26841,0,31879
142230101900000,SE 231,Residential,5270,0,5270,0,0,5270
142230102000000,SE 231,Exempt,0,5270,5270,0,57673,62943
142230102100000,SE 231,Residential,5325,0,5325,35841,0,41166
142230102200000,SE 231,Residential,5325,0,5325,53907,0,59232
142230102300000,SE 231,Residential,10000,0,10000,36466,0,46466
142230102400000,SE 231,Residential,10000,0,10000,84027,0,94027
142230102500000,SE 231,Exempt,0,10000,10000,0,56108,66108
142230102600000,SE 231,Residential,12750,0,12750,64894,0,77644
142230102700000,SE 231,Residential,10000,0,10000,73032,0,83032
142230102800000,SE 231,Residential,12500,0,12500,78586,0,91086
142230102900000,CONVERSION,Commercial,0,11340,11340,0,69426,80766
142230103000000,SE 231,Residential,10000,0,10000,61895,0,71895
142230103100000,SE 231,Residential,10000,0,10000,73797,0,83797
142230103200000,SE 231,Residential,10000,0,10000,50183,0,60183
142230103300000,SE 231,Residential,10000,0,10000,53610,0,63610
142230103400000,SE 231,Residential,13246,0,13246,62843,0,76089
142230103500000,SE 231,Exempt,0,5475,5475,0,41705,47180
142230103600000,SE 231,Residential,5846,0,5846,68785,0,74631
142230103700000,SE 231,Residential,5038,0,5038,50175,0,55213
142230103800000,SE 231,Residential,4956,0,4956,60659,0,65615
142230103900000,SE 231,Residential,5363,0,5363,63491,0,68854
142230200100000,SE 231,Residential,7905,0,7905,68145,0,76050
142230200200000,SE 231,Residential,10000,0,10000,62047,0,72047
142230200300000,SE 231,Residential,10000,0,10000,34167,0,44167
142230200400000,SE 231,Residential,10000,0,10000,34410,0,44410
142230200500000,SE 231,Residential,7500,0,7500,56030,0,63530
142230200600000,SE 231,Exempt,0,7500,7500,0,44544,52044
142230200700000,SE 231,Residential,7500,0,7500,51273,0,58773
142230200800000,SE 231,Residential,7500,0,7500,55702,0,63202
142230200900000,SE 231,Residential,11250,0,11250,27178,0,38428
142230201000000,APARTMENT,Commercial,0,17010,17010,0,149003,166013
142230201100000,CONVERSION,Commercial,0,6847,6847,0,50561,57408
142230201200000,SE 231,Residential,7000,0,7000,37164,0,44164
142230201300000,SE 231,Residential,5475,0,5475,0,0,5475
142230201400000,SE 231,Residential,5700,0,5700,45050,0,50750
142230201500000,SE 231,Residential,5063,0,5063,35334,0,40397
142230201600000,SE 231,Residential,4650,0,4650,35759,0,40409
142230201700000,SE 231,Residential,5425,0,5425,51123,0,56548
142230201800000,SE 231,Residential,5425,0,5425,44571,0,49996
142230201900000,SE 231,Residential,10500,0,10500,0,0,10500
142230202000000,SE 231,Residential,12750,0,12750,52534,0,65284
142230202100000,SE 231,Exempt,0,7500,7500,0,44960,52460
142230202200000,SE 231,Residential,7500,0,7500,62836,0,70336
142230202300000,SE 231,Residential,7500,0,7500,24875,0,32375
142230202400000,SE 231,Residential,7500,0,7500,24316,0,31816
142230202500000,SE 231,Residential,10040,0,10040,23960,0,34000
142230202600000,SE 231,Residential,10000,0,10000,36174,0,46174
142230202700000,SE 231,Residential,10000,0,10000,32915,0,42915
142230202800000,SE 231,Residential,10270,0,10270,54730,0,65000
142230203100000,SE 231,Residential,5250,0,5250,50971,0,56221
142230203200000,SE 231,Residential,3675,0,3675,0,0,3675
142230203300000,SE 231,Residential,5425,0,5425,30292,0,35717
142230203400000,SE 231,Residential,5425,0,5425,39051,0,44476
142230203500000,CONVERSION,Commercial,0,3888,3888,0,36244,40132
142230203600000,SE 231,Residential,6200,0,6200,26588,0,32788
142230203700000,SE 231,Residential,10000,0,10000,92598,0,102598
142230203800000,SE 231,Residential,10000,0,10000,0,0,10000
142230300100000,SE 231,Residential,7848,0,7848,76589,0,84437
142230300200000,SE 231,Residential,7300,0,7300,71985,0,79285
142230300300000,SE 231,Residential,10000,0,10000,49656,0,59656
142230300400000,SE 231,Residential,10000,0,10000,57655,0,67655
142230300500000,SE 231,Residential,10000,0,10000,64410,0,74410
142230300600000,SE 231,Residential,10000,0,10000,48384,0,58384
142230300700000,SE 231,Residential,10000,0,10000,65824,0,75824
142230300800000,SE 231,Residential,10000,0,10000,66771,0,76771
142230300900000,SE 231,Residential,10000,0,10000,59355,0,69355
142230301000000,SE 231,Residential,10000,0,10000,57731,0,67731
142230301100000,SE 231,Residential,10000,0,10000,49860,0,59860
142230301200000,SE 231,Residential,10000,0,10000,39370,0,49370
142230301300000,SE 231,Residential,10000,0,10000,54394,0,64394
142230301400000,SE 231,Residential,10000,0,10000,51718,0,61718
142230301500000,SE 231,Residential,10000,0,10000,58031,0,68031
142230301600000,SE 231,Residential,5527,0,5527,41473,0,47000
142230301700000,SE 231,Residential,5658,0,5658,39836,0,45494
142230301800000,SE 231,Residential,4631,0,4631,42636,0,47267
142230301900000,SE 231,Residential,4631,0,4631,40581,0,45212
142230302000000,SE 231,Residential,813,0,813,0,0,813
142230302100000,SE 231,Residential,5038,0,5038,26016,0,31054
142230302200000,SE 231,Residential,5038,0,5038,35897,0,40935
142230302300000,SE 231,Residential,9307,0,9307,53863,0,63170
142230302400000,SE 231,Residential,10000,0,10000,78644,0,88644
142230302500000,SE 231,Residential,10276,0,10276,34724,0,45000
142230302600000,SE 231,Residential,12629,0,12629,72371,0,85000
142230302700000,SE 231,Residential,10000,0,10000,65882,0,75882
142230302900000,SE 231,Residential,8750,0,8750,32639,0,41389
142230303000000,CONVERSION,Commercial,0,11340,11340,0,57978,69318
142230303100000,SE 231,Residential,10000,0,10000,78374,0,88374
142230303200000,SE 231,Residential,10000,0,10000,76293,0,86293
142230303300000,SE 231,Residential,10000,0,10000,75145,0,85145
142230303400000,SE 231,Residential,10000,0,10000,75913,0,85913
142230303500000,SE 231,Residential,10000,0,10000,76613,0,86613
142230303600000,SE 231,Residential,10000,0,10000,63216,0,73216
142230303700000,CONVERSION,Commercial,0,7727,7727,0,72899,80626
142230303800000,SE 231,Residential,5363,0,5363,46614,0,51977
142230303900000,SE 231,Residential,5363,0,5363,53326,0,58689
142230304000000,SE 231,Residential,6419,0,6419,63943,0,70362
142230304100000,SE 231,Residential,6419,0,6419,34486,0,40905
142230400100000,SE 231,Residential,4650,0,4650,0,0,4650
142230400200000,SE 231,Residential,4650,0,4650,0,0,4650
142230400300000,SE 231,Residential,10000,0,10000,41473,0,51473
142230400400000,SE 231,Residential,10000,0,10000,78986,0,88986
142230400500000,SE 231,Residential,10000,0,10000,63123,0,73123
142230400600000,SE 231,Residential,10000,0,10000,66032,0,76032
142230400700000,SE 231,Residential,10000,0,10000,37317,0,47317
142230400800000,SE 231,Residential,10000,0,10000,27314,0,37314
142230400900000,SE 231,Residential,10000,0,10000,43775,0,53775
142230401000000,SE 231,Residential,10000,0,10000,44400,0,54400
142230401100000,SE 231,Residential,10000,0,10000,51239,0,61239
142230401200000,SE 231,Residential,168,0,168,0,0,168
142230401300000,SE 231,Residential,7345,0,7345,34844,0,42189
142230401400000,SE 231,Residential,7500,0,7500,51814,0,59314
142230401500000,SE 231,Residential,6056,0,6056,48978,0,55034
142230401600000,SE 231,Residential,4807,0,4807,50585,0,55392
142230401700000,APARTMENT,Commercial,0,6804,6804,0,60304,67108
142230401800000,SE 231,Residential,7750,0,7750,35717,0,43467
142230401900000,SE 231,Residential,10582,0,10582,14333,0,24915
142230402000000,SE 231,Residential,7500,0,7500,1558,0,9058
142230402100000,SE 231,Residential,7500,0,7500,38894,0,46394
142230402200000,SE 231,Residential,10000,0,10000,54940,0,64940
142230402300000,SE 231,Residential,10000,0,10000,54929,0,64929
142230402400000,SE 231,Residential,10340,0,10340,47214,0,57554
142230402500000,SE 231,Residential,10000,0,10000,72527,0,82527
142230402600000,SE 231,Residential,10000,0,10000,56152,0,66152
142230402700000,SE 231,Residential,10000,0,10000,35105,0,45105
142230402800000,SE 231,Residential,10000,0,10000,63588,0,73588
142230402900000,SE 231,Residential,10000,0,10000,60879,0,70879
142230403000000,SE 231,Residential,10000,0,10000,48371,0,58371
142230403100000,SE 231,Residential,5475,0,5475,40402,0,45877
142230403200000,SE 231,Residential,5475,0,5475,75333,0,80808
142230403300000,SE 231,Residential,5038,0,5038,30638,0,35676
142230403400000,SE 231,Residential,5038,0,5038,43234,0,48272
142230403600000,SE 231,Residential,6200,0,6200,40011,0,46211
142230403700000,SE 231,Residential,6311,0,6311,42348,0,48659
142230500100000,SE 231,Residential,7975,0,7975,49921,0,57896
142230500200000,SE 231,Residential,7300,0,7300,87556,0,94856
142230500300000,SE 231,Residential,10000,0,10000,80039,0,90039
142230500400000,SE 231,Residential,10000,0,10000,43637,0,53637
142230500500000,SE 231,Residential,10000,0,10000,67273,0,77273
142230500600000,APARTMENT,Commercial,0,9072,9072,0,77405,86477
142230500700000,SE 231,Residential,10000,0,10000,94221,0,104221
142230500800000,SE 231,Residential,10000,0,10000,65310,0,75310
142230500900000,SE 231,Residential,10000,0,10000,60306,0,70306
142230501000000,SE 231,Residential,10000,0,10000,61529,0,71529
142230501100000,SE 231,Residential,10094,0,10094,39906,0,50000
142230501200000,SE 231,Residential,10000,0,10000,69800,0,79800
142230501300000,SE 231,Residential,10144,0,10144,38156,0,48300
142230501400000,SE 231,Residential,10000,0,10000,47235,0,57235
142230501500000,SE 231,Residential,10000,0,10000,65286,0,75286
142230501600000,SE 231,Residential,5250,0,5250,42347,0,47597
142230501700000,SE 231,Exempt,0,5250,5250,0,52926,58176
142230501800000,SE 231,Residential,5425,0,5425,61122,0,66547
142230501900000,SE 231,Residential,5425,0,5425,54166,0,59591
142230502000000,SE 231,Residential,5726,0,5726,53274,0,59000
142230502100000,SE 231,Residential,5363,0,5363,44696,0,50059
142230502200000,SE 231,Residential,5250,0,5250,52077,0,57327
142230502300000,SE 231,Residential,5928,0,5928,24799,0,30727
142230502400000,SE 231,Residential,10000,0,10000,19906,0,29906
142230502500000,SE 231,Residential,10000,0,10000,30224,0,40224
142230502600000,SE 231,Residential,10000,0,10000,25613,0,35613
142230502700000,SE 231,Residential,10000,0,10000,50213,0,60213
142230502800000,SE 231,Residential,10000,0,10000,82184,0,92184
142230502900000,SE 231,Residential,10000,0,10000,93439,0,103439
142230503000000,SE 231,Residential,10000,0,10000,75868,0,85868
142230503100000,SE 231,Residential,10000,0,10000,82187,0,92187
142230503200000,SE 231,Residential,10000,0,10000,43468,0,53468
142230503300000,SE 231,Residential,10000,0,10000,58411,0,68411
142230503400000,SE 231,Residential,10000,0,10000,74414,0,84414
142230503500000,SE 231,Residential,10000,0,10000,57135,0,67135
142230503600000,SE 231,Residential,9978,0,9978,56103,0,66081
142230503700000,SE 231,Residential,7300,0,7300,33778,0,41078
142230503800000,SE 231,Residential,7802,0,7802,26494,0,34296
142230503900000,SE 231,Residential,6175,0,6175,42819,0,48994
142230504000000,SE 231,Residential,6175,0,6175,54084,0,60259
142230504100000,SE 231,Residential,6419,0,6419,48784,0,55203
142230504200000,SE 231,Residential,6419,0,6419,51448,0,57867
142230600100000,SE 231,Residential,5475,0,5475,44665,0,50140
142230600200000,SE 231,Residential,5475,0,5475,49381,0,54856
142230600300000,SE 231,Exempt,0,10000,10000,0,58858,68858
142230600400000,SE 231,Residential,10000,0,10000,0,0,10000
142230600500000,CITY PROPERTY,Exempt,0,0,0,0,0,0
142230600600000,SE 231,Residential,10000,0,10000,54366,0,64366
142230600700000,SE 231,Residential,10000,0,10000,60264,0,70264
142230600800000,SE 231,Residential,9250,0,9250,46891,0,56141
142230600900000,SE 231,Residential,5475,0,5475,32369,0,37844
142230601000000,SE 231,Residential,5618,0,5618,49382,0,55000
142230601100000,SE 231,Residential,4650,0,4650,60018,0,64668
142230601200000,SE 231,Residential,7263,0,7263,46680,0,53943
142230601300000,SE 231,Residential,8375,0,8375,60579,0,68954
142230601400000,SE 231,Residential,10407,0,10407,39993,0,50400
142230601500000,SE 231,Residential,10000,0,10000,81716,0,91716
142230601600000,SE 231,Residential,10000,0,10000,56551,0,66551
142230601700000,SE 231,Residential,12750,0,12750,48083,0,60833
142230601800000,SE 231,Residential,10000,0,10000,48688,0,58688
142230601900000,SE 231,Residential,10000,0,10000,50761,0,60761
142230602000000,SE 231,Residential,7347,0,7347,49654,0,57001
142230602100000,SE 231,Exempt,0,7600,7600,0,58342,65942
142230602200000,SE 231,Residential,9307,0,9307,57723,0,67030
142230602300000,SE 231,Residential,5038,0,5038,44680,0,49718
142230602400000,SE 231,Residential,5038,0,5038,34576,0,39614
142230700100000,CONVERSION,Commercial,0,4528,4528,0,5250,9778
142230700200000,SE 232,Residential,10070,0,10070,57172,0,67242
142230700300000,SE 232,Residential,9085,0,9085,46219,0,55304
142230700500000,SE 232,Residential,5850,0,5850,42254,0,48104
142230700600000,SE 232,Residential,4200,0,4200,46814,0,51014
142230700700000,SE 232,Residential,9231,0,9231,19684,0,28915
142230700800000,SE 232,Residential,9900,0,9900,33061,0,42961
142230700900000,SE 232,Exempt,0,9900,9900,0,41571,51471
142230701000000,SE 232,Exempt,0,7673,7673,0,40762,48435
142230701100000,SE 232,Residential,7673,0,7673,46417,0,54090
142230701200000,SE 232,Residential,7673,0,7673,46311,0,53984
142230701300000,SE 232,Exempt,0,9900,9900,0,34163,44063
142230701400000,SE 232,Residential,6200,0,6200,48898,0,55098
142230701500000,SE 232,Exempt,0,6975,6975,0,56447,63422
142230701600000,SE 232,Residential,7595,0,7595,49822,0,57417
142230800100000,SE 231,Residential,7163,0,7163,41959,0,49122
142230800200000,SE 231,Residential,6429,0,6429,33271,0,39700
142230800300000,SE 231,Residential,6094,0,6094,42531,0,48625
142230800400000,SE 231,Residential,6175,0,6175,56912,0,63087
142230800500000,SE 231,Residential,10000,0,10000,50776,0,60776
142230800600000,SE 231,Residential,10000,0,10000,57444,0,67444
142230800700000,SE 231,Residential,10000,0,10000,49199,0,59199
142230800800000,SE 231,Residential,10000,0,10000,49931,0,59931
142230800900000,SE 231,Residential,10000,0,10000,46173,0,56173
142230801000000,SE 231,Residential,10000,0,10000,77761,0,87761
142230801100000,SE 231,Residential,12750,0,12750,55263,0,68013
142230801200000,SE 231,Residential,12750,0,12750,66968,0,79718
142230801300000,SE 231,Residential,10000,0,10000,45117,0,55117
142230801400000,SE 231,Residential,10000,0,10000,33537,0,43537
142230801500000,SE 231,Residential,10000,0,10000,38458,0,48458
142230801600000,SE 231,Residential,10000,0,10000,65991,0,75991
142230801700000,SE 231,Residential,13766,0,13766,42308,0,56074
142230900100000,SE 231,Exempt,0,9406,9406,0,69741,79147
142230900200000,SE 231,Exempt,0,8771,8771,0,46337,55108
142230900300000,SE 231,Residential,9910,0,9910,41816,0,51726
142230900400000,SE 231,Residential,10000,0,10000,75997,0,85997
142230900500000,SE 231,Residential,10000,0,10000,45958,0,55958
142230900600000,SE 231,Residential,10000,0,10000,49847,0,59847
142230900700000,SE 231,Residential,10000,0,10000,35319,0,45319
142230900800000,SE 231,Residential,10000,0,10000,59593,0,69593
142230900900000,SE 231,Residential,5818,0,5818,62588,0,68406
142230901000000,SE 231,Residential,6646,0,6646,49040,0,55686
142230901100000,SE 231,Residential,5280,0,5280,49294,0,54574
142230901200000,SE 231,Residential,5200,0,5200,26717,0,31917
142232600100000,CHURCH,Exempt,0,210816,210816,0,3140691,3351507
142232600300000,SE 232,Residential,10000,0,10000,34663,0,44663
142232600400000,SE 232,Exempt,0,10000,10000,0,55399,65399
142232600500000,CONVERSION,Commercial,0,9072,9072,0,67600,76672
142232600600000,SE 232,Residential,10000,0,10000,29598,0,39598
142232600700000,CONVERSION,Commercial,0,9072,9072,0,60333,69405
142232600800000,APARTMENT,Commercial,0,9072,9072,0,106183,115255
142232600900000,APARTMENT,Commercial,0,9072,9072,0,106807,115879
142232601000000,SE 232,Residential,10000,0,10000,0,0,10000
142232601100000,OFFICE,Commercial,0,24192,24192,0,83571,107763
142232601201000,OFFICE,Commercial,0,83160,83160,0,326247,409407
142232601201001,OFFICE,Commercial,0,83160,83160,0,344513,427673
142232601300000,FLAT PARKING,Commercial,0,120960,120960,0,20800,141760
142232601400000,SE 232,Residential,12500,0,12500,0,0,12500
142232601700000,SE 232,Residential,12500,0,12500,71600,0,84100
142232601800000,SE 232,Residential,12500,0,12500,54067,0,66567
142232601900000,SE 232,Residential,10000,0,10000,34716,0,44716
142232602000000,FLAT PARKING,Exempt,0,48384,48384,0,21078,69462
142232602200000,SE 232,Residential,10000,0,10000,53031,0,63031
142232602300000,SE 232,Residential,10000,0,10000,36623,0,46623
142232602400000,FLAT PARKING,Exempt,0,24192,24192,0,10751,34943
142232602500000,FLAT PARKING,Exempt,0,89662,89662,0,40740,130402
142232602600000,APARTMENT,Commercial,0,18144,18144,0,53240,71384
142232700100000,OFFICE; MEDICAL,Commercial,0,135821,135821,0,792201,928022
142232700400000,CONVERSION,Exempt,0,12474,12474,0,160262,172736
142232700500000,CONVERSION,Residential,7425,0,7425,0,0,7425
142232700600000,SE 232,Residential,10000,0,10000,0,0,10000
142232700700000,CONVERSION,Commercial,0,11340,11340,0,74321,85661
142232700800000,SE 232,Residential,7500,0,7500,0,0,7500
142232700900000,SE 232,Residential,7906,0,7906,41607,0,49513
142232701000000,CONVERSION,Commercial,0,6156,6156,0,51068,57224
142232701100000,CONVERSION,Commercial,0,2592,2592,0,40195,42787
142232701200000,FLAT PARKING,Commercial,0,6739,6739,0,3516,10255
142232701300000,CONVERSION,Commercial,0,12814,12814,0,97115,109929
142232701500000,OFFICE,Commercial,0,70459,70459,0,150725,221184
142232701600000,CONVERSION,Commercial,0,11340,11340,0,77689,89029
142232701700000,CONVERSION,Commercial,0,15876,15876,0,70464,86340
142232701800000,SE 232,Residential,16750,0,16750,94085,0,110835
142232701900000,CONVERSION,Commercial,0,6804,6804,0,46738,53542
142232702000000,SE 232,Residential,7500,0,7500,44140,0,51640
142232702100000,SE 232,Residential,7500,0,7500,38001,0,45501
142232702200000,CONVERSION,Commercial,0,6804,6804,0,51948,58752
142232702300000,OFFICE; MEDICAL,Commercial,0,122170,122170,0,971937,1094107
142232702400000,CONVERSION,Commercial,0,8278,8278,0,68638,76916
142232800100000,FLAT PARKING,Commercial,0,34776,34776,0,5486,40262
142232800200000,VACANT LAND,Commercial,0,24348,24348,0,0,24348
142232800300000,FLAT PARKING,Commercial,0,25704,25704,0,8468,34172
142232800400000,FLAT PARKING,Commercial,0,25704,25704,0,3796,29500
142232800500000,SMALL RETAIL,Commercial,0,18144,18144,0,31788,49932
142232800600000,SMALL RETAIL,Commercial,0,18144,18144,0,29680,47824
142232800700000,SMALL RETAIL,Commercial,0,69930,69930,0,178730,248660
142232800800000,CONVENIENCE STORE,Commercial,0,163296,163296,0,283881,447177
142232800900000,FLAT PARKING,Commercial,0,81648,81648,0,7137,88785
142232900100000,RESTAURANT,Commercial,0,90720,90720,0,124762,215482
142232900102000,BILLBOARD(BLL),Commercial,0,0,0,0,29384,29384
142232900200000,OFFICE,Commercial,0,90720,90720,0,193128,283848
142232900300000,VACANT LAND,Commercial,0,39118,39118,0,0,39118
142233000100000,VACANT LAND,Commercial,0,47628,47628,0,0,47628
142233000200000,APARTMENT,Commercial,0,10773,10773,0,144227,155000
142233000300000,OFFICE,Commercial,0,57644,57644,0,97356,155000
142233000400000,SMALL RETAIL,Commercial,0,102060,102060,0,0,102060
142233000500000,SMALL RETAIL,Commercial,0,34020,34020,0,0,34020
142233000600000,APARTMENT,Residential,10206,0,10206,0,0,10206
142233000700000,VACANT LAND,Commercial,0,34609,34609,0,0,34609
142233000900000,VACANT LAND,Commercial,0,143640,143640,0,10725,154365
142233001000000,VACANT LAND,Commercial,0,35170,35170,0,0,35170
142233100100000,SR/NURSING/ASSTD LIV,Exempt,0,263520,263520,0,3162796,3426316
142233100200000,OFFICE; MEDICAL,Commercial,0,42517,42517,0,144039,186556
142233100300000,FLAT PARKING,Commercial,0,33445,33445,0,4928,38373
142233100400000,VACANT LAND,Exempt,0,37981,37981,0,2800,40781
142233100500000,OFFICE,Commercial,0,29484,29484,0,125634,155118
142233100600000,OFFICE,Commercial,0,45360,45360,0,0,45360
142233100700000,CONVERSION,Commercial,0,9072,9072,0,56808,65880
142233100900000,FLAT PARKING,Commercial,0,52920,52920,0,10220,63140
142233101000000,FLAT PARKING,Commercial,0,63504,63504,0,11508,75012
142233101100000,FLAT PARKING,Commercial,0,63504,63504,0,12408,75912
142233101200000,OFFICE; MEDICAL,Commercial,0,218160,218160,0,2241783,2459943
142233101300000,VACANT LAND,Exempt,0,6890,6890,0,0,6890
142233101500000,HOSPITAL,Exempt,0,42071,42071,0,0,42071
142233101600000,OFFICE,Exempt,0,41434,41434,0,598139,639573
142233200200000,VACANT LAND,Exempt,0,23085,23085,0,0,23085
142233200500000,APARTMENT,Exempt,0,27234,27234,0,228186,255420
142233200600000,SE 232,Exempt,0,0,0,0,0,0
142233200700000,VACANT LAND,Commercial,0,18144,18144,0,0,18144
142233200800000,WAREHOUSE,Commercial,0,24192,24192,0,62389,86581
142233201000000,CHURCH,Exempt,0,22032,22032,0,122540,144572
142233201100000,SE 232,Exempt,0,0,0,0,0,0
142233201200000,SR/NURSING/ASSTD LIV,Exempt,0,300672,300672,0,2891942,3192614
142233201300000,SE 232,Residential,9700,0,9700,54900,0,64600
142233201400000,SE 232,Residential,10875,0,10875,45408,0,56283
142233300100000,SMALL RETAIL,Commercial,0,7560,7560,0,108026,115586
142233300200000,FLAT PARKING,Commercial,0,7452,7452,0,2074,9526
142233300300000,SE 232,Residential,4185,0,4185,39282,0,43467
142233300400000,SE 232,Residential,6750,0,6750,37362,0,44112
142233300500000,SE 232,Residential,5400,0,5400,35701,0,41101
142233300600000,OFFICE,Commercial,0,504360,504360,0,3235032,3739392
142233400100000,CONVERSION,Commercial,0,7128,7128,0,47887,55015
142233400200000,SE 232,Residential,10000,0,10000,65446,0,75446
142233400300000,SE 232,Residential,12750,0,12750,26058,0,38808
142233400400000,SE 232,Residential,7500,0,7500,39353,0,46853
142233400500000,SE 232,Residential,7500,0,7500,32743,0,40243
142233400600000,SE 232,Residential,12750,0,12750,62491,0,75241
142233400700000,CONVERSION,Commercial,0,6804,6804,0,53115,59919
142233400800000,SE 232,Residential,7500,0,7500,46397,0,53897
142233400900000,CONVERSION,Commercial,0,9234,9234,0,75611,84845
142233401000000,SE 232,Residential,6975,0,6975,33007,0,39982
142233401100000,SE 232,Residential,6650,0,6650,40182,0,46832
142233401200000,SE 232,Residential,6650,0,6650,62835,0,69485
142233401300000,SE 232,Residential,4500,0,4500,132,0,4632
142233401400000,SE 232,Residential,12750,0,12750,0,0,12750
142233401500000,SE 232,Residential,8000,0,8000,49636,0,57636
142233401600000,SE 232,Residential,6817,0,6817,27462,0,34279
142233401700000,SE 232,Exempt,0,7320,7320,0,41802,49122
142233500100000,SE 232,Exempt,0,12750,12750,0,87693,100443
142233500200000,SE 232,Exempt,0,7725,7725,0,44124,51849
142235100100000,SE 232,Residential,7000,0,7000,0,0,7000
142235100200000,SE 232,Residential,3375,0,3375,37354,0,40729
142235100300000,SE 232,Residential,4500,0,4500,32292,0,36792
142235200100000,SCHOOL,Exempt,0,0,0,0,0,0
142235200200000,SE 232,Residential,5700,0,5700,35323,0,41023
142235200300000,CONVERSION,Commercial,0,3888,3888,0,42956,46844
142235200400000,SE 232,Residential,6200,0,6200,40081,0,46281
142235200500000,SE 232,Residential,5700,0,5700,15924,0,21624
142235200600000,SE 232,Residential,5700,0,5700,25382,0,31082
142235200700000,SE 232,Residential,5700,0,5700,36082,0,41782
142235200800000,SE 232,Residential,5700,0,5700,0,0,5700
142235200900000,SE 232,Residential,12936,0,12936,0,0,12936
142235201000000,SE 232,Residential,4940,0,4940,0,0,4940
142235201100000,SE 232,Residential,7600,0,7600,34758,0,42358
142235201200000,SE 232,Residential,7600,0,7600,25551,0,33151
142235201300000,SE 232,Residential,8800,0,8800,35704,0,44504
142235201400000,SE 232,Residential,9386,0,9386,48126,0,57512
142235201500000,SCHOOL,Exempt,0,0,0,0,0,0
142235201600000,SCHOOL,Exempt,0,0,0,0,0,0
142235201700000,SCHOOL,Exempt,0,0,0,0,0,0
142235202000000,SE 232,Residential,9925,0,9925,0,0,9925
142235202100000,CITY PROPERTY,Exempt,0,0,0,0,0,0
142235202200000,CONVERSION,Commercial,0,5832,5832,0,80026,85858
142235202300000,SE 232,Residential,7350,0,7350,32558,0,39908
142235202400000,SE 232,Residential,7350,0,7350,29190,0,36540
142235202500000,SE 232,Residential,12495,0,12495,41722,0,54217
142235202600000,SE 232,Residential,7040,0,7040,36795,0,43835
142235202700000,CONVERSION,Exempt,0,6156,6156,0,101990,108146
142235202800000,CONVERSION,Commercial,0,8100,8100,0,78384,86484
142235202900000,SE 232,Residential,11500,0,11500,50795,0,62295
142235203000000,SE 232,Residential,12512,0,12512,0,0,12512
142235203100000,SCHOOL,Exempt,0,0,0,0,0,0
142235203200000,SCHOOL,Exempt,0,0,0,0,0,0
142235203300000,SCHOOL,Exempt,0,0,0,0,0,0
142235203500000,FLAT PARKING,Exempt,0,160989,160989,0,16660,177649
142235203600000,SE 232,Residential,8050,0,8050,42917,0,50967
142235203700000,DAY CARE CENTER,Commercial,0,21384,21384,0,1760,23144
142235203800000,DAY CARE CENTER,Commercial,0,183902,183902,0,471453,655355
142235203900000,FLAT PARKING,Exempt,0,40824,40824,0,4160,44984
142235204000000,OFFICE; MEDICAL,Commercial,0,108670,108670,0,279868,388538
142235204100000,HOSPITAL,Exempt,0,55404,55404,0,0,55404
142235204400000,OFFICE,Commercial,0,27410,27410,0,107425,134835
142235300100000,NBHD SHOPPING CENTER,Commercial,0,334800,334800,0,989940,1324740
142235400100000,OFFICE; MED; CTRL CR,Commercial,0,97200,97200,0,375340,472540
142235400102000,BILLBOARD(BLL),Commercial,0,0,0,0,16736,16736
142235400200000,OFFICE; MED; CTRL CR,Commercial,0,574518,574518,0,2092856,2667374
142235500100000,HOSPITAL,Commercial,0,900504,900504,0,98093239,98993743
142235500200000,HOSPITAL,Exempt,0,313200,313200,0,9120786,9433986
142235500300000,HOSPITAL,Exempt,0,103162,103162,0,8820,111982
142235500400000,HOSPITAL,Exempt,0,376650,376650,0,1944753,2321403
142235500500000,FLAT PARKING,Exempt,0,38880,38880,0,9150,48030
142235500600000,WAREHOUSE,Exempt,0,386208,386208,0,580783,966991
142235500700000,OFFICE; MEDICAL,Exempt,0,89424,89424,0,495988,585412
142235500800000,FLAT PARKING,Commercial,0,38880,38880,0,8856,47736
142235600100000,WAREHOUSE,Exempt,0,153187,153187,0,267678,420865
142235600400000,CITY PROPERTY,Exempt,0,0,0,0,0,0
142235600500000,CITY PROPERTY,Exempt,0,0,0,0,0,0
142235600600000,HOSPITAL,Exempt,0,1296,1296,0,0,1296
142235600900000,FLAT PARKING,Exempt,0,10368,10368,0,6426,16794
142237600100000,SE 231,Residential,6256,0,6256,44444,0,50700
142237600200000,SE 231,Residential,6338,0,6338,34568,0,40906
142237600300000,SE 231,Residential,8349,0,8349,79124,0,87473
142237600400000,SE 231,Residential,7300,0,7300,39340,0,46640
142237600500000,SE 231,Residential,10000,0,10000,37986,0,47986
142237600600000,SE 231,Residential,10000,0,10000,61537,0,71537
142237600700000,SE 231,Residential,10000,0,10000,83115,0,93115
142237600800000,SE 231,Residential,10000,0,10000,50719,0,60719
142237600900000,SE 231,Residential,10000,0,10000,76376,0,86376
142237601000000,SE 231,Residential,10000,0,10000,61007,0,71007
142237601100000,SE 231,Residential,10000,0,10000,74704,0,84704
142237601200000,SE 231,Residential,10000,0,10000,54634,0,64634
142237601300000,SE 231,Residential,10000,0,10000,71999,0,81999
142237601400000,SE 231,Residential,10000,0,10000,44010,0,54010
142237601500000,SE 231,Residential,10000,0,10000,41905,0,51905
142237601600000,SE 231,Residential,10000,0,10000,58283,0,68283
142237601700000,SE 231,Residential,10000,0,10000,11378,0,21378
142237601800000,SE 231,Residential,5775,0,5775,37632,0,43407
142237601900000,SE 231,Exempt,0,5600,5600,0,44513,50113
142237602000000,SE 231,Residential,9235,0,9235,50278,0,59513
142237700100000,SE 231,Residential,7394,0,7394,49216,0,56610
142237700200000,SE 231,Residential,7475,0,7475,49074,0,56549
142237700300000,SE 231,Residential,8349,0,8349,42756,0,51105
142237700400000,SE 231,Residential,6023,0,6023,20666,0,26689
142237700500000,SE 231,Residential,6205,0,6205,59035,0,65240
142237700600000,SE 231,Residential,8250,0,8250,48399,0,56649
142237700700000,SE 231,Residential,10000,0,10000,48344,0,58344
142237700800000,SE 231,Residential,10000,0,10000,66984,0,76984
142237700900000,SE 231,Residential,10000,0,10000,40837,0,50837
142237701000000,SE 231,Residential,10000,0,10000,13997,0,23997
142237701100000,SE 231,Residential,9005,0,9005,54744,0,63749
142237701200000,SE 231,Residential,5719,0,5719,38185,0,43904
142237701300000,SE 231,Residential,5038,0,5038,41760,0,46798
142237800100000,SMALL RETAIL,Commercial,0,49896,49896,0,170230,220126
142237800200000,SE 231,Residential,10000,0,10000,53608,0,63608
142237800300000,FLAT PARKING,Commercial,0,18144,18144,0,10476,28620
142237900100000,SE 231,Residential,7163,0,7163,71663,0,78826
142237900200000,SE 231,Residential,6388,0,6388,44973,0,51361
142237900300000,SE 231,Residential,10000,0,10000,88176,0,98176
142237900400000,SE 231,Residential,10000,0,10000,57243,0,67243
142237900500000,SE 231,Residential,10000,0,10000,77172,0,87172
142237900600000,SE 231,Residential,10000,0,10000,96159,0,106159
142237900700000,SE 231,Residential,10000,0,10000,73028,0,83028
142237900800000,SE 231,Residential,10000,0,10000,45560,0,55560
142237900900000,SE 231,Residential,10000,0,10000,45041,0,55041
142237901000000,SE 231,Residential,10000,0,10000,76257,0,86257
142237901100000,SE 231,Residential,10000,0,10000,56778,0,66778
142237901200000,SE 231,Residential,10000,0,10000,47349,0,57349
142237901300000,SE 231,Residential,10000,0,10000,102663,0,112663
142237901400000,SE 231,Residential,10000,0,10000,52523,0,62523
142237901500000,SE 231,Residential,10000,0,10000,63088,0,73088
142237901600000,SE 231,Residential,6458,0,6458,41765,0,48223
142237901700000,SE 231,Residential,6388,0,6388,57461,0,63849
142237901800000,SE 231,Residential,5606,0,5606,53280,0,58886
142237901900000,SE 231,Residential,5444,0,5444,53076,0,58520
142237902000000,SE 231,Residential,9240,0,9240,50794,0,60034
142237902100000,SE 231,Residential,5250,0,5250,53584,0,58834
142237902200000,SE 231,Residential,5098,0,5098,58441,0,63539
142237902300000,SE 231,Residential,10000,0,10000,54883,0,64883
142237902400000,SE 231,Residential,10000,0,10000,60426,0,70426
142237902500000,SE 231,Residential,10000,0,10000,44456,0,54456
142237902600000,SE 231,Residential,10000,0,10000,67122,0,77122
142237902700000,SE 231,Residential,10000,0,10000,76801,0,86801
142237902800000,SE 231,Residential,10000,0,10000,77381,0,87381
142237902900000,SE 231,Residential,10000,0,10000,46255,0,56255
142237903000000,SE 231,Residential,10000,0,10000,63749,0,73749
142237903100000,SE 231,Residential,10000,0,10000,65419,0,75419
142237903200000,SE 231,Residential,10000,0,10000,56078,0,66078
142237903300000,SE 231,Residential,10000,0,10000,51593,0,61593
142237903400000,SE 231,Residential,8333,0,8333,52316,0,60649
142237903500000,SE 231,Residential,8333,0,8333,47534,0,55867
142237903600000,SE 231,Residential,8333,0,8333,78169,0,86502
142237903700000,SE 231,Residential,9599,0,9599,79015,0,88614
142237903800000,SE 231,Residential,5200,0,5200,51934,0,57134
142237903900000,SE 231,Residential,5200,0,5200,68091,0,73291
142237904000000,SE 231,Residential,6175,0,6175,32097,0,38272
142237904100000,SE 231,Residential,6094,0,6094,33858,0,39952
142238000100000,SE 231,Residential,9005,0,9005,48518,0,57523
142238000200000,SE 231,Residential,10000,0,10000,52727,0,62727
142238000300000,SE 231,Residential,10000,0,10000,75105,0,85105
142238000400000,SE 231,Residential,10000,0,10000,53653,0,63653
142238000500000,SE 231,Exempt,0,10000,10000,0,47292,57292
142238000600000,SE 231,Residential,10000,0,10000,56960,0,66960
142238000700000,SE 231,Residential,10000,0,10000,56435,0,66435
142238000800000,SE 231,Residential,6536,0,6536,53211,0,59747
142238000900000,SE 231,Residential,7055,0,7055,58653,0,65708
142238001000000,SE 231,Residential,8000,0,8000,84902,0,92902
142238001100000,SE 231,Residential,5038,0,5038,57471,0,62509
142238001200000,SE 231,Residential,5509,0,5509,43991,0,49500
142238001300000,SE 231,Residential,8782,0,8782,61908,0,70690
142238001400000,SE 231,Residential,10000,0,10000,52031,0,62031
142238001500000,SE 231,Residential,10000,0,10000,80697,0,90697
142238001600000,SE 231,Residential,10000,0,10000,56163,0,66163
142238001700000,SE 231,Residential,12500,0,12500,76044,0,88544
142238001800000,SE 231,Residential,12500,0,12500,84629,0,97129
142238001900000,SE 231,Residential,10954,0,10954,83037,0,93991
142238002000000,SE 231,Exempt,0,6256,6256,0,46324,52580
142238002100000,SE 231,Residential,6338,0,6338,12064,0,18402
142238002200000,SE 231,Residential,5425,0,5425,40119,0,45544
142238002300000,SE 231,Residential,5338,0,5338,65284,0,70622
142238100100000,SE 231,Residential,5561,0,5561,64792,0,70353
142238100200000,SE 231,Residential,6191,0,6191,43738,0,49929
142238100300000,SE 231,Residential,5444,0,5444,38017,0,43461
142238100400000,SE 231,Residential,5444,0,5444,46608,0,52052
142238100500000,SE 231,Residential,5038,0,5038,26767,0,31805
142238100600000,SE 231,Residential,5038,0,5038,35328,0,40366
142238100700000,SE 231,Residential,5475,0,5475,43010,0,48485
142238100800000,SE 231,Residential,5475,0,5475,43341,0,48816
142238100900000,SE 231,Residential,11125,0,11125,51275,0,62400
142238101000000,SE 231,Residential,10000,0,10000,74220,0,84220
142238101100000,SE 231,Residential,10000,0,10000,74013,0,84013
142238101200000,SE 231,Residential,10000,0,10000,32898,0,42898
142238101300000,SE 231,Residential,10000,0,10000,56287,0,66287
142238101400000,SE 231,Residential,10000,0,10000,36180,0,46180
142238101500000,SE 231,Residential,10000,0,10000,63892,0,73892
142238101600000,SE 231,Residential,12500,0,12500,29630,0,42130
142238101700000,SE 231,Residential,10000,0,10000,28658,0,38658
142238101800000,SE 231,Residential,10000,0,10000,53646,0,63646
142238101900000,SE 231,Residential,10000,0,10000,51016,0,61016
142238102000000,SE 231,Residential,12500,0,12500,107896,0,120396
142238102100000,SE 231,Residential,10000,0,10000,28402,0,38402
142238102200000,SE 231,Residential,10000,0,10000,49655,0,59655
142238102300000,SE 231,Residential,12750,0,12750,44966,0,57716
142238102400000,SE 231,Residential,13425,0,13425,56782,0,70207
142238102500000,SE 230,Residential,17100,0,17100,78714,0,95814
142238102600000,SE 231,Residential,4117,0,4117,34805,0,38922
142238102700000,SE 230,Residential,16686,0,16686,102620,0,119306
142238102800000,SE 230,Residential,13812,0,13812,90570,0,104382
142238102900000,SE 231,Residential,12375,0,12375,84300,0,96675
142238103000000,SE 231,Residential,9900,0,9900,79957,0,89857
142238103100000,SE 231,Residential,9900,0,9900,75690,0,85590
142238103200000,SE 231,Residential,9900,0,9900,62688,0,72588
142238103300000,SE 231,Residential,3200,0,3200,28186,0,31386
142238103400000,SE 231,Residential,6700,0,6700,67592,0,74292
142238200100000,SE 231,Residential,8645,0,8645,57269,0,65914
142238200200000,SE 231,Residential,7875,0,7875,51019,0,58894
142238200300000,SE 231,Residential,7875,0,7875,64198,0,72073
142238200400000,SE 231,Residential,6375,0,6375,77235,0,83610
142238200500000,SE 231,Residential,8455,0,8455,54490,0,62945
142238200600000,SE 231,Residential,10000,0,10000,38048,0,48048
142238200700000,SE 231,Residential,7500,0,7500,48267,0,55767
142238200800000,SE 231,Residential,7500,0,7500,43878,0,51378
142238200900000,SE 231,Residential,10000,0,10000,57060,0,67060
142238201000000,SE 231,Residential,10000,0,10000,60418,0,70418
142238201100000,SE 231,Residential,10000,0,10000,65596,0,75596
142238201200000,SE 231,Residential,10000,0,10000,52128,0,62128
142238201300000,SE 231,Residential,10000,0,10000,49535,0,59535
142238201400000,SE 231,Residential,10000,0,10000,54185,0,64185
142238201500000,SE 231,Residential,10000,0,10000,59600,0,69600
142238201600000,SE 231,Residential,10000,0,10000,55910,0,65910
142238201700000,SE 231,Residential,10000,0,10000,66665,0,76665
142238201800000,SE 231,Residential,10000,0,10000,43362,0,53362
142238201900000,SE 231,Residential,10000,0,10000,49172,0,59172
142238202000000,SE 231,Residential,12750,0,12750,59677,0,72427
142238202100000,AUTO REPAIR/SALES,Commercial,0,14040,14040,0,13752,27792
142238202200000,SMALL RETAIL,Commercial,0,19966,19966,0,58886,78852
142238202300000,SMALL RETAIL,Commercial,0,12960,12960,0,54144,67104
142238202400000,SE 231,Residential,10582,0,10582,57219,0,67801
142238202500000,SE 231,Residential,10000,0,10000,31395,0,41395
142238202600000,SE 231,Residential,10000,0,10000,28451,0,38451
142238202700000,SE 231,Residential,10000,0,10000,80435,0,90435
142238202800000,SE 231,Residential,10000,0,10000,47886,0,57886
142238202900000,SE 231,Residential,9000,0,9000,74042,0,83042
142238203000000,SE 231,Residential,11000,0,11000,65360,0,76360
142238203100000,SE 231,Residential,10000,0,10000,48523,0,58523
142238203200000,SE 231,Residential,10000,0,10000,52102,0,62102
142238203300000,CONVERSION,Commercial,0,13608,13608,0,57935,71543
142238203400000,SE 231,Residential,10000,0,10000,37292,0,47292
142238203500000,SE 231,Residential,10000,0,10000,80862,0,90862
142238203600000,SE 231,Residential,10000,0,10000,50401,0,60401
142238203700000,SE 231,Residential,10000,0,10000,39903,0,49903
142238203800000,SE 231,Residential,8745,0,8745,49145,0,57890
142238300100000,SE 231,Residential,5025,0,5025,41388,0,46413
142238300200000,SE 231,Residential,5425,0,5425,67216,0,72641
142238300300000,SE 231,Residential,5425,0,5425,64914,0,70339
142238300400000,SE 231,Residential,5425,0,5425,50977,0,56402
142238300500000,SE 231,Residential,8680,0,8680,70697,0,79377
142238300600000,SE 231,Residential,10582,0,10582,65028,0,75610
142238300700000,SE 231,Residential,10600,0,10600,53018,0,63618
142238300800000,SE 231,Residential,10600,0,10600,63404,0,74004
142238300900000,SE 231,Residential,10600,0,10600,66705,0,77305
142238301000000,SE 231,Residential,10600,0,10600,73369,0,83969
142238301100000,SE 231,Residential,10600,0,10600,88430,0,99030
142238301200000,SE 231,Residential,10600,0,10600,56039,0,66639
142238301300000,SE 231,Residential,2358,0,2358,1308,0,3666
142238301400000,SE 231,Residential,10865,0,10865,67200,0,78065
142238301500000,SMALL RETAIL,Commercial,0,33048,33048,0,87912,120960
142238301600000,WAREHOUSE,Commercial,0,254016,254016,0,493770,747786
142238301700000,OFFICE,Commercial,0,14256,14256,0,12794,27050
142238301800000,SE 231,Residential,7750,0,7750,16014,0,23764
142238301900000,SE 231,Residential,5743,0,5743,34257,0,40000
142238302000000,SE 231,Residential,6200,0,6200,32735,0,38935
142238302100000,SMALL RETAIL,Commercial,0,19566,19566,0,141721,161287
142238302200000,SE 231,Residential,13515,0,13515,60136,0,73651
142238302300000,SE 231,Residential,10865,0,10865,55868,0,66733
142238302400000,SE 231,Residential,11053,0,11053,45127,0,56180
142238302500000,SE 231,Residential,10600,0,10600,42310,0,52910
142238302600000,SE 231,Residential,10600,0,10600,45493,0,56093
142238302700000,SE 231,Residential,7950,0,7950,77001,0,84951
142238302800000,SE 231,Residential,9275,0,9275,72080,0,81355
142238302900000,SE 231,Residential,9275,0,9275,41106,0,50381
142238303000000,SE 231,Residential,13515,0,13515,66173,0,79688
142238303100000,SE 231,Residential,5025,0,5025,34342,0,39367
142238303200000,SE 231,Residential,8508,0,8508,37413,0,45921
142240100100000,SE 228,Residential,24479,0,24479,112236,0,136715
142240100200000,SE 228,Residential,25000,0,25000,105945,0,130945
142240100300000,SE 228,Residential,30000,0,30000,153384,0,183384
142240100400000,SE 228,Residential,30000,0,30000,138281,0,168281
142240100500000,SE 228,Residential,30000,0,30000,142752,0,172752
142240100600000,SE 228,Residential,30000,0,30000,124260,0,154260
142240100700000,SE 228,Residential,30000,0,30000,134766,0,164766
142240100800000,SE 228,Residential,30000,0,30000,142860,0,172860
142240100900000,SE 228,Residential,30000,0,30000,131901,0,161901
142240101000000,SE 228,Residential,30716,0,30716,218920,0,249636
142240101100000,SE 228,Residential,27667,0,27667,153630,0,181297
142240101200000,SE 228,Residential,30000,0,30000,177457,0,207457
142240101300000,SE 228,Residential,30000,0,30000,127913,0,157913
142240101400000,SE 228,Residential,30000,0,30000,100350,0,130350
142240101500000,SE 228,Residential,30000,0,30000,142417,0,172417
142240101600000,SE 228,Residential,30000,0,30000,151790,0,181790
142240101700000,SE 228,Residential,33750,0,33750,152424,0,186174
142240101800000,SE 228,Residential,33750,0,33750,141625,0,175375
142240101900000,SE 228,Residential,23999,0,23999,87389,0,111388
142240102000000,SE 228,Residential,20800,0,20800,104220,0,125020
142240102100000,SE 228,Residential,18975,0,18975,106333,0,125308
142240200100000,SE 228,Residential,31034,0,31034,160085,0,191119
142240200200000,SE 228,Residential,25000,0,25000,110563,0,135563
142240200300000,SE 228,Residential,30000,0,30000,131118,0,161118
142240200400000,SE 228,Residential,30000,0,30000,155743,0,185743
142240200500000,SE 228,Residential,30000,0,30000,112721,0,142721
142240200600000,SE 228,Residential,30000,0,30000,144497,0,174497
142240200700000,SE 228,Residential,32000,0,32000,119444,0,151444
142240200800000,SE 228,Residential,25000,0,25000,130846,0,155846
142240200900000,SE 228,Residential,25000,0,25000,110013,0,135013
142240201000000,SE 228,Residential,30716,0,30716,167038,0,197754
142240201100000,SE 228,Residential,10980,0,10980,92628,0,103608
142240201200000,SE 228,Residential,20647,0,20647,91719,0,112366
142240201300000,SE 228,Residential,30000,0,30000,115231,0,145231
142240201400000,SE 228,Residential,30000,0,30000,126781,0,156781
142240201500000,SE 228,Residential,30000,0,30000,161223,0,191223
142240201600000,SE 228,Residential,30000,0,30000,114072,0,144072
142240201700000,SE 228,Residential,30000,0,30000,163824,0,193824
142240201800000,SE 228,Residential,30000,0,30000,109001,0,139001
142240201900000,SE 228,Residential,30000,0,30000,107755,0,137755
142240202000000,SE 228,Residential,30000,0,30000,181877,0,211877
142240202100000,SE 228,Residential,25824,0,25824,129664,0,155488
142240202200000,SE 228,Residential,16000,0,16000,91670,0,107670
142240300100000,SE 228,Residential,26462,0,26462,100248,0,126710
142240300200000,SE 228,Residential,25810,0,25810,93750,0,119560
142240300300000,SE 228,Residential,29610,0,29610,119320,0,148930
142240300400000,SE 228,Residential,30566,0,30566,149166,0,179732
142240300500000,SE 228,Residential,30000,0,30000,222606,0,252606
142240300600000,SE 228,Residential,30000,0,30000,120860,0,150860
142240300700000,SE 228,Residential,30000,0,30000,123745,0,153745
142240300800000,SE 228,Residential,30000,0,30000,112599,0,142599
142240300900000,SE 228,Residential,25824,0,25824,113169,0,138993
142240301000000,SE 228,Residential,16000,0,16000,83495,0,99495
142240301100000,SE 228,Residential,15500,0,15500,100813,0,116313
142240301200000,SE 228,Residential,27141,0,27141,102182,0,129323
142240301300000,SE 228,Residential,36000,0,36000,115527,0,151527
142240301400000,SE 228,Residential,36000,0,36000,216848,0,252848
142240301500000,SE 228,Residential,36000,0,36000,151055,0,187055
142240301600000,SE 228,Residential,36000,0,36000,118477,0,154477
142240301700000,SE 228,Residential,35340,0,35340,192986,0,228326
142240301800000,SE 228,Residential,35340,0,35340,185233,0,220573
142240301900000,SE 228,Residential,37400,0,37400,186491,0,223891
142240302000000,SE 228,Residential,35800,0,35800,135746,0,171546
142240302100000,SE 228,Residential,34987,0,34987,131445,0,166432
142240400100000,SE 228,Residential,26284,0,26284,120087,0,146371
142240400200000,SE 228,Residential,30000,0,30000,75342,0,105342
142240400300000,SE 228,Residential,30000,0,30000,136777,0,166777
142240400400000,SE 228,Residential,30000,0,30000,133548,0,163548
142240400500000,SE 228,Residential,30000,0,30000,99211,0,129211
142240400600000,SE 228,Residential,30000,0,30000,98308,0,128308
142240400700000,SE 228,Residential,30000,0,30000,112832,0,142832
142240400800000,SE 228,Residential,30000,0,30000,132536,0,162536
142240400900000,SE 228,Residential,30000,0,30000,107844,0,137844
142240401000000,SE 228,Residential,27020,0,27020,127607,0,154627
142240401100000,SE 228,Residential,8256,0,8256,102148,0,110404
142240401200000,SE 228,Residential,27667,0,27667,87825,0,115492
142240401300000,SE 228,Residential,30000,0,30000,162564,0,192564
142240401400000,SE 228,Residential,30000,0,30000,125175,0,155175
142240401500000,SE 228,Residential,30000,0,30000,182587,0,212587
142240401600000,SE 228,Residential,30000,0,30000,123960,0,153960
142240401700000,SE 228,Residential,30000,0,30000,150514,0,180514
142240401800000,SE 228,Residential,30000,0,30000,132793,0,162793
142240401900000,SE 228,Residential,30000,0,30000,152186,0,182186
142240402000000,SE 228,Residential,30000,0,30000,157400,0,187400
142240402100000,SE 228,Residential,25824,0,25824,146643,0,172467
142240402200000,SE 228,Residential,16000,0,16000,95524,0,111524
142240500100000,CITY PROPERTY,Exempt,0,0,0,0,0,0
142240600100000,SE 247,Residential,97988,0,97988,218021,0,316009
142240600200000,SE 247,Residential,98158,0,98158,140591,0,238749
142240600300000,SE 247,Residential,102286,0,102286,170048,0,272334
142240600400000,SE 247,Residential,91498,0,91498,232721,0,324219
142240600500000,SE 247,Residential,94874,0,94874,189019,0,283893
142240600600000,SE 247,Residential,73480,0,73480,213738,0,287218
142240600700000,SE 247,Residential,64750,0,64750,158944,0,223694
142240600800000,SE 247,Residential,60720,0,60720,200078,0,260798
142240600900000,SE 247,Residential,77760,0,77760,238533,0,316293
142240601000000,CITY PROPERTY,Exempt,0,0,0,0,0,0
142240601100000,SE 247,Residential,176950,0,176950,323720,0,500670
142240601200000,SE 247,Residential,72896,0,72896,178428,0,251324
142240601300000,SE 247,Residential,94410,0,94410,244588,0,338998
142240601400000,SE 247,Residential,88208,0,88208,215896,0,304104
142240601500000,SE 247,Residential,94041,0,94041,347045,0,441086
142240601600000,SE 247,Residential,900,0,900,0,0,900
142240700100000,SE 247,Residential,175150,0,175150,146520,0,321670
142240800100000,SE 247,Residential,142975,0,142975,260129,0,403104
142240800200000,SE 247,Residential,83250,0,83250,244916,0,328166
142240800300000,SE 230,Residential,52020,0,52020,144650,0,196670
142240800400000,SE 230,Residential,45900,0,45900,141632,0,187532
142240800500000,SE 247,Residential,90000,0,90000,262748,0,352748
142242600100000,SE 230,Residential,13845,0,13845,143142,0,156987
142242600200000,SE 230,Residential,10000,0,10000,103091,0,113091
142242600300000,SE 230,Residential,11250,0,11250,78380,0,89630
142242600400000,SE 230,Residential,12500,0,12500,113880,0,126380
142242600500000,SE 230,Residential,10000,0,10000,87301,0,97301
142242600600000,SE 230,Residential,10000,0,10000,112182,0,122182
142242600700000,SE 230,Residential,10000,0,10000,81933,0,91933
142242600800000,SE 230,Residential,6023,0,6023,93906,0,99929
142242600900000,SE 230,Residential,6524,0,6524,80498,0,87022
142242601000000,SE 230,Residential,5444,0,5444,66901,0,72345
142242601100000,SE 230,Residential,5363,0,5363,63600,0,68963
142242601200000,SE 230,Residential,5606,0,5606,70972,0,76578
142242601300000,SE 230,Residential,5606,0,5606,61313,0,66919
142242601400000,SE 230,Residential,9967,0,9967,76477,0,86444
142242601500000,SE 230,Residential,10000,0,10000,59050,0,69050
142242601600000,SE 230,Residential,10000,0,10000,100640,0,110640
142242601700000,SE 230,Residential,12500,0,12500,75966,0,88466
142242601800000,SE 230,Residential,12500,0,12500,119675,0,132175
142242601900000,SE 230,Residential,10000,0,10000,106577,0,116577
142242602000000,SE 230,Residential,10000,0,10000,78630,0,88630
142242602100000,SE 230,Residential,8959,0,8959,84520,0,93479
142242602200000,SE 230,Residential,10318,0,10318,127672,0,137990
142242602300000,SE 230,Residential,11400,0,11400,83634,0,95034
142242602400000,SE 230,Residential,12174,0,12174,83913,0,96087
142242700100000,SE 230,Residential,8007,0,8007,57147,0,65154
142242700200000,SE 230,Residential,9139,0,9139,49426,0,58565
142242700300000,SE 230,Residential,11278,0,11278,39482,0,50760
142242700400000,CONVERSION,Commercial,0,14262,14262,0,76556,90818
142242700500000,SE 230,Residential,9775,0,9775,43237,0,53012
142242700600000,SE 230,Residential,8343,0,8343,52848,0,61191
142242700700000,SE 230,Residential,12750,0,12750,74929,0,87679
142242700800000,SE 230,Residential,10000,0,10000,58368,0,68368
142242700900000,SE 230,Residential,10000,0,10000,66415,0,76415
142242701000000,SE 230,Residential,10000,0,10000,81558,0,91558
142242701100000,APARTMENT,Commercial,0,13608,13608,0,118065,131673
142242701200000,SMALL RETAIL,Commercial,0,13608,13608,0,54770,68378
142242701300000,SE 230,Residential,4650,0,4650,39946,0,44596
142242701400000,SE 230,Residential,6200,0,6200,52604,0,58804
142242701500000,SE 230,Residential,9900,0,9900,66308,0,76208
142242701600000,SE 230,Residential,9900,0,9900,79440,0,89340
142242701700000,SE 230,Residential,12375,0,12375,98291,0,110666
142242701800000,SE 230,Residential,9735,0,9735,92912,0,102647
142242701900000,SE 230,Residential,9405,0,9405,93336,0,102741
142242702000000,SE 230,Residential,5520,0,5520,52943,0,58463
142242702100000,SE 230,Residential,5911,0,5911,79900,0,85811
142242702200000,SE 230,Residential,5363,0,5363,62350,0,67713
142242702300000,SE 230,Residential,5200,0,5200,66423,0,71623
142242702400000,SE 230,Residential,7700,0,7700,78787,0,86487
142242702500000,SE 230,Residential,7700,0,7700,74833,0,82533
142242800100000,SE 230,Residential,15000,0,15000,85509,0,100509
142242800200000,SE 230,Residential,8050,0,8050,42802,0,50852
142242800300000,SE 230,Residential,9200,0,9200,30336,0,39536
142242800400000,SE 230,Residential,8740,0,8740,78721,0,87461
142242800500000,SE 230,Residential,8510,0,8510,41582,0,50092
142242800600000,SE 230,Residential,8740,0,8740,59424,0,68164
142242800700000,SE 230,Residential,8510,0,8510,37347,0,45857
142242800800000,SMALL RETAIL,Exempt,0,26730,26730,0,127926,154656
142242800900000,SE 230,Residential,5038,0,5038,9756,0,14794
142242801000000,SE 230,Residential,5038,0,5038,50044,0,55082
142242801100000,SE 230,Residential,5813,0,5813,27417,0,33230
142242801200000,SE 230,Exempt,0,5813,5813,0,37131,42944
142242801300000,SE 230,Residential,12750,0,12750,59475,0,72225
142242801400000,SE 230,Residential,7500,0,7500,58287,0,65787
142242801500000,SE 230,Residential,7500,0,7500,59209,0,66709
142242801600000,SE 230,Residential,12750,0,12750,46351,0,59101
142242900100000,SE 230,Residential,10744,0,10744,118415,0,129159
142242900200000,SE 230,Residential,9846,0,9846,58794,0,68640
142242900300000,SE 230,Residential,10000,0,10000,85871,0,95871
142242900400000,SE 230,Residential,10000,0,10000,89211,0,99211
142242900500000,SE 230,Residential,10000,0,10000,92482,0,102482
142242900600000,SE 230,Residential,10000,0,10000,85286,0,95286
142242900700000,SE 230,Residential,7500,0,7500,65074,0,72574
142242900800000,SE 230,Residential,7500,0,7500,63431,0,70931
142242900900000,SE 230,Residential,7500,0,7500,70577,0,78077
142242901000000,SE 230,Residential,8256,0,8256,31744,0,40000
142242901100000,SE 230,Residential,6707,0,6707,76736,0,83443
142242901200000,SE 230,Residential,5444,0,5444,57068,0,62512
142242901300000,SE 230,Residential,5363,0,5363,55756,0,61119
142242901400000,SE 230,Residential,5261,0,5261,51350,0,56611
142242901500000,SE 230,Residential,5951,0,5951,55193,0,61144
142242901600000,SE 230,Residential,6068,0,6068,52473,0,58541
142242901700000,SE 230,Residential,5658,0,5658,51903,0,57561
142242901800000,SE 230,Residential,10000,0,10000,57742,0,67742
142242901900000,SE 230,Residential,10000,0,10000,89823,0,99823
142242902000000,SE 230,Residential,12500,0,12500,68390,0,80890
142242902100000,SE 230,Residential,12500,0,12500,81484,0,93984
142242902200000,SE 230,Residential,10000,0,10000,74191,0,84191
142242902300000,SE 230,Residential,10000,0,10000,110330,0,120330
142242902400000,SE 230,Residential,10000,0,10000,116239,0,126239
142242902500000,SE 230,Residential,10676,0,10676,96736,0,107412
142242902600000,SE 230,Residential,7695,0,7695,83969,0,91664
142242902700000,SE 230,Residential,9300,0,9300,86605,0,95905
142243000100000,SE 230,Residential,6074,0,6074,65847,0,71921
142243000200000,SE 230,Residential,5840,0,5840,73976,0,79816
142243000300000,SE 230,Residential,9500,0,9500,60641,0,70141
142243000400000,SE 230,Residential,9167,0,9167,48636,0,57803
142243000500000,SE 230,Residential,7500,0,7500,60029,0,67529
142243000600000,SE 230,Residential,7500,0,7500,0,0,7500
142243000700000,SE 230,Residential,7500,0,7500,74528,0,82028
142243000800000,SE 230,Residential,10000,0,10000,62378,0,72378
142243000900000,OFFICE,Exempt,0,27216,27216,0,363202,390418
142243001000000,VACANT LAND,Exempt,0,27216,27216,0,32228,59444
142243001100000,APARTMENT,Commercial,0,13608,13608,0,112927,126535
142243001200000,SE 230,Residential,12750,0,12750,59796,0,72546
142243001300000,CONVERSION,Commercial,0,5832,5832,0,91182,97014
142243001400000,SE 230,Residential,6975,0,6975,21405,0,28380
142243001500000,SE 230,Residential,5425,0,5425,46079,0,51504
142243001600000,SE 230,Residential,10000,0,10000,48591,0,58591
142243001700000,SE 230,Residential,12500,0,12500,39122,0,51622
142243001800000,SE 230,Residential,10000,0,10000,53066,0,63066
142243001900000,SE 230,Residential,9833,0,9833,65926,0,75759
142243002000000,SE 230,Residential,9500,0,9500,82321,0,91821
142243002100000,SE 230,Residential,9128,0,9128,65203,0,74331
142243002200000,SE 230,Residential,6000,0,6000,76273,0,82273
142243002300000,SE 230,Residential,5038,0,5038,48690,0,53728
142243002400000,SE 230,Residential,5688,0,5688,84158,0,89846
142243002500000,SE 230,Residential,5606,0,5606,43098,0,48704
142243100100000,SE 230,Residential,7000,0,7000,64600,0,71600
142243100200000,SE 230,Residential,6650,0,6650,53569,0,60219
142243100300000,SE 230,Residential,6650,0,6650,67291,0,73941
142243100400000,SE 230,Residential,9500,0,9500,36180,0,45680
142243100500000,SE 230,Residential,7000,0,7000,67933,0,74933
142243100600000,SE 230,Residential,7000,0,7000,66038,0,73038
142243100700000,SE 230,Residential,7000,0,7000,72053,0,79053
142243100800000,SE 230,Residential,9200,0,9200,70544,0,79744
142243100900000,SE 230,Residential,9200,0,9200,75805,0,85005
142243101000000,SE 230,Residential,9200,0,9200,66981,0,76181
142243101100000,SE 230,Residential,11730,0,11730,83935,0,95665
142243101200000,APARTMENT,Commercial,0,7290,7290,0,96880,104170
142243101300000,SE 230,Residential,4573,0,4573,13241,0,17814
142243101400000,SE 230,Exempt,0,5503,5503,0,71493,76996
142243101500000,SE 230,Residential,7500,0,7500,66430,0,73930
142243101600000,SE 230,Residential,7500,0,7500,61470,0,68970
142243101700000,SE 230,Residential,12750,0,12750,76977,0,89727
142243101800000,SE 230,Residential,10000,0,10000,64599,0,74599
142243101900000,SE 230,Residential,7000,0,7000,70336,0,77336
142243200100000,SE 230,Residential,10776,0,10776,60333,0,71109
142243200200000,SE 230,Residential,9798,0,9798,43600,0,53398
142243200300000,SE 230,Residential,10000,0,10000,108189,0,118189
142243200400000,SE 230,Residential,10000,0,10000,75147,0,85147
142243200500000,SE 230,Residential,10000,0,10000,103216,0,113216
142243200600000,SE 230,Residential,10000,0,10000,102394,0,112394
142243200700000,SE 230,Residential,10000,0,10000,88725,0,98725
142243200800000,SE 230,Residential,7500,0,7500,76347,0,83847
142243200900000,SE 230,Residential,5475,0,5475,58335,0,63810
142243201000000,SE 230,Residential,10026,0,10026,103451,0,113477
142243201100000,SE 230,Residential,11741,0,11741,78813,0,90554
142243201200000,SE 230,Residential,5606,0,5606,57104,0,62710
142243201300000,SE 230,Residential,5606,0,5606,49234,0,54840
142243201400000,SE 230,Residential,6068,0,6068,93845,0,99913
142243201500000,SE 230,Residential,5658,0,5658,62263,0,67921
142243201600000,SE 230,Residential,10000,0,10000,62662,0,72662
142243201700000,SE 230,Residential,10000,0,10000,87865,0,97865
142243201800000,SE 230,Residential,7500,0,7500,58617,0,66117
142243201900000,SE 230,Residential,10000,0,10000,82231,0,92231
142243202000000,SE 230,Residential,7500,0,7500,60119,0,67619
142243202100000,SE 230,Residential,10000,0,10000,88855,0,98855
142243202200000,SE 230,Residential,10000,0,10000,69272,0,79272
142243202300000,SE 230,Residential,10000,0,10000,79609,0,89609
142243202400000,SE 230,Residential,12382,0,12382,78994,0,91376
142243202500000,SE 230,Residential,8550,0,8550,98074,0,106624
142243202600000,SE 230,Residential,9873,0,9873,72214,0,82087
142243300100000,SE 230,Residential,6141,0,6141,45684,0,51825
142243300200000,SE 230,Residential,5840,0,5840,43246,0,49086
142243300300000,SE 230,Residential,9500,0,9500,53150,0,62650
142243300400000,SE 230,Residential,9167,0,9167,85514,0,94681
142243300500000,SE 230,Residential,11250,0,11250,67959,0,79209
142243300600000,SE 230,Residential,8750,0,8750,60715,0,69465
142243300700000,SE 230,Residential,10000,0,10000,79356,0,89356
142243300800000,SE 230,Residential,10000,0,10000,50245,0,60245
142243300900000,SE 230,Residential,10000,0,10000,92805,0,102805
142243301000000,CONVERSION,Commercial,0,9299,9299,0,74057,83356
142243301100000,APARTMENT,Commercial,0,11113,11113,0,107792,118905
142243301200000,SE 230,Residential,6125,0,6125,40973,0,47098
142243301300000,SE 230,Residential,6125,0,6125,62508,0,68633
142243301400000,SE 230,Residential,6125,0,6125,21412,0,27537
142243301500000,SE 230,Residential,6125,0,6125,61690,0,67815
142243301600000,SE 230,Residential,10000,0,10000,66180,0,76180
142243301700000,SE 230,Residential,10000,0,10000,84548,0,94548
142243301800000,SE 230,Residential,10000,0,10000,74301,0,84301
142243301900000,SE 230,Residential,11250,0,11250,78641,0,89891
142243302000000,CENTRALLY ASSESSED,Other,0,0,0,0,0,0
142243302100000,SE 230,Residential,11626,0,11626,33032,0,44658
142243302200000,SE 230,Residential,9833,0,9833,48624,0,58457
142243302300000,SE 230,Residential,8645,0,8645,40177,0,48822
142243302400000,SE 230,Residential,5840,0,5840,60644,0,66484
142243302500000,SE 230,Residential,6050,0,6050,45921,0,51971
142243302600000,SE 230,Residential,5200,0,5200,54245,0,59445
142243302700000,SE 230,Residential,7069,0,7069,68450,0,75519
142243302800000,SE 230,Residential,6125,0,6125,65640,0,71765
142243302900000,SE 230,Residential,5175,0,5175,45550,0,50725
142243400100000,SE 230,Residential,9945,0,9945,72375,0,82320
142243400200000,SE 230,Residential,14000,0,14000,60433,0,74433
142243400300000,SE 230,Residential,10000,0,10000,80866,0,90866
142243400400000,SE 230,Residential,9750,0,9750,68913,0,78663
142243400500000,SE 230,Residential,10000,0,10000,38732,0,48732
142243400600000,SE 230,Residential,8434,0,8434,57977,0,66411
142243400700000,SE 230,Residential,5344,0,5344,78862,0,84206
142243400800000,SE 230,Residential,5344,0,5344,37958,0,43302
142243400900000,SE 230,Residential,7705,0,7705,68838,0,76543
142243401000000,SE 230,Residential,5025,0,5025,54790,0,59815
142243401100000,SE 230,Residential,5445,0,5445,45086,0,50531
142243401200000,SE 230,Residential,5445,0,5445,38549,0,43994
142243401300000,SE 230,Residential,10083,0,10083,41668,0,51751
142243401400000,SE 230,Residential,9917,0,9917,47437,0,57354
142243401500000,SE 230,Residential,9750,0,9750,50907,0,60657
142243401600000,SE 230,Residential,6125,0,6125,58653,0,64778
142243401700000,SE 230,Residential,7875,0,7875,63233,0,71108
142243401800000,SE 230,Residential,6650,0,6650,41636,0,48286
142243401900000,SE 230,Residential,6650,0,6650,45299,0,51949
142243402000000,SE 230,Residential,4988,0,4988,29941,0,34929
142243402100000,SE 230,Residential,2993,0,2993,22345,0,25338
142243500100000,SE 230,Residential,12892,0,12892,131231,0,144123
142243500200000,SE 230,Residential,9300,0,9300,65010,0,74310
142243500300000,SE 230,Residential,10000,0,10000,70101,0,80101
142243500400000,SE 230,Residential,10000,0,10000,81568,0,91568
142243500500000,SE 230,Residential,10000,0,10000,84814,0,94814
142243500600000,SE 230,Residential,10000,0,10000,103028,0,113028
142243500700000,SE 230,Residential,9778,0,9778,77222,0,87000
142243500800000,SE 230,Residential,10000,0,10000,110479,0,120479
142243500900000,SE 230,Residential,10000,0,10000,92582,0,102582
142243501000000,SE 230,Residential,7300,0,7300,60993,0,68293
142243501100000,SE 230,Residential,8897,0,8897,92259,0,101156
142243501200000,SE 230,Residential,6500,0,6500,63655,0,70155
142243501300000,SE 230,Residential,6419,0,6419,55697,0,62116
142243600100000,SE 230,Residential,6141,0,6141,66086,0,72227
142243600200000,SE 230,Residential,5840,0,5840,44865,0,50705
142243600300000,SE 230,Residential,9500,0,9500,64074,0,73574
142243600400000,SE 230,Residential,9167,0,9167,70397,0,79564
142243600500000,SE 230,Residential,12558,0,12558,66194,0,78752
142243600600000,SE 230,Residential,10000,0,10000,76709,0,86709
142243600700000,SE 230,Residential,10000,0,10000,65312,0,75312
142243600800000,SE 230,Residential,10000,0,10000,57789,0,67789
142243600900000,SE 230,Residential,10000,0,10000,77003,0,87003
142243601000000,SE 230,Residential,10250,0,10250,90443,0,100693
142243601100000,SE 230,Residential,6358,0,6358,75540,0,81898
142243601200000,SE 230,Residential,10111,0,10111,84619,0,94730
142243601300000,SE 230,Residential,5513,0,5513,68214,0,73727
142243601400000,SE 230,Residential,5779,0,5779,68156,0,73935
142243700100000,SE 230,Residential,6942,0,6942,46121,0,53063
142243700200000,SE 230,Residential,7000,0,7000,71797,0,78797
142243700300000,SE 230,Residential,10000,0,10000,73448,0,83448
142243700400000,SE 230,Residential,10000,0,10000,66385,0,76385
142243700500000,SE 230,Residential,10000,0,10000,51692,0,61692
142243700600000,SE 230,Residential,6125,0,6125,40965,0,47090
142243700700000,SE 230,Residential,6125,0,6125,68893,0,75018
142243700800000,SE 230,Residential,6125,0,6125,54302,0,60427
142243700900000,SE 230,Residential,6125,0,6125,0,0,6125
142243701000000,SE 230,Residential,6650,0,6650,62164,0,68814
142243701100000,SE 230,Residential,6650,0,6650,72814,0,79464
142245100100000,SE 230,Residential,8550,0,8550,44174,0,52724
142245100200000,SE 230,Residential,10925,0,10925,114056,0,124981
142245100300000,SE 230,Residential,7500,0,7500,86900,0,94400
142245100400000,SE 230,Residential,7500,0,7500,88171,0,95671
142245100500000,SE 230,Residential,10000,0,10000,72555,0,82555
142245100600000,SE 230,Residential,10000,0,10000,79699,0,89699
142245100700000,SE 230,Residential,10000,0,10000,80336,0,90336
142245100800000,SE 230,Residential,10000,0,10000,95418,0,105418
142245100900000,SE 230,Residential,14000,0,14000,107835,0,121835
142245101000000,SE 230,Residential,5606,0,5606,56379,0,61985
142245101100000,SE 230,Residential,5606,0,5606,48391,0,53997
142245101200000,SE 230,Residential,6068,0,6068,66576,0,72644
142245101300000,SE 230,Residential,5658,0,5658,64975,0,70633
142245200100000,SE 230,Residential,5931,0,5931,67491,0,73422
142245200200000,SE 230,Residential,8694,0,8694,62197,0,70891
142245200300000,SE 230,Residential,7510,0,7510,57475,0,64985
142245200400000,SE 230,Residential,9851,0,9851,55169,0,65020
142245200500000,SE 230,Residential,14641,0,14641,98558,0,113199
142245200600000,SE 230,Residential,10000,0,10000,60113,0,70113
142245200700000,SE 230,Residential,8750,0,8750,68876,0,77626
142245200800000,SE 230,Residential,11250,0,11250,85869,0,97119
142245200900000,SE 230,Residential,10000,0,10000,73986,0,83986
142245201000000,SE 230,Residential,10125,0,10125,49721,0,59846
142245201100000,SE 230,Residential,8300,0,8300,72410,0,80710
142245201200000,SE 230,Residential,8638,0,8638,75878,0,84516
142245300100000,SE 230,Residential,6650,0,6650,37051,0,43701
142245300200000,SE 230,Residential,6650,0,6650,43962,0,50612
142245300300000,SE 230,Residential,7000,0,7000,47981,0,54981
142245300400000,SE 230,Residential,7000,0,7000,42271,0,49271
142245300500000,SE 230,Residential,10000,0,10000,71052,0,81052
142245300600000,SE 230,Residential,10000,0,10000,68319,0,78319
142245300700000,SE 230,Residential,10000,0,10000,78681,0,88681
142245300800000,SE 230,Residential,6125,0,6125,44999,0,51124
142245300900000,SE 230,Residential,6125,0,6125,59514,0,65639
142245301100000,SE 230,Residential,6125,0,6125,43922,0,50047
142245302000000,SE 230,Residential,6125,0,6125,48832,0,54957
142245400100000,SE 230,Residential,9825,0,9825,98248,0,108073
142245400200000,SE 230,Residential,9800,0,9800,101214,0,111014
142245400300000,SE 230,Residential,9800,0,9800,102081,0,111881
142245400400000,SE 230,Residential,9800,0,9800,71448,0,81248
142245400500000,SE 230,Residential,7350,0,7350,79189,0,86539
142245400600000,SE 230,Residential,7350,0,7350,79349,0,86699
142245400700000,SE 230,Residential,9800,0,9800,62774,0,72574
142245400800000,SE 230,Residential,9800,0,9800,67254,0,77054
142245400900000,SE 230,Residential,9971,0,9971,95029,0,105000
142245401000000,SE 230,Residential,7840,0,7840,79062,0,86902
142245401100000,SE 230,Residential,8167,0,8167,82845,0,91012
142245401200000,SE 230,Residential,8029,0,8029,69686,0,77715
142245401300000,SE 230,Residential,5033,0,5033,61401,0,66434
142245401400000,SE 230,Residential,5528,0,5528,76596,0,82124
142245401500000,SE 230,Residential,5858,0,5858,82858,0,88716
142245401600000,SE 230,Residential,7500,0,7500,85530,0,93030
142245401700000,SE 230,Residential,8000,0,8000,69845,0,77845
142245401800000,SE 230,Residential,8500,0,8500,94273,0,102773
142245401900000,SE 230,Residential,11115,0,11115,98864,0,109979
142245402000000,SE 230,Residential,8760,0,8760,70688,0,79448
142245402100000,SE 230,Residential,10408,0,10408,95323,0,105731
142245402200000,SE 230,Residential,9150,0,9150,90519,0,99669
142245500100000,SE 230,Residential,7438,0,7438,80725,0,88163
142245500200000,SE 230,Residential,7650,0,7650,38710,0,46360
142245500300000,SE 230,Residential,10633,0,10633,97101,0,107734
142245500400000,SE 230,Residential,10000,0,10000,66725,0,76725
142245500500000,SE 230,Residential,10000,0,10000,71018,0,81018
142245500600000,SE 230,Residential,10000,0,10000,84023,0,94023
142245500700000,SE 230,Residential,10000,0,10000,93511,0,103511
142245500800000,SE 230,Residential,10305,0,10305,94635,0,104940
142245500900000,SE 230,Residential,10498,0,10498,83910,0,94408
142245501000000,SE 230,Residential,7988,0,7988,82716,0,90704
142245501100000,SE 230,Residential,11125,0,11125,67925,0,79050
142245501200000,SE 230,Residential,10738,0,10738,72619,0,83357
142245501300000,SE 230,Residential,8300,0,8300,66678,0,74978
142245501400000,SE 230,Residential,14000,0,14000,119637,0,133637
142245501500000,SE 230,Residential,11500,0,11500,80951,0,92451
142245501600000,SE 230,Residential,13400,0,13400,124384,0,137784
142245501700000,SE 230,Residential,9583,0,9583,84922,0,94505
142245501800000,SE 230,Residential,11500,0,11500,81132,0,92632
142245501900000,SE 230,Residential,11375,0,11375,95356,0,106731
142245502000000,SE 230,Residential,10800,0,10800,83971,0,94771
142245502100000,SE 230,Residential,10575,0,10575,73794,0,84369
142245502200000,SE 230,Residential,8800,0,8800,77214,0,86014
142245502300000,SE 230,Residential,8700,0,8700,72926,0,81626
142245502400000,SE 230,Residential,8600,0,8600,70106,0,78706
142245502500000,SE 230,Residential,8091,0,8091,66515,0,74606
142245502600000,SE 230,Residential,7400,0,7400,54959,0,62359
142245502700000,SE 230,Residential,7500,0,7500,64902,0,72402
142245502800000,SE 230,Residential,7500,0,7500,0,0,7500
142245502900000,SE 230,Residential,7306,0,7306,64194,0,71500
142245503000000,SE 230,Residential,9200,0,9200,87678,0,96878
142245503100000,SE 230,Residential,9100,0,9100,73806,0,82906
142245503200000,SE 230,Residential,9100,0,9100,72401,0,81501
142245503300000,SE 230,Residential,10125,0,10125,86169,0,96294
142245503400000,SE 230,Residential,11250,0,11250,75675,0,86925
142245503500000,SE 230,Residential,11125,0,11125,75750,0,86875
142245503600000,SE 230,Residential,10375,0,10375,67900,0,78275
142245503700000,SE 230,Residential,10513,0,10513,67792,0,78305
142245503800000,SE 230,Residential,13500,0,13500,81825,0,95325
142245503900000,SE 230,Residential,10300,0,10300,66712,0,77012
142245504000000,SE 230,Residential,10100,0,10100,63275,0,73375
142245504100000,SE 230,Residential,9900,0,9900,58364,0,68264
142245504200000,SE 230,Residential,6873,0,6873,43127,0,50000
142245504300000,SE 230,Residential,7310,0,7310,50432,0,57742
142245600100000,SE 230,Residential,10000,0,10000,54835,0,64835
142245600200000,SE 230,Residential,10000,0,10000,55601,0,65601
142245600300000,SE 230,Residential,10000,0,10000,83035,0,93035
142245600400000,SE 230,Residential,10000,0,10000,54752,0,64752
142245600500000,SE 230,Residential,10000,0,10000,41470,0,51470
142245600600000,SE 230,Residential,6125,0,6125,36456,0,42581
142245600700000,SE 230,Residential,6125,0,6125,43801,0,49926
142245600800000,SE 230,Residential,6125,0,6125,46062,0,52187
142245600900000,SE 230,Residential,6125,0,6125,39369,0,45494
142245601000000,SE 230,Residential,5688,0,5688,48829,0,54517
142245601100000,SE 230,Residential,5688,0,5688,56623,0,62311
142245601200000,SE 230,Residential,6388,0,6388,55534,0,61922
142245601300000,SE 230,Residential,6388,0,6388,45113,0,51501
142245601400000,SE 230,Residential,10000,0,10000,49789,0,59789
142245601500000,SE 230,Residential,10000,0,10000,88287,0,98287
142245601600000,SE 230,Residential,14000,0,14000,89999,0,103999
142245601700000,SE 230,Residential,10000,0,10000,70780,0,80780
142245700100000,SE 230,Residential,13680,0,13680,89010,0,102690
142245700200000,SE 230,Residential,9300,0,9300,76421,0,85721
142245700300000,SE 230,Residential,9600,0,9600,94439,0,104039
142245700400000,SE 230,Residential,9700,0,9700,82535,0,92235
142245700500000,SE 230,Residential,9900,0,9900,91611,0,101511
142245700600000,SE 230,Residential,8900,0,8900,72261,0,81161
142245700700000,SE 230,Residential,13362,0,13362,74058,0,87420
142245700800000,SE 230,Residential,7700,0,7700,62384,0,70084
142245700900000,SE 230,Residential,10300,0,10300,64873,0,75173
142245701000000,SE 230,Residential,10300,0,10300,71260,0,81560
142245701100000,SE 230,Residential,10300,0,10300,69044,0,79344
142245701200000,SE 230,Residential,10400,0,10400,74927,0,85327
142245701300000,SE 230,Residential,10400,0,10400,64759,0,75159
142245701400000,SE 230,Residential,8194,0,8194,68672,0,76866
142245701500000,SE 230,Residential,7700,0,7700,65042,0,72742
142245701600000,SE 230,Residential,7700,0,7700,77103,0,84803
142245701700000,SE 230,Residential,7347,0,7347,37287,0,44634
142245701800000,SE 230,Residential,10240,0,10240,57464,0,67704
142245701900000,SE 230,Residential,7700,0,7700,66494,0,74194
142245702000000,SE 230,Residential,7700,0,7700,65391,0,73091
142245702100000,SE 230,Residential,7610,0,7610,78490,0,86100
142245702200000,SE 230,Residential,11280,0,11280,81928,0,93208
142245702300000,SE 230,Residential,12480,0,12480,85939,0,98419
142245702400000,SE 230,Residential,12480,0,12480,98085,0,110565
142245702500000,SE 230,Residential,12480,0,12480,83809,0,96289
142245702600000,SE 230,Residential,12480,0,12480,86603,0,99083
142245702700000,SE 230,Residential,9960,0,9960,84882,0,94842
142245800100000,SE 230,Residential,11403,0,11403,78888,0,90291
142245800200000,SE 230,Residential,11000,0,11000,94852,0,105852
142245800300000,SE 230,Residential,11000,0,11000,63831,0,74831
142245800400000,SE 230,Residential,11000,0,11000,73735,0,84735
142245800500000,SE 230,Residential,12161,0,12161,89259,0,101420
142245800600000,SE 230,Residential,15970,0,15970,75164,0,91134
142245800700000,SE 230,Residential,16078,0,16078,99303,0,115381
142245800800000,SE 230,Residential,16078,0,16078,121034,0,137112
142245800900000,SE 230,Residential,16187,0,16187,115607,0,131794
142245801000000,SE 230,Residential,18000,0,18000,108745,0,126745
142245801100000,SR/NURSING/ASSTD LIV,Commercial,0,369360,369360,0,1790492,2159852
142245801200000,SE 230,Residential,9450,0,9450,58146,0,67596
142245801300000,SE 230,Residential,9425,0,9425,94065,0,103490
142245801400000,SE 230,Residential,9315,0,9315,67880,0,77195
142245801500000,SE 230,Residential,6388,0,6388,52611,0,58999
142245801600000,SE 230,Residential,6929,0,6929,63884,0,70813
142245801700000,SE 230,Residential,5769,0,5769,75637,0,81406
142245801800000,SE 230,Residential,5688,0,5688,62124,0,67812
142245801900000,SE 230,Residential,10220,0,10220,108350,0,118570
142245802000000,SE 230,Residential,6846,0,6846,79988,0,86834
142245802100000,SE 230,Residential,6650,0,6650,50947,0,57597
142245802200000,SE 230,Residential,9563,0,9563,54312,0,63875
142245802300000,SE 230,Residential,9563,0,9563,76563,0,86126
142245802400000,SE 230,Residential,9563,0,9563,63947,0,73510
142245802500000,SE 230,Residential,8738,0,8738,60298,0,69036
142245802600000,SE 230,Residential,14300,0,14300,98071,0,112371
142245802700000,SE 230,Residential,16215,0,16215,84066,0,100281
142245802800000,SE 230,Residential,13675,0,13675,80308,0,93983
142245802900000,SE 230,Residential,13675,0,13675,70424,0,84099
142245803000000,SE 230,Residential,12627,0,12627,56096,0,68723
142245900100000,APARTMENT,Commercial,0,10823,10823,0,91119,101942
142245900200000,SE 230,Residential,11025,0,11025,72965,0,83990
142245900300000,SE 230,Residential,7300,0,7300,46346,0,53646
142245900400000,SE 230,Residential,5475,0,5475,50506,0,55981
142245900500000,SE 230,Residential,6388,0,6388,44961,0,51349
142245900600000,SE 230,Residential,6750,0,6750,69736,0,76486
142245900700000,SE 230,Residential,9785,0,9785,55593,0,65378
142245900800000,SE 230,Residential,9500,0,9500,80287,0,89787
142245900900000,SE 230,Residential,9500,0,9500,87853,0,97353
142245901000000,SE 230,Residential,18011,0,18011,100832,0,118843
142245901100000,SE 230,Residential,15434,0,15434,84683,0,100117
142245901200000,SE 230,Residential,9315,0,9315,86081,0,95396
142245901300000,SE 230,Residential,9419,0,9419,85791,0,95210
142245901400000,SE 230,Residential,13623,0,13623,85416,0,99039
142245901500000,SE 230,Residential,38556,0,38556,224417,0,262973
142245901600000,APARTMENT,Commercial,0,17982,17982,0,107049,125031
142245901700000,CONVERSION,Commercial,0,8879,8879,0,77283,86162
142246000100000,SE 230,Residential,6728,0,6728,64089,0,70817
142246000200000,SE 230,Residential,6388,0,6388,75225,0,81613
142246000300000,SE 230,Residential,10100,0,10100,65815,0,75915
142246000400000,SE 230,Residential,10100,0,10100,71977,0,82077
142246000500000,SE 230,Residential,10100,0,10100,57019,0,67119
142246000600000,SE 230,Residential,10100,0,10100,75616,0,85716
142246000700000,SE 230,Residential,10100,0,10100,116274,0,126374
142246000800000,SE 230,Residential,6563,0,6563,65444,0,72007
142246000900000,SE 230,Residential,6369,0,6369,78355,0,84724
142246001000000,SE 230,Residential,6030,0,6030,80663,0,86693
142246001100000,SE 230,Residential,5695,0,5695,75576,0,81271
142246001200000,SE 230,Residential,5931,0,5931,47765,0,53696
142246001300000,SE 230,Residential,5850,0,5850,73695,0,79545
142246001400000,SE 230,Residential,6503,0,6503,67882,0,74385
142246001500000,SE 230,Residential,6388,0,6388,13631,0,20019
142246001600000,SE 230,Residential,10000,0,10000,72432,0,82432
142246001700000,SE 230,Residential,9900,0,9900,66303,0,76203
142246001800000,SE 230,Residential,9900,0,9900,66296,0,76196
142246001900000,SE 230,Residential,9900,0,9900,89248,0,99148
142246002000000,SE 230,Residential,9900,0,9900,62378,0,72278
142246002100000,SE 230,Residential,9758,0,9758,68527,0,78285
142246002200000,SE 230,Residential,7118,0,7118,55362,0,62480
142246002300000,SE 230,Residential,7020,0,7020,66591,0,73611
142246002400000,SE 230,Residential,7980,0,7980,64667,0,72647
142246002500000,SE 230,Residential,7875,0,7875,56037,0,63912
142246100100000,SE 230,Residential,15606,0,15606,85167,0,100773
142246100200000,SE 230,Residential,19140,0,19140,125603,0,144743
142246100300000,SE 230,Residential,16141,0,16141,140411,0,156552
142246100400000,SE 230,Residential,12750,0,12750,66220,0,78970
142246100500000,SE 230,Residential,13393,0,13393,102565,0,115958
142246100600000,SE 230,Residential,16575,0,16575,68421,0,84996
142246100700000,SE 230,Residential,2419,0,2419,0,0,2419
142247600100000,SE 247,Residential,96603,0,96603,335013,0,431616
142247600200000,SE 247,Residential,93133,0,93133,348017,0,441150
142247600300000,SE 247,Residential,95016,0,95016,231567,0,326583
142247600400000,SE 247,Residential,95958,0,95958,238833,0,334791
142247700100000,SE 247,Residential,130711,0,130711,339835,0,470546
142247700200000,SE 247,Residential,93886,0,93886,223549,0,317435
142247700300000,SE 247,Residential,93789,0,93789,160368,0,254157
142247700400000,SE 247,Residential,91545,0,91545,205041,0,296586
142247700500000,SE 247,Residential,90581,0,90581,176402,0,266983
142247700600000,SE 247,Residential,131133,0,131133,188867,0,320000
142247800100000,SE 247,Residential,181600,0,181600,456972,0,638572
142247800200000,SE 247,Residential,91282,0,91282,271274,0,362556
142247800300000,SE 247,Residential,91282,0,91282,316485,0,407767
142247800400000,SE 247,Residential,148400,0,148400,0,0,148400
142247800500000,SE 247,Residential,95962,0,95962,178907,0,274869
142247900100000,SE 247,Residential,90000,0,90000,277144,0,367144
142247900200000,SE 230,Residential,45900,0,45900,174412,0,220312
142247900300000,SE 230,Residential,46535,0,46535,108465,0,155000
142247900400000,SE 247,Residential,93880,0,93880,211355,0,305235
142247900500000,SE 247,Residential,90000,0,90000,200973,0,290973
142248000100000,SE 247,Residential,48609,0,48609,100351,0,148960
142248000200000,SE 247,Residential,62667,0,62667,144197,0,206864
142248000300000,SE 247,Residential,63997,0,63997,133409,0,197406
142248000400000,SE 247,Residential,64800,0,64800,117300,0,182100
142248000500000,SE 230,Residential,21398,0,21398,141312,0,162710
142248000600000,SE 230,Residential,15000,0,15000,107662,0,122662
142248000700000,SE 230,Residential,15800,0,15800,99825,0,115625
142248100100000,SE 247,Residential,64555,0,64555,184274,0,248829
142248100200000,SE 247,Residential,79459,0,79459,167548,0,247007
142248100300000,SE 247,Residential,53994,0,53994,116685,0,170679
142248100400000,SE 247,Residential,51837,0,51837,104028,0,155865
142248100500000,SE 230,Residential,24750,0,24750,108602,0,133352
142248100600000,SE 230,Residential,24750,0,24750,62380,0,87130
142248100700000,SE 230,Residential,24750,0,24750,124046,0,148796
142248100800000,SE 247,Residential,45424,0,45424,99382,0,144806
142248100900000,SE 247,Residential,45424,0,45424,121309,0,166733
142248101000000,SE 247,Residential,48573,0,48573,129032,0,177605
142248101100000,SE 247,Residential,51857,0,51857,142348,0,194205
142248200100000,SE 247,Residential,87075,0,87075,226199,0,313274
142248200200000,SE 247,Residential,52920,0,52920,135694,0,188614
142248200300000,SE 247,Residential,52920,0,52920,147383,0,200303
142248200400000,SE 230,Residential,24750,0,24750,89628,0,114378
142248200500000,SE 230,Residential,24750,0,24750,106956,0,131706
142248200600000,SE 230,Residential,24750,0,24750,89236,0,113986
142248200700000,SE 230,Residential,24750,0,24750,72981,0,97731
142248200800000,SE 230,Residential,25245,0,25245,109870,0,135115
142248200900000,SE 230,Residential,19800,0,19800,83173,0,102973
142248201000000,CITY PROPERTY,Exempt,0,0,0,0,0,0
142248201100000,SE 230,Residential,24750,0,24750,100491,0,125241
142248201200000,SE 230,Residential,24750,0,24750,74247,0,98997
142248201300000,SE 230,Residential,24750,0,24750,107648,0,132398
142248201400000,SE 230,Residential,24750,0,24750,88940,0,113690
142248201500000,SE 230,Residential,24750,0,24750,134247,0,158997
142248300100000,SE 230,Residential,17600,0,17600,107105,0,124705
142248300200000,SE 230,Residential,30400,0,30400,129709,0,160109
142248300300000,SE 230,Residential,30400,0,30400,99357,0,129757
142248300400000,SE 230,Residential,30000,0,30000,79695,0,109695
142248300500000,SE 230,Residential,18620,0,18620,89357,0,107977
142248300600000,SE 230,Residential,16660,0,16660,70304,0,86964
142248300700000,SE 230,Residential,19600,0,19600,75154,0,94754
142248300800000,SE 230,Residential,19600,0,19600,100823,0,120423
142248300900000,SE 230,Residential,21560,0,21560,90754,0,112314
142248301000000,SE 230,Residential,11160,0,11160,112832,0,123992
142248301100000,SE 230,Residential,11160,0,11160,82714,0,93874
142248301200000,SE 230,Residential,11160,0,11160,77154,0,88314
142248301300000,SE 230,Residential,11160,0,11160,88482,0,99642
142248301400000,SE 230,Residential,11160,0,11160,90596,0,101756
142248301500000,SE 230,Residential,8640,0,8640,90744,0,99384
142248301600000,SE 230,Residential,8640,0,8640,75891,0,84531
142248301700000,SE 230,Residential,15200,0,15200,77675,0,92875
142248301800000,SE 230,Residential,22270,0,22270,84804,0,107074
142248301900000,SE 230,Residential,19380,0,19380,45955,0,65335
142248302000000,SE 230,Residential,22950,0,22950,64564,0,87514
142248302100000,SE 230,Residential,24480,0,24480,109571,0,134051
142248302200000,SE 230,Residential,20200,0,20200,81560,0,101760
142248302300000,SE 230,Residential,20000,0,20000,97587,0,117587
142248302400000,SE 230,Residential,16000,0,16000,80171,0,96171
142248302500000,SE 230,Residential,16000,0,16000,95128,0,111128
142248302600000,SE 230,Residential,26606,0,26606,123394,0,150000
142248302700000,SE 230,Residential,17600,0,17600,106354,0,123954
142248302800000,SE 230,Residential,17600,0,17600,60287,0,77887
142248302900000,SE 230,Residential,17600,0,17600,67482,0,85082
142248303000000,SE 230,Residential,17600,0,17600,72814,0,90414
142248303100000,SE 230,Residential,17600,0,17600,76994,0,94594
142248303200000,SE 230,Residential,17600,0,17600,87799,0,105399
142248400100000,SE 247,Residential,60107,0,60107,116157,0,176264
142248400200000,SE 247,Residential,48830,0,48830,148330,0,197160
142248400300000,SE 247,Residential,50234,0,50234,121678,0,171912
142248400400000,SE 247,Residential,52906,0,52906,164395,0,217301
142248400500000,SE 235,Residential,21574,0,21574,87169,0,108743
142248400600000,SE 235,Residential,23415,0,23415,69722,0,93137
142248400700000,SE 235,Residential,22488,0,22488,78675,0,101163
142248400800000,SE 235,Residential,17500,0,17500,81741,0,99241
142248400900000,SE 235,Residential,17500,0,17500,68531,0,86031
142248500100000,SE 230,Residential,17600,0,17600,94855,0,112455
142248500200000,SE 230,Residential,21330,0,21330,74344,0,95674
142248500300000,SE 230,Residential,21330,0,21330,89751,0,111081
142248500400000,SE 230,Residential,21330,0,21330,68702,0,90032
142248500500000,SE 230,Residential,15200,0,15200,72631,0,87831
142248500600000,SE 230,Residential,15200,0,15200,80037,0,95237
142248500700000,SE 230,Residential,25840,0,25840,93750,0,119590
142248500800000,SE 230,Residential,16000,0,16000,73563,0,89563
142248500900000,SE 230,Residential,16000,0,16000,66895,0,82895
142248501000000,SE 230,Residential,15200,0,15200,69910,0,85110
142248501100000,SE 230,Residential,15200,0,15200,74455,0,89655
142248501200000,SE 230,Residential,22572,0,22572,67650,0,90222
142248501300000,SE 230,Residential,10950,0,10950,77045,0,87995
142248501400000,SE 230,Residential,10950,0,10950,76001,0,86951
142248501500000,SE 230,Residential,14050,0,14050,92386,0,106436
142248501600000,CONVENIENCE STORE,Commercial,0,58061,58061,0,177212,235273
142248501700000,SMALL RETAIL,Commercial,0,51011,51011,0,95555,146566
142248501800000,FLAT PARKING,Commercial,0,63452,63452,0,4060,67512
142248501900000,SE 230,Residential,18240,0,18240,56892,0,75132
142248502000000,SE 230,Residential,18970,0,18970,79523,0,98493
142248502100000,SE 230,Residential,18970,0,18970,94301,0,113271
142248502200000,SE 230,Residential,18240,0,18240,50397,0,68637
142248502300000,SE 230,Residential,18240,0,18240,61465,0,79705
142248502400000,SE 230,Residential,14250,0,14250,58464,0,72714
142248502500000,SE 230,Residential,14250,0,14250,63074,0,77324
142248502600000,SE 230,Residential,17600,0,17600,87728,0,105328
142248502700000,SE 230,Residential,17600,0,17600,64662,0,82262
142248502800000,SE 230,Residential,17600,0,17600,65141,0,82741
142310100100000,SE 212,Residential,5450,0,5450,0,0,5450
142310100200000,SE 212,Residential,126200,0,126200,265814,0,392014
142310100300000,SE 212,Residential,118692,0,118692,542270,0,660962
142310100400000,SE 212,Residential,130950,0,130950,373214,0,504164
142310100500000,SE 212,Residential,94735,0,94735,238976,0,333711
142310100600000,SE 212,Residential,89706,0,89706,327915,0,417621
142310100700000,SE 212,Residential,94002,0,94002,310070,0,404072
142310100800000,SE 212,Residential,85406,0,85406,283746,0,369152
142310100900000,SE 212,Residential,91060,0,91060,296581,0,387641
142310101000000,SE 212,Residential,128300,0,128300,527750,0,656050
142310101100000,SE 212,Residential,89779,0,89779,337322,0,427101
142310101200000,SE 211,Residential,35904,0,35904,200961,0,236865
142310101300000,SE 211,Residential,34680,0,34680,165076,0,199756
142310101400000,SE 211,Residential,34680,0,34680,148040,0,182720
142310101500000,SE 211,Residential,35092,0,35092,177095,0,212187
142310101600000,SE 211,Residential,33858,0,33858,180777,0,214635
142310101700000,SE 211,Residential,37120,0,37120,209228,0,246348
142310101800000,SE 211,Residential,38972,0,38972,256954,0,295926
142310101900000,SE 212,Residential,88400,0,88400,312853,0,401253
142310102000000,SE 212,Residential,84032,0,84032,0,0,84032
142310102100000,SE 212,Residential,101419,0,101419,365664,0,467083
142310102200000,SE 212,Residential,103369,0,103369,257507,0,360876
142310102300000,SE 211,Residential,38500,0,38500,198729,0,237229
142310102400000,SE 211,Residential,38149,0,38149,229572,0,267721
142310102500000,SE 211,Residential,35934,0,35934,192754,0,228688
142310102600000,SE 211,Residential,34688,0,34688,184681,0,219369
142310102700000,SE 211,Residential,37845,0,37845,174658,0,212503
142310102800000,SE 211,Residential,38089,0,38089,225006,0,263095
142310102900000,SE 211,Residential,34248,0,34248,145725,0,179973
142310103000000,SE 211,Residential,34680,0,34680,136352,0,171032
142310103100000,SE 211,Residential,34680,0,34680,137399,0,172079
142310103200000,SE 211,Residential,34680,0,34680,160723,0,195403
142310103300000,SE 211,Residential,91750,0,91750,211984,0,303734
142310103400000,SE 212,Residential,139200,0,139200,282696,0,421896
142310103500000,SE 212,Residential,133300,0,133300,371993,0,505293
142310103600000,SE 211,Residential,40520,0,40520,238081,0,278601
142310103700000,SE 211,Residential,60320,0,60320,157207,0,217527
142310103800000,SE 211,Residential,69032,0,69032,207388,0,276420
142310104000000,SE 211,Residential,69768,0,69768,182547,0,252315
142310104100000,SE 211,Residential,66008,0,66008,0,0,66008
142310104200000,SE 212,Residential,2195,0,2195,0,0,2195
142310104300000,SE 212,Residential,0,0,0,0,0,0
142310104400000,SE 212,Residential,20,0,20,0,0,20
142312600100000,CITY PROPERTY,Exempt,0,0,0,0,0,0
142312600200000,CITY PROPERTY,Exempt,0,0,0,0,0,0
142312600300000,SE 211,Residential,37968,0,37968,176885,0,214853
142312600400000,SE 211,Residential,38330,0,38330,226705,0,265035
142312600500000,SE 211,Residential,38964,0,38964,236495,0,275459
142312600600000,SE 211,Residential,37108,0,37108,176966,0,214074
142312800100000,SE 211,Residential,35308,0,35308,164833,0,200141
142315100100000,SE 213,Residential,30916,0,30916,148700,0,179616
142315200100000,SE 213,Residential,34982,0,34982,147148,0,182130
142315200200000,SE 213,Residential,35000,0,35000,208766,0,243766
142315200300000,SE 213,Residential,34340,0,34340,148560,0,182900
142315200400000,SE 213,Residential,34000,0,34000,172170,0,206170
142315200500000,SE 213,Residential,31680,0,31680,209499,0,241179
142315200600000,SE 213,Residential,31680,0,31680,116039,0,147719
142315200700000,SE 213,Residential,31680,0,31680,107023,0,138703
142315200800000,SE 213,Residential,31060,0,31060,100377,0,131437
142315200900000,SE 213,Residential,18400,0,18400,116732,0,135132
142315201000000,SE 213,Residential,16000,0,16000,62107,0,78107
142315201100000,SE 213,Residential,16000,0,16000,85116,0,101116
142315201200000,SE 213,Residential,16000,0,16000,57851,0,73851
142315201300000,SE 213,Residential,23512,0,23512,53528,0,77040
142315201400000,SE 213,Residential,16488,0,16488,56695,0,73183
142315201500000,SE 213,Residential,16000,0,16000,56060,0,72060
142315201600000,SE 213,Residential,16000,0,16000,45645,0,61645
142315201700000,SE 213,Residential,16000,0,16000,52400,0,68400
142315201800000,SE 213,Residential,16000,0,16000,46478,0,62478
142315201900000,SE 213,Residential,16000,0,16000,41828,0,57828
142315202000000,SE 213,Residential,27000,0,27000,28666,0,55666
142315202100000,SE 213,Residential,20000,0,20000,56903,0,76903
142315300100000,SE 213,Residential,30958,0,30958,139997,0,170955
142315300200000,SE 213,Residential,30780,0,30780,172172,0,202952
142315300300000,SE 213,Residential,30780,0,30780,146126,0,176906
142315400100000,SE 213,Residential,31680,0,31680,134131,0,165811
142315400200000,SE 213,Residential,31112,0,31112,122720,0,153832
142315400300000,SE 213,Residential,18400,0,18400,43797,0,62197
142315400400000,SE 213,Residential,22400,0,22400,56070,0,78470
142315400500000,SE 213,Residential,28600,0,28600,130560,0,159160
142315400600000,SE 213,Residential,16000,0,16000,24815,0,40815
142315400700000,SE 213,Residential,16000,0,16000,44391,0,60391
142315400800000,SE 213,Residential,16000,0,16000,51253,0,67253
142315400900000,SE 213,Residential,22400,0,22400,64677,0,87077
142315401000000,SE 213,Residential,19360,0,19360,71800,0,91160
142315401100000,SE 213,Residential,25200,0,25200,70678,0,95878
142315401200000,SE 213,Residential,18592,0,18592,113627,0,132219
142315401300000,SE 213,Residential,28000,0,28000,78343,0,106343
142317600100000,SE 213,Residential,78050,0,78050,318913,0,396963
142317600200000,SE 213,Residential,36317,0,36317,161506,0,197823
142317600300000,SE 213,Residential,37339,0,37339,127408,0,164747
142317600400000,SE 213,Residential,37087,0,37087,189569,0,226656
142317600500000,SE 213,Residential,34509,0,34509,183900,0,218409
142317600600000,SE 213,Residential,31515,0,31515,140721,0,172236
142317600700000,SE 213,Residential,32895,0,32895,167274,0,200169
142317600800000,SE 213,Residential,31556,0,31556,144534,0,176090
142317600900000,SE 213,Residential,33101,0,33101,161214,0,194315
142317601000000,SE 213,Residential,31661,0,31661,173691,0,205352
142317601100000,SE 213,Residential,31389,0,31389,142767,0,174156
142317601200000,SE 213,Residential,31674,0,31674,176389,0,208063
142317601300000,SE 213,Residential,31713,0,31713,168567,0,200280
142317700100000,SE 213,Residential,34042,0,34042,138285,0,172327
142317700200000,SE 213,Residential,34340,0,34340,178008,0,212348
142317700300000,SE 213,Residential,34340,0,34340,147539,0,181879
142317700400000,SE 213,Residential,34680,0,34680,157207,0,191887
142317700500000,SE 213,Residential,34680,0,34680,153267,0,187947
142317700600000,SE 213,Residential,33048,0,33048,152365,0,185413
142317700700000,SE 213,Residential,32320,0,32320,171653,0,203973
142317700800000,SE 213,Residential,33128,0,33128,157635,0,190763
142317700900000,SE 213,Residential,32859,0,32859,143081,0,175940
142317701000000,SE 213,Residential,30545,0,30545,162456,0,193001
142317701100000,SE 213,Residential,31680,0,31680,123867,0,155547
142317701200000,SE 213,Residential,32472,0,32472,157678,0,190150
142317701300000,SE 213,Residential,32076,0,32076,94195,0,126271
142317701400000,SE 213,Residential,34000,0,34000,174632,0,208632
142317701500000,SE 213,Residential,34000,0,34000,177626,0,211626
142317701600000,SE 213,Residential,34609,0,34609,119626,0,154235
142317701700000,SE 213,Residential,34340,0,34340,175400,0,209740
142317701800000,SE 213,Residential,33650,0,33650,185723,0,219373
142317800100000,SE 213,Residential,93050,0,93050,317267,0,410317
142317800200000,SE 213,Residential,27100,0,27100,118827,0,145927
142317800300000,SE 213,Residential,36502,0,36502,160483,0,196985
142317800400000,SE 213,Residential,35578,0,35578,145505,0,181083
142317800500000,SE 213,Residential,34142,0,34142,181458,0,215600
142317800600000,SE 213,Residential,34222,0,34222,164387,0,198609
142317800700000,SE 213,Residential,33320,0,33320,176461,0,209781
142317800800000,SE 213,Residential,33320,0,33320,191612,0,224932
142317800900000,SE 213,Residential,33343,0,33343,151657,0,185000
142317801000000,SE 213,Residential,33402,0,33402,144934,0,178336
142317801100000,SE 213,Residential,31680,0,31680,146566,0,178246
142317801200000,SE 213,Residential,31680,0,31680,135823,0,167503
142317801300000,SE 213,Residential,34689,0,34689,115138,0,149827
142317801400000,SE 213,Residential,33838,0,33838,102057,0,135895
142317801500000,SE 213,Residential,31369,0,31369,96743,0,128112
142317801600000,SE 213,Residential,27880,0,27880,58667,0,86547
142317801700000,SE 213,Residential,28560,0,28560,30767,0,59327
142317801800000,SE 213,Residential,21280,0,21280,50234,0,71514
142317801900000,SE 213,Residential,28000,0,28000,87547,0,115547
142317802000000,SE 213,Residential,24000,0,24000,73776,0,97776
142317802100000,SE 213,Residential,33351,0,33351,0,0,33351
142317802200000,SE 213,Residential,30918,0,30918,0,0,30918
142317802300000,SE 213,Residential,32300,0,32300,140280,0,172580
142317802400000,SE 213,Residential,24700,0,24700,111511,0,136211
142317802500000,SE 213,Residential,24700,0,24700,65193,0,89893
142317802600000,SE 213,Residential,31752,0,31752,97040,0,128792
142317802700000,SE 213,Residential,31360,0,31360,82205,0,113565
142317802800000,SE 213,Residential,31360,0,31360,119725,0,151085
142317802900000,SE 213,Residential,32300,0,32300,156083,0,188383
142317803000000,SE 213,Residential,32640,0,32640,126983,0,159623
142317803100000,SE 213,Residential,30756,0,30756,168819,0,199575
142317803200000,SE 213,Residential,34720,0,34720,196788,0,231508
142317803300000,SE 213,Residential,44006,0,44006,213294,0,257300
142317803400000,SE 213,Residential,43245,0,43245,171904,0,215149
142317803500000,SE 213,Residential,32813,0,32813,156339,0,189152
142317803600000,SE 213,Residential,40831,0,40831,172030,0,212861
142317803700000,SE 213,Residential,41450,0,41450,144830,0,186280
142317803800000,SE 213,Residential,28724,0,28724,198999,0,227723
142317803900000,SCHOOL,Exempt,0,102600,102600,0,985316,1087916
142317804000000,SE 213,Residential,28616,0,28616,99973,0,128589
142317804100000,SE 213,Residential,27832,0,27832,153284,0,181116
142317804200000,SE 213,Residential,27832,0,27832,109901,0,137733
142317804300000,SE 213,Residential,29400,0,29400,89004,0,118404
142317804400000,SE 213,Residential,33320,0,33320,165958,0,199278
142317804500000,SE 213,Residential,33320,0,33320,173054,0,206374
142317804600000,SE 213,Residential,69154,0,69154,244590,0,313744
142317804700000,SE 213,Residential,95334,0,95334,396666,0,492000
142317804800000,SE 213,Residential,58368,0,58368,252133,0,310501
142320100100000,SE 248,Residential,176650,0,176650,281618,0,458268
142320100200000,SE 248,Residential,183550,0,183550,573729,0,757279
142320100300000,SE 248,Residential,150675,0,150675,186748,0,337423
142320100400000,SE 248,Residential,156800,0,156800,428343,0,585143
142320100500000,SE 248,Residential,192400,0,192400,357157,0,549557
142320100600000,SE 248,Residential,152250,0,152250,307362,0,459612
142320100700000,SE 248,Residential,166425,0,166425,272449,0,438874
142320100800000,SE 248,Residential,218500,0,218500,453585,0,672085
142320100900000,SE 248,Residential,192270,0,192270,532013,0,724283
142320101000000,SE 248,Residential,61347,0,61347,135901,0,197248
142320101100000,SE 248,Residential,71232,0,71232,196279,0,267511
142320101200000,SE 248,Residential,66667,0,66667,189163,0,255830
142320101300000,SE 248,Residential,78507,0,78507,203167,0,281674
142320101400000,SE 248,Residential,78320,0,78320,194410,0,272730
142320101500000,SE 248,Residential,71040,0,71040,175054,0,246094
142320101600000,SE 248,Residential,80000,0,80000,203325,0,283325
142320101700000,SE 248,Residential,80000,0,80000,122721,0,202721
142320101800000,SE 248,Residential,180125,0,180125,235199,0,415324
142320101900000,SE 248,Residential,82822,0,82822,214346,0,297168
142320102000000,SE 248,Residential,179670,0,179670,460293,0,639963
142320102100000,SE 248,Residential,79483,0,79483,0,0,79483
142320102200000,SE 248,Residential,79429,0,79429,0,0,79429
142320102300000,SE 248,Residential,179350,0,179350,185872,0,365222
142320102400000,SE 248,Residential,95200,0,95200,175793,0,270993
142320102500000,SE 248,Residential,54320,0,54320,168701,0,223021
142320102600000,SE 248,Residential,56107,0,56107,168977,0,225084
142320102700000,SE 248,Residential,62560,0,62560,230214,0,292774
142320102800000,SE 248,Residential,91265,0,91265,180866,0,272131
142320200100000,SE 248,Residential,52746,0,52746,218951,0,271697
142320200200000,SE 248,Residential,53973,0,53973,156177,0,210150
142320200300000,SE 248,Residential,57840,0,57840,125241,0,183081
142320200400000,SE 248,Residential,61333,0,61333,132558,0,193891
142320300100000,SE 248,Residential,52358,0,52358,153684,0,206042
142320300200000,SE 248,Residential,52877,0,52877,166343,0,219220
142322600100000,SE 248,Residential,182050,0,182050,320721,0,502771
142322600200000,SE 248,Residential,172200,0,172200,260485,0,432685
142322700100000,SE 248,Residential,171500,0,171500,315643,0,487143
142322700200000,SE 248,Residential,187750,0,187750,292401,0,480151
142322700300000,SE 248,Residential,103007,0,103007,324957,0,427964
142322800100000,SE 248,Residential,114735,0,114735,231892,0,346627
142322800200000,SE 248,Residential,56021,0,56021,232960,0,288981
142322800300000,SE 248,Residential,77357,0,77357,148753,0,226110
142322800400000,SE 248,Residential,61440,0,61440,155235,0,216675
142322800500000,SE 248,Residential,50320,0,50320,175039,0,225359
142322800600000,SE 248,Residential,55968,0,55968,108884,0,164852
142322800700000,SE 248,Residential,97616,0,97616,154857,0,252473
142322800800000,SE 248,Residential,78770,0,78770,188022,0,266792
142322800900000,SE 248,Residential,85200,0,85200,150169,0,235369
142322801000000,SE 248,Residential,62720,0,62720,195116,0,257836
142322900100000,SE 248,Residential,176682,0,176682,423318,0,600000
142322900200000,SE 248,Residential,121840,0,121840,148158,0,269998
142322900300000,SE 248,Residential,145045,0,145045,320174,0,465219
142322900400000,SE 248,Residential,113957,0,113957,443956,0,557913
142322900500000,SE 248,Residential,151025,0,151025,311555,0,462580
142322900600000,SE 248,Residential,75680,0,75680,212381,0,288061
142322900700000,SE 248,Residential,43200,0,43200,126927,0,170127
142322900800000,SE 248,Residential,112662,0,112662,293416,0,406078
142322900900000,SE 248,Residential,85572,0,85572,274238,0,359810
142322901000000,SE 248,Residential,43600,0,43600,174649,0,218249
142322901100000,SE 248,Residential,43600,0,43600,156290,0,199890
142322901200000,SE 248,Residential,43600,0,43600,143100,0,186700
142322901300000,SE 248,Residential,43600,0,43600,156180,0,199780
142322901400000,SE 248,Residential,47960,0,47960,155659,0,203619
142322901500000,SE 248,Residential,48400,0,48400,115990,0,164390
142322901600000,SE 248,Residential,61600,0,61600,168226,0,229826
142322901700000,SE 248,Residential,180100,0,180100,364603,0,544703
142323000100000,SE 248,Residential,99264,0,99264,179833,0,279097
142323100100000,SE 248,Residential,55267,0,55267,207395,0,262662
142323200100000,SE 248,Residential,69888,0,69888,171151,0,241039
142323200200000,SE 248,Residential,54880,0,54880,173961,0,228841
142323200300000,SE 248,Residential,73830,0,73830,175560,0,249390
142323200400000,SE 248,Residential,178375,0,178375,231625,0,410000
142323200500000,SE 248,Residential,176110,0,176110,345415,0,521525
142323200600000,SE 248,Residential,133700,0,133700,188624,0,322324
142323200700000,SE 248,Residential,94400,0,94400,344183,0,438583
142323200800000,SE 248,Residential,111360,0,111360,251057,0,362417
142323200900000,SE 248,Residential,67800,0,67800,226506,0,294306
142323201000000,SE 248,Residential,49280,0,49280,144414,0,193694
142323201100000,SE 248,Residential,59349,0,59349,154851,0,214200
142323201200000,SE 248,Residential,55840,0,55840,166620,0,222460
142323201300000,SE 248,Residential,64640,0,64640,187928,0,252568
142323201400000,SE 248,Residential,46912,0,46912,128668,0,175580
142323201500000,SE 216,Residential,41867,0,41867,105832,0,147699
142325100100000,SE 248,Residential,58133,0,58133,192844,0,250977
142325100200000,SE 248,Residential,58133,0,58133,157042,0,215175
142325100300000,SE 248,Residential,92163,0,92163,195508,0,287671
142325100400000,SE 248,Residential,88000,0,88000,181694,0,269694
142325200100000,SE 248,Residential,57333,0,57333,161913,0,219246
142325200200000,SE 248,Residential,56187,0,56187,132602,0,188789
142325200300000,SE 248,Residential,69692,0,69692,206227,0,275919
142325200400000,SE 248,Residential,63000,0,63000,199404,0,262404
142325200500000,SE 248,Residential,62003,0,62003,153997,0,216000
142325200600000,SE 248,Residential,63000,0,63000,168971,0,231971
142325200700000,SE 248,Residential,63000,0,63000,155754,0,218754
142325200800000,SE 248,Residential,63000,0,63000,184379,0,247379
142325200900000,SE 248,Residential,63000,0,63000,164754,0,227754
142325201000000,SE 248,Residential,63000,0,63000,135208,0,198208
142325201100000,SE 248,Residential,63000,0,63000,321766,0,384766
142325201200000,SE 248,Residential,63000,0,63000,253546,0,316546
142325201300000,SE 248,Residential,47250,0,47250,197980,0,245230
142325201400000,SE 248,Residential,25200,0,25200,140677,0,165877
142325201500000,SE 248,Residential,22050,0,22050,102833,0,124883
142325201600000,SE 248,Residential,36816,0,36816,138768,0,175584
142325201700000,SE 248,Residential,36312,0,36312,130109,0,166421
142325201800000,SE 248,Residential,32160,0,32160,140836,0,172996
142325300100000,SE 248,Residential,142975,0,142975,219595,0,362570
142325300200000,SE 248,Residential,110304,0,110304,177990,0,288294
142325300300000,SE 248,Residential,114480,0,114480,247423,0,361903
142325300400000,SE 248,Residential,95040,0,95040,205235,0,300275
142325300500000,SE 248,Residential,103887,0,103887,266113,0,370000
142325300600000,SE 248,Residential,96784,0,96784,330508,0,427292
142325400100000,SE 248,Residential,84207,0,84207,244599,0,328806
142325400200000,SE 248,Residential,84800,0,84800,385072,0,469872
142325400300000,SE 248,Residential,81691,0,81691,282153,0,363844
142325400400000,SE 248,Residential,73680,0,73680,142543,0,216223
142325400500000,SE 248,Residential,78261,0,78261,173888,0,252149
142325400600000,SE 248,Residential,84293,0,84293,195419,0,279712
142325400700000,SE 248,Residential,80640,0,80640,178411,0,259051
142325400800000,SE 248,Residential,118763,0,118763,326627,0,445390
142325400900000,SE 248,Residential,65208,0,65208,203707,0,268915
142325401000000,SE 248,Residential,63744,0,63744,209826,0,273570
142325500100000,SE 248,Residential,62981,0,62981,262290,0,325271
142325500200000,SE 248,Residential,74360,0,74360,195833,0,270193
142325500300000,SE 248,Residential,86188,0,86188,207645,0,293833
142325500400000,SE 248,Residential,74624,0,74624,236200,0,310824
142325500500000,SE 248,Residential,59136,0,59136,194049,0,253185
142325500600000,SE 248,Residential,51520,0,51520,126256,0,177776
142325500700000,SE 248,Residential,63626,0,63626,143855,0,207481
142325500800000,SE 248,Residential,61152,0,61152,196810,0,257962
142325500900000,SE 248,Residential,67891,0,67891,171342,0,239233
142325501000000,SE 248,Residential,77486,0,77486,164865,0,242351
142325501100000,SE 248,Residential,69115,0,69115,143354,0,212469
142325501200000,SE 248,Residential,68238,0,68238,147601,0,215839
142325501300000,SE 248,Residential,63240,0,63240,162685,0,225925
142325501400000,SE 248,Residential,68800,0,68800,162640,0,231440
142325600100000,SE 248,Residential,187000,0,187000,792189,0,979189
142325600200000,SE 227,Residential,30149,0,30149,101530,0,131679
142325600300000,SE 227,Residential,27900,0,27900,122210,0,150110
142325600400000,SE 227,Residential,27621,0,27621,60748,0,88369
142325600500000,SE 227,Residential,26966,0,26966,114339,0,141305
142325600600000,SE 227,Residential,28500,0,28500,146517,0,175017
142325600700000,SE 227,Residential,27233,0,27233,102812,0,130045
142325600800000,SE 248,Residential,62149,0,62149,114848,0,176997
142325600900000,SE 248,Residential,86079,0,86079,244232,0,330311
142325601000000,SE 248,Residential,54941,0,54941,126937,0,181878
142325601100000,SE 248,Residential,35640,0,35640,132459,0,168099
142325601200000,SE 248,Residential,45200,0,45200,153371,0,198571
142325601300000,SE 248,Residential,76262,0,76262,131373,0,207635
142325700100000,SE 248,Residential,75571,0,75571,208091,0,283662
142325700200000,SE 248,Residential,80000,0,80000,192132,0,272132
142325700300000,SE 248,Residential,72720,0,72720,196557,0,269277
142325700400000,SE 248,Residential,73440,0,73440,154774,0,228214
142325700500000,SE 248,Residential,76584,0,76584,137842,0,214426
142325700600000,SE 248,Residential,78779,0,78779,196796,0,275575
142325700700000,SE 248,Residential,86240,0,86240,202627,0,288867
142325700800000,SE 248,Residential,74400,0,74400,133644,0,208044
142325700900000,SE 248,Residential,86832,0,86832,225296,0,312128
142325701000000,SE 227,Residential,55962,0,55962,157617,0,213579
142325701100000,SE 227,Residential,47616,0,47616,124936,0,172552
142325701200000,SE 227,Residential,48000,0,48000,117014,0,165014
142325701300000,SE 227,Residential,48000,0,48000,104113,0,152113
142325701400000,SE 227,Residential,48000,0,48000,124964,0,172964
142325701500000,SE 227,Residential,48000,0,48000,151631,0,199631
142325701600000,SE 227,Residential,48000,0,48000,127322,0,175322
142325701700000,SE 227,Residential,48000,0,48000,207405,0,255405
142325701800000,SE 227,Residential,48000,0,48000,156127,0,204127
142325701900000,SE 227,Residential,48000,0,48000,135591,0,183591
142325702000000,SE 227,Residential,48000,0,48000,135958,0,183958
142325702100000,SE 227,Residential,48000,0,48000,108212,0,156212
142325702200000,SE 227,Residential,54000,0,54000,145037,0,199037
142325702300000,SE 227,Residential,60900,0,60900,79100,0,140000
142325800100000,SE 227,Residential,33997,0,33997,109790,0,143787
142325800200000,SE 227,Residential,31298,0,31298,73314,0,104612
142325800300000,SE 227,Residential,30262,0,30262,117319,0,147581
142325800400000,SE 227,Residential,36920,0,36920,148333,0,185253
142325800500000,SE 227,Residential,26145,0,26145,99881,0,126026
142325800600000,SE 227,Residential,26145,0,26145,85024,0,111169
142325800700000,SE 227,Residential,29700,0,29700,114041,0,143741
142327600100000,SE 248,Residential,59021,0,59021,160958,0,219979
142327600200000,SE 248,Residential,46200,0,46200,151518,0,197718
142327600300000,SE 248,Residential,41712,0,41712,104126,0,145838
142327600400000,SE 248,Residential,48918,0,48918,112838,0,161756
142327600500000,SE 248,Residential,41712,0,41712,138948,0,180660
142327600600000,SE 248,Residential,46015,0,46015,129578,0,175593
142327600700000,SE 248,Residential,44400,0,44400,139002,0,183402
142327600800000,SE 248,Residential,68800,0,68800,162611,0,231411
142327700100000,SE 248,Residential,59904,0,59904,156713,0,216617
142327700200000,SE 248,Residential,49507,0,49507,150337,0,199844
142327700300000,SE 248,Residential,46720,0,46720,126401,0,173121
142327700400000,SE 248,Residential,47888,0,47888,129744,0,177632
142327700500000,SE 248,Residential,52891,0,52891,120364,0,173255
142327700600000,SE 248,Residential,44773,0,44773,129137,0,173910
142327800100000,SE 248,Residential,43800,0,43800,148250,0,192050
142327800200000,SE 248,Residential,43195,0,43195,136543,0,179738
142327800300000,SE 248,Residential,46754,0,46754,151358,0,198112
142327800400000,SE 248,Residential,46886,0,46886,114465,0,161351
142327800500000,SE 248,Residential,48240,0,48240,177481,0,225721
142327800600000,SE 248,Residential,48642,0,48642,206537,0,255179
142327800700000,SE 248,Residential,105538,0,105538,250908,0,356446
142327800800000,SE 248,Residential,74818,0,74818,192426,0,267244
142327800900000,SE 248,Residential,68280,0,68280,185720,0,254000
142327801000000,SE 248,Residential,66383,0,66383,166054,0,232437
142327801100000,SE 248,Residential,68251,0,68251,237106,0,305357
142327801200000,SE 248,Residential,55227,0,55227,148472,0,203699
142327801300000,SE 248,Residential,146475,0,146475,347076,0,493551
142327801400000,SE 248,Residential,79560,0,79560,154865,0,234425
142327801500000,SE 248,Residential,61360,0,61360,221260,0,282620
142327801600000,SE 248,Residential,91915,0,91915,256358,0,348273
142327801700000,SE 248,Residential,68016,0,68016,207296,0,275312
142327801800000,SE 248,Residential,68080,0,68080,179707,0,247787
142327801900000,SE 248,Residential,57552,0,57552,183091,0,240643
142327802000000,SE 248,Residential,53059,0,53059,161199,0,214258
142327802100000,SE 248,Residential,52602,0,52602,106559,0,159161
142327900100000,SE 248,Residential,145160,0,145160,429721,0,574881
142327900200000,SE 248,Residential,87200,0,87200,195565,0,282765
142327900300000,SE 248,Residential,106864,0,106864,169018,0,275882
142327900400000,SE 248,Residential,125850,0,125850,387939,0,513789
142327900500000,SE 248,Residential,117040,0,117040,296351,0,413391
142327900600000,SE 248,Residential,109440,0,109440,284578,0,394018
142327900700000,SE 248,Residential,103187,0,103187,209799,0,312986
142327900800000,SE 248,Residential,108867,0,108867,198195,0,307062
142327900900000,SE 248,Residential,65056,0,65056,153369,0,218425
142327901000000,SE 248,Residential,61333,0,61333,94004,0,155337
142327901100000,SE 248,Residential,48000,0,48000,119019,0,167019
142327901200000,SE 248,Residential,48000,0,48000,150601,0,198601
142327901300000,SE 248,Residential,48000,0,48000,128020,0,176020
142327901400000,SE 248,Residential,49333,0,49333,171150,0,220483
142328000100000,SE 248,Residential,67891,0,67891,177495,0,245386
142328000200000,SE 248,Residential,63360,0,63360,220932,0,284292
142328000300000,SE 248,Residential,65280,0,65280,174896,0,240176
142328000400000,SE 248,Residential,64800,0,64800,207017,0,271817
142328000500000,SE 248,Residential,73372,0,73372,207190,0,280562
142328000600000,SE 248,Residential,56800,0,56800,220896,0,277696
142328000700000,SE 248,Residential,50425,0,50425,145364,0,195789
142328000800000,SE 248,Residential,68523,0,68523,193626,0,262149
142328000900000,SE 248,Residential,44888,0,44888,183158,0,228046
142328001000000,SE 248,Residential,44518,0,44518,121363,0,165881
142328001100000,SE 248,Residential,48484,0,48484,92415,0,140899
142328001200000,SE 248,Residential,49776,0,49776,166608,0,216384
142328001300000,SE 248,Residential,53040,0,53040,141185,0,194225
142328001400000,SE 248,Residential,59718,0,59718,237399,0,297117
142328001500000,SE 248,Residential,63054,0,63054,246126,0,309180
142328001600000,SE 248,Residential,82335,0,82335,190028,0,272363
142328001700000,SE 227,Residential,52205,0,52205,110461,0,162666
142328001800000,SE 227,Residential,35436,0,35436,106718,0,142154
142328001900000,SE 227,Residential,36000,0,36000,145664,0,181664
142328002000000,SE 227,Residential,36000,0,36000,121881,0,157881
142328002100000,SE 227,Residential,36000,0,36000,127958,0,163958
142328002200000,SE 227,Residential,35000,0,35000,98819,0,133819
142328002300000,SE 248,Residential,71400,0,71400,129319,0,200719
142328100100000,SE 227,Residential,81555,0,81555,166439,0,247994
142328100200000,SE 248,Residential,83755,0,83755,219110,0,302865
142328100300000,SE 248,Residential,82256,0,82256,363538,0,445794
142328100400000,SE 248,Residential,180730,0,180730,612993,0,793723
142328100500000,SE 248,Residential,177245,0,177245,612755,0,790000
142328100600000,SE 248,Residential,109800,0,109800,458238,0,568038
142328100700000,SE 248,Residential,118557,0,118557,292223,0,410780
142328100800000,SE 248,Residential,82384,0,82384,341257,0,423641
142328100900000,SE 248,Residential,109744,0,109744,246255,0,355999
142328101000000,SE 248,Residential,102698,0,102698,0,0,102698
142328101100000,SE 227,Residential,70144,0,70144,169133,0,239277
142328101200000,SE 227,Residential,52520,0,52520,143452,0,195972
142328101300000,SE 227,Residential,49920,0,49920,115585,0,165505
142328101400000,SE 227,Residential,59920,0,59920,176297,0,236217
142328101500000,SE 227,Residential,54080,0,54080,107489,0,161569
142328101600000,SE 227,Residential,54080,0,54080,179657,0,233737
142328101700000,SE 227,Residential,49920,0,49920,113994,0,163914
142328101800000,SE 227,Residential,48000,0,48000,172418,0,220418
142328101900000,SE 227,Residential,54000,0,54000,122827,0,176827
142330100100000,SE 227,Residential,30960,0,30960,100460,0,131420
142330100200000,SE 227,Residential,28800,0,28800,90762,0,119562
142330100300000,SE 227,Residential,28800,0,28800,97442,0,126242
142330100400000,SE 227,Residential,28000,0,28000,106356,0,134356
142330100500000,SE 227,Residential,32340,0,32340,103936,0,136276
142330100600000,SE 227,Residential,32340,0,32340,108398,0,140738
142330100700000,SE 227,Residential,32340,0,32340,149690,0,182030
142330100800000,SE 227,Residential,30590,0,30590,126514,0,157104
142330100900000,SE 227,Residential,30451,0,30451,100269,0,130720
142330101000000,SE 227,Residential,30294,0,30294,87058,0,117352
142330101100000,SE 227,Residential,24074,0,24074,92402,0,116476
142330101200000,SE 227,Residential,29400,0,29400,23749,0,53149
142330101300000,SE 227,Residential,29400,0,29400,96991,0,126391
142330101400000,SE 227,Residential,29400,0,29400,97972,0,127372
142330101500000,SE 227,Residential,31860,0,31860,115690,0,147550
142330101600000,SE 227,Residential,31860,0,31860,83345,0,115205
142330101700000,SE 227,Residential,29400,0,29400,98428,0,127828
142330101800000,SE 227,Residential,32400,0,32400,95494,0,127894
142330101900000,SE 227,Residential,29400,0,29400,116828,0,146228
142330102000000,SE 227,Residential,29400,0,29400,85877,0,115277
142330102100000,SE 227,Residential,28714,0,28714,98371,0,127085
142330102200000,SE 227,Residential,29400,0,29400,76164,0,105564
142330102300000,SE 227,Residential,33237,0,33237,95314,0,128551
142330102400000,SE 227,Residential,32767,0,32767,99046,0,131813
142330102500000,SE 227,Residential,31500,0,31500,56489,0,87989
142330102600000,SE 227,Residential,31500,0,31500,46717,0,78217
142330102700000,SE 227,Residential,31500,0,31500,85979,0,117479
142330102800000,SE 227,Residential,31500,0,31500,98587,0,130087
142330102900000,SE 227,Residential,28350,0,28350,125963,0,154313
142330103000000,SE 227,Residential,28017,0,28017,82737,0,110754
142330103100000,SE 227,Residential,28092,0,28092,119111,0,147203
142330103200000,SE 227,Residential,33300,0,33300,120367,0,153667
142330103300000,SE 227,Residential,32492,0,32492,104014,0,136506
142330103400000,SE 227,Residential,32828,0,32828,128253,0,161081
142330103500000,SE 227,Residential,27750,0,27750,95354,0,123104
142330103600000,SE 227,Residential,24975,0,24975,105282,0,130257
142330103700000,SE 227,Residential,24975,0,24975,92721,0,117696
142330103800000,SE 227,Residential,26048,0,26048,90605,0,116653
142330200100000,SE 227,Residential,55226,0,55226,188641,0,243867
142330200200000,SE 227,Residential,48369,0,48369,152134,0,200503
142330200300000,SE 227,Residential,40800,0,40800,80733,0,121533
142330200400000,SE 227,Residential,35088,0,35088,79399,0,114487
142330200500000,SE 227,Residential,41861,0,41861,102473,0,144334
142330200600000,SE 227,Residential,41779,0,41779,128735,0,170514
142330200700000,SE 227,Residential,41616,0,41616,139379,0,180995
142330200800000,SE 227,Residential,39815,0,39815,114705,0,154520
142330200900000,SE 227,Residential,40800,0,40800,109497,0,150297
142330201000000,SE 227,Residential,40800,0,40800,156598,0,197398
142330201100000,SE 227,Residential,40800,0,40800,134797,0,175597
142330201200000,SE 227,Residential,41600,0,41600,91889,0,133489
142330201300000,SE 227,Residential,43656,0,43656,131606,0,175262
142330201400000,SE 227,Residential,44000,0,44000,122142,0,166142
142330201500000,SE 227,Residential,43620,0,43620,141420,0,185040
142330201600000,SE 227,Residential,35130,0,35130,95279,0,130409
142330201700000,SE 227,Residential,37445,0,37445,107142,0,144587
142330201800000,SE 227,Residential,35796,0,35796,96168,0,131964
142330201900000,SE 227,Residential,42541,0,42541,88987,0,131528
142330202000000,SE 227,Residential,36288,0,36288,152655,0,188943
142330202100000,SE 227,Residential,39155,0,39155,97170,0,136325
142330202200000,SE 227,Residential,40524,0,40524,100334,0,140858
142330202300000,SE 227,Residential,38528,0,38528,86652,0,125180
142330202400000,SE 227,Residential,32411,0,32411,116144,0,148555
142330202500000,SE 227,Residential,31584,0,31584,97546,0,129130
142330202600000,SE 227,Residential,31133,0,31133,91646,0,122779
142330202700000,SE 227,Residential,23008,0,23008,80690,0,103698
142330202800000,SE 227,Residential,29100,0,29100,91390,0,120490
142330202900000,SE 227,Residential,29100,0,29100,86942,0,116042
142330203000000,SE 227,Residential,29100,0,29100,97594,0,126694
142330203100000,SE 227,Residential,29100,0,29100,84689,0,113789
142330203200000,SE 227,Residential,29100,0,29100,92581,0,121681
142330203300000,SE 227,Residential,29100,0,29100,99853,0,128953
142330203400000,SE 227,Residential,29818,0,29818,72864,0,102682
142330203500000,SE 227,Residential,29100,0,29100,99754,0,128854
142330203600000,SE 227,Residential,29100,0,29100,128983,0,158083
142330203700000,SE 227,Residential,26202,0,26202,109575,0,135777
142330203800000,SE 227,Residential,30398,0,30398,104681,0,135079
142330203900000,SE 227,Residential,29100,0,29100,126934,0,156034
142330204000000,SE 227,Residential,29100,0,29100,74208,0,103308
142330204100000,SE 227,Residential,29100,0,29100,111029,0,140129
142330204200000,SE 227,Residential,29100,0,29100,97940,0,127040
142330204300000,SE 227,Residential,29100,0,29100,67152,0,96252
142330300100000,SE 227,Residential,41880,0,41880,122652,0,164532
142330300200000,SE 227,Residential,40000,0,40000,160988,0,200988
142330300300000,SE 227,Residential,40000,0,40000,97167,0,137167
142330300400000,SE 227,Residential,40000,0,40000,115657,0,155657
142330300500000,SE 227,Residential,40000,0,40000,91322,0,131322
142330300600000,SE 227,Residential,40000,0,40000,108664,0,148664
142330300700000,SE 227,Residential,40080,0,40080,120391,0,160471
142330300800000,SE 227,Residential,42000,0,42000,87716,0,129716
142330300900000,SE 227,Residential,40000,0,40000,105960,0,145960
142330301000000,SE 227,Residential,40000,0,40000,101560,0,141560
142330301100000,SE 227,Residential,40000,0,40000,92285,0,132285
142330301200000,SE 227,Residential,40000,0,40000,113931,0,153931
142330301300000,SE 227,Residential,40000,0,40000,127580,0,167580
142330301400000,SE 227,Residential,39408,0,39408,75187,0,114595
142330400100000,SE 227,Residential,40944,0,40944,134357,0,175301
142330400200000,SE 227,Residential,40000,0,40000,91895,0,131895
142330400300000,SE 227,Residential,40000,0,40000,136058,0,176058
142330400400000,SE 227,Residential,40000,0,40000,106968,0,146968
142330400500000,SE 227,Residential,40000,0,40000,129362,0,169362
142330400600000,SE 227,Residential,40000,0,40000,122263,0,162263
142330400700000,SE 227,Residential,40080,0,40080,128919,0,168999
142330400800000,SE 227,Residential,46592,0,46592,120540,0,167132
142330400900000,SE 227,Residential,45696,0,45696,111299,0,156995
142330401000000,SE 227,Residential,41933,0,41933,93171,0,135104
142330401100000,SE 227,Residential,42310,0,42310,128244,0,170554
142330401200000,SE 227,Residential,43697,0,43697,109907,0,153604
142330401300000,SE 227,Residential,40063,0,40063,110213,0,150276
142330500100000,SE 227,Residential,42747,0,42747,107214,0,149961
142330500200000,SE 227,Residential,43979,0,43979,110911,0,154890
142330500300000,SE 227,Residential,42651,0,42651,91736,0,134387
142330500400000,SE 227,Residential,42651,0,42651,74090,0,116741
142330600100000,SE 227,Residential,24353,0,24353,76207,0,100560
142330600200000,SE 227,Residential,36266,0,36266,131700,0,167966
142330600300000,SE 227,Residential,31500,0,31500,96410,0,127910
142330600400000,SE 227,Residential,31500,0,31500,83392,0,114892
142330600500000,SE 227,Residential,18900,0,18900,79027,0,97927
142330600600000,SE 227,Residential,18295,0,18295,0,0,18295
142330600700000,SE 227,Residential,30184,0,30184,99492,0,129676
142330600800000,SE 227,Residential,29400,0,29400,95957,0,125357
142330600900000,SE 227,Residential,30086,0,30086,73354,0,103440
142330601000000,SE 227,Residential,39348,0,39348,112019,0,151367
142330601100000,SE 227,Residential,38625,0,38625,84785,0,123410
142330601200000,SE 227,Residential,38625,0,38625,91482,0,130107
142330601300000,SE 227,Residential,38625,0,38625,148876,0,187501
142330601400000,SE 227,Residential,38625,0,38625,97502,0,136127
142330601500000,SE 227,Residential,38625,0,38625,106271,0,144896
142330601600000,SE 227,Residential,40303,0,40303,112735,0,153038
142330601700000,SE 227,Residential,49827,0,49827,134249,0,184076
142330601800000,SE 227,Residential,23250,0,23250,87161,0,110411
142330601900000,SE 227,Residential,22000,0,22000,74925,0,96925
142330700100000,SE 227,Residential,38888,0,38888,116503,0,155391
142330700200000,SE 227,Residential,39480,0,39480,111136,0,150616
142330700300000,SE 227,Residential,39480,0,39480,101458,0,140938
142330700400000,SE 227,Residential,39480,0,39480,114857,0,154337
142330700500000,SE 227,Residential,39480,0,39480,83918,0,123398
142330800100000,SE 227,Residential,34216,0,34216,101455,0,135671
142330800200000,SE 227,Residential,34216,0,34216,88886,0,123102
142330800300000,SE 227,Residential,34216,0,34216,87637,0,121853
142330800400000,SE 227,Residential,34216,0,34216,84576,0,118792
142330800500000,SE 227,Residential,34216,0,34216,60509,0,94725
142330800600000,SE 227,Residential,34717,0,34717,73752,0,108469
142330900100000,SE 227,Residential,23490,0,23490,104954,0,128444
142330900200000,SE 227,Residential,39744,0,39744,101649,0,141393
142330900300000,SE 227,Residential,38448,0,38448,111021,0,149469
142330900400000,SE 227,Residential,38880,0,38880,120692,0,159572
142330900500000,SE 227,Residential,42614,0,42614,115868,0,158482
142330900600000,SE 227,Residential,41069,0,41069,122845,0,163914
142330900700000,SE 227,Residential,28594,0,28594,78139,0,106733
142330900800000,SE 227,Residential,51492,0,51492,115761,0,167253
142330900900000,SE 227,Residential,42000,0,42000,89156,0,131156
142330901000000,SE 227,Residential,42000,0,42000,88883,0,130883
142330901100000,SE 227,Residential,42000,0,42000,97648,0,139648
142330901200000,SE 227,Residential,41825,0,41825,97514,0,139339
142330901300000,SE 227,Residential,42000,0,42000,121266,0,163266
142330901400000,SE 227,Residential,26910,0,26910,155103,0,182013
142330901500000,SE 227,Residential,34320,0,34320,109193,0,143513
142330901600000,SE 227,Residential,24412,0,24412,127524,0,151936
142330901700000,SE 227,Residential,23400,0,23400,112839,0,136239
142330901800000,SE 227,Residential,21900,0,21900,104957,0,126857
142330901900000,SE 227,Residential,48123,0,48123,147350,0,195473
142332600100000,SE 227,Residential,45547,0,45547,213134,0,258681
142332600200000,SE 227,Residential,44800,0,44800,151305,0,196105
142332600300000,SE 227,Residential,40000,0,40000,121043,0,161043
142332600400000,SE 227,Residential,40000,0,40000,130253,0,170253
142332600500000,SE 227,Residential,38933,0,38933,90176,0,129109
142332600600000,SE 227,Residential,41067,0,41067,147884,0,188951
142332600700000,SE 227,Residential,40000,0,40000,94739,0,134739
142332600800000,SE 227,Residential,40000,0,40000,102619,0,142619
142332600900000,SE 227,Residential,40000,0,40000,115242,0,155242
142332601000000,SE 227,Residential,40000,0,40000,101063,0,141063
142332601100000,SE 227,Residential,38933,0,38933,109202,0,148135
142332700100000,SE 227,Residential,41067,0,41067,98310,0,139377
142332700200000,SE 227,Residential,40000,0,40000,100809,0,140809
142332700300000,SE 227,Residential,40000,0,40000,94250,0,134250
142332700400000,SE 227,Residential,40000,0,40000,119161,0,159161
142332700500000,SE 227,Residential,40000,0,40000,123131,0,163131
142332700600000,SE 227,Residential,41706,0,41706,97368,0,139074
142332700700000,SE 227,Residential,43696,0,43696,133113,0,176809
142332700800000,SE 227,Residential,40386,0,40386,129790,0,170176
142332700900000,SE 227,Residential,40320,0,40320,108846,0,149166
142332701000000,SE 227,Residential,39960,0,39960,89720,0,129680
142332800100000,SE 227,Residential,23363,0,23363,100183,0,123546
142332800200000,SE 227,Residential,23696,0,23696,107552,0,131248
142332800300000,SE 227,Residential,23850,0,23850,87826,0,111676
142332800400000,SE 227,Residential,24181,0,24181,94439,0,118620
142332800500000,SE 227,Residential,29700,0,29700,116447,0,146147
142332800600000,SE 227,Residential,29700,0,29700,106046,0,135746
142332800700000,SE 227,Residential,29700,0,29700,96320,0,126020
142332800800000,SE 227,Residential,29700,0,29700,114896,0,144596
142332800900000,SE 227,Residential,29700,0,29700,112583,0,142283
142332801000000,SE 227,Residential,29700,0,29700,136297,0,165997
142332801100000,SE 227,Residential,29700,0,29700,123493,0,153193
142332801200000,SE 227,Residential,37961,0,37961,121872,0,159833
142332801300000,SE 227,Residential,37920,0,37920,131344,0,169264
142332801400000,SE 227,Residential,41328,0,41328,119456,0,160784
142332801500000,SE 227,Residential,41412,0,41412,108390,0,149802
142332801600000,SE 227,Residential,48000,0,48000,105577,0,153577
142332801700000,SE 227,Residential,48000,0,48000,143373,0,191373
142332801800000,SE 227,Residential,48000,0,48000,139273,0,187273
142332801900000,SE 227,Residential,47520,0,47520,121312,0,168832
142332802000000,SE 227,Residential,57024,0,57024,102022,0,159046
142332802100000,SE 227,Residential,47520,0,47520,99857,0,147377
142332900100000,SE 227,Residential,38400,0,38400,118657,0,157057
142332900200000,SE 227,Residential,35904,0,35904,113207,0,149111
142332900300000,SE 227,Residential,42789,0,42789,125800,0,168589
142333000100000,SE 227,Residential,40000,0,40000,138481,0,178481
142333000200000,SE 227,Residential,40000,0,40000,150129,0,190129
142333000300000,SE 227,Residential,40000,0,40000,62764,0,102764
142333000400000,SE 227,Residential,51000,0,51000,149435,0,200435
142333000500000,SE 227,Residential,51000,0,51000,90818,0,141818
142333000600000,SE 227,Residential,40000,0,40000,138297,0,178297
142333000700000,SE 227,Residential,40000,0,40000,132799,0,172799
142333000800000,SE 227,Residential,40000,0,40000,138629,0,178629
142333000900000,SE 227,Residential,40000,0,40000,109037,0,149037
142333001000000,SE 227,Residential,53824,0,53824,166540,0,220364
142333001100000,SE 227,Residential,52490,0,52490,157382,0,209872
142333001200000,SE 227,Residential,40000,0,40000,69221,0,109221
142333001300000,SE 227,Residential,40000,0,40000,105460,0,145460
142333001400000,SE 227,Residential,40000,0,40000,134879,0,174879
142333001500000,SE 227,Residential,40000,0,40000,126929,0,166929
142333001600000,SE 227,Residential,51000,0,51000,129750,0,180750
142333001700000,SE 227,Residential,51000,0,51000,103669,0,154669
142333001800000,SE 227,Residential,40000,0,40000,151207,0,191207
142333100100000,SE 227,Residential,42325,0,42325,131616,0,173941
142333100200000,SE 227,Residential,43200,0,43200,123604,0,166804
142333100300000,SE 227,Residential,42800,0,42800,118453,0,161253
142333100400000,SE 227,Residential,42400,0,42400,128055,0,170455
142333100500000,SE 227,Residential,42000,0,42000,149921,0,191921
142333100600000,SE 227,Residential,41600,0,41600,127250,0,168850
142333100700000,SE 227,Residential,40800,0,40800,126572,0,167372
142333100800000,SE 227,Residential,40000,0,40000,97831,0,137831
142333100900000,SE 227,Residential,40000,0,40000,118771,0,158771
142333101000000,SE 227,Residential,40000,0,40000,79938,0,119938
142333101100000,SE 227,Residential,40000,0,40000,150382,0,190382
142333101200000,SE 227,Residential,41800,0,41800,129873,0,171673
142333101300000,SE 227,Residential,36000,0,36000,140596,0,176596
142333101400000,SE 227,Residential,40000,0,40000,131178,0,171178
142333101500000,SE 227,Residential,40221,0,40221,115679,0,155900
142333101600000,SE 227,Residential,44856,0,44856,98698,0,143554
142333101700000,SE 227,Residential,43792,0,43792,116505,0,160297
142333200100000,SE 227,Residential,44257,0,44257,116379,0,160636
142333200200000,SE 227,Residential,43650,0,43650,133784,0,177434
142333200300000,SE 227,Residential,35040,0,35040,78975,0,114015
142333200400000,SE 227,Residential,35040,0,35040,144291,0,179331
142333200500000,SE 227,Residential,46059,0,46059,138019,0,184078
142333200600000,SE 227,Residential,41440,0,41440,133647,0,175087
142333300100000,SE 227,Residential,35040,0,35040,121284,0,156324
142333300200000,SE 227,Residential,34560,0,34560,111471,0,146031
142333300300000,SE 227,Residential,43758,0,43758,101949,0,145707
142333300400000,SE 227,Residential,42432,0,42432,95083,0,137515
142333300500000,SE 227,Residential,59910,0,59910,188923,0,248833
142333400100000,SE 227,Residential,41616,0,41616,129071,0,170687
142333400200000,SE 227,Residential,49852,0,49852,138431,0,188283
142333400300000,SE 227,Residential,47759,0,47759,134852,0,182611
142333400400000,SE 227,Residential,48902,0,48902,125577,0,174479
142333400500000,SE 227,Residential,49248,0,49248,117384,0,166632
142333400600000,SE 227,Residential,40000,0,40000,81829,0,121829
142333400700000,SE 227,Residential,40000,0,40000,122867,0,162867
142333400800000,SE 227,Residential,42180,0,42180,146758,0,188938
142333400900000,SE 227,Residential,48672,0,48672,102899,0,151571
142333401000000,SE 227,Residential,48768,0,48768,116620,0,165388
142333401100000,SE 227,Residential,49852,0,49852,100269,0,150121
142333401200000,SE 227,Residential,45387,0,45387,161297,0,206684
142333401300000,SE 227,Residential,40000,0,40000,119302,0,159302
142333401400000,SE 227,Residential,40000,0,40000,152150,0,192150
142333401500000,SE 227,Residential,42400,0,42400,146772,0,189172
142333500100000,SE 227,Residential,68208,0,68208,163774,0,231982
142333500200000,SE 227,Residential,64288,0,64288,146107,0,210395
142333500300000,SE 227,Residential,40000,0,40000,90961,0,130961
142333500400000,SE 227,Residential,40000,0,40000,88535,0,128535
142333500500000,SE 227,Residential,40000,0,40000,86369,0,126369
142333500600000,SE 227,Residential,40000,0,40000,89132,0,129132
142333500700000,SE 227,Residential,40000,0,40000,112790,0,152790
142333500800000,SE 227,Residential,40000,0,40000,105206,0,145206
142333500900000,SE 227,Residential,42667,0,42667,149908,0,192575
142333501000000,SE 227,Residential,43680,0,43680,34017,0,77697
142333501100000,SE 227,Residential,40000,0,40000,88643,0,128643
142333501200000,SE 227,Residential,40000,0,40000,117976,0,157976
142333501300000,SE 227,Residential,40000,0,40000,109467,0,149467
142333600100000,SE 227,Residential,138562,0,138562,195262,0,333824
142333600200000,SE 227,Residential,76199,0,76199,197826,0,274025
142333600300000,SE 227,Residential,94378,0,94378,316880,0,411258
142333600400000,SE 227,Residential,91728,0,91728,359702,0,451430
142335100100000,SE 243,Residential,80401,0,80401,152458,0,232859
142335100200000,SE 243,Residential,85440,0,85440,143223,0,228663
142335100300000,SE 243,Residential,72320,0,72320,75747,0,148067
142335100400000,SE 243,Residential,72320,0,72320,189833,0,262153
142335100500000,SE 243,Residential,114000,0,114000,230272,0,344272
142335100600000,SE 243,Residential,140000,0,140000,229253,0,369253
142335100700000,SE 243,Residential,84240,0,84240,238550,0,322790
142335100800000,SE 243,Residential,76524,0,76524,211435,0,287959
142335100900000,SE 243,Residential,78874,0,78874,192367,0,271241
142335101000000,SE 243,Residential,75802,0,75802,190582,0,266384
142335101100000,SE 243,Residential,84634,0,84634,219503,0,304137
142335101200000,SE 243,Residential,96219,0,96219,233550,0,329769
142335101300000,SE 243,Residential,91228,0,91228,279856,0,371084
142335101400000,SE 247,Residential,175000,0,175000,550629,0,725629
142335101500000,SE 247,Residential,68160,0,68160,207874,0,276034
142335101600000,SE 247,Residential,69227,0,69227,232957,0,302184
142335101700000,SE 247,Residential,75816,0,75816,381020,0,456836
142335101800000,SE 247,Residential,76973,0,76973,276039,0,353012
142335101900000,SE 243,Residential,109388,0,109388,221711,0,331099
142335102000000,SE 243,Residential,93643,0,93643,144067,0,237710
142335102100000,SE 243,Residential,93643,0,93643,267905,0,361548
142335102200000,SE 243,Residential,78376,0,78376,150474,0,228850
142335200100000,SE 247,Residential,72520,0,72520,166045,0,238565
142335200200000,SE 247,Residential,91123,0,91123,380203,0,471326
142335200300000,SE 247,Residential,87024,0,87024,238389,0,325413
142335200400000,SE 247,Residential,92651,0,92651,169496,0,262147
142335200500000,SE 247,Residential,109670,0,109670,319933,0,429603
142335200600000,SE 247,Residential,92288,0,92288,293380,0,385668
142335200700000,SE 247,Residential,92220,0,92220,305131,0,397351
142335300100000,SE 247,Residential,79283,0,79283,196216,0,275499
142335300200000,SE 247,Residential,79283,0,79283,237099,0,316382
142335300300000,SE 247,Residential,65878,0,65878,167369,0,233247
142335300400000,SE 247,Residential,135275,0,135275,298199,0,433474
142335300500000,SE 247,Residential,95304,0,95304,217082,0,312386
142335300600000,SE 247,Residential,93462,0,93462,279825,0,373287
142335300700000,SE 247,Residential,82800,0,82800,189797,0,272597
142335300800000,SE 247,Residential,76032,0,76032,138211,0,214243
142335300900000,SE 247,Residential,66427,0,66427,105365,0,171792
142335301000000,SE 235,Residential,48000,0,48000,81038,0,129038
142335301100000,SE 235,Residential,22838,0,22838,80973,0,103811
142335301200000,SE 235,Residential,40880,0,40880,64610,0,105490
142335301300000,SE 247,Residential,95010,0,95010,174749,0,269759
142335301400000,SE 247,Residential,82400,0,82400,149239,0,231639
142335301500000,SE 247,Residential,83888,0,83888,167745,0,251633
142335301600000,SE 247,Residential,77611,0,77611,128194,0,205805
142335301700000,SE 247,Residential,70400,0,70400,145935,0,216335
142335400100000,SE 235,Residential,22120,0,22120,65326,0,87446
142335400200000,SE 247,Residential,91646,0,91646,133096,0,224742
142335400300000,SE 247,Residential,90145,0,90145,207153,0,297298
142335400400000,SE 247,Residential,89496,0,89496,248745,0,338241
142335400500000,SE 247,Residential,87433,0,87433,209365,0,296798
142335400600000,SE 247,Residential,94502,0,94502,251243,0,345745
142335400700000,SE 247,Residential,94195,0,94195,387535,0,481730
142335400800000,SE 247,Residential,98374,0,98374,219770,0,318144
142335400900000,SE 247,Residential,87200,0,87200,286856,0,374056
142335401000000,SE 247,Residential,97014,0,97014,175070,0,272084
142335401100000,SE 247,Residential,97888,0,97888,164561,0,262449
142335401200000,SE 235,Residential,36960,0,36960,105188,0,142148
142335401300000,SE 235,Residential,44160,0,44160,89296,0,133456
142335401400000,SE 235,Residential,21000,0,21000,88156,0,109156
142335401500000,SE 235,Residential,21000,0,21000,90843,0,111843
142335401600000,SE 235,Residential,21000,0,21000,70958,0,91958
142335401700000,SE 235,Residential,21000,0,21000,68088,0,89088
142335401800000,SE 235,Residential,21000,0,21000,68860,0,89860
142335401900000,SE 235,Residential,22050,0,22050,97322,0,119372
142335500100000,SE 247,Residential,72420,0,72420,158025,0,230445
142335500200000,SE 247,Residential,50483,0,50483,145917,0,196400
142335600100000,SE 235,Residential,54400,0,54400,101523,0,155923
142335600200000,SE 235,Residential,41547,0,41547,118869,0,160416
142335600300000,SE 247,Residential,69552,0,69552,149728,0,219280
142335600400000,SE 247,Residential,71400,0,71400,172651,0,244051
142335600500000,SE 247,Residential,75264,0,75264,205284,0,280548
142335600600000,SE 247,Residential,63075,0,63075,187971,0,251046
142335600700000,SE 247,Residential,62560,0,62560,192997,0,255557
142335600800000,SE 235,Residential,17500,0,17500,85265,0,102765
142335600900000,SE 235,Residential,17500,0,17500,79090,0,96590
142335601000000,SE 235,Residential,17500,0,17500,95846,0,113346
142335601100000,SE 235,Residential,17500,0,17500,113792,0,131292
142335601200000,SE 235,Residential,17500,0,17500,83087,0,100587
142337600100000,SE 224,Residential,38850,0,38850,102954,0,141804
142337600200000,SE 224,Residential,27721,0,27721,109348,0,137069
142337600300000,SE 224,Residential,27034,0,27034,76893,0,103927
142337600400000,SE 224,Residential,28636,0,28636,105974,0,134610
142337600500000,SE 224,Residential,26422,0,26422,99626,0,126048
142337600600000,SE 224,Residential,26833,0,26833,101507,0,128340
142337600700000,SE 224,Residential,28436,0,28436,87151,0,115587
142337600800000,SE 224,Residential,33300,0,33300,137401,0,170701
142337600900000,SE 224,Residential,38850,0,38850,107277,0,146127
142337601000000,SE 224,Residential,33966,0,33966,84209,0,118175
142337601100000,SE 224,Residential,33966,0,33966,82670,0,116636
142337700100000,SE 224,Residential,32310,0,32310,89319,0,121629
142337700200000,SE 224,Residential,28305,0,28305,76369,0,104674
142337700300000,SE 224,Residential,28305,0,28305,73540,0,101845
142337700400000,SE 224,Residential,28305,0,28305,69721,0,98026
142337700500000,SE 224,Residential,28305,0,28305,100095,0,128400
142337700600000,SE 224,Residential,26700,0,26700,61295,0,87995
142337700700000,SE 224,Residential,26700,0,26700,89960,0,116660
142337700800000,SE 224,Residential,27145,0,27145,73960,0,101105
142337700900000,SE 224,Residential,27540,0,27540,71023,0,98563
142337701000000,SE 224,Residential,27540,0,27540,72641,0,100181
142337701100000,SE 224,Residential,28593,0,28593,95443,0,124036
142337701200000,SE 224,Residential,28435,0,28435,77625,0,106060
142337701300000,SE 224,Residential,27034,0,27034,118981,0,146015
142337701400000,SE 224,Residential,28148,0,28148,94880,0,123028
142337800100000,SCHOOL,Exempt,0,0,0,0,0,0
142337800200000,SE 227,Residential,55440,0,55440,120702,0,176142
142337800300000,SE 227,Residential,26250,0,26250,117990,0,144240
142337800400000,SE 227,Residential,26250,0,26250,97032,0,123282
142337800500000,SE 227,Residential,26250,0,26250,121567,0,147817
142337800600000,SE 227,Residential,26250,0,26250,122610,0,148860
142337800700000,SE 227,Residential,26250,0,26250,134823,0,161073
142337800800000,SE 227,Residential,26250,0,26250,91305,0,117555
142337800900000,SE 227,Residential,26250,0,26250,140229,0,166479
142337801000000,SE 227,Residential,26250,0,26250,107887,0,134137
142337801100000,SE 227,Residential,26250,0,26250,94262,0,120512
142337801200000,SE 227,Residential,23100,0,23100,108684,0,131784
142337801300000,SE 227,Residential,26250,0,26250,91326,0,117576
142337801400000,SE 227,Residential,26250,0,26250,87683,0,113933
142337801500000,SE 227,Residential,26250,0,26250,113390,0,139640
142337801600000,SE 227,Residential,26250,0,26250,119966,0,146216
142337801700000,SE 227,Residential,26250,0,26250,97560,0,123810
142337801800000,SE 227,Residential,26250,0,26250,93192,0,119442
142337801900000,SE 227,Residential,26250,0,26250,84613,0,110863
142337802000000,SE 227,Residential,26250,0,26250,84234,0,110484
142337802100000,SE 227,Residential,26250,0,26250,108133,0,134383
142337802200000,SE 227,Residential,26250,0,26250,70226,0,96476
142337802300000,SE 227,Residential,26250,0,26250,109846,0,136096
142337802400000,SE 227,Residential,26250,0,26250,80086,0,106336
142337802500000,SE 227,Residential,26250,0,26250,93238,0,119488
142337802600000,SE 227,Residential,25724,0,25724,74171,0,99895
142337802700000,CITY PROPERTY,Exempt,0,0,0,0,0,0
142337802800000,SE 224,Residential,17374,0,17374,62380,0,79754
142337802900000,SE 224,Residential,26513,0,26513,75778,0,102291
142337803000000,SE 224,Residential,26505,0,26505,80679,0,107184
142337803100000,SE 224,Residential,27000,0,27000,98274,0,125274
142337803200000,SE 224,Residential,27360,0,27360,93800,0,121160
142337803300000,SE 224,Residential,26100,0,26100,96152,0,122252
142337803400000,SE 224,Residential,25375,0,25375,80044,0,105419
142337900100000,SE 224,Residential,31080,0,31080,74309,0,105389
142337900200000,SE 224,Residential,26939,0,26939,103685,0,130624
142337900300000,SE 224,Residential,26700,0,26700,91146,0,117846
142337900400000,SE 224,Residential,26700,0,26700,111390,0,138090
142337900500000,SE 224,Residential,26700,0,26700,97876,0,124576
142337900600000,SE 224,Residential,27268,0,27268,107397,0,134665
142337900700000,SE 224,Residential,27268,0,27268,99830,0,127098
142337900800000,SE 224,Residential,26700,0,26700,106494,0,133194
142337900900000,SE 224,Residential,29053,0,29053,125966,0,155019
142337901000000,SE 224,Residential,28533,0,28533,82173,0,110706
142337901100000,SE 224,Residential,34565,0,34565,116446,0,151011
142337901200000,SE 224,Residential,33389,0,33389,104132,0,137521
142337901300000,SE 224,Residential,28533,0,28533,88385,0,116918
142337901400000,SE 224,Residential,30963,0,30963,100375,0,131338
142337901500000,SE 224,Residential,26700,0,26700,80839,0,107539
142337901600000,SE 224,Residential,27268,0,27268,87583,0,114851
142337901700000,SE 224,Residential,27268,0,27268,109693,0,136961
142337901800000,SE 224,Residential,26700,0,26700,85779,0,112479
142337901900000,SE 224,Residential,26700,0,26700,83866,0,110566
142337902000000,SE 224,Residential,26633,0,26633,83098,0,109731
142337902100000,SE 224,Residential,27753,0,27753,101029,0,128782
142337902200000,SE 224,Residential,27553,0,27553,85619,0,113172
142337902300000,SE 224,Residential,27622,0,27622,94662,0,122284
142337902400000,SE 224,Residential,26700,0,26700,107795,0,134495
142337902500000,SE 224,Residential,26255,0,26255,88363,0,114618
142337902600000,SE 224,Residential,26550,0,26550,100525,0,127075
142337902700000,SE 224,Residential,26550,0,26550,59501,0,86051
142337902800000,SE 224,Residential,26550,0,26550,87097,0,113647
142337902900000,SE 224,Residential,26550,0,26550,66522,0,93072
142337903000000,SE 224,Residential,26728,0,26728,77272,0,104000
142337903100000,SE 224,Residential,26550,0,26550,80510,0,107060
142337903200000,SE 224,Residential,26550,0,26550,95893,0,122443
142337903300000,SE 224,Residential,26550,0,26550,74357,0,100907
142337903400000,SE 224,Residential,26550,0,26550,120885,0,147435
142337903500000,SE 224,Residential,27000,0,27000,99700,0,126700
142337903600000,SE 224,Residential,17437,0,17437,76463,0,93900
142337903700000,SE 224,Residential,17424,0,17424,90580,0,108004
142337903800000,SE 224,Residential,25299,0,25299,77758,0,103057
142337903900000,SE 224,Residential,25235,0,25235,89016,0,114251
142337904000000,SE 224,Residential,19600,0,19600,73230,0,92830
142337904100000,SE 224,Residential,16100,0,16100,84635,0,100735
142337904200000,SE 224,Residential,31185,0,31185,104136,0,135321
142337904300000,SE 224,Residential,21475,0,21475,73334,0,94809
142337904400000,SE 224,Residential,18568,0,18568,54975,0,73543
142337904500000,SE 224,Residential,27652,0,27652,51848,0,79500
142337904600000,SE 224,Residential,27750,0,27750,68080,0,95830
142337904700000,SE 224,Residential,27195,0,27195,54940,0,82135
142337904800000,SE 224,Residential,27750,0,27750,119610,0,147360
142337904900000,SE 224,Residential,33300,0,33300,92382,0,125682
142337905000000,SE 224,Residential,33000,0,33000,104146,0,137146
142337905100000,SE 224,Residential,23773,0,23773,62493,0,86266
142337905200000,SE 224,Residential,26363,0,26363,89902,0,116265
142337905300000,SE 224,Residential,25530,0,25530,76050,0,101580
142337905400000,SE 224,Residential,21830,0,21830,0,0,21830
142337905500000,SE 224,Residential,19000,0,19000,79543,0,98543
142337905600000,SE 224,Residential,31080,0,31080,110838,0,141918
142337905700000,SE 224,Residential,31080,0,31080,67498,0,98578
142337905800000,SE 224,Residential,31080,0,31080,108588,0,139668
142338000100000,SE 224,Residential,25163,0,25163,49837,0,75000
142338000200000,SE 224,Residential,25092,0,25092,80352,0,105444
142338000300000,SE 224,Residential,25266,0,25266,81761,0,107027
142338000400000,SE 224,Residential,24743,0,24743,84929,0,109672
142338000500000,SE 224,Residential,25583,0,25583,71035,0,96618
142338000600000,SE 224,Residential,16450,0,16450,81467,0,97917
142338000700000,SE 224,Residential,22751,0,22751,102977,0,125728
142338000800000,SE 224,Residential,18725,0,18725,66163,0,84888
142338000900000,SE 224,Residential,18725,0,18725,86629,0,105354
142338001000000,SE 224,Residential,24500,0,24500,74620,0,99120
142338001100000,SE 224,Residential,24990,0,24990,68656,0,93646
142338001200000,SE 224,Residential,25480,0,25480,78579,0,104059
142338001300000,SE 224,Residential,24500,0,24500,72354,0,96854
142340100100000,SE 210,Residential,7560,0,7560,0,0,7560
142340100200000,SE 210,Residential,54300,0,54300,428161,0,482461
142340100300000,SE 210,Residential,1290,0,1290,0,0,1290
142340100400000,SE 210,Residential,1035,0,1035,0,0,1035
142340100500000,SE 210,Residential,39290,0,39290,120710,0,160000
142340100600000,SE 210,Residential,27738,0,27738,155929,0,183667
142340100700000,SE 210,Residential,28444,0,28444,112586,0,141030
142340100800000,SE 210,Residential,35087,0,35087,158860,0,193947
142340100900000,SE 210,Residential,35425,0,35425,119143,0,154568
142340101000000,SE 210,Residential,38362,0,38362,197924,0,236286
142340101100000,SE 210,Residential,29044,0,29044,175483,0,204527
142340101200000,SE 210,Residential,26750,0,26750,133841,0,160591
142340101300000,SE 210,Residential,24304,0,24304,113514,0,137818
142340101400000,SE 224,Residential,31268,0,31268,134939,0,166207
142340101500000,SE 210,Residential,42049,0,42049,136941,0,178990
142340101600000,SE 210,Residential,28609,0,28609,124947,0,153556
142340101700000,SE 210,Residential,31040,0,31040,0,0,31040
142340101800000,SE 210,Residential,33950,0,33950,126108,0,160058
142340101900000,SE 210,Residential,28420,0,28420,105778,0,134198
142340102000000,SE 210,Residential,30400,0,30400,152881,0,183281
142340102100000,SE 210,Residential,31416,0,31416,121945,0,153361
142340102200000,SE 210,Residential,29376,0,29376,104877,0,134253
142340102300000,SE 210,Residential,29029,0,29029,157059,0,186088
142340102400000,SE 210,Residential,25398,0,25398,121307,0,146705
142340200100000,SE 224,Residential,29460,0,29460,106239,0,135699
142340200200000,SE 224,Residential,29452,0,29452,96209,0,125661
142340200300000,SE 224,Residential,34009,0,34009,94477,0,128486
142340200400000,SE 224,Residential,35363,0,35363,110012,0,145375
142340200500000,SE 224,Residential,28200,0,28200,82762,0,110962
142340200600000,SE 224,Residential,28200,0,28200,91411,0,119611
142340200700000,SE 224,Residential,29022,0,29022,93018,0,122040
142340200800000,SE 224,Residential,31587,0,31587,128420,0,160007
142340200900000,SE 224,Residential,32062,0,32062,89394,0,121456
142340300100000,SE 224,Residential,28458,0,28458,118729,0,147187
142340300200000,SE 224,Residential,38663,0,38663,95528,0,134191
142340300300000,SE 224,Residential,24847,0,24847,115251,0,140098
142340300400000,SE 224,Residential,32831,0,32831,105229,0,138060
142340300500000,SE 224,Residential,32831,0,32831,114100,0,146931
142340400100000,SE 210,Residential,28458,0,28458,153702,0,182160
142340400200000,SE 210,Residential,31512,0,31512,177024,0,208536
142340400300000,SE 210,Residential,29892,0,29892,124189,0,154081
142340400400000,SE 210,Residential,22873,0,22873,102411,0,125284
142340400500000,SE 210,Residential,21150,0,21150,94664,0,115814
142340400600000,SE 210,Residential,21840,0,21840,141937,0,163777
142340400700000,SE 210,Residential,21312,0,21312,110719,0,132031
142340400800000,SE 210,Residential,21150,0,21150,106960,0,128110
142340400900000,SE 210,Residential,18960,0,18960,97506,0,116466
142340401000000,SE 210,Residential,26901,0,26901,123524,0,150425
142340401100000,SE 224,Residential,26560,0,26560,102486,0,129046
142340401200000,SE 224,Residential,30600,0,30600,85804,0,116404
142340401300000,SE 224,Residential,31185,0,31185,124735,0,155920
142340401400000,SE 224,Residential,29808,0,29808,95663,0,125471
142340401500000,SE 224,Residential,30576,0,30576,93568,0,124144
142340401600000,SE 224,Residential,26987,0,26987,136589,0,163576
142340401700000,SE 224,Residential,25200,0,25200,89629,0,114829
142340401800000,SE 224,Residential,25200,0,25200,90871,0,116071
142340401900000,SE 224,Residential,31196,0,31196,119118,0,150314
142340402000000,SE 224,Residential,30080,0,30080,104451,0,134531
142340402100000,SE 224,Residential,34000,0,34000,108984,0,142984
142340402200000,SE 224,Residential,34000,0,34000,111968,0,145968
142340402300000,SE 224,Residential,31512,0,31512,96585,0,128097
142340500100000,SE 224,Residential,29782,0,29782,101482,0,131264
142340500200000,SE 224,Residential,29469,0,29469,79415,0,108884
142340500300000,SE 224,Residential,29469,0,29469,68528,0,97997
142340500400000,SE 224,Residential,29469,0,29469,88083,0,117552
142340500500000,SE 224,Residential,29469,0,29469,97540,0,127009
142340500600000,SE 224,Residential,29469,0,29469,76132,0,105601
142340500700000,SE 224,Residential,29782,0,29782,84472,0,114254
142340500800000,SE 224,Residential,29782,0,29782,85278,0,115060
142340500900000,SE 224,Residential,29782,0,29782,91608,0,121390
142340501000000,SE 224,Residential,29782,0,29782,101018,0,130800
142340600100000,SE 224,Residential,32290,0,32290,99900,0,132190
142340600200000,SE 224,Residential,32290,0,32290,71823,0,104113
142340600300000,SE 224,Residential,32290,0,32290,85345,0,117635
142340600400000,SE 224,Residential,32290,0,32290,115152,0,147442
142340600500000,SE 224,Residential,32290,0,32290,83946,0,116236
142340700100000,SE 224,Residential,26752,0,26752,109103,0,135855
142340700200000,SE 224,Residential,23936,0,23936,81124,0,105060
142340700300000,SE 224,Residential,24218,0,24218,76663,0,100881
142340700400000,SE 224,Residential,25740,0,25740,78298,0,104038
142340700500000,SE 224,Residential,29100,0,29100,96571,0,125671
142340700600000,SE 224,Residential,23520,0,23520,80143,0,103663
142340800100000,SE 224,Residential,29991,0,29991,144996,0,174987
142340800200000,SE 224,Residential,25200,0,25200,81056,0,106256
142340800300000,SE 224,Residential,24600,0,24600,93013,0,117613
142340800400000,SE 224,Residential,29999,0,29999,108764,0,138763
142340800500000,SE 224,Residential,28583,0,28583,80158,0,108741
142340800600000,SE 224,Residential,29400,0,29400,76902,0,106302
142340800700000,SE 224,Residential,29400,0,29400,81864,0,111264
142340800800000,SE 224,Residential,29400,0,29400,79113,0,108513
142340800900000,SE 224,Residential,27900,0,27900,76049,0,103949
142340801000000,SE 224,Residential,30750,0,30750,81438,0,112188
142340801100000,SE 224,Residential,28350,0,28350,86951,0,115301
142340900100000,SE 224,Residential,28500,0,28500,113518,0,142018
142340900200000,SE 224,Residential,29331,0,29331,113170,0,142501
142340900300000,SE 224,Residential,30720,0,30720,111808,0,142528
142340900400000,SE 224,Residential,31040,0,31040,102187,0,133227
142340900500000,SE 224,Residential,29949,0,29949,129159,0,159108
142340900600000,SE 224,Residential,29988,0,29988,104156,0,134144
142340900700000,SE 224,Residential,29700,0,29700,72466,0,102166
142340900800000,SE 224,Residential,30856,0,30856,112528,0,143384
142340900900000,SE 224,Residential,29925,0,29925,78645,0,108570
142340901000000,SE 224,Residential,30887,0,30887,93529,0,124416
142340901100000,SE 224,Residential,29925,0,29925,82210,0,112135
142340901200000,SE 224,Residential,30400,0,30400,84812,0,115212
142340901300000,SE 224,Residential,28500,0,28500,94629,0,123129
142340901400000,SE 224,Residential,28500,0,28500,73750,0,102250
142341000100000,SE 224,Residential,29589,0,29589,101858,0,131447
142341000200000,SE 224,Residential,30600,0,30600,93630,0,124230
142341000300000,SE 224,Residential,32946,0,32946,95745,0,128691
142341000400000,SE 224,Residential,32320,0,32320,81888,0,114208
142341000500000,SE 224,Residential,31500,0,31500,109444,0,140944
142341000600000,SE 224,Residential,31500,0,31500,117799,0,149299
142341000700000,SE 224,Residential,30891,0,30891,96526,0,127417
142341100100000,SE 224,Residential,29073,0,29073,65838,0,94911
142341100200000,SE 224,Residential,28800,0,28800,84088,0,112888
142341100300000,SE 224,Residential,28800,0,28800,67519,0,96319
142341100400000,SE 224,Residential,29440,0,29440,68656,0,98096
142341100500000,SE 224,Residential,29440,0,29440,70493,0,99933
142341100600000,SE 224,Residential,30053,0,30053,79529,0,109582
142341100700000,SE 224,Residential,28520,0,28520,116964,0,145484
142342600100000,SE 224,Residential,28432,0,28432,72215,0,100647
142342600200000,SE 224,Residential,19892,0,19892,50785,0,70677
142342600300000,SE 224,Residential,17600,0,17600,37027,0,54627
142342600400000,SE 224,Residential,20000,0,20000,55401,0,75401
142342600500000,SE 224,Residential,20000,0,20000,36018,0,56018
142342600600000,SE 224,Residential,20000,0,20000,33063,0,53063
142342600800000,SE 224,Exempt,0,16000,16000,0,63642,79642
142342600900000,SE 224,Exempt,0,16534,16534,0,79722,96256
142342700100000,SE 224,Residential,33429,0,33429,95459,0,128888
142342700200000,SE 224,Residential,31680,0,31680,88931,0,120611
142342700300000,SE 224,Residential,26928,0,26928,76457,0,103385
142342700400000,SE 224,Residential,37975,0,37975,91130,0,129105
142342700500000,SE 224,Residential,33660,0,33660,66786,0,100446
142342700600000,SE 224,Residential,30000,0,30000,74263,0,104263
142342700700000,SE 224,Residential,30000,0,30000,92943,0,122943
142342700800000,SE 224,Residential,43680,0,43680,112801,0,156481
142342700900000,SE 224,Residential,31200,0,31200,62400,0,93600
142342701000000,SE 224,Residential,30600,0,30600,98554,0,129154
142342701100000,SE 224,Residential,30600,0,30600,66214,0,96814
142342701200000,SE 224,Residential,30600,0,30600,81146,0,111746
142342701300000,SE 224,Residential,36000,0,36000,78123,0,114123
142342701400000,SE 224,Residential,30000,0,30000,97865,0,127865
142342701500000,SE 224,Residential,30000,0,30000,80710,0,110710
142342701600000,SE 224,Residential,36000,0,36000,67976,0,103976
142342701700000,SE 224,Residential,36000,0,36000,76324,0,112324
142342702100000,SE 224,Residential,22275,0,22275,29013,0,51288
142342702200000,SE 224,Residential,24750,0,24750,79558,0,104308
142342702300000,SE 224,Residential,22275,0,22275,98167,0,120442
142342702400000,SE 224,Residential,23000,0,23000,71872,0,94872
142342702500000,SE 224,Residential,30000,0,30000,64054,0,94054
142342702600000,SE 224,Residential,25000,0,25000,73620,0,98620
142342702700000,SE 224,Residential,25000,0,25000,85782,0,110782
142342702800000,SE 224,Residential,30000,0,30000,90150,0,120150
142342702900000,SE 224,Residential,25500,0,25500,87760,0,113260
142342703000000,SE 224,Residential,25500,0,25500,64349,0,89849
142342703100000,SE 224,Residential,25500,0,25500,103453,0,128953
142342703200000,SE 224,Residential,29000,0,29000,89000,0,118000
142342703300000,SE 224,Residential,35000,0,35000,88924,0,123924
142342703400000,SE 224,Residential,26000,0,26000,52328,0,78328
142342703500000,SE 224,Residential,26000,0,26000,65266,0,91266
142342703600000,SE 224,Residential,28050,0,28050,57969,0,86019
142342703700000,SE 224,Residential,29835,0,29835,99384,0,129219
142342703800000,SE 224,Residential,29835,0,29835,53991,0,83826
142342703900000,SE 224,Residential,21333,0,21333,88392,0,109725
142342704000000,SE 224,Residential,20000,0,20000,109322,0,129322
142342704100000,SE 224,Residential,32000,0,32000,82521,0,114521
142342704200000,SE 224,Residential,20000,0,20000,53833,0,73833
142342704300000,BRANCH BANK/CU,Commercial,0,55041,55041,0,323788,378829
142342800100000,SE 224,Residential,33466,0,33466,44399,0,77865
142342800200000,SE 224,Residential,32000,0,32000,122900,0,154900
142342800300000,SE 224,Residential,20000,0,20000,44440,0,64440
142342800400000,SE 224,Residential,20000,0,20000,73464,0,93464
142342800500000,SE 224,Residential,20000,0,20000,44152,0,64152
142342800600000,SE 224,Residential,23167,0,23167,74566,0,97733
142342900100000,SE 224,Residential,21167,0,21167,73178,0,94345
142342900200000,SE 224,Residential,34069,0,34069,72896,0,106965
142342900300000,SE 224,Residential,28250,0,28250,82828,0,111078
142342900400000,SE 224,Residential,31075,0,31075,87927,0,119002
142342900500000,SE 224,Residential,28000,0,28000,57346,0,85346
142342900600000,SE 224,Residential,28000,0,28000,88264,0,116264
142342900700000,SE 224,Residential,40600,0,40600,134553,0,175153
142342900800000,SE 224,Residential,25000,0,25000,103977,0,128977
142342900900000,SE 224,Residential,29000,0,29000,75710,0,104710
142342901000000,SE 224,Residential,29000,0,29000,105396,0,134396
142342901100000,SE 224,Residential,29000,0,29000,67847,0,96847
142342901200000,SE 224,Residential,33900,0,33900,66756,0,100656
142342901300000,SE 224,Residential,25000,0,25000,100000,0,125000
142342901400000,SE 224,Residential,25000,0,25000,90482,0,115482
142342901500000,SE 224,Residential,30000,0,30000,64797,0,94797
142342901600000,SE 224,Residential,30000,0,30000,65677,0,95677
142342901700000,SE 224,Residential,23750,0,23750,108391,0,132141
142342901800000,SE 224,Residential,21375,0,21375,131818,0,153193
142342901900000,SE 224,Residential,21375,0,21375,83317,0,104692
142342902000000,SE 224,Residential,37088,0,37088,97498,0,134586
142342902100000,SE 224,Residential,33744,0,33744,126995,0,160739
142342902200000,SE 224,Residential,34271,0,34271,119045,0,153316
142342902300000,SE 224,Residential,27750,0,27750,115998,0,143748
142342902400000,SE 224,Residential,30250,0,30250,133368,0,163618
142342902500000,SE 224,Residential,40438,0,40438,91061,0,131499
142342902600000,SE 224,Residential,24720,0,24720,119255,0,143975
142342902700000,SE 224,Residential,24720,0,24720,133451,0,158171
142342902800000,SE 224,Residential,24720,0,24720,126641,0,151361
142342902900000,SE 224,Residential,24651,0,24651,118544,0,143195
142342903000000,SE 224,Residential,23105,0,23105,153705,0,176810
142342903100000,SE 224,Residential,27300,0,27300,159007,0,186307
142342903200000,SE 224,Residential,29748,0,29748,153399,0,183147
142342903300000,SE 224,Residential,32408,0,32408,153521,0,185929
142342903400000,SE 224,Residential,23806,0,23806,150362,0,174168
142342903500000,SE 224,Residential,21120,0,21120,106035,0,127155
142342903600000,SE 224,Residential,21120,0,21120,98607,0,119727
142342903700000,SE 224,Residential,22016,0,22016,120934,0,142950
142342903800000,SE 224,Residential,24738,0,24738,112929,0,137667
142342903900000,SE 224,Residential,24010,0,24010,122424,0,146434
142342904000000,SE 224,Residential,20401,0,20401,108067,0,128468
142342904100000,SE 224,Residential,21056,0,21056,117380,0,138436
142342904200000,SE 224,Residential,21060,0,21060,123214,0,144274
142342904300000,SE 224,Residential,21060,0,21060,100915,0,121975
142342904400000,SE 224,Residential,22477,0,22477,143301,0,165778
142342904500000,SE 224,Residential,34247,0,34247,131289,0,165536
142342904600000,SE 224,Residential,26807,0,26807,79132,0,105939
142342904700000,SE 224,Residential,24960,0,24960,84953,0,109913
142342904800000,SE 224,Residential,25460,0,25460,83464,0,108924
142342904900000,SE 223,Residential,25970,0,25970,79513,0,105483
142342905000000,SE 223,Residential,28090,0,28090,80828,0,108918
142342905100000,SE 223,Residential,28090,0,28090,91626,0,119716
142342905200000,SE 223,Residential,28090,0,28090,88476,0,116566
142342905300000,SE 223,Residential,28090,0,28090,68649,0,96739
142342905400000,SE 223,Residential,28090,0,28090,67137,0,95227
142342905500000,SE 223,Residential,27825,0,27825,69762,0,97587
142342905600000,SE 223,Residential,27825,0,27825,85387,0,113212
142342905700000,SE 223,Residential,28665,0,28665,54455,0,83120
142342905800000,SE 223,Residential,29250,0,29250,77443,0,106693
142342905900000,SE 223,Residential,29250,0,29250,41059,0,70309
142342906000000,SE 223,Residential,24250,0,24250,85859,0,110109
142342906100000,SE 223,Residential,29250,0,29250,68127,0,97377
142342906200000,SE 223,Residential,26550,0,26550,80698,0,107248
142342906300000,SE 223,Residential,26550,0,26550,76457,0,103007
142342906400000,SE 223,Residential,25370,0,25370,70405,0,95775
142342906500000,SE 223,Residential,23010,0,23010,91620,0,114630
142342906600000,SE 224,Residential,23197,0,23197,96755,0,119952
142342906700000,SE 224,Residential,36000,0,36000,84686,0,120686
142342906800000,SE 224,Residential,20000,0,20000,61576,0,81576
142342906900000,SE 224,Residential,33150,0,33150,112800,0,145950
142342907000000,SE 224,Residential,21000,0,21000,89056,0,110056
142342907100000,SE 224,Residential,20000,0,20000,69779,0,89779
142342907200000,SE 224,Residential,20000,0,20000,41674,0,61674
142342907300000,SE 224,Residential,20000,0,20000,78051,0,98051
142342907400000,SE 224,Residential,21167,0,21167,80968,0,102135
142342907500000,SE 224,Residential,28186,0,28186,105662,0,133848
142342907600000,SE 224,Residential,28186,0,28186,100331,0,128517
142342907700000,SE 224,Residential,19780,0,19780,99049,0,118829
142342907800000,SE 224,Residential,23000,0,23000,126721,0,149721
142342907900000,SE 224,Residential,24800,0,24800,99099,0,123899
142342908000000,SR/NURSING/ASSTD LIV,Commercial,0,39528,39528,0,331974,371502
142342908100000,SE 224,Residential,21840,0,21840,66509,0,88349
142342908200000,SE 224,Residential,19200,0,19200,70474,0,89674
142342908300000,SE 224,Residential,19200,0,19200,76122,0,95322
142342908400000,SE 224,Residential,20894,0,20894,110212,0,131106
142342908500000,SE 224,Residential,20857,0,20857,106202,0,127059
142342908600000,SE 224,Residential,20857,0,20857,105817,0,126674
142342908700000,SE 224,Residential,23833,0,23833,65529,0,89362
142342908800000,SE 224,Residential,25000,0,25000,65402,0,90402
142342908900000,SE 224,Residential,30000,0,30000,90272,0,120272
142342909000000,SE 224,Residential,25000,0,25000,100348,0,125348
142342909100000,SE 224,Residential,32000,0,32000,86094,0,118094
142343000100000,SE 224,Residential,21833,0,21833,66975,0,88808
142343000200000,SE 224,Residential,32000,0,32000,92917,0,124917
142343000300000,SE 224,Residential,20000,0,20000,63381,0,83381
142343000400000,SE 224,Residential,20000,0,20000,63453,0,83453
142343000500000,SE 224,Residential,20000,0,20000,76998,0,96998
142343000600000,SE 224,Residential,20000,0,20000,70141,0,90141
142343000700000,SE 224,Residential,20000,0,20000,74920,0,94920
142343000800000,SE 224,Residential,20000,0,20000,70535,0,90535
142343000900000,SE 224,Residential,32000,0,32000,81770,0,113770
142343001000000,SE 224,Residential,22403,0,22403,89190,0,111593
142345100100000,SE 223,Residential,23375,0,23375,0,0,23375
142345100200000,SE 223,Residential,34680,0,34680,112777,0,147457
142345100300000,SE 223,Residential,24072,0,24072,76928,0,101000
142345100400000,SE 223,Residential,24745,0,24745,77688,0,102433
142345100500000,SE 223,Residential,25250,0,25250,94179,0,119429
142345100600000,SE 223,Residential,26462,0,26462,79901,0,106363
142345100700000,SE 223,Residential,25385,0,25385,97142,0,122527
142345100800000,SE 223,Residential,23735,0,23735,75266,0,99001
142345100900000,SE 223,Residential,30300,0,30300,92026,0,122326
142345101000000,SE 223,Residential,30300,0,30300,73487,0,103787
142345101100000,SE 223,Residential,30855,0,30855,95962,0,126817
142345200100000,SE 223,Residential,22865,0,22865,111207,0,134072
142345200200000,SE 223,Residential,22185,0,22185,73541,0,95726
142345200300000,SE 223,Residential,23035,0,23035,67212,0,90247
142345200400000,SE 223,Residential,23338,0,23338,76802,0,100140
142345200500000,SE 223,Residential,22145,0,22145,77155,0,99300
142345200600000,SE 223,Residential,22660,0,22660,75884,0,98544
142345200700000,SE 223,Residential,22145,0,22145,60301,0,82446
142345200800000,SE 223,Residential,22660,0,22660,74414,0,97074
142345200900000,SE 223,Residential,28677,0,28677,87639,0,116316
142345201000000,SE 223,Residential,23347,0,23347,69348,0,92695
142345201100000,SE 223,Residential,22145,0,22145,83224,0,105369
142345201200000,SE 223,Residential,22660,0,22660,41249,0,63909
142345201300000,SE 223,Residential,29123,0,29123,79452,0,108575
142345201400000,SE 223,Residential,22145,0,22145,60600,0,82745
142345201500000,SE 223,Residential,21937,0,21937,45246,0,67183
142345201600000,SE 223,Residential,23685,0,23685,87228,0,110913
142345201700000,SE 223,Residential,30636,0,30636,99290,0,129926
142345300100000,SE 223,Residential,26500,0,26500,101410,0,127910
142345300200000,SE 223,Residential,31005,0,31005,91129,0,122134
142345300300000,SE 223,Residential,35535,0,35535,89596,0,125131
142345300400000,SE 223,Residential,25056,0,25056,83640,0,108696
142345300500000,SE 223,Residential,24784,0,24784,74749,0,99533
142345300600000,SE 223,Residential,24250,0,24250,84988,0,109238
142345300700000,SE 223,Residential,24250,0,24250,79535,0,103785
142345300800000,SE 223,Residential,24735,0,24735,62468,0,87203
142345300900000,SE 223,Residential,24250,0,24250,119088,0,143338
142345301000000,SE 223,Residential,24250,0,24250,85056,0,109306
142345301100000,SE 223,Residential,24250,0,24250,84095,0,108345
142345301200000,SE 223,Residential,24250,0,24250,73834,0,98084
142345301300000,SE 223,Residential,25000,0,25000,90360,0,115360
142345301400000,SE 223,Residential,24921,0,24921,99159,0,124080
142345301500000,SE 223,Residential,26070,0,26070,65505,0,91575
142345301600000,SE 223,Residential,25750,0,25750,82315,0,108065
142345301700000,SE 223,Residential,27300,0,27300,98557,0,125857
142345301800000,SE 223,Residential,27300,0,27300,75127,0,102427
142345301900000,SE 223,Residential,26250,0,26250,90540,0,116790
142345302000000,SE 223,Residential,26250,0,26250,92839,0,119089
142345302100000,SE 223,Residential,25257,0,25257,92609,0,117866
142345302200000,SE 223,Residential,26314,0,26314,76892,0,103206
142345302300000,SE 223,Residential,33000,0,33000,129253,0,162253
142345302400000,SE 223,Residential,28840,0,28840,125618,0,154458
142345302500000,SE 224,Residential,40930,0,40930,143331,0,184261
142345302600000,SE 224,Residential,35280,0,35280,80131,0,115411
142345302700000,SE 224,Residential,33129,0,33129,130694,0,163823
142345302800000,SE 224,Residential,36720,0,36720,82373,0,119093
142345302900000,SE 224,Residential,31620,0,31620,85604,0,117224
142345303000000,SE 224,Residential,30600,0,30600,74267,0,104867
142345303100000,SE 224,Residential,30600,0,30600,89159,0,119759
142345303200000,SE 224,Residential,31289,0,31289,78046,0,109335
142345303300000,SE 224,Residential,29610,0,29610,66157,0,95767
142345303400000,SE 224,Residential,28964,0,28964,63234,0,92198
142345303500000,SE 223,Residential,25500,0,25500,79328,0,104828
142345303600000,SE 223,Residential,25500,0,25500,78500,0,104000
142345303700000,SE 223,Residential,25500,0,25500,46447,0,71947
142345303800000,SE 223,Residential,25500,0,25500,87329,0,112829
142345303900000,SE 223,Residential,25500,0,25500,60187,0,85687
142345304000000,SE 223,Residential,25500,0,25500,80168,0,105668
142345304100000,SE 223,Residential,25419,0,25419,74933,0,100352
142345304200000,SE 223,Residential,25500,0,25500,64469,0,89969
142345304300000,SE 223,Residential,25500,0,25500,64235,0,89735
142345304400000,SE 223,Residential,25500,0,25500,91367,0,116867
142345304500000,SE 223,Residential,31319,0,31319,90960,0,122279
142345304600000,SE 223,Residential,20400,0,20400,71271,0,91671
142345304700000,SE 223,Residential,20400,0,20400,81502,0,101902
142345304800000,SE 223,Residential,30600,0,30600,92672,0,123272
142345304900000,SE 223,Residential,30600,0,30600,55795,0,86395
142345305000000,SE 223,Residential,20400,0,20400,75602,0,96002
142345305100000,SE 223,Residential,30600,0,30600,66853,0,97453
142345305200000,SE 223,Residential,32130,0,32130,79934,0,112064
142345305300000,SE 223,Residential,25500,0,25500,64902,0,90402
142345400100000,SE 223,Residential,24964,0,24964,42145,0,67109
142345400200000,SE 223,Residential,23287,0,23287,94585,0,117872
142345400300000,SE 223,Residential,22145,0,22145,70099,0,92244
142345400400000,SE 223,Residential,22660,0,22660,71594,0,94254
142345400500000,SE 223,Residential,22145,0,22145,73855,0,96000
142345400600000,SE 223,Residential,22660,0,22660,54058,0,76718
142345400700000,SE 223,Residential,22145,0,22145,57752,0,79897
142345400800000,SE 223,Residential,21973,0,21973,84564,0,106537
142345400900000,SE 223,Residential,23347,0,23347,84755,0,108102
142345401000000,SE 223,Residential,22145,0,22145,77205,0,99350
142345401100000,SE 223,Residential,23896,0,23896,78284,0,102180
142345401200000,SE 223,Residential,23896,0,23896,89126,0,113022
142345401300000,SE 223,Residential,23896,0,23896,80071,0,103967
142345401400000,SE 223,Residential,21879,0,21879,67214,0,89093
142345401500000,SE 223,Residential,23685,0,23685,65156,0,88841
142345401600000,SE 223,Residential,22725,0,22725,70927,0,93652
142345401700000,SE 223,Residential,22725,0,22725,65594,0,88319
142345401800000,SE 223,Residential,22725,0,22725,76012,0,98737
142345401900000,SE 223,Residential,22725,0,22725,59011,0,81736
142345500100000,SE 223,Residential,27089,0,27089,55950,0,83039
142345500200000,SE 223,Residential,28265,0,28265,89994,0,118259
142345500300000,SE 223,Residential,24745,0,24745,55716,0,80461
142345500400000,SE 223,Residential,24745,0,24745,60223,0,84968
142345500500000,SE 223,Residential,24745,0,24745,54737,0,79482
142345500600000,SE 223,Residential,24745,0,24745,97897,0,122642
142345500700000,SE 223,Residential,24745,0,24745,67137,0,91882
142345500800000,SE 223,Residential,24745,0,24745,68481,0,93226
142345500900000,SE 223,Residential,24745,0,24745,70325,0,95070
142345501000000,SE 223,Residential,24745,0,24745,70298,0,95043
142345501100000,OFFICE,Commercial,0,48978,48978,0,68022,117000
142345501200000,RESTAURANT,Commercial,0,40881,40881,0,47159,88040
142345600100000,SE 223,Residential,29286,0,29286,132113,0,161399
142345600200000,SE 223,Residential,26849,0,26849,75855,0,102704
142345600600000,SE 223,Residential,25500,0,25500,74574,0,100074
142345600700000,SE 223,Residential,25500,0,25500,80248,0,105748
142345600800000,SE 223,Residential,27030,0,27030,93782,0,120812
142345600900000,SE 223,Residential,23970,0,23970,71194,0,95164
142345601000000,SE 223,Residential,27030,0,27030,72014,0,99044
142345601100000,SE 224,Residential,29440,0,29440,80839,0,110279
142345601200000,SE 224,Residential,27600,0,27600,105982,0,133582
142345601300000,SE 224,Residential,30000,0,30000,42359,0,72359
142345601400000,SE 224,Residential,30000,0,30000,0,0,30000
142345601700000,SMALL RETAIL,Commercial,0,198720,198720,0,286835,485555
142345601800000,CHURCH,Exempt,0,12015,12015,0,0,12015
142345601900000,CHURCH,Exempt,0,13203,13203,0,0,13203
142345602000000,SMALL RETAIL,Commercial,0,58547,58547,0,17942,76489
142345602002000,ANTENNAS/TOWERS(BLL),Commercial,0,0,0,0,159550,159550
142345602100000,SMALL RETAIL,Commercial,0,128993,128993,0,156208,285201
142345602300000,SE 223,Residential,24745,0,24745,59629,0,84374
142345602400000,SE 223,Residential,24745,0,24745,87174,0,111919
142345602500000,SE 223,Residential,24745,0,24745,54398,0,79143
142345602600000,SE 223,Residential,24745,0,24745,77716,0,102461
142345602700000,SE 223,Residential,24745,0,24745,74375,0,99120
142345602800000,SE 223,Residential,24745,0,24745,61864,0,86609
142345602900000,SE 223,Residential,24745,0,24745,57925,0,82670
142345603000000,VACANT LAND,Commercial,0,62351,62351,0,0,62351
142345603100000,CHURCH,Exempt,0,669870,669870,0,6485170,7155040
142347600100000,SE 225,Residential,32550,0,32550,66028,0,98578
142347600200000,SE 225,Residential,30000,0,30000,71464,0,101464
142347600300000,SE 225,Residential,22700,0,22700,63580,0,86280
142347600400000,SE 225,Residential,33750,0,33750,84230,0,117980
142347700100000,SE 225,Residential,24583,0,24583,85337,0,109920
142347700200000,SE 225,Residential,25417,0,25417,66948,0,92365
142347700300000,SE 225,Residential,25000,0,25000,93916,0,118916
142347700400000,SE 225,Residential,25000,0,25000,73802,0,98802
142347700500000,SE 225,Residential,25000,0,25000,75558,0,100558
142347700600000,SE 225,Residential,25000,0,25000,76081,0,101081
142347700700000,SE 225,Residential,25000,0,25000,66198,0,91198
142347700800000,SE 225,Residential,25000,0,25000,71672,0,96672
142347700900000,SE 225,Residential,24500,0,24500,79807,0,104307
142347800100000,SE 225,Residential,29538,0,29538,88824,0,118362
142347800300000,CHURCH,Exempt,0,68291,68291,0,1248185,1316476
142347800400000,SE 223,Residential,27270,0,27270,91192,0,118462
142347800500000,SE 223,Residential,27270,0,27270,86951,0,114221
142347800600000,SE 223,Residential,27270,0,27270,81850,0,109120
142347800700000,SE 223,Residential,27270,0,27270,120309,0,147579
142347800800000,SE 223,Residential,27270,0,27270,67742,0,95012
142347800900000,SE 223,Residential,30991,0,30991,85173,0,116164
142347801000000,SE 223,Residential,29814,0,29814,73284,0,103098
142347801100000,SE 225,Residential,30426,0,30426,87574,0,118000
142347801200000,SE 225,Residential,25000,0,25000,75009,0,100009
142347801300000,SE 225,Residential,25000,0,25000,79141,0,104141
142347801400000,SE 225,Residential,25000,0,25000,84666,0,109666
142347801500000,SE 225,Residential,25000,0,25000,73726,0,98726
142347801600000,SE 225,Residential,25000,0,25000,85288,0,110288
142347801700000,SE 225,Residential,25000,0,25000,69901,0,94901
142347801800000,SE 225,Residential,25000,0,25000,69618,0,94618
142347802000000,SE 225,Exempt,0,25000,25000,1094,64035,90129
142347900100000,SE 223,Residential,30991,0,30991,102639,0,133630
142347900200000,SE 223,Residential,29500,0,29500,81612,0,111112
142347900300000,SE 223,Residential,33936,0,33936,101128,0,135064
142347900400000,SE 223,Residential,30300,0,30300,74909,0,105209
142347900500000,SE 223,Residential,30300,0,30300,65782,0,96082
142347900600000,SE 223,Residential,30300,0,30300,84829,0,115129
142347900700000,SE 223,Residential,30300,0,30300,106152,0,136452
142347900800000,SE 223,Residential,30300,0,30300,80767,0,111067
142347900900000,SE 223,Residential,30117,0,30117,61245,0,91362
142347901000000,SE 223,Residential,29808,0,29808,85555,0,115363
142348000100000,SE 223,Residential,23760,0,23760,65117,0,88877
142348000200000,SE 225,Residential,22968,0,22968,74721,0,97689
142348000300000,SE 225,Residential,22968,0,22968,44757,0,67725
142348000400000,SE 225,Residential,22968,0,22968,54985,0,77953
142348000500000,SE 225,Residential,22968,0,22968,61743,0,84711
142348000600000,SE 225,Residential,22968,0,22968,52390,0,75358
142348000700000,SE 225,Residential,22968,0,22968,68376,0,91344
142348000800000,SE 225,Residential,22968,0,22968,91177,0,114145
142348001000000,SE 225,Residential,41343,0,41343,82408,0,123751
142348001200000,SE 225,Residential,22968,0,22968,87648,0,110616
142348001300000,SE 225,Residential,22968,0,22968,70062,0,93030
142348001400000,SE 223,Residential,23760,0,23760,72449,0,96209
142348001500000,SE 223,Residential,22968,0,22968,62620,0,85588
142348001600000,SE 223,Residential,23760,0,23760,67469,0,91229
142348001700000,SE 223,Residential,23760,0,23760,75103,0,98863
142348001800000,SE 223,Residential,22968,0,22968,84876,0,107844
142348001900000,SE 223,Residential,22968,0,22968,53068,0,76036
142348002000000,SE 223,Residential,22968,0,22968,71801,0,94769
142348002100000,SE 223,Residential,22968,0,22968,69931,0,92899
142348100100000,SE 225,Residential,25000,0,25000,69937,0,94937
142348100200000,SE 225,Residential,24863,0,24863,46961,0,71824
142348100300000,SE 225,Residential,25000,0,25000,68572,0,93572
142348100400000,SE 225,Residential,25000,0,25000,79487,0,104487
142348100500000,SE 225,Residential,25000,0,25000,76630,0,101630
142348100600000,SE 225,Residential,25000,0,25000,80717,0,105717
142348100700000,SE 225,Residential,25000,0,25000,117785,0,142785
142348100800000,SE 225,Residential,25000,0,25000,69791,0,94791
142348100900000,SE 225,Residential,25000,0,25000,74891,0,99891
142348101000000,SE 225,Residential,25000,0,25000,116012,0,141012
142348101100000,SE 225,Residential,25000,0,25000,86801,0,111801
142348101200000,SE 225,Residential,25000,0,25000,68449,0,93449
142348101300000,SE 225,Residential,25000,0,25000,73782,0,98782
142348101400000,SE 225,Residential,25000,0,25000,79018,0,104018
142348101500000,SE 225,Residential,25000,0,25000,56657,0,81657
142348101600000,SE 225,Residential,25000,0,25000,64784,0,89784
142348101700000,SE 225,Residential,25000,0,25000,77136,0,102136
142348101800000,SE 225,Residential,25000,0,25000,89692,0,114692
142348200100000,SE 225,Residential,25000,0,25000,91588,0,116588
142348200200000,SE 225,Residential,25000,0,25000,93398,0,118398
142348200300000,SE 225,Residential,25000,0,25000,84970,0,109970
142348200400000,SE 225,Residential,25000,0,25000,67323,0,92323
142348200500000,SE 225,Residential,25000,0,25000,72761,0,97761
142348200600000,SE 225,Residential,25000,0,25000,57734,0,82734
142348200700000,SE 225,Residential,25000,0,25000,85077,0,110077
142348200800000,SE 225,Residential,25000,0,25000,52317,0,77317
142348200900000,SE 225,Residential,25000,0,25000,90471,0,115471
142348201000000,SE 225,Residential,25000,0,25000,114105,0,139105
142348201100000,SE 225,Residential,25000,0,25000,95091,0,120091
142348201200000,SE 225,Residential,35000,0,35000,85523,0,120523
142348201300000,SE 225,Residential,25000,0,25000,74710,0,99710
142348201400000,SE 225,Residential,25000,0,25000,60263,0,85263
142348201500000,SE 225,Residential,25000,0,25000,53547,0,78547
142348201600000,SE 225,Residential,35000,0,35000,141694,0,176694
142348300100000,SE 223,Residential,24840,0,24840,91738,0,116578
142348300200000,SE 225,Residential,23400,0,23400,77582,0,100982
142348300300000,SE 225,Residential,23400,0,23400,81760,0,105160
142348300400000,SE 225,Residential,23400,0,23400,87239,0,110639
142348300500000,SE 225,Residential,23400,0,23400,78766,0,102166
142348300600000,SE 225,Residential,23400,0,23400,86276,0,109676
142348300700000,SE 225,Residential,23400,0,23400,93163,0,116563
142348300800000,SE 225,Residential,23400,0,23400,66437,0,89837
142348300900000,SE 225,Residential,23400,0,23400,53428,0,76828
142348301000000,SE 225,Residential,23400,0,23400,55544,0,78944
142348301100000,CARWASH,Commercial,0,101777,101777,0,94524,196301
142348301200000,BRANCH BANK/CU,Commercial,0,379080,379080,0,830487,1209567
142348301500000,SE 223,Residential,24840,0,24840,91957,0,116797
142348400100000,SE 225,Residential,25000,0,25000,60488,0,85488
142348400400000,SE 225,Residential,25000,0,25000,78982,0,103982
142348400500000,SE 225,Residential,25000,0,25000,81060,0,106060
142348400600000,SE 225,Residential,25000,0,25000,107140,0,132140
142348400700000,SE 225,Residential,25000,0,25000,81526,0,106526
142348400800000,SE 225,Residential,25000,0,25000,79885,0,104885
142348400900000,SE 225,Residential,25000,0,25000,81275,0,106275
142348401000000,SE 225,Residential,25000,0,25000,85684,0,110684
142348401100000,SE 225,Residential,25000,0,25000,96593,0,121593
142348401200000,SE 225,Residential,25000,0,25000,79021,0,104021
142348401300000,SE 225,Residential,25000,0,25000,63234,0,88234
142348401400000,SE 225,Residential,25000,0,25000,53575,0,78575
142348401500000,SE 225,Residential,25000,0,25000,68511,0,93511
142348401600000,SE 225,Residential,25000,0,25000,96247,0,121247
142348401700000,SE 225,Residential,25000,0,25000,65877,0,90877
142348401800000,SE 225,Residential,24918,0,24918,50082,0,75000
142348402000000,SE 225,Residential,35000,0,35000,91064,0,126064
142348500100000,SE 225,Residential,33345,0,33345,75580,0,108925
142348500200000,SE 223,Residential,26320,0,26320,63014,0,89334
142348500300000,SE 223,Residential,26618,0,26618,56690,0,83308
142348500400000,SE 223,Residential,26010,0,26010,41615,0,67625
142348500500000,SE 223,Residential,26010,0,26010,38714,0,64724
142348500600000,SE 223,Residential,26010,0,26010,82301,0,108311
142348500700000,SE 223,Residential,26285,0,26285,45140,0,71425
142348500800000,SE 223,Residential,25500,0,25500,40790,0,66290
142348500900000,SE 223,Residential,25500,0,25500,54102,0,79602
142348501000000,LAUNDROMAT/CLEANERS,Commercial,0,63095,63095,0,125545,188640
142348501200000,SE 225,Residential,25000,0,25000,79678,0,104678
142348501300000,SE 225,Residential,25000,0,25000,87385,0,112385
142348501400000,SE 225,Residential,25000,0,25000,59404,0,84404
142348501500000,SE 225,Residential,25000,0,25000,54607,0,79607
142348501600000,SE 225,Residential,25000,0,25000,59900,0,84900
142348501700000,SE 225,Residential,25000,0,25000,88655,0,113655
142348501800000,SE 225,Residential,25000,0,25000,60591,0,85591
142348501900000,SMALL RETAIL,Commercial,0,145800,145800,0,506197,651997
142348600100000,SE 223,Residential,28684,0,28684,104794,0,133478
142348600200000,SE 223,Residential,28350,0,28350,54932,0,83282
142348600300000,SE 223,Residential,26520,0,26520,84919,0,111439
142348600400000,SE 223,Residential,26129,0,26129,60048,0,86177
142348600500000,SE 223,Residential,30600,0,30600,58938,0,89538
142348600600000,SE 223,Residential,30600,0,30600,68295,0,98895
142348600700000,FAST FOOD,Commercial,0,241110,241110,0,507979,749089
142348700100000,SE 225,Residential,25000,0,25000,103085,0,128085
142348700200000,SE 225,Residential,25000,0,25000,87222,0,112222
142348700300000,SE 225,Residential,25000,0,25000,85317,0,110317
142348700400000,SE 225,Residential,25000,0,25000,65510,0,90510
142348700500000,SE 225,Residential,25000,0,25000,83954,0,108954
142348700600000,SE 225,Residential,25000,0,25000,69622,0,94622
142348700700000,SE 225,Residential,25000,0,25000,77009,0,102009
142348700800000,SE 225,Residential,30000,0,30000,75021,0,105021
142348700900000,SE 225,Residential,16920,0,16920,69473,0,86393
142348701000000,SE 225,Residential,14430,0,14430,4662,0,19092
142348701100000,SE 225,Residential,17150,0,17150,54529,0,71679
142348701200000,SE 225,Residential,17150,0,17150,50119,0,67269
142348701300000,SE 225,Residential,17150,0,17150,59922,0,77072
142348701400000,SE 225,Residential,17150,0,17150,59069,0,76219
142348701500000,FAST FOOD,Commercial,0,109836,109836,0,233688,343524
142410200100000,SE 209,Residential,53602,0,53602,163210,0,216812
142410200200000,SE 209,Residential,51263,0,51263,172099,0,223362
142410200300000,SE 209,Residential,52393,0,52393,213192,0,265585
142412600100000,CITY PROPERTY,Exempt,0,0,0,0,0,0
142412600200000,SE 221,Residential,319700,0,319700,489768,0,809468
142412600500000,SE 221,Residential,110001,0,110001,188473,0,298474
142412700100000,SE 245,Residential,91624,0,91624,323387,0,415011
142412700200000,SE 245,Residential,100000,0,100000,327599,0,427599
142412700300000,SE 245,Residential,93767,0,93767,249281,0,343048
142415100100000,CHURCH,Exempt,0,301752,301752,0,1050436,1352188
142415100200000,SE 245,Residential,67305,0,67305,442599,0,509904
142415100300000,SE 245,Residential,64200,0,64200,340275,0,404475
142415100400000,SE 245,Residential,58752,0,58752,243198,0,301950
142415100500000,SE 245,Residential,61904,0,61904,314219,0,376123
142415100600000,SE 245,Residential,71734,0,71734,437691,0,509425
142415100700000,SE 245,Residential,81127,0,81127,443586,0,524713
142415100800000,SE 245,Residential,71168,0,71168,364696,0,435864
142415100900000,SE 245,Residential,75816,0,75816,359022,0,434838
142415101000000,SE 245,Residential,73776,0,73776,301842,0,375618
142415101100000,SE 245,Residential,77367,0,77367,318847,0,396214
142415101200000,SE 245,Residential,80922,0,80922,262415,0,343337
142415101300000,SE 245,Residential,74943,0,74943,326043,0,400986
142415101400000,SE 245,Residential,79860,0,79860,320001,0,399861
142415101500000,SE 245,Residential,83405,0,83405,277215,0,360620
142415101600000,SE 245,Residential,75504,0,75504,255500,0,331004
142415101700000,SE 245,Residential,73726,0,73726,264860,0,338586
142415101800000,SE 245,Residential,83941,0,83941,315721,0,399662
142415101900000,SE 245,Residential,87621,0,87621,331028,0,418649
142415200100000,SE 220,Residential,37440,0,37440,135804,0,173244
142415200200000,SE 220,Residential,38848,0,38848,133968,0,172816
142415200400000,SE 221,Residential,32000,0,32000,132539,0,164539
142415200500000,SE 221,Residential,31680,0,31680,119241,0,150921
142415200600000,SE 221,Residential,31680,0,31680,120530,0,152210
142415200700000,SE 221,Residential,32194,0,32194,130081,0,162275
142415300100000,SE 221,Residential,32000,0,32000,132900,0,164900
142415300200000,SE 221,Residential,32000,0,32000,136280,0,168280
142415300300000,SE 221,Residential,31999,0,31999,165263,0,197262
142415301900000,SE 221,Residential,35017,0,35017,122315,0,157332
142415302000000,SE 221,Residential,35378,0,35378,133238,0,168616
142415302100000,SE 221,Residential,35569,0,35569,114426,0,149995
142415302200000,SE 221,Residential,37482,0,37482,191954,0,229436
142415302300000,SE 221,Residential,39047,0,39047,145272,0,184319
142415302400000,SE 221,Residential,34497,0,34497,144547,0,179044
142415302500000,SE 221,Residential,31680,0,31680,154604,0,186284
142415302600000,SE 221,Residential,31680,0,31680,129522,0,161202
142415400100000,SE 221,Residential,31680,0,31680,169584,0,201264
142415400200000,SE 221,Residential,31680,0,31680,108914,0,140594
142415400300000,SE 221,Residential,31680,0,31680,121066,0,152746
142415400400000,SE 221,Residential,31679,0,31679,123817,0,155496
142415400500000,SE 221,Residential,31680,0,31680,128214,0,159894
142415400600000,SE 221,Residential,30790,0,30790,132702,0,163492
142415400700000,SE 221,Residential,37647,0,37647,126417,0,164064
142415400800000,SE 221,Residential,33815,0,33815,138925,0,172740
142415400900000,SE 221,Residential,32640,0,32640,112155,0,144795
142415401000000,SE 221,Residential,35672,0,35672,90266,0,125938
142415401100000,SE 221,Residential,37737,0,37737,140736,0,178473
142415401200000,SE 221,Residential,36267,0,36267,117926,0,154193
142415401300000,SE 221,Residential,32592,0,32592,155916,0,188508
142415401400000,SE 221,Residential,32592,0,32592,130671,0,163263
142415401500000,SE 221,Residential,32592,0,32592,124980,0,157572
142415401600000,SE 221,Residential,32593,0,32593,123423,0,156016
142415401700000,SE 221,Residential,38016,0,38016,184433,0,222449
142415401800000,SE 221,Residential,39110,0,39110,126013,0,165123
142415402600000,SE 221,Residential,31679,0,31679,146167,0,177846
142415402700000,SE 221,Residential,31368,0,31368,157510,0,188878
142415402800000,SE 221,Residential,36018,0,36018,140722,0,176740
142415402900000,SE 221,Residential,34910,0,34910,133218,0,168128
142415403000000,SE 221,Residential,31680,0,31680,139953,0,171633
142415403100000,SE 221,Residential,31680,0,31680,135422,0,167102
142415403200000,SE 221,Residential,31680,0,31680,134948,0,166628
142415403300000,SE 221,Residential,31681,0,31681,114370,0,146051
142415403400000,SE 221,Residential,31680,0,31680,135919,0,167599
142415500100000,SE 221,Residential,37153,0,37153,126313,0,163466
142415500200000,SE 221,Residential,35600,0,35600,133275,0,168875
142415500300000,SE 221,Residential,33320,0,33320,130338,0,163658
142415500400000,SE 221,Residential,34580,0,34580,126772,0,161352
142415500500000,SE 221,Residential,36972,0,36972,127446,0,164418
142415500600000,SE 221,Residential,36704,0,36704,157096,0,193800
142415500700000,SE 221,Residential,34579,0,34579,168892,0,203471
142415500800000,SE 221,Residential,33320,0,33320,118633,0,151953
142415600100000,SE 221,Residential,32592,0,32592,156996,0,189588
142415600200000,SE 221,Residential,32592,0,32592,129550,0,162142
142415600300000,SE 221,Residential,32592,0,32592,152106,0,184698
142415600400000,SE 221,Residential,32592,0,32592,134636,0,167228
142415600500000,SE 221,Residential,34144,0,34144,130487,0,164631
142415600600000,SE 221,Residential,32592,0,32592,151153,0,183745
142415600700000,SE 221,Residential,32592,0,32592,149946,0,182538
142415600800000,SE 221,Residential,33244,0,33244,128753,0,161997
142417600100000,SE 219,Residential,105020,0,105020,721119,0,826139
142417600200000,SE 219,Residential,103620,0,103620,0,0,103620
142417600400000,SE 219,Residential,57000,0,57000,704,0,57704
142417600500000,SE 219,Residential,64816,0,64816,322159,0,386975
142417600600000,SE 219,Residential,64662,0,64662,252997,0,317659
142417600700000,SE 219,Residential,79726,0,79726,310455,0,390181
142417600800000,SE 219,Residential,66569,0,66569,373048,0,439617
142417600900000,SE 219,Residential,68462,0,68462,354593,0,423055
142417601000000,SE 219,Residential,59684,0,59684,0,0,59684
142417601100000,SE 219,Residential,75420,0,75420,376292,0,451712
142417601200000,SE 219,Residential,53774,0,53774,288124,0,341898
142417601300000,SE 219,Residential,76500,0,76500,278188,0,354688
142417601400000,SE 219,Residential,55930,0,55930,314390,0,370320
142417601500000,SE 219,Residential,109220,0,109220,406450,0,515670
142417601600000,CENTRALLY ASSESSED,Other,0,0,0,0,0,0
142417700100000,SE 220,Residential,36117,0,36117,123696,0,159813
142417700200000,SE 220,Residential,36492,0,36492,125079,0,161571
142417700300000,SE 220,Residential,42330,0,42330,195288,0,237618
142417700400000,SE 220,Residential,35948,0,35948,149608,0,185556
142417700500000,SE 220,Residential,34744,0,34744,147458,0,182202
142417800100000,SE 220,Residential,39206,0,39206,170719,0,209925
142417800200000,SE 220,Residential,42714,0,42714,151655,0,194369
142417800300000,SE 220,Residential,42039,0,42039,146215,0,188254
142417800400000,SE 220,Residential,41600,0,41600,187161,0,228761
142417800500000,SE 220,Residential,36960,0,36960,199797,0,236757
142417800600000,SE 220,Residential,34513,0,34513,163448,0,197961
142417800700000,SE 220,Residential,34200,0,34200,163109,0,197309
142417800800000,SE 220,Residential,46147,0,46147,212027,0,258174
142417900100000,SE 220,Residential,42776,0,42776,144117,0,186893
142417900200000,SE 220,Residential,51979,0,51979,171672,0,223651
142417900300000,SE 220,Residential,38548,0,38548,237981,0,276529
142417900400000,SE 220,Residential,39661,0,39661,110810,0,150471
142417900500000,SE 220,Residential,38280,0,38280,123357,0,161637
142417900600000,SE 220,Residential,42016,0,42016,120168,0,162184
142417900700000,SE 220,Residential,35067,0,35067,102645,0,137712
142417900800000,SE 220,Residential,33560,0,33560,129310,0,162870
142417900900000,SE 220,Residential,44336,0,44336,118088,0,162424
142417901000000,SE 220,Residential,44708,0,44708,211665,0,256373
142417901100000,SE 220,Residential,43003,0,43003,141090,0,184093
142417901200000,SE 220,Residential,39240,0,39240,149856,0,189096
142417901300000,SE 220,Residential,41283,0,41283,118962,0,160245
142417901400000,SE 220,Residential,38178,0,38178,174373,0,212551
142417901500000,SE 220,Residential,37353,0,37353,129578,0,166931
142417901600000,SE 220,Residential,36040,0,36040,230877,0,266917
142417901700000,SE 220,Residential,36000,0,36000,167698,0,203698
142417901800000,SE 220,Residential,36000,0,36000,120307,0,156307
142417901900000,SE 220,Residential,33067,0,33067,148376,0,181443
142417902000000,SE 220,Residential,35687,0,35687,164680,0,200367
142417902100000,SE 220,Residential,36393,0,36393,116865,0,153258
142417902200000,SE 220,Residential,36720,0,36720,126578,0,163298
142417902300000,SE 220,Residential,39520,0,39520,152289,0,191809
142418000100000,SE 220,Residential,20,0,20,0,0,20
142420100100000,SE 210,Residential,33840,0,33840,175218,0,209058
142420100200000,SE 210,Residential,33840,0,33840,208643,0,242483
142420100300000,SE 210,Residential,28200,0,28200,169064,0,197264
142420100400000,SE 210,Residential,27900,0,27900,190045,0,217945
142420100500000,SE 210,Residential,45685,0,45685,207226,0,252911
142420100600000,SE 210,Residential,43537,0,43537,211538,0,255075
142420100700000,SE 210,Residential,42584,0,42584,173084,0,215668
142420100800000,SE 210,Residential,36664,0,36664,242382,0,279046
142420100900000,SE 210,Residential,36720,0,36720,200999,0,237719
142420101000000,SE 210,Residential,36720,0,36720,186773,0,223493
142420101100000,SE 210,Residential,36290,0,36290,213238,0,249528
142420101200000,CENTRALLY ASSESSED,Other,0,0,0,0,0,0
142420101300000,SE 210,Residential,61244,0,61244,230882,0,292126
142420101400000,SE 210,Residential,44000,0,44000,265744,0,309744
142420101500000,SE 210,Residential,36800,0,36800,246119,0,282919
142420101600000,SE 210,Residential,37200,0,37200,230140,0,267340
142420101700000,SE 210,Residential,37600,0,37600,249796,0,287396
142420101800000,SE 210,Residential,43062,0,43062,169955,0,213017
142420101900000,SE 210,Residential,42749,0,42749,245651,0,288400
142420102000000,SE 210,Residential,49099,0,49099,229044,0,278143
142420102100000,SE 210,Residential,45288,0,45288,269515,0,314803
142420102200000,SE 210,Residential,51760,0,51760,305580,0,357340
142420200100000,SE 210,Residential,41072,0,41072,278049,0,319121
142420300100000,SE 210,Residential,36720,0,36720,221437,0,258157
142420400100000,SE 210,Residential,40320,0,40320,170102,0,210422
142420400200000,SE 210,Residential,34168,0,34168,114806,0,148974
142420400300000,SE 210,Residential,34950,0,34950,127117,0,162067
142420400400000,SE 210,Residential,36480,0,36480,127381,0,163861
142420400500000,SE 210,Residential,37760,0,37760,180225,0,217985
142420400600000,SE 210,Residential,39040,0,39040,126407,0,165447
142420400700000,SE 210,Residential,38400,0,38400,202556,0,240956
142420400800000,SE 210,Residential,41200,0,41200,103603,0,144803
142420400900000,SE 210,Residential,41040,0,41040,153272,0,194312
142420401000000,SE 210,Residential,40320,0,40320,128416,0,168736
142420500100000,SE 210,Residential,39016,0,39016,108546,0,147562
142420500200000,SE 210,Residential,38766,0,38766,124458,0,163224
142420500300000,SE 210,Residential,38102,0,38102,102450,0,140552
142420500400000,SE 210,Residential,38800,0,38800,171074,0,209874
142420500500000,SE 210,Residential,38800,0,38800,116389,0,155189
142420500600000,SE 210,Residential,39461,0,39461,174111,0,213572
142420500700000,SE 210,Residential,39600,0,39600,168096,0,207696
142420500800000,SE 210,Residential,39531,0,39531,127665,0,167196
142420500900000,SE 210,Residential,37440,0,37440,107954,0,145394
142420501000000,SE 210,Residential,35280,0,35280,164555,0,199835
142420501100000,SE 210,Residential,36360,0,36360,149428,0,185788
142420501200000,SE 210,Residential,35640,0,35640,122688,0,158328
142420501300000,SE 210,Residential,33690,0,33690,147079,0,180769
142420501400000,SE 210,Residential,36403,0,36403,138640,0,175043
142420501500000,SE 210,Residential,38528,0,38528,94224,0,132752
142420501600000,SE 210,Residential,38800,0,38800,191887,0,230687
142420501700000,SE 210,Residential,34920,0,34920,138244,0,173164
142420600100000,SE 210,Residential,35944,0,35944,154310,0,190254
142420600200000,SE 210,Residential,2750,0,2750,0,0,2750
142420600300000,SE 210,Residential,34772,0,34772,116881,0,151653
142420600400000,SE 210,Residential,36860,0,36860,102017,0,138877
142420600500000,SE 210,Residential,36860,0,36860,121270,0,158130
142420600600000,SE 210,Residential,38800,0,38800,137793,0,176593
142420600700000,SE 210,Residential,38800,0,38800,129893,0,168693
142420600800000,SE 210,Residential,38800,0,38800,143571,0,182371
142420600900000,SE 210,Residential,38800,0,38800,145497,0,184297
142420601000000,SE 210,Residential,39318,0,39318,104115,0,143433
142420601100000,SE 210,Residential,33827,0,33827,128931,0,162758
142420601200000,SE 210,Residential,34515,0,34515,148749,0,183264
142420601300000,SE 210,Residential,34920,0,34920,110883,0,145803
142420601400000,SE 210,Residential,34920,0,34920,170351,0,205271
142420601500000,SE 210,Residential,34920,0,34920,146375,0,181295
142420601600000,SE 210,Residential,34920,0,34920,129551,0,164471
142420700100000,SE 210,Residential,36495,0,36495,163110,0,199605
142420700200000,SE 210,Residential,34705,0,34705,120041,0,154746
142420700300000,SE 210,Residential,35280,0,35280,124997,0,160277
142420700400000,SE 210,Residential,35280,0,35280,181743,0,217023
142420700500000,SE 210,Residential,35280,0,35280,112135,0,147415
142420700600000,SE 210,Residential,36456,0,36456,131271,0,167727
142420700700000,SE 210,Residential,36456,0,36456,97714,0,134170
142420700800000,SE 210,Residential,36456,0,36456,156939,0,193395
142420700900000,SE 210,Residential,36456,0,36456,143530,0,179986
142420701000000,SE 210,Residential,36456,0,36456,146163,0,182619
142420701100000,SE 210,Residential,34783,0,34783,174363,0,209146
142420800100000,SE 210,Residential,44440,0,44440,200636,0,245076
142420800200000,SE 210,Residential,36360,0,36360,104413,0,140773
142420800300000,SE 210,Residential,36360,0,36360,115413,0,151773
142420800400000,SE 210,Residential,36360,0,36360,109016,0,145376
142422600100000,SE 211,Residential,100,0,100,0,0,100
142422600200000,SE 211,Residential,59042,0,59042,167848,0,226890
142422600300000,SE 211,Residential,60437,0,60437,184038,0,244475
142422600400000,SE 211,Residential,60437,0,60437,196480,0,256917
142422600500000,SE 211,Residential,59649,0,59649,171307,0,230956
142422600600000,SE 211,Residential,54947,0,54947,175464,0,230411
142422600700000,SE 211,Residential,64755,0,64755,128671,0,193426
142422600800000,SE 211,Residential,138550,0,138550,287859,0,426409
142422600900000,SE 211,Residential,59207,0,59207,155548,0,214755
142422601000000,SE 211,Residential,62985,0,62985,182224,0,245209
142422601100000,SE 211,Residential,67925,0,67925,168066,0,235991
142422601200000,SE 211,Residential,46900,0,46900,191541,0,238441
142422601300000,SE 211,Residential,49300,0,49300,121280,0,170580
142422601400000,SE 211,Residential,48346,0,48346,213282,0,261628
142422601500000,SE 211,Residential,57545,0,57545,199003,0,256548
142422601600000,SE 211,Residential,51848,0,51848,146542,0,198390
142422601700000,SE 211,Residential,50325,0,50325,136207,0,186532
142422601800000,SE 211,Residential,51667,0,51667,137984,0,189651
142422601900000,SE 211,Residential,52250,0,52250,131947,0,184197
142422602000000,SE 211,Residential,49284,0,49284,134059,0,183343
142422602100000,SE 211,Residential,41600,0,41600,171520,0,213120
142422602200000,SE 211,Residential,62243,0,62243,165360,0,227603
142422602300000,SE 211,Residential,60442,0,60442,195030,0,255472
142422602400000,SE 211,Residential,49000,0,49000,180585,0,229585
142422602500000,SE 211,Residential,49000,0,49000,168196,0,217196
142422602600000,SE 211,Residential,62100,0,62100,360012,0,422112
142422602700000,SE 211,Residential,60375,0,60375,202235,0,262610
142422602800000,SE 211,Residential,62675,0,62675,319389,0,382064
142422602900000,SE 211,Residential,66125,0,66125,227179,0,293304
142422603000000,SE 211,Residential,75839,0,75839,210203,0,286042
142422603100000,SE 211,Residential,71860,0,71860,229847,0,301707
142422603200000,SE 211,Residential,67996,0,67996,216506,0,284502
142422603300000,SE 211,Residential,52866,0,52866,231438,0,284304
142422603400000,SE 211,Residential,67999,0,67999,208096,0,276095
142422603500000,SE 211,Residential,70150,0,70150,255441,0,325591
142422603600000,SE 211,Residential,70725,0,70725,265756,0,336481
142422603700000,SE 211,Residential,4895,0,4895,0,0,4895
142422603800000,SE 211,Residential,64200,0,64200,226109,0,290309
142422603900000,SE 211,Residential,65895,0,65895,211535,0,277430
142422604000000,SE 211,Residential,56320,0,56320,291809,0,348129
142422604100000,SE 211,Residential,48500,0,48500,137258,0,185758
142422604200000,SE 211,Residential,50642,0,50642,139416,0,190058
142422604300000,SE 211,Residential,69212,0,69212,168613,0,237825
142422604400000,SE 211,Residential,65914,0,65914,174623,0,240537
142422604500000,SE 211,Residential,53580,0,53580,166547,0,220127
142422604600000,SE 211,Residential,39949,0,39949,172950,0,212899
142422604700000,SE 211,Residential,2060,0,2060,0,0,2060
142422700100000,SE 211,Residential,52800,0,52800,171641,0,224441
142422700200000,SE 211,Residential,55290,0,55290,143395,0,198685
142422700300000,SE 211,Residential,43120,0,43120,194738,0,237858
142422700400000,SE 211,Residential,43120,0,43120,173537,0,216657
142422700500000,SE 211,Residential,43120,0,43120,133064,0,176184
142422700600000,SE 211,Residential,52525,0,52525,159308,0,211833
142422700700000,SE 211,Residential,52800,0,52800,135245,0,188045
142422700800000,SE 211,Residential,53900,0,53900,141942,0,195842
142422700900000,SE 211,Residential,53900,0,53900,136126,0,190026
142422701000000,SE 211,Residential,53900,0,53900,149285,0,203185
142425100100000,SE 211,Residential,132900,0,132900,334916,0,467816
142425100200000,SE 211,Residential,98745,0,98745,375594,0,474339
142425100300000,SE 211,Residential,84989,0,84989,0,0,84989
142425100400000,SE 211,Residential,96344,0,96344,387072,0,483416
142425100500000,SE 211,Residential,86966,0,86966,353141,0,440107
142425100600000,SE 211,Residential,83470,0,83470,328721,0,412191
142425100700000,SE 211,Residential,88571,0,88571,362414,0,450985
142425100800000,SE 211,Residential,106744,0,106744,561402,0,668146
142425100900000,SE 211,Residential,91205,0,91205,307827,0,399032
142425101200000,SE 211,Residential,128400,0,128400,541208,0,669608
142425101400000,SE 211,Residential,112500,0,112500,297630,0,410130
142425101500000,SE 211,Residential,100000,0,100000,244187,0,344187
142425101600000,SE 211,Residential,94711,0,94711,293797,0,388508
142425101700000,SE 211,Residential,93065,0,93065,278085,0,371150
142425101800000,SE 211,Residential,101420,0,101420,282879,0,384299
142425101900000,SE 211,Residential,100820,0,100820,291517,0,392337
142425102000000,SE 211,Residential,104420,0,104420,259035,0,363455
142425102100000,SE 211,Residential,104720,0,104720,293241,0,397961
142425102200000,SE 211,Residential,73234,0,73234,260626,0,333860
142425102300000,SE 211,Exempt,0,118020,118020,0,580852,698872
142425102400000,SE 211,Residential,62080,0,62080,210785,0,272865
142425102500000,SE 210,Residential,48300,0,48300,180521,0,228821
142425102600000,SE 210,Residential,53500,0,53500,251484,0,304984
142425102700000,SE 210,Residential,52428,0,52428,154756,0,207184
142425102800000,SE 210,Residential,52364,0,52364,119061,0,171425
142425102900000,SE 210,Residential,47080,0,47080,144765,0,191845
142425103000000,SE 210,Residential,43248,0,43248,115514,0,158762
142425103100000,SE 210,Residential,43370,0,43370,117123,0,160493
142425103200000,SE 210,Residential,43956,0,43956,148995,0,192951
142425103300000,SE 210,Residential,47460,0,47460,134399,0,181859
142425103400000,SE 210,Residential,60250,0,60250,179467,0,239717
142425103500000,SE 210,Residential,47834,0,47834,119099,0,166933
142425103700000,SE 211,Residential,74375,0,74375,0,0,74375
142425103900000,SE 211,Residential,51450,0,51450,0,0,51450
142425104000000,SE 211,Residential,135000,0,135000,692755,0,827755
142425200100000,SE 210,Residential,41205,0,41205,180782,0,221987
142425200200000,SE 210,Residential,42835,0,42835,91865,0,134700
142425200300000,SE 210,Residential,41189,0,41189,83000,0,124189
142427600100000,SE 210,Residential,36360,0,36360,131407,0,167767
142427600200000,SE 210,Residential,36360,0,36360,123734,0,160094
142427600300000,SE 210,Residential,36360,0,36360,117842,0,154202
142427600400000,SE 210,Residential,36360,0,36360,107211,0,143571
142427600500000,SE 210,Residential,36360,0,36360,133685,0,170045
142427600600000,SE 210,Residential,41778,0,41778,138410,0,180188
142427700100000,SE 210,Residential,42800,0,42800,152845,0,195645
142427700200000,SE 210,Residential,35640,0,35640,128125,0,163765
142427700300000,SE 210,Residential,40073,0,40073,166497,0,206570
142427700400000,SE 210,Residential,37200,0,37200,166136,0,203336
142427700500000,SE 210,Residential,36800,0,36800,194551,0,231351
142427700600000,SE 210,Residential,36800,0,36800,124552,0,161352
142427800100000,SE 210,Residential,41013,0,41013,156504,0,197517
142427800200000,SE 210,Residential,35020,0,35020,125359,0,160379
142427800300000,SE 210,Residential,33660,0,33660,94770,0,128430
142427800400000,SE 210,Residential,36432,0,36432,109094,0,145526
142427800500000,SE 210,Residential,34796,0,34796,113552,0,148348
142427900100000,SE 210,Residential,34000,0,34000,101437,0,135437
142427900200000,SE 210,Residential,34000,0,34000,108312,0,142312
142427900300000,SE 210,Residential,34000,0,34000,104920,0,138920
142427900400000,SE 210,Residential,34000,0,34000,157416,0,191416
142427900500000,SE 210,Residential,34000,0,34000,115630,0,149630
142427900600000,SE 210,Residential,33867,0,33867,144051,0,177918
142427900700000,SE 210,Residential,37482,0,37482,114495,0,151977
142427900800000,SE 210,Residential,36040,0,36040,118918,0,154958
142427900900000,SE 210,Residential,36040,0,36040,108885,0,144925
142427901000000,SE 210,Residential,36040,0,36040,114183,0,150223
142427901100000,SE 210,Residential,36040,0,36040,108065,0,144105
142427901200000,SE 210,Residential,36040,0,36040,114946,0,150986
142427901300000,SE 210,Residential,36040,0,36040,123056,0,159096
142428000100000,SE 210,Residential,37642,0,37642,127800,0,165442
142428000200000,SE 210,Residential,45635,0,45635,175087,0,220722
142428000300000,SE 210,Residential,44147,0,44147,160585,0,204732
142428000400000,SE 210,Residential,39573,0,39573,111373,0,150946
142428000500000,SE 210,Residential,40000,0,40000,140452,0,180452
142428000600000,SE 210,Residential,41894,0,41894,113064,0,154958
142428000700000,SE 210,Residential,43795,0,43795,103300,0,147095
142428000800000,SE 210,Residential,45108,0,45108,327631,0,372739
142428000900000,SE 210,Residential,44478,0,44478,141225,0,185703
142428100100000,SE 210,Residential,33392,0,33392,118126,0,151518
142428100200000,SE 210,Residential,33762,0,33762,155516,0,189278
142428100300000,SE 210,Residential,34204,0,34204,139009,0,173213
142428100400000,SE 210,Residential,34333,0,34333,124624,0,158957
142428100500000,SE 210,Residential,34804,0,34804,109475,0,144279
142428100600000,SE 210,Residential,35343,0,35343,138609,0,173952
142428100700000,SE 210,Residential,35086,0,35086,120810,0,155896
142428200100000,SE 210,Residential,38170,0,38170,113438,0,151608
142428200200000,SE 210,Residential,37740,0,37740,133145,0,170885
142428200300000,SE 210,Residential,37740,0,37740,163408,0,201148
142428200400000,SE 210,Residential,37475,0,37475,84504,0,121979
142428200500000,SE 210,Residential,36720,0,36720,121091,0,157811
142428200600000,SE 210,Residential,36040,0,36040,111846,0,147886
142428200700000,SE 210,Residential,37536,0,37536,103887,0,141423
142428200800000,SE 210,Residential,40032,0,40032,149475,0,189507
142428200900000,SE 210,Residential,42154,0,42154,120473,0,162627
142428201000000,SE 210,Residential,46250,0,46250,144292,0,190542
142428201100000,SE 210,Residential,42401,0,42401,143698,0,186099
142428201200000,SE 210,Residential,41636,0,41636,130478,0,172114
142428201300000,SE 210,Residential,48561,0,48561,126456,0,175017
142428201400000,SE 210,Residential,46354,0,46354,147683,0,194037
142428201500000,SE 210,Residential,47236,0,47236,132264,0,179500
142428201600000,SE 210,Residential,48576,0,48576,182540,0,231116
142428201700000,SE 210,Residential,48536,0,48536,163625,0,212161
142428201800000,SE 210,Residential,46398,0,46398,123152,0,169550
142428201900000,SE 210,Residential,45562,0,45562,143363,0,188925
142428202000000,SE 210,Residential,49426,0,49426,238838,0,288264
142428202100000,SE 210,Residential,41208,0,41208,199981,0,241189
142428202200000,SE 210,Residential,43639,0,43639,185001,0,228640
142428202300000,SE 210,Residential,42636,0,42636,102397,0,145033
142428202400000,SE 210,Residential,43890,0,43890,100619,0,144509
142428202500000,SE 210,Residential,41616,0,41616,152549,0,194165
142428202600000,SE 210,Residential,45426,0,45426,119834,0,165260
142428300100000,SE 210,Residential,44727,0,44727,111496,0,156223
142428300200000,SE 210,Residential,40293,0,40293,132176,0,172469
142428300300000,SE 210,Residential,40656,0,40656,151334,0,191990
142428300400000,SE 210,Residential,40577,0,40577,119799,0,160376
142428300500000,SE 210,Residential,40669,0,40669,100197,0,140866
142428300600000,SE 210,Residential,38247,0,38247,81084,0,119331
142428300700000,SE 210,Residential,38318,0,38318,88850,0,127168
142430100100000,SE 210,Residential,37318,0,37318,110308,0,147626
142430100200000,SE 210,Residential,31360,0,31360,111375,0,142735
142430100300000,SE 210,Residential,29074,0,29074,110167,0,139241
142430100400000,SE 210,Residential,32275,0,32275,79204,0,111479
142430100500000,SE 210,Residential,31020,0,31020,95039,0,126059
142430100600000,SE 210,Residential,34533,0,34533,119500,0,154033
142430100700000,SE 210,Residential,27744,0,27744,109450,0,137194
142430100800000,SE 210,Residential,28149,0,28149,128607,0,156756
142430100900000,SE 210,Residential,28420,0,28420,80893,0,109313
142430101000000,SE 210,Residential,28420,0,28420,78008,0,106428
142430101100000,SE 210,Residential,28420,0,28420,87925,0,116345
142430101200000,SE 210,Residential,28980,0,28980,74710,0,103690
142430101300000,SE 210,Residential,28704,0,28704,90741,0,119445
142430101400000,SE 210,Residential,31428,0,31428,106776,0,138204
142430101500000,SE 210,Residential,28037,0,28037,74334,0,102371
142430200100000,SE 210,Residential,64350,0,64350,194984,0,259334
142430200200000,SE 210,Residential,61050,0,61050,142492,0,203542
142430200300000,SE 210,Residential,34593,0,34593,125188,0,159781
142430200400000,SE 210,Residential,35178,0,35178,128898,0,164076
142430200500000,SE 210,Residential,37625,0,37625,140956,0,178581
142430200600000,SE 210,Residential,34092,0,34092,142075,0,176167
142430200700000,SE 210,Residential,30975,0,30975,145218,0,176193
142430200800000,SE 210,Residential,29808,0,29808,142497,0,172305
142430200900000,SE 210,Residential,39268,0,39268,153185,0,192453
142430201000000,SE 210,Residential,37223,0,37223,147453,0,184676
142430201100000,SE 210,Residential,32724,0,32724,149220,0,181944
142430201200000,SE 210,Residential,34542,0,34542,148442,0,182984
142430201300000,SE 210,Residential,34200,0,34200,133251,0,167451
142430201400000,SE 210,Residential,31960,0,31960,172214,0,204174
142430201500000,SE 210,Residential,34295,0,34295,144564,0,178859
142430201600000,SE 210,Residential,36442,0,36442,109754,0,146196
142430201700000,SE 210,Residential,30456,0,30456,159629,0,190085
142430201800000,SE 210,Residential,30053,0,30053,151748,0,181801
142430201900000,SE 210,Residential,39000,0,39000,80978,0,119978
142430202100000,SE 210,Residential,27989,0,27989,84883,0,112872
142430202200000,SE 210,Residential,26802,0,26802,126836,0,153638
142430202300000,SE 210,Residential,30403,0,30403,103511,0,133914
142430202400000,SE 210,Residential,29478,0,29478,111112,0,140590
142430202500000,SE 210,Residential,34639,0,34639,115737,0,150376
142430202600000,SE 210,Residential,34031,0,34031,113286,0,147317
142430202700000,SE 210,Residential,33920,0,33920,105978,0,139898
142430202800000,SE 210,Residential,34240,0,34240,121649,0,155889
142430202900000,SE 210,Residential,33379,0,33379,98988,0,132367
142430203000000,SE 210,Residential,32760,0,32760,100626,0,133386
142430203100000,SE 210,Residential,34299,0,34299,160251,0,194550
142430203200000,SE 210,Residential,34560,0,34560,121000,0,155560
142430203300000,SE 210,Residential,35136,0,35136,101519,0,136655
142430203400000,SE 210,Residential,35100,0,35100,87584,0,122684
142430300100000,SE 210,Residential,36708,0,36708,154077,0,190785
142430300200000,SE 210,Residential,31368,0,31368,175082,0,206450
142430300300000,SE 210,Residential,31583,0,31583,160153,0,191736
142430300400000,SE 210,Residential,32244,0,32244,151720,0,183964
142430300500000,SE 210,Residential,32896,0,32896,97735,0,130631
142430300600000,SE 210,Residential,34592,0,34592,126822,0,161414
142430300700000,SE 210,Residential,33743,0,33743,121466,0,155209
142430300800000,SE 210,Residential,31450,0,31450,120198,0,151648
142430300900000,SE 210,Residential,30053,0,30053,163309,0,193362
142430301000000,SE 210,Residential,33927,0,33927,133715,0,167642
142430301100000,SE 210,Residential,38782,0,38782,114260,0,153042
142430400100000,SE 210,Residential,31772,0,31772,158099,0,189871
142430400200000,SE 210,Residential,28032,0,28032,129563,0,157595
142430400300000,SE 210,Residential,29223,0,29223,117718,0,146941
142430400400000,SE 210,Residential,32605,0,32605,97671,0,130276
142430400500000,SE 210,Residential,28356,0,28356,95221,0,123577
142430400600000,SE 210,Residential,28717,0,28717,109862,0,138579
142430400700000,SE 210,Residential,27200,0,27200,112614,0,139814
142430500100000,SE 210,Residential,33617,0,33617,112801,0,146418
142430500200000,SE 210,Residential,32980,0,32980,103089,0,136069
142430500300000,SE 210,Residential,28149,0,28149,166181,0,194330
142430500400000,SE 210,Residential,27388,0,27388,121014,0,148402
142430500500000,SE 210,Residential,25637,0,25637,146320,0,171957
142430500600000,SE 210,Residential,26727,0,26727,109011,0,135738
142430500700000,SE 210,Residential,22568,0,22568,84080,0,106648
142430500800000,SE 210,Residential,24752,0,24752,116016,0,140768
142430500900000,SE 210,Residential,25760,0,25760,122539,0,148299
142430501000000,SE 210,Residential,27160,0,27160,116585,0,143745
142430501100000,SE 210,Residential,30714,0,30714,107063,0,137777
142430501200000,SE 210,Residential,29488,0,29488,90965,0,120453
142430501300000,SE 210,Residential,29488,0,29488,100193,0,129681
142430501400000,SE 210,Residential,29488,0,29488,103765,0,133253
142430501500000,SE 210,Exempt,0,29488,29488,0,112420,141908
142430501600000,SE 210,Residential,29488,0,29488,97910,0,127398
142430501700000,SE 210,Residential,29488,0,29488,102285,0,131773
142430501800000,SE 210,Residential,29488,0,29488,107695,0,137183
142430600100000,SE 210,Residential,26640,0,26640,101113,0,127753
142430600200000,SE 210,Residential,27540,0,27540,97908,0,125448
142430600300000,SE 210,Residential,25989,0,25989,85498,0,111487
142430600400000,SE 210,Residential,26218,0,26218,164890,0,191108
142430600600000,SE 210,Residential,30264,0,30264,32434,0,62698
142430600700000,SE 210,Residential,29841,0,29841,102606,0,132447
142430600800000,SE 210,Residential,29488,0,29488,87786,0,117274
142430600900000,SE 210,Residential,29488,0,29488,102385,0,131873
142430601000000,SE 210,Residential,29488,0,29488,94994,0,124482
142430601100000,SE 210,Residential,29488,0,29488,96984,0,126472
142430601200000,SE 210,Residential,29488,0,29488,86128,0,115616
142430601300000,SE 210,Residential,29488,0,29488,100986,0,130474
142430601400000,SE 210,Residential,29488,0,29488,99422,0,128910
142430601500000,SE 210,Residential,30638,0,30638,104990,0,135628
142430601700000,SE 210,Residential,21060,0,21060,37945,0,59005
142432600100000,SE 210,Residential,43061,0,43061,106700,0,149761
142432600200000,SE 210,Residential,46463,0,46463,146834,0,193297
142432700100000,SE 210,Residential,41692,0,41692,183378,0,225070
142432700400000,SE 210,Residential,43546,0,43546,126674,0,170220
142432700500000,SE 210,Residential,42269,0,42269,140634,0,182903
142432700600000,SE 210,Residential,46104,0,46104,93389,0,139493
142432700700000,SE 210,Residential,46104,0,46104,200937,0,247041
142432700800000,SE 210,Residential,46104,0,46104,143987,0,190091
142432700900000,SE 210,Residential,46104,0,46104,258496,0,304600
142432701000000,SE 210,Residential,31237,0,31237,86874,0,118111
142432701100000,SE 210,Residential,29400,0,29400,106086,0,135486
142432701200000,SE 210,Residential,27930,0,27930,97532,0,125462
142432701300000,SE 210,Residential,27930,0,27930,95717,0,123647
142432701400000,SE 210,Residential,32100,0,32100,105854,0,137954
142432701500000,SE 210,Residential,32100,0,32100,115183,0,147283
142432701600000,SE 210,Residential,32100,0,32100,85365,0,117465
142432701700000,SE 210,Residential,32100,0,32100,103413,0,135513
142432701800000,SE 210,Residential,32100,0,32100,128413,0,160513
142432701900000,SE 210,Residential,32742,0,32742,119431,0,152173
142432702000000,SE 210,Residential,32742,0,32742,105432,0,138174
142432702100000,SE 210,Residential,32742,0,32742,109008,0,141750
142432702200000,SE 210,Residential,41580,0,41580,130672,0,172252
142432800100000,SE 210,Residential,45937,0,45937,102316,0,148253
142432800200000,SE 210,Residential,20800,0,20800,86204,0,107004
142432800300000,SE 210,Residential,43597,0,43597,131017,0,174614
142432800400000,SE 210,Residential,39200,0,39200,118925,0,158125
142432800500000,SE 210,Residential,39200,0,39200,120580,0,159780
142432800600000,SE 210,Residential,38701,0,38701,106956,0,145657
142432800700000,SE 210,Residential,29100,0,29100,94045,0,123145
142432800800000,SE 210,Residential,29100,0,29100,93781,0,122881
142432800900000,SE 210,Residential,29100,0,29100,107343,0,136443
142432801000000,SE 210,Residential,28567,0,28567,96373,0,124940
142432801100000,SE 210,Residential,30020,0,30020,96485,0,126505
142432801200000,SE 210,Residential,33174,0,33174,124073,0,157247
142432801300000,SE 210,Residential,15770,0,15770,112824,0,128594
142432801400000,SE 210,Residential,30109,0,30109,101197,0,131306
142432900100000,SE 222,Residential,28000,0,28000,138964,0,166964
142432900200000,SE 222,Residential,24700,0,24700,116434,0,141134
142432900300000,SE 222,Residential,24000,0,24000,74948,0,98948
142432900400000,SE 222,Residential,24000,0,24000,89595,0,113595
142432900500000,SE 222,Residential,24000,0,24000,98349,0,122349
142432900600000,SE 222,Residential,24000,0,24000,88599,0,112599
142432900700000,SE 222,Residential,24700,0,24700,90777,0,115477
142432900800000,SE 222,Residential,24000,0,24000,66283,0,90283
142432900900000,SE 222,Residential,24000,0,24000,89612,0,113612
142432901000000,SE 222,Residential,24000,0,24000,80784,0,104784
142432901100000,SE 222,Residential,24000,0,24000,99212,0,123212
142432901200000,SE 222,Residential,24000,0,24000,129119,0,153119
142432901300000,SE 222,Residential,24000,0,24000,86049,0,110049
142432901400000,SE 222,Residential,24000,0,24000,87999,0,111999
142432901500000,SE 222,Residential,24000,0,24000,94989,0,118989
142432901600000,SE 222,Residential,24700,0,24700,106083,0,130783
142432901700000,SE 222,Residential,24700,0,24700,120929,0,145629
142432901800000,SE 222,Residential,24480,0,24480,96686,0,121166
142432901900000,SE 222,Residential,24480,0,24480,102063,0,126543
142433000100000,SE 222,Residential,24000,0,24000,99573,0,123573
142433000200000,SE 222,Residential,24000,0,24000,111344,0,135344
142433000300000,SE 222,Residential,24000,0,24000,107724,0,131724
142433000400000,SE 222,Residential,24000,0,24000,119785,0,143785
142433000500000,SE 222,Residential,24000,0,24000,59738,0,83738
142433000600000,SE 222,Residential,24000,0,24000,66572,0,90572
142433000700000,SE 222,Residential,24000,0,24000,67903,0,91903
142433000800000,SE 222,Residential,24000,0,24000,76986,0,100986
142433000900000,SE 222,Residential,24000,0,24000,64984,0,88984
142433001000000,SE 222,Residential,24000,0,24000,86182,0,110182
142433001100000,SE 222,Residential,25200,0,25200,86600,0,111800
142433001200000,CITY PROPERTY,Exempt,0,0,0,0,0,0
142433001300000,SE 222,Residential,24725,0,24725,68812,0,93537
142433001400000,SE 222,Residential,25200,0,25200,109623,0,134823
142433001500000,SE 223,Residential,24461,0,24461,86981,0,111442
142433001600000,SE 223,Residential,20200,0,20200,73801,0,94001
142433001700000,SE 223,Residential,26438,0,26438,88861,0,115299
142433001800000,SE 222,Residential,25200,0,25200,102516,0,127716
142433001900000,SE 222,Residential,24000,0,24000,94867,0,118867
142433002000000,SE 222,Residential,24000,0,24000,101516,0,125516
142433002100000,SE 222,Residential,24000,0,24000,93883,0,117883
142433002200000,SE 222,Residential,24000,0,24000,81644,0,105644
142433002300000,SE 222,Residential,24000,0,24000,103138,0,127138
142433002400000,SE 222,Residential,24000,0,24000,101410,0,125410
142433002500000,SE 222,Residential,24000,0,24000,98645,0,122645
142433002600000,SE 222,Residential,24000,0,24000,119529,0,143529
142433100100000,SE 210,Residential,32174,0,32174,89926,0,122100
142433100200000,SE 210,Residential,32183,0,32183,111320,0,143503
142433100300000,SE 210,Residential,32183,0,32183,66232,0,98415
142433100400000,SE 210,Residential,32183,0,32183,112441,0,144624
142433100500000,SE 210,Residential,30214,0,30214,102417,0,132631
142433100600000,SE 210,Residential,28028,0,28028,109686,0,137714
142433100700000,SE 210,Residential,29400,0,29400,117690,0,147090
142433100800000,SE 210,Residential,29400,0,29400,131884,0,161284
142433100900000,SE 210,Residential,29100,0,29100,98044,0,127144
142433101000000,SE 210,Residential,29100,0,29100,122827,0,151927
142433101100000,SE 210,Residential,29100,0,29100,106159,0,135259
142433101200000,SE 210,Residential,28509,0,28509,119546,0,148055
142433101300000,SE 210,Residential,33274,0,33274,73326,0,106600
142433101400000,SE 210,Residential,30186,0,30186,96460,0,126646
142433101500000,SE 210,Residential,30186,0,30186,106427,0,136613
142433101600000,SE 210,Residential,29992,0,29992,116934,0,146926
142433200100000,SE 223,Residential,22010,0,22010,106671,0,128681
142433200200000,SE 223,Residential,21709,0,21709,77420,0,99129
142433200300000,SE 223,Residential,24480,0,24480,88289,0,112769
142433200400000,SE 223,Residential,23520,0,23520,80744,0,104264
142433200500000,SE 223,Residential,21840,0,21840,101423,0,123263
142435100100000,SCHOOL,Exempt,0,0,0,0,0,0
142435200100000,SE 223,Residential,21840,0,21840,90099,0,111939
142435200200000,SE 223,Residential,24027,0,24027,83695,0,107722
142435200300000,SE 223,Residential,21840,0,21840,101684,0,123524
142435200400000,SE 223,Residential,21840,0,21840,84877,0,106717
142435200500000,SE 223,Residential,21840,0,21840,93428,0,115268
142435200600000,SE 223,Residential,21840,0,21840,90103,0,111943
142435200700000,SE 223,Residential,21840,0,21840,103088,0,124928
142435200800000,SE 223,Residential,21840,0,21840,81224,0,103064
142435200900000,SE 223,Residential,23617,0,23617,129451,0,153068
142435201000000,SE 223,Residential,23514,0,23514,132626,0,156140
142435201100000,SE 223,Residential,24752,0,24752,105204,0,129956
142435201200000,SE 223,Residential,22859,0,22859,77740,0,100599
142435201300000,SE 223,Residential,23228,0,23228,87417,0,110645
142435201400000,SE 223,Residential,23296,0,23296,79488,0,102784
142435201500000,SE 223,Residential,21840,0,21840,76341,0,98181
142435201600000,SE 223,Residential,21840,0,21840,77609,0,99449
142435201700000,SE 223,Residential,21840,0,21840,79824,0,101664
142435201800000,SE 223,Residential,21840,0,21840,85044,0,106884
142435201900000,SE 223,Residential,21840,0,21840,77884,0,99724
142435202000000,SE 223,Residential,21840,0,21840,103354,0,125194
142435202100000,SE 223,Residential,21840,0,21840,78088,0,99928
142435300100000,SE 223,Residential,26600,0,26600,122169,0,148769
142435300200000,SE 223,Residential,27669,0,27669,84100,0,111769
142435300300000,SE 223,Residential,28848,0,28848,95021,0,123869
142435300400000,SE 223,Residential,23280,0,23280,77692,0,100972
142435300500000,SE 223,Residential,23280,0,23280,75737,0,99017
142435300600000,SE 223,Residential,24624,0,24624,71833,0,96457
142435300700000,SE 223,Residential,32604,0,32604,63528,0,96132
142435300800000,SE 223,Residential,25080,0,25080,62317,0,87397
142435300900000,SE 223,Residential,24000,0,24000,69553,0,93553
142435301000000,SE 223,Residential,24000,0,24000,101211,0,125211
142435301100000,SE 223,Residential,23040,0,23040,70904,0,93944
142435301200000,SE 223,Residential,26240,0,26240,89756,0,115996
142435301300000,SE 223,Residential,23600,0,23600,74067,0,97667
142435301400000,SE 223,Residential,22890,0,22890,84109,0,106999
142435301500000,SE 223,Residential,22632,0,22632,84926,0,107558
142435301600000,SE 223,Residential,22632,0,22632,109869,0,132501
142435301700000,SE 223,Residential,22632,0,22632,90522,0,113154
142435301800000,SE 223,Residential,21340,0,21340,94285,0,115625
142435301900000,SE 223,Residential,21340,0,21340,85701,0,107041
142435302000000,SE 223,Residential,21185,0,21185,73145,0,94330
142435302100000,SE 223,Residential,27120,0,27120,108135,0,135255
142435302200000,SE 223,Residential,24960,0,24960,85997,0,110957
142435302300000,SE 223,Residential,2160,0,2160,0,0,2160
142435302400000,SE 223,Residential,25197,0,25197,96964,0,122161
142435400100000,SE 223,Residential,24177,0,24177,86838,0,111015
142435400200000,SE 223,Residential,24317,0,24317,85542,0,109859
142435400300000,SE 223,Residential,24464,0,24464,99385,0,123849
142435400400000,SE 223,Residential,24177,0,24177,101244,0,125421
142435400500000,SE 223,Residential,24317,0,24317,109513,0,133830
142435400600000,SE 223,Residential,24464,0,24464,94894,0,119358
142435500200000,APARTMENT,Commercial,0,18245,18245,0,108632,126877
142435500300000,APARTMENT,Residential,17622,0,17622,109378,0,127000
142435500600000,CHURCH,Exempt,0,168750,168750,0,399079,567829
142435500700000,OFFICE; MEDICAL,Commercial,0,362880,362880,0,948754,1311634
142435600100000,SE 223,Residential,22162,0,22162,75839,0,98001
142435600200000,SE 223,Residential,22575,0,22575,80523,0,103098
142435600300000,SE 223,Residential,22477,0,22477,91010,0,113487
142435600400000,SE 223,Residential,22568,0,22568,79085,0,101653
142435600500000,SE 223,Residential,22896,0,22896,112900,0,135796
142435600600000,SE 223,Residential,23296,0,23296,94931,0,118227
142435600700000,OFFICE; MEDICAL,Commercial,0,152023,152023,0,291391,443414
142435600800000,SE 223,Residential,18200,0,18200,96536,0,114736
142435600900000,SE 223,Residential,18200,0,18200,96161,0,114361
142435601000000,SE 223,Residential,21840,0,21840,86519,0,108359
142435601100000,SE 223,Residential,21840,0,21840,80418,0,102258
142435601200000,SE 223,Residential,21840,0,21840,79126,0,100966
142435601300000,SE 223,Residential,21840,0,21840,77582,0,99422
142435601400000,SE 223,Residential,21840,0,21840,76553,0,98393
142435700100000,SE 223,Residential,23893,0,23893,105852,0,129745
142435700200000,SE 223,Residential,25085,0,25085,122090,0,147175
142435700300000,SE 223,Residential,20972,0,20972,57364,0,78336
142435700400000,SE 223,Residential,21400,0,21400,66567,0,87967
142435700500000,SE 223,Residential,29680,0,29680,94275,0,123955
142435700600000,SE 223,Residential,31434,0,31434,0,0,31434
142435700700000,SMALL RETAIL,Commercial,0,85147,85147,0,177968,263115
142435700800000,SERVICE STATION,Commercial,0,78791,78791,0,54224,133015
142435700900000,BRANCH BANK/CU,Commercial,0,221400,221400,0,567451,788851
142435701000000,SE 223,Residential,18952,0,18952,74772,0,93724
142435701100000,SE 223,Residential,18983,0,18983,79757,0,98740
142435701200000,SE 223,Residential,23230,0,23230,102483,0,125713
142435701300000,SE 223,Residential,23147,0,23147,89324,0,112471
142435701400000,SE 223,Residential,23147,0,23147,96451,0,119598
142435800100000,SE 223,Residential,24424,0,24424,90149,0,114573
142435800200000,SE 223,Residential,24571,0,24571,114866,0,139437
142435800300000,SE 223,Residential,24725,0,24725,90429,0,115154
142435800400000,SE 223,Residential,21367,0,21367,118696,0,140063
142435800500000,SE 223,Residential,21499,0,21499,106492,0,127991
142435800600000,SE 223,Residential,21638,0,21638,81671,0,103309
142437600100000,SE 223,Residential,22846,0,22846,89590,0,112436
142437600200000,SE 223,Residential,22800,0,22800,91046,0,113846
142437600300000,SE 223,Residential,22800,0,22800,103641,0,126441
142437600400000,SE 223,Residential,27720,0,27720,108977,0,136697
142437600500000,SE 223,Residential,27720,0,27720,118406,0,146126
142437600600000,SE 223,Residential,27720,0,27720,85526,0,113246
142437600700000,SE 223,Residential,27500,0,27500,90983,0,118483
142437600800000,SE 223,Residential,27500,0,27500,94163,0,121663
142437600900000,SE 223,Residential,27500,0,27500,85253,0,112753
142437601000000,SE 223,Residential,27553,0,27553,86051,0,113604
142437601100000,SE 223,Residential,23320,0,23320,101120,0,124440
142437601200000,SE 223,Residential,27073,0,27073,63059,0,90132
142437601300000,SE 223,Residential,26240,0,26240,109821,0,136061
142437601400000,SE 223,Residential,23548,0,23548,89798,0,113346
142437601500000,SE 223,Residential,23940,0,23940,105685,0,129625
142437601600000,SE 223,Residential,24051,0,24051,120793,0,144844
142437601700000,SE 223,Residential,22851,0,22851,72892,0,95743
142437601800000,SE 223,Residential,23328,0,23328,90750,0,114078
142437601900000,SE 223,Residential,23560,0,23560,100770,0,124330
142437602000000,SE 223,Residential,28679,0,28679,127273,0,155952
142437602100000,SE 223,Residential,26611,0,26611,89850,0,116461
142437602200000,SE 223,Residential,23501,0,23501,117423,0,140924
142437602300000,SE 223,Residential,22560,0,22560,111673,0,134233
142437602400000,SE 223,Residential,22793,0,22793,106980,0,129773
142437602500000,SE 223,Residential,24365,0,24365,103104,0,127469
142437602600000,SE 223,Residential,26825,0,26825,128019,0,154844
142437602700000,SE 223,Residential,26905,0,26905,141934,0,168839
142437602800000,SE 223,Residential,26780,0,26780,75959,0,102739
142437602900000,SE 223,Residential,26780,0,26780,108819,0,135599
142437603000000,SE 223,Residential,26780,0,26780,76788,0,103568
142437603100000,SE 223,Residential,26459,0,26459,111041,0,137500
142437603200000,SE 223,Residential,26780,0,26780,83278,0,110058
142437603300000,SE 223,Residential,26780,0,26780,84284,0,111064
142437603400000,SE 223,Residential,25868,0,25868,78067,0,103935
142437603500000,SE 223,Residential,25086,0,25086,83467,0,108553
142437603600000,SE 223,Residential,27346,0,27346,92731,0,120077
142437603700000,SE 223,Residential,27572,0,27572,97604,0,125176
142437603800000,SE 223,Residential,27572,0,27572,93147,0,120719
142437603900000,SE 223,Residential,23219,0,23219,103981,0,127200
142437604000000,SE 223,Residential,24327,0,24327,119737,0,144064
142437604100000,SE 223,Residential,28016,0,28016,110388,0,138404
142437604200000,SE 223,Residential,28044,0,28044,101100,0,129144
142437604300000,SE 223,Residential,23760,0,23760,78070,0,101830
142437604400000,SE 223,Residential,24683,0,24683,94265,0,118948
142437604500000,SE 223,Residential,24440,0,24440,111393,0,135833
142437604600000,SE 223,Residential,25503,0,25503,113538,0,139041
142437604700000,SE 223,Residential,28938,0,28938,111717,0,140655
142437604800000,SE 223,Residential,29765,0,29765,104460,0,134225
142437700100000,SE 223,Residential,26585,0,26585,73812,0,100397
142437700200000,SE 223,Residential,26585,0,26585,103577,0,130162
142437700300000,SE 223,Residential,26585,0,26585,71479,0,98064
142437700400000,SE 223,Residential,26585,0,26585,76121,0,102706
142437700500000,SE 223,Residential,26585,0,26585,85738,0,112323
142437700600000,SE 223,Residential,25987,0,25987,101084,0,127071
142437700700000,SE 223,Residential,25920,0,25920,89791,0,115711
142437700800000,SE 223,Residential,25900,0,25900,80333,0,106233
142437700900000,SE 223,Residential,25142,0,25142,93910,0,119052
142437701000000,SE 223,Residential,26385,0,26385,74141,0,100526
142437701100000,SE 223,Residential,26088,0,26088,113651,0,139739
142437701200000,SE 223,Residential,26182,0,26182,116306,0,142488
142437701300000,SE 223,Residential,25776,0,25776,87940,0,113716
142437701400000,SE 223,Residential,29469,0,29469,91422,0,120891
142437701500000,SE 223,Residential,30096,0,30096,110535,0,140631
142437701600000,SE 223,Residential,29992,0,29992,94160,0,124152
142437701700000,SE 223,Residential,35708,0,35708,107528,0,143236
142437701800000,SE 223,Residential,33152,0,33152,101978,0,135130
142437701900000,SE 223,Residential,33220,0,33220,107075,0,140295
142437702000000,SE 223,Residential,33220,0,33220,100562,0,133782
142437702100000,SE 223,Residential,33242,0,33242,114912,0,148154
142437702200000,SE 223,Residential,33242,0,33242,106288,0,139530
142437800100000,SE 223,Residential,33792,0,33792,146366,0,180158
142437800200000,SE 223,Residential,35200,0,35200,102784,0,137984
142437800300000,SE 223,Residential,35244,0,35244,119221,0,154465
142437800400000,SE 223,Residential,29788,0,29788,105000,0,134788
142437800500000,SE 223,Residential,26384,0,26384,111811,0,138195
142437800600000,SE 223,Residential,32548,0,32548,108960,0,141508
142437800700000,SE 223,Residential,27333,0,27333,101771,0,129104
142437800800000,SE 223,Residential,29229,0,29229,104455,0,133684
142437800900000,SE 223,Residential,30258,0,30258,83471,0,113729
142437801000000,SE 223,Residential,24952,0,24952,86781,0,111733
142437801100000,SE 223,Residential,25160,0,25160,98474,0,123634
142437801200000,SE 223,Residential,25452,0,25452,92356,0,117808
142437801300000,SE 223,Residential,25376,0,25376,114086,0,139462
142437801400000,SE 223,Residential,26400,0,26400,98823,0,125223
142437801500000,SE 223,Residential,29018,0,29018,84992,0,114010
142437801600000,SE 223,Residential,27986,0,27986,83848,0,111834
142437801700000,SE 223,Residential,29172,0,29172,100632,0,129804
142437801800000,SE 223,Residential,29260,0,29260,90862,0,120122
142437900100000,SE 223,Residential,26198,0,26198,74805,0,101003
142437900200000,SE 223,Residential,24192,0,24192,74942,0,99134
142437900300000,SE 223,Residential,23040,0,23040,112603,0,135643
142437900400000,SE 223,Residential,23040,0,23040,101615,0,124655
142437900500000,SE 223,Residential,23040,0,23040,120107,0,143147
142437900600000,SE 223,Residential,23040,0,23040,84943,0,107983
142437900700000,SE 223,Residential,23040,0,23040,109237,0,132277
142437900800000,SE 223,Residential,23841,0,23841,79137,0,102978
142437900900000,SE 223,Residential,24879,0,24879,143067,0,167946
142437901000000,SE 223,Residential,23040,0,23040,94505,0,117545
142437901100000,SE 223,Residential,23040,0,23040,78856,0,101896
142437901200000,SE 223,Residential,23040,0,23040,88014,0,111054
142437901300000,SE 223,Residential,23040,0,23040,84992,0,108032
142437901400000,SE 223,Residential,23040,0,23040,88473,0,111513
142437901500000,SE 223,Residential,24192,0,24192,84857,0,109049
142437901600000,SE 223,Residential,26188,0,26188,111340,0,137528
142437901700000,SE 223,Residential,24948,0,24948,96149,0,121097
142438000100000,SE 223,Residential,25615,0,25615,80230,0,105845
142438000200000,SE 223,Residential,25724,0,25724,88638,0,114362
142438000300000,SE 223,Residential,25724,0,25724,86203,0,111927
142438000400000,SE 223,Residential,25791,0,25791,74373,0,100164
142438000500000,SE 223,Residential,24471,0,24471,72938,0,97409
142438000600000,SE 223,Residential,24735,0,24735,91291,0,116026
142438000700000,SE 223,Residential,24339,0,24339,97272,0,121611
142438000800000,SE 223,Residential,25395,0,25395,81475,0,106870
142438000900000,SE 223,Residential,24576,0,24576,101426,0,126002
142438001000000,SE 223,Residential,24576,0,24576,84118,0,108694
142438001100000,SE 223,Residential,21297,0,21297,80518,0,101815
142438001200000,SE 223,Residential,21644,0,21644,87378,0,109022
142438001300000,SE 223,Residential,21597,0,21597,82105,0,103702
142438001400000,SE 223,Residential,20385,0,20385,87132,0,107517
142438001500000,SE 223,Residential,21618,0,21618,91186,0,112804
142438001600000,SE 223,Residential,21185,0,21185,80259,0,101444
142438001700000,SE 223,Residential,21275,0,21275,95801,0,117076
142438100100000,SE 223,Residential,26560,0,26560,120186,0,146746
142438100200000,SE 223,Residential,23280,0,23280,76238,0,99518
142438100300000,SE 223,Residential,23280,0,23280,89530,0,112810
142438100400000,SE 223,Residential,23280,0,23280,74420,0,97700
142438100500000,SE 223,Residential,23280,0,23280,93961,0,117241
142438100600000,SE 223,Residential,23280,0,23280,90942,0,114222
142438100700000,SE 223,Residential,24056,0,24056,95732,0,119788
142438100800000,SE 223,Residential,24806,0,24806,131509,0,156315
142438100900000,SE 223,Residential,21452,0,21452,92165,0,113617
142438101000000,SE 223,Residential,21049,0,21049,92420,0,113469
142438101100000,SE 223,Residential,20370,0,20370,77864,0,98234
142438101200000,SE 223,Residential,20370,0,20370,74434,0,94804
142438101300000,SE 223,Residential,20370,0,20370,81349,0,101719
142438101400000,SE 223,Residential,20370,0,20370,67377,0,87747
142438101500000,SE 223,Residential,20370,0,20370,96788,0,117158
142438101600000,SE 223,Residential,26880,0,26880,90031,0,116911
142438101700000,SE 223,Residential,25200,0,25200,107902,0,133102
142440100100000,SE 220,Residential,38890,0,38890,279135,0,318025
142440200100000,SE 220,Residential,44080,0,44080,171441,0,215521
142440200200000,SE 220,Residential,6700,0,6700,0,0,6700
142440200400000,SE 220,Residential,103820,0,103820,271858,0,375678
142440200500000,SE 220,Residential,152620,0,152620,476023,0,628643
142440200600000,SE 220,Residential,42667,0,42667,155644,0,198311
142440200700000,SE 220,Residential,43264,0,43264,221485,0,264749
142440200800000,SE 220,Residential,48336,0,48336,195305,0,243641
142440200900000,SE 220,Residential,63000,0,63000,227074,0,290074
142440201000000,SE 220,Residential,43942,0,43942,157066,0,201008
142440201100000,SE 220,Residential,44475,0,44475,220158,0,264633
142440201200000,SE 220,Residential,44080,0,44080,120980,0,165060
142440201300000,SE 220,Residential,41240,0,41240,159323,0,200563
142440201400000,SE 220,Residential,43904,0,43904,158828,0,202732
142440201500000,SE 220,Residential,42397,0,42397,196993,0,239390
142440201600000,SE 220,Residential,42960,0,42960,139636,0,182596
142440201700000,SE 220,Residential,46862,0,46862,152794,0,199656
142440201800000,SE 220,Residential,46400,0,46400,152882,0,199282
142440300100000,SE 220,Residential,34048,0,34048,192537,0,226585
142440300200000,SE 220,Residential,39342,0,39342,256069,0,295411
142440400100000,SE 220,Residential,33317,0,33317,150491,0,183808
142440400200000,SE 220,Residential,46683,0,46683,125824,0,172507
142440400300000,SE 220,Residential,41885,0,41885,183404,0,225289
142440400400000,SE 220,Residential,38443,0,38443,206476,0,244919
142440400500000,SE 220,Residential,35733,0,35733,232881,0,268614
142440400600000,SE 220,Residential,34920,0,34920,152981,0,187901
142440400700000,SE 220,Residential,33618,0,33618,154874,0,188492
142440400800000,SE 220,Residential,38216,0,38216,204384,0,242600
142440400900000,SE 220,Residential,37060,0,37060,202132,0,239192
142440401000000,SE 220,Residential,39324,0,39324,273236,0,312560
142440401100000,SE 220,Residential,4900,0,4900,0,0,4900
142440401200000,SE 220,Residential,40624,0,40624,201670,0,242294
142440401300000,SE 220,Residential,37595,0,37595,150447,0,188042
142442600200000,SE 220,Residential,80070,0,80070,204393,0,284463
142442600400000,SE 220,Residential,72320,0,72320,277885,0,350205
142442600500000,SE 220,Residential,100600,0,100600,283058,0,383658
142442600600000,SE 220,Residential,91300,0,91300,200964,0,292264
142442600700000,SE 220,Residential,106200,0,106200,249875,0,356075
142442600800000,SE 220,Residential,103920,0,103920,251631,0,355551
142442600900000,SE 220,Residential,98520,0,98520,223747,0,322267
142442601000000,SE 220,Residential,99800,0,99800,938059,0,1037859
142442601100000,SE 220,Residential,120650,0,120650,436200,0,556850
142442700100000,SE 221,Residential,37674,0,37674,137805,0,175479
142442700200000,SE 221,Residential,35390,0,35390,146484,0,181874
142442700300000,SE 221,Residential,33647,0,33647,130086,0,163733
142442700400000,SE 221,Residential,33711,0,33711,153670,0,187381
142442700500000,SE 221,Residential,31999,0,31999,111066,0,143065
142442700600000,SE 221,Residential,75457,0,75457,225178,0,300635
142442700700000,SE 221,Residential,50520,0,50520,0,0,50520
142442700800000,SE 221,Residential,68513,0,68513,245799,0,314312
142442700900000,SE 221,Residential,65726,0,65726,230936,0,296662
142442701000000,SE 221,Residential,70641,0,70641,260112,0,330753
142442701100000,SE 221,Residential,65767,0,65767,273764,0,339531
142442701200000,SE 223,Residential,50000,0,50000,112613,0,162613
142442701600000,SE 221,Residential,52380,0,52380,0,0,52380
142442701800000,SE 221,Residential,34145,0,34145,56800,0,90945
142442701900000,SE 221,Residential,33696,0,33696,115961,0,149657
142442702200000,SE 221,Residential,49150,0,49150,259756,0,308906
142442702400000,SE 221,Residential,32000,0,32000,139750,0,171750
142442702500000,SE 221,Residential,32000,0,32000,154704,0,186704
142442702600000,SE 221,Residential,32500,0,32500,109566,0,142066
142442702700000,SE 221,Residential,35401,0,35401,149462,0,184863
142442702800000,SE 221,Residential,38548,0,38548,154797,0,193345
142442702900000,SE 221,Residential,38456,0,38456,130962,0,169418
142442703000000,SE 221,Residential,20,0,20,0,0,20
142442703100000,SE 221,Residential,20,0,20,0,0,20
142442703400000,SE 221,Residential,62801,0,62801,213323,0,276124
142442800100000,SE 223,Residential,56450,0,56450,47020,0,103470
142442800200000,CITY PROPERTY,Exempt,0,0,0,0,0,0
142445100100000,SE 220,Residential,101120,0,101120,365030,0,466150
142445100200000,SE 220,Residential,103820,0,103820,356074,0,459894
142445100300000,SE 220,Residential,106820,0,106820,266585,0,373405
142445100400000,SE 220,Residential,102520,0,102520,318080,0,420600
142445100700000,SE 220,Residential,101120,0,101120,410655,0,511775
142445100800000,SE 220,Residential,85820,0,85820,370106,0,455926
142445100900000,SE 220,Residential,82340,0,82340,350717,0,433057
142445200200000,SE 223,Residential,5200,0,5200,0,0,5200
142445200300000,SE 223,Residential,30084,0,30084,77671,0,107755
142445200400000,SE 223,Residential,29627,0,29627,87128,0,116755
142445200500000,SE 223,Residential,31108,0,31108,98355,0,129463
142445200600000,SE 223,Residential,32832,0,32832,123600,0,156432
142445200800000,SE 221,Residential,32148,0,32148,130117,0,162265
142445300100000,SE 223,Residential,27589,0,27589,147565,0,175154
142445300200000,SE 223,Residential,27619,0,27619,137207,0,164826
142445300300000,SE 222,Residential,28408,0,28408,138725,0,167133
142445300400000,SE 223,Residential,28125,0,28125,155769,0,183894
142445300500000,SE 223,Residential,28215,0,28215,90490,0,118705
142445300600000,SE 223,Residential,27032,0,27032,91292,0,118324
142445300700000,SE 223,Residential,26784,0,26784,94040,0,120824
142445300800000,SE 223,Residential,26288,0,26288,107205,0,133493
142445300900000,SE 223,Residential,26932,0,26932,115062,0,141994
142445400100000,SE 222,Residential,24710,0,24710,110286,0,134996
142445400200000,SE 223,Residential,23775,0,23775,100211,0,123986
142445400300000,SE 223,Residential,23775,0,23775,103425,0,127200
142445400400000,SE 223,Residential,23775,0,23775,90903,0,114678
142445400500000,SE 223,Residential,23678,0,23678,94856,0,118534
142445400600000,SE 223,Residential,23873,0,23873,76185,0,100058
142445400700000,SE 223,Residential,24328,0,24328,118173,0,142501
142445400800000,SE 223,Residential,24328,0,24328,51360,0,75688
142445400900000,SE 223,Residential,24328,0,24328,95050,0,119378
142445401000000,SE 223,Residential,24230,0,24230,68269,0,92499
142447600100000,SE 220,Residential,40128,0,40128,188850,0,228978
142447600200000,SE 220,Residential,42933,0,42933,208372,0,251305
142447600300000,SE 220,Residential,34200,0,34200,232718,0,266918
142447600400000,SE 220,Residential,45798,0,45798,171704,0,217502
142447600500000,SE 220,Residential,13000,0,13000,47040,0,60040
142447600600000,SE 220,Residential,30386,0,30386,0,0,30386
142447600700000,SE 220,Residential,42372,0,42372,182417,0,224789
142447600800000,SE 220,Residential,37579,0,37579,132717,0,170296
142447600900000,SE 220,Residential,33368,0,33368,127963,0,161331
142447601000000,SE 220,Residential,32703,0,32703,126267,0,158970
142447601100000,SE 220,Residential,43180,0,43180,222417,0,265597
142447601200000,SE 233,Residential,43656,0,43656,131047,0,174703
142447601300000,SE 233,Residential,1200,0,1200,0,0,1200
142447601400000,SHOP,Commercial,0,74768,74768,0,41890,116658
142447601700000,SE 233,Residential,12400,0,12400,19381,0,31781
142447601800000,SE 233,Residential,11600,0,11600,20775,0,32375
142447601900000,SE 233,Residential,695,0,695,0,0,695
142447602000000,SE 233,Residential,20240,0,20240,0,0,20240
142447700100000,SE 220,Residential,40115,0,40115,171139,0,211254
142447700200000,SE 220,Residential,140020,0,140020,601862,0,741882
142447700300000,SE 220,Residential,100720,0,100720,315259,0,415979
142447700400000,SE 220,Residential,82320,0,82320,540083,0,622403
142447700500000,SE 220,Residential,100920,0,100920,240011,0,340931
142447700600000,SE 220,Residential,119820,0,119820,377383,0,497203
142447700700000,SE 220,Residential,103017,0,103017,286983,0,390000
142447700800000,SE 220,Residential,78420,0,78420,337366,0,415786
142447700900000,CITY PROPERTY,Exempt,0,0,0,0,0,0
142447700902000,ANTENNAS/TOWERS(BLL),Commercial,0,0,0,0,38251,38251
142447700902001,ANTENNAS/TOWERS(BLL),Commercial,0,0,0,0,49805,49805
142447701000000,SE 233,Residential,40950,0,40950,86723,0,127673
142447701100000,SE 233,Residential,40200,0,40200,48088,0,88288
142447701300000,SE 220,Residential,41040,0,41040,226184,0,267224
142447701400000,SE 220,Residential,41269,0,41269,194902,0,236171
142447701500000,SE 220,Residential,39179,0,39179,145288,0,184467
142447701600000,SE 220,Residential,39200,0,39200,142341,0,181541
142447701700000,SE 220,Residential,39200,0,39200,147005,0,186205
142447701800000,SE 220,Residential,39200,0,39200,153702,0,192902
142510100400000,SE 233,Residential,37640,0,37640,0,0,37640
142510100700000,SE 233,Residential,36500,0,36500,0,0,36500
142510100800000,SE 233,Residential,37000,0,37000,205183,0,242183
142510100900000,SE 233,Residential,37000,0,37000,0,0,37000
142510101000000,SE 233,Residential,37500,0,37500,0,0,37500
142510101100000,SE 233,Residential,37350,0,37350,244988,0,282338
142510101200000,SE 233,Residential,37350,0,37350,0,0,37350
142510101300000,SE 233,Residential,52450,0,52450,181972,0,234422
142512600100000,VACANT LAND,Commercial,0,246712,246712,0,0,246712
142512600300000,AUTO REPAIR/SALES,Commercial,0,257364,257364,0,455439,712803
142512600400000,AUTO REPAIR/SALES,Commercial,0,110717,110717,0,151323,262040
142512600500000,CARWASH,Commercial,0,99250,99250,0,157752,257002
142512600600000,OFFICE; MEDICAL,Commercial,0,152582,152582,0,535149,687731
142515100200000,SE 246,Residential,95440,0,95440,0,0,95440
142515100700000,SE 246,Residential,74356,0,74356,315179,0,389535
142515100800000,SE 246,Residential,73566,0,73566,531984,0,605550
142515100900000,SE 246,Residential,92610,0,92610,281755,0,374365
142515101000000,SE 246,Residential,74670,0,74670,263290,0,337960
142515101100000,SE 246,Residential,67900,0,67900,258357,0,326257
142515101200000,SE 246,Residential,70700,0,70700,286112,0,356812
142520100100000,VACANT LAND,Commercial,0,223020,223020,0,0,223020
142520100200000,LG DISCOUNT/RETAIL,Commercial,0,681210,681210,0,2768790,3450000
142520100300000,OFFICE,Commercial,0,226503,226503,0,159906,386409
142520100400000,OFFICE; MEDICAL,Commercial,0,362880,362880,0,736463,1099343
142520100500000,SE 234,Residential,19075,0,19075,54796,0,73871
142520100600000,SE 234,Residential,16975,0,16975,50325,0,67300
142520100700000,SE 234,Residential,16975,0,16975,57175,0,74150
142520100800000,SE 234,Residential,16741,0,16741,53959,0,70700
142520100900000,SE 234,Residential,21571,0,21571,68938,0,90509
142520101000000,SE 234,Residential,20939,0,20939,76576,0,97515
142520101100000,SE 234,Residential,22000,0,22000,82493,0,104493
142520101200000,SE 234,Residential,21200,0,21200,95341,0,116541
142520101300000,SE 234,Residential,19800,0,19800,77281,0,97081
142520101400000,SE 234,Residential,18587,0,18587,78219,0,96806
142520101600000,SE 234,Residential,22000,0,22000,83472,0,105472
142520101700000,SE 234,Residential,23560,0,23560,88363,0,111923
142520101800000,SE 234,Residential,24480,0,24480,88063,0,112543
142520101900000,SE 234,Residential,24113,0,24113,85504,0,109617
142520102000000,SE 234,Residential,22240,0,22240,101709,0,123949
142520102100000,SE 234,Residential,23714,0,23714,87137,0,110851
142520102200000,SE 234,Residential,23760,0,23760,90188,0,113948
142520102300000,SE 234,Residential,23760,0,23760,102870,0,126630
142520102400000,SE 234,Residential,23760,0,23760,78104,0,101864
142520102500000,SE 234,Residential,23760,0,23760,100610,0,124370
142520102600000,SE 234,Residential,23760,0,23760,91574,0,115334
142520102700000,SE 234,Residential,23760,0,23760,79350,0,103110
142520102800000,SE 234,Residential,23760,0,23760,102559,0,126319
142520102900000,APARTMENT,Exempt,0,302400,302400,0,2272182,2574582
142520200100000,SE 234,Residential,17325,0,17325,76841,0,94166
142520200200000,SE 234,Residential,17500,0,17500,66993,0,84493
142520200300000,SE 234,Residential,17500,0,17500,62730,0,80230
142520200400000,SE 234,Residential,18594,0,18594,63939,0,82533
142520200500000,SE 234,Residential,20000,0,20000,88285,0,108285
142520200600000,SE 234,Residential,20000,0,20000,82542,0,102542
142520200700000,SE 234,Residential,20000,0,20000,65446,0,85446
142520200800000,SE 234,Residential,20000,0,20000,79653,0,99653
142520200900000,SE 234,Residential,20000,0,20000,73065,0,93065
142520201000000,SE 234,Residential,20000,0,20000,87200,0,107200
142520201100000,SE 234,Residential,19800,0,19800,88452,0,108252
142520201200000,SE 234,Residential,19800,0,19800,75528,0,95328
142520201300000,SE 234,Residential,20000,0,20000,74621,0,94621
142520201400000,SE 234,Residential,20000,0,20000,92105,0,112105
142520201500000,SE 234,Residential,20000,0,20000,89794,0,109794
142520201600000,SE 234,Residential,20000,0,20000,74787,0,94787
142520201700000,SE 234,Residential,22991,0,22991,95526,0,118517
142520201800000,SE 234,Residential,23112,0,23112,92102,0,115214
142520300100000,SE 234,Residential,22405,0,22405,81990,0,104395
142520300200000,SE 234,Residential,22458,0,22458,76917,0,99375
142520300300000,SE 234,Residential,22053,0,22053,98598,0,120651
142520300400000,SE 234,Residential,22053,0,22053,85957,0,108010
142520300500000,SE 234,Residential,24049,0,24049,89272,0,113321
142520300600000,SE 234,Residential,24000,0,24000,100639,0,124639
142520300700000,SE 234,Residential,24000,0,24000,98392,0,122392
142520300800000,SE 234,Residential,24000,0,24000,92061,0,116061
142520300900000,SE 234,Residential,24000,0,24000,91059,0,115059
142520301000000,SE 234,Residential,24000,0,24000,88081,0,112081
142520301100000,SE 234,Residential,24000,0,24000,86455,0,110455
142520301200000,SE 234,Residential,24000,0,24000,94380,0,118380
142520301300000,COUNTY PROPERTY,Exempt,0,0,0,0,0,0
142522600100000,SE 234,Residential,26507,0,26507,62731,0,89238
142522600200000,SE 234,Residential,22800,0,22800,64124,0,86924
142522600300000,SE 234,Residential,20000,0,20000,91391,0,111391
142522600400000,SE 234,Residential,20000,0,20000,82735,0,102735
142522700100000,SE 234,Residential,27057,0,27057,61716,0,88773
142522700200000,SE 234,Residential,20506,0,20506,55321,0,75827
142522700300000,SE 234,Residential,21609,0,21609,55306,0,76915
142522700400000,SE 234,Residential,21829,0,21829,75377,0,97206
142522700500000,SE 234,Residential,21829,0,21829,79572,0,101401
142522700600000,HOTEL,Exempt,0,181710,181710,0,131810,313520
142522700700000,OFFICE,Commercial,0,69984,69984,0,101099,171083
142522700800000,SE 234,Residential,23940,0,23940,116919,0,140859
142522700900000,SE 234,Residential,22464,0,22464,85580,0,108044
142522701000000,SE 234,Residential,23055,0,23055,105872,0,128927
142522701100000,SE 234,Residential,22600,0,22600,93069,0,115669
142522701200000,SE 234,Residential,22600,0,22600,106181,0,128781
142522701300000,SE 234,Residential,22721,0,22721,94930,0,117651
142522701400000,SE 234,Residential,27600,0,27600,66169,0,93769
142522701500000,SE 234,Residential,23000,0,23000,92405,0,115405
142522701600000,SE 234,Residential,23000,0,23000,91423,0,114423
142522701700000,SE 234,Residential,23000,0,23000,73500,0,96500
142522701800000,SE 234,Residential,23000,0,23000,98938,0,121938
142522701900000,SE 234,Residential,24399,0,24399,71780,0,96179
142522702000000,SE 234,Residential,24453,0,24453,100550,0,125003
142522702100000,SE 234,Residential,28679,0,28679,116114,0,144793
142522702200000,SE 234,Residential,27120,0,27120,105018,0,132138
142522702300000,SE 234,Residential,27120,0,27120,77936,0,105056
142522702400000,SE 234,Residential,27225,0,27225,107693,0,134918
142522702500000,SE 234,Residential,24039,0,24039,99128,0,123167
142522702600000,SE 234,Residential,23575,0,23575,104310,0,127885
142522702700000,SE 234,Residential,23387,0,23387,95481,0,118868
142522702800000,SE 234,Residential,23970,0,23970,94082,0,118052
142522702900000,SE 234,Residential,23218,0,23218,94868,0,118086
142522703000000,SE 234,Residential,23218,0,23218,86626,0,109844
142522703100000,SE 234,Residential,23218,0,23218,72983,0,96201
142522703200000,SE 234,Residential,23465,0,23465,96782,0,120247
142522703300000,SE 234,Residential,24206,0,24206,83427,0,107633
142522703400000,SE 234,Residential,24700,0,24700,93813,0,118513
142522703500000,SE 234,Residential,24000,0,24000,86108,0,110108
142522703600000,SE 234,Residential,24000,0,24000,73631,0,97631
142522703700000,SE 234,Residential,24000,0,24000,83208,0,107208
142522703800000,SE 234,Residential,24000,0,24000,75769,0,99769
142522703900000,SE 234,Residential,24000,0,24000,91476,0,115476
142522704000000,SE 234,Residential,25200,0,25200,93317,0,118517
142522704100000,SE 234,Residential,26293,0,26293,103384,0,129677
142522704200000,SE 234,Residential,26520,0,26520,104438,0,130958
142522704300000,SE 234,Residential,28576,0,28576,83010,0,111586
142522704400000,SE 234,Residential,26550,0,26550,96263,0,122813
142522704500000,SE 234,Residential,24192,0,24192,66723,0,90915
142522704600000,SE 234,Residential,23407,0,23407,69066,0,92473
142522800100000,LG DISCOUNT/RETAIL,Commercial,0,615600,615600,0,854964,1470564
142522800200000,BRANCH BANK/CU,Commercial,0,191797,191797,0,201934,393731
142522800300000,SE 234,Residential,29242,0,29242,94658,0,123900
142522800400000,SE 234,Residential,28161,0,28161,143770,0,171931
142522800500000,SE 234,Residential,30143,0,30143,128172,0,158315
142522800600000,SE 234,Residential,23575,0,23575,134245,0,157820
142522800700000,SE 234,Residential,25219,0,25219,92609,0,117828
142522800800000,SE 234,Residential,26208,0,26208,101286,0,127494
142522800900000,SE 234,Residential,26083,0,26083,100258,0,126341
142522801000000,SE 234,Residential,25110,0,25110,115874,0,140984
142522801100000,SE 234,Residential,23465,0,23465,119170,0,142635
142522801200000,SE 234,Residential,24054,0,24054,98934,0,122988
142522801300000,SE 234,Residential,28991,0,28991,86009,0,115000
142522801400000,SE 234,Residential,23333,0,23333,91146,0,114479
142522801500000,SE 234,Residential,29359,0,29359,123986,0,153345
142522801600000,SE 234,Residential,28080,0,28080,127028,0,155108
142522801700000,SE 234,Residential,29948,0,29948,106319,0,136267
142522802700000,SE 234,Residential,24027,0,24027,90811,0,114838
142522900100000,SE 234,Residential,28000,0,28000,103248,0,131248
142522900200000,SE 234,Residential,24700,0,24700,79091,0,103791
142522900300000,SE 234,Residential,24700,0,24700,86844,0,111544
142522900400000,SE 234,Residential,25242,0,25242,74461,0,99703
142522900500000,SE 234,Residential,25068,0,25068,82945,0,108013
142522900600000,SE 234,Residential,25200,0,25200,75952,0,101152
142522900700000,SE 234,Residential,22564,0,22564,82901,0,105465
142522900800000,SE 234,Residential,22996,0,22996,98445,0,121441
142522900900000,SE 234,Residential,23200,0,23200,85521,0,108721
142522901000000,SE 234,Residential,23200,0,23200,80966,0,104166
142522901100000,SE 234,Residential,23200,0,23200,92567,0,115767
142522901200000,SE 234,Residential,23786,0,23786,105888,0,129674
142522901300000,SE 234,Residential,23546,0,23546,98408,0,121954
142522901400000,SE 234,Residential,23546,0,23546,87992,0,111538
142522901500000,SE 234,Residential,23546,0,23546,91942,0,115488
142522901600000,SE 234,Residential,23040,0,23040,97270,0,120310
142522901700000,SE 234,Residential,23040,0,23040,87216,0,110256
142522901800000,SE 234,Residential,23040,0,23040,89487,0,112527
142522901900000,SE 234,Residential,23008,0,23008,101943,0,124951
142522902100000,SE 234,Residential,24768,0,24768,93184,0,117952
142522902200000,SE 234,Residential,23040,0,23040,84563,0,107603
142522902300000,SE 234,Residential,23040,0,23040,84228,0,107268
142522902400000,SE 234,Residential,23040,0,23040,98214,0,121254
142522902500000,SE 234,Residential,23040,0,23040,94305,0,117345
142522902600000,SE 234,Residential,22825,0,22825,88206,0,111031
142522902700000,SE 234,Residential,23786,0,23786,92690,0,116476
142522902900000,SE 234,Residential,23200,0,23200,77823,0,101023
142522903000000,SE 234,Residential,23200,0,23200,89776,0,112976
142522903100000,SE 234,Residential,23200,0,23200,86514,0,109714
142522903200000,SE 234,Residential,23160,0,23160,60920,0,84080
142522903300000,SE 234,Residential,22400,0,22400,80565,0,102965
142522903400000,SE 234,Residential,25568,0,25568,71854,0,97422
142522903500000,SE 234,Residential,25704,0,25704,78634,0,104338
142522903600000,SE 234,Residential,31680,0,31680,77049,0,108729
142523000100000,SE 234,Residential,22714,0,22714,80834,0,103548
142523000200000,SE 234,Residential,24816,0,24816,86515,0,111331
142523000300000,SE 234,Residential,24109,0,24109,88021,0,112130
142523000400000,SE 234,Residential,20680,0,20680,82658,0,103338
142523000500000,SE 234,Residential,21340,0,21340,68965,0,90305
142523000600000,SE 234,Residential,21780,0,21780,84351,0,106131
142523000700000,SE 234,Residential,25200,0,25200,81358,0,106558
142523000800000,SE 234,Residential,26460,0,26460,88736,0,115196
142523000900000,SE 234,Residential,27165,0,27165,147831,0,174996
142523001000000,CEMETERY,Exempt,0,0,0,0,0,0
142523100100000,SE 234,Residential,23814,0,23814,113260,0,137074
142523100200000,SE 234,Residential,22504,0,22504,159752,0,182256
142523100300000,SE 234,Residential,23814,0,23814,93447,0,117261
142523100400000,SE 234,Residential,25715,0,25715,91463,0,117178
142523100500000,SE 234,Residential,25957,0,25957,110253,0,136210
142523100600000,SE 234,Residential,25761,0,25761,109972,0,135733
142523100700000,SE 234,Residential,23800,0,23800,111718,0,135518
142523100800000,SE 234,Residential,24816,0,24816,120000,0,144816
142523100900000,SE 234,Residential,25285,0,25285,93737,0,119022
142523101000000,SE 234,Residential,37578,0,37578,142093,0,179671
142523101100000,SE 234,Residential,38112,0,38112,187647,0,225759
142523101200000,SE 234,Residential,35910,0,35910,0,0,35910
142523101300000,SE 234,Residential,12631,0,12631,0,0,12631
142523101400000,SE 234,Residential,24826,0,24826,115343,0,140169
142523101500000,SE 234,Residential,24361,0,24361,112951,0,137312
142523101600000,SE 234,Residential,24361,0,24361,147153,0,171514
142523101700000,SE 234,Residential,25567,0,25567,122239,0,147806
142523101800000,SE 234,Residential,30780,0,30780,124626,0,155406
142523200100000,SE 234,Residential,21357,0,21357,0,0,21357
142523200200000,SE 234,Residential,35213,0,35213,347965,0,383178
142523200300000,SE 234,Residential,1156,0,1156,0,0,1156
142525100100000,SE 234,Residential,26160,0,26160,82307,0,108467
142525100200000,SE 234,Residential,26880,0,26880,96493,0,123373
142525100300000,SE 234,Residential,27600,0,27600,92894,0,120494
142525100400000,SE 234,Residential,25920,0,25920,84528,0,110448
142525100500000,SE 234,Residential,25626,0,25626,86597,0,112223
142525200100000,SE 234,Residential,26695,0,26695,89434,0,116129
142525200200000,SE 234,Residential,22708,0,22708,79166,0,101874
142525300100000,SE 234,Residential,25600,0,25600,88155,0,113755
142525300200000,SE 234,Residential,24480,0,24480,93053,0,117533
142525300300000,SE 234,Residential,24279,0,24279,93199,0,117478
142525300400000,SE 234,Residential,24000,0,24000,57557,0,81557
142525300500000,SE 234,Residential,24304,0,24304,90847,0,115151
142525300600000,SE 234,Residential,24056,0,24056,97864,0,121920
142525300700000,SE 234,Residential,24704,0,24704,104583,0,129287
142525300800000,SE 234,Residential,24954,0,24954,95598,0,120552
142525300900000,SE 234,Residential,23333,0,23333,94988,0,118321
142525301000000,SE 234,Residential,24077,0,24077,87017,0,111094
142525301100000,SE 234,Residential,23773,0,23773,120124,0,143897
142525301200000,SE 234,Residential,23773,0,23773,103761,0,127534
142525301300000,SE 234,Residential,23773,0,23773,93425,0,117198
142525301400000,SE 234,Residential,25080,0,25080,121469,0,146549
142525301500000,SE 234,Residential,25330,0,25330,102726,0,128056
142525301600000,SE 234,Residential,24960,0,24960,98525,0,123485
142525301700000,SE 234,Residential,24000,0,24000,103767,0,127767
142525301800000,SE 234,Residential,24800,0,24800,89965,0,114765
142525301900000,SE 234,Residential,24667,0,24667,96548,0,121215
142525302000000,SE 234,Residential,24303,0,24303,94176,0,118479
142525302100000,SE 234,Residential,23746,0,23746,104697,0,128443
142525302200000,SE 234,Residential,23959,0,23959,102712,0,126671
142525302300000,SE 234,Residential,23959,0,23959,126484,0,150443
142525302400000,SE 234,Residential,23959,0,23959,95878,0,119837
142525302500000,SE 234,Residential,23959,0,23959,84756,0,108715
142525302600000,SE 234,Residential,22861,0,22861,101996,0,124857
142525302700000,SE 234,Residential,22887,0,22887,91416,0,114303
142525302800000,SE 234,Residential,23099,0,23099,90889,0,113988
142525302900000,SE 234,Residential,22982,0,22982,77918,0,100900
142525303000000,SE 234,Residential,22983,0,22983,80777,0,103760
142525303100000,SE 234,Residential,23347,0,23347,95402,0,118749
142525400100000,SE 234,Residential,22610,0,22610,108282,0,130892
142525400200000,SE 234,Residential,34240,0,34240,198718,0,232958
142525400300000,SE 234,Residential,25680,0,25680,129125,0,154805
142525400400000,SE 234,Residential,25680,0,25680,165807,0,191487
142525400500000,SE 234,Residential,25680,0,25680,153436,0,179116
142525400600000,SE 234,Residential,25680,0,25680,169057,0,194737
142525400700000,SE 234,Residential,25680,0,25680,144391,0,170071
142525400800000,SE 234,Residential,27820,0,27820,130833,0,158653
142525400900000,SE 234,Residential,27989,0,27989,130244,0,158233
142525401000000,SE 234,Residential,28612,0,28612,165256,0,193868
142525401100000,SE 234,Residential,39421,0,39421,221002,0,260423
142525401200000,SE 234,Residential,26854,0,26854,97054,0,123908
142525401300000,SE 234,Residential,29462,0,29462,127621,0,157083
142525401400000,SE 234,Residential,27343,0,27343,107657,0,135000
142525401500000,SE 234,Residential,23520,0,23520,106057,0,129577
142525401600000,SE 234,Residential,25220,0,25220,80084,0,105304
142525401700000,SE 234,Residential,25440,0,25440,79727,0,105167
142525401800000,SE 234,Residential,27039,0,27039,116811,0,143850
142525401900000,SE 234,Residential,29040,0,29040,97261,0,126301
142525402000000,SE 234,Residential,27600,0,27600,94924,0,122524
142525402100000,SE 234,Residential,23760,0,23760,86156,0,109916
142525402200000,SE 234,Residential,25714,0,25714,88714,0,114428
142525402300000,SE 234,Residential,25273,0,25273,96833,0,122106
142525402400000,SE 234,Residential,24000,0,24000,80322,0,104322
142525402500000,SE 234,Residential,24000,0,24000,74144,0,98144
142525402600000,SE 234,Residential,24000,0,24000,79795,0,103795
142525402700000,SE 234,Residential,24000,0,24000,80189,0,104189
142525402800000,SE 234,Residential,25213,0,25213,80745,0,105958
142525402900000,SE 234,Residential,24948,0,24948,116929,0,141877
142525403000000,SE 234,Residential,24192,0,24192,116204,0,140396
142525403100000,SE 234,Residential,23688,0,23688,96655,0,120343
142525403200000,SE 234,Residential,22685,0,22685,93581,0,116266
142525403300000,SE 234,Residential,22560,0,22560,104660,0,127220
142525403400000,SE 234,Residential,22560,0,22560,85667,0,108227
142525403500000,SE 234,Residential,22560,0,22560,102551,0,125111
142525500100000,SE 234,Residential,34880,0,34880,229784,0,264664
142525500200000,SE 234,Residential,26160,0,26160,214149,0,240309
142525500300000,SE 234,Residential,26160,0,26160,0,0,26160
142525500400000,SE 234,Residential,26160,0,26160,204340,0,230500
142525500500000,SE 234,Residential,27128,0,27128,195872,0,223000
142525500600000,SE 234,Residential,26160,0,26160,195818,0,221978
142525500700000,SE 234,Residential,28340,0,28340,204812,0,233152
142525500800000,SE 234,Residential,28340,0,28340,167349,0,195689
142525500900000,SE 234,Residential,27508,0,27508,226757,0,254265
142525501000000,SE 234,Residential,24767,0,24767,0,0,24767
142525501100000,SE 234,Residential,24240,0,24240,121194,0,145434
142525501200000,SE 234,Residential,24420,0,24420,89900,0,114320
142525600100000,SE 234,Residential,23579,0,23579,84027,0,107606
142525600200000,SE 234,Residential,23728,0,23728,80321,0,104049
142525600300000,SE 234,Residential,24043,0,24043,97952,0,121995
142525600400000,SE 234,Residential,24515,0,24515,84835,0,109350
142525600500000,SE 234,Residential,24515,0,24515,97211,0,121726
142525600600000,SE 234,Residential,24231,0,24231,79583,0,103814
142525600700000,SE 234,Residential,24607,0,24607,94674,0,119281
142525600800000,SE 234,Residential,25004,0,25004,101627,0,126631
142525600900000,SE 234,Residential,25293,0,25293,107303,0,132596
142525601000000,SE 234,Residential,25425,0,25425,83560,0,108985
142525601100000,SE 234,Residential,23968,0,23968,75897,0,99865
142525601200000,SE 234,Residential,23760,0,23760,92181,0,115941
142525601300000,SE 234,Residential,25536,0,25536,101088,0,126624
142525601400000,SE 234,Residential,26387,0,26387,105484,0,131871
142525601500000,SE 234,Residential,25200,0,25200,84121,0,109321
142525601600000,SE 234,Residential,24192,0,24192,90021,0,114213
142525601700000,SE 234,Residential,27973,0,27973,87971,0,115944
142525601800000,SE 234,Residential,29678,0,29678,125470,0,155148
142525601900000,SE 234,Residential,27472,0,27472,108312,0,135784
142525602000000,SE 234,Residential,26502,0,26502,142343,0,168845
142525602100000,SE 234,Residential,27720,0,27720,134133,0,161853
142525602200000,SE 234,Residential,27133,0,27133,130121,0,157254
142525602300000,SE 234,Residential,23688,0,23688,122893,0,146581
142525602400000,SE 234,Residential,24473,0,24473,104866,0,129339
142525602500000,SE 234,Residential,25519,0,25519,89690,0,115209
142525602600000,SE 234,Residential,23465,0,23465,97944,0,121409
142525602700000,SE 234,Residential,23280,0,23280,93034,0,116314
142525602800000,SE 234,Residential,23760,0,23760,71060,0,94820
142525700100000,SE 234,Residential,25920,0,25920,82893,0,108813
142525700200000,SE 234,Residential,26160,0,26160,89410,0,115570
142525700300000,SE 234,Residential,27032,0,27032,89909,0,116941
142525700400000,SE 234,Residential,26450,0,26450,72319,0,98769
142525700500000,SE 234,Residential,26232,0,26232,77249,0,103481
142525700600000,SE 234,Residential,25920,0,25920,106235,0,132155
142525700700000,SE 234,Residential,25200,0,25200,93041,0,118241
142525700800000,SE 234,Residential,27058,0,27058,87973,0,115031
142525700900000,SE 234,Residential,26600,0,26600,80368,0,106968
142525701000000,SE 234,Residential,25800,0,25800,102103,0,127903
142525701100000,SE 234,Residential,92400,0,92400,0,0,92400
142525800100000,SE 234,Residential,24000,0,24000,109346,0,133346
142525800200000,SE 234,Residential,24000,0,24000,101357,0,125357
142525800300000,SE 234,Residential,24000,0,24000,80018,0,104018
142525800400000,SE 234,Residential,24000,0,24000,103579,0,127579
142525800500000,SE 234,Residential,24000,0,24000,109598,0,133598
142525800600000,SE 234,Residential,23520,0,23520,102606,0,126126
142525800700000,SE 234,Residential,24000,0,24000,103735,0,127735
142525800800000,SE 234,Residential,24000,0,24000,97016,0,121016
142525800900000,SE 234,Residential,24000,0,24000,150619,0,174619
142525801000000,SE 234,Residential,23853,0,23853,109985,0,133838
142525801100000,SE 234,Residential,23760,0,23760,101162,0,124922
142525801200000,SE 234,Residential,23760,0,23760,88305,0,112065
142527600100000,SE 234,Residential,26803,0,26803,76853,0,103656
142527600200000,SE 234,Residential,24966,0,24966,131808,0,156774
142527600300000,SE 234,Residential,22861,0,22861,110154,0,133015
142527600400000,SE 234,Residential,22560,0,22560,94307,0,116867
142527600500000,SE 234,Residential,23688,0,23688,93955,0,117643
142527600600000,SE 234,Residential,22861,0,22861,107624,0,130485
142527600700000,SE 234,Residential,22504,0,22504,119779,0,142283
142527600800000,SE 234,Residential,22504,0,22504,121994,0,144498
142527600900000,SE 234,Residential,22861,0,22861,116218,0,139079
142527601000000,SE 234,Residential,22504,0,22504,91940,0,114444
142527601100000,SE 234,Residential,23182,0,23182,99703,0,122885
142527700100000,SE 234,Residential,23932,0,23932,112346,0,136278
142527700200000,SE 234,Residential,23760,0,23760,92106,0,115866
142527700300000,SE 234,Residential,23760,0,23760,87793,0,111553
142527700400000,SE 234,Residential,23760,0,23760,112363,0,136123
142527700500000,SE 234,Residential,23760,0,23760,78585,0,102345
142527700600000,SE 234,Residential,23760,0,23760,83675,0,107435
142527700700000,SE 234,Residential,25021,0,25021,95325,0,120346
142527700800000,SE 234,Residential,24310,0,24310,93677,0,117987
142527700900000,SE 234,Residential,16352,0,16352,94544,0,110896
142527701000000,SE 234,Residential,16900,0,16900,6828,0,23728
142527701100000,SE 234,Residential,24700,0,24700,109028,0,133728
142527701200000,SE 234,Residential,24453,0,24453,112875,0,137328
142527800100000,SE 234,Residential,24000,0,24000,96408,0,120408
142527800200000,SE 234,Residential,24000,0,24000,96362,0,120362
142527800300000,SE 234,Residential,24000,0,24000,77428,0,101428
142527800400000,SE 234,Residential,24000,0,24000,88335,0,112335
142527800500000,SE 234,Residential,24400,0,24400,79821,0,104221
142527800600000,SE 234,Residential,24566,0,24566,85053,0,109619
142527900100000,SE 234,Residential,24169,0,24169,80320,0,104489
142527900200000,SE 234,Residential,25155,0,25155,124224,0,149379
142527900300000,SE 234,Residential,24662,0,24662,118973,0,143635
142527900400000,SE 234,Residential,23718,0,23718,91842,0,115560
142527900500000,SE 234,Residential,23182,0,23182,92113,0,115295
142527900600000,SE 234,Residential,23485,0,23485,111271,0,134756
142527900700000,SE 234,Residential,23182,0,23182,99678,0,122860
142527900800000,SE 234,Residential,23182,0,23182,117670,0,140852
142527900900000,SE 234,Residential,23182,0,23182,93677,0,116859
142527901000000,SE 234,Residential,23182,0,23182,147435,0,170617
142527901100000,SE 234,Residential,23676,0,23676,104545,0,128221
142527901200000,SE 234,Residential,23397,0,23397,85680,0,109077
142527901300000,SE 234,Residential,23778,0,23778,89478,0,113256
142527901400000,SE 234,Residential,23643,0,23643,87047,0,110690
142527901500000,SE 234,Residential,25160,0,25160,78283,0,103443
142527901600000,SE 234,Residential,24800,0,24800,98463,0,123263
142527901700000,SE 234,Residential,24304,0,24304,108064,0,132368
142527901800000,SE 234,Residential,24185,0,24185,89765,0,113950
142527901900000,SE 234,Residential,24674,0,24674,126011,0,150685
142527902000000,SE 234,Residential,24370,0,24370,118680,0,143050
142527902100000,SE 234,Residential,24824,0,24824,90556,0,115380
142527902200000,SE 234,Residential,26107,0,26107,118889,0,144996
142527902300000,SE 234,Residential,25217,0,25217,55886,0,81103
142527902400000,SE 234,Residential,29900,0,29900,74698,0,104598
142527902500000,SE 234,Residential,23257,0,23257,86743,0,110000
142528000100000,SE 234,Residential,24000,0,24000,46497,0,70497
142528000200000,SE 234,Residential,24000,0,24000,99742,0,123742
142528000300000,SE 234,Residential,25432,0,25432,90282,0,115714
142528000400000,SE 234,Residential,26964,0,26964,132499,0,159463
142528000500000,SE 234,Residential,26969,0,26969,99914,0,126883
142528000600000,SE 234,Residential,28548,0,28548,84820,0,113368
142528000700000,SE 234,Residential,28477,0,28477,88699,0,117176
142528000800000,SE 234,Residential,28477,0,28477,97743,0,126220
142528000900000,SE 234,Residential,28220,0,28220,121826,0,150046
142528001000000,SE 234,Residential,28304,0,28304,96418,0,124722
142528001100000,SE 234,Residential,27600,0,27600,99786,0,127386
142528001200000,SE 234,Residential,27251,0,27251,77401,0,104652
142528001300000,SE 234,Residential,24832,0,24832,83265,0,108097
142528001400000,SE 234,Residential,27044,0,27044,85825,0,112869
142528001500000,SE 234,Residential,22925,0,22925,0,0,22925
142528001600000,SE 234,Residential,30500,0,30500,0,0,30500
142528001700000,SE 234,Residential,26705,0,26705,0,0,26705
142528001800000,SE 234,Residential,27000,0,27000,0,0,27000
142528001900000,SE 234,Residential,53900,0,53900,280505,0,334405
142528002000000,SE 234,Residential,27000,0,27000,0,0,27000
142528002100000,SE 234,Residential,16000,0,16000,0,0,16000
142528002200000,SE 234,Residential,53089,0,53089,280353,0,333442
142528002300000,SE 234,Residential,16000,0,16000,0,0,16000
142528002400000,SE 234,Residential,16000,0,16000,0,0,16000
142528002500000,SE 234,Residential,57899,0,57899,377758,0,435657
142528002600000,SE 234,Residential,55327,0,55327,331247,0,386574
142528002700000,SE 234,Residential,56479,0,56479,0,0,56479
142528002800000,SE 234,Residential,50000,0,50000,339174,0,389174
142528002900000,SE 234,Residential,60480,0,60480,375084,0,435564
142528003000000,SE 234,Residential,27500,0,27500,0,0,27500
142528003100000,SE 234,Residential,52430,0,52430,290817,0,343247
142528003200000,SE 234,Residential,59360,0,59360,271360,0,330720
142528003300000,CITY PROPERTY,Exempt,0,0,0,0,0,0
142528100100000,SE 234,Residential,28053,0,28053,81222,0,109275
142528100200000,SE 234,Residential,23192,0,23192,101256,0,124448
142528100300000,SE 234,Residential,23760,0,23760,72842,0,96602
142528100400000,SE 234,Residential,23760,0,23760,70928,0,94688
142528100500000,SE 234,Residential,23760,0,23760,97597,0,121357
142528100600000,SE 234,Residential,23760,0,23760,86088,0,109848
142528100700000,SE 234,Residential,23760,0,23760,113821,0,137581
142528100800000,SE 234,Residential,23760,0,23760,70258,0,94018
142528100900000,SE 234,Residential,23760,0,23760,81920,0,105680
142528101000000,SE 234,Residential,28349,0,28349,89213,0,117562
142528101100000,SE 234,Residential,25600,0,25600,81924,0,107524
142528101200000,SE 234,Residential,32950,0,32950,0,0,32950
142528200100000,SE 234,Residential,25106,0,25106,92881,0,117987
142528200200000,SE 234,Residential,24000,0,24000,93449,0,117449
142528200300000,SE 234,Residential,24359,0,24359,77772,0,102131
142528200400000,SE 234,Residential,23760,0,23760,85092,0,108852
142528200500000,SE 234,Residential,23760,0,23760,88587,0,112347
142528200600000,SE 234,Residential,23760,0,23760,85581,0,109341
142528200700000,SE 234,Residential,23760,0,23760,83294,0,107054
142528200800000,SE 234,Residential,23760,0,23760,86753,0,110513
142528300100000,SE 234,Residential,23760,0,23760,88764,0,112524
142528300200000,SE 234,Residential,23760,0,23760,82479,0,106239
142528400100000,SE 234,Residential,23760,0,23760,85487,0,109247
142528400200000,SE 234,Residential,27574,0,27574,122264,0,149838
142530100100000,SE 239,Residential,59100,0,59100,0,0,59100
142530100300000,SE 239,Residential,71875,0,71875,170033,0,241908
142530100400000,SE 239,Residential,71875,0,71875,7636,0,79511
142530100500000,SE 239,Residential,47781,0,47781,234342,0,282123
142530100600000,SE 239,Residential,42420,0,42420,183319,0,225739
142530100700000,SE 239,Residential,50400,0,50400,280178,0,330578
142530100800000,SE 239,Residential,53125,0,53125,209810,0,262935
142530100900000,SE 239,Residential,63913,0,63913,218961,0,282874
142530101000000,SE 239,Residential,60646,0,60646,244129,0,304775
142530101100000,SE 239,Residential,66299,0,66299,282467,0,348766
142530101200000,SE 239,Residential,61086,0,61086,296924,0,358010
142530101300000,SE 239,Residential,62160,0,62160,276691,0,338851
142530101400000,SE 239,Residential,54390,0,54390,242993,0,297383
142530101500000,SE 246,Residential,62905,0,62905,229284,0,292189
142530101600000,SE 246,Residential,59916,0,59916,177458,0,237374
142530101700000,SE 246,Residential,54920,0,54920,219542,0,274462
142530101800000,SE 246,Residential,58853,0,58853,6978,0,65831
142530101900000,SE 246,Residential,58433,0,58433,191567,0,250000
142530102000000,CITY PROPERTY,Exempt,0,0,0,0,0,0
142530102100000,SE 246,Residential,54075,0,54075,297765,0,351840
142530102200000,SE 246,Residential,56700,0,56700,240851,0,297551
142530102300000,SE 246,Residential,56021,0,56021,263357,0,319378
142530200100000,SE 239,Residential,45816,0,45816,0,0,45816
142530200200000,SE 246,Residential,56270,0,56270,0,0,56270
142530300100000,SE 246,Residential,55578,0,55578,311780,0,367358
142530300200000,SE 246,Residential,52020,0,52020,255714,0,307734
142530300300000,SE 246,Residential,53104,0,53104,267536,0,320640
142530300400000,SE 246,Residential,52675,0,52675,230695,0,283370
142530300500000,SE 246,Residential,57117,0,57117,250864,0,307981
142530300600000,SE 246,Residential,57120,0,57120,206414,0,263534
142530300700000,SE 246,Residential,55377,0,55377,289623,0,345000
142530300800000,SE 246,Residential,55064,0,55064,231611,0,286675
142530300900000,SE 246,Residential,48361,0,48361,0,0,48361
142530301000000,SE 246,Residential,50190,0,50190,193820,0,244010
142532600100000,SE 239,Residential,125700,0,125700,0,0,125700
142532600300000,SE 239,Residential,49600,0,49600,62042,0,111642
142532600600000,SE 239,Residential,49550,0,49550,115431,0,164981
142532600700000,SE 239,Residential,49800,0,49800,91561,0,141361
142532600800000,SE 239,Residential,59300,0,59300,146807,0,206107
142532600900000,SE 239,Residential,40000,0,40000,108746,0,148746
142532601100000,SE 239,Residential,54720,0,54720,181374,0,236094
142532601200000,SE 239,Residential,52574,0,52574,0,0,52574
142532601300000,SE 239,Residential,43650,0,43650,0,0,43650
142532601400000,SE 239,Residential,66126,0,66126,162485,0,228611
142532601500000,SE 239,Residential,54023,0,54023,185231,0,239254
142532601600000,SE 239,Residential,54488,0,54488,0,0,54488
142532601700000,SE 239,Residential,43700,0,43700,0,0,43700
142532601800000,SE 239,Residential,46332,0,46332,0,0,46332
142532601900000,SE 239,Residential,51888,0,51888,144260,0,196148
142540100500000,SE 246,Residential,79867,0,79867,114058,0,193925
142540100600000,SE 246,Residential,77093,0,77093,0,0,77093
142540100700000,SE 246,Residential,73320,0,73320,0,0,73320
142540100800000,SE 246,Residential,71879,0,71879,381846,0,453725
142540100900000,SE 246,Residential,71265,0,71265,0,0,71265
142540101000000,SE 246,Residential,73283,0,73283,0,0,73283
142540101100000,SE 246,Residential,71658,0,71658,354269,0,425927
142540101200000,SE 246,Residential,115855,0,115855,339481,0,455336
142540101300000,SE 246,Residential,87668,0,87668,277156,0,364824
142540101400000,SE 246,Residential,86036,0,86036,395051,0,481087
142540101500000,SE 246,Residential,82311,0,82311,0,0,82311
142540101700000,SE 246,Residential,85061,0,85061,283797,0,368858
142540101800000,SE 246,Residential,88307,0,88307,285376,0,373683
142540101900000,SE 246,Residential,125740,0,125740,661960,0,787700
142540200100000,SE 246,Residential,83026,0,83026,308364,0,391390
142540200200000,SE 246,Residential,92232,0,92232,287044,0,379276
142540200300000,SE 246,Residential,82047,0,82047,277770,0,359817
142540200400000,SE 246,Residential,9982,0,9982,0,0,9982
142540200500000,SE 246,Residential,104915,0,104915,77051,0,181966
142540200600000,SE 246,Residential,5986,0,5986,0,0,5986
142540200700000,SE 246,Residential,5264,0,5264,0,0,5264
142540200800000,SE 246,Residential,5533,0,5533,0,0,5533
142540200900000,SE 246,Residential,9556,0,9556,0,0,9556
142540201000000,SE 246,Residential,6906,0,6906,0,0,6906
142540201100000,SE 246,Residential,80512,0,80512,3965,0,84477
142540201200000,SE 246,Residential,5469,0,5469,0,0,5469
142540201300000,SE 246,Residential,97378,0,97378,407472,0,504850
142540201400000,SE 246,Residential,7927,0,7927,0,0,7927
142540201500000,SE 246,Residential,5620,0,5620,0,0,5620
142540201600000,SE 246,Residential,5733,0,5733,0,0,5733
142540201700000,SE 246,Residential,8019,0,8019,0,0,8019
142540201800000,SE 246,Residential,11614,0,11614,0,0,11614
142542600100000,SE 246,Residential,72144,0,72144,233856,0,306000
142542600200000,SE 246,Residential,69767,0,69767,359768,0,429535
142542600300000,SE 246,Residential,77880,0,77880,266810,0,344690
142542600400000,SE 246,Residential,73383,0,73383,270820,0,344203
142542600500000,SE 246,Residential,64492,0,64492,258446,0,322938
142542600600000,SE 246,Residential,55500,0,55500,0,0,55500
142542700100000,SE 246,Residential,71140,0,71140,285847,0,356987
142542700200000,SE 246,Residential,56862,0,56862,262218,0,319080
142542700300000,SE 246,Residential,55283,0,55283,274853,0,330136
142542700400000,SE 246,Residential,60067,0,60067,323541,0,383608
142542700500000,SE 246,Residential,71383,0,71383,371665,0,443048
142542700600000,SE 246,Residential,73523,0,73523,325321,0,398844
142542700700000,SE 246,Residential,71370,0,71370,270064,0,341434
142542700800000,SE 246,Residential,71797,0,71797,284754,0,356551
142542800100000,SE 246,Residential,80784,0,80784,289800,0,370584
142542800200000,SE 246,Residential,100100,0,100100,341313,0,441413
142542800300000,SE 246,Residential,57720,0,57720,306550,0,364270
142542800400000,SE 246,Residential,57068,0,57068,404841,0,461909
142542800500000,SE 246,Residential,58240,0,58240,286930,0,345170
142542800600000,SE 246,Residential,60600,0,60600,305689,0,366289
142542900100000,SE 246,Residential,19096,0,19096,0,0,19096
142542900200000,SE 246,Residential,90020,0,90020,274406,0,364426
142542900300000,SE 246,Residential,125800,0,125800,0,0,125800
142542900400000,SE 246,Residential,60473,0,60473,232407,0,292880
142542900500000,SE 246,Residential,68950,0,68950,238829,0,307779
142542900600000,SE 246,Residential,66640,0,66640,218908,0,285548
142542900700000,SE 246,Residential,49000,0,49000,351874,0,400874
142542900800000,SE 246,Residential,49000,0,49000,229473,0,278473
142542900900000,SE 246,Residential,51000,0,51000,251960,0,302960
142542901000000,SE 246,Residential,53500,0,53500,249352,0,302852
142542901100000,CITY PROPERTY,Exempt,0,0,0,0,0,0
142610100300000,NBHD SHOPPING CENTER,Commercial,0,129470,129470,0,363653,493123
142610100400000,SE 234,Residential,25200,0,25200,76475,0,101675
142610100500000,SE 234,Residential,21000,0,21000,80023,0,101023
142610100600000,SE 234,Residential,23280,0,23280,108525,0,131805
142610100700000,SE 234,Residential,24444,0,24444,83723,0,108167
142610100800000,SE 234,Residential,21728,0,21728,101713,0,123441
142610100900000,SE 234,Residential,20176,0,20176,94291,0,114467
142610101000000,SE 234,Residential,23956,0,23956,102473,0,126429
142610101100000,SE 234,Residential,24266,0,24266,53014,0,77280
142610101200000,CONVENIENCE STORE,Commercial,0,417960,417960,0,101592,519552
142610200100000,RESTAURANT,Commercial,0,64994,64994,0,101796,166790
142610200200000,SE 234,Residential,15604,0,15604,74547,0,90151
142610200300000,SE 234,Residential,15246,0,15246,73134,0,88380
142610200400000,SE 234,Residential,15581,0,15581,85166,0,100747
142610200500000,SE 234,Residential,18720,0,18720,76471,0,95191
142610200600000,SE 234,Residential,18720,0,18720,81609,0,100329
142610200700000,SE 234,Residential,20800,0,20800,89453,0,110253
142610200800000,SE 234,Residential,22680,0,22680,92433,0,115113
142610200900000,SE 234,Residential,22680,0,22680,53717,0,76397
142610300100000,OFFICE,Commercial,0,38404,38404,0,109242,147646
142610300200000,NBHD SHOPPING CENTER,Commercial,0,199800,199800,0,387843,587643
142610300800000,SE 234,Residential,15593,0,15593,41978,0,57571
142610300900000,SE 234,Residential,17387,0,17387,42613,0,60000
142610301000000,SE 234,Residential,23280,0,23280,96453,0,119733
142610301100000,SE 234,Residential,21340,0,21340,66486,0,87826
142610301200000,SE 234,Residential,27518,0,27518,105267,0,132785
142610301300000,SE 234,Residential,22562,0,22562,91303,0,113865
142610301400000,SE 234,Residential,19614,0,19614,114789,0,134403
142610301500000,SE 234,Residential,19879,0,19879,85256,0,105135
142610301600000,SE 234,Residential,16820,0,16820,75002,0,91822
142610400100000,SE 234,Residential,61800,0,61800,116264,0,178064
142610400400000,SE 234,Residential,25654,0,25654,114411,0,140065
142610400500000,SE 234,Residential,25856,0,25856,121397,0,147253
142610400600000,SE 234,Residential,25856,0,25856,118485,0,144341
142610400700000,SE 234,Residential,25856,0,25856,124668,0,150524
142610400800000,SE 234,Residential,25856,0,25856,96443,0,122299
142610400900000,SE 234,Residential,26300,0,26300,148599,0,174899
142610401000000,SE 233,Residential,23956,0,23956,78760,0,102716
142610401100000,SE 234,Residential,24649,0,24649,70351,0,95000
142610401200000,SE 234,Residential,22176,0,22176,88283,0,110459
142610401300000,SE 234,Residential,22070,0,22070,90015,0,112085
142610401400000,SE 234,Residential,22070,0,22070,89644,0,111714
142610401500000,SE 234,Residential,22070,0,22070,100883,0,122953
142610401600000,SE 234,Residential,22070,0,22070,76348,0,98418
142610401700000,SE 234,Residential,22070,0,22070,107494,0,129564
142610401800000,SE 234,Residential,55000,0,55000,180932,0,235932
142610401900000,SE 234,Residential,22070,0,22070,92262,0,114332
142610402000000,SE 234,Residential,22070,0,22070,82353,0,104423
142610402100000,SE 234,Residential,22070,0,22070,83890,0,105960
142610402200000,SE 234,Residential,22070,0,22070,89328,0,111398
142610402300000,SE 234,Residential,22070,0,22070,119440,0,141510
142610402400000,SE 234,Residential,22176,0,22176,113971,0,136147
142610402500000,SE 234,Residential,21369,0,21369,108631,0,130000
142610402600000,SE 234,Residential,21000,0,21000,79905,0,100905
142610402700000,SE 234,Residential,21000,0,21000,52668,0,73668
142610402800000,SE 234,Residential,21000,0,21000,85340,0,106340
142610402900000,SE 234,Residential,21000,0,21000,110234,0,131234
142610403000000,SE 234,Residential,21000,0,21000,78477,0,99477
142610403100000,SE 234,Residential,21000,0,21000,73270,0,94270
142610403200000,SE 234,Residential,21000,0,21000,80630,0,101630
142610403300000,SE 234,Residential,21000,0,21000,126087,0,147087
142610403400000,SE 234,Residential,21000,0,21000,72242,0,93242
142610403500000,SE 234,Residential,29400,0,29400,127811,0,157211
142610403600000,SE 234,Residential,21000,0,21000,106088,0,127088
142610403700000,SE 234,Residential,27703,0,27703,72692,0,100395
142610403800000,SE 234,Residential,26880,0,26880,91216,0,118096
142610403900000,SE 234,Residential,26775,0,26775,87794,0,114569
142610404000000,SE 234,Residential,35700,0,35700,97600,0,133300
142610404100000,SE 234,Residential,35319,0,35319,134475,0,169794
142610500100000,SE 234,Residential,24000,0,24000,80050,0,104050
142610500200000,SE 234,Residential,24000,0,24000,69746,0,93746
142610500300000,SE 234,Residential,24000,0,24000,79249,0,103249
142610500400000,SE 234,Residential,24307,0,24307,53750,0,78057
142610500500000,SE 234,Residential,20800,0,20800,83634,0,104434
142610500600000,SE 234,Residential,20160,0,20160,93609,0,113769
142610500700000,SE 234,Residential,21600,0,21600,88192,0,109792
142610500800000,SE 234,Residential,22000,0,22000,97787,0,119787
142610500900000,SE 234,Residential,22200,0,22200,75038,0,97238
142610501000000,SE 234,Residential,28305,0,28305,125563,0,153868
142610501100000,SE 234,Residential,28050,0,28050,96801,0,124851
142610501200000,SE 234,Residential,26683,0,26683,114245,0,140928
142610501300000,SE 234,Residential,26656,0,26656,80085,0,106741
142610501400000,SE 234,Residential,21400,0,21400,71597,0,92997
142610501500000,SE 234,Residential,21400,0,21400,58016,0,79416
142610501600000,SE 234,Residential,21400,0,21400,92639,0,114039
142610501700000,SE 234,Residential,21400,0,21400,79134,0,100534
142610501800000,SE 234,Residential,21400,0,21400,84150,0,105550
142610501900000,SE 234,Residential,21400,0,21400,78837,0,100237
142610502000000,SE 234,Residential,21400,0,21400,89505,0,110905
142610502100000,SE 234,Residential,21400,0,21400,91872,0,113272
142610502200000,SE 234,Residential,21400,0,21400,77311,0,98711
142610600100000,SE 234,Residential,25167,0,25167,120410,0,145577
142610600200000,SE 234,Residential,28050,0,28050,112671,0,140721
142610600300000,SE 234,Residential,24780,0,24780,94215,0,118995
142610600400000,SE 234,Residential,30570,0,30570,128412,0,158982
142610600500000,SE 234,Residential,23038,0,23038,69448,0,92486
142610600600000,SE 234,Residential,21542,0,21542,82681,0,104223
142610600700000,SE 234,Residential,19740,0,19740,74960,0,94700
142610600800000,SE 234,Residential,22793,0,22793,71982,0,94775
142610600900000,SE 234,Residential,22971,0,22971,88295,0,111266
142610601000000,SE 234,Residential,19260,0,19260,89701,0,108961
142610601100000,SE 234,Residential,19440,0,19440,63776,0,83216
142610601200000,SE 234,Residential,24288,0,24288,116412,0,140700
142610601300000,SE 234,Residential,24402,0,24402,85550,0,109952
142610700100000,SE 234,Residential,25582,0,25582,78823,0,104405
142610700200000,SE 234,Residential,20400,0,20400,63252,0,83652
142610700300000,SE 234,Residential,20400,0,20400,89373,0,109773
142610700400000,SE 234,Residential,20800,0,20800,81673,0,102473
142610700500000,SE 234,Residential,21000,0,21000,80638,0,101638
142610700600000,SE 234,Residential,21600,0,21600,118579,0,140179
142610700700000,SE 234,Residential,26964,0,26964,134295,0,161259
142610700800000,SE 234,Residential,26964,0,26964,79633,0,106597
142610700900000,SE 234,Residential,23540,0,23540,74925,0,98465
142610701000000,SE 234,Residential,23320,0,23320,83817,0,107137
142610701100000,SE 234,Residential,41796,0,41796,126662,0,168458
142610800100000,SE 234,Residential,20160,0,20160,89442,0,109602
142610800200000,SE 234,Residential,29131,0,29131,96766,0,125897
142610800300000,SE 234,Residential,25376,0,25376,101319,0,126695
142610800400000,SE 234,Residential,25256,0,25256,125766,0,151022
142610800500000,SE 234,Residential,26123,0,26123,142607,0,168730
142610800600000,SE 234,Residential,25000,0,25000,88403,0,113403
142610800700000,SE 234,Residential,35464,0,35464,138684,0,174148
142610800800000,SE 234,Residential,34720,0,34720,116946,0,151666
142610800900000,SE 234,Residential,21400,0,21400,77594,0,98994
142610801000000,SE 234,Residential,27285,0,27285,97225,0,124510
142610801100000,SE 234,Residential,27285,0,27285,111821,0,139106
142610801200000,SE 234,Residential,29325,0,29325,117708,0,147033
142610801300000,SE 234,Residential,29325,0,29325,82963,0,112288
142612600100000,OFFICE,Commercial,0,89813,89813,0,297067,386880
142612600200000,OFFICE,Commercial,0,163039,163039,0,322193,485232
142612600300000,RESTAURANT,Commercial,0,163296,163296,0,203062,366358
142612600400000,SE 234,Residential,27709,0,27709,122533,0,150242
142612600500000,SMALL RETAIL,Commercial,0,134784,134784,0,59246,194030
142612600600000,SMALL RETAIL,Commercial,0,48853,48853,0,105135,153988
142612600700000,SMALL RETAIL,Commercial,0,70308,70308,0,412285,482593
142612600800000,SE 234,Residential,36627,0,36627,58373,0,95000
142612600900000,SE 234,Residential,23199,0,23199,90248,0,113447
142612601000000,SE 234,Residential,25440,0,25440,105622,0,131062
142612601100000,SE 234,Residential,24480,0,24480,125810,0,150290
142612601200000,SE 234,Residential,24480,0,24480,149801,0,174281
142612601300000,SE 234,Residential,23261,0,23261,124832,0,148093
142612601400000,SE 234,Residential,24863,0,24863,137554,0,162417
142612601500000,SE 234,Residential,24499,0,24499,102848,0,127347
142612601600000,SE 234,Residential,25024,0,25024,137958,0,162982
142612601700000,SE 234,Residential,24558,0,24558,151659,0,176217
142612601800000,SE 234,Residential,22932,0,22932,109059,0,131991
142612601900000,SE 234,Residential,23218,0,23218,126232,0,149450
142612602000000,SE 234,Residential,23220,0,23220,115128,0,138348
142612602100000,SE 234,Residential,25688,0,25688,95060,0,120748
142612602200000,SE 234,Residential,22880,0,22880,96507,0,119387
142612602300000,SE 234,Residential,22880,0,22880,104323,0,127203
142612602400000,SE 234,Residential,22880,0,22880,120857,0,143737
142612602500000,SE 234,Residential,22880,0,22880,124530,0,147410
142612602600000,SE 234,Residential,22880,0,22880,87081,0,109961
142612602700000,SE 234,Residential,22880,0,22880,77490,0,100370
142612602800000,SE 234,Residential,22880,0,22880,114861,0,137741
142612602900000,SE 234,Residential,22880,0,22880,92877,0,115757
142612603000000,SE 234,Residential,22880,0,22880,74496,0,97376
142612603100000,SE 234,Residential,22880,0,22880,97538,0,120418
142612603200000,SE 234,Residential,22880,0,22880,55945,0,78825
142612603300000,SE 234,Residential,22880,0,22880,82503,0,105383
142612603400000,CITY PROPERTY,Exempt,0,0,0,0,0,0
142612603500000,SE 234,Residential,24505,0,24505,79265,0,103770
142612603600000,SE 234,Residential,23512,0,23512,108848,0,132360
142612603700000,SE 234,Residential,23512,0,23512,95748,0,119260
142612603800000,SE 234,Residential,23512,0,23512,66258,0,89770
142612603900000,SE 234,Residential,23512,0,23512,73026,0,96538
142612604000000,SE 234,Residential,23512,0,23512,90478,0,113990
142612604100000,SE 234,Residential,23512,0,23512,90095,0,113607
142612604200000,SE 234,Residential,24235,0,24235,87171,0,111406
142612604300000,SE 234,Residential,24480,0,24480,106092,0,130572
142612604400000,SE 234,Residential,25208,0,25208,85652,0,110860
142612604500000,SE 234,Residential,25386,0,25386,77728,0,103114
142612604600000,SE 234,Residential,25149,0,25149,79621,0,104770
142612604700000,SE 234,Residential,25080,0,25080,82429,0,107509
142612604800000,SE 234,Residential,24970,0,24970,87782,0,112752
142612604900000,SE 234,Residential,26160,0,26160,69926,0,96086
142612605000000,SE 234,Residential,25816,0,25816,138489,0,164305
142612605100000,SE 234,Residential,25246,0,25246,104226,0,129472
142612605200000,SE 234,Residential,25579,0,25579,123247,0,148826
142612605300000,SE 234,Residential,27342,0,27342,127954,0,155296
142612605400000,SE 234,Residential,23715,0,23715,86891,0,110606
142612605500000,SE 234,Residential,24192,0,24192,92230,0,116422
142612605600000,SE 234,Residential,23959,0,23959,92518,0,116477
142612605700000,SE 234,Residential,24453,0,24453,85939,0,110392
142612605800000,SE 234,Residential,25080,0,25080,67884,0,92964
142612605900000,SE 234,Residential,40500,0,40500,147086,0,187586
142612606000000,SE 234,Residential,29400,0,29400,111155,0,140555
142612606100000,SE 234,Residential,26347,0,26347,110715,0,137062
142612700100000,SMALL RETAIL,Commercial,0,57788,57788,0,40480,98268
142612700200000,LG DISCOUNT/RETAIL,Commercial,0,748440,748440,0,974671,1723111
142612700300000,VETERINARY CLINIC,Commercial,0,89910,89910,0,205310,295220
142612700400000,APARTMENT,Commercial,0,144720,144720,0,1549267,1693987
142612700500000,SE 234,Residential,35078,0,35078,49276,0,84354
142612700600000,SE 234,Residential,31099,0,31099,82973,0,114072
142612700700000,SE 234,Residential,31099,0,31099,90547,0,121646
142612700800000,SE 234,Residential,31099,0,31099,97329,0,128428
142612700900000,SE 234,Residential,30347,0,30347,111751,0,142098
142612701000000,SE 234,Residential,24391,0,24391,126524,0,150915
142612701100000,SE 234,Residential,23712,0,23712,112080,0,135792
142612701200000,SE 234,Residential,26208,0,26208,97955,0,124163
142612701300000,SE 234,Residential,25688,0,25688,90951,0,116639
142612701400000,SE 234,Residential,24960,0,24960,114707,0,139667
142612701500000,SE 234,Residential,25144,0,25144,73856,0,99000
142612701600000,SE 234,Residential,24960,0,24960,91544,0,116504
142612701700000,SE 234,Residential,24960,0,24960,92869,0,117829
142612701800000,SE 234,Residential,25688,0,25688,117041,0,142729
142612701900000,SE 234,Residential,26544,0,26544,97418,0,123962
142612702000000,SE 234,Residential,26208,0,26208,91402,0,117610
142612702100000,SE 234,Residential,29400,0,29400,81151,0,110551
142612702200000,SE 234,Residential,25935,0,25935,139661,0,165596
142612702300000,CENTRALLY ASSESSED,Other,0,0,0,0,0,0
142612702400000,FLAT PARKING,Commercial,0,9979,9979,0,2646,12625
142612702500000,FLAT PARKING,Commercial,0,45814,45814,0,6835,52649
142612702600000,SE 234,Residential,28350,0,28350,58081,0,86431
142612702700000,APARTMENT,Commercial,0,10935,10935,0,138987,149922
142612800100000,SE 234,Residential,28162,0,28162,103831,0,131993
142612800200000,SE 234,Residential,25585,0,25585,93058,0,118643
142612800300000,SE 234,Residential,26894,0,26894,145791,0,172685
142612800400000,SE 234,Residential,26742,0,26742,85360,0,112102
142612800500000,SE 234,Residential,25608,0,25608,98850,0,124458
142612800600000,SE 234,Residential,23587,0,23587,121422,0,145009
142612800700000,SE 234,Residential,27151,0,27151,118295,0,145446
142612800800000,SE 234,Residential,28787,0,28787,102666,0,131453
142612800900000,SE 234,Residential,23030,0,23030,106771,0,129801
142612801000000,SE 234,Residential,23280,0,23280,109151,0,132431
142612801100000,SE 234,Residential,23760,0,23760,78368,0,102128
142612801200000,SE 234,Residential,24240,0,24240,94972,0,119212
142612801300000,SE 234,Residential,24480,0,24480,85104,0,109584
142612801400000,SE 234,Residential,24960,0,24960,88207,0,113167
142612801500000,SE 234,Residential,26206,0,26206,98797,0,125003
142612801600000,SE 234,Residential,25688,0,25688,76159,0,101847
142612801700000,SE 234,Residential,25935,0,25935,97132,0,123067
142612801800000,SE 234,Residential,25935,0,25935,79944,0,105879
142612801900000,SE 234,Residential,25666,0,25666,104808,0,130474
142612802000000,SE 234,Residential,25502,0,25502,104423,0,129925
142615100100000,SE 234,Residential,25523,0,25523,90398,0,115921
142615100200000,SE 234,Residential,24960,0,24960,89963,0,114923
142615100300000,SE 234,Residential,24960,0,24960,99709,0,124669
142615100400000,SE 234,Residential,24960,0,24960,81438,0,106398
142615100500000,SE 234,Residential,24960,0,24960,83872,0,108832
142615100600000,SE 234,Residential,24960,0,24960,120417,0,145377
142615100700000,SE 234,Residential,24960,0,24960,86939,0,111899
142615100800000,SE 234,Residential,24960,0,24960,80957,0,105917
142615100900000,SE 234,Residential,27981,0,27981,108493,0,136474
142615101000000,SE 234,Residential,24061,0,24061,70493,0,94554
142615101100000,SE 234,Residential,24544,0,24544,98472,0,123016
142615101200000,SE 234,Residential,24544,0,24544,77231,0,101775
142615101300000,SE 234,Residential,25068,0,25068,74160,0,99228
142615101400000,SE 234,Residential,23383,0,23383,92469,0,115852
142615101500000,SE 234,Residential,27961,0,27961,112011,0,139972
142615101600000,SE 234,Residential,24960,0,24960,97828,0,122788
142615101700000,SE 234,Residential,24960,0,24960,109340,0,134300
142615101800000,SE 234,Residential,24960,0,24960,110174,0,135134
142615101900000,SE 234,Residential,24960,0,24960,111882,0,136842
142615102000000,SE 234,Residential,24960,0,24960,86204,0,111164
142615102100000,SE 234,Residential,24960,0,24960,131801,0,156761
142615102200000,SE 234,Residential,24960,0,24960,93820,0,118780
142615102300000,SE 234,Residential,24000,0,24000,118621,0,142621
142615102400000,SE 234,Residential,24000,0,24000,84725,0,108725
142615102500000,SE 234,Residential,25523,0,25523,104932,0,130455
142615200100000,SE 234,Residential,22405,0,22405,96451,0,118856
142615200200000,SE 234,Residential,23940,0,23940,106038,0,129978
142615200300000,SE 234,Residential,24381,0,24381,89110,0,113491
142615200400000,SE 234,Residential,22800,0,22800,106231,0,129031
142615200500000,SE 234,Residential,22800,0,22800,120361,0,143161
142615200600000,SE 234,Residential,19000,0,19000,83160,0,102160
142615200700000,SE 234,Residential,23732,0,23732,95418,0,119150
142615300100000,SE 234,Residential,24752,0,24752,89406,0,114158
142615300200000,SE 234,Residential,26279,0,26279,65301,0,91580
142615300300000,SE 234,Residential,25709,0,25709,89298,0,115007
142615300400000,SE 234,Residential,26624,0,26624,124084,0,150708
142615300500000,SE 234,Residential,24832,0,24832,104144,0,128976
142615300600000,SE 234,Residential,22528,0,22528,102986,0,125514
142615300700000,SE 234,Residential,19466,0,19466,91405,0,110871
142615300800000,SE 234,Residential,23520,0,23520,95048,0,118568
142615300900000,SE 234,Residential,22050,0,22050,65162,0,87212
142615301000000,SE 234,Residential,24766,0,24766,75211,0,99977
142615301100000,SE 234,Residential,29088,0,29088,98833,0,127921
142615301200000,SE 234,Residential,24398,0,24398,86948,0,111346
142615301300000,SE 234,Residential,24868,0,24868,97089,0,121957
142615301400000,SE 234,Residential,24496,0,24496,95567,0,120063
142615301500000,SE 234,Residential,24000,0,24000,43551,0,67551
142615301600000,SE 234,Residential,24000,0,24000,78078,0,102078
142615301700000,SE 234,Residential,24000,0,24000,95712,0,119712
142615301800000,SE 234,Residential,24000,0,24000,95678,0,119678
142615400100000,SE 234,Residential,23195,0,23195,98542,0,121737
142615400200000,SE 234,Residential,22800,0,22800,90324,0,113124
142615400300000,SE 234,Residential,22800,0,22800,103329,0,126129
142615400400000,SE 234,Residential,22800,0,22800,98491,0,121291
142615400500000,SE 234,Residential,22800,0,22800,74337,0,97137
142615400600000,SE 234,Residential,22800,0,22800,97737,0,120537
142615400700000,SE 234,Residential,22969,0,22969,101565,0,124534
142615400800000,SE 234,Residential,25108,0,25108,126708,0,151816
142615400900000,SE 234,Residential,27432,0,27432,123683,0,151115
142615401000000,SE 234,Residential,25500,0,25500,114605,0,140105
142615401100000,SE 234,Residential,25160,0,25160,82587,0,107747
142615401200000,SE 234,Residential,27600,0,27600,112860,0,140460
142615401300000,SE 234,Residential,25916,0,25916,130102,0,156018
142615401400000,SE 234,Residential,25704,0,25704,132637,0,158341
142615401500000,SE 234,Residential,25114,0,25114,80801,0,105915
142615500100000,SE 234,Residential,22400,0,22400,103942,0,126342
142615500200000,SE 234,Residential,22400,0,22400,118424,0,140824
142615500300000,SE 234,Residential,26432,0,26432,95475,0,121907
142615500400000,SE 234,Residential,31693,0,31693,133793,0,165486
142615500500000,SE 234,Residential,36600,0,36600,138693,0,175293
142615500600000,SE 234,Residential,40425,0,40425,176190,0,216615
142615500700000,SE 234,Residential,40125,0,40125,165887,0,206012
142615500800000,SE 234,Residential,24121,0,24121,156183,0,180304
142615500900000,SE 234,Residential,26129,0,26129,89086,0,115215
142615501000000,SE 234,Residential,31411,0,31411,107055,0,138466
142615501100000,SE 234,Residential,42650,0,42650,216571,0,259221
142615501200000,SE 234,Residential,28639,0,28639,177669,0,206308
142615501300000,SE 234,Residential,32274,0,32274,109918,0,142192
142615501400000,SE 234,Residential,27000,0,27000,124417,0,151417
142615501500000,SE 234,Residential,24968,0,24968,115690,0,140658
142615501600000,SE 234,Residential,25024,0,25024,94554,0,119578
142615501700000,SE 234,Residential,25704,0,25704,146555,0,172259
142615501800000,SE 234,Residential,29648,0,29648,91701,0,121349
142615501900000,SE 234,Residential,30375,0,30375,102707,0,133082
142615502000000,SE 234,Residential,22741,0,22741,88469,0,111210
142615502100000,SE 234,Residential,22893,0,22893,91724,0,114617
142615502200000,SE 234,Residential,40650,0,40650,88485,0,129135
142615502300000,SE 234,Residential,24912,0,24912,150852,0,175764
142615502400000,SE 234,Residential,41575,0,41575,296556,0,338131
142615502500000,SE 234,Residential,46975,0,46975,60711,0,107686
142615502600000,SE 234,Residential,31232,0,31232,77788,0,109020
142615502700000,SE 234,Residential,41075,0,41075,53353,0,94428
142615502800000,SE 234,Residential,35864,0,35864,48608,0,84472
142615502900000,SE 234,Residential,24700,0,24700,85597,0,110297
142615503000000,SE 234,Residential,24700,0,24700,81169,0,105869
142617600100000,SE 234,Residential,31090,0,31090,167872,0,198962
142617600200000,SE 234,Residential,20480,0,20480,76364,0,96844
142617600300000,SE 234,Residential,26237,0,26237,98104,0,124341
142617600400000,SE 234,Residential,36375,0,36375,138667,0,175042
142617600500000,SE 234,Residential,38050,0,38050,153358,0,191408
142617600600000,SE 234,Residential,36125,0,36125,115098,0,151223
142617600700000,SE 234,Residential,27708,0,27708,161411,0,189119
142617600800000,SE 234,Residential,28253,0,28253,118901,0,147154
142617600900000,SE 234,Residential,26203,0,26203,91599,0,117802
142617601000000,SE 234,Residential,26334,0,26334,136623,0,162957
142617601100000,SE 234,Residential,25582,0,25582,99224,0,124806
142617601200000,SE 234,Residential,27086,0,27086,107692,0,134778
142617601300000,CITY PROPERTY,Exempt,0,0,0,0,0,0
142617601400000,SE 234,Residential,21120,0,21120,132130,0,153250
142617601500000,SE 234,Residential,21120,0,21120,136174,0,157294
142617601600000,SE 234,Residential,21018,0,21018,100176,0,121194
142617601700000,SE 234,Residential,23760,0,23760,90042,0,113802
142617601800000,SE 234,Residential,23868,0,23868,94734,0,118602
142617601900000,SE 234,Residential,27664,0,27664,111653,0,139317
142617602000000,SE 234,Residential,25200,0,25200,87040,0,112240
142617602100000,SE 234,Residential,25410,0,25410,121826,0,147236
142617602200000,SE 234,Residential,39816,0,39816,116644,0,156460
142617602300000,SE 234,Residential,33566,0,33566,68401,0,101967
142617602400000,SE 234,Residential,36655,0,36655,156050,0,192705
142617602500000,SE 234,Residential,31752,0,31752,142906,0,174658
142617602600000,SE 234,Residential,35046,0,35046,143274,0,178320
142617603100000,SE 234,Residential,29073,0,29073,112212,0,141285
142617603200000,SE 234,Residential,29400,0,29400,115672,0,145072
142617603400000,SCHOOL,Exempt,0,0,0,0,0,0
142617603500000,SE 234,Residential,28277,0,28277,169733,0,198010
142617603600000,SE 234,Residential,27292,0,27292,0,0,27292
142617603700000,SE 234,Residential,28546,0,28546,0,0,28546
142617603800000,SE 234,Residential,24267,0,24267,0,0,24267
142617603900000,SE 234,Residential,24220,0,24220,136023,0,160243
142617604000000,SE 234,Residential,22213,0,22213,127250,0,149463
142617700100000,SE 234,Residential,28904,0,28904,93723,0,122627
142617700200000,SE 234,Residential,26520,0,26520,113848,0,140368
142617700300000,SE 234,Residential,28771,0,28771,80816,0,109587
142617700400000,SE 234,Residential,29772,0,29772,114811,0,144583
142617700500000,SE 234,Residential,29640,0,29640,92260,0,121900
142617700600000,SE 234,Residential,31573,0,31573,79462,0,111035
142617700700000,SE 234,Residential,29440,0,29440,164402,0,193842
142617700900000,SE 234,Residential,25560,0,25560,120309,0,145869
142617701000000,SE 234,Residential,25200,0,25200,111011,0,136211
142617701100000,SE 234,Residential,22187,0,22187,129718,0,151905
142617701200000,SE 234,Residential,23120,0,23120,71601,0,94721
142617701400000,SE 234,Residential,30512,0,30512,84204,0,114716
142617701500000,SE 234,Residential,26520,0,26520,68663,0,95183
142617800100000,SE 234,Residential,27257,0,27257,118116,0,145373
142617800200000,SE 234,Residential,24947,0,24947,75769,0,100716
142617800300000,SE 234,Residential,24888,0,24888,120361,0,145249
142617800400000,SE 234,Residential,24936,0,24936,87157,0,112093
142617800500000,SE 234,Residential,23667,0,23667,77319,0,100986
142617800600000,SE 234,Residential,23586,0,23586,70692,0,94278
142617800700000,SE 234,Residential,23959,0,23959,88271,0,112230
142617800800000,SE 234,Residential,24591,0,24591,87352,0,111943
142617800900000,SE 234,Residential,24616,0,24616,76669,0,101285
142617801000000,SE 234,Residential,25200,0,25200,87074,0,112274
142617801100000,SE 234,Residential,24422,0,24422,104082,0,128504
142617801200000,SE 234,Residential,25459,0,25459,73131,0,98590
142617801300000,SE 234,Residential,25506,0,25506,94291,0,119797
142617801400000,SE 234,Residential,26880,0,26880,122174,0,149054
142620100100000,RESTAURANT,Commercial,0,272160,272160,0,157275,429435
142620100200000,SE 235,Residential,17500,0,17500,75113,0,92613
142620100300000,SE 235,Residential,17500,0,17500,67191,0,84691
142620100400000,SE 235,Residential,17500,0,17500,105009,0,122509
142620100500000,SE 235,Residential,31248,0,31248,74763,0,106011
142620100600000,SE 235,Residential,28215,0,28215,85951,0,114166
142620100700000,SE 235,Residential,28842,0,28842,77778,0,106620
142620100800000,SE 235,Residential,28842,0,28842,139533,0,168375
142620100900000,SE 235,Residential,32291,0,32291,86987,0,119278
142620101000000,SE 235,Residential,32291,0,32291,104766,0,137057
142620101100000,SE 235,Residential,26010,0,26010,88539,0,114549
142620101200000,SE 235,Residential,31622,0,31622,70872,0,102494
142620101300000,SE 235,Residential,33672,0,33672,83681,0,117353
142620101400000,SE 235,Residential,49840,0,49840,89074,0,138914
142620101500000,SE 235,Residential,30520,0,30520,75536,0,106056
142620101600000,SE 235,Residential,30515,0,30515,72018,0,102533
142620101700000,SE 235,Residential,30510,0,30510,65943,0,96453
142620101800000,SE 235,Residential,30505,0,30505,54794,0,85299
142620101900000,SE 235,Residential,30361,0,30361,85501,0,115862
142620102000000,SE 235,Residential,25832,0,25832,20207,0,46039
142620102100000,SE 235,Residential,25832,0,25832,81378,0,107210
142620102200000,SE 235,Residential,22766,0,22766,146794,0,169560
142620102300000,SE 235,Residential,29394,0,29394,113879,0,143273
142620102400000,SE 235,Residential,28340,0,28340,119413,0,147753
142620200100000,SE 235,Residential,15030,0,15030,56070,0,71100
142620200200000,SE 235,Residential,16957,0,16957,72696,0,89653
142620200300000,SE 235,Residential,21168,0,21168,67545,0,88713
142620200400000,SE 235,Residential,21168,0,21168,96972,0,118140
142620200500000,SE 235,Residential,24333,0,24333,90754,0,115087
142620200600000,SE 235,Residential,25000,0,25000,84816,0,109816
142620200700000,SE 235,Residential,25000,0,25000,118780,0,143780
142620200800000,SE 235,Residential,25000,0,25000,96077,0,121077
142620200900000,SE 235,Residential,25000,0,25000,113420,0,138420
142620201000000,SE 235,Residential,25000,0,25000,66787,0,91787
142620201100000,SE 235,Residential,25000,0,25000,100485,0,125485
142620201200000,SE 235,Residential,25000,0,25000,103154,0,128154
142620201300000,SE 235,Residential,25000,0,25000,83618,0,108618
142620201400000,SE 235,Residential,25000,0,25000,69148,0,94148
142620201500000,SE 235,Residential,25000,0,25000,61295,0,86295
142620201600000,SE 235,Residential,25000,0,25000,83156,0,108156
142620201700000,SE 235,Residential,25667,0,25667,88064,0,113731
142620201800000,SE 235,Residential,945,0,945,0,0,945
142620201900000,SE 235,Residential,8650,0,8650,0,0,8650
142620202000000,SE 235,Residential,54700,0,54700,232351,0,287051
142620202100000,SE 235,Residential,31957,0,31957,99664,0,131621
142620202200000,SE 235,Residential,28350,0,28350,97074,0,125424
142620202300000,SE 235,Residential,28125,0,28125,76383,0,104508
142620202400000,SE 235,Residential,28125,0,28125,89945,0,118070
142620202500000,SE 235,Residential,24750,0,24750,73156,0,97906
142620202600000,SE 235,Residential,27787,0,27787,87795,0,115582
142620202700000,SE 235,Residential,24750,0,24750,94810,0,119560
142620202800000,SE 235,Residential,24750,0,24750,93797,0,118547
142620202900000,SE 235,Residential,25200,0,25200,89115,0,114315
142620300100000,SE 235,Residential,18371,0,18371,74652,0,93023
142620300200000,SE 235,Residential,17108,0,17108,86080,0,103188
142620300300000,SE 235,Residential,18835,0,18835,63077,0,81912
142620300400000,SE 235,Residential,19058,0,19058,112733,0,131791
142620300500000,SE 235,Residential,27830,0,27830,81945,0,109775
142620300600000,SE 235,Residential,27600,0,27600,92399,0,119999
142620300700000,SE 235,Residential,27600,0,27600,73667,0,101267
142620300800000,SE 235,Residential,27600,0,27600,84488,0,112088
142620300900000,SE 235,Residential,27600,0,27600,80015,0,107615
142620301000000,SE 235,Residential,27600,0,27600,90697,0,118297
142620301100000,SE 235,Residential,27600,0,27600,89035,0,116635
142620301200000,SE 235,Residential,27600,0,27600,107954,0,135554
142620301300000,SE 235,Residential,27600,0,27600,96568,0,124168
142620301400000,SE 235,Residential,27600,0,27600,113277,0,140877
142620301500000,SE 235,Residential,27231,0,27231,98258,0,125489
142620301600000,SE 235,Residential,26400,0,26400,80888,0,107288
142620301700000,SE 235,Residential,1082,0,1082,0,0,1082
142620301800000,SE 235,Residential,36518,0,36518,199874,0,236392
142620301900000,SE 235,Residential,32456,0,32456,92405,0,124861
142620302000000,SE 235,Residential,22725,0,22725,78430,0,101155
142620302100000,SE 235,Residential,25250,0,25250,97017,0,122267
142620302200000,SE 235,Residential,25250,0,25250,79448,0,104698
142620302300000,SE 235,Residential,25250,0,25250,91503,0,116753
142620302400000,SE 235,Residential,25250,0,25250,88250,0,113500
142620302500000,SE 235,Residential,25250,0,25250,75348,0,100598
142620302600000,SE 235,Residential,25250,0,25250,91391,0,116641
142620302700000,SE 235,Residential,25250,0,25250,90587,0,115837
142620302800000,SE 235,Residential,25250,0,25250,118920,0,144170
142620302900000,SE 235,Residential,25250,0,25250,117007,0,142257
142620303000000,SE 235,Residential,25250,0,25250,116588,0,141838
142620303100000,SE 235,Residential,37902,0,37902,98523,0,136425
142620303200000,SE 235,Residential,21500,0,21500,85022,0,106522
142620400100000,SE 235,Residential,19058,0,19058,59899,0,78957
142620400200000,LG DISCOUNT/RETAIL,Commercial,0,342900,342900,0,362613,705513
142620400300000,APARTMENT,Commercial,0,15390,15390,0,79610,95000
142620400400000,APARTMENT,Commercial,0,16913,16913,0,105294,122207
142620400500000,APARTMENT,Commercial,0,16103,16103,0,94063,110166
142620400600000,APARTMENT,Commercial,0,17337,17337,0,77663,95000
142620400700000,SE 235,Residential,27210,0,27210,104973,0,132183
142620400800000,SE 235,Residential,27000,0,27000,80295,0,107295
142620400900000,SE 235,Residential,27000,0,27000,82051,0,109051
142620401000000,SE 235,Residential,27000,0,27000,90294,0,117294
142620401100000,SE 235,Residential,26790,0,26790,91050,0,117840
142620500100000,SE 235,Residential,26790,0,26790,96667,0,123457
142620500200000,SE 235,Residential,21488,0,21488,78041,0,99529
142620500300000,SE 235,Residential,23500,0,23500,69230,0,92730
142620500400000,SE 235,Residential,23970,0,23970,84333,0,108303
142620500500000,SE 235,Residential,23500,0,23500,96950,0,120450
142620500600000,SE 235,Residential,24957,0,24957,102831,0,127788
142620500700000,SE 235,Residential,38100,0,38100,144992,0,183092
142620500800000,SE 235,Residential,42049,0,42049,164405,0,206454
142620500900000,SE 235,Residential,4240,0,4240,0,0,4240
142620501000000,SE 235,Residential,27723,0,27723,123922,0,151645
142620501100000,SE 235,Residential,27000,0,27000,90383,0,117383
142620501200000,SE 235,Residential,27000,0,27000,72486,0,99486
142620501300000,SE 235,Residential,27000,0,27000,64360,0,91360
142620501400000,SE 235,Residential,27000,0,27000,87632,0,114632
142622600100000,NBHD SHOPPING CENTER,Commercial,0,294300,294300,0,457205,751505
142622600200000,SE 235,Residential,25486,0,25486,80981,0,106467
142622600300000,SE 235,Residential,15397,0,15397,58297,0,73694
142622600400000,SE 235,Residential,14994,0,14994,76838,0,91832
142622600500000,SE 235,Residential,22500,0,22500,55658,0,78158
142622600600000,SE 235,Residential,22500,0,22500,77473,0,99973
142622600700000,SE 235,Residential,21600,0,21600,51869,0,73469
142622600800000,SE 235,Residential,22500,0,22500,73537,0,96037
142622600900000,SE 235,Residential,27880,0,27880,93523,0,121403
142622601000000,SE 235,Residential,26250,0,26250,82315,0,108565
142622601100000,SE 235,Exempt,0,25626,25626,0,73635,99261
142622601200000,SE 235,Residential,28700,0,28700,77822,0,106522
142622700100000,SE 235,Residential,16625,0,16625,81807,0,98432
142622700200000,SE 235,Residential,19332,0,19332,64765,0,84097
142622700300000,SE 235,Residential,16461,0,16461,56588,0,73049
142622700400000,SE 235,Residential,22968,0,22968,65904,0,88872
142622700500000,SE 235,Residential,24404,0,24404,75001,0,99405
142622700600000,SE 235,Residential,19140,0,19140,76816,0,95956
142622700700000,SE 235,Residential,24283,0,24283,82110,0,106393
142622700800000,SE 235,Residential,20380,0,20380,78156,0,98536
142622700900000,SE 235,Residential,19600,0,19600,86874,0,106474
142622701000000,SE 235,Residential,16632,0,16632,56726,0,73358
142622701100000,SE 235,Residential,30600,0,30600,93689,0,124289
142622701200000,SE 235,Residential,25500,0,25500,73246,0,98746
142622701300000,SE 235,Residential,25500,0,25500,76450,0,101950
142622800100000,SE 235,Residential,21538,0,21538,54710,0,76248
142622800200000,SE 235,Residential,22500,0,22500,71231,0,93731
142622800300000,SE 235,Residential,21805,0,21805,67193,0,88998
142622800400000,SE 235,Residential,21805,0,21805,69246,0,91051
142622800500000,SE 235,Residential,21805,0,21805,73799,0,95604
142622800600000,SE 235,Residential,21805,0,21805,73387,0,95192
142622800700000,SE 235,Residential,21805,0,21805,62946,0,84751
142622800800000,SE 235,Residential,22250,0,22250,60264,0,82514
142622800900000,SE 235,Residential,22250,0,22250,95753,0,118003
142622801000000,SE 235,Residential,28200,0,28200,106633,0,134833
142622801100000,SE 235,Residential,28200,0,28200,71490,0,99690
142622801200000,SE 235,Residential,27829,0,27829,82171,0,110000
142622801300000,SE 235,Residential,25850,0,25850,83355,0,109205
142622900100000,SE 235,Residential,21750,0,21750,67961,0,89711
142622900200000,SE 235,Residential,21750,0,21750,69892,0,91642
142622900300000,SE 235,Residential,21750,0,21750,71318,0,93068
142622900400000,SE 235,Residential,23100,0,23100,83426,0,106526
142622900500000,SE 235,Residential,22050,0,22050,73880,0,95930
142622900600000,SE 235,Residential,22050,0,22050,72370,0,94420
142622900700000,SE 235,Residential,22050,0,22050,78507,0,100557
142622900800000,SE 235,Residential,22500,0,22500,83303,0,105803
142622900900000,SE 235,Residential,22250,0,22250,63367,0,85617
142622901000000,SE 235,Residential,22250,0,22250,70891,0,93141
142622901100000,SE 235,Residential,22500,0,22500,53358,0,75858
142622901200000,SE 235,Residential,22050,0,22050,60594,0,82644
142622901300000,SE 235,Residential,22050,0,22050,66530,0,88580
142622901400000,SE 235,Residential,22050,0,22050,78967,0,101017
142623000100000,SE 235,Residential,29362,0,29362,70340,0,99702
142623000200000,SE 235,Residential,510,0,510,0,0,510
142623000300000,SE 235,Residential,28323,0,28323,83413,0,111736
142623000400000,SE 235,Residential,28547,0,28547,112526,0,141073
142623000500000,SE 235,Residential,29003,0,29003,83117,0,112120
142623000600000,SE 235,Residential,37625,0,37625,85443,0,123068
142623000700000,SE 235,Residential,27567,0,27567,109678,0,137245
142623000800000,SE 235,Residential,37625,0,37625,90087,0,127712
142623000900000,SE 235,Residential,40075,0,40075,106025,0,146100
142623001000000,SE 235,Residential,28175,0,28175,93260,0,121435
142623001100000,SE 235,Residential,21250,0,21250,95221,0,116471
142623001200000,SE 235,Residential,23970,0,23970,58588,0,82558
142623001300000,SE 235,Residential,24480,0,24480,75101,0,99581
142623001400000,SE 235,Residential,24480,0,24480,67623,0,92103
142623001500000,SE 235,Residential,26010,0,26010,68750,0,94760
142623001600000,CITY PROPERTY,Exempt,0,0,0,0,0,0
142623001700000,COUNTY PROPERTY,Exempt,0,0,0,0,0,0
142623001800000,CENTRALLY ASSESSED,Other,0,0,0,0,0,0
142623001900000,CENTRALLY ASSESSED,Other,0,0,0,0,0,0
142623002000000,SE 235,Residential,39800,0,39800,155831,0,195631
142623002100000,SE 235,Residential,39800,0,39800,107825,0,147625
142625100100000,CITY PROPERTY,Exempt,0,0,0,0,0,0
142627600100000,SE 236,Residential,32640,0,32640,91468,0,124108
142627600200000,SE 236,Residential,36397,0,36397,149481,0,185878
142627600300000,SE 236,Residential,35462,0,35462,149523,0,184985
142627600400000,SE 236,Residential,32810,0,32810,115121,0,147931
142627600500000,SE 236,Residential,29591,0,29591,122820,0,152411
142627600600000,SE 236,Residential,23436,0,23436,109524,0,132960
142627600700000,SE 236,Residential,25048,0,25048,86464,0,111512
142627600800000,SE 236,Residential,32736,0,32736,114859,0,147595
142627600900000,SE 236,Residential,27880,0,27880,95944,0,123824
142627601000000,SE 236,Residential,26400,0,26400,107840,0,134240
142627601100000,SE 236,Residential,25480,0,25480,123787,0,149267
142627601200000,SE 236,Residential,26320,0,26320,108242,0,134562
142627601300000,SE 236,Residential,30132,0,30132,150062,0,180194
142627601400000,SE 236,Residential,26600,0,26600,93156,0,119756
142627601500000,SE 236,Residential,24960,0,24960,103691,0,128651
142627601600000,SE 236,Residential,24444,0,24444,105743,0,130187
142627601700000,SE 236,Residential,25931,0,25931,92644,0,118575
142627601800000,SE 236,Residential,25996,0,25996,96049,0,122045
142627601900000,SE 236,Residential,24341,0,24341,97015,0,121356
142627602000000,SE 236,Residential,25220,0,25220,89443,0,114663
142627602100000,SE 236,Residential,25220,0,25220,84147,0,109367
142627602200000,SE 236,Residential,25996,0,25996,85341,0,111337
142627602300000,SE 236,Residential,24960,0,24960,90864,0,115824
142627700100000,SE 236,Residential,36980,0,36980,173551,0,210531
142627700200000,SE 236,Residential,34608,0,34608,133123,0,167731
142627700300000,SE 236,Residential,31620,0,31620,122797,0,154417
142627700400000,SE 236,Residential,23797,0,23797,97337,0,121134
142627700500000,SE 236,Residential,23074,0,23074,104414,0,127488
142627700600000,SE 236,Residential,22811,0,22811,107162,0,129973
142627700700000,SE 236,Residential,22196,0,22196,85860,0,108056
142627700800000,SE 236,Residential,24800,0,24800,113299,0,138099
142627700900000,SE 236,Residential,27560,0,27560,108910,0,136470
142627701000000,SE 236,Residential,31040,0,31040,101341,0,132381
142627701100000,SE 236,Residential,28000,0,28000,104670,0,132670
142627701200000,SE 236,Residential,27936,0,27936,97248,0,125184
142627701300000,SE 236,Residential,26240,0,26240,91972,0,118212
142627701400000,SE 236,Residential,28200,0,28200,121555,0,149755
142627701500000,SE 236,Residential,27900,0,27900,94370,0,122270
142627701600000,SE 236,Residential,28800,0,28800,91405,0,120205
142627701700000,SE 236,Residential,30000,0,30000,116158,0,146158
142627701800000,SE 236,Residential,31724,0,31724,98190,0,129914
142627701900000,SE 236,Residential,30430,0,30430,127955,0,158385
142627702000000,SE 236,Residential,31848,0,31848,121330,0,153178
142627702100000,SE 236,Residential,30611,0,30611,119177,0,149788
142627800100000,SE 236,Residential,23184,0,23184,102737,0,125921
142627800200000,SE 236,Residential,27720,0,27720,102209,0,129929
142627800300000,SE 236,Residential,25721,0,25721,97250,0,122971
142627800400000,SE 236,Residential,27720,0,27720,98329,0,126049
142627800500000,SE 236,Residential,26069,0,26069,101190,0,127259
142627800600000,SE 236,Residential,24552,0,24552,117338,0,141890
142627800700000,SE 236,Residential,26320,0,26320,113849,0,140169
142627800800000,SE 236,Residential,30031,0,30031,111978,0,142009
142627800900000,SE 236,Residential,31416,0,31416,98605,0,130021
142627801000000,SE 236,Residential,48125,0,48125,117423,0,165548
142627801100000,SE 236,Residential,30600,0,30600,139418,0,170018
142627801200000,SE 236,Residential,30264,0,30264,105700,0,135964
142627801300000,SE 237,Residential,26280,0,26280,100630,0,126910
142627801400000,SE 236,Residential,28812,0,28812,104431,0,133243
142627801500000,SE 236,Residential,29564,0,29564,107966,0,137530
142627801600000,SE 236,Residential,31952,0,31952,125620,0,157572
142627801700000,SE 236,Residential,36309,0,36309,147072,0,183381
142627801800000,SE 236,Residential,30520,0,30520,104390,0,134910
142627900100000,SE 236,Residential,26320,0,26320,86676,0,112996
142627900200000,SE 236,Residential,26400,0,26400,104770,0,131170
142627900300000,SE 236,Residential,26000,0,26000,105385,0,131385
142627900400000,SE 236,Residential,26067,0,26067,96854,0,122921
142627900500000,SE 236,Residential,26260,0,26260,100890,0,127150
142627900600000,SE 236,Residential,26520,0,26520,107013,0,133533
142627900700000,SE 236,Residential,27733,0,27733,101266,0,128999
142627900800000,SE 236,Residential,26901,0,26901,97119,0,124020
142627900900000,SE 236,Residential,28560,0,28560,83157,0,111717
142627901000000,SE 236,Residential,28280,0,28280,92774,0,121054
142627901100000,SE 236,Residential,27720,0,27720,116445,0,144165
142627901200000,SE 236,Residential,27160,0,27160,95143,0,122303
142627901300000,SE 236,Residential,28500,0,28500,98750,0,127250
142627901400000,SE 236,Residential,29269,0,29269,111427,0,140696
142627901500000,SE 236,Residential,27680,0,27680,115229,0,142909
142627901600000,SE 236,Residential,29779,0,29779,105856,0,135635
142627901700000,SE 236,Residential,34340,0,34340,115698,0,150038
142627901800000,SE 236,Residential,34680,0,34680,144104,0,178784
142627901900000,SE 236,Residential,33503,0,33503,116128,0,149631
142627902000000,SE 236,Residential,29508,0,29508,107450,0,136958
142627902100000,SE 236,Residential,30940,0,30940,97661,0,128601
142627902200000,SE 236,Residential,31061,0,31061,114385,0,145446
142627902300000,SE 236,Residential,29376,0,29376,122670,0,152046
142627902400000,SE 236,Residential,29333,0,29333,93625,0,122958
142627902500000,SE 236,Residential,22072,0,22072,93213,0,115285
142627902600000,SE 236,Residential,24440,0,24440,84620,0,109060
142627902700000,SE 236,Residential,24440,0,24440,78033,0,102473
142628000100000,SE 236,Residential,22344,0,22344,109745,0,132089
142628000200000,SE 236,Residential,24375,0,24375,133062,0,157437
142628000300000,SE 236,Residential,23280,0,23280,87590,0,110870
142628000400000,SE 236,Residential,23381,0,23381,59216,0,82597
142628000500000,SE 236,Residential,23280,0,23280,92554,0,115834
142628000600000,SE 236,Residential,23280,0,23280,127099,0,150379
142628000700000,SE 236,Residential,24942,0,24942,117229,0,142171
142628000800000,SE 236,Residential,24450,0,24450,73096,0,97546
142628000900000,SE 236,Residential,24426,0,24426,106383,0,130809
142628001000000,SE 236,Residential,24426,0,24426,97523,0,121949
142628001100000,SE 236,Residential,23197,0,23197,81059,0,104256
142628001200000,SE 236,Residential,24396,0,24396,90267,0,114663
142628001300000,SE 236,Residential,7975,0,7975,0,0,7975
142628100100000,SE 236,Residential,27984,0,27984,108985,0,136969
142628100200000,SE 236,Residential,25693,0,25693,99196,0,124889
142628100300000,SE 236,Residential,25668,0,25668,104668,0,130336
142628100400000,SE 236,Residential,23432,0,23432,92462,0,115894
142628100500000,SE 236,Residential,23200,0,23200,86830,0,110030
142628100600000,SE 236,Residential,23200,0,23200,95514,0,118714
142628100700000,SE 236,Residential,23200,0,23200,85504,0,108704
142628100800000,SE 236,Residential,24267,0,24267,113183,0,137450
142628100900000,SE 236,Residential,27160,0,27160,100531,0,127691
142628101000000,SE 236,Residential,25802,0,25802,92034,0,117836
142628101100000,SE 236,Residential,26384,0,26384,101189,0,127573
142628101200000,SE 236,Residential,24573,0,24573,97714,0,122287
142628200100000,SE 236,Residential,29100,0,29100,108423,0,137523
142628200200000,SE 236,Residential,30184,0,30184,102409,0,132593
142628200300000,SE 236,Residential,30639,0,30639,94777,0,125416
142628200400000,SE 236,Residential,30042,0,30042,110163,0,140205
142628200500000,SE 236,Residential,30135,0,30135,99651,0,129786
142628200600000,SE 236,Residential,30380,0,30380,94055,0,124435
142628200700000,SE 236,Residential,31518,0,31518,108068,0,139586
142628200800000,SE 236,Residential,31800,0,31800,119162,0,150962
142628200900000,SE 236,Residential,25440,0,25440,100941,0,126381
142628201000000,SE 236,Residential,24720,0,24720,113677,0,138397
142628201100000,SE 236,Residential,23760,0,23760,94759,0,118519
142628201200000,SE 236,Residential,23040,0,23040,89117,0,112157
142628201300000,SE 236,Residential,23437,0,23437,88728,0,112165
142628201400000,SE 236,Residential,23040,0,23040,101022,0,124062
142630100100000,SE 240,Residential,27353,0,27353,104993,0,132346
142630100200000,SE 240,Residential,28560,0,28560,110380,0,138940
142630100300000,SE 240,Residential,28560,0,28560,90143,0,118703
142630100400000,SE 240,Residential,28560,0,28560,88801,0,117361
142630100500000,SE 240,Residential,35476,0,35476,111769,0,147245
142630100600000,SE 240,Residential,48307,0,48307,158991,0,207298
142630200100000,SE 240,Residential,34079,0,34079,92529,0,126608
142630200200000,SE 240,Residential,18857,0,18857,0,0,18857
142630200300000,SE 240,Residential,40950,0,40950,0,0,40950
142630200400000,SE 240,Residential,59325,0,59325,258724,0,318049
142630200500000,SE 240,Residential,22247,0,22247,3565,0,25812
142630200600000,SE 240,Residential,20994,0,20994,4925,0,25919
142630200700000,SE 240,Residential,20570,0,20570,4212,0,24782
142630200800000,SE 240,Residential,37696,0,37696,113432,0,151128
142630200900000,SE 240,Residential,46100,0,46100,0,0,46100
142630201000000,SE 240,Residential,40450,0,40450,136464,0,176914
142630201100000,SE 240,Residential,32544,0,32544,108514,0,141058
142630201200000,SE 240,Residential,42475,0,42475,0,0,42475
142630201300000,SE 240,Residential,42775,0,42775,156309,0,199084
142630201400000,SE 240,Residential,36288,0,36288,110877,0,147165
142630201500000,SE 240,Residential,35243,0,35243,76151,0,111394
142630201600000,SE 240,Residential,35640,0,35640,126865,0,162505
142630201700000,SE 240,Residential,34344,0,34344,101409,0,135753
142630201800000,SE 240,Residential,32724,0,32724,99221,0,131945
142630300100000,SE 240,Residential,43276,0,43276,144438,0,187714
142630300200000,SE 240,Residential,38311,0,38311,77892,0,116203
142630300300000,SE 240,Residential,38111,0,38111,158785,0,196896
142632600100000,SE 240,Residential,67800,0,67800,225080,0,292880
142632600200000,CITY PROPERTY,Exempt,0,0,0,0,0,0
142632600300000,SE 240,Residential,39190,0,39190,24518,0,63708
142632601100000,SE 240,Residential,44667,0,44667,115842,0,160509
142632602100000,SE 240,Residential,43701,0,43701,154405,0,198106
142635100100000,SE 242,Residential,10000,0,10000,0,0,10000
142635100200000,SE 242,Ag Dwelling,14865,0,14865,51353,2731,68949
142637600100000,SE 240,Residential,33650,0,33650,0,0,33650
142637600200000,SE 240,Residential,40000,0,40000,128861,0,168861
142637700100000,SE 240,Residential,41950,0,41950,62938,0,104888
142637700200000,SE 240,Residential,34650,0,34650,0,0,34650
142637700300000,CITY PROPERTY,Exempt,0,0,0,0,0,0
142637700400000,CITY PROPERTY,Exempt,0,0,0,0,0,0
142637700500000,SE 240,Residential,45275,0,45275,141563,0,186838
142637700600000,SE 240,Residential,35251,0,35251,83471,0,118722
142637700700000,SE 240,Residential,46525,0,46525,110233,0,156758
142637700800000,SE 240,Residential,42375,0,42375,116293,0,158668
142640100100000,APARTMENT,Commercial,0,54540,54540,0,475828,530368
142640100200000,APARTMENT,Commercial,0,49680,49680,0,490465,540145
142640100300000,APARTMENT,Residential,224640,0,224640,1173028,0,1397668
142640100400000,SE 239,Residential,37760,0,37760,88285,0,126045
142640100500000,SE 239,Residential,51650,0,51650,138933,0,190583
142640100600000,CHURCH,Exempt,0,30537,30537,0,60320,90857
142640100700000,SE 239,Residential,53475,0,53475,77740,0,131215
142640100800000,SE 239,Residential,50724,0,50724,0,0,50724
142640100900000,SE 239,Residential,50724,0,50724,0,0,50724
142640200100000,SE 239,Exempt,0,19852,19852,428,90160,110440
142640200200000,SE 239,Residential,18768,0,18768,100972,0,119740
142640200300000,SE 239,Residential,20424,0,20424,86130,0,106554
142640200400000,SE 239,Residential,20424,0,20424,87449,0,107873
142640200500000,SE 239,Residential,19731,0,19731,90589,0,110320
142640200600000,SE 239,Residential,19425,0,19425,0,0,19425
142640300100000,SE 239,Residential,53175,0,53175,160669,0,213844
142642600100000,SE 239,Residential,50025,0,50025,0,0,50025
142642600200000,SE 239,Residential,60800,0,60800,0,0,60800
142642600300000,SE 239,Residential,65360,0,65360,55864,0,121224
142642600400000,SE 239,Residential,32000,0,32000,63975,0,95975
142642600500000,SE 239,Residential,24400,0,24400,75953,0,100353
142642600600000,SE 239,Residential,14000,0,14000,0,0,14000
142642600700000,SE 239,Residential,53675,0,53675,0,0,53675
142642600800000,SE 239,Residential,14250,0,14250,0,0,14250
142642600900000,SE 240,Residential,56775,0,56775,0,0,56775
142642601000000,SE 240,Residential,48250,0,48250,248245,0,296495
142642601200000,SE 240,Residential,44444,0,44444,157158,0,201602
142642601300000,SE 240,Residential,44441,0,44441,202070,0,246511
142642601400000,SE 240,Residential,44660,0,44660,147044,0,191704
142642601500000,SE 240,Residential,40619,0,40619,173148,0,213767
142642601600000,SE 240,Residential,60729,0,60729,159271,0,220000
142642601700000,SE 240,Residential,53100,0,53100,168892,0,221992
142642601800000,SE 240,Residential,49717,0,49717,137183,0,186900
142642601900000,SE 240,Residential,50225,0,50225,139775,0,190000
142642602000000,SE 240,Residential,44607,0,44607,149928,0,194535
142642700100000,SE 239,Residential,50858,0,50858,135542,0,186400
142642700200000,SE 239,Residential,18958,0,18958,0,0,18958
142645100100000,SE 239,Residential,18000,0,18000,0,0,18000
142645100200000,SE 239,Residential,50000,0,50000,78510,0,128510
142645100300000,SE 240,Residential,55650,0,55650,139603,0,195253
142645100400000,SE 240,Residential,45900,0,45900,117867,0,163767
142645100500000,SE 240,Residential,47325,0,47325,56694,0,104019
142645100600000,SE 240,Residential,52075,0,52075,0,0,52075
142645100700000,SE 240,Residential,52225,0,52225,0,0,52225
142645100800000,SE 240,Residential,36400,0,36400,45254,0,81654
142645100900000,SE 239,Residential,55140,0,55140,240,0,55380
142645101000000,SE 239,Residential,28028,0,28028,47684,0,75712
142645101100000,SE 239,Residential,26565,0,26565,64473,0,91038
142647600100000,SE 239,Residential,66125,0,66125,0,0,66125
142647600200000,SE 239,Residential,31484,0,31484,80775,0,112259
142647600300000,SE 239,Residential,36452,0,36452,43941,0,80393
142647600400000,SE 239,Residential,72275,0,72275,179935,0,252210
142647600500000,SE 239,Residential,68000,0,68000,110431,0,178431
142647600600000,SE 239,Residential,42375,0,42375,34854,0,77229
142647600700000,SE 239,Residential,53520,0,53520,0,0,53520
142647600800000,COUNTY PROPERTY,Exempt,0,0,0,0,0,0
142647600900000,SE 239,Residential,4979,0,4979,0,0,4979
142710100100000,SE 235,Residential,17100,0,17100,47111,0,64211
142710100200000,SE 235,Residential,19237,0,19237,57221,0,76458
142710100300000,SE 235,Residential,23760,0,23760,85443,0,109203
142710100400000,SE 235,Residential,23760,0,23760,68151,0,91911
142710100500000,SE 235,Residential,24717,0,24717,59810,0,84527
142710100600000,SE 235,Residential,20057,0,20057,52389,0,72446
142710100700000,SE 235,Residential,47520,0,47520,116856,0,164376
142710100800000,SE 235,Residential,71280,0,71280,0,0,71280
142710100900000,SE 235,Residential,26928,0,26928,87735,0,114663
142710101000000,SE 235,Residential,25344,0,25344,107474,0,132818
142710101100000,SE 235,Residential,27720,0,27720,56738,0,84458
142710101200000,SE 235,Residential,23760,0,23760,86046,0,109806
142710101300000,SE 235,Residential,23760,0,23760,103026,0,126786
142710101600000,SE 235,Residential,57024,0,57024,89571,0,146595
142710200100000,SE 235,Residential,24057,0,24057,80216,0,104273
142710200200000,SE 235,Residential,14138,0,14138,77158,0,91296
142710200300000,SE 235,Residential,13253,0,13253,69138,0,82391
142710200400000,SE 235,Residential,12672,0,12672,88178,0,100850
142710200500000,SE 235,Residential,20000,0,20000,80843,0,100843
142710200600000,SE 235,Residential,20000,0,20000,81734,0,101734
142710200700000,SE 235,Residential,20000,0,20000,119727,0,139727
142710200800000,SE 235,Residential,20000,0,20000,101006,0,121006
142710200900000,SE 235,Residential,20000,0,20000,76171,0,96171
142710201000000,SE 235,Residential,20000,0,20000,82831,0,102831
142710201100000,SE 235,Residential,20000,0,20000,79348,0,99348
142710201200000,SE 235,Residential,20000,0,20000,88153,0,108153
142710201300000,SE 235,Residential,17573,0,17573,76997,0,94570
142710201400000,SE 235,Residential,15200,0,15200,84417,0,99617
142710201500000,SE 235,Residential,20480,0,20480,69398,0,89878
142710201600000,SE 235,Residential,25344,0,25344,50590,0,75934
142710201700000,SE 235,Residential,17820,0,17820,78356,0,96176
142710201800000,SE 235,Residential,23760,0,23760,114929,0,138689
142710201900000,SE 235,Residential,23760,0,23760,77141,0,100901
142710202000000,SE 235,Residential,23760,0,23760,92497,0,116257
142710202100000,SE 235,Residential,17820,0,17820,58070,0,75890
142710300100000,SE 235,Residential,18899,0,18899,95684,0,114583
142710300200000,SE 235,Residential,19353,0,19353,99752,0,119105
142710300300000,SE 235,Residential,25585,0,25585,111686,0,137271
142710300400000,SE 235,Residential,18900,0,18900,61960,0,80860
142710300500000,SE 235,Residential,10500,0,10500,53050,0,63550
142710300600000,SE 235,Residential,10209,0,10209,49791,0,60000
142710300700000,SE 235,Residential,17262,0,17262,0,0,17262
142710300800000,SMALL RETAIL,Commercial,0,32113,32113,0,38732,70845
142710300900000,SMALL RETAIL,Commercial,0,7920,7920,0,24247,32167
142710301000000,SE 235,Residential,18090,0,18090,36211,0,54301
142710301100000,SE 235,Residential,24120,0,24120,30352,0,54472
142710301200000,SE 235,Residential,24000,0,24000,50935,0,74935
142710301300000,SE 235,Residential,27000,0,27000,43799,0,70799
142710301400000,SE 235,Residential,16800,0,16800,57644,0,74444
142710301500000,SE 235,Residential,23756,0,23756,96992,0,120748
142710301600000,SE 235,Residential,26343,0,26343,18444,0,44787
142710301700000,SE 235,Residential,26343,0,26343,47762,0,74105
142710301800000,SE 235,Residential,19472,0,19472,51464,0,70936
142710301900000,SE 235,Residential,19472,0,19472,62124,0,81596
142710302000000,SE 235,Residential,19472,0,19472,51751,0,71223
142710302100000,SE 235,Residential,19472,0,19472,33870,0,53342
142710302200000,SE 235,Residential,18720,0,18720,55885,0,74605
142710302300000,SE 235,Residential,19053,0,19053,59598,0,78651
142710302400000,SE 235,Residential,19472,0,19472,42669,0,62141
142710302500000,SE 235,Residential,19472,0,19472,70534,0,90006
142710302600000,SE 235,Residential,16640,0,16640,56268,0,72908
142710302700000,SE 235,Residential,20303,0,20303,90356,0,110659
142710302800000,SE 235,Residential,28143,0,28143,59578,0,87721
142710302900000,SE 235,Residential,28143,0,28143,53164,0,81307
142710303000000,SE 235,Residential,16000,0,16000,70971,0,86971
142710303100000,SE 235,Residential,16000,0,16000,61509,0,77509
142710303200000,SE 235,Residential,18079,0,18079,49534,0,67613
142710303300000,SE 235,Residential,25631,0,25631,100778,0,126409
142710303400000,SE 235,Residential,22533,0,22533,76853,0,99386
142710303500000,SE 235,Residential,20000,0,20000,66564,0,86564
142710303600000,SE 235,Residential,20000,0,20000,60902,0,80902
142710303700000,SE 235,Residential,20000,0,20000,64564,0,84564
142710303800000,SE 235,Residential,20000,0,20000,70481,0,90481
142710303900000,SE 235,Residential,20000,0,20000,54722,0,74722
142710304000000,SE 235,Residential,20000,0,20000,65488,0,85488
142710304100000,SE 235,Residential,20000,0,20000,71043,0,91043
142710304200000,SE 235,Residential,20000,0,20000,103123,0,123123
142710304300000,SE 235,Residential,20000,0,20000,84895,0,104895
142710304400000,SE 235,Residential,20000,0,20000,98785,0,118785
142710304500000,SE 235,Residential,20000,0,20000,101073,0,121073
142710304600000,SE 235,Residential,20000,0,20000,108017,0,128017
142710304700000,SE 235,Residential,20000,0,20000,109832,0,129832
142710304800000,SE 235,Residential,20000,0,20000,29814,0,49814
142710400100000,VACANT LAND,Commercial,0,30845,30845,0,0,30845
142710400200000,SE 235,Residential,15232,0,15232,0,0,15232
142710400300000,SE 235,Residential,15150,0,15150,72727,0,87877
142710400400000,SE 235,Residential,28280,0,28280,55473,0,83753
142710400500000,SE 235,Residential,20200,0,20200,59415,0,79615
142710400600000,SE 235,Residential,20200,0,20200,28094,0,48294
142710400700000,CEMETERY,Exempt,0,0,0,0,0,0
142710400800000,SE 235,Residential,20200,0,20200,51191,0,71391
142710400900000,SE 235,Residential,20200,0,20200,57056,0,77256
142710401000000,SE 235,Residential,20200,0,20200,19161,0,39361
142710401100000,SE 235,Residential,20200,0,20200,27977,0,48177
142710401200000,SE 235,Residential,25856,0,25856,55476,0,81332
142710401300000,SE 235,Residential,20142,0,20142,53705,0,73847
142710401400000,SE 235,Residential,20200,0,20200,61927,0,82127
142710401500000,SE 235,Residential,20200,0,20200,28254,0,48454
142710401600000,SE 235,Residential,24240,0,24240,63267,0,87507
142710401700000,SE 235,Residential,28280,0,28280,105110,0,133390
142710401800000,SE 235,Residential,20200,0,20200,31429,0,51629
142710401900000,SE 235,Residential,20000,0,20000,71343,0,91343
142710402000000,SE 235,Residential,19439,0,19439,67466,0,86905
142710500100000,SE 235,Residential,21216,0,21216,67355,0,88571
142710500200000,SE 235,Residential,22000,0,22000,87499,0,109499
142710500300000,SE 235,Residential,22000,0,22000,67074,0,89074
142710500400000,SE 235,Residential,23436,0,23436,91983,0,115419
142710500500000,SE 235,Residential,22932,0,22932,86606,0,109538
142710500600000,SE 235,Residential,22572,0,22572,68427,0,90999
142710500700000,SE 235,Residential,23760,0,23760,67928,0,91688
142710500800000,SE 235,Residential,24627,0,24627,64422,0,89049
142710500900000,SE 235,Residential,41151,0,41151,87290,0,128441
142710501000000,SE 235,Residential,31292,0,31292,116460,0,147752
142710501100000,SE 235,Residential,25168,0,25168,50789,0,75957
142710501200000,SE 235,Residential,22464,0,22464,72711,0,95175
142710501300000,SE 235,Residential,24295,0,24295,75625,0,99920
142710501400000,SE 235,Residential,24000,0,24000,69991,0,93991
142710501500000,SE 235,Residential,23200,0,23200,108680,0,131880
142712600100000,CEMETERY,Exempt,0,0,0,0,0,0
142712600200000,SE 249,Residential,17338,0,17338,94497,0,111835
142712600300000,SE 249,Residential,17566,0,17566,98415,0,115981
142712600400000,SE 249,Residential,17876,0,17876,98467,0,116343
142712600500000,SE 249,Residential,11794,0,11794,94982,0,106776
142712600600000,SE 249,Residential,16848,0,16848,89936,0,106784
142712600700000,SE 249,Residential,16848,0,16848,112977,0,129825
142712600800000,SE 249,Residential,16848,0,16848,91077,0,107925
142712600900000,SE 249,Residential,11794,0,11794,112810,0,124604
142712601000000,SE 249,Residential,16848,0,16848,99617,0,116465
142712601100000,SE 249,Residential,16848,0,16848,93759,0,110607
142712601200000,SE 249,Residential,16848,0,16848,87705,0,104553
142712601300000,SE 249,Residential,16848,0,16848,92027,0,108875
142712601400000,SE 249,Residential,17781,0,17781,96549,0,114330
142712601500000,SE 249,Residential,17632,0,17632,88384,0,106016
142712601600000,SE 249,Residential,17533,0,17533,95115,0,112648
142712601700000,SE 249,Residential,17544,0,17544,92609,0,110153
142712700100000,SE 249,Residential,17322,0,17322,108129,0,125451
142712700200000,SE 249,Residential,17123,0,17123,96422,0,113545
142712700300000,SE 249,Residential,17123,0,17123,96431,0,113554
142712700400000,SE 249,Residential,17123,0,17123,101182,0,118305
142712700500000,SE 249,Residential,17123,0,17123,91628,0,108751
142712700600000,SE 249,Residential,17123,0,17123,98952,0,116075
142712700700000,SE 249,Residential,17123,0,17123,109283,0,126406
142712700800000,SE 249,Residential,17123,0,17123,85824,0,102947
142712700900000,SE 249,Residential,17316,0,17316,111248,0,128564
142715100100000,CEMETERY,Exempt,0,0,0,0,0,0
142715200100000,SE 237,Residential,12000,0,12000,71978,0,83978
142715200200000,SE 237,Residential,10000,0,10000,66261,0,76261
142715200300000,SE 237,Residential,10000,0,10000,55295,0,65295
142715200400000,SE 237,Residential,10000,0,10000,42553,0,52553
142715200500000,SE 237,Residential,10000,0,10000,66451,0,76451
142715200600000,SE 237,Residential,10244,0,10244,31572,0,41816
142715200700000,SE 237,Residential,7627,0,7627,34561,0,42188
142715200800000,SE 237,Residential,7200,0,7200,21448,0,28648
142715200900000,SE 237,Residential,9627,0,9627,45115,0,54742
142715201000000,SE 237,Residential,10000,0,10000,78930,0,88930
142715201100000,SE 237,Residential,10000,0,10000,52790,0,62790
142715201200000,SE 237,Residential,10000,0,10000,99409,0,109409
142715201300000,SE 237,Residential,10000,0,10000,67574,0,77574
142715201400000,SE 237,Residential,10000,0,10000,48427,0,58427
142715201500000,SE 237,Residential,10000,0,10000,51527,0,61527
142715201600000,SE 237,Residential,10000,0,10000,31243,0,41243
142715300100000,SE 237,Residential,8000,0,8000,67271,0,75271
142715300200000,SE 237,Residential,8000,0,8000,41523,0,49523
142715300300000,SE 237,Residential,11200,0,11200,39269,0,50469
142715300400000,SE 237,Residential,8000,0,8000,61977,0,69977
142715300500000,SE 237,Residential,10000,0,10000,65972,0,75972
142715300600000,SE 237,Residential,10000,0,10000,80217,0,90217
142715300700000,SE 237,Residential,8000,0,8000,55466,0,63466
142715300800000,SE 237,Residential,10073,0,10073,29982,0,40055
142715300900000,SE 237,Residential,10386,0,10386,52749,0,63135
142715301000000,SE 237,Residential,8000,0,8000,35331,0,43331
142715301100000,SE 237,Residential,8000,0,8000,56162,0,64162
142715301200000,SE 237,Residential,8000,0,8000,31829,0,39829
142715301300000,SE 237,Residential,12000,0,12000,16496,0,28496
142715301400000,SE 237,Residential,12000,0,12000,36212,0,48212
142715400100000,SE 237,Residential,23200,0,23200,64874,0,88074
142715400200000,SE 237,Residential,5400,0,5400,19224,0,24624
142715400300000,OFFICE,Exempt,0,14580,14580,0,23553,38133
142715400400000,CHURCH,Exempt,0,34020,34020,0,88,34108
142715400500000,SE 237,Residential,19200,0,19200,0,0,19200
142715500100000,SE 237,Residential,8800,0,8800,82771,0,91571
142715500200000,SE 237,Residential,8800,0,8800,92482,0,101282
142715500300000,SE 237,Residential,8800,0,8800,76649,0,85449
142715500400000,SE 237,Residential,10000,0,10000,91149,0,101149
142715500500000,SE 237,Residential,10000,0,10000,92327,0,102327
142715500600000,SE 237,Residential,10000,0,10000,87234,0,97234
142715500700000,SE 237,Residential,12000,0,12000,89708,0,101708
142715500800000,CITY PROPERTY,Exempt,0,0,0,0,0,0
142715500900000,SE 237,Residential,10000,0,10000,0,0,10000
142715501000000,SE 237,Residential,10000,0,10000,55261,0,65261
142715501100000,SE 237,Residential,10000,0,10000,0,0,10000
142715501200000,CITY PROPERTY,Exempt,0,0,0,0,0,0
142715600100000,SE 237,Residential,10000,0,10000,58585,0,68585
142715600200000,SE 237,Residential,10000,0,10000,55722,0,65722
142715600300000,SE 237,Residential,12000,0,12000,59650,0,71650
142715600400000,SE 237,Residential,10000,0,10000,40992,0,50992
142715600500000,SE 237,Residential,10000,0,10000,52652,0,62652
142715600600000,SE 237,Residential,11200,0,11200,45427,0,56627
142715600700000,CITY PROPERTY,Exempt,0,0,0,0,0,0
142715700100000,CITY PROPERTY,Exempt,0,0,0,0,0,0
142717600100000,CITY PROPERTY,Exempt,0,0,0,0,0,0
142720100100000,CITY PROPERTY,Exempt,0,0,0,0,0,0
142720100200000,SE 237,Residential,9750,0,9750,0,0,9750
142720100300000,SE 237,Residential,9600,0,9600,52122,0,61722
142720100400000,SE 237,Residential,8119,0,8119,23881,0,32000
142720100500000,SE 237,Residential,10200,0,10200,40266,0,50466
142720100600000,SE 237,Residential,8000,0,8000,58748,0,66748
142720100700000,SE 237,Residential,8000,0,8000,52722,0,60722
142720100800000,CEMETERY,Exempt,0,0,0,0,0,0
142720200100000,SE 237,Residential,8000,0,8000,64174,0,72174
142720200200000,SE 237,Residential,8000,0,8000,26100,0,34100
142720200300000,SE 237,Residential,8000,0,8000,68668,0,76668
142720200400000,CITY PROPERTY,Exempt,0,0,0,0,0,0
142720200500000,SE 237,Residential,8000,0,8000,0,0,8000
142720200600000,SE 237,Residential,8000,0,8000,22723,0,30723
142720200700000,SE 237,Residential,7920,0,7920,34288,0,42208
142720200800000,SE 237,Residential,9504,0,9504,41270,0,50774
142720200900000,SE 237,Residential,7920,0,7920,41673,0,49593
142720201000000,SE 237,Residential,9052,0,9052,61689,0,70741
142720201100000,SE 237,Residential,7920,0,7920,15074,0,22994
142720201200000,SE 237,Residential,7719,0,7719,47512,0,55231
142720201300000,SE 237,Residential,7920,0,7920,67356,0,75276
142720201400000,SE 237,Residential,8000,0,8000,33922,0,41922
142720201500000,SE 237,Residential,8000,0,8000,43998,0,51998
142720201600000,SE 237,Residential,8000,0,8000,67684,0,75684
142720201700000,SE 237,Residential,8170,0,8170,30093,0,38263
142720201800000,SE 237,Residential,8550,0,8550,53243,0,61793
142720201900000,SE 237,Residential,7000,0,7000,38555,0,45555
142720202000000,SE 237,Residential,8000,0,8000,20109,0,28109
142720202100000,SE 237,Residential,8000,0,8000,49264,0,57264
142720202200000,CITY PROPERTY,Exempt,0,0,0,0,0,0
142720202300000,SE 237,Residential,11790,0,11790,52965,0,64755
142720300100000,SCHOOL,Exempt,0,47002,47002,0,42070,89072
142720300200000,AUTO REPAIR/SALES,Commercial,0,71913,71913,0,113315,185228
142720300202000,BILLBOARD(BLL),Commercial,0,0,0,0,17328,17328
142720300300000,FLAT PARKING,Commercial,0,95876,95876,0,23636,119512
142720300400000,FLAT PARKING,Commercial,0,14515,14515,0,3920,18435
142720300500000,FLAT PARKING,Commercial,0,5948,5948,0,0,5948
142720300600000,SMALL RETAIL,Commercial,0,26471,26471,0,96640,123111
142720300700000,SE 237,Residential,7600,0,7600,19583,0,27183
142720300800000,HOSPITAL,Exempt,0,7448,7448,0,0,7448
142720300900000,HOSPITAL,Exempt,0,13608,13608,0,0,13608
142720301000000,HOSPITAL,Exempt,0,5880,5880,0,0,5880
142720301100000,HOSPITAL,Exempt,0,5880,5880,0,0,5880
142720301200000,HOSPITAL,Exempt,0,6174,6174,0,0,6174
142720301300000,HOSPITAL,Exempt,0,5586,5586,0,0,5586
142720301400000,HOSPITAL,Exempt,0,2352,2352,0,0,2352
142720301500000,SE 237,Residential,13500,0,13500,101985,0,115485
142720301600000,SE 237,Residential,5200,0,5200,32173,0,37373
142720301700000,SE 237,Residential,5200,0,5200,37145,0,42345
142720301800000,SE 237,Residential,4950,0,4950,32238,0,37188
142720301900000,SE 237,Residential,6204,0,6204,25773,0,31977
142720302000000,SE 237,Residential,5800,0,5800,52382,0,58182
142720302100000,CITY PROPERTY,Exempt,0,0,0,0,0,0
142720302200000,CITY PROPERTY,Exempt,0,0,0,0,0,0
142720302300000,CITY PROPERTY,Exempt,0,0,0,0,0,0
142720302400000,SE 237,Residential,5840,0,5840,26182,0,32022
142720302500000,SE 237,Residential,8240,0,8240,136170,0,144410
142720302600000,SE 237,Residential,7743,0,7743,0,0,7743
142720302700000,SE 237,Residential,12000,0,12000,135116,0,147116
142720302800000,SE 237,Residential,12000,0,12000,26469,0,38469
142720302900000,SE 237,Residential,6000,0,6000,25734,0,31734
142720303000000,SE 237,Residential,6000,0,6000,38960,0,44960
142720303100000,SE 237,Residential,6000,0,6000,24916,0,30916
142720303200000,SE 237,Residential,6000,0,6000,34526,0,40526
142720303300000,SE 237,Residential,8400,0,8400,0,0,8400
142720303400000,SE 237,Residential,8680,0,8680,0,0,8680
142720303500000,RESTAURANT,Commercial,0,47002,47002,0,38116,85118
142720400100000,CENTRALLY ASSESSED,Other,0,0,0,0,0,0
142720400200000,SE 237,Residential,6000,0,6000,0,0,6000
142720400300000,SE 237,Residential,6000,0,6000,66568,0,72568
142720400400000,SE 237,Residential,6000,0,6000,32701,0,38701
142720400500000,SE 237,Residential,6000,0,6000,43534,0,49534
142720400600000,SE 237,Residential,8000,0,8000,46552,0,54552
142720400700000,DAY CARE CENTER,Commercial,0,8467,8467,0,37196,45663
142720400800000,SE 237,Residential,8000,0,8000,36506,0,44506
142720400900000,SE 237,Residential,8000,0,8000,30466,0,38466
142720401000000,SE 237,Residential,8000,0,8000,25394,0,33394
142720401100000,SE 237,Residential,8000,0,8000,50323,0,58323
142720401200000,SE 237,Residential,8000,0,8000,51057,0,59057
142720401300000,SE 237,Residential,9600,0,9600,63304,0,72904
142720401400000,SE 237,Residential,7650,0,7650,43649,0,51299
142720401500000,SE 237,Residential,2766,0,2766,0,0,2766
142720401600000,SE 237,Residential,12460,0,12460,66332,0,78792
142720401800000,SE 237,Residential,8000,0,8000,90633,0,98633
142720401900000,SE 237,Residential,8000,0,8000,0,0,8000
142720402000000,SE 237,Residential,7637,0,7637,75407,0,83044
142720402100000,SE 237,Residential,8000,0,8000,32870,0,40870
142720402200000,SE 237,Residential,8071,0,8071,47089,0,55160
142720402300000,SE 237,Residential,8000,0,8000,69093,0,77093
142720402400000,SE 237,Residential,8000,0,8000,36497,0,44497
142720402500000,SE 237,Residential,8000,0,8000,78225,0,86225
142720402600000,CONVERSION,Commercial,0,9072,9072,0,42387,51459
142720402700000,CITY PROPERTY,Exempt,0,0,0,0,0,0
142720500100000,SE 237,Residential,8208,0,8208,111599,0,119807
142720600100000,SE 237,Residential,8400,0,8400,119362,0,127762
142720600200000,SE 237,Residential,8246,0,8246,118548,0,126794
142720600300000,SE 237,Residential,6000,0,6000,61137,0,67137
142720600400000,SE 237,Residential,6000,0,6000,52059,0,58059
142720600500000,SE 237,Residential,8400,0,8400,42277,0,50677
142720600600000,SE 237,Residential,8400,0,8400,40603,0,49003
142720600700000,SE 237,Residential,8400,0,8400,108160,0,116560
142720600800000,SE 237,Residential,8100,0,8100,38022,0,46122
142720600900000,SE 237,Residential,8000,0,8000,79074,0,87074
142720601000000,SE 237,Residential,7000,0,7000,90824,0,97824
142720601100000,SE 237,Residential,6735,0,6735,43224,0,49959
142720601200000,SE 237,Residential,8400,0,8400,61409,0,69809
142720601300000,SE 237,Residential,8000,0,8000,44285,0,52285
142720601400000,SE 237,Residential,8177,0,8177,72029,0,80206
142720601500000,SE 237,Residential,3756,0,3756,29415,0,33171
142720601600000,SMALL RETAIL,Commercial,0,8624,8624,0,54015,62639
142720601700000,SE 237,Residential,5360,0,5360,18591,0,23951
142720601800000,SE 237,Residential,4200,0,4200,34122,0,38322
142720601900000,SE 237,Residential,5600,0,5600,46857,0,52457
142720602000000,SE 237,Residential,8917,0,8917,59492,0,68409
142720602100000,SE 237,Residential,6580,0,6580,46329,0,52909
142720602200000,SE 237,Residential,4986,0,4986,0,0,4986
142720602300000,SE 237,Residential,8000,0,8000,48158,0,56158
142720602400000,SE 237,Residential,7400,0,7400,33652,0,41052
142720602500000,SE 237,Residential,7876,0,7876,34124,0,42000
142720602600000,CITY PROPERTY,Exempt,0,0,0,0,0,0
142720602700000,SE 237,Residential,8500,0,8500,7173,0,15673
142720602800000,SE 237,Residential,8000,0,8000,64057,0,72057
142720602900000,SE 237,Residential,8000,0,8000,103814,0,111814
142720603000000,SE 237,Residential,6000,0,6000,49606,0,55606
142720603100000,SE 237,Residential,6000,0,6000,58150,0,64150
142720700100000,SE 237,Residential,6000,0,6000,28907,0,34907
142720700200000,SE 237,Residential,6000,0,6000,29564,0,35564
142720700300000,SE 237,Residential,8000,0,8000,33089,0,41089
142720700400000,SE 237,Residential,8000,0,8000,0,0,8000
142720700500000,SE 237,Residential,8022,0,8022,32474,0,40496
142720700600000,SE 237,Residential,8000,0,8000,49778,0,57778
142720700700000,SE 237,Residential,8123,0,8123,36160,0,44283
142720700800000,SE 237,Residential,6840,0,6840,59877,0,66717
142720700900000,CITY PROPERTY,Exempt,0,0,0,0,0,0
142720701000000,SE 237,Residential,11185,0,11185,57629,0,68814
142720701100000,SE 237,Residential,8000,0,8000,32893,0,40893
142720701200000,SE 237,Residential,8000,0,8000,116480,0,124480
142720701300000,SE 237,Residential,8000,0,8000,54396,0,62396
142720701400000,SE 237,Residential,8000,0,8000,121844,0,129844
142720701500000,SE 237,Residential,8000,0,8000,121844,0,129844
142720701600000,SE 237,Residential,8000,0,8000,127054,0,135054
142720701700000,SE 237,Residential,8000,0,8000,121844,0,129844
142720701800000,SE 237,Residential,8000,0,8000,49652,0,57652
142720701900000,SE 237,Residential,8000,0,8000,45901,0,53901
142720702000000,SE 237,Residential,3040,0,3040,0,0,3040
142720702100000,SMALL RETAIL,Commercial,0,4990,4990,0,22829,27819
142720702200000,SE 237,Residential,7839,0,7839,34713,0,42552
142720702300000,SE 237,Residential,4800,0,4800,0,0,4800
142720702400000,SE 237,Residential,4800,0,4800,51895,0,56695
142720702500000,CITY PROPERTY,Exempt,0,0,0,0,0,0
142720702600000,SE 237,Residential,8000,0,8000,51487,0,59487
142720702700000,SE 237,Residential,8000,0,8000,0,0,8000
142720800100000,SE 237,Residential,6300,0,6300,37820,0,44120
142720800200000,SE 237,Residential,6000,0,6000,46522,0,52522
142720801100000,SE 237,Residential,7867,0,7867,91568,0,99435
142720801200000,SE 237,Residential,8000,0,8000,84204,0,92204
142720801300000,SE 237,Residential,8400,0,8400,108070,0,116470
142720801400000,SE 237,Residential,8400,0,8400,91000,0,99400
142720801500000,SE 237,Residential,8400,0,8400,84815,0,93215
142720801600000,SE 237,Residential,8600,0,8600,94579,0,103179
142722700100000,OFFICE; MED; CTRL CR,Commercial,0,251640,251640,0,1097307,1348947
142722700200000,FLAT PARKING,Commercial,0,37584,37584,0,2320,39904
142722700300000,OFFICE; MED; CTRL CR,Commercial,0,251640,251640,0,2389504,2641144
142722800100000,HOSPITAL,Exempt,0,27216,27216,0,6796,34012
142722900100000,SE 237,Residential,8208,0,8208,47209,0,55417
142722900200000,SE 237,Residential,7440,0,7440,88885,0,96325
142722900300000,SE 237,Residential,6200,0,6200,74744,0,80944
142722900400000,SE 237,Residential,4980,0,4980,42059,0,47039
142722900500000,SE 237,Residential,4980,0,4980,46518,0,51498
142722900600000,VACANT LAND,Commercial,0,10206,10206,0,0,10206
142722900700000,SE 237,Residential,8000,0,8000,79609,0,87609
142722900800000,SE 237,Residential,7000,0,7000,52380,0,59380
142722900900000,SE 237,Residential,8000,0,8000,105838,0,113838
142722901000000,SE 237,Residential,7221,0,7221,83295,0,90516
142722901100000,CHURCH,Exempt,0,2703,2703,0,30141,32844
142722901400000,SE 237,Residential,7440,0,7440,18532,0,25972
142722901500000,SE 237,Residential,6000,0,6000,62302,0,68302
142722901600000,SE 237,Residential,6000,0,6000,25629,0,31629
142722902000000,SE 237,Residential,8200,0,8200,94724,0,102924
142722902100000,SE 237,Residential,8000,0,8000,94756,0,102756
142722902200000,SE 237,Residential,8000,0,8000,87245,0,95245
142722902400000,VACANT LAND,Residential,720,0,720,0,0,720
142722902500000,SE 237,Residential,8208,0,8208,106682,0,114890
142723000100000,FLAT PARKING,Commercial,0,251640,251640,0,48460,300100
142723000200000,HOSPITAL,Exempt,0,230580,230580,0,0,230580
142723000300000,HOSPITAL,Exempt,0,10195,10195,0,4656,14851
142723000400000,HOSPITAL,Exempt,0,10195,10195,0,4656,14851
142723100400000,OFFICE; MED; CTRL CR,Commercial,0,440339,440339,0,4334903,4775242
142723200100000,SE 237,Residential,6390,0,6390,77876,0,84266
142723200200000,SE 237,Residential,1538,0,1538,0,0,1538
142723200300000,SE 237,Residential,4241,0,4241,0,0,4241
142723200600000,SE 237,Residential,8000,0,8000,96537,0,104537
142723200700000,SE 237,Residential,8000,0,8000,97133,0,105133
142723200800000,SE 237,Residential,6000,0,6000,49263,0,55263
142723200900000,CITY PROPERTY,Exempt,0,0,0,0,0,0
142723201000000,SE 237,Residential,6300,0,6300,26336,0,32636
142723201100000,SE 237,Residential,6510,0,6510,94195,0,100705
142723201200000,SE 237,Residential,8009,0,8009,127250,0,135259
142723201300000,SE 237,Residential,10394,0,10394,114250,0,124644
142723201400000,SE 237,Residential,6000,0,6000,67735,0,73735
142723201500000,SE 237,Residential,7000,0,7000,36415,0,43415
142723201800000,SE 237,Residential,8000,0,8000,125939,0,133939
142723202000000,SE 237,Residential,6000,0,6000,109249,0,115249
142723202100000,SE 237,Residential,8415,0,8415,99600,0,108015
142723202200000,SE 237,Residential,6000,0,6000,108117,0,114117
142723300100000,FLAT PARKING,Commercial,0,145800,145800,0,18000,163800
142723300200000,HOSPITAL,Exempt,0,186030,186030,0,531476,717506
142723300300000,HOSPITAL,Exempt,0,13608,13608,0,5393,19001
142723300400000,HOSPITAL,Exempt,0,54432,54432,0,17490,71922
142723400100000,SE 237,Residential,6000,0,6000,108273,0,114273
142723400200000,SE 237,Residential,6000,0,6000,29903,0,35903
142723500200000,SE 237,Residential,3323,0,3323,0,0,3323
142723500300000,SE 237,Residential,5580,0,5580,42577,0,48157
142723500400000,SE 237,Residential,6840,0,6840,90632,0,97472
142723500500000,CITY PROPERTY,Exempt,0,0,0,0,0,0
142723500600000,SE 237,Residential,6000,0,6000,29897,0,35897
142723500700000,SE 237,Residential,6000,0,6000,16955,0,22955
142723500800000,SE 237,Residential,6226,0,6226,69026,0,75252
142723500900000,SE 237,Residential,5774,0,5774,50838,0,56612
142723501000000,SE 237,Residential,8400,0,8400,79596,0,87996
142723501100000,SE 237,Residential,8400,0,8400,89804,0,98204
142723501200000,SE 237,Residential,6000,0,6000,37245,0,43245
142723501300000,SE 237,Residential,6000,0,6000,53665,0,59665
142723501400000,SE 237,Residential,8400,0,8400,71963,0,80363
142723501500000,SE 237,Residential,8400,0,8400,54446,0,62846
142723501700000,SE 237,Residential,6480,0,6480,83655,0,90135
142723600100000,SE 237,Residential,5130,0,5130,0,0,5130
142723600800000,SE 237,Residential,5000,0,5000,0,0,5000
142723600900000,SMALL RETAIL,Exempt,0,20412,20412,0,215686,236098
142723601200000,APARTMENT,Commercial,0,82080,82080,0,700989,783069
142723700100000,SMALL RET; CTRL CR,Commercial,0,120960,120960,0,417699,538659
142723700700000,VACANT LAND,Commercial,0,22680,22680,0,0,22680
142723700800000,HOSPITAL,Exempt,0,3836,3836,0,0,3836
142723700900000,FLAT PARKING,Commercial,0,71734,71734,0,23134,94868
142723701000000,HOSPITAL,Exempt,0,8232,8232,0,47547,55779
142723701100000,SE 238,Residential,7392,0,7392,41793,0,49185
142723701200000,HOSPITAL,Exempt,0,4720,4720,0,50101,54821
142723800100000,SE 237,Residential,6510,0,6510,41784,0,48294
142723800400000,SE 237,Residential,9000,0,9000,87575,0,96575
142723800500000,SE 237,Residential,8600,0,8600,100377,0,108977
142723800600000,SE 237,Residential,7600,0,7600,105958,0,113558
142723800700000,SE 237,Residential,7800,0,7800,92447,0,100247
142723900100000,SE 237,Exempt,0,28560,28560,0,141143,169703
142723900200000,SE 237,Exempt,0,2480,2480,0,0,2480
142723900300000,SMALL RETAIL,Commercial,0,4374,4374,0,0,4374
142723900400000,SE 237,Residential,4980,0,4980,0,0,4980
142723900500000,SE 237,Residential,6750,0,6750,88555,0,95305
142723900600000,SE 237,Residential,6750,0,6750,97869,0,104619
142723900900000,SE 237,Residential,6750,0,6750,90285,0,97035
142723901000000,CHURCH,Exempt,0,13608,13608,0,27984,41592
142723901100000,SE 237,Residential,6076,0,6076,38277,0,44353
142723901200000,SE 237,Residential,6300,0,6300,48464,0,54764
142723901300000,SE 237,Residential,5800,0,5800,108117,0,113917
142723901400000,SE 237,Residential,6200,0,6200,108117,0,114317
142723901500000,SE 237,Residential,5400,0,5400,0,0,5400
142724000100000,CHURCH,Exempt,0,24601,24601,0,212944,237545
142724000200000,SE 237,Residential,5899,0,5899,17905,0,23804
142724000300000,SE 237,Residential,5019,0,5019,26226,0,31245
142724000400000,SE 237,Residential,4500,0,4500,47898,0,52398
142724000500000,SE 237,Residential,3960,0,3960,38225,0,42185
142724000600000,SE 237,Residential,288,0,288,0,0,288
142724000700000,SE 237,Residential,4500,0,4500,39214,0,43714
142724000800000,SE 237,Residential,4500,0,4500,17140,0,21640
142724000900000,SE 237,Residential,4018,0,4018,8293,0,12311
142724001000000,SE 237,Residential,1984,0,1984,0,0,1984
142724001100000,CITY PROPERTY,Exempt,0,0,0,0,0,0
142724001200000,SE 237,Residential,6750,0,6750,33616,0,40366
142724001300000,SE 237,Residential,6750,0,6750,0,0,6750
142724001400000,SE 237,Residential,6750,0,6750,0,0,6750
142724001500000,SE 237,Residential,6750,0,6750,21054,0,27804
142724001600000,SE 237,Residential,5974,0,5974,0,0,5974
142724001700000,SE 237,Residential,1840,0,1840,0,0,1840
142724200200000,HOSPITAL,Exempt,0,0,0,0,0,0
142725100300000,SE 237,Residential,2700,0,2700,0,0,2700
142725100400000,SE 237,Residential,5000,0,5000,0,0,5000
142725100500000,SE 237,Residential,4800,0,4800,21360,0,26160
142725100600000,SE 237,Residential,6960,0,6960,75609,0,82569
142725100700000,SE 237,Residential,4500,0,4500,17990,0,22490
142725100800000,CITY PROPERTY,Exempt,0,0,0,0,0,0
142725100900000,SE 237,Residential,4500,0,4500,30654,0,35154
142725101000000,SE 237,Residential,5000,0,5000,0,0,5000
142725101100000,SE 237,Residential,1048,0,1048,8074,0,9122
142725101200000,SE 237,Residential,7882,0,7882,75582,0,83464
142725101300000,SE 237,Residential,6637,0,6637,34603,0,41240
142725101400000,SE 237,Residential,5400,0,5400,39800,0,45200
142725101500000,SE 237,Residential,6000,0,6000,31110,0,37110
142725101600000,SE 237,Residential,6000,0,6000,22631,0,28631
142725101700000,SE 237,Residential,6000,0,6000,47541,0,53541
142725101800000,SE 237,Residential,6000,0,6000,73053,0,79053
142725101900000,SE 237,Residential,9000,0,9000,102250,0,111250
142725200100000,VACANT LAND,Exempt,0,0,0,0,0,0
142725300200000,SE 237,Residential,5000,0,5000,0,0,5000
142725300300000,CITY PROPERTY,Exempt,0,0,0,0,0,0
142725300400000,SE 237,Residential,5602,0,5602,45093,0,50695
142725300600000,SECTION 42,Commercial,0,56160,56160,0,1004313,1060473
142725400100000,SCHOOL,Exempt,0,0,0,0,0,0
142725400200000,SCHOOL,Exempt,0,0,0,0,0,0
142725500100000,SE 237,Residential,4725,0,4725,56507,0,61232
142725500400000,SE 237,Residential,4725,0,4725,39467,0,44192
142725501300000,CITY PROPERTY,Exempt,0,0,0,0,0,0
142725501500000,SE 237,Residential,4800,0,4800,46571,0,51371
142725501700000,SE 237,Residential,4500,0,4500,25826,0,30326
142725501800000,CITY PROPERTY,Exempt,0,0,0,0,0,0
142725502000000,SECTION 42,Commercial,0,71280,71280,0,2873199,2944479
142725600100000,CHURCH,Exempt,0,13608,13608,0,22945,36553
142725600200000,CITY PROPERTY,Exempt,0,0,0,0,0,0
142725600300000,CITY PROPERTY,Exempt,0,0,0,0,0,0
142725600400000,VACANT LAND,Commercial,0,19640,19640,0,0,19640
142725600500000,SE 237,Residential,4950,0,4950,31350,0,36300
142725600600000,CITY PROPERTY,Exempt,0,0,0,0,0,0
142725600700000,VACANT LAND,Commercial,0,9072,9072,0,0,9072
142725600800000,FLAT PARKING,Commercial,0,15120,15120,0,0,15120
142725600900000,SE 237,Residential,6000,0,6000,0,0,6000
142725601000000,SE 237,Residential,6000,0,6000,15197,0,21197
142725601100000,SE 237,Residential,6000,0,6000,29495,0,35495
142725601200000,SE 237,Residential,6000,0,6000,0,0,6000
142725601300000,SE 237,Residential,6000,0,6000,0,0,6000
142725700100000,CITY PROPERTY,Exempt,0,0,0,0,0,0
142725700200000,CITY PROPERTY,Exempt,0,0,0,0,0,0
142725700300000,CITY PROPERTY,Exempt,0,0,0,0,0,0
142725700500000,SE 237,Residential,5559,0,5559,31066,0,36625
142725700600000,SE 237,Residential,4646,0,4646,16522,0,21168
142725800701000,VACANT LAND,Residential,5000,0,5000,0,0,5000
142725800701001,VACANT LAND,Residential,5000,0,5000,0,0,5000
142725800701002,VACANT LAND,Residential,5000,0,5000,0,0,5000
142725800701003,VACANT LAND,Residential,5000,0,5000,0,0,5000
142725800701004,VACANT LAND,Residential,5000,0,5000,0,0,5000
142725800701005,VACANT LAND,Residential,5000,0,5000,0,0,5000
142725800701006,VACANT LAND,Residential,5000,0,5000,0,0,5000
142725800701007,VACANT LAND,Residential,5000,0,5000,0,0,5000
142725800701008,VACANT LAND,Residential,5000,0,5000,0,0,5000
142725800701009,VACANT LAND,Residential,5000,0,5000,0,0,5000
142725800701010,VACANT LAND,Residential,5000,0,5000,0,0,5000
142725800701011,VACANT LAND,Residential,5000,0,5000,0,0,5000
142725800701012,VACANT LAND,Residential,5000,0,5000,0,0,5000
142725800701013,VACANT LAND,Residential,5000,0,5000,0,0,5000
142725800701014,VACANT LAND,Residential,5000,0,5000,0,0,5000
142725800701015,VACANT LAND,Residential,5000,0,5000,0,0,5000
142725800701016,VACANT LAND,Residential,5000,0,5000,0,0,5000
142725800701017,VACANT LAND,Residential,5000,0,5000,0,0,5000
142725800701018,VACANT LAND,Residential,5000,0,5000,0,0,5000
142725800701019,VACANT LAND,Residential,5000,0,5000,0,0,5000
142725800701020,VACANT LAND,Residential,5000,0,5000,0,0,5000
142725800701021,VACANT LAND,Residential,5000,0,5000,0,0,5000
142725800701022,VACANT LAND,Commercial,0,6000,6000,0,0,6000
142725800701023,VACANT LAND,Commercial,0,6000,6000,0,0,6000
142725800701024,VACANT LAND,Commercial,0,6000,6000,0,0,6000
142725800701025,VACANT LAND,Commercial,0,6000,6000,0,0,6000
142725900100000,CITY PROPERTY,Exempt,0,0,0,0,0,0
142725900200000,CENTRALLY ASSESSED,Other,0,0,0,0,0,0
142726000200000,SCHOOL,Exempt,0,243000,243000,0,510569,753569
142726000602000,BILLBOARD(BLL),Commercial,0,0,0,0,8455,8455
142726000800000,CITY PROPERTY,Exempt,0,0,0,0,0,0
142726100100000,FLAT PARKING,Exempt,0,130950,130950,0,4419,135369
142726100300000,CITY PROPERTY,Exempt,0,0,0,0,0,0
142726100400000,SE 237,Residential,2362,0,2362,0,0,2362
142726100500000,CHURCH,Exempt,0,22950,22950,0,0,22950
142726100700000,CITY PROPERTY,Exempt,0,0,0,0,0,0
142726100800000,CITY PROPERTY,Exempt,0,0,0,0,0,0
142726100900000,SE 237,Residential,2025,0,2025,0,0,2025
142726101000000,CITY PROPERTY,Exempt,0,0,0,0,0,0
142726101100000,CITY PROPERTY,Exempt,0,0,0,0,0,0
142726101200000,CITY PROPERTY,Exempt,0,0,0,0,0,0
142726101300000,CITY PROPERTY,Exempt,0,0,0,0,0,0
142726101400000,CITY PROPERTY,Exempt,0,0,0,0,0,0
142726200100000,FLAT PARKING,Commercial,0,72560,72560,0,61953,134513
142727600100000,APARTMENT,Commercial,0,115560,115560,0,526387,641947
142727600200000,SE 237,Residential,11000,0,11000,134450,0,145450
142727700100000,APARTMENT,Commercial,0,325620,325620,0,2067794,2393414
142727700200000,CHURCH,Exempt,0,26055,26055,0,148349,174404
142727700300000,FLAT PARKING,Exempt,0,145800,145800,0,1762,147562
142727700400000,CITY PROPERTY,Exempt,0,0,0,0,0,0
142727700500000,CITY PROPERTY,Exempt,0,0,0,0,0,0
142727700600000,SCHOOL,Exempt,0,104490,104490,0,1760271,1864761
142727700700000,CITY PROPERTY,Exempt,0,0,0,0,0,0
142727700800000,CITY PROPERTY,Exempt,0,0,0,0,0,0
142727700900000,APARTMENT,Commercial,0,64260,64260,0,262726,326986
142727800100000,CITY PROPERTY,Exempt,0,0,0,0,0,0
142727900300000,SE 237,Residential,7000,0,7000,81113,0,88113
142727900400000,SE 237,Residential,7000,0,7000,84815,0,91815
142728000100000,SE 237,Residential,9894,0,9894,79307,0,89201
142728000200000,SE 237,Residential,9894,0,9894,84519,0,94413
142728000300000,SE 237,Residential,9894,0,9894,87517,0,97411
142728000400000,SE 237,Residential,9894,0,9894,82830,0,92724
142728000500000,APARTMENT,Commercial,0,68580,68580,0,261566,330146
142728100100000,FLAT PARKING,Industrial,0,4244,4244,0,31830,36074
142728100200000,FLAT PARKING,Industrial,0,2236,2236,0,15347,17583
142728100300000,FLAT PARKING,Industrial,0,2300,2300,0,15631,17931
142728100400000,WAREHOUSE,Industrial,0,58320,58320,0,102773,161093
142728100500000,VACANT LAND,Industrial,0,891,891,0,0,891
142728100600000,VACANT LAND,Industrial,0,1134,1134,0,0,1134
142728100700000,VACANT LAND,Industrial,0,1085,1085,0,0,1085
142728100800000,FLAT PARKING,Industrial,0,3127,3127,0,5400,8527
142728100900000,FLAT PARKING,Industrial,0,7970,7970,0,48314,56284
142728101000000,CITY PROPERTY,Exempt,0,0,0,0,0,0
142728200100000,SE 237,Residential,3808,0,3808,0,0,3808
142728200200000,SE 237,Residential,3467,0,3467,0,0,3467
142728200300000,SE 237,Residential,3232,0,3232,44459,0,47691
142728200400000,SE 237,Residential,3060,0,3060,41252,0,44312
142728200500000,SE 237,Residential,7434,0,7434,24827,0,32261
142728200600000,SE 237,Residential,3880,0,3880,22970,0,26850
142728200700000,SE 237,Residential,2731,0,2731,35366,0,38097
142728200800000,CITY PROPERTY,Exempt,0,0,0,0,0,0
142728200900000,SE 237,Residential,5000,0,5000,0,0,5000
142728300100000,VACANT LAND,Commercial,0,6804,6804,0,0,6804
142728300200000,SE 237,Residential,3000,0,3000,0,0,3000
142728300300000,VACANT LAND,Commercial,0,8845,8845,0,0,8845
142728300400000,SE 237,Residential,4500,0,4500,28788,0,33288
142728300500000,CITY PROPERTY,Exempt,0,0,0,0,0,0
142728300600000,SE 237,Residential,4500,0,4500,24225,0,28725
142728300700000,CITY PROPERTY,Exempt,0,0,0,0,0,0
142730100200000,FOOD GRADE;INDUST,Industrial,0,29970,29970,0,0,29970
142730200100000,FLAT PARKING,Industrial,0,1555,1555,0,10515,12070
142730200200000,FLAT PARKING,Industrial,0,1555,1555,0,10515,12070
142730200300000,FLAT PARKING,Industrial,0,3127,3127,0,21315,24442
142730200400000,FLAT PARKING,Industrial,0,3127,3127,0,19894,23021
142730200500000,FLAT PARKING,Industrial,0,3127,3127,0,5684,8811
142730200600000,VACANT LAND,Industrial,0,3127,3127,0,0,3127
142730300100000,SE 237,Residential,2728,0,2728,0,0,2728
142730300200000,SE 237,Residential,4500,0,4500,0,0,4500
142730300300000,SE 237,Residential,1200,0,1200,0,0,1200
142730300400000,SE 237,Residential,4500,0,4500,0,0,4500
142730300500000,CITY PROPERTY,Exempt,0,0,0,0,0,0
142730300600000,CITY PROPERTY,Exempt,0,0,0,0,0,0
142730300700000,CITY PROPERTY,Exempt,0,0,0,0,0,0
142730300800000,SE 237,Residential,2666,0,2666,0,0,2666
142730300900000,SE 237,Residential,3286,0,3286,0,0,3286
142730301000000,CITY PROPERTY,Exempt,0,0,0,0,0,0
142730400100000,SE 237,Residential,4980,0,4980,0,0,4980
142730400200000,SE 237,Residential,5000,0,5000,0,0,5000
142730400300000,CITY PROPERTY,Exempt,0,0,0,0,0,0
142730400400000,CITY PROPERTY,Exempt,0,0,0,0,0,0
142730400500000,SE 237,Residential,3000,0,3000,0,0,3000
142730400600000,SE 237,Residential,3000,0,3000,0,0,3000
142730400700000,SE 237,Residential,3000,0,3000,0,0,3000
142730400800000,SE 237,Residential,3000,0,3000,0,0,3000
142730400900000,SE 237,Residential,1200,0,1200,0,0,1200
142730401000000,SE 237,Residential,2250,0,2250,0,0,2250
142730401100000,SE 237,Residential,3100,0,3100,20829,0,23929
142730500100000,CENTRALLY ASSESSED,Other,0,0,0,0,0,0
142730500200000,OFFICE,Exempt,0,0,0,0,0,0
142730600600000,FOOD GRADE;INDUST,Industrial,0,52974,52974,0,447311,500285
142730700100000,SE 237,Residential,3800,0,3800,0,0,3800
142730700200000,SE 237,Residential,3800,0,3800,0,0,3800
142730700300000,CITY PROPERTY,Exempt,0,0,0,0,0,0
142730700400000,SE 237,Residential,4560,0,4560,19238,0,23798
142730700500000,SE 237,Residential,2944,0,2944,0,0,2944
142730700600000,SE 237,Residential,2944,0,2944,0,0,2944
142730700700000,SE 237,Residential,3800,0,3800,0,0,3800
142730700800000,SE 237,Residential,1253,0,1253,0,0,1253
142730700900000,SE 237,Residential,2628,0,2628,0,0,2628
142730701000000,CITY PROPERTY,Exempt,0,0,0,0,0,0
142732600100000,WAREHOUSE,Commercial,0,50026,50026,0,64681,114707
142732600200000,FLAT PARKING,Commercial,0,23814,23814,0,2250,26064
142732700100000,SE 237,Residential,800,0,800,0,0,800
142732700800000,VACANT LAND,Commercial,0,13608,13608,0,0,13608
142732700900000,WAREHOUSE,Commercial,0,21773,21773,0,17431,39204
142732701000000,SE 237,Residential,5000,0,5000,0,0,5000
142732701200000,SE 237,Residential,3000,0,3000,0,0,3000
142732701300000,CITY PROPERTY,Exempt,0,0,0,0,0,0
142732701400000,SE 237,Residential,3500,0,3500,0,0,3500
142732701500000,AUTO REPAIR/SALES,Commercial,0,22136,22136,0,15259,37395
142732701600000,CITY PROPERTY,Exempt,0,0,0,0,0,0
142732701700000,SE 237,Residential,2250,0,2250,0,0,2250
142732701800000,SE 237,Residential,3000,0,3000,0,0,3000
142732701900000,SE 237,Residential,3000,0,3000,0,0,3000
142732702000000,SE 237,Residential,1200,0,1200,0,0,1200
142732702100000,SE 237,Residential,1280,0,1280,1382,0,2662
142732702200000,CITY PROPERTY,Exempt,0,0,0,0,0,0
142732800100000,CITY PROPERTY,Exempt,0,0,0,0,0,0
142732800102000,BILLBOARD(BLL),Commercial,0,0,0,0,9900,9900
142732800200000,WAREHOUSE,Commercial,0,70740,70740,0,109713,180453
142732800600000,FLAT PARKING,Commercial,0,18954,18954,0,1170,20124
142732800700000,VACANT LAND,Commercial,0,29160,29160,0,0,29160
142732800800000,VACANT LAND,Commercial,0,20655,20655,0,0,20655
142732801000000,FLAT PARKING,Commercial,0,29160,29160,0,4050,33210
142732801100000,RESTAURANT,Commercial,0,47984,47984,0,73298,121282
142732801200000,FLAT PARKING,Commercial,0,14113,14113,0,4050,18163
142732900100000,SE 237,Residential,3000,0,3000,0,0,3000
142732900200000,CITY PROPERTY,Exempt,0,0,0,0,0,0
142732900300000,SE 237,Residential,1360,0,1360,0,0,1360
142732900400000,SE 237,Residential,2600,0,2600,0,0,2600
142732900500000,BARS/LOUNGE,Commercial,0,21115,21115,0,35999,57114
142732900600000,FLAT PARKING,Commercial,0,10162,10162,0,1530,11692
142733000100000,OFFICE,Commercial,0,55339,55339,0,12943,68282
142733000200000,VACANT LAND,Commercial,0,14580,14580,0,0,14580
142733000300000,WAREHOUSE,Commercial,0,58320,58320,0,51802,110122
142733000400000,SMALL RETAIL,Commercial,0,15930,15930,0,79229,95159
142733000500000,FLAT PARKING,Commercial,0,8886,8886,0,0,8886
142733000600000,BARS/LOUNGE,Commercial,0,5000,5000,0,0,5000
142733000700000,SMALL RETAIL,Commercial,0,10441,10441,0,59831,70272
142733000800000,OFFICE,Commercial,0,26606,26606,0,35341,61947
142733000900000,VACANT LAND,Commercial,0,22097,22097,0,0,22097
142733001000000,SE 237,Residential,4590,0,4590,0,0,4590
142733001100000,SE 237,Residential,5000,0,5000,0,0,5000
142733001200000,SE 237,Residential,5508,0,5508,0,0,5508
142733001300000,CITY PROPERTY,Exempt,0,0,0,0,0,0
142733001400000,SE 237,Residential,3060,0,3060,0,0,3060
142733001500000,SE 237,Residential,1224,0,1224,0,0,1224
142733001600000,CITY PROPERTY,Exempt,0,0,0,0,0,0
142733001700000,CITY PROPERTY,Exempt,0,0,0,0,0,0
142733001800000,CITY PROPERTY,Exempt,0,0,0,0,0,0
142733001900000,CITY PROPERTY,Exempt,0,0,0,0,0,0
142733100100000,CITY PROPERTY,Exempt,0,0,0,0,0,0
142733100200000,SE 237,Residential,3030,0,3030,0,0,3030
142733100300000,CITY PROPERTY,Exempt,0,0,0,0,0,0
142733100400000,CITY PROPERTY,Exempt,0,0,0,0,0,0
142733100500000,CITY PROPERTY,Exempt,0,0,0,0,0,0
142733100600000,CITY PROPERTY,Exempt,0,0,0,0,0,0
142733100700000,CITY PROPERTY,Exempt,0,0,0,0,0,0
142733100800000,CITY PROPERTY,Exempt,0,0,0,0,0,0
142733100900000,CITY PROPERTY,Exempt,0,0,0,0,0,0
142733101000000,SE 237,Residential,2000,0,2000,0,0,2000
142733101100000,CITY PROPERTY,Exempt,0,0,0,0,0,0
142733101200000,CITY PROPERTY,Exempt,0,0,0,0,0,0
142733101300000,CITY PROPERTY,Exempt,0,0,0,0,0,0
142733101400000,CITY PROPERTY,Exempt,0,0,0,0,0,0
142733101500000,CITY PROPERTY,Exempt,0,0,0,0,0,0
142733101600000,CITY PROPERTY,Exempt,0,0,0,0,0,0
142733101700000,CITY PROPERTY,Exempt,0,0,0,0,0,0
142733101800000,FLAT PARKING,Industrial,0,5184,5184,0,2640,7824
142733101900000,CITY PROPERTY,Exempt,0,0,0,0,0,0
142733102000000,CITY PROPERTY,Exempt,0,0,0,0,0,0
142733200100000,APARTMENT,Commercial,0,9202,9202,0,26806,36008
142735100100000,CITY PROPERTY,Exempt,0,0,0,0,0,0
142735200100000,WAREHOUSE,Commercial,0,56092,56092,0,46969,103061
142735200200000,WAREHOUSE,Commercial,0,15356,15356,0,0,15356
142735300100000,WAREHOUSE,Commercial,0,26483,26483,0,4160,30643
142735300200000,SW 412,Residential,10511,0,10511,0,0,10511
142735300300000,CITY PROPERTY,Exempt,0,0,0,0,0,0
142735300400000,CITY PROPERTY,Exempt,0,0,0,0,0,0
142735300500000,CITY PROPERTY,Exempt,0,0,0,0,0,0
142735300600000,SW 412,Residential,10200,0,10200,0,0,10200
142735300700000,CITY PROPERTY,Exempt,0,0,0,0,0,0
142735400100000,COUNTY PROPERTY,Exempt,0,0,0,0,0,0
142735400200000,CITY PROPERTY,Exempt,0,0,0,0,0,0
142735400300000,SW 402,Residential,14700,0,14700,21717,0,36417
142735400400000,CITY PROPERTY,Exempt,0,0,0,0,0,0
142735400500000,SW 402,Residential,5000,0,5000,0,0,5000
142735400600000,CITY PROPERTY,Exempt,0,0,0,0,0,0
142735400700000,CITY PROPERTY,Exempt,0,0,0,0,0,0
142735400800000,CITY PROPERTY,Exempt,0,0,0,0,0,0
142735400900000,CITY PROPERTY,Exempt,0,0,0,0,0,0
142735401000000,CITY PROPERTY,Exempt,0,0,0,0,0,0
142735401100000,CITY PROPERTY,Exempt,0,0,0,0,0,0
142735401200000,CITY PROPERTY,Exempt,0,0,0,0,0,0
142735401300000,CITY PROPERTY,Exempt,0,0,0,0,0,0
142737600100000,CITY PROPERTY,Exempt,0,0,0,0,0,0
142740100100000,CENTRALLY ASSESSED,Other,0,0,0,0,0,0
142742600100000,FOOD GRADE;INDUST,Industrial,0,386370,386370,0,7601873,7988243
142745100100000,CITY PROPERTY,Exempt,0,0,0,0,0,0
142747600100000,CENTRALLY ASSESSED,Other,0,0,0,0,0,0
142810100100000,FEDERAL PROPERTY,Exempt,0,0,0,0,0,0
142810300100000,CONVERSION,Commercial,0,15876,15876,0,108677,124553
142810300200000,CONVERSION,Commercial,0,3402,3402,0,43338,46740
142810300300000,FLAT PARKING,Commercial,0,133229,133229,0,99428,232657
142810300500000,WAREHOUSE; CTRL CR,Commercial,0,91125,91125,0,565023,656148
142810300600000,FLAT PARKING,Commercial,0,13608,13608,0,17215,30823
142810300700000,VACANT LAND,Commercial,0,27216,27216,0,0,27216
142810400100000,WAREHOUSE; CTRL CR,Commercial,0,108864,108864,0,199538,308402
142810400200000,WAREHOUSE; CTRL CR,Commercial,0,215892,215892,0,1038202,1254094
142810500100000,CONVERSION,Exempt,0,19157,19157,0,312824,331981
142810500300000,FLAT PARKING,Commercial,0,39150,39150,0,0,39150
142810500400000,CITY PROPERTY,Exempt,0,0,0,0,0,0
142810500500000,FLAT PARKING,Commercial,0,31320,31320,0,60132,91452
142810500600000,VACANT LAND,Commercial,0,22680,22680,0,0,22680
142810500700000,VACANT LAND,Commercial,0,16672,16672,0,0,16672
142810500800000,FLAT PARKING,Commercial,0,63450,63450,0,38296,101746
142810500900000,VACANT LAND,Commercial,0,10800,10800,0,0,10800
142810501000000,FLAT PARKING,Commercial,0,11583,11583,0,5219,16802
142810501100000,CITY PROPERTY,Exempt,0,0,0,0,0,0
142810600100000,OFFICE; MED; CTRL CR,Commercial,0,81648,81648,0,417010,498658
142810600200000,SMALL RET; CTRL CR,Commercial,0,54432,54432,0,325156,379588
142810600400000,OFFICE; MED; CTRL CR,Commercial,0,207360,207360,0,1597779,1805139
142810700100000,OFFICE; CTRL CR,Commercial,0,101925,101925,0,1152355,1254280
142810700200000,WAREHOUSE; CTRL CR,Commercial,0,127710,127710,0,463587,591297
142810700300000,TECH PROD MFG;INDUST,Industrial,0,41472,41472,0,172905,214377
142810800100000,OFFICE; CTRL CR,Commercial,0,54432,54432,0,284099,338531
142810900100000,FLAT PARKING,Commercial,0,74250,74250,0,18046,92296
142810900300000,WAREHOUSE; CTRL CR,Commercial,0,14515,14515,0,80887,95402
142810900400000,WAREHOUSE; CTRL CR,Commercial,0,36288,36288,0,52439,88727
142810900500000,RESTAURANT; CTRL CR,Commercial,0,36288,36288,0,64679,100967
142810900600000,VACANT LAND,Exempt,0,7666,7666,0,0,7666
142810900700000,FLAT PARKING,Exempt,0,93053,93053,0,40624,133677
142810900800000,SE 238,Residential,3952,0,3952,0,0,3952
142810900900000,SE 238,Residential,3458,0,3458,0,0,3458
142810901000000,SE 238,Residential,5270,0,5270,20414,0,25684
142811000100000,WAREHOUSE; CTRL CR,Commercial,0,129600,129600,0,291936,421536
142811000400000,FLAT PARKING,Commercial,0,90720,90720,0,8880,99600
142811000402000,BILLBOARD(BLL),Commercial,0,0,0,0,54843,54843
142811000500000,AUTO REP/SAL;CTRL CR,Commercial,0,45360,45360,0,22170,67530
142811000600000,AUTO REP/SAL;CTRL CR,Commercial,0,45360,45360,0,54581,99941
142811000700000,AUTO REP/SAL;CTRL CR,Commercial,0,22680,22680,0,38323,61003
142811000800000,BARS/LOUNGE; CTRL CR,Commercial,0,13608,13608,0,75166,88774
142811000900000,CENTRALLY ASSESSED,Other,0,0,0,0,0,0
142811100100000,FLAT PARKING,Commercial,0,35496,35496,0,7680,43176
142811100200000,FLAT PARKING,Commercial,0,24883,24883,0,0,24883
142811100300000,WAREHOUSE; CTRL CR,Commercial,0,43546,43546,0,127264,170810
142811100400000,FLAT PARKING,Commercial,0,31055,31055,0,4260,35315
142811300100000,SHOP,Commercial,0,72576,72576,0,155443,228019
142811300200000,OFFICE; MED; CTRL CR,Commercial,0,108864,108864,0,494152,603016
142811300300000,OFFICE,Exempt,0,81648,81648,0,1021183,1102831
142811400300000,WAREHOUSE; CTRL CR,Commercial,0,10886,10886,0,33600,44486
142811400400000,WAREHOUSE; CTRL CR,Commercial,0,41058,41058,0,31350,72408
142811400500000,WAREHOUSE; CTRL CR,Commercial,0,17003,17003,0,43567,60570
142811401000000,OFFICE; CTRL CR,Exempt,0,149037,149037,0,5725624,5874661
142811500100000,BARS/LOUNGE; CTRL CR,Commercial,0,23328,23328,0,33747,57075
142812600100000,OFFICE; CTRL CR,Commercial,0,142776,142776,0,1415988,1558764
142812600200000,FLAT PARKING,Commercial,0,214272,214272,0,62336,276608
142812600300000,FLAT PARKING,Commercial,0,97200,97200,0,26280,123480
142812700100000,OFFICE; CTRL CR,Commercial,0,79834,79834,0,480947,560781
142812700200000,OFFICE; CTRL CR,Commercial,0,108864,108864,0,781826,890690
142812700300000,OFFICE; CTRL CR,Commercial,0,145152,145152,0,558730,703882
142812700400000,OFFICE,Exempt,0,69625,69625,0,578535,648160
142812700500000,BRNCH BK/CR; CTRL CR,Commercial,0,167098,167098,0,453149,620247
142812700600000,CITY PROPERTY,Exempt,0,0,0,0,0,0
142812800100000,OFFICE; CTRL CR,Commercial,0,72576,72576,0,493138,565714
142812800200000,OFFICE; CTRL CR,Commercial,0,145152,145152,0,1300405,1445557
142812800300000,OFFICE; CTRL CR,Commercial,0,154829,154829,0,986499,1141328
142812800400000,OFFICE; CTRL CR,Commercial,0,244339,244339,0,1344166,1588505
142812800402000,MISCELLANEOUS,Commercial,0,0,0,0,20,20
142812900100000,CITY PROPERTY,Exempt,0,0,0,0,0,0
142812900200000,FLAT PARKING,Commercial,0,208224,208224,0,16804,225028
142812900300000,BARS/LOUNGE; CTRL CR,Commercial,0,10692,10692,0,5000,15692
142812900400000,FLAT PARKING,Commercial,0,72252,72252,0,7040,79292
142812900500000,SR/NURSING/ASSTD LIV,Commercial,0,62208,62208,0,3330303,3392511
142813000100000,OFFICE; CTRL CR,Commercial,0,471744,471744,0,5479023,5950767
142813000200000,OFFICE; CTRL CR,Commercial,0,326592,326592,0,2776952,3103544
142813000300000,OFFICE; CTRL CR,Commercial,0,290304,290304,0,770818,1061122
142813000400000,OFFICE; CTRL CR,Commercial,0,121824,121824,0,1446386,1568210
142813000500000,FLAT PARKING,Commercial,0,23328,23328,0,1306,24634
142813100101000,OFFICE; CTRL CR,Commercial,0,21880,21880,0,99681,121561
142813100101001,SMALL RET; CTRL CR,Commercial,0,14600,14600,0,62779,77379
142813100101002,OFFICE; CTRL CR,Commercial,0,21900,21900,0,114337,136237
142813100101003,OFFICE; CTRL CR,Commercial,0,23700,23700,0,126149,149849
142813100101004,OFFICE; CTRL CR,Commercial,0,14592,14592,0,78467,93059
142813100101005,OFFICE; CTRL CR,Commercial,0,42860,42860,0,244405,287265
142813100101006,OFFICE; CTRL CR,Commercial,0,42860,42860,0,83543,126403
142813100102000,CITY PROPERTY,Exempt,0,0,0,0,0,0
142813100200000,OFFICE,Exempt,0,73872,73872,0,499926,573798
142813100300000,RESTAURANT; CTRL CR,Commercial,0,29549,29549,0,85190,114739
142813100400000,OFFICE; CTRL CR,Commercial,0,72576,72576,0,182489,255065
142813100500000,OFFICE; CTRL CR,Commercial,0,72576,72576,0,129110,201686
142813100600000,OFFICE; CTRL CR,Commercial,0,72576,72576,0,248127,320703
142813100700000,CITY PROPERTY,Exempt,0,0,0,0,0,0
142813100800000,CITY PROPERTY,Exempt,0,0,0,0,0,0
142813100900000,VACANT LAND,Commercial,0,180403,180403,0,0,180403
142813100904000,CITY PROPERTY,Exempt,0,0,0,0,0,0
142813101000000,CITY PROPERTY,Exempt,0,0,0,0,0,0
142813200100000,FLAT PARKING,Commercial,0,17496,17496,0,1863,19359
142813200200000,FLAT PARKING,Commercial,0,45360,45360,0,6720,52080
142813200300000,FLAT PARKING,Commercial,0,15120,15120,0,2240,17360
142813200400000,SMALL RET; CTRL CR,Commercial,0,60480,60480,0,398368,458848
142813200500000,PRINTING,Industrial,0,21773,21773,0,96452,118225
142813200600000,OFFICE; CTRL CR,Commercial,0,54432,54432,0,28825,83257
142813200700000,OFFICE; CTRL CR,Commercial,0,124934,124934,0,1171104,1296038
142813300100000,OFFICE; CTRL CR,Commercial,0,72576,72576,0,1655545,1728121
142813300200000,FLAT PARKING,Commercial,0,72576,72576,0,27284,99860
142813300300000,OFFICE; CTRL CR,Commercial,0,72576,72576,0,945459,1018035
142813300400000,CITY PROPERTY,Exempt,0,0,0,0,0,0
142813300500000,CITY PROPERTY,Exempt,0,0,0,0,0,0
142813300501000,OFFICE; CTRL CR,Commercial,0,0,0,0,570404,570404
142813300501001,OFFICE; CTRL CR,Commercial,0,0,0,0,297777,297777
142813300501002,OFFICE; CTRL CR,Commercial,0,0,0,0,151307,151307
142813300501003,OFFICE; CTRL CR,Commercial,0,0,0,0,189134,189134
142813300501004,OFFICE; CTRL CR,Commercial,0,0,0,0,296137,296137
142813300501005,OFFICE; CTRL CR,Commercial,0,0,0,0,151307,151307
142813300501006,OFFICE; CTRL CR,Commercial,0,0,0,0,151307,151307
142813300501007,OFFICE; CTRL CR,Commercial,0,0,0,0,137957,137957
142813300501008,OFFICE; CTRL CR,Commercial,0,0,0,0,137957,137957
142813300501009,OFFICE; CTRL CR,Commercial,0,0,0,0,276041,276041
142813300501010,OFFICE; CTRL CR,Commercial,0,0,0,0,570404,570404
142813300501011,OFFICE; CTRL CR,Commercial,0,0,0,0,570404,570404
142813300501012,OFFICE; CTRL CR,Commercial,0,0,0,0,296137,296137
142813300501013,OFFICE; CTRL CR,Commercial,0,0,0,0,296137,296137
142813300501014,OFFICE; CTRL CR,Commercial,0,0,0,0,570404,570404
142813300501015,OFFICE; CTRL CR,Commercial,0,0,0,0,570404,570404
142813300501016,OFFICE; CTRL CR,Commercial,0,0,0,0,570404,570404
142813300501017,OFFICE; CTRL CR,Commercial,0,0,0,0,570404,570404
142813300501018,OFFICE; CTRL CR,Commercial,0,0,0,0,589607,589607
142813300501019,OFFICE; CTRL CR,Commercial,0,0,0,0,294236,294236
142813300501020,OFFICE; CTRL CR,Commercial,0,0,0,0,253460,253460
142813300502002,SCHOOL,Exempt,0,0,0,0,1537281,1537281
142813300700000,OFFICE; CTRL CR,Commercial,0,132192,132192,0,845892,978084
142813300800000,SCHOOL,Exempt,0,38880,38880,0,124946,163826
142813400100000,OFFICE; CTRL CR,Commercial,0,249912,249912,0,2605154,2855066
142813400200000,OFFICE; CTRL CR,Commercial,0,198072,198072,0,1679964,1878036
142813400300000,OFFICE,Exempt,0,71747,71747,0,1047391,1119138
142813400400000,FLAT PARKING,Commercial,0,223206,223206,0,11576,234782
142813400500000,FLAT PARKING,Exempt,0,125107,125107,0,53980,179087
142813400600000,FLAT PARKING,Commercial,0,50718,50718,0,25600,76318
142813500100000,OFFICE,Commercial,0,25000,25000,0,225000,250000
142813600100000,BARS/LOUNGE; CTRL CR,Commercial,0,33048,33048,0,235295,268343
142813600200000,CEMETERY,Exempt,0,52978,52978,0,132497,185475
142813600400000,THEATER,Exempt,0,82304,82304,0,1108056,1190360
142813600500000,CITY PROPERTY,Exempt,0,0,0,0,0,0
142813600600000,CITY PROPERTY,Exempt,0,0,0,0,0,0
142813600700000,LITERARY/LIBRARY/ART,Exempt,0,43821,43821,0,0,43821
142813600800000,LITERARY/LIBRARY/ART,Exempt,0,4909,4909,0,0,4909
142813700100000,WAREHOUSE; CTRL CR,Commercial,0,27994,27994,0,900,28894
142813700200000,WAREHOUSE; CTRL CR,Commercial,0,21773,21773,0,24616,46389
142813700300000,SMALL RET; CTRL CR,Commercial,0,29030,29030,0,330495,359525
142813700400000,AUTO REP/SAL;CTRL CR,Commercial,0,50803,50803,0,110491,161294
142815100200000,FITNESS CENTER,Exempt,0,437981,437981,0,7488154,7926135
142815200100000,CITY PROPERTY,Exempt,0,0,0,0,0,0
142815200200000,SMALL RET; CTRL CR,Commercial,0,58061,58061,0,401799,459860
142815200300000,FLAT PARKING,Commercial,0,152712,152712,0,58023,210735
142815300100000,CITY PROPERTY,Exempt,0,0,0,0,0,0
142815300200000,FLAT PARKING,Commercial,0,233280,233280,0,91314,324594
142815300300000,CITY PROPERTY,Exempt,0,0,0,0,0,0
142815300400000,OFFICE; CTRL CR,Commercial,0,226800,226800,0,12601641,12828441
142815400200000,FEDERAL PROPERTY,Exempt,0,0,0,0,0,0
142815600100000,CITY PROPERTY,Exempt,0,0,0,0,0,0
142815600300000,CITY PROPERTY,Exempt,0,0,0,0,0,0
142815700100000,CITY PROPERTY,Exempt,0,0,0,0,0,0
142815800100000,COUNTY PROPERTY,Exempt,0,0,0,0,0,0
142815800200000,CITY PROPERTY,Exempt,0,0,0,0,0,0
142816400202000,OFFICE; CTRL CR,Commercial,0,0,0,0,32509,32509
142816400902000,MISCELLANEOUS,Commercial,0,0,0,0,20,20
142817600100000,SE 237,Residential,2400,0,2400,0,0,2400
142817600200000,SE 237,Residential,1860,0,1860,0,0,1860
142817600300000,VACANT LAND,Commercial,0,10595,10595,0,0,10595
142817600400000,CITY PROPERTY,Exempt,0,0,0,0,0,0
142817600500000,SE 237,Residential,2762,0,2762,0,0,2762
142817600600000,SE 237,Residential,3596,0,3596,0,0,3596
142817600700000,CITY PROPERTY,Exempt,0,0,0,0,0,0
142817600800000,SE 237,Residential,4980,0,4980,32481,0,37461
142817700100000,WAREHOUSE; CTRL CR,Commercial,0,21773,21773,0,74389,96162
142817700200000,WAREHOUSE; CTRL CR,Commercial,0,21773,21773,0,62526,84299
142817800100000,VACANT LAND,Exempt,0,28350,28350,0,0,28350
142817800200000,SMALL RET; CTRL CR,Commercial,0,36288,36288,0,65143,101431
142817900200000,WAREHOUSE; CTRL CR,Commercial,0,30730,30730,0,67777,98507
142817900202000,BILLBOARD(BLL),Commercial,0,0,0,0,12281,12281
142818000300000,CENTRALLY ASSESSED,Other,0,0,0,0,0,0
142818000400000,MATERIALS MFG;INDUST,Industrial,0,87179,87179,0,390072,477251
142818000500000,VACANT LAND,Commercial,0,6804,6804,0,0,6804
142818000600000,FLAT PARKING,Commercial,0,27216,27216,0,2400,29616
142818000700000,FLAT PARKING,Commercial,0,13608,13608,0,2280,15888
142818000800000,FLAT PARKING,Commercial,0,13608,13608,0,2280,15888
142818000900000,SE 237,Residential,5000,0,5000,0,0,5000
142818001000000,SE 237,Residential,4557,0,4557,0,0,4557
142818001100000,SE 237,Residential,4557,0,4557,0,0,4557
142818001200000,CENTRALLY ASSESSED,Other,0,0,0,0,0,0
142818001300000,CENTRALLY ASSESSED,Other,0,0,0,0,0,0
142818100100000,OFFICE; CTRL CR,Commercial,0,28771,28771,0,95796,124567
142818100300000,CENTRALLY ASSESSED,Other,0,0,0,0,0,0
142818200100000,SMALL RET; CTRL CR,Commercial,0,231552,231552,0,412533,644085
142818200300000,CENTRALLY ASSESSED,Other,0,0,0,0,0,0
142818300100000,WAREHOUSE; CTRL CR,Commercial,0,4968,4968,0,8575,13543
142818300200000,WAREHOUSE; CTRL CR,Commercial,0,33048,33048,0,35592,68640
142818300300000,WAREHOUSE; CTRL CR,Commercial,0,10368,10368,0,14880,25248
142818300400000,WAREHOUSE; CTRL CR,Commercial,0,54432,54432,0,21000,75432
142818300500000,VACANT LAND,Commercial,0,9990,9990,0,0,9990
142818300600000,FLAT PARKING,Commercial,0,3780,3780,0,1320,5100
142818300700000,WAREHOUSE; CTRL CR,Commercial,0,31212,31212,0,8755,39967
142818300800000,FLAT PARKING,Commercial,0,87480,87480,0,12422,99902
142818300900000,FLAT PARKING,Commercial,0,1037,1037,0,101,1138
142818400100000,VACANT LAND,Commercial,0,65137,65137,0,0,65137
142818400200000,VACANT LAND,Commercial,0,89519,89519,0,0,89519
142818400300000,CONVENIENCE STORE,Commercial,0,65318,65318,0,184990,250308
142818400400000,AUTO REP/SAL;CTRL CR,Commercial,0,104112,104112,0,355499,459611
142818500100000,OFFICE; CTRL CR,Commercial,0,72878,72878,0,484468,557346
142818500200000,FLAT PARKING,Commercial,0,13608,13608,0,0,13608
142818500300000,SE 237,Residential,5000,0,5000,0,0,5000
142818500400000,SMALL RET; CTRL CR,Commercial,0,14515,14515,0,40304,54819
142818500500000,SMALL RET; CTRL CR,Commercial,0,14515,14515,0,20609,35124
142818500600000,OFFICE; CTRL CR,Commercial,0,29030,29030,0,39000,68030
142818500700000,CITY PROPERTY,Exempt,0,0,0,0,0,0
142818500800000,CITY PROPERTY,Exempt,0,0,0,0,0,0
142818600102000,ANTENNAS/TOWERS(BLL),Commercial,0,0,0,0,12736,12736
142818600102001,ANTENNAS/TOWERS(BLL),Commercial,0,0,0,0,9597,9597
142818600201000,OFFICE; CTRL CR,Commercial,0,14040,14040,0,107271,121311
142818600201001,OFFICE; CTRL CR,Commercial,0,14040,14040,0,65002,79042
142818600201002,OFFICE; CTRL CR,Commercial,0,14040,14040,0,77309,91349
142818600201003,OFFICE; CTRL CR,Commercial,0,14040,14040,0,124798,138838
142818600300000,FLAT PARKING,Commercial,0,56160,56160,0,26017,82177
142818600400000,VACANT LAND,Commercial,0,31860,31860,0,0,31860
142818700100000,WAREHOUSE,Exempt,0,0,0,0,0,0
142818700200000,CITY PROPERTY,Exempt,0,0,0,0,0,0
142818700300000,CITY PROPERTY,Exempt,0,0,0,0,0,0
142818700400000,CITY PROPERTY,Exempt,0,0,0,0,0,0
142818700500000,CITY PROPERTY,Exempt,0,0,0,0,0,0
142818700600000,CITY PROPERTY,Exempt,0,0,0,0,0,0
142818700700000,CITY PROPERTY,Exempt,0,0,0,0,0,0
142818800100000,SE 237,Exempt,0,36288,36288,0,0,36288
142818800200000,SE 237,Exempt,0,27216,27216,0,0,27216
142818800300000,SE 237,Exempt,0,27216,27216,0,0,27216
142818800400000,SE 237,Residential,4500,0,4500,0,0,4500
142818800500000,CITY PROPERTY,Exempt,0,0,0,0,0,0
142818800600000,CITY PROPERTY,Exempt,0,0,0,0,0,0
142818800700000,CITY PROPERTY,Exempt,0,0,0,0,0,0
142818800800000,CITY PROPERTY,Exempt,0,0,0,0,0,0
142818800900000,SMALL RET; CTRL CR,Commercial,0,29030,29030,0,48772,77802
142818801000000,SE 237,Residential,2400,0,2400,0,0,2400
142818801100000,SE 237,Residential,4500,0,4500,0,0,4500
142818801200000,CONVERSION,Commercial,0,5400,5400,0,0,5400
142818801300000,VACANT LAND,Exempt,0,5880,5880,0,0,5880
142818801400000,VACANT LAND,Exempt,0,5880,5880,0,0,5880
142818801500000,VACANT LAND,Exempt,0,18144,18144,0,0,18144
142818900100000,WAREHOUSE; CTRL CR,Commercial,0,21773,21773,0,47884,69657
142818900200000,RESTAURANT; CTRL CR,Commercial,0,21773,21773,0,119725,141498
142819000100000,LITERARY/LIBRARY/ART,Exempt,0,39312,39312,0,99478,138790
142819000200000,LITERARY/LIBRARY/ART,Exempt,0,5880,5880,0,21810,27690
142819000300000,SE 237,Residential,5000,0,5000,0,0,5000
142819100100000,CENTRALLY ASSESSED,Other,0,0,0,0,0,0
142820100100000,OFFICE; CTRL CR,Commercial,0,206323,206323,0,1283675,1489998
142820100200000,OFFICE; CTRL CR,Commercial,0,103680,103680,0,7248,110928
142820100300000,OFFICE,Other,0,0,0,0,0,0
142820100400000,OFFICE; CTRL CR,Commercial,0,23846,23846,0,49983,73829
142820100500000,OFFICE; CTRL CR,Commercial,0,155520,155520,0,947136,1102656
142820100600000,OFFICE; CTRL CR,Commercial,0,145152,145152,0,567244,712396
142820100700000,BARS/LOUNGE; CTRL CR,Commercial,0,110304,110304,0,0,110304
142820100800000,SMALL RET; CTRL CR,Commercial,0,55987,55987,0,42772,98759
142820200100000,OFFICE; CTRL CR,Commercial,0,181440,181440,0,0,181440
142820200200000,PARKING STRUCTURE,Commercial,0,337212,337212,0,2064919,2402131
142820300100000,CITY PROPERTY,Exempt,0,0,0,0,0,0
142820400100000,CITY PROPERTY,Exempt,0,0,0,0,0,0
142820400107000,MISCELLANEOUS,Commercial,0,0,0,0,4692346,4692346
142820400107001,MISCELLANEOUS,Commercial,0,0,0,0,74458,74458
142820400107002,MISCELLANEOUS,Commercial,0,0,0,0,1191626,1191626
142820400107003,MISCELLANEOUS,Commercial,0,0,0,0,1489757,1489757
142820400107004,MISCELLANEOUS,Commercial,0,0,0,0,578690,578690
142820400107005,MISCELLANEOUS,Commercial,0,0,0,0,13088,13088
142820400107008,MISCELLANEOUS,Commercial,0,0,0,0,11673,11673
142820500100000,CITY PROPERTY,Exempt,0,0,0,0,0,0
142820600100000,CITY PROPERTY,Exempt,0,0,0,0,0,0
142820600200000,CITY PROPERTY,Exempt,0,0,0,0,0,0
142820700100000,DEPT/ANCHOR STORE,Commercial,0,377909,377909,0,1319375,1697284
142820800100000,COUNTY PROPERTY,Exempt,0,0,0,0,0,0
142820900100000,CITY PROPERTY,Exempt,0,0,0,0,0,0
142821000100000,OFFICE; CTRL CR,Commercial,0,132710,132710,0,2284453,2417163
142822600100000,CITY PROPERTY,Exempt,0,0,0,0,0,0
142822700100000,CITY PROPERTY,Exempt,0,0,0,0,0,0
142822800100000,CITY PROPERTY,Exempt,0,0,0,0,0,0
142822800200000,CITY PROPERTY,Exempt,0,0,0,0,0,0
142822800300000,CITY PROPERTY,Exempt,0,0,0,0,0,0
142822800400000,FLAT PARKING,Commercial,0,5443,5443,0,3149,8592
142822800500000,CITY PROPERTY,Exempt,0,0,0,0,0,0
142822800600000,FAST FOOD,Commercial,0,59590,59590,0,27500,87090
142822800700000,SMALL RET; CTRL CR,Commercial,0,103343,103343,0,106382,209725
142822800800000,SERVICE STATION,Commercial,0,130637,130637,0,0,130637
142822800900000,SMALL RET; CTRL CR,Commercial,0,51408,51408,0,62300,113708
142822900100000,CITY PROPERTY,Exempt,0,0,0,0,0,0
142822900300000,CITY PROPERTY,Exempt,0,0,0,0,0,0
142823000100000,CITY PROPERTY,Exempt,0,0,0,0,0,0
142823100100000,OFFICE; CTRL CR,Commercial,0,108978,108978,0,551048,660026
142823100200000,FLAT PARKING,Commercial,0,25920,25920,0,5100,31020
142823100300000,CITY PROPERTY,Exempt,0,0,0,0,0,0
142823100400000,CITY PROPERTY,Exempt,0,0,0,0,0,0
142823100500000,FLAT PARKING,Commercial,0,8281,8281,0,939,9220
142823100600000,FLAT PARKING,Commercial,0,24313,24313,0,2758,27071
142823100700000,SW 401,Residential,7200,0,7200,38938,0,46138
142823100800000,WAREHOUSE; CTRL CR,Commercial,0,9677,9677,0,37088,46765
142823100900000,OFFICE; CTRL CR,Commercial,0,19354,19354,0,132406,151760
142823101000000,FLAT PARKING,Commercial,0,7728,7728,0,2558,10286
142823101100000,SW 401,Residential,4987,0,4987,0,0,4987
142823101200000,SMALL RET; CTRL CR,Commercial,0,87091,87091,0,70919,158010
142823200100000,SMALL RET; CTRL CR,Commercial,0,87382,87382,0,110469,197851
142823200102000,BILLBOARD(BLL),Commercial,0,0,0,0,28213,28213
142823200200000,CITY PROPERTY,Exempt,0,0,0,0,0,0
142823200300000,CITY PROPERTY,Exempt,0,0,0,0,0,0
142823200400000,CITY PROPERTY,Exempt,0,0,0,0,0,0
142823200500000,VACANT LAND,Commercial,0,9979,9979,0,0,9979
142823200600000,AUTO REP/SAL;CTRL CR,Commercial,0,29030,29030,0,39178,68208
142823200800000,CITY PROPERTY,Exempt,0,0,0,0,0,0
142823201100000,CITY PROPERTY,Exempt,0,0,0,0,0,0
142823300300000,COUNTY PROPERTY,Exempt,0,0,0,0,0,0
142823300400000,STATE PROPERTY,Exempt,0,0,0,0,0,0
142823300500000,STATE PROPERTY,Exempt,0,0,0,0,0,0
142823400100000,BRNCH BK/CR; CTRL CR,Commercial,0,123336,123336,0,475525,598861
142823400200000,FLAT PARKING,Commercial,0,54432,54432,0,5712,60144
142823400300000,CITY PROPERTY,Exempt,0,0,0,0,0,0
142823400500000,CITY PROPERTY,Exempt,0,0,0,0,0,0
142823400700000,SMALL RET; CTRL CR,Commercial,0,11612,11612,0,53557,65169
142823400800000,OFFICE; CTRL CR,Commercial,0,8709,8709,0,79395,88104
142823400900000,CITY PROPERTY,Exempt,0,0,0,0,0,0
142823401000000,OFFICE; CTRL CR,Commercial,0,8620,8620,0,22000,30620
142823401100000,CITY PROPERTY,Exempt,0,0,0,0,0,0
142823500100000,SMALL RET; CTRL CR,Commercial,0,29030,29030,0,106436,135466
142823500500000,VACANT LAND,Commercial,0,20563,20563,0,0,20563
142823500600000,SW 401,Residential,13351,0,13351,56468,0,69819
142823500700000,SW 401,Residential,6360,0,6360,0,0,6360
142823500800000,SW 401,Residential,6840,0,6840,0,0,6840
142823500900000,CITY PROPERTY,Exempt,0,0,0,0,0,0
142823501000000,CITY PROPERTY,Exempt,0,0,0,0,0,0
142823501100000,CITY PROPERTY,Exempt,0,0,0,0,0,0
142823501200000,WAREHOUSE,Commercial,0,58061,58061,0,229843,287904
142823600100000,BRNCH BK/CR; CTRL CR,Commercial,0,62424,62424,0,1009000,1071424
142823700200000,SW 401,Residential,13202,0,13202,0,0,13202
142823700300000,SW 401,Residential,5199,0,5199,24001,0,29200
142823900100000,BARS/LOUNGE,Commercial,0,15629,15629,0,74562,90191
142825100100000,FLAT PARKING,Commercial,0,83376,83376,0,18245,101621
142825100200000,BRNCH BK/CR; CTRL CR,Commercial,0,116424,116424,0,202363,318787
142825100300000,FLAT PARKING,Commercial,0,8640,8640,0,1274,9914
142825200100000,CITY PROPERTY,Exempt,0,0,0,0,0,0
142825300100000,SW 401,Residential,5000,0,5000,0,0,5000
142825300200000,FLAT PARKING,Commercial,0,37260,37260,0,5400,42660
142825300300000,SMALL RET; CTRL CR,Commercial,0,21773,21773,0,23701,45474
142825300302000,BILLBOARD(BLL),Commercial,0,0,0,0,44709,44709
142825300400000,BARS/LOUNGE; CTRL CR,Commercial,0,29030,29030,0,99536,128566
142825400100000,SCHOOL,Exempt,0,0,0,0,0,0
142825400200000,SCHOOL,Exempt,0,90720,90720,0,158771,249491
142825400300000,CONVERSIONS; NON-APT,Commercial,0,48166,48166,0,149422,197588
142825500100000,PRINTING,Industrial,0,48384,48384,0,208296,256680
142825500200000,OFFICE; CTRL CR,Commercial,0,9677,9677,0,136531,146208
142825500300000,OFFICE; CTRL CR,Commercial,0,29030,29030,0,104269,133299
142825500400000,SMALL RET; CTRL CR,Commercial,0,29030,29030,0,138764,167794
142825500500000,SHOP,Commercial,0,29030,29030,0,34888,63918
142825500502000,BILLBOARD(BLL),Commercial,0,0,0,0,12121,12121
142825500600000,PRINTING,Industrial,0,32760,32760,0,0,32760
142825500700000,FLAT PARKING,Commercial,0,38102,38102,0,6600,44702
142825500800000,SW 401,Residential,4185,0,4185,30541,0,34726
142825500900000,SW 401,Residential,4185,0,4185,0,0,4185
142825501000000,OFFICE; CTRL CR,Commercial,0,12442,12442,0,52610,65052
142825600100000,CITY PROPERTY,Exempt,0,0,0,0,0,0
142825600200000,CITY PROPERTY,Exempt,0,0,0,0,0,0
142825600300000,SW 401,Residential,11250,0,11250,37737,0,48987
142825600400000,SW 401,Residential,7875,0,7875,0,0,7875
142825600500000,SMALL RET; CTRL CR,Commercial,0,16330,16330,0,153564,169894
142825600600000,SW 401,Residential,4522,0,4522,0,0,4522
142825600700000,SW 401,Residential,4522,0,4522,41641,0,46163
142825600800000,SW 401,Residential,5000,0,5000,0,0,5000
142825600900000,CITY PROPERTY,Exempt,0,0,0,0,0,0
142825601000000,SW 401,Residential,5580,0,5580,0,0,5580
142825601100000,CONVERSIONS; NON-APT,Commercial,0,7776,7776,0,56346,64122
142825601200000,CONVERSION,Commercial,0,10206,10206,0,39478,49684
142825601300000,SMALL RET; CTRL CR,Commercial,0,10886,10886,0,64406,75292
142825601400000,SW 401,Residential,6750,0,6750,35518,0,42268
142825601500000,CITY PROPERTY,Exempt,0,0,0,0,0,0
142825601600000,CITY PROPERTY,Exempt,0,0,0,0,0,0
142825601700000,CONVERSION,Commercial,0,4860,4860,0,0,4860
142825601800000,SW 401,Residential,5000,0,5000,0,0,5000
142825601900000,SW 401,Residential,4673,0,4673,38622,0,43295
142825602000000,SW 401,Residential,4743,0,4743,40644,0,45387
142825602100000,SW 401,Residential,4882,0,4882,25168,0,30050
142825700100000,NBHD SHOPPING CENTER,Commercial,0,48384,48384,0,371973,420357
142825700200000,LAUNDROMAT/CLEANERS,Commercial,0,24192,24192,0,62760,86952
142825700300000,FLAT PARKING,Commercial,0,30240,30240,0,15105,45345
142825700400000,FLAT PARKING,Commercial,0,25174,25174,0,1329,26503
142825700500000,SW 401,Residential,11250,0,11250,54935,0,66185
142825700600000,SW 401,Residential,11250,0,11250,39380,0,50630
142825700700000,SW 401,Residential,5000,0,5000,0,0,5000
142825700800000,CITY PROPERTY,Exempt,0,0,0,0,0,0
142825700900000,SW 401,Residential,6750,0,6750,0,0,6750
142825701000000,SW 401,Residential,11025,0,11025,51063,0,62088
142825701100000,FLAT PARKING,Commercial,0,9639,9639,0,0,9639
142825800100000,SW 401,Residential,5000,0,5000,0,0,5000
142825800800000,CITY PROPERTY,Exempt,0,0,0,0,0,0
142825800900000,SW 401,Residential,5000,0,5000,0,0,5000
142825801000000,SW 401,Residential,7965,0,7965,55769,0,63734
142825801100000,SW 401,Residential,6750,0,6750,20521,0,27271
142825801200000,SW 401,Residential,6750,0,6750,32438,0,39188
142825801300000,CITY PROPERTY,Exempt,0,0,0,0,0,0
142825801400000,FRATERNAL,Exempt,0,81855,81855,0,114673,196528
142825900100000,SW 401,Residential,7560,0,7560,36729,0,44289
142825900200000,SW 401,Residential,14175,0,14175,71304,0,85479
142825900300000,SW 401,Residential,5000,0,5000,0,0,5000
142825900400000,SW 401,Residential,11250,0,11250,9811,0,21061
142825900500000,SW 401,Residential,11250,0,11250,50672,0,61922
142825900600000,APARTMENT,Commercial,0,9072,9072,0,136619,145691
142825900700000,CONVERSION,Commercial,0,8505,8505,0,58299,66804
142825900800000,SW 401,Residential,5000,0,5000,0,0,5000
142825900900000,SW 401,Residential,8505,0,8505,60641,0,69146
142825901000000,CITY PROPERTY,Exempt,0,0,0,0,0,0
142825901100000,CITY PROPERTY,Exempt,0,0,0,0,0,0
142825901200000,CITY PROPERTY,Exempt,0,0,0,0,0,0
142825901300000,CITY PROPERTY,Exempt,0,0,0,0,0,0
142825901400000,CITY PROPERTY,Exempt,0,0,0,0,0,0
142825901500000,CITY PROPERTY,Exempt,0,0,0,0,0,0
142825901600000,SW 401,Residential,11250,0,11250,39551,0,50801
142825901700000,SW 401,Residential,11250,0,11250,65723,0,76973
142825901800000,SW 401,Residential,11250,0,11250,49639,0,60889
142825901900000,SW 401,Residential,5456,0,5456,31164,0,36620
142825902000000,CITY PROPERTY,Exempt,0,0,0,0,0,0
142825902100000,SW 401,Residential,11250,0,11250,44396,0,55646
142825902200000,SW 401,Residential,5625,0,5625,31411,0,37036
142825902300000,SW 401,Residential,5625,0,5625,33184,0,38809
142825902400000,CITY PROPERTY,Exempt,0,0,0,0,0,0
142825902500000,CITY PROPERTY,Exempt,0,0,0,0,0,0
142825902600000,SW 401,Residential,4860,0,4860,21810,0,26670
142825902700000,SW 401,Residential,4743,0,4743,39396,0,44139
142825902800000,SW 401,Residential,7672,0,7672,42371,0,50043
142826000100000,SW 403,Residential,15061,0,15061,39610,0,54671
142826000200000,SW 403,Residential,8860,0,8860,50259,0,59119
142826000300000,SW 403,Residential,8775,0,8775,38146,0,46921
142826000400000,SW 403,Residential,5000,0,5000,0,0,5000
142826000500000,CITY PROPERTY,Exempt,0,0,0,0,0,0
142826000600000,CITY PROPERTY,Exempt,0,0,0,0,0,0
142826000700000,SW 403,Residential,1721,0,1721,0,0,1721
142826100100000,SW 401,Residential,10251,0,10251,68595,0,78846
142827600100000,CITY PROPERTY,Exempt,0,0,0,0,0,0
142827600200000,CITY PROPERTY,Exempt,0,0,0,0,0,0
142827600300000,CITY PROPERTY,Exempt,0,0,0,0,0,0
142827600400000,CITY PROPERTY,Exempt,0,0,0,0,0,0
142827700100000,BRNCH BK/CR; CTRL CR,Commercial,0,146016,146016,0,142991,289007
142827800100000,OFFICE; MED; CTRL CR,Commercial,0,7349,7349,0,0,7349
142827800200000,FLAT PARKING,Commercial,0,8748,8748,0,4428,13176
142827800300000,CITY PROPERTY,Exempt,0,0,0,0,0,0
142827800400000,FLAT PARKING,Commercial,0,56700,56700,0,35014,91714
142827800500000,SHOP,Commercial,0,16884,16884,0,0,16884
142827800600000,FLAT PARKING,Commercial,0,13608,13608,0,835,14443
142827800700000,SHOP,Commercial,0,10886,10886,0,0,10886
142827800800000,AUTO REP/SAL;CTRL CR,Commercial,0,17418,17418,0,0,17418
142827800900000,CITY PROPERTY,Exempt,0,0,0,0,0,0
142827801000000,CITY PROPERTY,Exempt,0,0,0,0,0,0
142827801100000,CITY PROPERTY,Exempt,0,0,0,0,0,0
142827801200000,CITY PROPERTY,Exempt,0,0,0,0,0,0
142827801300000,CITY PROPERTY,Exempt,0,0,0,0,0,0
142827801400000,CITY PROPERTY,Exempt,0,0,0,0,0,0
142827801500000,CITY PROPERTY,Exempt,0,0,0,0,0,0
142827900100000,WAREHOUSE; CTRL CR,Commercial,0,64152,64152,0,34739,98891
142827900200000,CITY PROPERTY,Exempt,0,0,0,0,0,0
142827900300000,VACANT LAND,Commercial,0,38006,38006,0,0,38006
142827900400000,COUNTY PROPERTY,Exempt,0,0,0,0,0,0
142827900500000,COUNTY PROPERTY,Exempt,0,0,0,0,0,0
142827900600000,COUNTY PROPERTY,Exempt,0,0,0,0,0,0
142827900700000,SHOP,Exempt,0,0,0,0,0,0
142827900800000,COUNTY PROPERTY,Exempt,0,0,0,0,0,0
142828000100000,SMALL RET; CTRL CR,Commercial,0,5759,5759,0,0,5759
142828000200000,SW 401,Residential,3302,0,3302,0,0,3302
142828000300000,SW 401,Residential,3906,0,3906,0,0,3906
142828000400000,SW 401,Residential,5000,0,5000,0,0,5000
142828000500000,SW 401,Residential,5198,0,5198,31629,0,36827
142828000600000,SW 401,Residential,3720,0,3720,0,0,3720
142828000700000,SW 401,Residential,5000,0,5000,0,0,5000
142828000800000,CITY PROPERTY,Exempt,0,0,0,0,0,0
142828000900000,SW 401,Residential,5000,0,5000,0,0,5000
142828001000000,SW 401,Residential,5760,0,5760,24061,0,29821
142828001100000,CONVERSION,Commercial,0,5103,5103,0,29572,34675
142828001200000,SW 401,Residential,8100,0,8100,20561,0,28661
142828001300000,SW 401,Residential,5040,0,5040,30017,0,35057
142828001400000,SW 401,Residential,3780,0,3780,19907,0,23687
142828001500000,OFFICE,Commercial,0,82555,82555,0,313821,396376
142828002000000,SW 401,Residential,4500,0,4500,0,0,4500
142828002100000,SW 401,Residential,3235,0,3235,0,0,3235
142828100100000,SW 401,Residential,5161,0,5161,45802,0,50963
142828100200000,SW 401,Residential,4603,0,4603,35897,0,40500
142828100300000,SW 401,Residential,7481,0,7481,61758,0,69239
142828100400000,SW 401,Residential,7481,0,7481,51930,0,59411
142828100500000,SW 401,Residential,2025,0,2025,1304,0,3329
142828100600000,CONVERSION,Commercial,0,2551,2551,0,45678,48229
142828100700000,SW 401,Residential,6750,0,6750,19329,0,26079
142828100800000,CONVERSION,Commercial,0,5433,5433,0,51168,56601
142828100900000,CONVERSION,Commercial,0,3937,3937,0,32450,36387
142828200100000,CITY PROPERTY,Exempt,0,0,0,0,0,0
142828300100000,CONVERSION,Commercial,0,9720,9720,0,57233,66953
142828300200000,SW 401,Residential,7440,0,7440,46074,0,53514
142828300300000,SW 401,Exempt,0,18000,18000,0,85721,103721
142828300700000,SMALL RETAIL,Commercial,0,91465,91465,0,300533,391998
142828301000000,SMALL RETAIL,Commercial,0,72576,72576,0,60135,132711
142828301200000,SHOP,Commercial,0,32659,32659,0,53211,85870
142828301300000,SMALL RETAIL,Commercial,0,11794,11794,0,37901,49695
142828301400000,SW 401,Residential,9000,0,9000,44880,0,53880
142828400100000,CITY PROPERTY,Exempt,0,0,0,0,0,0
142830100100000,SW 401,Residential,7812,0,7812,36209,0,44021
142830100200000,CITY PROPERTY,Exempt,0,0,0,0,0,0
142830200100000,OFFICE,Commercial,0,79834,79834,0,163357,243191
142830200200000,SW 401,Residential,8078,0,8078,0,0,8078
142830200500000,SW 401,Residential,16830,0,16830,37472,0,54302
142830200600000,SW 401,Residential,15000,0,15000,62778,0,77778
142830200700000,SW 401,Residential,15000,0,15000,56294,0,71294
142830200800000,SW 401,Residential,15000,0,15000,37407,0,52407
142830200900000,FLAT PARKING,Commercial,0,26006,26006,0,10475,36481
142830201000000,VACANT LAND,Commercial,0,2708,2708,0,0,2708
142830201100000,SW 401,Residential,4109,0,4109,28222,0,32331
142830201200000,VACANT LAND,Commercial,0,5638,5638,0,0,5638
142830201300000,VACANT LAND,Commercial,0,10212,10212,0,0,10212
142830201400000,VACANT LAND,Commercial,0,6382,6382,0,0,6382
142830201500000,VACANT LAND,Commercial,0,30240,30240,0,0,30240
142830300100000,SW 401,Residential,13356,0,13356,66125,0,79481
142830300200000,SW 401,Residential,13536,0,13536,64308,0,77844
142830300300000,CITY PROPERTY,Exempt,0,0,0,0,0,0
142830300400000,CITY PROPERTY,Exempt,0,0,0,0,0,0
142830300500000,CITY PROPERTY,Exempt,0,0,0,0,0,0
142830300600000,SW 401,Residential,6480,0,6480,49367,0,55847
142830300700000,SW 401,Residential,5000,0,5000,0,0,5000
142830400100000,FOOD GRADE;INDUST,Industrial,0,260550,260550,0,662603,923153
142830500100000,RESTAURANT,Commercial,0,23328,23328,0,37418,60746
142830500500000,CENTRALLY ASSESSED,Other,0,0,0,0,0,0
142830500600000,FLAT PARKING,Commercial,0,1782,1782,0,0,1782
142830500700000,FLAT PARKING,Commercial,0,31104,31104,0,7322,38426
142830500800000,BRANCH BANK/CU,Commercial,0,118973,118973,0,570527,689500
142830600100000,SMALL RETAIL,Commercial,0,3833,3833,0,36457,40290
142830600200000,SW 401,Residential,10306,0,10306,37748,0,48054
142830600300000,SW 401,Residential,7161,0,7161,33296,0,40457
142830600400000,CITY PROPERTY,Exempt,0,0,0,0,0,0
142830600500000,CITY PROPERTY,Exempt,0,0,0,0,0,0
142830600600000,SW 401,Residential,5000,0,5000,0,0,5000
142830600800000,CITY PROPERTY,Exempt,0,0,0,0,0,0
142830600900000,APARTMENT,Commercial,0,9526,9526,0,20000,29526
142830601000000,SMALL RETAIL,Commercial,0,9526,9526,0,28710,38236
142830601100000,SW 401,Residential,5000,0,5000,0,0,5000
142830601200000,SW 401,Residential,11880,0,11880,25891,0,37771
142830601300000,SW 401,Residential,5580,0,5580,24519,0,30099
142830601400000,SW 401,Residential,3348,0,3348,0,0,3348
142830601500000,SW 401,Residential,8370,0,8370,36281,0,44651
142830601600000,SW 401,Residential,9300,0,9300,31571,0,40871
142830601700000,SW 401,Residential,9000,0,9000,47934,0,56934
142830601800000,CITY PROPERTY,Exempt,0,0,0,0,0,0
142830601900000,SW 401,Residential,12000,0,12000,49511,0,61511
142830602000000,SW 401,Residential,12000,0,12000,71626,0,83626
142830602100000,SW 401,Residential,16484,0,16484,48449,0,64933
142830701200000,COUNTY PROPERTY,Exempt,0,0,0,0,0,0
142830800100000,FOOD GRADE;INDUST,Industrial,0,10724,10724,0,462911,473635
142830800200000,COUNTY PROPERTY,Exempt,0,0,0,0,0,0
142830900100000,FLAT PARKING,Commercial,0,27216,27216,0,0,27216
142830900102000,SMALL RETAIL,Commercial,0,0,0,0,150691,150691
142830900200000,VACANT LAND,Commercial,0,10964,10964,0,0,10964
142830900300000,COUNTY PROPERTY,Exempt,0,0,0,0,0,0
142830900400000,COUNTY PROPERTY,Exempt,0,0,0,0,0,0
142830900500000,OFFICE,Commercial,0,14742,14742,0,5206,19948
142830900600000,CITY PROPERTY,Exempt,0,0,0,0,0,0
142830900700000,COUNTY PROPERTY,Exempt,0,0,0,0,0,0
142830900800000,SHOP,Commercial,0,20412,20412,0,51637,72049
142830900900000,FLAT PARKING,Commercial,0,27216,27216,0,0,27216
142830901000000,COUNTY PROPERTY,Exempt,0,0,0,0,0,0
142831000100000,FOOD GRADE;INDUST,Industrial,0,15390,15390,0,45990,61380
142831000200000,FOOD GRADE;INDUST,Industrial,0,17658,17658,0,59850,77508
142831100100000,CITY PROPERTY,Exempt,0,0,0,0,0,0
142831100200000,SW 402,Residential,5580,0,5580,41090,0,46670
142831100300000,SW 402,Residential,5000,0,5000,0,0,5000
142831100400000,SW 402,Residential,5000,0,5000,0,0,5000
142831100500000,SW 402,Residential,4619,0,4619,22422,0,27041
142831100600000,CITY PROPERTY,Exempt,0,0,0,0,0,0
142831100700000,CITY PROPERTY,Exempt,0,0,0,0,0,0
142831100800000,SW 402,Residential,11493,0,11493,46505,0,57998
142831100900000,SW 402,Residential,8200,0,8200,0,0,8200
142831101000000,CITY PROPERTY,Exempt,0,0,0,0,0,0
142831101100000,SMALL RETAIL,Exempt,0,14580,14580,0,106697,121277
142831200100000,BARS/LOUNGE,Commercial,0,27216,27216,0,47508,74724
142831300100000,CENTRALLY ASSESSED,Other,0,0,0,0,0,0
142832600100000,STATE PROPERTY,Exempt,0,0,0,0,0,0
142832600200000,SW 401,Residential,11576,0,11576,30392,0,41968
142832600300000,CITY PROPERTY,Exempt,0,0,0,0,0,0
142832600400000,SW 401,Residential,9963,0,9963,30175,0,40138
142832600500000,STATE PROPERTY,Exempt,0,0,0,0,0,0
142832700300000,CONVERSION,Commercial,0,5103,5103,0,56102,61205
142832700400000,SW 403,Residential,5000,0,5000,0,0,5000
142832700500000,SW 403,Residential,13294,0,13294,38682,0,51976
142832700600000,SW 403,Residential,5000,0,5000,0,0,5000
142832700700000,SW 403,Residential,5000,0,5000,0,0,5000
142832700800000,CITY PROPERTY,Exempt,0,0,0,0,0,0
142832700900000,SW 403,Residential,10226,0,10226,0,0,10226
142832701000000,SW 403,Residential,5000,0,5000,0,0,5000
142832701100000,AUTO REPAIR/SALES,Commercial,0,39511,39511,0,92542,132053
142832701200000,FLAT PARKING,Commercial,0,12960,12960,0,8996,21956
142832701300000,CONVENIENCE STORE,Commercial,0,37645,37645,0,155050,192695
142832701400000,SW 403,Residential,19305,0,19305,57951,0,77256
142832800100000,SW 403,Residential,5000,0,5000,0,0,5000
142832800200000,SW 403,Residential,11590,0,11590,52058,0,63648
142832800300000,SW 403,Residential,5000,0,5000,0,0,5000
142832800400000,SW 403,Residential,15453,0,15453,57765,0,73218
142832800500000,SW 403,Residential,14137,0,14137,59291,0,73428
142832800600000,CONVERSION,Commercial,0,4406,4406,0,38580,42986
142832800700000,SW 403,Residential,12852,0,12852,45609,0,58461
142832800800000,SW 403,Residential,9371,0,9371,54001,0,63372
142832800900000,CONVERSION,Commercial,0,6378,6378,0,52268,58646
142832801000000,SW 403,Residential,18697,0,18697,45291,0,63988
142832801100000,SW 403,Residential,17384,0,17384,61044,0,78428
142832801200000,SW 403,Residential,11590,0,11590,57690,0,69280
142832801300000,SW 403,Residential,5000,0,5000,0,0,5000
142832801400000,SW 403,Residential,11217,0,11217,46121,0,57338
142832801500000,SW 403,Residential,5000,0,5000,0,0,5000
142832801600000,SW 403,Residential,5000,0,5000,0,0,5000
142832801700000,CITY PROPERTY,Exempt,0,0,0,0,0,0
142832900100000,SW 403,Residential,5000,0,5000,0,0,5000
142832900200000,SW 403,Residential,10226,0,10226,44538,0,54764
142832900300000,CITY PROPERTY,Exempt,0,0,0,0,0,0
142832900400000,SW 403,Residential,14998,0,14998,26045,0,41043
142832900500000,SW 403,Residential,5000,0,5000,0,0,5000
142832900600000,CONVERSION,Commercial,0,9040,9040,0,42547,51587
142832900700000,CONVERSION,Commercial,0,9040,9040,0,53817,62857
142832900800000,SW 403,Residential,10908,0,10908,51325,0,62233
142832900900000,SW 403,Residential,21859,0,21859,50376,0,72235
142832901000000,SW 403,Residential,5000,0,5000,0,0,5000
142832901100000,SW 403,Residential,9686,0,9686,39883,0,49569
142833000100000,SW 403,Residential,16362,0,16362,55962,0,72324
142833000200000,VACANT LAND,Commercial,0,24106,24106,0,0,24106
142833000300000,SW 403,Residential,16362,0,16362,59470,0,75832
142833000400000,SW 403,Residential,10226,0,10226,59902,0,70128
142833000500000,CITY PROPERTY,Exempt,0,0,0,0,0,0
142833000600000,SW 403,Residential,14282,0,14282,63883,0,78165
142833000700000,VACANT LAND,Residential,8756,0,8756,0,0,8756
142833000800000,SW 403,Residential,10226,0,10226,36621,0,46847
142833000900000,SW 403,Residential,10226,0,10226,33686,0,43912
142833001000000,CONVERSION,Commercial,0,9040,9040,0,40461,49501
142833001100000,CONVERSION,Commercial,0,2644,2644,0,32116,34760
142833001200000,SW 403,Residential,10226,0,10226,53888,0,64114
142833001300000,CONVERSION,Commercial,0,6853,6853,0,48375,55228
142833001400000,CITY PROPERTY,Exempt,0,0,0,0,0,0
142833100100000,CITY PROPERTY,Exempt,0,0,0,0,0,0
142833100200000,CITY PROPERTY,Exempt,0,0,0,0,0,0
142833100300000,SW 403,Residential,18209,0,18209,61178,0,79387
142833100400000,SW 403,Residential,16419,0,16419,60243,0,76662
142833100500000,SW 403,Residential,17384,0,17384,81702,0,99086
142833100600000,SW 403,Residential,16971,0,16971,66783,0,83754
142833100700000,SW 403,Residential,10710,0,10710,51632,0,62342
142833100800000,SW 403,Residential,11573,0,11573,52216,0,63789
142833100900000,CITY PROPERTY,Exempt,0,0,0,0,0,0
142833101000000,CITY PROPERTY,Exempt,0,0,0,0,0,0
142833101100000,SW 403,Residential,5000,0,5000,0,0,5000
142833101200000,SW 403,Residential,15453,0,15453,60701,0,76154
142833101300000,SW 403,Residential,5000,0,5000,0,0,5000
142833101400000,SW 403,Residential,15453,0,15453,53798,0,69251
142833101500000,SW 403,Residential,15269,0,15269,61897,0,77166
142833101600000,CITY PROPERTY,Exempt,0,0,0,0,0,0
142833101700000,SW 403,Residential,14344,0,14344,53100,0,67444
142833101800000,SW 403,Residential,19881,0,19881,55318,0,75199
142833101900000,CITY PROPERTY,Exempt,0,0,0,0,0,0
142833102000000,SW 403,Residential,18073,0,18073,59118,0,77191
142833102100000,SW 403,Residential,12049,0,12049,26770,0,38819
142833102200000,CITY PROPERTY,Exempt,0,0,0,0,0,0
142833200100000,CONVERSION,Commercial,0,9040,9040,0,74897,83937
142833200200000,SW 403,Residential,16362,0,16362,53653,0,70015
142833200300000,SW 403,Residential,9204,0,9204,0,0,9204
142833200400000,SW 403,Residential,11249,0,11249,0,0,11249
142833200500000,SW 403,Residential,10226,0,10226,39355,0,49581
142833200600000,CITY PROPERTY,Exempt,0,0,0,0,0,0
142833200700000,CONVERSION,Commercial,0,5400,5400,0,0,5400
142833200800000,CONVERSION,Commercial,0,8587,8587,0,55558,64145
142833200900000,SW 403,Residential,13635,0,13635,53419,0,67054
142833201000000,SW 403,Residential,13635,0,13635,57902,0,71537
142833201100000,CITY PROPERTY,Exempt,0,0,0,0,0,0
142833201200000,SW 403,Residential,15340,0,15340,0,0,15340
142833201300000,SW 403,Residential,14974,0,14974,47348,0,62322
142833201400000,CITY PROPERTY,Exempt,0,0,0,0,0,0
142833201500000,CONVERSION,Commercial,0,14563,14563,0,56564,71127
142833201600000,SW 403,Residential,8505,0,8505,27414,0,35919
142833201700000,SW 403,Residential,5000,0,5000,0,0,5000
142833201800000,SW 403,Residential,13635,0,13635,51503,0,65138
142833201900000,SW 403,Residential,13635,0,13635,47567,0,61202
142833202000000,SW 403,Residential,13635,0,13635,38685,0,52320
142833202100000,SW 403,Residential,13635,0,13635,33471,0,47106
142833202200000,SW 403,Residential,15544,0,15544,79376,0,94920
142833202300000,SW 403,Residential,13635,0,13635,43928,0,57563
142833202400000,CITY PROPERTY,Exempt,0,0,0,0,0,0
142833202500000,SW 403,Residential,13635,0,13635,36737,0,50372
142833202600000,SW 403,Residential,16362,0,16362,62331,0,78693
142833202700000,SW 403,Residential,5000,0,5000,0,0,5000
142833300100000,CHURCH,Exempt,0,20412,20412,0,154581,174993
142833300200000,SW 403,Residential,12240,0,12240,61348,0,73588
142833300300000,SW 403,Residential,13923,0,13923,37553,0,51476
142833300400000,SW 403,Residential,13230,0,13230,0,0,13230
142833300500000,SW 403,Residential,15912,0,15912,61480,0,77392
142833300600000,CITY PROPERTY,Exempt,0,0,0,0,0,0
142833300700000,VACANT LAND,Commercial,0,22918,22918,0,0,22918
142833300800000,CHURCH,Exempt,0,15139,15139,0,3730,18869
142833300900000,CHURCH,Exempt,0,15184,15184,0,1906,17090
142833301000000,SW 403,Residential,20884,0,20884,0,0,20884
142833301100000,CHURCH,Exempt,0,19505,19505,0,4816,24321
142833400100000,SW 403,Residential,10710,0,10710,53648,0,64358
142833400200000,SW 403,Residential,12485,0,12485,51139,0,63624
142833400300000,SW 403,Residential,15453,0,15453,81147,0,96600
142833400400000,SW 403,Residential,5000,0,5000,0,0,5000
142833400500000,SW 403,Residential,15453,0,15453,68210,0,83663
142833400600000,SW 403,Residential,15453,0,15453,13565,0,29018
142833400700000,SW 403,Residential,15453,0,15453,54338,0,69791
142833400800000,CITY PROPERTY,Exempt,0,0,0,0,0,0
142833400900000,SW 403,Residential,12620,0,12620,62299,0,74919
142833401000000,WAREHOUSE;MINI STORG,Commercial,0,27978,27978,0,70152,98130
142833401100000,SHOP,Commercial,0,14890,14890,0,118776,133666
142833401200000,SW 403,Residential,15453,0,15453,52686,0,68139
142833401300000,SW 403,Residential,15453,0,15453,59055,0,74508
142833401400000,SW 403,Residential,15453,0,15453,61658,0,77111
142833401500000,SW 403,Residential,15453,0,15453,55565,0,71018
142833401600000,SW 403,Residential,15453,0,15453,54485,0,69938
142833500100000,SW 403,Residential,17860,0,17860,64065,0,81925
142833500200000,SW 403,Residential,13635,0,13635,48860,0,62495
142833500300000,SW 403,Residential,13635,0,13635,73863,0,87498
142833500400000,SW 403,Residential,13635,0,13635,67985,0,81620
142833500500000,SW 403,Residential,13635,0,13635,48857,0,62492
142833500600000,SW 403,Residential,13635,0,13635,61315,0,74950
142833500700000,SW 403,Residential,13635,0,13635,57068,0,70703
142833500800000,SW 403,Residential,13635,0,13635,41268,0,54903
142833500900000,VACANT LAND,Commercial,0,8035,8035,0,0,8035
142833501000000,SW 403,Residential,13635,0,13635,51609,0,65244
142833501100000,CITY PROPERTY,Exempt,0,0,0,0,0,0
142833501200000,SW 403,Residential,13635,0,13635,56990,0,70625
142833501300000,SW 403,Residential,14317,0,14317,53984,0,68301
142833501400000,SW 403,Residential,14165,0,14165,0,0,14165
142833501500000,SW 403,Residential,14317,0,14317,62477,0,76794
142833501600000,SW 403,Residential,14317,0,14317,29555,0,43872
142833501700000,SW 403,Residential,13635,0,13635,20488,0,34123
142833501800000,SW 403,Residential,5000,0,5000,0,0,5000
142833501900000,SW 403,Residential,13635,0,13635,51210,0,64845
142833502000000,SW 403,Residential,13635,0,13635,63745,0,77380
142833502100000,SW 403,Residential,5000,0,5000,0,0,5000
142833502200000,SW 403,Residential,13635,0,13635,38607,0,52242
142833502300000,SW 403,Residential,13635,0,13635,59844,0,73479
142833502400000,SW 403,Residential,13635,0,13635,59146,0,72781
142833502500000,SW 403,Residential,13635,0,13635,69138,0,82773
142833502600000,SW 403,Residential,13635,0,13635,61444,0,75079
142833502700000,SW 403,Residential,13635,0,13635,60758,0,74393
142833502800000,SW 403,Residential,11249,0,11249,52051,0,63300
142833502900000,SW 403,Residential,10226,0,10226,54959,0,65185
142833503000000,SW 403,Residential,10840,0,10840,53187,0,64027
142833600100000,VACANT LAND,Commercial,0,14493,14493,0,0,14493
142833600200000,SW 403,Residential,12150,0,12150,15280,0,27430
142833600300000,SW 403,Residential,12960,0,12960,61766,0,74726
142833600400000,SW 403,Residential,13439,0,13439,31758,0,45197
142833600500000,SW 403,Residential,13635,0,13635,0,0,13635
142833600600000,SW 403,Residential,13635,0,13635,36339,0,49974
142833600700000,SW 403,Residential,13635,0,13635,45260,0,58895
142833600800000,SW 403,Residential,5000,0,5000,0,0,5000
142833600900000,SW 403,Residential,13635,0,13635,57470,0,71105
142833601000000,SW 403,Residential,13635,0,13635,57330,0,70965
142833601100000,SW 403,Residential,13635,0,13635,45090,0,58725
142833601200000,SW 403,Residential,5000,0,5000,0,0,5000
142833601300000,FLAT PARKING,Commercial,0,22499,22499,0,1088,23587
142833700100000,VACANT LAND,Commercial,0,196425,196425,0,0,196425
142833700200000,CENTRALLY ASSESSED,Other,0,0,0,0,0,0
142833700300000,CENTRALLY ASSESSED,Other,0,0,0,0,0,0
142835100100000,VACANT LAND,Commercial,0,32938,32938,0,0,32938
142835100200000,SW 403,Residential,13770,0,13770,29771,0,43541
142835100300000,SW 403,Residential,9584,0,9584,0,0,9584
142835100400000,CITY PROPERTY,Exempt,0,0,0,0,0,0
142835100500000,SW 403,Residential,13770,0,13770,41902,0,55672
142835100600000,SW 403,Residential,16524,0,16524,39351,0,55875
142835100700000,CITY PROPERTY,Exempt,0,0,0,0,0,0
142835100800000,CITY PROPERTY,Exempt,0,0,0,0,0,0
142835100900000,SW 403,Residential,13770,0,13770,55512,0,69282
142835101000000,SW 403,Residential,9181,0,9181,32211,0,41392
142835101100000,SW 403,Residential,5000,0,5000,0,0,5000
142835101200000,SW 403,Residential,16066,0,16066,38283,0,54349
142835101400000,SW 403,Residential,13770,0,13770,31241,0,45011
142835101500000,SW 403,Residential,13770,0,13770,0,0,13770
142835101600000,SW 403,Residential,13770,0,13770,0,0,13770
142835101700000,SW 403,Residential,13770,0,13770,41440,0,55210
142835101800000,FLAT PARKING,Commercial,0,16459,16459,0,0,16459
142835200100000,SW 403,Residential,13635,0,13635,68902,0,82537
142835200200000,SW 403,Residential,5000,0,5000,0,0,5000
142835200300000,CITY PROPERTY,Exempt,0,0,0,0,0,0
142835200400000,SW 403,Residential,5000,0,5000,0,0,5000
142835200500000,CITY PROPERTY,Exempt,0,0,0,0,0,0
142835200600000,SW 403,Residential,13635,0,13635,44712,0,58347
142835200700000,SW 403,Residential,13635,0,13635,29863,0,43498
142835200800000,SW 403,Residential,13635,0,13635,42126,0,55761
142835200900000,SW 403,Residential,13635,0,13635,56952,0,70587
142835201000000,SW 403,Residential,13635,0,13635,52900,0,66535
142835201100000,CITY PROPERTY,Exempt,0,0,0,0,0,0
142835201200000,SW 403,Residential,13635,0,13635,0,0,13635
142835201300000,SW 403,Residential,13635,0,13635,32285,0,45920
142835201400000,SW 403,Residential,5000,0,5000,0,0,5000
142835201500000,SW 403,Residential,8181,0,8181,0,0,8181
142835201600000,SW 403,Residential,13635,0,13635,0,0,13635
142835201700000,SW 403,Residential,13635,0,13635,0,0,13635
142835201800000,SW 403,Residential,13635,0,13635,0,0,13635
142835300100000,CENTRALLY ASSESSED,Other,0,0,0,0,0,0
142835300400000,CITY PROPERTY,Exempt,0,0,0,0,0,0
142835300500000,CITY PROPERTY,Exempt,0,0,0,0,0,0
142835300600000,CITY PROPERTY,Exempt,0,0,0,0,0,0
142835300700000,CITY PROPERTY,Exempt,0,0,0,0,0,0
142835400100000,VACANT LAND,Commercial,0,6204,6204,0,0,6204
142835400200000,WAREHOUSE,Commercial,0,64281,64281,0,21157,85438
142835400300000,CENTRALLY ASSESSED,Other,0,0,0,0,0,0
142835500100000,SW 403,Residential,6065,0,6065,0,0,6065
142835500200000,SW 403,Residential,7700,0,7700,35912,0,43612
142835500300000,CITY PROPERTY,Exempt,0,0,0,0,0,0
142835500400000,SW 403,Residential,5000,0,5000,0,0,5000
142835500500000,SW 403,Residential,5000,0,5000,0,0,5000
142835500600000,SW 403,Residential,15606,0,15606,53951,0,69557
142835500700000,SW 403,Residential,15606,0,15606,0,0,15606
142835500800000,SW 403,Residential,18298,0,18298,45140,0,63438
142835500900000,SW 403,Residential,15606,0,15606,61059,0,76665
142835501000000,SW 403,Residential,5000,0,5000,0,0,5000
142835501100000,CITY PROPERTY,Exempt,0,0,0,0,0,0
142835501200000,SW 403,Residential,15606,0,15606,37303,0,52909
142835501300000,SW 403,Residential,15606,0,15606,4675,0,20281
142835501400000,SW 403,Residential,16581,0,16581,23190,0,39771
142835501500000,SW 403,Residential,5172,0,5172,0,0,5172
142835501600000,SW 403,Residential,5000,0,5000,0,0,5000
142835501700000,SW 403,Residential,15606,0,15606,44895,0,60501
142835501800000,SW 403,Residential,15606,0,15606,52762,0,68368
142835501900000,SW 403,Residential,5000,0,5000,0,0,5000
142835502000000,SW 403,Residential,18727,0,18727,37134,0,55861
142835502100000,SW 403,Residential,15606,0,15606,58265,0,73871
142835502200000,SW 403,Residential,15606,0,15606,42599,0,58205
142835502300000,SW 403,Residential,15606,0,15606,21721,0,37327
142835502400000,SW 403,Residential,5000,0,5000,0,0,5000
142835600100000,SW 403,Residential,20861,0,20861,88902,0,109763
142835600200000,CITY PROPERTY,Exempt,0,0,0,0,0,0
142835600300000,SW 403,Residential,15453,0,15453,37323,0,52776
142835600400000,SW 403,Residential,15453,0,15453,23421,0,38874
142835600500000,SW 403,Residential,15453,0,15453,54854,0,70307
142835600600000,SW 403,Residential,15453,0,15453,49979,0,65432
142835600700000,SW 403,Residential,15453,0,15453,53610,0,69063
142835600800000,SW 403,Residential,15453,0,15453,48252,0,63705
142835600900000,SW 403,Residential,15453,0,15453,50377,0,65830
142835601000000,SW 403,Residential,5000,0,5000,0,0,5000
142835601100000,SW 403,Residential,14680,0,14680,9953,0,24633
142835601200000,CITY PROPERTY,Exempt,0,0,0,0,0,0
142835601300000,SW 403,Residential,16419,0,16419,49017,0,65436
142835601400000,SW 403,Residential,15453,0,15453,56422,0,71875
142835601500000,SW 403,Residential,15453,0,15453,33927,0,49380
142835601600000,SW 403,Residential,15453,0,15453,0,0,15453
142835601700000,SW 403,Residential,15453,0,15453,0,0,15453
142835601800000,SW 403,Residential,15453,0,15453,0,0,15453
142835601900000,SW 403,Residential,15453,0,15453,29852,0,45305
142835602000000,SW 403,Residential,15453,0,15453,54125,0,69578
142835602100000,CITY PROPERTY,Exempt,0,0,0,0,0,0
142835700100000,SW 403,Residential,20655,0,20655,67360,0,88015
142835700200000,CITY PROPERTY,Exempt,0,0,0,0,0,0
142835700300000,SW 403,Residential,20655,0,20655,22533,0,43188
142835700400000,SW 403,Residential,17213,0,17213,55497,0,72710
142835700500000,SW 403,Residential,17213,0,17213,59911,0,77124
142835700600000,SW 403,Residential,17213,0,17213,45998,0,63211
142835700700000,SW 403,Residential,17213,0,17213,59504,0,76717
142835700800000,SW 403,Residential,20655,0,20655,44307,0,64962
142835700900000,SW 403,Residential,20655,0,20655,47428,0,68083
142835701000000,SW 403,Residential,18360,0,18360,60094,0,78454
142835701100000,SW 403,Residential,18360,0,18360,43742,0,62102
142835701200000,SW 403,Residential,18360,0,18360,56889,0,75249
142835701300000,CITY PROPERTY,Exempt,0,0,0,0,0,0
142835701400000,SW 403,Residential,18360,0,18360,45843,0,64203
142835800100000,SW 403,Residential,17044,0,17044,44842,0,61886
142835800200000,SW 403,Residential,20452,0,20452,96099,0,116551
142835800300000,SW 403,Residential,20452,0,20452,47774,0,68226
142835800400000,SW 403,Residential,20452,0,20452,61489,0,81941
142835800500000,SW 403,Residential,20452,0,20452,57990,0,78442
142835800600000,SW 403,Residential,20452,0,20452,45611,0,66063
142835800700000,SW 403,Residential,20452,0,20452,90848,0,111300
142835800800000,SW 403,Residential,22725,0,22725,72082,0,94807
142835800900000,SW 403,Residential,22725,0,22725,61854,0,84579
142835801000000,CITY PROPERTY,Exempt,0,0,0,0,0,0
142835801100000,SW 403,Residential,17044,0,17044,53575,0,70619
142835801200000,SW 403,Residential,17044,0,17044,38453,0,55497
142835801300000,CITY PROPERTY,Exempt,0,0,0,0,0,0
142837600100000,SW 402,Residential,12000,0,12000,57256,0,69256
142837600200000,SW 402,Residential,24000,0,24000,58836,0,82836
142837600300000,SW 402,Residential,12000,0,12000,44496,0,56496
142837600400000,SW 402,Residential,12600,0,12600,30865,0,43465
142837600500000,SW 402,Residential,9765,0,9765,40868,0,50633
142837600600000,SW 402,Residential,9000,0,9000,58971,0,67971
142837600700000,SW 402,Residential,13500,0,13500,44173,0,57673
142837600800000,SW 402,Residential,13500,0,13500,28778,0,42278
142837600900000,SW 402,Residential,18000,0,18000,0,0,18000
142837601000000,SW 402,Residential,9000,0,9000,27394,0,36394
142837601100000,SW 402,Residential,9000,0,9000,21909,0,30909
142837700100000,SW 402,Residential,13390,0,13390,0,0,13390
142837700200000,SW 402,Residential,6840,0,6840,0,0,6840
142837700300000,CONVERSION,Commercial,0,5400,5400,0,0,5400
142837700400000,SW 402,Residential,8190,0,8190,39853,0,48043
142837700500000,SW 402,Residential,8190,0,8190,0,0,8190
142837700600000,APARTMENT,Exempt,0,10109,10109,0,156195,166304
142837700700000,CONVERSION,Commercial,0,5832,5832,0,38268,44100
142837700800000,SW 402,Residential,14880,0,14880,41854,0,56734
142837700900000,CITY PROPERTY,Exempt,0,0,0,0,0,0
142837701000000,CITY PROPERTY,Exempt,0,0,0,0,0,0
142837701100000,SW 402,Residential,4867,0,4867,24407,0,29274
142837701200000,SW 402,Residential,6697,0,6697,25502,0,32199
142837701500000,CITY PROPERTY,Exempt,0,0,0,0,0,0
142837701600000,SW 402,Residential,11250,0,11250,0,0,11250
142837701700000,CITY PROPERTY,Exempt,0,0,0,0,0,0
142837701800000,SW 402,Residential,13500,0,13500,68714,0,82214
142837800100000,VACANT LAND,Commercial,0,17496,17496,0,0,17496
142837800200000,SW 402,Residential,15147,0,15147,30870,0,46017
142837800300000,SW 402,Residential,5000,0,5000,0,0,5000
142837800400000,SW 402,Residential,7573,0,7573,27237,0,34810
142837800500000,SW 402,Residential,7573,0,7573,31952,0,39525
142837800600000,APARTMENT,Commercial,0,8529,8529,0,66305,74834
142837900100000,SW 402,Residential,14100,0,14100,57392,0,71492
142837900200000,SW 402,Residential,5000,0,5000,0,0,5000
142837900300000,SW 402,Residential,12000,0,12000,70937,0,82937
142837900400000,SW 402,Residential,12600,0,12600,28542,0,41142
142838000100000,CITY PROPERTY,Exempt,0,0,0,0,0,0
142838000200000,SW 402,Residential,10650,0,10650,44839,0,55489
142838000300000,SW 402,Residential,10080,0,10080,36745,0,46825
142838000400000,SW 402,Residential,11040,0,11040,31269,0,42309
142838000500000,SW 402,Residential,11838,0,11838,33708,0,45546
142838000600000,SW 402,Residential,12000,0,12000,36968,0,48968
142838000700000,SW 402,Residential,9000,0,9000,49821,0,58821
142838000800000,SW 402,Residential,5000,0,5000,0,0,5000
142838000900000,SW 402,Residential,9000,0,9000,39334,0,48334
142838001000000,SW 402,Residential,6750,0,6750,1555,0,8305
142838001100000,SW 402,Residential,8000,0,8000,0,0,8000
142838001200000,SW 402,Residential,18000,0,18000,64281,0,82281
142838001300000,SW 402,Residential,17000,0,17000,57813,0,74813
142838001400000,SW 402,Residential,13662,0,13662,51948,0,65610
142838001500000,SW 402,Residential,7831,0,7831,0,0,7831
142838001600000,SW 402,Residential,9672,0,9672,39315,0,48987
142838100100000,SW 402,Residential,12060,0,12060,44149,0,56209
142838100200000,SW 402,Residential,7440,0,7440,48417,0,55857
142838100300000,SW 402,Residential,6510,0,6510,38918,0,45428
142838100400000,SW 402,Residential,12144,0,12144,76147,0,88291
142838100500000,SW 402,Residential,12392,0,12392,61812,0,74204
142838100600000,CITY PROPERTY,Exempt,0,0,0,0,0,0
142838100700000,SW 402,Residential,13860,0,13860,0,0,13860
142838100800000,SW 402,Residential,11840,0,11840,0,0,11840
142838100900000,SW 402,Residential,16380,0,16380,46945,0,63325
142838101000000,SW 402,Residential,16380,0,16380,37065,0,53445
142838101100000,SW 402,Residential,18000,0,18000,53810,0,71810
142838101200000,SW 402,Residential,9000,0,9000,28576,0,37576
142838101300000,SW 402,Residential,9000,0,9000,45645,0,54645
142838101400000,SW 402,Residential,18000,0,18000,69560,0,87560
142838101500000,SW 402,Residential,18000,0,18000,53072,0,71072
142838200100000,CITY PROPERTY,Exempt,0,0,0,0,0,0
142838200200000,SW 402,Residential,10204,0,10204,0,0,10204
142838200300000,SW 402,Residential,13023,0,13023,48628,0,61651
142838200400000,SW 402,Residential,9149,0,9149,36584,0,45733
142838200500000,SW 402,Residential,8905,0,8905,39275,0,48180
142838200600000,SW 402,Residential,5000,0,5000,0,0,5000
142838200700000,SW 402,Residential,9996,0,9996,0,0,9996
142838200800000,CITY PROPERTY,Exempt,0,0,0,0,0,0
142838200900000,SW 402,Residential,6739,0,6739,18774,0,25513
142838201000000,SW 402,Residential,10472,0,10472,47428,0,57900
142838300100000,SW 402,Residential,14580,0,14580,60155,0,74735
142838300200000,SW 402,Residential,5000,0,5000,0,0,5000
142838300300000,CITY PROPERTY,Exempt,0,0,0,0,0,0
142838300400000,SW 402,Residential,7500,0,7500,0,0,7500
142838300500000,SW 402,Residential,10500,0,10500,44395,0,54895
142838300600000,SW 402,Residential,18000,0,18000,49303,0,67303
142838300700000,SW 402,Residential,9600,0,9600,38985,0,48585
142838300800000,CITY PROPERTY,Exempt,0,0,0,0,0,0
142838300900000,CITY PROPERTY,Exempt,0,0,0,0,0,0
142838301000000,SW 402,Residential,5000,0,5000,0,0,5000
142838301100000,SW 402,Residential,18360,0,18360,46456,0,64816
142838301200000,SW 402,Residential,9180,0,9180,54522,0,63702
142838301300000,SW 402,Residential,5000,0,5000,0,0,5000
142838301400000,SW 402,Residential,8808,0,8808,66257,0,75065
142838301500000,SW 402,Residential,9552,0,9552,46342,0,55894
142838301600000,SW 402,Residential,18360,0,18360,46400,0,64760
142838400100000,SW 402,Residential,18000,0,18000,65676,0,83676
142838400200000,SW 402,Residential,10920,0,10920,45637,0,56557
142838400300000,SW 402,Residential,10920,0,10920,42640,0,53560
142838400400000,CITY PROPERTY,Exempt,0,0,0,0,0,0
142838400500000,SW 402,Residential,14490,0,14490,30611,0,45101
142838400600000,SW 402,Residential,1890,0,1890,12659,0,14549
142838400700000,SW 402,Residential,14742,0,14742,47971,0,62713
142838400800000,SW 402,Residential,16805,0,16805,85652,0,102457
142838400900000,SW 402,Residential,5000,0,5000,0,0,5000
142838401000000,CITY PROPERTY,Exempt,0,0,0,0,0,0
142838401100000,SW 402,Residential,15750,0,15750,0,0,15750
142838401200000,SW 402,Residential,18000,0,18000,33504,0,51504
142838500100000,CITY PROPERTY,Exempt,0,0,0,0,0,0
142838500200000,SW 402,Residential,11900,0,11900,59415,0,71315
142838500300000,SW 402,Residential,12239,0,12239,63807,0,76046
142838500400000,SW 402,Residential,7021,0,7021,60854,0,67875
142838500500000,SW 402,Residential,10647,0,10647,0,0,10647
142838500600000,SW 402,Residential,12352,0,12352,0,0,12352
142838500700000,SW 402,Residential,17280,0,17280,55934,0,73214
142838500800000,SW 402,Residential,17280,0,17280,60461,0,77741
142838500900000,CITY PROPERTY,Exempt,0,0,0,0,0,0
142838600100000,SW 402,Residential,18360,0,18360,59426,0,77786
142838600200000,CONVERSION,Commercial,0,10206,10206,0,40674,50880
142838600300000,SW 402,Residential,6000,0,6000,0,0,6000
142838600400000,SW 402,Residential,12000,0,12000,56894,0,68894
142838600500000,SW 402,Residential,13500,0,13500,50477,0,63977
142838600600000,SW 402,Residential,19890,0,19890,61382,0,81272
142838600700000,SW 402,Residential,18360,0,18360,64538,0,82898
142838700100000,SW 402,Residential,18240,0,18240,71529,0,89769
142838700200000,SW 402,Residential,13020,0,13020,76977,0,89997
142838700300000,SW 402,Residential,12600,0,12600,38247,0,50847
142838700400000,SW 402,Residential,12600,0,12600,56131,0,68731
142838700500000,SW 402,Residential,22680,0,22680,65039,0,87719
142838700600000,SW 402,Residential,14560,0,14560,76593,0,91153
142838700700000,SW 402,Residential,13832,0,13832,54338,0,68170
142838700800000,SW 402,Residential,26000,0,26000,86485,0,112485
142838700900000,SW 402,Residential,24000,0,24000,76167,0,100167
142838800100000,SW 402,Residential,17100,0,17100,73241,0,90341
142838800200000,SW 402,Residential,17100,0,17100,62074,0,79174
142838800300000,SW 402,Residential,17100,0,17100,58043,0,75143
142838800400000,SW 402,Residential,19145,0,19145,118130,0,137275
142840100100000,BARS/LOUNGE,Commercial,0,108864,108864,0,262196,371060
142840200100000,BARS/LOUNGE; CTRL CR,Commercial,0,23587,23587,0,106919,130506
142840200200000,SMALL RET; CTRL CR,Commercial,0,10886,10886,0,128244,139130
142840200300000,SE 237,Residential,5000,0,5000,0,0,5000
142840200400000,LITERARY/LIBRARY/ART,Exempt,0,6615,6615,0,0,6615
142840200500000,CITY PROPERTY,Exempt,0,0,0,0,0,0
142840200600000,SE 237,Residential,2400,0,2400,0,0,2400
142840200700000,VACANT LAND,Commercial,0,27216,27216,0,0,27216
142840200800000,SE 237,Residential,5000,0,5000,0,0,5000
142840200900000,SMALL RET; CTRL CR,Commercial,0,7394,7394,0,25000,32394
142840201000000,WAREHOUSE; CTRL CR,Commercial,0,29030,29030,0,33757,62787
142840201100000,SHOP,Commercial,0,10127,10127,0,30505,40632
142840300100000,CITY PROPERTY,Exempt,0,0,0,0,0,0
142840300200000,CENTRALLY ASSESSED,Other,0,0,0,0,0,0
142840400200000,RESTAURANT,Commercial,0,177228,177228,0,192863,370091
142840400300000,CITY PROPERTY,Exempt,0,0,0,0,0,0
142840400400000,SE 237,Residential,3000,0,3000,23253,0,26253
142840400500000,CITY PROPERTY,Exempt,0,0,0,0,0,0
142840400600000,FUNERAL HOME,Commercial,0,17690,17690,0,78926,96616
142840400700000,CARWASH,Commercial,0,21773,21773,0,19720,41493
142840400800000,WAREHOUSE,Commercial,0,21773,21773,0,36617,58390
142840500100000,CITY PROPERTY,Exempt,0,0,0,0,0,0
142840500200000,VACANT LAND,Commercial,0,16524,16524,0,0,16524
142840500300000,VACANT LAND,Commercial,0,14969,14969,0,0,14969
142840500400000,CITY PROPERTY,Exempt,0,0,0,0,0,0
142840500500000,SE 237,Residential,3000,0,3000,0,0,3000
142840500600000,SE 237,Residential,2250,0,2250,0,0,2250
142840500700000,BARS/LOUNGE,Commercial,0,23950,23950,0,11050,35000
142840600100000,CITY PROPERTY,Exempt,0,0,0,0,0,0
142840600200000,FRATERNAL,Exempt,0,166860,166860,0,904298,1071158
142840600300000,CITY PROPERTY,Exempt,0,0,0,0,0,0
142840600400000,CITY PROPERTY,Exempt,0,0,0,0,0,0
142840600500000,CITY PROPERTY,Exempt,0,0,0,0,0,0
142840600600000,CITY PROPERTY,Exempt,0,0,0,0,0,0
142840600700000,CITY PROPERTY,Exempt,0,0,0,0,0,0
142840600800000,FRATERNAL,Commercial,0,104112,104112,0,287167,391279
142840600900000,SE 237,Residential,1980,0,1980,50410,0,52390
142840601000000,CITY PROPERTY,Exempt,0,0,0,0,0,0
142840601100000,SE 237,Residential,3000,0,3000,0,0,3000
142840601200000,CITY PROPERTY,Exempt,0,0,0,0,0,0
142840601300000,CITY PROPERTY,Exempt,0,0,0,0,0,0
142840601400000,CITY PROPERTY,Exempt,0,0,0,0,0,0
142840601500000,SE 237,Residential,3000,0,3000,0,0,3000
142840601600000,SMALL RETAIL,Commercial,0,10930,10930,0,0,10930
142840700100000,CITY PROPERTY,Exempt,0,0,0,0,0,0
142840700200000,CITY PROPERTY,Exempt,0,0,0,0,0,0
142840700300000,CITY PROPERTY,Exempt,0,0,0,0,0,0
142842600100000,FOOD GRADE;INDUST,Industrial,0,688122,688122,0,9237454,9925576
142842700100000,FOOD GRADE;INDUST,Industrial,0,54108,54108,0,1280127,1334235
142842800100000,CENTRALLY ASSESSED,Other,0,0,0,0,0,0
142845100100000,CITY PROPERTY,Exempt,0,0,0,0,0,0
142845100200000,FOOD GRADE;INDUST,Industrial,0,8764,8764,0,23625,32389
142845200100000,SW 402,Residential,24000,0,24000,84653,0,108653
142845200200000,SW 402,Residential,24000,0,24000,71911,0,95911
142845300100000,SW 402,Residential,5000,0,5000,0,0,5000
142845300200000,SW 402,Residential,13080,0,13080,53201,0,66281
142845300300000,SW 402,Residential,12720,0,12720,58449,0,71169
142845300400000,SW 402,Residential,15150,0,15150,48998,0,64148
142845300500000,SW 402,Residential,13950,0,13950,57912,0,71862
142845300600000,SW 402,Residential,5000,0,5000,0,0,5000
142845400100000,SERVICE STATION,Commercial,0,9112,9112,0,0,9112
142845400200000,SW 402,Residential,10912,0,10912,33725,0,44637
142845400300000,SW 402,Residential,17080,0,17080,30894,0,47974
142845400400000,SW 402,Residential,12408,0,12408,38142,0,50550
142845400500000,SW 402,Residential,14159,0,14159,0,0,14159
142845400600000,SW 402,Residential,14600,0,14600,60213,0,74813
142845400700000,SW 402,Residential,17600,0,17600,50205,0,67805
142845400800000,CITY PROPERTY,Exempt,0,0,0,0,0,0
142845400900000,CITY PROPERTY,Exempt,0,0,0,0,0,0
142845500100000,SW 402,Residential,22400,0,22400,75009,0,97409
142845500200000,SW 402,Residential,5400,0,5400,3834,0,9234
142845500300000,CITY PROPERTY,Exempt,0,0,0,0,0,0
142845500400000,SW 402,Residential,20400,0,20400,86591,0,106991
142845500500000,SW 402,Residential,14880,0,14880,72123,0,87003
142845500600000,SW 402,Residential,9728,0,9728,70676,0,80404
142845500700000,SW 402,Residential,8512,0,8512,59252,0,67764
142845500800000,SW 402,Residential,12000,0,12000,73114,0,85114
142845500900000,SW 402,Residential,12000,0,12000,44506,0,56506
142845501000000,SW 402,Residential,24000,0,24000,99544,0,123544
142845501100000,SW 402,Residential,24320,0,24320,84203,0,108523
142845600100000,CITY PROPERTY,Exempt,0,0,0,0,0,0
142845600200000,SW 402,Residential,22453,0,22453,65380,0,87833
142845600300000,SW 402,Residential,18920,0,18920,102370,0,121290
142845600400000,SW 402,Residential,14740,0,14740,62837,0,77577
142845600500000,OFFICE,Commercial,0,82166,82166,0,201408,283574
142845700100000,SW 402,Residential,10200,0,10200,28094,0,38294
142845700200000,SW 402,Residential,20400,0,20400,66441,0,86841
142845700300000,SW 402,Residential,20400,0,20400,94928,0,115328
142845700400000,APARTMENT,Commercial,0,9720,9720,0,86237,95957
142845700500000,SW 402,Residential,17600,0,17600,31903,0,49503
142845700600000,SW 402,Residential,17600,0,17600,84157,0,101757
142845700700000,SW 402,Residential,17600,0,17600,46883,0,64483
142845700800000,SW 402,Residential,17600,0,17600,62231,0,79831
142845700900000,SW 402,Residential,12320,0,12320,56141,0,68461
142845701000000,SW 402,Residential,22880,0,22880,55845,0,78725
142845701100000,SW 402,Residential,20400,0,20400,66040,0,86440
142845701200000,SW 402,Residential,20400,0,20400,71353,0,91753
142845701300000,SW 402,Residential,20400,0,20400,60776,0,81176
142845701400000,SW 402,Residential,20400,0,20400,41741,0,62141
142845701500000,CONVERSION,Commercial,0,13436,13436,0,56636,70072
142845701600000,SW 402,Residential,16120,0,16120,56602,0,72722
142845701700000,SW 402,Residential,16400,0,16400,45750,0,62150
142845701800000,SW 402,Residential,16613,0,16613,42697,0,59310
142845701900000,SW 402,Residential,16720,0,16720,32465,0,49185
142845800100000,SW 402,Residential,5000,0,5000,0,0,5000
142845800200000,SW 402,Residential,12900,0,12900,71972,0,84872
142845800300000,SW 402,Residential,13305,0,13305,53043,0,66348
142845800400000,CITY PROPERTY,Exempt,0,0,0,0,0,0
142845800500000,SW 402,Residential,5000,0,5000,0,0,5000
142845800600000,SW 402,Residential,11550,0,11550,56656,0,68206
142845800700000,SW 402,Residential,5000,0,5000,0,0,5000
142845800800000,SW 402,Residential,17280,0,17280,0,0,17280
142845800900000,SW 402,Residential,11160,0,11160,51921,0,63081
142845801000000,SW 402,Residential,14880,0,14880,58631,0,73511
142845801100000,SW 402,Residential,5000,0,5000,0,0,5000
142845801200000,SW 402,Residential,14122,0,14122,48744,0,62866
142845801300000,CONVERSION,Commercial,0,8420,8420,0,75863,84283
142845801400000,SW 402,Residential,19847,0,19847,58417,0,78264
142845801500000,SW 402,Residential,14305,0,14305,52225,0,66530
142845801600000,SW 402,Residential,7788,0,7788,38658,0,46446
142845801700000,CITY PROPERTY,Exempt,0,0,0,0,0,0
142845801800000,SW 402,Residential,8928,0,8928,39949,0,48877
142845801900000,SW 402,Residential,425,0,425,0,0,425
142845900100000,CITY PROPERTY,Exempt,0,0,0,0,0,0
142845900200000,CITY PROPERTY,Exempt,0,0,0,0,0,0
142845900300000,CITY PROPERTY,Exempt,0,0,0,0,0,0
142845900400000,SW 402,Residential,12672,0,12672,0,0,12672
142845900500000,SW 402,Residential,12672,0,12672,0,0,12672
142845900600000,SW 402,Residential,28109,0,28109,79684,0,107793
142845900700000,SW 402,Residential,17440,0,17440,65944,0,83384
142845900800000,SW 402,Residential,15717,0,15717,70364,0,86081
142845900900000,SW 402,Residential,13920,0,13920,57492,0,71412
142845901000000,SW 402,Residential,14080,0,14080,70956,0,85036
142845901100000,CITY PROPERTY,Exempt,0,0,0,0,0,0
142845901200000,CITY PROPERTY,Exempt,0,0,0,0,0,0
142845901300000,CITY PROPERTY,Exempt,0,0,0,0,0,0
142845901400000,SW 402,Residential,24000,0,24000,79225,0,103225
142845901500000,SW 402,Residential,13986,0,13986,7398,0,21384
142845901600000,SW 402,Residential,13986,0,13986,43834,0,57820
142846000100000,SW 402,Residential,14880,0,14880,69692,0,84572
142846000200000,SW 402,Residential,9920,0,9920,72203,0,82123
142846000300000,SW 402,Residential,26600,0,26600,59303,0,85903
142846000400000,SW 402,Residential,15200,0,15200,66584,0,81784
142846000500000,SW 402,Residential,11200,0,11200,71466,0,82666
142846000600000,SW 402,Residential,11200,0,11200,51267,0,62467
142846000700000,SW 402,Residential,15200,0,15200,81564,0,96764
142846000800000,SW 402,Residential,26600,0,26600,114527,0,141127
142846000900000,SW 402,Residential,15200,0,15200,65260,0,80460
142846001000000,SW 402,Residential,22800,0,22800,74477,0,97277
142846001100000,SW 402,Residential,20088,0,20088,67953,0,88041
142846001200000,SW 402,Residential,19920,0,19920,69049,0,88969
142846001300000,SW 402,Residential,25920,0,25920,70520,0,96440
142846001400000,SW 402,Residential,12960,0,12960,59222,0,72182
142846001500000,SW 402,Residential,12880,0,12880,60386,0,73266
142846001600000,SW 402,Residential,8589,0,8589,36555,0,45144
142846001700000,SW 402,Residential,12531,0,12531,43657,0,56188
142846100100000,SW 402,Residential,19110,0,19110,69357,0,88467
142846100200000,SW 402,Residential,16174,0,16174,62258,0,78432
142846100300000,SW 402,Residential,14280,0,14280,28709,0,42989
142846100400000,SW 402,Residential,20124,0,20124,31216,0,51340
142846100500000,SW 402,Residential,14400,0,14400,36488,0,50888
142846100600000,CITY PROPERTY,Exempt,0,0,0,0,0,0
142846100700000,SW 402,Residential,12825,0,12825,40231,0,53056
142846100800000,SW 402,Residential,12825,0,12825,47938,0,60763
142846100900000,SW 402,Residential,12330,0,12330,41792,0,54122
142846101000000,SW 402,Residential,13110,0,13110,49200,0,62310
142846101100000,SW 402,Residential,13110,0,13110,50116,0,63226
142846101200000,SW 402,Residential,13248,0,13248,53135,0,66383
142846101300000,SW 402,Residential,15916,0,15916,39463,0,55379
142846200100000,SW 402,Residential,8400,0,8400,33041,0,41441
142846200200000,SW 402,Residential,8742,0,8742,51344,0,60086
142846200300000,SW 402,Residential,4185,0,4185,32698,0,36883
142846300100000,SW 402,Residential,22800,0,22800,77692,0,100492
142846300200000,SW 402,Residential,14080,0,14080,53592,0,67672
142846300300000,SW 402,Residential,22528,0,22528,71744,0,94272
142846300400000,SW 402,Residential,12240,0,12240,29001,0,41241
142846300500000,SW 402,Residential,21200,0,21200,46520,0,67720
142846300600000,SW 402,Residential,21200,0,21200,55249,0,76449
142846300700000,SW 402,Residential,21200,0,21200,55011,0,76211
142846300800000,SW 402,Residential,21200,0,21200,59237,0,80437
142846400100000,SW 402,Residential,15675,0,15675,40111,0,55786
142846500100000,SW 402,Residential,14250,0,14250,53927,0,68177
142846500200000,SW 402,Residential,11400,0,11400,18096,0,29496
142846500300000,SW 402,Residential,13674,0,13674,35203,0,48877
142846500400000,SW 402,Residential,18000,0,18000,73241,0,91241
142847600100000,CITY PROPERTY,Exempt,0,0,0,0,0,0
142847600200000,CITY PROPERTY,Exempt,0,0,0,0,0,0
142847700100000,WAREHOUSE,Exempt,0,37260,37260,0,37812,75072
142847700200000,LITERARY/LIBRARY/ART,Exempt,0,207900,207900,0,882807,1090707
142847700300000,CITY PROPERTY,Exempt,0,0,0,0,0,0
142847800100000,CITY PROPERTY,Exempt,0,0,0,0,0,0
142847800300000,LITERARY/LIBRARY/ART,Exempt,0,70502,70502,0,0,70502
142847800400000,CITY PROPERTY,Exempt,0,0,0,0,0,0
142847800500000,CITY PROPERTY,Exempt,0,0,0,0,0,0
142847800600000,CITY PROPERTY,Exempt,0,0,0,0,0,0
142847800700000,CITY PROPERTY,Exempt,0,0,0,0,0,0
142847800800000,CITY PROPERTY,Exempt,0,0,0,0,0,0
142847800900000,WAREHOUSE,Commercial,0,24137,24137,0,80111,104248
142847801000000,CITY PROPERTY,Exempt,0,0,0,0,0,0
142847801100000,SMALL RETAIL,Commercial,0,25272,25272,0,327822,353094
142847801200000,CITY PROPERTY,Exempt,0,0,0,0,0,0
142847801300000,CITY PROPERTY,Exempt,0,0,0,0,0,0
142847801400000,LITERARY/LIBRARY/ART,Exempt,0,0,0,0,0,0
142847801500000,CITY PROPERTY,Exempt,0,0,0,0,0,0
142847900100000,OFFICE,Exempt,0,40608,40608,0,35407,76015
142847900200000,SMALL RETAIL,Commercial,0,29160,29160,0,21936,51096
142847900300000,FLAT PARKING,Commercial,0,32400,32400,0,4000,36400
142847900400000,SMALL RETAIL,Commercial,0,117720,117720,0,198664,316384
142847900500000,SMALL RETAIL,Commercial,0,14385,14385,0,75222,89607
142847900600000,BARS/LOUNGE,Commercial,0,12928,12928,0,112012,124940
142847900800000,SMALL RETAIL,Commercial,0,24300,24300,0,69438,93738
142847900900000,SW 402,Exempt,0,11956,11956,0,35713,47669
142847901000000,SMALL RETAIL,Commercial,0,9355,9355,0,22423,31778
142847901100000,OFFICE,Commercial,0,24300,24300,0,62773,87073
142847901200000,FRATERNAL,Exempt,0,32400,32400,0,534696,567096
142847901300000,RESTAURANT,Commercial,0,39137,39137,0,74636,113773
142847901400000,SMALL RETAIL,Commercial,0,14785,14785,0,116553,131338
142847901500000,SW 402,Residential,5000,0,5000,0,0,5000
142847901600000,OFFICE,Commercial,0,16848,16848,0,165021,181869
142847901800000,CITY PROPERTY,Exempt,0,0,0,0,0,0
142847901900000,CITY PROPERTY,Exempt,0,0,0,0,0,0
142847902000000,CITY PROPERTY,Exempt,0,0,0,0,0,0
142847902100000,CITY PROPERTY,Exempt,0,0,0,0,0,0
142847902200000,CITY PROPERTY,Exempt,0,0,0,0,0,0
142847902300000,CITY PROPERTY,Exempt,0,0,0,0,0,0
142847902400000,CITY PROPERTY,Exempt,0,0,0,0,0,0
142847902500000,WAREHOUSE,Commercial,0,12150,12150,0,3328,15478
142848000100000,CITY PROPERTY,Exempt,0,0,0,0,0,0
142848000200000,CITY PROPERTY,Exempt,0,0,0,0,0,0
142848000300000,CITY PROPERTY,Exempt,0,0,0,0,0,0
142848000400000,CITY PROPERTY,Exempt,0,0,0,0,0,0
142848000500000,SHOP,Commercial,0,12150,12150,0,50208,62358
142848000600000,CITY PROPERTY,Exempt,0,0,0,0,0,0
142848000700000,FLAT PARKING,Commercial,0,9936,9936,0,3404,13340
142848000800000,FLAT PARKING,Commercial,0,8748,8748,0,2160,10908
142848000900000,CITY PROPERTY,Exempt,0,0,0,0,0,0
142848001000000,CITY PROPERTY,Exempt,0,0,0,0,0,0
142848001100000,SMALL RETAIL,Commercial,0,24300,24300,0,65257,89557
142848001200000,SMALL RETAIL,Commercial,0,19440,19440,0,55798,75238
142848001300000,BARS/LOUNGE,Commercial,0,9720,9720,0,77200,86920
142848001400000,BARS/LOUNGE,Commercial,0,14728,14728,0,113735,128463
142848001500000,SMALL RETAIL,Commercial,0,9849,9849,0,42662,52511
142848001600000,SMALL RETAIL,Commercial,0,19440,19440,0,65950,85390
142848001700000,SMALL RETAIL,Commercial,0,24300,24300,0,87808,112108
142848001800000,SMALL RETAIL,Commercial,0,48600,48600,0,75199,123799
142848001900000,BARS/LOUNGE,Commercial,0,21870,21870,0,143316,165186
142848100100000,CITY PROPERTY,Exempt,0,0,0,0,0,0
142848100200000,CITY PROPERTY,Exempt,0,0,0,0,0,0
142848100300000,CITY PROPERTY,Exempt,0,0,0,0,0,0
142848100400000,SW 402,Residential,8800,0,8800,0,0,8800
142848100500000,CITY PROPERTY,Exempt,0,0,0,0,0,0
142848100600000,CITY PROPERTY,Exempt,0,0,0,0,0,0
142848100700000,CITY PROPERTY,Exempt,0,0,0,0,0,0
142848100800000,CITY PROPERTY,Exempt,0,0,0,0,0,0
142848100900000,CITY PROPERTY,Exempt,0,0,0,0,0,0
142848101000000,SW 402,Residential,8470,0,8470,0,0,8470
142848200300000,SW 402,Residential,5000,0,5000,0,0,5000
142848200400000,CITY PROPERTY,Exempt,0,0,0,0,0,0
142848200500000,SW 402,Residential,10560,0,10560,39063,0,49623
142848200600000,CITY PROPERTY,Exempt,0,0,0,0,0,0
142848200700000,SW 402,Residential,5000,0,5000,0,0,5000
142848200800000,CITY PROPERTY,Exempt,0,0,0,0,0,0
142848200900000,CITY PROPERTY,Exempt,0,0,0,0,0,0
142848201000000,CITY PROPERTY,Exempt,0,0,0,0,0,0
142848201100000,SW 402,Residential,10560,0,10560,0,0,10560
142848201200000,CITY PROPERTY,Exempt,0,0,0,0,0,0
142848201300000,CITY PROPERTY,Exempt,0,0,0,0,0,0
142848201400000,SW 402,Residential,9240,0,9240,0,0,9240
142848201500000,CITY PROPERTY,Exempt,0,0,0,0,0,0
142848201600000,CITY PROPERTY,Exempt,0,0,0,0,0,0
142848201700000,SW 402,Residential,3010,0,3010,0,0,3010
142848300100000,CITY PROPERTY,Exempt,0,0,0,0,0,0
142848300200000,SW 402,Residential,8330,0,8330,0,0,8330
142848300300000,VACANT LAND,Commercial,0,5000,5000,0,0,5000
142848300400000,CITY PROPERTY,Exempt,0,0,0,0,0,0
142848300500000,CITY PROPERTY,Exempt,0,0,0,0,0,0
142848300600000,SW 402,Residential,9240,0,9240,0,0,9240
142848300700000,CITY PROPERTY,Exempt,0,0,0,0,0,0
142848300800000,CITY PROPERTY,Exempt,0,0,0,0,0,0
142848300900000,SW 402,Residential,5400,0,5400,0,0,5400
142848301000000,CITY PROPERTY,Exempt,0,0,0,0,0,0
142848301100000,CITY PROPERTY,Exempt,0,0,0,0,0,0
142848301200000,SW 402,Residential,5000,0,5000,0,0,5000
142848301300000,SW 402,Residential,8800,0,8800,0,0,8800
142848301400000,CITY PROPERTY,Exempt,0,0,0,0,0,0
142848301500000,CITY PROPERTY,Exempt,0,0,0,0,0,0
142848301600000,CITY PROPERTY,Exempt,0,0,0,0,0,0
142848301700000,CITY PROPERTY,Exempt,0,0,0,0,0,0
142848400100000,CITY PROPERTY,Exempt,0,0,0,0,0,0
142848400200000,CITY PROPERTY,Exempt,0,0,0,0,0,0
142848400300000,CITY PROPERTY,Exempt,0,0,0,0,0,0
142848400400000,SW 402,Residential,11120,0,11120,0,0,11120
142848400500000,CITY PROPERTY,Exempt,0,0,0,0,0,0
142848500100000,CITY PROPERTY,Exempt,0,0,0,0,0,0
142848500200000,CITY PROPERTY,Exempt,0,0,0,0,0,0
142848500300000,CITY PROPERTY,Exempt,0,0,0,0,0,0
142848500400000,CITY PROPERTY,Exempt,0,0,0,0,0,0
142848500500000,CITY PROPERTY,Exempt,0,0,0,0,0,0
142848500600000,SW 402,Residential,7600,0,7600,0,0,7600
142848500700000,SW 402,Residential,13200,0,13200,61612,0,74812
142848500800000,SW 402,Residential,13200,0,13200,67257,0,80457
142848500900000,CITY PROPERTY,Exempt,0,0,0,0,0,0
142848501000000,SW 402,Residential,13200,0,13200,0,0,13200
142848501100000,CITY PROPERTY,Exempt,0,0,0,0,0,0
142848501200000,CITY PROPERTY,Exempt,0,0,0,0,0,0
142848600100000,SW 402,Residential,13200,0,13200,0,0,13200
142848600200000,CITY PROPERTY,Exempt,0,0,0,0,0,0
142848600300000,CITY PROPERTY,Exempt,0,0,0,0,0,0
142848600400000,CITY PROPERTY,Exempt,0,0,0,0,0,0
142848600500000,CITY PROPERTY,Exempt,0,0,0,0,0,0
142848600600000,WAREHOUSE,Commercial,0,16200,16200,0,60353,76553
142848600700000,CITY PROPERTY,Exempt,0,0,0,0,0,0
142848600800000,SW 402,Residential,13200,0,13200,61906,0,75106
142848600900000,CITY PROPERTY,Exempt,0,0,0,0,0,0
142848601000000,CITY PROPERTY,Exempt,0,0,0,0,0,0
142848601100000,SW 402,Residential,13200,0,13200,0,0,13200
142848601200000,SW 402,Residential,13200,0,13200,0,0,13200
142848700100000,AUTO REPAIR/SALES,Commercial,0,21436,21436,0,19935,41371
142848700200000,CITY PROPERTY,Exempt,0,0,0,0,0,0
142848700300000,SW 402,Residential,17000,0,17000,56207,0,73207
142848700400000,SW 402,Residential,18020,0,18020,62824,0,80844
142848700500000,CITY PROPERTY,Exempt,0,0,0,0,0,0
142848700600000,SMALL RETAIL,Commercial,0,32400,32400,0,49995,82395
142848700700000,SMALL RETAIL,Commercial,0,89424,89424,0,199148,288572
142848700800000,SW 402,Residential,11288,0,11288,50267,0,61555
142848700900000,SW 402,Residential,21270,0,21270,97275,0,118545
142848701000000,SW 402,Residential,26163,0,26163,0,0,26163
142848800100000,SMALL RETAIL,Commercial,0,18144,18144,0,61953,80097
142848800200000,SW 402,Residential,16520,0,16520,43203,0,59723
142848800300000,SW 402,Residential,23460,0,23460,1472,0,24932
142910100100000,CITY PROPERTY,Exempt,0,0,0,0,0,0
142910100200000,CITY PROPERTY,Exempt,0,0,0,0,0,0
142910100300000,CITY PROPERTY,Exempt,0,0,0,0,0,0
142910100400000,CITY PROPERTY,Exempt,0,0,0,0,0,0
142910100500000,OFFICE,Commercial,0,19116,19116,0,128568,147684
142910100600000,FLAT PARKING,Commercial,0,9936,9936,0,3634,13570
142910100700000,NW 318,Residential,5000,0,5000,0,0,5000
142910100800000,NW 318,Residential,5000,0,5000,0,0,5000
142910100900000,CITY PROPERTY,Exempt,0,0,0,0,0,0
142910101000000,CITY PROPERTY,Exempt,0,0,0,0,0,0
142910200100000,NW 318,Residential,5000,0,5000,0,0,5000
142910200200000,NW 318,Residential,6750,0,6750,26000,0,32750
142910200300000,NW 318,Residential,5000,0,5000,0,0,5000
142910200400000,CITY PROPERTY,Exempt,0,0,0,0,0,0
142910200500000,NW 318,Residential,5000,0,5000,0,0,5000
142910200600000,NW 318,Residential,4882,0,4882,36758,0,41640
142910200700000,NW 318,Residential,5000,0,5000,0,0,5000
142910200800000,NW 318,Residential,4882,0,4882,32413,0,37295
142910200900000,NW 318,Residential,5000,0,5000,0,0,5000
142910201000000,NW 318,Residential,13500,0,13500,61898,0,75398
142910201100000,APARTMENT,Exempt,0,6804,6804,0,79844,86648
142910201200000,CITY PROPERTY,Exempt,0,0,0,0,0,0
142910201300000,NW 318,Residential,9000,0,9000,47971,0,56971
142910201400000,NW 318,Residential,13500,0,13500,50243,0,63743
142910201500000,NW 318,Residential,9450,0,9450,34568,0,44018
142910201600000,CITY PROPERTY,Exempt,0,0,0,0,0,0
142910201700000,NW 318,Residential,6556,0,6556,32440,0,38996
142910300100000,CITY PROPERTY,Exempt,0,0,0,0,0,0
142910400100000,CITY PROPERTY,Exempt,0,0,0,0,0,0
142910400200000,AUTO REPAIR/SALES,Commercial,0,2171,2171,0,0,2171
142910400300000,CITY PROPERTY,Exempt,0,0,0,0,0,0
142910400400000,CENTRALLY ASSESSED,Other,0,0,0,0,0,0
142910400500000,CITY PROPERTY,Exempt,0,0,0,0,0,0
142910400600000,NW 318,Residential,7560,0,7560,0,0,7560
142910400700000,NW 318,Residential,5490,0,5490,18811,0,24301
142910400800000,CITY PROPERTY,Exempt,0,0,0,0,0,0
142910500300000,CENTRALLY ASSESSED,Other,0,0,0,0,0,0
142910600100000,CITY PROPERTY,Exempt,0,0,0,0,0,0
142910700100000,NW 318,Residential,3348,0,3348,0,0,3348
142910700200000,CITY PROPERTY,Exempt,0,0,0,0,0,0
142910700300000,NW 318,Residential,13500,0,13500,49733,0,63233
142910700400000,NW 318,Residential,13500,0,13500,36378,0,49878
142910700500000,NW 318,Residential,4882,0,4882,37537,0,42419
142910700600000,NW 318,Residential,4882,0,4882,38131,0,43013
142910700700000,NW 318,Residential,5580,0,5580,33602,0,39182
142910700800000,NW 318,Residential,5000,0,5000,0,0,5000
142910700900000,CITY PROPERTY,Exempt,0,0,0,0,0,0
142910701000000,CITY PROPERTY,Exempt,0,0,0,0,0,0
142910701100000,NW 318,Residential,10260,0,10260,31572,0,41832
142910701200000,NW 318,Residential,9000,0,9000,30953,0,39953
142910701300000,NW 318,Residential,9000,0,9000,34856,0,43856
142910701400000,NW 318,Residential,5000,0,5000,0,0,5000
142910701500000,CONVERSION,Commercial,0,5832,5832,0,0,5832
142910701600000,NW 318,Residential,9450,0,9450,33823,0,43273
142910701700000,CITY PROPERTY,Exempt,0,0,0,0,0,0
142910701800000,CITY PROPERTY,Exempt,0,0,0,0,0,0
142910701900000,CITY PROPERTY,Exempt,0,0,0,0,0,0
142910702000000,CITY PROPERTY,Exempt,0,0,0,0,0,0
142910702100000,NW 318,Residential,2530,0,2530,0,0,2530
142910800100000,NW 318,Residential,9450,0,9450,38233,0,47683
142910800200000,NW 318,Residential,9000,0,9000,0,0,9000
142910800300000,APARTMENT,Commercial,0,16330,16330,0,247314,263644
142910800400000,FLAT PARKING,Commercial,0,27095,27095,0,2880,29975
142910800500000,CITY PROPERTY,Exempt,0,0,0,0,0,0
142910800600000,FLAT PARKING,Industrial,0,1336,1336,0,0,1336
142910800700000,SHOP,Commercial,0,11008,11008,0,6363,17371
142910800800000,NW 318,Residential,13500,0,13500,54911,0,68411
142910800900000,CITY PROPERTY,Exempt,0,0,0,0,0,0
142910801000000,NW 318,Residential,9000,0,9000,51990,0,60990
142910801100000,NW 318,Residential,9000,0,9000,38572,0,47572
142910801200000,NW 318,Residential,4927,0,4927,35519,0,40446
142910801300000,NW 318,Residential,8550,0,8550,44549,0,53099
142910801400000,NW 318,Residential,10507,0,10507,38205,0,48712
142910801500000,NW 318,Residential,9765,0,9765,53234,0,62999
142910900100000,CITY PROPERTY,Exempt,0,0,0,0,0,0
142910900200000,CITY PROPERTY,Exempt,0,0,0,0,0,0
142910900300000,CITY PROPERTY,Exempt,0,0,0,0,0,0
142911000100000,CITY PROPERTY,Exempt,0,0,0,0,0,0
142911000200000,NW 318,Residential,9099,0,9099,36832,0,45931
142911000300000,NW 318,Residential,9225,0,9225,42106,0,51331
142911000600000,CITY PROPERTY,Exempt,0,0,0,0,0,0
142911000700000,CITY PROPERTY,Exempt,0,0,0,0,0,0
142911000800000,NW 318,Residential,4860,0,4860,31903,0,36763
142911000900000,NW 318,Residential,3780,0,3780,22932,0,26712
142911001000000,RESTAURANT,Commercial,0,70217,70217,0,93760,163977
142911001300000,NW 318,Residential,5400,0,5400,18438,0,23838
142911001400000,CITY PROPERTY,Exempt,0,0,0,0,0,0
142911001500000,CITY PROPERTY,Exempt,0,0,0,0,0,0
142911001600000,NW 318,Residential,5922,0,5922,53689,0,59611
142911001700000,SMALL RETAIL,Commercial,0,120238,120238,0,287208,407446
142911100100000,NW 318,Residential,4725,0,4725,37384,0,42109
142911100200000,NW 318,Residential,4725,0,4725,36987,0,41712
142911100300000,NW 318,Residential,9000,0,9000,47407,0,56407
142911100400000,NW 318,Residential,9000,0,9000,34802,0,43802
142911100500000,NW 318,Residential,9000,0,9000,23755,0,32755
142911100600000,NW 318,Residential,6750,0,6750,28090,0,34840
142911100700000,NW 318,Residential,5000,0,5000,0,0,5000
142911100800000,NW 318,Residential,13500,0,13500,21835,0,35335
142911101100000,CHURCH,Exempt,0,341345,341345,0,2272024,2613369
142911101200000,CHURCH,Exempt,0,8370,8370,0,2227,10597
142911101400000,CONVERSION,Commercial,0,10206,10206,0,67073,77279
142911101500000,NW 318,Residential,9000,0,9000,41533,0,50533
142911102100000,NW 318,Residential,6300,0,6300,20239,0,26539
142911102200000,NW 318,Residential,8505,0,8505,11106,0,19611
142911102300000,CITY PROPERTY,Exempt,0,0,0,0,0,0
142911102400000,NW 318,Residential,5000,0,5000,0,0,5000
142911200100000,WAREHOUSE,Commercial,0,87723,87723,0,106048,193771
142911200200000,VACANT LAND,Industrial,0,2462,2462,0,0,2462
142911200300000,NW 318,Residential,5000,0,5000,0,0,5000
142911200400000,CITY PROPERTY,Exempt,0,0,0,0,0,0
142911200500000,CITY PROPERTY,Exempt,0,0,0,0,0,0
142911200600000,NW 318,Residential,9000,0,9000,37808,0,46808
142911200700000,NW 318,Residential,6750,0,6750,1598,0,8348
142911200800000,NW 318,Residential,5000,0,5000,0,0,5000
142911200900000,CITY PROPERTY,Exempt,0,0,0,0,0,0
142911201000000,NW 318,Residential,9000,0,9000,36757,0,45757
142911201100000,FLAT PARKING,Commercial,0,18144,18144,0,4480,22624
142911300100000,EQUIPMENT MFG;INDUST,Industrial,0,21773,21773,0,5869,27642
142911400100000,SCHOOL,Exempt,0,0,0,0,0,0
142911400200000,SMALL RETAIL,Commercial,0,44335,44335,0,207297,251632
142911400300000,BRANCH BANK/CU,Commercial,0,102920,102920,0,225487,328407
142911400400000,SMALL RETAIL,Commercial,0,4724,4724,0,73534,78258
142911500100000,NW 318,Residential,9000,0,9000,35767,0,44767
142911500200000,NW 318,Residential,9000,0,9000,34595,0,43595
142911500300000,NW 318,Residential,9000,0,9000,39217,0,48217
142911500400000,NW 318,Residential,5000,0,5000,0,0,5000
142911500500000,NW 318,Residential,8775,0,8775,42133,0,50908
142911500600000,NW 318,Residential,9000,0,9000,40738,0,49738
142911500700000,NW 318,Residential,9000,0,9000,41922,0,50922
142911500800000,CONVERSION,Commercial,0,6804,6804,0,98014,104818
142911500900000,CITY PROPERTY,Exempt,0,0,0,0,0,0
142911501000000,EQUIPMENT MFG;INDUST,Industrial,0,12150,12150,0,0,12150
142911501100000,SMALL RETAIL,Commercial,0,27216,27216,0,114883,142099
142911501200000,SMALL RETAIL,Commercial,0,27216,27216,0,78264,105480
142911501300000,NW 318,Residential,7560,0,7560,38273,0,45833
142911501400000,CITY PROPERTY,Exempt,0,0,0,0,0,0
142911501500000,NW 318,Residential,5580,0,5580,46846,0,52426
142911501600000,FLAT PARKING,Commercial,0,10368,10368,0,3840,14208
142911501700000,OFFICE,Commercial,0,9072,9072,0,45507,54579
142911501800000,NW 318,Residential,7087,0,7087,31739,0,38826
142912700100000,CITY PROPERTY,Exempt,0,0,0,0,0,0
142912700200000,CITY PROPERTY,Exempt,0,0,0,0,0,0
142912700300000,NW 311,Residential,8400,0,8400,0,0,8400
142912700400000,NW 311,Residential,4080,0,4080,0,0,4080
142912700500000,NW 311,Residential,13600,0,13600,62845,0,76445
142912700600000,NW 311,Residential,13600,0,13600,59623,0,73223
142912700700000,NW 311,Residential,13600,0,13600,47358,0,60958
142912700800000,NW 311,Residential,9928,0,9928,55527,0,65455
142912700900000,NW 311,Residential,9520,0,9520,41547,0,51067
142912701000000,NW 311,Residential,7615,0,7615,56777,0,64392
142912701100000,NW 311,Residential,7913,0,7913,64337,0,72250
142912701200000,NW 311,Residential,7913,0,7913,49568,0,57481
142912701300000,NW 311,Residential,7913,0,7913,52180,0,60093
142912701400000,NW 311,Residential,7140,0,7140,67672,0,74812
142912701500000,NW 311,Residential,7140,0,7140,66403,0,73543
142912701600000,NW 311,Residential,10200,0,10200,39396,0,49596
142912701700000,CITY PROPERTY,Exempt,0,0,0,0,0,0
142912701800000,NW 311,Residential,10200,0,10200,51281,0,61481
142912701900000,NW 311,Residential,10200,0,10200,53484,0,63684
142912702000000,CITY PROPERTY,Exempt,0,0,0,0,0,0
142912702100000,NW 311,Residential,9200,0,9200,38261,0,47461
142912702200000,CITY PROPERTY,Exempt,0,0,0,0,0,0
142912702300000,CITY PROPERTY,Exempt,0,0,0,0,0,0
142912702400000,CITY PROPERTY,Exempt,0,0,0,0,0,0
142912800100000,CONVERSION,Commercial,0,12474,12474,0,86842,99316
142912800200000,NW 311,Residential,22000,0,22000,94224,0,116224
142912800300000,NW 311,Residential,25200,0,25200,105849,0,131049
142912800400000,NW 311,Residential,17560,0,17560,105016,0,122576
142912800500000,NW 311,Residential,12285,0,12285,70054,0,82339
142912800600000,NW 311,Residential,14175,0,14175,72718,0,86893
142912800700000,NW 311,Residential,15000,0,15000,80200,0,95200
142912800800000,NW 311,Residential,15000,0,15000,61004,0,76004
142912800900000,NW 311,Residential,15000,0,15000,116556,0,131556
142912801000000,NW 311,Residential,13500,0,13500,53017,0,66517
142912801100000,NW 311,Residential,6615,0,6615,71618,0,78233
142912900100000,NW 311,Residential,16600,0,16600,56487,0,73087
142912900200000,NW 311,Residential,20000,0,20000,37861,0,57861
142912900300000,NW 311,Residential,20000,0,20000,60035,0,80035
142912900400000,NW 311,Residential,20000,0,20000,51107,0,71107
142912900500000,NW 311,Residential,20000,0,20000,85876,0,105876
142912900600000,NW 311,Residential,20800,0,20800,55070,0,75870
142912900700000,NW 311,Residential,17967,0,17967,81995,0,99962
142912900800000,NW 311,Residential,17500,0,17500,101289,0,118789
142912900900000,NW 311,Residential,17500,0,17500,66491,0,83991
142912901000000,NW 311,Residential,14000,0,14000,56969,0,70969
142912901100000,NW 311,Residential,17500,0,17500,86833,0,104333
142912901200000,NW 311,Residential,21000,0,21000,85393,0,106393
142912901300000,NW 311,Residential,9450,0,9450,79028,0,88478
142913000100000,CENTRALLY ASSESSED,Exempt,0,0,0,0,0,0
142913000200000,NW 311,Residential,8032,0,8032,26963,0,34995
142913000300000,NW 311,Residential,7140,0,7140,44209,0,51349
142913000400000,NW 311,Residential,10200,0,10200,52150,0,62350
142913000500000,NW 311,Residential,10200,0,10200,51429,0,61629
142913000600000,NW 311,Residential,7459,0,7459,40727,0,48186
142913000700000,NW 311,Residential,7650,0,7650,47762,0,55412
142913000800000,CITY PROPERTY,Exempt,0,0,0,0,0,0
142913100100000,NW 311,Residential,10200,0,10200,62915,0,73115
142913100200000,NW 311,Residential,10200,0,10200,58480,0,68680
142913100300000,NW 311,Residential,10200,0,10200,46914,0,57114
142913100400000,NW 311,Residential,10200,0,10200,0,0,10200
142913100500000,NW 311,Residential,10200,0,10200,42826,0,53026
142913100600000,NW 311,Residential,8925,0,8925,49525,0,58450
142913100700000,NW 311,Residential,10200,0,10200,39868,0,50068
142913100800000,NW 311,Residential,6502,0,6502,45874,0,52376
142913100900000,NW 311,Residential,5865,0,5865,55543,0,61408
142913101000000,NW 311,Residential,5482,0,5482,44777,0,50259
142913101100000,CITY PROPERTY,Exempt,0,0,0,0,0,0
142913101200000,NW 311,Residential,7650,0,7650,43673,0,51323
142913101300000,NW 311,Residential,10200,0,10200,62234,0,72434
142913101400000,CITY PROPERTY,Exempt,0,0,0,0,0,0
142913101500000,NW 311,Residential,15300,0,15300,59740,0,75040
142913101600000,CITY PROPERTY,Exempt,0,0,0,0,0,0
142913101700000,CITY PROPERTY,Exempt,0,0,0,0,0,0
142913200100000,CONVERSION,Commercial,0,10206,10206,0,137455,147661
142913200200000,NW 311,Residential,15000,0,15000,90987,0,105987
142913200300000,NW 311,Residential,15000,0,15000,70775,0,85775
142913200400000,NW 311,Residential,15000,0,15000,70693,0,85693
142913200500000,NW 311,Residential,8100,0,8100,63814,0,71914
142913200600000,NW 311,Residential,8100,0,8100,39676,0,47776
142913200700000,NW 311,Residential,6480,0,6480,61068,0,67548
142913200800000,NW 311,Residential,15000,0,15000,56277,0,71277
142913200900000,NW 311,Residential,10500,0,10500,44435,0,54935
142913201000000,NW 311,Residential,9450,0,9450,0,0,9450
142913201100000,APARTMENT,Commercial,0,10206,10206,0,111552,121758
142913201200000,NW 311,Residential,15000,0,15000,82958,0,97958
142913300100000,NW 311,Residential,14580,0,14580,87667,0,102247
142913300200000,NW 311,Residential,15715,0,15715,84132,0,99847
142913300300000,NW 311,Residential,17500,0,17500,69831,0,87331
142913300400000,NW 311,Residential,17500,0,17500,56151,0,73651
142913300500000,NW 311,Residential,15575,0,15575,60212,0,75787
142913300600000,NW 311,Residential,12460,0,12460,30891,0,43351
142913300700000,NW 311,Residential,15575,0,15575,20896,0,36471
142913300800000,FRATERNAL,Exempt,0,130545,130545,0,304926,435471
142913300900000,NW 311,Residential,11400,0,11400,92593,0,103993
142913400100000,EQUIPMENT MFG;INDUST,Industrial,0,83543,83543,0,742019,825562
142913500100000,NW 311,Residential,7752,0,7752,68371,0,76123
142913500200000,NW 311,Residential,10200,0,10200,61665,0,71865
142913500300000,NW 311,Residential,10200,0,10200,63783,0,73983
142913500400000,NW 311,Residential,15300,0,15300,54047,0,69347
142913500500000,NW 311,Residential,15300,0,15300,58827,0,74127
142913500600000,NW 311,Residential,10200,0,10200,54729,0,64929
142913500700000,CITY PROPERTY,Exempt,0,0,0,0,0,0
142913500800000,CITY PROPERTY,Exempt,0,0,0,0,0,0
142913500900000,NW 311,Residential,12476,0,12476,50325,0,62801
142913501000000,NW 311,Residential,11507,0,11507,37850,0,49357
142913501100000,OFFICE,Commercial,0,28125,28125,0,39140,67265
142913501200000,NW 311,Residential,6885,0,6885,76345,0,83230
142913600100000,NW 311,Residential,10500,0,10500,67087,0,77587
142913600200000,NW 311,Residential,10800,0,10800,58536,0,69336
142913600300000,NW 311,Residential,12000,0,12000,66443,0,78443
142913600400000,NW 311,Residential,9000,0,9000,79265,0,88265
142913600500000,NW 311,Residential,12000,0,12000,39495,0,51495
142913600600000,NW 311,Residential,13200,0,13200,70360,0,83560
142913600700000,NW 311,Residential,6480,0,6480,65723,0,72203
142913600800000,NW 311,Residential,15000,0,15000,71849,0,86849
142913600900000,NW 311,Residential,15000,0,15000,59759,0,74759
142913601000000,NW 311,Residential,15000,0,15000,71161,0,86161
142913601100000,NW 311,Residential,15000,0,15000,74080,0,89080
142913601200000,NW 311,Residential,15000,0,15000,115927,0,130927
142913601400000,NW 311,Residential,8715,0,8715,67942,0,76657
142913601500000,CITY PROPERTY,Exempt,0,0,0,0,0,0
142913700100000,NW 311,Residential,17500,0,17500,75991,0,93491
142913700200000,NW 311,Residential,17500,0,17500,85828,0,103328
142913700300000,NW 311,Residential,17500,0,17500,77954,0,95454
142913700400000,NW 311,Residential,15000,0,15000,66722,0,81722
142913700500000,NW 311,Residential,15750,0,15750,69330,0,85080
142913700600000,NW 311,Residential,16100,0,16100,59789,0,75889
142913700700000,NW 311,Residential,21000,0,21000,50833,0,71833
142913700800000,NW 311,Residential,14000,0,14000,58901,0,72901
142913700900000,NW 311,Residential,14000,0,14000,73612,0,87612
142913701000000,NW 311,Residential,7735,0,7735,0,0,7735
142913701100000,NW 311,Residential,9100,0,9100,48712,0,57812
142913701200000,NW 311,Residential,16800,0,16800,55462,0,72262
142913701300000,NW 311,Residential,17500,0,17500,60529,0,78029
142913800100000,WAREHOUSE,Commercial,0,113400,113400,0,732906,846306
142913900100000,NW 311,Residential,12408,0,12408,61113,0,73521
142913900200000,NW 311,Residential,15000,0,15000,69019,0,84019
142913900300000,CHURCH,Exempt,0,22680,22680,0,299259,321939
142913900400000,NW 311,Residential,12144,0,12144,72967,0,85111
142913900500000,NW 311,Residential,12408,0,12408,60263,0,72671
142914000100000,DAY CARE CENTER,Exempt,0,22453,22453,0,409354,431807
142914000200000,CENTRALLY ASSESSED,Other,0,0,0,0,0,0
142914000300000,NW 311,Residential,17500,0,17500,63723,0,81223
142914000400000,NW 311,Residential,14525,0,14525,60217,0,74742
142914000500000,NW 311,Residential,14525,0,14525,67354,0,81879
142914000600000,NW 311,Residential,11620,0,11620,57199,0,68819
142915100100000,EQUIPMENT MFG;INDUST,Industrial,0,100165,100165,0,295575,395740
142915100200000,SMALL RETAIL,Commercial,0,108742,108742,0,143591,252333
142915100300000,WAREHOUSE,Commercial,0,20412,20412,0,14202,34614
142915100400000,NW 311,Residential,5000,0,5000,0,0,5000
142915100500000,NW 311,Residential,10944,0,10944,58688,0,69632
142915100600000,NW 311,Residential,10488,0,10488,52690,0,63178
142915100700000,NW 311,Residential,15200,0,15200,48663,0,63863
142915100800000,FLAT PARKING,Commercial,0,24192,24192,0,11340,35532
142915100900000,DAY CARE CENTER,Commercial,0,40824,40824,0,165148,205972
142915101000000,VACANT LAND,Commercial,0,9720,9720,0,180,9900
142915101100000,VACANT LAND,Commercial,0,4320,4320,0,0,4320
142915200100000,VACANT LAND,Commercial,0,8505,8505,0,0,8505
142915200200000,NW 311,Residential,9324,0,9324,37678,0,47002
142915200300000,NW 311,Residential,9804,0,9804,37704,0,47508
142915200400000,NW 311,Residential,11160,0,11160,53840,0,65000
142915200500000,NW 311,Residential,11760,0,11760,0,0,11760
142915300100000,NW 311,Residential,10563,0,10563,78195,0,88758
142915300200000,NW 311,Residential,1681,0,1681,0,0,1681
142915300300000,NW 311,Residential,8645,0,8645,57698,0,66343
142915300400000,CONVERSION,Commercial,0,6845,6845,0,60265,67110
142915300500000,NW 311,Residential,11025,0,11025,37467,0,48492
142915300600000,NW 311,Residential,9584,0,9584,45023,0,54607
142915300700000,NW 311,Residential,10500,0,10500,45590,0,56090
142915300800000,NW 311,Residential,5000,0,5000,38015,0,43015
142915300900000,NW 311,Residential,7500,0,7500,48811,0,56311
142915301000000,NW 311,Residential,13200,0,13200,62009,0,75209
142915301100000,NW 311,Residential,5000,0,5000,0,0,5000
142915301200000,NW 311,Residential,8400,0,8400,55596,0,63996
142915301300000,NW 311,Residential,7776,0,7776,66965,0,74741
142915400100000,CHURCH,Exempt,0,18978,18978,0,25276,44254
142915400200000,NW 311,Residential,19320,0,19320,40326,0,59646
142915400300000,NW 311,Residential,9660,0,9660,64226,0,73886
142915400400000,NW 311,Residential,9660,0,9660,45720,0,55380
142915400500000,NW 311,Residential,9660,0,9660,78372,0,88032
142915400600000,NW 311,Residential,9660,0,9660,51000,0,60660
142915400700000,NW 311,Residential,9660,0,9660,53460,0,63120
142915401000000,NW 311,Residential,11620,0,11620,57410,0,69030
142915401100000,NW 311,Residential,15400,0,15400,69610,0,85010
142915401200000,NW 311,Residential,12320,0,12320,50338,0,62658
142915401300000,NW 311,Residential,17500,0,17500,61573,0,79073
142915401400000,NW 311,Residential,17500,0,17500,76671,0,94171
142915401500000,NW 311,Residential,17500,0,17500,72384,0,89884
142915401600000,COUNTY PROPERTY,Exempt,0,0,0,0,0,0
142915401700000,NW 311,Residential,13524,0,13524,48595,0,62119
142915500100000,CITY PROPERTY,Exempt,0,0,0,0,0,0
142915500200000,NW 311,Residential,8640,0,8640,53914,0,62554
142915500300000,NW 311,Residential,14000,0,14000,64974,0,78974
142915500400000,NW 311,Residential,14000,0,14000,59737,0,73737
142915500500000,NW 311,Residential,12960,0,12960,89640,0,102600
142915500600000,NW 311,Residential,8640,0,8640,57007,0,65647
142915600100000,NW 311,Residential,10050,0,10050,66455,0,76505
142915600200000,NW 311,Residential,15000,0,15000,91084,0,106084
142915600300000,NW 311,Residential,9000,0,9000,57732,0,66732
142915600400000,NW 311,Residential,10500,0,10500,63857,0,74357
142915600500000,NW 311,Residential,10500,0,10500,76305,0,86805
142915600600000,NW 311,Residential,15000,0,15000,57268,0,72268
142915600700000,NW 311,Residential,8100,0,8100,45852,0,53952
142915600800000,OFFICE,Commercial,0,55890,55890,0,158665,214555
142915600900000,BARS/LOUNGE,Commercial,0,34020,34020,0,123750,157770
142915601000000,SMALL RETAIL,Commercial,0,48600,48600,0,96769,145369
142915601100000,NW 311,Residential,10560,0,10560,61222,0,71782
142915601200000,NW 311,Residential,5670,0,5670,64819,0,70489
142915601300000,NW 311,Residential,6480,0,6480,60811,0,67291
142915700100000,NW 311,Residential,11340,0,11340,70377,0,81717
142915700200000,NW 311,Residential,14175,0,14175,55651,0,69826
142915700300000,NW 311,Residential,17500,0,17500,79529,0,97029
142915700400000,NW 311,Residential,17500,0,17500,84058,0,101558
142915700500000,NW 311,Residential,14000,0,14000,75144,0,89144
142915700600000,NW 311,Residential,5513,0,5513,47552,0,53065
142915700700000,NW 311,Residential,13230,0,13230,74059,0,87289
142915700800000,NW 311,Residential,20000,0,20000,120516,0,140516
142915700900000,NW 311,Residential,20000,0,20000,0,0,20000
142915701000000,NW 311,Residential,20000,0,20000,0,0,20000
142915701100000,OFFICE,Commercial,0,24840,24840,0,64071,88911
142915701200000,NW 311,Residential,7776,0,7776,62377,0,70153
142915701300000,NW 311,Residential,11076,0,11076,67483,0,78559
142915701400000,NW 311,Residential,5670,0,5670,49157,0,54827
142915800100000,NW 311,Residential,12128,0,12128,55678,0,67806
142915800200000,NW 311,Residential,10500,0,10500,75974,0,86474
142915800300000,NW 311,Residential,10640,0,10640,60855,0,71495
142915800400000,NW 311,Residential,20000,0,20000,72232,0,92232
142915800500000,NW 311,Residential,400,0,400,0,0,400
142915800600000,NW 311,Residential,20400,0,20400,70156,0,90556
142915800700000,NW 311,Residential,16320,0,16320,53764,0,70084
142915800800000,NW 311,Residential,20400,0,20400,73719,0,94119
142915800900000,NW 311,Residential,20400,0,20400,98807,0,119207
142915801000000,NW 311,Residential,20400,0,20400,88826,0,109226
142915801100000,APARTMENT,Residential,9720,0,9720,100914,0,110634
142915801200000,NW 311,Residential,10850,0,10850,93853,0,104703
142915801300000,NW 311,Residential,11753,0,11753,61686,0,73439
142915801400000,NW 311,Residential,11554,0,11554,63151,0,74705
142915900100000,SMALL RETAIL,Commercial,0,208008,208008,0,38090,246098
142915900200000,VACANT LAND,Commercial,0,19810,19810,0,0,19810
142916000100000,AUTO REPAIR/SALES,Commercial,0,68040,68040,0,94974,163014
142916000102000,BILLBOARD(BLL),Commercial,0,0,0,0,20767,20767
142916000200000,LG DISCOUNT/RETAIL,Commercial,0,211896,211896,0,238296,450192
142916000300000,WAREHOUSE,Commercial,0,132435,132435,0,251476,383911
142916100100000,CONVENIENCE STORE,Commercial,0,54432,54432,0,175208,229640
142916100200000,NW 311,Residential,8000,0,8000,66220,0,74220
142916100300000,NW 311,Residential,8000,0,8000,732,0,8732
142916100400000,OFFICE,Commercial,0,48384,48384,0,115288,163672
142916100500000,APARTMENT,Commercial,0,10206,10206,0,102342,112548
142916100600000,VACANT LAND,Commercial,0,18144,18144,0,0,18144
142916100700000,BARS/LOUNGE,Commercial,0,20412,20412,0,60321,80733
142916100800000,NW 311,Residential,15000,0,15000,51061,0,66061
142916100900000,NW 311,Residential,7075,0,7075,43934,0,51009
142916101000000,NW 311,Residential,7209,0,7209,51085,0,58294
142916101100000,NW 311,Residential,8396,0,8396,53935,0,62331
142916200100000,NW 311,Residential,19920,0,19920,101358,0,121278
142916200200000,NW 311,Residential,20000,0,20000,84170,0,104170
142916200300000,NW 311,Residential,20000,0,20000,69885,0,89885
142916200400000,NW 311,Residential,20000,0,20000,87741,0,107741
142916200500000,NW 311,Residential,20000,0,20000,74022,0,94022
142916200600000,NW 311,Residential,16000,0,16000,77137,0,93137
142916200700000,CONVERSION,Commercial,0,13608,13608,0,102413,116021
142916200800000,NW 311,Residential,7290,0,7290,64078,0,71368
142916200900000,NW 311,Residential,11400,0,11400,56484,0,67884
142916201000000,NW 311,Residential,15132,0,15132,85076,0,100208
142916201100000,NW 311,Residential,15000,0,15000,58466,0,73466
142916201200000,NW 311,Residential,15000,0,15000,56627,0,71627
142916201300000,NW 311,Residential,15000,0,15000,46543,0,61543
142916201400000,NW 311,Residential,15000,0,15000,68834,0,83834
142916201500000,NW 311,Residential,13680,0,13680,45585,0,59265
142916201600000,OFFICE,Commercial,0,11664,11664,0,88801,100465
142916201700000,NW 311,Residential,9300,0,9300,50365,0,59665
142916300100000,SHOP,Commercial,0,84078,84078,0,235876,319954
142916300200000,VACANT LAND,Commercial,0,23133,23133,0,0,23133
142916300300000,SHOP,Commercial,0,54453,54453,0,140237,194690
142916300400000,SHOP,Commercial,0,17095,17095,0,15980,33075
142916300500000,CITY PROPERTY,Exempt,0,0,0,0,0,0
142916300600000,NW 318,Residential,8662,0,8662,34857,0,43519
142916300700000,NW 318,Residential,8580,0,8580,0,0,8580
142916400100000,VACANT LAND,Commercial,0,12015,12015,0,0,12015
142916400200000,SHOP,Commercial,0,55525,55525,0,145097,200622
142916400300000,FLAT PARKING,Commercial,0,20925,20925,0,4841,25766
142916400400000,FLAT PARKING,Commercial,0,9450,9450,0,1425,10875
142916400500000,FLAT PARKING,Commercial,0,11745,11745,0,2400,14145
142916400600000,FLAT PARKING,Commercial,0,11745,11745,0,300,12045
142916400700000,OFFICE,Commercial,0,11745,11745,0,268682,280427
142916400800000,NW 311,Residential,10050,0,10050,52050,0,62100
142916400900000,NW 311,Residential,7560,0,7560,55274,0,62834
142916401000000,NW 311,Residential,11288,0,11288,52417,0,63705
142916401100000,NW 311,Residential,6222,0,6222,46294,0,52516
142916401200000,NW 311,Residential,8501,0,8501,42852,0,51353
142916401300000,NW 311,Residential,10950,0,10950,52561,0,63511
142916401400000,NW 311,Residential,10576,0,10576,53945,0,64521
142916401500000,FLAT PARKING,Commercial,0,15660,15660,0,2880,18540
142916401600000,WAREHOUSE,Commercial,0,64516,64516,0,180977,245493
142916401700000,VACANT LAND,Commercial,0,9315,9315,0,0,9315
142917600100000,SCHOOL,Exempt,0,0,0,0,0,0
142917700100000,SMALL RETAIL,Commercial,0,97803,97803,0,55502,153305
142917700200000,SMALL RETAIL,Commercial,0,32601,32601,0,93294,125895
142917700202000,BILLBOARD(BLL),Commercial,0,0,0,0,13427,13427
142917700300000,CONVENIENCE STORE,Commercial,0,53913,53913,0,66087,120000
142917700400000,CITY PROPERTY,Exempt,0,0,0,0,0,0
142917700500000,WAREHOUSE; CTRL CR,Commercial,0,19958,19958,0,27941,47899
142917700600000,AUTO REP/SAL;CTRL CR,Commercial,0,26728,26728,0,26987,53715
142917700700000,CITY PROPERTY,Exempt,0,0,0,0,0,0
142917700800000,CITY PROPERTY,Exempt,0,0,0,0,0,0
142917700900000,CONVERSION,Commercial,0,7290,7290,0,55322,62612
142917701000000,CONVERSION,Commercial,0,7290,7290,0,57648,64938
142917701100000,SW 401,Residential,9180,0,9180,0,0,9180
142917800100000,SMALL RETAIL,Commercial,0,27216,27216,0,36862,64078
142917800200000,NW 318,Residential,12000,0,12000,0,0,12000
142917800300000,FLAT PARKING,Commercial,0,30240,30240,0,4480,34720
142917800400000,RESTAURANT,Commercial,0,27216,27216,0,107193,134409
142917800500000,FLAT PARKING,Commercial,0,30240,30240,0,6124,36364
142917800600000,FLAT PARKING,Commercial,0,30240,30240,0,6124,36364
142917800700000,SMALL RETAIL,Commercial,0,54432,54432,0,207269,261701
142917800800000,NW 318,Residential,87480,0,87480,79543,0,167023
142917900100000,SW 401,Exempt,0,0,0,0,0,0
142917900200000,CHURCH,Exempt,0,6750,6750,0,0,6750
142917900300000,CHURCH,Exempt,0,6750,6750,0,0,6750
142917900400000,CHURCH,Exempt,0,3213,3213,0,0,3213
142917900500000,CHURCH,Exempt,0,12960,12960,0,3480,16440
142917900600000,CHURCH,Exempt,0,45506,45506,0,330593,376099
142917900700000,CHURCH,Exempt,0,18144,18144,0,18886,37030
142917900800000,SCHOOL,Exempt,0,18144,18144,0,189568,207712
142917900900000,CHURCH,Exempt,0,18144,18144,0,2214,20358
142917901000000,CHURCH,Exempt,0,9072,9072,0,0,9072
142917901100000,CITY PROPERTY,Exempt,0,0,0,0,0,0
142917901200000,CONVERSION,Commercial,0,14515,14515,0,32611,47126
142917901300000,CONVERSION,Commercial,0,5400,5400,0,33473,38873
142917901400000,COUNTY PROPERTY,Exempt,0,0,0,0,0,0
142917901500000,SW 401,Residential,9207,0,9207,56098,0,65305
142917901600000,SCHOOL,Exempt,0,0,0,0,0,0
142918000100000,NW 318,Residential,7350,0,7350,43058,0,50408
142918000200000,CONVERSION,Commercial,0,3827,3827,0,70557,74384
142918000300000,VACANT LAND,Commercial,0,84672,84672,0,0,84672
142918000400000,FAST FOOD,Commercial,0,27216,27216,0,56374,83590
142918000500000,OFFICE,Commercial,0,22982,22982,0,117795,140777
142918000600000,NW 318,Residential,5512,0,5512,0,0,5512
142918000700000,FLAT PARKING,Commercial,0,7938,7938,0,6300,14238
142918000800000,NW 318,Residential,5000,0,5000,0,0,5000
142918000900000,NW 318,Residential,4882,0,4882,51153,0,56035
142918001000000,NW 318,Residential,9450,0,9450,0,0,9450
142918001100000,CITY PROPERTY,Exempt,0,0,0,0,0,0
142918001200000,FLAT PARKING,Commercial,0,13608,13608,0,7938,21546
142918001300000,FLAT PARKING,Commercial,0,27216,27216,0,15876,43092
142918001400000,FLAT PARKING,Commercial,0,13608,13608,0,7938,21546
142918001500000,CITY PROPERTY,Exempt,0,0,0,0,0,0
142918001600000,CITY PROPERTY,Exempt,0,0,0,0,0,0
142918001700000,NW 318,Residential,5301,0,5301,23461,0,28762
142918001800000,CITY PROPERTY,Exempt,0,0,0,0,0,0
142918001900000,CITY PROPERTY,Exempt,0,0,0,0,0,0
142918100100000,FLAT PARKING,Commercial,0,40824,40824,0,5315,46139
142918100200000,RESTAURANT,Commercial,0,75038,75038,0,168726,243764
142918100300000,FLAT PARKING,Commercial,0,27864,27864,0,4116,31980
142918100400000,SMALL RETAIL,Commercial,0,27216,27216,0,42094,69310
142918100500000,BARS/LOUNGE,Commercial,0,27216,27216,0,68919,96135
142918100600000,VACANT LAND,Commercial,0,16728,16728,0,0,16728
142918100700000,NW 318,Residential,9000,0,9000,38580,0,47580
142918100800000,NW 318,Residential,9000,0,9000,34924,0,43924
142918100900000,CITY PROPERTY,Exempt,0,0,0,0,0,0
142918101000000,NW 318,Residential,9000,0,9000,39185,0,48185
142918101100000,CITY PROPERTY,Exempt,0,0,0,0,0,0
142918101200000,CITY PROPERTY,Exempt,0,0,0,0,0,0
142918101300000,CONVERSION,Commercial,0,6804,6804,0,36740,43544
142918101400000,CONVERSION,Commercial,0,6804,6804,0,50937,57741
142918101500000,NW 318,Residential,5000,0,5000,0,0,5000
142918101600000,NW 318,Residential,5000,0,5000,0,0,5000
142918101700000,NW 318,Residential,6075,0,6075,37562,0,43637
142918101800000,FLAT PARKING,Commercial,0,9590,9590,0,8673,18263
142918200100000,OFFICE; CTRL CR,Commercial,0,111249,111249,0,388550,499799
142918200300000,FLAT PARKING,Commercial,0,21724,21724,0,0,21724
142918200400000,FLAT PARKING,Commercial,0,10344,10344,0,0,10344
142918200500000,SW 401,Residential,5000,0,5000,0,0,5000
142918300100000,NW 318,Residential,5371,0,5371,51270,0,56641
142918300200000,SMALL RETAIL,Commercial,0,73483,73483,0,180371,253854
142918300300000,NW 318,Residential,4725,0,4725,20163,0,24888
142918300400000,BARS/LOUNGE,Commercial,0,6124,6124,0,68222,74346
142918300500000,CITY PROPERTY,Exempt,0,0,0,0,0,0
142918300600000,NW 318,Residential,4882,0,4882,42679,0,47561
142918300700000,NW 318,Residential,4464,0,4464,30593,0,35057
142918300800000,NW 318,Residential,6034,0,6034,41000,0,47034
142918300900000,NW 318,Residential,4613,0,4613,40005,0,44618
142918301000000,NW 318,Residential,4432,0,4432,45309,0,49741
142918301100000,NW 318,Residential,5602,0,5602,45948,0,51550
142918301200000,FLAT PARKING,Commercial,0,18468,18468,0,1607,20075
142918301300000,FLAT PARKING,Commercial,0,68040,68040,0,11139,79179
142918301400000,AUTO REPAIR/SALES,Commercial,0,61236,61236,0,66358,127594
142918301500000,NW 318,Residential,4464,0,4464,24887,0,29351
142918301600000,NW 318,Residential,4534,0,4534,0,0,4534
142918301700000,NW 318,Residential,5161,0,5161,30669,0,35830
142918400100000,NW 318,Residential,7492,0,7492,28232,0,35724
142918400200000,NW 318,Residential,6570,0,6570,19367,0,25937
142918400300000,NW 318,Residential,9000,0,9000,33238,0,42238
142918400400000,NW 318,Residential,5000,0,5000,0,0,5000
142918400500000,NW 318,Residential,9000,0,9000,38634,0,47634
142918400600000,NW 318,Residential,9000,0,9000,33697,0,42697
142918400700000,NW 318,Residential,9000,0,9000,43093,0,52093
142918400800000,NW 318,Residential,6075,0,6075,20801,0,26876
142918400900000,NW 318,Residential,5000,0,5000,0,0,5000
142918401000000,CITY PROPERTY,Exempt,0,0,0,0,0,0
142918401200000,NW 318,Residential,18000,0,18000,47542,0,65542
142918401300000,NW 318,Residential,6300,0,6300,34281,0,40581
142918401400000,NW 318,Residential,7200,0,7200,44737,0,51937
142918401500000,NW 318,Residential,5000,0,5000,0,0,5000
142918401600000,NW 318,Residential,5580,0,5580,45038,0,50618
142918401700000,SMALL RETAIL,Commercial,0,6065,6065,0,40254,46319
142918401800000,NW 318,Residential,5000,0,5000,0,0,5000
142918500100000,CITY PROPERTY,Exempt,0,0,0,0,0,0
142918500200000,NW 318,Residential,9000,0,9000,34830,0,43830
142918500300000,NW 318,Residential,9000,0,9000,10066,0,19066
142918500400000,NW 318,Residential,9000,0,9000,24087,0,33087
142918500500000,CITY PROPERTY,Exempt,0,0,0,0,0,0
142918500600000,SHOP,Commercial,0,15673,15673,0,120044,135717
142918500700000,CITY PROPERTY,Exempt,0,0,0,0,0,0
142918500800000,NW 318,Residential,8977,0,8977,28472,0,37449
142918500900000,CITY PROPERTY,Exempt,0,0,0,0,0,0
142918501000000,NW 318,Residential,9000,0,9000,28792,0,37792
142918501100000,CITY PROPERTY,Exempt,0,0,0,0,0,0
142918501200000,APARTMENT,Commercial,0,8165,8165,0,119552,127717
142918501300000,NW 318,Residential,9000,0,9000,29656,0,38656
142918501400000,NW 318,Residential,9000,0,9000,0,0,9000
142918501500000,NW 318,Residential,9000,0,9000,21611,0,30611
142918600100000,NW 318,Residential,8010,0,8010,74633,0,82643
142918600200000,CITY PROPERTY,Exempt,0,0,0,0,0,0
142918600300000,NW 318,Residential,5000,0,5000,0,0,5000
142918600400000,VACANT LAND,Commercial,0,18144,18144,0,0,18144
142918600500000,NW 318,Residential,5000,0,5000,0,0,5000
142918600600000,NW 318,Residential,5000,0,5000,0,0,5000
142918600700000,NW 318,Residential,11250,0,11250,70293,0,81543
142918600800000,NW 318,Residential,5434,0,5434,38872,0,44306
142918600900000,NW 318,Residential,5434,0,5434,30122,0,35556
142918601000000,NW 318,Residential,4896,0,4896,30037,0,34933
142918601100000,NW 318,Residential,5814,0,5814,55951,0,61765
142918601200000,NW 318,Residential,7200,0,7200,36859,0,44059
142918601300000,NW 318,Residential,7650,0,7650,46278,0,53928
142918601400000,NW 318,Residential,7650,0,7650,35284,0,42934
142918601500000,NW 318,Residential,7200,0,7200,26709,0,33909
142918601600000,NW 318,Residential,6750,0,6750,38316,0,45066
142918601700000,NW 318,Residential,5512,0,5512,19723,0,25235
142918601800000,CITY PROPERTY,Exempt,0,0,0,0,0,0
142918601900000,NW 318,Residential,5512,0,5512,10077,0,15589
142918602000000,CITY PROPERTY,Exempt,0,0,0,0,0,0
142918602100000,NW 318,Residential,3847,0,3847,38089,0,41936
142918700100000,BARS/LOUNGE,Commercial,0,15552,15552,0,81246,96798
142918700200000,NW 318,Residential,4617,0,4617,17707,0,22324
142918700300000,CITY PROPERTY,Exempt,0,0,0,0,0,0
142918700400000,NW 318,Residential,5000,0,5000,0,0,5000
142918700500000,NW 318,Residential,5440,0,5440,23360,0,28800
142918700600000,NW 318,Residential,5747,0,5747,20196,0,25943
142918700700000,NW 318,Residential,7603,0,7603,1088,0,8691
142918700800000,NW 318,Residential,5920,0,5920,28714,0,34634
142918700900000,NW 318,Residential,6432,0,6432,38864,0,45296
142918701000000,CITY PROPERTY,Exempt,0,0,0,0,0,0
142918701100000,CITY PROPERTY,Exempt,0,0,0,0,0,0
142918701200000,NW 318,Residential,7824,0,7824,31185,0,39009
142918701300000,CITY PROPERTY,Exempt,0,0,0,0,0,0
142918701400000,NW 318,Residential,6210,0,6210,33046,0,39256
142918701500000,NW 318,Residential,7245,0,7245,0,0,7245
142918800100000,NW 318,Residential,9000,0,9000,28272,0,37272
142918800200000,NW 318,Residential,9000,0,9000,65515,0,74515
142918800300000,CITY PROPERTY,Exempt,0,0,0,0,0,0
142918800400000,NW 318,Residential,9000,0,9000,34301,0,43301
142918800500000,NW 318,Residential,9000,0,9000,31174,0,40174
142918800600000,NW 318,Residential,9000,0,9000,43403,0,52403
142918800700000,CITY PROPERTY,Exempt,0,0,0,0,0,0
142918800800000,CITY PROPERTY,Exempt,0,0,0,0,0,0
142918800900000,NW 318,Residential,8721,0,8721,30867,0,39588
142918801000000,NW 318,Residential,6300,0,6300,35545,0,41845
142918801100000,NW 318,Residential,7470,0,7470,36434,0,43904
142918801200000,NW 318,Residential,8820,0,8820,22464,0,31284
142918801300000,NW 318,Residential,720,0,720,758,0,1478
142918801400000,CENTRALLY ASSESSED,Other,0,0,0,0,0,0
142918801500000,NW 318,Residential,9000,0,9000,45266,0,54266
142918801600000,NW 318,Residential,9000,0,9000,0,0,9000
142918801700000,CITY PROPERTY,Exempt,0,0,0,0,0,0
142918801800000,NW 318,Residential,9000,0,9000,0,0,9000
142918900100000,NW 318,Residential,6030,0,6030,25939,0,31969
142918900200000,CITY PROPERTY,Exempt,0,0,0,0,0,0
142918900300000,NW 318,Residential,8550,0,8550,0,0,8550
142918900400000,CITY PROPERTY,Exempt,0,0,0,0,0,0
142918900500000,VACANT LAND,Commercial,0,34020,34020,0,0,34020
142918900600000,CITY PROPERTY,Exempt,0,0,0,0,0,0
142918900700000,VACANT LAND,Commercial,0,5000,5000,0,0,5000
142918900702000,BILLBOARD(BLL),Commercial,0,0,0,0,8782,8782
142918900800000,CITY PROPERTY,Exempt,0,0,0,0,0,0
142918900900000,NW 318,Residential,6750,0,6750,30420,0,37170
142918901000000,NW 318,Residential,7830,0,7830,0,0,7830
142918901100000,NW 318,Residential,8460,0,8460,34759,0,43219
142918901200000,NW 318,Residential,5569,0,5569,22003,0,27572
142920100100000,COUNTY PROPERTY,Exempt,0,0,0,0,0,0
142920100200000,SCHOOL,Exempt,0,0,0,0,0,0
142920100300000,CONVERSION,Commercial,0,8932,8932,0,86150,95082
142920100400000,NW 311,Residential,16337,0,16337,69791,0,86128
142920100500000,NW 311,Residential,16000,0,16000,71212,0,87212
142920100600000,NW 311,Residential,16000,0,16000,54059,0,70059
142920100700000,NW 311,Residential,16000,0,16000,66240,0,82240
142920100800000,NW 311,Residential,16000,0,16000,79272,0,95272
142920100900000,NW 311,Residential,16000,0,16000,75946,0,91946
142920101000000,NW 311,Residential,16000,0,16000,71081,0,87081
142920101100000,NW 311,Residential,16000,0,16000,72826,0,88826
142920101200000,NW 311,Residential,16000,0,16000,68718,0,84718
142920101300000,NW 311,Residential,16000,0,16000,69138,0,85138
142920101400000,NW 311,Residential,16000,0,16000,65268,0,81268
142920101500000,NW 311,Residential,16000,0,16000,67825,0,83825
142920101600000,NW 311,Residential,15019,0,15019,62614,0,77633
142920101700000,NW 311,Residential,14047,0,14047,65334,0,79381
142920101800000,NW 311,Residential,9920,0,9920,36207,0,46127
142920200100000,SCHOOL,Exempt,0,0,0,0,0,0
142920300100000,NW 311,Residential,11200,0,11200,72289,0,83489
142920300200000,NW 311,Residential,16000,0,16000,70736,0,86736
142920300300000,NW 311,Residential,16000,0,16000,74971,0,90971
142920300400000,CITY PROPERTY,Exempt,0,0,0,0,0,0
142920300500000,CITY PROPERTY,Exempt,0,0,0,0,0,0
142920300600000,CITY PROPERTY,Exempt,0,0,0,0,0,0
142920300700000,NW 311,Residential,16000,0,16000,49464,0,65464
142920300800000,NW 311,Residential,16000,0,16000,42903,0,58903
142920300900000,NW 311,Residential,16000,0,16000,57620,0,73620
142920301000000,NW 311,Residential,16000,0,16000,77413,0,93413
142920301100000,NW 311,Residential,16000,0,16000,70021,0,86021
142920301200000,NW 311,Residential,20800,0,20800,56692,0,77492
142920301300000,NW 311,Residential,14080,0,14080,76623,0,90703
142920301400000,NW 311,Residential,14080,0,14080,92203,0,106283
142920301500000,NW 311,Residential,12160,0,12160,54475,0,66635
142920301600000,NW 311,Residential,16000,0,16000,57913,0,73913
142920301700000,NW 311,Residential,16000,0,16000,58691,0,74691
142920301800000,NW 311,Residential,12600,0,12600,92955,0,105555
142920301900000,NW 311,Residential,12800,0,12800,89684,0,102484
142920302000000,NW 311,Residential,12160,0,12160,84261,0,96421
142920302100000,NW 311,Residential,13440,0,13440,65103,0,78543
142920302200000,NW 311,Residential,13000,0,13000,66961,0,79961
142920302300000,NW 311,Residential,17510,0,17510,65120,0,82630
142920302400000,NW 311,Residential,11400,0,11400,55581,0,66981
142920302500000,NW 311,Residential,16000,0,16000,73239,0,89239
142920302600000,NW 311,Residential,16000,0,16000,45829,0,61829
142920302700000,NW 311,Residential,16000,0,16000,52233,0,68233
142920302800000,NW 311,Residential,16000,0,16000,47371,0,63371
142920302900000,NW 311,Residential,16000,0,16000,54455,0,70455
142920303000000,NW 311,Residential,20800,0,20800,80868,0,101668
142920303100000,NW 311,Residential,11340,0,11340,57707,0,69047
142920400100000,NW 311,Residential,16000,0,16000,75658,0,91658
142920400200000,NW 311,Residential,10800,0,10800,73132,0,83932
142920400300000,NW 311,Residential,11200,0,11200,43682,0,54882
142920400400000,NW 311,Residential,15680,0,15680,88733,0,104413
142920400500000,NW 311,Residential,15680,0,15680,67966,0,83646
142920400600000,NW 311,Residential,15680,0,15680,41328,0,57008
142920400700000,NW 311,Residential,16000,0,16000,57209,0,73209
142920400800000,NW 311,Residential,16000,0,16000,58408,0,74408
142920400900000,NW 311,Residential,16000,0,16000,77240,0,93240
142920500100000,NW 311,Residential,13680,0,13680,67925,0,81605
142920500200000,NW 311,Residential,11160,0,11160,65737,0,76897
142920500300000,NW 311,Residential,14790,0,14790,43896,0,58686
142920500400000,NW 311,Residential,15300,0,15300,74677,0,89977
142920500500000,NW 311,Residential,15045,0,15045,63506,0,78551
142920500600000,NW 311,Residential,16000,0,16000,45085,0,61085
142920500700000,NW 311,Residential,18000,0,18000,54596,0,72596
142920600100000,NW 320,Residential,16800,0,16800,80360,0,97160
142920600200000,NW 320,Residential,16416,0,16416,61343,0,77759
142920600300000,NW 320,Residential,13880,0,13880,84122,0,98002
142920600400000,NW 320,Residential,11400,0,11400,66830,0,78230
142920600500000,NW 320,Residential,16000,0,16000,62464,0,78464
142920600600000,NW 320,Residential,16000,0,16000,71170,0,87170
142920600700000,NW 320,Residential,16000,0,16000,51644,0,67644
142920600800000,NW 320,Residential,16000,0,16000,56057,0,72057
142920600900000,NW 320,Residential,16000,0,16000,52549,0,68549
142920601000000,NW 320,Residential,16000,0,16000,77522,0,93522
142920601100000,NW 320,Residential,16000,0,16000,71590,0,87590
142920601200000,NW 320,Residential,16000,0,16000,81696,0,97696
142920601300000,NW 320,Residential,14000,0,14000,73806,0,87806
142920601400000,NW 320,Residential,16000,0,16000,65437,0,81437
142920601500000,NW 320,Residential,16000,0,16000,53203,0,69203
142920601600000,NW 320,Residential,16000,0,16000,53158,0,69158
142922600100000,NW 320,Residential,25620,0,25620,69676,0,95296
142922600200000,NW 320,Residential,26318,0,26318,73444,0,99762
142922600300000,NW 320,Residential,22491,0,22491,71011,0,93502
142922600400000,NW 320,Residential,29450,0,29450,101211,0,130661
142922600500000,NW 320,Residential,18570,0,18570,80616,0,99186
142922600600000,NW 320,Residential,18207,0,18207,62521,0,80728
142922600700000,NW 320,Residential,17493,0,17493,76633,0,94126
142922600800000,NW 320,Residential,29890,0,29890,0,0,29890
142922600900000,NW 320,Residential,29890,0,29890,84414,0,114304
142922601000000,NW 320,Residential,17325,0,17325,45924,0,63249
142922601100000,NW 320,Residential,18900,0,18900,62416,0,81316
142922601200000,NW 320,Residential,28175,0,28175,121013,0,149188
142922601300000,NW 320,Residential,26215,0,26215,91701,0,117916
142922601400000,NW 320,Residential,27264,0,27264,179507,0,206771
142922601500000,NW 320,Residential,21221,0,21221,97739,0,118960
142922601600000,NW 320,Residential,21168,0,21168,92538,0,113706
142922601700000,NW 320,Residential,21221,0,21221,100062,0,121283
142922601800000,NW 320,Residential,24547,0,24547,83472,0,108019
142922601900000,NW 320,Residential,24723,0,24723,85020,0,109743
142922602000000,NW 320,Residential,25373,0,25373,107254,0,132627
142922602100000,NW 320,Residential,50800,0,50800,141753,0,192553
142922602200000,CITY PROPERTY,Exempt,0,0,0,0,0,0
142922602300000,NW 320,Residential,24225,0,24225,92391,0,116616
142922602400000,NW 320,Residential,24939,0,24939,117784,0,142723
142922602500000,NW 320,Residential,25529,0,25529,112677,0,138206
142922602600000,NW 320,Residential,20143,0,20143,76013,0,96156
142922602700000,NW 320,Residential,24200,0,24200,115940,0,140140
142922602800000,NW 320,Residential,24200,0,24200,76114,0,100314
142922602900000,NW 320,Residential,24200,0,24200,99812,0,124012
142922603000000,NW 320,Residential,24200,0,24200,115849,0,140049
142922603100000,NW 320,Residential,51050,0,51050,126618,0,177668
142922603200000,NW 320,Residential,50800,0,50800,123532,0,174332
142922603300000,NW 320,Residential,50000,0,50000,119990,0,169990
142922603400000,NW 320,Residential,26400,0,26400,110398,0,136798
142922603500000,NW 320,Residential,27000,0,27000,123189,0,150189
142922603600000,NW 320,Residential,24600,0,24600,97410,0,122010
142922603700000,NW 320,Residential,31365,0,31365,91707,0,123072
142922603800000,NW 320,Residential,31365,0,31365,86733,0,118098
142922603900000,NW 320,Residential,26840,0,26840,75946,0,102786
142922604000000,NW 320,Residential,51750,0,51750,92386,0,144136
142922604100000,NW 320,Residential,30110,0,30110,70080,0,100190
142922604200000,NW 320,Residential,30110,0,30110,85775,0,115885
142922604300000,NW 320,Residential,30640,0,30640,63477,0,94117
142922700100000,NW 320,Residential,19227,0,19227,75974,0,95201
142922700200000,NW 320,Residential,16000,0,16000,68736,0,84736
142922700300000,NW 320,Residential,16000,0,16000,60820,0,76820
142922700400000,NW 320,Residential,16000,0,16000,52428,0,68428
142922700500000,NW 320,Residential,16000,0,16000,59788,0,75788
142922700600000,NW 320,Residential,18816,0,18816,81615,0,100431
142922700700000,NW 320,Residential,11760,0,11760,73702,0,85462
142922700800000,NW 320,Residential,11620,0,11620,66692,0,78312
142922700900000,NW 320,Residential,11060,0,11060,75691,0,86751
142922701000000,NW 320,Residential,18590,0,18590,88982,0,107572
142922701100000,NW 320,Residential,14800,0,14800,90419,0,105219
142922701200000,NW 320,Residential,15860,0,15860,59140,0,75000
142922701300000,NW 320,Residential,16000,0,16000,86411,0,102411
142922701400000,NW 320,Residential,16000,0,16000,72603,0,88603
142922701500000,NW 320,Residential,16000,0,16000,64558,0,80558
142922701600000,NW 320,Residential,14728,0,14728,67565,0,82293
142922701700000,NW 320,Residential,12000,0,12000,44828,0,56828
142922800100000,NW 320,Residential,21905,0,21905,75366,0,97271
142922800200000,NW 320,Residential,16000,0,16000,72153,0,88153
142922800300000,NW 320,Residential,14000,0,14000,80428,0,94428
142922800400000,NW 320,Residential,16000,0,16000,91609,0,107609
142922800500000,NW 320,Residential,16000,0,16000,86230,0,102230
142922800600000,NW 320,Residential,14000,0,14000,93624,0,107624
142922800700000,NW 320,Residential,16000,0,16000,75143,0,91143
142922800800000,NW 320,Residential,16000,0,16000,79228,0,95228
142922800900000,NW 320,Residential,20240,0,20240,117543,0,137783
142922801000000,NW 320,Residential,21480,0,21480,66500,0,87980
142922801100000,NW 320,Residential,16000,0,16000,45625,0,61625
142922801200000,NW 320,Residential,16000,0,16000,47668,0,63668
142922801300000,NW 320,Residential,14000,0,14000,88869,0,102869
142922801400000,NW 320,Residential,16000,0,16000,88555,0,104555
142922801500000,NW 320,Residential,16000,0,16000,60005,0,76005
142922801600000,NW 320,Residential,14000,0,14000,65013,0,79013
142922801700000,NW 320,Residential,16000,0,16000,80172,0,96172
142922801800000,NW 320,Residential,14080,0,14080,82486,0,96566
142922801900000,NW 320,Residential,18660,0,18660,85996,0,104656
142922802000000,NW 320,Residential,13440,0,13440,74250,0,87690
142922802100000,NW 320,Residential,9240,0,9240,51848,0,61088
142922900100000,NW 320,Residential,21500,0,21500,123853,0,145353
142922900200000,NW 320,Residential,16000,0,16000,76447,0,92447
142922900300000,NW 320,Residential,16000,0,16000,22678,0,38678
142922900400000,NW 320,Residential,16000,0,16000,74814,0,90814
142922900500000,NW 320,Residential,16000,0,16000,105389,0,121389
142922900600000,NW 320,Residential,16000,0,16000,57781,0,73781
142922900700000,NW 320,Residential,16000,0,16000,90030,0,106030
142922900800000,NW 320,Residential,16000,0,16000,72228,0,88228
142922900900000,NW 320,Residential,16000,0,16000,84061,0,100061
142922901000000,NW 320,Residential,21133,0,21133,84599,0,105732
142922901100000,NW 320,Residential,20210,0,20210,49268,0,69478
142922901200000,SMALL RETAIL,Commercial,0,14124,14124,0,38024,52148
142922901300000,SMALL RETAIL,Commercial,0,14548,14548,0,30122,44670
142922901400000,NW 320,Residential,16000,0,16000,78294,0,94294
142922901500000,NW 320,Residential,16000,0,16000,84763,0,100763
142922901600000,NW 320,Residential,16000,0,16000,69005,0,85005
142922901700000,NW 320,Residential,16000,0,16000,80772,0,96772
142922901800000,NW 320,Residential,16000,0,16000,53372,0,69372
142922901900000,NW 320,Residential,16000,0,16000,76549,0,92549
142922902000000,NW 320,Residential,16000,0,16000,71413,0,87413
142922902100000,NW 320,Residential,15443,0,15443,64149,0,79592
142922902200000,NW 320,Residential,13440,0,13440,64179,0,77619
142923000100000,NW 320,Residential,19600,0,19600,80124,0,99724
142923000200000,NW 320,Residential,19880,0,19880,63934,0,83814
142923000300000,NW 320,Residential,19320,0,19320,84521,0,103841
142923000400000,NW 320,Residential,19320,0,19320,83543,0,102863
142923000500000,NW 320,Residential,16000,0,16000,80853,0,96853
142923000600000,NW 320,Residential,16000,0,16000,75012,0,91012
142923000700000,NW 320,Residential,16000,0,16000,62391,0,78391
142923000800000,NW 320,Residential,16000,0,16000,78632,0,94632
142923100100000,NW 320,Residential,19727,0,19727,79424,0,99151
142923100200000,NW 320,Residential,19852,0,19852,77040,0,96892
142923100300000,NW 320,Residential,16000,0,16000,91164,0,107164
142923100400000,NW 320,Residential,16000,0,16000,67846,0,83846
142923100500000,NW 320,Residential,15200,0,15200,77215,0,92415
142923100600000,NW 320,Residential,16000,0,16000,82705,0,98705
142923100700000,NW 320,Residential,16000,0,16000,59098,0,75098
142923100800000,NW 320,Residential,15200,0,15200,66790,0,81990
142923100900000,NW 320,Residential,16000,0,16000,83700,0,99700
142923101000000,NW 320,Residential,16000,0,16000,67140,0,83140
142923101100000,NW 320,Residential,15776,0,15776,63734,0,79510
142923101200000,NW 320,Residential,17100,0,17100,71052,0,88152
142923101300000,NW 320,Residential,15660,0,15660,69204,0,84864
142923101400000,NW 320,Residential,20550,0,20550,81167,0,101717
142923101500000,NW 320,Residential,13069,0,13069,64177,0,77246
142923101600000,NW 320,Residential,15008,0,15008,84444,0,99452
142923101700000,NW 320,Residential,17275,0,17275,96390,0,113665
142923101800000,NW 320,Residential,17920,0,17920,110309,0,128229
142923200100000,SMALL RETAIL,Commercial,0,11858,11858,0,34203,46061
142923200200000,VACANT LAND,Commercial,0,9882,9882,0,0,9882
142923200300000,SMALL RETAIL,Commercial,0,9684,9684,0,17623,27307
142923200400000,OFFICE,Exempt,0,16848,16848,0,177953,194801
142923200500000,NW 320,Exempt,0,24002,24002,0,3840,27842
142925100100000,NW 320,Residential,16000,0,16000,68622,0,84622
142925100200000,NW 320,Residential,16000,0,16000,108835,0,124835
142925100300000,NW 320,Residential,16000,0,16000,90073,0,106073
142925100400000,NW 320,Residential,19740,0,19740,100239,0,119979
142925100500000,NW 320,Residential,20160,0,20160,108996,0,129156
142925100600000,NW 320,Residential,19320,0,19320,75905,0,95225
142925100700000,NW 320,Residential,19600,0,19600,87926,0,107526
142925100800000,NW 320,Residential,16000,0,16000,76176,0,92176
142925200100000,NW 320,Residential,19292,0,19292,86615,0,105907
142925200200000,NW 320,Residential,19600,0,19600,116346,0,135946
142925200300000,NW 320,Residential,16000,0,16000,88203,0,104203
142925200400000,NW 320,Residential,16000,0,16000,94248,0,110248
142925200500000,NW 320,Residential,16000,0,16000,89260,0,105260
142925200600000,NW 320,Residential,16000,0,16000,95853,0,111853
142925200700000,NW 320,Residential,16000,0,16000,70606,0,86606
142925200800000,NW 320,Residential,16000,0,16000,88842,0,104842
142925200900000,NW 320,Residential,16000,0,16000,77213,0,93213
142925201000000,NW 320,Residential,16373,0,16373,75427,0,91800
142925201100000,NW 320,Residential,21798,0,21798,108380,0,130178
142925201200000,NW 320,Residential,20242,0,20242,77720,0,97962
142925201300000,NW 320,Residential,18576,0,18576,59361,0,77937
142925300100000,NW 320,Residential,21006,0,21006,77463,0,98469
142925300200000,OFFICE,Commercial,0,19907,19907,0,68326,88233
142925300300000,NW 320,Residential,20680,0,20680,65511,0,86191
142925300400000,NW 320,Residential,19980,0,19980,87789,0,107769
142925300500000,NW 320,Residential,20513,0,20513,83614,0,104127
142925300600000,NW 320,Residential,19980,0,19980,97090,0,117070
142925300700000,NW 320,Residential,20160,0,20160,91315,0,111475
142925300800000,NW 320,Residential,20160,0,20160,82841,0,103001
142925300900000,NW 320,Residential,20160,0,20160,81905,0,102065
142925301000000,NW 320,Residential,18080,0,18080,91446,0,109526
142925301100000,NW 320,Residential,20340,0,20340,93261,0,113601
142925301200000,NW 320,Residential,20340,0,20340,108050,0,128390
142925301300000,NW 320,Residential,20520,0,20520,73891,0,94411
142925301400000,NW 320,Residential,20520,0,20520,100790,0,121310
142925301500000,NW 320,Residential,20520,0,20520,68236,0,88756
142925301600000,NW 320,Residential,19000,0,19000,71771,0,90771
142925301700000,NW 320,Residential,19206,0,19206,93431,0,112637
142925301800000,NW 320,Residential,21295,0,21295,87398,0,108693
142925301900000,NW 320,Residential,20520,0,20520,106151,0,126671
142925302000000,NW 320,Residential,22942,0,22942,114555,0,137497
142925302100000,NW 320,Residential,42760,0,42760,141369,0,184129
142925302200000,NW 320,Residential,20794,0,20794,154091,0,174885
142925302300000,NW 320,Residential,20700,0,20700,113910,0,134610
142925302400000,NW 320,Residential,21059,0,21059,118056,0,139115
142925302500000,NW 320,Residential,20875,0,20875,122421,0,143296
142925302600000,NW 320,Residential,20689,0,20689,106918,0,127607
142925302700000,NW 320,Residential,20646,0,20646,94939,0,115585
142925302800000,NW 320,Residential,20646,0,20646,104517,0,125163
142925302900000,NW 320,Residential,20274,0,20274,111680,0,131954
142925303000000,NW 320,Residential,20088,0,20088,96937,0,117025
142925303100000,NW 320,Residential,19970,0,19970,104462,0,124432
142925303200000,NW 320,Residential,20216,0,20216,75449,0,95665
142925303300000,NW 320,Residential,20107,0,20107,116794,0,136901
142925303400000,NW 320,Residential,18988,0,18988,77529,0,96517
142925303500000,NW 320,Residential,19072,0,19072,58175,0,77247
142925303600000,NW 320,Residential,20517,0,20517,34789,0,55306
142925400100000,NW 320,Residential,17031,0,17031,61192,0,78223
142925400200000,NW 320,Residential,19379,0,19379,80737,0,100116
142925400300000,NW 320,Residential,18600,0,18600,77216,0,95816
142925400400000,NW 320,Residential,16989,0,16989,58011,0,75000
142925400500000,NW 320,Residential,16640,0,16640,68836,0,85476
142925400600000,NW 320,Residential,13860,0,13860,122820,0,136680
142925400700000,NW 320,Residential,14416,0,14416,75412,0,89828
142925400800000,NW 320,Residential,13860,0,13860,69595,0,83455
142925400900000,NW 320,Residential,18720,0,18720,110371,0,129091
142925401000000,NW 320,Residential,19180,0,19180,87952,0,107132
142925401100000,NW 320,Residential,13872,0,13872,88367,0,102239
142925401200000,NW 320,Residential,13332,0,13332,80452,0,93784
142925401300000,NW 320,Residential,13068,0,13068,86002,0,99070
142925401400000,NW 320,Residential,19025,0,19025,89819,0,108844
142925401500000,NW 320,Residential,11480,0,11480,94741,0,106221
142925401600000,NW 320,Residential,13500,0,13500,87495,0,100995
142925401700000,NW 320,Residential,18848,0,18848,98691,0,117539
142925401800000,NW 320,Residential,19151,0,19151,111561,0,130712
142925401900000,NW 320,Residential,17520,0,17520,98476,0,115996
142925402000000,NW 320,Residential,12221,0,12221,45936,0,58157
142925402100000,NW 320,Residential,12703,0,12703,95553,0,108256
142925402200000,NW 320,Residential,17820,0,17820,105929,0,123749
142925402300000,NW 320,Residential,13350,0,13350,99792,0,113142
142925402400000,NW 320,Residential,13950,0,13950,45245,0,59195
142925402500000,NW 320,Residential,19400,0,19400,93740,0,113140
142925402600000,NW 320,Residential,18176,0,18176,90386,0,108562
142925402700000,NW 320,Residential,18180,0,18180,93497,0,111677
142925402800000,NW 320,Residential,18887,0,18887,86047,0,104934
142925402900000,NW 320,Residential,18000,0,18000,76028,0,94028
142925403000000,NW 320,Residential,18000,0,18000,79873,0,97873
142925403100000,NW 320,Residential,13646,0,13646,81822,0,95468
142925500100000,NW 320,Residential,21294,0,21294,84035,0,105329
142925500200000,NW 320,Residential,19754,0,19754,98191,0,117945
142925500300000,NW 320,Residential,11200,0,11200,77543,0,88743
142925500400000,NW 320,Residential,18880,0,18880,78714,0,97594
142925500500000,NW 320,Residential,15040,0,15040,79713,0,94753
142925500600000,NW 320,Residential,22670,0,22670,95137,0,117807
142925500700000,NW 320,Residential,18744,0,18744,110968,0,129712
142925500800000,NW 320,Residential,19215,0,19215,123648,0,142863
142925500900000,NW 320,Residential,19221,0,19221,105600,0,124821
142925501000000,NW 320,Residential,17709,0,17709,87410,0,105119
142925501100000,NW 320,Residential,19581,0,19581,84175,0,103756
142925501200000,NW 320,Residential,19207,0,19207,103851,0,123058
142925501300000,NW 320,Residential,19094,0,19094,114662,0,133756
142925501400000,NW 320,Residential,21120,0,21120,83791,0,104911
142925501500000,NW 320,Residential,20886,0,20886,74736,0,95622
142925501600000,NW 320,Residential,19669,0,19669,92986,0,112655
142925501700000,NW 320,Residential,19400,0,19400,73479,0,92879
142925501800000,NW 320,Residential,17820,0,17820,85954,0,103774
142925501900000,NW 320,Residential,18000,0,18000,98001,0,116001
142925502000000,NW 320,Residential,18000,0,18000,70382,0,88382
142925502100000,NW 320,Residential,25200,0,25200,123227,0,148427
142925502200000,NW 320,Residential,13320,0,13320,75986,0,89306
142925502300000,NW 320,Residential,13080,0,13080,69533,0,82613
142925502400000,NW 320,Residential,18360,0,18360,106891,0,125251
142925502500000,NW 320,Residential,19080,0,19080,81367,0,100447
142925502600000,NW 320,Residential,16640,0,16640,86323,0,102963
142925502700000,NW 320,Residential,21634,0,21634,123259,0,144893
142925502800000,NW 320,Residential,18727,0,18727,119076,0,137803
142925502900000,NW 320,Residential,18720,0,18720,93463,0,112183
142925503000000,NW 320,Residential,19179,0,19179,113854,0,133033
142925503100000,NW 320,Residential,19360,0,19360,79409,0,98769
142925600100000,CITY PROPERTY,Exempt,0,0,0,0,0,0
142925700100000,CHURCH,Exempt,0,437400,437400,0,463905,901305
142925700400000,NW 320,Residential,26928,0,26928,136702,0,163630
142925700500000,OFFICE,Commercial,0,48600,48600,0,131974,180574
142925800100000,NW 320,Residential,18000,0,18000,101890,0,119890
142925800200000,NW 320,Residential,14140,0,14140,91963,0,106103
142925800300000,NW 320,Residential,12240,0,12240,116264,0,128504
142925800400000,NW 320,Residential,14420,0,14420,113341,0,127761
142925800500000,NW 320,Residential,18720,0,18720,128347,0,147067
142925800600000,NW 320,Residential,18720,0,18720,92856,0,111576
142925800700000,NW 320,Residential,18720,0,18720,89733,0,108453
142925800800000,NW 320,Residential,17860,0,17860,91351,0,109211
142925800900000,NW 320,Residential,8640,0,8640,71450,0,80090
142925801000000,NW 320,Residential,17820,0,17820,99229,0,117049
142925801100000,NW 320,Residential,18000,0,18000,104024,0,122024
142925801200000,NW 320,Residential,18000,0,18000,103070,0,121070
142925801300000,NW 320,Residential,18000,0,18000,91588,0,109588
142925801400000,NW 320,Residential,18000,0,18000,85737,0,103737
142925801500000,NW 320,Residential,18000,0,18000,81723,0,99723
142925801600000,NW 320,Residential,18000,0,18000,122927,0,140927
142925900100000,NW 320,Residential,18180,0,18180,81960,0,100140
142925900200000,NW 320,Residential,17820,0,17820,86604,0,104424
142925900300000,NW 320,Residential,17820,0,17820,79457,0,97277
142925900400000,NW 320,Residential,17820,0,17820,71799,0,89619
142925900500000,NW 320,Residential,17820,0,17820,85663,0,103483
142925900600000,NW 320,Residential,17820,0,17820,79374,0,97194
142925900700000,NW 320,Residential,17000,0,17000,66386,0,83386
142925900800000,NW 320,Residential,17719,0,17719,68767,0,86486
142925900900000,NW 320,Residential,14400,0,14400,60554,0,74954
142925901000000,NW 320,Residential,18651,0,18651,116662,0,135313
142925901100000,NW 320,Residential,17820,0,17820,108446,0,126266
142925901200000,NW 320,Residential,17820,0,17820,78887,0,96707
142925901300000,NW 320,Residential,17820,0,17820,79760,0,97580
142925901400000,NW 320,Residential,17820,0,17820,83767,0,101587
142925901500000,NW 320,Residential,17820,0,17820,94804,0,112624
142925901600000,NW 320,Residential,17820,0,17820,74916,0,92736
142925901700000,NW 320,Residential,17755,0,17755,87838,0,105593
142927600100000,NW 311,Residential,15600,0,15600,59303,0,74903
142927600200000,NW 311,Residential,16072,0,16072,77224,0,93296
142927600300000,NW 311,Residential,13720,0,13720,64962,0,78682
142927600400000,NW 311,Residential,19339,0,19339,81380,0,100719
142927600500000,NW 311,Residential,15840,0,15840,84286,0,100126
142927600600000,NW 311,Residential,16000,0,16000,85473,0,101473
142927600700000,NW 311,Residential,16429,0,16429,68052,0,84481
142927600800000,NW 311,Residential,16320,0,16320,55777,0,72097
142927600900000,NW 311,Residential,17996,0,17996,102464,0,120460
142927601000000,NW 311,Residential,17654,0,17654,55814,0,73468
142927601100000,NW 311,Residential,16394,0,16394,52692,0,69086
142927601200000,NW 311,Residential,20000,0,20000,58579,0,78579
142927601300000,NW 311,Residential,20000,0,20000,83000,0,103000
142927601400000,NW 311,Residential,20000,0,20000,53996,0,73996
142927601500000,NW 311,Residential,20000,0,20000,59615,0,79615
142927601600000,NW 311,Residential,16000,0,16000,61346,0,77346
142927601700000,NW 311,Residential,16320,0,16320,67488,0,83808
142927601800000,NW 311,Residential,16320,0,16320,70362,0,86682
142927601900000,NW 311,Residential,16025,0,16025,77987,0,94012
142927602000000,NW 311,Residential,15867,0,15867,85483,0,101350
142927602100000,NW 311,Residential,15840,0,15840,63746,0,79586
142927602200000,NW 311,Residential,16415,0,16415,75404,0,91819
142927602300000,NW 311,Residential,14913,0,14913,46087,0,61000
142927700100000,NW 311,Residential,16400,0,16400,78840,0,95240
142927700200000,NW 311,Residential,15045,0,15045,68930,0,83975
142927700300000,NW 311,Residential,13760,0,13760,75802,0,89562
142927700400000,NW 311,Residential,14400,0,14400,60536,0,74936
142927700500000,NW 311,Residential,15200,0,15200,65406,0,80606
142927700600000,NW 311,Residential,14720,0,14720,82391,0,97111
142927700700000,NW 311,Residential,15520,0,15520,65626,0,81146
142927700800000,NW 311,Residential,15840,0,15840,62054,0,77894
142927700900000,NW 311,Residential,20000,0,20000,66076,0,86076
142927701000000,NW 311,Residential,20000,0,20000,81258,0,101258
142927701100000,NW 311,Residential,20000,0,20000,72236,0,92236
142927701200000,NW 311,Residential,20000,0,20000,81520,0,101520
142927701300000,NW 311,Residential,20450,0,20450,66478,0,86928
142927701400000,SR/NURSING/ASSTD LIV,Commercial,0,68040,68040,0,1219516,1287556
142927701500000,NW 311,Residential,15667,0,15667,53651,0,69318
142927701600000,NW 311,Residential,12000,0,12000,50362,0,62362
142927701700000,NW 311,Residential,20000,0,20000,74033,0,94033
142927701800000,NW 311,Residential,21600,0,21600,84428,0,106028
142927701900000,NW 311,Residential,18045,0,18045,71123,0,89168
142927702000000,NW 311,Residential,16281,0,16281,60328,0,76609
142927702100000,NW 311,Residential,16281,0,16281,100502,0,116783
142927702200000,NW 311,Residential,16281,0,16281,90499,0,106780
142927702300000,NW 311,Residential,16116,0,16116,70711,0,86827
142927702400000,NW 311,Residential,16116,0,16116,68696,0,84812
142927702500000,NW 311,Residential,14000,0,14000,69145,0,83145
142927800100000,NW 320,Residential,16000,0,16000,81415,0,97415
142927800200000,NW 320,Residential,16000,0,16000,78105,0,94105
142927800300000,NW 320,Residential,16000,0,16000,68838,0,84838
142927800400000,NW 320,Residential,16000,0,16000,43856,0,59856
142927800500000,NW 320,Residential,16000,0,16000,49024,0,65024
142927800600000,NW 320,Residential,16000,0,16000,89130,0,105130
142927800700000,NW 320,Residential,16000,0,16000,56531,0,72531
142927800800000,NW 320,Residential,16000,0,16000,86803,0,102803
142927800900000,NW 320,Residential,16000,0,16000,76770,0,92770
142927801000000,NW 320,Residential,16000,0,16000,59144,0,75144
142927801100000,NW 320,Residential,16000,0,16000,65885,0,81885
142927801200000,NW 320,Residential,14000,0,14000,63171,0,77171
142927801300000,NW 320,Residential,16000,0,16000,61928,0,77928
142927801400000,NW 320,Residential,13552,0,13552,92232,0,105784
142927801500000,NW 320,Residential,15272,0,15272,90681,0,105953
142927801600000,NW 320,Residential,10200,0,10200,65694,0,75894
142927900100000,NW 320,Residential,22400,0,22400,112209,0,134609
142927900200000,NW 320,Residential,16000,0,16000,66261,0,82261
142927900300000,NW 320,Residential,16000,0,16000,61770,0,77770
142927900400000,NW 320,Residential,16000,0,16000,75472,0,91472
142927900500000,NW 320,Residential,16000,0,16000,89320,0,105320
142927900600000,NW 320,Residential,16000,0,16000,77537,0,93537
142927900700000,NW 320,Residential,16000,0,16000,68913,0,84913
142927900800000,NW 320,Residential,16000,0,16000,89237,0,105237
142927900900000,NW 320,Residential,16000,0,16000,74287,0,90287
142927901000000,NW 320,Residential,16000,0,16000,98395,0,114395
142927901100000,NW 320,Residential,15600,0,15600,59977,0,75577
142927901200000,NW 320,Residential,14400,0,14400,63039,0,77439
142927901300000,NW 320,Residential,16000,0,16000,69552,0,85552
142927901400000,NW 320,Residential,11200,0,11200,56991,0,68191
142927901500000,NW 320,Residential,11200,0,11200,67091,0,78291
142927901600000,NW 320,Residential,16000,0,16000,80261,0,96261
142927901700000,NW 320,Residential,16000,0,16000,89690,0,105690
142927901800000,NW 320,Residential,16000,0,16000,86137,0,102137
142927901900000,NW 320,Residential,14000,0,14000,89220,0,103220
142927902000000,NW 320,Residential,16000,0,16000,92182,0,108182
142927902100000,NW 320,Residential,16000,0,16000,91863,0,107863
142927902200000,NW 320,Residential,16000,0,16000,82792,0,98792
142927902300000,NW 320,Residential,16000,0,16000,88432,0,104432
142927902400000,NW 320,Residential,16000,0,16000,95547,0,111547
142927902500000,NW 320,Residential,16000,0,16000,73931,0,89931
142927902600000,NW 320,Residential,16000,0,16000,114757,0,130757
142927902700000,NW 320,Residential,15964,0,15964,43036,0,59000
142927902800000,NW 320,Residential,16000,0,16000,97635,0,113635
142927902900000,NW 320,Residential,16000,0,16000,70649,0,86649
142927903000000,NW 320,Residential,16000,0,16000,102898,0,118898
142928000100000,NW 320,Residential,16649,0,16649,48524,0,65173
142928000200000,NW 320,Residential,18156,0,18156,105132,0,123288
142928000300000,NW 320,Residential,15520,0,15520,88361,0,103881
142928000400000,NW 320,Residential,16000,0,16000,57340,0,73340
142928000500000,NW 320,Residential,16000,0,16000,98915,0,114915
142928000600000,NW 320,Residential,16000,0,16000,118483,0,134483
142928000700000,NW 320,Residential,16000,0,16000,97347,0,113347
142928000800000,NW 320,Residential,16000,0,16000,88694,0,104694
142928000900000,NW 320,Residential,16000,0,16000,65830,0,81830
142928001000000,NW 320,Residential,16000,0,16000,76337,0,92337
142928001100000,NW 320,Residential,22500,0,22500,122319,0,144819
142928001200000,NW 320,Residential,13600,0,13600,62436,0,76036
142928001300000,NW 320,Residential,16920,0,16920,91332,0,108252
142928001400000,NW 320,Residential,14288,0,14288,37181,0,51469
142928001500000,NW 320,Residential,18400,0,18400,113888,0,132288
142928001600000,NW 320,Residential,18000,0,18000,86572,0,104572
142928001700000,NW 320,Residential,18000,0,18000,110218,0,128218
142928001800000,NW 320,Residential,18000,0,18000,112856,0,130856
142928001900000,NW 320,Residential,18000,0,18000,112194,0,130194
142928002000000,NW 320,Residential,13335,0,13335,73427,0,86762
142928002100000,NW 320,Residential,13335,0,13335,86750,0,100085
142928002200000,NW 320,Residential,13335,0,13335,82411,0,95746
142928002300000,CONVERSION,Commercial,0,9072,9072,0,85753,94825
142928002400000,NW 320,Residential,22027,0,22027,97902,0,119929
142928002500000,NW 320,Residential,18000,0,18000,90738,0,108738
142928002600000,NW 320,Residential,18000,0,18000,88500,0,106500
142928002700000,NW 320,Residential,20000,0,20000,141618,0,161618
142928002800000,NW 320,Residential,18000,0,18000,108253,0,126253
142928100100000,NW 311,Residential,20400,0,20400,80889,0,101289
142928100200000,NW 311,Residential,17600,0,17600,61156,0,78756
142928100300000,NW 311,Residential,17600,0,17600,139185,0,156785
142928100400000,NW 311,Residential,17600,0,17600,74845,0,92445
142928100500000,NW 311,Residential,24480,0,24480,137302,0,161782
142928100600000,NW 311,Residential,20400,0,20400,92964,0,113364
142928200100000,NW 311,Residential,17600,0,17600,83590,0,101190
142928200200000,NW 311,Residential,20400,0,20400,73196,0,93596
142928200300000,NW 311,Residential,16000,0,16000,68602,0,84602
142928200400000,NW 311,Residential,12000,0,12000,67234,0,79234
142928200500000,NW 311,Residential,10640,0,10640,61311,0,71951
142928200600000,NW 311,Residential,10640,0,10640,71013,0,81653
142928200700000,NW 311,Residential,21280,0,21280,85003,0,106283
142928200800000,NW 311,Residential,20400,0,20400,140281,0,160681
142928200900000,NW 311,Residential,20400,0,20400,111824,0,132224
142928201000000,NW 311,Residential,20400,0,20400,78062,0,98462
142928201100000,CONVERSION,Commercial,0,15139,15139,0,101986,117125
142928201200000,NW 311,Residential,16320,0,16320,90529,0,106849
142928201300000,NW 311,Residential,17600,0,17600,84120,0,101720
142928201400000,NW 311,Residential,17600,0,17600,84590,0,102190
142928300100000,NW 320,Residential,24000,0,24000,66478,0,90478
142928300200000,NW 320,Residential,16000,0,16000,83822,0,99822
142928300300000,NW 320,Residential,20000,0,20000,112930,0,132930
142928300400000,NW 320,Residential,20000,0,20000,120362,0,140362
142928300500000,NW 320,Residential,20000,0,20000,106393,0,126393
142928300600000,NW 320,Residential,9240,0,9240,68816,0,78056
142928300700000,NW 320,Residential,10223,0,10223,48553,0,58776
142928300800000,NW 320,Residential,11900,0,11900,54600,0,66500
142928300900000,NW 320,Residential,11760,0,11760,50971,0,62731
142928301000000,NW 320,Residential,6480,0,6480,58625,0,65105
142928301100000,NW 320,Residential,6480,0,6480,50720,0,57200
142928301200000,NW 320,Residential,15200,0,15200,72834,0,88034
142928301300000,NW 320,Residential,27588,0,27588,93944,0,121532
142928301400000,NW 320,Residential,20000,0,20000,105177,0,125177
142928301500000,CONVERSION,Commercial,0,11340,11340,0,71375,82715
142928301600000,NW 320,Residential,20000,0,20000,115941,0,135941
142928301700000,NW 320,Residential,24800,0,24800,137515,0,162315
142928301800000,CONVERSION,Commercial,0,14968,14968,0,110437,125405
142928400100000,NW 320,Residential,24000,0,24000,124664,0,148664
142928400200000,NW 320,Residential,18000,0,18000,100748,0,118748
142928400300000,NW 320,Residential,18000,0,18000,83118,0,101118
142928400400000,NW 320,Residential,18000,0,18000,83958,0,101958
142928400500000,NW 320,Residential,18000,0,18000,79989,0,97989
142928400600000,NW 320,Residential,11872,0,11872,78874,0,90746
142928400700000,NW 320,Residential,17792,0,17792,81193,0,98985
142928400800000,NW 320,Residential,10640,0,10640,71366,0,82006
142928401200000,NW 320,Residential,13860,0,13860,74819,0,88679
142928401300000,NW 320,Residential,14000,0,14000,67075,0,81075
142928401400000,NW 320,Residential,18000,0,18000,85539,0,103539
142928401500000,NW 320,Residential,18000,0,18000,75263,0,93263
142928401600000,NW 320,Residential,18000,0,18000,85572,0,103572
142928401700000,NW 320,Residential,16600,0,16600,45880,0,62480
142928401800000,NW 320,Residential,10800,0,10800,63831,0,74631
142928401900000,NW 320,Residential,32566,0,32566,63138,0,95704
142928500100000,NW 311,Residential,20000,0,20000,93776,0,113776
142928500200000,FUNERAL HOME,Commercial,0,180360,180360,0,397285,577645
142928500300000,CITY PROPERTY,Exempt,0,0,0,0,0,0
142930100100000,CHURCH,Exempt,0,14580,14580,0,5332,19912
142930100200000,SW 404,Residential,15480,0,15480,60879,0,76359
142930100300000,SW 404,Residential,15790,0,15790,61663,0,77453
142930100400000,CHURCH,Exempt,0,22005,22005,0,3900,25905
142930100500000,SW 404,Residential,20624,0,20624,56376,0,77000
142930100600000,SW 404,Residential,18934,0,18934,53710,0,72644
142930100700000,SW 404,Residential,20406,0,20406,60443,0,80849
142930101000000,SW 404,Residential,21879,0,21879,58921,0,80800
142930101100000,SW 404,Residential,22070,0,22070,68823,0,90893
142930101200000,SW 404,Residential,19635,0,19635,56852,0,76487
142930101300000,SW 404,Residential,17850,0,17850,72027,0,89877
142930101400000,SW 404,Residential,18934,0,18934,58300,0,77234
142930101500000,SW 404,Residential,21332,0,21332,73248,0,94580
142930200100000,SW 404,Residential,18176,0,18176,97790,0,115966
142930200200000,SW 404,Residential,17820,0,17820,82430,0,100250
142930200300000,SW 404,Residential,17820,0,17820,107045,0,124865
142930200400000,SW 404,Residential,23364,0,23364,67454,0,90818
142930200500000,SW 404,Residential,18880,0,18880,110817,0,129697
142930200600000,SW 404,Residential,18880,0,18880,91779,0,110659
142930200700000,SW 404,Residential,18880,0,18880,104932,0,123812
142930200900000,SW 404,Residential,20400,0,20400,78614,0,99014
142930201000000,CHURCH,Exempt,0,21840,21840,0,0,21840
142930201100000,SW 404,Residential,19763,0,19763,69786,0,89549
142930201200000,SW 404,Residential,23562,0,23562,55137,0,78699
142930201300000,SW 404,Residential,16830,0,16830,62611,0,79441
142930201400000,SW 404,Residential,21038,0,21038,65497,0,86535
142930201500000,CONVERSION,Commercial,0,15989,15989,0,59955,75944
142930201600000,SW 404,Residential,1758,0,1758,3179,0,4937
142930300100000,CHURCH,Exempt,0,3375,3375,0,0,3375
142930300200000,CHURCH,Exempt,0,193050,193050,0,867127,1060177
142930300300000,SW 404,Residential,23100,0,23100,108777,0,131877
142930300400000,SW 404,Residential,22620,0,22620,16257,0,38877
142930300600000,SW 404,Residential,18800,0,18800,103704,0,122504
142930300700000,SW 404,Residential,22320,0,22320,99953,0,122273
142930300800000,SW 404,Residential,22491,0,22491,74841,0,97332
142930300900000,SW 404,Residential,22491,0,22491,89312,0,111803
142930301100000,APARTMENT,Commercial,0,15236,15236,0,122273,137509
142930400100000,SW 404,Residential,20196,0,20196,68954,0,89150
142930400200000,SW 404,Residential,20196,0,20196,72583,0,92779
142930400300000,SW 404,Residential,20196,0,20196,70568,0,90764
142930400400000,SW 404,Residential,20196,0,20196,90234,0,110430
142930400500000,SW 404,Residential,16830,0,16830,62572,0,79402
142930400600000,SW 404,Residential,16830,0,16830,74146,0,90976
142930400700000,CHURCH,Exempt,0,87739,87739,0,0,87739
142930500100000,SCHOOL,Exempt,0,272592,272592,0,1190551,1463143
142930500200000,SW 404,Residential,26136,0,26136,85472,0,111608
142930500300000,SW 404,Residential,24839,0,24839,125712,0,150551
142930500400000,SW 404,Residential,20304,0,20304,73224,0,93528
142930500500000,SW 404,Residential,20304,0,20304,72488,0,92792
142930500600000,SW 404,Residential,24365,0,24365,83436,0,107801
142930500700000,SW 404,Residential,20304,0,20304,90898,0,111202
142930500800000,SW 404,Residential,26750,0,26750,66352,0,93102
142930500900000,SW 404,Residential,26136,0,26136,121081,0,147217
142930600100000,CITY PROPERTY,Exempt,0,0,0,0,0,0
142932600100000,CITY PROPERTY,Exempt,0,0,0,0,0,0
142932600200000,SW 405,Residential,20221,0,20221,87762,0,107983
142932600300000,SW 405,Residential,20583,0,20583,116188,0,136771
142932600400000,SW 405,Residential,17928,0,17928,76350,0,94278
142932600500000,SW 405,Residential,17136,0,17136,85558,0,102694
142932600600000,SW 405,Residential,17136,0,17136,84522,0,101658
142932600700000,SW 405,Residential,17136,0,17136,106654,0,123790
142932600800000,SW 405,Residential,17136,0,17136,92449,0,109585
142932600900000,SW 405,Residential,17136,0,17136,70253,0,87389
142932601000000,SW 405,Residential,16320,0,16320,69798,0,86118
142932601100000,SW 405,Residential,16320,0,16320,68979,0,85299
142932601200000,SW 405,Residential,16320,0,16320,72088,0,88408
142932601300000,SW 405,Residential,16320,0,16320,65507,0,81827
142932601400000,SW 405,Residential,16320,0,16320,65721,0,82041
142932601500000,SW 405,Residential,18217,0,18217,123037,0,141254
142932700100000,SW 405,Residential,17503,0,17503,125096,0,142599
142932700200000,SW 405,Residential,19400,0,19400,126831,0,146231
142932700300000,SW 405,Residential,19400,0,19400,68494,0,87894
142932700400000,SW 405,Residential,19400,0,19400,63185,0,82585
142932700500000,SW 405,Residential,19400,0,19400,56432,0,75832
142932700600000,SW 405,Residential,23292,0,23292,99940,0,123232
142932700700000,SW 405,Residential,21347,0,21347,80585,0,101932
142932700800000,SW 405,Residential,20517,0,20517,75580,0,96097
142932700900000,SW 405,Residential,20000,0,20000,72055,0,92055
142932701000000,SW 405,Residential,19600,0,19600,66702,0,86302
142932701100000,SW 405,Residential,19400,0,19400,77148,0,96548
142932701200000,SW 405,Residential,19400,0,19400,84045,0,103445
142932701300000,SW 405,Residential,19400,0,19400,76260,0,95660
142932701400000,SW 405,Residential,19400,0,19400,69641,0,89041
142932701500000,SW 405,Residential,19646,0,19646,81070,0,100716
142932701600000,SW 405,Residential,18217,0,18217,84638,0,102855
142932701700000,SW 405,Residential,16320,0,16320,74357,0,90677
142932701800000,SW 405,Residential,16320,0,16320,74332,0,90652
142932701900000,SW 405,Residential,16320,0,16320,96097,0,112417
142932702000000,SW 405,Residential,16320,0,16320,80514,0,96834
142932702100000,SW 405,Residential,16320,0,16320,108312,0,124632
142932702200000,SW 405,Residential,17136,0,17136,98064,0,115200
142932702300000,SW 405,Residential,17136,0,17136,86390,0,103526
142932702400000,SW 405,Residential,17136,0,17136,63540,0,80676
142932702500000,SW 405,Residential,17136,0,17136,80703,0,97839
142932702600000,SW 405,Residential,17136,0,17136,76740,0,93876
142932702700000,SW 405,Residential,18360,0,18360,92388,0,110748
142932800100000,SW 405,Residential,23598,0,23598,71103,0,94701
142932900100000,SW 405,Residential,20460,0,20460,76834,0,97294
142932900200000,SW 405,Residential,19788,0,19788,98234,0,118022
142932900300000,SW 405,Residential,21248,0,21248,93619,0,114867
142932900400000,SW 405,Residential,19400,0,19400,69673,0,89073
142932900500000,SW 405,Residential,19600,0,19600,84998,0,104598
142932900600000,SW 405,Residential,19352,0,19352,71752,0,91104
142933000100000,SW 405,Residential,26160,0,26160,105841,0,132001
142933000200000,SW 405,Residential,28362,0,28362,129455,0,157817
142933000300000,SW 405,Residential,28499,0,28499,115007,0,143506
142933000400000,SW 405,Residential,25792,0,25792,107480,0,133272
142933000500000,SW 405,Residential,19454,0,19454,93815,0,113269
142933000600000,SW 405,Residential,27851,0,27851,107873,0,135724
142933000700000,SW 405,Residential,17626,0,17626,57012,0,74638
142933000800000,SW 405,Residential,17136,0,17136,79228,0,96364
142933000900000,SW 405,Residential,17136,0,17136,67593,0,84729
142933001000000,SW 405,Residential,23338,0,23338,107306,0,130644
142933001100000,SW 405,Residential,17952,0,17952,76113,0,94065
142933001200000,SW 405,Residential,20680,0,20680,84614,0,105294
142933001300000,SW 405,Residential,21056,0,21056,111543,0,132599
142933001400000,SW 405,Residential,23280,0,23280,93782,0,117062
142933001500000,SW 405,Residential,23280,0,23280,82927,0,106207
142933001600000,SW 405,Residential,21922,0,21922,78686,0,100608
142933001700000,SW 405,Residential,21922,0,21922,93844,0,115766
142933001800000,SW 405,Residential,23280,0,23280,114413,0,137693
142933001900000,SW 405,Residential,20295,0,20295,106169,0,126464
142933002000000,SW 405,Residential,25300,0,25300,110640,0,135940
142933002100000,SW 405,Residential,22320,0,22320,101091,0,123411
142933002200000,SW 405,Residential,23280,0,23280,75351,0,98631
142933002300000,SW 405,Residential,26160,0,26160,94616,0,120776
142933100100000,SW 405,Residential,15136,0,15136,73607,0,88743
142933100200000,SW 405,Residential,17680,0,17680,77707,0,95387
142933100300000,SW 405,Residential,20604,0,20604,68883,0,89487
142933100400000,SW 405,Residential,20604,0,20604,67163,0,87767
142933100500000,SW 405,Residential,20792,0,20792,83483,0,104275
142933100600000,SW 405,Residential,21379,0,21379,95517,0,116896
142933100700000,SW 405,Residential,21379,0,21379,83731,0,105110
142933100800000,SW 405,Residential,21845,0,21845,110814,0,132659
142933100900000,SW 405,Residential,21599,0,21599,95751,0,117350
142933101000000,SW 405,Residential,21820,0,21820,89460,0,111280
142933101100000,SW 405,Residential,21820,0,21820,86994,0,108814
142933101200000,SW 405,Residential,21782,0,21782,102232,0,124014
142933101300000,SW 405,Residential,19440,0,19440,66100,0,85540
142933101500000,SW 405,Residential,23599,0,23599,122684,0,146283
142933101600000,SW 405,Residential,16320,0,16320,66590,0,82910
142933101700000,SW 405,Residential,16320,0,16320,62406,0,78726
142933101800000,SW 405,Residential,17952,0,17952,77331,0,95283
142933101900000,SW 405,Residential,17952,0,17952,78844,0,96796
142933102000000,SW 405,Residential,11669,0,11669,93133,0,104802
142933102100000,SW 405,Residential,11669,0,11669,0,0,11669
142933102200000,SW 405,Residential,23338,0,23338,68872,0,92210
142933102300000,SW 405,Residential,17952,0,17952,75912,0,93864
142933102400000,SW 405,Residential,15136,0,15136,72248,0,87384
142933200100000,SW 405,Residential,22382,0,22382,78951,0,101333
142933200200000,SW 405,Residential,22220,0,22220,90598,0,112818
142933200300000,SW 405,Residential,20533,0,20533,86694,0,107227
142933200400000,SW 405,Residential,21170,0,21170,68296,0,89466
142933300100000,SW 405,Residential,23980,0,23980,93630,0,117610
142933300200000,SW 405,Residential,24128,0,24128,77493,0,101621
142933300300000,SW 405,Residential,24752,0,24752,93010,0,117762
142933300400000,SW 405,Residential,24752,0,24752,101289,0,126041
142933300500000,SW 405,Residential,24960,0,24960,95287,0,120247
142933300600000,SW 405,Residential,24960,0,24960,73546,0,98506
142933300700000,SW 405,Residential,24960,0,24960,81262,0,106222
142933300800000,SW 405,Residential,24150,0,24150,76519,0,100669
142933300900000,SW 405,Residential,12444,0,12444,75001,0,87445
142933301000000,SW 405,Residential,12444,0,12444,63620,0,76064
142933301100000,SW 405,Residential,20502,0,20502,69132,0,89634
142933301200000,SW 405,Residential,16320,0,16320,69454,0,85774
142933301300000,SW 405,Residential,18360,0,18360,0,0,18360
142933301400000,SW 405,Residential,19421,0,19421,109998,0,129419
142933301500000,SW 405,Residential,19074,0,19074,86523,0,105597
142933301600000,SW 405,Residential,21429,0,21429,94716,0,116145
142933301700000,SW 405,Residential,21252,0,21252,81579,0,102831
142933301800000,SW 405,Residential,21216,0,21216,71781,0,92997
142933301900000,SW 405,Residential,21216,0,21216,74137,0,95353
142933302000000,SW 405,Residential,21216,0,21216,96007,0,117223
142933302100000,SW 405,Residential,21216,0,21216,82757,0,103973
142933302200000,SW 405,Residential,21216,0,21216,91357,0,112573
142933302300000,SW 405,Residential,20700,0,20700,99936,0,120636
142933302400000,SW 405,Residential,24595,0,24595,88009,0,112604
142933302500000,SW 405,Residential,23000,0,23000,100008,0,123008
142933302600000,SW 405,Residential,23980,0,23980,84572,0,108552
142933302700000,SW 405,Residential,21800,0,21800,92863,0,114663
142933400100000,SW 405,Residential,21155,0,21155,82802,0,103957
142933400200000,SW 405,Residential,20776,0,20776,101571,0,122347
142933400300000,SW 405,Residential,20776,0,20776,72659,0,93435
142933400400000,SW 405,Residential,20776,0,20776,89786,0,110562
142933400500000,SW 405,Residential,19592,0,19592,97978,0,117570
142935100100000,SW 405,Residential,21502,0,21502,50640,0,72142
142935100200000,SW 405,Residential,18200,0,18200,58104,0,76304
142935100300000,SW 405,Residential,19292,0,19292,52766,0,72058
142935100400000,SW 405,Residential,18200,0,18200,58528,0,76728
142935100500000,SW 405,Residential,19292,0,19292,61451,0,80743
142935100600000,SW 405,Residential,18200,0,18200,54943,0,73143
142935100700000,SW 405,Residential,19292,0,19292,64595,0,83887
142935100800000,SW 405,Residential,18200,0,18200,63751,0,81951
142935100900000,SW 405,Residential,19292,0,19292,66701,0,85993
142935101000000,SW 405,Residential,19716,0,19716,71524,0,91240
142935101100000,SW 405,Residential,20564,0,20564,58165,0,78729
142935101200000,SW 405,Residential,21412,0,21412,62915,0,84327
142935101300000,SW 405,Residential,19292,0,19292,59434,0,78726
142935101400000,SW 405,Residential,21594,0,21594,68722,0,90316
142935101500000,SW 405,Residential,20275,0,20275,58966,0,79241
142935101600000,SW 405,Residential,21168,0,21168,72213,0,93381
142935101700000,SW 405,Residential,21120,0,21120,76809,0,97929
142935101800000,SW 405,Residential,20434,0,20434,60851,0,81285
142935101900000,SW 405,Residential,19992,0,19992,91991,0,111983
142935102000000,SW 405,Residential,20888,0,20888,88374,0,109262
142935102100000,SW 405,Residential,20642,0,20642,61460,0,82102
142935102200000,SW 405,Residential,20626,0,20626,57970,0,78596
142935102300000,SW 405,Residential,20020,0,20020,58608,0,78628
142935102400000,SW 405,Residential,20020,0,20020,55943,0,75963
142935102500000,SW 405,Residential,20020,0,20020,59027,0,79047
142935102600000,SW 405,Residential,20020,0,20020,63574,0,83594
142935102700000,SW 405,Residential,20020,0,20020,55326,0,75346
142935102800000,SW 405,Residential,20657,0,20657,67793,0,88450
142935200100000,SW 405,Residential,20822,0,20822,73714,0,94536
142935200200000,SW 405,Residential,20680,0,20680,60746,0,81426
142935200300000,SW 405,Residential,20460,0,20460,59066,0,79526
142935200400000,SW 405,Residential,20871,0,20871,70763,0,91634
142935200500000,SW 405,Residential,20460,0,20460,63769,0,84229
142935200600000,SW 405,Residential,20196,0,20196,56302,0,76498
142935200700000,SW 405,Residential,20800,0,20800,57044,0,77844
142935200800000,SW 405,Residential,21186,0,21186,65350,0,86536
142935200900000,SW 405,Residential,20800,0,20800,54827,0,75627
142935201000000,SW 405,Residential,20240,0,20240,60661,0,80901
142935201100000,SW 405,Residential,21354,0,21354,66073,0,87427
142935201200000,SW 405,Residential,19947,0,19947,65127,0,85074
142935201300000,SW 405,Residential,21816,0,21816,55145,0,76961
142935201400000,SW 405,Residential,20489,0,20489,67487,0,87976
142935201500000,SW 405,Residential,23436,0,23436,55047,0,78483
142935201600000,SW 405,Residential,19689,0,19689,58569,0,78258
142935201700000,SW 405,Residential,20160,0,20160,63810,0,83970
142935201800000,SW 405,Residential,19968,0,19968,60956,0,80924
142935201900000,SW 405,Residential,20853,0,20853,60688,0,81541
142935300100000,SW 405,Residential,21082,0,21082,68558,0,89640
142935300200000,SW 405,Residential,19400,0,19400,58873,0,78273
142935300300000,SW 405,Residential,20564,0,20564,62946,0,83510
142935300400000,SW 405,Residential,19400,0,19400,57466,0,76866
142935300500000,SW 405,Residential,20564,0,20564,63923,0,84487
142935300600000,SW 405,Residential,19400,0,19400,59960,0,79360
142935300700000,SW 405,Residential,20564,0,20564,58802,0,79366
142935300800000,SW 405,Residential,19400,0,19400,58682,0,78082
142935300900000,SW 405,Residential,20952,0,20952,57028,0,77980
142935400100000,SW 405,Residential,22146,0,22146,60054,0,82200
142935400200000,SW 405,Residential,21120,0,21120,53022,0,74142
142935400300000,SW 405,Residential,21069,0,21069,58149,0,79218
142935400400000,SW 405,Residential,18800,0,18800,57881,0,76681
142935400500000,SW 405,Residential,19400,0,19400,79495,0,98895
142935400600000,SW 405,Residential,19400,0,19400,58107,0,77507
142935400700000,SW 405,Residential,21340,0,21340,61025,0,82365
142935400800000,SW 405,Residential,19400,0,19400,52997,0,72397
142935400900000,SW 405,Residential,19400,0,19400,59719,0,79119
142935401000000,SW 405,Residential,21340,0,21340,62320,0,83660
142935401100000,SW 405,Residential,19400,0,19400,90437,0,109837
142935401200000,SW 405,Residential,19400,0,19400,68405,0,87805
142935401300000,SW 405,Residential,18920,0,18920,74553,0,93473
142935401400000,SW 405,Residential,20762,0,20762,64227,0,84989
142935401500000,SW 405,Residential,21120,0,21120,59441,0,80561
142935401600000,SW 405,Residential,20515,0,20515,54015,0,74530
142935401700000,SW 405,Residential,18800,0,18800,65264,0,84064
142935401800000,SW 405,Residential,19400,0,19400,57596,0,76996
142935401900000,SW 405,Residential,19400,0,19400,68794,0,88194
142935402000000,SW 405,Residential,21340,0,21340,68313,0,89653
142935402100000,SW 405,Residential,19400,0,19400,60514,0,79914
142935402200000,SW 405,Residential,19400,0,19400,55258,0,74658
142935402300000,SW 405,Residential,21340,0,21340,74808,0,96148
142935402400000,SW 405,Residential,19400,0,19400,64750,0,84150
142935402500000,SW 405,Residential,19400,0,19400,63404,0,82804
142935402600000,SW 405,Residential,18920,0,18920,40790,0,59710
142935500100000,SW 405,Residential,22699,0,22699,65647,0,88346
142935500200000,SW 405,Residential,20400,0,20400,63064,0,83464
142935500300000,SW 405,Residential,19910,0,19910,83035,0,102945
142935500400000,SW 405,Residential,21766,0,21766,78509,0,100275
142935500500000,SW 405,Residential,20577,0,20577,58202,0,78779
142935500600000,SW 405,Residential,20564,0,20564,77158,0,97722
142935500700000,SW 405,Residential,20776,0,20776,77030,0,97806
142935500800000,SW 405,Residential,20792,0,20792,62918,0,83710
142935500900000,SW 405,Residential,21516,0,21516,57301,0,78817
142935501000000,SW 405,Residential,21333,0,21333,63829,0,85162
142935501100000,SW 405,Residential,20907,0,20907,58970,0,79877
142935501200000,SW 405,Residential,20480,0,20480,51087,0,71567
142935501300000,SW 405,Residential,20141,0,20141,53430,0,73571
142935501400000,SW 405,Residential,21120,0,21120,67531,0,88651
142935501500000,SW 405,Residential,18800,0,18800,81262,0,100062
142935501600000,SW 405,Residential,21466,0,21466,75724,0,97190
142935501700000,SW 405,Residential,19372,0,19372,108752,0,128124
142935501800000,SW 405,Residential,20836,0,20836,53703,0,74539
142935501900000,SW 405,Residential,20137,0,20137,63510,0,83647
142935502000000,SW 405,Residential,20045,0,20045,63684,0,83729
142935502100000,SW 405,Residential,20519,0,20519,62662,0,83181
142935502200000,SW 405,Residential,20854,0,20854,57778,0,78632
142935502300000,SW 405,Residential,21560,0,21560,67068,0,88628
142935502400000,SW 405,Residential,21987,0,21987,59265,0,81252
142935502500000,SW 405,Residential,20096,0,20096,62336,0,82432
142935502600000,SW 405,Residential,19988,0,19988,55954,0,75942
142935502700000,SW 405,Residential,21307,0,21307,55443,0,76750
142935502800000,SW 405,Residential,21197,0,21197,77672,0,98869
142935502900000,SW 405,Residential,23840,0,23840,57994,0,81834
142935503000000,SW 405,Residential,20304,0,20304,57804,0,78108
142935600100000,SW 405,Residential,20952,0,20952,89257,0,110209
142935600200000,SW 405,Residential,19400,0,19400,73774,0,93174
142935600300000,SW 405,Residential,20176,0,20176,75782,0,95958
142935600400000,SW 405,Residential,20176,0,20176,70776,0,90952
142935600500000,SW 405,Residential,20176,0,20176,68986,0,89162
142935600600000,SW 405,Residential,20176,0,20176,69639,0,89815
142935600700000,SW 405,Residential,20176,0,20176,77213,0,97389
142935600800000,SW 405,Residential,19400,0,19400,72551,0,91951
142935600900000,SW 405,Residential,20952,0,20952,64194,0,85146
142935700100000,SW 405,Residential,21364,0,21364,72590,0,93954
142935700200000,SW 405,Residential,20651,0,20651,80377,0,101028
142935700300000,SW 405,Residential,20520,0,20520,59622,0,80142
142935700400000,SW 405,Residential,20064,0,20064,58622,0,78686
142935700500000,SW 405,Residential,20686,0,20686,71610,0,92296
142935700600000,SW 405,Residential,20774,0,20774,55324,0,76098
142935700700000,SW 405,Residential,19840,0,19840,50104,0,69944
142935700800000,SW 405,Residential,19220,0,19220,74862,0,94082
142935700900000,SW 405,Residential,18393,0,18393,70273,0,88666
142935701000000,SW 405,Residential,17980,0,17980,80902,0,98882
142935701100000,SW 405,Residential,17773,0,17773,74802,0,92575
142935701200000,SW 405,Residential,18393,0,18393,81387,0,99780
142935701300000,SW 405,Residential,19013,0,19013,78707,0,97720
142935701400000,SW 405,Residential,19840,0,19840,79211,0,99051
142935701500000,SW 405,Residential,22016,0,22016,85943,0,107959
142935701600000,SW 405,Residential,18200,0,18200,81005,0,99205
142935701700000,SW 405,Residential,22016,0,22016,75699,0,97715
142935701800000,SW 405,Residential,21360,0,21360,81372,0,102732
142935701900000,SW 405,Residential,21467,0,21467,75774,0,97241
142935702000000,SW 405,Residential,20767,0,20767,90296,0,111063
142935702100000,SW 405,Residential,20533,0,20533,74880,0,95413
142935702200000,SW 405,Residential,17773,0,17773,80071,0,97844
142935702300000,SW 405,Residential,17980,0,17980,81474,0,99454
142935702400000,SW 405,Residential,18807,0,18807,69591,0,88398
142935702500000,SW 405,Residential,19200,0,19200,69709,0,88909
142935702600000,SW 405,Residential,20000,0,20000,69033,0,89033
142935702700000,SW 405,Residential,20600,0,20600,71232,0,91832
142935702800000,SW 405,Residential,21000,0,21000,81046,0,102046
142935702900000,SW 405,Residential,19600,0,19600,72379,0,91979
142935703000000,SW 405,Residential,21362,0,21362,57283,0,78645
142935703100000,SW 405,Residential,20826,0,20826,83816,0,104642
142935703200000,SW 405,Residential,21000,0,21000,76410,0,97410
142935703300000,SW 405,Residential,19800,0,19800,77130,0,96930
142935703400000,SW 405,Residential,21120,0,21120,71418,0,92538
142935800100000,SW 405,Residential,21097,0,21097,69535,0,90632
142935800200000,SW 405,Residential,18800,0,18800,73875,0,92675
142935800300000,SW 405,Residential,20000,0,20000,69741,0,89741
142935800400000,SW 405,Residential,20000,0,20000,69356,0,89356
142935800500000,SW 405,Residential,20000,0,20000,74859,0,94859
142935800600000,SW 405,Residential,20000,0,20000,86666,0,106666
142935800700000,SW 405,Residential,20000,0,20000,74700,0,94700
142935800800000,SW 405,Residential,20000,0,20000,76613,0,96613
142935800900000,SW 405,Residential,19800,0,19800,68810,0,88610
142935801000000,SW 405,Residential,19800,0,19800,78480,0,98280
142935801100000,SW 405,Residential,19800,0,19800,69177,0,88977
142935801200000,SW 405,Residential,19800,0,19800,74372,0,94172
142935801300000,SW 405,Residential,19800,0,19800,87825,0,107625
142935801400000,SW 405,Residential,20885,0,20885,78104,0,98989
142935801500000,SW 405,Residential,25663,0,25663,84580,0,110243
142935801600000,SW 405,Residential,18200,0,18200,69411,0,87611
142935801700000,SW 405,Residential,21989,0,21989,63861,0,85850
142935801800000,SW 405,Residential,21867,0,21867,75869,0,97736
142935801900000,SW 405,Residential,19800,0,19800,77497,0,97297
142935802000000,SW 405,Residential,19800,0,19800,80614,0,100414
142935802100000,SW 405,Residential,19800,0,19800,69692,0,89492
142935802200000,SW 405,Residential,19800,0,19800,74393,0,94193
142935802300000,SW 405,Residential,19800,0,19800,64880,0,84680
142935802400000,SW 405,Residential,19800,0,19800,69423,0,89223
142935802500000,SW 405,Residential,19800,0,19800,77352,0,97152
142935802600000,SW 405,Residential,19800,0,19800,72058,0,91858
142935802700000,SW 405,Residential,19800,0,19800,70073,0,89873
142935802800000,SW 405,Residential,19800,0,19800,76422,0,96222
142935802900000,SW 405,Residential,19800,0,19800,78905,0,98705
142935803000000,SW 405,Residential,19000,0,19000,69804,0,88804
142935803100000,SW 405,Residential,20862,0,20862,106446,0,127308
142935803200000,SW 405,Residential,18768,0,18768,82103,0,100871
142935803300000,SW 405,Residential,18547,0,18547,73690,0,92237
142935900100000,SW 405,Residential,21922,0,21922,64854,0,86776
142935900200000,SW 405,Residential,20608,0,20608,58181,0,78789
142935900300000,SW 405,Residential,18800,0,18800,74870,0,93670
142935900400000,SW 405,Residential,19200,0,19200,72421,0,91621
142935900500000,SW 405,Residential,19400,0,19400,69023,0,88423
142935900600000,SW 405,Residential,19972,0,19972,64415,0,84387
142935900700000,SW 405,Residential,18800,0,18800,87192,0,105992
142936000100000,SW 405,Residential,20352,0,20352,73220,0,93572
142936000200000,SW 405,Residential,20564,0,20564,71925,0,92489
142936000300000,SW 405,Residential,20564,0,20564,70238,0,90802
142936000400000,SW 405,Residential,19904,0,19904,88323,0,108227
142937600100000,CITY PROPERTY,Exempt,0,0,0,0,0,0
142937600200000,SCHOOL,Exempt,0,0,0,0,0,0
142937600202000,ANTENNAS/TOWERS(BLL),Commercial,0,0,0,0,87927,87927
142937600300000,CITY PROPERTY,Exempt,0,0,0,0,0,0
142937700100000,WAREHOUSE,Commercial,0,144450,144450,0,428935,573385
142937700200000,WAREHOUSE,Commercial,0,122445,122445,0,524323,646768
142937700300000,FLAT PARKING,Commercial,0,18225,18225,0,13860,32085
142937700400000,SHOP,Commercial,0,80865,80865,0,467950,548815
142937700500000,FLAT PARKING,Commercial,0,14774,14774,0,9922,24696
142937700600000,SHOP,Commercial,0,51322,51322,0,181671,232993
142937700700000,SHOP,Commercial,0,34814,34814,0,122386,157200
142937800100000,CENTRALLY ASSESSED,Other,0,0,0,0,0,0
142940100100000,SCHOOL,Exempt,0,0,0,0,0,0
142940100200000,CITY PROPERTY,Exempt,0,0,0,0,0,0
142940200100000,SW 404,Residential,12750,0,12750,61041,0,73791
142940200200000,CITY PROPERTY,Exempt,0,0,0,0,0,0
142940200300000,SW 404,Residential,12750,0,12750,52083,0,64833
142940200400000,SW 404,Residential,13770,0,13770,54442,0,68212
142940200500000,SW 404,Residential,10200,0,10200,53721,0,63921
142940200600000,CITY PROPERTY,Exempt,0,0,0,0,0,0
142940200700000,SW 404,Residential,5000,0,5000,0,0,5000
142940200800000,SW 404,Residential,14901,0,14901,64404,0,79305
142940200900000,SW 404,Residential,11156,0,11156,60762,0,71918
142940201000000,SW 404,Residential,9562,0,9562,69777,0,79339
142940201100000,SW 404,Residential,9562,0,9562,47266,0,56828
142940201200000,SW 404,Residential,9562,0,9562,0,0,9562
142940201300000,SW 404,Residential,15300,0,15300,76367,0,91667
142940201400000,SW 404,Residential,10870,0,10870,65375,0,76245
142940201500000,SW 404,Residential,13770,0,13770,64470,0,78240
142940201600000,SW 404,Residential,15300,0,15300,0,0,15300
142940201700000,SW 404,Residential,12750,0,12750,67885,0,80635
142940201800000,SW 404,Residential,12750,0,12750,29513,0,42263
142940201900000,SW 404,Residential,15300,0,15300,63021,0,78321
142940300100000,SW 404,Residential,13005,0,13005,78037,0,91042
142940300200000,SW 404,Residential,13005,0,13005,57312,0,70317
142940300300000,CITY PROPERTY,Exempt,0,0,0,0,0,0
142940300400000,WAREHOUSE,Commercial,0,14580,14580,0,6708,21288
142940300500000,CITY PROPERTY,Exempt,0,0,0,0,0,0
142940300600000,CITY PROPERTY,Exempt,0,0,0,0,0,0
142940300700000,SW 404,Residential,14370,0,14370,61000,0,75370
142940300800000,SW 404,Residential,14370,0,14370,63320,0,77690
142940300900000,SW 404,Residential,14370,0,14370,52153,0,66523
142940301000000,CONVERSION,Commercial,0,10561,10561,0,44427,54988
142940301100000,SW 404,Residential,13433,0,13433,42144,0,55577
142940301200000,SW 404,Residential,14045,0,14045,55343,0,69388
142940301300000,SW 404,Residential,14630,0,14630,54594,0,69224
142940301400000,SW 404,Residential,13495,0,13495,62685,0,76180
142940301500000,SW 404,Residential,14225,0,14225,67617,0,81842
142940400100000,CITY PROPERTY,Exempt,0,0,0,0,0,0
142940400200000,SW 404,Residential,8176,0,8176,43851,0,52027
142940400300000,SW 404,Residential,13076,0,13076,80358,0,93434
142940400400000,SW 404,Residential,14360,0,14360,49502,0,63862
142940400500000,SW 404,Residential,12112,0,12112,56186,0,68298
142940400600000,SW 404,Residential,11475,0,11475,40307,0,51782
142940400700000,SW 404,Residential,10837,0,10837,52857,0,63694
142940400800000,SW 404,Residential,11156,0,11156,47696,0,58852
142940400900000,SW 404,Residential,11245,0,11245,69505,0,80750
142940401000000,SMALL RETAIL,Commercial,0,58441,58441,0,134408,192849
142940401100000,SW 404,Residential,10200,0,10200,66750,0,76950
142940401200000,CITY PROPERTY,Exempt,0,0,0,0,0,0
142940401300000,SW 404,Residential,6757,0,6757,0,0,6757
142940500100000,SW 404,Residential,13464,0,13464,60315,0,73779
142940500200000,SW 404,Residential,7905,0,7905,51750,0,59655
142940500300000,SW 404,Residential,13838,0,13838,66043,0,79881
142940500400000,CONVERSION,Commercial,0,5400,5400,0,0,5400
142940500500000,SW 404,Residential,12750,0,12750,65081,0,77831
142940500600000,SW 404,Residential,5000,0,5000,0,0,5000
142940500700000,CITY PROPERTY,Exempt,0,0,0,0,0,0
142940500800000,SW 404,Residential,11023,0,11023,61677,0,72700
142940500900000,CHURCH,Exempt,0,12879,12879,0,20561,33440
142940501000000,SW 404,Residential,15300,0,15300,48150,0,63450
142940501100000,SW 404,Residential,13196,0,13196,58285,0,71481
142940501200000,SW 404,Residential,13021,0,13021,0,0,13021
142940501300000,CITY PROPERTY,Exempt,0,0,0,0,0,0
142940501400000,SW 404,Residential,11335,0,11335,57718,0,69053
142940600100000,SW 404,Residential,12941,0,12941,31299,0,44240
142940600200000,SW 404,Residential,9595,0,9595,51818,0,61413
142940600300000,SW 404,Residential,9595,0,9595,38733,0,48328
142940600400000,SW 404,Residential,6917,0,6917,53165,0,60082
142940600500000,SW 404,Residential,6917,0,6917,51470,0,58387
142940600600000,SW 404,Residential,6694,0,6694,51496,0,58190
142940600700000,SW 404,Residential,6694,0,6694,57179,0,63873
142940600800000,SW 404,Residential,12881,0,12881,42816,0,55697
142940600900000,SW 404,Residential,13387,0,13387,59629,0,73016
142940601000000,SW 404,Residential,13387,0,13387,60867,0,74254
142940601100000,SW 404,Residential,8366,0,8366,34781,0,43147
142940601200000,SW 404,Residential,7461,0,7461,38998,0,46459
142940601300000,SW 404,Residential,7461,0,7461,41917,0,49378
142940601400000,SW 404,Residential,8366,0,8366,42101,0,50467
142940601500000,SW 404,Residential,6456,0,6456,48982,0,55438
142940601600000,SW 404,Residential,5000,0,5000,0,0,5000
142940601700000,SW 404,Residential,5000,0,5000,0,0,5000
142940601800000,SW 404,Residential,6456,0,6456,52408,0,58864
142940601900000,SW 404,Residential,11794,0,11794,56619,0,68413
142940602000000,SW 404,Residential,11156,0,11156,37540,0,48696
142940602100000,SW 404,Residential,11475,0,11475,73018,0,84493
142940602200000,SW 404,Residential,8479,0,8479,34911,0,43390
142940700500000,SW 404,Residential,5000,0,5000,0,0,5000
142940700600000,SW 404,Residential,13770,0,13770,71120,0,84890
142940700700000,SW 404,Residential,11156,0,11156,71094,0,82250
142940701000000,CITY PROPERTY,Exempt,0,0,0,0,0,0
142940701100000,SW 404,Residential,12346,0,12346,63337,0,75683
142940701200000,NBHD SHOPPING CENTER,Commercial,0,128628,128628,0,328027,456655
142940701300000,SW 404,Residential,18169,0,18169,60896,0,79065
142940800100000,SW 404,Residential,15778,0,15778,42133,0,57911
142940800200000,SW 404,Residential,12941,0,12941,39538,0,52479
142940800300000,SW 404,Residential,5000,0,5000,0,0,5000
142940800400000,SW 404,Residential,10353,0,10353,53207,0,63560
142940800500000,SW 404,Residential,5000,0,5000,0,0,5000
142940800600000,SW 404,Residential,3713,0,3713,8086,0,11799
142940800700000,CITY PROPERTY,Exempt,0,0,0,0,0,0
142940800800000,CITY PROPERTY,Exempt,0,0,0,0,0,0
142940800900000,SW 404,Residential,12272,0,12272,68630,0,80902
142940801000000,SW 404,Residential,9817,0,9817,53988,0,63805
142940801100000,SW 404,Residential,9817,0,9817,67704,0,77521
142940801200000,SW 404,Residential,14360,0,14360,60245,0,74605
142940801300000,SW 404,Residential,14360,0,14360,64780,0,79140
142940801400000,SW 404,Residential,16575,0,16575,65670,0,82245
142940801500000,SW 404,Residential,12750,0,12750,39772,0,52522
142940900100000,SW 404,Residential,14360,0,14360,47647,0,62007
142940900200000,SW 404,Residential,8540,0,8540,55293,0,63833
142940900300000,SW 404,Residential,15988,0,15988,80095,0,96083
142940900400000,SW 404,Residential,12375,0,12375,66235,0,78610
142940900500000,SW 404,Residential,12750,0,12750,66578,0,79328
142940900600000,SW 404,Residential,12750,0,12750,74801,0,87551
142940900700000,SW 404,Residential,16894,0,16894,76902,0,93796
142940900800000,SW 404,Residential,16894,0,16894,53008,0,69902
142940900900000,SW 404,Residential,8176,0,8176,54327,0,62503
142940901000000,SW 404,Residential,7267,0,7267,60836,0,68103
142940901100000,SW 404,Residential,9967,0,9967,57587,0,67554
142940901200000,SW 404,Residential,12750,0,12750,54657,0,67407
142940901300000,SW 404,Residential,14360,0,14360,55062,0,69422
142940901400000,SW 404,Residential,5000,0,5000,0,0,5000
142940901500000,SW 404,Residential,10360,0,10360,63821,0,74181
142941000100000,SW 404,Residential,17212,0,17212,84994,0,102206
142941000200000,SW 404,Residential,9765,0,9765,58948,0,68713
142941000300000,SW 404,Residential,15835,0,15835,44840,0,60675
142941000400000,SW 404,Residential,16084,0,16084,81837,0,97921
142941000500000,SW 404,Residential,10,0,10,0,0,10
142941000600000,SW 404,Residential,14153,0,14153,80981,0,95134
142941000700000,SW 404,Residential,13770,0,13770,56520,0,70290
142941000800000,SW 404,Residential,15487,0,15487,48354,0,63841
142941000900000,SW 404,Residential,13388,0,13388,72329,0,85717
142941001000000,SW 404,Residential,13388,0,13388,67877,0,81265
142941001100000,SW 404,Residential,13770,0,13770,58482,0,72252
142941001200000,COUNTY PROPERTY,Exempt,0,0,0,0,0,0
142941001300000,SW 404,Residential,13388,0,13388,72090,0,85478
142941001400000,SW 404,Residential,13388,0,13388,66837,0,80225
142941001500000,SW 404,Residential,11475,0,11475,60430,0,71905
142941100100000,CITY PROPERTY,Exempt,0,0,0,0,0,0
142941100200000,SW 404,Residential,16065,0,16065,0,0,16065
142941100300000,SW 404,Residential,10472,0,10472,51216,0,61688
142941100400000,CITY PROPERTY,Exempt,0,0,0,0,0,0
142941100500000,CITY PROPERTY,Exempt,0,0,0,0,0,0
142941100600000,SW 404,Residential,10472,0,10472,55445,0,65917
142941100700000,SW 404,Residential,10880,0,10880,71590,0,82470
142941100800000,SW 404,Residential,10880,0,10880,56851,0,67731
142941100900000,SW 404,Residential,9945,0,9945,57344,0,67289
142941101000000,SW 404,Residential,9460,0,9460,52653,0,62113
142941200100000,SW 404,Residential,15259,0,15259,27977,0,43236
142941200200000,CITY PROPERTY,Exempt,0,0,0,0,0,0
142941200300000,SW 404,Residential,9279,0,9279,53471,0,62750
142941200400000,SW 404,Residential,9551,0,9551,51834,0,61385
142941200500000,SW 404,Residential,9551,0,9551,56446,0,65997
142941200600000,SW 404,Residential,9551,0,9551,49309,0,58860
142941200700000,SW 404,Residential,12750,0,12750,51006,0,63756
142941201000000,SW 404,Residential,14858,0,14858,36731,0,51589
142941201100000,SW 404,Residential,12995,0,12995,85295,0,98290
142941300100000,SW 404,Residential,16894,0,16894,78900,0,95794
142941300200000,SMALL RETAIL,Commercial,0,12247,12247,0,40116,52363
142941300300000,SW 404,Residential,15675,0,15675,63019,0,78694
142941300400000,SW 404,Residential,15000,0,15000,65785,0,80785
142941300500000,SW 404,Residential,14250,0,14250,64539,0,78789
142941300600000,SW 404,Residential,17550,0,17550,57724,0,75274
142941300700000,SW 404,Residential,15000,0,15000,58363,0,73363
142942600100000,SW 404,Residential,5966,0,5966,0,0,5966
142942600200000,OFFICE,Commercial,0,13996,13996,0,55465,69461
142942600300000,SW 404,Residential,11963,0,11963,48100,0,60063
142942600400000,SW 404,Residential,15000,0,15000,66599,0,81599
142942600500000,SW 404,Residential,16875,0,16875,80385,0,97260
142942600600000,SW 404,Residential,15000,0,15000,69812,0,84812
142942600700000,SW 404,Residential,15000,0,15000,60449,0,75449
142942600800000,APARTMENT,Commercial,0,7258,7258,0,47421,54679
142942600900000,SW 404,Residential,15000,0,15000,78295,0,93295
142942601000000,SW 404,Residential,15000,0,15000,46562,0,61562
142942601100000,SW 404,Residential,15000,0,15000,71755,0,86755
142942601200000,SW 404,Residential,12000,0,12000,77884,0,89884
142942601300000,CITY PROPERTY,Exempt,0,0,0,0,0,0
142942601400000,SW 404,Residential,15000,0,15000,69074,0,84074
142942601500000,SW 404,Residential,15000,0,15000,79509,0,94509
142942601600000,SW 404,Residential,15000,0,15000,67842,0,82842
142942601700000,SW 404,Residential,15000,0,15000,62324,0,77324
142942601800000,SW 404,Residential,15000,0,15000,63696,0,78696
142942601900000,SW 404,Residential,15187,0,15187,48274,0,63461
142942700200000,CENTRALLY ASSESSED,Other,0,0,0,0,0,0
142942700300000,VACANT LAND,Commercial,0,36515,36515,0,0,36515
142942700302000,WAREHOUSE,Commercial,0,0,0,0,78274,78274
142942700400000,WAREHOUSE,Commercial,0,137700,137700,0,129102,266802
142942700500000,CENTRALLY ASSESSED,Other,0,0,0,0,0,0
142942800100000,SMALL RETAIL,Commercial,0,120150,120150,0,144511,264661
142942800200000,SW 404,Residential,21168,0,21168,96494,0,117662
142942800300000,SW 404,Residential,16800,0,16800,71551,0,88351
142942800400000,SW 404,Residential,11200,0,11200,73343,0,84543
142942800500000,SW 404,Residential,17638,0,17638,77377,0,95015
142942800600000,SW 404,Residential,14000,0,14000,84331,0,98331
142942800700000,SW 404,Residential,16579,0,16579,78741,0,95320
142942800800000,SW 404,Residential,22233,0,22233,88475,0,110708
142942800900000,SW 404,Residential,22233,0,22233,70150,0,92383
142942801000000,SW 404,Residential,22233,0,22233,49647,0,71880
142942801100000,SW 404,Residential,22233,0,22233,63242,0,85475
142942801200000,SW 404,Residential,22233,0,22233,52892,0,75125
142942801300000,SW 404,Residential,22233,0,22233,60490,0,82723
142942801400000,SW 404,Residential,22233,0,22233,78731,0,100964
142942801500000,SW 404,Residential,22233,0,22233,80984,0,103217
142942801600000,SW 404,Residential,22080,0,22080,25367,0,47447
142942801700000,SW 404,Residential,12730,0,12730,66945,0,79675
142942801800000,SW 404,Residential,13410,0,13410,56870,0,70280
142942801900000,SW 404,Residential,13754,0,13754,0,0,13754
142942802000000,SW 404,Residential,21340,0,21340,56730,0,78070
142942802100000,SW 404,Residential,22000,0,22000,24447,0,46447
142942802200000,SW 404,Residential,20600,0,20600,0,0,20600
142942900100000,SW 404,Residential,21996,0,21996,64325,0,86321
142942900200000,SW 404,Residential,21996,0,21996,62278,0,84274
142942900300000,SW 404,Residential,21816,0,21816,71576,0,93392
142942900400000,SW 404,Residential,21141,0,21141,91165,0,112306
142942900500000,SW 404,Residential,14663,0,14663,90002,0,104665
142942900600000,SW 404,Residential,21038,0,21038,67164,0,88202
142942900700000,SW 404,Residential,21038,0,21038,58010,0,79048
142942900800000,SW 404,Residential,21038,0,21038,56152,0,77190
142942900900000,SW 404,Residential,21038,0,21038,68043,0,89081
142942901000000,SW 404,Residential,21038,0,21038,63057,0,84095
142942901100000,SW 404,Residential,21038,0,21038,77791,0,98829
142942901200000,SW 404,Residential,21038,0,21038,65648,0,86686
142942901300000,SW 404,Residential,21038,0,21038,69081,0,90119
142942901400000,SW 404,Residential,19565,0,19565,100535,0,120100
142942901500000,SW 404,Residential,25904,0,25904,76023,0,101927
142942901600000,SW 404,Residential,21587,0,21587,50868,0,72455
142942901700000,SW 404,Residential,20825,0,20825,65505,0,86330
142942901800000,SW 404,Residential,20825,0,20825,70830,0,91655
142942901900000,SW 404,Residential,20825,0,20825,64147,0,84972
142942902000000,SW 404,Residential,20825,0,20825,64524,0,85349
142942902100000,SW 404,Residential,23824,0,23824,99101,0,122925
142942902200000,SW 404,Residential,20825,0,20825,66984,0,87809
142943000100000,CHURCH,Exempt,0,103275,103275,0,446896,550171
142943000200000,SW 404,Residential,21038,0,21038,51278,0,72316
142943000300000,SW 404,Residential,21038,0,21038,73202,0,94240
142943000400000,SW 404,Residential,21038,0,21038,72365,0,93403
142943000500000,SW 404,Residential,23513,0,23513,68030,0,91543
142943000600000,SW 404,Residential,21038,0,21038,67603,0,88641
142943000700000,SW 404,Residential,21038,0,21038,59822,0,80860
142943000800000,SW 404,Residential,19565,0,19565,70758,0,90323
142943100100000,SW 404,Residential,19350,0,19350,57558,0,76908
142943100200000,SW 404,Residential,15750,0,15750,65873,0,81623
142943100300000,SW 404,Residential,15750,0,15750,58208,0,73958
142943100400000,SW 404,Residential,15750,0,15750,53085,0,68835
142943100500000,SW 404,Residential,15750,0,15750,86655,0,102405
142943100600000,SW 404,Residential,15750,0,15750,92492,0,108242
142943100700000,SW 404,Residential,11813,0,11813,44242,0,56055
142943100800000,SW 404,Residential,11813,0,11813,69527,0,81340
142943100900000,SW 404,Residential,11813,0,11813,49279,0,61092
142943101000000,SW 404,Residential,11813,0,11813,61138,0,72951
142943101100000,SW 404,Residential,15750,0,15750,54996,0,70746
142943200100000,SW 404,Residential,16720,0,16720,58136,0,74856
142943200200000,VACANT LAND,Commercial,0,22032,22032,0,0,22032
142943200300000,CENTRALLY ASSESSED,Other,0,0,0,0,0,0
142943200400000,SW 404,Residential,18700,0,18700,56481,0,75181
142943200500000,SW 404,Residential,16800,0,16800,42164,0,58964
142943200600000,SW 404,Residential,16800,0,16800,62912,0,79712
142943200700000,SW 404,Residential,16800,0,16800,61601,0,78401
142943200800000,SW 404,Residential,16800,0,16800,54378,0,71178
142943200900000,SW 404,Residential,16800,0,16800,79732,0,96532
142943201000000,SW 404,Residential,16920,0,16920,59964,0,76884
142943201100000,SW 404,Residential,14800,0,14800,0,0,14800
142943201200000,SW 404,Residential,18480,0,18480,91216,0,109696
142943300100000,OFFICE,Commercial,0,24348,24348,0,71542,95890
142943300200000,SHOP,Commercial,0,12860,12860,0,51054,63914
142943300300000,SHOP,Commercial,0,13249,13249,0,25081,38330
142943300400000,SHOP,Commercial,0,22956,22956,0,94376,117332
142943300500000,WAREHOUSE,Commercial,0,44712,44712,0,84532,129244
142943300600000,WAREHOUSE,Commercial,0,51840,51840,0,163640,215480
142943300700000,SW 404,Residential,12840,0,12840,34082,0,46922
142943300800000,SW 404,Residential,12960,0,12960,37782,0,50742
142945100100000,SW 404,Residential,15375,0,15375,45643,0,61018
142945100200000,SW 404,Residential,16125,0,16125,71081,0,87206
142945100300000,SW 404,Residential,15675,0,15675,56110,0,71785
142945200100000,CITY PROPERTY,Exempt,0,0,0,0,0,0
142945200200000,VACANT LAND,Commercial,0,13219,13219,0,0,13219
142945300100000,FOOD GRADE;INDUST,Industrial,0,466668,466668,0,2462649,2929317
142945300102000,BILLBOARD(BLL),Commercial,0,0,0,0,14583,14583
142945400100000,SW 404,Residential,18360,0,18360,55027,0,73387
142945400200000,BARS/LOUNGE,Commercial,0,52877,52877,0,109255,162132
142945400300000,OFFICE,Commercial,0,101250,101250,0,141392,242642
142945400400000,WAREHOUSE,Commercial,0,198450,198450,0,788421,986871
142945500100000,SW 404,Residential,16000,0,16000,39894,0,55894
142945500200000,SW 404,Residential,16000,0,16000,44890,0,60890
142945500300000,SW 404,Residential,16000,0,16000,40379,0,56379
142945500400000,CONVERSION,Commercial,0,9072,9072,0,41447,50519
142945500500000,SW 404,Residential,16000,0,16000,47428,0,63428
142945500600000,SW 404,Residential,16000,0,16000,53178,0,69178
142945500700000,SW 404,Residential,16000,0,16000,62105,0,78105
142945500800000,SW 404,Residential,16000,0,16000,53029,0,69029
142945500900000,WAREHOUSE,Commercial,0,18144,18144,0,109363,127507
142945501000000,VACANT LAND,Commercial,0,18144,18144,0,0,18144
142945501002000,WAREHOUSE,Commercial,0,0,0,0,91152,91152
142945501100000,VACANT LAND,Commercial,0,44226,44226,0,0,44226
142945501202000,WAREHOUSE,Commercial,0,0,0,0,100214,100214
142945600100000,WAREHOUSE,Commercial,0,18144,18144,0,113956,132100
142945600200000,CENTRALLY ASSESSED,Industrial,0,12490,12490,0,0,12490
142945600202000,FOOD GRADE;INDUST,Industrial,0,0,0,0,20517,20517
142945600300000,WAREHOUSE,Commercial,0,86805,86805,0,332043,418848
142945600400000,SW 404,Residential,12000,0,12000,66166,0,78166
142945600500000,SW 404,Residential,16000,0,16000,95466,0,111466
142945600600000,SW 404,Residential,16000,0,16000,43407,0,59407
142945600700000,SW 404,Residential,16000,0,16000,43336,0,59336
142945600800000,SW 404,Residential,16000,0,16000,84954,0,100954
142945600900000,SW 404,Residential,12000,0,12000,65687,0,77687
142945601000000,SW 404,Residential,16000,0,16000,84590,0,100590
142945601100000,SW 404,Residential,16000,0,16000,71277,0,87277
142945601200000,SW 404,Residential,16000,0,16000,77729,0,93729
142945601300000,SW 404,Residential,16000,0,16000,70240,0,86240
142945700100000,CENTRALLY ASSESSED,Other,0,0,0,0,0,0
142945800100000,FOOD GRADE;INDUST,Industrial,0,27864,27864,0,1108238,1136102
142945800200000,CENTRALLY ASSESSED,Other,0,0,0,0,0,0
142945900100000,CENTRALLY ASSESSED,Other,0,0,0,0,0,0
142945900200000,VACANT LAND,Commercial,0,54432,54432,0,0,54432
142945900300000,CENTRALLY ASSESSED,Other,0,0,0,0,0,0
142945900400000,FLAT PARKING,Commercial,0,59805,59805,0,0,59805
142946000100000,CENTRALLY ASSESSED,Other,0,0,0,0,0,0
142946000200000,CENTRALLY ASSESSED,Other,0,0,0,0,0,0
142946000300000,CENTRALLY ASSESSED,Other,0,0,0,0,0,0
142946000400000,CENTRALLY ASSESSED,Other,0,0,0,0,0,0
142946000500000,VACANT LAND,Commercial,0,72576,72576,0,0,72576
142946000600000,VACANT LAND,Commercial,0,36288,36288,0,0,36288
142946000700000,CENTRALLY ASSESSED,Other,0,0,0,0,0,0
142946000800000,VACANT LAND,Commercial,0,18014,18014,0,0,18014
142946100100000,SHOP,Commercial,0,29565,29565,0,273442,303007
142946100200000,SW 404,Residential,8621,0,8621,36764,0,45385
142946100300000,SHOP,Commercial,0,25532,25532,0,53076,78608
142946100400000,BARS/LOUNGE,Commercial,0,19686,19686,0,59569,79255
142946100500000,SW 404,Residential,19123,0,19123,62047,0,81170
142946100600000,SW 404,Residential,16896,0,16896,36058,0,52954
142946100700000,SW 404,Residential,16896,0,16896,72512,0,89408
142946200100000,SW 404,Residential,23040,0,23040,90495,0,113535
142946200200000,SW 404,Residential,15360,0,15360,66244,0,81604
142946200300000,VACANT LAND,Commercial,0,137700,137700,0,0,137700
142946200400000,CENTRALLY ASSESSED,Other,0,0,0,0,0,0
142947600100000,SW 404,Residential,9945,0,9945,29394,0,39339
142947600200000,SW 404,Residential,5000,0,5000,0,0,5000
142947600300000,SW 404,Residential,9690,0,9690,51886,0,61576
142947600400000,SW 404,Residential,9163,0,9163,63967,0,73130
142947600500000,SW 404,Residential,9163,0,9163,51768,0,60931
142947600600000,SW 404,Residential,9163,0,9163,56291,0,65454
142947600700000,SW 404,Residential,9163,0,9163,58777,0,67940
142947700200000,SW 404,Residential,15000,0,15000,50926,0,65926
142947700300000,SW 404,Residential,12855,0,12855,59587,0,72442
142947700400000,SW 404,Residential,15860,0,15860,73417,0,89277
142947700500000,SW 404,Residential,13440,0,13440,51537,0,64977
142947700600000,SW 404,Residential,5000,0,5000,0,0,5000
142947700700000,SW 404,Residential,13600,0,13600,74043,0,87643
142947700800000,SW 404,Residential,13260,0,13260,46556,0,59816
142947800100000,SW 404,Residential,15000,0,15000,73756,0,88756
142947800200000,CITY PROPERTY,Exempt,0,0,0,0,0,0
142947800300000,SW 404,Residential,10866,0,10866,58277,0,69143
142947800400000,SW 404,Residential,10153,0,10153,64716,0,74869
142947800500000,SW 404,Residential,9619,0,9619,62831,0,72450
142947800600000,SW 404,Residential,14509,0,14509,45326,0,59835
142947800700000,SW 404,Residential,13894,0,13894,45108,0,59002
142947900100000,SW 404,Residential,11475,0,11475,59978,0,71453
142947900200000,SW 404,Residential,16352,0,16352,58105,0,74457
142947900300000,SW 404,Residential,17232,0,17232,46456,0,63688
142948000400000,VACANT LAND,Commercial,0,27521,27521,0,0,27521
142948000500000,CENTRALLY ASSESSED,Other,0,0,0,0,0,0
142948000600000,CENTRALLY ASSESSED,Other,0,0,0,0,0,0
142948000602000,BILLBOARD(BLL),Commercial,0,0,0,0,8455,8455
142948100100000,SHOP,Commercial,0,53179,53179,0,64478,117657
142948100200000,SHOP,Commercial,0,17788,17788,0,57006,74794
142948100300000,SW 404,Residential,17689,0,17689,56648,0,74337
142948100400000,CITY PROPERTY,Exempt,0,0,0,0,0,0
142948100500000,SHOP,Commercial,0,15454,15454,0,54461,69915
142948100600000,VACANT LAND,Commercial,0,18541,18541,0,0,18541
142948100800000,CENTRALLY ASSESSED,Other,0,0,0,0,0,0
142948200100000,SW 404,Residential,16000,0,16000,86898,0,102898
142948200200000,SW 404,Residential,16000,0,16000,91568,0,107568
142948200300000,SW 404,Residential,16000,0,16000,63562,0,79562
142948200400000,SW 404,Residential,16000,0,16000,70904,0,86904
142948200500000,SW 404,Residential,16000,0,16000,56461,0,72461
142948200600000,SW 404,Residential,16000,0,16000,66095,0,82095
142948200700000,SW 404,Residential,16000,0,16000,73634,0,89634
142948201100000,VACANT LAND,Commercial,0,18370,18370,0,0,18370
142948201200000,VACANT LAND,Commercial,0,18144,18144,0,0,18144
142948201300000,SW 404,Residential,16000,0,16000,53383,0,69383
142948201400000,SW 404,Residential,16000,0,16000,58767,0,74767
142948201500000,SW 404,Residential,16000,0,16000,53123,0,69123
142948201600000,SW 404,Residential,16000,0,16000,79157,0,95157
142948201700000,CENTRALLY ASSESSED,Other,0,0,0,0,0,0
142948201800000,CENTRALLY ASSESSED,Other,0,0,0,0,0,0
142948201900000,AUTO REPAIR/SALES,Commercial,0,30861,30861,0,0,30861
142948201902000,WAREHOUSE,Commercial,0,0,0,0,33470,33470
142948202000000,VACANT LAND,Commercial,0,8383,8383,0,0,8383
142948300100000,SW 404,Residential,10640,0,10640,60002,0,70642
142948300200000,SW 404,Residential,9975,0,9975,40225,0,50200
142948300300000,SW 404,Residential,9975,0,9975,53635,0,63610
142948300400000,SW 404,Residential,12160,0,12160,42084,0,54244
142948300500000,SW 404,Residential,16320,0,16320,87035,0,103355
142948300600000,SW 404,Residential,16320,0,16320,70438,0,86758
142948300700000,SW 404,Residential,16320,0,16320,72076,0,88396
142948300800000,SW 404,Residential,14280,0,14280,70267,0,84547
142948300900000,SW 404,Residential,14280,0,14280,76625,0,90905
142948301000000,SW 404,Residential,14280,0,14280,71238,0,85518
142948301100000,SW 404,Residential,12495,0,12495,69975,0,82470
142948301200000,CITY PROPERTY,Exempt,0,0,0,0,0,0
142948301300000,FLAT PARKING,Commercial,0,19440,19440,0,0,19440
142948301400000,VACANT LAND,Commercial,0,18841,18841,0,0,18841
142948400200000,WAREHOUSE,Commercial,0,185895,185895,0,301657,487552
142948500200000,CONC/ASPH;INDUSTRIAL,Industrial,0,399114,399114,0,814753,1213867
142948500300000,WAREHOUSE,Commercial,0,274536,274536,0,1082969,1357505
142948500500000,WAREHOUSE,Commercial,0,93015,93015,0,108129,201144
142948500600000,VACANT LAND,Commercial,0,184680,184680,0,0,184680
142948500602000,WAREHOUSE,Commercial,0,0,0,0,111346,111346
142948500602001,WAREHOUSE,Commercial,0,0,0,0,89021,89021
142948500700000,MATERIALS MFG;INDUST,Industrial,0,219110,219110,0,445687,664797
142948500800000,CITY PROPERTY,Exempt,0,0,0,0,0,0
142948500900000,CITY PROPERTY,Exempt,0,0,0,0,0,0
142948501000000,CITY PROPERTY,Exempt,0,0,0,0,0,0
142948501100000,OFFICE,Commercial,0,226800,226800,0,389540,616340
142948501200000,VACANT LAND,Industrial,0,2592,2592,0,0,2592
142948501300000,CENTRALLY ASSESSED,Other,0,0,0,0,0,0
142948501400000,CONC/ASPH;INDUSTRIAL,Industrial,0,18144,18144,0,11845,29989
142948600100000,VACANT LAND,Industrial,0,100035,100035,0,0,100035
142948600200000,CENTRALLY ASSESSED,Other,0,0,0,0,0,0
142948600300000,WAREHOUSE,Commercial,0,60480,60480,0,119229,179709
142948600400000,CENTRALLY ASSESSED,Other,0,0,0,0,0,0
142948600500000,CENTRALLY ASSESSED,Other,0,0,0,0,0,0
142948700400000,BRANCH BANK/CU,Commercial,0,113724,113724,0,211394,325118
142948800100000,FLAT PARKING,Commercial,0,57645,57645,0,4083,61728
143010100100000,NW 324,Residential,26208,0,26208,127695,0,153903
143010100200000,NW 324,Residential,51100,0,51100,184736,0,235836
143010100300000,NW 324,Residential,18988,0,18988,89295,0,108283
143010100400000,NW 324,Residential,18988,0,18988,66127,0,85115
143010100500000,NW 324,Residential,18899,0,18899,71710,0,90609
143010100600000,NW 324,Residential,20400,0,20400,87338,0,107738
143010100700000,NW 324,Residential,20400,0,20400,94370,0,114770
143010100800000,NW 324,Residential,20400,0,20400,95213,0,115613
143010100900000,NW 324,Residential,20400,0,20400,82241,0,102641
143010101000000,NW 324,Residential,20400,0,20400,88138,0,108538
143010101100000,NW 324,Residential,20400,0,20400,63719,0,84119
143010101200000,NW 324,Residential,20400,0,20400,104970,0,125370
143010101300000,NW 324,Residential,26520,0,26520,154519,0,181039
143010101400000,NW 324,Residential,20400,0,20400,72682,0,93082
143010101500000,NW 324,Residential,20400,0,20400,105535,0,125935
143010101600000,NW 324,Residential,20400,0,20400,91240,0,111640
143010101700000,NW 324,Residential,22950,0,22950,94249,0,117199
143010101800000,NW 324,Residential,22950,0,22950,103546,0,126496
143010101900000,NW 324,Residential,20400,0,20400,73304,0,93704
143010102000000,NW 324,Residential,20400,0,20400,98020,0,118420
143010102100000,NW 324,Residential,20400,0,20400,72957,0,93357
143010102200000,NW 324,Residential,20400,0,20400,127387,0,147787
143010102300000,NW 324,Residential,19676,0,19676,116027,0,135703
143010102400000,NW 324,Residential,19908,0,19908,87050,0,106958
143010102500000,NW 324,Residential,27421,0,27421,85056,0,112477
143010102600000,NW 324,Residential,24840,0,24840,104896,0,129736
143010102700000,NW 324,Residential,26662,0,26662,117541,0,144203
143010102800000,NW 324,Residential,29280,0,29280,123361,0,152641
143010102900000,NW 324,Residential,29280,0,29280,34321,0,63601
143010103000000,NW 324,Residential,32452,0,32452,95138,0,127590
143010103100000,NW 324,Residential,24400,0,24400,116976,0,141376
143010103200000,NW 324,Residential,31378,0,31378,116829,0,148207
143010103300000,NW 324,Residential,29280,0,29280,139713,0,168993
143010103400000,NW 324,Residential,24400,0,24400,113383,0,137783
143010103500000,NW 324,Residential,24400,0,24400,109751,0,134151
143010103600000,NW 324,Residential,29280,0,29280,111902,0,141182
143010103700000,NW 324,Residential,24400,0,24400,107731,0,132131
143010103800000,NW 324,Residential,26840,0,26840,129852,0,156692
143010103900000,NW 324,Residential,27664,0,27664,99828,0,127492
143010104000000,NW 324,Residential,24960,0,24960,90692,0,115652
143010104100000,NW 324,Residential,28035,0,28035,104734,0,132769
143010104200000,NW 324,Residential,27569,0,27569,111939,0,139508
143010200100000,NW 324,Residential,18899,0,18899,90554,0,109453
143010200200000,NW 324,Residential,24684,0,24684,92345,0,117029
143010200300000,CHURCH,Exempt,0,379674,379674,0,3635821,4015495
143010200400000,NW 324,Residential,50250,0,50250,136729,0,186979
143010200500000,NW 324,Residential,24240,0,24240,102083,0,126323
143010200600000,NW 324,Residential,24240,0,24240,91784,0,116024
143010200700000,NW 324,Residential,21412,0,21412,97924,0,119336
143010200800000,NW 324,Residential,21412,0,21412,114117,0,135529
143010200900000,NW 324,Residential,21412,0,21412,100067,0,121479
143010201000000,NW 324,Residential,30097,0,30097,147297,0,177394
143010201100000,NW 324,Residential,28080,0,28080,118227,0,146307
143010201200000,NW 324,Residential,24480,0,24480,70250,0,94730
143010201300000,NW 324,Residential,24480,0,24480,94276,0,118756
143010201400000,NW 324,Residential,24480,0,24480,68871,0,93351
143010201500000,NW 324,Residential,24480,0,24480,98642,0,123122
143010201600000,NW 324,Residential,24480,0,24480,72566,0,97046
143010201700000,NW 324,Residential,26936,0,26936,80093,0,107029
143010201800000,NW 324,Residential,26524,0,26524,97894,0,124418
143010201900000,NW 324,Residential,31856,0,31856,60297,0,92153
143010202000000,NW 324,Residential,51700,0,51700,123762,0,175462
143010202100000,NW 324,Residential,30163,0,30163,88141,0,118304
143010202200000,NW 324,Residential,24964,0,24964,92183,0,117147
143010202300000,NW 324,Exempt,0,59050,59050,0,102279,161329
143010202400000,NW 324,Residential,20116,0,20116,94627,0,114743
143010202500000,NW 324,Residential,19364,0,19364,92650,0,112014
143010202600000,NW 324,Residential,18760,0,18760,98771,0,117531
143010202700000,NW 324,Residential,20400,0,20400,95529,0,115929
143010202800000,NW 324,Residential,20400,0,20400,91291,0,111691
143010202900000,NW 324,Residential,20400,0,20400,84776,0,105176
143010203000000,NW 324,Residential,22950,0,22950,105194,0,128144
143010203100000,NW 324,Residential,22950,0,22950,129817,0,152767
143010203200000,NW 324,Residential,20400,0,20400,122082,0,142482
143010203300000,NW 324,Residential,20400,0,20400,89881,0,110281
143010203400000,NW 324,Residential,20400,0,20400,118157,0,138557
143010203500000,NW 324,Residential,20400,0,20400,87175,0,107575
143010203600000,NW 324,Residential,20400,0,20400,87871,0,108271
143010203700000,NW 324,Residential,20400,0,20400,77266,0,97666
143010203800000,NW 324,Residential,20400,0,20400,92276,0,112676
143010203900000,NW 324,Residential,20400,0,20400,98247,0,118647
143010204000000,NW 324,Residential,22950,0,22950,114287,0,137237
143010204100000,NW 324,Residential,22950,0,22950,99537,0,122487
143010204200000,NW 324,Residential,20400,0,20400,73245,0,93645
143010204300000,NW 324,Residential,20400,0,20400,94867,0,115267
143010300100000,NW 324,Residential,46008,0,46008,40765,0,86773
143010300200000,NW 324,Residential,22896,0,22896,99389,0,122285
143010300300000,NW 324,Residential,27132,0,27132,116852,0,143984
143010300400000,NW 324,Residential,27360,0,27360,93718,0,121078
143010300500000,NW 324,Residential,27300,0,27300,88505,0,115805
143010300600000,NW 324,Residential,21412,0,21412,91432,0,112844
143010300700000,NW 324,Residential,21412,0,21412,105573,0,126985
143010300800000,NW 324,Residential,24480,0,24480,99368,0,123848
143010300900000,NW 324,Residential,24480,0,24480,80030,0,104510
143010301000000,NW 324,Residential,24480,0,24480,53461,0,77941
143010301100000,NW 324,Residential,24480,0,24480,89367,0,113847
143010301200000,NW 324,Residential,24480,0,24480,77189,0,101669
143010301300000,NW 324,Residential,24480,0,24480,67063,0,91543
143010301400000,NW 324,Residential,31856,0,31856,100459,0,132315
143010301500000,NW 324,Residential,27598,0,27598,82836,0,110434
143010301600000,NW 324,Residential,24864,0,24864,40816,0,65680
143010400100000,CARWASH,Commercial,0,78797,78797,0,167594,246391
143012600100000,NW 324,Residential,52200,0,52200,119337,0,171537
143012600200000,NW 324,Residential,30607,0,30607,144393,0,175000
143012600300000,NW 324,Residential,24320,0,24320,110443,0,134763
143012600400000,NW 324,Residential,28900,0,28900,152650,0,181550
143012600500000,NW 324,Residential,28900,0,28900,111935,0,140835
143012600600000,NW 324,Residential,24661,0,24661,87617,0,112278
143012600700000,NW 324,Residential,24000,0,24000,110283,0,134283
143012600800000,NW 324,Residential,24000,0,24000,70607,0,94607
143012600900000,NW 324,Residential,24000,0,24000,117303,0,141303
143012601000000,NW 324,Residential,24000,0,24000,109940,0,133940
143012601100000,NW 324,Residential,24000,0,24000,94155,0,118155
143012601200000,NW 324,Residential,24000,0,24000,99249,0,123249
143012601300000,NW 324,Residential,26197,0,26197,125554,0,151751
143012601400000,NW 324,Residential,28004,0,28004,116592,0,144596
143012601500000,NW 324,Residential,24480,0,24480,79938,0,104418
143012700100000,NW 324,Residential,23100,0,23100,112072,0,135172
143012700200000,NW 324,Residential,23485,0,23485,127034,0,150519
143012700300000,NW 324,Residential,30530,0,30530,135375,0,165905
143012700400000,NW 324,Residential,22297,0,22297,109462,0,131759
143012700500000,NW 324,Residential,22560,0,22560,106155,0,128715
143012700600000,NW 324,Residential,22560,0,22560,86338,0,108898
143012700700000,NW 324,Residential,22560,0,22560,86877,0,109437
143012700800000,NW 324,Residential,22560,0,22560,99266,0,121826
143012700900000,NW 324,Residential,22560,0,22560,101064,0,123624
143012701000000,NW 324,Residential,22560,0,22560,103334,0,125894
143012701100000,NW 324,Residential,21780,0,21780,109190,0,130970
143012701200000,NW 324,Residential,21120,0,21120,85080,0,106200
143012701300000,NW 324,Residential,25460,0,25460,92604,0,118064
143012701400000,NW 324,Residential,24817,0,24817,104501,0,129318
143012701500000,NW 324,Residential,21557,0,21557,89963,0,111520
143012701600000,NW 324,Residential,22714,0,22714,107585,0,130299
143012701700000,NW 324,Residential,22560,0,22560,81791,0,104351
143012701800000,NW 324,Residential,22560,0,22560,86026,0,108586
143012701900000,NW 324,Residential,22560,0,22560,104597,0,127157
143012702000000,NW 324,Residential,22560,0,22560,116862,0,139422
143012702100000,NW 324,Residential,22823,0,22823,88655,0,111478
143012702200000,NW 324,Residential,26960,0,26960,133386,0,160346
143012702300000,NW 324,Residential,26355,0,26355,127400,0,153755
143012702400000,NW 324,Residential,22320,0,22320,105134,0,127454
143012702500000,NW 324,Residential,22320,0,22320,107874,0,130194
143012702600000,NW 324,Residential,22320,0,22320,100993,0,123313
143012702700000,NW 324,Residential,22320,0,22320,140102,0,162422
143012702800000,NW 324,Residential,22320,0,22320,88937,0,111257
143012702900000,NW 324,Residential,22320,0,22320,84465,0,106785
143012703000000,NW 324,Residential,22531,0,22531,104417,0,126948
143012703100000,NW 324,Residential,20400,0,20400,102939,0,123339
143012703200000,NW 324,Residential,28198,0,28198,102714,0,130912
143012703300000,NW 324,Residential,25685,0,25685,95458,0,121143
143012703400000,NW 324,Residential,24480,0,24480,111791,0,136271
143012703500000,NW 324,Residential,24480,0,24480,99603,0,124083
143012703600000,NW 324,Residential,24480,0,24480,104444,0,128924
143012703700000,NW 324,Residential,24480,0,24480,81511,0,105991
143012703800000,NW 324,Residential,24480,0,24480,100235,0,124715
143012703900000,NW 324,Residential,24480,0,24480,115267,0,139747
143012704000000,NW 324,Residential,24863,0,24863,93589,0,118452
143012704100000,NW 324,Residential,25704,0,25704,113484,0,139188
143012704200000,NW 324,Residential,26112,0,26112,118478,0,144590
143012704300000,NW 324,Residential,25952,0,25952,118128,0,144080
143012704400000,NW 324,Residential,26320,0,26320,127946,0,154266
143012704500000,NW 324,Residential,22974,0,22974,108320,0,131294
143012704600000,NW 324,Residential,23100,0,23100,136325,0,159425
143012800100000,NW 324,Residential,22823,0,22823,98872,0,121695
143012800200000,NW 324,Residential,23425,0,23425,79715,0,103140
143012800300000,NW 324,Residential,22560,0,22560,121139,0,143699
143012800400000,NW 324,Residential,22560,0,22560,88347,0,110907
143012800500000,NW 324,Residential,22560,0,22560,88811,0,111371
143012800600000,NW 324,Residential,22560,0,22560,81801,0,104361
143012800700000,NW 324,Residential,22560,0,22560,86583,0,109143
143012800800000,NW 324,Residential,22560,0,22560,83518,0,106078
143012800900000,NW 324,Residential,22560,0,22560,88642,0,111202
143012801000000,NW 324,Residential,22560,0,22560,83641,0,106201
143012801100000,NW 324,Residential,22560,0,22560,78854,0,101414
143012801200000,NW 324,Residential,22560,0,22560,85312,0,107872
143012801300000,NW 324,Residential,22560,0,22560,96686,0,119246
143012801400000,NW 324,Residential,22485,0,22485,69671,0,92156
143012801500000,NW 324,Residential,22334,0,22334,97271,0,119605
143012801600000,NW 324,Residential,22560,0,22560,121848,0,144408
143012801700000,NW 324,Residential,22560,0,22560,93316,0,115876
143012801800000,NW 324,Residential,22560,0,22560,112510,0,135070
143012801900000,NW 324,Residential,22560,0,22560,83868,0,106428
143012802000000,NW 324,Residential,22560,0,22560,101354,0,123914
143012802100000,NW 324,Residential,22560,0,22560,105756,0,128316
143012802200000,NW 324,Residential,22560,0,22560,85964,0,108524
143012802300000,NW 324,Residential,22560,0,22560,101342,0,123902
143012802400000,NW 324,Residential,22560,0,22560,96577,0,119137
143012802500000,NW 324,Residential,22560,0,22560,87786,0,110346
143012802600000,NW 324,Residential,22560,0,22560,89010,0,111570
143012900100000,NW 324,Residential,24045,0,24045,99005,0,123050
143012900200000,NW 324,Residential,23688,0,23688,109779,0,133467
143012900300000,NW 324,Residential,23184,0,23184,115474,0,138658
143012900400000,NW 324,Residential,22811,0,22811,130598,0,153409
143012900500000,NW 324,Residential,22560,0,22560,100936,0,123496
143012900600000,NW 324,Residential,22560,0,22560,109191,0,131751
143012900700000,NW 324,Residential,22560,0,22560,94562,0,117122
143012900800000,NW 324,Residential,22560,0,22560,88388,0,110948
143012900900000,NW 324,Residential,22560,0,22560,86657,0,109217
143012901000000,NW 324,Residential,21808,0,21808,87603,0,109411
143012901100000,NW 324,Residential,19351,0,19351,87291,0,106642
143012901200000,NW 324,Residential,22469,0,22469,98360,0,120829
143012901300000,NW 324,Residential,22320,0,22320,88957,0,111277
143012901400000,NW 324,Residential,22320,0,22320,83622,0,105942
143012901500000,NW 324,Residential,22320,0,22320,94050,0,116370
143012901600000,NW 324,Residential,22320,0,22320,103852,0,126172
143012901700000,NW 324,Residential,22320,0,22320,98442,0,120762
143012901800000,NW 324,Residential,22320,0,22320,95657,0,117977
143012901900000,NW 324,Residential,21824,0,21824,103747,0,125571
143013000100000,NW 324,Residential,24465,0,24465,89976,0,114441
143013000200000,NW 324,Residential,22580,0,22580,86371,0,108951
143013000300000,CITY PROPERTY,Exempt,0,0,0,0,0,0
143013000400000,NW 324,Residential,24079,0,24079,87697,0,111776
143013000500000,NW 324,Residential,24362,0,24362,87279,0,111641
143013000600000,NW 324,Residential,27960,0,27960,88051,0,116011
143013000700000,NW 324,Residential,27106,0,27106,81751,0,108857
143013000800000,NW 324,Residential,23064,0,23064,92583,0,115647
143013000900000,NW 324,Residential,23436,0,23436,96741,0,120177
143013001000000,NW 324,Residential,23436,0,23436,95595,0,119031
143013001100000,NW 324,Residential,23436,0,23436,89647,0,113083
143013001200000,NW 324,Residential,23436,0,23436,90246,0,113682
143013001300000,NW 324,Residential,23436,0,23436,83449,0,106885
143013001400000,NW 324,Residential,23436,0,23436,83456,0,106892
143013001500000,NW 324,Residential,23064,0,23064,98025,0,121089
143013001600000,NW 324,Residential,22560,0,22560,91430,0,113990
143013001700000,NW 324,Residential,23040,0,23040,94152,0,117192
143013001800000,NW 324,Residential,24240,0,24240,100530,0,124770
143013001900000,NW 324,Residential,25200,0,25200,125975,0,151175
143013002000000,NW 324,Residential,25680,0,25680,88032,0,113712
143013002100000,NW 324,Residential,30510,0,30510,129224,0,159734
143013002200000,NW 324,Residential,32527,0,32527,0,0,32527
143013100100000,NW 324,Residential,23903,0,23903,82066,0,105969
143013100200000,NW 324,Residential,23660,0,23660,83588,0,107248
143013100300000,NW 324,Residential,23660,0,23660,92544,0,116204
143013100400000,NW 324,Residential,23660,0,23660,99513,0,123173
143013100500000,NW 324,Residential,24494,0,24494,106243,0,130737
143013100600000,SCHOOL,Exempt,0,62370,62370,0,582650,645020
143013100700000,NW 324,Residential,27916,0,27916,87690,0,115606
143013100800000,NW 324,Residential,23808,0,23808,81045,0,104853
143013100900000,NW 324,Residential,23312,0,23312,88982,0,112294
143013101000000,NW 324,Residential,27900,0,27900,142600,0,170500
143013101100000,SMALL RETAIL,Commercial,0,44928,44928,0,168351,213279
143013101200000,OFFICE; MEDICAL,Commercial,0,146362,146362,0,422489,568851
143013101300000,SR/NURSING/ASSTD LIV,Commercial,0,146880,146880,0,1434648,1581528
143013101400000,APARTMENT,Commercial,0,24251,24251,0,428324,452575
143013101500000,NW 324,Residential,25158,0,25158,105796,0,130954
143015100100000,NW 324,Residential,26327,0,26327,71661,0,97988
143015100200000,NW 324,Residential,26566,0,26566,108434,0,135000
143015100300000,NW 324,Residential,24720,0,24720,98469,0,123189
143015100400000,NW 324,Residential,24844,0,24844,75261,0,100105
143015100500000,NW 324,Residential,21836,0,21836,69855,0,91691
143015100600000,NW 324,Residential,24720,0,24720,93181,0,117901
143015100700000,NW 324,Residential,24720,0,24720,92444,0,117164
143015100800000,NW 324,Residential,24720,0,24720,97758,0,122478
143015100900000,NW 324,Residential,24720,0,24720,67312,0,92032
143015101000000,NW 324,Residential,24720,0,24720,84547,0,109267
143015200100000,NW 324,Residential,28828,0,28828,85784,0,114612
143015200200000,NW 324,Residential,28329,0,28329,85108,0,113437
143015200300000,NW 324,Residential,28846,0,28846,87992,0,116838
143015200400000,NW 324,Residential,29159,0,29159,103954,0,133113
143015200500000,NW 324,Residential,24960,0,24960,119996,0,144956
143015200600000,NW 324,Residential,24960,0,24960,100982,0,125942
143015200700000,NW 324,Residential,25200,0,25200,94612,0,119812
143015200800000,NW 324,Residential,25200,0,25200,101470,0,126670
143015200900000,NW 324,Residential,25200,0,25200,76351,0,101551
143015201000000,NW 324,Residential,25200,0,25200,75928,0,101128
143015201100000,NW 324,Residential,23744,0,23744,80317,0,104061
143015201200000,NW 324,Residential,23044,0,23044,82117,0,105161
143015201300000,NW 324,Residential,37080,0,37080,164460,0,201540
143015201500000,NW 324,Residential,24720,0,24720,72790,0,97510
143015201600000,NW 324,Residential,22248,0,22248,108005,0,130253
143015201700000,NW 324,Residential,30338,0,30338,73755,0,104093
143015201800000,NW 324,Residential,27810,0,27810,145244,0,173054
143015300100000,NW 324,Residential,35704,0,35704,126119,0,161823
143015300200000,NW 324,Residential,24270,0,24270,84810,0,109080
143015300300000,NW 324,Residential,24948,0,24948,104145,0,129093
143015300400000,NW 324,Residential,24948,0,24948,96746,0,121694
143015300500000,NW 324,Residential,24552,0,24552,100766,0,125318
143015300600000,NW 324,Residential,22572,0,22572,82574,0,105146
143015300700000,NW 324,Residential,23760,0,23760,89472,0,113232
143015300800000,NW 324,Residential,23760,0,23760,78221,0,101981
143015300900000,NW 324,Residential,23760,0,23760,95184,0,118944
143015301000000,NW 324,Residential,23760,0,23760,99886,0,123646
143015301100000,NW 324,Residential,21933,0,21933,96558,0,118491
143015301200000,NW 324,Residential,23046,0,23046,108273,0,131319
143015301300000,NW 324,Residential,23296,0,23296,90382,0,113678
143015301400000,NW 324,Residential,24960,0,24960,87604,0,112564
143015301500000,NW 324,Residential,24960,0,24960,89412,0,114372
143015301600000,NW 324,Residential,25200,0,25200,73090,0,98290
143015301700000,NW 324,Residential,25200,0,25200,108870,0,134070
143015301800000,NW 324,Residential,25200,0,25200,102718,0,127918
143015301900000,NW 324,Residential,25200,0,25200,93289,0,118489
143015400100000,NW 324,Residential,25248,0,25248,81815,0,107063
143015400200000,NW 324,Residential,24648,0,24648,122096,0,146744
143015400300000,NW 324,Residential,24948,0,24948,96659,0,121607
143015400400000,NW 324,Residential,25218,0,25218,110686,0,135904
143015400500000,NW 324,Residential,24648,0,24648,117634,0,142282
143015400600000,NW 324,Residential,23760,0,23760,88666,0,112426
143015400700000,NW 324,Residential,23760,0,23760,99291,0,123051
143015400800000,NW 324,Residential,22176,0,22176,93917,0,116093
143015400900000,NW 324,Residential,23760,0,23760,100009,0,123769
143015401000000,NW 324,Residential,24354,0,24354,98444,0,122798
143015401100000,NW 324,Residential,22238,0,22238,124167,0,146405
143015401200000,NW 324,Residential,22233,0,22233,115392,0,137625
143015401300000,NW 324,Residential,23760,0,23760,96040,0,119800
143015401400000,NW 324,Residential,23760,0,23760,100929,0,124689
143015401500000,NW 324,Residential,22176,0,22176,85407,0,107583
143015401600000,NW 324,Residential,23760,0,23760,92883,0,116643
143015401700000,NW 324,Residential,24948,0,24948,96054,0,121002
143015401800000,NW 324,Residential,24060,0,24060,94678,0,118738
143015401900000,NW 324,Residential,26049,0,26049,95069,0,121118
143015402000000,NW 324,Residential,26165,0,26165,95835,0,122000
143015500100000,NW 324,Residential,23819,0,23819,95067,0,118886
143015500200000,NW 324,Residential,23520,0,23520,87517,0,111037
143015500300000,NW 324,Residential,24951,0,24951,97519,0,122470
143015500400000,NW 324,Residential,23520,0,23520,95648,0,119168
143015500500000,NW 324,Residential,23520,0,23520,81699,0,105219
143015500600000,NW 324,Residential,24952,0,24952,90145,0,115097
143015500700000,NW 324,Residential,23520,0,23520,82743,0,106263
143015500800000,NW 324,Residential,21952,0,21952,83716,0,105668
143015500900000,NW 324,Residential,23520,0,23520,103591,0,127111
143015501000000,NW 324,Residential,21952,0,21952,85132,0,107084
143015501100000,NW 324,Residential,21550,0,21550,97023,0,118573
143015501200000,NW 324,Residential,119450,0,119450,265330,0,384780
143015501300000,SCHOOL,Exempt,0,0,0,0,0,0
143017600100000,GROCERY STORE,Commercial,0,515160,515160,0,3163692,3678852
143017600200000,NW 324,Residential,24400,0,24400,96807,0,121207
143017600300000,NW 324,Residential,24400,0,24400,88968,0,113368
143017600400000,NW 324,Residential,33818,0,33818,106187,0,140005
143017600500000,NW 324,Residential,33818,0,33818,97296,0,131114
143017600600000,NW 324,Residential,32940,0,32940,104133,0,137073
143017600700000,NW 324,Residential,29280,0,29280,113532,0,142812
143017600800000,NW 324,Residential,31720,0,31720,112463,0,144183
143017600900000,NW 324,Residential,32448,0,32448,101076,0,133524
143017601000000,NW 324,Residential,21840,0,21840,108255,0,130095
143017601100000,NW 324,Residential,19400,0,19400,47737,0,67137
143017601200000,NW 324,Residential,19400,0,19400,100386,0,119786
143017601300000,NW 324,Residential,22000,0,22000,57922,0,79922
143017601400000,NW 324,Residential,24400,0,24400,78951,0,103351
143017601500000,NW 324,Residential,19968,0,19968,85917,0,105885
143017601600000,NW 324,Residential,28832,0,28832,99936,0,128768
143017601700000,NW 324,Residential,21840,0,21840,96869,0,118709
143017601800000,NW 324,Residential,21840,0,21840,108661,0,130501
143017601900000,NW 324,Residential,21840,0,21840,98740,0,120580
143017602000000,NW 324,Residential,30355,0,30355,92822,0,123177
143017602100000,NW 324,Residential,24400,0,24400,92487,0,116887
143017602200000,NW 324,Residential,24400,0,24400,110579,0,134979
143017602300000,NW 324,Residential,36600,0,36600,140437,0,177037
143017602400000,NW 324,Residential,24400,0,24400,51678,0,76078
143017602500000,NW 324,Residential,24400,0,24400,76783,0,101183
143017602600000,NW 324,Residential,24400,0,24400,74156,0,98556
143017602700000,NW 324,Residential,24400,0,24400,100421,0,124821
143017602800000,NW 324,Residential,33818,0,33818,117465,0,151283
143017602900000,NW 324,Residential,33818,0,33818,93688,0,127506
143017603000000,NW 324,Residential,36600,0,36600,67934,0,104534
143017603100000,NW 324,Residential,36600,0,36600,107812,0,144412
143017603200000,NW 324,Residential,24400,0,24400,76178,0,100578
143017700100000,NW 324,Residential,24797,0,24797,76453,0,101250
143017700200000,NW 324,Residential,21400,0,21400,66320,0,87720
143017700300000,NW 324,Residential,22657,0,22657,83819,0,106476
143017700400000,NW 324,Residential,27720,0,27720,89857,0,117577
143017700500000,NW 324,Residential,26208,0,26208,91266,0,117474
143017700600000,NW 324,Residential,29232,0,29232,72844,0,102076
143017700700000,NW 324,Residential,29367,0,29367,81480,0,110847
143017700800000,NW 324,Residential,24349,0,24349,87007,0,111356
143017700900000,NW 324,Residential,23256,0,23256,88672,0,111928
143017701000000,NW 324,Residential,24720,0,24720,60312,0,85032
143017701100000,NW 324,Residential,24720,0,24720,82541,0,107261
143017701200000,NW 324,Residential,24720,0,24720,100617,0,125337
143017701300000,NW 324,Residential,24720,0,24720,106620,0,131340
143017701400000,NW 324,Residential,24720,0,24720,103267,0,127987
143017701500000,NW 324,Residential,24720,0,24720,50676,0,75396
143017701600000,NW 324,Residential,24173,0,24173,53204,0,77377
143017701700000,NW 324,Residential,27357,0,27357,105399,0,132756
143017701800000,NW 324,Residential,27357,0,27357,93515,0,120872
143017701900000,NW 324,Residential,25936,0,25936,71943,0,97879
143017702000000,NW 324,Residential,26513,0,26513,53694,0,80207
143017702100000,NW 324,Residential,33211,0,33211,50219,0,83430
143017702200000,NW 324,Residential,23249,0,23249,56645,0,79894
143017702300000,NW 324,Residential,25440,0,25440,82672,0,108112
143017702400000,NW 324,Residential,25440,0,25440,102362,0,127802
143017702500000,NW 324,Residential,22560,0,22560,113739,0,136299
143017702600000,NW 324,Residential,11360,0,11360,40201,0,51561
143017800100000,NW 324,Residential,24720,0,24720,94657,0,119377
143017800200000,NW 324,Residential,24952,0,24952,81048,0,106000
143017800300000,NW 324,Residential,23520,0,23520,78289,0,101809
143017800400000,NW 324,Residential,23520,0,23520,87637,0,111157
143017800500000,NW 324,Residential,23520,0,23520,86486,0,110006
143017800600000,NW 324,Residential,23520,0,23520,79774,0,103294
143017800700000,NW 324,Residential,23520,0,23520,78496,0,102016
143017800800000,NW 324,Residential,23520,0,23520,89105,0,112625
143017800900000,NW 324,Residential,23520,0,23520,94552,0,118072
143017801000000,NW 324,Residential,23334,0,23334,61047,0,84381
143017900100000,NW 324,Residential,28080,0,28080,102379,0,130459
143017900200000,NW 324,Residential,27336,0,27336,108066,0,135402
143017900300000,NW 324,Residential,26532,0,26532,102069,0,128601
143017900400000,NW 324,Residential,26532,0,26532,90812,0,117344
143017900500000,NW 324,Residential,26136,0,26136,80203,0,106339
143017900600000,NW 324,Residential,29964,0,29964,122605,0,152569
143017900700000,NW 324,Residential,26400,0,26400,132157,0,158557
143017900800000,NW 324,Residential,26800,0,26800,90264,0,117064
143017900900000,NW 324,Residential,26800,0,26800,74320,0,101120
143017901000000,NW 324,Residential,26800,0,26800,103794,0,130594
143017901100000,NW 324,Residential,24240,0,24240,123152,0,147392
143017901200000,NW 324,Residential,24240,0,24240,96970,0,121210
143017901300000,NW 324,Residential,26260,0,26260,106685,0,132945
143017901400000,NW 324,Residential,28159,0,28159,119149,0,147308
143017901500000,CHURCH,Exempt,0,278424,278424,0,512175,790599
143017901600000,NW 324,Residential,24570,0,24570,68092,0,92662
143017901700000,NW 324,Residential,18096,0,18096,96195,0,114291
143017901800000,NW 324,Residential,18600,0,18600,63548,0,82148
143017901900000,NW 324,Residential,23200,0,23200,105591,0,128791
143017902000000,NW 324,Residential,36600,0,36600,77678,0,114278
143017902100000,NW 324,Residential,21200,0,21200,37342,0,58542
143017902200000,NW 324,Residential,21200,0,21200,120530,0,141730
143017902300000,NW 324,Residential,25440,0,25440,107283,0,132723
143017902400000,NW 324,Residential,25440,0,25440,113410,0,138850
143017902500000,NW 324,Residential,29062,0,29062,103891,0,132953
143020100100000,NW 324,Residential,24786,0,24786,96419,0,121205
143020100200000,NW 324,Residential,25220,0,25220,106402,0,131622
143020100300000,NW 324,Residential,26000,0,26000,99213,0,125213
143020100400000,NW 324,Residential,24480,0,24480,92792,0,117272
143020100500000,NW 324,Residential,24960,0,24960,98065,0,123025
143020100600000,NW 324,Residential,29172,0,29172,79250,0,108422
143020100700000,NW 324,Residential,29106,0,29106,120894,0,150000
143020100800000,NW 324,Residential,25251,0,25251,79917,0,105168
143020100900000,NW 324,Residential,25792,0,25792,83624,0,109416
143020101000000,NW 324,Residential,25792,0,25792,81575,0,107367
143020101100000,NW 324,Residential,26582,0,26582,91030,0,117612
143020101200000,NW 324,Residential,26250,0,26250,83822,0,110072
143020101300000,NW 324,Residential,25792,0,25792,91033,0,116825
143020101400000,NW 324,Residential,25792,0,25792,89977,0,115769
143020101500000,NW 324,Residential,26416,0,26416,91951,0,118367
143020101600000,NW 324,Residential,29172,0,29172,107632,0,136804
143020101700000,NW 324,Residential,28891,0,28891,111586,0,140477
143020101800000,NW 324,Residential,24077,0,24077,97797,0,121874
143020101900000,NW 324,Residential,23866,0,23866,105170,0,129036
143020102000000,NW 324,Residential,24478,0,24478,90910,0,115388
143020102100000,NW 324,Residential,29866,0,29866,125423,0,155289
143020102200000,NW 324,Residential,27174,0,27174,109346,0,136520
143020102300000,NW 324,Residential,27463,0,27463,98525,0,125988
143020102400000,NW 324,Residential,24644,0,24644,86977,0,111621
143020102500000,NW 324,Residential,24644,0,24644,91868,0,116512
143020102600000,NW 324,Residential,24644,0,24644,89184,0,113828
143020102700000,NW 324,Residential,24644,0,24644,94094,0,118738
143020102800000,NW 324,Residential,24644,0,24644,96569,0,121213
143020102900000,NW 324,Residential,24644,0,24644,111967,0,136611
143020103000000,NW 324,Residential,24644,0,24644,109102,0,133746
143020103100000,NW 324,Residential,24644,0,24644,100880,0,125524
143020103200000,NW 324,Residential,24644,0,24644,103154,0,127798
143020103300000,NW 324,Residential,24644,0,24644,103223,0,127867
143020103400000,NW 324,Residential,24967,0,24967,90224,0,115191
143020103500000,NW 324,Residential,24240,0,24240,87107,0,111347
143020103600000,NW 324,Residential,31512,0,31512,90494,0,122006
143020200100000,NW 324,Residential,25851,0,25851,143628,0,169479
143020200200000,NW 324,Residential,23312,0,23312,78643,0,101955
143020200300000,NW 324,Residential,23312,0,23312,93755,0,117067
143020200400000,NW 324,Residential,23312,0,23312,116161,0,139473
143020200500000,NW 324,Residential,23312,0,23312,89248,0,112560
143020200600000,NW 324,Residential,23312,0,23312,94567,0,117879
143020200700000,NW 324,Residential,23312,0,23312,125155,0,148467
143020200800000,NW 324,Residential,23312,0,23312,105158,0,128470
143020200900000,NW 324,Residential,23312,0,23312,126717,0,150029
143020201000000,NW 324,Residential,23312,0,23312,108778,0,132090
143020201100000,NW 324,Residential,23312,0,23312,105175,0,128487
143020201200000,NW 324,Residential,23312,0,23312,79547,0,102859
143020201300000,NW 324,Residential,25115,0,25115,97514,0,122629
143020201400000,APARTMENT,Commercial,0,37110,37110,0,128640,165750
143020201500000,NW 324,Residential,28440,0,28440,104216,0,132656
143020201600000,NW 324,Residential,26880,0,26880,111839,0,138719
143020201700000,NW 324,Residential,25600,0,25600,113984,0,139584
143020201800000,NW 324,Residential,25088,0,25088,94967,0,120055
143020201900000,NW 324,Residential,24832,0,24832,114656,0,139488
143020202000000,NW 324,Residential,24832,0,24832,90985,0,115817
143020202100000,NW 324,Residential,24174,0,24174,114826,0,139000
143020202200000,NW 324,Residential,24832,0,24832,129363,0,154195
143020202300000,NW 324,Residential,24832,0,24832,127535,0,152367
143020202400000,NW 324,Residential,24832,0,24832,106274,0,131106
143020202500000,NW 324,Residential,24848,0,24848,111172,0,136020
143020300100000,CITY PROPERTY,Exempt,0,0,0,0,0,0
143020300200000,NW 324,Residential,11600,0,11600,0,0,11600
143020300300000,NW 324,Residential,22861,0,22861,130600,0,153461
143020300400000,NW 324,Residential,22861,0,22861,107970,0,130831
143020300500000,NW 324,Residential,22975,0,22975,105025,0,128000
143020300600000,NW 324,Residential,22560,0,22560,102091,0,124651
143020300700000,NW 324,Residential,22560,0,22560,84066,0,106626
143020300800000,NW 324,Residential,22560,0,22560,99886,0,122446
143020300900000,NW 324,Residential,22560,0,22560,101111,0,123671
143020301000000,NW 324,Residential,24487,0,24487,127112,0,151599
143020301100000,NW 324,Residential,24904,0,24904,90893,0,115797
143020301200000,NW 324,Residential,22560,0,22560,97815,0,120375
143020301300000,NW 324,Residential,22560,0,22560,102801,0,125361
143020301400000,NW 324,Residential,22560,0,22560,96425,0,118985
143020301500000,NW 324,Residential,22560,0,22560,89282,0,111842
143020301600000,NW 324,Residential,22560,0,22560,97236,0,119796
143020301700000,NW 324,Residential,22861,0,22861,88413,0,111274
143020301800000,NW 324,Residential,22861,0,22861,99017,0,121878
143020400100000,NW 324,Residential,26098,0,26098,86793,0,112891
143020400200000,CITY PROPERTY,Exempt,0,0,0,0,0,0
143020400300000,CITY PROPERTY,Exempt,0,0,0,0,0,0
143020400400000,NW 324,Residential,25738,0,25738,107281,0,133019
143020400500000,NW 324,Residential,24832,0,24832,103132,0,127964
143020400600000,NW 324,Residential,24832,0,24832,103814,0,128646
143020400700000,NW 324,Residential,24832,0,24832,117960,0,142792
143020400800000,NW 324,Residential,24832,0,24832,113262,0,138094
143020400900000,NW 324,Residential,24832,0,24832,118798,0,143630
143020401000000,NW 324,Residential,24832,0,24832,98974,0,123806
143020401100000,NW 324,Residential,24832,0,24832,118302,0,143134
143020401200000,NW 324,Residential,24832,0,24832,111849,0,136681
143020401300000,NW 324,Residential,23808,0,23808,138124,0,161932
143020401500000,NW 324,Residential,27012,0,27012,84065,0,111077
143020401600000,NW 324,Residential,31504,0,31504,72345,0,103849
143020401700000,NW 324,Residential,23280,0,23280,88350,0,111630
143020401800000,NW 324,Residential,26190,0,26190,92070,0,118260
143020401900000,NW 324,Residential,25048,0,25048,86713,0,111761
143020402000000,NW 324,Residential,24886,0,24886,97899,0,122785
143020402100000,NW 324,Residential,24240,0,24240,107380,0,131620
143020402200000,NW 324,Residential,24240,0,24240,106173,0,130413
143020402300000,NW 324,Residential,24240,0,24240,95377,0,119617
143020402400000,NW 324,Residential,24240,0,24240,107325,0,131565
143020402500000,NW 324,Residential,24240,0,24240,109030,0,133270
143020402600000,NW 324,Residential,24240,0,24240,119331,0,143571
143020402700000,NW 324,Residential,24710,0,24710,80290,0,105000
143020402800000,NW 324,Residential,24644,0,24644,117547,0,142191
143020402900000,NW 324,Residential,24644,0,24644,98715,0,123359
143020403000000,NW 324,Residential,24644,0,24644,136381,0,161025
143020500100000,NW 324,Residential,23508,0,23508,97309,0,120817
143020500200000,NW 324,Residential,22264,0,22264,120030,0,142294
143020500300000,NW 324,Residential,22568,0,22568,106967,0,129535
143020500400000,NW 324,Residential,22568,0,22568,97198,0,119766
143020500500000,NW 324,Residential,22568,0,22568,86794,0,109362
143020500600000,NW 324,Residential,22725,0,22725,83368,0,106093
143022600100000,NW 324,Residential,22618,0,22618,101967,0,124585
143022600200000,NW 324,Residential,22618,0,22618,118565,0,141183
143022600300000,NW 324,Residential,22618,0,22618,120816,0,143434
143022600400000,NW 324,Residential,22320,0,22320,101669,0,123989
143022600500000,NW 324,Residential,22320,0,22320,85114,0,107434
143022600600000,NW 324,Residential,22320,0,22320,99052,0,121372
143022600700000,NW 324,Residential,22320,0,22320,104984,0,127304
143022600800000,NW 324,Residential,22320,0,22320,102669,0,124989
143022600900000,NW 324,Residential,22320,0,22320,100974,0,123294
143022601000000,NW 324,Residential,21840,0,21840,99478,0,121318
143022601100000,NW 324,Residential,22037,0,22037,107091,0,129128
143022601200000,NW 324,Residential,11232,0,11232,0,0,11232
143022601300000,NW 324,Residential,31824,0,31824,99135,0,130959
143022601400000,NW 324,Residential,22926,0,22926,96522,0,119448
143022601500000,NW 324,Residential,22568,0,22568,130343,0,152911
143022601600000,NW 324,Residential,23515,0,23515,83168,0,106683
143022601700000,NW 324,Residential,22704,0,22704,89846,0,112550
143022601800000,NW 324,Residential,22320,0,22320,97241,0,119561
143022601900000,NW 324,Residential,22320,0,22320,96980,0,119300
143022602000000,NW 324,Residential,22320,0,22320,105831,0,128151
143022602100000,NW 324,Residential,22320,0,22320,90255,0,112575
143022602200000,NW 324,Residential,22320,0,22320,104114,0,126434
143022602300000,NW 324,Residential,22320,0,22320,93858,0,116178
143022602400000,NW 324,Residential,22618,0,22618,98699,0,121317
143022700100000,CENTRALLY ASSESSED,Other,0,0,0,0,0,0
143022700200000,NW 324,Residential,26512,0,26512,97424,0,123936
143022700300000,NW 324,Residential,26664,0,26664,93476,0,120140
143022700400000,NW 324,Residential,27472,0,27472,119736,0,147208
143022700500000,NW 324,Residential,25856,0,25856,103054,0,128910
143022700600000,NW 324,Residential,28381,0,28381,99581,0,127962
143022700700000,NW 324,Residential,28280,0,28280,113544,0,141824
143022700800000,NW 324,Residential,29088,0,29088,108153,0,137241
143022700900000,NW 324,Residential,34325,0,34325,99206,0,133531
143022701000000,NW 324,Residential,23038,0,23038,102770,0,125808
143022701100000,NW 324,Residential,22800,0,22800,124715,0,147515
143022701200000,NW 324,Residential,22800,0,22800,99665,0,122465
143022701300000,NW 324,Residential,22800,0,22800,104499,0,127299
143022701400000,NW 324,Residential,22800,0,22800,85917,0,108717
143022701500000,NW 324,Residential,22800,0,22800,116559,0,139359
143022701600000,NW 324,Residential,22800,0,22800,102573,0,125373
143022701700000,NW 324,Residential,22800,0,22800,96824,0,119624
143022701800000,NW 324,Residential,22800,0,22800,100557,0,123357
143022701900000,NW 324,Residential,22800,0,22800,102241,0,125041
143022702000000,NW 324,Residential,22800,0,22800,91837,0,114637
143022702100000,NW 324,Residential,22800,0,22800,123465,0,146265
143022702200000,NW 324,Residential,22800,0,22800,90552,0,113352
143022800100000,FLAT PARKING,Commercial,0,99947,99947,0,3172,103119
143022800200000,FAST FOOD,Commercial,0,120960,120960,0,220825,341785
143022800300000,NW 324,Residential,17,0,17,0,0,17
143022800400000,NBHD SHOPPING CENTER,Commercial,0,621864,621864,0,2626296,3248160
143022800500000,NBHD SHOPPING CENTER,Commercial,0,374112,374112,0,1169412,1543524
143022800600000,CARWASH,Commercial,0,145800,145800,0,182029,327829
143022800900000,LAUNDROMAT/CLEANERS,Commercial,0,57022,57022,0,160016,217038
143022801000000,SMALL RETAIL,Commercial,0,103615,103615,0,127454,231069
143022801100000,SMALL RETAIL,Commercial,0,111586,111586,0,147307,258893
143022801200000,RESTAURANT,Commercial,0,84135,84135,0,135241,219376
143022801300000,SMALL RETAIL,Commercial,0,79388,79388,0,87116,166504
143022801400000,NW 324,Residential,27720,0,27720,67219,0,94939
143022801500000,NW 324,Residential,22325,0,22325,97410,0,119735
143022801600000,NW 324,Residential,28280,0,28280,103481,0,131761
143022801700000,NW 324,Residential,29088,0,29088,111639,0,140727
143022801800000,NW 324,Residential,28280,0,28280,93098,0,121378
143022801900000,NW 324,Residential,26719,0,26719,85167,0,111886
143022802000000,NW 324,Residential,25856,0,25856,107637,0,133493
143022802100000,NW 324,Residential,25856,0,25856,91416,0,117272
143022802200000,NW 324,Residential,27068,0,27068,109185,0,136253
143022802300000,NW 324,Residential,26057,0,26057,157345,0,183402
143022802400000,VACANT LAND,Commercial,0,6435,6435,0,0,6435
143022802500000,VACANT LAND,Commercial,0,15529,15529,0,0,15529
143022802600000,VACANT LAND,Commercial,0,35105,35105,0,0,35105
143022802700000,VACANT LAND,Commercial,0,35105,35105,0,0,35105
143022802800000,VACANT LAND,Commercial,0,38935,38935,0,0,38935
143022802900000,VACANT LAND,Commercial,0,38423,38423,0,0,38423
143022803000000,VACANT LAND,Commercial,0,33113,33113,0,0,33113
143022900700000,FLAT PARKING,Commercial,0,778,778,0,0,778
143022900800000,FLAT PARKING,Commercial,0,17604,17604,0,1187,18791
143025100100000,OFFICE,Commercial,0,123379,123379,0,168067,291446
143025100200000,OFFICE,Commercial,0,96665,96665,0,163966,260631
143025100500000,APARTMENT,Commercial,0,12134,12134,0,129640,141774
143025100600000,APARTMENT,Commercial,0,13268,13268,0,129640,142908
143025100700000,APARTMENT,Commercial,0,13414,13414,0,129360,142774
143025100800000,NW 333,Residential,28587,0,28587,93565,0,122152
143025100900000,NW 333,Residential,36012,0,36012,131302,0,167314
143025101000000,NW 333,Residential,44779,0,44779,150898,0,195677
143025101100000,NW 333,Residential,33046,0,33046,121472,0,154518
143025101200000,NW 333,Residential,33228,0,33228,97301,0,130529
143025101300000,NW 333,Residential,35100,0,35100,106474,0,141574
143025101400000,NW 333,Residential,35100,0,35100,92475,0,127575
143025101500000,NW 333,Residential,35100,0,35100,115184,0,150284
143025101600000,NW 333,Residential,35100,0,35100,101261,0,136361
143025101700000,NW 333,Residential,35802,0,35802,129458,0,165260
143025101800000,NW 333,Residential,32760,0,32760,104252,0,137012
143025101900000,NW 333,Residential,31200,0,31200,96293,0,127493
143025102000000,NW 333,Residential,31853,0,31853,95852,0,127705
143025102100000,NW 333,Residential,31200,0,31200,132515,0,163715
143025102200000,NW 333,Residential,31800,0,31800,176348,0,208148
143025102300000,NW 333,Residential,31800,0,31800,165378,0,197178
143025102400000,NW 333,Residential,30952,0,30952,174491,0,205443
143025102500000,NW 333,Residential,61200,0,61200,399832,0,461032
143025102600000,NW 324,Residential,57900,0,57900,0,0,57900
143025200100000,APARTMENT,Commercial,0,14580,14580,0,126191,140771
143025200200000,APARTMENT,Commercial,0,14580,14580,0,125333,139913
143025200300000,VACANT LAND,Residential,393174,0,393174,0,0,393174
143025200400000,NW 333,Residential,31393,0,31393,131334,0,162727
143025200500000,NW 333,Residential,37183,0,37183,134159,0,171342
143025200600000,NW 333,Residential,36032,0,36032,102761,0,138793
143025200700000,NW 333,Residential,30528,0,30528,118723,0,149251
143025200800000,NW 333,Residential,30528,0,30528,87044,0,117572
143025200900000,NW 333,Residential,30528,0,30528,80531,0,111059
143025201000000,NW 333,Residential,30528,0,30528,102550,0,133078
143025201100000,NW 333,Residential,30528,0,30528,84862,0,115390
143025201200000,NW 333,Residential,30782,0,30782,111379,0,142161
143025201300000,NW 333,Residential,29962,0,29962,89964,0,119926
143025201400000,NW 333,Residential,29680,0,29680,90240,0,119920
143025201500000,NW 333,Residential,29680,0,29680,86260,0,115940
143025201600000,NW 333,Residential,30210,0,30210,116552,0,146762
143025201700000,NW 333,Residential,30210,0,30210,100375,0,130585
143025201800000,NW 333,Residential,30210,0,30210,107390,0,137600
143025201900000,NW 333,Residential,29680,0,29680,97521,0,127201
143025202000000,NW 333,Residential,29991,0,29991,116830,0,146821
143025202100000,NW 333,Residential,29640,0,29640,112705,0,142345
143025202200000,NW 333,Residential,29120,0,29120,105581,0,134701
143025202300000,NW 333,Residential,29952,0,29952,101191,0,131143
143025202400000,NW 333,Residential,27040,0,27040,111884,0,138924
143025202500000,NW 333,Residential,29640,0,29640,120330,0,149970
143025202600000,NW 333,Residential,29528,0,29528,103597,0,133125
143025202700000,NW 333,Residential,29120,0,29120,113435,0,142555
143025202800000,APARTMENT,Commercial,0,14515,14515,0,134558,149073
143025300200000,CONVENIENCE STORE,Commercial,0,326268,326268,0,627672,953940
143025300300000,NBHD SHOPPING CENTER,Commercial,0,198990,198990,0,293072,492062
143025300400000,NW 333,Residential,29037,0,29037,72230,0,101267
143025300500000,NW 333,Residential,29120,0,29120,78324,0,107444
143025300600000,NW 333,Residential,29120,0,29120,90262,0,119382
143025300700000,NW 333,Residential,29120,0,29120,92626,0,121746
143025300800000,NW 333,Residential,29065,0,29065,77408,0,106473
143025300900000,NW 333,Residential,30727,0,30727,85051,0,115778
143025301000000,NW 333,Residential,29120,0,29120,83384,0,112504
143025301100000,NW 333,Residential,29120,0,29120,77759,0,106879
143025301200000,NW 333,Residential,29120,0,29120,68533,0,97653
143025301300000,NW 333,Residential,29120,0,29120,91472,0,120592
143025301400000,NW 333,Residential,30257,0,30257,88043,0,118300
143025400100000,NW 333,Residential,29646,0,29646,115411,0,145057
143025400200000,NW 333,Residential,30097,0,30097,105785,0,135882
143025400300000,NW 333,Residential,29680,0,29680,96632,0,126312
143025400400000,NW 333,Residential,30210,0,30210,98010,0,128220
143025400500000,NW 333,Residential,29680,0,29680,81336,0,111016
143025400600000,NW 333,Residential,30210,0,30210,116551,0,146761
143025400700000,NW 333,Residential,29680,0,29680,103463,0,133143
143025400800000,NW 333,Residential,30210,0,30210,95398,0,125608
143025400900000,NW 333,Residential,29680,0,29680,92117,0,121797
143025401000000,NW 333,Residential,28408,0,28408,111082,0,139490
143025401100000,NW 333,Residential,31418,0,31418,123113,0,154531
143025401200000,NW 333,Residential,30210,0,30210,89348,0,119558
143025401300000,NW 333,Residential,29680,0,29680,86975,0,116655
143025401400000,NW 333,Residential,30438,0,30438,99927,0,130365
143025401500000,NW 333,Residential,31811,0,31811,107699,0,139510
143025401600000,NW 333,Residential,29960,0,29960,94728,0,124688
143025401700000,NW 333,Residential,30210,0,30210,132041,0,162251
143025401800000,NW 333,Residential,29680,0,29680,121235,0,150915
143025401900000,NW 333,Residential,30210,0,30210,94611,0,124821
143025402000000,NW 333,Residential,29680,0,29680,144777,0,174457
143025402100000,NW 333,Residential,30210,0,30210,156458,0,186668
143025402200000,NW 333,Residential,29680,0,29680,119952,0,149632
143025402300000,NW 333,Residential,30210,0,30210,98471,0,128681
143025402400000,NW 333,Residential,29680,0,29680,118789,0,148469
143025402500000,NW 333,Residential,30210,0,30210,126322,0,156532
143025402600000,NW 333,Residential,29680,0,29680,117653,0,147333
143025500100000,NW 333,Residential,29120,0,29120,81368,0,110488
143025500200000,NW 333,Residential,29120,0,29120,107456,0,136576
143025500300000,NW 333,Residential,29120,0,29120,120255,0,149375
143025500400000,NW 333,Residential,29120,0,29120,80154,0,109274
143025500500000,NW 333,Residential,28160,0,28160,69655,0,97815
143025500600000,NW 333,Residential,28160,0,28160,102207,0,130367
143025500700000,NW 333,Residential,28087,0,28087,89047,0,117134
143025500800000,NW 333,Residential,29231,0,29231,112439,0,141670
143025500900000,NW 333,Residential,28160,0,28160,71765,0,99925
143025501000000,NW 333,Residential,28160,0,28160,109414,0,137574
143025600100000,NW 333,Residential,33300,0,33300,170901,0,204201
143025600200000,NW 333,Residential,33300,0,33300,170769,0,204069
143025600300000,NW 333,Residential,30932,0,30932,102543,0,133475
143025600400000,NW 333,Residential,28812,0,28812,133481,0,162293
143025600500000,NW 333,Residential,28000,0,28000,123708,0,151708
143027600100000,NW 324,Residential,33758,0,33758,95812,0,129570
143027600200000,NW 324,Residential,24240,0,24240,87690,0,111930
143027600300000,NW 324,Residential,24240,0,24240,69206,0,93446
143027600400000,NW 324,Residential,24240,0,24240,86510,0,110750
143027600500000,NW 324,Residential,24240,0,24240,75842,0,100082
143027600600000,NW 324,Residential,24240,0,24240,91847,0,116087
143027600700000,NW 324,Residential,28280,0,28280,84622,0,112902
143027600800000,NW 324,Residential,28280,0,28280,168677,0,196957
143027600900000,NW 324,Residential,29088,0,29088,96962,0,126050
143027601000000,NW 324,Residential,28280,0,28280,122931,0,151211
143027601100000,NW 324,Residential,28280,0,28280,95469,0,123749
143027601200000,NW 324,Residential,28280,0,28280,90027,0,118307
143027601300000,NW 324,Residential,28280,0,28280,89405,0,117685
143027601400000,NW 324,Residential,30300,0,30300,149478,0,179778
143027700200000,NW 324,Residential,24696,0,24696,84524,0,109220
143027700300000,NW 324,Residential,18397,0,18397,49037,0,67434
143027700400000,NW 324,Residential,18393,0,18393,106670,0,125063
143027700500000,NW 324,Residential,18393,0,18393,72261,0,90654
143027700600000,NW 324,Residential,24240,0,24240,69164,0,93404
143027700700000,NW 324,Residential,24240,0,24240,69890,0,94130
143027700800000,NW 324,Residential,24240,0,24240,32588,0,56828
143027700900000,APARTMENT,Commercial,0,36690,36690,0,113310,150000
143027701000000,NW 324,Residential,30906,0,30906,80820,0,111726
143027701100000,NW 324,Residential,31129,0,31129,87207,0,118336
143027701200000,NW 324,Residential,40226,0,40226,143759,0,183985
143027701300000,NW 324,Residential,30300,0,30300,171607,0,201907
143027701400000,NW 324,Residential,30300,0,30300,90290,0,120590
143027701500000,NW 324,Residential,29088,0,29088,89595,0,118683
143027701600000,NW 324,Residential,29088,0,29088,102830,0,131918
143027701700000,NW 324,Residential,24240,0,24240,80182,0,104422
143027701800000,NW 324,Residential,24240,0,24240,93547,0,117787
143027701900000,NW 324,Residential,20200,0,20200,91355,0,111555
143027702000000,NW 324,Residential,28280,0,28280,115387,0,143667
143027702100000,NW 324,Residential,24240,0,24240,93233,0,117473
143027702200000,NW 324,Residential,24240,0,24240,105105,0,129345
143027702300000,NW 324,Residential,24240,0,24240,70734,0,94974
143027702400000,NW 324,Residential,24240,0,24240,75736,0,99976
143027702600000,NW 324,Residential,34000,0,34000,0,0,34000
143027702800000,NW 324,Residential,26600,0,26600,70825,0,97425
143027703000000,NW 324,Residential,96,0,96,0,0,96
143027703100000,NW 324,Residential,30704,0,30704,97682,0,128386
143027800100000,NW 324,Residential,18397,0,18397,122442,0,140839
143027800200000,NW 324,Residential,18393,0,18393,71890,0,90283
143027800300000,NW 324,Residential,18393,0,18393,76484,0,94877
143027800400000,AUTO REPAIR/SALES,Commercial,0,125280,125280,0,112782,238062
143027800402000,CARWASH,Commercial,0,0,0,0,47544,47544
143027800500000,FAST FOOD,Commercial,0,111110,111110,0,132230,243340
143027800600000,OFFICE,Commercial,0,109555,109555,0,177751,287306
143027800700000,MFG HOME PARK,Commercial,0,352080,352080,0,186223,538303
143027800800000,NW 333,Residential,30952,0,30952,154536,0,185488
143027800900000,NW 333,Residential,31800,0,31800,157043,0,188843
143027801000000,NW 333,Residential,31800,0,31800,173305,0,205105
143027801100000,NW 324,Residential,57500,0,57500,85271,0,142771
143027801200000,NW 324,Residential,5000,0,5000,0,0,5000
143027801300000,NW 324,Residential,31162,0,31162,90631,0,121793
143027801400000,NW 324,Residential,23054,0,23054,86768,0,109822
143027801500000,NW 324,Residential,28473,0,28473,87580,0,116053
143027801600000,NW 324,Residential,28168,0,28168,94292,0,122460
143027801700000,NW 324,Residential,930,0,930,0,0,930
143027801800000,APARTMENT,Commercial,0,43060,43060,0,280396,323456
143027801900000,NW 324,Residential,9520,0,9520,0,0,9520
143027802000000,NW 324,Residential,24240,0,24240,34216,0,58456
143027802100000,NW 324,Residential,24240,0,24240,87628,0,111868
143027802200000,NW 324,Residential,24240,0,24240,35089,0,59329
143027802400000,NW 324,Residential,28324,0,28324,0,0,28324
143027802500000,NW 324,Residential,28324,0,28324,0,0,28324
143027802600000,NW 324,Residential,28324,0,28324,0,0,28324
143027802700000,NW 324,Residential,28324,0,28324,0,0,28324
143027900100000,NW 324,Residential,36741,0,36741,108208,0,144949
143027900200000,NW 324,Residential,36630,0,36630,111854,0,148484
143027900300000,NW 324,Residential,36630,0,36630,99974,0,136604
143027900400000,NW 324,Residential,36741,0,36741,118917,0,155658
143027900500000,NW 324,Residential,23320,0,23320,153592,0,176912
143028000100000,NW 333,Residential,33824,0,33824,187165,0,220989
143028000200000,NW 333,Residential,33600,0,33600,172806,0,206406
143028000300000,NW 324,Residential,28080,0,28080,0,0,28080
143028000400000,NW 324,Residential,26320,0,26320,53326,0,79646
143028000500000,NW 324,Residential,26320,0,26320,199876,0,226196
143028000600000,CITY PROPERTY,Exempt,0,0,0,0,0,0
143028100100000,NW 324,Residential,20,0,20,0,0,20
143030100100000,CHURCH,Exempt,0,396576,396576,0,864100,1260676
143030100200000,NW 333,Residential,25913,0,25913,110095,0,136008
143030100300000,NW 333,Residential,25860,0,25860,127355,0,153215
143030100400000,NW 333,Residential,26014,0,26014,110698,0,136712
143030100500000,NW 333,Residential,26220,0,26220,107093,0,133313
143030100600000,NW 333,Residential,26220,0,26220,123395,0,149615
143030100700000,NW 333,Residential,26220,0,26220,130234,0,156454
143030100800000,NW 333,Residential,33579,0,33579,141132,0,174711
143030100900000,NW 333,Residential,28816,0,28816,96106,0,124922
143030101000000,CITY PROPERTY,Exempt,0,0,0,0,0,0
143030101100000,NW 333,Residential,32123,0,32123,122587,0,154710
143030101200000,NW 333,Residential,29220,0,29220,144369,0,173589
143030101300000,NW 333,Residential,27537,0,27537,90698,0,118235
143030101400000,NW 333,Residential,24240,0,24240,88870,0,113110
143030101500000,NW 333,Residential,27472,0,27472,110608,0,138080
143030200100000,NW 333,Residential,25993,0,25993,106978,0,132971
143030200200000,NW 333,Residential,25280,0,25280,91160,0,116440
143030200300000,NW 333,Residential,24800,0,24800,83126,0,107926
143030200400000,NW 333,Residential,26684,0,26684,91446,0,118130
143030200500000,NW 333,Residential,28896,0,28896,88903,0,117799
143030200600000,NW 333,Residential,39179,0,39179,111969,0,151148
143030300100000,NW 333,Residential,28955,0,28955,138112,0,167067
143030300200000,NW 333,Residential,30562,0,30562,126707,0,157269
143030300300000,NW 333,Residential,33320,0,33320,133829,0,167149
143030300400000,NW 333,Residential,32944,0,32944,123248,0,156192
143030300500000,NW 333,Residential,28920,0,28920,139058,0,167978
143030300600000,NW 333,Residential,29058,0,29058,124305,0,153363
143030300700000,NW 333,Residential,26574,0,26574,89878,0,116452
143030300800000,NW 333,Residential,26574,0,26574,95872,0,122446
143030300900000,NW 333,Residential,26574,0,26574,89864,0,116438
143030301000000,NW 333,Residential,26574,0,26574,87638,0,114212
143030301100000,NW 333,Residential,26574,0,26574,86558,0,113132
143030301200000,NW 333,Residential,26574,0,26574,83453,0,110027
143030301300000,NW 333,Residential,27724,0,27724,88713,0,116437
143030301400000,NW 333,Residential,27520,0,27520,94281,0,121801
143030301500000,NW 333,Residential,56300,0,56300,156701,0,213001
143030301600000,NW 333,Residential,39942,0,39942,102760,0,142702
143030301700000,NW 333,Residential,32096,0,32096,151595,0,183691
143030301800000,NW 333,Residential,31459,0,31459,75840,0,107299
143030301900000,NW 333,Residential,28000,0,28000,126841,0,154841
143030302000000,NW 333,Residential,26477,0,26477,103958,0,130435
143030302100000,NW 333,Residential,29539,0,29539,137949,0,167488
143030302200000,NW 333,Residential,26577,0,26577,117837,0,144414
143030400100000,SW 406,Residential,56650,0,56650,732,0,57382
143030400200000,SW 406,Residential,35986,0,35986,150393,0,186379
143030400300000,SW 406,Residential,29520,0,29520,103990,0,133510
143030400400000,SW 406,Residential,27077,0,27077,141721,0,168798
143030400500000,SW 406,Residential,26965,0,26965,144818,0,171783
143030400600000,SW 406,Residential,23718,0,23718,99294,0,123012
143030400700000,SW 406,Residential,48300,0,48300,87386,0,135686
143030400800000,SW 406,Residential,22680,0,22680,95726,0,118406
143030400900000,SW 406,Residential,27300,0,27300,113256,0,140556
143030401000000,SW 427,Residential,51200,0,51200,234050,0,285250
143030401100000,SW 427,Residential,57350,0,57350,210853,0,268203
143030401200000,SW 427,Residential,28903,0,28903,152921,0,181824
143030401300000,SW 427,Residential,29159,0,29159,148396,0,177555
143030401400000,SW 427,Residential,28463,0,28463,147448,0,175911
143030401500000,SW 427,Residential,28018,0,28018,140675,0,168693
143030401600000,SW 427,Residential,28425,0,28425,106363,0,134788
143030500200000,FRATERNAL,Exempt,0,192186,192186,0,1182541,1374727
143030500300000,SW 406,Residential,34272,0,34272,96197,0,130469
143030500400000,SW 406,Residential,59200,0,59200,324679,0,383879
143030500500000,SW 406,Residential,28350,0,28350,63195,0,91545
143030500600000,SW 406,Residential,24111,0,24111,67676,0,91787
143030500700000,SW 406,Residential,32544,0,32544,99281,0,131825
143030500800000,SW 406,Residential,21840,0,21840,88603,0,110443
143032600100000,NW 333,Residential,29169,0,29169,129858,0,159027
143032600200000,NW 333,Residential,27744,0,27744,111196,0,138940
143032600300000,NW 333,Residential,27744,0,27744,114963,0,142707
143032600400000,NW 333,Residential,27744,0,27744,103995,0,131739
143032700100000,NW 333,Residential,24720,0,24720,95185,0,119905
143032700200000,NW 333,Residential,26154,0,26154,88701,0,114855
143032700300000,NW 333,Residential,25956,0,25956,94394,0,120350
143032700400000,NW 333,Residential,28170,0,28170,123165,0,151335
143032800100000,NW 333,Residential,31623,0,31623,103276,0,134899
143032800200000,NW 333,Residential,29120,0,29120,91759,0,120879
143032800300000,NW 333,Residential,29357,0,29357,105899,0,135256
143032900100000,NW 333,Residential,28883,0,28883,114173,0,143056
143032900200000,NW 333,Residential,29120,0,29120,116381,0,145501
143032900300000,NW 333,Residential,29120,0,29120,95309,0,124429
143032900400000,NW 333,Residential,29357,0,29357,89873,0,119230
143033000100000,NW 333,Residential,29376,0,29376,104317,0,133693
143033000200000,NW 333,Residential,26112,0,26112,100142,0,126254
143033000300000,NW 333,Residential,26357,0,26357,107190,0,133547
143033000400000,NW 333,Residential,27744,0,27744,111651,0,139395
143033000500000,NW 333,Residential,26177,0,26177,87760,0,113937
143033000600000,NW 333,Residential,27744,0,27744,107298,0,135042
143033000700000,NW 333,Residential,27744,0,27744,91240,0,118984
143033000800000,NW 333,Residential,29552,0,29552,122613,0,152165
143033000900000,NW 333,Residential,29955,0,29955,83742,0,113697
143033001000000,NW 333,Residential,29952,0,29952,87319,0,117271
143033001100000,NW 333,Residential,29952,0,29952,89509,0,119461
143033001200000,NW 333,Residential,29120,0,29120,102187,0,131307
143033001300000,NW 333,Residential,29952,0,29952,82249,0,112201
143033001400000,NW 333,Residential,29952,0,29952,82986,0,112938
143033001500000,NW 333,Residential,29952,0,29952,84148,0,114100
143033001600000,NW 333,Residential,29952,0,29952,83694,0,113646
143033001700000,NW 333,Residential,29952,0,29952,84508,0,114460
143033001800000,NW 333,Residential,29711,0,29711,84150,0,113861
143033001900000,NW 333,Residential,25772,0,25772,82871,0,108643
143033002000000,NW 333,Residential,25544,0,25544,69896,0,95440
143033002100000,NW 333,Residential,25544,0,25544,101818,0,127362
143033002200000,NW 333,Residential,25544,0,25544,82163,0,107707
143033002300000,NW 333,Residential,25544,0,25544,87289,0,112833
143033002400000,NW 333,Residential,25544,0,25544,88085,0,113629
143033002500000,NW 333,Residential,24682,0,24682,83976,0,108658
143033002600000,NW 333,Residential,28815,0,28815,109966,0,138781
143033002700000,NW 333,Residential,28620,0,28620,117477,0,146097
143033002800000,NW 333,Residential,26005,0,26005,114912,0,140917
143033002900000,NW 333,Residential,25368,0,25368,70465,0,95833
143033003000000,NW 333,Residential,29842,0,29842,110244,0,140086
143033003100000,NW 333,Residential,28016,0,28016,90943,0,118959
143033003200000,NW 333,Residential,28016,0,28016,79663,0,107679
143033003300000,NW 333,Residential,26434,0,26434,93811,0,120245
143033003400000,NW 333,Residential,28016,0,28016,94433,0,122449
143033003500000,NW 333,Residential,28016,0,28016,82926,0,110942
143033003600000,NW 333,Residential,28016,0,28016,107350,0,135366
143033003700000,NW 333,Residential,28016,0,28016,109164,0,137180
143033100100000,NW 333,Residential,28016,0,28016,84579,0,112595
143033100200000,NW 333,Residential,28016,0,28016,96207,0,124223
143033100300000,NW 333,Residential,28016,0,28016,101175,0,129191
143033100400000,NW 333,Residential,28016,0,28016,132749,0,160765
143033100500000,NW 333,Residential,26434,0,26434,87884,0,114318
143033100600000,NW 333,Residential,28016,0,28016,88764,0,116780
143033100700000,NW 333,Residential,28016,0,28016,108898,0,136914
143033100800000,NW 333,Residential,29842,0,29842,92611,0,122453
143033100900000,NW 333,Residential,29422,0,29422,97743,0,127165
143033101000000,NW 333,Residential,29845,0,29845,99616,0,129461
143033101100000,NW 333,Residential,29661,0,29661,109481,0,139142
143033101200000,NW 333,Residential,24720,0,24720,90748,0,115468
143033101300000,NW 333,Residential,25137,0,25137,80556,0,105693
143033101400000,NW 333,Residential,25544,0,25544,80040,0,105584
143033101500000,NW 333,Residential,25544,0,25544,103753,0,129297
143033101600000,NW 333,Residential,25544,0,25544,105466,0,131010
143033101700000,NW 333,Residential,25544,0,25544,80837,0,106381
143033101800000,NW 333,Residential,25544,0,25544,80360,0,105904
143033101900000,NW 333,Residential,25316,0,25316,98122,0,123438
143033102000000,NW 333,Residential,25772,0,25772,81695,0,107467
143033102100000,NW 333,Residential,25544,0,25544,90080,0,115624
143033102200000,NW 333,Residential,25544,0,25544,86712,0,112256
143033102300000,NW 333,Residential,25544,0,25544,98257,0,123801
143033102400000,NW 333,Residential,25544,0,25544,87009,0,112553
143033102500000,NW 333,Residential,24720,0,24720,93291,0,118011
143033102600000,NW 333,Residential,28612,0,28612,107443,0,136055
143033102700000,NW 333,Residential,28824,0,28824,97121,0,125945
143033102800000,NW 333,Residential,26780,0,26780,108600,0,135380
143033102900000,NW 333,Residential,25928,0,25928,83359,0,109287
143033103000000,NW 333,Residential,28560,0,28560,104942,0,133502
143033103100000,NW 333,Residential,29664,0,29664,108873,0,138537
143033103200000,NW 333,Residential,29664,0,29664,117302,0,146966
143033103300000,NW 333,Residential,29862,0,29862,108068,0,137930
143033103400000,NW 333,Residential,29746,0,29746,114873,0,144619
143033103500000,NW 333,Residential,30996,0,30996,141413,0,172409
143033103600000,NW 333,Residential,28922,0,28922,121631,0,150553
143033103700000,NW 333,Residential,25800,0,25800,118036,0,143836
143033103800000,NW 333,Residential,27276,0,27276,88882,0,116158
143033103900000,NW 333,Residential,28500,0,28500,113207,0,141707
143033104000000,NW 333,Residential,28500,0,28500,103544,0,132044
143033104100000,NW 333,Residential,31007,0,31007,96882,0,127889
143033200100000,NW 333,Residential,31188,0,31188,97304,0,128492
143033200200000,NW 333,Residential,29862,0,29862,94900,0,124762
143033200300000,NW 333,Residential,29664,0,29664,91352,0,121016
143033200400000,NW 333,Residential,29664,0,29664,107999,0,137663
143033200500000,NW 333,Residential,30400,0,30400,127411,0,157811
143033200600000,NW 333,Residential,32565,0,32565,113501,0,146066
143033200700000,NW 333,Residential,28520,0,28520,115519,0,144039
143033200800000,NW 333,Residential,28494,0,28494,110731,0,139225
143033200900000,NW 333,Residential,31128,0,31128,93398,0,124526
143033201000000,NW 333,Residential,28840,0,28840,112264,0,141104
143033201100000,NW 333,Residential,28840,0,28840,94134,0,122974
143033201200000,NW 333,Residential,34718,0,34718,124895,0,159613
143033201300000,NW 333,Residential,30138,0,30138,100354,0,130492
143033201400000,NW 333,Residential,24682,0,24682,95683,0,120365
143033201500000,NW 333,Residential,25180,0,25180,74983,0,100163
143033201600000,NW 333,Residential,28491,0,28491,82917,0,111408
143033201700000,NW 333,Residential,25440,0,25440,94318,0,119758
143033201800000,NW 333,Residential,25228,0,25228,72422,0,97650
143033201900000,NW 333,Residential,23256,0,23256,50027,0,73283
143033202000000,NW 333,Residential,26984,0,26984,85191,0,112175
143033202100000,NW 333,Residential,21420,0,21420,0,0,21420
143033202200000,NW 333,Residential,16957,0,16957,75727,0,92684
143033202400000,NW 333,Residential,28373,0,28373,83326,0,111699
143033202500000,NW 333,Residential,27720,0,27720,97697,0,125417
143033202600000,NW 333,Residential,28169,0,28169,93719,0,121888
143033202700000,NW 333,Residential,34658,0,34658,58660,0,93318
143033202800000,NW 333,Residential,33966,0,33966,109398,0,143364
143033202900000,NW 333,Residential,34200,0,34200,90060,0,124260
143033203000000,NW 333,Residential,30348,0,30348,125776,0,156124
143033203100000,NW 333,Residential,28800,0,28800,97785,0,126585
143033203200000,NW 333,Residential,40180,0,40180,176150,0,216330
143033203300000,NW 333,Residential,41210,0,41210,79752,0,120962
143033300100000,SW 406,Residential,32742,0,32742,85249,0,117991
143033300200000,SW 406,Residential,30548,0,30548,96094,0,126642
143033300300000,SW 406,Residential,36225,0,36225,164160,0,200385
143033300400000,SW 406,Residential,36225,0,36225,149397,0,185622
143033300500000,SW 406,Residential,36225,0,36225,113352,0,149577
143033300600000,SW 406,Residential,36070,0,36070,131306,0,167376
143033400100000,SW 406,Residential,29376,0,29376,92277,0,121653
143033400200000,SW 406,Residential,27968,0,27968,86730,0,114698
143033400300000,SW 406,Residential,33201,0,33201,125386,0,158587
143033400400000,SW 406,Residential,33048,0,33048,114867,0,147915
143033400500000,SW 406,Residential,32130,0,32130,112768,0,144898
143033400600000,CHURCH,Exempt,0,224640,224640,0,716376,941016
143033400700000,SW 406,Residential,45050,0,45050,90658,0,135708
143033400800000,SW 406,Residential,37834,0,37834,123366,0,161200
143033400900000,SW 406,Residential,37584,0,37584,107246,0,144830
143033401000000,SW 406,Residential,4296,0,4296,0,0,4296
143033500100000,SW 406,Residential,29382,0,29382,96299,0,125681
143035100100000,SW 406,Residential,35190,0,35190,113403,0,148593
143035100200000,SW 406,Residential,34155,0,34155,99833,0,133988
143035100300000,SW 406,Residential,32775,0,32775,91524,0,124299
143035100400000,SW 406,Residential,31104,0,31104,113001,0,144105
143035100500000,SW 406,Residential,27360,0,27360,90343,0,117703
143035200100000,SW 406,Residential,27936,0,27936,113037,0,140973
143035200200000,SW 406,Residential,27936,0,27936,89074,0,117010
143035200300000,SW 406,Residential,25105,0,25105,76383,0,101488
143035200400000,SW 406,Residential,25488,0,25488,91238,0,116726
143035200500000,SW 406,Residential,26550,0,26550,70349,0,96899
143035200600000,SW 406,Residential,27776,0,27776,87447,0,115223
143035200700000,SW 406,Residential,28811,0,28811,86675,0,115486
143035200800000,SW 406,Residential,28888,0,28888,90418,0,119306
143035300100000,SW 406,Residential,27284,0,27284,92066,0,119350
143035300200000,SW 406,Residential,42476,0,42476,139362,0,181838
143035300300000,SW 406,Residential,33048,0,33048,110412,0,143460
143035300400000,SW 406,Residential,19398,0,19398,90715,0,110113
143035300500000,SW 406,Residential,22567,0,22567,94546,0,117113
143035300600000,SW 406,Residential,22567,0,22567,77542,0,100109
143035300700000,DAY CARE CENTER,Commercial,0,102390,102390,0,120897,223287
143035300800000,SR/NURSING/ASSTD LIV,Commercial,0,35694,35694,0,657487,693181
143035300900000,SW 406,Residential,25461,0,25461,71943,0,97404
143035301000000,SW 406,Residential,25461,0,25461,58680,0,84141
143035301100000,SW 406,Residential,28711,0,28711,91318,0,120029
143035301200000,SW 406,Residential,27284,0,27284,92888,0,120172
143035301300000,SW 406,Residential,27284,0,27284,81922,0,109206
143035301400000,SW 406,Residential,27284,0,27284,88475,0,115759
143035301500000,SW 406,Residential,27284,0,27284,84234,0,111518
143035301600000,SW 406,Residential,27284,0,27284,89087,0,116371
143035301700000,SW 406,Residential,27284,0,27284,81282,0,108566
143035301800000,SW 406,Residential,27284,0,27284,96762,0,124046
143035301900000,SW 406,Residential,27284,0,27284,86663,0,113947
143035400100000,SW 406,Residential,27936,0,27936,92334,0,120270
143035400200000,SW 406,Residential,27936,0,27936,88213,0,116149
143035400300000,SW 406,Exempt,0,56450,56450,0,160952,217402
143035400400000,SW 406,Residential,27776,0,27776,80492,0,108268
143035400500000,SW 406,Residential,27081,0,27081,89717,0,116798
143035400600000,SW 406,Residential,26019,0,26019,79266,0,105285
143035400700000,SW 406,Residential,25105,0,25105,93582,0,118687
143035400800000,SW 406,Residential,30033,0,30033,97266,0,127299
143035400900000,SW 406,Residential,27284,0,27284,93593,0,120877
143035401000000,SW 406,Residential,27284,0,27284,67610,0,94894
143035401100000,SW 406,Residential,27284,0,27284,99233,0,126517
143035401200000,SW 406,Residential,27284,0,27284,97453,0,124737
143035401300000,SW 406,Residential,28590,0,28590,89294,0,117884
143035401400000,SW 406,Residential,32308,0,32308,110247,0,142555
143035401500000,SW 406,Residential,30110,0,30110,91111,0,121221
143035401600000,SW 406,Residential,23094,0,23094,82574,0,105668
143035401700000,SW 406,Residential,22950,0,22950,101253,0,124203
143035401800000,SW 406,Residential,29376,0,29376,90776,0,120152
143035401900000,SW 406,Residential,29376,0,29376,86050,0,115426
143035402000000,SW 406,Residential,29376,0,29376,89457,0,118833
143035402100000,SW 406,Residential,29376,0,29376,91160,0,120536
143035500100000,SW 406,Residential,28512,0,28512,74830,0,103342
143035500200000,SW 406,Residential,28512,0,28512,90355,0,118867
143035500300000,SW 406,Residential,33048,0,33048,97837,0,130885
143035500400000,SW 406,Residential,33121,0,33121,86654,0,119775
143035600100000,OFFICE,Exempt,0,96660,96660,0,473636,570296
143035600200000,SW 406,Residential,28800,0,28800,134069,0,162869
143035600300000,CONVERSION,Commercial,0,28350,28350,0,66863,95213
143035600400000,SW 406,Residential,27799,0,27799,119498,0,147297
143035600500000,SW 406,Residential,32185,0,32185,103186,0,135371
143035600600000,SW 406,Residential,28560,0,28560,108740,0,137300
143035600700000,SW 406,Residential,25704,0,25704,89692,0,115396
143035600800000,SW 406,Residential,26033,0,26033,0,0,26033
143035600900000,OFFICE,Commercial,0,126360,126360,0,329631,455991
143035601000000,BRANCH BANK/CU,Commercial,0,241650,241650,0,254783,496433
143035601100000,FAST FOOD,Commercial,0,278100,278100,0,361740,639840
143035601200000,STATE PROPERTY,Exempt,0,0,0,0,0,0
143035601300000,CONVENIENCE STORE,Commercial,0,183605,183605,0,284849,468454
143035601400000,BARS/LOUNGE,Commercial,0,96846,96846,0,77459,174305
143035601500000,NBHD SHOPPING CENTER,Commercial,0,373680,373680,0,980487,1354167
143035601600000,SMALL RETAIL,Commercial,0,179820,179820,0,465687,645507
143035601602000,BILLBOARD(BLL),Commercial,0,0,0,0,30180,30180
143035601700000,FAST FOOD,Commercial,0,244080,244080,0,182043,426123
143035601800000,FLAT PARKING,Commercial,0,35046,35046,0,0,35046
143035601900000,HOTEL,Commercial,0,534600,534600,0,415400,950000
143037600100000,SW 427,Residential,28840,0,28840,114987,0,143827
143037600200000,SW 427,Residential,28560,0,28560,109850,0,138410
143037600300000,SW 427,Residential,28280,0,28280,123360,0,151640
143037600400000,SW 427,Residential,28528,0,28528,138298,0,166826
143037600500000,SW 427,Residential,27809,0,27809,138360,0,166169
143037600600000,SW 427,Residential,28158,0,28158,114711,0,142869
143037600700000,SW 427,Residential,28272,0,28272,110504,0,138776
143037600800000,SW 427,Residential,27952,0,27952,121406,0,149358
143037600900000,SW 427,Residential,27160,0,27160,129246,0,156406
143037601000000,SW 427,Residential,27160,0,27160,116937,0,144097
143037601100000,SW 427,Residential,27975,0,27975,117472,0,145447
143037700100000,CITY PROPERTY,Exempt,0,0,0,0,0,0
143037700200000,SW 406,Residential,28350,0,28350,96693,0,125043
143037700300000,SW 406,Residential,30240,0,30240,134024,0,164264
143037700400000,SW 406,Residential,22444,0,22444,0,0,22444
143037700500000,SW 406,Residential,22444,0,22444,83616,0,106060
143037700600000,SW 406,Residential,23256,0,23256,68415,0,91671
143037700700000,SW 406,Residential,23256,0,23256,87163,0,110419
143037700800000,SW 406,Residential,24826,0,24826,132970,0,157796
143037700900000,SW 406,Residential,21060,0,21060,81339,0,102399
143037701000000,SW 406,Residential,24403,0,24403,137287,0,161690
143037701100000,SW 406,Residential,24480,0,24480,138620,0,163100
143037701300000,SW 406,Residential,29788,0,29788,89408,0,119196
143037701400000,SW 427,Residential,28032,0,28032,119679,0,147711
143037701500000,SW 427,Residential,28032,0,28032,153423,0,181455
143037701600000,SW 427,Residential,29290,0,29290,136632,0,165922
143037701700000,SW 427,Residential,29492,0,29492,113307,0,142799
143037701800000,SW 427,Residential,29258,0,29258,127503,0,156761
143037701900000,SW 427,Residential,29793,0,29793,131381,0,161174
143037702000000,SW 427,Residential,28534,0,28534,127642,0,156176
143037702100000,SW 427,Residential,31117,0,31117,118692,0,149809
143037702200000,SW 427,Residential,27862,0,27862,141776,0,169638
143037702300000,SW 427,Residential,27997,0,27997,112526,0,140523
143037800100000,SW 406,Residential,23310,0,23310,136314,0,159624
143037800200000,SW 406,Residential,55750,0,55750,242852,0,298602
143037800300000,SW 406,Residential,28889,0,28889,87147,0,116036
143037900100000,SW 406,Residential,24309,0,24309,98471,0,122780
143037900200000,SW 406,Residential,29755,0,29755,87847,0,117602
143037900300000,SW 406,Residential,24509,0,24509,78724,0,103233
143037900400000,SW 406,Residential,21060,0,21060,72976,0,94036
143037900500000,SW 406,Residential,27378,0,27378,57725,0,85103
143037900600000,SW 406,Residential,25272,0,25272,72866,0,98138
143037900700000,SW 406,Residential,25272,0,25272,125767,0,151039
143037900800000,SW 406,Residential,24633,0,24633,101996,0,126629
143037900900000,SW 406,Residential,24480,0,24480,75470,0,99950
143037901000000,SW 406,Residential,24309,0,24309,84161,0,108470
143038000100000,AUTO REPAIR/SALES,Commercial,0,118800,118800,0,80654,199454
143038000200000,SW 406,Residential,24401,0,24401,46779,0,71180
143038000300000,SW 406,Residential,24948,0,24948,77990,0,102938
143038000500000,SW 406,Residential,30937,0,30937,92034,0,122971
143038000600000,SW 406,Residential,26649,0,26649,50365,0,77014
143038000700000,SW 406,Residential,25875,0,25875,123848,0,149723
143038000800000,SW 406,Residential,43500,0,43500,77466,0,120966
143038000802000,BILLBOARD(BLL),Commercial,0,0,0,0,20295,20295
143038001000000,VACANT LAND,Commercial,0,97200,97200,0,0,97200
143038001100000,VACANT LAND,Commercial,0,172500,172500,0,0,172500
143038001200000,AUTO REPAIR/SALES,Commercial,0,126387,126387,0,250540,376927
143038001300000,SMALL RETAIL,Commercial,0,57265,57265,0,88807,146072
143038001400000,SECTION 42,Commercial,0,23860,23860,0,59908,83768
143038001500000,RESTAURANT,Commercial,0,354931,354931,0,25069,380000
143038001600000,VACANT LAND,Commercial,0,5994,5994,0,0,5994
143038100100000,CONVENIENCE STORE,Commercial,0,123323,123323,0,241888,365211
143038100300000,FLAT PARKING,Commercial,0,5713,5713,0,588,6301
143038100400000,FAST FOOD,Commercial,0,239760,239760,0,596157,835917
143038100500000,CITY PROPERTY,Exempt,0,0,0,0,0,0
143040100100000,SW 405,Residential,20580,0,20580,90375,0,110955
143040100200000,SW 405,Residential,19861,0,19861,80576,0,100437
143040100300000,SW 405,Residential,19861,0,19861,72423,0,92284
143040100400000,SW 405,Residential,19861,0,19861,64156,0,84017
143040100500000,SW 405,Residential,19861,0,19861,86732,0,106593
143040100600000,SW 405,Residential,19861,0,19861,77635,0,97496
143040100700000,SW 405,Residential,19861,0,19861,66780,0,86641
143040100800000,SW 405,Residential,19861,0,19861,70516,0,90377
143040100900000,SW 405,Residential,19861,0,19861,76575,0,96436
143040101000000,SW 405,Residential,19861,0,19861,65451,0,85312
143040101100000,SW 405,Residential,19861,0,19861,64800,0,84661
143040101200000,SW 405,Residential,19861,0,19861,69729,0,89590
143040101300000,SW 405,Residential,19861,0,19861,79846,0,99707
143040101400000,SW 405,Residential,19861,0,19861,78230,0,98091
143040101500000,SW 405,Residential,19861,0,19861,108783,0,128644
143040101600000,SW 405,Residential,19861,0,19861,59502,0,79363
143040101700000,SW 405,Residential,19600,0,19600,70123,0,89723
143040101800000,SW 405,Residential,19600,0,19600,85354,0,104954
143040101900000,SW 405,Residential,19600,0,19600,74115,0,93715
143040102000000,SW 405,Residential,24234,0,24234,65881,0,90115
143040102100000,SW 405,Residential,21036,0,21036,102245,0,123281
143040102200000,SW 405,Residential,20047,0,20047,70911,0,90958
143040102300000,SW 405,Residential,20047,0,20047,79826,0,99873
143040102400000,SW 405,Residential,20047,0,20047,70180,0,90227
143040102500000,SW 405,Residential,20047,0,20047,77898,0,97945
143040102600000,SW 405,Residential,20047,0,20047,73552,0,93599
143040102700000,SW 405,Residential,20047,0,20047,63050,0,83097
143040102800000,SW 405,Residential,20047,0,20047,92385,0,112432
143040102900000,SW 405,Residential,20047,0,20047,81881,0,101928
143040103000000,SW 405,Residential,20047,0,20047,69596,0,89643
143040103100000,SW 405,Residential,20047,0,20047,67974,0,88021
143040103200000,SW 405,Residential,20047,0,20047,101834,0,121881
143040103300000,SW 405,Residential,20047,0,20047,74134,0,94181
143040103400000,SW 405,Residential,20047,0,20047,57500,0,77547
143040103500000,SW 405,Residential,20047,0,20047,76175,0,96222
143040200100000,SW 405,Residential,22230,0,22230,78521,0,100751
143040200200000,SW 405,Residential,24225,0,24225,81232,0,105457
143040200300000,SW 405,Residential,21634,0,21634,69545,0,91179
143040200400000,SW 405,Residential,20680,0,20680,62430,0,83110
143040200500000,SW 405,Residential,20800,0,20800,76510,0,97310
143040200600000,SW 405,Residential,21424,0,21424,77664,0,99088
143040200700000,SW 405,Residential,20592,0,20592,80936,0,101528
143040200800000,SW 405,Residential,21923,0,21923,106260,0,128183
143040200900000,SW 405,Residential,27581,0,27581,51316,0,78897
143040201000000,SW 405,Residential,36180,0,36180,122524,0,158704
143040201100000,SW 405,Residential,32906,0,32906,121433,0,154339
143040201200000,SW 405,Residential,24294,0,24294,108879,0,133173
143040201300000,SW 405,Residential,26180,0,26180,115641,0,141821
143040201400000,SW 405,Residential,26400,0,26400,83205,0,109605
143040201500000,SW 405,Residential,24720,0,24720,97842,0,122562
143040201600000,SW 405,Residential,24905,0,24905,93498,0,118403
143040201700000,SW 405,Residential,24128,0,24128,73558,0,97686
143040201800000,SW 405,Residential,21539,0,21539,99917,0,121456
143040201900000,SW 405,Residential,21384,0,21384,95698,0,117082
143040202000000,SW 405,Residential,22938,0,22938,83822,0,106760
143040202100000,SW 405,Residential,22624,0,22624,65645,0,88269
143040202200000,SW 405,Residential,23028,0,23028,75137,0,98165
143040202300000,SW 405,Residential,22440,0,22440,64624,0,87064
143040202400000,SW 405,Residential,22440,0,22440,111384,0,133824
143040202500000,SW 405,Residential,23484,0,23484,85136,0,108620
143040202600000,SW 405,Residential,22180,0,22180,93273,0,115453
143040202700000,SW 405,Residential,22394,0,22394,87024,0,109418
143040202800000,SW 405,Residential,22394,0,22394,76307,0,98701
143040202900000,SW 405,Residential,21780,0,21780,82793,0,104573
143040203000000,SW 405,Residential,23187,0,23187,62342,0,85529
143040203100000,SW 405,Residential,21466,0,21466,88673,0,110139
143040300100000,SW 405,Residential,20570,0,20570,70833,0,91403
143040300200000,SW 405,Residential,20736,0,20736,76948,0,97684
143040300300000,SW 405,Residential,21056,0,21056,84908,0,105964
143040300400000,SW 405,Residential,20743,0,20743,83336,0,104079
143040300500000,SW 405,Residential,21120,0,21120,71356,0,92476
143040300600000,SW 405,Residential,20825,0,20825,69033,0,89858
143040300700000,SW 405,Residential,20088,0,20088,71326,0,91414
143040300800000,SW 405,Residential,21050,0,21050,74391,0,95441
143040300900000,SW 405,Residential,20930,0,20930,71557,0,92487
143040301000000,SW 405,Residential,20330,0,20330,74192,0,94522
143040301100000,SW 405,Residential,20423,0,20423,87224,0,107647
143040301200000,SW 405,Residential,20564,0,20564,77932,0,98496
143040301300000,SW 405,Residential,20000,0,20000,75915,0,95915
143040301400000,SW 405,Residential,21216,0,21216,87076,0,108292
143040400100000,SW 405,Residential,22220,0,22220,82100,0,104320
143040400200000,SW 405,Residential,22220,0,22220,70829,0,93049
143040400300000,SW 405,Residential,22220,0,22220,74737,0,96957
143040400400000,SW 405,Residential,22220,0,22220,115335,0,137555
143040400500000,SW 405,Residential,22220,0,22220,74214,0,96434
143040400600000,SW 405,Residential,22220,0,22220,75970,0,98190
143040400700000,SW 405,Residential,22220,0,22220,79477,0,101697
143040400800000,SW 405,Residential,22220,0,22220,64485,0,86705
143040400900000,SW 405,Residential,22904,0,22904,87525,0,110429
143040401000000,SW 405,Residential,22395,0,22395,102120,0,124515
143040401100000,SW 405,Residential,21937,0,21937,96022,0,117959
143040401200000,SW 405,Residential,22097,0,22097,58350,0,80447
143040401300000,SW 405,Residential,22800,0,22800,108613,0,131413
143040401400000,SW 405,Residential,22410,0,22410,81036,0,103446
143040401500000,SW 405,Residential,23100,0,23100,77103,0,100203
143040401600000,SW 405,Residential,21651,0,21651,109687,0,131338
143040401700000,SW 405,Residential,20680,0,20680,73622,0,94302
143040401800000,SW 405,Residential,21173,0,21173,80135,0,101308
143040401900000,SW 405,Residential,22220,0,22220,122840,0,145060
143040402000000,SW 405,Residential,22220,0,22220,92952,0,115172
143040402100000,SW 405,Residential,22220,0,22220,123862,0,146082
143040402200000,SW 405,Residential,22220,0,22220,83488,0,105708
143040402300000,SW 405,Residential,22220,0,22220,111803,0,134023
143040402400000,SW 405,Residential,22220,0,22220,81126,0,103346
143040402500000,SW 405,Residential,22220,0,22220,102306,0,124526
143040402600000,SW 405,Residential,22220,0,22220,96413,0,118633
143040402700000,SW 405,Residential,22220,0,22220,99213,0,121433
143040402800000,SW 405,Residential,21001,0,21001,91391,0,112392
143040500100000,SW 405,Residential,23971,0,23971,86701,0,110672
143040500200000,SW 405,Residential,23236,0,23236,68469,0,91705
143040500300000,SW 405,Residential,21077,0,21077,58933,0,80010
143040500400000,SW 405,Residential,23520,0,23520,66063,0,89583
143040500500000,SW 405,Residential,21168,0,21168,67682,0,88850
143040500600000,SW 405,Residential,23520,0,23520,68412,0,91932
143040500700000,SW 405,Residential,23520,0,23520,76793,0,100313
143040500800000,SW 405,Residential,23128,0,23128,83544,0,106672
143040500900000,SW 405,Residential,23128,0,23128,85259,0,108387
143040501000000,SW 405,Residential,23128,0,23128,78351,0,101479
143040501100000,SW 405,Residential,21747,0,21747,64447,0,86194
143040501200000,SW 405,Residential,21747,0,21747,68488,0,90235
143040501300000,SW 405,Residential,21747,0,21747,73717,0,95464
143040501400000,SW 405,Residential,21747,0,21747,75202,0,96949
143040501500000,SW 405,Residential,21747,0,21747,74818,0,96565
143040501600000,SW 405,Residential,22116,0,22116,70994,0,93110
143040501700000,SW 405,Residential,21340,0,21340,84775,0,106115
143040501800000,SW 405,Residential,21340,0,21340,98085,0,119425
143040501900000,SW 405,Residential,21340,0,21340,74003,0,95343
143040502000000,SW 405,Residential,21340,0,21340,84904,0,106244
143040502100000,SW 405,Residential,21340,0,21340,81891,0,103231
143040502200000,SW 405,Residential,21340,0,21340,77838,0,99178
143040600100000,CITY PROPERTY,Exempt,0,0,0,0,0,0
143040700100000,SW 405,Residential,21030,0,21030,74191,0,95221
143040700200000,SW 405,Residential,21340,0,21340,84668,0,106008
143040700300000,SW 405,Residential,21340,0,21340,103024,0,124364
143040700400000,SW 405,Residential,21340,0,21340,91869,0,113209
143040700500000,SW 405,Residential,21340,0,21340,84343,0,105683
143040700600000,SW 405,Residential,21340,0,21340,121282,0,142622
143040700700000,SW 405,Residential,21340,0,21340,82624,0,103964
143040700800000,SW 405,Residential,21340,0,21340,107582,0,128922
143040700900000,SW 405,Residential,21340,0,21340,110550,0,131890
143040701000000,SW 405,Residential,19400,0,19400,76048,0,95448
143040701100000,SW 405,Residential,20952,0,20952,76169,0,97121
143040701200000,SW 405,Residential,21340,0,21340,110141,0,131481
143040701300000,SW 405,Residential,20952,0,20952,94398,0,115350
143040701400000,SW 405,Residential,21600,0,21600,124608,0,146208
143040701500000,SW 405,Residential,20952,0,20952,115252,0,136204
143040701600000,SW 405,Residential,20777,0,20777,74915,0,95692
143040701700000,SW 405,Residential,23285,0,23285,82230,0,105515
143040701800000,SW 405,Residential,24064,0,24064,72691,0,96755
143040701900000,SW 405,Residential,24480,0,24480,81812,0,106292
143040702000000,SW 405,Residential,26960,0,26960,69300,0,96260
143042600100000,SW 405,Residential,22504,0,22504,91972,0,114476
143042600200000,SW 405,Residential,24000,0,24000,72584,0,96584
143042600300000,SW 405,Residential,24700,0,24700,80243,0,104943
143042600400000,SW 405,Residential,24700,0,24700,102129,0,126829
143042600500000,SW 405,Residential,24700,0,24700,81050,0,105750
143042600600000,SW 405,Residential,24700,0,24700,69276,0,93976
143042600700000,SW 405,Residential,24700,0,24700,101501,0,126201
143042600800000,SW 405,Exempt,0,24700,24700,0,116928,141628
143042600900000,SW 405,Residential,20900,0,20900,68553,0,89453
143042601000000,SW 405,Residential,20900,0,20900,70876,0,91776
143042601100000,SW 405,Residential,21600,0,21600,77331,0,98931
143042601200000,SW 405,Residential,21600,0,21600,67985,0,89585
143042601300000,SW 405,Residential,21600,0,21600,66027,0,87627
143042601400000,SW 405,Residential,22400,0,22400,111025,0,133425
143042601500000,SW 405,Residential,21600,0,21600,89189,0,110789
143042601600000,SW 405,Residential,21600,0,21600,94449,0,116049
143042601700000,SW 405,Residential,22504,0,22504,81109,0,103613
143042601800000,SW 405,Residential,22504,0,22504,119515,0,142019
143042601900000,SW 405,Residential,22504,0,22504,78701,0,101205
143042602000000,SW 405,Residential,22504,0,22504,100852,0,123356
143042700100000,SW 405,Residential,25581,0,25581,110798,0,136379
143042700200000,SW 405,Residential,21632,0,21632,60172,0,81804
143042700300000,SW 405,Residential,21888,0,21888,71592,0,93480
143042700400000,SW 405,Residential,23040,0,23040,81958,0,104998
143042700500000,SW 405,Residential,23040,0,23040,126481,0,149521
143042700600000,SW 405,Residential,27648,0,27648,97072,0,124720
143042700700000,SW 405,Residential,23040,0,23040,87990,0,111030
143042700800000,SW 405,Residential,23040,0,23040,39400,0,62440
143042700900000,SW 405,Residential,23040,0,23040,69970,0,93010
143042701000000,SW 405,Residential,22948,0,22948,19299,0,42247
143042701100000,SW 405,Residential,22760,0,22760,90982,0,113742
143042701200000,SW 405,Residential,20469,0,20469,56133,0,76602
143042701300000,SW 405,Residential,20634,0,20634,61926,0,82560
143042701400000,SW 405,Residential,19400,0,19400,56535,0,75935
143042701500000,SW 405,Residential,22080,0,22080,55124,0,77204
143042701600000,SW 405,Residential,24000,0,24000,62840,0,86840
143042701700000,SW 405,Residential,21307,0,21307,78701,0,100008
143042701800000,SW 405,Residential,20627,0,20627,58935,0,79562
143042701900000,SW 405,Residential,21840,0,21840,57213,0,79053
143042702000000,SW 405,Residential,21840,0,21840,59163,0,81003
143042702100000,SW 405,Residential,21840,0,21840,63603,0,85443
143042702200000,SW 405,Residential,21840,0,21840,57025,0,78865
143042702300000,SW 405,Residential,22338,0,22338,62164,0,84502
143042702400000,SW 405,Residential,22528,0,22528,48438,0,70966
143042800100000,NW 333,Residential,45700,0,45700,66541,0,112241
143042800200000,NW 333,Residential,43680,0,43680,128693,0,172373
143042900100000,SW 405,Residential,23280,0,23280,83283,0,106563
143042900200000,SW 405,Residential,19400,0,19400,58560,0,77960
143042900300000,SW 405,Residential,19400,0,19400,58120,0,77520
143042900400000,SW 405,Residential,19400,0,19400,61259,0,80659
143042900500000,SW 405,Residential,19400,0,19400,69032,0,88432
143042900600000,SW 405,Residential,19400,0,19400,62065,0,81465
143042900700000,SW 405,Residential,19400,0,19400,55995,0,75395
143042900800000,SW 405,Residential,20952,0,20952,80244,0,101196
143042900900000,SW 405,Residential,20642,0,20642,62620,0,83262
143042901000000,SW 405,Residential,21107,0,21107,64791,0,85898
143042901100000,SW 405,Residential,21107,0,21107,47945,0,69052
143042901200000,SW 405,Residential,20176,0,20176,66718,0,86894
143042901300000,SW 405,Residential,20176,0,20176,73560,0,93736
143042901400000,SW 405,Residential,20176,0,20176,58875,0,79051
143042901500000,SW 405,Residential,20176,0,20176,53586,0,73762
143042901600000,SW 405,Residential,20176,0,20176,56519,0,76695
143042901700000,SW 405,Residential,20176,0,20176,51188,0,71364
143042901800000,SW 405,Residential,20176,0,20176,84199,0,104375
143042901900000,SW 405,Residential,20176,0,20176,59889,0,80065
143042902000000,SW 405,Residential,23280,0,23280,65532,0,88812
143042902100000,SW 405,Residential,23280,0,23280,74870,0,98150
143042902200000,SW 405,Residential,23280,0,23280,52986,0,76266
143043000100000,SW 405,Residential,23923,0,23923,61227,0,85150
143043000200000,SW 405,Residential,23773,0,23773,64412,0,88185
143043000300000,SW 405,Residential,24435,0,24435,67362,0,91797
143043000400000,SW 405,Residential,23571,0,23571,51472,0,75043
143043000500000,SW 405,Residential,24206,0,24206,61426,0,85632
143043000600000,SW 405,Residential,23443,0,23443,69995,0,93438
143043000700000,SW 405,Residential,24012,0,24012,62783,0,86795
143043000800000,SW 405,Residential,21808,0,21808,57989,0,79797
143043000900000,SW 405,Residential,24480,0,24480,68783,0,93263
143043001000000,SW 405,Residential,23856,0,23856,56371,0,80227
143043100100000,SW 405,Residential,22050,0,22050,83159,0,105209
143043100200000,SW 405,Residential,23332,0,23332,105590,0,128922
143043100300000,SW 405,Residential,23392,0,23392,58737,0,82129
143043100400000,SW 405,Residential,22385,0,22385,66463,0,88848
143043100500000,SW 405,Residential,24119,0,24119,63000,0,87119
143043100600000,SW 405,Residential,23561,0,23561,55663,0,79224
143043100700000,SW 405,Residential,23563,0,23563,69755,0,93318
143043100800000,SW 405,Residential,23640,0,23640,54699,0,78339
143043100900000,SW 405,Residential,23389,0,23389,79287,0,102676
143043101000000,SW 405,Residential,20693,0,20693,50540,0,71233
143043101100000,SW 405,Residential,24240,0,24240,95062,0,119302
143043101200000,SW 405,Residential,25640,0,25640,89500,0,115140
143043101300000,SW 405,Residential,25060,0,25060,104513,0,129573
143043101400000,SW 405,Residential,24966,0,24966,159018,0,183984
143043101500000,SW 405,Residential,24000,0,24000,71114,0,95114
143043101600000,SW 405,Residential,24000,0,24000,116897,0,140897
143043101700000,SW 405,Residential,24000,0,24000,85575,0,109575
143043101800000,SW 405,Residential,24000,0,24000,71450,0,95450
143043101900000,SW 405,Residential,24000,0,24000,101575,0,125575
143043102000000,SW 405,Residential,24750,0,24750,105096,0,129846
143043102100000,SW 405,Residential,25899,0,25899,75478,0,101377
143043200100000,SW 405,Residential,22320,0,22320,61608,0,83928
143043200200000,SW 405,Residential,23392,0,23392,58409,0,81801
143043200300000,SW 405,Residential,23941,0,23941,59373,0,83314
143043200400000,SW 405,Residential,25480,0,25480,78062,0,103542
143043200500000,SW 405,Residential,26118,0,26118,64491,0,90609
143043200600000,SW 405,Residential,22898,0,22898,58602,0,81500
143043300100000,SW 405,Residential,20840,0,20840,77911,0,98751
143043300200000,SW 405,Residential,20600,0,20600,64369,0,84969
143043300300000,SW 405,Residential,20600,0,20600,61117,0,81717
143043300400000,SW 405,Residential,20600,0,20600,58150,0,78750
143043300500000,SW 405,Residential,20600,0,20600,68460,0,89060
143043300600000,SW 405,Residential,20600,0,20600,53320,0,73920
143043300700000,SW 405,Residential,20600,0,20600,61784,0,82384
143043300800000,SW 405,Residential,20600,0,20600,57479,0,78079
143043300900000,SW 405,Residential,20600,0,20600,59746,0,80346
143043301000000,SW 405,Residential,20600,0,20600,71922,0,92522
143043301100000,SW 405,Residential,20600,0,20600,63381,0,83981
143043301200000,SW 405,Residential,20600,0,20600,74126,0,94726
143043301300000,SW 405,Residential,20689,0,20689,62847,0,83536
143043301400000,SW 405,Residential,21006,0,21006,61989,0,82995
143043301500000,SW 405,Residential,20000,0,20000,60047,0,80047
143043301600000,SW 405,Residential,20000,0,20000,52357,0,72357
143043301700000,SW 405,Residential,20000,0,20000,56779,0,76779
143043301800000,SW 405,Residential,20000,0,20000,57469,0,77469
143043301900000,SW 405,Residential,20000,0,20000,57784,0,77784
143043302000000,SW 405,Residential,20000,0,20000,72310,0,92310
143043302100000,SW 405,Residential,20000,0,20000,56801,0,76801
143043302200000,SW 405,Residential,20000,0,20000,51499,0,71499
143043302300000,SW 405,Residential,20000,0,20000,55732,0,75732
143043302400000,SW 405,Residential,20000,0,20000,69625,0,89625
143043302500000,SW 405,Residential,20000,0,20000,60370,0,80370
143043302600000,SW 405,Residential,19773,0,19773,63449,0,83222
143043400100000,SW 405,Residential,23128,0,23128,68250,0,91378
143043400200000,SW 405,Residential,23128,0,23128,68149,0,91277
143043400300000,SW 405,Residential,20900,0,20900,67451,0,88351
143043400400000,SW 405,Residential,20900,0,20900,70473,0,91373
143043400500000,SW 405,Residential,26173,0,26173,78906,0,105079
143043400600000,SW 405,Residential,24989,0,24989,101688,0,126677
143043500100000,SW 405,Residential,19607,0,19607,55923,0,75530
143043500200000,SW 405,Residential,19400,0,19400,61143,0,80543
143043500300000,SW 405,Residential,19400,0,19400,60045,0,79445
143043500400000,SW 405,Residential,19400,0,19400,71982,0,91382
143043500500000,SW 405,Residential,19400,0,19400,69765,0,89165
143043500600000,SW 405,Residential,19400,0,19400,62771,0,82171
143043500700000,SW 405,Residential,19400,0,19400,69875,0,89275
143043500800000,SW 405,Residential,19400,0,19400,59125,0,78525
143043500900000,SW 405,Residential,19400,0,19400,64922,0,84322
143043501000000,SW 405,Residential,19400,0,19400,64086,0,83486
143043501100000,SW 405,Residential,19400,0,19400,65146,0,84546
143043501200000,SW 405,Residential,19400,0,19400,63260,0,82660
143043501300000,SW 405,Residential,20644,0,20644,71758,0,92402
143043501400000,SW 427,Residential,28365,0,28365,106510,0,134875
143043501500000,SW 427,Residential,28401,0,28401,139212,0,167613
143043501600000,SW 427,Residential,33936,0,33936,164668,0,198604
143043501700000,SW 427,Residential,28863,0,28863,139378,0,168241
143043501800000,SW 405,Residential,24240,0,24240,68844,0,93084
143043501900000,SW 405,Residential,24240,0,24240,83803,0,108043
143043502000000,SW 405,Residential,24240,0,24240,81695,0,105935
143043502100000,SW 405,Residential,24240,0,24240,74594,0,98834
143043502200000,SW 405,Residential,24240,0,24240,95202,0,119442
143045100100000,SW 405,Residential,24000,0,24000,63391,0,87391
143045200100000,SW 405,Residential,26384,0,26384,104554,0,130938
143045200200000,SW 405,Residential,25797,0,25797,90951,0,116748
143045200300000,SW 405,Residential,23520,0,23520,74926,0,98446
143045200400000,SW 405,Residential,23520,0,23520,86301,0,109821
143045200500000,SW 405,Residential,23520,0,23520,95010,0,118530
143045200600000,SW 405,Residential,23520,0,23520,83668,0,107188
143045200700000,SW 405,Residential,23520,0,23520,87636,0,111156
143045200800000,SW 405,Residential,26251,0,26251,106075,0,132326
143045200900000,SW 406,Residential,30888,0,30888,244432,0,275320
143045201000000,SW 406,Residential,57150,0,57150,119661,0,176811
143045201100000,WAREHOUSE;MINI STORG,Commercial,0,45923,45923,0,35588,81511
143045201200000,SERVICE STATION,Commercial,0,88243,88243,0,47784,136027
143045201300000,FLAT PARKING,Commercial,0,631260,631260,0,0,631260
143045201400000,SHOP,Commercial,0,177444,177444,0,474542,651986
143045201500000,SW 405,Residential,25930,0,25930,87937,0,113867
143045201600000,SW 405,Residential,25252,0,25252,69334,0,94586
143045201700000,SW 405,Residential,24888,0,24888,136174,0,161062
143045201800000,SW 405,Residential,25488,0,25488,89307,0,114795
143045201900000,SW 405,Residential,23976,0,23976,74494,0,98470
143045202000000,SW 405,Residential,24720,0,24720,79473,0,104193
143045202100000,SW 405,Residential,24480,0,24480,73703,0,98183
143045202200000,SW 405,Residential,24480,0,24480,91858,0,116338
143045202300000,SW 405,Residential,24480,0,24480,76728,0,101208
143045202400000,SW 405,Residential,24480,0,24480,76628,0,101108
143045202500000,CITY PROPERTY,Exempt,0,0,0,0,0,0
143045202600000,CITY PROPERTY,Exempt,0,0,0,0,0,0
143045202700000,SW 405,Residential,26048,0,26048,75451,0,101499
143045202800000,SW 405,Residential,25379,0,25379,83175,0,108554
143045202900000,SW 405,Residential,25608,0,25608,77194,0,102802
143045203000000,SW 405,Residential,24768,0,24768,106958,0,131726
143045203100000,SW 405,Residential,24593,0,24593,83992,0,108585
143045203200000,SW 405,Residential,24315,0,24315,83211,0,107526
143045203300000,SW 405,Residential,23280,0,23280,79456,0,102736
143045203400000,SW 405,Residential,23280,0,23280,69006,0,92286
143045203500000,SW 405,Residential,23280,0,23280,86433,0,109713
143045203600000,SW 405,Residential,23280,0,23280,78539,0,101819
143045203700000,SW 405,Exempt,0,23280,23280,0,74183,97463
143045203800000,SW 405,Residential,23280,0,23280,67286,0,90566
143045203900000,SW 405,Residential,20952,0,20952,87461,0,108413
143045300100000,SW 406,Residential,23956,0,23956,71689,0,95645
143045300200000,SW 406,Residential,28294,0,28294,81702,0,109996
143045300300000,SW 406,Residential,28350,0,28350,78788,0,107138
143045300400000,SW 406,Residential,28350,0,28350,119090,0,147440
143045300500000,SW 406,Residential,28350,0,28350,85074,0,113424
143045300700000,SW 427,Residential,27824,0,27824,112970,0,140794
143045300800000,SW 427,Residential,27824,0,27824,108877,0,136701
143045300900000,SW 427,Residential,25994,0,25994,119220,0,145214
143045301000000,SW 427,Residential,29057,0,29057,133460,0,162517
143045301100000,SW 406,Residential,35519,0,35519,105154,0,140673
143045301200000,SW 427,Residential,28000,0,28000,118505,0,146505
143045301300000,SW 427,Residential,27160,0,27160,135981,0,163141
143045301500000,SW 406,Residential,21952,0,21952,89865,0,111817
143045301600000,SW 406,Residential,23669,0,23669,124894,0,148563
143045301700000,SW 406,Residential,26733,0,26733,106546,0,133279
143045301800000,SW 406,Residential,23192,0,23192,111864,0,135056
143045301900000,SW 406,Residential,3555,0,3555,0,0,3555
143045302000000,SW 406,Residential,29484,0,29484,706,0,30190
143045400100000,SW 427,Residential,29100,0,29100,107806,0,136906
143045400200000,SW 427,Residential,28984,0,28984,112712,0,141696
143045400300000,SW 427,Residential,28168,0,28168,128974,0,157142
143045500100000,SW 405,Residential,24066,0,24066,68741,0,92807
143045500200000,SW 405,Residential,24133,0,24133,66097,0,90230
143045500300000,SW 405,Residential,24133,0,24133,68828,0,92961
143045500400000,SW 405,Residential,24133,0,24133,75073,0,99206
143045500500000,SW 405,Residential,24667,0,24667,85037,0,109704
143045500600000,SW 405,Residential,24000,0,24000,87861,0,111861
143045500700000,SW 405,Residential,24000,0,24000,93414,0,117414
143045600800000,SW 405,Residential,26558,0,26558,107512,0,134070
143045600900000,SW 405,Residential,23985,0,23985,91779,0,115764
143045601000000,SW 405,Residential,24433,0,24433,87137,0,111570
143045601100000,SW 405,Residential,26228,0,26228,101501,0,127729
143045601200000,SW 405,Residential,24480,0,24480,101691,0,126171
143045601300000,SW 405,Residential,24240,0,24240,96540,0,120780
143045601400000,SW 405,Residential,24240,0,24240,96565,0,120805
143045601500000,SW 405,Residential,24240,0,24240,75128,0,99368
143045601600000,SW 405,Residential,24240,0,24240,84922,0,109162
143045601700000,SW 405,Residential,24240,0,24240,76785,0,101025
143045601800000,SW 405,Residential,24240,0,24240,102057,0,126297
143045601900000,SW 405,Residential,24240,0,24240,85907,0,110147
143045602000000,SW 405,Residential,23971,0,23971,95879,0,119850
143045602100000,SW 405,Residential,23760,0,23760,87108,0,110868
143045602200000,SW 405,Residential,23760,0,23760,90954,0,114714
143045602300000,SW 405,Residential,23760,0,23760,102464,0,126224
143045602400000,SW 405,Residential,23760,0,23760,91687,0,115447
143045602500000,SW 405,Residential,23760,0,23760,89131,0,112891
143045602600000,SW 405,Residential,24796,0,24796,91445,0,116241
143045602700000,SW 405,Residential,24472,0,24472,114747,0,139219
143045700100000,VACANT LAND,Commercial,0,11761,11761,0,0,11761
143047600100000,SCHOOL,Exempt,0,0,0,0,0,0
143047600200000,CONVERSION,Commercial,0,9309,9309,0,96143,105452
143047600300000,SW 405,Residential,25200,0,25200,77238,0,102438
143047600400000,SW 405,Residential,24000,0,24000,103103,0,127103
143047600500000,SW 405,Residential,24000,0,24000,87259,0,111259
143047600600000,SW 405,Residential,24000,0,24000,79636,0,103636
143047600700000,SW 405,Residential,24000,0,24000,110140,0,134140
143047600800000,SW 405,Residential,24320,0,24320,93310,0,117630
143047600900000,SW 405,Residential,24320,0,24320,98899,0,123219
143047601000000,SW 405,Residential,24320,0,24320,95507,0,119827
143047601100000,SW 405,Residential,24320,0,24320,83023,0,107343
143047601200000,SW 405,Residential,24320,0,24320,78229,0,102549
143047601300000,SW 405,Residential,24092,0,24092,68183,0,92275
143047700100000,SW 405,Residential,25946,0,25946,59577,0,85523
143047700200000,SW 405,Residential,24480,0,24480,76255,0,100735
143047700300000,SW 405,Residential,24192,0,24192,73267,0,97459
143047700400000,SW 405,Residential,23760,0,23760,83330,0,107090
143047700500000,SW 405,Residential,23760,0,23760,71504,0,95264
143047700600000,SW 405,Residential,23760,0,23760,87680,0,111440
143047700700000,SW 405,Residential,24644,0,24644,120735,0,145379
143047700800000,SW 405,Residential,25687,0,25687,95038,0,120725
143047700900000,SW 405,Residential,25200,0,25200,97752,0,122952
143047800100000,SW 405,Residential,24738,0,24738,87075,0,111813
143047800200000,SW 405,Residential,24316,0,24316,85528,0,109844
143047800300000,SW 405,Residential,23320,0,23320,76733,0,100053
143047800400000,SW 405,Residential,24953,0,24953,111688,0,136641
143047800500000,SW 405,Residential,24644,0,24644,77593,0,102237
143047800600000,SW 405,Residential,23760,0,23760,76885,0,100645
143047800700000,SW 405,Residential,24817,0,24817,88883,0,113700
143047800800000,SW 405,Residential,24854,0,24854,69135,0,93989
143110100100000,WAREHOUSE,Commercial,0,120150,120150,0,233596,353746
143110100200000,CENTRALLY ASSESSED,Other,0,0,0,0,0,0
143110100300000,WAREHOUSE,Commercial,0,160650,160650,0,91845,252495
143110100400000,OFFICE,Commercial,0,216000,216000,0,320829,536829
143110100500000,SHOP,Commercial,0,291384,291384,0,139512,430896
143110200100000,FLAT PARKING,Commercial,0,90936,90936,0,27600,118536
143110200200000,LG DISCOUNT/RETAIL,Commercial,0,232200,232200,0,339418,571618
143110300100000,SHOP,Commercial,0,160650,160650,0,110917,271567
143110300200000,VETERINARY CLINIC,Commercial,0,84240,84240,0,298548,382788
143110300300000,OFFICE,Commercial,0,48600,48600,0,144890,193490
143110300400000,FRATERNAL,Commercial,0,48600,48600,0,70224,118824
143110300402000,BILLBOARD(BLL),Commercial,0,0,0,0,10943,10943
143110300500000,WAREHOUSE,Commercial,0,130140,130140,0,317068,447208
143110300600000,SHOP,Commercial,0,71280,71280,0,115457,186737
143110300700000,FLAT PARKING,Commercial,0,24840,24840,0,0,24840
143110300800000,AUTO REPAIR/SALES,Commercial,0,139050,139050,0,430614,569664
143110300900000,RESTAURANT,Commercial,0,108270,108270,0,129430,237700
143110301000000,SMALL RETAIL,Commercial,0,31943,31943,0,208676,240619
143110301100000,AUTO REPAIR/SALES,Commercial,0,130140,130140,0,229697,359837
143110301600000,SW 420,Residential,555250,0,555250,0,0,555250
143110301700000,FLAT PARKING,Commercial,0,186300,186300,0,65792,252092
143110301702000,BILLBOARD(BLL),Commercial,0,0,0,0,22146,22146
143112600100000,WAREHOUSE,Commercial,0,167400,167400,0,442999,610399
143112600200000,AUTO REPAIR/SALES,Commercial,0,86805,86805,0,90290,177095
143112600300000,RESTAURANT,Commercial,0,89100,89100,0,94735,183835
143112600400000,RESTAURANT,Commercial,0,79966,79966,0,149714,229680
143112601000000,VETERINARY CLINIC,Commercial,0,193050,193050,0,0,193050
143112601100000,OFFICE,Commercial,0,295488,295488,0,367262,662750
143112700100000,AUTO REPAIR/SALES,Commercial,0,81810,81810,0,181088,262898
143112700200000,RESTAURANT,Commercial,0,121905,121905,0,157886,279791
143112700300000,SMALL RETAIL,Commercial,0,162675,162675,0,432800,595475
143112700400000,SW 420,Residential,36878,0,36878,0,0,36878
143112700500000,SW 420,Residential,41200,0,41200,142337,0,183537
143112700600000,SW 420,Residential,41600,0,41600,142337,0,183937
143112700700000,SW 420,Residential,40109,0,40109,146063,0,186172
143112700800000,SW 420,Residential,39576,0,39576,135907,0,175483
143112700900000,SW 420,Residential,33950,0,33950,135312,0,169262
143112800100000,CHURCH,Commercial,0,139455,139455,0,227454,366909
143112800200000,SHOP,Commercial,0,209250,209250,0,284789,494039
143112800300000,OFFICE,Commercial,0,247050,247050,0,222417,469467
143112800400000,AUTO REPAIR/SALES,Commercial,0,259200,259200,0,208387,467587
143112800402000,BILLBOARD(BLL),Commercial,0,0,0,0,24639,24639
143112800500000,WAREHOUSE,Commercial,0,127526,127526,0,120808,248334
143112800600000,SW 420,Residential,39442,0,39442,148179,0,187621
143112800700000,SW 420,Residential,39200,0,39200,142865,0,182065
143112800800000,SW 420,Residential,39200,0,39200,140358,0,179558
143112800900000,SW 420,Residential,38634,0,38634,126142,0,164776
143112801000000,SW 420,Residential,41233,0,41233,137654,0,178887
143112801100000,SW 420,Residential,40853,0,40853,0,0,40853
143112801200000,SW 420,Residential,41990,0,41990,0,0,41990
143112801300000,SW 420,Residential,39024,0,39024,135312,0,174336
143112801400000,SW 420,Residential,36734,0,36734,135312,0,172046
143112801500000,SW 420,Residential,36734,0,36734,142997,0,179731
143112801600000,SW 420,Residential,36734,0,36734,138739,0,175473
143112801900000,SW 420,Residential,27775,0,27775,35912,0,63687
143112802000000,SW 420,Residential,27775,0,27775,83419,0,111194
143112802100000,SW 420,Residential,27775,0,27775,115157,0,142932
143112802200000,SW 420,Residential,27775,0,27775,98985,0,126760
143112802300000,SW 420,Residential,27775,0,27775,128165,0,155940
143112802400000,SW 420,Residential,29925,0,29925,112836,0,142761
143112802500000,SW 420,Residential,41344,0,41344,114679,0,156023
143112802600000,SW 420,Residential,46469,0,46469,9979,0,56448
143112802700000,SW 420,Residential,38819,0,38819,42024,0,80843
143112802800000,SW 420,Residential,30240,0,30240,9979,0,40219
143112802900000,SW 420,Residential,27775,0,27775,102545,0,130320
143112803000000,SW 420,Residential,27775,0,27775,97776,0,125551
143112803100000,SW 420,Residential,27775,0,27775,96234,0,124009
143112803200000,SW 420,Residential,27775,0,27775,84205,0,111980
143112803300000,SW 420,Residential,27775,0,27775,84205,0,111980
143112900100000,SW 420,Residential,37461,0,37461,139502,0,176963
143112900200000,SW 420,Residential,37875,0,37875,135312,0,173187
143112900300000,SW 420,Residential,41814,0,41814,135312,0,177126
143112900400000,SW 420,Residential,41328,0,41328,135312,0,176640
143112900500000,SW 420,Residential,40698,0,40698,137654,0,178352
143112900600000,SW 420,Residential,39860,0,39860,137654,0,177514
143115100400000,SW 420,Residential,25440,0,25440,107361,0,132801
143115100500000,SW 420,Residential,25440,0,25440,77548,0,102988
143115100600000,SW 420,Residential,25440,0,25440,118506,0,143946
143115100700000,SW 420,Residential,25440,0,25440,107647,0,133087
143115100800000,SW 420,Residential,25440,0,25440,117376,0,142816
143115100900000,SW 420,Residential,25440,0,25440,86879,0,112319
143115101000000,SW 420,Residential,25160,0,25160,63299,0,88459
143115101100000,SW 420,Residential,29507,0,29507,101030,0,130537
143115101200000,SW 420,Residential,25735,0,25735,64577,0,90312
143115101300000,SW 420,Residential,40163,0,40163,94794,0,134957
143115101400000,SW 420,Residential,40163,0,40163,104451,0,144614
143115101500000,SW 420,Residential,40163,0,40163,165276,0,205439
143115101600000,SW 420,Residential,42350,0,42350,3351,0,45701
143115101800000,SW 420,Residential,48332,0,48332,244639,0,292971
143115101900000,SW 420,Residential,44449,0,44449,224650,0,269099
143115102000000,SW 420,Residential,42101,0,42101,0,0,42101
143115102200000,SW 420,Residential,65401,0,65401,310522,0,375923
143115102300000,SW 420,Residential,46186,0,46186,185522,0,231708
143115102400000,SW 420,Residential,45000,0,45000,204583,0,249583
143115102500000,SW 420,Residential,45000,0,45000,216306,0,261306
143115102600000,SW 420,Residential,45000,0,45000,168954,0,213954
143115102700000,SW 420,Residential,40000,0,40000,209432,0,249432
143115102800000,SW 420,Residential,39125,0,39125,166380,0,205505
143115200200000,SW 420,Residential,31000,0,31000,131058,0,162058
143115200300000,SW 420,Residential,30110,0,30110,140578,0,170688
143115200400000,SW 420,Residential,30600,0,30600,120926,0,151526
143115200500000,SW 420,Residential,30600,0,30600,133425,0,164025
143115200600000,SW 420,Residential,30600,0,30600,95816,0,126416
143115200700000,SW 420,Residential,30600,0,30600,98976,0,129576
143115200800000,SW 420,Residential,30600,0,30600,106308,0,136908
143115200900000,SW 420,Residential,30600,0,30600,112279,0,142879
143115201000000,SW 420,Residential,30600,0,30600,165620,0,196220
143115201100000,SW 420,Residential,32640,0,32640,128775,0,161415
143115201200000,SW 420,Residential,43369,0,43369,184595,0,227964
143115201300000,SW 420,Residential,40800,0,40800,0,0,40800
143115201400000,SW 420,Residential,40800,0,40800,176593,0,217393
143115201500000,SW 420,Residential,45818,0,45818,197727,0,243545
143115201600000,SW 420,Residential,54810,0,54810,222947,0,277757
143115201700000,SW 420,Residential,45450,0,45450,269059,0,314509
143115201800000,SW 420,Residential,45450,0,45450,188741,0,234191
143115201900000,SW 420,Residential,45584,0,45584,212108,0,257692
143115202000000,SW 420,Residential,30300,0,30300,148981,0,179281
143115202100000,SW 420,Residential,30300,0,30300,144538,0,174838
143115202200000,SW 420,Residential,30300,0,30300,167863,0,198163
143115202300000,SW 420,Residential,30300,0,30300,143463,0,173763
143115202400000,SW 420,Residential,30300,0,30300,181587,0,211887
143115202500000,SW 420,Residential,30300,0,30300,142122,0,172422
143115202600000,SW 420,Residential,30300,0,30300,152293,0,182593
143115202700000,SW 420,Residential,30300,0,30300,158876,0,189176
143115202800000,SW 420,Residential,32825,0,32825,176799,0,209624
143115202900000,CITY PROPERTY,Exempt,0,0,0,0,0,0
143115203000000,SW 420,Residential,32825,0,32825,190147,0,222972
143115203100000,SW 420,Residential,32825,0,32825,189218,0,222043
143115203200000,SW 420,Residential,32825,0,32825,183151,0,215976
143115203300000,SW 420,Residential,32148,0,32148,153724,0,185872
143115203400000,SW 420,Residential,30300,0,30300,189408,0,219708
143115203500000,SW 420,Residential,30300,0,30300,158255,0,188555
143115203600000,SW 420,Residential,30300,0,30300,139331,0,169631
143115203700000,SW 420,Residential,30300,0,30300,139943,0,170243
143115203800000,SW 420,Residential,35628,0,35628,135706,0,171334
143115203900000,SW 420,Residential,35628,0,35628,190788,0,226416
143115204000000,SW 420,Residential,32825,0,32825,146307,0,179132
143115204100000,SW 420,Residential,32825,0,32825,152774,0,185599
143115204200000,SW 420,Residential,32825,0,32825,145412,0,178237
143115204300000,SW 420,Residential,32825,0,32825,190558,0,223383
143115204500000,SW 420,Residential,39869,0,39869,0,0,39869
143115204700000,SW 420,Residential,5013,0,5013,0,0,5013
143115204800000,SW 420,Residential,30300,0,30300,70226,0,100526
143115204900000,SW 420,Residential,5014,0,5014,0,0,5014
143115205000000,SW 420,Residential,5015,0,5015,0,0,5015
143115205100000,SW 420,Residential,5017,0,5017,0,0,5017
143115205200000,SW 420,Residential,30300,0,30300,5322,0,35622
143115205300000,SW 420,Residential,5019,0,5019,0,0,5019
143115205400000,SW 420,Residential,5020,0,5020,0,0,5020
143115205500000,SW 420,Residential,5021,0,5021,0,0,5021
143115205600000,SW 420,Residential,30300,0,30300,148934,0,179234
143115205700000,SW 420,Residential,30300,0,30300,115394,0,145694
143115205800000,SW 420,Residential,11204,0,11204,0,0,11204
143115205900000,SW 420,Residential,6002,0,6002,0,0,6002
143115206000000,SW 420,Residential,4937,0,4937,0,0,4937
143115206100000,SW 420,Residential,30300,0,30300,5322,0,35622
143115206200000,SW 420,Residential,4937,0,4937,0,0,4937
143115206300000,SW 420,Residential,30300,0,30300,103950,0,134250
143115206400000,SW 420,Residential,30300,0,30300,5322,0,35622
143115206500000,SW 420,Residential,4937,0,4937,0,0,4937
143115206600000,SW 420,Residential,30300,0,30300,130517,0,160817
143115206700000,SW 420,Residential,30300,0,30300,5322,0,35622
143115206800000,SW 420,Residential,32825,0,32825,103209,0,136034
143115300900000,SW 420,Residential,45734,0,45734,243484,0,289218
143115400100000,SW 420,Residential,45004,0,45004,205055,0,250059
143115400200000,SW 420,Residential,42005,0,42005,185478,0,227483
143115400300000,SW 420,Residential,45004,0,45004,195494,0,240498
143115500100000,SW 420,Residential,34723,0,34723,148602,0,183325
143115500200000,SW 420,Residential,30048,0,30048,141763,0,171811
143115500300000,SW 420,Residential,32194,0,32194,172909,0,205103
143115500400000,SW 420,Residential,31013,0,31013,128731,0,159744
143115500500000,SW 420,Residential,31013,0,31013,162131,0,193144
143115500600000,SW 420,Residential,30048,0,30048,136981,0,167029
143115500700000,SW 420,Residential,30048,0,30048,184554,0,214602
143115500800000,SW 420,Residential,30048,0,30048,164998,0,195046
143115500900000,SW 420,Residential,30048,0,30048,165561,0,195609
143115501000000,SW 420,Residential,30048,0,30048,148058,0,178106
143115501100000,SW 420,Residential,29588,0,29588,174074,0,203662
143115600100000,SW 420,Residential,36304,0,36304,182674,0,218978
143115600200000,SW 420,Residential,36304,0,36304,174642,0,210946
143115600300000,SW 420,Residential,35779,0,35779,135907,0,171686
143115600400000,SW 420,Residential,27775,0,27775,113973,0,141748
143115700100000,SW 420,Residential,35350,0,35350,136842,0,172192
143115700200000,SW 420,Residential,27775,0,27775,35912,0,63687
143115800100000,SW 420,Residential,38134,0,38134,134114,0,172248
143115800200000,SW 420,Residential,35365,0,35365,136891,0,172256
143115800300000,SW 420,Residential,37617,0,37617,143456,0,181073
143117600200000,SW 420,Residential,25740,0,25740,83812,0,109552
143117600300000,SW 420,Residential,25740,0,25740,64620,0,90360
143117600400000,SW 420,Residential,23760,0,23760,78083,0,101843
143117600500000,SW 420,Residential,31680,0,31680,64169,0,95849
143117600600000,SW 420,Residential,25740,0,25740,107670,0,133410
143117600700000,SW 420,Residential,27720,0,27720,66025,0,93745
143117600800000,SW 420,Residential,25740,0,25740,89623,0,115363
143117600900000,SW 420,Residential,20244,0,20244,49806,0,70050
143117601000000,SW 420,Residential,37926,0,37926,81648,0,119574
143117601100000,SW 420,Residential,23175,0,23175,33290,0,56465
143117601300000,SW 420,Residential,32111,0,32111,0,0,32111
143117601400000,SW 420,Residential,32320,0,32320,200548,0,232868
143117601500000,SW 420,Residential,32320,0,32320,180429,0,212749
143117601600000,SW 420,Residential,32640,0,32640,185046,0,217686
143117601700000,SW 420,Residential,38520,0,38520,169927,0,208447
143117601800000,SW 420,Residential,31212,0,31212,158892,0,190104
143117601900000,SW 420,Residential,29478,0,29478,188024,0,217502
143117602000000,SW 420,Residential,29867,0,29867,250267,0,280134
143117602100000,SW 420,Residential,38078,0,38078,163413,0,201491
143117602300000,SW 420,Residential,1140,0,1140,0,0,1140
143117602400000,SW 420,Residential,36203,0,36203,243968,0,280171
143117602500000,SW 420,Residential,28701,0,28701,197172,0,225873
143117602600000,SW 420,Residential,28620,0,28620,168364,0,196984
143117602700000,SW 420,Residential,29440,0,29440,182079,0,211519
143117602800000,SW 420,Residential,29440,0,29440,167151,0,196591
143117602900000,SW 420,Residential,30400,0,30400,198870,0,229270
143117603000000,SW 420,Residential,32000,0,32000,167277,0,199277
143117603100000,SW 420,Residential,32320,0,32320,187936,0,220256
143117603200000,SW 420,Residential,32320,0,32320,201231,0,233551
143117603300000,SW 420,Residential,32331,0,32331,185503,0,217834
143117603400000,SW 420,Residential,30478,0,30478,157468,0,187946
143117603500000,SW 420,Residential,30906,0,30906,142430,0,173336
143117603600000,SW 420,Residential,30300,0,30300,85435,0,115735
143117603700000,SW 420,Residential,30300,0,30300,108163,0,138463
143117603800000,SW 420,Residential,30300,0,30300,110192,0,140492
143117603900000,SW 420,Residential,30704,0,30704,155129,0,185833
143117604000000,SW 420,Residential,31088,0,31088,110838,0,141926
143117604100000,SW 420,Residential,31108,0,31108,131199,0,162307
143117604200000,SW 420,Residential,31815,0,31815,159823,0,191638
143117604300000,SW 420,Residential,32623,0,32623,178165,0,210788
143117604400000,SW 420,Residential,30219,0,30219,150940,0,181159
143117604500000,SW 420,Residential,31270,0,31270,185960,0,217230
143117604600000,SW 420,Residential,31557,0,31557,155973,0,187530
143117604800000,CITY PROPERTY,Exempt,0,0,0,0,0,0
143117604900000,CITY PROPERTY,Exempt,0,0,0,0,0,0
143117605000000,CITY PROPERTY,Exempt,0,0,0,0,0,0
143117605100000,SW 420,Residential,25480,0,25480,152896,0,178376
143117605200000,SW 420,Residential,25480,0,25480,135331,0,160811
143117605300000,SW 420,Residential,25480,0,25480,154164,0,179644
143117605400000,SW 420,Residential,25480,0,25480,179714,0,205194
143117605600000,SW 420,Residential,58016,0,58016,222931,0,280947
143117605700000,CITY PROPERTY,Exempt,0,0,0,0,0,0
143117605800000,CITY PROPERTY,Exempt,0,0,0,0,0,0
143117605900000,SW 420,Residential,62400,0,62400,66663,0,129063
143117606000000,SW 420,Residential,6250,0,6250,0,0,6250
143117700100000,SW 420,Residential,34340,0,34340,224011,0,258351
143117700300000,SW 420,Residential,68150,0,68150,132822,0,200972
143117700500000,SW 420,Residential,33769,0,33769,231495,0,265264
143117700600000,SW 420,Residential,30300,0,30300,140528,0,170828
143117700700000,SW 420,Residential,27270,0,27270,112459,0,139729
143117700800000,SW 420,Residential,30300,0,30300,119703,0,150003
143117700900000,SW 420,Residential,30300,0,30300,0,0,30300
143117701000000,SW 420,Residential,30300,0,30300,128676,0,158976
143117701100000,SW 420,Residential,30381,0,30381,177039,0,207420
143117701200000,SW 420,Residential,30300,0,30300,112574,0,142874
143117701300000,SW 420,Residential,36360,0,36360,179959,0,216319
143117701400000,SW 420,Residential,540,0,540,0,0,540
143117701500000,SW 420,Residential,32623,0,32623,219893,0,252516
143117701600000,SW 420,Residential,32280,0,32280,200687,0,232967
143117701700000,SW 420,Residential,46027,0,46027,248811,0,294838
143117701800000,SW 420,Residential,40668,0,40668,204146,0,244814
143117701900000,SW 420,Residential,80350,0,80350,0,0,80350
143117800100000,SW 420,Residential,44827,0,44827,164501,0,209328
143117800200000,SW 420,Residential,40400,0,40400,198831,0,239231
143117800300000,SW 420,Residential,40400,0,40400,205166,0,245566
143117800400000,SW 420,Residential,40400,0,40400,198361,0,238761
143117800500000,SW 420,Residential,40400,0,40400,189542,0,229942
143117800600000,SW 420,Residential,40400,0,40400,197877,0,238277
143117900100000,SW 420,Residential,45904,0,45904,172862,0,218766
143117900200000,SW 420,Residential,42845,0,42845,188285,0,231130
143117900300000,SW 420,Residential,45454,0,45454,204250,0,249704
143120100200000,CITY PROPERTY,Exempt,0,0,0,0,0,0
143120100300000,CITY PROPERTY,Exempt,0,0,0,0,0,0
143120200100000,AUTO REPAIR/SALES,Commercial,0,307584,307584,0,221313,528897
143120200300000,RESTAURANT,Commercial,0,127130,127130,0,201215,328345
143120200600000,LG DISCOUNT/RETAIL,Commercial,0,926100,926100,0,2233106,3159206
143120200700000,RESTAURANT,Commercial,0,133920,133920,0,207906,341826
143120200800000,SMALL RETAIL,Commercial,0,487080,487080,0,704215,1191295
143122600200000,BRANCH BANK/CU,Commercial,0,280800,280800,0,546266,827066
143122600300000,LG DISCOUNT/RETAIL,Commercial,0,689310,689310,0,2249162,2938472
143122600400000,LG DISCOUNT/RETAIL,Commercial,0,427680,427680,0,403972,831652
143122700100000,AUTO REPAIR/SALES,Commercial,0,297432,297432,0,264413,561845
143122700200000,FLAT PARKING,Commercial,0,141912,141912,0,0,141912
143122700300000,SMALL RETAIL,Commercial,0,130464,130464,0,225847,356311
143122700400000,WAREHOUSE,Commercial,0,48730,48730,0,90334,139064
143122700500000,LG DISCOUNT/RETAIL,Commercial,0,528120,528120,0,965344,1493464
143122700600000,SHOP,Commercial,0,274234,274234,0,146244,420478
143122700700000,WAREHOUSE,Commercial,0,366336,366336,0,1605759,1972095
143122700702000,BILLBOARD(BLL),Commercial,0,0,0,0,24395,24395
143122700800000,FLAT PARKING,Commercial,0,113832,113832,0,40860,154692
143122700900000,FLAT PARKING,Commercial,0,99187,99187,0,20400,119587
143122701000000,VACANT LAND,Commercial,0,40241,40241,0,0,40241
143122701002000,ANTENNAS/TOWERS(BLL),Commercial,0,0,0,0,166255,166255
143122701100000,FLAT PARKING,Commercial,0,103788,103788,0,9461,113249
143122701102000,ANTENNAS/TOWERS(BLL),Commercial,0,0,0,0,140093,140093
143122701200000,AUTO REPAIR/SALES,Commercial,0,137592,137592,0,314586,452178
143122701300000,BOWLING ALLEY,Commercial,0,292032,292032,0,436103,728135
143122701400000,VACANT LAND,Commercial,0,259308,259308,0,0,259308
143125100100000,VACANT LAND,Commercial,0,22,22,0,0,22
143125100300000,RESTAURANT,Commercial,0,827704,827704,0,867395,1695099
143125100700000,APARTMENT,Residential,39551,0,39551,358845,0,398396
143125100800000,APARTMENT,Residential,40043,0,40043,358661,0,398704
143125100900000,APARTMENT,Residential,29546,0,29546,209424,0,238970
143125101000000,VACANT LAND,Commercial,0,2624,2624,0,0,2624
143125101100000,NBHD SHOPPING CENTER,Commercial,0,583200,583200,0,2375979,2959179
143125101200000,VACANT LAND,Commercial,0,116640,116640,0,0,116640
143125101300000,VACANT LAND,Commercial,0,259200,259200,0,0,259200
143125101400000,NBHD SHOPPING CENTER,Commercial,0,270000,270000,0,574980,844980
143125101500000,OFFICE; MEDICAL,Commercial,0,155520,155520,0,296480,452000
143125101600000,VACANT LAND,Commercial,0,198000,198000,0,0,198000
143125101700000,FAST FOOD,Commercial,0,174960,174960,0,597651,772611
143125101702000,BILLBOARD(BLL),Commercial,0,0,0,0,39516,39516
143125101800000,BRANCH BANK/CU,Commercial,0,263520,263520,0,1093745,1357265
143125102000000,VACANT LAND,Commercial,0,142560,142560,0,0,142560
143125102002000,BILLBOARD(BLL),Commercial,0,0,0,0,56007,56007
143125102100000,OFFICE,Commercial,0,228960,228960,0,730940,959900
143125200100000,WAREHOUSE,Commercial,0,361152,361152,0,442868,804020
143125300100000,SW 420,Residential,35449,0,35449,59677,0,95126
143125300200000,SW 420,Residential,35280,0,35280,102491,0,137771
143125300300000,SW 420,Residential,36096,0,36096,49056,0,85152
143125300400000,SW 420,Residential,36531,0,36531,44306,0,80837
143125300500000,APARTMENT,Residential,13497,0,13497,95712,0,109209
143125300600000,APARTMENT,Commercial,0,32226,32226,0,316712,348938
143127600100000,SW 420,Residential,26725,0,26725,87631,0,114356
143127600200000,SW 420,Residential,26866,0,26866,102420,0,129286
143127600300000,SW 420,Residential,26866,0,26866,88834,0,115700
143127600400000,SW 420,Residential,26058,0,26058,119700,0,145758
143127600500000,SW 420,Residential,26058,0,26058,100960,0,127018
143127600600000,SW 420,Residential,26058,0,26058,94678,0,120736
143127600700000,SW 420,Residential,26058,0,26058,83899,0,109957
143127600800000,SW 420,Residential,26058,0,26058,95823,0,121881
143127600900000,SW 420,Residential,27654,0,27654,73149,0,100803
143127601000000,SW 420,Residential,29157,0,29157,97982,0,127139
143127601400000,CHURCH,Exempt,0,35381,35381,0,99605,134986
143127601500000,SW 420,Residential,33328,0,33328,72053,0,105381
143127601600000,SW 420,Residential,24000,0,24000,85466,0,109466
143127601700000,SW 420,Residential,24000,0,24000,120012,0,144012
143127601800000,SW 420,Residential,27171,0,27171,118107,0,145278
143127601900000,SW 420,Residential,27273,0,27273,106294,0,133567
143127602000000,SW 420,Residential,28576,0,28576,88213,0,116789
143127602100000,SW 420,Residential,26076,0,26076,87824,0,113900
143127602200000,SW 420,Residential,26790,0,26790,88840,0,115630
143127602300000,SW 420,Residential,26538,0,26538,112420,0,138958
143127602400000,SW 420,Residential,28814,0,28814,99332,0,128146
143127602500000,SW 420,Residential,23688,0,23688,110821,0,134509
143127602600000,SW 420,Residential,24252,0,24252,90630,0,114882
143127602700000,SW 420,Residential,24410,0,24410,87114,0,111524
143127602800000,SW 420,Residential,26204,0,26204,67004,0,93208
143127602900000,SW 420,Residential,28787,0,28787,103779,0,132566
143127603000000,SECTION 42,Commercial,0,588573,588573,0,680583,1269156
143127700100000,SW 420,Residential,26007,0,26007,86459,0,112466
143127700200000,SW 420,Residential,26320,0,26320,102054,0,128374
143127700300000,SW 420,Residential,26320,0,26320,91351,0,117671
143127700400000,SW 420,Residential,26320,0,26320,94994,0,121314
143127700500000,SW 420,Residential,24252,0,24252,86338,0,110590
143127700600000,SW 420,Residential,24252,0,24252,98031,0,122283
143127700700000,SW 420,Residential,24252,0,24252,100017,0,124269
143127700800000,SW 420,Residential,24252,0,24252,100864,0,125116
143127700900000,SW 420,Residential,26050,0,26050,90865,0,116915
143127701000000,SW 420,Residential,24839,0,24839,91448,0,116287
143127701100000,SW 420,Residential,24252,0,24252,89578,0,113830
143127701200000,SW 420,Residential,22560,0,22560,95026,0,117586
143127701300000,SW 420,Residential,26611,0,26611,97447,0,124058
143127701400000,SW 420,Residential,26320,0,26320,96836,0,123156
143127701500000,SW 420,Residential,26320,0,26320,117534,0,143854
143127701600000,SW 420,Residential,26320,0,26320,88864,0,115184
143127701700000,SW 420,Residential,26320,0,26320,98335,0,124655
143127701800000,SW 420,Residential,26633,0,26633,88719,0,115352
143127800100000,SW 420,Residential,30631,0,30631,96863,0,127494
143127800200000,SW 420,Residential,30912,0,30912,86756,0,117668
143127800300000,SW 420,Residential,30912,0,30912,106165,0,137077
143127800400000,SW 420,Residential,30912,0,30912,85361,0,116273
143127800500000,SW 420,Residential,30912,0,30912,92506,0,123418
143127800600000,SW 420,Residential,31248,0,31248,85686,0,116934
143127800700000,SW 420,Residential,29760,0,29760,90273,0,120033
143127800800000,SW 420,Residential,25568,0,25568,95114,0,120682
143127800900000,SW 420,Residential,28200,0,28200,85163,0,113363
143127801000000,SW 420,Residential,28200,0,28200,117962,0,146162
143127900100000,SW 420,Residential,26938,0,26938,93145,0,120083
143127900200000,SW 420,Residential,27744,0,27744,105541,0,133285
143127900300000,SW 420,Residential,27000,0,27000,96885,0,123885
143127900400000,SW 420,Residential,27270,0,27270,94495,0,121765
143127900500000,SW 420,Residential,27315,0,27315,110863,0,138178
143127900600000,SW 420,Residential,30527,0,30527,97240,0,127767
143127900700000,SW 420,Residential,30400,0,30400,82883,0,113283
143127900800000,SW 420,Residential,31059,0,31059,101192,0,132251
143127900900000,SW 420,Residential,31137,0,31137,118114,0,149251
143127901000000,SW 420,Residential,29184,0,29184,95746,0,124930
143127901100000,SW 420,Residential,28453,0,28453,80761,0,109214
143127901200000,SW 420,Residential,30380,0,30380,80865,0,111245
143127901300000,SW 420,Residential,31040,0,31040,101993,0,133033
143127901400000,SW 420,Residential,30780,0,30780,83242,0,114022
143127901500000,SW 420,Residential,26880,0,26880,89647,0,116527
143128000100000,SW 420,Residential,30888,0,30888,86718,0,117606
143128000200000,SW 420,Residential,26741,0,26741,91559,0,118300
143128000300000,SW 420,Residential,27664,0,27664,103510,0,131174
143128000400000,SW 420,Residential,25480,0,25480,118012,0,143492
143128000500000,SW 420,Residential,29563,0,29563,97428,0,126991
143128000600000,SW 420,Residential,28200,0,28200,92127,0,120327
143128000700000,SW 420,Residential,28200,0,28200,91564,0,119764
143128000800000,SW 420,Residential,28200,0,28200,104884,0,133084
143128000900000,SW 420,Residential,30080,0,30080,90467,0,120547
143128001000000,SW 420,Residential,30080,0,30080,105493,0,135573
143128001100000,SW 420,Residential,30080,0,30080,90252,0,120332
143128001200000,SW 420,Residential,30080,0,30080,91006,0,121086
143128001300000,SW 420,Residential,27232,0,27232,99933,0,127165
143128001400000,SW 420,Residential,30053,0,30053,99833,0,129886
143128001500000,SW 420,Residential,30464,0,30464,107510,0,137974
143128001600000,SW 420,Residential,32760,0,32760,99983,0,132743
143128001700000,SW 420,Residential,32760,0,32760,117598,0,150358
143128001800000,SW 420,Residential,32760,0,32760,95080,0,127840
143128001900000,SW 420,Residential,30950,0,30950,111241,0,142191
143128100100000,SW 420,Residential,29120,0,29120,107481,0,136601
143128100200000,SW 420,Residential,31305,0,31305,85323,0,116628
143128100300000,SW 420,Residential,29328,0,29328,100827,0,130155
143128100400000,SW 420,Residential,29328,0,29328,119352,0,148680
143128100500000,SW 420,Residential,29328,0,29328,109205,0,138533
143128100600000,SW 420,Residential,30264,0,30264,116872,0,147136
143128100700000,SW 420,Residential,28288,0,28288,89250,0,117538
143128100800000,SW 420,Residential,28203,0,28203,125599,0,153802
143128100900000,SW 420,Residential,27200,0,27200,110068,0,137268
143128101000000,SW 420,Residential,28160,0,28160,122327,0,150487
143128101100000,SW 420,Residential,31741,0,31741,124684,0,156425
143128101200000,SW 420,Residential,29958,0,29958,105928,0,135886
143130100100000,SW 420,Residential,33759,0,33759,131946,0,165705
143130100200000,SW 420,Residential,33759,0,33759,94491,0,128250
143130100300000,SW 420,Residential,32329,0,32329,121887,0,154216
143130100400000,SW 420,Residential,35921,0,35921,86040,0,121961
143130100500000,SW 420,Residential,33075,0,33075,105211,0,138286
143130100600000,SW 420,Residential,33075,0,33075,159428,0,192503
143130100700000,SW 420,Residential,49815,0,49815,122754,0,172569
143130100800000,SW 420,Residential,53900,0,53900,92816,0,146716
143130100900000,SW 420,Residential,2350,0,2350,0,0,2350
143130101000000,SW 420,Residential,54400,0,54400,246193,0,300593
143130101100000,SW 420,Residential,46800,0,46800,128243,0,175043
143130101200000,SW 420,Residential,37800,0,37800,130483,0,168283
143130200100000,SW 420,Residential,26144,0,26144,63512,0,89656
143130200200000,SW 420,Residential,43575,0,43575,81303,0,124878
143130200300000,SW 420,Residential,39040,0,39040,141972,0,181012
143130200400000,SW 420,Residential,39040,0,39040,101890,0,140930
143130200500000,SW 420,Residential,31040,0,31040,86078,0,117118
143130200600000,SW 420,Residential,33330,0,33330,50704,0,84034
143130200700000,SW 420,Residential,33296,0,33296,78313,0,111609
143130200800000,SW 420,Residential,24396,0,24396,74616,0,99012
143130200900000,SW 420,Residential,25308,0,25308,67868,0,93176
143130201000000,SW 420,Residential,32206,0,32206,43139,0,75345
143130201100000,SW 420,Residential,48314,0,48314,62400,0,110714
143130201200000,SW 420,Residential,60950,0,60950,103482,0,164432
143130201300000,SCHOOL,Exempt,0,0,0,0,0,0
143130201400000,SW 420,Residential,78050,0,78050,146546,0,224596
143130201500000,SW 420,Residential,48708,0,48708,108138,0,156846
143130201600000,SW 420,Residential,39803,0,39803,111696,0,151499
143130201700000,SW 420,Residential,39803,0,39803,154466,0,194269
143130201800000,SW 420,Residential,41513,0,41513,136771,0,178284
143130201900000,SW 420,Residential,27863,0,27863,136548,0,164411
143130202000000,SW 420,Exempt,0,27864,27864,0,135909,163773
143130300100000,SW 420,Residential,23203,0,23203,74984,0,98187
143130300200000,SW 420,Residential,39406,0,39406,72636,0,112042
143130300300000,SW 420,Residential,35136,0,35136,32064,0,67200
143130300400000,SW 420,Residential,31040,0,31040,157553,0,188593
143130300500000,SW 420,Residential,29100,0,29100,179174,0,208274
143130300600000,SW 420,Residential,29100,0,29100,130329,0,159429
143130300700000,SW 420,Residential,29232,0,29232,148762,0,177994
143130300800000,SW 420,Residential,21941,0,21941,70090,0,92031
143130300900000,SW 420,Residential,23760,0,23760,95128,0,118888
143130301000000,SW 420,Residential,22176,0,22176,79245,0,101421
143130301100000,SW 420,Residential,23760,0,23760,83312,0,107072
143130400100000,SW 420,Residential,32076,0,32076,146623,0,178699
143130400200000,SW 420,Residential,32436,0,32436,174789,0,207225
143130400300000,SW 420,Residential,33183,0,33183,151759,0,184942
143130400400000,SW 420,Residential,31040,0,31040,114505,0,145545
143130400500000,SW 420,Residential,31040,0,31040,116525,0,147565
143130400600000,SW 420,Residential,32766,0,32766,136919,0,169685
143130400700000,SW 420,Residential,31564,0,31564,136609,0,168173
143130500100000,SW 420,Residential,32332,0,32332,110499,0,142831
143130500200000,SW 420,Residential,29100,0,29100,124643,0,153743
143130500300000,SW 420,Residential,28409,0,28409,85079,0,113488
143130500400000,SW 420,Residential,30814,0,30814,105174,0,135988
143130500500000,SW 420,Residential,30000,0,30000,109408,0,139408
143130500600000,SW 420,Residential,30000,0,30000,115182,0,145182
143130500700000,SW 420,Residential,30000,0,30000,105332,0,135332
143130500800000,SW 420,Residential,30414,0,30414,106188,0,136602
143132600100000,SW 420,Residential,36234,0,36234,103520,0,139754
143132600200000,SW 420,Residential,36234,0,36234,117055,0,153289
143132600300000,SW 420,Residential,31258,0,31258,102913,0,134171
143132600400000,SW 420,Residential,24960,0,24960,133245,0,158205
143132600500000,SW 420,Residential,31916,0,31916,144050,0,175966
143132600600000,SW 420,Residential,32724,0,32724,114851,0,147575
143132600700000,SW 420,Residential,32724,0,32724,126141,0,158865
143132600800000,SW 420,Residential,54,0,54,0,0,54
143132600900000,SW 420,Residential,30400,0,30400,139151,0,169551
143132601000000,SW 420,Residential,30720,0,30720,130976,0,161696
143132700100000,SW 420,Residential,25680,0,25680,0,0,25680
143132700200000,SW 420,Residential,32164,0,32164,92478,0,124642
143132700300000,SW 420,Exempt,0,50126,50126,0,178286,228412
143132700400000,SW 420,Residential,32738,0,32738,151317,0,184055
143132700500000,SW 420,Residential,36000,0,36000,154302,0,190302
143132700600000,SW 420,Residential,36720,0,36720,163217,0,199937
143132700700000,SW 420,Residential,36720,0,36720,186411,0,223131
143132700800000,SW 420,Residential,35640,0,35640,151858,0,187498
143132700900000,SW 420,Residential,39954,0,39954,156470,0,196424
143132701000000,SW 420,Residential,41071,0,41071,159753,0,200824
143132701100000,SW 420,Residential,35640,0,35640,163482,0,199122
143132701200000,SW 420,Residential,37269,0,37269,162661,0,199930
143132701300000,SW 420,Residential,36701,0,36701,163361,0,200062
143132701400000,SW 420,Residential,36720,0,36720,0,0,36720
143132701500000,SW 420,Residential,31680,0,31680,92809,0,124489
143132701600000,SW 420,Residential,31696,0,31696,83490,0,115186
143132701700000,SW 420,Residential,31878,0,31878,80156,0,112034
143132702700000,THEATER,Commercial,0,1495584,1495584,0,4261462,5757046
143132702800000,FAST FOOD,Commercial,0,384426,384426,0,667173,1051599
143132702900000,FAST FOOD,Commercial,0,396900,396900,0,776613,1173513
143132703000000,SW 420,Residential,41310,0,41310,174859,0,216169
143132703100000,SW 420,Residential,40920,0,40920,256609,0,297529
143132703200000,SW 420,Residential,36720,0,36720,212213,0,248933
143132703300000,SW 420,Residential,39015,0,39015,191976,0,230991
143132703400000,SW 420,Residential,36720,0,36720,153230,0,189950
143132703500000,SW 420,Residential,39015,0,39015,221364,0,260379
143132703600000,SW 420,Residential,36995,0,36995,271431,0,308426
143132703700000,SW 420,Residential,28526,0,28526,173290,0,201816
143132703800000,SW 420,Residential,29100,0,29100,134623,0,163723
143132703900000,SW 420,Residential,31736,0,31736,109428,0,141164
143132704000000,SW 420,Residential,31512,0,31512,157852,0,189364
143132704100000,SW 420,Residential,32320,0,32320,126638,0,158958
143132704200000,SW 420,Residential,32320,0,32320,134901,0,167221
143132704300000,SW 420,Residential,30300,0,30300,119700,0,150000
143132704400000,SW 420,Residential,26220,0,26220,163785,0,190005
143132704500000,OFFICE; MEDICAL,Commercial,0,1057207,1057207,0,2801764,3858971
143132800100000,SW 420,Residential,33833,0,33833,172185,0,206018
143132800200000,SW 420,Residential,32400,0,32400,163593,0,195993
143132800300000,SW 420,Residential,34247,0,34247,203878,0,238125
143132800400000,SW 420,Residential,28948,0,28948,0,0,28948
143132800500000,SW 420,Residential,28215,0,28215,115810,0,144025
143132800600000,SW 420,Residential,29876,0,29876,107506,0,137382
143132800700000,SW 420,Residential,29100,0,29100,113149,0,142249
143132800800000,SW 420,Residential,29100,0,29100,121288,0,150388
143132900100000,SW 420,Residential,29100,0,29100,116067,0,145167
143132900200000,SW 420,Residential,34542,0,34542,112941,0,147483
143132900300000,SW 420,Residential,38250,0,38250,122344,0,160594
143132900400000,SW 420,Residential,35451,0,35451,113472,0,148923
143133000100000,SW 420,Residential,31331,0,31331,145845,0,177176
143133000200000,SW 420,Residential,31040,0,31040,117248,0,148288
143133000300000,SW 420,Residential,31331,0,31331,129976,0,161307
143133000400000,SW 420,Residential,35640,0,35640,191731,0,227371
143133000500000,SW 420,Residential,37868,0,37868,172295,0,210163
143133000600000,SW 420,Residential,37868,0,37868,176487,0,214355
143133000700000,SW 420,Residential,37868,0,37868,134395,0,172263
143133000800000,SW 420,Residential,37868,0,37868,164658,0,202526
143133000900000,SW 420,Residential,31680,0,31680,110778,0,142458
143133001000000,SW 420,Residential,29700,0,29700,113946,0,143646
143133001100000,SW 420,Residential,30397,0,30397,115527,0,145924
143133100600000,SW 420,Residential,40905,0,40905,116519,0,157424
143135100100000,SW 420,Residential,39774,0,39774,140853,0,180627
143135100200000,SW 420,Residential,37021,0,37021,137476,0,174497
143135200100000,SW 420,Residential,37873,0,37873,175773,0,213646
143135200200000,SW 420,Residential,34554,0,34554,162998,0,197552
143135200300000,SW 420,Residential,34104,0,34104,172616,0,206720
143135200400000,SW 420,Residential,34455,0,34455,192845,0,227300
143135200500000,SW 420,Residential,36865,0,36865,183125,0,219990
143135200600000,SW 420,Residential,37868,0,37868,156483,0,194351
143135200700000,SW 420,Residential,38411,0,38411,171647,0,210058
143135200800000,SW 420,Residential,39541,0,39541,185314,0,224855
143135200900000,SW 420,Residential,38111,0,38111,191786,0,229897
143135201000000,SW 420,Residential,37868,0,37868,215114,0,252982
143135201100000,SW 420,Residential,38120,0,38120,215819,0,253939
143135201200000,SW 420,Residential,38091,0,38091,160552,0,198643
143135201300000,SW 420,Residential,37868,0,37868,185333,0,223201
143135201400000,SW 420,Residential,35640,0,35640,186034,0,221674
143135201500000,SW 420,Residential,39214,0,39214,168848,0,208062
143135201600000,SW 420,Residential,37957,0,37957,185628,0,223585
143135201700000,SW 420,Residential,35640,0,35640,188942,0,224582
143135201800000,SW 420,Residential,37868,0,37868,142416,0,180284
143135201900000,SW 420,Residential,37308,0,37308,189557,0,226865
143135202000000,SW 420,Residential,40243,0,40243,201884,0,242127
143135300100000,SW 420,Residential,39708,0,39708,181421,0,221129
143135300200000,RESTAURANT,Commercial,0,548100,548100,0,873447,1421547
143135300400000,SW 420,Residential,46859,0,46859,306713,0,353572
143135300500000,SW 420,Residential,44753,0,44753,217414,0,262167
143135300600000,SW 420,Residential,41153,0,41153,238378,0,279531
143135300700000,SW 420,Residential,38628,0,38628,213855,0,252483
143135300800000,SW 420,Residential,43092,0,43092,213241,0,256333
143135300900000,SW 420,Residential,44145,0,44145,251444,0,295589
143135301000000,SW 420,Residential,41368,0,41368,226337,0,267705
143135301100000,SW 420,Residential,43680,0,43680,221327,0,265007
143135301200000,NBHD SHOPPING CENTER,Commercial,0,743904,743904,0,1083936,1827840
143135301300000,VACANT LAND,Commercial,0,22,22,0,0,22
143135301400000,RESTAURANT,Commercial,0,532224,532224,0,971528,1503752
143135301500000,RESTAURANT,Commercial,0,476280,476280,0,670155,1146435
143135301600000,FAST FOOD,Commercial,0,387828,387828,0,542431,930259
143135301700000,BRANCH BANK/CU,Commercial,0,373464,373464,0,1609643,1983107
143135301800000,OFFICE,Commercial,0,612360,612360,0,1344437,1956797
143135302100000,SCHOOL,Commercial,0,737856,737856,0,1862144,2600000
143135302200000,VACANT LAND,Commercial,0,4447,4447,0,0,4447
143135302300000,FAST FOOD,Commercial,0,374447,374447,0,356460,730907
143135302400000,BRANCH BANK/CU,Commercial,0,504792,504792,0,1225436,1730228
143135302600000,SW 420,Residential,29440,0,29440,174635,0,204075
143135302700000,SW 420,Residential,33649,0,33649,193107,0,226756
143135302800000,SW 420,Residential,28520,0,28520,167572,0,196092
143135302900000,SW 420,Residential,33723,0,33723,170440,0,204163
143135303000000,SW 420,Residential,39934,0,39934,165756,0,205690
143135303100000,SW 420,Residential,32085,0,32085,154985,0,187070
143135303200000,SW 420,Residential,31102,0,31102,169666,0,200768
143135303300000,SW 420,Residential,32085,0,32085,153423,0,185508
143137600100000,CITY PROPERTY,Exempt,0,0,0,0,0,0
143137700100000,SW 420,Residential,62450,0,62450,91484,0,153934
143137700200000,SW 420,Residential,29787,0,29787,147275,0,177062
143137700300000,SW 420,Residential,30000,0,30000,140937,0,170937
143137700400000,SW 420,Residential,30000,0,30000,0,0,30000
143137700500000,SW 420,Residential,32000,0,32000,142137,0,174137
143137700600000,SW 420,Residential,37445,0,37445,201477,0,238922
143137700700000,SW 420,Residential,26190,0,26190,140665,0,166855
143137700800000,SW 420,Residential,26609,0,26609,123524,0,150133
143137700900000,SW 420,Residential,25181,0,25181,138039,0,163220
143137701000000,SW 420,Residential,24978,0,24978,143161,0,168139
143137701200000,CITY PROPERTY,Exempt,0,0,0,0,0,0
143137701300000,SW 420,Residential,30768,0,30768,147041,0,177809
143137701400000,SW 420,Residential,30941,0,30941,132109,0,163050
143137701500000,SW 420,Residential,31185,0,31185,128052,0,159237
143137701600000,SW 420,Residential,31185,0,31185,120636,0,151821
143137701700000,SW 420,Residential,31185,0,31185,105029,0,136214
143137701800000,SW 420,Residential,31429,0,31429,106735,0,138164
143137701900000,SW 420,Residential,31185,0,31185,92532,0,123717
143137702000000,CITY PROPERTY,Exempt,0,0,0,0,0,0
143137702100000,CITY PROPERTY,Exempt,0,0,0,0,0,0
143137800100000,SW 420,Residential,32128,0,32128,102611,0,134739
143137800200000,SW 420,Residential,38475,0,38475,187876,0,226351
143137800300000,SW 420,Residential,36337,0,36337,169857,0,206194
143137800400000,SW 420,Residential,37402,0,37402,169163,0,206565
143137800500000,SW 420,Residential,38097,0,38097,178613,0,216710
143137800600000,SW 420,Residential,38475,0,38475,205476,0,243951
143137800700000,SW 420,Residential,38475,0,38475,178793,0,217268
143137800800000,SW 420,Residential,42795,0,42795,150629,0,193424
143137800900000,SW 420,Residential,29067,0,29067,119744,0,148811
143137801000000,SW 420,Residential,30000,0,30000,149257,0,179257
143137801100000,SW 420,Residential,30000,0,30000,147251,0,177251
143137801200000,SW 420,Residential,30000,0,30000,133935,0,163935
143137801300000,SW 420,Residential,32000,0,32000,125845,0,157845
143137801400000,SW 420,Exempt,0,33536,33536,0,122885,156421
143137801500000,SW 420,Residential,65,0,65,0,0,65
143137801600000,SW 420,Residential,30000,0,30000,114696,0,144696
143137801700000,SW 420,Residential,30000,0,30000,121451,0,151451
143137801800000,SW 420,Residential,30000,0,30000,94353,0,124353
143137900400000,SW 420,Residential,33614,0,33614,175694,0,209308
143137900500000,SW 420,Residential,33649,0,33649,212216,0,245865
143137900600000,SW 420,Residential,28520,0,28520,189809,0,218329
143137900700000,SW 420,Residential,33649,0,33649,168752,0,202401
143137900800000,SW 420,Residential,32660,0,32660,149341,0,182001
143137900900000,SW 420,Residential,33120,0,33120,222465,0,255585
143137901000000,SW 420,Residential,33649,0,33649,167451,0,201100
143137901100000,SW 420,Residential,33649,0,33649,184594,0,218243
143137901200000,SW 420,Residential,32660,0,32660,177809,0,210469
143137901300000,SW 420,Residential,33649,0,33649,189382,0,223031
143137901400000,SW 420,Residential,35420,0,35420,190736,0,226156
143137901500000,SW 420,Residential,33649,0,33649,158068,0,191717
143137901600000,SW 420,Residential,34500,0,34500,194051,0,228551
143137901700000,SW 420,Residential,33638,0,33638,174308,0,207946
143137901800000,SW 420,Residential,35708,0,35708,159505,0,195213
143137901900000,SW 420,Residential,31619,0,31619,175570,0,207189
143137902000000,SW 420,Residential,32085,0,32085,154363,0,186448
143137902100000,SW 420,Residential,37260,0,37260,187358,0,224618
143137902200000,SW 420,Residential,37260,0,37260,168149,0,205409
143137902300000,SW 420,Residential,33638,0,33638,190925,0,224563
143137902400000,SW 420,Residential,35708,0,35708,184275,0,219983
143137902500000,SW 420,Residential,32085,0,32085,208911,0,240996
143137902600000,SW 420,Residential,33638,0,33638,0,0,33638
143137902700000,SW 420,Residential,34673,0,34673,184938,0,219611
143137902800000,SW 420,Residential,35708,0,35708,193915,0,229623
143137902900000,SW 420,Residential,30584,0,30584,179918,0,210502
143137903000000,SW 420,Residential,35436,0,35436,192158,0,227594
143140100100000,SW 419,Residential,19775,0,19775,73928,0,93703
143140100200000,SW 419,Residential,31442,0,31442,33943,0,65385
143140100300000,SW 419,Residential,20650,0,20650,116560,0,137210
143140100400000,SW 419,Residential,20650,0,20650,50959,0,71609
143140100500000,SW 419,Residential,20650,0,20650,110279,0,130929
143140100600000,SW 419,Residential,20650,0,20650,58033,0,78683
143140100700000,SW 419,Residential,30975,0,30975,93015,0,123990
143140100800000,SW 419,Residential,30975,0,30975,71013,0,101988
143140100900000,SW 419,Residential,30975,0,30975,64386,0,95361
143140101000000,SW 419,Residential,30665,0,30665,93140,0,123805
143140101100000,SW 419,Residential,30665,0,30665,49052,0,79717
143140101200000,SW 419,Residential,27258,0,27258,90621,0,117879
143140101300000,SW 419,Residential,25606,0,25606,50416,0,76022
143140101400000,SW 419,Residential,28910,0,28910,88853,0,117763
143140101500000,SW 419,Residential,27258,0,27258,51130,0,78388
143140101600000,SW 419,Residential,27258,0,27258,103000,0,130258
143140101700000,SW 419,Residential,38161,0,38161,46194,0,84355
143140101800000,SW 419,Residential,68350,0,68350,127011,0,195361
143140101900000,SW 419,Ag Land,25264,0,25264,0,0,25264
143140102000000,SW 419,Ag Dwelling,4607,0,4607,180795,5040,190442
143140102100000,SW 419,Residential,46300,0,46300,111400,0,157700
143140102200000,SW 419,Residential,40000,0,40000,88733,0,128733
143140102300000,SW 419,Residential,2453,0,2453,0,0,2453
143142600100000,SW 420,Residential,33075,0,33075,122892,0,155967
143142600200000,SW 420,Residential,29376,0,29376,105417,0,134793
143142600300000,SW 420,Residential,25839,0,25839,110084,0,135923
143142600400000,SW 420,Residential,30740,0,30740,95289,0,126029
143142600500000,SW 420,Residential,33413,0,33413,104484,0,137897
143142600600000,SW 420,Residential,33413,0,33413,87854,0,121267
143142600700000,SW 420,Residential,33413,0,33413,95431,0,128844
143142600800000,SW 420,Residential,33413,0,33413,92395,0,125808
143142600900000,SW 420,Residential,33413,0,33413,109750,0,143163
143142601000000,SW 420,Residential,33413,0,33413,103132,0,136545
143142601100000,SW 420,Residential,33413,0,33413,99948,0,133361
143142601200000,SW 420,Residential,33413,0,33413,102529,0,135942
143142601300000,SW 420,Residential,33413,0,33413,97090,0,130503
143142601400000,SW 420,Residential,33413,0,33413,108466,0,141879
143142601500000,SW 420,Residential,33413,0,33413,103552,0,136965
143142700100000,SW 420,Residential,26918,0,26918,126547,0,153465
143142700200000,SMALL RETAIL,Commercial,0,83268,83268,0,95887,179155
143142700300000,SW 420,Ag Dwelling,13487,0,13487,48585,9842,71914
143142700400000,SW 420,Residential,25973,0,25973,96903,0,122876
143142700500000,SW 420,Residential,24240,0,24240,101639,0,125879
143142700600000,SW 420,Residential,24240,0,24240,83781,0,108021
143142700700000,SW 420,Residential,24240,0,24240,91431,0,115671
143142700800000,SW 420,Residential,24240,0,24240,96692,0,120932
143142700900000,SW 420,Residential,24240,0,24240,99262,0,123502
143142701000000,SW 420,Residential,24240,0,24240,111355,0,135595
143142701100000,SW 420,Residential,24240,0,24240,95219,0,119459
143142701200000,SW 420,Residential,24240,0,24240,111688,0,135928
143142701300000,SW 420,Residential,24240,0,24240,84389,0,108629
143142701400000,SW 420,Residential,25856,0,25856,143105,0,168961
143142701500000,SW 420,Residential,25856,0,25856,105829,0,131685
143142701600000,SW 420,Residential,25856,0,25856,114814,0,140670
143142701700000,SW 420,Residential,25856,0,25856,91002,0,116858
143142701800000,SW 420,Residential,25856,0,25856,106622,0,132478
143142701900000,SW 420,Residential,25856,0,25856,100169,0,126025
143142702000000,SW 420,Residential,25856,0,25856,104001,0,129857
143142702100000,SW 420,Residential,25856,0,25856,100961,0,126817
143142702200000,SW 420,Residential,25856,0,25856,137899,0,163755
143142702300000,SW 420,Residential,26188,0,26188,120636,0,146824
143142702400000,SW 420,Residential,34088,0,34088,105635,0,139723
143142702500000,SW 420,Residential,34088,0,34088,89573,0,123661
143142702600000,SW 420,Residential,34088,0,34088,102892,0,136980
143142702700000,SW 420,Residential,34088,0,34088,114996,0,149084
143142702800000,SW 420,Residential,33750,0,33750,120150,0,153900
143142702900000,SW 420,Residential,33750,0,33750,119883,0,153633
143142703000000,SW 420,Residential,33750,0,33750,113540,0,147290
143142703100000,SW 420,Residential,33580,0,33580,115671,0,149251
143142703200000,SW 420,Residential,33580,0,33580,16023,0,49603
143142703300000,SW 420,Residential,31500,0,31500,0,0,31500
143142703400000,SW 420,Residential,31500,0,31500,122024,0,153524
143142703500000,SW 420,Residential,33413,0,33413,134262,0,167675
143142703600000,SW 420,Residential,29988,0,29988,129317,0,159305
143142703700000,SW 420,Residential,26190,0,26190,120451,0,146641
143142800100000,SW 420,Residential,29013,0,29013,98983,0,127996
143142800200000,SW 420,Residential,26910,0,26910,78759,0,105669
143142800300000,SW 420,Residential,25073,0,25073,152835,0,177908
143142800400000,SW 420,Residential,30294,0,30294,0,0,30294
143142800500000,SW 420,Residential,33763,0,33763,112858,0,146621
143142800600000,SW 420,Residential,34088,0,34088,126803,0,160891
143142800700000,SW 420,Residential,33633,0,33633,123012,0,156645
143142800800000,SW 420,Residential,33633,0,33633,109823,0,143456
143142800900000,SW 420,Residential,34088,0,34088,125691,0,159779
143142801000000,SW 420,Residential,34088,0,34088,149886,0,183974
143142801100000,SW 420,Residential,34088,0,34088,149723,0,183811
143142801200000,SW 420,Residential,53850,0,53850,0,0,53850
143142801300000,SW 420,Residential,26969,0,26969,115454,0,142423
143142801400000,SW 420,Residential,24644,0,24644,123956,0,148600
143142801500000,SW 420,Residential,24644,0,24644,110741,0,135385
143142801600000,SW 420,Residential,24644,0,24644,102783,0,127427
143142801700000,SW 420,Residential,24644,0,24644,101003,0,125647
143142801800000,SW 420,Residential,26442,0,26442,118017,0,144459
143142801900000,SW 420,Residential,28280,0,28280,108557,0,136837
143142802000000,SW 420,Residential,27270,0,27270,112835,0,140105
143142802100000,SW 420,Residential,25856,0,25856,108448,0,134304
143142802200000,SW 420,Residential,26906,0,26906,115850,0,142756
143142802300000,SW 420,Residential,24240,0,24240,73827,0,98067
143142802400000,SW 420,Residential,24240,0,24240,85730,0,109970
143142802500000,SW 420,Residential,24240,0,24240,94544,0,118784
143142802600000,SW 420,Residential,24240,0,24240,93180,0,117420
143142802700000,SW 420,Residential,24240,0,24240,101791,0,126031
143142802800000,SW 420,Residential,24240,0,24240,136524,0,160764
143142802900000,SW 420,Residential,24240,0,24240,88490,0,112730
143142803000000,SW 420,Residential,24240,0,24240,84963,0,109203
143142900100000,SW 420,Residential,32360,0,32360,112123,0,144483
143142900200000,SW 420,Residential,30208,0,30208,113488,0,143696
143142900300000,SW 420,Residential,32597,0,32597,120787,0,153384
143142900400000,SW 420,Residential,32270,0,32270,110431,0,142701
143142900500000,SW 420,Residential,32270,0,32270,117944,0,150214
143142900600000,SW 420,Residential,32270,0,32270,122559,0,154829
143142900700000,SW 420,Residential,33633,0,33633,138602,0,172235
143143000100000,SW 420,Residential,24498,0,24498,0,0,24498
143145100100000,SW 420,Ag Land,46897,0,46897,0,0,46897
143145100200000,SW 455,Ag Dwelling,15445,0,15445,73085,0,88530
143145100300000,SW 455,Residential,32500,0,32500,31862,0,64362
143147600100000,SW 455,Ag Land,30434,0,30434,0,9510,39944
143147600200000,SW 455,Ag Dwelling,1204,0,1204,91813,0,93017
143147600300000,SW 455,Ag Dwelling,25118,0,25118,75930,2137,103185
143147600400000,SW 455,Ag Dwelling,17460,0,17460,109274,11957,138691
143210100100000,RESTAURANT,Commercial,0,22680,22680,0,65457,88137
143210100200000,FLAT PARKING,Commercial,0,26460,26460,0,3808,30268
143210100300000,SW 404,Residential,16031,0,16031,51511,0,67542
143210100400000,SW 404,Residential,15000,0,15000,66865,0,81865
143210100500000,SW 404,Residential,15000,0,15000,44192,0,59192
143210100600000,SW 404,Residential,15000,0,15000,63399,0,78399
143210100700000,SW 404,Residential,15000,0,15000,84058,0,99058
143210100800000,SW 404,Residential,15000,0,15000,58916,0,73916
143210100900000,SW 404,Residential,15000,0,15000,59410,0,74410
143210101000000,SW 404,Residential,15000,0,15000,55067,0,70067
143210101100000,SW 404,Residential,15000,0,15000,55225,0,70225
143210101200000,SW 404,Residential,15000,0,15000,70097,0,85097
143210101300000,SW 404,Residential,15000,0,15000,71129,0,86129
143210101400000,SW 404,Residential,15000,0,15000,58267,0,73267
143210101500000,SW 404,Residential,15000,0,15000,62828,0,77828
143210101600000,SW 404,Residential,15000,0,15000,77528,0,92528
143210200500000,SW 404,Residential,15000,0,15000,85217,0,100217
143210200600000,APARTMENT,Commercial,0,19051,19051,0,230949,250000
143210200700000,APARTMENT,Residential,46267,0,46267,589358,0,635625
143210300100000,SW 404,Residential,17100,0,17100,52673,0,69773
143210300200000,SW 404,Residential,15000,0,15000,57610,0,72610
143210300300000,SW 404,Residential,17100,0,17100,76342,0,93442
143210300400000,SW 404,Residential,17100,0,17100,0,0,17100
143210400100000,LG DISCOUNT/RETAIL,Commercial,0,448470,448470,0,1177942,1626412
143210400600000,SW 404,Residential,18000,0,18000,68695,0,86695
143210400700000,SW 404,Residential,18000,0,18000,69556,0,87556
143210400800000,SW 404,Residential,15000,0,15000,57195,0,72195
143210400900000,SW 404,Residential,15000,0,15000,45440,0,60440
143210401000000,SW 404,Residential,15000,0,15000,55207,0,70207
143210401100000,SW 404,Residential,15675,0,15675,51778,0,67453
143210401200000,SW 404,Residential,19140,0,19140,97692,0,116832
143210401300000,SW 404,Residential,17595,0,17595,43089,0,60684
143210401400000,SW 404,Residential,17802,0,17802,77133,0,94935
143210401500000,SW 404,Residential,15000,0,15000,35714,0,50714
143210401600000,APARTMENT,Commercial,0,27216,27216,0,392493,419709
143210401700000,SW 404,Residential,15000,0,15000,75212,0,90212
143210401800000,CONVERSION,Commercial,0,9072,9072,0,77203,86275
143210500100000,SW 404,Residential,15871,0,15871,72503,0,88374
143210500200000,SW 404,Residential,15781,0,15781,64906,0,80687
143210500300000,SW 404,Residential,16875,0,16875,81172,0,98047
143210500400000,SW 404,Residential,16875,0,16875,76951,0,93826
143210500500000,SW 404,Residential,15781,0,15781,58156,0,73937
143210500600000,SW 404,Residential,14892,0,14892,59353,0,74245
143210500700000,SW 404,Residential,14430,0,14430,64838,0,79268
143210500800000,SW 404,Residential,14430,0,14430,59203,0,73633
143210500900000,SW 404,Residential,19280,0,19280,93883,0,113163
143210501000000,SW 404,Residential,16875,0,16875,56816,0,73691
143210501100000,SW 404,Residential,16875,0,16875,76456,0,93331
143210501200000,SW 404,Residential,15781,0,15781,80360,0,96141
143210501300000,SW 404,Residential,15029,0,15029,74312,0,89341
143210501400000,SW 404,Residential,14625,0,14625,75272,0,89897
143210501500000,SW 404,Residential,14430,0,14430,68028,0,82458
143210600100000,SW 404,Residential,7417,0,7417,0,0,7417
143210600200000,SW 404,Residential,18000,0,18000,76316,0,94316
143210600300000,SW 404,Residential,15000,0,15000,51990,0,66990
143210600400000,SW 404,Residential,14835,0,14835,54381,0,69216
143210600500000,SW 404,Residential,17802,0,17802,62907,0,80709
143210600600000,SW 404,Residential,14662,0,14662,152322,0,166984
143210600700000,SW 404,Residential,7417,0,7417,11475,0,18892
143210700300000,FLAT PARKING,Commercial,0,16848,16848,0,2964,19812
143210700400000,SW 404,Residential,15000,0,15000,56900,0,71900
143210700500000,SW 404,Residential,15000,0,15000,55100,0,70100
143210700600000,SW 404,Residential,15000,0,15000,65479,0,80479
143210700700000,SW 404,Residential,15000,0,15000,52168,0,67168
143210700800000,SW 404,Residential,15000,0,15000,47571,0,62571
143210700900000,VACANT LAND,Residential,17640,0,17640,52289,0,69929
143210701000000,VACANT LAND,Residential,17640,0,17640,0,0,17640
143210701100000,SW 404,Residential,15000,0,15000,63862,0,78862
143210701200000,SW 404,Residential,11400,0,11400,76990,0,88390
143210701300000,SW 404,Residential,10125,0,10125,84295,0,94420
143210701400000,SW 404,Residential,20400,0,20400,76193,0,96593
143210701500000,SW 404,Residential,19125,0,19125,70588,0,89713
143210701600000,SW 404,Residential,21037,0,21037,107161,0,128198
143210701700000,SW 404,Residential,17000,0,17000,86279,0,103279
143210701800000,SW 404,Residential,17000,0,17000,55262,0,72262
143210701900000,SW 404,Residential,17000,0,17000,54874,0,71874
143210702000000,SW 404,Residential,17000,0,17000,60448,0,77448
143210702100000,SW 404,Residential,17000,0,17000,53614,0,70614
143210702200000,SW 404,Residential,17000,0,17000,45483,0,62483
143210702300000,SW 404,Residential,20400,0,20400,52373,0,72773
143210702400000,SW 404,Residential,20017,0,20017,46841,0,66858
143210702500000,BARS/LOUNGE,Commercial,0,9720,9720,0,114265,123985
143210702600000,HOTEL,Commercial,0,31050,31050,0,106068,137118
143210702700000,AUTO REPAIR/SALES,Commercial,0,95971,95971,0,112316,208287
143210800100000,SW 404,Residential,15675,0,15675,88558,0,104233
143210800200000,SW 404,Residential,15000,0,15000,60328,0,75328
143210800300000,SW 404,Residential,18000,0,18000,76975,0,94975
143210800500000,SW 404,Residential,15000,0,15000,43604,0,58604
143210800600000,SW 404,Residential,15000,0,15000,38473,0,53473
143210800700000,SW 404,Residential,15000,0,15000,0,0,15000
143210800800000,SW 404,Residential,15000,0,15000,101339,0,116339
143210800900000,SW 404,Residential,8262,0,8262,42050,0,50312
143210801000000,SW 404,Residential,7803,0,7803,42334,0,50137
143210801300000,SW 404,Residential,17000,0,17000,48593,0,65593
143210801400000,SW 404,Residential,17000,0,17000,45258,0,62258
143210801500000,SW 404,Residential,17000,0,17000,92890,0,109890
143210801600000,SW 404,Residential,17000,0,17000,39429,0,56429
143210801700000,SW 404,Residential,17000,0,17000,77087,0,94087
143210801800000,SW 404,Residential,17765,0,17765,54580,0,72345
143210801900000,SMALL RETAIL,Commercial,0,14629,14629,0,142642,157271
143210900100000,SCHOOL,Exempt,0,0,0,0,0,0
143211000100000,RESTAURANT,Commercial,0,90720,90720,0,126174,216894
143211000200000,SW 404,Residential,17000,0,17000,37018,0,54018
143211000300000,SW 404,Residential,17000,0,17000,55657,0,72657
143211000400000,SW 404,Residential,17000,0,17000,47477,0,64477
143211000500000,SW 404,Residential,20400,0,20400,46704,0,67104
143211000600000,SW 404,Residential,20400,0,20400,72628,0,93028
143211000700000,SW 404,Residential,17000,0,17000,68625,0,85625
143211000800000,SW 404,Residential,17000,0,17000,71262,0,88262
143211000900000,SW 404,Residential,20400,0,20400,78071,0,98471
143211001000000,SW 404,Residential,20400,0,20400,70594,0,90994
143211001100000,SW 404,Residential,17000,0,17000,82978,0,99978
143211001200000,SW 404,Residential,17000,0,17000,60243,0,77243
143211001300000,SW 404,Residential,17000,0,17000,75560,0,92560
143211001400000,SW 404,Residential,17000,0,17000,62271,0,79271
143211001500000,SW 404,Residential,17000,0,17000,54552,0,71552
143211001600000,SW 404,Residential,17000,0,17000,94109,0,111109
143211001700000,SW 404,Residential,17000,0,17000,95284,0,112284
143211001800000,SW 404,Residential,17000,0,17000,35089,0,52089
143211001900000,SW 404,Residential,17000,0,17000,49110,0,66110
143211002000000,SW 404,Residential,17000,0,17000,61022,0,78022
143211002100000,SW 404,Residential,17000,0,17000,67587,0,84587
143211002200000,SW 404,Residential,17000,0,17000,64970,0,81970
143211002300000,AUTO REPAIR/SALES,Commercial,0,90720,90720,0,61576,152296
143211100100000,CHURCH,Exempt,0,21546,21546,0,5940,27486
143211100200000,SW 404,Exempt,0,20400,20400,0,124669,145069
143211100300000,CHURCH,Exempt,0,20844,20844,0,360030,380874
143211100400000,SW 404,Residential,14212,0,14212,65153,0,79365
143211100500000,SW 404,Residential,20188,0,20188,78873,0,99061
143211100600000,SW 404,Residential,17000,0,17000,70869,0,87869
143211100700000,SW 404,Residential,20400,0,20400,121813,0,142213
143211100800000,SW 404,Residential,20400,0,20400,114869,0,135269
143211100900000,SW 404,Residential,17000,0,17000,88684,0,105684
143211101000000,SW 404,Residential,17765,0,17765,79395,0,97160
143211200100000,SW 404,Residential,18088,0,18088,66283,0,84371
143211200200000,SW 404,Residential,20400,0,20400,63642,0,84042
143211200300000,SW 404,Residential,20400,0,20400,71685,0,92085
143211200400000,SW 404,Residential,17000,0,17000,78897,0,95897
143211200500000,SW 404,Residential,18564,0,18564,70043,0,88607
143211200600000,SW 404,Residential,15504,0,15504,60492,0,75996
143211200700000,SW 404,Residential,18088,0,18088,70926,0,89014
143212600100000,SW 404,Residential,15000,0,15000,55658,0,70658
143212600200000,SW 404,Residential,15000,0,15000,79631,0,94631
143212600300000,SW 404,Residential,15000,0,15000,54758,0,69758
143212600400000,SW 404,Residential,15000,0,15000,53189,0,68189
143212600500000,SW 404,Residential,15000,0,15000,64461,0,79461
143212600600000,SW 404,Residential,22500,0,22500,73061,0,95561
143212600700000,SW 404,Residential,19500,0,19500,89164,0,108664
143212700100000,SW 404,Residential,16575,0,16575,75833,0,92408
143212700200000,SW 404,Residential,10500,0,10500,43452,0,53952
143212700300000,SW 404,Residential,15000,0,15000,45939,0,60939
143212700400000,SW 404,Residential,15000,0,15000,68891,0,83891
143212700500000,SW 404,Residential,15000,0,15000,39172,0,54172
143212700600000,SW 404,Residential,15000,0,15000,25170,0,40170
143212700700000,SW 404,Residential,15000,0,15000,84964,0,99964
143212700800000,SW 404,Residential,15000,0,15000,44492,0,59492
143212700900000,VACANT LAND,Commercial,0,18144,18144,0,0,18144
143212701000000,VACANT LAND,Commercial,0,18144,18144,0,0,18144
143212701100000,SW 404,Residential,15000,0,15000,101112,0,116112
143212701200000,SW 404,Residential,15000,0,15000,85983,0,100983
143212701300000,SW 404,Residential,15000,0,15000,80562,0,95562
143212800200000,MISCELLANEOUS,Commercial,0,43186,43186,0,22216,65402
143212800300000,CENTRALLY ASSESSED,Other,0,0,0,0,0,0
143212900100000,SW 404,Residential,18000,0,18000,74312,0,92312
143212900200000,SW 404,Residential,15000,0,15000,51033,0,66033
143212900300000,SW 404,Residential,15000,0,15000,47730,0,62730
143212900400000,SW 404,Residential,15000,0,15000,51951,0,66951
143212900500000,SW 404,Residential,15000,0,15000,49558,0,64558
143212900600000,SW 404,Residential,15000,0,15000,97891,0,112891
143212900700000,SW 404,Residential,15000,0,15000,0,0,15000
143212900800000,SW 404,Residential,15000,0,15000,60557,0,75557
143212900900000,SW 404,Residential,15000,0,15000,44468,0,59468
143212901000000,SW 404,Residential,15000,0,15000,44878,0,59878
143212901100000,SW 404,Residential,15000,0,15000,44305,0,59305
143212901200000,SW 404,Residential,15000,0,15000,24225,0,39225
143212901300000,SW 404,Residential,15000,0,15000,43999,0,58999
143212901400000,SW 404,Residential,15000,0,15000,46205,0,61205
143212901500000,SW 404,Residential,15000,0,15000,84035,0,99035
143212901600000,SW 404,Residential,9000,0,9000,0,0,9000
143212901700000,SW 404,Residential,9000,0,9000,82714,0,91714
143212901800000,SW 404,Residential,15000,0,15000,64569,0,79569
143213000100000,SW 404,Residential,15000,0,15000,75029,0,90029
143213000200000,SW 404,Residential,15000,0,15000,89404,0,104404
143213000300000,SW 404,Residential,9000,0,9000,63183,0,72183
143213000400000,SW 404,Residential,9000,0,9000,0,0,9000
143213000500000,SW 404,Residential,15000,0,15000,76501,0,91501
143213000600000,SW 404,Residential,18000,0,18000,28638,0,46638
143213000700000,SW 404,Residential,18000,0,18000,45070,0,63070
143213000800000,SW 404,Residential,15000,0,15000,0,0,15000
143213000900000,SW 404,Residential,15000,0,15000,36322,0,51322
143213001000000,SW 404,Residential,15000,0,15000,12540,0,27540
143213001100000,SW 404,Residential,15000,0,15000,24814,0,39814
143213001200000,SW 404,Residential,15000,0,15000,50307,0,65307
143213001300000,SW 404,Residential,15000,0,15000,63206,0,78206
143213001400000,SW 404,Residential,15000,0,15000,56139,0,71139
143213001500000,VACANT LAND,Commercial,0,18144,18144,0,0,18144
143213001600000,SW 404,Residential,18000,0,18000,99388,0,117388
143213001700000,SW 404,Residential,15000,0,15000,64465,0,79465
143213001800000,SW 404,Residential,18000,0,18000,66095,0,84095
143213001900000,SW 404,Residential,18000,0,18000,72515,0,90515
143213002000000,SW 404,Residential,15000,0,15000,26292,0,41292
143213002100000,SW 404,Residential,15000,0,15000,35399,0,50399
143213002200000,SW 404,Residential,17719,0,17719,56620,0,74339
143213100100000,VACANT LAND,Commercial,0,9765,9765,0,0,9765
143213100200000,SMALL RETAIL,Commercial,0,191700,191700,0,422760,614460
143213100300000,VACANT LAND,Commercial,0,14580,14580,0,0,14580
143213200100000,SW 404,Residential,15000,0,15000,39132,0,54132
143213200200000,SW 404,Residential,15000,0,15000,0,0,15000
143213200300000,SW 404,Residential,15000,0,15000,62937,0,77937
143213200400000,SW 404,Residential,15000,0,15000,56205,0,71205
143213200500000,SW 404,Residential,15000,0,15000,73672,0,88672
143213200600000,SW 404,Residential,15000,0,15000,0,0,15000
143213200700000,SW 404,Residential,15000,0,15000,53539,0,68539
143213200800000,SW 404,Residential,15000,0,15000,63728,0,78728
143213200900000,SW 404,Residential,17000,0,17000,74839,0,91839
143213201000000,SW 404,Residential,17000,0,17000,65832,0,82832
143213201100000,SW 404,Residential,17000,0,17000,72816,0,89816
143213201200000,SW 404,Residential,17000,0,17000,71579,0,88579
143213201300000,SW 404,Residential,17000,0,17000,46151,0,63151
143213201400000,SCHOOL,Exempt,0,0,0,0,0,0
143213201500000,VACANT LAND,Exempt,0,0,0,0,0,0
143213300100000,SW 404,Residential,15000,0,15000,72027,0,87027
143213300200000,SW 404,Residential,15000,0,15000,49157,0,64157
143213300300000,SW 404,Residential,15000,0,15000,49954,0,64954
143213300400000,SW 404,Residential,15000,0,15000,36559,0,51559
143213300500000,SW 404,Residential,15000,0,15000,60943,0,75943
143213300600000,SW 404,Residential,15000,0,15000,63950,0,78950
143213300700000,SW 404,Residential,15000,0,15000,83976,0,98976
143213300800000,SW 404,Residential,15000,0,15000,43549,0,58549
143213300900000,WAREHOUSE;MINI STORG,Commercial,0,84240,84240,0,197541,281781
143213301000000,SW 404,Residential,17000,0,17000,5515,0,22515
143213301100000,SW 404,Residential,17000,0,17000,89154,0,106154
143213301200000,SW 404,Residential,17000,0,17000,83241,0,100241
143213301300000,SW 404,Residential,17000,0,17000,51740,0,68740
143213301400000,SW 404,Residential,17000,0,17000,48818,0,65818
143213301500000,SW 404,Residential,17000,0,17000,73396,0,90396
143213301600000,SW 404,Residential,17000,0,17000,41098,0,58098
143213301700000,SW 404,Residential,17000,0,17000,40113,0,57113
143213301800000,SW 404,Residential,17000,0,17000,55024,0,72024
143213301900000,SW 404,Residential,20400,0,20400,71189,0,91589
143213302000000,SW 404,Residential,17000,0,17000,51248,0,68248
143213302100000,SW 404,Residential,17000,0,17000,44374,0,61374
143213400100000,SW 404,Residential,17000,0,17000,39358,0,56358
143213400200000,SW 404,Residential,25500,0,25500,85387,0,110887
143213400300000,SW 404,Residential,17000,0,17000,51529,0,68529
143213400400000,SW 404,Residential,19507,0,19507,49063,0,68570
143213400500000,SW 404,Residential,19507,0,19507,76386,0,95893
143213400600000,SW 404,Residential,17000,0,17000,20524,0,37524
143213400700000,SW 404,Residential,17000,0,17000,27376,0,44376
143213400800000,SW 404,Residential,19807,0,19807,70193,0,90000
143213400900000,SW 404,Residential,21080,0,21080,79684,0,100764
143213500100000,SW 404,Residential,17000,0,17000,47549,0,64549
143213500200000,SW 404,Residential,17212,0,17212,92844,0,110056
143213500300000,SW 404,Residential,14875,0,14875,51497,0,66372
143213500400000,SW 404,Residential,20400,0,20400,82196,0,102596
143213500500000,SW 404,Residential,20400,0,20400,127537,0,147937
143213500600000,SW 404,Residential,17000,0,17000,59908,0,76908
143213500700000,SW 404,Residential,17000,0,17000,61103,0,78103
143213500800000,SW 404,Residential,17000,0,17000,83191,0,100191
143213500900000,SW 404,Residential,14960,0,14960,48120,0,63080
143213501000000,SW 404,Residential,11900,0,11900,63813,0,75713
143213501100000,SW 404,Residential,15470,0,15470,55364,0,70834
143213501200000,SW 404,Residential,17000,0,17000,54403,0,71403
143213501300000,SW 404,Residential,17000,0,17000,45730,0,62730
143213501400000,SW 404,Residential,17000,0,17000,60516,0,77516
143213501500000,SW 404,Residential,17000,0,17000,49046,0,66046
143213501600000,SW 404,Residential,17000,0,17000,64203,0,81203
143213501700000,SW 404,Residential,17000,0,17000,91637,0,108637
143213501800000,SW 404,Residential,17000,0,17000,65435,0,82435
143213600100000,SW 404,Residential,20400,0,20400,55513,0,75913
143213600200000,SW 404,Residential,17000,0,17000,124627,0,141627
143213600300000,SW 404,Residential,17000,0,17000,72791,0,89791
143213600400000,SW 404,Residential,17000,0,17000,58434,0,75434
143213600500000,SW 404,Residential,17000,0,17000,61288,0,78288
143213600600000,SW 404,Residential,17212,0,17212,79063,0,96275
143213600700000,SW 404,Residential,19125,0,19125,95839,0,114964
143213600800000,SW 404,Residential,17000,0,17000,60189,0,77189
143213600900000,SW 404,Residential,17000,0,17000,57690,0,74690
143213601000000,SW 404,Residential,17000,0,17000,63172,0,80172
143213601100000,SW 404,Residential,17000,0,17000,57532,0,74532
143213601200000,SW 404,Residential,17000,0,17000,65931,0,82931
143213601300000,SW 404,Residential,17000,0,17000,58136,0,75136
143213601400000,SW 404,Residential,17000,0,17000,65707,0,82707
143213601500000,SW 404,Residential,17000,0,17000,101436,0,118436
143213601600000,SW 404,Residential,17000,0,17000,12590,0,29590
143213601700000,SW 404,Residential,17000,0,17000,53426,0,70426
143213601800000,SW 404,Residential,17000,0,17000,47130,0,64130
143213601900000,SW 404,Residential,17000,0,17000,52048,0,69048
143213602000000,SW 404,Residential,17000,0,17000,47651,0,64651
143213602100000,SW 404,Residential,17000,0,17000,45590,0,62590
143213602200000,SW 404,Residential,20400,0,20400,46288,0,66688
143213602300000,SW 404,Residential,17000,0,17000,86103,0,103103
143213700100000,SW 404,Residential,17000,0,17000,60691,0,77691
143213700200000,SW 404,Residential,17000,0,17000,30673,0,47673
143213700300000,SW 404,Residential,17000,0,17000,78140,0,95140
143213700400000,SW 404,Residential,17000,0,17000,46625,0,63625
143213700500000,SW 404,Residential,17000,0,17000,85456,0,102456
143213700600000,SW 404,Residential,19507,0,19507,50495,0,70002
143213700700000,SW 404,Residential,19507,0,19507,62425,0,81932
143213700800000,SW 404,Residential,17000,0,17000,93804,0,110804
143213700900000,SW 404,Residential,17000,0,17000,37612,0,54612
143213701000000,SW 404,Residential,17000,0,17000,53377,0,70377
143213701100000,SW 404,Residential,17000,0,17000,58381,0,75381
143213701200000,SW 404,Residential,17000,0,17000,48688,0,65688
143215100100000,SW 404,Residential,20400,0,20400,65811,0,86211
143215100200000,SW 404,Residential,20400,0,20400,84410,0,104810
143215100300000,SW 404,Residential,17000,0,17000,18048,0,35048
143215100400000,SW 404,Residential,17000,0,17000,20115,0,37115
143215100500000,SW 404,Residential,17000,0,17000,59223,0,76223
143215100600000,SW 404,Residential,17000,0,17000,56771,0,73771
143215100700000,SW 404,Residential,17000,0,17000,51273,0,68273
143215100800000,SW 404,Residential,17000,0,17000,59713,0,76713
143215100900000,SW 404,Residential,17000,0,17000,56625,0,73625
143215101000000,SW 404,Residential,17000,0,17000,64674,0,81674
143215101100000,SW 404,Residential,17000,0,17000,57414,0,74414
143215101200000,SW 404,Residential,17000,0,17000,53336,0,70336
143215101300000,SW 404,Residential,17000,0,17000,55311,0,72311
143215101400000,SW 404,Residential,17000,0,17000,49435,0,66435
143215101500000,SW 404,Residential,17000,0,17000,62673,0,79673
143215101600000,SW 404,Residential,20400,0,20400,72327,0,92727
143215101700000,SW 404,Residential,20400,0,20400,51444,0,71844
143215200100000,SW 404,Residential,17000,0,17000,33198,0,50198
143215200200000,SW 404,Residential,17000,0,17000,62849,0,79849
143215200300000,SW 404,Residential,17000,0,17000,66074,0,83074
143215200400000,SW 404,Residential,17000,0,17000,58725,0,75725
143215200500000,SW 404,Residential,17000,0,17000,44631,0,61631
143215200600000,SW 404,Residential,20400,0,20400,71285,0,91685
143215200700000,SW 404,Residential,17000,0,17000,44932,0,61932
143215200800000,SW 404,Residential,17000,0,17000,84918,0,101918
143215200900000,SW 404,Residential,17000,0,17000,50555,0,67555
143215201000000,SW 404,Residential,17000,0,17000,43477,0,60477
143215201100000,SW 404,Residential,17000,0,17000,59345,0,76345
143215201200000,SW 404,Residential,17000,0,17000,41116,0,58116
143215201300000,SW 404,Residential,17000,0,17000,77641,0,94641
143215201400000,SW 404,Residential,17000,0,17000,69052,0,86052
143215201500000,SW 404,Residential,17000,0,17000,72764,0,89764
143215201600000,SW 404,Residential,17000,0,17000,105782,0,122782
143215201700000,SW 404,Residential,17000,0,17000,118660,0,135660
143215201800000,SW 404,Residential,20400,0,20400,83343,0,103743
143215201900000,SW 404,Residential,17000,0,17000,77025,0,94025
143215202000000,SW 404,Residential,17000,0,17000,43004,0,60004
143215202100000,SW 404,Residential,17000,0,17000,29923,0,46923
143215202200000,SW 404,Residential,17000,0,17000,67458,0,84458
143215202300000,SW 404,Residential,20400,0,20400,17928,0,38328
143215300100000,SW 404,Residential,17000,0,17000,76110,0,93110
143215300200000,SW 404,Residential,17000,0,17000,52570,0,69570
143215300300000,SW 404,Residential,17000,0,17000,39804,0,56804
143215300400000,SW 404,Residential,17000,0,17000,46488,0,63488
143215300500000,SW 404,Residential,17000,0,17000,44174,0,61174
143215300600000,SW 404,Residential,19507,0,19507,71466,0,90973
143215300700000,SW 404,Residential,15776,0,15776,52962,0,68738
143215300800000,SW 404,Residential,17000,0,17000,40947,0,57947
143215300900000,SW 404,Residential,17000,0,17000,52677,0,69677
143215301000000,SW 404,Residential,17000,0,17000,47388,0,64388
143215301100000,SW 404,Residential,17000,0,17000,59245,0,76245
143215400100000,SW 404,Residential,20400,0,20400,58558,0,78958
143215400200000,SW 404,Residential,17000,0,17000,38026,0,55026
143215400300000,SW 404,Residential,20400,0,20400,61462,0,81862
143215400400000,SW 404,Residential,20400,0,20400,64448,0,84848
143215400500000,SW 404,Residential,17000,0,17000,51425,0,68425
143215400600000,SW 404,Residential,20400,0,20400,114226,0,134626
143215400700000,SW 404,Residential,20400,0,20400,104004,0,124404
143215400800000,SW 404,Residential,17000,0,17000,45418,0,62418
143215400900000,SW 404,Residential,17000,0,17000,102423,0,119423
143215401000000,SW 404,Residential,17000,0,17000,39395,0,56395
143215401100000,SW 404,Residential,20400,0,20400,85088,0,105488
143215401200000,SW 404,Residential,17000,0,17000,75665,0,92665
143215401300000,SW 404,Residential,17000,0,17000,67491,0,84491
143215401400000,SW 404,Residential,20400,0,20400,62728,0,83128
143215500100000,SW 404,Residential,17000,0,17000,81046,0,98046
143215500200000,SW 404,Residential,20400,0,20400,0,0,20400
143215500300000,SW 404,Residential,20400,0,20400,85682,0,106082
143215500400000,SW 404,Residential,17000,0,17000,48714,0,65714
143215500500000,SW 404,Residential,17000,0,17000,86507,0,103507
143215500600000,SW 404,Residential,17000,0,17000,40920,0,57920
143215500700000,SW 404,Residential,17000,0,17000,51196,0,68196
143215500800000,SW 404,Residential,17000,0,17000,48282,0,65282
143215500900000,SW 404,Residential,17000,0,17000,52759,0,69759
143215501000000,SW 404,Residential,20400,0,20400,58888,0,79288
143215501100000,SW 404,Residential,25500,0,25500,85539,0,111039
143215501200000,SW 404,Residential,10200,0,10200,0,0,10200
143215501300000,SW 404,Residential,10200,0,10200,48245,0,58445
143215501400000,SW 404,Residential,20400,0,20400,48318,0,68718
143215501500000,SW 404,Residential,17000,0,17000,64715,0,81715
143215501600000,SW 404,Residential,20400,0,20400,44726,0,65126
143215501700000,SW 404,Residential,17000,0,17000,74578,0,91578
143215501800000,SW 404,Residential,17000,0,17000,54919,0,71919
143215501900000,SW 404,Residential,17000,0,17000,73793,0,90793
143215600100000,SW 404,Residential,17000,0,17000,38389,0,55389
143215600200000,SW 404,Residential,17000,0,17000,32728,0,49728
143215600300000,SW 404,Residential,20400,0,20400,32489,0,52889
143215600400000,SW 404,Residential,17000,0,17000,45364,0,62364
143215600500000,SW 404,Residential,18966,0,18966,77988,0,96954
143215600600000,SW 404,Residential,19623,0,19623,108108,0,127731
143215600700000,SW 404,Residential,20400,0,20400,20225,0,40625
143215600800000,SW 404,Residential,17000,0,17000,45733,0,62733
143215600900000,SW 404,Residential,17000,0,17000,51457,0,68457
143215601000000,SW 404,Residential,17000,0,17000,52851,0,69851
143215700100000,SW 404,Residential,20400,0,20400,49444,0,69844
143215700200000,SW 404,Residential,17000,0,17000,83655,0,100655
143215700300000,SW 404,Residential,17000,0,17000,51819,0,68819
143215700400000,SW 404,Residential,17000,0,17000,51449,0,68449
143215700500000,SW 404,Residential,17000,0,17000,31483,0,48483
143215700600000,SW 404,Residential,17000,0,17000,42845,0,59845
143215700700000,SW 404,Residential,16957,0,16957,63888,0,80845
143215700800000,SW 404,Residential,16957,0,16957,67052,0,84009
143215700900000,SW 404,Residential,15000,0,15000,46311,0,61311
143215701000000,SW 404,Residential,22500,0,22500,62015,0,84515
143215701100000,SW 404,Residential,15000,0,15000,52348,0,67348
143215701200000,SW 404,Residential,15000,0,15000,88926,0,103926
143215701300000,SW 404,Residential,15000,0,15000,63802,0,78802
143215701400000,SW 404,Residential,15000,0,15000,89579,0,104579
143215701500000,SW 404,Residential,15000,0,15000,77683,0,92683
143215800100000,SW 404,Residential,17000,0,17000,60196,0,77196
143215800200000,SW 404,Residential,20400,0,20400,64448,0,84848
143215800300000,SW 404,Residential,19337,0,19337,76059,0,95396
143215800400000,SW 404,Residential,19337,0,19337,113590,0,132927
143215800500000,SW 404,Residential,17000,0,17000,83540,0,100540
143215800600000,SW 404,Residential,17000,0,17000,79625,0,96625
143215800700000,SW 404,Residential,17000,0,17000,91555,0,108555
143215800800000,SW 404,Residential,17000,0,17000,34390,0,51390
143215800900000,SW 404,Residential,17000,0,17000,44508,0,61508
143215801000000,SW 404,Residential,17000,0,17000,39924,0,56924
143215801100000,SW 404,Residential,17000,0,17000,64957,0,81957
143215801200000,SW 404,Residential,15000,0,15000,59967,0,74967
143215801300000,SW 404,Residential,15000,0,15000,47887,0,62887
143215801400000,SW 404,Residential,18000,0,18000,55873,0,73873
143215801600000,SW 404,Residential,18000,0,18000,92360,0,110360
143215801700000,SW 404,Residential,15000,0,15000,69889,0,84889
143215801800000,SW 404,Residential,15000,0,15000,37671,0,52671
143215801900000,SW 404,Residential,15000,0,15000,66867,0,81867
143215802000000,SW 404,Residential,15000,0,15000,4812,0,19812
143215802100000,SW 404,Residential,15000,0,15000,60779,0,75779
143215802200000,SW 404,Residential,15000,0,15000,71115,0,86115
143215802300000,SW 404,Residential,15000,0,15000,49026,0,64026
143215900100000,SW 404,Residential,20400,0,20400,74855,0,95255
143215900200000,SW 404,Residential,17000,0,17000,51754,0,68754
143215900300000,SW 404,Residential,20400,0,20400,49739,0,70139
143215900400000,SW 404,Residential,19507,0,19507,82094,0,101601
143215900500000,SW 404,Residential,16807,0,16807,75574,0,92381
143215900600000,SW 404,Residential,15000,0,15000,55171,0,70171
143215900700000,SW 404,Residential,18000,0,18000,89209,0,107209
143215900800000,SW 404,Residential,18000,0,18000,107955,0,125955
143216000100000,SW 404,Residential,18816,0,18816,3680,0,22496
143216000200000,SW 404,Residential,17640,0,17640,56255,0,73895
143216000300000,SW 404,Residential,14700,0,14700,65512,0,80212
143216000400000,SW 404,Residential,14700,0,14700,29739,0,44439
143216000500000,SW 404,Residential,17640,0,17640,62914,0,80554
143216000600000,SW 404,Residential,14700,0,14700,100230,0,114930
143216000700000,SW 404,Residential,17640,0,17640,46127,0,63767
143216100100000,SW 404,Residential,14700,0,14700,44164,0,58864
143216100200000,SW 404,Residential,14700,0,14700,77145,0,91845
143216100300000,SW 404,Residential,17640,0,17640,86523,0,104163
143216100500000,SW 404,Residential,17640,0,17640,97342,0,114982
143216100600000,SW 404,Residential,18816,0,18816,62422,0,81238
143216100700000,SW 404,Residential,15680,0,15680,73858,0,89538
143216100800000,SW 404,Residential,14700,0,14700,29520,0,44220
143216100900000,SW 404,Residential,14700,0,14700,40414,0,55114
143216101000000,SW 404,Residential,18816,0,18816,65657,0,84473
143216200100000,SW 404,Residential,17685,0,17685,41477,0,59162
143216200200000,SW 404,Residential,15680,0,15680,50958,0,66638
143216200300000,SW 404,Residential,14700,0,14700,68570,0,83270
143216200400000,SW 404,Residential,18816,0,18816,75751,0,94567
143216200500000,SW 404,Residential,17346,0,17346,113625,0,130971
143217600100000,OFFICE,Commercial,0,90720,90720,0,181075,271795
143217600200000,SW 404,Residential,17000,0,17000,60808,0,77808
143217600300000,SW 404,Residential,17000,0,17000,83151,0,100151
143217600400000,SW 404,Residential,17000,0,17000,58780,0,75780
143217600500000,SW 404,Residential,17000,0,17000,63022,0,80022
143217600600000,SW 404,Residential,17000,0,17000,99572,0,116572
143217600700000,SW 404,Residential,20400,0,20400,94121,0,114521
143217600800000,SW 404,Residential,17000,0,17000,97400,0,114400
143217600900000,SW 404,Residential,17000,0,17000,48439,0,65439
143217601000000,SW 404,Residential,17000,0,17000,63380,0,80380
143217601100000,SW 404,Residential,12920,0,12920,76195,0,89115
143217601200000,SW 404,Residential,11475,0,11475,45515,0,56990
143217601300000,SW 404,Residential,14110,0,14110,64832,0,78942
143217601400000,SW 404,Residential,16150,0,16150,49640,0,65790
143217601500000,SW 404,Residential,14110,0,14110,47879,0,61989
143217601600000,SW 404,Residential,17000,0,17000,57286,0,74286
143217601700000,SW 404,Residential,17000,0,17000,128549,0,145549
143217601800000,SW 404,Residential,17000,0,17000,47109,0,64109
143217601900000,SW 404,Residential,17000,0,17000,65551,0,82551
143217602000000,SW 404,Residential,17000,0,17000,17231,0,34231
143217602100000,SW 404,Residential,20400,0,20400,59471,0,79871
143217602200000,SW 404,Residential,17000,0,17000,66843,0,83843
143217602300000,SW 404,Residential,17000,0,17000,41219,0,58219
143217602400000,SW 404,Residential,17000,0,17000,57540,0,74540
143217602500000,AUTO REPAIR/SALES,Commercial,0,90720,90720,0,100019,190739
143217700100000,SW 404,Residential,17765,0,17765,73547,0,91312
143217700200000,SW 404,Residential,17000,0,17000,55378,0,72378
143217700300000,SW 404,Residential,17000,0,17000,52982,0,69982
143217700400000,SW 404,Residential,17000,0,17000,57789,0,74789
143217700500000,SW 404,Residential,17000,0,17000,72037,0,89037
143217700600000,SW 404,Residential,17000,0,17000,45344,0,62344
143217700700000,SW 404,Residential,17000,0,17000,63647,0,80647
143217700800000,SW 404,Residential,17765,0,17765,99061,0,116826
143217700900000,SW 404,Residential,17627,0,17627,68626,0,86253
143217701000000,SW 404,Residential,17627,0,17627,101702,0,119329
143217701100000,SW 404,Residential,17000,0,17000,31073,0,48073
143217701200000,SW 404,Residential,17000,0,17000,63803,0,80803
143217701300000,SW 404,Residential,17000,0,17000,53457,0,70457
143217701400000,SW 404,Residential,20400,0,20400,102115,0,122515
143217701500000,SW 404,Residential,17765,0,17765,74277,0,92042
143217800100000,SW 404,Residential,21037,0,21037,68075,0,89112
143217800200000,SW 404,Residential,17000,0,17000,73463,0,90463
143217800300000,SW 404,Residential,17000,0,17000,77244,0,94244
143217800400000,SW 404,Residential,17000,0,17000,83347,0,100347
143217800500000,SW 404,Residential,17000,0,17000,75763,0,92763
143217800600000,SW 404,Residential,19125,0,19125,46683,0,65808
143217900100000,BRANCH BANK/CU,Commercial,0,120960,120960,0,210456,331416
143217900200000,FLAT PARKING,Commercial,0,30240,30240,0,2483,32723
143217900300000,SW 404,Residential,25500,0,25500,60650,0,86150
143217900400000,SW 404,Residential,20400,0,20400,68339,0,88739
143217900500000,SW 404,Residential,17000,0,17000,87676,0,104676
143217900600000,SW 404,Residential,17000,0,17000,80343,0,97343
143217900700000,SW 404,Residential,17000,0,17000,90427,0,107427
143217900800000,SW 404,Residential,17000,0,17000,87258,0,104258
143217900900000,SW 404,Residential,17000,0,17000,77729,0,94729
143217901000000,SW 404,Residential,20400,0,20400,72835,0,93235
143217901100000,SW 404,Residential,17000,0,17000,68693,0,85693
143217901200000,SW 404,Residential,17000,0,17000,73145,0,90145
143217901300000,SW 404,Residential,17000,0,17000,72687,0,89687
143217901400000,SW 404,Residential,17000,0,17000,74205,0,91205
143217901500000,SW 404,Residential,17000,0,17000,59160,0,76160
143217901600000,SW 404,Residential,17000,0,17000,51928,0,68928
143217901700000,SW 404,Residential,17000,0,17000,58659,0,75659
143217901800000,SW 404,Residential,17000,0,17000,53054,0,70054
143217901900000,SW 404,Residential,17000,0,17000,74978,0,91978
143217902000000,SW 404,Residential,17000,0,17000,37703,0,54703
143217902100000,SW 404,Residential,17000,0,17000,64687,0,81687
143217902200000,SW 404,Residential,34000,0,34000,68496,0,102496
143217902300000,SMALL RETAIL,Commercial,0,60480,60480,0,68242,128722
143218000100000,SW 404,Residential,13651,0,13651,69902,0,83553
143218000200000,SW 404,Residential,17000,0,17000,62895,0,79895
143218000300000,SW 404,Residential,17000,0,17000,49701,0,66701
143218000400000,SW 404,Residential,17000,0,17000,86668,0,103668
143218000500000,SW 404,Residential,17000,0,17000,65491,0,82491
143218000600000,SW 404,Residential,17000,0,17000,48957,0,65957
143218000700000,SW 404,Residential,17000,0,17000,107947,0,124947
143218000800000,SW 404,Residential,17765,0,17765,111613,0,129378
143218000900000,SW 404,Residential,17765,0,17765,59991,0,77756
143218001000000,SW 404,Residential,17000,0,17000,56136,0,73136
143218001100000,SW 404,Residential,17000,0,17000,43905,0,60905
143218001200000,SW 404,Residential,17000,0,17000,74591,0,91591
143218001300000,SW 404,Residential,20400,0,20400,72087,0,92487
143218001400000,SW 404,Residential,21420,0,21420,94739,0,116159
143218001500000,SW 404,Residential,13260,0,13260,40869,0,54129
143218100100000,SW 404,Residential,19125,0,19125,80532,0,99657
143218100300000,SW 404,Residential,17000,0,17000,90985,0,107985
143218100400000,SW 404,Residential,21037,0,21037,55622,0,76659
143218100500000,SW 404,Residential,17000,0,17000,81094,0,98094
143218100600000,SW 404,Residential,17000,0,17000,83134,0,100134
143218100700000,SW 404,Residential,20400,0,20400,107591,0,127991
143218200100000,FAST FOOD,Commercial,0,30240,30240,0,157965,188205
143218200200000,SW 404,Residential,17000,0,17000,40478,0,57478
143218200300000,SW 404,Residential,17000,0,17000,52882,0,69882
143218200400000,SW 404,Residential,17000,0,17000,50502,0,67502
143218200500000,SW 404,Residential,17000,0,17000,33505,0,50505
143218200600000,SW 404,Residential,17000,0,17000,51141,0,68141
143218200700000,SW 404,Residential,17000,0,17000,63590,0,80590
143218200800000,SW 404,Residential,17000,0,17000,43293,0,60293
143218200900000,SW 404,Residential,17000,0,17000,45934,0,62934
143218201000000,SW 404,Residential,17000,0,17000,75897,0,92897
143218201100000,SW 404,Residential,17000,0,17000,48484,0,65484
143218201200000,SW 404,Residential,17000,0,17000,29422,0,46422
143218201300000,SW 404,Residential,17000,0,17000,56023,0,73023
143218201400000,SW 404,Residential,17000,0,17000,64121,0,81121
143218201500000,SW 404,Residential,17000,0,17000,41796,0,58796
143218201600000,SW 404,Residential,16279,0,16279,40693,0,56972
143218201700000,SW 404,Residential,17410,0,17410,73350,0,90760
143218201800000,SW 404,Residential,17000,0,17000,73407,0,90407
143218201900000,SW 404,Residential,17000,0,17000,58474,0,75474
143218202000000,SW 404,Residential,17000,0,17000,42542,0,59542
143218202100000,SW 404,Residential,17000,0,17000,77886,0,94886
143218202200000,SW 404,Residential,17000,0,17000,78724,0,95724
143218202300000,SW 404,Residential,17000,0,17000,66593,0,83593
143218202400000,SW 404,Residential,17000,0,17000,62507,0,79507
143218202500000,SW 404,Residential,17000,0,17000,52452,0,69452
143218202600000,SW 404,Residential,17000,0,17000,51141,0,68141
143218202700000,SW 404,Residential,17000,0,17000,40368,0,57368
143218202800000,SW 404,Residential,17000,0,17000,103163,0,120163
143218202900000,SERVICE STATION,Commercial,0,60480,60480,0,59147,119627
143218300100000,SW 404,Residential,17765,0,17765,44043,0,61808
143218300200000,SW 404,Residential,17000,0,17000,70599,0,87599
143218300300000,SW 404,Residential,17000,0,17000,45864,0,62864
143218300400000,SW 404,Residential,17000,0,17000,45903,0,62903
143218300500000,SW 404,Residential,17000,0,17000,41478,0,58478
143218300600000,SW 404,Residential,17000,0,17000,64772,0,81772
143218300700000,SW 404,Residential,17000,0,17000,49843,0,66843
143218300800000,SW 404,Residential,13090,0,13090,72539,0,85629
143218300900000,SW 404,Residential,14280,0,14280,57767,0,72047
143218301000000,SW 404,Residential,20400,0,20400,67731,0,88131
143218301100000,SW 404,Residential,20400,0,20400,73452,0,93852
143218301200000,SW 404,Residential,17000,0,17000,84344,0,101344
143218301300000,SW 404,Residential,20400,0,20400,68454,0,88854
143218301400000,SW 404,Residential,17000,0,17000,71181,0,88181
143218301500000,SW 404,Residential,17765,0,17765,62275,0,80040
143218400100000,SW 404,Residential,19125,0,19125,48273,0,67398
143218400200000,SW 404,Residential,17000,0,17000,49633,0,66633
143218400300000,SW 404,Residential,15000,0,15000,47940,0,62940
143218400400000,SW 404,Residential,19125,0,19125,56158,0,75283
143218400500000,SW 404,Residential,17000,0,17000,36001,0,53001
143218400600000,SW 404,Residential,17000,0,17000,57517,0,74517
143218400700000,SW 404,Residential,20400,0,20400,89395,0,109795
143218400800000,SW 404,Residential,17000,0,17000,61129,0,78129
143218500100000,CENTRALLY ASSESSED,Other,0,0,0,0,0,0
143218500200000,CITY PROPERTY,Exempt,0,0,0,0,0,0
143218500300000,SW 404,Residential,15680,0,15680,55544,0,71224
143218500400000,SW 404,Residential,18346,0,18346,47155,0,65501
143218500500000,SW 404,Residential,16934,0,16934,103610,0,120544
143218500600000,SW 404,Residential,16660,0,16660,85852,0,102512
143218500700000,SW 404,Residential,15680,0,15680,55819,0,71499
143218500800000,SW 404,Residential,16660,0,16660,30900,0,47560
143218500900000,SW 404,Residential,15680,0,15680,49953,0,65633
143218501000000,SW 404,Residential,15680,0,15680,68079,0,83759
143218501100000,SW 404,Residential,15520,0,15520,52774,0,68294
143218501200000,SW 404,Residential,15520,0,15520,52699,0,68219
143218501300000,SW 404,Residential,16538,0,16538,62526,0,79064
143218501400000,SW 404,Residential,15565,0,15565,111571,0,127136
143218600100000,BRANCH BANK/CU,Commercial,0,67418,67418,0,314791,382209
143218600200000,SW 404,Residential,15520,0,15520,82917,0,98437
143218600300000,SW 404,Residential,15520,0,15520,21211,0,36731
143218600400000,SW 404,Residential,19555,0,19555,34834,0,54389
143218700100000,SW 404,Residential,21216,0,21216,60110,0,81326
143218700200000,SW 404,Residential,16848,0,16848,87070,0,103918
143220100100000,SW 404,Residential,19954,0,19954,56180,0,76134
143220200100000,VACANT LAND,Commercial,0,972,972,0,0,972
143220200200000,VACANT LAND,Commercial,0,38941,38941,0,0,38941
143220300100000,VACANT LAND,Commercial,0,30375,30375,0,0,30375
143220300200000,SHOP,Commercial,0,168750,168750,0,253970,422720
143220300300000,WAREHOUSE;MINI STORG,Commercial,0,339012,339012,0,766427,1105439
143220300400000,STATE PROPERTY,Exempt,0,0,0,0,0,0
143220400100000,SW 404,Residential,17000,0,17000,55247,0,72247
143220400200000,SW 404,Residential,17000,0,17000,50397,0,67397
143220400300000,SW 404,Residential,20400,0,20400,22049,0,42449
143220400400000,SW 404,Residential,17000,0,17000,60660,0,77660
143220400500000,SW 404,Residential,17000,0,17000,33250,0,50250
143220400600000,SW 404,Residential,17000,0,17000,74453,0,91453
143220400700000,SW 404,Residential,17000,0,17000,54377,0,71377
143220400800000,SW 404,Residential,13600,0,13600,75931,0,89531
143220400900000,SW 404,Residential,10200,0,10200,0,0,10200
143220401000000,SW 404,Residential,17000,0,17000,42107,0,59107
143220401100000,SW 404,Residential,17000,0,17000,52637,0,69637
143220401200000,SW 404,Residential,17000,0,17000,81627,0,98627
143220401300000,SW 404,Residential,17000,0,17000,88531,0,105531
143220401400000,SW 404,Residential,17000,0,17000,59484,0,76484
143220401500000,SW 404,Residential,17000,0,17000,79372,0,96372
143220401600000,SW 404,Residential,17000,0,17000,61490,0,78490
143220401700000,SW 404,Residential,17000,0,17000,38927,0,55927
143220401800000,SW 404,Residential,17000,0,17000,57635,0,74635
143220401900000,SW 404,Residential,17000,0,17000,64346,0,81346
143220402000000,SW 404,Residential,20400,0,20400,54663,0,75063
143220402100000,SW 404,Residential,20400,0,20400,44024,0,64424
143220500100000,STATE PROPERTY,Exempt,0,0,0,0,0,0
143220500200000,SW 404,Residential,26845,0,26845,76680,0,103525
143220500202000,BILLBOARD(BLL),Commercial,0,0,0,0,23304,23304
143220500300000,SW 404,Residential,19623,0,19623,47280,0,66903
143220500400000,SW 404,Residential,20373,0,20373,60055,0,80428
143220500500000,SW 404,Residential,17000,0,17000,79154,0,96154
143220500800000,SW 404,Residential,20400,0,20400,40208,0,60608
143220500900000,SW 404,Residential,17000,0,17000,66568,0,83568
143220501000000,SW 404,Residential,13728,0,13728,47016,0,60744
143220501100000,SW 404,Residential,14131,0,14131,43606,0,57737
143220501200000,SW 404,Residential,13728,0,13728,46498,0,60226
143220501300000,SW 404,Residential,19507,0,19507,75527,0,95034
143220501400000,SW 404,Residential,22525,0,22525,86198,0,108723
143220600100000,SW 404,Residential,20400,0,20400,52173,0,72573
143220600200000,SW 404,Residential,17000,0,17000,52876,0,69876
143220600300000,SW 404,Residential,20400,0,20400,45380,0,65780
143220600400000,SW 404,Residential,20400,0,20400,81465,0,101865
143220600500000,SW 404,Residential,17000,0,17000,56751,0,73751
143220600600000,SW 404,Residential,20400,0,20400,40305,0,60705
143220600700000,SW 404,Residential,17000,0,17000,83066,0,100066
143220600800000,SW 404,Residential,17000,0,17000,44145,0,61145
143220600900000,SW 404,Residential,20400,0,20400,86735,0,107135
143220601000000,SW 404,Residential,17000,0,17000,57740,0,74740
143220601100000,SW 404,Residential,17000,0,17000,99524,0,116524
143220601200000,SW 404,Residential,20400,0,20400,58840,0,79240
143220601300000,SW 404,Residential,17000,0,17000,61085,0,78085
143220601400000,SW 404,Residential,17000,0,17000,75175,0,92175
143220601500000,SW 404,Residential,17000,0,17000,109747,0,126747
143220601600000,SW 404,Residential,17000,0,17000,59073,0,76073
143220601700000,SW 404,Residential,17000,0,17000,49381,0,66381
143220601800000,SW 404,Residential,17000,0,17000,100200,0,117200
143220700100000,SW 404,Residential,17000,0,17000,65384,0,82384
143220700200000,SW 404,Residential,17000,0,17000,53200,0,70200
143220700300000,SW 404,Residential,17000,0,17000,42229,0,59229
143220700400000,SW 404,Residential,20400,0,20400,90295,0,110695
143220700500000,SW 404,Residential,17000,0,17000,81973,0,98973
143220700600000,SW 404,Residential,17000,0,17000,58948,0,75948
143220700700000,SW 404,Residential,20400,0,20400,11823,0,32223
143220700800000,SW 404,Residential,17000,0,17000,50592,0,67592
143220700900000,SW 404,Residential,20400,0,20400,56727,0,77127
143220701000000,SW 404,Residential,17000,0,17000,58913,0,75913
143220701100000,SW 404,Residential,22206,0,22206,94824,0,117030
143220701200000,SW 404,Residential,24834,0,24834,86867,0,111701
143220701300000,SW 404,Residential,17000,0,17000,0,0,17000
143220701400000,SW 404,Residential,25500,0,25500,90158,0,115658
143220701500000,SW 404,Residential,20400,0,20400,47405,0,67805
143220701600000,SW 404,Residential,20400,0,20400,62457,0,82857
143220701700000,SW 404,Residential,17000,0,17000,65477,0,82477
143220701800000,SW 404,Residential,17000,0,17000,55712,0,72712
143220701900000,SW 404,Residential,19869,0,19869,67382,0,87251
143220702000000,SW 404,Residential,20719,0,20719,66052,0,86771
143220702100000,SW 404,Residential,17000,0,17000,65496,0,82496
143220702200000,SW 404,Residential,20400,0,20400,57198,0,77598
143222600100000,SW 405,Residential,18400,0,18400,77159,0,95559
143222600200000,SW 405,Residential,18600,0,18600,80133,0,98733
143222600300000,SW 405,Residential,18800,0,18800,62477,0,81277
143222600400000,SW 405,Residential,19200,0,19200,81991,0,101191
143222600500000,SW 405,Residential,19400,0,19400,59394,0,78794
143222600600000,SW 405,Residential,19400,0,19400,84392,0,103792
143222600700000,SW 405,Residential,19200,0,19200,61952,0,81152
143222600800000,SW 405,Residential,19200,0,19200,65351,0,84551
143222600900000,SW 405,Residential,19000,0,19000,58816,0,77816
143222601000000,SW 405,Residential,18800,0,18800,52983,0,71783
143222601100000,SW 405,Residential,18600,0,18600,62816,0,81416
143222601200000,SW 405,Residential,18400,0,18400,54843,0,73243
143222601300000,SW 405,Residential,18200,0,18200,54943,0,73143
143222601400000,SW 405,Residential,18000,0,18000,75993,0,93993
143222601500000,SW 405,Residential,20664,0,20664,60042,0,80706
143222601600000,SW 405,Residential,20304,0,20304,58997,0,79301
143222601700000,SW 405,Residential,22614,0,22614,87291,0,109905
143222601800000,SW 405,Residential,21709,0,21709,65666,0,87375
143222601900000,SW 405,Residential,19817,0,19817,58769,0,78586
143222602000000,SW 405,Residential,20491,0,20491,60407,0,80898
143222602100000,BARS/LOUNGE,Commercial,0,58320,58320,0,179487,237807
143222602200000,RESTAURANT,Commercial,0,82620,82620,0,219981,302601
143222602300000,FLAT PARKING,Commercial,0,43740,43740,0,15937,59677
143222602400000,AUTO REPAIR/SALES,Commercial,0,162000,162000,0,196264,358264
143222602500000,CARWASH,Commercial,0,101149,101149,0,80949,182098
143222602502000,BILLBOARD(BLL),Commercial,0,0,0,0,57933,57933
143222602600000,FLAT PARKING,Commercial,0,44955,44955,0,1200,46155
143222602700000,STATE PROPERTY,Exempt,0,0,0,0,0,0
143222700100000,SW 405,Residential,19400,0,19400,85358,0,104758
143222700200000,SW 405,Residential,19969,0,19969,70304,0,90273
143222700300000,VACANT LAND,Commercial,0,29808,29808,0,0,29808
143222700400000,AUTO REPAIR/SALES,Commercial,0,94095,94095,0,115080,209175
143222800100000,SMALL RETAIL,Commercial,0,189810,189810,0,533002,722812
143222800200000,VACANT LAND,Commercial,0,66926,66926,0,0,66926
143222800300000,APARTMENT,Commercial,0,173137,173137,0,121052,294189
143222800400000,SW 405,Ag Land,8595,0,8595,0,0,8595
143222800500000,SW 405,Ag Dwelling,12668,0,12668,30854,2324,45846
143225100100000,WAREHOUSE,Commercial,0,253314,253314,0,42953,296267
143225100102001,BILLBOARD(BLL),Commercial,0,0,0,0,15217,15217
143225200300000,SW 405,Residential,38976,0,38976,92374,0,131350
143225200400000,SW 405,Residential,24860,0,24860,77817,0,102677
143225200500000,SW 405,Residential,22600,0,22600,67850,0,90450
143225200600000,SW 405,Residential,24640,0,24640,80292,0,104932
143225200700000,SW 405,Residential,28726,0,28726,58716,0,87442
143225300300000,SW 405,Residential,49199,0,49199,142273,0,191472
143225300400000,SW 405,Residential,32179,0,32179,0,0,32179
143225300500000,SW 405,Residential,35670,0,35670,125372,0,161042
143225300600000,SW 405,Residential,24548,0,24548,101887,0,126435
143225300700000,SW 405,Residential,23660,0,23660,103869,0,127529
143225300800000,SW 405,Residential,23660,0,23660,96113,0,119773
143225300900000,SW 405,Residential,27587,0,27587,62191,0,89778
143225301000000,SW 405,Residential,22400,0,22400,73923,0,96323
143225301100000,SW 405,Residential,22400,0,22400,0,0,22400
143225301200000,SW 405,Residential,22400,0,22400,124271,0,146671
143225301300000,SW 405,Residential,52667,0,52667,99809,0,152476
143225301400000,SW 405,Residential,30804,0,30804,58061,0,88865
143225301600000,WAREHOUSE,Commercial,0,37800,37800,0,88477,126277
143225301700000,SW 405,Residential,48358,0,48358,67850,0,116208
143225301800000,SW 405,Residential,46129,0,46129,87030,0,133159
143227600100000,SW 404,Residential,17000,0,17000,0,0,17000
143227600200000,SW 404,Residential,17000,0,17000,42315,0,59315
143227600300000,SW 404,Residential,20400,0,20400,97889,0,118289
143227600400000,SW 404,Residential,10200,0,10200,0,0,10200
143227600500000,SW 404,Residential,10200,0,10200,64532,0,74732
143227600600000,SW 404,Residential,17000,0,17000,49801,0,66801
143227600700000,SW 404,Residential,17000,0,17000,66537,0,83537
143227600800000,SW 404,Residential,20400,0,20400,73136,0,93536
143227600900000,SW 404,Residential,18411,0,18411,57874,0,76285
143227601000000,SW 404,Residential,12920,0,12920,58386,0,71306
143227601100000,SW 404,Residential,12920,0,12920,52376,0,65296
143227601200000,SW 404,Residential,17000,0,17000,60635,0,77635
143227601400000,SW 404,Residential,20400,0,20400,85434,0,105834
143227601500000,SW 404,Residential,20400,0,20400,54834,0,75234
143227601600000,SW 404,Residential,17000,0,17000,74204,0,91204
143227601700000,SW 404,Residential,17000,0,17000,49789,0,66789
143227601800000,SW 404,Residential,17000,0,17000,57415,0,74415
143227601900000,CITY PROPERTY,Exempt,0,0,0,0,0,0
143227602000000,SW 404,Residential,2125,0,2125,0,0,2125
143227602100000,SW 404,Residential,17000,0,17000,59995,0,76995
143227602200000,SW 404,Residential,17000,0,17000,0,0,17000
143227700100000,SW 404,Residential,20400,0,20400,58196,0,78596
143227700200000,SW 404,Residential,17000,0,17000,69776,0,86776
143227700300000,SW 404,Residential,20400,0,20400,73972,0,94372
143227700400000,SW 404,Residential,17000,0,17000,69371,0,86371
143227700500000,SW 404,Residential,17000,0,17000,88456,0,105456
143227700600000,SW 404,Residential,17000,0,17000,59993,0,76993
143227700700000,SW 404,Residential,17000,0,17000,49434,0,66434
143227700800000,SW 404,Residential,20400,0,20400,55633,0,76033
143227700900000,SW 404,Residential,21250,0,21250,56587,0,77837
143227701000000,SW 404,Residential,21250,0,21250,65702,0,86952
143227701100000,SW 404,Residential,21250,0,21250,85098,0,106348
143227701200000,SW 404,Residential,20952,0,20952,47001,0,67953
143227701300000,SW 404,Residential,20400,0,20400,85966,0,106366
143227701400000,SW 404,Residential,20400,0,20400,78378,0,98778
143227701500000,SW 404,Residential,20400,0,20400,77826,0,98226
143227701600000,SW 404,Residential,17000,0,17000,85380,0,102380
143227701700000,SW 404,Residential,20400,0,20400,89474,0,109874
143227701800000,SW 404,Residential,17000,0,17000,17404,0,34404
143227701900000,SW 404,Residential,8500,0,8500,0,0,8500
143227702000000,SW 404,Residential,17000,0,17000,100953,0,117953
143227702100000,SW 404,Residential,19125,0,19125,84254,0,103379
143227702200000,SW 404,Residential,18169,0,18169,100215,0,118384
143227800100000,SW 404,Residential,17000,0,17000,38006,0,55006
143227800200000,SW 404,Residential,20400,0,20400,36500,0,56900
143227800300000,CITY PROPERTY,Exempt,0,0,0,0,0,0
143227800400000,SW 404,Residential,20400,0,20400,76435,0,96835
143227800500000,SW 404,Residential,20400,0,20400,37191,0,57591
143227800600000,SW 404,Residential,20400,0,20400,56827,0,77227
143227800700000,SW 404,Residential,10200,0,10200,1045,0,11245
143227800800000,SW 404,Residential,10200,0,10200,76790,0,86990
143227800900000,SW 404,Residential,20400,0,20400,83947,0,104347
143227801000000,SW 404,Residential,17000,0,17000,81460,0,98460
143227801100000,SW 404,Residential,20400,0,20400,94784,0,115184
143227801200000,CITY PROPERTY,Exempt,0,0,0,0,0,0
143227801300000,SW 404,Residential,17000,0,17000,37904,0,54904
143227801400000,SW 404,Residential,20400,0,20400,63828,0,84228
143227801500000,SW 404,Residential,20400,0,20400,0,0,20400
143227801600000,SW 404,Residential,17000,0,17000,82068,0,99068
143227900100000,SW 404,Residential,17000,0,17000,71631,0,88631
143227900200000,SW 404,Residential,17000,0,17000,80451,0,97451
143227900300000,SW 404,Residential,17000,0,17000,31458,0,48458
143227900400000,SW 404,Residential,17000,0,17000,38993,0,55993
143227900500000,SW 404,Residential,17000,0,17000,28478,0,45478
143227900600000,SW 404,Residential,17000,0,17000,60706,0,77706
143227900700000,SW 404,Residential,17000,0,17000,56243,0,73243
143227900800000,SW 404,Residential,17000,0,17000,92080,0,109080
143227900900000,SW 404,Residential,17000,0,17000,74282,0,91282
143227901000000,SW 404,Residential,17000,0,17000,96652,0,113652
143227901100000,SW 404,Residential,23800,0,23800,124903,0,148703
143227901200000,SW 404,Residential,17000,0,17000,64868,0,81868
143227901300000,SW 404,Residential,17000,0,17000,81924,0,98924
143227901400000,SW 404,Residential,17000,0,17000,74982,0,91982
143227901700000,SW 404,Residential,19714,0,19714,46860,0,66574
143227901800000,SW 404,Residential,19386,0,19386,59575,0,78961
143227901900000,SW 404,Residential,20400,0,20400,65016,0,85416
143227902000000,SW 404,Residential,23375,0,23375,119368,0,142743
143227902100000,SW 404,Residential,17000,0,17000,61232,0,78232
143227902200000,SW 404,Residential,17000,0,17000,65083,0,82083
143227902300000,SW 404,Residential,17000,0,17000,70898,0,87898
143227902400000,SW 404,Residential,17000,0,17000,72723,0,89723
143227902500000,SW 404,Residential,17000,0,17000,35045,0,52045
143227902600000,SW 404,Residential,20400,0,20400,43630,0,64030
143227902700000,SW 404,Residential,17000,0,17000,72599,0,89599
143227902800000,SW 404,Residential,22100,0,22100,68016,0,90116
143227902900000,SW 404,Residential,17000,0,17000,76440,0,93440
143227903000000,SW 404,Residential,17000,0,17000,69039,0,86039
143227903100000,SW 404,Residential,17000,0,17000,50561,0,67561
143227903200000,SW 404,Residential,30000,0,30000,82478,0,112478
143228000100000,CITY PROPERTY,Exempt,0,0,0,0,0,0
143228000200000,SW 404,Residential,17000,0,17000,62201,0,79201
143228000300000,SW 404,Residential,25500,0,25500,35170,0,60670
143228000400000,SW 404,Residential,17000,0,17000,75764,0,92764
143228000500000,SW 404,Residential,15000,0,15000,76710,0,91710
143228000600000,SW 404,Residential,15000,0,15000,55153,0,70153
143228000700000,SW 404,Residential,15000,0,15000,74347,0,89347
143228000800000,SW 404,Residential,15000,0,15000,27448,0,42448
143228000900000,SW 404,Residential,15000,0,15000,62869,0,77869
143228001000000,SW 404,Residential,15000,0,15000,0,0,15000
143228100100000,SW 404,Residential,17000,0,17000,73248,0,90248
143228100200000,SW 404,Residential,17000,0,17000,83573,0,100573
143228100300000,SW 404,Residential,17000,0,17000,74144,0,91144
143228100400000,SW 404,Residential,22100,0,22100,75302,0,97402
143228100500000,SW 404,Residential,17000,0,17000,90435,0,107435
143228100600000,SW 404,Residential,17000,0,17000,99423,0,116423
143228100700000,SW 404,Residential,17000,0,17000,36969,0,53969
143228100800000,SW 404,Residential,17000,0,17000,43068,0,60068
143228100900000,SW 404,Residential,17000,0,17000,23902,0,40902
143228101000000,SW 404,Residential,17000,0,17000,97754,0,114754
143228101100000,SW 404,Residential,17000,0,17000,58919,0,75919
143228101200000,SW 404,Residential,17175,0,17175,27825,0,45000
143228101300000,SW 404,Residential,20400,0,20400,95345,0,115745
143228101400000,SW 404,Residential,20400,0,20400,92053,0,112453
143228101700000,SW 404,Residential,17600,0,17600,39165,0,56765
143228101800000,SW 404,Residential,19500,0,19500,75020,0,94520
143228101900000,SW 404,Residential,15000,0,15000,69811,0,84811
143228102000000,SW 404,Residential,15000,0,15000,59564,0,74564
143228102100000,SW 404,Residential,15000,0,15000,77454,0,92454
143228102200000,SW 404,Residential,15000,0,15000,69706,0,84706
143228102300000,SW 404,Residential,15000,0,15000,54309,0,69309
143228102400000,SW 404,Residential,15000,0,15000,30444,0,45444
143228102500000,SW 404,Residential,15000,0,15000,52785,0,67785
143228102600000,SW 404,Residential,15000,0,15000,74176,0,89176
143228102700000,SW 404,Residential,19500,0,19500,63075,0,82575
143228102800000,SW 404,Residential,15000,0,15000,41644,0,56644
143228102900000,SW 404,Residential,15000,0,15000,44768,0,59768
143228103000000,SW 404,Residential,15000,0,15000,54126,0,69126
143228103100000,SW 404,Residential,19500,0,19500,32412,0,51912
143228103200000,SW 404,Residential,22482,0,22482,85475,0,107957
143228200100000,CITY PROPERTY,Exempt,0,0,0,0,0,0
143228200200000,SW 404,Residential,15680,0,15680,57948,0,73628
143228200300000,SW 404,Residential,15680,0,15680,37842,0,53522
143228200400000,SW 404,Residential,15680,0,15680,74239,0,89919
143228200500000,SW 404,Residential,14700,0,14700,62171,0,76871
143228200600000,SW 404,Residential,15680,0,15680,64592,0,80272
143228200700000,SW 404,Residential,15680,0,15680,56286,0,71966
143228200800000,SW 404,Residential,14700,0,14700,29343,0,44043
143228200900000,SW 404,Residential,15680,0,15680,51275,0,66955
143228201200000,OFFICE,Exempt,0,49781,49781,0,148986,198767
143228300100000,SW 404,Residential,14700,0,14700,89763,0,104463
143228300200000,SW 404,Residential,14700,0,14700,73115,0,87815
143228300300000,SW 404,Residential,14700,0,14700,81932,0,96632
143228300400000,SW 404,Residential,10050,0,10050,35144,0,45194
143228300500000,SW 404,Residential,10720,0,10720,32396,0,43116
143228300600000,SW 404,Residential,10050,0,10050,36417,0,46467
143228300700000,SW 404,Residential,10720,0,10720,33956,0,44676
143228300900000,SW 404,Residential,20384,0,20384,94743,0,115127
143228301000000,SW 404,Residential,19800,0,19800,48915,0,68715
143228301100000,SW 404,Residential,10050,0,10050,34892,0,44942
143228301200000,SW 404,Residential,10050,0,10050,30722,0,40772
143228301300000,SW 404,Residential,10720,0,10720,37593,0,48313
143228301400000,SW 404,Residential,23520,0,23520,75090,0,98610
143228301500000,SW 404,Residential,19296,0,19296,42357,0,61653
143228301600000,SW 404,Residential,17085,0,17085,31887,0,48972
143228301700000,SW 404,Residential,21168,0,21168,80690,0,101858
143228301800000,SW 404,Residential,17339,0,17339,45837,0,63176
143230100100000,CENTRALLY ASSESSED,Other,0,0,0,0,0,0
143230100300000,VACANT LAND,Commercial,0,2291,2291,0,0,2291
143230100500000,WAREHOUSE,Commercial,0,299430,299430,0,2091091,2390521
143230100600000,COUNTY PROPERTY,Exempt,0,0,0,0,0,0
143230100700000,VACANT LAND,Commercial,0,273393,273393,0,0,273393
143232600100000,SMALL RETAIL,Commercial,0,139946,139946,0,252919,392865
143232600200000,SW 455,Residential,36920,0,36920,0,0,36920
143232600300000,SW 455,Residential,38588,0,38588,60322,0,98910
143232600400000,SW 455,Residential,30700,0,30700,37145,0,67845
143232700100000,CENTRALLY ASSESSED,Other,0,0,0,0,0,0
143232800100000,SW 455,Residential,25736,0,25736,30340,0,56076
143232800200000,SW 455,Residential,26940,0,26940,3060,0,30000
143232800300000,SW 455,Residential,17850,0,17850,63220,0,81070
143232800400000,SW 455,Residential,17850,0,17850,81088,0,98938
143232800500000,SW 455,Residential,17850,0,17850,71632,0,89482
143232800600000,SW 455,Residential,20400,0,20400,70790,0,91190
143232800700000,SW 455,Residential,30345,0,30345,92591,0,122936
143232800800000,SW 455,Residential,17850,0,17850,96360,0,114210
143232800900000,SW 455,Residential,12320,0,12320,49832,0,62152
143232801000000,SW 455,Residential,19342,0,19342,56889,0,76231
143232801100000,SW 455,Residential,29704,0,29704,63605,0,93309
143232801200000,SW 455,Residential,225,0,225,0,0,225
143232801300000,SW 455,Residential,24500,0,24500,62315,0,86815
143232801400000,SW 455,Residential,21309,0,21309,45558,0,66867
143232801500000,SW 455,Residential,16000,0,16000,79812,0,95812
143232801600000,SHOP,Commercial,0,325728,325728,0,712305,1038033
143232801700000,SW 455,Residential,35450,0,35450,1208,0,36658
143232801800000,SW 455,Residential,16000,0,16000,38256,0,54256
143235100100000,SW 418,Ag Land,33985,0,33985,0,0,33985
143235100300000,CENTRALLY ASSESSED,Other,0,0,0,0,0,0
143235200100000,SW 418,Ag Dwelling,15010,0,15010,106210,0,121220
143235200200000,CENTRALLY ASSESSED,Other,0,0,0,0,0,0
143237600200000,WAREHOUSE,Commercial,0,299106,299106,0,782119,1081225
143237600500000,VACANT LAND,Industrial,0,160920,160920,0,0,160920
143237600600000,VACANT LAND,Commercial,0,59400,59400,0,0,59400
143237600700000,VACANT LAND,Commercial,0,41918,41918,0,0,41918
143237600900000,VACANT LAND,Commercial,0,216574,216574,0,0,216574
143240100100000,EQUIPMENT MFG;INDUST,Industrial,0,491136,491136,0,3508864,4000000
143242600100000,EQUIPMENT MFG;INDUST,Industrial,0,422376,422376,0,1903257,2325633
143242600200000,CENTRALLY ASSESSED,Other,0,0,0,0,0,0
143242600300000,VACANT LAND,Industrial,0,59000,59000,0,0,59000
143242600400000,VACANT LAND,Industrial,0,150000,150000,0,0,150000
143242600500000,CENTRALLY ASSESSED,Other,0,0,0,0,0,0
143242600600000,WAREHOUSE,Commercial,0,47520,47520,0,53216,100736
143242600700000,OFFICE,Commercial,0,109728,109728,0,295235,404963
143242600900000,ANTENNAS/TOWERS(BLL),Commercial,0,108972,108972,0,460008,568980
143245100100000,WAREHOUSE,Commercial,0,365013,365013,0,1667614,2032627
143245100200000,WAREHOUSE,Commercial,0,172800,172800,0,212414,385214
143245100300000,OFFICE,Commercial,0,50855,50855,0,116024,166879
143245100400000,VACANT LAND,Commercial,0,31018,31018,0,0,31018
143245100500000,WAREHOUSE,Commercial,0,44635,44635,0,52139,96774
143245200100000,WAREHOUSE,Commercial,0,80179,80179,0,415779,495958
143245200200000,ANTENNAS/TOWERS(BLL),Commercial,0,71798,71798,0,489313,561111
143245200300000,WAREHOUSE,Commercial,0,107568,107568,0,377488,485056
143245200400000,WAREHOUSE,Commercial,0,71280,71280,0,260528,331808
143245200500000,FLAT PARKING,Commercial,0,30996,30996,0,1840,32836
143245200600000,SHOP,Commercial,0,101174,101174,0,273062,374236
143245200700000,BRANCH BANK/CU,Commercial,0,81821,81821,0,68179,150000
143245300100000,WAREHOUSE,Commercial,0,338526,338526,0,1487721,1826247
143245300200000,OFFICE,Commercial,0,181008,181008,0,476816,657824
143245400100000,OFFICE,Commercial,0,200448,200448,0,209433,409881
143245400200000,WAREHOUSE,Commercial,0,69444,69444,0,285574,355018
143245400300000,FLAT PARKING,Commercial,0,29700,29700,0,6600,36300
143245400400000,WAREHOUSE,Commercial,0,54000,54000,0,134276,188276
143245400500000,AUTO REPAIR/SALES,Commercial,0,45576,45576,0,110156,155732
143245400600000,WAREHOUSE,Commercial,0,262980,262980,0,261874,524854
143245400700000,WAREHOUSE,Commercial,0,122688,122688,0,302559,425247
143247600100000,WAREHOUSE,Commercial,0,660906,660906,0,2639852,3300758
143247600200000,VACANT LAND,Commercial,0,102546,102546,0,0,102546
143247600300000,SHOP,Commercial,0,221832,221832,0,1020542,1242374
143247700100000,AUTO REPAIR/SALES,Commercial,0,124740,124740,0,40298,165038
143247700200000,AUTO REPAIR/SALES,Commercial,0,140940,140940,0,411022,551962
143247700300000,VACANT LAND,Commercial,0,19440,19440,0,0,19440
143247700400000,AUTO REPAIR/SALES,Commercial,0,292885,292885,0,764246,1057131
143247700500000,WAREHOUSE,Commercial,0,80352,80352,0,301841,382193
143247700600000,WAREHOUSE,Commercial,0,80006,80006,0,71668,151674
143247700700000,FLAT PARKING,Commercial,0,191376,191376,0,15098,206474
143247800100000,SHOP,Commercial,0,88992,88992,0,302750,391742
143247800200000,WAREHOUSE,Commercial,0,87696,87696,0,34272,121968
143247800300000,VACANT LAND,Commercial,0,40565,40565,0,0,40565
143247800400000,SHOP,Commercial,0,23846,23846,0,62314,86160
143247800500000,FLAT PARKING,Commercial,0,42656,42656,0,9760,52416
143247800600000,VACANT LAND,Commercial,0,43416,43416,0,0,43416
143247800700000,FLAT PARKING,Commercial,0,19440,19440,0,1944,21384
143247800800000,AUTO REPAIR/SALES,Commercial,0,245700,245700,0,854300,1100000
143310100100000,CITY PROPERTY,Exempt,0,0,0,0,0,0
143310100200000,CITY PROPERTY,Exempt,0,0,0,0,0,0
143310100300000,CITY PROPERTY,Exempt,0,0,0,0,0,0
143310100400000,CITY PROPERTY,Exempt,0,0,0,0,0,0
143310100500000,CITY PROPERTY,Exempt,0,0,0,0,0,0
143310100600000,VACANT LAND,Commercial,0,60480,60480,0,0,60480
143310100700000,SW 402,Residential,15000,0,15000,0,0,15000
143310200100000,CITY PROPERTY,Exempt,0,0,0,0,0,0
143310200200000,CITY PROPERTY,Exempt,0,0,0,0,0,0
143310200300000,CITY PROPERTY,Exempt,0,0,0,0,0,0
143310200400000,SW 402,Residential,13200,0,13200,0,0,13200
143310200500000,CITY PROPERTY,Exempt,0,0,0,0,0,0
143310200600000,CITY PROPERTY,Exempt,0,0,0,0,0,0
143310300100000,SW 412,Residential,14437,0,14437,70196,0,84633
143310300200000,SW 412,Residential,14437,0,14437,35443,0,49880
143310300300000,CITY PROPERTY,Exempt,0,0,0,0,0,0
143310300400000,CITY PROPERTY,Exempt,0,0,0,0,0,0
143310300500000,CITY PROPERTY,Exempt,0,0,0,0,0,0
143310300600000,CITY PROPERTY,Exempt,0,0,0,0,0,0
143310300700000,SW 412,Residential,6000,0,6000,0,0,6000
143310300800000,SW 412,Residential,7219,0,7219,34550,0,41769
143310300900000,SW 412,Residential,7000,0,7000,0,0,7000
143310301000000,SW 412,Residential,23375,0,23375,52242,0,75617
143310301100000,SW 412,Residential,14875,0,14875,83403,0,98278
143310301200000,SW 412,Residential,14875,0,14875,84614,0,99489
143310301300000,SW 412,Residential,17000,0,17000,112980,0,129980
143310301400000,SW 412,Residential,23375,0,23375,66454,0,89829
143310301500000,SW 412,Residential,23375,0,23375,70953,0,94328
143310301600000,SW 412,Residential,23375,0,23375,71648,0,95023
143310301700000,SW 412,Residential,23375,0,23375,83060,0,106435
143310301800000,SW 412,Residential,23375,0,23375,104856,0,128231
143310400100000,CITY PROPERTY,Exempt,0,0,0,0,0,0
143310400200000,SW 402,Residential,11857,0,11857,25058,0,36915
143310400300000,SW 402,Residential,21165,0,21165,53170,0,74335
143310400400000,SW 402,Residential,25500,0,25500,64398,0,89898
143310400500000,SW 402,Residential,24769,0,24769,52969,0,77738
143310400600000,SW 402,Residential,10965,0,10965,48882,0,59847
143310400700000,SW 402,Residential,9945,0,9945,52243,0,62188
143310500100000,FLAT PARKING,Commercial,0,46267,46267,0,4896,51163
143310500200000,SW 412,Residential,20910,0,20910,60876,0,81786
143310500300000,BRANCH BANK/CU,Commercial,0,19582,19582,0,64846,84428
143310600100000,CITY PROPERTY,Exempt,0,0,0,0,0,0
143310600200000,SW 412,Residential,10944,0,10944,72993,0,83937
143310600300000,SW 412,Residential,10500,0,10500,64787,0,75287
143310600400000,SW 412,Residential,10500,0,10500,77007,0,87507
143310600500000,SW 412,Residential,10500,0,10500,70427,0,80927
143310600600000,SW 412,Residential,10500,0,10500,71008,0,81508
143310600700000,SW 412,Residential,10500,0,10500,85152,0,95652
143310600800000,SW 412,Residential,10500,0,10500,75314,0,85814
143310600900000,SW 412,Residential,10500,0,10500,66533,0,77033
143310601000000,SW 412,Residential,16912,0,16912,76850,0,93762
143310601100000,SW 412,Residential,14386,0,14386,58989,0,73375
143310601200000,SW 412,Residential,14450,0,14450,71442,0,85892
143310601300000,SW 412,Residential,14450,0,14450,62770,0,77220
143310601400000,SW 412,Residential,14450,0,14450,66149,0,80599
143310601500000,SW 412,Residential,14450,0,14450,64166,0,78616
143310601600000,SW 412,Residential,14450,0,14450,65438,0,79888
143310601700000,SW 412,Residential,14450,0,14450,52391,0,66841
143310601800000,CITY PROPERTY,Exempt,0,0,0,0,0,0
143310601900000,SW 412,Residential,10000,0,10000,0,0,10000
143310602000000,SW 412,Residential,14016,0,14016,68891,0,82907
143310602100000,SW 412,Residential,16353,0,16353,78594,0,94947
143310700100000,SCHOOL,Exempt,0,325728,325728,0,613535,939263
143310700200000,CONVERSION,Commercial,0,5533,5533,0,55644,61177
143310700300000,SW 412,Residential,14734,0,14734,32468,0,47202
143310700400000,SW 412,Residential,12745,0,12745,37740,0,50485
143310700500000,SW 412,Residential,15636,0,15636,46088,0,61724
143310700600000,CITY PROPERTY,Exempt,0,0,0,0,0,0
143310700700000,SW 412,Residential,17701,0,17701,44582,0,62283
143310700800000,SW 412,Residential,17701,0,17701,54833,0,72534
143310700900000,SW 412,Residential,17701,0,17701,47861,0,65562
143310701000000,SW 412,Residential,17701,0,17701,75290,0,92991
143310701100000,SW 412,Residential,17701,0,17701,45919,0,63620
143310800100000,SW 412,Residential,19825,0,19825,60974,0,80799
143310800200000,SW 412,Residential,19825,0,19825,84257,0,104082
143310800300000,SW 412,Residential,17701,0,17701,61689,0,79390
143310800400000,SW 412,Residential,14161,0,14161,74760,0,88921
143310800500000,SW 412,Residential,19291,0,19291,42633,0,61924
143310800600000,SW 412,Residential,18062,0,18062,53207,0,71269
143310800700000,SW 412,Residential,18062,0,18062,68247,0,86309
143310800800000,SW 412,Residential,18062,0,18062,78083,0,96145
143310800900000,SW 412,Residential,18062,0,18062,89332,0,107394
143310801000000,SW 412,Residential,18062,0,18062,58014,0,76076
143310801100000,SW 412,Residential,18062,0,18062,68438,0,86500
143310801200000,SW 412,Residential,17701,0,17701,75344,0,93045
143310801300000,SW 412,Residential,17701,0,17701,65405,0,83106
143310801400000,SW 412,Residential,17701,0,17701,71456,0,89157
143310801500000,SW 412,Residential,9500,0,9500,0,0,9500
143310801600000,SW 412,Residential,17701,0,17701,93617,0,111318
143310801700000,SW 412,Residential,15223,0,15223,49692,0,64915
143310801800000,SW 412,Residential,13099,0,13099,0,0,13099
143310801900000,CITY PROPERTY,Exempt,0,0,0,0,0,0
143310900100000,SW 412,Residential,14132,0,14132,95297,0,109429
143310900200000,SW 412,Residential,14270,0,14270,80916,0,95186
143310900300000,SW 412,Residential,14450,0,14450,82603,0,97053
143310900400000,SW 412,Residential,10000,0,10000,0,0,10000
143310900500000,SW 412,Residential,14450,0,14450,83842,0,98292
143310900600000,SW 412,Residential,14450,0,14450,69375,0,83825
143310900700000,SW 412,Residential,21241,0,21241,78467,0,99708
143310900800000,SW 412,Residential,18508,0,18508,63549,0,82057
143310900900000,SW 412,Residential,14883,0,14883,50921,0,65804
143310901000000,SW 412,Residential,14883,0,14883,74187,0,89070
143310901100000,SW 412,Residential,14883,0,14883,49995,0,64878
143310901200000,SW 412,Residential,14883,0,14883,70271,0,85154
143310901300000,SW 412,Residential,14883,0,14883,79023,0,93906
143310901400000,SW 412,Residential,14883,0,14883,81191,0,96074
143310901500000,SW 412,Residential,22513,0,22513,63544,0,86057
143310901600000,SW 412,Residential,19768,0,19768,70509,0,90277
143310901700000,SW 412,Residential,12257,0,12257,52502,0,64759
143310901800000,SW 412,Residential,12257,0,12257,25315,0,37572
143310901900000,SW 412,Residential,12257,0,12257,74868,0,87125
143310902000000,SW 412,Residential,12257,0,12257,63967,0,76224
143310902100000,SW 412,Residential,12257,0,12257,76953,0,89210
143310902200000,SW 412,Residential,12257,0,12257,75877,0,88134
143310902300000,SW 412,Residential,5000,0,5000,0,0,5000
143310902400000,SW 412,Residential,12257,0,12257,76587,0,88844
143311000100000,CITY PROPERTY,Exempt,0,0,0,0,0,0
143311000200000,SW 412,Residential,19472,0,19472,53027,0,72499
143311000300000,CITY PROPERTY,Exempt,0,0,0,0,0,0
143311000400000,SW 412,Residential,19472,0,19472,53848,0,73320
143311000500000,SW 412,Residential,19472,0,19472,79675,0,99147
143311000600000,SW 412,Residential,19472,0,19472,81902,0,101374
143311000700000,SW 412,Residential,19472,0,19472,87449,0,106921
143311000800000,SW 412,Residential,19472,0,19472,61478,0,80950
143311000900000,SW 412,Residential,19472,0,19472,67615,0,87087
143311001000000,SW 412,Residential,18764,0,18764,64557,0,83321
143311100100000,SW 412,Residential,19472,0,19472,59365,0,78837
143311100200000,SW 412,Residential,18062,0,18062,84521,0,102583
143311100300000,SW 412,Residential,18062,0,18062,67925,0,85987
143311100400000,SW 412,Residential,18062,0,18062,60374,0,78436
143311100500000,SW 412,Residential,18062,0,18062,53345,0,71407
143311100600000,SW 412,Residential,18062,0,18062,89035,0,107097
143311100700000,SW 412,Residential,18062,0,18062,66657,0,84719
143311100800000,SW 412,Residential,18062,0,18062,63245,0,81307
143311100900000,SW 412,Residential,18062,0,18062,79770,0,97832
143311101000000,SW 412,Residential,10000,0,10000,0,0,10000
143311101100000,SW 412,Residential,15365,0,15365,79086,0,94451
143311101200000,SW 412,Residential,18764,0,18764,53908,0,72672
143311101300000,SW 412,Residential,19472,0,19472,83236,0,102708
143311101400000,SW 412,Residential,19472,0,19472,66604,0,86076
143311101500000,SW 412,Residential,19472,0,19472,63414,0,82886
143311101600000,SW 412,Residential,19472,0,19472,85567,0,105039
143311101700000,SW 412,Residential,19472,0,19472,70794,0,90266
143311101800000,SW 412,Residential,19472,0,19472,54753,0,74225
143311101900000,SW 412,Residential,19472,0,19472,68183,0,87655
143312600100000,BRANCH BANK/CU,Commercial,0,40824,40824,0,223776,264600
143312700100000,CITY PROPERTY,Exempt,0,0,0,0,0,0
143312700200000,CITY PROPERTY,Exempt,0,0,0,0,0,0
143312700500000,SW 402,Residential,21200,0,21200,46894,0,68094
143312700600000,SW 402,Residential,20213,0,20213,83051,0,103264
143312700700000,SW 402,Residential,17147,0,17147,71330,0,88477
143312700800000,SW 402,Residential,19080,0,19080,93607,0,112687
143312800100000,SW 402,Residential,12600,0,12600,55803,0,68403
143312800200000,SW 402,Residential,13020,0,13020,23889,0,36909
143312800300000,SW 402,Residential,15675,0,15675,48005,0,63680
143312800400000,SW 402,Residential,16245,0,16245,28409,0,44654
143312800500000,SW 402,Residential,14175,0,14175,43610,0,57785
143312800600000,SW 402,Residential,9450,0,9450,42470,0,51920
143312800700000,SW 402,Residential,8466,0,8466,38534,0,47000
143312800800000,SW 402,Residential,8466,0,8466,45064,0,53530
143312800900000,SW 402,Residential,17679,0,17679,39741,0,57420
143312801000000,SW 402,Residential,6972,0,6972,32065,0,39037
143312801100000,SW 402,Residential,18000,0,18000,54552,0,72552
143312801200000,SW 402,Residential,18000,0,18000,69971,0,87971
143312801300000,SW 402,Residential,18000,0,18000,38075,0,56075
143312801400000,SW 402,Residential,18000,0,18000,45745,0,63745
143312900100000,SW 402,Residential,18000,0,18000,65996,0,83996
143312900200000,SW 402,Residential,18000,0,18000,43181,0,61181
143312900300000,CHURCH,Exempt,0,13608,13608,0,45902,59510
143312900500000,CITY PROPERTY,Exempt,0,0,0,0,0,0
143312900600000,CITY PROPERTY,Exempt,0,0,0,0,0,0
143312900700000,SW 402,Residential,9540,0,9540,0,0,9540
143312900800000,SW 402,Residential,14000,0,14000,0,0,14000
143312900900000,RESTAURANT,Commercial,0,42817,42817,0,86630,129447
143312901000000,VACANT LAND,Commercial,0,45360,45360,0,0,45360
143312901100000,SW 402,Residential,18000,0,18000,58828,0,76828
143312901200000,SW 402,Residential,9000,0,9000,48395,0,57395
143312901300000,SW 402,Residential,9000,0,9000,53881,0,62881
143312901400000,SW 402,Residential,18000,0,18000,53314,0,71314
143313000100000,CITY PROPERTY,Exempt,0,0,0,0,0,0
143313000200000,SW 402,Residential,12060,0,12060,52498,0,64558
143313000300000,CENTRALLY ASSESSED,Other,0,0,0,0,0,0
143313000400000,SW 402,Residential,22141,0,22141,0,0,22141
143313100100000,FLAT PARKING,Commercial,0,36288,36288,0,3600,39888
143313100200000,FLAT PARKING,Commercial,0,36288,36288,0,7734,44022
143313100300000,SW 412,Residential,17850,0,17850,61404,0,79254
143313100400000,SW 412,Residential,17850,0,17850,107385,0,125235
143313100500000,SW 412,Residential,17850,0,17850,62022,0,79872
143313100600000,SW 412,Residential,18062,0,18062,65148,0,83210
143313100700000,SW 412,Residential,18062,0,18062,45463,0,63525
143313100800000,SW 412,Residential,18062,0,18062,59956,0,78018
143313100900000,SW 412,Residential,18062,0,18062,70365,0,88427
143313101000000,SW 412,Residential,18062,0,18062,47067,0,65129
143313101100000,SW 412,Residential,18062,0,18062,79973,0,98035
143313200100000,APARTMENT,Commercial,0,10498,10498,0,127312,137810
143313200200000,APARTMENT,Commercial,0,10498,10498,0,140614,151112
143313200300000,SW 412,Residential,5000,0,5000,0,0,5000
143313200400000,WAREHOUSE,Commercial,0,20412,20412,0,31479,51891
143313200500000,SW 412,Residential,11812,0,11812,48420,0,60232
143313200600000,SW 412,Residential,12600,0,12600,34206,0,46806
143313200700000,SW 412,Residential,8951,0,8951,39875,0,48826
143313200800000,CITY PROPERTY,Exempt,0,0,0,0,0,0
143313200900000,SW 412,Residential,6783,0,6783,25003,0,31786
143313201000000,SW 412,Residential,8491,0,8491,45934,0,54425
143313201100000,SW 412,Residential,9868,0,9868,46590,0,56458
143313201400000,SW 412,Residential,12750,0,12750,65185,0,77935
143313201500000,SW 412,Residential,12750,0,12750,63248,0,75998
143313201600000,SW 412,Residential,16256,0,16256,74335,0,90591
143313201700000,SW 412,Residential,17850,0,17850,117686,0,135536
143313300100000,SW 412,Residential,15750,0,15750,62207,0,77957
143313300200000,SW 412,Residential,15750,0,15750,53828,0,69578
143313300300000,SW 412,Residential,15750,0,15750,73518,0,89268
143313300400000,SW 412,Residential,15750,0,15750,62113,0,77863
143313300500000,SW 412,Residential,15750,0,15750,71099,0,86849
143313300600000,BARS/LOUNGE,Commercial,0,24948,24948,0,150243,175191
143313300700000,FLAT PARKING,Commercial,0,39312,39312,0,8190,47502
143313300800000,FLAT PARKING,Commercial,0,52682,52682,0,11160,63842
143313300900000,GROCERY STORE,Commercial,0,122212,122212,0,300831,423043
143313301000000,SW 412,Residential,10000,0,10000,0,0,10000
143313301100000,SW 412,Residential,17850,0,17850,19179,0,37029
143313301200000,SW 412,Residential,12750,0,12750,61219,0,73969
143313301300000,SW 412,Residential,12750,0,12750,31985,0,44735
143313301400000,SW 412,Residential,12750,0,12750,66923,0,79673
143313400100000,SW 412,Residential,17545,0,17545,64890,0,82435
143313400200000,SW 412,Residential,14822,0,14822,51607,0,66429
143313400300000,SW 412,Residential,17248,0,17248,69683,0,86931
143313400400000,SW 412,Residential,13125,0,13125,61788,0,74913
143313400500000,SW 412,Residential,13125,0,13125,45969,0,59094
143313400600000,SW 412,Residential,15937,0,15937,45990,0,61927
143313400700000,SW 412,Residential,15937,0,15937,48600,0,64537
143313400800000,SW 412,Residential,15937,0,15937,70096,0,86033
143313400900000,CITY PROPERTY,Exempt,0,0,0,0,0,0
143313500100000,CITY PROPERTY,Exempt,0,0,0,0,0,0
143313500200000,SW 412,Residential,17155,0,17155,71929,0,89084
143313600100000,SW 412,Residential,13766,0,13766,58966,0,72732
143313600200000,CITY PROPERTY,Exempt,0,0,0,0,0,0
143313600300000,SW 412,Residential,9135,0,9135,57838,0,66973
143313600400000,SW 412,Residential,16670,0,16670,59927,0,76597
143313700100000,SW 412,Residential,13196,0,13196,73069,0,86265
143313700200000,SW 412,Residential,5000,0,5000,0,0,5000
143313700300000,SW 412,Residential,6917,0,6917,50201,0,57118
143313700400000,SW 412,Residential,8606,0,8606,41608,0,50214
143313700500000,SW 412,Residential,13228,0,13228,64864,0,78092
143313700600000,CITY PROPERTY,Exempt,0,0,0,0,0,0
143313700700000,SW 412,Residential,15937,0,15937,61718,0,77655
143313700800000,SW 412,Residential,15937,0,15937,66812,0,82749
143313700900000,SW 412,Residential,15937,0,15937,75264,0,91201
143313701000000,SW 412,Residential,15937,0,15937,61525,0,77462
143313701100000,SW 412,Residential,15937,0,15937,51879,0,67816
143313701200000,SW 412,Residential,14767,0,14767,55450,0,70217
143313701300000,SW 412,Residential,14771,0,14771,57304,0,72075
143313701400000,SW 412,Residential,14767,0,14767,64144,0,78911
143313701500000,SW 412,Residential,10883,0,10883,0,0,10883
143313701600000,SW 412,Residential,15937,0,15937,77139,0,93076
143313701700000,SW 412,Residential,15937,0,15937,50667,0,66604
143313701800000,SW 412,Residential,15937,0,15937,57584,0,73521
143313701900000,SW 412,Residential,10000,0,10000,0,0,10000
143313702000000,SW 412,Residential,15937,0,15937,63886,0,79823
143313702100000,SW 412,Residential,15937,0,15937,62804,0,78741
143313702200000,SW 412,Residential,15937,0,15937,46824,0,62761
143313702300000,SW 412,Residential,12750,0,12750,63898,0,76648
143313800100000,SW 412,Residential,10500,0,10500,90217,0,100717
143313800200000,SW 412,Residential,10500,0,10500,65629,0,76129
143313800300000,CITY PROPERTY,Exempt,0,0,0,0,0,0
143313900100000,SW 412,Residential,12750,0,12750,68638,0,81388
143313900200000,SW 412,Residential,12750,0,12750,71660,0,84410
143313900300000,SW 412,Residential,12750,0,12750,57047,0,69797
143313900400000,SW 412,Residential,12750,0,12750,73387,0,86137
143313900500000,SW 412,Residential,15937,0,15937,54799,0,70736
143313900600000,SW 412,Residential,15937,0,15937,56383,0,72320
143313900700000,SW 412,Residential,19125,0,19125,67584,0,86709
143314000100000,SW 412,Residential,18987,0,18987,61895,0,80882
143314000200000,SW 412,Residential,17846,0,17846,88054,0,105900
143314000300000,SW 412,Residential,14450,0,14450,50326,0,64776
143314000400000,SW 412,Residential,14450,0,14450,56417,0,70867
143314000500000,SW 412,Residential,14450,0,14450,63305,0,77755
143314000600000,SW 412,Residential,14450,0,14450,66009,0,80459
143314000700000,SW 412,Residential,14450,0,14450,0,0,14450
143314000800000,SW 412,Residential,14450,0,14450,43825,0,58275
143314000900000,SW 412,Residential,14450,0,14450,59892,0,74342
143314001000000,SW 412,Residential,14450,0,14450,59673,0,74123
143314001100000,SW 412,Residential,14450,0,14450,72857,0,87307
143314001200000,SW 412,Residential,14450,0,14450,71944,0,86394
143314001300000,SW 412,Residential,14450,0,14450,31746,0,46196
143314001400000,SW 412,Residential,14450,0,14450,72614,0,87064
143314001500000,SW 412,Residential,10000,0,10000,0,0,10000
143314001600000,SW 412,Residential,14450,0,14450,72743,0,87193
143314100100000,SW 412,Residential,19125,0,19125,76860,0,95985
143314100200000,SW 412,Residential,17000,0,17000,87220,0,104220
143314100300000,SW 412,Residential,17000,0,17000,64664,0,81664
143314100400000,SW 412,Residential,17000,0,17000,69377,0,86377
143314100500000,SW 412,Residential,34000,0,34000,40576,0,74576
143314100600000,SW 412,Residential,17000,0,17000,96965,0,113965
143314100700000,SW 412,Residential,17000,0,17000,79378,0,96378
143314100800000,WAREHOUSE,Commercial,0,13608,13608,0,58835,72443
143314100900000,SW 412,Residential,17000,0,17000,107995,0,124995
143314101000000,SW 412,Residential,17000,0,17000,75052,0,92052
143314101100000,SW 412,Residential,17000,0,17000,74456,0,91456
143314101200000,SW 412,Residential,17000,0,17000,53986,0,70986
143314101300000,SW 412,Residential,5000,0,5000,0,0,5000
143314101400000,SW 412,Residential,17000,0,17000,95364,0,112364
143314101500000,SW 412,Residential,14875,0,14875,82085,0,96960
143315100100000,SW 412,Residential,16531,0,16531,68769,0,85300
143315100200000,SW 412,Residential,15895,0,15895,63676,0,79571
143315100300000,SW 412,Residential,24796,0,24796,75602,0,100398
143315100400000,SW 412,Residential,24796,0,24796,54282,0,79078
143315100500000,SW 412,Residential,25035,0,25035,82437,0,107472
143315100600000,SW 412,Residential,25035,0,25035,78538,0,103573
143315100700000,SW 412,Residential,24081,0,24081,82041,0,106122
143315100800000,SW 412,Residential,24081,0,24081,67730,0,91811
143315100900000,SW 412,Residential,22908,0,22908,90056,0,112964
143315101000000,SW 412,Residential,22908,0,22908,72556,0,95464
143315101100000,SW 412,Residential,31238,0,31238,109113,0,140351
143315101200000,SW 412,Residential,23793,0,23793,68339,0,92132
143315101300000,SW 412,Residential,23793,0,23793,58752,0,82545
143315101400000,SW 412,Residential,24024,0,24024,62079,0,86103
143315101500000,SW 412,Residential,24024,0,24024,82541,0,106565
143315101600000,SW 412,Residential,22695,0,22695,96949,0,119644
143315101700000,SW 412,Residential,22695,0,22695,91622,0,114317
143315101800000,CITY PROPERTY,Exempt,0,0,0,0,0,0
143315101900000,SW 412,Residential,12860,0,12860,52279,0,65139
143315200100000,SW 412,Residential,20825,0,20825,81545,0,102370
143315200200000,SW 412,Residential,20409,0,20409,81052,0,101461
143315200300000,SW 412,Residential,28892,0,28892,65878,0,94770
143315200400000,SW 412,Residential,28892,0,28892,83211,0,112103
143315200500000,SW 412,Residential,30799,0,30799,95544,0,126343
143315200600000,SW 412,Residential,30799,0,30799,96211,0,127010
143315200700000,SW 412,Residential,45275,0,45275,94487,0,139762
143315200800000,SW 412,Residential,25755,0,25755,99489,0,125244
143315200900000,SW 412,Residential,23180,0,23180,107701,0,130881
143315201000000,SW 412,Residential,21463,0,21463,79885,0,101348
143315201100000,SW 412,Residential,21463,0,21463,69875,0,91338
143315201200000,SW 412,Residential,21463,0,21463,99111,0,120574
143315201300000,SW 412,Residential,30799,0,30799,76898,0,107697
143315201400000,SW 412,Residential,30799,0,30799,71643,0,102442
143315201500000,SW 412,Residential,30799,0,30799,43612,0,74411
143315201600000,SW 412,Residential,29284,0,29284,87517,0,116801
143315201700000,SW 412,Residential,29474,0,29474,77818,0,107292
143315201800000,SW 412,Residential,16218,0,16218,55699,0,71917
143315201900000,SW 412,Residential,23562,0,23562,73538,0,97100
143315202000000,SW 412,Residential,30600,0,30600,110424,0,141024
143315202100000,SW 412,Residential,28459,0,28459,81878,0,110337
143315202200000,SW 412,Residential,24863,0,24863,88457,0,113320
143315202300000,SW 412,Residential,24863,0,24863,87087,0,111950
143315202400000,SW 412,Residential,24650,0,24650,73304,0,97954
143315202500000,SW 412,Residential,32566,0,32566,70499,0,103065
143315202600000,SW 412,Residential,21250,0,21250,62969,0,84219
143315202700000,SW 412,Residential,21250,0,21250,38913,0,60163
143315202800000,SW 412,Residential,21250,0,21250,68482,0,89732
143315202900000,SW 412,Residential,192,0,192,0,0,192
143315203000000,SW 412,Residential,6368,0,6368,0,0,6368
143315203100000,SW 412,Residential,11249,0,11249,0,0,11249
143315203300000,SW 412,Residential,22440,0,22440,98229,0,120669
143315203400000,SW 412,Residential,22440,0,22440,76831,0,99271
143315203500000,SW 412,Residential,22440,0,22440,76487,0,98927
143315300100000,SW 412,Residential,21250,0,21250,75872,0,97122
143315300200000,SW 412,Residential,19964,0,19964,76730,0,96694
143315300300000,SW 412,Residential,21049,0,21049,98316,0,119365
143315300400000,SW 412,Residential,20515,0,20515,77837,0,98352
143315300500000,SW 412,Residential,21250,0,21250,77476,0,98726
143315300600000,SW 412,Residential,21250,0,21250,63746,0,84996
143315300700000,SW 412,Residential,21250,0,21250,104180,0,125430
143315300800000,SW 412,Residential,21250,0,21250,88163,0,109413
143315300900000,SW 412,Residential,22157,0,22157,76674,0,98831
143315301000000,SW 412,Residential,26145,0,26145,79500,0,105645
143315301100000,SW 412,Residential,25560,0,25560,95677,0,121237
143315301200000,SW 412,Residential,26350,0,26350,103699,0,130049
143315301300000,SW 412,Residential,22695,0,22695,74778,0,97473
143315301400000,SW 412,Residential,30260,0,30260,97737,0,127997
143315301500000,SW 412,Residential,21250,0,21250,104899,0,126149
143315301600000,SW 412,Residential,21250,0,21250,70326,0,91576
143315400100000,SW 412,Residential,14822,0,14822,25375,0,40197
143315400200000,SW 412,Residential,19763,0,19763,69463,0,89226
143315400300000,SW 412,Residential,18577,0,18577,84666,0,103243
143315400400000,SW 412,Residential,19763,0,19763,82027,0,101790
143315400500000,SW 412,Residential,20948,0,20948,80511,0,101459
143315400600000,SW 412,Residential,20948,0,20948,73363,0,94311
143315400700000,SW 412,Residential,19763,0,19763,86651,0,106414
143315400800000,SW 412,Residential,18577,0,18577,83105,0,101682
143315400900000,SW 412,Residential,19763,0,19763,88146,0,107909
143315401000000,SW 412,Residential,19565,0,19565,105692,0,125257
143315401100000,SW 412,Residential,20158,0,20158,73844,0,94002
143315401200000,SW 412,Residential,19763,0,19763,72520,0,92283
143315401300000,SW 412,Residential,19763,0,19763,73580,0,93343
143315401400000,SW 412,Residential,19763,0,19763,70542,0,90305
143315401500000,SW 412,Residential,19763,0,19763,87284,0,107047
143315401600000,SW 412,Residential,19763,0,19763,102997,0,122760
143315401700000,SW 412,Residential,19763,0,19763,63171,0,82934
143315401800000,SW 412,Residential,19763,0,19763,58119,0,77882
143315401900000,SW 412,Residential,19763,0,19763,72450,0,92213
143315402000000,SW 412,Residential,19499,0,19499,84343,0,103842
143315500100000,SCHOOL,Exempt,0,307260,307260,0,3480222,3787482
143315500200000,SW 412,Exempt,0,33000,33000,0,114393,147393
143315500300000,SW 412,Residential,21250,0,21250,73836,0,95086
143315500400000,SW 412,Residential,21250,0,21250,50859,0,72109
143315500500000,SW 412,Residential,21250,0,21250,81578,0,102828
143315500600000,SW 412,Residential,21250,0,21250,95566,0,116816
143315500700000,SW 412,Residential,21250,0,21250,94354,0,115604
143315500800000,SW 412,Residential,21647,0,21647,76064,0,97711
143315500900000,SW 412,Residential,30716,0,30716,64937,0,95653
143315501000000,SW 412,Residential,16926,0,16926,117026,0,133952
143315501100000,SW 412,Residential,16948,0,16948,95618,0,112566
143315501200000,SW 412,Residential,17093,0,17093,97204,0,114297
143315501300000,SW 412,Residential,17093,0,17093,96939,0,114032
143315501400000,SW 412,Residential,17093,0,17093,92073,0,109166
143315501500000,SW 412,Residential,17093,0,17093,59358,0,76451
143315501600000,SW 412,Residential,24255,0,24255,66778,0,91033
143315501700000,SW 412,Residential,29920,0,29920,75786,0,105706
143315501800000,SW 412,Residential,18700,0,18700,59583,0,78283
143315501900000,SW 412,Residential,31790,0,31790,91011,0,122801
143315502000000,SW 412,Residential,34525,0,34525,121032,0,155557
143315502100000,CHURCH,Exempt,0,278,278,0,0,278
143315600100000,SW 412,Residential,21675,0,21675,112664,0,134339
143315600200000,SW 412,Residential,21675,0,21675,68373,0,90048
143315600300000,SW 412,Residential,21675,0,21675,74930,0,96605
143315600400000,SW 412,Residential,21675,0,21675,89734,0,111409
143315600500000,SW 412,Residential,21675,0,21675,74246,0,95921
143315600600000,SW 412,Residential,21675,0,21675,83701,0,105376
143315600700000,SW 412,Residential,28611,0,28611,94611,0,123222
143315600800000,SW 412,Residential,31862,0,31862,103598,0,135460
143315600900000,SW 412,Residential,18743,0,18743,47344,0,66087
143315601000000,SW 412,Residential,16660,0,16660,74815,0,91475
143315601100000,SW 412,Residential,17701,0,17701,83077,0,100778
143315601200000,SW 412,Residential,30925,0,30925,78054,0,108979
143315601300000,SW 412,Residential,23562,0,23562,80433,0,103995
143315601400000,SW 412,Residential,24990,0,24990,21792,0,46782
143315601500000,SW 412,Residential,21420,0,21420,61138,0,82558
143315601600000,SW 412,Residential,24990,0,24990,84008,0,108998
143315601700000,SW 412,Residential,19635,0,19635,81221,0,100856
143315601800000,SW 412,Residential,16065,0,16065,80540,0,96605
143316500500000,SW 402,Residential,9390,0,9390,39472,0,48862
143316500600000,CITY PROPERTY,Exempt,0,0,0,0,0,0
143317600100000,SW 412,Residential,15546,0,15546,52512,0,68058
143317600200000,SW 412,Residential,18692,0,18692,54898,0,73590
143317600300000,SW 412,Residential,21666,0,21666,65920,0,87586
143317600400000,SW 412,Residential,21666,0,21666,66892,0,88558
143317600500000,SW 412,Residential,21666,0,21666,61431,0,83097
143317600600000,SW 412,Residential,22108,0,22108,93533,0,115641
143317600700000,SW 412,Residential,22108,0,22108,68224,0,90332
143317600800000,SW 412,Residential,23158,0,23158,80323,0,103481
143317600900000,SW 412,Residential,21478,0,21478,72060,0,93538
143317601000000,SW 412,Residential,20459,0,20459,65277,0,85736
143317601100000,SW 412,Residential,21464,0,21464,78048,0,99512
143317601200000,SW 412,Residential,20461,0,20461,75214,0,95675
143317601300000,SW 412,Residential,22137,0,22137,69640,0,91777
143317601400000,SW 412,Residential,22137,0,22137,85016,0,107153
143317601500000,SW 412,Residential,20808,0,20808,78141,0,98949
143317601600000,SW 412,Residential,23984,0,23984,89834,0,113818
143317601700000,SW 412,Residential,24915,0,24915,64736,0,89651
143317601800000,SW 412,Residential,24677,0,24677,88112,0,112789
143317601900000,SW 412,Residential,24677,0,24677,89272,0,113949
143317602000000,SW 412,Residential,24677,0,24677,91722,0,116399
143317602100000,SW 412,Residential,24677,0,24677,80474,0,105151
143317602200000,SW 412,Residential,23247,0,23247,79944,0,103191
143317602300000,SW 412,Residential,22054,0,22054,95223,0,117277
143317602400000,SW 412,Residential,21351,0,21351,96696,0,118047
143317602500000,SW 412,Residential,24677,0,24677,66671,0,91348
143317602600000,SW 412,Residential,24677,0,24677,78241,0,102918
143317602700000,SW 412,Residential,24677,0,24677,66933,0,91610
143317602800000,SW 412,Residential,24677,0,24677,62823,0,87500
143317602900000,SW 412,Residential,24677,0,24677,76419,0,101096
143317603000000,SW 412,Residential,29032,0,29032,106624,0,135656
143317603100000,SW 412,Residential,29453,0,29453,122509,0,151962
143317603200000,SW 412,Residential,25441,0,25441,81727,0,107168
143317603300000,SW 413,Residential,25468,0,25468,119531,0,144999
143317603400000,SW 413,Residential,23908,0,23908,116030,0,139938
143317603500000,SW 413,Residential,25869,0,25869,83938,0,109807
143317603600000,SW 413,Residential,20370,0,20370,83674,0,104044
143317603700000,APARTMENT,Commercial,0,16425,16425,0,105501,121926
143317603800000,APARTMENT,Commercial,0,18468,18468,0,180094,198562
143317604000000,APARTMENT,Commercial,0,18079,18079,0,123313,141392
143317604100000,APARTMENT,Commercial,0,18808,18808,0,129022,147830
143317604200000,APARTMENT,Residential,39188,0,39188,260812,0,300000
143317604300000,APARTMENT,Commercial,0,38998,38998,0,311877,350875
143317700100000,SW 412,Residential,21241,0,21241,46700,0,67941
143317700200000,SW 412,Residential,14161,0,14161,82391,0,96552
143317700300000,SW 412,Residential,16660,0,16660,52160,0,68820
143317700400000,SW 412,Residential,16660,0,16660,66871,0,83531
143317700500000,SW 412,Residential,16660,0,16660,39465,0,56125
143317700600000,SW 412,Residential,16660,0,16660,84854,0,101514
143317700700000,SW 412,Residential,24990,0,24990,51131,0,76121
143317700800000,SW 412,Residential,24990,0,24990,73309,0,98299
143317700900000,SW 412,Residential,16660,0,16660,55921,0,72581
143317701000000,SW 412,Residential,16660,0,16660,67113,0,83773
143317701100000,SW 412,Residential,16660,0,16660,53005,0,69665
143317701200000,SW 412,Residential,16660,0,16660,67346,0,84006
143317701300000,SW 412,Residential,16660,0,16660,74544,0,91204
143317701400000,SW 412,Residential,29932,0,29932,59063,0,88995
143317701500000,SW 412,Residential,30212,0,30212,69194,0,99406
143317701600000,SW 412,Residential,16660,0,16660,68626,0,85286
143317701700000,SW 412,Residential,16660,0,16660,56542,0,73202
143317701800000,SW 412,Residential,16660,0,16660,67240,0,83900
143317701900000,SW 412,Residential,16660,0,16660,94612,0,111272
143317702000000,SW 412,Residential,16660,0,16660,66536,0,83196
143317702100000,SW 412,Residential,16660,0,16660,59600,0,76260
143317702200000,SW 412,Residential,16660,0,16660,69792,0,86452
143317702300000,SW 412,Residential,16660,0,16660,62601,0,79261
143317702400000,SW 412,Residential,16660,0,16660,33807,0,50467
143317702500000,SW 412,Residential,16660,0,16660,78699,0,95359
143317702600000,SW 412,Residential,24990,0,24990,78294,0,103284
143317800200000,SW 413,Residential,22726,0,22726,95301,0,118027
143317800300000,SW 413,Residential,24602,0,24602,99532,0,124134
143317800400000,SW 413,Residential,22523,0,22523,70863,0,93386
143317800500000,SW 413,Residential,24689,0,24689,82504,0,107193
143317800600000,SW 413,Residential,22523,0,22523,81162,0,103685
143317800700000,SW 413,Residential,22523,0,22523,78345,0,100868
143317800800000,SW 413,Residential,24521,0,24521,85305,0,109826
143317800900000,SW 413,Residential,26017,0,26017,81087,0,107104
143317801000000,SW 413,Residential,21609,0,21609,69288,0,90897
143317801100000,GROCERY STORE,Commercial,0,948888,948888,0,4103499,5052387
143317900100000,SW 413,Residential,25577,0,25577,84460,0,110037
143317900200000,SW 413,Residential,23331,0,23331,92602,0,115933
143317900300000,SW 413,Residential,23331,0,23331,96216,0,119547
143317900400000,SW 413,Residential,22978,0,22978,75520,0,98498
143317900500000,SW 413,Residential,24745,0,24745,128715,0,153460
143317900600000,SW 413,Residential,25187,0,25187,117827,0,143014
143317900700000,SW 413,Residential,20150,0,20150,66313,0,86463
143317900800000,SW 413,Residential,20198,0,20198,85464,0,105662
143317900900000,SW 413,Residential,21564,0,21564,64618,0,86182
143317901000000,SW 413,Residential,20750,0,20750,66959,0,87709
143317901100000,SW 413,Residential,23765,0,23765,92784,0,116549
143317901200000,SW 413,Residential,22531,0,22531,90030,0,112561
143317901300000,SW 413,Residential,20422,0,20422,77263,0,97685
143317901400000,SW 413,Residential,21417,0,21417,112188,0,133605
143317901500000,SW 413,Residential,25704,0,25704,69842,0,95546
143317901600000,SW 413,Residential,22491,0,22491,78664,0,101155
143317901700000,SW 413,Residential,24276,0,24276,92798,0,117074
143317901800000,SW 413,Residential,21420,0,21420,75690,0,97110
143317904700000,APARTMENT,Commercial,0,19217,19217,0,202530,221747
143317904800000,APARTMENT,Commercial,0,10498,10498,0,107980,118478
143318000100000,SW 412,Residential,34884,0,34884,92217,0,127101
143318000200000,SW 412,Residential,20853,0,20853,114530,0,135383
143318000300000,SW 412,Residential,19125,0,19125,74309,0,93434
143318000400000,SW 412,Residential,19125,0,19125,113105,0,132230
143318000500000,SW 412,Residential,19125,0,19125,70146,0,89271
143318000600000,SW 412,Residential,21250,0,21250,54324,0,75574
143318000700000,SW 412,Residential,21250,0,21250,66456,0,87706
143318000800000,SW 412,Residential,21250,0,21250,98799,0,120049
143318000900000,SW 412,Residential,21250,0,21250,71776,0,93026
143318001000000,SW 412,Residential,21250,0,21250,71189,0,92439
143318001100000,SW 412,Residential,20400,0,20400,71223,0,91623
143318001200000,SW 412,Residential,21916,0,21916,132062,0,153978
143318001300000,SW 412,Residential,25500,0,25500,96636,0,122136
143318001400000,SW 412,Residential,25500,0,25500,89534,0,115034
143318001500000,SW 412,Residential,22879,0,22879,107135,0,130014
143318001600000,SW 412,Residential,21250,0,21250,56247,0,77497
143318001700000,SW 412,Residential,21250,0,21250,66642,0,87892
143318001800000,SW 412,Residential,21250,0,21250,101677,0,122927
143318001900000,SW 412,Residential,21250,0,21250,83775,0,105025
143318002000000,SW 412,Residential,21250,0,21250,84883,0,106133
143318002100000,SW 412,Residential,32300,0,32300,114914,0,147214
143320100100000,SW 402,Residential,15300,0,15300,35080,0,50380
143320100200000,SW 402,Residential,15000,0,15000,47189,0,62189
143320100300000,SW 402,Residential,15000,0,15000,34482,0,49482
143320100400000,SW 402,Residential,15000,0,15000,53190,0,68190
143320100500000,SW 402,Residential,15000,0,15000,55314,0,70314
143320100600000,SW 402,Residential,15300,0,15300,39362,0,54662
143320100700000,SW 402,Residential,15300,0,15300,50482,0,65782
143320100800000,SW 402,Residential,15300,0,15300,62892,0,78192
143320200100000,SW 402,Residential,20000,0,20000,66525,0,86525
143320200200000,SW 402,Residential,12740,0,12740,63782,0,76522
143320200300000,SW 402,Residential,12012,0,12012,55826,0,67838
143320200400000,SW 402,Residential,12376,0,12376,55585,0,67961
143320200500000,SW 402,Residential,13300,0,13300,52504,0,65804
143320200600000,SW 402,Residential,13300,0,13300,58345,0,71645
143320200700000,SW 402,Residential,25344,0,25344,65983,0,91327
143320200800000,SW 402,Residential,20000,0,20000,39916,0,59916
143320200900000,SW 402,Residential,20000,0,20000,76415,0,96415
143320201000000,SW 402,Residential,20000,0,20000,86234,0,106234
143320300100000,SW 402,Residential,15907,0,15907,70766,0,86673
143320300200000,SW 402,Residential,15907,0,15907,86536,0,102443
143320300300000,SW 402,Residential,15907,0,15907,44705,0,60612
143320300400000,SMALL RETAIL,Commercial,0,17617,17617,0,18252,35869
143320400100000,CITY PROPERTY,Exempt,0,0,0,0,0,0
143320400200000,SW 402,Residential,20000,0,20000,44605,0,64605
143320400300000,SW 402,Residential,20000,0,20000,50921,0,70921
143320400400000,SW 402,Residential,20000,0,20000,59230,0,79230
143320400500000,SW 402,Residential,20000,0,20000,62137,0,82137
143320400600000,CITY PROPERTY,Exempt,0,0,0,0,0,0
143320400700000,SW 402,Residential,20000,0,20000,33772,0,53772
143320400800000,CONVENIENCE STORE,Commercial,0,60750,60750,0,224488,285238
143320400900000,FLAT PARKING,Commercial,0,40500,40500,0,13679,54179
143320401000000,CITY PROPERTY,Exempt,0,0,0,0,0,0
143320401100000,SW 402,Residential,18360,0,18360,0,0,18360
143320500100000,SW 402,Residential,20000,0,20000,64621,0,84621
143320500200000,SW 402,Residential,18200,0,18200,33629,0,51829
143320500300000,SW 402,Residential,18200,0,18200,55622,0,73822
143320500400000,SW 402,Residential,18200,0,18200,64968,0,83168
143320500500000,SW 402,Residential,18200,0,18200,72229,0,90429
143320500600000,SW 402,Residential,21840,0,21840,73268,0,95108
143320500700000,SW 402,Residential,14560,0,14560,43468,0,58028
143320500800000,SW 402,Residential,20000,0,20000,96949,0,116949
143320500900000,CITY PROPERTY,Exempt,0,0,0,0,0,0
143320501000000,SW 402,Residential,20000,0,20000,56054,0,76054
143320501100000,SW 402,Residential,20000,0,20000,48407,0,68407
143320501200000,SW 402,Residential,20000,0,20000,29878,0,49878
143320600100000,SW 402,Residential,12250,0,12250,39898,0,52148
143320600200000,CITY PROPERTY,Exempt,0,0,0,0,0,0
143320600300000,CITY PROPERTY,Exempt,0,0,0,0,0,0
143320600400000,SW 402,Residential,14400,0,14400,51595,0,65995
143320600500000,SW 402,Residential,12600,0,12600,48403,0,61003
143320600600000,SW 402,Residential,5000,0,5000,0,0,5000
143320600700000,SW 402,Residential,15907,0,15907,57890,0,73797
143320600800000,SW 402,Residential,15907,0,15907,50685,0,66592
143320700100000,FUNERAL HOME,Commercial,0,44550,44550,0,196746,241296
143320700200000,FLAT PARKING,Commercial,0,21600,21600,0,6840,28440
143320700300000,SW 402,Residential,18360,0,18360,0,0,18360
143320700400000,SW 402,Residential,20000,0,20000,74192,0,94192
143320700500000,SW 402,Residential,20000,0,20000,54571,0,74571
143320700600000,SW 402,Residential,20000,0,20000,63393,0,83393
143320700700000,SW 402,Residential,20000,0,20000,94028,0,114028
143320700800000,SW 402,Residential,16200,0,16200,42197,0,58397
143320700900000,SW 402,Residential,20750,0,20750,74194,0,94944
143320701000000,SW 402,Residential,25500,0,25500,83730,0,109230
143320701100000,SW 402,Residential,25500,0,25500,41868,0,67368
143320701200000,SW 402,Residential,25500,0,25500,47414,0,72914
143320800100000,SW 402,Residential,10000,0,10000,0,0,10000
143320800200000,SW 402,Residential,23400,0,23400,43444,0,66844
143320800300000,SW 402,Residential,23400,0,23400,53378,0,76778
143320800400000,SW 402,Residential,23400,0,23400,33375,0,56775
143320800500000,CITY PROPERTY,Exempt,0,0,0,0,0,0
143320800600000,SW 402,Residential,23400,0,23400,49147,0,72547
143320800700000,SW 402,Residential,23400,0,23400,59531,0,82931
143320800800000,SW 402,Residential,20000,0,20000,75972,0,95972
143320800900000,SW 402,Residential,20000,0,20000,75350,0,95350
143320801000000,SW 402,Residential,20000,0,20000,62080,0,82080
143320801100000,SW 402,Residential,20000,0,20000,102142,0,122142
143320801200000,SW 402,Residential,20000,0,20000,73911,0,93911
143320900100000,SW 402,Residential,14630,0,14630,65471,0,80101
143320900200000,SW 402,Residential,15840,0,15840,54183,0,70023
143320900300000,SW 402,Residential,14630,0,14630,74305,0,88935
143320900400000,SW 402,Residential,15907,0,15907,60710,0,76617
143320900500000,SW 402,Residential,15907,0,15907,45495,0,61402
143320900600000,APARTMENT,Commercial,0,18144,18144,0,170221,188365
143321000100000,SW 402,Residential,25500,0,25500,89807,0,115307
143321000200000,SW 402,Residential,30000,0,30000,55514,0,85514
143321000300000,SW 402,Residential,30000,0,30000,66722,0,96722
143321000400000,SW 402,Residential,16000,0,16000,61179,0,77179
143321000500000,SW 402,Residential,16000,0,16000,0,0,16000
143321000600000,SW 402,Residential,25000,0,25000,82082,0,107082
143321000700000,SW 402,Residential,25000,0,25000,62789,0,87789
143321000800000,SW 402,Residential,17500,0,17500,61695,0,79195
143321000900000,SW 402,Residential,18900,0,18900,55661,0,74561
143321001000000,SW 402,Residential,25500,0,25500,45016,0,70516
143321001100000,SW 402,Residential,25500,0,25500,51384,0,76884
143321001200000,SW 402,Residential,25500,0,25500,69942,0,95442
143321001300000,SW 402,Residential,25500,0,25500,69196,0,94696
143321001400000,SW 402,Residential,25500,0,25500,69488,0,94988
143321001500000,SW 402,Residential,25500,0,25500,91783,0,117283
143321100100000,SW 402,Residential,25000,0,25000,108905,0,133905
143321100200000,SW 402,Residential,15840,0,15840,38537,0,54377
143321100300000,SW 402,Residential,15840,0,15840,26523,0,42363
143321100400000,SW 402,Residential,15840,0,15840,38673,0,54513
143321100500000,SW 402,Residential,15840,0,15840,41955,0,57795
143321100600000,SW 402,Residential,23400,0,23400,95027,0,118427
143321100700000,SW 402,Residential,23400,0,23400,66282,0,89682
143321100800000,SW 402,Residential,23400,0,23400,24917,0,48317
143321100900000,SW 402,Residential,23400,0,23400,33232,0,56632
143321101000000,SW 402,Residential,23400,0,23400,69273,0,92673
143321101100000,SW 402,Residential,25000,0,25000,70555,0,95555
143321101200000,SW 402,Residential,25000,0,25000,47769,0,72769
143321101300000,SW 402,Residential,25000,0,25000,73927,0,98927
143321101400000,SW 402,Residential,25000,0,25000,68863,0,93863
143321101500000,SW 402,Residential,25000,0,25000,67144,0,92144
143321101600000,SW 402,Residential,25000,0,25000,61166,0,86166
143321200100000,SW 402,Residential,15907,0,15907,50708,0,66615
143321200200000,SW 402,Residential,17675,0,17675,69052,0,86727
143321200300000,SW 402,Residential,17675,0,17675,56228,0,73903
143321200400000,SW 402,Residential,15907,0,15907,73203,0,89110
143322600100000,SW 403,Residential,20655,0,20655,39031,0,59686
143322600200000,SW 403,Residential,15147,0,15147,51426,0,66573
143322600300000,SW 403,Residential,19989,0,19989,88528,0,108517
143322600400000,SW 403,Residential,20655,0,20655,62907,0,83562
143322600500000,SW 403,Residential,20655,0,20655,66383,0,87038
143322600600000,SW 403,Residential,19035,0,19035,59900,0,78935
143322600700000,SW 403,Residential,21171,0,21171,43435,0,64606
143322600800000,SW 403,Residential,20655,0,20655,57201,0,77856
143322700100000,SW 403,Residential,18180,0,18180,67869,0,86049
143322700200000,SW 403,Residential,18180,0,18180,65189,0,83369
143322700300000,SW 403,Residential,18180,0,18180,59404,0,77584
143322700400000,SW 403,Residential,18180,0,18180,58543,0,76723
143322700500000,SW 403,Residential,18180,0,18180,72810,0,90990
143322700600000,SW 403,Residential,18180,0,18180,54600,0,72780
143322700700000,SW 403,Residential,18180,0,18180,51406,0,69586
143322700800000,SW 403,Residential,18180,0,18180,65466,0,83646
143322700900000,SW 403,Residential,18180,0,18180,50083,0,68263
143322701000000,SW 403,Residential,18180,0,18180,52425,0,70605
143322800100000,CITY PROPERTY,Exempt,0,0,0,0,0,0
143322800200000,CITY PROPERTY,Exempt,0,0,0,0,0,0
143322900100000,SW 403,Residential,25245,0,25245,79989,0,105234
143322900200000,SW 403,Residential,21256,0,21256,37435,0,58691
143322900300000,SW 403,Residential,20304,0,20304,44520,0,64824
143322900400000,SW 403,Residential,20655,0,20655,62375,0,83030
143322900500000,SW 403,Residential,20655,0,20655,87267,0,107922
143322900600000,SW 403,Residential,20655,0,20655,71790,0,92445
143322900700000,SW 403,Residential,20655,0,20655,65698,0,86353
143322900800000,SW 403,Residential,20655,0,20655,68467,0,89122
143322900900000,SW 403,Residential,20655,0,20655,55221,0,75876
143322901000000,SW 403,Residential,20655,0,20655,102310,0,122965
143322901100000,SW 403,Residential,20655,0,20655,51908,0,72563
143323000100000,SW 403,Residential,23452,0,23452,52715,0,76167
143323000200000,SW 403,Residential,18900,0,18900,40660,0,59560
143323000300000,SW 403,Residential,18900,0,18900,75913,0,94813
143323000400000,SW 403,Residential,18900,0,18900,57300,0,76200
143323000500000,CITY PROPERTY,Exempt,0,0,0,0,0,0
143323000600000,SW 403,Residential,18900,0,18900,62879,0,81779
143323000700000,SW 403,Residential,18900,0,18900,60215,0,79115
143323000800000,SW 403,Residential,22680,0,22680,61046,0,83726
143323000900000,SW 403,Residential,16380,0,16380,45639,0,62019
143323001000000,SW 403,Residential,18612,0,18612,53714,0,72326
143323001100000,SW 403,Residential,18612,0,18612,44125,0,62737
143323001200000,SW 403,Residential,15908,0,15908,49817,0,65725
143323001300000,SW 403,Residential,19089,0,19089,36332,0,55421
143323001400000,SW 403,Residential,19544,0,19544,75433,0,94977
143323100100000,SW 403,Residential,20884,0,20884,104505,0,125389
143323100200000,STATE PROPERTY,Exempt,0,0,0,0,0,0
143323100300000,SW 403,Residential,20884,0,20884,76222,0,97106
143323100400000,FAST FOOD,Commercial,0,110160,110160,0,409450,519610
143323100500000,FLAT PARKING,Commercial,0,76410,76410,0,7321,83731
143323100600000,SW 403,Residential,18036,0,18036,61849,0,79885
143323100700000,SW 403,Residential,18360,0,18360,59952,0,78312
143323100800000,SW 403,Residential,17548,0,17548,65448,0,82996
143323100900000,SW 403,Residential,17548,0,17548,44888,0,62436
143323101000000,SW 403,Residential,18360,0,18360,64451,0,82811
143323101100000,SW 403,Residential,18537,0,18537,49853,0,68390
143323200100000,SW 403,Residential,20655,0,20655,65910,0,86565
143323200200000,SW 403,Residential,20655,0,20655,60117,0,80772
143323200300000,SW 403,Residential,20655,0,20655,72731,0,93386
143323200400000,SW 403,Residential,20655,0,20655,92280,0,112935
143323200500000,SW 403,Residential,20655,0,20655,54161,0,74816
143323200600000,SW 403,Residential,18360,0,18360,60373,0,78733
143323200700000,SW 403,Residential,22032,0,22032,67854,0,89886
143323200800000,SW 403,Residential,20655,0,20655,63224,0,83879
143323200900000,SW 403,Residential,20655,0,20655,38475,0,59130
143323201000000,SW 403,Residential,20655,0,20655,72317,0,92972
143323201100000,SW 403,Residential,20655,0,20655,54881,0,75536
143323201200000,SW 403,Residential,20655,0,20655,50585,0,71240
143323300100000,SW 403,Residential,20655,0,20655,42897,0,63552
143323300200000,SW 403,Residential,20655,0,20655,28327,0,48982
143323300300000,SW 403,Residential,22950,0,22950,57026,0,79976
143323300400000,SW 403,Residential,20655,0,20655,41779,0,62434
143323300500000,SW 403,Residential,730,0,730,0,0,730
143323300600000,SW 403,Residential,20655,0,20655,43187,0,63842
143323300700000,SW 403,Residential,20655,0,20655,57081,0,77736
143323300800000,SW 403,Residential,23452,0,23452,71243,0,94695
143323300900000,SW 403,Residential,19430,0,19430,61689,0,81119
143323301000000,SW 403,Residential,18180,0,18180,90534,0,108714
143323301100000,SW 403,Residential,19544,0,19544,67166,0,86710
143323301200000,SW 403,Residential,23452,0,23452,88738,0,112190
143323301300000,SW 403,Residential,22680,0,22680,56897,0,79577
143323301400000,SW 403,Residential,2520,0,2520,0,0,2520
143323301500000,SW 403,Residential,2520,0,2520,0,0,2520
143323301600000,SW 403,Residential,18900,0,18900,47737,0,66637
143323301700000,SW 403,Residential,18900,0,18900,50462,0,69362
143323301800000,SW 403,Residential,18900,0,18900,49212,0,68112
143323301900000,SW 403,Residential,18900,0,18900,40800,0,59700
143323302000000,SW 403,Residential,17905,0,17905,46435,0,64340
143323302100000,SW 403,Residential,17640,0,17640,46520,0,64160
143323302200000,SW 403,Residential,21168,0,21168,58545,0,79713
143323302300000,SW 403,Residential,21168,0,21168,58843,0,80011
143323302400000,SW 403,Residential,20014,0,20014,55180,0,75194
143323302500000,SW 403,Residential,17640,0,17640,63950,0,81590
143323302600000,SW 403,Residential,24410,0,24410,139252,0,163662
143323302700000,SW 403,Residential,20617,0,20617,55312,0,75929
143323302800000,SW 403,Residential,17640,0,17640,0,0,17640
143323303100000,SMALL RETAIL,Commercial,0,64670,64670,0,110586,175256
143325100100000,CITY PROPERTY,Exempt,0,0,0,0,0,0
143325100200000,CONVENIENCE STORE,Commercial,0,430920,430920,0,369843,800763
143325100300000,FUNERAL HOME,Commercial,0,304560,304560,0,510775,815335
143325100400000,SW 403,Residential,35363,0,35363,54565,0,89928
143325100500000,SW 403,Residential,24327,0,24327,85488,0,109815
143325100600000,SW 403,Residential,23513,0,23513,67071,0,90584
143325100700000,SW 403,Residential,23513,0,23513,40241,0,63754
143325100800000,SW 403,Residential,23571,0,23571,66760,0,90331
143325100900000,SW 403,Residential,23571,0,23571,85208,0,108779
143325101000000,SW 403,Residential,25700,0,25700,65669,0,91369
143325101100000,SW 403,Residential,24109,0,24109,39863,0,63972
143325101200000,SW 403,Residential,23436,0,23436,46518,0,69954
143325101300000,SW 403,Residential,23436,0,23436,59903,0,83339
143325101400000,SW 403,Residential,23436,0,23436,65475,0,88911
143325101500000,SW 403,Residential,23436,0,23436,90758,0,114194
143325200100000,SW 403,Residential,18450,0,18450,63311,0,81761
143325200200000,SW 403,Residential,19710,0,19710,62942,0,82652
143325200300000,SW 403,Residential,22140,0,22140,37038,0,59178
143325200400000,SW 403,Residential,22140,0,22140,55545,0,77685
143325200500000,SW 403,Residential,22783,0,22783,58126,0,80909
143325200600000,SW 403,Residential,22771,0,22771,51588,0,74359
143325200700000,SW 403,Residential,22140,0,22140,53542,0,75682
143325200800000,SW 403,Residential,22140,0,22140,64000,0,86140
143325200900000,SW 403,Residential,24300,0,24300,74580,0,98880
143325201000000,SW 403,Residential,18450,0,18450,63481,0,81931
143327600100000,SW 412,Residential,22109,0,22109,80110,0,102219
143327600200000,SW 412,Residential,11900,0,11900,32150,0,44050
143327600300000,SW 412,Residential,17990,0,17990,60694,0,78684
143327600400000,SW 412,Residential,17000,0,17000,67783,0,84783
143327600500000,SW 412,Residential,17000,0,17000,100329,0,117329
143327600600000,SW 412,Residential,17000,0,17000,52206,0,69206
143327600700000,SW 412,Residential,17000,0,17000,63251,0,80251
143327600800000,SW 412,Residential,17000,0,17000,84260,0,101260
143327600900000,SW 412,Residential,21675,0,21675,78540,0,100215
143327601000000,SW 412,Residential,22109,0,22109,110309,0,132418
143327601100000,SW 412,Residential,17340,0,17340,78554,0,95894
143327601200000,SW 412,Residential,17340,0,17340,109203,0,126543
143327601300000,SW 412,Residential,17340,0,17340,75164,0,92504
143327601400000,SW 412,Residential,17340,0,17340,47325,0,64665
143327601500000,SW 412,Residential,17340,0,17340,103370,0,120710
143327700100000,SW 412,Residential,21675,0,21675,74851,0,96526
143327700200000,SW 412,Residential,17850,0,17850,70315,0,88165
143327700300000,SW 412,Residential,19665,0,19665,84763,0,104428
143327700400000,SW 412,Residential,18009,0,18009,65362,0,83371
143327700500000,SW 412,Residential,18720,0,18720,78169,0,96889
143327700600000,SW 412,Residential,18720,0,18720,86593,0,105313
143327700700000,SW 412,Residential,18720,0,18720,77183,0,95903
143327700800000,SW 412,Residential,18720,0,18720,89749,0,108469
143327700900000,SW 412,Residential,23868,0,23868,41975,0,65843
143327701000000,SW 412,Residential,21675,0,21675,106018,0,127693
143327701100000,SW 412,Residential,17000,0,17000,82496,0,99496
143327701200000,SW 412,Residential,17000,0,17000,63943,0,80943
143327701300000,SW 412,Residential,17000,0,17000,82763,0,99763
143327701400000,SW 412,Residential,17000,0,17000,88903,0,105903
143327701500000,SW 412,Residential,17000,0,17000,78099,0,95099
143327800100000,SW 412,Residential,26010,0,26010,55544,0,81554
143327800200000,SW 412,Residential,28384,0,28384,49401,0,77785
143327800300000,SW 412,Residential,26648,0,26648,119618,0,146266
143327800400000,SW 412,Residential,25500,0,25500,32999,0,58499
143327800500000,SW 412,Residential,25500,0,25500,102927,0,128427
143327800600000,SW 412,Residential,25500,0,25500,81143,0,106643
143327800700000,SW 412,Residential,17340,0,17340,100031,0,117371
143327800800000,SW 412,Residential,17340,0,17340,74129,0,91469
143327800900000,SW 412,Residential,17340,0,17340,38478,0,55818
143327801000000,SW 412,Residential,26010,0,26010,14396,0,40406
143327801100000,SW 412,Residential,26010,0,26010,69088,0,95098
143327900100000,SW 412,Residential,23205,0,23205,59009,0,82214
143327900200000,SW 412,Residential,9207,0,9207,21188,0,30395
143327900300000,SW 412,Residential,28080,0,28080,33889,0,61969
143327900400000,SW 412,Residential,28080,0,28080,78126,0,106206
143327900500000,SW 412,Residential,28080,0,28080,31456,0,59536
143327900600000,SW 412,Residential,18720,0,18720,61175,0,79895
143327900700000,SW 412,Residential,18720,0,18720,62658,0,81378
143327900800000,SW 412,Residential,18720,0,18720,47703,0,66423
143327900900000,SW 412,Residential,25500,0,25500,94248,0,119748
143327901000000,SW 412,Residential,30600,0,30600,54545,0,85145
143327901100000,SW 412,Residential,12750,0,12750,46600,0,59350
143327901200000,SW 412,Residential,12750,0,12750,63931,0,76681
143327901300000,SW 412,Residential,12750,0,12750,56478,0,69228
143328000100000,SW 412,Residential,20790,0,20790,69906,0,90696
143328000200000,SW 412,Residential,20790,0,20790,83737,0,104527
143328000300000,SW 412,Residential,21829,0,21829,104097,0,125926
143328000400000,SW 412,Residential,20790,0,20790,92245,0,113035
143328000500000,SW 412,Residential,20790,0,20790,72067,0,92857
143328000600000,SW 412,Residential,22523,0,22523,48445,0,70968
143328000700000,SW 412,Residential,19058,0,19058,69405,0,88463
143328000800000,SW 412,Residential,20790,0,20790,45646,0,66436
143328000900000,SW 412,Residential,23562,0,23562,147167,0,170729
143328100100000,SW 412,Residential,28177,0,28177,101444,0,129621
143328100200000,SW 412,Residential,17000,0,17000,52072,0,69072
143328100300000,SW 412,Residential,27200,0,27200,89336,0,116536
143328100400000,SW 412,Residential,30600,0,30600,69175,0,99775
143328100500000,SW 412,Residential,20188,0,20188,81777,0,101965
143328100600000,SW 412,Residential,22440,0,22440,88512,0,110952
143328100700000,SW 412,Residential,22440,0,22440,89418,0,111858
143328100800000,SW 412,Residential,13872,0,13872,0,0,13872
143328100900000,SW 412,Residential,13872,0,13872,91574,0,105446
143328101000000,SW 412,Residential,22950,0,22950,93241,0,116191
143328200100000,SW 412,Residential,22950,0,22950,115130,0,138080
143328200200000,SW 412,Residential,25272,0,25272,75978,0,101250
143328200300000,SW 412,Residential,25272,0,25272,71163,0,96435
143328200400000,SW 412,Residential,25272,0,25272,80809,0,106081
143328200500000,SW 412,Residential,25840,0,25840,45739,0,71579
143328200600000,SW 412,Residential,25840,0,25840,73624,0,99464
143328200700000,SW 412,Residential,22950,0,22950,118897,0,141847
143328200800000,SW 412,Residential,22950,0,22950,66126,0,89076
143328200900000,SW 412,Residential,22950,0,22950,94446,0,117396
143328201000000,SW 412,Residential,22950,0,22950,62145,0,85095
143328300100000,SW 412,Residential,15173,0,15173,76881,0,92054
143328300200000,SW 412,Residential,22610,0,22610,99709,0,122319
143328300300000,SW 412,Residential,19380,0,19380,75203,0,94583
143328300400000,SW 412,Residential,19380,0,19380,37804,0,57184
143328300500000,SW 412,Residential,16150,0,16150,87247,0,103397
143328300600000,SW 412,Residential,16150,0,16150,65192,0,81342
143328300700000,SW 412,Residential,16150,0,16150,87721,0,103871
143328300800000,SW 412,Residential,16150,0,16150,69342,0,85492
143328300900000,SW 412,Residential,23256,0,23256,82197,0,105453
143328301000000,SW 412,Residential,22253,0,22253,90315,0,112568
143328301100000,SW 412,Residential,19168,0,19168,73547,0,92715
143328301200000,SW 412,Residential,19152,0,19152,110137,0,129289
143328301300000,SW 412,Residential,13300,0,13300,72517,0,85817
143328301400000,SW 412,Residential,13300,0,13300,82336,0,95636
143328301500000,SW 412,Residential,14630,0,14630,82854,0,97484
143328301600000,SW 412,Residential,14630,0,14630,84749,0,99379
143328301700000,SW 412,Residential,14630,0,14630,76484,0,91114
143328301800000,SW 412,Residential,14630,0,14630,74981,0,89611
143328301900000,SW 412,Residential,15960,0,15960,88932,0,104892
143328302000000,SW 412,Residential,16660,0,16660,68498,0,85158
143328302100000,SW 412,Residential,16456,0,16456,51817,0,68273
143328302200000,SW 412,Residential,12566,0,12566,0,0,12566
143328302300000,SW 412,Residential,17340,0,17340,83363,0,100703
143328400100000,SW 412,Residential,21418,0,21418,83882,0,105300
143328400200000,SW 412,Residential,23644,0,23644,114491,0,138135
143330100100000,SW 416,Residential,57290,0,57290,133178,0,190468
143330100200000,SW 416,Residential,25680,0,25680,100891,0,126571
143330100300000,SW 416,Residential,31744,0,31744,67969,0,99713
143330100400000,SW 416,Residential,3120,0,3120,41128,0,44248
143330100500000,SW 416,Residential,17120,0,17120,82760,0,99880
143330100600000,SW 416,Residential,21400,0,21400,69192,0,90592
143330100700000,SW 416,Residential,21400,0,21400,95649,0,117049
143330100800000,SW 416,Residential,25680,0,25680,78740,0,104420
143330100900000,SW 416,Residential,29960,0,29960,102095,0,132055
143330101000000,SW 416,Residential,29680,0,29680,60439,0,90119
143330101100000,SW 416,Residential,33920,0,33920,64922,0,98842
143330101200000,SW 416,Residential,21200,0,21200,86850,0,108050
143330101300000,SW 416,Residential,30210,0,30210,39751,0,69961
143330101400000,SW 416,Residential,30210,0,30210,79012,0,109222
143330101500000,SW 416,Residential,21200,0,21200,74035,0,95235
143330101600000,SW 416,Residential,21200,0,21200,91889,0,113089
143330101700000,SW 416,Residential,21200,0,21200,109933,0,131133
143330101800000,SW 416,Residential,21200,0,21200,93051,0,114251
143330101900000,SW 416,Residential,17520,0,17520,73982,0,91502
143330102000000,SW 416,Residential,29792,0,29792,76366,0,106158
143330102100000,SW 416,Residential,30520,0,30520,93049,0,123569
143330102200000,SW 416,Residential,30520,0,30520,99009,0,129529
143330200100000,SW 417,Residential,37411,0,37411,71850,0,109261
143330200200000,SW 417,Residential,33600,0,33600,83021,0,116621
143330200300000,SW 417,Residential,35784,0,35784,114266,0,150050
143330300100000,SW 416,Residential,22565,0,22565,135124,0,157689
143330300200000,SW 416,Residential,25440,0,25440,103702,0,129142
143330300300000,SW 416,Residential,21200,0,21200,74441,0,95641
143330300400000,SW 416,Residential,21200,0,21200,98038,0,119238
143330300500000,SW 416,Residential,21200,0,21200,78249,0,99449
143330300600000,SW 416,Residential,21200,0,21200,87613,0,108813
143330300700000,SW 416,Residential,31800,0,31800,95860,0,127660
143330300800000,SW 416,Residential,21200,0,21200,79400,0,100600
143330300900000,SW 416,Residential,17600,0,17600,78105,0,95705
143330301000000,SW 416,Residential,29920,0,29920,82909,0,112829
143330301100000,SW 416,Residential,26075,0,26075,101749,0,127824
143330301200000,SW 416,Residential,23280,0,23280,78775,0,102055
143330301300000,SW 416,Residential,23280,0,23280,84488,0,107768
143330301400000,SW 416,Residential,23280,0,23280,105899,0,129179
143330301500000,SW 416,Residential,23280,0,23280,72302,0,95582
143330301600000,SW 416,Residential,23280,0,23280,84984,0,108264
143330301700000,SW 416,Residential,23280,0,23280,93969,0,117249
143330301800000,SW 416,Residential,23280,0,23280,71354,0,94634
143330301900000,SW 416,Residential,23280,0,23280,89275,0,112555
143330302000000,SW 416,Residential,23280,0,23280,105290,0,128570
143330302100000,SW 416,Residential,24240,0,24240,73900,0,98140
143330302200000,SW 416,Residential,30199,0,30199,86877,0,117076
143330302300000,SW 416,Residential,27160,0,27160,81634,0,108794
143330302400000,SW 416,Residential,20952,0,20952,55034,0,75986
143330400100000,SW 417,Residential,36400,0,36400,85690,0,122090
143330400200000,SW 417,Residential,32428,0,32428,104058,0,136486
143330400300000,SW 417,Residential,31200,0,31200,61180,0,92380
143330500100000,SW 416,Residential,27160,0,27160,85628,0,112788
143330500200000,SW 416,Residential,30031,0,30031,77974,0,108005
143330500300000,SW 416,Residential,23280,0,23280,52006,0,75286
143330500400000,SW 416,Residential,31040,0,31040,103704,0,134744
143330500500000,SW 416,Residential,27547,0,27547,111292,0,138839
143330500600000,SW 416,Residential,26000,0,26000,87694,0,113694
143330500700000,SW 416,Residential,28000,0,28000,100664,0,128664
143330500800000,SW 416,Residential,24000,0,24000,75173,0,99173
143330500900000,SW 416,Residential,28000,0,28000,109026,0,137026
143330501000000,SW 416,Residential,33810,0,33810,87495,0,121305
143330501100000,SW 416,Residential,30051,0,30051,92020,0,122071
143330501200000,SW 416,Residential,36855,0,36855,134297,0,171152
143330600100000,SW 416,Residential,29488,0,29488,88213,0,117701
143330600200000,SW 416,Residential,23280,0,23280,88196,0,111476
143330600300000,SW 416,Residential,23280,0,23280,101877,0,125157
143330600400000,SW 416,Residential,23280,0,23280,81914,0,105194
143330600500000,SW 416,Residential,23280,0,23280,83595,0,106875
143330600600000,SW 416,Residential,23180,0,23180,533,0,23713
143330600700000,SW 416,Residential,22848,0,22848,95728,0,118576
143330600800000,SW 416,Residential,22848,0,22848,122107,0,144955
143330600900000,SW 416,Residential,22848,0,22848,110848,0,133696
143330601000000,SW 416,Residential,26887,0,26887,123395,0,150282
143330601100000,SW 416,Residential,35451,0,35451,299815,0,335266
143330601200000,SW 416,Residential,24240,0,24240,7969,0,32209
143330601300000,SW 416,Residential,28280,0,28280,78516,0,106796
143330601400000,SW 416,Residential,27541,0,27541,83411,0,110952
143330700100000,SW 417,Residential,31200,0,31200,86794,0,117994
143330700200000,SW 417,Residential,32501,0,32501,154440,0,186941
143330700300000,SW 417,Residential,33051,0,33051,100339,0,133390
143330700400000,SW 417,Residential,29769,0,29769,89954,0,119723
143330700500000,SW 417,Residential,27495,0,27495,77744,0,105239
143332600100000,SW 417,Residential,32072,0,32072,73818,0,105890
143332600200000,SW 417,Residential,32882,0,32882,74739,0,107621
143332600300000,SW 417,Residential,30736,0,30736,88434,0,119170
143332600400000,SW 417,Residential,29380,0,29380,99721,0,129101
143332600500000,SW 417,Residential,28200,0,28200,57461,0,85661
143332600600000,SW 417,Residential,34642,0,34642,49931,0,84573
143332600700000,SW 417,Residential,28500,0,28500,45994,0,74494
143332600800000,SW 417,Residential,32700,0,32700,52949,0,85649
143332600900000,SW 417,Residential,34580,0,34580,51148,0,85728
143332601000000,SW 417,Residential,32589,0,32589,48220,0,80809
143332601100000,SW 417,Residential,30600,0,30600,59584,0,90184
143332700100000,SW 417,Residential,30600,0,30600,63229,0,93829
143332700200000,SW 417,Residential,30600,0,30600,57736,0,88336
143332700300000,SW 417,Residential,30600,0,30600,66270,0,96870
143332700400000,SW 417,Residential,30600,0,30600,85578,0,116178
143332700500000,SW 417,Residential,30600,0,30600,67080,0,97680
143332800100000,SW 417,Residential,31200,0,31200,86064,0,117264
143332800200000,SW 417,Residential,33197,0,33197,54217,0,87414
143332800300000,CITY PROPERTY,Exempt,0,0,0,0,0,0
143332800400000,SW 417,Residential,34800,0,34800,86108,0,120908
143332800500000,SERVICE STATION,Commercial,0,136307,136307,0,46132,182439
143332800600000,SW 417,Residential,28967,0,28967,48359,0,77326
143332800700000,SW 417,Residential,29760,0,29760,65798,0,95558
143332800800000,SW 417,Residential,31185,0,31185,46401,0,77586
143332800900000,SW 417,Residential,28215,0,28215,49802,0,78017
143332801000000,SW 417,Residential,28215,0,28215,71726,0,99941
143332801100000,SW 417,Residential,28215,0,28215,95341,0,123556
143332801200000,SW 417,Residential,28215,0,28215,48167,0,76382
143332801300000,SW 417,Residential,29490,0,29490,53966,0,83456
143332801400000,SW 417,Residential,29640,0,29640,50295,0,79935
143332801500000,SW 417,Residential,31200,0,31200,44643,0,75843
143332900100000,SW 417,Residential,32657,0,32657,75900,0,108557
143332900200000,SW 417,Residential,29100,0,29100,69973,0,99073
143332900300000,SW 417,Residential,29100,0,29100,60902,0,90002
143332900400000,SW 417,Residential,29100,0,29100,56555,0,85655
143332900500000,SW 417,Residential,31769,0,31769,68570,0,100339
143333000100000,SW 417,Residential,31977,0,31977,59543,0,91520
143333000200000,SW 417,Residential,32141,0,32141,50687,0,82828
143333000300000,SW 417,Residential,31984,0,31984,61079,0,93063
143333000400000,SW 417,Residential,33000,0,33000,55688,0,88688
143333000500000,SW 417,Residential,33789,0,33789,54910,0,88699
143333000600000,SW 417,Residential,28200,0,28200,51098,0,79298
143333000700000,SW 417,Residential,28200,0,28200,55498,0,83698
143333000800000,SW 417,Residential,28200,0,28200,49339,0,77539
143333000900000,SW 417,Residential,28200,0,28200,46930,0,75130
143333001000000,SW 417,Residential,32490,0,32490,52459,0,84949
143333001100000,SW 417,Residential,34800,0,34800,75334,0,110134
143333001200000,SW 417,Residential,33170,0,33170,61510,0,94680
143333001300000,SW 417,Residential,33480,0,33480,56608,0,90088
143333001400000,SW 417,Residential,28200,0,28200,59791,0,87991
143333001500000,SW 417,Residential,28200,0,28200,59664,0,87864
143333001600000,SW 417,Residential,29853,0,29853,63620,0,93473
143333001700000,SW 417,Residential,31927,0,31927,61980,0,93907
143333001800000,SW 417,Residential,33072,0,33072,65308,0,98380
143333001900000,SW 417,Residential,34650,0,34650,55728,0,90378
143333002000000,SW 417,Residential,32875,0,32875,69914,0,102789
143333002100000,SW 417,Residential,31882,0,31882,60758,0,92640
143333002200000,SW 417,Residential,28200,0,28200,55395,0,83595
143333002300000,SW 417,Residential,28200,0,28200,62480,0,90680
143333002400000,SW 417,Residential,28200,0,28200,58175,0,86375
143333002500000,SW 417,Residential,32542,0,32542,76361,0,108903
143333002600000,SW 417,Residential,32430,0,32430,46626,0,79056
143333002700000,SW 417,Residential,34216,0,34216,73323,0,107539
143333002800000,SW 417,Residential,33277,0,33277,47980,0,81257
143333002900000,SW 417,Residential,28200,0,28200,56803,0,85003
143333003000000,SW 417,Residential,28200,0,28200,49351,0,77551
143333003100000,SW 417,Residential,28200,0,28200,57020,0,85220
143333003200000,SW 417,Residential,28200,0,28200,55195,0,83395
143333003300000,SW 417,Residential,28200,0,28200,65106,0,93306
143333003400000,SW 417,Residential,31840,0,31840,48122,0,79962
143333100100000,SW 417,Residential,35092,0,35092,76792,0,111884
143333100200000,SW 417,Residential,33240,0,33240,69170,0,102410
143333100300000,SW 417,Residential,31492,0,31492,42576,0,74068
143333100400000,SW 417,Residential,30600,0,30600,71946,0,102546
143333100500000,SW 417,Residential,30600,0,30600,50616,0,81216
143333100600000,SW 417,Residential,33074,0,33074,42873,0,75947
143333100700000,SW 417,Residential,32559,0,32559,53519,0,86078
143333100800000,SW 417,Residential,33507,0,33507,57612,0,91119
143333100900000,SW 417,Residential,26875,0,26875,84153,0,111028
143333101000000,SW 417,Residential,29627,0,29627,60777,0,90404
143333101100000,SW 417,Residential,33180,0,33180,69100,0,102280
143333101200000,SW 417,Residential,32368,0,32368,65442,0,97810
143333101300000,SW 417,Residential,31850,0,31850,58475,0,90325
143333101400000,SW 417,Residential,32273,0,32273,53474,0,85747
143333101500000,SW 417,Residential,32974,0,32974,47390,0,80364
143333101600000,SW 417,Residential,30525,0,30525,50776,0,81301
143333101700000,SW 417,Residential,29700,0,29700,52916,0,82616
143333101800000,SW 417,Residential,31498,0,31498,56182,0,87680
143333101900000,SW 417,Residential,33725,0,33725,66996,0,100721
143333102000000,SW 417,Residential,30317,0,30317,103526,0,133843
143333102100000,SW 417,Residential,33934,0,33934,61954,0,95888
143333102200000,SW 417,Residential,34580,0,34580,52803,0,87383
143333102300000,SW 417,Residential,32500,0,32500,44673,0,77173
143333200100000,SW 417,Residential,28761,0,28761,52059,0,80820
143333200200000,SW 417,Residential,29100,0,29100,51476,0,80576
143333200300000,SW 417,Residential,29100,0,29100,52710,0,81810
143333200400000,SW 417,Residential,29100,0,29100,65563,0,94663
143333200500000,SW 417,Residential,29100,0,29100,45847,0,74947
143333200600000,SW 417,Residential,30555,0,30555,54080,0,84635
143333200700000,SW 417,Residential,30953,0,30953,54722,0,85675
143333300100000,SW 417,Residential,29941,0,29941,48472,0,78413
143333300200000,SW 417,Residential,31927,0,31927,51755,0,83682
143333300300000,SW 417,Residential,36907,0,36907,61444,0,98351
143333300400000,SW 417,Residential,33262,0,33262,50105,0,83367
143333300500000,SW 417,Residential,30690,0,30690,66471,0,97161
143333300600000,SW 417,Residential,32743,0,32743,57317,0,90060
143333300700000,SW 417,Residential,34968,0,34968,51787,0,86755
143333300800000,SW 417,Residential,31809,0,31809,53471,0,85280
143333300900000,SW 417,Residential,32007,0,32007,73578,0,105585
143333301000000,SW 417,Residential,31587,0,31587,54671,0,86258
143333301100000,SW 417,Residential,31752,0,31752,87611,0,119363
143333301200000,SW 417,Residential,29340,0,29340,59859,0,89199
143333301300000,SW 417,Residential,31920,0,31920,51381,0,83301
143333301400000,SW 417,Residential,31490,0,31490,53294,0,84784
143333301500000,SW 417,Residential,30550,0,30550,55258,0,85808
143333301600000,SW 417,Residential,30550,0,30550,54681,0,85231
143333301700000,SW 417,Residential,30546,0,30546,42454,0,73000
143333301800000,SW 417,Residential,31200,0,31200,48787,0,79987
143333301900000,SW 417,Residential,32300,0,32300,49907,0,82207
143333302000000,SW 417,Residential,31200,0,31200,75866,0,107066
143333400100000,SW 417,Residential,31667,0,31667,50589,0,82256
143333400200000,SW 417,Residential,31525,0,31525,57587,0,89112
143333400300000,SW 417,Residential,29700,0,29700,54869,0,84569
143333400400000,SW 417,Residential,28333,0,28333,62848,0,91181
143333400500000,SW 417,Residential,29667,0,29667,51767,0,81434
143333400600000,SW 417,Residential,32292,0,32292,59100,0,91392
143333400700000,SW 417,Residential,32754,0,32754,53034,0,85788
143333400800000,SW 417,Residential,32627,0,32627,63220,0,95847
143333400900000,SW 417,Residential,33075,0,33075,47223,0,80298
143333401000000,SW 417,Residential,33598,0,33598,65644,0,99242
143333401100000,SW 417,Residential,34457,0,34457,92528,0,126985
143333401200000,SW 417,Residential,32521,0,32521,52328,0,84849
143333401300000,SW 417,Residential,29425,0,29425,59755,0,89180
143333401400000,SW 417,Residential,30520,0,30520,51575,0,82095
143333401500000,SW 417,Residential,32221,0,32221,68331,0,100552
143333401600000,SW 417,Residential,31973,0,31973,70141,0,102114
143333401700000,SW 417,Residential,29067,0,29067,69752,0,98819
143333401800000,SW 417,Residential,32375,0,32375,54718,0,87093
143333401900000,SW 417,Residential,31850,0,31850,60851,0,92701
143333402000000,SW 417,Residential,28800,0,28800,80964,0,109764
143333500100000,SW 417,Residential,31027,0,31027,67986,0,99013
143333500200000,SW 417,Residential,30625,0,30625,48127,0,78752
143333500300000,SW 417,Residential,32700,0,32700,54712,0,87412
143333500400000,SW 417,Residential,34352,0,34352,44194,0,78546
143333500500000,SW 417,Residential,32870,0,32870,48807,0,81677
143333500600000,SW 417,Residential,33345,0,33345,79677,0,113022
143333500700000,SW 417,Residential,38867,0,38867,56305,0,95172
143335100200000,SW 417,Residential,30600,0,30600,53182,0,83782
143335100300000,SW 417,Residential,30600,0,30600,49161,0,79761
143335100400000,SW 417,Residential,30600,0,30600,66032,0,96632
143335100500000,SW 417,Residential,30600,0,30600,47945,0,78545
143335100600000,SW 417,Residential,30600,0,30600,39798,0,70398
143335100800000,SW 417,Residential,30600,0,30600,78377,0,108977
143335100900000,SW 417,Residential,30600,0,30600,58132,0,88732
143335101000000,SW 417,Residential,30600,0,30600,50883,0,81483
143335101100000,SW 417,Residential,30600,0,30600,45604,0,76204
143335101200000,SW 417,Residential,30600,0,30600,53096,0,83696
143335200100000,SW 417,Residential,26176,0,26176,120562,0,146738
143335200200000,SW 417,Residential,21400,0,21400,69303,0,90703
143335200300000,SW 417,Residential,29520,0,29520,90064,0,119584
143335200400000,SW 417,Residential,29520,0,29520,64802,0,94322
143335200500000,SW 417,Residential,29520,0,29520,87861,0,117381
143335200600000,SW 417,Residential,29520,0,29520,58608,0,88128
143335200700000,SW 417,Residential,29520,0,29520,94350,0,123870
143335200800000,SW 417,Residential,29520,0,29520,84661,0,114181
143335200900000,SW 417,Residential,29520,0,29520,101464,0,130984
143335201000000,SW 417,Residential,29520,0,29520,94306,0,123826
143335201100000,SW 417,Residential,29520,0,29520,50597,0,80117
143335201200000,SW 417,Residential,27820,0,27820,81117,0,108937
143335201300000,SW 417,Residential,24192,0,24192,53774,0,77966
143335201400000,OFFICE; MEDICAL,Commercial,0,106434,106434,0,193620,300054
143335201500000,RESTAURANT,Commercial,0,153770,153770,0,136438,290208
143335201600000,VETERINARY CLINIC,Commercial,0,137970,137970,0,168145,306115
143335201700000,CARWASH,Commercial,0,243000,243000,0,145154,388154
143335201800000,SW 417,Residential,29520,0,29520,97726,0,127246
143335201900000,SW 417,Residential,28782,0,28782,3033,0,31815
143335202000000,SW 417,Residential,25092,0,25092,77909,0,103001
143335202100000,SW 417,Residential,24600,0,24600,61765,0,86365
143335202200000,SW 417,Residential,24600,0,24600,35113,0,59713
143335202300000,SW 417,Residential,24600,0,24600,36598,0,61198
143335202400000,SW 417,Residential,24600,0,24600,103580,0,128180
143335202500000,SW 417,Residential,24600,0,24600,88784,0,113384
143335202600000,SW 417,Residential,29520,0,29520,84458,0,113978
143335202700000,SW 417,Residential,29520,0,29520,73195,0,102715
143335202800000,SW 417,Residential,29520,0,29520,119015,0,148535
143335202900000,SW 417,Residential,24600,0,24600,76454,0,101054
143335203000000,SW 417,Residential,24600,0,24600,112219,0,136819
143335203100000,SW 417,Residential,32472,0,32472,82252,0,114724
143335300100000,SW 417,Residential,21400,0,21400,64283,0,85683
143335300200000,SW 417,Residential,3200,0,3200,0,0,3200
143335300300000,SW 417,Residential,24600,0,24600,83112,0,107712
143335300400000,SW 417,Residential,21400,0,21400,96155,0,117555
143335300500000,SW 417,Residential,25020,0,25020,76895,0,101915
143335300700000,SW 417,Residential,29520,0,29520,88776,0,118296
143335300800000,SW 417,Residential,29520,0,29520,35179,0,64699
143335300900000,SW 417,Residential,20400,0,20400,62263,0,82663
143335301000000,SW 417,Residential,20400,0,20400,48890,0,69290
143335301100000,SW 417,Residential,8400,0,8400,0,0,8400
143335301200000,SW 417,Residential,24600,0,24600,48704,0,73304
143335301300000,SW 417,Residential,24600,0,24600,48725,0,73325
143335301400000,SW 417,Residential,24600,0,24600,75434,0,100034
143335301800000,APARTMENT,Commercial,0,14542,14542,0,133997,148539
143335301900000,FLAT PARKING,Commercial,0,48182,48182,0,4506,52688
143335302000000,FLAT PARKING,Commercial,0,48600,48600,0,5226,53826
143335302300000,RESTAURANT,Commercial,0,148824,148824,0,255468,404292
143335302400000,OFFICE,Commercial,0,143856,143856,0,449299,593155
143335302500000,STATE PROPERTY,Exempt,0,0,0,0,0,0
143335302600000,SW 417,Residential,25560,0,25560,31177,0,56737
143335302700000,SW 417,Residential,20800,0,20800,36575,0,57375
143335400100000,CHURCH,Exempt,0,76680,76680,0,338702,415382
143335400700000,SW 417,Residential,29120,0,29120,85037,0,114157
143335401300000,SW 417,Residential,27975,0,27975,72797,0,100772
143335401400000,SW 417,Residential,28125,0,28125,100697,0,128822
143335401500000,SW 417,Residential,25000,0,25000,67032,0,92032
143335401600000,SW 417,Residential,25000,0,25000,59394,0,84394
143335401700000,SW 417,Residential,5400,0,5400,0,0,5400
143335401800000,VACANT LAND,Commercial,0,43675,43675,0,0,43675
143335401900000,SW 417,Residential,19400,0,19400,89195,0,108595
143335402000000,SW 417,Residential,29120,0,29120,116085,0,145205
143335402100000,SW 417,Residential,29120,0,29120,112543,0,141663
143335402200000,SW 417,Residential,29120,0,29120,106202,0,135322
143335402300000,SW 417,Residential,35700,0,35700,76559,0,112259
143335402400000,SW 417,Residential,28860,0,28860,50372,0,79232
143335402500000,APARTMENT,Exempt,0,41904,41904,0,461525,503429
143337600100000,SW 416,Residential,31320,0,31320,73665,0,104985
143337600200000,SW 416,Residential,30246,0,30246,87548,0,117794
143337600300000,SW 416,Residential,45475,0,45475,69109,0,114584
143337600400000,SW 416,Residential,22377,0,22377,107344,0,129721
143337600500000,SW 416,Residential,22050,0,22050,104134,0,126184
143337600600000,SW 416,Residential,22050,0,22050,73820,0,95870
143337600700000,SW 416,Residential,22050,0,22050,77679,0,99729
143337600800000,SW 416,Residential,22600,0,22600,82474,0,105074
143337600900000,SW 416,Residential,27247,0,27247,105508,0,132755
143337601000000,SW 416,Residential,27010,0,27010,92331,0,119341
143337601100000,SW 416,Residential,32878,0,32878,108919,0,141797
143337601200000,SW 416,Residential,29880,0,29880,65082,0,94962
143337601300000,SW 416,Residential,29520,0,29520,79861,0,109381
143337601400000,SW 416,Residential,33408,0,33408,50033,0,83441
143337700100000,SW 417,Residential,40248,0,40248,110833,0,151081
143337700200000,SW 417,Exempt,0,29980,29980,0,115517,145497
143337800100000,SW 416,Residential,23680,0,23680,67306,0,90986
143337800200000,SW 416,Residential,23600,0,23600,66009,0,89609
143337800300000,SW 416,Residential,23600,0,23600,72897,0,96497
143337800400000,SW 416,Residential,23600,0,23600,82996,0,106596
143337800500000,SW 416,Residential,23600,0,23600,82603,0,106203
143337800600000,SW 416,Residential,30401,0,30401,54599,0,85000
143337800700000,SW 416,Residential,17700,0,17700,90308,0,108008
143337800900000,SW 416,Residential,26550,0,26550,105950,0,132500
143337801000000,SW 416,Residential,23600,0,23600,121928,0,145528
143337801100000,SW 416,Residential,23600,0,23600,88383,0,111983
143337801200000,SW 416,Residential,26260,0,26260,59770,0,86030
143337801300000,SW 416,Residential,30373,0,30373,75329,0,105702
143337801400000,SW 416,Residential,24662,0,24662,86486,0,111148
143337801500000,SW 416,Residential,30680,0,30680,93318,0,123998
143337801600000,SW 416,Residential,30680,0,30680,76862,0,107542
143337801700000,SW 416,Residential,30680,0,30680,72439,0,103119
143337801800000,SW 416,Residential,30680,0,30680,119380,0,150060
143337801900000,SW 416,Residential,30680,0,30680,44232,0,74912
143337802000000,SW 416,Residential,32400,0,32400,70867,0,103267
143337802200000,SW 416,Residential,22200,0,22200,68772,0,90972
143337802300000,SW 416,Residential,22200,0,22200,66397,0,88597
143337802400000,SW 416,Residential,29600,0,29600,96560,0,126160
143337802500000,SW 416,Residential,30192,0,30192,49936,0,80128
143337802600000,SW 416,Residential,8850,0,8850,0,0,8850
143337900100000,SW 417,Residential,32472,0,32472,55938,0,88410
143337900200000,SW 417,Residential,30602,0,30602,0,0,30602
143337900300000,SW 417,Residential,30602,0,30602,76689,0,107291
143338000100000,SW 416,Residential,29098,0,29098,62881,0,91979
143338000200000,SW 416,Residential,20000,0,20000,65411,0,85411
143338000300000,SW 416,Exempt,0,35107,35107,0,237041,272148
143338000400000,SW 416,Residential,23600,0,23600,34013,0,57613
143338000500000,SW 416,Residential,23600,0,23600,93706,0,117306
143338000600000,SW 416,Residential,30680,0,30680,38916,0,69596
143338000700000,SW 416,Residential,20000,0,20000,59925,0,79925
143338000800000,SW 416,Residential,24480,0,24480,84320,0,108800
143338000900000,SW 416,Residential,30680,0,30680,67701,0,98381
143338001000000,SW 416,Residential,30680,0,30680,100918,0,131598
143338001100000,SW 416,Residential,28025,0,28025,119568,0,147593
143338001200000,SW 416,Residential,10594,0,10594,0,0,10594
143338100100000,SW 417,Residential,25092,0,25092,66751,0,91843
143340100100000,SERVICE STATION,Commercial,0,64260,64260,0,75179,139439
143340100200000,FLAT PARKING,Commercial,0,127613,127613,0,15000,142613
143340100700000,SW 414,Residential,22220,0,22220,64692,0,86912
143340100800000,SW 414,Residential,22220,0,22220,82541,0,104761
143340100900000,SW 414,Residential,22220,0,22220,59680,0,81900
143340101000000,SW 414,Residential,24240,0,24240,54669,0,78909
143340101100000,SW 414,Residential,24240,0,24240,87694,0,111934
143340101200000,SW 414,Residential,38784,0,38784,87981,0,126765
143340101300000,SW 414,Residential,22220,0,22220,64639,0,86859
143340101400000,SW 414,Residential,37774,0,37774,103530,0,141304
143340101600000,SW 414,Residential,38896,0,38896,147203,0,186099
143340101700000,SMALL RETAIL,Commercial,0,63202,63202,0,103281,166483
143340200100000,SW 414,Residential,30001,0,30001,85005,0,115006
143340200200000,SW 414,Residential,30492,0,30492,93586,0,124078
143340200300000,SW 414,Residential,29700,0,29700,112585,0,142285
143340200400000,SW 414,Residential,29399,0,29399,125331,0,154730
143340200500000,SW 414,Residential,17820,0,17820,137395,0,155215
143340200600000,SW 414,Residential,32640,0,32640,117411,0,150051
143340200700000,SW 414,Residential,32640,0,32640,110483,0,143123
143340200800000,SW 414,Residential,22220,0,22220,110355,0,132575
143340200900000,SW 414,Residential,23028,0,23028,82278,0,105306
143340201000000,SW 414,Residential,13120,0,13120,71702,0,84822
143340201100000,SW 414,Residential,26320,0,26320,93086,0,119406
143340201200000,SW 414,Residential,30410,0,30410,104192,0,134602
143340201300000,SW 414,Residential,29700,0,29700,84676,0,114376
143340201400000,SW 414,Residential,29700,0,29700,117772,0,147472
143340201500000,SW 414,Residential,30114,0,30114,83463,0,113577
143340201600000,SW 414,Residential,24313,0,24313,100983,0,125296
143340201700000,SW 414,Residential,24000,0,24000,107424,0,131424
143340201800000,SW 414,Residential,24000,0,24000,82355,0,106355
143340201900000,SW 414,Residential,24000,0,24000,81110,0,105110
143340202000000,SW 414,Residential,24501,0,24501,87389,0,111890
143340202100000,SW 414,Residential,34263,0,34263,85546,0,119809
143340300100000,SW 414,Residential,27750,0,27750,73215,0,100965
143340300200000,SW 414,Residential,36630,0,36630,54849,0,91479
143340300300000,SW 414,Residential,35200,0,35200,133242,0,168442
143340300400000,SW 414,Residential,38085,0,38085,71876,0,109961
143340300500000,SW 414,Residential,24500,0,24500,157336,0,181836
143340300600000,SW 414,Residential,29256,0,29256,159205,0,188461
143340300700000,SW 414,Residential,23316,0,23316,127929,0,151245
143340300800000,SW 414,Residential,23563,0,23563,117318,0,140881
143340300900000,SW 414,Residential,29854,0,29854,186516,0,216370
143340301000000,SW 414,Residential,29639,0,29639,170741,0,200380
143340301100000,CITY PROPERTY,Exempt,0,0,0,0,0,0
143340301200000,SW 414,Residential,32438,0,32438,129917,0,162355
143340301300000,SW 414,Residential,29645,0,29645,142944,0,172589
143340301400000,SW 414,Residential,27440,0,27440,151081,0,178521
143340301500000,SW 414,Residential,27440,0,27440,148900,0,176340
143340301600000,SW 414,Residential,29700,0,29700,141832,0,171532
143340301700000,SW 414,Residential,31441,0,31441,86603,0,118044
143340301800000,SW 414,Residential,27904,0,27904,94496,0,122400
143340301900000,SW 414,Residential,28560,0,28560,121869,0,150429
143340302000000,SW 414,Residential,29245,0,29245,113697,0,142942
143340302100000,SW 414,Residential,29120,0,29120,110712,0,139832
143340302200000,SW 414,Residential,29120,0,29120,120325,0,149445
143340302300000,SW 414,Residential,29536,0,29536,107634,0,137170
143340302400000,SW 414,Residential,29536,0,29536,101255,0,130791
143340302500000,SW 414,Residential,26624,0,26624,96706,0,123330
143340302600000,SW 414,Residential,26624,0,26624,87206,0,113830
143340302700000,SW 414,Residential,28343,0,28343,109719,0,138062
143340302800000,SW 414,Residential,25326,0,25326,96527,0,121853
143340302900000,SW 414,Residential,24960,0,24960,137010,0,161970
143340303000000,SW 414,Residential,29623,0,29623,123398,0,153021
143340303100000,SW 414,Residential,24594,0,24594,112794,0,137388
143340303200000,SW 414,Residential,29083,0,29083,118712,0,147795
143340400100000,SW 414,Residential,27528,0,27528,94307,0,121835
143340400200000,SW 414,Residential,27200,0,27200,121263,0,148463
143340400300000,SW 414,Residential,27200,0,27200,126261,0,153461
143340400400000,SW 414,Residential,26889,0,26889,137925,0,164814
143340400500000,SW 414,Residential,30457,0,30457,130581,0,161038
143340400600000,SW 414,Residential,26624,0,26624,127400,0,154024
143340400700000,SW 414,Residential,26624,0,26624,119812,0,146436
143340400800000,SW 414,Residential,25376,0,25376,93543,0,118919
143340400900000,SW 414,Residential,23560,0,23560,97803,0,121363
143340401000000,SW 414,Residential,28500,0,28500,109488,0,137988
143340401100000,SW 414,Residential,27260,0,27260,108893,0,136153
143340401200000,SW 414,Residential,23365,0,23365,96566,0,119931
143340401300000,SW 414,Residential,21216,0,21216,115782,0,136998
143340401400000,SW 414,Residential,24544,0,24544,134561,0,159105
143340401500000,SW 414,Residential,26912,0,26912,131182,0,158094
143340401600000,SW 414,Residential,32573,0,32573,97280,0,129853
143340500100000,SW 414,Residential,27512,0,27512,105055,0,132567
143340500200000,SW 414,Residential,27200,0,27200,93300,0,120500
143340500300000,SW 414,Residential,27200,0,27200,93307,0,120507
143340500400000,SW 414,Residential,27300,0,27300,98243,0,125543
143340500500000,SW 414,Residential,29856,0,29856,122638,0,152494
143340500600000,SW 414,Residential,31500,0,31500,103775,0,135275
143340500700000,SW 414,Residential,31500,0,31500,108671,0,140171
143340500800000,SW 414,Residential,31500,0,31500,91608,0,123108
143340500900000,SW 414,Residential,31676,0,31676,106183,0,137859
143340501000000,SW 414,Residential,31408,0,31408,122300,0,153708
143340501100000,SW 414,Residential,30231,0,30231,134500,0,164731
143340501200000,SW 414,Residential,30023,0,30023,125083,0,155106
143340501300000,SW 414,Residential,31616,0,31616,97296,0,128912
143340501400000,SW 414,Residential,29884,0,29884,114432,0,144316
143340600100000,SW 414,Residential,32320,0,32320,94707,0,127027
143340600200000,SW 414,Residential,32320,0,32320,113338,0,145658
143340600300000,SW 414,Residential,24244,0,24244,136314,0,160558
143340600400000,SW 414,Residential,24279,0,24279,85025,0,109304
143340600500000,SW 414,Residential,25096,0,25096,90307,0,115403
143340600600000,SW 414,Residential,26004,0,26004,85055,0,111059
143340700100000,SW 414,Residential,26532,0,26532,124294,0,150826
143340700200000,SW 414,Residential,25344,0,25344,100828,0,126172
143340700300000,SW 414,Residential,25044,0,25044,102275,0,127319
143340700400000,SW 414,Residential,22639,0,22639,103941,0,126580
143340700500000,SW 414,Residential,22007,0,22007,104162,0,126169
143340700600000,SW 414,Residential,23066,0,23066,105847,0,128913
143340700700000,SW 414,Residential,22272,0,22272,91880,0,114152
143340700800000,SW 414,Residential,28200,0,28200,110599,0,138799
143340800100000,SW 414,Residential,22902,0,22902,101123,0,124025
143340800200000,SW 414,Residential,28800,0,28800,106225,0,135025
143340800300000,SW 414,Residential,26880,0,26880,109759,0,136639
143340800400000,SW 414,Residential,25728,0,25728,102232,0,127960
143340800500000,SW 414,Residential,25192,0,25192,104516,0,129708
143340800600000,SW 414,Residential,27648,0,27648,111655,0,139303
143340800700000,SW 414,Residential,27840,0,27840,120751,0,148591
143340800800000,SW 414,Residential,23094,0,23094,118847,0,141941
143340900100000,SW 414,Residential,26112,0,26112,91732,0,117844
143340900200000,SW 414,Residential,29184,0,29184,105304,0,134488
143340900300000,SW 414,Residential,31280,0,31280,98149,0,129429
143340900400000,SW 414,Residential,28996,0,28996,105425,0,134421
143340900500000,SW 414,Residential,26624,0,26624,95153,0,121777
143340900600000,SW 414,Residential,27252,0,27252,91150,0,118402
143340900700000,SW 414,Residential,24576,0,24576,95681,0,120257
143340900800000,SW 414,Residential,27648,0,27648,82413,0,110061
143340900900000,SW 414,Residential,25344,0,25344,119574,0,144918
143340901000000,SW 414,Residential,26112,0,26112,88810,0,114922
143340901100000,SW 414,Residential,25344,0,25344,103942,0,129286
143340901200000,SW 414,Residential,25608,0,25608,118916,0,144524
143340901300000,SW 414,Residential,25840,0,25840,90095,0,115935
143341000100000,SW 414,Residential,32623,0,32623,108883,0,141506
143341000200000,SW 414,Residential,25542,0,25542,110285,0,135827
143341000300000,SW 414,Residential,25415,0,25415,131928,0,157343
143341000400000,SW 414,Residential,24933,0,24933,138954,0,163887
143341000500000,SW 414,Residential,28616,0,28616,102701,0,131317
143341000600000,SW 414,Residential,26264,0,26264,114477,0,140741
143342600100000,SW 416,Residential,34560,0,34560,104558,0,139118
143342600200000,SW 416,Residential,28800,0,28800,79046,0,107846
143342600300000,SW 416,Residential,26773,0,26773,62075,0,88848
143342600400000,SW 416,Residential,26773,0,26773,95733,0,122506
143342600500000,SW 416,Residential,27192,0,27192,77796,0,104988
143342600600000,SW 416,Residential,27192,0,27192,60035,0,87227
143342600700000,SW 416,Residential,27192,0,27192,91009,0,118201
143342600800000,SW 416,Residential,25872,0,25872,106183,0,132055
143342600900000,SW 416,Residential,33947,0,33947,91298,0,125245
143342601000000,SW 416,Residential,21560,0,21560,122417,0,143977
143342601100000,SW 416,Residential,14896,0,14896,39826,0,54722
143342601200000,SW 416,Residential,14896,0,14896,52491,0,67387
143342601300000,SW 416,Residential,14896,0,14896,42634,0,57530
143342601400000,SW 416,Residential,14896,0,14896,74770,0,89666
143342601500000,SW 416,Residential,14896,0,14896,102198,0,117094
143342601600000,SW 416,Residential,28248,0,28248,71751,0,99999
143342601700000,SW 416,Residential,27192,0,27192,109392,0,136584
143342601800000,SW 416,Residential,27192,0,27192,73539,0,100731
143342601900000,SW 416,Residential,27192,0,27192,63249,0,90441
143342602000000,SW 416,Residential,32320,0,32320,0,0,32320
143342602100000,SW 416,Residential,34613,0,34613,152966,0,187579
143342700100000,SCHOOL,Exempt,0,0,0,0,0,0
143342700102000,ANTENNAS/TOWERS(BLL),Commercial,0,0,0,0,6046,6046
143342700200000,SW 416,Residential,27440,0,27440,92725,0,120165
143342700300000,SW 416,Residential,17640,0,17640,63259,0,80899
143342700400000,SW 416,Residential,15680,0,15680,57749,0,73429
143342700500000,SW 416,Residential,23520,0,23520,64699,0,88219
143342700600000,SW 416,Residential,23520,0,23520,60546,0,84066
143342700700000,SW 416,Residential,15680,0,15680,46226,0,61906
143342700800000,SW 416,Residential,32928,0,32928,76010,0,108938
143342700900000,SW 416,Residential,15680,0,15680,78380,0,94060
143342701000000,SW 416,Residential,15680,0,15680,91252,0,106932
143342701100000,SW 416,Residential,15680,0,15680,57142,0,72822
143342701200000,SW 416,Residential,15680,0,15680,63370,0,79050
143342701300000,SW 416,Residential,15680,0,15680,69492,0,85172
143342701400000,SW 416,Residential,15680,0,15680,69802,0,85482
143342701500000,SW 416,Residential,31360,0,31360,59067,0,90427
143342701600000,SW 416,Residential,31360,0,31360,85581,0,116941
143342701700000,SW 416,Residential,15680,0,15680,70263,0,85943
143342800100000,SW 414,Residential,31406,0,31406,200145,0,231551
143342800200000,SW 416,Residential,23357,0,23357,98371,0,121728
143342800300000,SW 416,Residential,23660,0,23660,74999,0,98659
143342800400000,SW 416,Residential,23660,0,23660,75127,0,98787
143342800500000,SW 416,Residential,25480,0,25480,99920,0,125400
143342800600000,SW 416,Residential,25480,0,25480,76409,0,101889
143342800700000,SW 416,Residential,23660,0,23660,74945,0,98605
143342800800000,SW 416,Residential,23400,0,23400,73798,0,97198
143342800900000,SW 416,Residential,23400,0,23400,114925,0,138325
143342801000000,SW 416,Residential,23400,0,23400,94743,0,118143
143342801100000,SW 416,Residential,23400,0,23400,104346,0,127746
143342801200000,SW 416,Residential,23400,0,23400,104567,0,127967
143342801300000,SW 416,Residential,21900,0,21900,91706,0,113606
143342801400000,SW 416,Residential,38372,0,38372,181763,0,220135
143342801600000,SW 414,Residential,28200,0,28200,168261,0,196461
143342801700000,SW 414,Residential,25220,0,25220,163258,0,188478
143342801800000,SW 414,Residential,25221,0,25221,156659,0,181880
143342801900000,SW 414,Residential,27432,0,27432,123539,0,150971
143342802000000,SW 414,Residential,32127,0,32127,198599,0,230726
143342900100000,SW 416,Residential,28382,0,28382,84920,0,113302
143342900200000,SW 416,Residential,20440,0,20440,63307,0,83747
143342900300000,SW 416,Residential,17520,0,17520,47755,0,65275
143342900400000,SW 416,Residential,14720,0,14720,57912,0,72632
143342900500000,SW 416,Residential,14720,0,14720,52629,0,67349
143342900600000,SW 416,Residential,15688,0,15688,59949,0,75637
143342900700000,SW 416,Residential,18232,0,18232,55038,0,73270
143342900800000,SW 416,Residential,16960,0,16960,107102,0,124062
143342900900000,SW 416,Residential,16960,0,16960,77016,0,93976
143342901000000,SW 416,Residential,16960,0,16960,85543,0,102503
143342901100000,SW 416,Residential,16960,0,16960,85117,0,102077
143342901200000,SW 416,Residential,25440,0,25440,88077,0,113517
143342901300000,SW 416,Residential,25440,0,25440,161373,0,186813
143342901400000,SW 416,Residential,16960,0,16960,76291,0,93251
143342901500000,SW 416,Residential,25440,0,25440,70608,0,96048
143342901600000,SW 416,Residential,25440,0,25440,89664,0,115104
143342901700000,SW 416,Residential,16960,0,16960,80295,0,97255
143342901800000,SW 416,Residential,16960,0,16960,59954,0,76914
143342901900000,SW 416,Residential,25440,0,25440,81423,0,106863
143342902000000,SW 416,Residential,21200,0,21200,96191,0,117391
143342902100000,SW 416,Residential,21200,0,21200,68712,0,89912
143342902200000,SW 416,Residential,27341,0,27341,84056,0,111397
143342902300000,SW 416,Residential,19584,0,19584,22706,0,42290
143342902400000,SW 416,Residential,24106,0,24106,63094,0,87200
143342902500000,SW 416,Residential,23654,0,23654,85663,0,109317
143342902600000,SW 416,Residential,30528,0,30528,71385,0,101913
143342902700000,SW 416,Residential,30528,0,30528,89938,0,120466
143342902800000,SW 416,Residential,30528,0,30528,88504,0,119032
143342902900000,SW 416,Residential,30528,0,30528,66835,0,97363
143342903000000,SW 416,Residential,16960,0,16960,32660,0,49620
143342903100000,SW 416,Residential,16960,0,16960,73128,0,90088
143342903200000,SW 416,Residential,30528,0,30528,79419,0,109947
143342903300000,SW 416,Residential,16960,0,16960,84131,0,101091
143342903400000,SW 416,Residential,16960,0,16960,34000,0,50960
143342903500000,SW 416,Residential,16960,0,16960,32524,0,49484
143342903600000,SW 416,Residential,16960,0,16960,66610,0,83570
143342903900000,SW 416,Residential,16960,0,16960,50309,0,67269
143342904000000,SW 416,Residential,30528,0,30528,96294,0,126822
143345100100000,SW 416,Residential,26000,0,26000,75648,0,101648
143345100200000,SW 416,Residential,33800,0,33800,74163,0,107963
143345100300000,SW 416,Residential,31383,0,31383,67953,0,99336
143345100400000,SW 416,Residential,29342,0,29342,139760,0,169102
143345100500000,SW 416,Residential,24729,0,24729,78855,0,103584
143345100600000,SW 416,Residential,21400,0,21400,61713,0,83113
143345100700000,SW 416,Residential,21800,0,21800,54418,0,76218
143345100800000,SW 416,Residential,22200,0,22200,68382,0,90582
143345200100000,SW 416,Residential,30274,0,30274,113860,0,144134
143345200200000,SW 416,Residential,29815,0,29815,97670,0,127485
143345200300000,SW 416,Residential,33068,0,33068,71668,0,104736
143345200400000,SW 416,Residential,25568,0,25568,52105,0,77673
143345200500000,SW 416,Residential,18424,0,18424,61042,0,79466
143345200600000,SW 416,Residential,19461,0,19461,64749,0,84210
143345200700000,SW 416,Residential,19440,0,19440,85018,0,104458
143345200800000,SW 416,Residential,19440,0,19440,138729,0,158169
143345200900000,SW 416,Residential,22846,0,22846,79501,0,102347
143345201000000,SW 416,Residential,19656,0,19656,86286,0,105942
143345201100000,SW 416,Residential,26136,0,26136,98630,0,124766
143345201200000,SW 416,Residential,21414,0,21414,84686,0,106100
143345300100000,SW 416,Residential,24060,0,24060,110406,0,134466
143345300200000,SW 416,Residential,31541,0,31541,68190,0,99731
143345300300000,SW 416,Residential,28000,0,28000,44001,0,72001
143345300400000,SW 416,Residential,27200,0,27200,81098,0,108298
143345300500000,SW 416,Residential,45875,0,45875,135614,0,181489
143345300600000,SW 416,Residential,45925,0,45925,0,0,45925
143345300700000,SCHOOL,Exempt,0,0,0,0,0,0
143345300800000,SW 416,Residential,29505,0,29505,65611,0,95116
143345300900000,SW 416,Residential,19600,0,19600,89284,0,108884
143345301000000,SW 416,Residential,23520,0,23520,84694,0,108214
143345301100000,SW 416,Residential,23520,0,23520,57333,0,80853
143345301200000,SW 416,Residential,25480,0,25480,99232,0,124712
143345301300000,SW 416,Residential,21560,0,21560,79947,0,101507
143345301400000,SW 416,Residential,23520,0,23520,59954,0,83474
143345301500000,SW 416,Residential,29400,0,29400,66361,0,95761
143345301600000,SW 416,Residential,34104,0,34104,98223,0,132327
143345301700000,SW 416,Residential,31008,0,31008,56377,0,87385
143345301800000,SW 416,Residential,32967,0,32967,91969,0,124936
143345301900000,SW 416,Residential,33253,0,33253,90002,0,123255
143345302000000,SW 416,Residential,35100,0,35100,81028,0,116128
143345302100000,SW 416,Residential,35573,0,35573,73015,0,108588
143345302200000,SW 416,Residential,35496,0,35496,94217,0,129713
143345302300000,SW 416,Residential,28080,0,28080,84118,0,112198
143345302400000,SW 416,Residential,32713,0,32713,48010,0,80723
143345302500000,SW 416,Residential,39350,0,39350,80401,0,119751
143345302600000,SW 416,Residential,42284,0,42284,76666,0,118950
143345302700000,SW 416,Residential,20200,0,20200,68456,0,88656
143345302800000,SW 416,Residential,21037,0,21037,30997,0,52034
143345400100000,SW 416,Residential,29385,0,29385,53602,0,82987
143345400200000,SW 416,Residential,33120,0,33120,85032,0,118152
143345400300000,SW 416,Residential,35505,0,35505,57527,0,93032
143345400400000,SW 416,Residential,35343,0,35343,101858,0,137201
143345400500000,SW 416,Residential,36689,0,36689,43701,0,80390
143345400600000,SW 416,Residential,28712,0,28712,56758,0,85470
143345400700000,SW 416,Residential,24563,0,24563,75106,0,99669
143345400800000,SW 416,Residential,25239,0,25239,92083,0,117322
143345400900000,SW 416,Residential,22272,0,22272,33764,0,56036
143345401000000,SW 416,Residential,28520,0,28520,66526,0,95046
143345401100000,SW 416,Residential,25232,0,25232,75612,0,100844
143345401200000,SW 416,Residential,27572,0,27572,88011,0,115583
143345401300000,SW 416,Residential,21840,0,21840,55594,0,77434
143345401400000,SW 416,Residential,21840,0,21840,62807,0,84647
143345401500000,SW 416,Residential,22272,0,22272,47746,0,70018
143345401600000,SW 416,Residential,22349,0,22349,55886,0,78235
143345401700000,SW 416,Residential,23000,0,23000,69503,0,92503
143345401800000,SW 416,Residential,23000,0,23000,57355,0,80355
143345401900000,SW 416,Residential,23000,0,23000,82851,0,105851
143345402000000,SW 416,Residential,23000,0,23000,77050,0,100050
143345402100000,SW 416,Residential,23000,0,23000,99199,0,122199
143345402200000,SW 416,Residential,19200,0,19200,56674,0,75874
143345402300000,SW 416,Residential,28160,0,28160,62077,0,90237
143345402400000,SW 416,Residential,27080,0,27080,100643,0,127723
143345402500000,SW 416,Residential,28400,0,28400,83877,0,112277
143345402600000,SW 416,Residential,23600,0,23600,102275,0,125875
143345402700000,SW 416,Residential,23400,0,23400,77022,0,100422
143345402800000,SW 416,Residential,34800,0,34800,51363,0,86163
143345402900000,SW 416,Residential,32544,0,32544,130181,0,162725
143345403000000,SW 416,Residential,30800,0,30800,81045,0,111845
143345403100000,SW 416,Residential,32100,0,32100,86157,0,118257
143345403200000,SW 416,Residential,31200,0,31200,100805,0,132005
143345403300000,SW 416,Residential,27592,0,27592,82443,0,110035
143345403400000,SW 416,Residential,25680,0,25680,73798,0,99478
143345403500000,SW 416,Residential,25440,0,25440,93947,0,119387
143345403600000,SW 416,Residential,32760,0,32760,101420,0,134180
143347600100000,SW 414,Residential,31654,0,31654,109036,0,140690
143347600200000,SW 414,Residential,25542,0,25542,103967,0,129509
143347600300000,SW 414,Residential,31783,0,31783,143364,0,175147
143347600400000,SW 414,Residential,25939,0,25939,147875,0,173814
143347600500000,SW 414,Residential,27472,0,27472,100367,0,127839
143347600600000,SW 414,Residential,29088,0,29088,127806,0,156894
143347700100000,SW 414,Residential,26624,0,26624,115868,0,142492
143347700200000,SW 414,Residential,29000,0,29000,105264,0,134264
143347700300000,SW 414,Residential,29000,0,29000,122464,0,151464
143347700400000,SW 414,Residential,32148,0,32148,78544,0,110692
143347700500000,SW 414,Residential,28800,0,28800,97946,0,126746
143347700600000,SW 414,Residential,33733,0,33733,81873,0,115606
143347700700000,SW 414,Residential,33048,0,33048,166504,0,199552
143347700800000,SW 414,Residential,37440,0,37440,178040,0,215480
143347700900000,SW 414,Residential,28800,0,28800,113731,0,142531
143347701000000,SW 414,Residential,36000,0,36000,112797,0,148797
143347701100000,SW 414,Residential,36000,0,36000,144190,0,180190
143347701200000,SW 414,Residential,24000,0,24000,101146,0,125146
143347701300000,SW 414,Residential,36000,0,36000,131728,0,167728
143347701400000,SW 414,Residential,32400,0,32400,74869,0,107269
143347701500000,SW 414,Residential,32400,0,32400,153029,0,185429
143347701600000,SW 414,Residential,32980,0,32980,134291,0,167271
143347701700000,SW 414,Residential,32980,0,32980,55553,0,88533
143347701800000,SW 414,Residential,32200,0,32200,101235,0,133435
143347701900000,SW 414,Residential,24150,0,24150,171088,0,195238
143347702000000,SW 414,Residential,32769,0,32769,173733,0,206502
143347702100000,SW 414,Residential,24644,0,24644,89173,0,113817
143347702200000,SW 414,Residential,24644,0,24644,90026,0,114670
143347702300000,SW 414,Residential,24644,0,24644,111445,0,136089
143347702400000,SW 414,Residential,23901,0,23901,101179,0,125080
143347702500000,SW 414,Residential,34374,0,34374,106841,0,141215
143347702600000,SW 414,Residential,34066,0,34066,121061,0,155127
143347702700000,SW 414,Residential,33262,0,33262,124713,0,157975
143347702800000,SW 414,Residential,31616,0,31616,110177,0,141793
143347702900000,SW 414,Residential,31616,0,31616,127167,0,158783
143347703000000,SW 414,Residential,31616,0,31616,131247,0,162863
143347703100000,SW 414,Residential,31200,0,31200,103268,0,134468
143347703200000,SW 414,Residential,31200,0,31200,118998,0,150198
143347703300000,SW 414,Residential,26000,0,26000,146843,0,172843
143347703400000,SW 414,Residential,32240,0,32240,112820,0,145060
143347703500000,SW 414,Residential,29744,0,29744,123318,0,153062
143347703600000,SW 414,Residential,30160,0,30160,104912,0,135072
143347703700000,SW 414,Residential,29952,0,29952,101469,0,131421
143347703800000,SW 414,Residential,29120,0,29120,103526,0,132646
143347800200000,SW 416,Residential,29000,0,29000,60487,0,89487
143347800300000,SW 416,Residential,29000,0,29000,36398,0,65398
143347800400000,SW 416,Residential,29000,0,29000,98435,0,127435
143347800500000,SW 416,Residential,26000,0,26000,58063,0,84063
143347800600000,SW 416,Residential,22600,0,22600,64746,0,87346
143347800700000,SW 416,Residential,38520,0,38520,112965,0,151485
143347800800000,SW 416,Residential,29988,0,29988,84057,0,114045
143347800900000,SW 416,Residential,28080,0,28080,83714,0,111794
143347801000000,SW 416,Residential,27000,0,27000,90747,0,117747
143347801100000,SW 416,Residential,27000,0,27000,21936,0,48936
143347801200000,SW 416,Residential,22500,0,22500,68498,0,90998
143347801300000,SW 416,Residential,22500,0,22500,91313,0,113813
143347801400000,SW 416,Residential,35700,0,35700,156824,0,192524
143347801500000,SW 416,Residential,38250,0,38250,157830,0,196080
143347900100000,SW 414,Residential,32970,0,32970,107122,0,140092
143347900200000,SW 414,Residential,30244,0,30244,134471,0,164715
143347900300000,SW 414,Residential,31508,0,31508,111268,0,142776
143347900400000,SW 414,Residential,26222,0,26222,108549,0,134771
143347900500000,SW 414,Residential,28280,0,28280,114641,0,142921
143347900600000,SW 414,Residential,28280,0,28280,107180,0,135460
143347900700000,SW 414,Residential,30724,0,30724,123607,0,154331
143347900800000,SW 414,Residential,30520,0,30520,123168,0,153688
143347900900000,SW 414,Residential,33136,0,33136,139430,0,172566
143347901000000,SW 414,Residential,27904,0,27904,114622,0,142526
143347901100000,SW 414,Residential,31392,0,31392,98711,0,130103
143347901200000,SW 414,Residential,29648,0,29648,120032,0,149680
143347901300000,SW 414,Residential,27904,0,27904,126466,0,154370
143347901400000,SW 414,Residential,27904,0,27904,115189,0,143093
143347901500000,SW 414,Residential,31186,0,31186,135964,0,167150
143347901600000,SW 414,Residential,28389,0,28389,139213,0,167602
143347901700000,SW 414,Residential,33660,0,33660,125486,0,159146
143347901800000,SW 414,Residential,33858,0,33858,77713,0,111571
143347901900000,SW 414,Residential,21840,0,21840,116472,0,138312
143347902000000,SW 414,Residential,21840,0,21840,0,0,21840
143347902100000,CHURCH,Exempt,0,187380,187380,0,985654,1173034
143347902200000,DAY CARE CENTER,Commercial,0,150163,150163,0,214503,364666
143348000100000,SW 416,Residential,22560,0,22560,33481,0,56041
143348000200000,SW 416,Residential,29280,0,29280,71506,0,100786
143348000300000,SW 416,Residential,29719,0,29719,87013,0,116732
143348000400000,SW 416,Residential,30598,0,30598,52917,0,83515
143348000500000,SW 416,Residential,31536,0,31536,118501,0,150037
143348000600000,SW 416,Residential,32166,0,32166,67712,0,99878
143348000700000,CHURCH,Exempt,0,37206,37206,0,0,37206
143348000800000,SW 416,Residential,37760,0,37760,67801,0,105561
143348000900000,SW 416,Residential,19800,0,19800,80613,0,100413
143348001000000,CHURCH,Exempt,0,73980,73980,0,685135,759115
143410100100000,SE 242,Residential,20952,0,20952,42130,0,63082
143415100100000,CITY PROPERTY,Exempt,0,0,0,0,0,0
143415100200000,OFFICE,Exempt,0,1138320,1138320,0,4084763,5223083
143415100300000,CENTRALLY ASSESSED,Other,0,0,0,0,0,0
143420100100000,CITY PROPERTY,Exempt,0,0,0,0,0,0
143420100200000,CITY PROPERTY,Exempt,0,0,0,0,0,0
143422600100000,CITY PROPERTY,Exempt,0,0,0,0,0,0
143422600200000,CITY PROPERTY,Exempt,0,0,0,0,0,0
143422600300000,CITY PROPERTY,Exempt,0,0,0,0,0,0
143422600400000,CITY PROPERTY,Exempt,0,0,0,0,0,0
143422600500000,SW 412,Residential,9996,0,9996,47348,0,57344
143422600600000,SW 412,Residential,5000,0,5000,0,0,5000
143422600700000,CITY PROPERTY,Exempt,0,0,0,0,0,0
143422600800000,CITY PROPERTY,Exempt,0,0,0,0,0,0
143422600900000,CITY PROPERTY,Exempt,0,0,0,0,0,0
143422601000000,CITY PROPERTY,Exempt,0,0,0,0,0,0
143422601100000,CITY PROPERTY,Exempt,0,0,0,0,0,0
143422601200000,SW 412,Residential,12495,0,12495,67440,0,79935
143422601300000,SW 412,Residential,12495,0,12495,52310,0,64805
143422601400000,SW 412,Residential,12495,0,12495,84874,0,97369
143422601500000,SW 412,Residential,20196,0,20196,60382,0,80578
143422601600000,SW 412,Residential,20323,0,20323,94204,0,114527
143422601700000,CITY PROPERTY,Exempt,0,0,0,0,0,0
143422601800000,CITY PROPERTY,Exempt,0,0,0,0,0,0
143422700100000,CITY PROPERTY,Exempt,0,0,0,0,0,0
143422700200000,CITY PROPERTY,Exempt,0,0,0,0,0,0
143422700300000,CITY PROPERTY,Exempt,0,0,0,0,0,0
143422700400000,CITY PROPERTY,Exempt,0,0,0,0,0,0
143422700500000,CITY PROPERTY,Exempt,0,0,0,0,0,0
143422700600000,SW 412,Residential,12750,0,12750,52359,0,65109
143422700700000,SW 412,Residential,11475,0,11475,0,0,11475
143422700800000,CITY PROPERTY,Exempt,0,0,0,0,0,0
143422700900000,CITY PROPERTY,Exempt,0,0,0,0,0,0
143422701000000,CITY PROPERTY,Exempt,0,0,0,0,0,0
143422701100000,SW 412,Residential,5000,0,5000,0,0,5000
143422701200000,CITY PROPERTY,Exempt,0,0,0,0,0,0
143422701300000,CITY PROPERTY,Exempt,0,0,0,0,0,0
143422701400000,CITY PROPERTY,Exempt,0,0,0,0,0,0
143422701500000,APARTMENT,Commercial,0,6739,6739,0,68311,75050
143422701600000,CITY PROPERTY,Exempt,0,0,0,0,0,0
143422701700000,SW 412,Residential,5000,0,5000,0,0,5000
143422701800000,SW 412,Residential,12495,0,12495,38863,0,51358
143422701900000,SW 412,Residential,12495,0,12495,58414,0,70909
143422702000000,CITY PROPERTY,Exempt,0,0,0,0,0,0
143422702100000,CITY PROPERTY,Exempt,0,0,0,0,0,0
143422702200000,CITY PROPERTY,Exempt,0,0,0,0,0,0
143422702300000,CITY PROPERTY,Exempt,0,0,0,0,0,0
143422702400000,CITY PROPERTY,Exempt,0,0,0,0,0,0
143422702500000,CITY PROPERTY,Exempt,0,0,0,0,0,0
143422800100000,CITY PROPERTY,Exempt,0,0,0,0,0,0
143422900100000,SW 402,Residential,5000,0,5000,0,0,5000
143422900200000,CITY PROPERTY,Exempt,0,0,0,0,0,0
143422900300000,CITY PROPERTY,Exempt,0,0,0,0,0,0
143422900400000,CITY PROPERTY,Exempt,0,0,0,0,0,0
143423000100000,SW 412,Residential,16867,0,16867,67123,0,83990
143423000200000,SW 412,Residential,18354,0,18354,93260,0,111614
143423000400000,SW 412,Residential,17640,0,17640,96512,0,114152
143423000500000,SW 412,Residential,19320,0,19320,112950,0,132270
143423000600000,SW 412,Residential,20580,0,20580,85250,0,105830
143423000700000,SW 412,Residential,21420,0,21420,70376,0,91796
143423000800000,SW 412,Residential,22260,0,22260,71908,0,94168
143423000900000,SW 412,Residential,22890,0,22890,73828,0,96718
143423001000000,SW 412,Residential,19339,0,19339,89030,0,108369
143423001100000,SW 412,Residential,17325,0,17325,64806,0,82131
143423001200000,SW 412,Residential,20790,0,20790,105454,0,126244
143423001300000,SW 412,Residential,12370,0,12370,63363,0,75733
143423001400000,SW 412,Residential,23716,0,23716,111307,0,135023
143423001500000,SW 412,Residential,19869,0,19869,80750,0,100619
143423001600000,SW 412,Residential,19869,0,19869,92065,0,111934
143423001700000,SW 412,Residential,19869,0,19869,93727,0,113596
143423001800000,APARTMENT,Commercial,0,19920,19920,0,141404,161324
143423001900000,SW 412,Residential,23302,0,23302,90891,0,114193
143423002000000,SW 412,Residential,24993,0,24993,86561,0,111554
143423002100000,SW 412,Residential,24778,0,24778,85984,0,110762
143423002200000,SW 412,Residential,23520,0,23520,108317,0,131837
143423002300000,SW 412,Residential,24990,0,24990,79960,0,104950
143423002400000,SW 412,Residential,20580,0,20580,79279,0,99859
143423002500000,SW 412,Residential,19320,0,19320,58870,0,78190
143423002600000,SW 412,Residential,17640,0,17640,75963,0,93603
143423002700000,SW 412,Residential,15372,0,15372,67892,0,83264
143423002800000,SW 412,Residential,15372,0,15372,5796,0,21168
143423100100000,CITY PROPERTY,Exempt,0,0,0,0,0,0
143423100200000,SW 412,Residential,5000,0,5000,0,0,5000
143423100300000,CITY PROPERTY,Exempt,0,0,0,0,0,0
143423100400000,SW 412,Residential,10500,0,10500,52576,0,63076
143423100500000,SW 412,Residential,10500,0,10500,40133,0,50633
143423100600000,SW 412,Residential,10500,0,10500,60119,0,70619
143423100700000,SW 412,Residential,10500,0,10500,53940,0,64440
143423100800000,SW 412,Residential,10500,0,10500,0,0,10500
143423100900000,CITY PROPERTY,Exempt,0,0,0,0,0,0
143423101000000,CITY PROPERTY,Exempt,0,0,0,0,0,0
143423101100000,CITY PROPERTY,Exempt,0,0,0,0,0,0
143423101200000,CITY PROPERTY,Exempt,0,0,0,0,0,0
143423101300000,SW 412,Residential,20081,0,20081,41988,0,62069
143423101400000,SW 412,Residential,12750,0,12750,67235,0,79985
143423101500000,SW 412,Residential,12750,0,12750,69136,0,81886
143423101600000,CITY PROPERTY,Exempt,0,0,0,0,0,0
143423101700000,SW 412,Residential,12750,0,12750,0,0,12750
143423101800000,SW 412,Residential,12750,0,12750,51334,0,64084
143423101900000,SW 412,Residential,12750,0,12750,60479,0,73229
143423102000000,SW 412,Residential,12750,0,12750,55140,0,67890
143423200100000,SW 412,Residential,14450,0,14450,98120,0,112570
143423200200000,SW 412,Residential,14450,0,14450,56937,0,71387
143423200300000,SW 412,Residential,10000,0,10000,0,0,10000
143423200400000,SW 412,Residential,14450,0,14450,73117,0,87567
143423200500000,SW 412,Residential,16507,0,16507,81598,0,98105
143423200600000,SW 412,Residential,16992,0,16992,36354,0,53346
143423200700000,SW 412,Residential,14726,0,14726,61609,0,76335
143425100200000,CEMETERY,Exempt,0,0,0,0,0,0
143425100400000,APARTMENT,Commercial,0,26013,26013,0,161428,187441
143425100500000,APARTMENT,Commercial,0,26013,26013,0,161396,187409
143425100600000,SW 413,Exempt,0,33137,33137,0,207269,240406
143425100800000,APARTMENT,Commercial,0,27474,27474,0,155594,183068
143425100900000,APARTMENT,Commercial,0,27474,27474,0,157386,184860
143425101500000,CEMETERY,Exempt,0,0,0,0,0,0
143425101600000,FUNERAL HOME,Commercial,0,343872,343872,0,792301,1136173
143425101700000,CEMETERY,Exempt,0,0,0,0,0,0
143427600100000,APARTMENT,Exempt,0,498312,498312,0,5767898,6266210
143427600200000,SW 410,Residential,22548,0,22548,118134,0,140682
143427600300000,SW 410,Residential,22050,0,22050,115129,0,137179
143427600600000,VACANT LAND,Commercial,0,36504,36504,0,0,36504
143427600700000,APARTMENT,Exempt,0,56106,56106,0,1118623,1174729
143427600900000,APARTMENT,Commercial,0,28943,28943,0,167730,196673
143427700100000,SW 410,Residential,27745,0,27745,71559,0,99304
143427800100000,SW 410,Residential,11785,0,11785,38083,0,49868
143427800200000,SW 410,Residential,23871,0,23871,0,0,23871
143427800300000,SW 410,Residential,22634,0,22634,102727,0,125361
143427800400000,SW 410,Residential,21210,0,21210,90327,0,111537
143427800500000,SW 430,Residential,37440,0,37440,96493,0,133933
143427800600000,SW 430,Residential,37125,0,37125,103649,0,140774
143427800700000,SW 430,Residential,33787,0,33787,99765,0,133552
143427800800000,SW 430,Residential,35030,0,35030,103450,0,138480
143427800900000,SW 430,Residential,35030,0,35030,105880,0,140910
143427801000000,SW 430,Residential,35030,0,35030,100107,0,135137
143427801100000,SW 430,Residential,35030,0,35030,95759,0,130789
143427801200000,SW 430,Residential,30070,0,30070,91652,0,121722
143427801300000,SW 430,Residential,34726,0,34726,100596,0,135322
143427801400000,SW 430,Residential,30742,0,30742,83688,0,114430
143427801500000,SW 410,Residential,25134,0,25134,77629,0,102763
143427801600000,SW 410,Residential,14981,0,14981,64468,0,79449
143427801700000,SW 410,Residential,23990,0,23990,62396,0,86386
143427801800000,SW 410,Residential,13800,0,13800,72522,0,86322
143427801900000,SW 410,Residential,13800,0,13800,45319,0,59119
143427802000000,SW 410,Residential,11730,0,11730,0,0,11730
143427900100000,SW 430,Residential,38697,0,38697,85965,0,124662
143427900200000,SW 430,Residential,30133,0,30133,81169,0,111302
143427900300000,SW 430,Residential,29848,0,29848,111276,0,141124
143427900400000,SW 430,Residential,33280,0,33280,83025,0,116305
143427900500000,SW 430,Residential,33810,0,33810,107166,0,140976
143427900600000,SW 430,Residential,35112,0,35112,79815,0,114927
143427900700000,SW 430,Residential,31000,0,31000,86276,0,117276
143427900800000,SW 430,Residential,31000,0,31000,106024,0,137024
143427900900000,SW 430,Residential,31000,0,31000,88378,0,119378
143427901000000,SW 430,Residential,31000,0,31000,91546,0,122546
143427901100000,SW 430,Residential,31000,0,31000,84710,0,115710
143427901200000,SW 430,Residential,31000,0,31000,90810,0,121810
143427901300000,SW 430,Residential,31000,0,31000,86198,0,117198
143427901400000,SW 430,Residential,31000,0,31000,89499,0,120499
143427901500000,SW 430,Residential,31000,0,31000,98608,0,129608
143427901600000,SW 430,Residential,31000,0,31000,106030,0,137030
143427901700000,SW 430,Residential,35833,0,35833,96012,0,131845
143427901800000,SW 430,Residential,34667,0,34667,92717,0,127384
143427901900000,SW 430,Residential,31000,0,31000,90577,0,121577
143427902000000,SW 430,Residential,31000,0,31000,77998,0,108998
143427902100000,SW 430,Residential,31000,0,31000,89934,0,120934
143427902200000,SW 430,Residential,31000,0,31000,102715,0,133715
143427902300000,SW 430,Residential,31000,0,31000,91454,0,122454
143427902400000,SW 430,Residential,31000,0,31000,93889,0,124889
143427902500000,SW 430,Residential,36192,0,36192,97096,0,133288
143427902600000,SW 430,Residential,36023,0,36023,78254,0,114277
143427902700000,SW 430,Residential,33330,0,33330,81921,0,115251
143428000100000,SW 430,Residential,27963,0,27963,100271,0,128234
143428000200000,SW 430,Residential,28340,0,28340,92606,0,120946
143428000300000,SW 430,Residential,33600,0,33600,107924,0,141524
143428000400000,SW 430,Residential,30896,0,30896,78070,0,108966
143428000500000,SW 430,Residential,33920,0,33920,83858,0,117778
143428000600000,SW 430,Residential,30855,0,30855,81423,0,112278
143428000700000,SW 430,Residential,28827,0,28827,86357,0,115184
143428000800000,SW 430,Residential,29140,0,29140,101586,0,130726
143428000900000,SW 430,Residential,29140,0,29140,79792,0,108932
143428001000000,SW 430,Residential,29140,0,29140,83996,0,113136
143428001100000,SW 430,Residential,29140,0,29140,115939,0,145079
143428001200000,SW 430,Residential,29140,0,29140,94894,0,124034
143428001300000,SW 430,Residential,29140,0,29140,90823,0,119963
143428001400000,SW 430,Residential,29140,0,29140,88901,0,118041
143428001500000,SW 430,Residential,29140,0,29140,82785,0,111925
143428001600000,SW 430,Residential,29140,0,29140,76388,0,105528
143428001700000,SW 430,Residential,29140,0,29140,81916,0,111056
143428001800000,SW 430,Residential,32649,0,32649,105542,0,138191
143430100100000,SW 410,Residential,20056,0,20056,17907,0,37963
143430100200000,SW 410,Residential,16950,0,16950,92185,0,109135
143430100300000,SW 410,Residential,16950,0,16950,60851,0,77801
143430100400000,SW 410,Residential,15000,0,15000,81731,0,96731
143430100500000,SW 410,Residential,14848,0,14848,107771,0,122619
143430100600000,SW 410,Residential,14848,0,14848,50622,0,65470
143430100700000,SW 410,Residential,19200,0,19200,114477,0,133677
143430100800000,SW 410,Residential,18000,0,18000,71868,0,89868
143430100900000,SW 410,Residential,18000,0,18000,51635,0,69635
143430101000000,SW 410,Residential,18000,0,18000,0,0,18000
143430101100000,SW 410,Residential,18000,0,18000,84325,0,102325
143430101200000,SW 410,Residential,18000,0,18000,78548,0,96548
143430101300000,SW 410,Residential,18000,0,18000,44051,0,62051
143430101400000,SW 410,Residential,18000,0,18000,57725,0,75725
143430101500000,SW 410,Residential,18000,0,18000,29986,0,47986
143430101600000,SW 410,Residential,18000,0,18000,53444,0,71444
143430101700000,SW 410,Residential,18000,0,18000,51993,0,69993
143430101800000,SW 410,Residential,18000,0,18000,54382,0,72382
143430101900000,SW 410,Residential,18000,0,18000,82934,0,100934
143430102000000,SW 410,Residential,18000,0,18000,83335,0,101335
143430102100000,SW 410,Residential,18000,0,18000,60238,0,78238
143430102200000,SW 410,Residential,18000,0,18000,93321,0,111321
143430102300000,SW 410,Residential,18000,0,18000,73322,0,91322
143430102400000,SW 410,Residential,18000,0,18000,61552,0,79552
143430102500000,SW 410,Residential,18000,0,18000,53512,0,71512
143430102600000,SW 410,Residential,18000,0,18000,44857,0,62857
143430102700000,SW 410,Residential,18000,0,18000,18022,0,36022
143430102800000,SW 410,Residential,17850,0,17850,45336,0,63186
143430200100000,SW 410,Residential,19206,0,19206,0,0,19206
143430200200000,SW 410,Residential,17100,0,17100,76836,0,93936
143430200300000,SW 410,Residential,21888,0,21888,46726,0,68614
143430200400000,SW 410,Residential,20349,0,20349,90233,0,110582
143430200500000,SW 410,Residential,17100,0,17100,76597,0,93697
143430200600000,SW 430,Residential,27350,0,27350,70965,0,98315
143430200700000,SW 430,Residential,24024,0,24024,88972,0,112996
143430200800000,SW 430,Residential,30600,0,30600,96423,0,127023
143430200900000,SW 430,Residential,30600,0,30600,79777,0,110377
143430201000000,SW 430,Residential,30600,0,30600,79082,0,109682
143430201100000,SW 430,Residential,30600,0,30600,96238,0,126838
143430201200000,SW 430,Residential,30600,0,30600,78489,0,109089
143430201300000,SW 430,Residential,30600,0,30600,89030,0,119630
143430201400000,SW 430,Residential,30600,0,30600,79291,0,109891
143430201500000,SW 430,Residential,30600,0,30600,102708,0,133308
143430201600000,SW 430,Residential,30600,0,30600,103861,0,134461
143430201700000,SW 430,Residential,33150,0,33150,100416,0,133566
143430201800000,SW 430,Residential,30600,0,30600,86286,0,116886
143430201900000,SW 430,Residential,33660,0,33660,83874,0,117534
143430202000000,SW 430,Residential,30090,0,30090,96683,0,126773
143430202100000,SW 430,Residential,31875,0,31875,83513,0,115388
143430202200000,SW 430,Residential,31875,0,31875,82203,0,114078
143430202300000,SW 430,Residential,32555,0,32555,102343,0,134898
143430202400000,SW 430,Residential,32462,0,32462,84523,0,116985
143430202500000,SW 430,Residential,35842,0,35842,76816,0,112658
143430202600000,SW 430,Residential,38881,0,38881,81809,0,120690
143430202700000,SW 410,Residential,18000,0,18000,76893,0,94893
143430202800000,SW 410,Residential,27000,0,27000,36147,0,63147
143430202900000,SW 410,Residential,18000,0,18000,30666,0,48666
143430203000000,SW 410,Residential,18000,0,18000,96868,0,114868
143430203100000,SW 410,Residential,18000,0,18000,64886,0,82886
143430203200000,SW 410,Residential,18000,0,18000,90340,0,108340
143430203300000,SW 410,Residential,18000,0,18000,112610,0,130610
143430203400000,SW 410,Residential,18000,0,18000,69724,0,87724
143430203500000,SW 410,Residential,18000,0,18000,102854,0,120854
143430203600000,SW 410,Residential,18000,0,18000,58056,0,76056
143430203700000,SW 410,Residential,18000,0,18000,49890,0,67890
143430203800000,SW 410,Residential,18000,0,18000,46699,0,64699
143430203900000,SW 410,Residential,18000,0,18000,115205,0,133205
143430204000000,SW 410,Residential,18000,0,18000,50877,0,68877
143430204100000,SW 410,Residential,18000,0,18000,50544,0,68544
143430204200000,SW 410,Residential,18000,0,18000,64767,0,82767
143430204300000,SW 410,Residential,18000,0,18000,44254,0,62254
143430204400000,SW 410,Residential,18000,0,18000,69532,0,87532
143430204500000,SW 410,Residential,18000,0,18000,89308,0,107308
143430204600000,SW 410,Residential,18000,0,18000,45799,0,63799
143430204700000,SW 410,Residential,11400,0,11400,47430,0,58830
143430204800000,SW 410,Residential,11400,0,11400,42009,0,53409
143430300100000,SW 430,Residential,24024,0,24024,113083,0,137107
143430300200000,SW 430,Residential,24000,0,24000,80238,0,104238
143430300300000,SW 430,Residential,24000,0,24000,81744,0,105744
143430300400000,SW 430,Residential,23733,0,23733,94935,0,118668
143430300500000,SW 430,Residential,30000,0,30000,92662,0,122662
143430300600000,SW 430,Residential,30000,0,30000,83568,0,113568
143430300700000,SW 430,Residential,30000,0,30000,77472,0,107472
143430300800000,SW 430,Residential,30000,0,30000,94113,0,124113
143430300900000,SW 430,Residential,30000,0,30000,109710,0,139710
143430301000000,SW 430,Residential,30000,0,30000,89971,0,119971
143430301100000,SW 430,Residential,30000,0,30000,104173,0,134173
143430301200000,SW 430,Residential,30000,0,30000,91578,0,121578
143430301300000,SW 430,Residential,30000,0,30000,86419,0,116419
143430301400000,SW 430,Residential,31250,0,31250,88355,0,119605
143430301500000,SW 430,Residential,31250,0,31250,85195,0,116445
143430301600000,SW 430,Residential,32400,0,32400,86391,0,118791
143430301700000,SW 430,Residential,26500,0,26500,100851,0,127351
143430301800000,SW 430,Residential,31250,0,31250,88705,0,119955
143430301900000,SW 430,Residential,31250,0,31250,105162,0,136412
143430302000000,SW 430,Residential,31875,0,31875,75237,0,107112
143430302100000,SW 430,Residential,32400,0,32400,104091,0,136491
143430302200000,SW 430,Residential,33488,0,33488,126421,0,159909
143430302300000,SW 430,Residential,31650,0,31650,80402,0,112052
143430302400000,SW 430,Residential,32500,0,32500,81381,0,113881
143430302500000,SW 430,Residential,30000,0,30000,106870,0,136870
143430302600000,SW 430,Residential,31250,0,31250,94581,0,125831
143430302700000,SW 430,Residential,31250,0,31250,86570,0,117820
143430302800000,SW 430,Residential,28500,0,28500,109698,0,138198
143430302900000,SW 430,Residential,34000,0,34000,77337,0,111337
143430303000000,SW 430,Residential,30000,0,30000,92221,0,122221
143430303100000,SW 430,Residential,30000,0,30000,81211,0,111211
143430303200000,SW 430,Residential,30000,0,30000,89076,0,119076
143430303300000,SW 430,Residential,30000,0,30000,94459,0,124459
143430303400000,SW 430,Residential,30000,0,30000,87221,0,117221
143430303500000,SW 430,Residential,30000,0,30000,80721,0,110721
143430303600000,SW 430,Residential,30000,0,30000,92100,0,122100
143430303700000,SW 430,Residential,30000,0,30000,76237,0,106237
143430303800000,SW 430,Residential,30000,0,30000,88284,0,118284
143430400100000,SW 430,Residential,24267,0,24267,87341,0,111608
143430400200000,SW 430,Residential,23971,0,23971,79414,0,103385
143430400300000,SW 430,Residential,30000,0,30000,80406,0,110406
143430400400000,SW 430,Residential,30000,0,30000,81634,0,111634
143430400500000,SW 430,Residential,30000,0,30000,84211,0,114211
143430400600000,SW 430,Residential,30000,0,30000,81230,0,111230
143430400700000,SW 430,Residential,30000,0,30000,127560,0,157560
143430400800000,SW 430,Residential,33250,0,33250,153681,0,186931
143430400900000,SW 430,Residential,25000,0,25000,86740,0,111740
143430401000000,SW 430,Residential,30000,0,30000,90323,0,120323
143430401100000,SW 430,Residential,30000,0,30000,81184,0,111184
143430401200000,SW 430,Residential,33250,0,33250,117725,0,150975
143430401300000,SW 430,Residential,27500,0,27500,131143,0,158643
143430401400000,SW 430,Residential,31250,0,31250,85167,0,116417
143430401500000,SW 430,Residential,31250,0,31250,100829,0,132079
143430401600000,SW 430,Residential,37500,0,37500,106345,0,143845
143430401700000,SW 430,Residential,37700,0,37700,116389,0,154089
143430401800000,SW 430,Residential,33036,0,33036,81269,0,114305
143430401900000,SW 430,Residential,41220,0,41220,96138,0,137358
143432600100000,CITY PROPERTY,Exempt,0,0,0,0,0,0
143432600200000,SW 414,Residential,21800,0,21800,60701,0,82501
143432600300000,SW 414,Residential,33792,0,33792,97844,0,131636
143432600400000,SW 414,Residential,25692,0,25692,103890,0,129582
143432600500000,SW 414,Residential,26624,0,26624,94805,0,121429
143432600600000,SW 414,Residential,26624,0,26624,89934,0,116558
143432600700000,SW 414,Residential,26624,0,26624,85872,0,112496
143432600800000,SW 414,Residential,26624,0,26624,89871,0,116495
143432600900000,SW 414,Residential,26624,0,26624,116412,0,143036
143432601000000,SW 414,Residential,26624,0,26624,115479,0,142103
143432601100000,SW 414,Residential,26624,0,26624,102951,0,129575
143432601200000,SW 414,Residential,26624,0,26624,104881,0,131505
143432601300000,SW 414,Residential,26624,0,26624,87958,0,114582
143432601400000,SW 414,Residential,26624,0,26624,98106,0,124730
143432601500000,SW 414,Residential,29952,0,29952,110251,0,140203
143432601600000,SW 414,Residential,26624,0,26624,124247,0,150871
143432601700000,SW 414,Residential,30784,0,30784,133363,0,164147
143432601800000,SW 414,Residential,31200,0,31200,108012,0,139212
143432601900000,SW 414,Residential,24480,0,24480,105163,0,129643
143432602000000,SW 414,Residential,31132,0,31132,124629,0,155761
143432700100000,SW 414,Residential,25440,0,25440,93128,0,118568
143432700200000,SW 414,Residential,31800,0,31800,100415,0,132215
143432700300000,SW 414,Residential,32301,0,32301,109273,0,141574
143432700400000,SW 414,Residential,34339,0,34339,101393,0,135732
143432700500000,SW 414,Residential,31887,0,31887,97807,0,129694
143432700600000,SW 414,Residential,22697,0,22697,118410,0,141107
143432700700000,SW 414,Residential,28812,0,28812,101902,0,130714
143432700800000,SW 414,Residential,22697,0,22697,117357,0,140054
143432700900000,SW 414,Residential,30184,0,30184,111360,0,141544
143432701000000,SW 414,Residential,29792,0,29792,95782,0,125574
143432701100000,SW 414,Residential,28812,0,28812,120837,0,149649
143432701200000,SW 414,Residential,23520,0,23520,89959,0,113479
143432701300000,SW 414,Residential,28812,0,28812,92821,0,121633
143432701400000,SW 414,Residential,23520,0,23520,93297,0,116817
143432701500000,SW 414,Residential,23912,0,23912,91085,0,114997
143432701600000,SW 414,Residential,25441,0,25441,108464,0,133905
143432701700000,SW 414,Residential,27440,0,27440,112570,0,140010
143432701800000,SW 414,Residential,22046,0,22046,101071,0,123117
143432701900000,SW 414,Residential,26394,0,26394,98951,0,125345
143432702000000,SW 414,Residential,30784,0,30784,100950,0,131734
143432702100000,SW 414,Residential,26624,0,26624,107693,0,134317
143432702200000,SW 414,Residential,29952,0,29952,107174,0,137126
143432702300000,SW 414,Residential,27872,0,27872,97174,0,125046
143432702400000,SW 414,Residential,26624,0,26624,92480,0,119104
143432702500000,SW 414,Residential,26208,0,26208,93679,0,119887
143432702600000,SW 414,Residential,26208,0,26208,85453,0,111661
143432702700000,SW 414,Residential,25792,0,25792,78417,0,104209
143432702800000,SW 414,Residential,26624,0,26624,84113,0,110737
143432702900000,SW 414,Residential,26208,0,26208,112641,0,138849
143432703000000,SW 414,Residential,26208,0,26208,96318,0,122526
143432703100000,SW 414,Residential,26208,0,26208,89605,0,115813
143432703200000,SW 414,Residential,26208,0,26208,79520,0,105728
143432703300000,SW 414,Residential,26415,0,26415,92626,0,119041
143432800100000,FAST FOOD,Commercial,0,90899,90899,0,96507,187406
143432800200000,SW 414,Residential,33221,0,33221,105736,0,138957
143432800300000,SW 414,Residential,25181,0,25181,92363,0,117544
143432800400000,SW 414,Residential,24056,0,24056,88608,0,112664
143432800500000,SW 414,Residential,29876,0,29876,115499,0,145375
143432800600000,SW 414,Residential,28518,0,28518,105824,0,134342
143432800700000,SW 414,Residential,28324,0,28324,112503,0,140827
143432800800000,SW 414,Residential,27548,0,27548,92470,0,120018
143432800900000,SW 414,Residential,28518,0,28518,126237,0,154755
143432801000000,SW 414,Residential,24250,0,24250,82567,0,106817
143432801100000,SW 414,Residential,25181,0,25181,94428,0,119609
143432801200000,SW 414,Residential,23668,0,23668,87611,0,111279
143432801300000,SW 414,Residential,24952,0,24952,118949,0,143901
143432801400000,SW 414,Residential,25181,0,25181,89592,0,114773
143432801500000,SW 414,Residential,23254,0,23254,105891,0,129145
143432900100000,SW 414,Residential,28879,0,28879,87061,0,115940
143432900200000,SW 414,Residential,27472,0,27472,98002,0,125474
143432900300000,SW 414,Residential,29980,0,29980,131815,0,161795
143432900400000,SW 414,Residential,23261,0,23261,130112,0,153373
143432900500000,SW 414,Residential,23879,0,23879,132369,0,156248
143432900600000,SW 414,Residential,33949,0,33949,129199,0,163148
143435100100000,SW 414,Residential,24740,0,24740,81349,0,106089
143435100200000,SW 414,Residential,25200,0,25200,91697,0,116897
143435100300000,SW 414,Residential,25200,0,25200,96702,0,121902
143435100400000,SW 414,Residential,25200,0,25200,109106,0,134306
143435100500000,SW 414,Residential,24800,0,24800,108552,0,133352
143435100600000,SW 414,Residential,24800,0,24800,103944,0,128744
143435100700000,SW 414,Residential,32000,0,32000,123237,0,155237
143435100800000,SW 414,Residential,27572,0,27572,151792,0,179364
143435100900000,SW 414,Residential,27200,0,27200,154098,0,181298
143435101000000,SW 414,Residential,32000,0,32000,108039,0,140039
143435101100000,SW 414,Residential,26000,0,26000,104998,0,130998
143435101200000,SW 414,Residential,32000,0,32000,130761,0,162761
143435101300000,SW 414,Residential,32000,0,32000,97997,0,129997
143435101400000,SW 414,Residential,32000,0,32000,108515,0,140515
143435101500000,SW 414,Residential,32000,0,32000,128375,0,160375
143435101600000,SW 414,Residential,32000,0,32000,128101,0,160101
143435101700000,SW 414,Residential,32000,0,32000,107000,0,139000
143435101800000,SW 414,Residential,32284,0,32284,108597,0,140881
143435200100000,SW 414,Residential,25413,0,25413,95514,0,120927
143435200200000,SW 414,Residential,24000,0,24000,84291,0,108291
143435200300000,SW 414,Residential,24000,0,24000,83007,0,107007
143435200400000,SW 414,Residential,24000,0,24000,78412,0,102412
143435200500000,SW 414,Residential,24000,0,24000,88352,0,112352
143435200600000,SW 414,Residential,25600,0,25600,99214,0,124814
143435200700000,SW 414,Residential,25069,0,25069,82899,0,107968
143435300100000,SW 414,Residential,24460,0,24460,84836,0,109296
143435300200000,SW 414,Residential,24250,0,24250,87367,0,111617
143435300300000,SW 414,Residential,24250,0,24250,89627,0,113877
143435300400000,SW 414,Residential,24040,0,24040,88546,0,112586
143435300500000,SW 414,Residential,26311,0,26311,98237,0,124548
143435300600000,SW 414,Residential,25856,0,25856,109542,0,135398
143435300700000,SW 414,Residential,28280,0,28280,118055,0,146335
143435300800000,SW 414,Residential,25856,0,25856,74484,0,100340
143435300900000,SW 414,Residential,25856,0,25856,96115,0,121971
143435301000000,SW 414,Residential,29128,0,29128,99796,0,128924
143435301100000,SW 414,Residential,28819,0,28819,94234,0,123053
143435301200000,SW 414,Residential,30888,0,30888,129095,0,159983
143435301300000,SW 414,Residential,27936,0,27936,104866,0,132802
143435301400000,SW 414,Residential,32587,0,32587,131279,0,163866
143435301500000,SW 414,Residential,30400,0,30400,160456,0,190856
143435301600000,SW 414,Residential,29952,0,29952,103830,0,133782
143435301700000,SW 414,Residential,26656,0,26656,116083,0,142739
143435301800000,SW 414,Residential,32139,0,32139,108777,0,140916
143435301900000,SW 414,Residential,31512,0,31512,110078,0,141590
143435302000000,SW 414,Residential,27744,0,27744,111141,0,138885
143435302100000,SW 414,Residential,26112,0,26112,101037,0,127149
143435302200000,SW 414,Residential,26112,0,26112,98877,0,124989
143435302300000,SW 414,Residential,26112,0,26112,93138,0,119250
143435302400000,SW 414,Residential,25549,0,25549,106335,0,131884
143435400100000,SW 414,Residential,25889,0,25889,90455,0,116344
143435400200000,SW 414,Residential,25600,0,25600,116409,0,142009
143435400300000,SW 414,Residential,24000,0,24000,89986,0,113986
143435400400000,SW 414,Residential,27200,0,27200,89741,0,116941
143435400500000,SW 414,Residential,28000,0,28000,88057,0,116057
143435400600000,SW 414,Residential,28000,0,28000,92629,0,120629
143435400700000,SW 414,Residential,27720,0,27720,104334,0,132054
143435400800000,SW 414,Residential,31548,0,31548,106064,0,137612
143435400900000,SW 414,Residential,28512,0,28512,93151,0,121663
143435401000000,SW 414,Residential,25480,0,25480,96173,0,121653
143435401100000,SW 414,Residential,24960,0,24960,104335,0,129295
143435401200000,SW 414,Residential,28243,0,28243,102194,0,130437
143435401300000,SW 414,Residential,29700,0,29700,121346,0,151046
143435401400000,SW 414,Residential,34300,0,34300,103124,0,137424
143435401500000,SW 414,Residential,25644,0,25644,114374,0,140018
143435401600000,SW 414,Residential,25600,0,25600,117431,0,143031
143435401700000,SW 414,Residential,25380,0,25380,150175,0,175555
143435401800000,SW 414,Residential,26516,0,26516,94364,0,120880
143435401900000,SW 414,Residential,25600,0,25600,105717,0,131317
143435402000000,SW 414,Residential,25600,0,25600,89120,0,114720
143435402100000,SW 414,Residential,25600,0,25600,111242,0,136842
143435402200000,SW 414,Residential,28045,0,28045,111392,0,139437
143437600100000,SW 410,Residential,17850,0,17850,118528,0,136378
143437600200000,SW 410,Residential,17850,0,17850,70185,0,88035
143437600300000,SW 410,Residential,17850,0,17850,56471,0,74321
143437600400000,SW 410,Residential,17850,0,17850,67014,0,84864
143437600500000,SW 410,Residential,17850,0,17850,122087,0,139937
143437600600000,SW 410,Residential,21420,0,21420,38007,0,59427
143437600700000,SW 410,Residential,21420,0,21420,80084,0,101504
143437600800000,SW 410,Residential,21420,0,21420,47615,0,69035
143437600900000,SW 410,Residential,17850,0,17850,65788,0,83638
143437601000000,SW 410,Residential,17850,0,17850,60843,0,78693
143437601100000,SW 410,Residential,17850,0,17850,89983,0,107833
143437601200000,SW 410,Residential,21420,0,21420,50881,0,72301
143437601300000,SW 410,Residential,17850,0,17850,48410,0,66260
143437601400000,SW 410,Residential,17850,0,17850,66411,0,84261
143437601500000,SW 410,Residential,17850,0,17850,40801,0,58651
143437601600000,SW 410,Residential,17850,0,17850,69611,0,87461
143437601700000,SW 410,Residential,17850,0,17850,42887,0,60737
143437601800000,SW 410,Residential,17850,0,17850,103663,0,121513
143437601900000,SW 410,Residential,17850,0,17850,126267,0,144117
143437602000000,SW 410,Residential,17850,0,17850,59486,0,77336
143437602100000,SW 410,Residential,17850,0,17850,131482,0,149332
143437602200000,CITY PROPERTY,Exempt,0,0,0,0,0,0
143437700100000,SW 410,Residential,17850,0,17850,67535,0,85385
143437700200000,CITY PROPERTY,Exempt,0,0,0,0,0,0
143437700300000,SW 410,Residential,20849,0,20849,72718,0,93567
143437700400000,SW 410,Residential,17850,0,17850,92351,0,110201
143437700500000,SW 410,Residential,17850,0,17850,38743,0,56593
143437700600000,SW 410,Residential,17850,0,17850,56336,0,74186
143437700700000,SW 410,Residential,17850,0,17850,55688,0,73538
143437700800000,SW 410,Residential,17850,0,17850,0,0,17850
143437700900000,SW 410,Residential,21420,0,21420,113244,0,134664
143437701000000,SW 410,Residential,21420,0,21420,58989,0,80409
143437701100000,SW 410,Residential,17850,0,17850,63677,0,81527
143437701200000,SW 410,Residential,21420,0,21420,39915,0,61335
143437701300000,SW 410,Residential,21420,0,21420,42432,0,63852
143437701400000,SW 410,Residential,17850,0,17850,56159,0,74009
143437701500000,SW 410,Residential,17850,0,17850,40873,0,58723
143437701600000,SW 410,Residential,17850,0,17850,70435,0,88285
143437701700000,SW 410,Residential,17850,0,17850,62997,0,80847
143437701800000,SW 410,Residential,17850,0,17850,98792,0,116642
143437701900000,SW 410,Residential,17850,0,17850,66045,0,83895
143437702000000,SW 410,Residential,17850,0,17850,76935,0,94785
143437702100000,SW 410,Residential,17850,0,17850,69488,0,87338
143437702200000,SW 410,Residential,17850,0,17850,83481,0,101331
143437702300000,SW 410,Residential,17850,0,17850,76218,0,94068
143440100100000,CITY PROPERTY,Exempt,0,0,0,0,0,0
143440200100000,SW 411,Residential,53125,0,53125,102589,0,155714
143440300100000,SW 411,Residential,5000,0,5000,1380,0,6380
143440300200000,SW 411,Residential,11750,0,11750,0,0,11750
143442600100000,SW 411,Residential,45550,0,45550,77621,0,123171
143442600200000,SW 411,Residential,33495,0,33495,6922,0,40417
143442600300000,SW 411,Residential,33495,0,33495,74199,0,107694
143442600400000,SW 411,Residential,33495,0,33495,59368,0,92863
143442600500000,SW 411,Residential,33495,0,33495,49344,0,82839
143442600600000,SW 411,Residential,33495,0,33495,70890,0,104385
143442600700000,VACANT LAND,Exempt,0,27000,27000,0,0,27000
143442600800000,SW 411,Exempt,0,35284,35284,0,116345,151629
143442600900000,SW 411,Exempt,0,33495,33495,0,90964,124459
143442601000000,VACANT LAND,Exempt,0,54000,54000,0,0,54000
143442601100000,VACANT LAND,Exempt,0,49302,49302,0,432,49734
143442601200000,VACANT LAND,Exempt,0,27815,27815,0,0,27815
143442601300000,VACANT LAND,Exempt,0,24057,24057,0,0,24057
143442700300000,SW 431,Residential,34794,0,34794,143993,0,178787
143442700400000,SW 431,Residential,32640,0,32640,139456,0,172096
143442700500000,SW 431,Residential,28000,0,28000,145931,0,173931
143442700600000,SW 431,Residential,29557,0,29557,135698,0,165255
143442700700000,SW 431,Residential,31243,0,31243,166306,0,197549
143442700800000,SW 431,Residential,29436,0,29436,169494,0,198930
143442700900000,SW 411,Residential,41752,0,41752,64108,0,105860
143442701000000,SW 411,Residential,34090,0,34090,0,0,34090
143442701100000,SW 431,Residential,28563,0,28563,147072,0,175635
143442701200000,SW 431,Residential,25716,0,25716,0,0,25716
143442701300000,SW 411,Residential,50000,0,50000,0,0,50000
143442701400000,SW 411,Residential,45800,0,45800,103686,0,149486
143442800100000,SW 411,Residential,20790,0,20790,87146,0,107936
143442800200000,SW 411,Residential,20790,0,20790,0,0,20790
143442800300000,SW 411,Residential,20790,0,20790,0,0,20790
143442800400000,SW 411,Residential,27720,0,27720,79694,0,107414
143442800500000,SW 411,Residential,27720,0,27720,86893,0,114613
143442800600000,SW 411,Residential,27720,0,27720,87692,0,115412
143442800700000,SW 411,Residential,28298,0,28298,81648,0,109946
143442800800000,SW 411,Residential,31474,0,31474,136939,0,168413
143442800900000,SW 411,Residential,26775,0,26775,131632,0,158407
143442801000000,SW 411,Residential,33916,0,33916,124925,0,158841
143442801100000,SW 411,Residential,32680,0,32680,126323,0,159003
143442801200000,SW 411,Residential,26136,0,26136,40715,0,66851
143442801300000,SW 411,Residential,27143,0,27143,117703,0,144846
143442801400000,SW 411,Residential,27720,0,27720,98831,0,126551
143442801500000,SW 411,Residential,27720,0,27720,86540,0,114260
143442801600000,SW 411,Residential,27720,0,27720,92851,0,120571
143442801700000,SW 411,Residential,37422,0,37422,38546,0,75968
143442900100000,SW 411,Residential,33495,0,33495,152325,0,185820
143442900200000,SW 411,Residential,33495,0,33495,155931,0,189426
143442900300000,SW 411,Residential,33495,0,33495,121922,0,155417
143442900400000,SW 411,Residential,35496,0,35496,83632,0,119128
143442900500000,SW 411,Residential,38592,0,38592,93495,0,132087
143442900600000,SW 411,Residential,53750,0,53750,218127,0,271877
143442900700000,SW 411,Residential,45075,0,45075,80788,0,125863
143442900800000,SW 411,Residential,33495,0,33495,98349,0,131844
143443000100000,SW 411,Residential,22176,0,22176,42062,0,64238
143443000200000,SW 411,Residential,24552,0,24552,46024,0,70576
143443000300000,SW 411,Residential,47425,0,47425,63239,0,110664
143443000500000,SW 411,Residential,28613,0,28613,0,0,28613
143443000600000,SW 411,Residential,29952,0,29952,0,0,29952
143443000700000,SW 411,Residential,29952,0,29952,0,0,29952
143443000800000,SW 411,Residential,29952,0,29952,166702,0,196654
143443000900000,SW 431,Residential,29224,0,29224,116096,0,145320
143443001000000,SW 431,Residential,33040,0,33040,144552,0,177592
143443001100000,SW 431,Residential,31640,0,31640,138234,0,169874
143443001200000,SW 431,Residential,29120,0,29120,129835,0,158955
143443001300000,SW 431,Residential,35468,0,35468,201645,0,237113
143443001400000,SW 431,Residential,37484,0,37484,186646,0,224130
143443001500000,SW 411,Residential,28351,0,28351,53712,0,82063
143443001700000,SW 431,Residential,28630,0,28630,162208,0,190838
143443001800000,SW 431,Residential,32934,0,32934,184933,0,217867
143445100100000,SW 411,Residential,42591,0,42591,97568,0,140159
143445100300000,CITY PROPERTY,Exempt,0,0,0,0,0,0
143445100400000,SW 411,Residential,59250,0,59250,172045,0,231295
143445100500000,SW 411,Residential,45900,0,45900,92805,0,138705
143445100700000,SW 431,Residential,31214,0,31214,161721,0,192935
143445100800000,SW 431,Residential,30600,0,30600,166467,0,197067
143445101100000,SW 431,Residential,3612,0,3612,0,0,3612
143445101200000,SW 431,Residential,38420,0,38420,189506,0,227926
143445101300000,SW 431,Residential,43430,0,43430,156697,0,200127
143445101400000,SW 431,Residential,57304,0,57304,262545,0,319849
143445101500000,SW 431,Residential,42784,0,42784,0,0,42784
143445101600000,CITY PROPERTY,Exempt,0,0,0,0,0,0
143445101700000,SW 431,Residential,28480,0,28480,149632,0,178112
143445101800000,SW 431,Residential,29760,0,29760,0,0,29760
143445200100000,SW 431,Residential,25760,0,25760,156310,0,182070
143445200200000,SW 431,Residential,33651,0,33651,153955,0,187606
143445200300000,SW 431,Residential,35968,0,35968,73276,0,109244
143445200400000,SW 431,Residential,28581,0,28581,137608,0,166189
143445200500000,SW 431,Residential,29440,0,29440,173922,0,203362
143447600100000,SW 411,Residential,47750,0,47750,62704,0,110454
143447600200000,SW 411,Residential,46875,0,46875,33861,0,80736
143447600300000,SW 411,Residential,49775,0,49775,18251,0,68026
143510100100000,SE 239,Residential,48718,0,48718,169282,0,218000
143510100200000,SE 239,Residential,86600,0,86600,109971,0,196571
143510100300000,SE 239,Residential,20,0,20,0,0,20
143510100400000,CITY PROPERTY,Exempt,0,0,0,0,0,0
143510100500000,SE 239,Residential,45500,0,45500,93094,0,138594
143510100600000,SE 239,Residential,47980,0,47980,81777,0,129757
143512600100000,SE 239,Residential,83100,0,83100,56996,0,140096
143515100100000,SE 239,Ag Dwelling,25536,0,25536,136190,5548,167274
143515100200000,SE 239,Residential,24476,0,24476,74754,0,99230
143515100300000,SE 239,Residential,30625,0,30625,129957,0,160582
143515100400000,SE 239,Residential,11010,0,11010,0,0,11010
143515100500000,SE 239,Ag Dwelling,7643,0,7643,109708,5945,123296
143517600100000,SE 239,Ag Land,23500,0,23500,0,0,23500
143520100100000,SE 242,Residential,55760,0,55760,622,0,56382
143520100200000,SE 242,Ag Land,13575,0,13575,0,0,13575
143520100300000,SE 242,Residential,21000,0,21000,65400,0,86400
143520200100000,SE 242,Residential,35496,0,35496,96367,0,131863
143520200200000,CITY PROPERTY,Exempt,0,0,0,0,0,0
143520200400000,SE 242,Residential,24453,0,24453,92447,0,116900
143520200700000,SE 242,Residential,35632,0,35632,92407,0,128039
143520200800000,SE 242,Residential,37500,0,37500,82012,0,119512
143520200900000,SE 242,Residential,5025,0,5025,0,0,5025
143520201000000,SE 242,Residential,42425,0,42425,203200,0,245625
143520201100000,SE 242,Residential,31977,0,31977,44379,0,76356
143520201200000,SE 242,Residential,36924,0,36924,163810,0,200734
143520201300000,SE 242,Residential,39513,0,39513,139164,0,178677
143520201400000,SE 242,Residential,18693,0,18693,0,0,18693
143520201500000,SE 242,Residential,18693,0,18693,135081,0,153774
143520201600000,SE 242,Residential,26705,0,26705,177145,0,203850
143520201700000,SE 242,Residential,34713,0,34713,81273,0,115986
143522600100000,SE 242,Residential,23000,0,23000,132434,0,155434
143522600200000,SE 242,Residential,23000,0,23000,80284,0,103284
143522600300000,SE 242,Residential,25875,0,25875,143994,0,169869
143522600400000,SE 242,Residential,26860,0,26860,88134,0,114994
143522600500000,SE 242,Residential,23426,0,23426,170981,0,194407
143522600600000,SE 242,Residential,15680,0,15680,110789,0,126469
143522600700000,SE 242,Residential,20052,0,20052,79179,0,99231
143522600800000,SE 242,Residential,13860,0,13860,96433,0,110293
143522700100000,SE 242,Residential,12980,0,12980,123013,0,135993
143522700200000,SE 242,Residential,19470,0,19470,76381,0,95851
143522700300000,SE 242,Residential,19470,0,19470,0,0,19470
143522700400000,SE 242,Residential,23364,0,23364,64284,0,87648
143522700500000,SE 242,Residential,12980,0,12980,2920,0,15900
143522800100000,SE 242,Residential,28500,0,28500,43779,0,72279
143522800200000,SE 242,Residential,7750,0,7750,0,0,7750
143522800300000,SE 242,Residential,17142,0,17142,49743,0,66885
143522800400000,SE 242,Residential,26904,0,26904,121355,0,148259
143522800500000,SE 242,Residential,26326,0,26326,143674,0,170000
143522800600000,SE 242,Residential,17700,0,17700,0,0,17700
143522800900000,SE 242,Residential,29628,0,29628,204446,0,234074
143522801000000,SE 242,Residential,29250,0,29250,196761,0,226011
143522801100000,SE 242,Residential,28500,0,28500,166767,0,195267
143522801200000,SE 242,Residential,28500,0,28500,117478,0,145978
143522801300000,SE 242,Residential,44250,0,44250,189769,0,234019
143522900100000,SE 242,Residential,27568,0,27568,57728,0,85296
143522900200000,SE 242,Residential,13712,0,13712,0,0,13712
143522900300000,SE 242,Residential,4460,0,4460,2394,0,6854
143522900400000,SE 242,Residential,9086,0,9086,63095,0,72181
143522900500000,SE 242,Residential,12980,0,12980,139744,0,152724
143522900600000,SE 242,Residential,27472,0,27472,121997,0,149469
143522900700000,SE 242,Residential,2900,0,2900,3668,0,6568
143522900800000,SE 242,Residential,20944,0,20944,118646,0,139590
143522900900000,SE 242,Residential,22517,0,22517,53390,0,75907
143522901000000,SE 242,Residential,22738,0,22738,2416,0,25154
143522901100000,SE 242,Residential,11700,0,11700,91742,0,103442
143522901200000,SE 242,Residential,11700,0,11700,118429,0,130129
143522901300000,SE 242,Residential,17708,0,17708,0,0,17708
143522901400000,SE 242,Residential,13024,0,13024,131614,0,144638
143522901500000,SE 242,Residential,14040,0,14040,149833,0,163873
143525100100000,SE 242,Residential,12870,0,12870,0,0,12870
143525100200000,SE 242,Residential,14610,0,14610,92490,0,107100
143525100300000,SE 242,Residential,10500,0,10500,92987,0,103487
143525100400000,SE 242,Residential,10500,0,10500,93904,0,104404
143525200100000,SE 242,Residential,19997,0,19997,93055,0,113052
143525300100000,SE 242,Residential,9000,0,9000,29171,0,38171
143525400100000,SE 242,Residential,33925,0,33925,152302,0,186227
143525400200000,SE 242,Ag Dwelling,25601,0,25601,32967,2506,61074
143525400300000,SE 242,Ag Land,10864,0,10864,0,0,10864
143525400400000,SE 242,Residential,3982,0,3982,0,0,3982
143525400500000,SE 242,Residential,5974,0,5974,92556,0,98530
143525400600000,SE 242,Residential,5974,0,5974,2163,0,8137
143525401000000,SE 242,Residential,8850,0,8850,90811,0,99661
143525401100000,SE 242,Residential,8850,0,8850,55924,0,64774
143525401200000,SE 242,Residential,8850,0,8850,70554,0,79404
143525401300000,SE 242,Residential,8850,0,8850,50674,0,59524
143525401400000,SE 242,Residential,13748,0,13748,0,0,13748
143525401500000,VACANT LAND,Commercial,0,1798,1798,0,0,1798
143525401600000,SE 242,Residential,13275,0,13275,83188,0,96463
143527600100000,SE 242,Ag Land,3757,0,3757,0,0,3757
143527600200000,SE 242,Ag Land,8283,0,8283,0,0,8283
143527700100000,SE 242,Residential,14926,0,14926,126960,0,141886
143527700200000,SE 242,Residential,23600,0,23600,181523,0,205123
143527700300000,SE 242,Residential,20800,0,20800,104115,0,124915
143527700400000,SE 242,Residential,21800,0,21800,46225,0,68025
143527700500000,SE 242,Residential,13560,0,13560,77160,0,90720
143527700600000,SE 242,Residential,13920,0,13920,0,0,13920
143527700700000,SE 242,Residential,30200,0,30200,211387,0,241587
143527700800000,SE 242,Residential,31025,0,31025,144434,0,175459
143527700900000,SE 242,Residential,31625,0,31625,120453,0,152078
143527701000000,SE 242,Residential,15262,0,15262,0,0,15262
143527701100000,CITY PROPERTY,Exempt,0,0,0,0,0,0
143527701200000,SE 242,Residential,10620,0,10620,68758,0,79378
143527701300000,SE 242,Residential,8850,0,8850,0,0,8850
143527701400000,SE 242,Residential,9562,0,9562,125430,0,134992
143527701500000,SE 242,Residential,10800,0,10800,131620,0,142420
143527701600000,SE 242,Residential,21600,0,21600,37245,0,58845
143527701700000,SE 242,Residential,10737,0,10737,84988,0,95725
143527701800000,SE 242,Residential,21060,0,21060,77026,0,98086
143527701900000,SE 242,Residential,9990,0,9990,85619,0,95609
143527702000000,SE 242,Residential,16050,0,16050,38069,0,54119
143530100100000,SE 242,Residential,21999,0,21999,93292,0,115291
143530100200000,SE 242,Residential,15930,0,15930,144153,0,160083
143530100300000,SE 242,Residential,9270,0,9270,69830,0,79100
143530100400000,SE 242,Residential,8820,0,8820,87119,0,95939
143530100500000,SE 242,Residential,9103,0,9103,59725,0,68828
143530100600000,CITY PROPERTY,Exempt,0,0,0,0,0,0
143530100700000,CITY PROPERTY,Exempt,0,0,0,0,0,0
143530100800000,SE 242,Residential,6606,0,6606,69784,0,76390
143530100900000,SE 242,Residential,8518,0,8518,103438,0,111956
143530200100000,SE 242,Residential,8950,0,8950,73022,0,81972
143530200200000,SE 242,Residential,6184,0,6184,57069,0,63253
143530200300000,SE 242,Residential,6184,0,6184,47805,0,53989
143530200400000,SE 242,Residential,6184,0,6184,45766,0,51950
143530200500000,SE 242,Residential,9562,0,9562,0,0,9562
143530200600000,SE 242,Residential,7459,0,7459,45774,0,53233
143530200700000,SE 242,Residential,7459,0,7459,68197,0,75656
143530200800000,SE 242,Residential,7459,0,7459,58362,0,65821
143530200900000,SE 242,Residential,6375,0,6375,54720,0,61095
143530201000000,SE 242,Residential,1275,0,1275,0,0,1275
143530201100000,SE 242,Residential,6375,0,6375,59846,0,66221
143530201200000,SE 242,Residential,1275,0,1275,0,0,1275
143530201300000,SE 242,Residential,6375,0,6375,46530,0,52905
143530201400000,SE 242,Residential,1275,0,1275,0,0,1275
143530201500000,CITY PROPERTY,Exempt,0,0,0,0,0,0
143530201600000,SE 242,Residential,1275,0,1275,0,0,1275
143530201700000,SE 242,Residential,6375,0,6375,47488,0,53863
143530201800000,SE 242,Residential,1275,0,1275,0,0,1275
143530201900000,SE 242,Residential,7020,0,7020,1318,0,8338
143530202100000,SE 242,Residential,5265,0,5265,71052,0,76317
143530202200000,SE 242,Residential,4387,0,4387,0,0,4387
143530202300000,SE 242,Residential,4387,0,4387,0,0,4387
143530202400000,SE 242,Residential,5000,0,5000,0,0,5000
143530202500000,SE 242,Residential,4387,0,4387,0,0,4387
143530202600000,SE 242,Residential,6318,0,6318,17742,0,24060
143530202700000,CITY PROPERTY,Exempt,0,0,0,0,0,0
143530202800000,SE 242,Residential,5000,0,5000,0,0,5000
143530202900000,SE 242,Residential,6318,0,6318,22505,0,28823
143530203000000,SE 242,Residential,8950,0,8950,18295,0,27245
143530203100000,SE 242,Residential,11188,0,11188,69431,0,80619
143530203200000,SE 242,Residential,8950,0,8950,47839,0,56789
143530203300000,SE 242,Residential,7459,0,7459,39329,0,46788
143530203400000,SE 242,Residential,7459,0,7459,26074,0,33533
143530203500000,SE 242,Residential,7459,0,7459,59013,0,66472
143530203600000,SE 242,Residential,7459,0,7459,65565,0,73024
143530300100000,SE 242,Residential,17442,0,17442,57312,0,74754
143530300300000,SE 242,Residential,13081,0,13081,0,0,13081
143530300400000,CITY PROPERTY,Exempt,0,0,0,0,0,0
143530300500000,SE 242,Residential,7267,0,7267,35759,0,43026
143530300600000,CITY PROPERTY,Exempt,0,0,0,0,0,0
143530300700000,CITY PROPERTY,Exempt,0,0,0,0,0,0
143530300800000,CITY PROPERTY,Exempt,0,0,0,0,0,0
143530300900000,CITY PROPERTY,Exempt,0,0,0,0,0,0
143530301000000,SE 242,Residential,5130,0,5130,21896,0,27026
143530301100000,CITY PROPERTY,Exempt,0,0,0,0,0,0
143530301200000,CITY PROPERTY,Exempt,0,0,0,0,0,0
143530301500000,CITY PROPERTY,Exempt,0,0,0,0,0,0
143530301600000,SE 242,Residential,6156,0,6156,60292,0,66448
143530301700000,CITY PROPERTY,Exempt,0,0,0,0,0,0
143530301800000,SE 242,Residential,9234,0,9234,89567,0,98801
143530301900000,SE 242,Residential,5130,0,5130,0,0,5130
143530302000000,SE 242,Residential,7267,0,7267,29463,0,36730
143530302100000,SE 242,Residential,7267,0,7267,52763,0,60030
143530302200000,SE 242,Residential,7267,0,7267,0,0,7267
143530302300000,SE 242,Residential,10901,0,10901,0,0,10901
143530302400000,SE 242,Residential,10901,0,10901,0,0,10901
143530302500000,SE 242,Residential,5130,0,5130,1693,0,6823
143530400100000,SE 242,Residential,5085,0,5085,37590,0,42675
143530400200000,CITY PROPERTY,Exempt,0,0,0,0,0,0
143530400300000,CITY PROPERTY,Exempt,0,0,0,0,0,0
143530400400000,SE 242,Residential,5085,0,5085,23902,0,28987
143530400500000,SE 242,Residential,6102,0,6102,38120,0,44222
143530400600000,SE 242,Residential,6102,0,6102,62535,0,68637
143530400700000,SE 242,Residential,5085,0,5085,39243,0,44328
143530400800000,SE 242,Residential,7627,0,7627,0,0,7627
143530400900000,CITY PROPERTY,Exempt,0,0,0,0,0,0
143530401000000,CITY PROPERTY,Exempt,0,0,0,0,0,0
143530401100000,CITY PROPERTY,Exempt,0,0,0,0,0,0
143530401200000,CITY PROPERTY,Exempt,0,0,0,0,0,0
143530401300000,SE 242,Residential,4198,0,4198,0,0,4198
143530401400000,SE 242,Residential,6719,0,6719,72099,0,78818
143530401500000,SE 242,Residential,4237,0,4237,0,0,4237
143532600100000,SE 242,Residential,7522,0,7522,69558,0,77080
143532600200000,SE 242,Residential,7522,0,7522,67223,0,74745
143532600300000,SE 242,Residential,7522,0,7522,100815,0,108337
143532600400000,SE 242,Residential,7522,0,7522,67974,0,75496
143532600500000,SE 242,Residential,11283,0,11283,74410,0,85693
143532600600000,SE 242,Residential,7522,0,7522,33141,0,40663
143532600900000,CITY PROPERTY,Exempt,0,0,0,0,0,0
143532601000000,CITY PROPERTY,Exempt,0,0,0,0,0,0
143532601100000,SE 242,Residential,4995,0,4995,32111,0,37106
143532601200000,SE 242,Residential,5000,0,5000,0,0,5000
143532601300000,SE 242,Residential,9027,0,9027,75077,0,84104
143532700100000,CITY PROPERTY,Exempt,0,0,0,0,0,0
143532700200000,CITY PROPERTY,Exempt,0,0,0,0,0,0
143532700300000,CENTRALLY ASSESSED,Other,0,0,0,0,0,0
143535100100000,CITY PROPERTY,Exempt,0,0,0,0,0,0
143537700100000,CITY PROPERTY,Exempt,0,0,0,0,0,0
143540100100000,SE 242,Ag Dwelling,38926,0,38926,94364,3504,136794
143540100200000,SE 242,Residential,37050,0,37050,77278,0,114328
143540100300000,SE 242,Residential,22800,0,22800,173683,0,196483
143540100400000,SE 242,Residential,1243,0,1243,0,0,1243
143542600100000,SE 242,Ag Dwelling,13869,0,13869,102884,0,116753
143542700100000,SE 242,Residential,17460,0,17460,0,0,17460
143542700200000,SE 242,Residential,14232,0,14232,81619,0,95851
143542700300000,SE 242,Residential,14007,0,14007,90993,0,105000
143542700400000,SE 242,Residential,10035,0,10035,75747,0,85782
143542700500000,CITY PROPERTY,Exempt,0,0,0,0,0,0
143542700600000,CITY PROPERTY,Exempt,0,0,0,0,0,0
143542700800000,SE 242,Residential,19501,0,19501,0,0,19501
143542700900000,SE 242,Residential,21800,0,21800,71162,0,92962
143542701000000,SE 242,Residential,21800,0,21800,136492,0,158292
143542701100000,SE 242,Residential,17440,0,17440,0,0,17440
143542701200000,SE 242,Residential,12208,0,12208,0,0,12208
143542701300000,SE 242,Residential,12208,0,12208,103417,0,115625
143542701400000,SE 242,Residential,17440,0,17440,103057,0,120497
143542701500000,SE 242,Residential,21840,0,21840,65206,0,87046
143542701600000,SE 242,Residential,24619,0,24619,0,0,24619
143542701700000,SE 242,Residential,20411,0,20411,0,0,20411
143542701800000,SE 242,Residential,30500,0,30500,85349,0,115849
143542701900000,SE 242,Residential,30000,0,30000,280317,0,310317
143542702000000,CITY PROPERTY,Exempt,0,0,0,0,0,0
143542702100000,SE 242,Residential,15043,0,15043,149553,0,164596
143542702200000,SE 242,Residential,14216,0,14216,0,0,14216
143542702300000,SE 242,Residential,15618,0,15618,151741,0,167359
143542702400000,SE 242,Residential,15752,0,15752,112911,0,128663
143542702500000,SE 242,Residential,14216,0,14216,0,0,14216
143542702600000,CITY PROPERTY,Exempt,0,0,0,0,0,0
143542702700000,CITY PROPERTY,Exempt,0,0,0,0,0,0
143545100100000,CITY PROPERTY,Exempt,0,0,0,0,0,0
143545200100000,CITY PROPERTY,Exempt,0,0,0,0,0,0
143547600100000,SE 242,Ag Dwelling,38260,0,38260,102928,7166,148354
143547700100000,CITY PROPERTY,Exempt,0,0,0,0,0,0
143547700200000,CENTRALLY ASSESSED,Other,0,0,0,0,0,0
143640200100000,CITY PROPERTY,Exempt,0,0,0,0,0,0
143647600200000,FLAT PARKING,Commercial,0,257796,257796,0,57420,315216
143647600300000,VACANT LAND,Commercial,0,151200,151200,0,0,151200
143647700100000,CITY PROPERTY,Exempt,0,0,0,0,0,0
151815100400000,SE 244,Residential,159000,0,159000,0,0,159000
151815100500000,SE 244,Residential,92000,0,92000,0,0,92000
151815100600000,SE 244,Residential,247500,0,247500,0,0,247500
151815100700000,SE 244,Residential,209250,0,209250,0,0,209250
151815100800000,SE 244,Residential,294000,0,294000,663776,0,957776
151815100900000,SE 244,Residential,121500,0,121500,664451,0,785951
151822600900000,SE 244,Residential,70000,0,70000,0,0,70000
151822601000000,SE 244,Residential,94050,0,94050,0,0,94050
151822601100000,SE 244,Residential,103128,0,103128,421872,0,525000
151822601200000,VACANT LAND,Commercial,0,64260,64260,0,0,64260
151822601202000,ANTENNAS/TOWERS(BLL),Commercial,0,0,0,0,287210,287210
151822601300000,SE 244,Residential,65000,0,65000,0,0,65000
151822601400000,SE 244,Residential,85957,0,85957,95363,0,181320
151822601500000,SE 244,Residential,86982,0,86982,372414,0,459396
151822601600000,SE 244,Residential,68000,0,68000,0,0,68000
151822700100000,SE 244,Residential,55000,0,55000,0,0,55000
151822700400000,SE 244,Residential,60000,0,60000,0,0,60000
151822700500000,SE 244,Residential,80080,0,80080,429280,0,509360
151822700600000,SE 244,Residential,82538,0,82538,357962,0,440500
151822700700000,SE 244,Residential,81717,0,81717,434560,0,516277
151822700800000,SE 244,Residential,81703,0,81703,469209,0,550912
151822700900000,SE 244,Residential,78663,0,78663,460660,0,539323
151822701000000,SE 244,Residential,168939,0,168939,1028712,0,1197651
151825100500000,SE 244,Residential,55000,0,55000,0,0,55000
151825100600000,SE 244,Residential,151850,0,151850,498774,0,650624
151825100700000,SE 244,Residential,86487,0,86487,461828,0,548315
151825100800000,SE 244,Residential,5220,0,5220,0,0,5220
151827600200000,SE 244,Residential,112000,0,112000,0,0,112000
151827600300000,SE 244,Residential,112000,0,112000,404417,0,516417
151827600400000,SE 244,Residential,119200,0,119200,0,0,119200
151827600500000,SE 244,Residential,98400,0,98400,0,0,98400
151827600800000,SE 244,Residential,161250,0,161250,0,0,161250
151827600900000,SE 205,Residential,128250,0,128250,0,0,128250
151827601000000,SE 244,Residential,160000,0,160000,627888,0,787888
151827601100000,SE 244,Residential,160000,0,160000,522458,0,682458
151827601200000,SE 244,Residential,0,0,0,0,0,0
151827700100000,SE 244,Residential,120000,0,120000,0,0,120000
151827700200000,SE 244,Residential,88000,0,88000,497884,0,585884
151827700300000,SE 244,Residential,108000,0,108000,0,0,108000
151827700400000,SE 244,Residential,106200,0,106200,506973,0,613173
151827700500000,SE 244,Residential,106200,0,106200,0,0,106200
151827700600000,SE 244,Residential,108000,0,108000,0,0,108000
151827700700000,SE 244,Residential,106200,0,106200,544470,0,650670
151827700800000,SE 244,Residential,121500,0,121500,0,0,121500
151827700900000,SE 244,Residential,149000,0,149000,0,0,149000
151827701000000,SE 244,Residential,149000,0,149000,0,0,149000
151827701100000,SE 244,Residential,145000,0,145000,0,0,145000
151827800100000,SE 244,Residential,91000,0,91000,415465,0,506465
151827800200000,SE 244,Residential,96000,0,96000,0,0,96000
151827800300000,SE 244,Residential,96000,0,96000,489500,0,585500
151827800400000,SE 244,Residential,96000,0,96000,0,0,96000
151827800500000,SE 244,Residential,107200,0,107200,0,0,107200
151827800600000,SE 244,Residential,182986,0,182986,567014,0,750000
151827800800000,SE 244,Residential,168840,0,168840,654160,0,823000
151827800900000,SE 244,Residential,120000,0,120000,0,0,120000
151827900100000,SE 244,Residential,152100,0,152100,0,0,152100
151827900200000,SE 244,Residential,162000,0,162000,0,0,162000
151827900300000,SE 244,Residential,162000,0,162000,0,0,162000
151827900400000,SE 244,Residential,144000,0,144000,0,0,144000
151827900500000,SE 244,Residential,144000,0,144000,0,0,144000
151830100300000,SE 205,Residential,7560,0,7560,0,0,7560
151830100400000,SE 244,Residential,106200,0,106200,0,0,106200
151830100500000,SE 244,Residential,106200,0,106200,515227,0,621427
151830100600000,SE 244,Residential,106200,0,106200,499772,0,605972
151830100700000,SE 244,Residential,124250,0,124250,0,0,124250
151830100800000,SE 244,Residential,119700,0,119700,618101,0,737801
151830100900000,SE 244,Residential,112500,0,112500,497685,0,610185
151830101000000,SE 244,Residential,208050,0,208050,667950,0,876000
151830101100000,SE 244,Residential,121500,0,121500,0,0,121500
151830101200000,SE 244,Residential,126000,0,126000,0,0,126000
151830101300000,SE 244,Residential,94500,0,94500,0,0,94500
151830101400000,SE 205,Residential,0,0,0,0,0,0
151830101500000,SE 244,Residential,190000,0,190000,877699,0,1067699
151830101600000,SE 244,Residential,180000,0,180000,841513,0,1021513
151830101700000,SE 244,Residential,157000,0,157000,0,0,157000
151830101800000,SE 244,Residential,156000,0,156000,0,0,156000
151830101900000,SE 244,Residential,155000,0,155000,430666,0,585666
151830102000000,SE 244,Residential,88000,0,88000,0,0,88000
151830102100000,SE 244,Residential,140000,0,140000,0,0,140000
151830200100000,SE 244,Residential,156000,0,156000,0,0,156000
151830200200000,SE 244,Residential,144000,0,144000,641015,0,785015
151830200300000,SE 244,Residential,158684,0,158684,491316,0,650000
151830200400000,SE 244,Residential,136800,0,136800,0,0,136800
151830300100000,SE 244,Residential,68250,0,68250,0,0,68250
151830300200000,SE 244,Residential,63000,0,63000,865279,0,928279
151830300300000,SE 244,Residential,76500,0,76500,0,0,76500
151832600400000,SE 244,Residential,116800,0,116800,0,0,116800
151832600500000,SE 244,Residential,112000,0,112000,0,0,112000
151832600600000,SE 244,Residential,120000,0,120000,0,0,120000
151832600700000,SE 244,Residential,106200,0,106200,0,0,106200
151832600800000,SE 205,Residential,20550,0,20550,0,0,20550
151835100300000,SE 244,Residential,118800,0,118800,0,0,118800
151837600200000,SE 244,Residential,126000,0,126000,0,0,126000
151837600300000,SE 244,Residential,241500,0,241500,0,0,241500
151837600400000,SE 244,Residential,198000,0,198000,0,0,198000
151842600400000,SE 244,Residential,2120,0,2120,0,0,2120
151842600500000,SE 244,Residential,63280,0,63280,0,0,63280
151842600600000,SE 244,Residential,144000,0,144000,675800,0,819800
151842600700000,SE 244,Residential,144000,0,144000,687213,0,831213
151842600800000,SE 244,Residential,153000,0,153000,661544,0,814544
151842600900000,SE 244,Residential,193000,0,193000,0,0,193000
151842601000000,SE 244,Residential,192000,0,192000,0,0,192000
151842601100000,SE 244,Residential,180000,0,180000,626324,0,806324
151842601200000,SE 244,Residential,206250,0,206250,0,0,206250
151842601300000,SE 244,Residential,237000,0,237000,603251,0,840251
151842601400000,SE 244,Residential,200000,0,200000,0,0,200000
151842601500000,SE 244,Residential,165000,0,165000,0,0,165000
151842601600000,SE 244,Residential,165000,0,165000,0,0,165000
151842601700000,SE 244,Residential,150000,0,150000,488406,0,638406
151842601800000,SE 244,Residential,0,0,0,0,0,0
151930300500000,SE 220,Residential,32264,0,32264,159943,0,192207
151930300600000,SE 220,Residential,31080,0,31080,200866,0,231946
151930300700000,SE 220,Residential,33156,0,33156,161741,0,194897
151930300800000,SE 220,Residential,32461,0,32461,0,0,32461
151930300900000,SE 220,Residential,33557,0,33557,223444,0,257001
151930301000000,SE 220,Residential,34962,0,34962,231214,0,266176
151930301100000,SE 220,Residential,33454,0,33454,183296,0,216750
151930301200000,SE 220,Residential,34189,0,34189,194905,0,229094
151930301300000,SE 220,Residential,36269,0,36269,186982,0,223251
151930301400000,SE 220,Residential,34306,0,34306,323058,0,357364
151930301500000,SE 220,Residential,27922,0,27922,89044,0,116966
151930400700000,SE 220,Residential,61750,0,61750,106013,0,167763
151932600100000,SE 220,Residential,37080,0,37080,142703,0,179783
151932600200000,SE 220,Residential,32960,0,32960,145887,0,178847
151932600300000,SE 220,Residential,41200,0,41200,204774,0,245974
151932600400000,SE 220,Residential,37080,0,37080,173956,0,211036
151932600500000,SE 220,Residential,37217,0,37217,218179,0,255396
151932600600000,SE 220,Residential,40491,0,40491,179894,0,220385
151932600700000,SE 220,Residential,35490,0,35490,205405,0,240895
151932600800000,SE 220,Residential,37080,0,37080,181863,0,218943
151932600900000,SE 220,Residential,37080,0,37080,214501,0,251581
151932601000000,SE 220,Residential,37080,0,37080,137138,0,174218
151932601100000,SE 220,Residential,41369,0,41369,166289,0,207658
151932601300000,SE 220,Residential,426,0,426,0,0,426
151932601600000,SE 220,Residential,249,0,249,0,0,249
151932601700000,SE 220,Residential,37858,0,37858,158929,0,196787
151932601800000,SE 220,Residential,35280,0,35280,179266,0,214546
151932601900000,SE 220,Residential,35280,0,35280,147284,0,182564
151932602000000,SE 220,Residential,35280,0,35280,148205,0,183485
151932602100000,SE 220,Residential,34920,0,34920,165255,0,200175
151932602200000,SE 220,Residential,30468,0,30468,207549,0,238017
151932602300000,SE 220,Residential,33840,0,33840,152866,0,186706
151932602400000,SE 220,Residential,33840,0,33840,144644,0,178484
151932602500000,SE 220,Residential,33522,0,33522,108919,0,142441
151932602600000,SE 220,Residential,33840,0,33840,125725,0,159565
151932602700000,SE 220,Residential,35600,0,35600,218441,0,254041
151932602800000,SE 220,Residential,38963,0,38963,185266,0,224229
151932602900000,SE 220,Residential,41485,0,41485,180956,0,222441
151932603000000,SE 220,Residential,34855,0,34855,172165,0,207020
151932603100000,SE 220,Residential,35640,0,35640,177114,0,212754
151932603200000,SE 220,Residential,35640,0,35640,210679,0,246319
151932603300000,SE 220,Residential,38333,0,38333,231741,0,270074
151932603400000,SE 220,Residential,52879,0,52879,225253,0,278132
151932603600000,SE 220,Residential,26600,0,26600,0,0,26600
151932603700000,SE 220,Residential,71350,0,71350,428019,0,499369
151932603800000,SE 220,Residential,37240,0,37240,148205,0,185445
151932603900000,SE 220,Residential,36040,0,36040,153945,0,189985
151932604000000,SE 220,Residential,36380,0,36380,165243,0,201623
151932604100000,SE 220,Residential,36380,0,36380,155953,0,192333
151932604200000,SE 220,Residential,36720,0,36720,169736,0,206456
151932604300000,SE 220,Residential,37060,0,37060,120626,0,157686
151932604400000,SE 220,Residential,39265,0,39265,190820,0,230085
151932604500000,SE 220,Residential,39900,0,39900,249202,0,289102
151932604600000,SE 220,Residential,34497,0,34497,150152,0,184649
151932604700000,SE 220,Residential,32049,0,32049,165076,0,197125
151932604800000,SE 220,Residential,32724,0,32724,148326,0,181050
151932604900000,SE 220,Residential,32400,0,32400,136983,0,169383
151932605000000,SE 220,Residential,32400,0,32400,230734,0,263134
151932605100000,SE 220,Residential,32400,0,32400,139736,0,172136
151932605200000,SE 220,Residential,39027,0,39027,162080,0,201107
151932605300000,SE 220,Residential,33721,0,33721,146158,0,179879
151932605400000,SE 220,Residential,32761,0,32761,118028,0,150789
151932605500000,SE 220,Residential,28501,0,28501,162432,0,190933
151935100400000,SE 220,Residential,48350,0,48350,165312,0,213662
151935100500000,SE 220,Residential,39300,0,39300,248721,0,288021
151935100600000,SE 220,Residential,45240,0,45240,244593,0,289833
151935100700000,SE 220,Residential,47810,0,47810,228823,0,276633
151935100800000,SE 220,Residential,46710,0,46710,259227,0,305937
151935100900000,SE 220,Residential,46340,0,46340,266088,0,312428
151935101000000,SE 220,Residential,47070,0,47070,275161,0,322231
151935101100000,SE 220,Residential,52600,0,52600,0,0,52600
151935101200000,SE 220,Residential,45710,0,45710,224595,0,270305
151935101300000,SE 220,Residential,61243,0,61243,300217,0,361460
151935101400000,SE 220,Residential,51300,0,51300,235946,0,287246
151935101500000,SE 220,Residential,51200,0,51200,256711,0,307911
151935101600000,SE 220,Residential,51000,0,51000,273458,0,324458
151935101700000,SE 220,Residential,47810,0,47810,0,0,47810
151935101800000,SE 220,Residential,53200,0,53200,310977,0,364177
151935101900000,SHOP,Commercial,0,45765,45765,0,89842,135607
151935103000000,SE 220,Residential,2840,0,2840,0,0,2840
151935103100000,SE 220,Exempt,0,0,0,0,0,0
152935100200000,CITY PROPERTY,Exempt,0,0,0,0,0,0
153032600200000,SE 246,Residential,161420,0,161420,293814,0,455234
153032600300000,SE 246,Residential,192100,0,192100,1019464,0,1211564
153032600400000,SE 246,Residential,130000,0,130000,257173,0,387173
153040300100000,CITY PROPERTY,Exempt,0,0,0,0,0,0
153210200100000,CITY PROPERTY,Exempt,0,0,0,0,0,0
153212600200000,CENTRALLY ASSESSED,Other,0,0,0,0,0,0
153222600100000,CITY PROPERTY,Exempt,0,0,0,0,0,0
153322700100000,CENTRALLY ASSESSED,Other,0,0,0,0,0,0
153322700102000,ANTENNAS/TOWERS(BLL),Exempt,0,0,0,0,0,0
153325100100000,SE 217,Exempt,0,0,0,0,0,0
153330100100000,CITY PROPERTY,Exempt,0,0,0,0,0,0
153332600100000,SE 217,Exempt,0,0,0,0,0,0
153335100100000,SE 217,Exempt,0,0,0,0,0,0
153337700100000,SE 217,Exempt,0,0,0,0,0,0
180622600100000,SW 422,Residential,383800,0,383800,0,0,383800
180625100100000,SW 422,Residential,411500,0,411500,0,0,411500
180632600200000,SW 422,Residential,200000,0,200000,0,0,200000
180635100200000,SW 422,Residential,15000,0,15000,0,0,15000
180715100200000,SW 448,Residential,943,0,943,0,0,943
180715200100000,SW 448,Residential,834,0,834,0,0,834
180715200200000,SW 448,Residential,758,0,758,0,0,758
180715200300000,SW 448,Residential,1410,0,1410,0,0,1410
180715200400000,SW 448,Residential,1046,0,1046,0,0,1046
180715200500000,SW 448,Residential,1165,0,1165,0,0,1165
180715200600000,SW 448,Residential,916,0,916,0,0,916
180715200700000,SW 448,Residential,987,0,987,0,0,987
180715200800000,SW 448,Residential,1682,0,1682,0,0,1682
180715200900000,SW 448,Residential,1494,0,1494,0,0,1494
180715201000000,SW 448,Residential,1251,0,1251,0,0,1251
180715201100000,SW 448,Residential,1450,0,1450,0,0,1450
180715201200000,SW 448,Residential,1045,0,1045,0,0,1045
180720100900000,SW 448,Residential,979,0,979,0,0,979
180720101000000,SW 448,Residential,974,0,974,0,0,974
180720101100000,SW 448,Residential,2079,0,2079,0,0,2079
180720101200000,SW 448,Residential,1092,0,1092,0,0,1092
180720200100000,SW 448,Residential,983,0,983,0,0,983
180720200200000,SW 448,Residential,1104,0,1104,0,0,1104
180727700100000,SW 448,Residential,1205,0,1205,0,0,1205
180727700200000,SW 448,Residential,1278,0,1278,0,0,1278
180727700300000,SW 448,Residential,1079,0,1079,0,0,1079
180727700400000,SW 448,Residential,1628,0,1628,0,0,1628
180727700500000,SW 448,Residential,1501,0,1501,0,0,1501
180727700600000,SW 448,Residential,1305,0,1305,0,0,1305
180727700700000,SW 448,Residential,1147,0,1147,0,0,1147
180727700800000,SW 448,Residential,924,0,924,0,0,924
180727800100000,SW 448,Residential,160387,0,160387,710104,0,870491
180727800200000,SW 448,Residential,128410,0,128410,859028,0,987438
180727800300000,SW 448,Residential,132100,0,132100,835733,0,967833
180727900100000,SW 448,Residential,1075,0,1075,0,0,1075
190110100100000,VACANT LAND,Commercial,0,378000,378000,0,0,378000
190115100100000,VACANT LAND,Commercial,0,702000,702000,0,0,702000
190117600100000,SW 422,Residential,400000,0,400000,0,0,400000
190140100100000,SW 422,Residential,400000,0,400000,0,0,400000
190142600100000,SW 422,Residential,400000,0,400000,0,0,400000
190145100100000,SW 422,Residential,400000,0,400000,0,0,400000
190147600100000,SW 422,Residential,400000,0,400000,0,0,400000
190210100100000,CITY PROPERTY,Exempt,0,0,0,0,0,0
190210100300000,SW 422,Ag Land,34325,0,34325,0,0,34325
190212600100000,CITY PROPERTY,Exempt,0,0,0,0,0,0
190215100100000,CITY PROPERTY,Exempt,0,0,0,0,0,0
190215200100000,SW 422,Residential,38325,0,38325,152258,0,190583
190215200200000,SW 422,Ag Land,2793,0,2793,0,0,2793
190215200400000,SW 422,Ag Land,6551,0,6551,0,0,6551
190217600100000,CITY PROPERTY,Exempt,0,0,0,0,0,0
190217700100000,SW 422,Residential,21900,0,21900,0,0,21900
190217700200000,SW 422,Residential,4885,0,4885,8191,0,13076
190217700300000,SW 422,Residential,9200,0,9200,0,0,9200
190217800100000,SW 422,Residential,60250,0,60250,135317,0,195567
190217800300000,SW 422,Residential,77300,0,77300,122493,0,199793
190220100100000,CITY PROPERTY,Exempt,0,0,0,0,0,0
190220200100000,CENTRALLY ASSESSED,Other,0,0,0,0,0,0
190222600100000,CITY PROPERTY,Exempt,0,0,0,0,0,0
190222700100000,SHOP,Commercial,0,42865,42865,0,74125,116990
190222700200000,SW 422,Residential,25070,0,25070,103622,0,128692
190222800100000,CENTRALLY ASSESSED,Other,0,0,0,0,0,0
190225100100000,CENTRALLY ASSESSED,Other,0,0,0,0,0,0
190225100200000,CENTRALLY ASSESSED,Exempt,0,0,0,0,0,0
190225200100000,VACANT LAND,Commercial,0,167400,167400,0,0,167400
190225200200000,CENTRALLY ASSESSED,Exempt,0,0,0,0,0,0
190225300100000,SW 422,Residential,39562,0,39562,159918,0,199480
190225300200000,SW 422,Residential,47437,0,47437,25241,0,72678
190225300300000,ANTENNAS/TOWERS(BLL),Commercial,0,151308,151308,0,301612,452920
190225400100000,CENTRALLY ASSESSED,Exempt,0,0,0,0,0,0
190225400200000,CENTRALLY ASSESSED,Exempt,0,0,0,0,0,0
190227600100000,CENTRALLY ASSESSED,Exempt,0,0,0,0,0,0
190227600200000,CITY PROPERTY,Exempt,0,0,0,0,0,0
190227700100000,SHOP,Commercial,0,120636,120636,0,254809,375445
190227700200000,SW 422,Residential,86250,0,86250,0,0,86250
190227700300000,SHOP,Residential,59900,0,59900,0,0,59900
190227700600000,SHOP,Commercial,0,40759,40759,0,153090,193849
190227700800000,BARS/LOUNGE,Commercial,0,25272,25272,0,47698,72970
190227700900000,VACANT LAND,Commercial,0,59616,59616,0,0,59616
190227701000000,SHOP,Commercial,0,68256,68256,0,71591,139847
190230100100000,SW 422,Ag Land,4339,0,4339,0,0,4339
190230100200000,SW 422,Ag Land,53952,0,53952,0,0,53952
190232600100000,SW 422,Residential,53850,0,53850,88785,0,142635
190232600200000,CEMETERY,Exempt,0,104976,104976,0,448,105424
190232700100000,SW 422,Ag Land,14553,0,14553,0,0,14553
190232800100000,VACANT LAND,Commercial,0,190323,190323,0,0,190323
190232800200000,VACANT LAND,Commercial,0,180684,180684,0,0,180684
190235100100000,SW 422,Residential,40120,0,40120,100777,0,140897
190235200100000,SW 422,Ag Land,1045,0,1045,0,0,1045
190235300100000,VACANT LAND,Commercial,0,7387,7387,0,0,7387
190235300200000,EQUIPMENT MFG;INDUST,Industrial,0,348274,348274,0,4448667,4796941
190235300300000,VACANT LAND,Commercial,0,91714,91714,0,0,91714
190235300400000,MISCELLANEOUS,Commercial,0,22993,22993,0,14230,37223
190237600100000,SW 422,Residential,50000,0,50000,122331,0,172331
190237600200000,SW 422,Ag Dwelling,28732,0,28732,149441,15203,193376
190237600300000,SW 422,Residential,51570,0,51570,98842,0,150412
190237600400000,SW 422,Residential,29760,0,29760,128883,0,158643
190237600500000,SW 422,Residential,51093,0,51093,136332,0,187425
190237600600000,SW 422,Residential,28340,0,28340,63190,0,91530
190237600700000,SW 422,Residential,12700,0,12700,0,0,12700
190237600800000,SW 422,Residential,69000,0,69000,79163,0,148163
190240100100000,SW 422,Residential,70000,0,70000,0,0,70000
190240100300000,SW 422,Ag Land,25935,0,25935,0,0,25935
190242600200000,SW 422,Residential,71650,0,71650,55687,0,127337
190242600300000,SW 422,Ag Dwelling,42743,0,42743,21116,346,64205
190245100100000,SW 422,Ag Land,50679,0,50679,0,0,50679
190245100200000,SW 422,Residential,11400,0,11400,0,0,11400
190247600100000,SW 422,Ag Land,42582,0,42582,0,2611,45193
190247600200000,SW 422,Residential,50750,0,50750,127315,0,178065
190310100100000,CITY PROPERTY,Exempt,0,0,0,0,0,0
190310100200000,CENTRALLY ASSESSED,Exempt,0,0,0,0,0,0
190315100100000,VACANT LAND,Industrial,0,129600,129600,0,0,129600
190317600100000,CENTRALLY ASSESSED,Other,0,0,0,0,0,0
190317600200000,CENTRALLY ASSESSED,Other,0,0,0,0,0,0
190317600300000,VACANT LAND,Commercial,0,342576,342576,0,0,342576
190317600400000,VACANT LAND,Industrial,0,193752,193752,0,0,193752
190320100100000,CITY PROPERTY,Exempt,0,0,0,0,0,0
190322600300000,SW 415,Residential,40579,0,40579,87188,0,127767
190322600400000,SW 415,Residential,23497,0,23497,86982,0,110479
190322600500000,SW 415,Residential,25026,0,25026,94407,0,119433
190322600600000,SW 415,Residential,21632,0,21632,95316,0,116948
190322600700000,SW 415,Residential,21857,0,21857,104179,0,126036
190322600800000,VACANT LAND,Commercial,0,10368,10368,0,0,10368
190322600900000,SW 415,Residential,22484,0,22484,104698,0,127182
190322601000000,SW 415,Residential,29067,0,29067,129738,0,158805
190322601100000,SW 415,Residential,24186,0,24186,85189,0,109375
190322601200000,SW 415,Residential,21420,0,21420,87925,0,109345
190322601300000,SW 415,Residential,22315,0,22315,92731,0,115046
190322601400000,SW 415,Residential,19877,0,19877,113652,0,133529
190322601500000,SW 415,Residential,21210,0,21210,108833,0,130043
190322601600000,SW 415,Residential,21210,0,21210,94712,0,115922
190322601700000,SW 415,Residential,21210,0,21210,100731,0,121941
190322601800000,SW 415,Residential,30300,0,30300,115847,0,146147
190322601900000,SW 415,Residential,30300,0,30300,109656,0,139956
190322602000000,SW 415,Residential,31499,0,31499,100497,0,131996
190322602100000,SW 415,Residential,31569,0,31569,106118,0,137687
190322700100000,SW 415,Residential,21000,0,21000,95444,0,116444
190322700200000,SW 415,Residential,21000,0,21000,95137,0,116137
190322700300000,SW 415,Residential,21280,0,21280,108248,0,129528
190322700400000,SW 415,Residential,24198,0,24198,116199,0,140397
190322700500000,SW 415,Residential,20591,0,20591,149376,0,169967
190322700600000,SW 415,Residential,21877,0,21877,142925,0,164802
190322700700000,SW 415,Residential,22274,0,22274,120743,0,143017
190322700800000,SW 415,Residential,21552,0,21552,114835,0,136387
190322700900000,SW 415,Residential,5478,0,5478,0,0,5478
190322701000000,SW 415,Residential,26081,0,26081,99891,0,125972
190322701100000,SW 415,Residential,28977,0,28977,83699,0,112676
190322701200000,SW 415,Residential,29400,0,29400,117214,0,146614
190322701300000,SW 415,Residential,24412,0,24412,91199,0,115611
190322701400000,SW 415,Residential,22807,0,22807,89683,0,112490
190322701500000,SW 415,Residential,21630,0,21630,103171,0,124801
190322701600000,SW 415,Residential,19828,0,19828,99447,0,119275
190322701700000,SW 415,Residential,19828,0,19828,103090,0,122918
190322701800000,SW 415,Residential,19828,0,19828,113356,0,133184
190322701900000,SW 415,Residential,21294,0,21294,103465,0,124759
190322800100000,SW 415,Residential,21540,0,21540,97524,0,119064
190322800200000,SW 415,Residential,21011,0,21011,95272,0,116283
190322800300000,SW 415,Residential,22050,0,22050,100951,0,123001
190322800400000,SW 415,Residential,22050,0,22050,104584,0,126634
190322800500000,SW 415,Residential,22743,0,22743,125120,0,147863
190322800600000,SW 415,Residential,21479,0,21479,104386,0,125865
190322800700000,SW 415,Residential,22491,0,22491,105400,0,127891
190322800800000,SW 415,Residential,22491,0,22491,109539,0,132030
190325100100000,SW 415,Residential,36585,0,36585,146999,0,183584
190325100200000,SW 415,Residential,30608,0,30608,117477,0,148085
190325100300000,SW 415,Residential,31184,0,31184,112884,0,144068
190325100400000,SW 415,Residential,30000,0,30000,101395,0,131395
190325100500000,SW 415,Residential,30198,0,30198,114383,0,144581
190325100600000,SW 415,Residential,21387,0,21387,101678,0,123065
190325100700000,SW 415,Residential,30624,0,30624,111447,0,142071
190327600100000,CITY PROPERTY,Exempt,0,0,0,0,0,0
190327600200000,CEMETERY,Other,0,0,0,0,0,0
190327600300000,CENTRALLY ASSESSED,Other,0,0,0,0,0,0
190327600400000,CITY PROPERTY,Exempt,0,0,0,0,0,0
190327600500000,CENTRALLY ASSESSED,Other,0,0,0,0,0,0
190330100100000,MFG HOME PARK,Commercial,0,182974,182974,0,112694,295668
190330100200000,CENTRALLY ASSESSED,Other,0,0,0,0,0,0
190330100300000,WAREHOUSE,Commercial,0,192240,192240,0,295006,487246
190330100400000,VACANT LAND,Commercial,0,324,324,0,0,324
190330100500000,CENTRALLY ASSESSED,Other,0,0,0,0,0,0
190330200100000,SW 422,Residential,17650,0,17650,0,0,17650
190330200200000,CENTRALLY ASSESSED,Other,0,0,0,0,0,0
190332600100000,SW 422,Residential,40250,0,40250,0,0,40250
190332600200000,CENTRALLY ASSESSED,Other,0,0,0,0,0,0
190332600300000,CITY PROPERTY,Exempt,0,0,0,0,0,0
190332600400000,SW 422,Residential,30057,0,30057,0,0,30057
190332600500000,CENTRALLY ASSESSED,Other,0,0,0,0,0,0
190332700100000,SHOP,Commercial,0,208818,208818,0,107179,315997
190332700200000,FLAT PARKING,Commercial,0,53406,53406,0,31500,84906
190332700300000,SHOP,Commercial,0,112320,112320,0,224068,336388
190332700400000,VETERINARY CLINIC,Commercial,0,110044,110044,0,338183,448227
190332700500000,CONVENIENCE STORE,Commercial,0,68504,68504,0,196270,264774
190332700600000,WAREHOUSE,Commercial,0,84037,84037,0,116947,200984
190335100100000,FLAT PARKING,Commercial,0,343980,343980,0,31740,375720
190335100200000,EQUIPMENT MFG;INDUST,Industrial,0,1393416,1393416,0,3999670,5393086
190337600200000,SHOP,Industrial,0,496800,496800,0,2683200,3180000
190337600300000,SHOP,Industrial,0,270972,270972,0,1603624,1874596
190337600400000,WAREHOUSE,Commercial,0,152064,152064,0,929764,1081828
190337600500000,CARWASH,Commercial,0,228312,228312,0,584131,812443
190337600600000,SHOP,Commercial,0,156384,156384,0,433019,589403
190337600700000,FLAT PARKING,Commercial,0,12312,12312,0,9530,21842
190337601000000,WAREHOUSE,Commercial,0,243648,243648,0,1238582,1482230
190340100100000,FOOD GRADE;INDUST,Industrial,0,711774,711774,0,9159848,9871622
190342600100000,VACANT LAND,Industrial,0,315414,315414,0,0,315414
190345100200000,WAREHOUSE,Commercial,0,628506,628506,0,7356575,7985081
190345100300000,FOOD GRADE;INDUST,Industrial,0,783475,783475,0,10435211,11218686
190347600200000,OFFICE,Commercial,0,375786,375786,0,1017514,1393300
190347600300000,OFFICE,Commercial,0,432216,432216,0,1500288,1932504
190410100100000,SW 428,Residential,28980,0,28980,164224,0,193204
190410100200000,SW 428,Residential,31968,0,31968,49773,0,81741
190410100300000,SW 428,Residential,31166,0,31166,105410,0,136576
190410100400000,SW 428,Residential,31036,0,31036,128236,0,159272
190410100500000,SW 428,Residential,24935,0,24935,48929,0,73864
190410100600000,SW 428,Residential,26640,0,26640,105040,0,131680
190410100700000,SW 428,Residential,26640,0,26640,117538,0,144178
190410100800000,SW 428,Residential,27501,0,27501,118854,0,146355
190410100900000,SW 428,Residential,33300,0,33300,105569,0,138869
190410101000000,SW 428,Residential,33300,0,33300,89771,0,123071
190410101100000,SW 428,Residential,33300,0,33300,127362,0,160662
190410101200000,SW 428,Residential,33300,0,33300,178775,0,212075
190410101300000,SW 428,Residential,33300,0,33300,95874,0,129174
190410101400000,SW 428,Residential,33300,0,33300,113215,0,146515
190410101500000,SW 428,Residential,33300,0,33300,48701,0,82001
190410101600000,SW 428,Residential,33300,0,33300,56583,0,89883
190410101700000,SW 428,Residential,30355,0,30355,90811,0,121166
190410101800000,SW 428,Residential,27989,0,27989,60462,0,88451
190410101900000,SW 428,Residential,24696,0,24696,71118,0,95814
190410102000000,SW 428,Residential,21340,0,21340,127134,0,148474
190410102100000,SW 428,Residential,23251,0,23251,111281,0,134532
190410102200000,SW 428,Residential,28350,0,28350,73050,0,101400
190410102300000,SW 428,Residential,28350,0,28350,91682,0,120032
190410102400000,SW 428,Residential,28350,0,28350,82249,0,110599
190410102500000,SW 428,Residential,27825,0,27825,78268,0,106093
190410102600000,SW 428,Residential,27825,0,27825,92057,0,119882
190410102700000,SW 428,Residential,27825,0,27825,134092,0,161917
190410102800000,SW 428,Residential,28612,0,28612,53334,0,81946
190410102900000,SW 428,Residential,25752,0,25752,103988,0,129740
190410103000000,SW 428,Residential,24798,0,24798,90923,0,115721
190410103100000,SW 428,Residential,24500,0,24500,84752,0,109252
190410103200000,SW 428,Residential,26001,0,26001,0,0,26001
190410200100000,SW 428,Residential,25819,0,25819,51290,0,77109
190410200200000,SW 428,Residential,25819,0,25819,77120,0,102939
190410200300000,SW 428,Residential,34965,0,34965,50893,0,85858
190410200400000,SW 428,Residential,34965,0,34965,104714,0,139679
190410200500000,SW 428,Residential,30600,0,30600,39630,0,70230
190410200600000,SW 428,Residential,32640,0,32640,68210,0,100850
190410200700000,SW 428,Residential,33300,0,33300,90377,0,123677
190410200800000,SW 428,Residential,33300,0,33300,66472,0,99772
190410200900000,SW 428,Residential,33744,0,33744,83807,0,117551
190410201000000,SW 428,Residential,26640,0,26640,109734,0,136374
190410201100000,SW 428,Residential,24420,0,24420,90634,0,115054
190410201200000,SW 428,Residential,31968,0,31968,98763,0,130731
190410201300000,SW 428,Residential,33300,0,33300,95092,0,128392
190410201400000,SW 428,Residential,33300,0,33300,75635,0,108935
190410201500000,SW 428,Residential,22200,0,22200,89098,0,111298
190410201600000,SW 428,Residential,22200,0,22200,54408,0,76608
190410201700000,SW 428,Residential,50780,0,50780,32408,0,83188
190410201800000,SW 428,Residential,21840,0,21840,99477,0,121317
190410201900000,SW 428,Residential,21840,0,21840,0,0,21840
190410202000000,SW 428,Residential,27273,0,27273,96559,0,123832
190410202100000,SW 428,Residential,29070,0,29070,121416,0,150486
190410202200000,SW 428,Residential,26640,0,26640,114830,0,141470
190410202300000,SW 428,Residential,34632,0,34632,101508,0,136140
190410202400000,SW 428,Residential,27972,0,27972,96742,0,124714
190410202500000,SW 428,Residential,33300,0,33300,100905,0,134205
190410202600000,SW 428,Residential,33300,0,33300,58121,0,91421
190410202700000,SW 428,Residential,33300,0,33300,93123,0,126423
190410202800000,SW 428,Residential,33300,0,33300,78891,0,112191
190410202900000,SW 428,Residential,33300,0,33300,88629,0,121929
190410203000000,SW 428,Residential,33300,0,33300,72693,0,105993
190410203100000,SW 428,Residential,23152,0,23152,79566,0,102718
190410203200000,SW 428,Residential,23280,0,23280,103900,0,127180
190410300100000,SW 428,Residential,31280,0,31280,70030,0,101310
190410300200000,SW 428,Residential,33300,0,33300,91196,0,124496
190410300300000,SW 428,Residential,33300,0,33300,104098,0,137398
190410300400000,SW 428,Residential,18200,0,18200,77507,0,95707
190410300500000,SW 428,Residential,17325,0,17325,90439,0,107764
190410300600000,SW 415,Residential,23310,0,23310,95174,0,118484
190410300700000,SW 415,Residential,23380,0,23380,111387,0,134767
190410300800000,SW 428,Residential,32760,0,32760,131592,0,164352
190410300900000,SW 415,Residential,18550,0,18550,117030,0,135580
190410301000000,SW 415,Residential,18550,0,18550,69603,0,88153
190410301100000,SW 428,Residential,29274,0,29274,0,0,29274
190410301200000,SW 428,Residential,30462,0,30462,60524,0,90986
190410301300000,SW 428,Residential,28800,0,28800,105683,0,134483
190410301400000,SW 415,Residential,19250,0,19250,79387,0,98637
190410301500000,SW 428,Residential,29646,0,29646,90559,0,120205
190410301600000,SW 428,Residential,22200,0,22200,124261,0,146461
190410301700000,SW 428,Residential,22200,0,22200,85449,0,107649
190410301800000,SW 428,Residential,33300,0,33300,53785,0,87085
190410301900000,SW 428,Residential,33300,0,33300,82641,0,115941
190410302000000,SW 428,Residential,22200,0,22200,97864,0,120064
190410302100000,SW 428,Residential,22200,0,22200,94699,0,116899
190410302200000,SW 428,Residential,28900,0,28900,82152,0,111052
190410400100000,SW 415,Residential,23252,0,23252,103234,0,126486
190410500100000,SW 415,Residential,28170,0,28170,114710,0,142880
190410500200000,SW 415,Residential,31185,0,31185,111677,0,142862
190410500300000,SW 415,Residential,23651,0,23651,93509,0,117160
190410500400000,SW 415,Residential,22400,0,22400,92400,0,114800
190410500500000,SW 415,Residential,22400,0,22400,93878,0,116278
190410500600000,SW 415,Residential,22400,0,22400,104365,0,126765
190412600100000,SW 416,Residential,23664,0,23664,110664,0,134328
190412600200000,SW 416,Residential,23664,0,23664,112723,0,136387
190412600300000,SW 416,Residential,20184,0,20184,93972,0,114156
190412600400000,SW 416,Residential,18919,0,18919,102318,0,121237
190412600500000,SW 416,Residential,17942,0,17942,116069,0,134011
190412600600000,SW 416,Residential,24521,0,24521,65877,0,90398
190412600700000,SW 428,Residential,30975,0,30975,118560,0,149535
190412600800000,SW 428,Residential,30187,0,30187,70289,0,100476
190412600900000,SW 428,Residential,28875,0,28875,111390,0,140265
190412700100000,SW 416,Residential,20532,0,20532,83309,0,103841
190412700200000,SW 416,Residential,20880,0,20880,72228,0,93108
190412700300000,SW 416,Residential,25440,0,25440,85921,0,111361
190412700400000,SW 416,Residential,25680,0,25680,80205,0,105885
190412700500000,DAY CARE CENTER,Commercial,0,100359,100359,0,343636,443995
190412700600000,SW 415,Residential,36044,0,36044,157897,0,193941
190412700700000,SW 415,Residential,30978,0,30978,172732,0,203710
190412700800000,SW 415,Residential,27961,0,27961,109414,0,137375
190412700900000,SW 415,Residential,24515,0,24515,103038,0,127553
190412701000000,SW 415,Residential,25549,0,25549,90900,0,116449
190412701100000,SW 415,Residential,25235,0,25235,101497,0,126732
190412701200000,SW 415,Residential,24115,0,24115,101527,0,125642
190412701300000,SW 415,Residential,24115,0,24115,107729,0,131844
190412701400000,SW 415,Residential,24634,0,24634,112920,0,137554
190412701500000,SW 415,Residential,24882,0,24882,127626,0,152508
190412701600000,SW 415,Residential,24783,0,24783,93377,0,118160
190412701700000,SW 415,Residential,25463,0,25463,99815,0,125278
190412701800000,SW 415,Residential,24514,0,24514,87629,0,112143
190412701900000,SW 415,Residential,25127,0,25127,93984,0,119111
190412702000000,SW 428,Residential,26894,0,26894,76682,0,103576
190412702100000,SW 428,Residential,54800,0,54800,74286,0,129086
190412702200000,SW 428,Residential,25466,0,25466,89765,0,115231
190412702300000,SW 428,Residential,27058,0,27058,107608,0,134666
190412702400000,SW 416,Residential,25163,0,25163,100132,0,125295
190412702500000,SW 416,Residential,20715,0,20715,71226,0,91941
190412800300000,SW 416,Residential,24720,0,24720,130027,0,154747
190412800400000,SW 416,Residential,24156,0,24156,80844,0,105000
190412800500000,SW 428,Residential,51850,0,51850,61155,0,113005
190412800600000,SW 428,Residential,25660,0,25660,84162,0,109822
190412800700000,SW 428,Residential,24439,0,24439,149941,0,174380
190412800800000,SW 428,Residential,57250,0,57250,98420,0,155670
190412800900000,SW 428,Residential,63950,0,63950,76622,0,140572
190412801000000,SW 415,Residential,25017,0,25017,100742,0,125759
190412801100000,SW 415,Residential,24765,0,24765,105298,0,130063
190412801200000,SW 415,Residential,23310,0,23310,98451,0,121761
190412801300000,SW 415,Residential,23660,0,23660,95862,0,119522
190412801400000,SW 415,Residential,24500,0,24500,92853,0,117353
190412801500000,SW 415,Residential,24500,0,24500,95810,0,120310
190412801600000,SW 415,Residential,24993,0,24993,110961,0,135954
190412801700000,SW 415,Residential,24538,0,24538,116022,0,140560
190412801800000,SW 415,Residential,25116,0,25116,94440,0,119556
190412802000000,SW 416,Residential,51215,0,51215,111669,0,162884
190412802100000,SW 416,Residential,36720,0,36720,125783,0,162503
190412900100000,SW 416,Residential,29019,0,29019,86588,0,115607
190412900200000,SW 416,Residential,25840,0,25840,128419,0,154259
190412900300000,SW 416,Residential,25048,0,25048,94876,0,119924
190412900400000,SW 416,Residential,24440,0,24440,83071,0,107511
190412900500000,SW 416,Residential,27741,0,27741,129708,0,157449
190412900600000,SW 428,Residential,19200,0,19200,64475,0,83675
190412900900000,SW 428,Residential,21042,0,21042,84240,0,105282
190412901000000,SW 428,Residential,20880,0,20880,75139,0,96019
190412901100000,SW 428,Residential,20640,0,20640,74854,0,95494
190412901200000,SW 428,Residential,20376,0,20376,89509,0,109885
190412901300000,SW 428,Residential,22003,0,22003,75483,0,97486
190412901400000,SW 428,Residential,20109,0,20109,79127,0,99236
190412901500000,SW 428,Residential,25216,0,25216,101920,0,127136
190412901600000,SW 428,Residential,31600,0,31600,125753,0,157353
190412901700000,SW 428,Residential,29359,0,29359,64878,0,94237
190412901800000,SW 428,Residential,12583,0,12583,0,0,12583
190412901900000,SW 428,Residential,12854,0,12854,0,0,12854
190412902000000,SW 428,Residential,60200,0,60200,0,0,60200
190412902100000,SW 428,Residential,8620,0,8620,0,0,8620
190412902200000,SW 428,Residential,11224,0,11224,0,0,11224
190412902300000,SW 428,Residential,11224,0,11224,0,0,11224
190412902400000,SW 428,Residential,10577,0,10577,0,0,10577
190412902500000,SW 428,Residential,22611,0,22611,89269,0,111880
190412902600000,SW 428,Residential,26837,0,26837,44972,0,71809
190412902700000,SW 428,Residential,19307,0,19307,88729,0,108036
190412902800000,SW 428,Residential,20025,0,20025,67225,0,87250
190412902900000,SW 428,Residential,25291,0,25291,84621,0,109912
190412903000000,SW 428,Residential,24937,0,24937,80292,0,105229
190412903100000,SW 428,Residential,24937,0,24937,80292,0,105229
190412903200000,SW 428,Residential,25505,0,25505,0,0,25505
190412903300000,CONVERSION,Commercial,0,23328,23328,0,102121,125449
190412903400000,SW 428,Residential,32384,0,32384,80240,0,112624
190413000100000,SW 415,Residential,22575,0,22575,100643,0,123218
190413000200000,SW 415,Residential,22575,0,22575,93265,0,115840
190413000300000,SW 415,Residential,22983,0,22983,89310,0,112293
190413000400000,SW 415,Residential,25470,0,25470,113685,0,139155
190413000500000,SW 415,Residential,25024,0,25024,130821,0,155845
190413000600000,SW 415,Residential,21840,0,21840,98947,0,120787
190413000700000,SW 415,Residential,21840,0,21840,108609,0,130449
190413000800000,SW 415,Residential,23797,0,23797,93514,0,117311
190413000900000,SW 415,Residential,25349,0,25349,103107,0,128456
190413100100000,SW 415,Residential,24497,0,24497,50146,0,74643
190413100200000,SW 415,Residential,22400,0,22400,94218,0,116618
190413100300000,SW 415,Residential,22400,0,22400,114269,0,136669
190413100400000,SW 415,Residential,22400,0,22400,96728,0,119128
190413100500000,SW 415,Residential,22400,0,22400,109159,0,131559
190413100600000,SW 415,Residential,22400,0,22400,92772,0,115172
190413100700000,SW 415,Residential,22050,0,22050,101464,0,123514
190413100800000,SW 415,Residential,22400,0,22400,123151,0,145551
190413100900000,SW 415,Residential,23450,0,23450,100368,0,123818
190413101000000,SW 415,Residential,23450,0,23450,111263,0,134713
190413101100000,SW 415,Residential,23450,0,23450,102735,0,126185
190413101200000,SW 415,Residential,23450,0,23450,98681,0,122131
190413101300000,SW 415,Residential,23450,0,23450,95333,0,118783
190413101400000,SW 415,Residential,31001,0,31001,108283,0,139284
190413101500000,SW 415,Residential,28077,0,28077,94000,0,122077
190413101600000,SW 415,Residential,22050,0,22050,96491,0,118541
190413101700000,SW 415,Residential,22050,0,22050,96465,0,118515
190413101800000,SW 415,Residential,22400,0,22400,95723,0,118123
190413101900000,SW 415,Residential,22400,0,22400,99706,0,122106
190413102000000,SW 415,Residential,22400,0,22400,94859,0,117259
190413102100000,SW 415,Residential,22400,0,22400,89335,0,111735
190413102200000,SW 415,Residential,22400,0,22400,96197,0,118597
190413102300000,SW 415,Residential,22400,0,22400,93108,0,115508
190413102400000,SW 415,Residential,22400,0,22400,90209,0,112609
190413102500000,SW 415,Residential,22400,0,22400,89964,0,112364
190413102600000,SW 415,Residential,22400,0,22400,105203,0,127603
190413102700000,SW 415,Residential,22400,0,22400,102103,0,124503
190413102800000,SW 415,Residential,22400,0,22400,97813,0,120213
190413102900000,SW 415,Residential,22400,0,22400,94183,0,116583
190415100100000,SW 428,Residential,30712,0,30712,130229,0,160941
190415100200000,SW 428,Residential,30712,0,30712,93266,0,123978
190415100300000,SW 428,Residential,30712,0,30712,98862,0,129574
190415100400000,SW 428,Residential,30712,0,30712,69309,0,100021
190415100500000,SW 415,Residential,24671,0,24671,92741,0,117412
190415100600000,SW 415,Residential,24671,0,24671,103537,0,128208
190415100700000,SW 415,Residential,24671,0,24671,91800,0,116471
190415100800000,SW 415,Residential,25235,0,25235,100779,0,126014
190415100900000,SW 415,Residential,24935,0,24935,103026,0,127961
190415101000000,SW 415,Residential,23930,0,23930,96865,0,120795
190415101100000,SW 415,Residential,23930,0,23930,81846,0,105776
190415101200000,SW 415,Residential,23930,0,23930,87986,0,111916
190415101300000,SW 415,Residential,23252,0,23252,94077,0,117329
190415101400000,SW 415,Residential,32083,0,32083,81032,0,113115
190415101500000,SW 428,Residential,45150,0,45150,128017,0,173167
190415101600000,SW 428,Residential,44100,0,44100,63054,0,107154
190415101700000,SW 428,Residential,22295,0,22295,111649,0,133944
190415101800000,SW 428,Residential,24360,0,24360,130106,0,154466
190415101900000,SW 428,Residential,42040,0,42040,0,0,42040
190415200100000,SW 415,Residential,24671,0,24671,88855,0,113526
190415200300000,VACANT LAND,Commercial,0,32805,32805,0,0,32805
190415200400000,CONVENIENCE STORE,Commercial,0,115992,115992,0,261569,377561
190415200500000,VACANT LAND,Commercial,0,40500,40500,0,0,40500
190415200600000,VACANT LAND,Commercial,0,40500,40500,0,0,40500
190415200700000,WAREHOUSE,Commercial,0,67262,67262,0,405057,472319
190415200800000,VACANT LAND,Commercial,0,2311,2311,0,0,2311
190415201000000,WAREHOUSE,Commercial,0,54000,54000,0,156712,210712
190415201100000,WAREHOUSE,Commercial,0,68364,68364,0,214081,282445
190415201200000,CENTRALLY ASSESSED,Other,0,0,0,0,0,0
190415201300000,SR/NURSING/ASSTD LIV,Commercial,0,181440,181440,0,1935488,2116928
190415201400000,SW 415,Residential,20429,0,20429,89283,0,109712
190415201500000,SW 415,Residential,20426,0,20426,70081,0,90507
190415201600000,SW 415,Residential,18886,0,18886,49308,0,68194
190415201700000,SW 415,Residential,25011,0,25011,87293,0,112304
190415201800000,SW 415,Residential,25024,0,25024,97487,0,122511
190415201900000,SW 415,Residential,25024,0,25024,99726,0,124750
190415202000000,SW 415,Residential,25024,0,25024,111437,0,136461
190415202100000,SW 415,Residential,25024,0,25024,96858,0,121882
190415202200000,SW 415,Residential,24560,0,24560,101817,0,126377
190415202300000,SW 415,Residential,24671,0,24671,98930,0,123601
190415202400000,SW 415,Residential,24671,0,24671,103118,0,127789
190415300100000,SW 428,Residential,33040,0,33040,67966,0,101006
190415300200000,SW 428,Residential,33040,0,33040,83418,0,116458
190415300300000,SW 428,Residential,33040,0,33040,94930,0,127970
190415300400000,SW 428,Residential,33040,0,33040,95704,0,128744
190415300500000,SW 428,Residential,33040,0,33040,109400,0,142440
190415300600000,SW 428,Residential,33040,0,33040,66568,0,99608
190415300700000,SW 428,Residential,15000,0,15000,0,0,15000
190415300800000,SW 428,Residential,32645,0,32645,42355,0,75000
190415300900000,SW 428,Residential,33040,0,33040,85805,0,118845
190415301000000,SW 428,Residential,33040,0,33040,84982,0,118022
190415301100000,SW 428,Residential,26019,0,26019,5058,0,31077
190415301200000,SHOP,Commercial,0,76896,76896,0,177846,254742
190415301300000,SHOP,Commercial,0,66636,66636,0,162918,229554
190417600100000,SW 428,Residential,22563,0,22563,68218,0,90781
190417600200000,SW 428,Residential,17640,0,17640,98658,0,116298
190417600300000,SW 428,Residential,17850,0,17850,83357,0,101207
190417600400000,SW 428,Residential,18883,0,18883,79334,0,98217
190417600500000,SW 428,Residential,24756,0,24756,60033,0,84789
190417600600000,SW 428,Residential,29970,0,29970,101349,0,131319
190417600700000,SW 428,Residential,30510,0,30510,91210,0,121720
190417600800000,SW 428,Residential,30780,0,30780,52537,0,83317
190417600900000,SW 428,Residential,18038,0,18038,114260,0,132298
190417601000000,SW 428,Residential,21000,0,21000,51759,0,72759
190417601100000,SW 428,Residential,24651,0,24651,102533,0,127184
190417601200000,SW 428,Residential,29401,0,29401,65987,0,95388
190417601300000,SW 428,Residential,19775,0,19775,81180,0,100955
190417601400000,SW 428,Residential,19775,0,19775,64655,0,84430
190417601500000,SW 428,Residential,19775,0,19775,87170,0,106945
190417601600000,SW 428,Residential,19775,0,19775,79317,0,99092
190417700100000,SW 428,Residential,27005,0,27005,126952,0,153957
190417700200000,SW 428,Residential,30712,0,30712,206172,0,236884
190417700300000,SW 428,Residential,30712,0,30712,82982,0,113694
190417700400000,SW 415,Residential,18550,0,18550,87373,0,105923
190417700500000,SW 415,Residential,27133,0,27133,13595,0,40728
190417700600000,SW 415,Residential,27132,0,27132,0,0,27132
190417700700000,SW 415,Residential,24947,0,24947,106838,0,131785
190417700800000,SW 415,Residential,18550,0,18550,98400,0,116950
190417700900000,SW 415,Residential,18550,0,18550,106860,0,125410
190417701000000,SW 415,Residential,18900,0,18900,94651,0,113551
190417701100000,SW 415,Residential,18900,0,18900,110041,0,128941
190417701200000,SW 428,Residential,1605,0,1605,0,0,1605
190417701300000,SW 428,Residential,1605,0,1605,0,0,1605
190417701400000,SW 428,Residential,24120,0,24120,153922,0,178042
190417701500000,SW 428,Residential,41580,0,41580,45473,0,87053
190417701600000,SW 428,Residential,39567,0,39567,67755,0,107322
190417701700000,SW 428,Residential,54600,0,54600,75068,0,129668
190417701800000,SW 428,Residential,36540,0,36540,80011,0,116551
190417701900000,SW 428,Residential,34212,0,34212,67562,0,101774
190417702000000,SW 428,Residential,19125,0,19125,99889,0,119014
190417702100000,SW 428,Residential,26400,0,26400,100520,0,126920
190417800100000,SW 428,Residential,32522,0,32522,132104,0,164626
190417800200000,SW 428,Residential,30975,0,30975,98578,0,129553
190417800300000,SW 428,Residential,20650,0,20650,62796,0,83446
190417800400000,SW 428,Residential,20650,0,20650,66525,0,87175
190417800500000,SW 428,Residential,20650,0,20650,75865,0,96515
190417800600000,SR/NURSING/ASSTD LIV,Commercial,0,56700,56700,0,280051,336751
190417800700000,SW 428,Residential,29736,0,29736,81751,0,111487
190417800800000,SW 428,Residential,34692,0,34692,105491,0,140183
190417800900000,SW 428,Residential,33040,0,33040,132912,0,165952
190417801000000,SW 428,Residential,33040,0,33040,75848,0,108888
190417801100000,SW 428,Residential,28084,0,28084,80794,0,108878
190417801200000,SW 428,Residential,34692,0,34692,74315,0,109007
190417801300000,SW 428,Residential,30975,0,30975,72639,0,103614
190417801400000,SW 428,Residential,33040,0,33040,88096,0,121136
190417900100000,COUNTY PROPERTY,Exempt,0,0,0,0,0,0
190417900200000,CITY PROPERTY,Exempt,0,0,0,0,0,0
190417900300000,VACANT LAND,Industrial,0,31104,31104,0,0,31104
190417900400000,CENTRALLY ASSESSED,Other,0,0,0,0,0,0
190420100100000,APARTMENT,Exempt,0,909900,909900,0,7855091,8764991
190420100200000,WAREHOUSE,Commercial,0,454831,454831,0,2493063,2947894
190422600100000,APARTMENT,Commercial,0,1179900,1179900,0,8670100,9850000
190422600200000,VACANT LAND,Commercial,0,56376,56376,0,0,56376
190422600300000,BOWLING ALLEY,Commercial,0,497880,497880,0,331408,829288
190422600400000,VACANT LAND,Commercial,0,296352,296352,0,0,296352
190422600500000,SMALL RETAIL,Commercial,0,244935,244935,0,303352,548287
190422600600000,FAST FOOD,Commercial,0,91706,91706,0,289936,381642
190422600700000,FLAT PARKING,Commercial,0,74472,74472,0,5400,79872
190422600800000,OFFICE,Commercial,0,59396,59396,0,33992,93388
190422600900000,FRATERNAL,Commercial,0,133229,133229,0,228198,361427
190422601000000,HOTEL,Commercial,0,260820,260820,0,680024,940844
190422601100000,HOTEL,Commercial,0,553500,553500,0,1531979,2085479
190422601200000,CONVENIENCE STORE,Commercial,0,253109,253109,0,307065,560174
190422601300000,FAST FOOD,Commercial,0,365904,365904,0,503301,869205
190422700100000,HOTEL,Commercial,0,199530,199530,0,652501,852031
190422701400000,VACANT LAND,Commercial,0,1441,1441,0,0,1441
190425100100000,FAST FOOD,Commercial,0,372816,372816,0,322697,695513
190425100200000,FAST FOOD,Commercial,0,249696,249696,0,472413,722109
190425100300000,FLAT PARKING,Commercial,0,187920,187920,0,12354,200274
190425100400000,HOTEL,Commercial,0,616950,616950,0,1383050,2000000
190425100500000,HOTEL,Commercial,0,576450,576450,0,1204142,1780592
190425200100000,HOTEL,Commercial,0,274752,274752,0,977874,1252626
190425200200000,HOTEL,Commercial,0,330480,330480,0,733831,1064311
190425200300000,OFFICE,Commercial,0,285120,285120,0,406727,691847
190425200400000,HOTEL,Commercial,0,459961,459961,0,2453132,2913093
190425200500000,RESTAURANT,Commercial,0,291773,291773,0,774198,1065971
190425200600000,FAST FOOD,Commercial,0,419580,419580,0,468881,888461
190425200700000,BRANCH BANK/CU,Commercial,0,421718,421718,0,619730,1041448
190425200800000,VACANT LAND,Commercial,0,166730,166730,0,0,166730
190425200900000,RESTAURANT,Commercial,0,366120,366120,0,371914,738034
190425300100000,RESTAURANT,Commercial,0,434160,434160,0,481034,915194
190425300200000,HOTEL,Commercial,0,324000,324000,0,1976000,2300000
190425300300000,OFFICE,Commercial,0,560520,560520,0,927266,1487786
190425300400000,HOTEL,Commercial,0,774792,774792,0,3409710,4184502
190425300500000,FAST FOOD,Commercial,0,391608,391608,0,658004,1049612
190425300600000,WAREHOUSE;MINI STORG,Commercial,0,362988,362988,0,812105,1175093
190425300700000,OFFICE,Commercial,0,105751,105751,0,424199,529950
190425400600000,OFFICE,Commercial,0,117331,117331,0,385437,502768
190425400700000,OFFICE,Commercial,0,117331,117331,0,419629,536960
190425400800000,WAREHOUSE,Commercial,0,157950,157950,0,421523,579473
190427600100000,SHOP,Commercial,0,366336,366336,0,519556,885892
190427600200000,SHOP,Commercial,0,298944,298944,0,523734,822678
190427600300000,SHOP,Commercial,0,206669,206669,0,479007,685676
190427600400000,SMALL RETAIL,Commercial,0,53921,53921,0,121333,175254
190427600500000,SHOP,Commercial,0,54315,54315,0,370529,424844
190427600700000,WAREHOUSE,Commercial,0,158378,158378,0,689314,847692
190427600800000,AUTO REPAIR/SALES,Commercial,0,127367,127367,0,844818,972185
190427600900000,SHOP,Commercial,0,130118,130118,0,334975,465093
190427601000000,WAREHOUSE,Commercial,0,232848,232848,0,1098276,1331124
190427601100000,SMALL RETAIL,Commercial,0,97481,97481,0,241907,339388
190427601102000,BILLBOARD(BLL),Commercial,0,0,0,0,8737,8737
190427601200000,OFFICE,Commercial,0,76967,76967,0,441150,518117
190427601300000,SHOP,Commercial,0,82434,82434,0,244017,326451
190427601400000,SHOP,Commercial,0,98986,98986,0,428997,527983
190427601500000,FRATERNAL,Commercial,0,66960,66960,0,203134,270094
190427601600000,VACANT LAND,Commercial,0,36720,36720,0,0,36720
190430100100000,WAREHOUSE,Commercial,0,213570,213570,0,1553730,1767300
190430200100000,CONC/ASPH;INDUSTRIAL,Industrial,0,245862,245862,0,203026,448888
190430200102000,BILLBOARD(BLL),Commercial,0,0,0,0,43185,43185
190430200200000,SHOP,Commercial,0,88128,88128,0,157563,245691
190430200300000,FLAT PARKING,Commercial,0,22637,22637,0,2345,24982
190430200400000,SHOP,Commercial,0,71928,71928,0,278653,350581
190430200500000,VACANT LAND,Commercial,0,177336,177336,0,0,177336
190430200502000,BILLBOARD(BLL),Commercial,0,0,0,0,43185,43185
190430300102000,BILLBOARD(BLL),Commercial,0,0,0,0,44860,44860
190432600100000,WAREHOUSE,Commercial,0,246294,246294,0,1706004,1952298
190432600200000,FLAT PARKING,Commercial,0,92988,92988,0,52792,145780
190435100200000,WAREHOUSE,Commercial,0,139887,139887,0,143309,283196
190435100300000,WAREHOUSE,Commercial,0,974970,974970,0,28307040,29282010
190435200100000,AUTO REPAIR/SALES,Commercial,0,109432,109432,0,0,109432
190435200200000,STATE PROPERTY,Exempt,0,0,0,0,0,0
190435300100000,WAREHOUSE,Commercial,0,66355,66355,0,262547,328902
190435300200000,CENTRALLY ASSESSED,Other,0,0,0,0,0,0
190435300300000,COUNTY PROPERTY,Exempt,0,0,0,0,0,0
190435300400000,SCHOOL,Exempt,0,0,0,0,0,0
190435300500000,MISCELLANEOUS,Commercial,0,65664,65664,0,23630,89294
190437600100000,CENTRALLY ASSESSED,Other,0,0,0,0,0,0
190437600200000,CENTRALLY ASSESSED,Other,0,0,0,0,0,0
190437700100000,BILLBOARD(BLL),Commercial,0,27216,27216,0,45835,73051
190440100100000,CITY PROPERTY,Exempt,0,0,0,0,0,0
190440100200000,CITY PROPERTY,Exempt,0,0,0,0,0,0
190440100300000,CITY PROPERTY,Exempt,0,0,0,0,0,0
190440100400000,CENTRALLY ASSESSED,Other,0,0,0,0,0,0
190440200200000,DAY CARE CENTER,Exempt,0,420098,420098,0,2025453,2445551
190440200300000,SHOP,Commercial,0,124537,124537,0,73237,197774
190440200400000,SW 422,Residential,77250,0,77250,54660,0,131910
190442600100000,CONC/ASPH;INDUSTRIAL,Industrial,0,206874,206874,0,322694,529568
190442600200000,VACANT LAND,Industrial,0,273726,273726,0,0,273726
190442600300000,WAREHOUSE,Commercial,0,193450,193450,0,86889,280339
190442600400000,SHOP,Commercial,0,162702,162702,0,395810,558512
190442600500000,CITY PROPERTY,Exempt,0,0,0,0,0,0
190442600600000,CENTRALLY ASSESSED,Other,0,0,0,0,0,0
190445100100000,CENTRALLY ASSESSED,Other,0,0,0,0,0,0
190445100200000,CENTRALLY ASSESSED,Other,0,0,0,0,0,0
190445100300000,CITY PROPERTY,Exempt,0,0,0,0,0,0
190445100400000,SW 422,Residential,187150,0,187150,111422,0,298572
190447600100000,SMALL RETAIL,Commercial,0,137376,137376,0,100154,237530
190447600200000,SW 422,Residential,66400,0,66400,59487,0,125887
190447600300000,WAREHOUSE,Commercial,0,41298,41298,0,84233,125531
190447600400000,WAREHOUSE,Commercial,0,111456,111456,0,230034,341490
190447600500000,SW 422,Residential,29700,0,29700,0,0,29700
190447600600000,SW 422,Residential,23222,0,23222,0,0,23222
190447600700000,SW 422,Residential,23178,0,23178,0,0,23178
190447600800000,SW 422,Residential,42800,0,42800,61990,0,104790
190447700100000,FEED/ADDITIVE;INDUST,Industrial,0,279234,279234,0,1599902,1879136
190447700200000,WAREHOUSE,Commercial,0,202986,202986,0,325948,528934
190447700300000,CENTRALLY ASSESSED,Other,0,0,0,0,0,0
190447700400000,MFG HOME PARK,Commercial,0,331776,331776,0,420343,752119
190510100100000,WAREHOUSE,Commercial,0,199066,199066,0,233609,432675
190510100200000,VACANT LAND,Commercial,0,119232,119232,0,0,119232
190510100300000,WAREHOUSE,Commercial,0,246672,246672,0,360961,607633
190510100400000,AUTO REPAIR/SALES,Commercial,0,90720,90720,0,255911,346631
190510100500000,VACANT LAND,Commercial,0,25574,25574,0,0,25574
190510100600000,VACANT LAND,Commercial,0,117504,117504,0,0,117504
190510100700000,WAREHOUSE,Commercial,0,151200,151200,0,403352,554552
190510100800000,VACANT LAND,Commercial,0,118368,118368,0,0,118368
190510100900000,WAREHOUSE,Commercial,0,70848,70848,0,257582,328430
190510101000000,WAREHOUSE,Commercial,0,160056,160056,0,197542,357598
190510101100000,BARS/LOUNGE,Commercial,0,135432,135432,0,174055,309487
190510101200000,VACANT LAND,Commercial,0,177120,177120,0,0,177120
190510101300000,WAREHOUSE,Commercial,0,99576,99576,0,237432,337008
190510200100000,RESTAURANT,Commercial,0,134514,134514,0,92234,226748
190510200200000,COUNTY PROPERTY,Exempt,0,0,0,0,0,0
190510200300000,WAREHOUSE;MINI STORG,Commercial,0,89424,89424,0,264982,354406
190510200400000,FLAT PARKING,Commercial,0,60718,60718,0,2646,63364
190510200500000,WAREHOUSE,Commercial,0,53524,53524,0,170952,224476
190510201300000,WAREHOUSE,Commercial,0,53050,53050,0,107563,160613
190510201400000,OFFICE,Exempt,0,130464,130464,0,674603,805067
190510201402001,BILLBOARD(BLL),Commercial,0,0,0,0,14612,14612
190510201500000,OFFICE,Commercial,0,220320,220320,0,665105,885425
190510201700000,BARS/LOUNGE,Commercial,0,125871,125871,0,176060,301931
190510201800000,SHOP,Commercial,0,44712,44712,0,197189,241901
190510201900000,OFFICE,Commercial,0,279647,279647,0,2770189,3049836
190510202000000,SECTION 42,Commercial,0,203904,203904,0,114761,318665
190512600500000,STATE PROPERTY,Exempt,0,0,0,0,0,0
190512700100000,WAREHOUSE,Commercial,0,290520,290520,0,327108,617628
190512700200000,EQUIPMENT MFG;INDUST,Industrial,0,149256,149256,0,612308,761564
190512700400000,OFFICE,Commercial,0,74412,74412,0,142730,217142
190512700500000,OFFICE,Commercial,0,71928,71928,0,116578,188506
190512700600000,WAREHOUSE,Commercial,0,155520,155520,0,391534,547054
190512700700000,SHOP,Commercial,0,59098,59098,0,262345,321443
190512700800000,OFFICE,Commercial,0,60826,60826,0,252513,313339
190512700900000,WAREHOUSE,Commercial,0,175392,175392,0,552850,728242
190512701000000,WAREHOUSE,Commercial,0,35078,35078,0,88897,123975
190512701100000,WAREHOUSE,Commercial,0,56765,56765,0,94843,151608
190515100101000,WAREHOUSE,Commercial,0,141199,141199,0,786662,927861
190515100101001,MATERIALS MFG;INDUST,Industrial,0,227286,227286,0,1944858,2172144
190515100101002,SCHOOL,Exempt,0,0,0,0,0,0
190515100101003,SCHOOL,Exempt,0,0,0,0,0,0
190515100101004,MATERIALS MFG;INDUST,Industrial,0,15658,15658,0,174887,190545
190515100101005,MATERIALS MFG;INDUST,Industrial,0,149027,149027,0,1364641,1513668
190515200100000,WAREHOUSE,Commercial,0,316764,316764,0,1733537,2050301
190515200200000,WAREHOUSE,Commercial,0,306882,306882,0,1672836,1979718
190515200300000,WAREHOUSE,Commercial,0,247806,247806,0,2465103,2712909
190515300100000,WAREHOUSE,Commercial,0,269460,269460,0,1036148,1305608
190515300200000,WAREHOUSE,Commercial,0,265140,265140,0,1127753,1392893
190517600200000,OFFICE,Commercial,0,59011,59011,0,445501,504512
190517600300000,OFFICE,Commercial,0,103680,103680,0,568693,672373
190517600600000,AUTO REPAIR/SALES,Commercial,0,221940,221940,0,448668,670608
190517600700000,VACANT LAND,Commercial,0,89640,89640,0,0,89640
190517600800000,VACANT LAND,Commercial,0,176040,176040,0,0,176040
190517600900000,HOTEL,Commercial,0,219456,219456,0,1279491,1498947
190517601000000,HOTEL,Commercial,0,171696,171696,0,829693,1001389
190517601100000,HOTEL,Commercial,0,209642,209642,0,450227,659869
190517601200000,FAST FOOD,Commercial,0,434700,434700,0,516258,950958
190517601300000,MATERIALS MFG;INDUST,Industrial,0,77639,77639,0,336482,414121
190517601500000,WAREHOUSE,Commercial,0,342252,342252,0,4094635,4436887
190517601600000,HOTEL,Commercial,0,315360,315360,0,10560,325920
190517700300000,AUTO REPAIR/SALES,Commercial,0,217350,217350,0,632862,850212
190517700400000,FLAT PARKING,Commercial,0,138834,138834,0,28785,167619
190517700500000,WAREHOUSE,Commercial,0,257040,257040,0,749050,1006090
190517700600000,WAREHOUSE,Commercial,0,149040,149040,0,313844,462884
190517700700000,WAREHOUSE,Commercial,0,83290,83290,0,328824,412114
190517700800000,WAREHOUSE,Commercial,0,277263,277263,0,549968,827231
190517800100000,FRATERNAL,Commercial,0,160920,160920,0,358498,519418
190517800200000,OFFICE,Commercial,0,128736,128736,0,862835,991571
190520100300000,VACANT LAND,Industrial,0,1080,1080,0,0,1080
190520100400000,MISCELLANEOUS,Commercial,0,15660,15660,0,45095,60755
190520100600000,MISCELLANEOUS,Commercial,0,70794,70794,0,53919,124713
190520100700000,SHOP,Commercial,0,365526,365526,0,2945508,3311034
190520100800000,WAREHOUSE,Commercial,0,216292,216292,0,768649,984941
190520100900000,VACANT LAND,Commercial,0,152400,152400,0,0,152400
190520200100000,SW 455,Ag Land,15928,0,15928,0,0,15928
190522600100000,SW 418,Ag Land,20867,0,20867,0,0,20867
190522600200000,CENTRALLY ASSESSED,Other,0,0,0,0,0,0
190522700200000,CITY PROPERTY,Exempt,0,0,0,0,0,0
190522700400000,SW 425,Residential,367,0,367,0,0,367
190522700500000,SW 425,Residential,140,0,140,0,0,140
190522700600000,SW 425,Residential,162,0,162,0,0,162
190522700700000,SW 425,Residential,174,0,174,0,0,174
190522700800000,SW 425,Residential,1140,0,1140,0,0,1140
190522700900000,SW 425,Residential,217,0,217,0,0,217
190522701000000,SW 425,Residential,183,0,183,0,0,183
190522701100000,SW 425,Residential,26136,0,26136,64161,0,90297
190522701200000,SW 425,Residential,26136,0,26136,63677,0,89813
190522701300000,SW 425,Residential,22687,0,22687,89596,0,112283
190522701400000,SW 425,Residential,22961,0,22961,89596,0,112557
190522701500000,SW 425,Residential,26730,0,26730,89596,0,116326
190522701600000,SW 425,Residential,24447,0,24447,92658,0,117105
190522701700000,SW 425,Residential,23716,0,23716,64349,0,88065
190522701800000,SW 425,Residential,25608,0,25608,62575,0,88183
190522701900000,SW 425,Residential,23474,0,23474,26260,0,49734
190522702000000,SW 425,Residential,23474,0,23474,26260,0,49734
190522702100000,SW 425,Residential,23474,0,23474,26260,0,49734
190522702200000,SW 425,Residential,23357,0,23357,26260,0,49617
190522800100000,SW 425,Residential,211,0,211,0,0,211
190522800200000,SW 425,Residential,181,0,181,0,0,181
190522800300000,SW 425,Residential,204,0,204,0,0,204
190522800400000,SW 425,Residential,210,0,210,0,0,210
190522800500000,SW 425,Residential,280,0,280,0,0,280
190522800600000,SW 425,Residential,210,0,210,0,0,210
190522800700000,SW 425,Residential,222,0,222,0,0,222
190522800800000,SW 425,Residential,181,0,181,0,0,181
190522800900000,SW 425,Residential,171,0,171,0,0,171
190522801000000,SW 425,Residential,213,0,213,0,0,213
190525100100000,SW 455,Ag Land,29038,0,29038,0,0,29038
190525200100000,CITY PROPERTY,Exempt,0,0,0,0,0,0
190525200200000,CITY PROPERTY,Exempt,0,0,0,0,0,0
190525200300000,SW 455,Residential,36250,0,36250,0,0,36250
190527600100000,MISCELLANEOUS,Commercial,0,70783,70783,0,99595,170378
190527600200000,MISCELLANEOUS,Commercial,0,96606,96606,0,225137,321743
190527700100000,SW 455,Ag Land,9925,0,9925,0,0,9925
190527800100000,SW 455,Ag Land,18461,0,18461,0,0,18461
190530100100000,SW 455,Ag Land,43371,0,43371,0,0,43371
190532600100000,SW 455,Ag Land,51734,0,51734,0,0,51734
190535100100000,CITY PROPERTY,Exempt,0,0,0,0,0,0
190535200100000,CENTRALLY ASSESSED,Industrial,0,37390,37390,0,0,37390
190537600100000,VACANT LAND,Commercial,0,63353,63353,0,0,63353
190537600200000,CITY PROPERTY,Exempt,0,0,0,0,0,0
190537700100000,CENTRALLY ASSESSED,Other,0,0,0,0,0,0
190540100200000,EQUIPMENT MFG;INDUST,Industrial,0,655398,655398,0,4666250,5321648
190540200100000,WAREHOUSE,Commercial,0,32076,32076,0,67395,99471
190540200200000,WAREHOUSE,Commercial,0,353052,353052,0,239911,592963
190540200300000,VACANT LAND,Commercial,0,78732,78732,0,0,78732
190540200400000,VACANT LAND,Commercial,0,19764,19764,0,0,19764
190540200500000,VACANT LAND,Commercial,0,19602,19602,0,200,19802
190540200600000,WAREHOUSE,Commercial,0,38394,38394,0,94438,132832
190542600200000,CENTRALLY ASSESSED,Other,0,0,0,0,0,0
190542600300000,SW 418,Ag Land,486,0,486,0,0,486
190542600400000,SW 418,Ag Land,25313,0,25313,0,0,25313
190545100100000,SHOP,Commercial,0,201096,201096,0,68054,269150
190545100200000,VACANT LAND,Commercial,0,21708,21708,0,0,21708
190545200100000,OFFICE,Commercial,0,82080,82080,0,151226,233306
190545200200000,WAREHOUSE,Commercial,0,32218,32218,0,216093,248311
190545200400000,CENTRALLY ASSESSED,Other,0,0,0,0,0,0
190545300100000,FLAT PARKING,Commercial,0,44712,44712,0,2904,47616
190545300200000,SW 418,Residential,53450,0,53450,37554,0,91004
190545300300000,SW 418,Residential,53100,0,53100,92006,0,145106
190547600100000,WAREHOUSE,Commercial,0,78246,78246,0,7156,85402
190547700100000,WAREHOUSE,Commercial,0,151087,151087,0,131728,282815
190547700102000,BILLBOARD(BLL),Commercial,0,0,0,0,37161,37161
190547700200000,CONC/ASPH;INDUSTRIAL,Industrial,0,75897,75897,0,186820,262717
190547700300000,WAREHOUSE,Commercial,0,30402,30402,0,256979,287381
190547700400000,WAREHOUSE,Commercial,0,241596,241596,0,1897041,2138637
190547700500000,FLAT PARKING,Commercial,0,15131,15131,0,1692,16823
190610100500000,SW 457,Residential,48195,0,48195,162667,0,210862
190610100600000,SW 457,Residential,285,0,285,0,0,285
190610100700000,SW 457,Residential,50400,0,50400,183736,0,234136
190610100800000,SW 457,Residential,53810,0,53810,170553,0,224363
190610100900000,SW 457,Residential,53686,0,53686,205410,0,259096
190610101000000,SW 457,Residential,49896,0,49896,153224,0,203120
190610101100000,SW 457,Residential,57688,0,57688,176743,0,234431
190610101200000,SW 457,Residential,49248,0,49248,142848,0,192096
190610101300000,SW 457,Residential,53881,0,53881,170189,0,224070
190610101400000,SW 457,Residential,59954,0,59954,210100,0,270054
190610101500000,CITY PROPERTY,Exempt,0,0,0,0,0,0
190610101600000,SW 457,Residential,54994,0,54994,205370,0,260364
190610101700000,SW 457,Residential,33384,0,33384,238489,0,271873
190610101800000,SW 457,Residential,48212,0,48212,175520,0,223732
190610101900000,SW 457,Residential,45955,0,45955,182157,0,228112
190610102100000,SW 457,Residential,49692,0,49692,181439,0,231131
190610102200000,SW 457,Residential,43430,0,43430,207723,0,251153
190610102300000,SW 457,Residential,46258,0,46258,168006,0,214264
190610102400000,SW 457,Residential,46258,0,46258,178246,0,224504
190610102600000,SW 457,Residential,10,0,10,0,0,10
190610102700000,SW 457,Residential,218,0,218,0,0,218
190610102800000,SW 457,Residential,225,0,225,0,0,225
190610102900000,SW 457,Residential,216,0,216,0,0,216
190610103000000,SW 457,Residential,335,0,335,0,0,335
190610103100000,SW 457,Residential,6601,0,6601,0,0,6601
190610103200000,SW 420,Ag Land,14821,0,14821,0,0,14821
190610200100000,SW 457,Residential,44676,0,44676,156069,0,200745
190610200200000,SW 457,Residential,245,0,245,0,0,245
190610200300000,SW 457,Residential,50094,0,50094,186570,0,236664
190610200400000,SW 457,Residential,59449,0,59449,188174,0,247623
190610200500000,SW 457,Residential,214,0,214,0,0,214
190610200600000,SW 457,Residential,376,0,376,0,0,376
190610200700000,SW 457,Residential,278,0,278,0,0,278
190610200800000,SW 457,Residential,271,0,271,0,0,271
190610300100000,SW 457,Residential,51948,0,51948,189756,0,241704
190610300200000,SW 457,Residential,198,0,198,0,0,198
190610400100000,SW 425,Residential,365,0,365,0,0,365
190610400200000,SW 425,Residential,227,0,227,0,0,227
190610500100000,SW 425,Residential,23958,0,23958,3457,0,27415
190610500200000,SW 425,Residential,28331,0,28331,3457,0,31788
190612600400000,CITY PROPERTY,Exempt,0,0,0,0,0,0
190612600700000,SW 457,Residential,51940,0,51940,199406,0,251346
190612600800000,SW 457,Residential,52644,0,52644,152864,0,205508
190612600900000,SW 457,Residential,55744,0,55744,182915,0,238659
190612601000000,SW 457,Residential,57960,0,57960,172091,0,230051
190612601100000,SW 457,Residential,50470,0,50470,235146,0,285616
190612601200000,SW 457,Residential,46812,0,46812,226650,0,273462
190612601300000,SW 457,Residential,51480,0,51480,183790,0,235270
190612601400000,SW 457,Residential,55650,0,55650,194559,0,250209
190612601500000,SW 457,Residential,45800,0,45800,204059,0,249859
190612601600000,SW 457,Residential,43260,0,43260,207059,0,250319
190612601700000,SW 457,Residential,49296,0,49296,209131,0,258427
190612601800000,SW 457,Residential,49440,0,49440,196820,0,246260
190612601900000,SW 457,Residential,48616,0,48616,191955,0,240571
190612602300000,SW 457,Residential,49440,0,49440,207983,0,257423
190612602400000,SW 457,Residential,49560,0,49560,217614,0,267174
190612602500000,SW 457,Residential,49392,0,49392,168046,0,217438
190612602600000,SW 457,Residential,42642,0,42642,147116,0,189758
190612602700000,SW 457,Residential,46512,0,46512,166078,0,212590
190612602800000,SW 457,Residential,44064,0,44064,178287,0,222351
190612602900000,SW 457,Residential,48960,0,48960,184304,0,233264
190612603000000,SW 457,Residential,46512,0,46512,204943,0,251455
190612603100000,SW 457,Residential,44064,0,44064,159002,0,203066
190612603200000,SW 457,Residential,47586,0,47586,160350,0,207936
190612603300000,SW 457,Residential,39552,0,39552,168992,0,208544
190612603400000,SW 457,Residential,46512,0,46512,167631,0,214143
190612603500000,SW 457,Residential,339,0,339,0,0,339
190612603600000,SW 457,Residential,357,0,357,0,0,357
190612603700000,SW 457,Residential,339,0,339,0,0,339
190612603800000,SW 457,Residential,401,0,401,0,0,401
190612603900000,SW 457,Residential,55970,0,55970,143281,0,199251
190612604000000,SW 457,Residential,49376,0,49376,213619,0,262995
190612604100000,SW 457,Residential,526,0,526,0,0,526
190612604200000,SW 457,Residential,53972,0,53972,127079,0,181051
190612700100000,SW 457,Residential,49800,0,49800,232250,0,282050
190612700200000,SW 457,Residential,48412,0,48412,157267,0,205679
190612700300000,SW 457,Residential,46080,0,46080,200135,0,246215
190612700400000,SW 457,Residential,58410,0,58410,201936,0,260346
190612700500000,SW 457,Residential,52208,0,52208,187645,0,239853
190612700600000,SW 457,Residential,48960,0,48960,197804,0,246764
190612700700000,SW 457,Residential,42840,0,42840,172478,0,215318
190612700800000,SW 457,Residential,46512,0,46512,206537,0,253049
190612701200000,SW 457,Residential,54151,0,54151,158054,0,212205
190612701300000,SW 457,Residential,51330,0,51330,164191,0,215521
190612701400000,SW 457,Residential,52731,0,52731,158330,0,211061
190612701500000,SW 457,Residential,44064,0,44064,168170,0,212234
190612701700000,SW 457,Residential,48792,0,48792,179650,0,228442
190612701800000,SW 457,Residential,46512,0,46512,208086,0,254598
190612800100000,SW 457,Residential,39060,0,39060,176896,0,215956
190612800200000,SW 457,Residential,47880,0,47880,157998,0,205878
190612800300000,SW 457,Residential,39060,0,39060,169478,0,208538
190612800400000,SW 457,Residential,58590,0,58590,152341,0,210931
190612800500000,SW 457,Residential,42840,0,42840,157518,0,200358
190612900100000,SW 457,Residential,254,0,254,0,0,254
190612900200000,SW 457,Residential,293,0,293,0,0,293
190612900300000,SW 457,Residential,331,0,331,0,0,331
190612900400000,SW 457,Residential,293,0,293,0,0,293
190612900500000,SW 457,Residential,290,0,290,0,0,290
190612900600000,SW 457,Residential,327,0,327,0,0,327
190612900700000,SW 457,Residential,302,0,302,0,0,302
190612900800000,SW 420,Ag Land,9211,0,9211,0,0,9211
190615100100000,SW 455,Residential,86700,0,86700,29563,0,116263
190615100200000,SW 455,Residential,69350,0,69350,0,0,69350
190615100300000,SW 455,Residential,77900,0,77900,88355,0,166255
190615100400000,SW 455,Residential,76500,0,76500,74312,0,150812
190615100500000,SW 455,Residential,78750,0,78750,101853,0,180603
190615100600000,SW 455,Residential,78750,0,78750,90756,0,169506
190615100700000,SW 455,Residential,77750,0,77750,3506,0,81256
190615100800000,SW 455,Residential,66800,0,66800,147510,0,214310
190617600100000,SW 432,Residential,33050,0,33050,0,0,33050
190617600400000,SW 432,Residential,23152,0,23152,164112,0,187264
190617600500000,SW 432,Residential,24528,0,24528,154571,0,179099
190617600600000,SW 432,Residential,24528,0,24528,149240,0,173768
190617600700000,SW 432,Residential,24528,0,24528,143995,0,168523
190617600800000,SW 432,Residential,24528,0,24528,162305,0,186833
190617600900000,SW 432,Residential,24528,0,24528,163625,0,188153
190617601000000,SW 432,Residential,24528,0,24528,152127,0,176655
190617601100000,SW 432,Residential,24528,0,24528,157603,0,182131
190617601200000,SW 432,Residential,24528,0,24528,157791,0,182319
190617601300000,SW 432,Residential,24528,0,24528,165097,0,189625
190617601400000,SW 432,Residential,24528,0,24528,157920,0,182448
190617601500000,SW 432,Residential,24528,0,24528,152748,0,177276
190617601600000,SW 432,Residential,24578,0,24578,151312,0,175890
190617601700000,SW 432,Residential,26999,0,26999,142465,0,169464
190617601800000,SW 432,Residential,31763,0,31763,179831,0,211594
190617601900000,SW 432,Residential,26999,0,26999,184484,0,211483
190617602000000,SW 432,Residential,27037,0,27037,181469,0,208506
190617602100000,SW 432,Residential,27395,0,27395,190064,0,217459
190617602200000,SW 432,Residential,27339,0,27339,165409,0,192748
190617602300000,SW 432,Residential,27339,0,27339,173630,0,200969
190617602400000,SW 432,Residential,27339,0,27339,164553,0,191892
190617602500000,SW 432,Residential,27339,0,27339,163976,0,191315
190617602600000,SW 432,Residential,27339,0,27339,206841,0,234180
190617602700000,SW 432,Residential,31244,0,31244,174011,0,205255
190617602800000,SW 432,Residential,27339,0,27339,176515,0,203854
190617602900000,SW 432,Residential,27339,0,27339,159806,0,187145
190617603000000,SW 432,Residential,27339,0,27339,195248,0,222587
190617603100000,SW 432,Residential,27339,0,27339,156802,0,184141
190617603200000,SW 432,Residential,23594,0,23594,187229,0,210823
190617603300000,SW 432,Residential,27845,0,27845,201914,0,229759
190617700100000,SW 432,Residential,22131,0,22131,155813,0,177944
190617700200000,SW 432,Residential,25200,0,25200,195392,0,220592
190617700300000,SW 432,Residential,24528,0,24528,144322,0,168850
190617700400000,SW 432,Residential,24528,0,24528,153555,0,178083
190617700500000,SW 432,Residential,24898,0,24898,166303,0,191201
190617700600000,SW 455,Ag Dwelling,16902,0,16902,55626,9526,82054
190617700700000,SW 432,Residential,22848,0,22848,145689,0,168537
190617700800000,SW 432,Residential,24528,0,24528,155105,0,179633
190617700900000,SW 432,Residential,24528,0,24528,153290,0,177818
190617701000000,SW 432,Residential,24528,0,24528,154356,0,178884
190617701100000,SW 432,Residential,24528,0,24528,163440,0,187968
190617701200000,SW 432,Residential,24528,0,24528,152533,0,177061
190617701300000,SW 432,Residential,24528,0,24528,157274,0,181802
190617701400000,SW 432,Residential,24579,0,24579,167510,0,192089
190617800200000,SW 432,Residential,76249,0,76249,228936,0,305185
190617800400000,SW 432,Residential,31171,0,31171,205417,0,236588
190617800500000,SW 432,Residential,31171,0,31171,187444,0,218615
190617800600000,SW 432,Residential,31171,0,31171,219115,0,250286
190617800700000,SW 432,Residential,31171,0,31171,198649,0,229820
190617800800000,SW 432,Residential,31171,0,31171,165110,0,196281
190617800900000,SW 432,Residential,31171,0,31171,168037,0,199208
190617801000000,SW 432,Residential,31427,0,31427,201176,0,232603
190617801100000,SW 432,Residential,31427,0,31427,180196,0,211623
190617801200000,SW 432,Residential,28413,0,28413,166074,0,194487
190617801300000,SW 432,Residential,31877,0,31877,183667,0,215544
190617801400000,SW 432,Residential,34939,0,34939,170616,0,205555
190617801500000,SW 432,Residential,30417,0,30417,184241,0,214658
190617801600000,SW 432,Residential,26990,0,26990,152199,0,179189
190620100200000,SW 421,Residential,32246,0,32246,103371,0,135617
190620100300000,SW 421,Residential,28800,0,28800,97380,0,126180
190620100400000,SW 421,Residential,26675,0,26675,91768,0,118443
190620100500000,SW 421,Residential,26675,0,26675,93000,0,119675
190620100600000,SW 421,Residential,26675,0,26675,88919,0,115594
190620100700000,SW 421,Residential,26950,0,26950,83757,0,110707
190620100800000,SW 421,Residential,26950,0,26950,93154,0,120104
190620100900000,SW 421,Residential,26950,0,26950,95106,0,122056
190620101000000,SW 421,Residential,26950,0,26950,92839,0,119789
190620101100000,SW 421,Residential,26950,0,26950,90555,0,117505
190620101200000,SW 421,Residential,26950,0,26950,90656,0,117606
190620101300000,SW 421,Residential,27225,0,27225,83519,0,110744
190620101400000,SW 421,Residential,27225,0,27225,89601,0,116826
190620101500000,SW 421,Residential,27225,0,27225,84078,0,111303
190620101600000,SW 421,Residential,27225,0,27225,90834,0,118059
190620101700000,SW 421,Residential,29552,0,29552,100106,0,129658
190620101800000,SW 421,Residential,33069,0,33069,91827,0,124896
190620101900000,SW 421,Residential,29540,0,29540,95129,0,124669
190620102000000,SW 421,Residential,28600,0,28600,54398,0,82998
190620102100000,SW 421,Residential,28600,0,28600,85604,0,114204
190620102200000,SW 421,Residential,26000,0,26000,104026,0,130026
190620102300000,SW 421,Residential,31200,0,31200,99841,0,131041
190620102400000,SW 421,Residential,31882,0,31882,93102,0,124984
190620102500000,SW 421,Residential,29662,0,29662,92214,0,121876
190620102600000,SW 421,Residential,27500,0,27500,80682,0,108182
190620102700000,SW 421,Residential,27500,0,27500,80116,0,107616
190620102800000,SW 421,Residential,27500,0,27500,103835,0,131335
190620102900000,SW 421,Residential,27500,0,27500,90284,0,117784
190620103000000,SW 421,Residential,27500,0,27500,75669,0,103169
190620103100000,SW 421,Residential,27500,0,27500,95888,0,123388
190620103200000,SW 421,Residential,27500,0,27500,94546,0,122046
190620103300000,SW 421,Residential,27500,0,27500,85528,0,113028
190620103400000,SW 421,Residential,27500,0,27500,82084,0,109584
190620103500000,SW 421,Residential,27500,0,27500,90651,0,118151
190620103600000,SW 421,Residential,27500,0,27500,60152,0,87652
190620103700000,SW 421,Residential,30000,0,30000,88377,0,118377
190620103800000,SW 421,Residential,30000,0,30000,100146,0,130146
190620103900000,SW 421,Residential,28500,0,28500,87105,0,115605
190620104000000,SW 421,Residential,31715,0,31715,94175,0,125890
190620104100000,SW 421,Residential,31570,0,31570,87684,0,119254
190620104200000,SW 421,Residential,28500,0,28500,79186,0,107686
190620104300000,SW 421,Residential,28500,0,28500,89989,0,118489
190620104400000,SW 421,Residential,28500,0,28500,90722,0,119222
190620104500000,SW 421,Residential,27500,0,27500,77657,0,105157
190620104600000,SW 421,Residential,27500,0,27500,79993,0,107493
190620104700000,SW 421,Residential,27500,0,27500,77539,0,105039
190620104800000,SW 421,Residential,27500,0,27500,89011,0,116511
190620104900000,SW 421,Residential,27500,0,27500,86617,0,114117
190620105000000,SW 421,Residential,27500,0,27500,89500,0,117000
190620105100000,SW 421,Residential,27500,0,27500,106608,0,134108
190620105200000,SW 421,Residential,27500,0,27500,80606,0,108106
190620105300000,SW 421,Residential,27500,0,27500,89276,0,116776
190620105400000,SW 421,Residential,27500,0,27500,86144,0,113644
190620105500000,SW 421,Residential,27500,0,27500,97863,0,125363
190620105600000,SW 421,Residential,27500,0,27500,84916,0,112416
190620105700000,SW 421,Residential,27500,0,27500,84622,0,112122
190620105800000,SW 421,Residential,27500,0,27500,90615,0,118115
190620105900000,SW 421,Residential,27500,0,27500,91422,0,118922
190620106000000,SW 421,Residential,27500,0,27500,87765,0,115265
190620106100000,SW 421,Residential,30566,0,30566,107539,0,138105
190620106200000,SW 421,Residential,22732,0,22732,89667,0,112399
190620106300000,SW 421,Residential,21412,0,21412,91671,0,113083
190620106400000,SW 421,Residential,23028,0,23028,96388,0,119416
190620106500000,SW 421,Residential,26422,0,26422,105906,0,132328
190620106600000,SW 421,Residential,27472,0,27472,110807,0,138279
190620106700000,SW 421,Residential,28280,0,28280,100705,0,128985
190620106800000,SW 421,Residential,28280,0,28280,98855,0,127135
190620106900000,SW 421,Residential,28000,0,28000,90211,0,118211
190620107000000,SW 421,Residential,27093,0,27093,90029,0,117122
190620107100000,DAY CARE CENTER,Exempt,0,70470,70470,0,83127,153597
190620107200000,SW 457,Residential,7150,0,7150,0,0,7150
190620107300000,SW 457,Residential,45424,0,45424,182053,0,227477
190620107400000,SW 457,Residential,41976,0,41976,164838,0,206814
190620107500000,SW 457,Residential,42962,0,42962,161450,0,204412
190620107600000,SW 457,Residential,41134,0,41134,163139,0,204273
190620107700000,SW 457,Residential,38514,0,38514,156777,0,195291
190620107800000,SW 457,Residential,31973,0,31973,170237,0,202210
190620107900000,SW 457,Residential,41160,0,41160,155907,0,197067
190620108000000,SW 457,Residential,43155,0,43155,212943,0,256098
190620108100000,SW 457,Residential,43228,0,43228,147352,0,190580
190620108200000,SW 457,Residential,48838,0,48838,162960,0,211798
190620108300000,SW 457,Residential,45658,0,45658,156480,0,202138
190620108400000,SW 457,Residential,44289,0,44289,183021,0,227310
190620108500000,SW 457,Residential,46740,0,46740,194815,0,241555
190620108600000,SW 457,Residential,45786,0,45786,176122,0,221908
190620108700000,SW 457,Residential,44800,0,44800,133431,0,178231
190620108800000,SW 457,Residential,50675,0,50675,207015,0,257690
190620108900000,SW 457,Residential,48501,0,48501,195422,0,243923
190620109000000,SW 457,Residential,49254,0,49254,179946,0,229200
190620109100000,SW 457,Residential,49595,0,49595,150150,0,199745
190620109200000,SW 457,Residential,42420,0,42420,152232,0,194652
190620109300000,SW 457,Residential,46648,0,46648,162452,0,209100
190620109400000,SW 457,Residential,49936,0,49936,223595,0,273531
190620109500000,SW 457,Residential,44238,0,44238,169212,0,213450
190620109600000,SW 457,Residential,45540,0,45540,176112,0,221652
190620109700000,SW 457,Residential,51792,0,51792,185884,0,237676
190620200100000,SW 421,Residential,29601,0,29601,107677,0,137278
190620200200000,SW 421,Residential,31580,0,31580,94645,0,126225
190620200300000,SW 421,Residential,28500,0,28500,89187,0,117687
190620200400000,SW 421,Residential,28500,0,28500,79141,0,107641
190620200500000,SW 421,Residential,28500,0,28500,98289,0,126789
190620200600000,SW 421,Residential,30000,0,30000,79079,0,109079
190620200700000,SW 421,Residential,28500,0,28500,82520,0,111020
190620200800000,SW 421,Residential,28500,0,28500,85051,0,113551
190620200900000,SW 421,Residential,28500,0,28500,89976,0,118476
190620201000000,SW 421,Residential,30000,0,30000,64328,0,94328
190620201100000,SW 421,Residential,27500,0,27500,82874,0,110374
190620201200000,SW 421,Residential,27500,0,27500,81838,0,109338
190620201300000,SW 421,Residential,27500,0,27500,88219,0,115719
190620201400000,SW 421,Residential,27500,0,27500,86868,0,114368
190620201500000,SW 421,Residential,27500,0,27500,76495,0,103995
190620201600000,SW 421,Residential,29452,0,29452,79118,0,108570
190620201700000,SW 421,Residential,29155,0,29155,95235,0,124390
190620201800000,SW 421,Residential,27225,0,27225,87171,0,114396
190620201900000,SW 421,Residential,27225,0,27225,91495,0,118720
190620202000000,SW 421,Residential,27225,0,27225,85847,0,113072
190620202100000,SW 421,Residential,27225,0,27225,88999,0,116224
190620202200000,SW 421,Residential,27225,0,27225,80821,0,108046
190620202300000,SW 421,Residential,28215,0,28215,98537,0,126752
190620202400000,SW 421,Residential,28215,0,28215,93209,0,121424
190620202500000,SW 421,Residential,28215,0,28215,93524,0,121739
190620202600000,SW 421,Residential,28215,0,28215,94226,0,122441
190620202700000,SW 421,Residential,28215,0,28215,91131,0,119346
190620202800000,SW 421,Residential,29700,0,29700,95988,0,125688
190620202900000,SW 421,Residential,28215,0,28215,96081,0,124296
190620203000000,SW 421,Residential,28215,0,28215,94702,0,122917
190620300100000,CITY PROPERTY,Exempt,0,0,0,0,0,0
190620300200000,SW 457,Residential,45199,0,45199,189999,0,235198
190620300300000,SW 457,Residential,40219,0,40219,215321,0,255540
190620300400000,SW 457,Residential,41983,0,41983,199758,0,241741
190620300500000,SW 457,Residential,42336,0,42336,201364,0,243700
190620300600000,SW 457,Residential,41483,0,41483,249757,0,291240
190620300700000,SW 457,Residential,43737,0,43737,180966,0,224703
190620300800000,SW 457,Residential,43157,0,43157,156567,0,199724
190620300900000,SW 457,Residential,44006,0,44006,178563,0,222569
190620301000000,SW 457,Residential,47785,0,47785,177184,0,224969
190620301100000,SW 457,Residential,49795,0,49795,153197,0,202992
190620301200000,SW 457,Residential,45556,0,45556,154476,0,200032
190620301300000,SW 457,Residential,46904,0,46904,174794,0,221698
190620301400000,SW 457,Residential,42768,0,42768,178826,0,221594
190620301500000,SW 457,Residential,41958,0,41958,173445,0,215403
190620301600000,SW 457,Residential,39600,0,39600,174662,0,214262
190620301700000,SW 457,Residential,41580,0,41580,152865,0,194445
190620301800000,SW 457,Residential,40630,0,40630,155566,0,196196
190620301900000,SW 457,Residential,39204,0,39204,164286,0,203490
190620302000000,SW 457,Residential,41580,0,41580,172547,0,214127
190620302100000,SW 457,Residential,41580,0,41580,197698,0,239278
190620302200000,SW 457,Residential,42768,0,42768,223902,0,266670
190620302300000,SW 457,Residential,45754,0,45754,190312,0,236066
190620302400000,SW 457,Residential,39204,0,39204,155040,0,194244
190620302500000,SW 457,Residential,41580,0,41580,186908,0,228488
190620302600000,SW 457,Residential,41580,0,41580,164498,0,206078
190620302700000,SW 457,Residential,48906,0,48906,209468,0,258374
190620302800000,SW 457,Residential,50600,0,50600,192183,0,242783
190622600100000,SW 421,Residential,28552,0,28552,90482,0,119034
190622600200000,SW 421,Residential,26164,0,26164,82587,0,108751
190622600300000,SW 421,Residential,24957,0,24957,68968,0,93925
190622600400000,SW 421,Residential,25803,0,25803,91878,0,117681
190622600500000,SW 421,Residential,22560,0,22560,83862,0,106422
190622600600000,SW 421,Residential,22560,0,22560,85614,0,108174
190622600700000,SW 421,Residential,23876,0,23876,99772,0,123648
190622600800000,SW 421,Residential,23876,0,23876,76641,0,100517
190622600900000,SW 421,Residential,22560,0,22560,91943,0,114503
190622601000000,SW 421,Residential,22560,0,22560,100661,0,123221
190622601100000,SW 421,Residential,22560,0,22560,86321,0,108881
190622601200000,SW 421,Residential,22560,0,22560,96481,0,119041
190622601300000,SW 421,Residential,23876,0,23876,96313,0,120189
190622601400000,SW 421,Residential,23876,0,23876,79834,0,103710
190622601500000,SW 421,Residential,22560,0,22560,99652,0,122212
190622601600000,SW 421,Residential,22560,0,22560,83791,0,106351
190622601700000,SW 421,Residential,22560,0,22560,99320,0,121880
190622601800000,SW 421,Residential,25568,0,25568,95283,0,120851
190622601900000,SW 421,Residential,31960,0,31960,83069,0,115029
190622602000000,SW 421,Residential,28200,0,28200,102268,0,130468
190622602100000,SW 421,Residential,28200,0,28200,73929,0,102129
190622602200000,SW 421,Residential,28200,0,28200,82175,0,110375
190622602300000,SW 421,Residential,29845,0,29845,75492,0,105337
190622602400000,SW 421,Residential,29845,0,29845,90155,0,120000
190622602500000,SW 421,Residential,28200,0,28200,83451,0,111651
190622602600000,SW 421,Residential,28200,0,28200,86190,0,114390
190622602700000,SW 421,Residential,28200,0,28200,84177,0,112377
190622602800000,SW 421,Residential,28200,0,28200,90126,0,118326
190622602900000,SW 421,Residential,29845,0,29845,79644,0,109489
190622603000000,SW 421,Residential,29845,0,29845,73013,0,102858
190622603100000,SW 421,Residential,28200,0,28200,89067,0,117267
190622603200000,SW 421,Residential,28200,0,28200,77887,0,106087
190622603300000,SW 421,Residential,28200,0,28200,80700,0,108900
190622603400000,SW 421,Residential,28200,0,28200,78619,0,106819
190622603500000,SW 421,Residential,30732,0,30732,97889,0,128621
190622603600000,SW 421,Residential,31725,0,31725,93880,0,125605
190622700100000,SW 421,Residential,19907,0,19907,92588,0,112495
190622700200000,SW 421,Residential,19907,0,19907,89792,0,109699
190622700300000,SW 421,Residential,28735,0,28735,86325,0,115060
190622700400000,SW 421,Residential,26460,0,26460,69723,0,96183
190622700500000,SW 421,Residential,26460,0,26460,80460,0,106920
190622700600000,SW 421,Residential,26460,0,26460,75315,0,101775
190622700700000,SW 421,Residential,25972,0,25972,68867,0,94839
190622700800000,SW 421,Residential,25704,0,25704,82486,0,108190
190622700900000,SW 421,Residential,25704,0,25704,72474,0,98178
190622701000000,SW 421,Residential,25436,0,25436,93269,0,118705
190622701100000,SW 421,Residential,25436,0,25436,88306,0,113742
190622701200000,SW 421,Residential,29610,0,29610,80157,0,109767
190622800100000,SW 421,Residential,31725,0,31725,99619,0,131344
190622800200000,SW 421,Residential,32187,0,32187,81945,0,114132
190622800300000,SW 421,Residential,28200,0,28200,88916,0,117116
190622800400000,SW 421,Residential,28200,0,28200,88162,0,116362
190622800500000,SW 421,Residential,28200,0,28200,96599,0,124799
190622800600000,SW 421,Residential,28200,0,28200,94553,0,122753
190622800700000,SW 421,Residential,29845,0,29845,88423,0,118268
190622800800000,SW 421,Residential,29845,0,29845,71349,0,101194
190622800900000,SW 421,Residential,28200,0,28200,92349,0,120549
190622801000000,SW 421,Residential,28200,0,28200,92370,0,120570
190622801100000,SW 421,Residential,28200,0,28200,88987,0,117187
190622801200000,SW 421,Residential,28200,0,28200,89720,0,117920
190622801300000,SW 421,Residential,29845,0,29845,95702,0,125547
190622801400000,SW 421,Residential,29845,0,29845,85834,0,115679
190622801500000,SW 421,Residential,28200,0,28200,88734,0,116934
190622801600000,SW 421,Residential,28200,0,28200,84232,0,112432
190622801700000,SW 421,Residential,28200,0,28200,94016,0,122216
190622801800000,SW 421,Residential,30362,0,30362,94353,0,124715
190622801900000,SW 421,Residential,30362,0,30362,84295,0,114657
190622802000000,SW 421,Residential,28200,0,28200,96581,0,124781
190622802100000,SW 421,Residential,28200,0,28200,82819,0,111019
190622802200000,SW 421,Residential,28200,0,28200,85095,0,113295
190622802300000,SW 421,Residential,29845,0,29845,92571,0,122416
190622802400000,SW 421,Residential,29845,0,29845,82436,0,112281
190622802500000,SW 421,Residential,28200,0,28200,96256,0,124456
190622802600000,SW 421,Residential,28200,0,28200,97766,0,125966
190622802700000,SW 421,Residential,28200,0,28200,83952,0,112152
190622802800000,SW 421,Residential,28200,0,28200,102144,0,130344
190622802900000,SW 421,Residential,29845,0,29845,89320,0,119165
190622803000000,SW 421,Residential,29845,0,29845,87662,0,117507
190622803100000,SW 421,Residential,28200,0,28200,97044,0,125244
190622803200000,SW 421,Residential,28200,0,28200,92513,0,120713
190622803300000,SW 421,Residential,28200,0,28200,86839,0,115039
190622803400000,SW 421,Residential,28200,0,28200,86327,0,114527
190622803500000,SW 421,Residential,33848,0,33848,72605,0,106453
190622803600000,SW 421,Residential,31725,0,31725,83553,0,115278
190622900100000,SW 421,Residential,30600,0,30600,95424,0,126024
190622900200000,SW 421,Residential,29100,0,29100,90396,0,119496
190622900300000,SW 421,Residential,29949,0,29949,83122,0,113071
190622900400000,SW 421,Residential,29416,0,29416,92523,0,121939
190622900500000,SW 421,Residential,28200,0,28200,82789,0,110989
190622900600000,SW 421,Residential,28200,0,28200,84935,0,113135
190622900700000,SW 421,Residential,28200,0,28200,91246,0,119446
190622900800000,SW 421,Residential,28200,0,28200,93700,0,121900
190622900900000,SW 421,Residential,28200,0,28200,80987,0,109187
190622901000000,SW 421,Residential,28200,0,28200,68219,0,96419
190622901100000,SW 421,Residential,28200,0,28200,88017,0,116217
190622901200000,SW 421,Residential,28200,0,28200,80428,0,108628
190622901300000,SW 421,Residential,27645,0,27645,88618,0,116263
190622901400000,SW 421,Residential,27751,0,27751,81396,0,109147
190622901500000,SW 421,Residential,28200,0,28200,81083,0,109283
190622901600000,SW 421,Residential,28200,0,28200,85426,0,113626
190622901700000,SW 421,Residential,28200,0,28200,85761,0,113961
190622901800000,SW 421,Residential,28200,0,28200,86128,0,114328
190622901900000,SW 421,Residential,28200,0,28200,85946,0,114146
190622902000000,SW 421,Residential,28200,0,28200,80898,0,109098
190622902100000,SW 421,Residential,28200,0,28200,79944,0,108144
190622902200000,SW 421,Residential,28200,0,28200,96635,0,124835
190622902300000,SW 421,Residential,28520,0,28520,73981,0,102501
190623000100000,SW 421,Residential,29949,0,29949,85255,0,115204
190623000200000,SW 421,Residential,28701,0,28701,78958,0,107659
190623000300000,SW 421,Residential,29100,0,29100,72368,0,101468
190623000400000,SW 421,Residential,29100,0,29100,80348,0,109448
190623000500000,SW 421,Residential,29100,0,29100,82815,0,111915
190623000600000,SW 421,Residential,27160,0,27160,95229,0,122389
190623000700000,SW 421,Residential,27160,0,27160,81936,0,109096
190623000800000,SW 421,Residential,27160,0,27160,95261,0,122421
190623000900000,SW 421,Residential,28130,0,28130,97299,0,125429
190623001000000,SW 421,Residential,28130,0,28130,86207,0,114337
190623001100000,SW 421,Residential,27160,0,27160,80652,0,107812
190623001200000,SW 421,Residential,27160,0,27160,97946,0,125106
190623001300000,SW 421,Residential,27160,0,27160,83990,0,111150
190623001400000,SW 421,Residential,27160,0,27160,76470,0,103630
190623001500000,SW 421,Residential,30555,0,30555,96395,0,126950
190623001600000,SW 421,Residential,30555,0,30555,93490,0,124045
190623001700000,SW 421,Residential,27160,0,27160,91273,0,118433
190623001800000,SW 421,Residential,27160,0,27160,89907,0,117067
190623001900000,SW 421,Residential,27160,0,27160,88756,0,115916
190623002000000,SW 421,Residential,27160,0,27160,84267,0,111427
190623002100000,SW 421,Residential,28130,0,28130,84696,0,112826
190623002200000,SW 421,Residential,28130,0,28130,85990,0,114120
190623002300000,SW 421,Residential,27160,0,27160,83365,0,110525
190623002400000,SW 421,Residential,27160,0,27160,95569,0,122729
190623002500000,SW 421,Residential,27160,0,27160,95806,0,122966
190623002600000,SW 421,Residential,29100,0,29100,97210,0,126310
190623002700000,SW 421,Residential,29100,0,29100,84262,0,113362
190623002800000,SW 421,Residential,29100,0,29100,89957,0,119057
190623002900000,SW 421,Residential,30570,0,30570,86272,0,116842
190623003000000,SW 421,Residential,31525,0,31525,96491,0,128016
190623100100000,SW 421,Residential,30550,0,30550,100973,0,131523
190623100200000,SW 421,Residential,28639,0,28639,89725,0,118364
190623100300000,SW 421,Residential,28200,0,28200,79969,0,108169
190623100400000,SW 421,Residential,28200,0,28200,78118,0,106318
190623100500000,SW 421,Residential,28200,0,28200,85845,0,114045
190623100600000,SW 421,Residential,28200,0,28200,90009,0,118209
190623100700000,SW 421,Residential,28200,0,28200,101362,0,129562
190623100800000,SW 421,Residential,28200,0,28200,80375,0,108575
190623100900000,SW 421,Residential,28200,0,28200,82837,0,111037
190623101000000,SW 421,Residential,28701,0,28701,78378,0,107079
190623101100000,SW 421,Residential,28526,0,28526,84060,0,112586
190623101200000,SW 421,Residential,28200,0,28200,75215,0,103415
190623101300000,SW 421,Residential,28200,0,28200,75081,0,103281
190623101400000,SW 421,Residential,28200,0,28200,93515,0,121715
190623101500000,SW 421,Residential,28200,0,28200,96843,0,125043
190623101600000,SW 421,Residential,28200,0,28200,77032,0,105232
190623101700000,SW 421,Residential,28200,0,28200,96923,0,125123
190623101800000,SW 421,Residential,28200,0,28200,96800,0,125000
190623101900000,SW 421,Residential,28701,0,28701,85369,0,114070
190623102000000,SW 421,Residential,30550,0,30550,84669,0,115219
190623200100000,SW 421,Residential,30005,0,30005,91760,0,121765
190623200200000,SW 421,Residential,28200,0,28200,85675,0,113875
190623200300000,SW 421,Residential,28200,0,28200,85615,0,113815
190623200400000,SW 421,Residential,28200,0,28200,73665,0,101865
190623200500000,SW 421,Residential,25380,0,25380,84982,0,110362
190623200600000,SW 421,Residential,27754,0,27754,78353,0,106107
190623200700000,CHURCH,Exempt,0,64260,64260,0,325978,390238
190623200800000,SW 421,Residential,31392,0,31392,140623,0,172015
190623200900000,SW 421,Residential,28666,0,28666,94349,0,123015
190623201000000,SW 421,Residential,23970,0,23970,103283,0,127253
190623201100000,SW 421,Residential,24480,0,24480,101820,0,126300
190623201200000,SW 421,Residential,26702,0,26702,97901,0,124603
190623201300000,SW 421,Residential,30550,0,30550,103711,0,134261
190623201400000,SW 421,Residential,30550,0,30550,86047,0,116597
190623201500000,SW 421,Residential,30550,0,30550,78140,0,108690
190623201600000,SW 421,Residential,29370,0,29370,92493,0,121863
190623300100000,SW 421,Residential,30550,0,30550,86634,0,117184
190623300200000,SW 421,Residential,28639,0,28639,82342,0,110981
190623300300000,SW 421,Residential,28200,0,28200,86201,0,114401
190623300400000,SW 421,Residential,28200,0,28200,88259,0,116459
190623300500000,SW 421,Residential,28200,0,28200,94683,0,122883
190623300600000,SW 421,Residential,28200,0,28200,86443,0,114643
190623300700000,SW 421,Residential,28200,0,28200,93952,0,122152
190623300800000,SW 421,Residential,28200,0,28200,88634,0,116834
190623300900000,SW 421,Residential,28200,0,28200,85461,0,113661
190623301000000,SW 421,Residential,28701,0,28701,96792,0,125493
190623301100000,SW 421,Residential,23043,0,23043,101988,0,125031
190623301200000,SW 421,Residential,22309,0,22309,98945,0,121254
190623301300000,SW 421,Residential,22320,0,22320,80716,0,103036
190623301400000,SW 421,Residential,22320,0,22320,90731,0,113051
190623301500000,SW 421,Residential,22320,0,22320,88448,0,110768
190623301600000,SW 421,Residential,22080,0,22080,81939,0,104019
190623301700000,SW 421,Residential,22080,0,22080,82372,0,104452
190623301800000,SW 421,Residential,21840,0,21840,100746,0,122586
190623301900000,SW 421,Residential,22095,0,22095,84573,0,106668
190623302000000,SW 421,Residential,23660,0,23660,94071,0,117731
190625100100000,SW 421,Residential,22944,0,22944,92067,0,115011
190625100200000,SW 421,Residential,25768,0,25768,101635,0,127403
190625100300000,SW 421,Residential,26220,0,26220,103236,0,129456
190625100400000,SW 421,Residential,26617,0,26617,98458,0,125075
190625100500000,SW 421,Residential,26676,0,26676,103440,0,130116
190625100600000,SW 421,Residential,27876,0,27876,91334,0,119210
190625100700000,SW 421,Residential,27472,0,27472,102242,0,129714
190625100800000,SW 421,Residential,26917,0,26917,96196,0,123113
190625100900000,SW 421,Residential,27504,0,27504,75468,0,102972
190625101000000,SW 421,Residential,27504,0,27504,105890,0,133394
190625101100000,SW 421,Residential,25632,0,25632,95342,0,120974
190625101200000,SW 421,Residential,26313,0,26313,89301,0,115614
190625101300000,SW 421,Residential,26136,0,26136,100410,0,126546
190625101400000,SW 421,Residential,24997,0,24997,90570,0,115567
190625101500000,SW 421,Residential,31882,0,31882,96203,0,128085
190625101600000,SW 421,Residential,29315,0,29315,90401,0,119716
190625101700000,SW 421,Residential,24997,0,24997,95601,0,120598
190625101800000,SW 421,Residential,24008,0,24008,92631,0,116639
190625101900000,SW 421,Residential,24008,0,24008,102721,0,126729
190625102000000,SW 421,Residential,27228,0,27228,94241,0,121469
190625102100000,SW 421,Residential,29812,0,29812,97415,0,127227
190625102200000,SW 421,Residential,27022,0,27022,89744,0,116766
190625102300000,SW 421,Residential,26496,0,26496,91587,0,118083
190625102400000,SW 421,Residential,26592,0,26592,91345,0,117937
190625102500000,SW 421,Residential,26463,0,26463,87966,0,114429
190625102600000,SW 421,Residential,26849,0,26849,95495,0,122344
190625102700000,SW 421,Residential,29563,0,29563,91591,0,121154
190625102800000,SW 421,Residential,26045,0,26045,100339,0,126384
190625102900000,SW 421,Residential,26649,0,26649,100860,0,127509
190625103000000,SW 421,Residential,28400,0,28400,106421,0,134821
190625103100000,SW 421,Residential,26520,0,26520,101990,0,128510
190625103200000,SW 421,Residential,27936,0,27936,98915,0,126851
190625103300000,SW 421,Residential,25920,0,25920,93736,0,119656
190625103400000,SW 421,Residential,27702,0,27702,94849,0,122551
190625103500000,SW 421,Residential,26362,0,26362,80776,0,107138
190625103600000,SW 421,Residential,25852,0,25852,91256,0,117108
190625103700000,SW 421,Residential,23808,0,23808,103719,0,127527
190625103800000,SW 421,Residential,23760,0,23760,91516,0,115276
190625103900000,SW 421,Residential,23796,0,23796,99639,0,123435
190625104000000,SW 421,Residential,23981,0,23981,92254,0,116235
190625104100000,SW 429,Residential,17854,0,17854,152695,0,170549
190625104200000,SW 429,Residential,18540,0,18540,112489,0,131029
190625104300000,SW 429,Residential,18540,0,18540,133913,0,152453
190625104400000,SW 429,Residential,18540,0,18540,133424,0,151964
190625105500000,SW 429,Residential,18540,0,18540,142424,0,160964
190625105600000,SW 429,Residential,18540,0,18540,151877,0,170417
190625105700000,SW 429,Residential,18540,0,18540,134318,0,152858
190625105800000,SW 429,Residential,18360,0,18360,129300,0,147660
190625105900000,SW 429,Residential,18360,0,18360,126679,0,145039
190625106000000,SW 429,Residential,19075,0,19075,161403,0,180478
190625106100000,SW 429,Residential,26610,0,26610,146381,0,172991
190625106300000,SW 429,Residential,21083,0,21083,151444,0,172527
190625106400000,SW 429,Residential,22159,0,22159,146945,0,169104
190625106500000,SW 429,Residential,24752,0,24752,152539,0,177291
190625106600000,SW 429,Residential,21482,0,21482,153324,0,174806
190625106700000,SW 429,Residential,19507,0,19507,136950,0,156457
190625106800000,SW 429,Residential,20655,0,20655,153713,0,174368
190625106900000,SW 429,Residential,21693,0,21693,137403,0,159096
190625107000000,SW 429,Residential,21128,0,21128,147179,0,168307
190625107100000,SW 429,Residential,20639,0,20639,143836,0,164475
190625107200000,SW 429,Residential,21588,0,21588,163006,0,184594
190625107300000,SW 429,Residential,21043,0,21043,122576,0,143619
190625107400000,SW 429,Residential,20452,0,20452,143063,0,163515
190625200100000,SW 421,Residential,28585,0,28585,85168,0,113753
190625200200000,SW 421,Residential,26313,0,26313,95071,0,121384
190625200300000,SW 421,Residential,27254,0,27254,100444,0,127698
190625200400000,SW 421,Residential,26581,0,26581,89489,0,116070
190625200500000,SW 421,Residential,26522,0,26522,88263,0,114785
190625200600000,SW 421,Residential,26945,0,26945,112744,0,139689
190625200700000,SW 421,Residential,26646,0,26646,104322,0,130968
190625200800000,SW 421,Residential,26460,0,26460,104282,0,130742
190625200900000,SW 421,Residential,28764,0,28764,90961,0,119725
190625201000000,SW 421,Residential,26936,0,26936,95795,0,122731
190625201100000,SW 421,Residential,28764,0,28764,98819,0,127583
190625201200000,SW 421,Residential,27369,0,27369,95979,0,123348
190625201300000,SW 421,Residential,27150,0,27150,96113,0,123263
190625201400000,SW 421,Residential,27105,0,27105,103442,0,130547
190625201500000,SW 421,Residential,27105,0,27105,104883,0,131988
190625201600000,SW 421,Residential,27105,0,27105,102809,0,129914
190625201700000,SW 421,Residential,27930,0,27930,89008,0,116938
190625300100000,SW 429,Residential,18314,0,18314,145507,0,163821
190625300200000,SW 429,Residential,24725,0,24725,134283,0,159008
190625300300000,SW 429,Residential,24970,0,24970,116263,0,141233
190625300400000,SW 429,Residential,26538,0,26538,147267,0,173805
190625301400000,SW 429,Residential,18540,0,18540,136563,0,155103
190625301500000,SW 429,Residential,18540,0,18540,132596,0,151136
190625301600000,SW 429,Residential,18540,0,18540,122930,0,141470
190625301700000,SW 429,Residential,18540,0,18540,125702,0,144242
190625301800000,SW 429,Residential,19706,0,19706,150581,0,170287
190625301900000,SW 429,Residential,18540,0,18540,140921,0,159461
190625302000000,SW 429,Residential,18540,0,18540,144397,0,162937
190625302100000,SW 429,Residential,18540,0,18540,132220,0,150760
190625302200000,SW 429,Residential,18540,0,18540,140485,0,159025
190625302300000,SW 429,Residential,20181,0,20181,130526,0,150707
190625302400000,SW 429,Residential,18540,0,18540,128363,0,146903
190625302500000,SW 429,Residential,20184,0,20184,115729,0,135913
190625302600000,SW 429,Residential,18540,0,18540,149517,0,168057
190625302700000,SW 429,Residential,18540,0,18540,126241,0,144781
190625302800000,SW 429,Residential,18540,0,18540,147343,0,165883
190625302900000,SW 429,Residential,18540,0,18540,146725,0,165265
190625303000000,SW 429,Residential,18540,0,18540,129052,0,147592
190625303100000,SW 429,Residential,18540,0,18540,162121,0,180661
190625303200000,SW 429,Residential,18540,0,18540,137108,0,155648
190625304500000,SW 429,Residential,18540,0,18540,148474,0,167014
190625304600000,SW 429,Residential,18540,0,18540,146219,0,164759
190625304700000,SW 429,Residential,18540,0,18540,141040,0,159580
190625304800000,SW 429,Residential,18540,0,18540,176936,0,195476
190625304900000,SW 429,Residential,18540,0,18540,134841,0,153381
190625305000000,SW 429,Residential,20255,0,20255,142024,0,162279
190625305100000,SW 429,Residential,20252,0,20252,137253,0,157505
190625305200000,SW 429,Residential,18540,0,18540,150886,0,169426
190625305300000,SW 429,Residential,18540,0,18540,139056,0,157596
190625305400000,SW 429,Residential,18540,0,18540,148697,0,167237
190625400100000,SW 429,Residential,24763,0,24763,128095,0,152858
190625400200000,SW 421,Residential,36166,0,36166,91275,0,127441
190625400300000,APARTMENT,Commercial,0,191160,191160,0,1639375,1830535
190625400400000,VACANT LAND,Commercial,0,250290,250290,0,0,250290
190625400500000,CONVENIENCE STORE,Commercial,0,235467,235467,0,540109,775576
190625400600000,OFFICE,Commercial,0,103140,103140,0,432577,535717
190627600100000,SW 418,Residential,66550,0,66550,97379,0,163929
190627600200000,SW 418,Residential,66550,0,66550,57086,0,123636
190627600300000,SW 418,Residential,35640,0,35640,107529,0,143169
190627600400000,SW 418,Residential,46900,0,46900,82169,0,129069
190627600500000,SW 418,Residential,46350,0,46350,44348,0,90698
190627600600000,SW 421,Residential,25380,0,25380,44992,0,70372
190627600900000,SW 421,Residential,45747,0,45747,163413,0,209160
190627601000000,SW 421,Residential,40680,0,40680,95323,0,136003
190627601100000,SW 418,Ag Dwelling,6419,0,6419,83723,8729,98871
190627601200000,SW 455,Residential,73450,0,73450,233036,0,306486
190627601300000,SW 455,Residential,60000,0,60000,114045,0,174045
190627601400000,SW 455,Residential,73500,0,73500,161323,0,234823
190627601500000,SW 429,Residential,53340,0,53340,88965,0,142305
190627601600000,SW 429,Residential,29400,0,29400,153855,0,183255
190627601700000,SW 429,Residential,32550,0,32550,252490,0,285040
190627601800000,CITY PROPERTY,Exempt,0,0,0,0,0,0
190627601900000,SW 429,Residential,26705,0,26705,171864,0,198569
190627602000000,SW 429,Residential,29376,0,29376,196440,0,225816
190627602100000,SW 429,Residential,29376,0,29376,243943,0,273319
190627602200000,SW 429,Residential,32550,0,32550,233949,0,266499
190627602300000,SW 429,Residential,32550,0,32550,258114,0,290664
190627602400000,SW 429,Residential,32550,0,32550,269657,0,302207
190627602500000,SW 429,Residential,29566,0,29566,281843,0,311409
190627602600000,SW 429,Residential,29566,0,29566,231098,0,260664
190627602700000,SW 429,Residential,29295,0,29295,301406,0,330701
190627602800000,CITY PROPERTY,Exempt,0,0,0,0,0,0
190627602900000,SW 429,Residential,28420,0,28420,244772,0,273192
190627603000000,SW 429,Residential,62937,0,62937,265265,0,328202
190627700100000,SW 429,Residential,33170,0,33170,182599,0,215769
190627700200000,SW 429,Residential,31446,0,31446,168357,0,199803
190627700300000,SW 429,Residential,31446,0,31446,232792,0,264238
190627700400000,SW 429,Residential,31446,0,31446,231943,0,263389
190627700500000,SW 429,Residential,31446,0,31446,227755,0,259201
190627700600000,SW 429,Residential,31446,0,31446,252343,0,283789
190627700700000,SW 429,Residential,31446,0,31446,173120,0,204566
190627700800000,SW 429,Residential,31029,0,31029,0,0,31029
190627700900000,CITY PROPERTY,Exempt,0,0,0,0,0,0
190627800100000,SW 429,Residential,31238,0,31238,0,0,31238
190627800200000,SW 429,Residential,28256,0,28256,167259,0,195515
190627800300000,SW 429,Residential,28256,0,28256,0,0,28256
190627800600000,SW 429,Residential,35868,0,35868,0,0,35868
190627800700000,SW 429,Residential,48855,0,48855,306288,0,355143
190630100100000,SW 455,Residential,43820,0,43820,104074,0,147894
190630100400000,SW 455,Residential,79350,0,79350,209832,0,289182
190630100500000,SW 455,Residential,72450,0,72450,221474,0,293924
190630100600000,SW 429,Residential,25916,0,25916,155674,0,181590
190630100700000,SW 429,Residential,23814,0,23814,145967,0,169781
190630100800000,SW 429,Residential,23814,0,23814,136361,0,160175
190630100900000,SW 429,Residential,23814,0,23814,149264,0,173078
190630101000000,SW 429,Residential,23814,0,23814,157577,0,181391
190630101100000,SW 429,Residential,23814,0,23814,140834,0,164648
190630101200000,SW 429,Residential,25940,0,25940,147828,0,173768
190630101300000,SW 429,Residential,26008,0,26008,148833,0,174841
190630101400000,SW 429,Residential,23814,0,23814,136586,0,160400
190630101500000,SW 429,Residential,23814,0,23814,154037,0,177851
190630101600000,SW 429,Residential,23814,0,23814,153472,0,177286
190630101700000,SW 429,Residential,23814,0,23814,150768,0,174582
190630101800000,SW 429,Residential,23814,0,23814,166316,0,190130
190630101900000,SW 429,Residential,25822,0,25822,135753,0,161575
190630200100000,CITY PROPERTY,Exempt,0,0,0,0,0,0
190630200200000,SW 429,Residential,23744,0,23744,141254,0,164998
190630200300000,SW 429,Residential,24411,0,24411,135419,0,159830
190630200400000,SW 429,Residential,24486,0,24486,140481,0,164967
190630200500000,SW 429,Residential,24486,0,24486,156648,0,181134
190630200600000,SW 429,Residential,24486,0,24486,157425,0,181911
190630200700000,SW 429,Residential,27166,0,27166,150916,0,178082
190630200800000,SW 429,Residential,24486,0,24486,151131,0,175617
190630300100000,SW 429,Residential,26434,0,26434,141912,0,168346
190630300200000,SW 429,Residential,24035,0,24035,153350,0,177385
190630300300000,SW 429,Residential,23814,0,23814,140460,0,164274
190630300400000,SW 429,Residential,23814,0,23814,144861,0,168675
190630300500000,SW 429,Residential,23814,0,23814,143266,0,167080
190630300600000,SW 429,Residential,23814,0,23814,143196,0,167010
190630300700000,SW 429,Residential,25696,0,25696,140350,0,166046
190630400100000,SW 429,Residential,26984,0,26984,263092,0,290076
190630400200000,SW 429,Residential,23436,0,23436,157368,0,180804
190630400300000,SW 429,Residential,23554,0,23554,166446,0,190000
190630400400000,SW 429,Residential,23436,0,23436,140721,0,164157
190630400500000,SW 429,Residential,23436,0,23436,129514,0,152950
190630400600000,SW 429,Residential,23436,0,23436,156934,0,180370
190630400700000,SW 429,Residential,23436,0,23436,133686,0,157122
190630400800000,SW 429,Residential,23436,0,23436,165271,0,188707
190630400900000,SW 429,Residential,22907,0,22907,153093,0,176000
190630401000000,SW 429,Residential,24459,0,24459,168587,0,193046
190632600100000,SW 429,Residential,24320,0,24320,143818,0,168138
190632600200000,SW 429,Residential,24253,0,24253,140238,0,164491
190632600300000,SW 429,Residential,22491,0,22491,156315,0,178806
190632600400000,SW 429,Residential,22491,0,22491,142841,0,165332
190632600500000,SW 429,Residential,22491,0,22491,137973,0,160464
190632600600000,SW 429,Residential,22491,0,22491,146317,0,168808
190632600700000,SW 429,Residential,22491,0,22491,143378,0,165869
190632600800000,SW 429,Residential,24276,0,24276,153235,0,177511
190632600900000,SW 429,Residential,24276,0,24276,155689,0,179965
190632601000000,SW 429,Residential,22491,0,22491,137734,0,160225
190632601100000,SW 429,Residential,22491,0,22491,136777,0,159268
190632601200000,SW 429,Residential,22491,0,22491,154971,0,177462
190632601300000,SW 429,Residential,22491,0,22491,134132,0,156623
190632601400000,SW 429,Residential,22491,0,22491,139198,0,161689
190632700100000,SW 429,Residential,24192,0,24192,145049,0,169241
190632700200000,SW 429,Residential,24125,0,24125,153821,0,177946
190632700300000,SW 429,Residential,22491,0,22491,134897,0,157388
190632700400000,SW 429,Residential,22491,0,22491,134369,0,156860
190632700500000,SW 429,Residential,22491,0,22491,146908,0,169399
190632700600000,SW 429,Residential,22491,0,22491,151162,0,173653
190632700700000,SW 429,Residential,22491,0,22491,123664,0,146155
190632700800000,SW 429,Residential,24276,0,24276,162787,0,187063
190632700900000,SW 429,Residential,24276,0,24276,143002,0,167278
190632701000000,SW 429,Residential,22491,0,22491,140095,0,162586
190632701100000,SW 429,Residential,22491,0,22491,137361,0,159852
190632701200000,SW 429,Residential,22491,0,22491,134998,0,157489
190632701300000,SW 429,Residential,22491,0,22491,159737,0,182228
190632701400000,SW 429,Residential,22491,0,22491,128436,0,150927
190632800200000,OFFICE,Commercial,0,485634,485634,0,2857809,3343443
190632800300000,OFFICE,Commercial,0,258210,258210,0,612572,870782
190632900100000,SW 429,Residential,26712,0,26712,127831,0,154543
190632900200000,SW 429,Residential,26712,0,26712,150476,0,177188
190632900300000,SW 429,Residential,23744,0,23744,149626,0,173370
190632900400000,SW 429,Residential,23744,0,23744,144888,0,168632
190632900500000,SW 429,Residential,23744,0,23744,160123,0,183867
190632900600000,SW 429,Residential,23744,0,23744,142748,0,166492
190632900700000,SW 429,Residential,23744,0,23744,138229,0,161973
190632900800000,SW 429,Residential,23744,0,23744,132802,0,156546
190632900900000,SW 429,Residential,24041,0,24041,157770,0,181811
190632901000000,SW 429,Residential,23744,0,23744,159236,0,182980
190633000100000,SW 429,Residential,26091,0,26091,164460,0,190551
190633000200000,SW 429,Residential,24035,0,24035,145571,0,169606
190633000300000,SW 429,Residential,24035,0,24035,164662,0,188697
190633000400000,SW 429,Residential,24035,0,24035,139065,0,163100
190633000500000,SW 429,Residential,24035,0,24035,140100,0,164135
190633000600000,SW 429,Residential,24035,0,24035,142954,0,166989
190633000700000,SW 429,Residential,25942,0,25942,152914,0,178856
190635100100000,WAREHOUSE,Commercial,0,363744,363744,0,2740930,3104674
190635100300000,VACANT LAND,Commercial,0,201690,201690,0,0,201690
190637600200000,WAREHOUSE,Commercial,0,237060,237060,0,273785,510845
190637600202000,ANTENNAS/TOWERS(BLL),Commercial,0,0,0,0,75204,75204
190637600300000,AUTO REPAIR/SALES,Commercial,0,430002,430002,0,1683421,2113423
190637600400000,VACANT LAND,Ag Land,5854,0,5854,0,0,5854
190640100100000,SW 455,Ag Dwelling,26117,0,26117,210490,1550,238157
190640100200000,CITY PROPERTY,Exempt,0,0,0,0,0,0
190640100300000,CENTRALLY ASSESSED,Other,0,0,0,0,0,0
190640200100000,SW 418,Residential,35200,0,35200,140145,0,175345
190642600200000,CITY PROPERTY,Exempt,0,0,0,0,0,0
190642600300000,SW 455,Residential,48576,0,48576,77242,0,125818
190642600400000,SW 455,Residential,35407,0,35407,49886,0,85293
190642600500000,SW 455,Residential,31444,0,31444,76510,0,107954
190642600600000,SW 455,Residential,63700,0,63700,930,0,64630
190645100100000,CITY PROPERTY,Exempt,0,0,0,0,0,0
190645200100000,CENTRALLY ASSESSED,Industrial,0,6853,6853,0,0,6853
190647600100000,CITY PROPERTY,Exempt,0,0,0,0,0,0
190647600200000,CENTRALLY ASSESSED,Other,0,0,0,0,0,0
190647700100000,CENTRALLY ASSESSED,Industrial,0,28318,28318,0,0,28318
190647700102000,BILLBOARD(BLL),Commercial,0,0,0,0,58490,58490
190710100100000,VACANT LAND,Industrial,0,10951,10951,0,0,10951
190710200100000,CENTRALLY ASSESSED,Other,0,0,0,0,0,0
190710200102000,BILLBOARD(BLL),Commercial,0,0,0,0,40012,40012
190712600100000,CENTRALLY ASSESSED,Other,0,0,0,0,0,0
190712600200000,SW 418,Ag Land,31918,0,31918,0,0,31918
190715100100000,SW 418,Ag Land,37195,0,37195,0,0,37195
190720100100000,CENTRALLY ASSESSED,Other,0,0,0,0,0,0
190720200100000,CITY PROPERTY,Exempt,0,0,0,0,0,0
190720200200000,VACANT LAND,Commercial,0,1037,1037,0,0,1037
190722600100000,VACANT LAND,Ag Land,24970,0,24970,0,0,24970
190722600200000,CITY PROPERTY,Exempt,0,0,0,0,0,0
190722700100000,CITY PROPERTY,Exempt,0,0,0,0,0,0
190722700200000,CENTRALLY ASSESSED,Other,0,0,0,0,0,0
190727600100000,SW 418,Ag Land,2717,0,2717,0,0,2717
190727700100000,WAREHOUSE,Commercial,0,176640,176640,0,52484,229124
190730100100000,VACANT LAND,Commercial,0,199780,199780,0,0,199780
190732600300000,OFFICE,Commercial,0,116872,116872,0,16577,133449
190732600400000,SW 418,Residential,60000,0,60000,129560,0,189560
190735100100000,SW 418,Ag Land,60559,0,60559,0,0,60559
190735100200000,CENTRALLY ASSESSED,Other,0,0,0,0,0,0
190737600100000,VACANT LAND,Commercial,0,206890,206890,0,0,206890
190742600100000,SW 418,Ag Land,58961,0,58961,0,0,58961
190745100100000,VACANT LAND,Industrial,0,1025757,1025757,0,0,1025757
190747600100000,SW 418,Ag Land,21707,0,21707,0,0,21707
190810100100000,HOTEL,Exempt,0,1608908,1608908,0,2217829,3826737
190810100102000,BILLBOARD(BLL),Commercial,0,0,0,0,8406,8406
190812600100000,FLAT PARKING,Commercial,0,31104,31104,0,33000,64104
190812700100000,SW 418,Residential,49250,0,49250,0,0,49250
190812700200000,SW 418,Residential,71250,0,71250,101840,0,173090
190812700300000,CITY PROPERTY,Exempt,0,0,0,0,0,0
190815100100000,EQUIPMENT MFG;INDUST,Industrial,0,218268,218268,0,1236415,1454683
190820100100000,VACANT LAND,Industrial,0,41893,41893,0,0,41893
190820200100000,CENTRALLY ASSESSED,Other,0,0,0,0,0,0
190820200200000,CENTRALLY ASSESSED,Other,0,0,0,0,0,0
190822600100000,VACANT LAND,Industrial,0,13203,13203,0,0,13203
190822600102000,BILLBOARD(BLL),Commercial,0,0,0,0,11531,11531
190822700100000,CENTRALLY ASSESSED,Other,0,0,0,0,0,0
190825100100000,CENTRALLY ASSESSED,Other,0,0,0,0,0,0
190825200100000,METAL;INDUSTRIAL,Industrial,0,2619114,2619114,0,8130886,10750000
190827600400000,FOOD GRADE;INDUST,Industrial,0,1504386,1504386,0,30787402,32291788
190830100300000,SHOP,Commercial,0,201906,201906,0,413377,615283
190830100400000,FLAT PARKING,Commercial,0,35964,35964,0,26083,62047
190830100500000,CITY PROPERTY,Exempt,0,0,0,0,0,0
190830100600000,SHOP,Commercial,0,85860,85860,0,319637,405497
190830100700000,VACANT LAND,Industrial,0,162000,162000,0,0,162000
190830100800000,WAREHOUSE,Commercial,0,62775,62775,0,263914,326689
190830100900000,OFFICE,Commercial,0,42525,42525,0,93396,135921
190830101000000,WAREHOUSE,Commercial,0,93960,93960,0,245086,339046
190830101100000,CITY PROPERTY,Exempt,0,0,0,0,0,0
190830101200000,MATERIALS MFG;INDUST,Industrial,0,201420,201420,0,398955,600375
190830101300000,VACANT LAND,Commercial,0,0,0,0,0,0
190835100100000,SW 418,Ag Land,44764,0,44764,0,0,44764
190837600200000,WAREHOUSE,Commercial,0,224910,224910,0,140182,365092
190837600300000,SHOP,Commercial,0,220698,220698,0,387023,607721
190837600400000,SHOP,Commercial,0,216648,216648,0,364719,581367
190837600500000,SHOP,Commercial,0,216000,216000,0,440458,656458
190840100100000,SHOP,Industrial,0,193592,193592,0,316615,510207
190840100200000,VACANT LAND,Industrial,0,10714,10714,0,0,10714
190840100300000,SW 418,Residential,19500,0,19500,0,0,19500
190840100400000,SHOP,Commercial,0,123930,123930,0,248235,372165
190840100500000,FOOD GRADE;INDUST,Industrial,0,242611,242611,0,396063,638674
190840100600000,VACANT LAND,Commercial,0,28350,28350,0,0,28350
190840100700000,SHOP,Industrial,0,52042,52042,0,89815,141857
190840100800000,APARTMENT,Exempt,0,288630,288630,0,2734855,3023485
190840100900000,SHOP,Industrial,0,240745,240745,0,1493576,1734321
190842600100000,SW 418,Residential,43000,0,43000,76854,0,119854
190842600200000,SW 418,Residential,31279,0,31279,44681,0,75960
190842700400000,FOOD GRADE;INDUST,Industrial,0,475362,475362,0,4072653,4548015
190845100300000,FOOD GRADE;INDUST,Industrial,0,134892,134892,0,68618,203510
190845100500000,SHOP,Industrial,0,122148,122148,0,111084,233232
190845100600000,SHOP,Industrial,0,93852,93852,0,378708,472560
190845100700000,CENTRALLY ASSESSED,Other,0,0,0,0,0,0
190845101000000,FOOD GRADE;INDUST,Industrial,0,80190,80190,0,244715,324905
190845101600000,VACANT LAND,Industrial,0,810,810,0,0,810
190845101700000,FOOD GRADE;INDUST,Industrial,0,490104,490104,0,15876266,16366370
190845101800000,FOOD GRADE;INDUST,Industrial,0,494802,494802,0,2274074,2768876
190845101900000,VACANT LAND,Industrial,0,2106,2106,0,0,2106
190845102000000,VACANT LAND,Industrial,0,972,972,0,0,972
190847600200000,SHOP,Commercial,0,314636,314636,0,422303,736939
190847600300000,MATERIALS MFG;INDUST,Industrial,0,205200,205200,0,505412,710612
190847600400000,WAREHOUSE,Commercial,0,116640,116640,0,527400,644040
190847600500000,SHOP,Commercial,0,67959,67959,0,180260,248219
190847600600000,SHOP,Commercial,0,67959,67959,0,149636,217595
190847600700000,WAREHOUSE,Commercial,0,41877,41877,0,90827,132704
190847600800000,WAREHOUSE,Commercial,0,57834,57834,0,93348,151182
190847600900000,VACANT LAND,Commercial,0,729,729,0,0,729
190847601000000,WAREHOUSE,Commercial,0,165402,165402,0,637409,802811
190847601100000,VACANT LAND,Commercial,0,106312,106312,0,0,106312
190847601200000,WAREHOUSE,Commercial,0,151470,151470,0,194735,346205
190847601300000,WAREHOUSE,Commercial,0,67959,67959,0,248037,315996
190847601400000,WAREHOUSE,Commercial,0,67959,67959,0,73030,140989
190847601500000,SMALL RETAIL,Commercial,0,92664,92664,0,125255,217919
190847601600000,OFFICE,Commercial,0,182520,182520,0,485032,667552
190847601700000,AUTO REPAIR/SALES,Commercial,0,96660,96660,0,349233,445893
190847601800000,FLAT PARKING,Commercial,0,66204,66204,0,23948,90152
190847601900000,WAREHOUSE,Commercial,0,61398,61398,0,72376,133774
190847602000000,WAREHOUSE,Commercial,0,37438,37438,0,138643,176081
190847602100000,SHOP,Commercial,0,124740,124740,0,103543,228283
190847602200000,VACANT LAND,Industrial,0,82818,82818,0,0,82818
190847602300000,VACANT LAND,Industrial,0,22356,22356,0,0,22356
190910100100000,VACANT LAND,Industrial,0,452574,452574,0,0,452574
190910100200000,PRINTING,Industrial,0,833857,833857,0,3737676,4571533
190912600100000,VACANT LAND,Industrial,0,94122,94122,0,0,94122
190912600200000,COUNTY PROPERTY,Exempt,0,0,0,0,0,0
190912600400000,CENTRALLY ASSESSED,Other,0,0,0,0,0,0
190912600500000,VACANT LAND,Commercial,0,20844,20844,0,0,20844
190912600700000,BARS/LOUNGE,Commercial,0,51030,51030,0,147886,198916
190912600702000,BILLBOARD(BLL),Commercial,0,0,0,0,17279,17279
190912600800000,OFFICE,Commercial,0,48600,48600,0,79467,128067
190912600900000,OFFICE,Commercial,0,41310,41310,0,224148,265458
190912601000000,FRATERNAL,Exempt,0,65126,65126,0,293708,358834
190912601100000,SW 422,Residential,28381,0,28381,124823,0,153204
190912601200000,SW 422,Residential,31535,0,31535,0,0,31535
190912601300000,SW 422,Residential,28381,0,28381,100821,0,129202
190912601400000,OFFICE,Commercial,0,36450,36450,0,318899,355349
190912601600000,SHOP,Commercial,0,196560,196560,0,274696,471256
190912601700000,WAREHOUSE,Commercial,0,127008,127008,0,462146,589154
190912601800000,WAREHOUSE,Commercial,0,186462,186462,0,100353,286815
190912601900000,WAREHOUSE,Commercial,0,81648,81648,0,420193,501841
190912602000000,WAREHOUSE,Commercial,0,104112,104112,0,856347,960459
190912602100000,VACANT LAND,Commercial,0,57216,57216,0,0,57216
190912602200000,VACANT LAND,Commercial,0,68429,68429,0,0,68429
190912602300000,WAREHOUSE,Commercial,0,158112,158112,0,195644,353756
190915100100000,WAREHOUSE,Commercial,0,307712,307712,0,3537063,3844775
190915100200000,CENTRALLY ASSESSED,Other,0,0,0,0,0,0
190915100300000,VACANT LAND,Commercial,0,13608,13608,0,0,13608
190915200100000,WAREHOUSE,Commercial,0,266598,266598,0,706981,973579
190915200200000,COUNTY PROPERTY,Exempt,0,0,0,0,0,0
190915200300000,SHOP,Commercial,0,93312,93312,0,217697,311009
190915200400000,SHOP,Commercial,0,235224,235224,0,506499,741723
190915200500000,WAREHOUSE,Commercial,0,271944,271944,0,1157465,1429409
190915200600000,SCHOOL,Exempt,0,196992,196992,0,1392969,1589961
190917600100000,MATERIALS MFG;INDUST,Industrial,0,473958,473958,0,1926042,2400000
190920100100000,WAREHOUSE,Commercial,0,58320,58320,0,102357,160677
190920100200000,SHOP,Commercial,0,200448,200448,0,432442,632890
190920100300000,PRINTING,Industrial,0,79272,79272,0,161562,240834
190920100400000,SHOP,Commercial,0,230472,230472,0,452101,682573
190920100500000,WAREHOUSE,Commercial,0,210816,210816,0,799893,1010709
190920100600000,WAREHOUSE,Commercial,0,237709,237709,0,272783,510492
190920100700000,VACANT LAND,Commercial,0,44064,44064,0,0,44064
190920100800000,WAREHOUSE,Commercial,0,158976,158976,0,355346,514322
190920200100000,CITY PROPERTY,Exempt,0,0,0,0,0,0
190922600100000,CITY PROPERTY,Exempt,0,0,0,0,0,0
190922600200000,WAREHOUSE,Commercial,0,257760,257760,0,1207721,1465481
190922600300000,SERVICE STATION,Commercial,0,50625,50625,0,60737,111362
190922600400000,WAREHOUSE,Commercial,0,247171,247171,0,663120,910291
190922700100000,WAREHOUSE,Commercial,0,107600,107600,0,573818,681418
190925100100000,CITY PROPERTY,Exempt,0,0,0,0,0,0
190925100200000,SHOP,Commercial,0,89856,89856,0,312412,402268
190925100300000,VACANT LAND,Commercial,0,32746,32746,0,0,32746
190925100400000,FLAT PARKING,Commercial,0,16502,16502,0,14985,31487
190925100500000,CONC/ASPH;INDUSTRIAL,Industrial,0,244404,244404,0,390971,635375
190925100600000,FLAT PARKING,Commercial,0,254610,254610,0,21553,276163
190925200100000,SHOP,Commercial,0,68408,68408,0,476993,545401
190925200200000,SHOP,Commercial,0,50123,50123,0,257995,308118
190925200300000,OFFICE,Commercial,0,48195,48195,0,208725,256920
190925200400000,WAREHOUSE,Commercial,0,239220,239220,0,338266,577486
190927600100000,FRATERNAL,Commercial,0,224424,224424,0,1092496,1316920
190927600200000,SW 422,Residential,35652,0,35652,61511,0,97163
190927600300000,SW 422,Residential,29106,0,29106,120503,0,149609
190927600400000,OFFICE,Commercial,0,28948,28948,0,165514,194462
190930100100000,WAREHOUSE;MINI STORG,Commercial,0,178864,178864,0,627643,806507
190930100200000,CITY PROPERTY,Exempt,0,0,0,0,0,0
190930100300000,SW 426,Residential,26460,0,26460,57165,0,83625
190930100400000,SW 426,Residential,27720,0,27720,57321,0,85041
190930100500000,SW 426,Residential,27720,0,27720,59648,0,87368
190930100600000,SW 426,Residential,27720,0,27720,59060,0,86780
190930100700000,SW 426,Residential,27720,0,27720,44856,0,72576
190930100800000,SW 426,Residential,27720,0,27720,63106,0,90826
190930100900000,SW 426,Residential,27720,0,27720,58416,0,86136
190930101000000,SW 426,Residential,27720,0,27720,57392,0,85112
190930200100000,SW 426,Residential,29959,0,29959,63051,0,93010
190930200200000,SW 426,Residential,29296,0,29296,75346,0,104642
190930200300000,SW 426,Residential,29296,0,29296,84251,0,113547
190930200400000,SW 426,Residential,30277,0,30277,75713,0,105990
190930200500000,SW 426,Residential,29182,0,29182,85816,0,114998
190930200600000,SW 426,Residential,29182,0,29182,60922,0,90104
190930300100000,SW 426,Residential,29383,0,29383,106285,0,135668
190930300200000,SW 426,Residential,30429,0,30429,74664,0,105093
190930300300000,SW 426,Residential,29417,0,29417,60394,0,89811
190932600100000,SHOP,Commercial,0,172800,172800,0,414300,587100
190932600200000,SHOP,Commercial,0,169560,169560,0,74383,243943
190932600300000,SHOP,Commercial,0,87480,87480,0,480330,567810
190932600400000,WAREHOUSE,Commercial,0,92340,92340,0,258436,350776
190932600500000,VACANT LAND,Commercial,0,133650,133650,0,0,133650
190932600600000,WAREHOUSE,Commercial,0,206118,206118,0,1350766,1556884
190932600800000,SHOP,Commercial,0,237546,237546,0,492333,729879
190932600900000,WAREHOUSE,Commercial,0,212544,212544,0,140850,353394
190932601000000,SHOP,Commercial,0,174960,174960,0,694818,869778
190932601100000,SHOP,Commercial,0,227340,227340,0,361894,589234
190932601200000,VACANT LAND,Commercial,0,224748,224748,0,0,224748
190935100100000,SHOP,Commercial,0,154530,154530,0,542904,697434
190935100500000,WAREHOUSE,Commercial,0,146610,146610,0,771534,918144
190935100700000,VACANT LAND,Commercial,0,143640,143640,0,0,143640
190935100701000,SHOP,Commercial,0,6840,6840,0,84199,91039
190935100701001,SHOP,Commercial,0,6840,6840,0,93639,100479
190935100701002,SHOP,Commercial,0,6840,6840,0,64113,70953
190935100701003,SHOP,Commercial,0,6840,6840,0,59097,65937
190935100701004,SHOP,Commercial,0,6840,6840,0,59271,66111
190935100701005,SHOP,Commercial,0,6840,6840,0,79920,86760
190935100701006,SHOP,Commercial,0,6840,6840,0,99744,106584
190935100701007,SHOP,Commercial,0,6840,6840,0,59791,66631
190935100701008,SHOP,Commercial,0,6840,6840,0,59097,65937
190935100701009,SHOP,Commercial,0,6840,6840,0,59791,66631
190935100701010,SHOP,Commercial,0,6840,6840,0,61846,68686
190935100701011,SHOP,Commercial,0,6840,6840,0,59791,66631
190935100701012,SHOP,Commercial,0,6840,6840,0,59097,65937
190935100701013,SHOP,Commercial,0,6840,6840,0,63471,70311
190935100701014,SHOP,Commercial,0,6840,6840,0,104647,111487
190935100701015,SHOP,Commercial,0,6840,6840,0,99689,106529
190935100701016,SHOP,Commercial,0,6840,6840,0,152913,159753
190935100701017,SHOP,Commercial,0,6840,6840,0,77618,84458
190935100701018,SHOP,Commercial,0,6840,6840,0,55307,62147
190935100701019,SHOP,Commercial,0,6840,6840,0,57821,64661
190935100701020,SHOP,Commercial,0,6840,6840,0,67370,74210
190935100701021,SHOP,Commercial,0,6840,6840,0,134664,141504
190935100702000,BILLBOARD(BLL),Commercial,0,0,0,0,66106,66106
190935200300000,SMALL RETAIL,Commercial,0,253800,253800,0,284760,538560
190935200400000,WAREHOUSE,Commercial,0,144990,144990,0,590961,735951
190935200500000,SHOP,Commercial,0,103680,103680,0,239579,343259
190935200600000,WAREHOUSE,Commercial,0,135011,135011,0,949176,1084187
190935200700000,VACANT LAND,Commercial,0,129600,129600,0,0,129600
190935200800000,WAREHOUSE,Commercial,0,184140,184140,0,257595,441735
190935200900000,VACANT LAND,Industrial,0,68040,68040,0,0,68040
190935201000000,SHOP,Industrial,0,235062,235062,0,777813,1012875
190935300100000,SHOP,Commercial,0,94770,94770,0,298618,393388
190935300200000,VACANT LAND,Commercial,0,59454,59454,0,0,59454
190935300300000,WAREHOUSE,Commercial,0,66258,66258,0,168146,234404
190935300400000,SHOP,Commercial,0,141480,141480,0,523210,664690
190935300600000,SW 418,Residential,99700,0,99700,159775,0,259475
190935301001000,WAREHOUSE,Commercial,0,10260,10260,0,162267,172527
190935301001001,WAREHOUSE,Commercial,0,10260,10260,0,55286,65546
190935301001002,WAREHOUSE,Commercial,0,10260,10260,0,50060,60320
190935301001003,WAREHOUSE,Commercial,0,10260,10260,0,50060,60320
190935301001004,SHOP,Commercial,0,10260,10260,0,46690,56950
190935301100000,SW 418,Residential,149400,0,149400,0,0,149400
190935301200000,BARS/LOUNGE,Commercial,0,180144,180144,0,790899,971043
190937600100000,SW 426,Residential,29144,0,29144,78736,0,107880
190937600200000,SW 426,Residential,29144,0,29144,62870,0,92014
190937600300000,SW 426,Residential,29144,0,29144,98099,0,127243
190937600400000,SW 426,Residential,29144,0,29144,67160,0,96304
190937600500000,SW 426,Residential,29106,0,29106,54910,0,84016
190937600600000,SW 426,Residential,29106,0,29106,65093,0,94199
190937600700000,SW 426,Residential,29106,0,29106,106866,0,135972
190937600800000,SW 426,Residential,29106,0,29106,78703,0,107809
190937600900000,SW 426,Residential,29106,0,29106,65264,0,94370
190937601000000,SW 426,Residential,29144,0,29144,77037,0,106181
190937601100000,SW 426,Residential,29144,0,29144,66404,0,95548
190937601200000,SW 426,Residential,29144,0,29144,65359,0,94503
190937601300000,SW 426,Residential,29182,0,29182,62440,0,91622
190937601400000,SW 426,Residential,30277,0,30277,56933,0,87210
190937601500000,SW 426,Residential,29296,0,29296,80790,0,110086
190937601600000,SW 426,Residential,29296,0,29296,83521,0,112817
190937601700000,SW 426,Residential,29959,0,29959,63800,0,93759
190937601800000,SW 426,Residential,29182,0,29182,60868,0,90050
190937601900000,SW 426,Residential,29144,0,29144,69308,0,98452
190937602000000,SW 426,Residential,29144,0,29144,97819,0,126963
190937602100000,SW 426,Residential,29144,0,29144,63861,0,93005
190937602200000,SW 426,Residential,29106,0,29106,100481,0,129587
190937602300000,SW 426,Residential,29106,0,29106,107621,0,136727
190937602400000,SW 426,Residential,29106,0,29106,60943,0,90049
190937602500000,SW 426,Residential,29106,0,29106,75100,0,104206
190937602600000,SW 426,Residential,29106,0,29106,65907,0,95013
190937602700000,SW 426,Residential,29144,0,29144,58138,0,87282
190937602800000,SW 426,Residential,29144,0,29144,61673,0,90817
190937700100000,SW 426,Residential,30648,0,30648,57445,0,88093
190937700200000,SW 418,Ag Land,9521,0,9521,0,0,9521
190937700300000,SW 426,Residential,30174,0,30174,58183,0,88357
190937700400000,SW 426,Residential,30030,0,30030,72802,0,102832
190937700500000,SW 426,Residential,30648,0,30648,61112,0,91760
190937700600000,SW 426,Residential,31237,0,31237,85414,0,116651
190937700700000,SW 426,Residential,31515,0,31515,98637,0,130152
190937700800000,SW 426,Residential,31809,0,31809,58221,0,90030
190937700900000,SW 426,Residential,37422,0,37422,58758,0,96180
190937701000000,SW 426,Residential,31832,0,31832,76241,0,108073
190937701100000,SW 426,Residential,31249,0,31249,73739,0,104988
190937900100000,SW 426,Residential,28375,0,28375,75773,0,104148
190937900200000,SW 426,Residential,29484,0,29484,61755,0,91239
190937900300000,SW 426,Residential,29484,0,29484,86127,0,115611
190937900400000,SW 426,Residential,29484,0,29484,95003,0,124487
190937900500000,SW 426,Residential,27922,0,27922,66042,0,93964
190938000100000,SW 426,Residential,30878,0,30878,88247,0,119125
190938000200000,SW 426,Residential,30029,0,30029,65931,0,95960
190940100100000,CONVENIENCE STORE,Commercial,0,91584,91584,0,321877,413461
190940100200000,FLAT PARKING,Commercial,0,24019,24019,0,6036,30055
190940100300000,BARS/LOUNGE,Commercial,0,79396,79396,0,136862,216258
190940100700000,APARTMENT,Commercial,0,40446,40446,0,259554,300000
190940100800000,APARTMENT,Commercial,0,64260,64260,0,536679,600939
190940200100000,FAST FOOD,Commercial,0,221184,221184,0,434930,656114
190940200200000,VACANT LAND,Commercial,0,438048,438048,0,0,438048
190940200202000,BILLBOARD(BLL),Commercial,0,0,0,0,10525,10525
190942600100000,SW 426,Residential,31185,0,31185,65180,0,96365
190942600200000,SW 426,Residential,31185,0,31185,71163,0,102348
190942700100000,WAREHOUSE;MINI STORG,Commercial,0,286851,286851,0,1643198,1930049
190942700200000,SW 426,Residential,27720,0,27720,53977,0,81697
190942700300000,SW 426,Residential,27720,0,27720,83092,0,110812
190942700400000,SW 426,Residential,27720,0,27720,98073,0,125793
190942700500000,SW 426,Residential,27720,0,27720,68979,0,96699
190942700600000,SW 426,Residential,27720,0,27720,82726,0,110446
190942700700000,SW 426,Residential,31779,0,31779,75860,0,107639
190942700800000,SW 426,Residential,29960,0,29960,69861,0,99821
190942700900000,SW 426,Residential,29960,0,29960,91627,0,121587
190942701000000,SW 426,Residential,29960,0,29960,100403,0,130363
190942701100000,SW 426,Residential,29960,0,29960,61830,0,91790
190942701200000,SW 426,Residential,31779,0,31779,88390,0,120169
190942701300000,SW 426,Residential,29732,0,29732,117716,0,147448
190942701400000,SW 426,Residential,28875,0,28875,69454,0,98329
190942701500000,SW 426,Residential,28231,0,28231,62499,0,90730
190942800100000,SW 426,Residential,22750,0,22750,99418,0,122168
190942800200000,SW 426,Residential,30520,0,30520,3616,0,34136
190942800300000,SW 426,Residential,34125,0,34125,109131,0,143256
190942800400000,SW 426,Residential,19443,0,19443,74750,0,94193
190942800500000,SW 426,Residential,32151,0,32151,91823,0,123974
190942900100000,SW 426,Residential,30644,0,30644,95118,0,125762
190942900200000,SW 426,Residential,29054,0,29054,70318,0,99372
190942900300000,SW 426,Residential,29750,0,29750,72427,0,102177
190942900400000,SW 426,Residential,29750,0,29750,62735,0,92485
190942900500000,SW 426,Residential,29750,0,29750,93480,0,123230
190942900600000,SW 426,Residential,28996,0,28996,88060,0,117056
190942900700000,SW 426,Residential,28996,0,28996,109522,0,138518
190942900800000,SW 426,Residential,28996,0,28996,85519,0,114515
190942900900000,SW 426,Residential,28996,0,28996,79745,0,108741
190942901000000,SW 426,Residential,28996,0,28996,66114,0,95110
190943000100000,SW 426,Residential,30236,0,30236,85264,0,115500
190943000200000,SW 426,Residential,29839,0,29839,76657,0,106496
190943000300000,SW 426,Residential,30817,0,30817,73370,0,104187
190943000400000,SW 426,Residential,29417,0,29417,63827,0,93244
190943000500000,SW 426,Residential,29750,0,29750,62478,0,92228
190943000600000,SW 426,Residential,31475,0,31475,52351,0,83826
190943100100000,SW 426,Residential,30508,0,30508,70165,0,100673
190943100200000,SW 426,Residential,30047,0,30047,71852,0,101899
190943100300000,SW 426,Residential,29306,0,29306,64581,0,93887
190943100400000,SW 426,Residential,29839,0,29839,60747,0,90586
190943100500000,SW 426,Residential,29839,0,29839,66006,0,95845
190945100100000,SW 426,Residential,31249,0,31249,63191,0,94440
190945100200000,SW 426,Residential,30648,0,30648,76641,0,107289
190945100300000,SW 426,Residential,29738,0,29738,96751,0,126489
190945100400000,SW 426,Residential,30523,0,30523,74936,0,105459
190945100500000,SW 426,Residential,30336,0,30336,67859,0,98195
190945100600000,SW 426,Residential,30336,0,30336,63757,0,94093
190945100700000,SW 426,Residential,30336,0,30336,74806,0,105142
190945100800000,SW 426,Residential,30631,0,30631,96070,0,126701
190945100900000,SW 426,Residential,28929,0,28929,71999,0,100928
190945200100000,SW 426,Residential,28996,0,28996,93177,0,122173
190945200200000,SW 426,Residential,29750,0,29750,68581,0,98331
190945200300000,SW 426,Residential,29750,0,29750,65030,0,94780
190945200400000,SW 426,Residential,29750,0,29750,63846,0,93596
190945200500000,SW 426,Residential,29344,0,29344,93229,0,122573
190945200600000,SW 426,Residential,30200,0,30200,102551,0,132751
190945200700000,SW 426,Residential,29940,0,29940,63158,0,93098
190945200800000,SW 426,Residential,31238,0,31238,68410,0,99648
190945200900000,SW 426,Residential,30138,0,30138,62381,0,92519
190945201000000,SW 426,Residential,31372,0,31372,86539,0,117911
190945201100000,SW 426,Residential,32178,0,32178,95152,0,127330
190945201200000,SW 426,Residential,31187,0,31187,59109,0,90296
190945201300000,SW 426,Residential,33130,0,33130,71989,0,105119
190945201400000,SW 426,Residential,29750,0,29750,81196,0,110946
190945201500000,SW 426,Residential,30335,0,30335,71614,0,101949
190945201600000,SW 426,Residential,29960,0,29960,66187,0,96147
190945201700000,SW 426,Residential,29960,0,29960,78124,0,108084
190945201800000,SW 426,Residential,33630,0,33630,99825,0,133455
190945201900000,SW 426,Residential,29055,0,29055,93692,0,122747
190945202000000,SW 426,Residential,28996,0,28996,97112,0,126108
190945202100000,SW 426,Residential,28996,0,28996,111484,0,140480
190945202200000,SW 426,Residential,28996,0,28996,66856,0,95852
190945202300000,SW 426,Residential,30522,0,30522,77317,0,107839
190945202400000,SW 426,Residential,28996,0,28996,65401,0,94397
190945202500000,SW 426,Residential,28996,0,28996,63051,0,92047
190945202600000,SW 426,Residential,28996,0,28996,68773,0,97769
190945202700000,SW 426,Residential,28996,0,28996,89700,0,118696
190945300100000,SW 426,Residential,29750,0,29750,86031,0,115781
190945300200000,SW 426,Residential,30139,0,30139,59038,0,89177
190945300300000,SW 426,Residential,30051,0,30051,86523,0,116574
190945300400000,SW 426,Residential,29383,0,29383,67732,0,97115
190945300500000,SW 426,Residential,30051,0,30051,88793,0,118844
190945300600000,SW 426,Residential,30986,0,30986,62217,0,93203
190945300700000,SW 426,Residential,31080,0,31080,66518,0,97598
190945300800000,SW 426,Residential,31360,0,31360,88852,0,120212
190945300900000,SW 426,Residential,31360,0,31360,75661,0,107021
190945301000000,SW 426,Residential,32340,0,32340,61897,0,94237
190945301100000,SW 426,Residential,29750,0,29750,59642,0,89392
190945400100000,SW 426,Residential,29780,0,29780,80718,0,110498
190945400200000,SW 426,Residential,29780,0,29780,60220,0,90000
190945400300000,SW 426,Residential,29780,0,29780,74554,0,104334
190945400400000,SW 426,Residential,29750,0,29750,83586,0,113336
190945400500000,SW 426,Residential,29750,0,29750,104969,0,134719
190945400600000,SW 426,Residential,29750,0,29750,55514,0,85264
190945400700000,SW 426,Residential,29750,0,29750,66209,0,95959
190945400800000,SW 426,Residential,29780,0,29780,66237,0,96017
190945400900000,SW 426,Residential,29780,0,29780,80316,0,110096
190945401000000,SW 426,Residential,29839,0,29839,61445,0,91284
190945401100000,SW 426,Residential,29336,0,29336,95034,0,124370
190945401200000,SW 426,Residential,30047,0,30047,90965,0,121012
190945401300000,SW 426,Residential,30338,0,30338,87600,0,117938
190945401400000,SW 426,Residential,29839,0,29839,67933,0,97772
190945401500000,SW 426,Residential,29780,0,29780,74191,0,103971
190945401600000,SW 426,Residential,29780,0,29780,61573,0,91353
190945401700000,SW 426,Residential,29750,0,29750,86139,0,115889
190945401800000,SW 426,Residential,29750,0,29750,69776,0,99526
190945401900000,SW 426,Residential,29750,0,29750,70759,0,100509
190945402000000,SW 426,Residential,29750,0,29750,56930,0,86680
190945402100000,SW 426,Residential,29780,0,29780,74889,0,104669
190945500100000,SW 426,Residential,31280,0,31280,100631,0,131911
190945500200000,SW 426,Residential,29207,0,29207,63819,0,93026
190945500300000,SW 426,Residential,29207,0,29207,70471,0,99678
190945500400000,SW 426,Residential,29207,0,29207,80648,0,109855
190945600100000,SW 426,Residential,32794,0,32794,75509,0,108303
190945600200000,SW 426,Residential,2075,0,2075,0,0,2075
190945600300000,SW 426,Residential,29736,0,29736,74013,0,103749
190945600400000,SW 426,Residential,29640,0,29640,68478,0,98118
190945600500000,SW 426,Residential,29484,0,29484,98328,0,127812
190945600600000,SW 426,Residential,30047,0,30047,80374,0,110421
190945600700000,SW 426,Residential,30047,0,30047,75241,0,105288
190945600800000,SW 426,Residential,29750,0,29750,77177,0,106927
190945700100000,SW 426,Residential,35742,0,35742,105031,0,140773
190945700200000,SW 426,Residential,31436,0,31436,74340,0,105776
190945700300000,SW 426,Residential,29210,0,29210,72736,0,101946
190945700400000,SW 426,Residential,30926,0,30926,64980,0,95906
190945800100000,SW 426,Residential,28917,0,28917,65522,0,94439
190945800200000,SW 426,Residential,29750,0,29750,86021,0,115771
190945800300000,SW 426,Residential,30206,0,30206,75468,0,105674
190945800400000,SW 426,Residential,30127,0,30127,66058,0,96185
190945800500000,SW 426,Residential,29373,0,29373,76299,0,105672
190947600200000,APARTMENT,Commercial,0,255420,255420,0,2044580,2300000
190947600300000,CENTRALLY ASSESSED,Other,0,0,0,0,0,0
190947600400000,DAY CARE CENTER,Exempt,0,734050,734050,0,4482504,5216554
190947600500000,SECTION 42,Commercial,0,110700,110700,0,19610,130310
191010100100000,PAPER; INDUSTRIAL,Industrial,0,2245104,2245104,0,44546852,46791956
191020100100000,CENTRALLY ASSESSED,Other,0,0,0,0,0,0
191020100500000,WAREHOUSE,Commercial,0,351540,351540,0,6295958,6647498
191020100700000,VACANT LAND,Commercial,0,364932,364932,0,0,364932
191020100800000,SW 422,Ag Land,7698,0,7698,0,0,7698
191020200100000,WAREHOUSE,Commercial,0,254124,254124,0,1627941,1882065
191020200200000,SHOP,Commercial,0,264106,264106,0,676814,940920
191022600200000,VACANT LAND,Industrial,0,48600,48600,0,0,48600
191022600300000,MATERIALS MFG;INDUST,Industrial,0,334800,334800,0,3563502,3898302
191022600400000,VACANT LAND,Commercial,0,144176,144176,0,0,144176
191022700200000,VACANT LAND,Commercial,0,157594,157594,0,0,157594
191022700300000,EQUIPMENT MFG;INDUST,Industrial,0,263358,263358,0,3460333,3723691
191022700400000,OFFICE,Commercial,0,432000,432000,0,933650,1365650
191025100100000,WAREHOUSE,Commercial,0,190080,190080,0,623324,813404
191025100200000,WAREHOUSE,Commercial,0,216000,216000,0,1289199,1505199
191025100300000,WAREHOUSE,Commercial,0,186624,186624,0,595857,782481
191025100400000,VACANT LAND,Commercial,0,150237,150237,0,0,150237
191025200100000,CONC/ASPH;INDUSTRIAL,Industrial,0,393169,393169,0,1385941,1779110
191025200200000,OFFICE,Commercial,0,418176,418176,0,1492683,1910859
191027600100000,WAREHOUSE,Commercial,0,259632,259632,0,1032602,1292234
191027600200000,WAREHOUSE,Commercial,0,221378,221378,0,849575,1070953
191027700200000,WAREHOUSE,Commercial,0,388463,388463,0,1745973,2134436
191027700300000,VACANT LAND,Commercial,0,267570,267570,0,0,267570
191032600200000,SW 456,Ag Land,24819,0,24819,0,0,24819
191035100100000,STATE PROPERTY,Exempt,0,0,0,0,0,0
191035100600000,NBHD SHOPPING CENTER,Commercial,0,231120,231120,0,559226,790346
191035101100000,OFFICE,Commercial,0,25650,25650,0,108932,134582
191035101200000,CARWASH,Commercial,0,116640,116640,0,200447,317087
191037600100000,MFG HOME PARK,Commercial,0,3780108,3780108,0,2727366,6507474
191040100200000,VACANT LAND,Ag Land,4684,0,4684,0,0,4684
191040100300000,VACANT LAND,Commercial,0,341264,341264,0,0,341264
191040100400000,OFFICE,Commercial,0,548064,548064,0,8046520,8594584
191040200100000,VACANT LAND,Ag Land,4684,0,4684,0,0,4684
191040300100000,VACANT LAND,Commercial,0,1426,1426,0,0,1426
191042600100000,VACANT LAND,Ag Land,4721,0,4721,0,0,4721
191042600200000,VACANT LAND,Ag Land,6161,0,6161,0,0,6161
191042600300000,SCHOOL,Exempt,0,457272,457272,0,1207917,1665189
191042600400000,VACANT LAND,Ag Land,9150,0,9150,0,0,9150
191042600500000,VACANT LAND,Ag Land,9041,0,9041,0,0,9041
191042600600000,VACANT LAND,Ag Land,7182,0,7182,0,0,7182
191042600700000,VACANT LAND,Ag Land,6489,0,6489,0,0,6489
191042600800000,VACANT LAND,Ag Land,5887,0,5887,0,0,5887
191045100200000,DAY CARE CENTER,Commercial,0,164700,164700,0,1936782,2101482
191045100300000,SW 422,Ag Land,6890,0,6890,0,0,6890
191047600200000,FLAT PARKING,Commercial,0,224100,224100,0,68492,292592
191047600300000,SW 456,Ag Land,63387,0,63387,0,2663,66050
191110100100000,SW 422,Ag Land,29813,0,29813,0,0,29813
191110100200000,SW 422,Ag Land,15404,0,15404,0,0,15404
191112600100000,SW 423,Residential,36300,0,36300,258516,0,294816
191112600200000,SW 423,Residential,36300,0,36300,125670,0,161970
191112600300000,SW 423,Residential,36600,0,36600,169722,0,206322
191112700100000,SW 423,Ag Land,35520,0,35520,0,0,35520
191112700200000,CITY PROPERTY,Exempt,0,0,0,0,0,0
191112700300000,SW 423,Residential,45450,0,45450,51533,0,96983
191112700400000,SW 423,Residential,45150,0,45150,164330,0,209480
191112700500000,SW 423,Residential,37500,0,37500,44155,0,81655
191112700600000,SW 423,Residential,36900,0,36900,104198,0,141098
191112700700000,SW 423,Residential,11520,0,11520,0,0,11520
191112700800000,SW 423,Residential,36720,0,36720,77849,0,114569
191112700900000,SW 423,Residential,34200,0,34200,84841,0,119041
191112701100000,SW 423,Residential,34200,0,34200,111996,0,146196
191112701200000,SW 423,Residential,35190,0,35190,48892,0,84082
191115100100000,SW 423,Residential,36600,0,36600,157513,0,194113
191115100200000,SW 423,Residential,36600,0,36600,67250,0,103850
191115100300000,SW 423,Residential,36600,0,36600,120346,0,156946
191115100400000,SW 423,Residential,36600,0,36600,114031,0,150631
191115100500000,SW 423,Residential,36600,0,36600,76315,0,112915
191115100600000,SW 423,Residential,36600,0,36600,80172,0,116772
191115100700000,SW 423,Residential,36900,0,36900,112146,0,149046
191115100800000,SW 423,Residential,57950,0,57950,72179,0,130129
191115200100000,SW 423,Residential,33150,0,33150,80292,0,113442
191115200200000,SW 423,Residential,49650,0,49650,70864,0,120514
191115200300000,SW 423,Residential,40162,0,40162,707,0,40869
191115200400000,SW 423,Residential,39487,0,39487,57678,0,97165
191115200500000,SW 423,Residential,43605,0,43605,35596,0,79201
191115200600000,SW 423,Residential,39600,0,39600,36610,0,76210
191115200700000,SW 423,Residential,32940,0,32940,33286,0,66226
191115200800000,SW 423,Residential,14285,0,14285,110973,0,125258
191115200900000,SW 423,Residential,22125,0,22125,59412,0,81537
191115201000000,SW 423,Residential,21938,0,21938,45566,0,67504
191115201100000,SW 423,Residential,37294,0,37294,55186,0,92480
191115201200000,SW 423,Residential,36965,0,36965,56840,0,93805
191115201300000,SW 423,Residential,36975,0,36975,62788,0,99763
191115201400000,SW 423,Residential,29848,0,29848,115822,0,145670
191115201500000,SW 423,Residential,11761,0,11761,26485,0,38246
191115300100000,SW 423,Residential,44505,0,44505,49997,0,94502
191115300200000,SW 423,Residential,47900,0,47900,76685,0,124585
191115300300000,SW 423,Residential,46800,0,46800,43720,0,90520
191115300400000,SW 423,Residential,15302,0,15302,0,0,15302
191115300500000,SW 423,Residential,37584,0,37584,131720,0,169304
191117600100000,SW 422,Ag Land,48306,0,48306,0,0,48306
191117800100000,SW 423,Residential,58750,0,58750,118742,0,177492
191120100200000,SW 423,Residential,33210,0,33210,90159,0,123369
191120100300000,SW 423,Residential,33300,0,33300,96626,0,129926
191120100400000,SW 423,Residential,45630,0,45630,64407,0,110037
191120100500000,SW 423,Residential,35400,0,35400,29489,0,64889
191120100600000,SW 423,Residential,35400,0,35400,146188,0,181588
191120100700000,SW 423,Residential,35400,0,35400,109176,0,144576
191120100800000,SW 423,Residential,35400,0,35400,111709,0,147109
191120100900000,SW 423,Residential,35700,0,35700,0,0,35700
191120101000000,SW 423,Residential,48900,0,48900,113631,0,162531
191120101100000,SW 423,Residential,45250,0,45250,56914,0,102164
191120101200000,SW 423,Residential,45550,0,45550,20979,0,66529
191120101300000,SW 433,Residential,38750,0,38750,203363,0,242113
191120101400000,SW 433,Residential,36860,0,36860,148204,0,185064
191120101500000,SW 433,Residential,32253,0,32253,139007,0,171260
191120101600000,SW 433,Residential,36859,0,36859,147312,0,184171
191120101700000,SW 433,Residential,34555,0,34555,147276,0,181831
191120101800000,SW 433,Residential,32253,0,32253,143617,0,175870
191120101900000,SW 433,Residential,34556,0,34556,185543,0,220099
191120102000000,SW 433,Residential,36860,0,36860,134096,0,170956
191120102100000,SW 433,Residential,32253,0,32253,143641,0,175894
191120102200000,SW 433,Residential,36860,0,36860,165176,0,202036
191120102300000,SW 433,Residential,36860,0,36860,148723,0,185583
191120102400000,SW 433,Residential,34556,0,34556,127151,0,161707
191120102500000,SW 433,Residential,32253,0,32253,129590,0,161843
191120102600000,SW 433,Residential,29949,0,29949,0,0,29949
191120102700000,SW 433,Residential,32253,0,32253,126453,0,158706
191120102800000,SW 433,Residential,29949,0,29949,130865,0,160814
191120102900000,SW 433,Residential,32253,0,32253,0,0,32253
191120103000000,SW 433,Residential,39101,0,39101,0,0,39101
191120200100000,SW 433,Residential,37003,0,37003,206479,0,243482
191120200200000,SW 433,Residential,39216,0,39216,213042,0,252258
191120200300000,SW 433,Residential,38988,0,38988,172962,0,211950
191120200400000,SW 433,Residential,37107,0,37107,225242,0,262349
191120200500000,SW 433,Residential,37506,0,37506,218620,0,256126
191120200600000,SW 433,Residential,37506,0,37506,247169,0,284675
191120200700000,SW 422,Residential,6359,0,6359,0,0,6359
191120300100000,SW 433,Residential,39395,0,39395,197142,0,236537
191120300200000,SW 433,Residential,34096,0,34096,140048,0,174144
191120300300000,SW 433,Residential,32253,0,32253,152506,0,184759
191120300400000,SW 433,Residential,38368,0,38368,188132,0,226500
191120300500000,SW 433,Residential,32253,0,32253,150305,0,182558
191120300600000,SW 433,Residential,34095,0,34095,170342,0,204437
191120300700000,SW 433,Residential,32252,0,32252,158253,0,190505
191120300800000,SW 433,Residential,37782,0,37782,169812,0,207594
191120300900000,SW 433,Residential,32253,0,32253,0,0,32253
191120301000000,SW 433,Residential,35496,0,35496,182820,0,218316
191120301100000,SW 433,Residential,39395,0,39395,116831,0,156226
191120301200000,SW 433,Residential,41467,0,41467,164888,0,206355
191120301300000,SW 433,Residential,35496,0,35496,143593,0,179089
191120301400000,SW 433,Residential,32253,0,32253,162424,0,194677
191120301500000,SW 433,Residential,37781,0,37781,165904,0,203685
191120301600000,SW 433,Residential,32253,0,32253,158978,0,191231
191120301700000,SW 433,Residential,34096,0,34096,146947,0,181043
191120301800000,SW 433,Residential,32253,0,32253,147402,0,179655
191120301900000,SW 433,Residential,37782,0,37782,131149,0,168931
191120302000000,SW 433,Residential,32253,0,32253,141260,0,173513
191120302100000,SW 433,Residential,34096,0,34096,139319,0,173415
191120302200000,SW 433,Residential,41468,0,41468,150636,0,192104
191120400100000,SW 433,Residential,39330,0,39330,0,0,39330
191120400200000,SW 433,Residential,35913,0,35913,139069,0,174982
191120400300000,SW 433,Residential,36273,0,36273,149362,0,185635
191120400400000,CITY PROPERTY,Exempt,0,0,0,0,0,0
191120400500000,SW 433,Residential,32775,0,32775,139158,0,171933
191120400600000,SW 433,Residential,32776,0,32776,158997,0,191773
191120400700000,SW 433,Residential,30590,0,30590,154655,0,185245
191120400800000,SW 433,Residential,30591,0,30591,164499,0,195090
191120400900000,SW 433,Residential,30589,0,30589,161601,0,192190
191120401000000,SW 433,Residential,9919,0,9919,0,0,9919
191120401100000,SW 433,Residential,11700,0,11700,0,0,11700
191120500100000,SW 433,Residential,41468,0,41468,191602,0,233070
191120500200000,SW 433,Residential,34096,0,34096,138337,0,172433
191120500300000,SW 433,Residential,32253,0,32253,156851,0,189104
191120500400000,SW 433,Residential,37782,0,37782,150152,0,187934
191120500500000,SW 433,Residential,32253,0,32253,130746,0,162999
191120500600000,SW 433,Residential,34097,0,34097,202436,0,236533
191120500700000,SW 433,Residential,32253,0,32253,154684,0,186937
191120500800000,SW 433,Residential,37782,0,37782,174732,0,212514
191120500900000,SW 433,Residential,32254,0,32254,137679,0,169933
191120501000000,SW 433,Residential,35496,0,35496,0,0,35496
191120501100000,SW 433,Residential,41468,0,41468,145534,0,187002
191120501200000,SW 433,Residential,7122,0,7122,0,0,7122
191120501300000,SW 433,Residential,6104,0,6104,0,0,6104
191120501400000,SW 433,Residential,32253,0,32253,139194,0,171447
191120501500000,SW 433,Residential,6359,0,6359,0,0,6359
191120501600000,SW 433,Residential,32253,0,32253,145606,0,177859
191120501700000,SW 433,Residential,5850,0,5850,0,0,5850
191120501800000,SW 433,Residential,32253,0,32253,137470,0,169723
191120501900000,SW 433,Residential,6359,0,6359,0,0,6359
191120502000000,SW 433,Residential,32253,0,32253,129695,0,161948
191120502100000,SW 433,Residential,5850,0,5850,0,0,5850
191120502200000,SW 433,Residential,41468,0,41468,173268,0,214736
191120600100000,SW 433,Residential,35939,0,35939,149480,0,185419
191120600200000,SW 433,Residential,32253,0,32253,131394,0,163647
191120600300000,SW 433,Residential,32253,0,32253,156429,0,188682
191120600400000,SW 433,Residential,34556,0,34556,166010,0,200566
191120600500000,SW 433,Residential,5596,0,5596,0,0,5596
191120600600000,SW 433,Residential,32252,0,32252,167947,0,200199
191120600700000,SW 433,Residential,36860,0,36860,160634,0,197494
191120600800000,SW 433,Residential,5850,0,5850,0,0,5850
191120600900000,SW 433,Residential,32253,0,32253,127624,0,159877
191120601000000,SW 433,Residential,32253,0,32253,154009,0,186262
191120601100000,SW 433,Residential,35478,0,35478,163939,0,199417
191120601200000,SW 433,Residential,32253,0,32253,153196,0,185449
191120601300000,SW 433,Residential,34556,0,34556,7128,0,41684
191120601400000,SW 433,Residential,6359,0,6359,0,0,6359
191120601500000,SW 433,Residential,5596,0,5596,0,0,5596
191120601600000,SW 433,Residential,32253,0,32253,127026,0,159279
191120601700000,SW 433,Residential,5596,0,5596,0,0,5596
191120601800000,SW 433,Residential,14236,0,14236,0,0,14236
191122600100000,SW 422,Ag Land,2660,0,2660,0,0,2660
191122700100000,MISCELLANEOUS,Commercial,0,90180,90180,0,29106,119286
191122700102000,BILLBOARD(BLL),Commercial,0,0,0,0,12225,12225
191122700200000,FOOD GRADE;INDUST,Industrial,0,506196,506196,0,5177280,5683476
191122700300000,CENTRALLY ASSESSED,Other,0,0,0,0,0,0
191122700700000,FOOD GRADE;INDUST,Industrial,0,328320,328320,0,3552107,3880427
191125100100000,VACANT LAND,Industrial,0,359154,359154,0,0,359154
191127600200000,SW 423,Residential,45150,0,45150,50925,0,96075
191127600300000,SW 423,Residential,38398,0,38398,84602,0,123000
191127600400000,SW 423,Residential,12465,0,12465,3979,0,16444
191127600500000,SW 423,Residential,7515,0,7515,33353,0,40868
191127600600000,SW 423,Residential,24525,0,24525,0,0,24525
191127600700000,SW 423,Residential,2740,0,2740,0,0,2740
191127600800000,SW 423,Residential,5620,0,5620,0,0,5620
191127600900000,SW 423,Residential,41265,0,41265,70663,0,111928
191127601000000,SW 423,Residential,40800,0,40800,221389,0,262189
191127601100000,SW 423,Residential,37471,0,37471,61299,0,98770
191127601200000,SW 423,Residential,35635,0,35635,55611,0,91246
191127601300000,SW 423,Residential,41625,0,41625,123395,0,165020
191127601400000,SW 423,Residential,37584,0,37584,103248,0,140832
191127601500000,SW 423,Residential,34749,0,34749,39576,0,74325
191127601600000,SW 423,Residential,35343,0,35343,43842,0,79185
191127601700000,SW 423,Residential,35700,0,35700,69211,0,104911
191127601800000,SW 423,Residential,45900,0,45900,58114,0,104014
191127601900000,SW 423,Residential,40650,0,40650,1065,0,41715
191127602000000,SW 423,Residential,24945,0,24945,75425,0,100370
191127602100000,SW 423,Residential,25847,0,25847,153892,0,179739
191127602300000,SW 423,Residential,37296,0,37296,168629,0,205925
191127602400000,SW 423,Residential,32046,0,32046,0,0,32046
191127602500000,SW 423,Residential,46154,0,46154,0,0,46154
191127700100000,SW 422,Residential,49400,0,49400,133185,0,182585
191127700200000,SW 422,Residential,50302,0,50302,85300,0,135602
191127700300000,SW 422,Residential,46700,0,46700,99111,0,145811
191127900100000,SW 423,Residential,31987,0,31987,94436,0,126423
191127900200000,SW 423,Residential,32825,0,32825,127385,0,160210
191127900300000,SW 423,Residential,48500,0,48500,130034,0,178534
191127900400000,SW 423,Residential,2315,0,2315,0,0,2315
191127900500000,SW 423,Residential,31473,0,31473,83792,0,115265
191132600100000,WAREHOUSE,Commercial,0,728084,728084,0,7956584,8684668
191135100200000,SW 450,Residential,35646,0,35646,0,0,35646
191135100300000,SW 450,Residential,35750,0,35750,111714,0,147464
191135100400000,SW 450,Residential,35937,0,35937,170389,0,206326
191135100500000,SW 450,Residential,36850,0,36850,135992,0,172842
191135100600000,SW 450,Residential,35750,0,35750,175495,0,211245
191135100700000,SW 450,Residential,35750,0,35750,148228,0,183978
191135100800000,SW 450,Residential,35750,0,35750,137250,0,173000
191135100900000,SW 450,Residential,35750,0,35750,160851,0,196601
191135101000000,SW 450,Residential,35750,0,35750,132541,0,168291
191135101100000,SW 450,Residential,35750,0,35750,136494,0,172244
191135101200000,SW 450,Residential,36108,0,36108,144927,0,181035
191135101300000,SW 450,Residential,35039,0,35039,0,0,35039
191135101600000,SW 450,Residential,32942,0,32942,0,0,32942
191135101700000,SW 450,Residential,29520,0,29520,0,0,29520
191135101900000,SW 450,Residential,38057,0,38057,139818,0,177875
191135102000000,SW 450,Residential,42928,0,42928,146808,0,189736
191135102100000,SW 450,Residential,43313,0,43313,123202,0,166515
191135102200000,SW 450,Residential,38500,0,38500,141747,0,180247
191135102300000,SW 450,Residential,51749,0,51749,146589,0,198338
191135200100000,SW 450,Residential,36000,0,36000,134764,0,170764
191135200200000,SW 450,Residential,33948,0,33948,155782,0,189730
191135300100000,SW 450,Residential,35572,0,35572,139829,0,175401
191135300200000,SW 450,Residential,38142,0,38142,143991,0,182133
191135300300000,SW 450,Residential,35750,0,35750,147627,0,183377
191135300400000,SW 450,Residential,37033,0,37033,145736,0,182769
191135400100000,SW 450,Residential,35748,0,35748,140368,0,176116
191135400200000,SW 450,Residential,35750,0,35750,154042,0,189792
191135400300000,SW 450,Residential,35750,0,35750,130582,0,166332
191135400400000,SW 450,Residential,44468,0,44468,0,0,44468
191135400500000,SW 450,Residential,37583,0,37583,153538,0,191121
191135400600000,SW 450,Residential,37583,0,37583,156532,0,194115
191135400700000,SW 450,Residential,37033,0,37033,153591,0,190624
191135400800000,SW 450,Residential,35750,0,35750,154832,0,190582
191135500200000,CARWASH,Commercial,0,157421,157421,0,206097,363518
191135500300000,NBHD SHOPPING CENTER,Commercial,0,325685,325685,0,1253042,1578727
191135500400000,VACANT LAND,Commercial,0,184896,184896,0,0,184896
191135500500000,CONVENIENCE STORE,Commercial,0,222912,222912,0,754235,977147
191135600100000,DAY CARE CENTER,Commercial,0,228096,228096,0,627965,856061
191135700100000,SW 450,Residential,36227,0,36227,173619,0,209846
191135700200000,SW 450,Residential,33433,0,33433,128861,0,162294
191137700200000,CITY PROPERTY,Exempt,0,0,0,0,0,0
191137701200000,SW 450,Residential,23215,0,23215,156977,0,180192
191137701300000,SW 450,Residential,37142,0,37142,156954,0,194096
191137701400000,SW 450,Residential,36185,0,36185,145546,0,181731
191137701500000,SW 450,Residential,37511,0,37511,153699,0,191210
191137701600000,CITY PROPERTY,Exempt,0,0,0,0,0,0
191137701700000,SW 450,Residential,37583,0,37583,131958,0,169541
191137701800000,SW 450,Residential,37207,0,37207,153519,0,190726
191137701900000,SW 450,Residential,37570,0,37570,183073,0,220643
191137702000000,SW 450,Residential,38329,0,38329,159735,0,198064
191137702100000,SW 450,Residential,37959,0,37959,134706,0,172665
191137702200000,SW 450,Residential,36663,0,36663,168150,0,204813
191137702300000,SW 450,Residential,36663,0,36663,147185,0,183848
191137702400000,SW 450,Residential,36385,0,36385,157135,0,193520
191137702500000,SW 450,Residential,36385,0,36385,172186,0,208571
191137702600000,SW 450,Residential,36107,0,36107,172515,0,208622
191137702700000,SW 450,Residential,41107,0,41107,148627,0,189734
191137702800000,SW 450,Residential,38187,0,38187,179251,0,217438
191137702900000,SW 450,Residential,41717,0,41717,130191,0,171908
191137703000000,SW 450,Residential,56895,0,56895,134399,0,191294
191137703100000,SW 450,Residential,47285,0,47285,164018,0,211303
191137703200000,SW 450,Residential,38317,0,38317,136587,0,174904
191137703300000,SW 450,Residential,35750,0,35750,154985,0,190735
191137703400000,SW 450,Residential,33183,0,33183,145858,0,179041
191137800100000,SW 450,Residential,45045,0,45045,135728,0,180773
191137800200000,SW 450,Residential,38500,0,38500,146281,0,184781
191137800300000,SW 450,Residential,38885,0,38885,143399,0,182284
191137800400000,SW 450,Residential,39270,0,39270,138852,0,178122
191137800500000,SW 450,Residential,39270,0,39270,150751,0,190021
191137800600000,SW 450,Residential,40993,0,40993,151116,0,192109
191137800700000,SW 450,Residential,37114,0,37114,150534,0,187648
191137800800000,SW 450,Residential,35393,0,35393,136706,0,172099
191137800900000,SW 450,Residential,35750,0,35750,144799,0,180549
191137801000000,SW 450,Residential,35665,0,35665,146048,0,181713
191222600300000,SW 447,Residential,46368,0,46368,199166,0,245534
191222600400000,SW 447,Residential,74602,0,74602,227287,0,301889
191222600500000,SW 447,Residential,2124,0,2124,0,0,2124
191222600600000,SW 447,Residential,61740,0,61740,264675,0,326415
191222600700000,SW 447,Residential,2314,0,2314,0,0,2314
191222600800000,SW 447,Residential,71969,0,71969,58316,0,130285
191222600900000,SW 447,Residential,2791,0,2791,0,0,2791
191222601000000,SW 447,Residential,64185,0,64185,210765,0,274950
191222601100000,SW 447,Residential,56927,0,56927,252621,0,309548
191222601200000,SW 447,Residential,66281,0,66281,296832,0,363113
191222601300000,SW 447,Residential,66587,0,66587,311553,0,378140
191222601400000,SW 447,Residential,3948,0,3948,0,0,3948
191222601500000,SW 447,Residential,69006,0,69006,275130,0,344136
191222601600000,SW 447,Residential,3199,0,3199,0,0,3199
191222601700000,SW 447,Residential,3131,0,3131,0,0,3131
191222601800000,SW 447,Residential,63665,0,63665,282109,0,345774
191222601900000,SW 447,Residential,63665,0,63665,246868,0,310533
191222602000000,SW 447,Residential,63665,0,63665,277558,0,341223
191222602100000,SW 447,Residential,67410,0,67410,245634,0,313044
191222602200000,SW 447,Residential,67410,0,67410,233442,0,300852
191222602400000,SW 447,Residential,67519,0,67519,0,0,67519
191222602500000,SW 447,Residential,1889,0,1889,0,0,1889
191222602600000,SW 447,Residential,2360,0,2360,0,0,2360
191222602700000,SW 447,Residential,2386,0,2386,0,0,2386
191222602800000,SW 447,Residential,2386,0,2386,0,0,2386
191222602900000,SW 447,Residential,4913,0,4913,0,0,4913
191222603000000,SW 447,Residential,3790,0,3790,0,0,3790
191222603100000,SW 447,Residential,3860,0,3860,0,0,3860
191222603200000,SW 447,Residential,2176,0,2176,0,0,2176
191222603300000,SW 447,Residential,2316,0,2316,0,0,2316
191222603400000,SW 447,Residential,60669,0,60669,316499,0,377168
191222603500000,SW 447,Residential,2386,0,2386,0,0,2386
191222603600000,SW 447,Residential,2456,0,2456,0,0,2456
191222603700000,SW 447,Residential,113350,0,113350,0,0,113350
191222700100000,SW 447,Residential,25,0,25,0,0,25
191225200100000,SW 447,Residential,855,0,855,0,0,855
191225200200000,SW 447,Residential,46703,0,46703,227289,0,273992
191225200300000,SW 447,Residential,48061,0,48061,119756,0,167817
191225200400000,SW 447,Residential,48020,0,48020,161837,0,209857
191225200500000,SW 447,Residential,47355,0,47355,154382,0,201737
191225200600000,SW 447,Residential,53865,0,53865,156757,0,210622
191225200700000,SW 447,Residential,47971,0,47971,197985,0,245956
191225200800000,SW 447,Residential,54264,0,54264,162352,0,216616
191225200900000,SW 447,Residential,48879,0,48879,214440,0,263319
191225201000000,SW 447,Residential,45080,0,45080,194631,0,239711
191225201100000,SW 447,Residential,56672,0,56672,141189,0,197861
191225201200000,SW 447,Residential,56,0,56,0,0,56
191225201300000,SW 447,Residential,49259,0,49259,127171,0,176430
191225201400000,SW 447,Residential,44483,0,44483,185280,0,229763
191225201500000,SW 447,Residential,48777,0,48777,238450,0,287227
191225201600000,SW 447,Residential,48300,0,48300,234039,0,282339
191225201700000,SW 447,Residential,46368,0,46368,286877,0,333245
191225201800000,SW 447,Residential,48300,0,48300,228407,0,276707
191225201900000,SW 447,Residential,50232,0,50232,160630,0,210862
191225202000000,SW 447,Residential,50232,0,50232,213032,0,263264
191225202100000,SW 447,Residential,46368,0,46368,224272,0,270640
191225202200000,SW 447,Residential,49214,0,49214,221165,0,270379
191225202300000,SW 447,Residential,1231,0,1231,0,0,1231
191225300100000,SW 447,Residential,50232,0,50232,208746,0,258978
191225300200000,SW 447,Residential,51520,0,51520,207905,0,259425
191225300300000,SW 447,Residential,48300,0,48300,237292,0,285592
191225300400000,SW 447,Residential,48300,0,48300,201643,0,249943
191225300500000,SW 447,Residential,51520,0,51520,163234,0,214754
191225300600000,SW 447,Residential,48300,0,48300,193787,0,242087
191225300700000,SW 447,Residential,46368,0,46368,205869,0,252237
191225300800000,SW 447,Residential,50232,0,50232,212597,0,262829
191225300900000,SW 447,Residential,56213,0,56213,200296,0,256509
191225301000000,SW 447,Residential,44,0,44,0,0,44
191225301100000,SW 447,Residential,145,0,145,0,0,145
191225301200000,SW 447,Residential,202,0,202,0,0,202
191225301300000,SW 447,Residential,57876,0,57876,193531,0,251407
191225301400000,SW 447,Residential,57708,0,57708,262996,0,320704
191225301500000,SW 447,Residential,54880,0,54880,289523,0,344403
191225301600000,SW 447,Residential,218,0,218,0,0,218
191225301700000,SW 447,Residential,254,0,254,0,0,254
191225301800000,SW 447,Residential,1011,0,1011,0,0,1011
191225400100000,SW 447,Residential,618,0,618,0,0,618
191225400200000,SW 447,Residential,69090,0,69090,239060,0,308150
191225400300000,SW 447,Residential,70686,0,70686,244398,0,315084
191225400400000,SW 447,Residential,56538,0,56538,224716,0,281254
191225400500000,SW 447,Residential,53669,0,53669,290100,0,343769
191225400600000,SW 447,Residential,51378,0,51378,163528,0,214906
191225400700000,SW 447,Residential,51378,0,51378,205758,0,257136
191225400800000,SW 447,Residential,51378,0,51378,218196,0,269574
191225400900000,SW 447,Residential,51378,0,51378,153349,0,204727
191225401000000,SW 447,Residential,50806,0,50806,204513,0,255319
191225401100000,SW 447,Residential,2973,0,2973,0,0,2973
191225401200000,SW 447,Residential,293,0,293,0,0,293
191225401300000,SW 447,Residential,306,0,306,0,0,306
191225401400000,SW 447,Residential,367,0,367,0,0,367
191225401500000,SW 447,Residential,318,0,318,0,0,318
191225401600000,SW 447,Residential,342,0,342,0,0,342
191225401700000,SW 447,Residential,513,0,513,0,0,513
191225500100000,SW 447,Residential,258,0,258,0,0,258
191225500200000,SW 447,Residential,65674,0,65674,233191,0,298865
191225500300000,SW 447,Residential,67410,0,67410,231679,0,299089
191225500400000,SW 447,Residential,67410,0,67410,217659,0,285069
191225500500000,SW 422,Residential,666,0,666,0,0,666
191225600100000,SW 447,Residential,367,0,367,0,0,367
191225600200000,SW 447,Residential,367,0,367,0,0,367
191225600300000,SW 447,Residential,403,0,403,0,0,403
191225600400000,SW 447,Residential,562,0,562,0,0,562
191225600500000,SW 447,Residential,966,0,966,0,0,966
191225700100000,SW 447,Residential,574,0,574,0,0,574
191412700200000,SW 449,Residential,35669,0,35669,0,0,35669
191412700300000,SW 449,Residential,37171,0,37171,0,0,37171
191412700400000,SW 449,Residential,37171,0,37171,0,0,37171
191412700500000,SW 449,Residential,37558,0,37558,0,0,37558
191412700600000,SW 449,Residential,37946,0,37946,0,0,37946
191412700700000,SW 449,Residential,37946,0,37946,0,0,37946
191412700800000,SW 449,Residential,38333,0,38333,0,0,38333
191412700900000,SW 449,Residential,38333,0,38333,0,0,38333
191412800100000,SW 449,Residential,34910,0,34910,0,0,34910
191412800200000,SW 449,Residential,34530,0,34530,0,0,34530
191412800300000,SW 449,Residential,34910,0,34910,0,0,34910
191412800400000,SW 449,Residential,35088,0,35088,0,0,35088
191412800500000,SW 449,Residential,50666,0,50666,146404,0,197070
191412800600000,SW 449,Residential,46362,0,46362,0,0,46362
191412800700000,SW 449,Residential,47097,0,47097,0,0,47097
191412900100000,SW 449,Residential,45521,0,45521,0,0,45521
191412900200000,SW 449,Residential,52250,0,52250,0,0,52250
191412900300000,SW 449,Residential,52250,0,52250,211636,0,263886
191412900400000,SW 449,Residential,53592,0,53592,209654,0,263246
191412900500000,SW 449,Residential,52250,0,52250,189576,0,241826
191412900600000,SW 449,Residential,51700,0,51700,191629,0,243329
191412900700000,SW 449,Residential,53975,0,53975,178851,0,232826
191412900800000,SW 449,Residential,44528,0,44528,0,0,44528
191412900900000,SW 449,Residential,48510,0,48510,189381,0,237891
191412901000000,SW 449,Residential,53900,0,53900,226879,0,280779
191412901100000,SW 449,Residential,52800,0,52800,197187,0,249987
191412901200000,SW 449,Residential,46166,0,46166,0,0,46166
191412901300000,SW 449,Residential,61383,0,61383,255768,0,317151
191412901400000,SW 449,Residential,58144,0,58144,266796,0,324940
191412901500000,SW 449,Residential,52272,0,52272,234939,0,287211
191412901600000,SW 449,Residential,46861,0,46861,0,0,46861
191412901700000,SW 449,Residential,46710,0,46710,0,0,46710
191412901800000,SW 449,Residential,46406,0,46406,0,0,46406
191412901900000,SW 449,Residential,47743,0,47743,0,0,47743
191412902000000,SW 449,Residential,45980,0,45980,0,0,45980
191413000100000,SW 449,Residential,53656,0,53656,214149,0,267805
191413000200000,SW 449,Residential,54313,0,54313,218340,0,272653
191413000300000,SW 449,Residential,56508,0,56508,187866,0,244374
191413000400000,SW 449,Residential,53350,0,53350,197066,0,250416
191413000500000,SW 449,Residential,45980,0,45980,0,0,45980
191413000600000,SW 449,Residential,52250,0,52250,231341,0,283591
191413000700000,SW 449,Residential,52773,0,52773,176889,0,229662
191413000800000,SW 449,Residential,46440,0,46440,0,0,46440
191413000900000,SW 449,Residential,52250,0,52250,194483,0,246733
191413001000000,SW 449,Residential,52250,0,52250,230358,0,282608
191413001100000,SW 449,Residential,52250,0,52250,222536,0,274786
191413100100000,SW 449,Residential,45980,0,45980,0,0,45980
191413100200000,SW 449,Residential,46900,0,46900,0,0,46900
191413100300000,SW 449,Residential,46900,0,46900,0,0,46900
191415200200000,SW 422,Ag Land,2663,0,2663,0,0,2663
191415300100000,SW 449,Residential,38333,0,38333,0,0,38333
191415300200000,SW 449,Residential,37946,0,37946,0,0,37946
191415400100000,SW 449,Residential,45980,0,45980,0,0,45980
191415400200000,SW 449,Residential,45980,0,45980,0,0,45980
191415400300000,SW 449,Residential,45980,0,45980,0,0,45980
191415400400000,SW 449,Residential,52250,0,52250,217778,0,270028
191415400500000,SW 449,Residential,52250,0,52250,185010,0,237260
191415400600000,SW 449,Residential,52250,0,52250,219427,0,271677
191415400700000,SW 449,Residential,52800,0,52800,0,0,52800
191415400800000,SW 449,Residential,67300,0,67300,248704,0,316004
191415400900000,SW 449,Residential,46464,0,46464,0,0,46464
191415401000000,SW 449,Residential,52250,0,52250,162659,0,214909
191415401100000,SW 449,Residential,52250,0,52250,176974,0,229224
191415401200000,SW 449,Residential,47819,0,47819,0,0,47819
191415401300000,SW 449,Residential,47819,0,47819,0,0,47819
191415401400000,SW 449,Residential,45980,0,45980,0,0,45980
191415401500000,SW 449,Residential,45980,0,45980,0,0,45980
191415401600000,SW 449,Residential,45980,0,45980,0,0,45980
191415401700000,SW 449,Residential,52250,0,52250,222550,0,274800
191415401800000,SW 449,Residential,52250,0,52250,220987,0,273237
191415401900000,SW 449,Residential,54450,0,54450,168686,0,223136
191415402000000,SW 449,Residential,53900,0,53900,233698,0,287598
191415402100000,SW 449,Residential,54450,0,54450,252381,0,306831
191415402200000,SW 449,Residential,55128,0,55128,159284,0,214412
191415402300000,SW 449,Residential,48091,0,48091,0,0,48091
191415402400000,SW 449,Residential,53519,0,53519,343246,0,396765
191415402500000,SW 449,Residential,54554,0,54554,164687,0,219241
191415402600000,SW 449,Residential,55907,0,55907,210381,0,266288
191415402700000,SW 449,Residential,55349,0,55349,8836,0,64185
191415402800000,SW 449,Residential,48174,0,48174,0,0,48174
191415402900000,SW 449,Residential,46510,0,46510,0,0,46510
191415403000000,SW 449,Residential,52978,0,52978,210607,0,263585
191415403100000,SW 449,Residential,48721,0,48721,0,0,48721
191415403200000,SW 449,Residential,47623,0,47623,0,0,47623
191415403300000,SW 449,Residential,46196,0,46196,0,0,46196
191415403400000,SW 449,Residential,54262,0,54262,171700,0,225962
191415403500000,SW 449,Residential,46592,0,46592,0,0,46592
191415403600000,SW 449,Residential,46973,0,46973,0,0,46973
191415500100000,SW 449,Residential,52250,0,52250,191630,0,243880
191415500200000,SW 449,Residential,50149,0,50149,234110,0,284259
191415500300000,SW 449,Residential,52772,0,52772,286412,0,339184
191415500400000,SW 449,Residential,43747,0,43747,195442,0,239189
191415500500000,SW 449,Residential,49368,0,49368,214930,0,264298
191415500600000,SW 449,Residential,51612,0,51612,255109,0,306721
191415500700000,SW 449,Residential,48048,0,48048,176008,0,224056
191415500800000,SW 449,Residential,48576,0,48576,230481,0,279057
191415500900000,SW 449,Residential,48576,0,48576,191308,0,239884
191415501000000,SW 449,Residential,48576,0,48576,194744,0,243320
191415501100000,SW 449,Residential,48576,0,48576,183749,0,232325
191415501200000,SW 449,Residential,48576,0,48576,191667,0,240243
191415501300000,SW 449,Residential,48070,0,48070,177229,0,225299
191415501400000,SW 449,Residential,51700,0,51700,165044,0,216744
191415600100000,SW 449,Residential,41382,0,41382,0,0,41382
191415600200000,SW 449,Residential,46064,0,46064,0,0,46064
191415600300000,SW 449,Residential,49500,0,49500,228503,0,278003
191415600400000,SW 449,Residential,50600,0,50600,232784,0,283384
191415600500000,SW 449,Residential,52250,0,52250,222954,0,275204
191415600600000,SW 449,Residential,53900,0,53900,202250,0,256150
191415600700000,SW 449,Residential,54450,0,54450,188502,0,242952
191415600800000,SW 449,Residential,54450,0,54450,208833,0,263283
191415600900000,SW 449,Residential,50967,0,50967,298672,0,349639
191415601000000,SW 449,Residential,48091,0,48091,0,0,48091
191415601100000,SW 449,Residential,48110,0,48110,0,0,48110
191415601200000,SCHOOL,Exempt,0,0,0,0,0,0
191415601300000,SW 449,Residential,48884,0,48884,0,0,48884
191415601400000,SW 449,Residential,48400,0,48400,0,0,48400
191415601500000,SW 449,Residential,47916,0,47916,0,0,47916
191415601600000,SW 449,Residential,46948,0,46948,0,0,46948
191415601700000,SW 449,Residential,51062,0,51062,0,0,51062
191415601800000,SW 449,Residential,49116,0,49116,0,0,49116
191415700100000,SW 449,Residential,47596,0,47596,0,0,47596
191415700200000,SW 449,Residential,55427,0,55427,206312,0,261739
191415700300000,SW 449,Residential,48510,0,48510,221826,0,270336
191415700400000,SW 449,Residential,48787,0,48787,0,0,48787
191415700500000,SW 449,Residential,52283,0,52283,228234,0,280517
191415700600000,SW 449,Residential,46284,0,46284,0,0,46284
191415700700000,SW 449,Residential,42471,0,42471,224939,0,267410
191415700800000,SW 449,Residential,49500,0,49500,168709,0,218209
191415700900000,CITY PROPERTY,Exempt,0,0,0,0,0,0
191415800100000,SW 449,Residential,48070,0,48070,223051,0,271121
191415800200000,SW 449,Residential,48593,0,48593,201695,0,250288
191415800300000,SW 449,Residential,48593,0,48593,250802,0,299395
191415800400000,SW 449,Residential,48593,0,48593,210800,0,259393
191415800500000,SW 449,Residential,48593,0,48593,196582,0,245175
191415800600000,SW 449,Residential,49115,0,49115,8836,0,57951
191415800700000,SW 449,Residential,43221,0,43221,0,0,43221
191415800800000,SW 449,Residential,47645,0,47645,0,0,47645
191415800900000,SW 449,Residential,48929,0,48929,0,0,48929
191415801000000,CITY PROPERTY,Exempt,0,0,0,0,0,0
191417700200000,SW 449,Residential,39270,0,39270,201052,0,240322
191417700300000,SW 449,Residential,44861,0,44861,0,0,44861
191417700400000,SW 449,Residential,43192,0,43192,0,0,43192
191417700500000,SW 449,Residential,43192,0,43192,0,0,43192
191417700600000,SW 449,Residential,42470,0,42470,0,0,42470
191417700700000,SW 449,Residential,48381,0,48381,0,0,48381
191417800100000,SW 449,Residential,49148,0,49148,0,0,49148
191417800200000,SW 449,Residential,48091,0,48091,0,0,48091
191417800300000,SW 449,Residential,45521,0,45521,0,0,45521
191417800400000,SW 449,Residential,45980,0,45980,0,0,45980
191417900100000,SW 449,Residential,37426,0,37426,0,0,37426
191417900200000,SW 449,Residential,31188,0,31188,0,0,31188
191417900300000,SW 449,Residential,29613,0,29613,0,0,29613
191417900400000,CITY PROPERTY,Exempt,0,0,0,0,0,0
191418000100000,SW 449,Residential,41842,0,41842,0,0,41842
191418000200000,SW 449,Residential,48070,0,48070,193278,0,241348
191418000300000,SW 449,Residential,48070,0,48070,210734,0,258804
191420100200000,CITY PROPERTY,Exempt,0,0,0,0,0,0
191420100300000,SW 449,Residential,47770,0,47770,0,0,47770
191420100400000,SW 449,Residential,46948,0,46948,0,0,46948
191420100500000,SW 449,Residential,53350,0,53350,191964,0,245314
191420100600000,SW 449,Residential,52800,0,52800,203901,0,256701
191420100700000,SW 449,Residential,54789,0,54789,231604,0,286393
191420100800000,SW 449,Residential,63595,0,63595,200934,0,264529
191420100900000,SW 449,Residential,57596,0,57596,267018,0,324614
191420101000000,SW 449,Residential,65831,0,65831,280172,0,346003
191420101100000,SW 449,Residential,60977,0,60977,202346,0,263323
191420101200000,SW 449,Residential,53955,0,53955,194368,0,248323
191420101300000,SW 449,Residential,53817,0,53817,180483,0,234300
191420101400000,SW 449,Residential,52250,0,52250,196811,0,249061
191420101500000,SW 449,Residential,54355,0,54355,176175,0,230530
191420101600000,SW 449,Residential,55385,0,55385,208226,0,263611
191420101700000,SW 449,Residential,63692,0,63692,271780,0,335472
191420101800000,SW 449,Residential,53906,0,53906,209158,0,263064
191420101900000,SW 449,Residential,54450,0,54450,185743,0,240193
191420102000000,SW 449,Residential,53900,0,53900,247238,0,301138
191420102100000,SW 449,Residential,53900,0,53900,257628,0,311528
191420102200000,SW 449,Residential,58551,0,58551,216954,0,275505
191420102300000,SW 449,Residential,59717,0,59717,211707,0,271424
191420102400000,SW 449,Residential,56907,0,56907,202592,0,259499
191420102700000,SW 450,Residential,10504,0,10504,0,0,10504
191420200100000,SW 449,Residential,54340,0,54340,233800,0,288140
191420200200000,SW 449,Residential,55000,0,55000,231672,0,286672
191420200300000,SW 449,Residential,55678,0,55678,183697,0,239375
191420200400000,SW 449,Residential,52250,0,52250,193761,0,246011
191420200500000,SW 449,Residential,43124,0,43124,0,0,43124
191420200600000,SW 449,Residential,48739,0,48739,0,0,48739
191420200700000,SW 449,Residential,45060,0,45060,0,0,45060
191420200800000,SW 449,Residential,45060,0,45060,0,0,45060
191420200900000,SW 449,Residential,45214,0,45214,0,0,45214
191420201000000,SW 449,Residential,48168,0,48168,0,0,48168
191420300100000,SW 450,Residential,283,0,283,0,0,283
191420300200000,SW 450,Residential,814,0,814,0,0,814
191420300300000,SW 450,Residential,831,0,831,0,0,831
191420300400000,SW 450,Residential,416,0,416,0,0,416
191420300500000,SW 450,Ag Land,5443,0,5443,0,0,5443
191422600100000,SW 456,Ag Dwelling,34761,0,34761,58785,5699,99245
191422600200000,SW 456,Residential,66000,0,66000,85256,0,151256
191422700100000,SW 450,Residential,274,0,274,0,0,274
191422700200000,SW 450,Residential,316,0,316,0,0,316
191422700300000,SW 450,Residential,266,0,266,0,0,266
191422700400000,SW 450,Residential,266,0,266,0,0,266
191422800100000,SW 450,Residential,40013,0,40013,136724,0,176737
191422800200000,SW 450,Residential,34678,0,34678,133463,0,168141
191422800300000,SW 450,Residential,257,0,257,0,0,257
191422800400000,SW 450,Residential,257,0,257,0,0,257
191422800500000,SW 450,Residential,35211,0,35211,149875,0,185086
191422800600000,SW 450,Residential,35211,0,35211,145411,0,180622
191422800700000,SW 450,Residential,35211,0,35211,152374,0,187585
191422800800000,SW 450,Residential,35211,0,35211,151103,0,186314
191422800900000,SW 450,Residential,274,0,274,0,0,274
191422801000000,SW 450,Residential,40013,0,40013,151272,0,191285
191422801100000,SW 450,Residential,35211,0,35211,145251,0,180462
191422801200000,SW 450,Residential,35211,0,35211,137082,0,172293
191422801300000,SW 450,Residential,35211,0,35211,150816,0,186027
191422801400000,SW 450,Residential,35211,0,35211,6816,0,42027
191422801500000,SW 450,Residential,299,0,299,0,0,299
191422801600000,SW 450,Residential,299,0,299,0,0,299
191422801700000,SW 450,Residential,266,0,266,0,0,266
191422801800000,SW 450,Residential,316,0,316,0,0,316
191422900100000,SW 450,Residential,247,0,247,0,0,247
191422900200000,SW 450,Ag Land,1244,0,1244,0,0,1244
191423000100000,SW 450,Residential,305,0,305,0,0,305
191423000200000,SW 450,Residential,40838,0,40838,199102,0,239940
191423000300000,SW 450,Residential,38850,0,38850,127643,0,166493
191423000400000,SW 450,Residential,35937,0,35937,147882,0,183819
191423000500000,SW 450,Residential,36264,0,36264,147164,0,183428
191423000600000,SW 450,Residential,38115,0,38115,145262,0,183377
191423000700000,SW 450,Residential,287,0,287,0,0,287
191423000800000,SW 450,Residential,910,0,910,0,0,910
191423200100000,SW 450,Residential,5917,0,5917,0,0,5917
191427600300000,SW 449,Residential,5380,0,5380,0,0,5380
191427600500000,SW 456,Ag Land,60612,0,60612,0,0,60612
191427700100000,SW 450,Residential,282,0,282,0,0,282
191427700200000,SW 450,Residential,316,0,316,0,0,316
191510100200000,OFFICE,Commercial,0,3038904,3038904,0,23134929,26173833
191510100300000,OFFICE,Commercial,0,669492,669492,0,16290169,16959661
191520100100000,EDUCATIONAL/COLLEGE,Exempt,0,0,0,0,0,0
191520100102000,OFFICE,Commercial,0,437400,437400,0,2034769,2472169
191525100100000,SW 422,Residential,98700,0,98700,81422,0,180122
191530100100000,EDUCATIONAL/COLLEGE,Exempt,0,0,0,0,0,0
191530100101000,WAREHOUSE,Commercial,0,32400,32400,0,472010,504410
191530100101001,EDUCATIONAL/COLLEGE,Exempt,0,0,0,0,0,0
191530100101002,EDUCATIONAL/COLLEGE,Exempt,0,0,0,0,0,0
191530100101003,WAREHOUSE,Commercial,0,5508,5508,0,31390,36898
191530100102000,ANTENNAS/TOWERS(BLL),Commercial,0,0,0,0,8664,8664
191530100102001,ANTENNAS/TOWERS(BLL),Commercial,0,0,0,0,3042,3042
191530100102002,ANTENNAS/TOWERS(BLL),Commercial,0,0,0,0,3659,3659
191530100102003,ANTENNAS/TOWERS(BLL),Commercial,0,0,0,0,6084,6084
191530100102004,ANTENNAS/TOWERS(BLL),Commercial,0,0,0,0,3196,3196
191532600100000,OFFICE,Commercial,0,337716,337716,0,4247175,4584891
191535100100000,CITY PROPERTY,Exempt,0,0,0,0,0,0
191540100300000,EDUCATIONAL/COLLEGE,Exempt,0,26521,26521,0,0,26521
191540200100000,SW 456,Ag Land,49695,0,49695,0,0,49695
191540200201237,NBHD SHOPPING CENTER,Commercial,0,33750,33750,0,31889,65639
191540200201238,NBHD SHOPPING CENTER,Commercial,0,33750,33750,0,31889,65639
191547600100000,EDUCATIONAL/COLLEGE,Exempt,0,56767,56767,0,0,56767
191547600200000,EDUCATIONAL/COLLEGE,Exempt,0,0,0,0,0,0
191610100100000,SW 426,Residential,27791,0,27791,91756,0,119547
191610100200000,SW 426,Residential,27072,0,27072,84911,0,111983
191610100300000,SW 426,Residential,27072,0,27072,93938,0,121010
191610100400000,SW 426,Residential,27072,0,27072,94878,0,121950
191610100500000,SW 426,Residential,27072,0,27072,100650,0,127722
191610100600000,SW 426,Residential,27072,0,27072,83664,0,110736
191610100700000,SW 426,Residential,26696,0,26696,69432,0,96128
191610100800000,SW 426,Residential,26696,0,26696,99636,0,126332
191610100900000,SW 426,Residential,26696,0,26696,88218,0,114914
191610101000000,SW 426,Residential,26696,0,26696,90849,0,117545
191610101100000,SW 426,Residential,26696,0,26696,103017,0,129713
191610101200000,SW 426,Residential,26696,0,26696,84398,0,111094
191610101300000,SW 426,Residential,26696,0,26696,84959,0,111655
191610101400000,SW 426,Residential,26696,0,26696,72308,0,99004
191610101500000,SW 426,Residential,29856,0,29856,69826,0,99682
191610101600000,SW 426,Residential,29792,0,29792,98749,0,128541
191610101700000,SW 426,Residential,29508,0,29508,134987,0,164495
191610101800000,SW 426,Residential,28269,0,28269,65612,0,93881
191610101900000,SW 426,Residential,26320,0,26320,101135,0,127455
191610102000000,SW 426,Residential,26320,0,26320,83202,0,109522
191610102100000,SW 426,Residential,26320,0,26320,56660,0,82980
191610102200000,SW 426,Residential,26320,0,26320,90139,0,116459
191610102300000,SW 426,Residential,26320,0,26320,80030,0,106350
191610102400000,SW 426,Residential,26338,0,26338,62028,0,88366
191610200100000,SW 426,Residential,25928,0,25928,92192,0,118120
191610200200000,SW 426,Residential,25568,0,25568,95426,0,120994
191610200300000,SW 426,Residential,25568,0,25568,56149,0,81717
191610200400000,SW 426,Residential,25568,0,25568,96244,0,121812
191610200500000,SW 426,Residential,25568,0,25568,77833,0,103401
191610200600000,SW 426,Residential,25960,0,25960,101382,0,127342
191610200700000,SW 426,Residential,20880,0,20880,96688,0,117568
191610200800000,SW 426,Residential,20880,0,20880,97807,0,118687
191610200900000,SW 426,Residential,20880,0,20880,108100,0,128980
191610201000000,SW 426,Residential,22100,0,22100,107065,0,129165
191610201100000,SW 426,Residential,18933,0,18933,98454,0,117387
191610201200000,SW 426,Residential,23073,0,23073,106509,0,129582
191610201300000,SW 426,Residential,21763,0,21763,107891,0,129654
191610201400000,SW 426,Residential,19427,0,19427,98542,0,117969
191610201500000,SW 426,Residential,19015,0,19015,101589,0,120604
191610201600000,SW 426,Residential,20877,0,20877,92728,0,113605
191610201700000,SW 426,Residential,20640,0,20640,97260,0,117900
191610201800000,SW 426,Residential,20400,0,20400,100265,0,120665
191610201900000,SW 426,Residential,20400,0,20400,90315,0,110715
191610202000000,SW 426,Residential,21632,0,21632,113875,0,135507
191610202100000,SW 426,Residential,22880,0,22880,96319,0,119199
191610202200000,SW 426,Residential,22880,0,22880,121095,0,143975
191610202300000,SW 426,Residential,22880,0,22880,108473,0,131353
191610202400000,SW 426,Residential,22811,0,22811,123207,0,146018
191610202500000,SW 426,Residential,29073,0,29073,84842,0,113915
191610202600000,SW 426,Residential,28322,0,28322,111133,0,139455
191610202700000,SW 426,Residential,27711,0,27711,93294,0,121005
191610202800000,SW 426,Residential,30558,0,30558,80041,0,110599
191610202900000,SW 426,Residential,28079,0,28079,61570,0,89649
191610203000000,SW 426,Residential,29667,0,29667,65907,0,95574
191610203100000,SW 426,Residential,30138,0,30138,67956,0,98094
191610203200000,CITY PROPERTY,Exempt,0,0,0,0,0,0
191610203300000,SW 426,Residential,62800,0,62800,84652,0,147452
191610300100000,SW 426,Residential,27565,0,27565,80517,0,108082
191610300200000,SW 426,Residential,27160,0,27160,74710,0,101870
191610300300000,SW 426,Residential,27160,0,27160,94077,0,121237
191610300400000,SW 426,Residential,26755,0,26755,99683,0,126438
191610300500000,SW 426,Residential,28652,0,28652,56348,0,85000
191610300600000,SW 426,Residential,28224,0,28224,36890,0,65114
191610300700000,SW 426,Residential,28224,0,28224,69903,0,98127
191610300800000,SW 426,Residential,28609,0,28609,65391,0,94000
191610300900000,SW 426,Residential,27360,0,27360,66167,0,93527
191610301000000,SW 426,Residential,29767,0,29767,77756,0,107523
191610301100000,SW 426,Residential,28498,0,28498,78262,0,106760
191610301200000,SW 426,Residential,26040,0,26040,77393,0,103433
191610301300000,SW 426,Residential,33405,0,33405,90697,0,124102
191610301400000,SW 426,Residential,25768,0,25768,101525,0,127293
191610301500000,SW 426,Residential,21432,0,21432,99291,0,120723
191610301600000,SW 426,Residential,21560,0,21560,97096,0,118656
191610301700000,SW 426,Residential,21560,0,21560,98534,0,120094
191610301800000,SW 426,Residential,21560,0,21560,93249,0,114809
191610301900000,SW 426,Residential,21560,0,21560,95852,0,117412
191610302000000,SW 426,Residential,21560,0,21560,122175,0,143735
191610302100000,SW 426,Residential,1045,0,1045,0,0,1045
191610400100000,SW 426,Residential,28030,0,28030,76933,0,104963
191610400200000,SW 426,Residential,27160,0,27160,99620,0,126780
191610400300000,SW 426,Residential,27160,0,27160,82690,0,109850
191610400400000,SW 426,Residential,28380,0,28380,82457,0,110837
191610400500000,SW 426,Residential,27101,0,27101,95039,0,122140
191610400600000,SW 426,Residential,28000,0,28000,62618,0,90618
191610400700000,SW 426,Residential,28000,0,28000,59688,0,87688
191610400800000,SW 426,Residential,28000,0,28000,63833,0,91833
191610400900000,SW 426,Residential,28547,0,28547,66334,0,94881
191610401000000,SW 426,Residential,32521,0,32521,51412,0,83933
191610401100000,SW 426,Residential,18200,0,18200,0,0,18200
191610401200000,SW 426,Residential,18200,0,18200,74194,0,92394
191610401300000,SW 426,Residential,28000,0,28000,70534,0,98534
191610401400000,SW 426,Residential,28421,0,28421,98509,0,126930
191610500100000,SW 426,Residential,27463,0,27463,72373,0,99836
191610500200000,SW 426,Residential,27463,0,27463,116685,0,144148
191610500300000,SW 426,Residential,27463,0,27463,77680,0,105143
191610500400000,SW 426,Residential,27463,0,27463,63252,0,90715
191610500500000,SW 426,Residential,27463,0,27463,97205,0,124668
191610500600000,SW 426,Residential,27463,0,27463,70595,0,98058
191610500700000,SW 426,Residential,27463,0,27463,61122,0,88585
191610500800000,SW 426,Residential,28274,0,28274,76255,0,104529
191610500900000,SW 426,Residential,27261,0,27261,54776,0,82037
191610501000000,SW 426,Residential,28560,0,28560,74145,0,102705
191610501100000,SW 426,Residential,25596,0,25596,62462,0,88058
191610501200000,SW 426,Residential,25740,0,25740,75411,0,101151
191610501300000,SW 426,Residential,26484,0,26484,76678,0,103162
191610501500000,SW 426,Residential,25717,0,25717,101749,0,127466
191610501600000,SW 426,Residential,24201,0,24201,101749,0,125950
191610501700000,SW 426,Residential,26989,0,26989,101749,0,128738
191610501800000,SW 426,Residential,24639,0,24639,98377,0,123016
191610501900000,SW 426,Residential,21474,0,21474,98377,0,119851
191610502000000,SW 426,Residential,27232,0,27232,101749,0,128981
191610502100000,SW 426,Residential,27540,0,27540,145389,0,172929
191610502200000,SW 426,Residential,26772,0,26772,145389,0,172161
191610502300000,SW 426,Residential,24555,0,24555,101147,0,125702
191610502400000,SW 426,Residential,26791,0,26791,145389,0,172180
191610502500000,SW 426,Residential,23490,0,23490,104611,0,128101
191610502600000,SW 426,Residential,27622,0,27622,104611,0,132233
191610502700000,SW 426,Residential,26655,0,26655,104611,0,131266
191610502800000,SW 426,Residential,23607,0,23607,104611,0,128218
191610600100000,SW 426,Residential,25550,0,25550,80895,0,106445
191610600200000,SW 426,Residential,25568,0,25568,60851,0,86419
191610600300000,SW 426,Residential,25568,0,25568,73904,0,99472
191610600400000,SW 426,Residential,25800,0,25800,104611,0,130411
191610600500000,CITY PROPERTY,Exempt,0,0,0,0,0,0
191612600100000,SW 426,Residential,29286,0,29286,63900,0,93186
191612600200000,SW 426,Residential,29486,0,29486,72361,0,101847
191612600300000,SW 426,Residential,29486,0,29486,57894,0,87380
191612600400000,SW 426,Residential,29486,0,29486,74590,0,104076
191612600500000,SW 426,Residential,29486,0,29486,70215,0,99701
191612600600000,SW 426,Residential,29486,0,29486,95228,0,124714
191612600700000,SW 426,Residential,29486,0,29486,77718,0,107204
191612600800000,SW 426,Residential,27816,0,27816,81636,0,109452
191612600900000,SW 426,Residential,26255,0,26255,114423,0,140678
191612700100000,SW 426,Residential,29750,0,29750,58703,0,88453
191612700200000,SW 426,Residential,29484,0,29484,65417,0,94901
191612700300000,SW 426,Residential,29484,0,29484,79602,0,109086
191612700400000,SW 426,Residential,29484,0,29484,77897,0,107381
191612700500000,SW 426,Residential,29484,0,29484,86400,0,115884
191612700600000,SW 426,Residential,29484,0,29484,81570,0,111054
191612700700000,SW 426,Residential,29484,0,29484,70808,0,100292
191612700800000,SW 426,Residential,29484,0,29484,62154,0,91638
191612700900000,SW 426,Residential,29393,0,29393,75488,0,104881
191612701000000,SW 426,Residential,29750,0,29750,84892,0,114642
191612701100000,CITY PROPERTY,Exempt,0,0,0,0,0,0
191612701200000,CITY PROPERTY,Exempt,0,0,0,0,0,0
191612701300000,SW 426,Residential,29750,0,29750,112590,0,142340
191612701400000,SW 426,Residential,29750,0,29750,65479,0,95229
191612701500000,SW 426,Residential,29750,0,29750,68635,0,98385
191612800100000,SW 426,Residential,29750,0,29750,67042,0,96792
191612800200000,SW 426,Residential,29750,0,29750,65220,0,94970
191612800300000,SW 426,Residential,29750,0,29750,62667,0,92417
191612800400000,SW 426,Residential,29750,0,29750,69093,0,98843
191612800500000,SW 426,Residential,29750,0,29750,77361,0,107111
191612800600000,SW 426,Residential,29750,0,29750,89772,0,119522
191612800700000,SW 426,Residential,34020,0,34020,75518,0,109538
191612800800000,SW 426,Residential,30498,0,30498,69709,0,100207
191612800900000,SW 426,Residential,29652,0,29652,96522,0,126174
191612801000000,SW 426,Residential,29750,0,29750,71966,0,101716
191612801100000,SW 426,Residential,29750,0,29750,87410,0,117160
191612801200000,SW 426,Residential,29750,0,29750,70232,0,99982
191612801300000,SW 426,Residential,29750,0,29750,69232,0,98982
191612900100000,SW 426,Residential,29750,0,29750,82985,0,112735
191612900200000,SW 426,Residential,29750,0,29750,70358,0,100108
191612900300000,SW 426,Residential,29750,0,29750,71603,0,101353
191612900400000,SW 426,Residential,29750,0,29750,61009,0,90759
191612900500000,SW 426,Residential,29750,0,29750,66896,0,96646
191612900600000,SW 426,Residential,29750,0,29750,112419,0,142169
191612900700000,SW 426,Residential,29750,0,29750,74329,0,104079
191612900800000,SW 426,Residential,29750,0,29750,82928,0,112678
191612900900000,SW 426,Residential,29750,0,29750,74383,0,104133
191612901000000,SW 426,Residential,29750,0,29750,122734,0,152484
191612901100000,SW 426,Residential,29750,0,29750,91234,0,120984
191613000100000,SW 426,Residential,30879,0,30879,73701,0,104580
191613000200000,SW 426,Residential,29452,0,29452,75756,0,105208
191613000300000,SW 426,Residential,1725,0,1725,0,0,1725
191613000400000,SW 426,Residential,1725,0,1725,0,0,1725
191613000500000,SW 426,Residential,30940,0,30940,93586,0,124526
191613000600000,SW 426,Residential,29750,0,29750,80792,0,110542
191613000700000,SW 426,Residential,29750,0,29750,70932,0,100682
191613000800000,SW 426,Residential,29452,0,29452,67280,0,96732
191613000900000,SW 426,Residential,1725,0,1725,0,0,1725
191613001000000,SW 426,Residential,29452,0,29452,73019,0,102471
191613001100000,SW 426,Residential,30931,0,30931,99019,0,129950
191613100100000,SW 426,Residential,29018,0,29018,85215,0,114233
191613100200000,SW 426,Residential,29694,0,29694,71252,0,100946
191613100300000,SW 426,Residential,31299,0,31299,105314,0,136613
191613100400000,SW 426,Residential,30047,0,30047,82307,0,112354
191613100500000,SW 426,Residential,29750,0,29750,80996,0,110746
191613100600000,SW 426,Residential,29750,0,29750,80747,0,110497
191613100700000,SW 426,Residential,29750,0,29750,91960,0,121710
191613100800000,SW 426,Residential,18702,0,18702,79706,0,98408
191613100900000,SW 426,Residential,19600,0,19600,83067,0,102667
191613101000000,SW 426,Residential,30021,0,30021,85953,0,115974
191613101100000,SW 426,Residential,29750,0,29750,87274,0,117024
191613101200000,SW 426,Residential,29750,0,29750,80152,0,109902
191613101300000,SW 426,Residential,29750,0,29750,80126,0,109876
191613200100000,SW 426,Residential,29750,0,29750,70059,0,99809
191613200200000,SW 426,Residential,29750,0,29750,60767,0,90517
191613200300000,SW 426,Residential,29750,0,29750,77724,0,107474
191613200400000,SW 426,Residential,29750,0,29750,80266,0,110016
191613200500000,SW 426,Residential,29750,0,29750,70543,0,100293
191613200600000,SW 426,Residential,29750,0,29750,73021,0,102771
191613200700000,SW 426,Residential,29750,0,29750,77104,0,106854
191613200800000,SW 426,Residential,29909,0,29909,84685,0,114594
191613200900000,SW 426,Residential,29550,0,29550,79331,0,108881
191613201000000,SW 426,Residential,29750,0,29750,87208,0,116958
191613201100000,SW 426,Residential,29750,0,29750,89330,0,119080
191613201200000,SW 426,Residential,29750,0,29750,74729,0,104479
191613201300000,SW 426,Residential,29750,0,29750,73304,0,103054
191613300100000,SW 426,Residential,30399,0,30399,76128,0,106527
191613300200000,SW 426,Residential,1850,0,1850,0,0,1850
191613300300000,SW 426,Residential,1830,0,1830,0,0,1830
191613300400000,SW 426,Residential,30099,0,30099,71006,0,101105
191613300500000,SW 426,Residential,29812,0,29812,91151,0,120963
191613300600000,SW 426,Residential,29812,0,29812,83872,0,113684
191615200100000,SW 451,Residential,37787,0,37787,179737,0,217524
191615200200000,CITY PROPERTY,Exempt,0,0,0,0,0,0
191615200300000,SW 451,Residential,32100,0,32100,126986,0,159086
191615200400000,SW 451,Residential,34200,0,34200,136818,0,171018
191615200500000,SW 451,Residential,30576,0,30576,126326,0,156902
191615200600000,SW 451,Residential,29440,0,29440,139965,0,169405
191615200700000,SW 451,Residential,27270,0,27270,119828,0,147098
191615200800000,SW 451,Residential,24240,0,24240,115920,0,140160
191615200900000,SW 451,Residential,32000,0,32000,130813,0,162813
191615201000000,SW 451,Residential,31680,0,31680,141998,0,173678
191615201100000,SW 451,Residential,24800,0,24800,145938,0,170738
191615201200000,SW 451,Residential,25296,0,25296,114327,0,139623
191615201300000,SW 451,Residential,25296,0,25296,114327,0,139623
191615201400000,SW 451,Residential,25296,0,25296,114396,0,139692
191615201500000,SW 451,Residential,27200,0,27200,112681,0,139881
191615300100000,SW 451,Residential,29160,0,29160,129483,0,158643
191615300200000,SW 451,Residential,24800,0,24800,138968,0,163768
191615300300000,SW 451,Residential,24800,0,24800,135298,0,160098
191615300400000,SW 451,Residential,24800,0,24800,142786,0,167586
191615300500000,SW 451,Residential,24800,0,24800,139946,0,164746
191615300600000,SW 451,Residential,24800,0,24800,146259,0,171059
191615300700000,SW 451,Residential,24800,0,24800,155680,0,180480
191615300800000,SW 451,Residential,24800,0,24800,146285,0,171085
191615300900000,SW 451,Residential,24800,0,24800,119719,0,144519
191615301000000,SW 451,Residential,32000,0,32000,131065,0,163065
191615301100000,SW 451,Residential,32400,0,32400,99265,0,131665
191615301200000,SW 451,Residential,24800,0,24800,109123,0,133923
191615301300000,SW 451,Residential,24800,0,24800,99265,0,124065
191615301400000,SW 451,Residential,24800,0,24800,99265,0,124065
191615301500000,SW 451,Residential,24800,0,24800,97371,0,122171
191615301600000,SW 451,Residential,24800,0,24800,107457,0,132257
191615301700000,SW 451,Residential,24800,0,24800,99265,0,124065
191615301800000,SW 451,Residential,24800,0,24800,103822,0,128622
191615301900000,SW 451,Residential,24800,0,24800,137840,0,162640
191615302000000,SW 451,Residential,4567,0,4567,0,0,4567
191615400100000,SW 451,Residential,8850,0,8850,0,0,8850
191615400200000,SW 451,Residential,26000,0,26000,137474,0,163474
191615400300000,SW 451,Residential,32400,0,32400,140102,0,172502
191615400400000,SW 451,Residential,24800,0,24800,131035,0,155835
191615400500000,SW 451,Residential,24800,0,24800,130661,0,155461
191615400600000,SW 451,Residential,24800,0,24800,121753,0,146553
191615400700000,SW 451,Residential,24800,0,24800,132230,0,157030
191615400800000,SW 451,Residential,24800,0,24800,132947,0,157747
191615400900000,SW 451,Residential,24800,0,24800,118993,0,143793
191615401000000,SW 451,Residential,24800,0,24800,125011,0,149811
191615401100000,SW 451,Residential,24800,0,24800,126973,0,151773
191615401200000,SW 451,Residential,30400,0,30400,127161,0,157561
191615401300000,SW 451,Residential,33264,0,33264,133094,0,166358
191615401400000,SW 451,Residential,31762,0,31762,126808,0,158570
191615401500000,SW 451,Residential,34153,0,34153,104651,0,138804
191615401600000,SW 451,Residential,31973,0,31973,156046,0,188019
191615401700000,SW 451,Residential,29970,0,29970,132518,0,162488
191615401800000,SW 451,Residential,26069,0,26069,115920,0,141989
191615401900000,SW 451,Residential,25856,0,25856,141201,0,167057
191615402000000,SW 451,Residential,25600,0,25600,122015,0,147615
191615402100000,SW 451,Residential,25600,0,25600,133448,0,159048
191615402200000,SW 451,Residential,25600,0,25600,124550,0,150150
191615402300000,SW 451,Residential,3671,0,3671,0,0,3671
191615402400000,SW 451,Residential,3670,0,3670,0,0,3670
191615402500000,SW 451,Residential,4184,0,4184,0,0,4184
191615500100000,SW 451,Residential,31008,0,31008,123118,0,154126
191615500200000,SW 451,Residential,25792,0,25792,114726,0,140518
191615500300000,SW 451,Residential,26040,0,26040,132074,0,158114
191615500400000,SW 451,Residential,25296,0,25296,141853,0,167149
191615500500000,SW 451,Residential,25048,0,25048,139393,0,164441
191615500600000,SW 451,Residential,30400,0,30400,126005,0,156405
191615500700000,CITY PROPERTY,Exempt,0,0,0,0,0,0
191615500900000,SW 451,Residential,29784,0,29784,49237,0,79021
191615501000000,SW 451,Residential,34997,0,34997,75028,0,110025
191615501100000,SW 451,Residential,30400,0,30400,99339,0,129739
191615600100000,SW 451,Residential,32440,0,32440,155186,0,187626
191615600200000,SW 451,Residential,24800,0,24800,97371,0,122171
191615600300000,SW 451,Residential,24800,0,24800,153832,0,178632
191615600400000,SW 451,Residential,24800,0,24800,138381,0,163181
191615600500000,SW 451,Residential,24800,0,24800,142472,0,167272
191615600600000,SW 451,Residential,24800,0,24800,141495,0,166295
191615600700000,SW 451,Residential,24800,0,24800,136205,0,161005
191615600800000,SW 451,Residential,24800,0,24800,153393,0,178193
191615600900000,SW 451,Residential,24800,0,24800,143328,0,168128
191615601000000,SW 451,Residential,4567,0,4567,0,0,4567
191615601100000,SW 451,Residential,4567,0,4567,0,0,4567
191615601200000,SW 451,Residential,3539,0,3539,0,0,3539
191615601300000,SW 451,Residential,3539,0,3539,0,0,3539
191615601400000,SW 451,Residential,3539,0,3539,0,0,3539
191615601500000,SW 451,Residential,3539,0,3539,0,0,3539
191615601600000,SW 451,Residential,3539,0,3539,0,0,3539
191615601700000,SW 451,Residential,3539,0,3539,0,0,3539
191615601800000,SW 451,Residential,3539,0,3539,0,0,3539
191615601900000,SW 451,Residential,3539,0,3539,0,0,3539
191615602000000,SW 451,Residential,32400,0,32400,108830,0,141230
191615700100000,SW 451,Residential,4225,0,4225,0,0,4225
191615700200000,SW 451,Residential,3663,0,3663,0,0,3663
191615700300000,SW 451,Residential,3719,0,3719,0,0,3719
191615700400000,SW 451,Residential,3660,0,3660,0,0,3660
191615700500000,SW 451,Residential,3715,0,3715,0,0,3715
191615700600000,SW 451,Residential,3657,0,3657,0,0,3657
191615700700000,SW 451,Residential,4141,0,4141,0,0,4141
191615700800000,SW 451,Residential,4219,0,4219,0,0,4219
191615800100000,CITY PROPERTY,Exempt,0,0,0,0,0,0
191615800200000,SW 451,Residential,5629,0,5629,0,0,5629
191615800300000,SW 451,Residential,4443,0,4443,0,0,4443
191615800400000,SW 451,Residential,4130,0,4130,0,0,4130
191615800500000,SW 451,Residential,4087,0,4087,0,0,4087
191615800600000,SW 451,Residential,4044,0,4044,0,0,4044
191615800700000,SW 451,Residential,4504,0,4504,0,0,4504
191615800800000,SW 451,Residential,3996,0,3996,0,0,3996
191615800900000,SW 451,Residential,3595,0,3595,0,0,3595
191615801000000,SW 451,Residential,3877,0,3877,0,0,3877
191615801100000,SW 451,Residential,4214,0,4214,0,0,4214
191615801200000,SW 451,Residential,4533,0,4533,0,0,4533
191615900100000,SW 451,Residential,4635,0,4635,0,0,4635
191615900200000,SW 451,Residential,5087,0,5087,0,0,5087
191615900300000,SW 451,Residential,3842,0,3842,0,0,3842
191615900400000,SW 451,Residential,3799,0,3799,0,0,3799
191615900500000,SW 451,Residential,3756,0,3756,0,0,3756
191615900600000,SW 451,Residential,3714,0,3714,0,0,3714
191615900700000,SW 451,Residential,3671,0,3671,0,0,3671
191615900800000,SW 451,Residential,3628,0,3628,0,0,3628
191615900900000,SW 451,Residential,3585,0,3585,0,0,3585
191615901000000,SW 451,Residential,3542,0,3542,0,0,3542
191615901100000,SW 451,Residential,4508,0,4508,0,0,4508
191615901200000,SW 451,Residential,4567,0,4567,0,0,4567
191615901300000,SW 451,Residential,3539,0,3539,0,0,3539
191615901400000,SW 451,Residential,3539,0,3539,0,0,3539
191615901500000,SW 451,Residential,3539,0,3539,0,0,3539
191615901600000,SW 451,Residential,3539,0,3539,0,0,3539
191615901700000,SW 451,Residential,3539,0,3539,0,0,3539
191615901800000,SW 451,Residential,3539,0,3539,0,0,3539
191615901900000,SW 451,Residential,3539,0,3539,0,0,3539
191615902000000,SW 451,Residential,3539,0,3539,0,0,3539
191617600100000,SW 426,Residential,30100,0,30100,87003,0,117103
191617600200000,APARTMENT,Residential,78300,0,78300,1195335,0,1273635
191617600300000,SW 426,Residential,35505,0,35505,82603,0,118108
191617600500000,SW 426,Residential,28078,0,28078,69271,0,97349
191617600600000,SW 426,Residential,27463,0,27463,60716,0,88179
191617600900000,APARTMENT,Commercial,0,29530,29530,0,210754,240284
191617601000000,APARTMENT,Commercial,0,27303,27303,0,211157,238460
191617700100000,EDUCATIONAL/COLLEGE,Exempt,0,86521,86521,0,0,86521
191617700500000,VACANT LAND,Commercial,0,122580,122580,0,0,122580
191617700700000,VACANT LAND,Commercial,0,14850,14850,0,0,14850
191620100100000,CITY PROPERTY,Exempt,0,0,0,0,0,0
191620100200000,CITY PROPERTY,Exempt,0,0,0,0,0,0
191622600100000,SW 418,Residential,203400,0,203400,0,0,203400
191622600200000,SW 418,Residential,103200,0,103200,0,0,103200
191622600300000,WAREHOUSE,Commercial,0,283770,283770,0,475982,759752
191622600400000,SW 418,Ag Dwelling,23417,0,23417,57379,5057,85853
191622600500000,WAREHOUSE,Commercial,0,257993,257993,0,1143748,1401741
191625100200000,WAREHOUSE,Commercial,0,143370,143370,0,428235,571605
191625100202000,BILLBOARD(BLL),Commercial,0,0,0,0,68037,68037
191625100300000,WAREHOUSE,Commercial,0,169290,169290,0,510157,679447
191625100400000,SMALL RETAIL,Commercial,0,169997,169997,0,287630,457627
191625100500000,WAREHOUSE,Commercial,0,261036,261036,0,1526591,1787627
191625100800000,WAREHOUSE,Commercial,0,373334,373334,0,2155222,2528556
191625200100000,SHOP,Industrial,0,118260,118260,0,464149,582409
191625200200000,SHOP,Exempt,0,269460,269460,0,657576,927036
191625200300000,SHOP,Commercial,0,90914,90914,0,382374,473288
191625200400000,SHOP,Commercial,0,71590,71590,0,386285,457875
191627600300000,SW 426,Residential,51000,0,51000,166857,0,217857
191627600400000,SW 426,Residential,260300,0,260300,0,0,260300
191630100100000,SW 422,Ag Land,53001,0,53001,0,0,53001
191632600100000,SW 418,Ag Land,39116,0,39116,0,0,39116
191632600200000,WAREHOUSE,Commercial,0,111780,111780,0,79515,191295
191632600300000,SW 418,Residential,35329,0,35329,106424,0,141753
191635100100000,SW 418,Ag Dwelling,50636,0,50636,128417,9655,188708
191637600100000,SW 456,Ag Dwelling,62304,0,62304,79796,6867,148967
191640100400000,CITY PROPERTY,Exempt,0,0,0,0,0,0
191640100402000,ANTENNAS/TOWERS(BLL),Commercial,0,0,0,0,45378,45378
191640100500000,CITY PROPERTY,Exempt,0,0,0,0,0,0
191640100600000,SW 433,Residential,40679,0,40679,212460,0,253139
191640100700000,SW 433,Residential,41512,0,41512,174621,0,216133
191640100800000,SW 433,Residential,41908,0,41908,222491,0,264399
191640100900000,SW 433,Residential,40660,0,40660,165848,0,206508
191640101000000,SW 433,Residential,41420,0,41420,250966,0,292386
191640101100000,SW 433,Residential,39686,0,39686,146727,0,186413
191640101200000,SW 433,Residential,44184,0,44184,209118,0,253302
191640101300000,SW 433,Residential,42750,0,42750,250864,0,293614
191640101400000,SW 433,Residential,33561,0,33561,225865,0,259426
191640101500000,SW 433,Residential,38610,0,38610,236544,0,275154
191640101600000,SW 433,Residential,38934,0,38934,250967,0,289901
191640101700000,SW 433,Residential,35848,0,35848,180171,0,216019
191640101800000,SW 433,Residential,40800,0,40800,230389,0,271189
191640101900000,SW 433,Residential,39200,0,39200,251437,0,290637
191640102000000,SW 433,Residential,40420,0,40420,208068,0,248488
191640102300000,SW 433,Residential,42401,0,42401,229402,0,271803
191640102400000,SW 433,Residential,55650,0,55650,0,0,55650
191640102500000,SW 433,Residential,35192,0,35192,0,0,35192
191640102600000,SW 433,Residential,38667,0,38667,0,0,38667
191640102700000,SW 433,Residential,47355,0,47355,0,0,47355
191640102800000,SW 433,Residential,49120,0,49120,0,0,49120
191640102900000,SW 433,Residential,46686,0,46686,0,0,46686
191640103000000,SW 433,Residential,35897,0,35897,226907,0,262804
191640103100000,SW 433,Residential,34187,0,34187,0,0,34187
191640103200000,SW 433,Residential,38048,0,38048,0,0,38048
191640103300000,SW 433,Residential,35890,0,35890,0,0,35890
191640103400000,SW 433,Residential,47302,0,47302,4010,0,51312
191640103500000,SW 433,Residential,45500,0,45500,4010,0,49510
191640103600000,SW 433,Residential,33350,0,33350,4010,0,37360
191640200100000,SW 433,Residential,41400,0,41400,153305,0,194705
191640200200000,SW 433,Residential,41401,0,41401,191255,0,232656
191640200300000,SW 433,Residential,35489,0,35489,155511,0,191000
191640200400000,SW 433,Residential,41401,0,41401,196433,0,237834
191640200500000,SW 433,Residential,41399,0,41399,188547,0,229946
191640200600000,SW 433,Residential,35880,0,35880,178107,0,213987
191640200700000,SW 433,Residential,35880,0,35880,194599,0,230479
191640200800000,SW 433,Residential,35880,0,35880,158014,0,193894
191640200900000,SW 433,Residential,35879,0,35879,160761,0,196640
191640201000000,SW 433,Residential,35880,0,35880,176743,0,212623
191640201100000,SW 433,Residential,35879,0,35879,143368,0,179247
191640300100000,SW 433,Residential,44892,0,44892,221941,0,266833
191640300200000,SW 433,Residential,41715,0,41715,205250,0,246965
191640300300000,SW 433,Residential,41039,0,41039,202598,0,243637
191640300400000,SW 433,Residential,41760,0,41760,249391,0,291151
191640300500000,SW 433,Residential,42120,0,42120,238363,0,280483
191640300600000,SW 433,Residential,42840,0,42840,213656,0,256496
191640300700000,SW 433,Residential,43200,0,43200,214321,0,257521
191640300800000,SW 433,Residential,44064,0,44064,220168,0,264232
191640300900000,SW 433,Residential,44805,0,44805,245341,0,290146
191640301000000,SW 433,Residential,43157,0,43157,169860,0,213017
191640301100000,SW 433,Residential,44323,0,44323,0,0,44323
191640301200000,SW 433,Residential,44939,0,44939,9356,0,54295
191640301300000,SW 433,Residential,43805,0,43805,174546,0,218351
191640301400000,SW 433,Residential,44179,0,44179,240475,0,284654
191640301500000,SW 433,Residential,44927,0,44927,209669,0,254596
191640301600000,SW 433,Residential,45677,0,45677,176879,0,222556
191640301700000,SW 433,Residential,44929,0,44929,180542,0,225471
191640301800000,SW 433,Residential,44961,0,44961,262323,0,307284
191640301900000,SW 433,Residential,40095,0,40095,154581,0,194676
191640400100000,SW 433,Residential,32595,0,32595,0,0,32595
191640400200000,SW 433,Residential,36364,0,36364,148113,0,184477
191640400300000,SW 433,Residential,35574,0,35574,145377,0,180951
191640400400000,SW 433,Residential,36317,0,36317,169542,0,205859
191640400500000,SW 433,Residential,37150,0,37150,174650,0,211800
191640400600000,SW 433,Residential,38330,0,38330,202143,0,240473
191640400700000,SW 433,Residential,38919,0,38919,201252,0,240171
191640400800000,SW 433,Residential,36288,0,36288,136753,0,173041
191640400900000,SW 433,Residential,34870,0,34870,149330,0,184200
191640401000000,SW 433,Residential,35414,0,35414,142556,0,177970
191640401100000,SW 433,Residential,34020,0,34020,151894,0,185914
191640401200000,SW 433,Residential,32130,0,32130,150561,0,182691
191640401300000,SW 433,Residential,32760,0,32760,167576,0,200336
191642600100000,SW 422,Ag Land,68633,0,68633,0,0,68633
191645100100000,SW 456,Ag Dwelling,65064,0,65064,69142,5490,139696
191647600200000,SCHOOL,Exempt,0,0,0,0,0,0
191647600300000,SW 422,Residential,41170,0,41170,8978,0,50148
191647600400000,SW 422,Residential,23160,0,23160,110811,0,133971
191647600500000,SW 433,Residential,30441,0,30441,171950,0,202391
191647600600000,SW 433,Residential,29439,0,29439,157791,0,187230
191647600700000,SW 433,Residential,29900,0,29900,145639,0,175539
191647600800000,SW 433,Residential,29899,0,29899,181116,0,211015
191647600900000,SW 433,Residential,29900,0,29900,186857,0,216757
191647601000000,SW 433,Residential,27784,0,27784,154365,0,182149
191647601100000,SW 433,Residential,31762,0,31762,135468,0,167230
191647601200000,SW 433,Residential,37255,0,37255,165116,0,202371
191647601300000,SW 433,Residential,35252,0,35252,183023,0,218275
191647601400000,SW 433,Residential,34523,0,34523,131344,0,165867
191647601500000,SW 433,Residential,35529,0,35529,105130,0,140659
191647601600000,SW 433,Residential,30346,0,30346,123093,0,153439
191647601700000,SW 433,Residential,31494,0,31494,124512,0,156006
191647601800000,SW 433,Residential,31524,0,31524,195401,0,226925
191647601900000,SW 433,Residential,31472,0,31472,0,0,31472
191647602000000,SW 433,Residential,39370,0,39370,218665,0,258035
191647602100000,SW 433,Residential,39251,0,39251,236003,0,275254
191647602200000,SW 433,Residential,43435,0,43435,254514,0,297949
191647602300000,SW 433,Residential,40600,0,40600,178142,0,218742
191647602400000,SW 433,Residential,40680,0,40680,242083,0,282763
191647602500000,SW 433,Residential,42265,0,42265,231918,0,274183
191647602600000,SW 433,Residential,39433,0,39433,219065,0,258498
191647602700000,SW 433,Residential,35701,0,35701,174861,0,210562
191647602800000,SW 433,Residential,42653,0,42653,236033,0,278686
191647602900000,SW 433,Residential,43636,0,43636,202248,0,245884
191647603000000,SW 433,Residential,38400,0,38400,202295,0,240695
191647603100000,SW 433,Residential,36874,0,36874,156616,0,193490
191647603200000,SW 433,Residential,36078,0,36078,145187,0,181265
191647603300000,SW 433,Residential,34665,0,34665,152335,0,187000
191647603400000,SW 433,Residential,40818,0,40818,0,0,40818
191647603500000,SW 433,Residential,40673,0,40673,199601,0,240274
191647603600000,SW 433,Residential,33264,0,33264,0,0,33264
191647700100000,SW 433,Residential,37450,0,37450,205285,0,242735
191647700200000,SW 433,Residential,37827,0,37827,162173,0,200000
191647700300000,CITY PROPERTY,Exempt,0,0,0,0,0,0
191647700400000,SW 433,Residential,38520,0,38520,202514,0,241034
191647700500000,SW 433,Residential,35425,0,35425,197140,0,232565
191647700600000,SW 433,Residential,36075,0,36075,168897,0,204972
191647700700000,SW 433,Residential,34580,0,34580,144523,0,179103
191647700800000,SW 433,Residential,37039,0,37039,166131,0,203170
191647700900000,SW 433,Residential,37952,0,37952,140224,0,178176
191647701000000,SW 433,Residential,42559,0,42559,184419,0,226978
191647701100000,SW 433,Residential,38405,0,38405,189227,0,227632
191647701200000,SW 433,Residential,31525,0,31525,190441,0,221966
191647701300000,SW 433,Residential,31525,0,31525,161369,0,192894
191647701400000,SW 433,Residential,37448,0,37448,139025,0,176473
191647701500000,SW 433,Residential,35880,0,35880,146016,0,181896
191647701600000,SW 433,Residential,35880,0,35880,158368,0,194248
191647701700000,SW 433,Residential,35880,0,35880,145606,0,181486
191647701800000,SW 433,Residential,37440,0,37440,196267,0,233707
191647701900000,SW 433,Residential,35489,0,35489,181630,0,217119
191647702000000,SW 433,Residential,39620,0,39620,230093,0,269713
191647702100000,SW 433,Residential,39765,0,39765,219210,0,258975
191647702200000,SW 433,Residential,42924,0,42924,230181,0,273105
191647702300000,SW 433,Residential,38590,0,38590,193104,0,231694
191647702400000,SW 433,Residential,39330,0,39330,150882,0,190212
191647702500000,SW 433,Residential,40320,0,40320,203554,0,243874
191647702600000,SW 433,Residential,40320,0,40320,209182,0,249502
191647702700000,SW 433,Residential,41325,0,41325,190472,0,231797
191647702800000,SW 433,Residential,40890,0,40890,107522,0,148412
191647702900000,SW 433,Residential,38516,0,38516,153633,0,192149
191647800100000,SW 433,Residential,35880,0,35880,145138,0,181018
191647800200000,SW 433,Residential,35880,0,35880,169663,0,205543
191647800300000,SW 433,Residential,35880,0,35880,131410,0,167290
191647800400000,SW 433,Residential,35880,0,35880,158064,0,193944
191647800500000,SW 433,Residential,35881,0,35881,163572,0,199453
191647800600000,SW 433,Residential,35880,0,35880,125780,0,161660
191647800700000,SW 433,Residential,35880,0,35880,171061,0,206941
191710100100000,VACANT LAND,Industrial,0,93960,93960,0,0,93960
191710100300000,SHOP,Commercial,0,127170,127170,0,581351,708521
191710100400000,SHOP,Commercial,0,44550,44550,0,169766,214316
191710100500000,SHOP,Commercial,0,38880,38880,0,192165,231045
191710200100000,VETERINARY CLINIC,Commercial,0,51030,51030,0,123363,174393
191710200200000,SW 418,Residential,54600,0,54600,81327,0,135927
191710200300000,FLAT PARKING,Commercial,0,148338,148338,0,70680,219018
191710200700000,VACANT LAND,Industrial,0,101614,101614,0,0,101614
191710200800000,WAREHOUSE,Commercial,0,171525,171525,0,540958,712483
191710201200000,VACANT LAND,Industrial,0,52974,52974,0,0,52974
191710201300000,VACANT LAND,Industrial,0,50706,50706,0,0,50706
191710201401000,SHOP,Commercial,0,159952,159952,0,1202550,1362502
191710201401001,WAREHOUSE,Commercial,0,93501,93501,0,601827,695328
191710201500000,WAREHOUSE,Commercial,0,167762,167762,0,605528,773290
191710201700000,WAREHOUSE,Commercial,0,47709,47709,0,230166,277875
191710201800000,WAREHOUSE,Commercial,0,48320,48320,0,244099,292419
191710202000000,CONC/ASPH;INDUSTRIAL,Industrial,0,250992,250992,0,436144,687136
191710202100000,VACANT LAND,Industrial,0,112347,112347,0,0,112347
191710202200000,WAREHOUSE,Commercial,0,91773,91773,0,586253,678026
191712600100000,WAREHOUSE,Commercial,0,26098,26098,0,171626,197724
191712600200000,SW 418,Residential,67500,0,67500,100581,0,168081
191712600300000,WAREHOUSE,Commercial,0,36855,36855,0,205756,242611
191712600400000,CITY PROPERTY,Exempt,0,0,0,0,0,0
191712600500000,WAREHOUSE,Commercial,0,169938,169938,0,401198,571136
191712600600000,WAREHOUSE,Commercial,0,262818,262818,0,346921,609739
191712600700000,EQUIPMENT MFG;INDUST,Industrial,0,285822,285822,0,1385560,1671382
191712600800000,WAREHOUSE,Commercial,0,224100,224100,0,601908,826008
191712600900000,CENTRALLY ASSESSED,Other,0,0,0,0,0,0
191712700100000,WAREHOUSE,Commercial,0,204012,204012,0,1327341,1531353
191712700200000,SHOP,Commercial,0,113400,113400,0,405464,518864
191712700300000,SHOP,Commercial,0,61236,61236,0,37170,98406
191712700400000,VACANT LAND,Commercial,0,94770,94770,0,0,94770
191712700500000,WAREHOUSE,Commercial,0,146610,146610,0,329545,476155
191715100100000,FOOD GRADE;INDUST,Industrial,0,250441,250441,0,152091,402532
191715200100000,VACANT LAND,Commercial,0,124447,124447,0,0,124447
191715200200000,FLAT PARKING,Commercial,0,202716,202716,0,45990,248706
191715200300000,WAREHOUSE,Commercial,0,100440,100440,0,303333,403773
191715200400000,WAREHOUSE,Commercial,0,166536,166536,0,197233,363769
191715300100000,WAREHOUSE,Commercial,0,218106,218106,0,674590,892696
191715300200000,FLAT PARKING,Commercial,0,13381,13381,0,10125,23506
191715300300000,FLAT PARKING,Commercial,0,80676,80676,0,65988,146664
191715400100000,SHOP,Commercial,0,217620,217620,0,634498,852118
191717600100000,WAREHOUSE,Commercial,0,153446,153446,0,331660,485106
191717600200000,SHOP,Commercial,0,167292,167292,0,363513,530805
191717600300000,VACANT LAND,Commercial,0,57996,57996,0,0,57996
191717600400000,SHOP,Industrial,0,210643,210643,0,1748350,1958993
191717600500000,WAREHOUSE,Commercial,0,48843,48843,0,124575,173418
191717600600000,WAREHOUSE,Commercial,0,58482,58482,0,194299,252781
191717600700000,SMALL RETAIL,Commercial,0,21074,21074,0,88392,109466
191717600800000,WAREHOUSE,Commercial,0,36855,36855,0,126646,163501
191717600900000,SMALL RETAIL,Commercial,0,57894,57894,0,92146,150040
191717601000000,VACANT LAND,Commercial,0,48608,48608,0,0,48608
191717601002000,BILLBOARD(BLL),Commercial,0,0,0,0,11812,11812
191717700100000,LG DISCOUNT/RETAIL,Commercial,0,186840,186840,0,268833,455673
191717700200000,WAREHOUSE,Commercial,0,68283,68283,0,127976,196259
191717700300000,WAREHOUSE,Commercial,0,62775,62775,0,208963,271738
191717700400000,WAREHOUSE,Commercial,0,60750,60750,0,50383,111133
191717700500000,WAREHOUSE,Commercial,0,237924,237924,0,669888,907812
191717700600000,WAREHOUSE,Commercial,0,49013,49013,0,129075,178088
191717700700000,SHOP,Commercial,0,170640,170640,0,198228,368868
191717800100000,EQUIPMENT MFG;INDUST,Industrial,0,98820,98820,0,206788,305608
191717800200000,WAREHOUSE,Commercial,0,231552,231552,0,1438786,1670338
191717800400000,WAREHOUSE,Commercial,0,71204,71204,0,150877,222081
191717800500000,WAREHOUSE,Commercial,0,135270,135270,0,197319,332589
191722600100000,SW 418,Ag Land,34856,0,34856,0,0,34856
191725100100000,SW 418,Ag Land,42436,0,42436,0,0,42436
191727600100000,FOOD GRADE;INDUST,Industrial,0,2632797,2632797,0,69945594,72578391
191732600100000,SW 418,Ag Land,44180,0,44180,0,0,44180
191735100100000,SW 418,Ag Land,41208,0,41208,0,0,41208
191737600300000,VACANT LAND,Commercial,0,133650,133650,0,0,133650
191737600500000,VACANT LAND,Industrial,0,264514,264514,0,0,264514
191737600600000,WAREHOUSE,Commercial,0,270756,270756,0,3784228,4054984
191737700100000,EQUIPMENT MFG;INDUST,Industrial,0,374112,374112,0,5326127,5700239
191740100100000,SW 418,Ag Dwelling,61136,0,61136,104816,8649,174601
191742600100000,SW 418,Ag Land,56197,0,56197,0,0,56197
191745100100000,SW 418,Ag Land,67346,0,67346,0,0,67346
191747600100000,SW 418,Ag Land,54604,0,54604,0,0,54604
191810100100000,SW 418,Ag Dwelling,52044,0,52044,82151,12257,146452
191812600100000,FEED/ADDITIVE;INDUST,Industrial,0,416602,416602,0,3122683,3539285
191815100100000,SW 418,Ag Land,66016,0,66016,0,0,66016
191817600100000,SW 418,Ag Land,64647,0,64647,0,0,64647
191820100100000,FLAT PARKING,Commercial,0,296931,296931,0,75000,371931
191820100200000,SW 418,Residential,82375,0,82375,88089,0,170464
191822600100000,SW 418,Ag Land,61249,0,61249,0,0,61249
191825100100000,SW 418,Ag Land,63696,0,63696,0,1187,64883
191825100200000,SW 418,Residential,95100,0,95100,123501,0,218601
191827600100000,SW 418,Ag Land,62652,0,62652,0,0,62652
191830100100000,SW 418,Ag Land,62261,0,62261,0,0,62261
191832600100000,SW 418,Ag Land,65062,0,65062,0,0,65062
191835100100000,SW 418,Ag Land,64116,0,64116,0,0,64116
191837600100000,SW 418,Ag Dwelling,65079,0,65079,53098,4002,122179
191840100100000,SW 418,Ag Land,66371,0,66371,0,0,66371
191842600100000,SW 418,Ag Land,66120,0,66120,0,0,66120
191845100100000,SW 418,Ag Land,65082,0,65082,0,0,65082
191847600100000,SW 418,Ag Land,62028,0,62028,0,0,62028
191847600200000,SW 418,Residential,49128,0,49128,0,0,49128
191910100100000,WAREHOUSE,Commercial,0,913086,913086,0,22203666,23116752
191917600100000,CITY PROPERTY,Exempt,0,0,0,0,0,0
191920100100000,CITY PROPERTY,Exempt,0,0,0,0,0,0
192010100100000,SW 418,Ag Dwelling,64857,0,64857,112502,4228,181587
192012600100000,SW 418,Ag Land,65071,0,65071,0,0,65071
192015100100000,SW 422,Ag Land,66540,0,66540,0,0,66540
192017600100000,WAREHOUSE,Commercial,0,843386,843386,0,3324313,4167699
192020100100000,EQUIPMENT MFG;INDUST,Industrial,0,617274,617274,0,5030355,5647629
192020100200000,OFFICE,Commercial,0,233010,233010,0,387552,620562
192020100300000,SW 418,Ag Land,10380,0,10380,0,0,10380
192022600100000,CITY PROPERTY,Exempt,0,0,0,0,0,0
192022600200000,SW 418,Ag Land,30583,0,30583,0,0,30583
192025100100000,SW 418,Ag Dwelling,58272,0,58272,100943,2334,161549
192027600100000,SW 418,Ag Land,66490,0,66490,0,0,66490
192030100300000,CITY PROPERTY,Exempt,0,0,0,0,0,0
192032600100000,CITY PROPERTY,Exempt,0,0,0,0,0,0
192037600200000,CITY PROPERTY,Exempt,0,0,0,0,0,0
192037600400000,CITY PROPERTY,Exempt,0,0,0,0,0,0
192037600500000,CITY PROPERTY,Exempt,0,0,0,0,0,0
192040100100000,SW 418,Ag Land,67365,0,67365,0,10184,77549
192040100102000,BILLBOARD(BLL),Commercial,0,0,0,0,11377,11377
192042600100000,SW 418,Ag Land,66298,0,66298,0,0,66298
192045100100000,SW 418,Ag Land,53880,0,53880,0,0,53880
192045200100000,SW 418,Ag Land,24401,0,24401,0,0,24401
192047600100000,VACANT LAND,Commercial,0,321705,321705,0,0,321705
192047600200000,VACANT LAND,Commercial,0,941,941,0,0,941
192047600300000,FLAT PARKING,Commercial,0,263520,263520,0,7992,271512
192047600400000,CONVENIENCE STORE,Commercial,0,248400,248400,0,551600,800000
192047700100000,HOTEL,Commercial,0,464400,464400,0,1179773,1644173
192047800100000,VACANT LAND,Commercial,0,321840,321840,0,0,321840
192047800200000,HOTEL,Commercial,0,446580,446580,0,1353420,1800000
192110100100000,SCHOOL,Exempt,0,0,0,0,0,0
192112600100000,SCHOOL,Exempt,0,0,0,0,0,0
192115100200000,SCHOOL,Exempt,0,0,0,0,0,0
192117600100000,SCHOOL,Exempt,0,0,0,0,0,0
192122600100000,SW 418,Ag Land,46355,0,46355,0,0,46355
192125100100000,SW 418,Ag Dwelling,56340,0,56340,78409,7349,142098
192125100102000,BILLBOARD(BLL),Commercial,0,0,0,0,48943,48943
192130100100000,SW 456,Ag Land,57223,0,57223,0,0,57223
192132600100000,VACANT LAND,Commercial,0,423967,423967,0,0,423967
192132600200000,VACANT LAND,Commercial,0,428355,428355,0,0,428355
192135100100000,VACANT LAND,Commercial,0,433701,433701,0,0,433701
192135100200000,VACANT LAND,Commercial,0,27000,27000,0,0,27000
192135100400000,VACANT LAND,Commercial,0,448362,448362,0,0,448362
192135100500000,FAST FOOD,Commercial,0,293760,293760,0,734873,1028633
192135100600000,VACANT LAND,Commercial,0,252720,252720,0,0,252720
192135100700000,VACANT LAND,Commercial,0,216437,216437,0,0,216437
192137600100000,SW 456,Ag Land,41035,0,41035,0,0,41035
192140100200000,SW 452,Residential,21162,0,21162,114532,0,135694
192140100300000,SW 452,Residential,21162,0,21162,113005,0,134167
192140100400000,SW 452,Residential,21038,0,21038,112870,0,133908
192140100500000,SW 452,Residential,21038,0,21038,112870,0,133908
192140100600000,SW 452,Residential,21038,0,21038,112870,0,133908
192140100700000,SW 452,Residential,21038,0,21038,112870,0,133908
192140100800000,SW 452,Residential,21038,0,21038,112870,0,133908
192140100900000,SW 452,Residential,21038,0,21038,112870,0,133908
192140101000000,SW 452,Residential,23549,0,23549,112870,0,136419
192140101100000,SW 452,Residential,22938,0,22938,112870,0,135808
192140101200000,SW 452,Residential,23883,0,23883,119326,0,143209
192140101300000,SW 452,Residential,27625,0,27625,120683,0,148308
192140101400000,SW 452,Residential,28987,0,28987,139076,0,168063
192140101500000,SW 452,Residential,24709,0,24709,145117,0,169826
192140101600000,SW 452,Residential,23241,0,23241,117858,0,141099
192140101700000,SW 452,Residential,24442,0,24442,134774,0,159216
192140101800000,SW 452,Residential,24194,0,24194,118684,0,142878
192140101900000,SW 452,Residential,24194,0,24194,117466,0,141660
192140102000000,SW 452,Residential,24194,0,24194,136864,0,161058
192140102100000,SW 452,Residential,24194,0,24194,129413,0,153607
192140102200000,SW 452,Residential,23760,0,23760,123920,0,147680
192140102300000,SW 452,Residential,23890,0,23890,125526,0,149416
192140102400000,SW 452,Residential,7013,0,7013,0,0,7013
192140102500000,SW 452,Residential,63595,0,63595,142160,0,205755
192140102600000,SW 452,Residential,36213,0,36213,151923,0,188136
192140102700000,SW 452,Residential,34650,0,34650,152762,0,187412
192140102800000,SW 452,Residential,34650,0,34650,145910,0,180560
192140102900000,SW 452,Residential,34650,0,34650,139329,0,173979
192140103000000,SW 452,Residential,34650,0,34650,163620,0,198270
192140103100000,SW 452,Residential,40931,0,40931,156862,0,197793
192140103200000,SW 452,Residential,41846,0,41846,153893,0,195739
192140103300000,SW 452,Residential,37385,0,37385,186785,0,224170
192140103400000,SW 452,Residential,38393,0,38393,184884,0,223277
192140103500000,SW 452,Residential,47040,0,47040,151583,0,198623
192140103600000,SW 452,Residential,41253,0,41253,143969,0,185222
192140103700000,SW 452,Residential,37450,0,37450,144048,0,181498
192140103800000,SW 452,Residential,52189,0,52189,133803,0,185992
192140103900000,SW 452,Residential,48314,0,48314,146980,0,195294
192140104000000,SW 452,Residential,47861,0,47861,150777,0,198638
192140104100000,SW 452,Residential,53937,0,53937,129966,0,183903
192140104200000,SW 452,Residential,51623,0,51623,142372,0,193995
192140104300000,SW 452,Residential,42966,0,42966,151687,0,194653
192140104400000,SW 452,Residential,42385,0,42385,156163,0,198548
192140104500000,SW 452,Residential,35467,0,35467,136888,0,172355
192140104600000,SW 452,Residential,61110,0,61110,187330,0,248440
192140104700000,SW 452,Residential,46529,0,46529,132535,0,179064
192140104800000,SW 452,Residential,45050,0,45050,197231,0,242281
192140104900000,SW 452,Residential,44650,0,44650,137428,0,182078
192140105000000,SW 452,Residential,332,0,332,0,0,332
192140105100000,SW 452,Residential,248,0,248,0,0,248
192140105200000,SW 452,Residential,238,0,238,0,0,238
192140105300000,SW 452,Residential,238,0,238,0,0,238
192140105400000,SW 452,Residential,238,0,238,0,0,238
192140105500000,SW 452,Residential,238,0,238,0,0,238
192140105600000,SW 452,Residential,238,0,238,0,0,238
192140105700000,SW 452,Residential,243,0,243,0,0,243
192140105800000,SW 452,Residential,296,0,296,0,0,296
192140105900000,SW 452,Residential,44896,0,44896,150589,0,195485
192140106000000,SW 452,Residential,573,0,573,0,0,573
192140200100000,SW 452,Residential,47101,0,47101,141854,0,188955
192140200200000,SW 452,Residential,36346,0,36346,150539,0,186885
192140200300000,SW 452,Residential,38115,0,38115,162757,0,200872
192140200400000,SW 452,Residential,38115,0,38115,135109,0,173224
192140200500000,SW 452,Residential,38115,0,38115,142789,0,180904
192140200600000,SW 452,Residential,30194,0,30194,134177,0,164371
192140200700000,SW 452,Residential,37884,0,37884,130109,0,167993
192140200800000,SW 452,Residential,37884,0,37884,136928,0,174812
192140200900000,SW 452,Residential,37884,0,37884,127824,0,165708
192140201000000,SW 452,Residential,37884,0,37884,161806,0,199690
192140201100000,SW 452,Residential,38437,0,38437,131443,0,169880
192140201200000,SW 452,Residential,42405,0,42405,146856,0,189261
192140201300000,SW 452,Residential,38115,0,38115,148383,0,186498
192140201400000,SW 452,Residential,38115,0,38115,151819,0,189934
192140201500000,SW 452,Residential,37868,0,37868,140758,0,178626
192140201600000,SW 452,Residential,45187,0,45187,147947,0,193134
192140300100000,SW 452,Residential,40045,0,40045,128519,0,168564
192140300200000,SW 452,Residential,39872,0,39872,139095,0,178967
192140300300000,SW 452,Residential,38164,0,38164,131162,0,169326
192140300400000,SW 452,Residential,38164,0,38164,132516,0,170680
192140300500000,SW 452,Residential,38164,0,38164,131162,0,169326
192140300600000,SW 452,Residential,44086,0,44086,138698,0,182784
192140300700000,SW 452,Residential,444,0,444,0,0,444
192140300800000,SW 452,Residential,310,0,310,0,0,310
192140300900000,SW 452,Residential,314,0,314,0,0,314
192140301000000,SW 452,Residential,314,0,314,0,0,314
192140301100000,SW 452,Residential,40737,0,40737,164719,0,205456
192140301200000,SW 452,Residential,265,0,265,0,0,265
192140301300000,SW 452,Residential,266,0,266,0,0,266
192140301400000,SW 452,Residential,237,0,237,0,0,237
192140301500000,SW 452,Residential,260,0,260,0,0,260
192140301600000,SW 452,Residential,295,0,295,0,0,295
192140301700000,SW 452,Residential,350,0,350,0,0,350
192140301800000,SW 452,Residential,324,0,324,0,0,324
192140301900000,SW 452,Residential,279,0,279,0,0,279
192140400200000,SW 452,Residential,237,0,237,0,0,237
192140400300000,SW 452,Residential,237,0,237,0,0,237
192140400400000,SW 452,Residential,237,0,237,0,0,237
192140400500000,SW 452,Residential,274,0,274,0,0,274
192140400600000,SW 452,Residential,413,0,413,0,0,413
192140400700000,SW 452,Residential,239,0,239,0,0,239
192142600100000,SW 456,Ag Land,67819,0,67819,0,0,67819
192145100200000,SW 456,Ag Land,7588,0,7588,0,0,7588
192145100300000,OFFICE,Commercial,0,201744,201744,0,2203495,2405239
192145100400000,SW 456,Ag Land,8562,0,8562,0,0,8562
192145200100000,OFFICE,Commercial,0,221508,221508,0,3913458,4134966
192145200200000,SW 456,Ag Land,23900,0,23900,0,0,23900
192145200300000,SW 456,Ag Land,4460,0,4460,0,0,4460
192147600300000,SW 418,Ag Land,58242,0,58242,0,0,58242
192147600400000,SW 452,Residential,251,0,251,0,0,251
192147600500000,SW 452,Residential,39900,0,39900,137697,0,177597
192147600600000,SW 452,Residential,262,0,262,0,0,262
192147600700000,SW 452,Residential,320,0,320,0,0,320
192147600800000,SW 452,Residential,464,0,464,0,0,464
192147601000000,SW 452,Residential,280,0,280,0,0,280
192222600300000,EDUCATIONAL/COLLEGE,Exempt,0,0,0,0,0,0
192225100300000,SCHOOL,Exempt,0,0,0,0,0,0
192820100100000,VACANT LAND,Commercial,0,608850,608850,0,0,608850
192820100200000,WAREHOUSE,Commercial,0,520560,520560,0,8609440,9130000
192822600100000,VACANT LAND,Commercial,0,316440,316440,0,0,316440
192822600200000,CONVENIENCE STORE,Commercial,0,308629,308629,0,458042,766671
192822600300000,VACANT LAND,Commercial,0,248400,248400,0,0,248400
192822600500000,WAREHOUSE,Commercial,0,317358,317358,0,540951,858309
192822600700000,AUTO REPAIR/SALES,Commercial,0,260642,260642,0,612055,872697
192822600800000,FLAT PARKING,Commercial,0,111221,111221,0,242209,353430
192825100100000,SW 422,Ag Land,16235,0,16235,0,0,16235
192825100200000,WAREHOUSE,Commercial,0,381240,381240,0,3958924,4340164
192825100300000,SW 422,Ag Land,26011,0,26011,0,0,26011
192825100302000,ANTENNAS/TOWERS(BLL),Commercial,0,0,0,0,105912,105912
192832600200000,SE 218,Ag Land,112013,0,112013,0,0,112013
192835100400000,WAREHOUSE,Commercial,0,286734,286734,0,4052097,4338831
192910100100000,VACANT LAND,Commercial,0,420255,420255,0,0,420255
192910100200000,OFFICE; MEDICAL,Commercial,0,475200,475200,0,1216259,1691459
192910200100000,OFFICE,Commercial,0,357912,357912,0,1440393,1798305
192910200200000,WAREHOUSE,Commercial,0,213570,213570,0,1222184,1435754
192910200201000,WAREHOUSE,Commercial,0,38745,38745,0,290716,329461
192910200300000,WAREHOUSE,Commercial,0,277560,277560,0,1425940,1703500
192910300100000,VACANT LAND,Commercial,0,157680,157680,0,0,157680
192910300200000,WAREHOUSE,Commercial,0,219780,219780,0,498279,718059
192910300300000,VETERINARY CLINIC,Commercial,0,129600,129600,0,756679,886279
192912600300000,SW 418,Residential,41039,0,41039,108278,0,149317
192912600400000,SW 418,Residential,32436,0,32436,127242,0,159678
192912600500000,SW 418,Residential,24000,0,24000,104605,0,128605
192912600600000,SW 418,Residential,24000,0,24000,82417,0,106417
192912600700000,SW 418,Residential,26448,0,26448,84769,0,111217
192912600800000,SW 418,Residential,28356,0,28356,84199,0,112555
192912600900000,SW 418,Residential,27576,0,27576,123647,0,151223
192912601100000,SW 418,Residential,37122,0,37122,121425,0,158547
192912601200000,SW 422,Ag Land,21278,0,21278,0,16602,37880
192912601400000,WAREHOUSE,Commercial,0,261900,261900,0,909902,1171802
192912601500000,SW 418,Ag Land,115,0,115,0,0,115
192912601600000,VACANT LAND,Commercial,0,30780,30780,0,0,30780
192912601700000,SW 418,Ag Land,30202,0,30202,0,0,30202
192915100200000,WAREHOUSE,Commercial,0,410400,410400,0,2450853,2861253
192915100300000,SW 418,Ag Land,58766,0,58766,0,0,58766
192915100400000,SW 418,Ag Land,57,0,57,0,0,57
192917600100000,SW 418,Ag Land,44988,0,44988,0,0,44988
192917600200000,SW 418,Residential,101500,0,101500,157932,0,259432
192917600300000,SW 418,Residential,1045,0,1045,0,0,1045
192917600400000,CENTRALLY ASSESSED,Other,0,0,0,0,0,0
192917700100000,OFFICE,Commercial,0,313686,313686,0,1849969,2163655
192917700200000,SW 416,Ag Land,4654,0,4654,0,0,4654
192920100200000,SW 418,Ag Land,3592,0,3592,0,7578,11170
192920100300000,SW 418,Ag Land,25197,0,25197,0,0,25197
192920100400000,CITY PROPERTY,Exempt,0,0,0,0,0,0
192920100500000,SW 418,Residential,52300,0,52300,120987,0,173287
192920100600000,SW 418,Residential,51150,0,51150,97980,0,149130
192920100700000,SW 418,Ag Land,1408,0,1408,0,0,1408
192920100800000,SW 418,Ag Land,457,0,457,0,0,457
192922600100000,SW 418,Residential,760,0,760,0,0,760
192922600300000,SW 418,Residential,31120,0,31120,99218,0,130338
192922600500000,SW 418,Residential,30943,0,30943,113050,0,143993
192922600600000,SW 418,Residential,30943,0,30943,166698,0,197641
192922600700000,SW 418,Residential,33263,0,33263,93888,0,127151
192922600800000,VACANT LAND,Commercial,0,159021,159021,0,0,159021
192922600900000,VACANT LAND,Commercial,0,170316,170316,0,0,170316
192922601000000,WAREHOUSE,Commercial,0,37703,37703,0,30799,68502
192922601200000,SW 418,Residential,47324,0,47324,112586,0,159910
192922601300000,SW 418,Residential,31273,0,31273,90573,0,121846
192922601400000,SW 418,Residential,760,0,760,0,0,760
192922601500000,WAREHOUSE,Commercial,0,97902,97902,0,367440,465342
192922601600000,SHOP,Commercial,0,113724,113724,0,0,113724
192922601800000,WAREHOUSE,Commercial,0,204660,204660,0,852903,1057563
192922601900000,WAREHOUSE,Commercial,0,171191,171191,0,1717440,1888631
192922700100000,SW 418,Residential,760,0,760,0,0,760
192922700200000,SW 418,Residential,760,0,760,0,0,760
192922700300000,SW 418,Residential,32185,0,32185,107508,0,139693
192922700400000,SW 418,Residential,35520,0,35520,88538,0,124058
192922700500000,SW 418,Residential,35017,0,35017,85731,0,120748
192922700600000,SW 418,Residential,36097,0,36097,121882,0,157979
192922700700000,SW 418,Residential,35520,0,35520,119701,0,155221
192922700800000,SW 418,Residential,30765,0,30765,83700,0,114465
192922800100000,VACANT LAND,Commercial,0,140810,140810,0,0,140810
192922800102000,MISCELLANEOUS,Commercial,0,0,0,0,32784,32784
192922800200000,VACANT LAND,Commercial,0,14742,14742,0,0,14742
192922800300000,SW 418,Residential,12644,0,12644,43570,0,56214
192940100100000,SW 418,Residential,62700,0,62700,122742,0,185442
192940100200000,SW 418,Ag Land,65413,0,65413,0,0,65413
192942600100000,SW 418,Ag Land,72577,0,72577,0,0,72577
192947600100000,WAREHOUSE,Commercial,0,232200,232200,0,560342,792542
192947600300000,MATERIALS MFG;INDUST,Industrial,0,150380,150380,0,1826348,1976728
192947600400000,VACANT LAND,Commercial,0,99604,99604,0,0,99604
192947600500000,VACANT LAND,Commercial,0,100284,100284,0,0,100284
192947700100000,WAREHOUSE,Commercial,0,230634,230634,0,341774,572408
193010100100000,CITY PROPERTY,Exempt,0,0,0,0,0,0
193020100100000,VACANT LAND,Commercial,0,275184,275184,0,0,275184
193020100200000,WAREHOUSE,Commercial,0,402840,402840,0,1320651,1723491
193020100300000,WAREHOUSE,Commercial,0,52164,52164,0,324363,376527
193020100400000,WAREHOUSE,Commercial,0,99765,99765,0,193761,293526
193020100500000,CITY PROPERTY,Exempt,0,0,0,0,0,0
193037600100000,CITY PROPERTY,Exempt,0,0,0,0,0,0
193047600100000,STATE PROPERTY,Exempt,0,0,0,0,0,0
193110100100000,CITY PROPERTY,Exempt,0,0,0,0,0,0
193222600100000,CITY PROPERTY,Exempt,0,0,0,0,0,0
193240100200000,SW 418,Ag Dwelling,8492,0,8492,176117,12472,197081
193242600200000,SW 418,Ag Land,131624,0,131624,0,0,131624
193322601200000,WAREHOUSE,Commercial,0,339606,339606,0,3395398,3735004
193322601300000,SW 418,Ag Land,10679,0,10679,0,0,10679
193322601400000,SW 418,Ag Land,7788,0,7788,0,0,7788
193322601500000,VACANT LAND,Commercial,0,9671,9671,0,0,9671
193325100300000,WAREHOUSE,Commercial,0,393925,393925,0,4054640,4448565
193325100600000,SW 422,Ag Land,18116,0,18116,0,0,18116
193325100700000,SW 422,Ag Land,5235,0,5235,0,0,5235
193325100800000,SW 422,Ag Land,15368,0,15368,0,0,15368
193325101100000,VACANT LAND,Commercial,0,7180,7180,0,0,7180
193332600100000,SW 422,Ag Land,55473,0,55473,0,0,55473
193335100200000,SW 418,Residential,38400,0,38400,97448,0,135848
193335100300000,SW 418,Residential,33600,0,33600,89131,0,122731
193335100400000,SW 418,Residential,61850,0,61850,77671,0,139521
193335100500000,SW 418,Ag Land,15351,0,15351,0,0,15351
193335100600000,SW 418,Ag Land,62394,0,62394,0,0,62394
200110100200000,LG DISCOUNT/RETAIL,Commercial,0,1688688,1688688,0,9083506,10772194
200110100300000,FAST FOOD,Commercial,0,298728,298728,0,545901,844629
200110100400000,NBHD SHOPPING CENTER,Commercial,0,747576,747576,0,2145151,2892727
200110100500000,NBHD SHOPPING CENTER,Commercial,0,361800,361800,0,699196,1060996
200110100700000,SERVICE STATION,Commercial,0,319788,319788,0,223915,543703
200110100900000,FAST FOOD,Commercial,0,298080,298080,0,569035,867115
200110101000000,CARWASH,Commercial,0,297432,297432,0,284393,581825
200110300100000,CHURCH,Exempt,0,1296,1296,0,0,1296
200112600200000,BRANCH BANK/CU,Commercial,0,537300,537300,0,1166435,1703735
200112600500000,AUTO REPAIR/SALES,Commercial,0,705991,705991,0,633751,1339742
200112700600000,VACANT LAND,Commercial,0,985068,985068,0,0,985068
200115100100000,SW 407,Ag Land,7783,0,7783,0,0,7783
200115100200000,SW 431,Residential,25760,0,25760,186722,0,212482
200115100300000,SW 431,Residential,25760,0,25760,166800,0,192560
200115100500000,SW 431,Residential,25760,0,25760,222085,0,247845
200115100600000,SW 431,Residential,25760,0,25760,183284,0,209044
200115100700000,SW 431,Residential,25760,0,25760,175575,0,201335
200115100800000,SW 431,Residential,25760,0,25760,167856,0,193616
200115100900000,SW 431,Residential,25760,0,25760,154684,0,180444
200115101000000,SW 431,Residential,25916,0,25916,158960,0,184876
200115101100000,SW 431,Residential,25760,0,25760,152828,0,178588
200115101200000,SW 431,Residential,37913,0,37913,149468,0,187381
200115101300000,SW 431,Residential,27600,0,27600,164280,0,191880
200115200300000,SW 431,Residential,31501,0,31501,176335,0,207836
200115200400000,SW 431,Residential,29440,0,29440,125534,0,154974
200115200500000,SW 431,Residential,29440,0,29440,201422,0,230862
200115200600000,SW 431,Residential,29440,0,29440,178952,0,208392
200115200700000,SW 431,Residential,31501,0,31501,210004,0,241505
200115200900000,SW 431,Residential,30415,0,30415,177194,0,207609
200115201000000,SW 431,Residential,29440,0,29440,179992,0,209432
200115201100000,SW 431,Residential,29440,0,29440,165811,0,195251
200115201200000,SW 431,Residential,29440,0,29440,165576,0,195016
200115201300000,SW 431,Residential,31560,0,31560,155864,0,187424
200115300100000,SW 431,Residential,28177,0,28177,163953,0,192130
200115300200000,SW 431,Residential,29440,0,29440,168653,0,198093
200115300300000,SW 431,Residential,29440,0,29440,171671,0,201111
200115300400000,SW 431,Residential,29440,0,29440,162042,0,191482
200115300500000,SW 431,Residential,29744,0,29744,169898,0,199642
200115400100000,SW 431,Residential,25760,0,25760,168863,0,194623
200115400200000,SW 431,Residential,25760,0,25760,170360,0,196120
200115400300000,SW 431,Residential,25760,0,25760,162785,0,188545
200115400400000,SW 431,Residential,25513,0,25513,153751,0,179264
200115400500000,SW 431,Residential,25760,0,25760,139642,0,165402
200115400600000,SW 431,Residential,29440,0,29440,173566,0,203006
200115500100000,SW 431,Residential,31190,0,31190,172020,0,203210
200115500200000,SW 431,Residential,30720,0,30720,160986,0,191706
200115500300000,SW 431,Residential,30720,0,30720,159024,0,189744
200115500400000,SW 431,Residential,30720,0,30720,162422,0,193142
200115500500000,SW 431,Residential,30396,0,30396,172541,0,202937
200115500600000,SW 407,Residential,28776,0,28776,0,0,28776
200115500700000,SW 407,Residential,27136,0,27136,178286,0,205422
200115500800000,SW 407,Residential,27648,0,27648,113113,0,140761
200115500900000,SW 407,Residential,27648,0,27648,223067,0,250715
200115501000000,SW 407,Residential,29952,0,29952,193919,0,223871
200115600100000,SW 431,Residential,29440,0,29440,155081,0,184521
200115600200000,SW 431,Residential,26126,0,26126,147643,0,173769
200115600300000,SW 407,Residential,30080,0,30080,181634,0,211714
200115600400000,SW 407,Residential,35520,0,35520,316556,0,352076
200115600500000,SW 407,Residential,38332,0,38332,208744,0,247076
200115600600000,SW 407,Residential,32640,0,32640,174142,0,206782
200115600700000,SW 407,Residential,28485,0,28485,0,0,28485
200115600800000,SW 407,Residential,28116,0,28116,173447,0,201563
200115600900000,SW 407,Residential,28116,0,28116,218674,0,246790
200115601000000,SW 407,Residential,28400,0,28400,202652,0,231052
200115601100000,SW 407,Residential,28400,0,28400,215358,0,243758
200115601200000,SW 407,Residential,28400,0,28400,202838,0,231238
200115601300000,SW 407,Residential,28889,0,28889,211111,0,240000
200115601500000,CITY PROPERTY,Exempt,0,0,0,0,0,0
200115700200000,CITY PROPERTY,Exempt,0,0,0,0,0,0
200117600200000,LG DISCOUNT/RETAIL,Commercial,0,1331762,1331762,0,6749276,8081038
200117600300000,NBHD SHOPPING CENTER,Commercial,0,589680,589680,0,1304970,1894650
200117700100000,CHURCH,Exempt,0,882684,882684,0,381013,1263697
200117700200000,SW 431,Residential,26320,0,26320,187230,0,213550
200117700300000,SW 431,Residential,30357,0,30357,212706,0,243063
200117700400000,SW 431,Residential,31262,0,31262,156181,0,187443
200117700500000,SW 431,Residential,29965,0,29965,154856,0,184821
200117700600000,SW 431,Residential,29660,0,29660,142646,0,172306
200117700700000,SW 431,Residential,30660,0,30660,153873,0,184533
200117800100000,SW 431,Residential,29376,0,29376,151252,0,180628
200117800200000,SW 431,Residential,30109,0,30109,136495,0,166604
200117800300000,SW 431,Residential,30410,0,30410,162319,0,192729
200117800400000,SW 431,Residential,29664,0,29664,231145,0,260809
200117800500000,SW 431,Residential,30940,0,30940,209277,0,240217
200117800600000,SW 431,Residential,27300,0,27300,201682,0,228982
200117800700000,SW 431,Residential,27843,0,27843,154727,0,182570
200117800800000,SW 431,Residential,30520,0,30520,166151,0,196671
200117800900000,SW 431,Residential,29648,0,29648,164500,0,194148
200117801000000,SW 431,Residential,40619,0,40619,219684,0,260303
200117801100000,SW 431,Residential,31172,0,31172,165476,0,196648
200117900100000,SW 431,Residential,36213,0,36213,181552,0,217765
200117900200000,SW 431,Residential,27900,0,27900,159262,0,187162
200117900300000,SW 431,Residential,27600,0,27600,184280,0,211880
200117900400000,SW 431,Residential,27600,0,27600,146362,0,173962
200117900500000,SW 431,Residential,28277,0,28277,156508,0,184785
200118000100000,SW 431,Residential,31552,0,31552,170112,0,201664
200118000200000,SW 431,Residential,30172,0,30172,199985,0,230157
200118000300000,SW 431,Residential,28831,0,28831,164565,0,193396
200118000400000,SW 431,Residential,28359,0,28359,178706,0,207065
200118000500000,SW 431,Residential,27979,0,27979,180103,0,208082
200118000600000,SW 431,Residential,25760,0,25760,163998,0,189758
200118000700000,SW 431,Residential,25760,0,25760,151476,0,177236
200118100100000,SW 431,Residential,25760,0,25760,176031,0,201791
200118100200000,SW 431,Residential,25760,0,25760,136030,0,161790
200120100200000,SW 407,Ag Land,42166,0,42166,0,0,42166
200122700200000,SW 407,Ag Land,6372,0,6372,0,0,6372
200132600100000,SW 418,Ag Land,51890,0,51890,0,0,51890
200132600200000,SW 422,Residential,53950,0,53950,196038,0,249988
200132600300000,SW 418,Residential,102000,0,102000,265684,0,367684
200140100500000,BRANCH BANK/CU,Commercial,0,440100,440100,0,486409,926509
200140100600000,VACANT LAND,Commercial,0,273024,273024,0,0,273024
200142900300000,CITY PROPERTY,Exempt,0,0,0,0,0,0
200145100300000,WAREHOUSE,Commercial,0,507600,507600,0,6147325,6654925
200145100500000,WAREHOUSE,Commercial,0,448146,448146,0,4051854,4500000
200145200100000,WAREHOUSE,Commercial,0,243540,243540,0,868248,1111788
200145200200000,WAREHOUSE,Commercial,0,160650,160650,0,202832,363482
200147600100000,VACANT LAND,Commercial,0,244853,244853,0,0,244853
200210100200000,SW 407,Ag Land,38085,0,38085,0,0,38085
200212600300000,SW 453,Residential,44533,0,44533,165192,0,209725
200212600400000,SW 453,Residential,40552,0,40552,157692,0,198244
200212600500000,SW 453,Residential,40552,0,40552,150803,0,191355
200212600600000,SW 453,Residential,40552,0,40552,155803,0,196355
200212600700000,SW 453,Residential,40552,0,40552,161591,0,202143
200212600800000,SW 453,Residential,40552,0,40552,155101,0,195653
200212600900000,SW 453,Residential,40552,0,40552,163803,0,204355
200212601000000,SW 453,Residential,40552,0,40552,160423,0,200975
200212601100000,SW 453,Residential,40552,0,40552,146701,0,187253
200212601200000,SW 453,Residential,40552,0,40552,163024,0,203576
200212601300000,SW 453,Residential,40552,0,40552,200041,0,240593
200212601400000,SW 453,Residential,40552,0,40552,173005,0,213557
200212601500000,SW 453,Residential,40552,0,40552,147588,0,188140
200212601600000,SW 453,Residential,40552,0,40552,152968,0,193520
200212601700000,SW 453,Residential,40552,0,40552,173291,0,213843
200212601800000,SW 453,Residential,40953,0,40953,168691,0,209644
200212602000000,CITY PROPERTY,Exempt,0,0,0,0,0,0
200212602100000,SW 453,Residential,40552,0,40552,144055,0,184607
200212602200000,SW 453,Residential,41076,0,41076,136069,0,177145
200212602300000,SW 453,Residential,40953,0,40953,127536,0,168489
200212602400000,SW 453,Residential,40953,0,40953,139697,0,180650
200212602500000,SW 453,Residential,40552,0,40552,144382,0,184934
200212602600000,SW 453,Residential,40552,0,40552,141821,0,182373
200212602700000,SW 453,Residential,40552,0,40552,141338,0,181890
200212602800000,SW 453,Residential,40552,0,40552,172362,0,212914
200212602900000,SW 453,Residential,40552,0,40552,147030,0,187582
200212603000000,SW 453,Residential,40552,0,40552,143923,0,184475
200212603100000,SW 453,Residential,40552,0,40552,146018,0,186570
200212603200000,SW 453,Residential,40552,0,40552,151009,0,191561
200212603300000,SW 453,Residential,40552,0,40552,197839,0,238391
200212603400000,SW 453,Residential,40552,0,40552,137527,0,178079
200212603500000,SW 453,Residential,40552,0,40552,155655,0,196207
200212603600000,SW 453,Residential,243,0,243,0,0,243
200212700100000,SW 453,Residential,44990,0,44990,179094,0,224084
200212700200000,SW 453,Residential,39600,0,39600,156070,0,195670
200212700300000,SW 453,Residential,39600,0,39600,156559,0,196159
200212700400000,SW 453,Residential,39600,0,39600,164043,0,203643
200212700500000,SW 453,Residential,39600,0,39600,157552,0,197152
200212700600000,SW 453,Residential,39600,0,39600,155379,0,194979
200212700700000,SW 453,Residential,44000,0,44000,159375,0,203375
200212700800000,SW 453,Residential,41250,0,41250,153733,0,194983
200212700900000,SW 453,Residential,41250,0,41250,168276,0,209526
200212701000000,SW 453,Residential,41250,0,41250,180883,0,222133
200212701100000,SW 453,Residential,40700,0,40700,151833,0,192533
200212701200000,SW 453,Residential,40700,0,40700,158661,0,199361
200212701300000,SW 453,Residential,41107,0,41107,143282,0,184389
200212701400000,SW 453,Residential,41107,0,41107,135705,0,176812
200212701500000,SW 453,Residential,41514,0,41514,153723,0,195237
200212701600000,SW 453,Residential,41107,0,41107,159563,0,200670
200212701700000,SW 453,Residential,7934,0,7934,136595,0,144529
200212800100000,SW 453,Residential,236,0,236,0,0,236
200212800200000,SW 453,Residential,40150,0,40150,134774,0,174924
200212800300000,SW 453,Residential,40150,0,40150,137942,0,178092
200212800400000,SW 453,Residential,40150,0,40150,187013,0,227163
200212800500000,SW 453,Residential,222,0,222,0,0,222
200212800600000,SW 453,Residential,41250,0,41250,155622,0,196872
200212800700000,SW 453,Residential,40150,0,40150,132364,0,172514
200212800800000,SW 453,Residential,40150,0,40150,135616,0,175766
200212800900000,SW 453,Residential,40150,0,40150,127417,0,167567
200212801000000,SW 453,Residential,41525,0,41525,136846,0,178371
200212801100000,SW 453,Residential,222,0,222,0,0,222
200212801200000,SW 453,Residential,222,0,222,0,0,222
200212801300000,SW 453,Residential,233,0,233,0,0,233
200212801400000,SW 453,Residential,243,0,243,0,0,243
200212801500000,SW 453,Residential,243,0,243,0,0,243
200212801600000,SW 453,Residential,243,0,243,0,0,243
200212801700000,SW 453,Residential,254,0,254,0,0,254
200212801800000,SW 453,Residential,254,0,254,0,0,254
200215100100000,SW 432,Ag Land,32609,0,32609,0,0,32609
200220100100000,SW 407,Ag Land,29501,0,29501,0,0,29501
200222600100000,SW 453,Residential,44280,0,44280,0,0,44280
200222600200000,SW 453,Residential,1300,0,1300,0,0,1300
200225100200000,SW 432,Residential,73200,0,73200,116751,0,189951
200225100300000,SW 432,Residential,93000,0,93000,142256,0,235256
200225100400000,SW 432,Residential,62350,0,62350,119985,0,182335
200225100700000,SW 407,Residential,11587,0,11587,0,0,11587
200227600400000,VACANT LAND,Commercial,0,607500,607500,0,0,607500
200227600500000,VACANT LAND,Commercial,0,852300,852300,0,0,852300
200227800100000,SW 432,Residential,85200,0,85200,236639,0,321839
200230200100000,SW 432,Residential,55800,0,55800,86354,0,142154
200232800200000,SW 432,Residential,38760,0,38760,170289,0,209049
200232800300000,SW 432,Residential,39375,0,39375,186765,0,226140
200232800400000,SW 432,Residential,36860,0,36860,192821,0,229681
200232800500000,SW 432,Residential,32430,0,32430,165017,0,197447
200232800600000,SW 432,Residential,31825,0,31825,165582,0,197407
200232800700000,SW 432,Residential,33165,0,33165,165564,0,198729
200232800800000,SW 432,Residential,35640,0,35640,165343,0,200983
200232800900000,SW 432,Residential,44583,0,44583,176477,0,221060
200232801000000,SW 432,Residential,42400,0,42400,228886,0,271286
200232801100000,SW 432,Residential,35000,0,35000,171906,0,206906
200232801200000,SW 432,Residential,35000,0,35000,176077,0,211077
200232801300000,SW 432,Residential,31200,0,31200,162557,0,193757
200232801400000,SW 432,Residential,36015,0,36015,164031,0,200046
200232801500000,SW 432,Residential,40950,0,40950,203483,0,244433
200232801600000,SW 432,Residential,51603,0,51603,206327,0,257930
200232801700000,SW 432,Residential,41382,0,41382,187384,0,228766
200232801800000,SW 432,Residential,35845,0,35845,166862,0,202707
200232801900000,SW 432,Residential,35845,0,35845,208028,0,243873
200232802000000,SW 432,Residential,35845,0,35845,171181,0,207026
200232802100000,SW 432,Residential,44640,0,44640,191797,0,236437
200232802200000,SW 432,Residential,48213,0,48213,0,0,48213
200232802300000,SW 432,Residential,42952,0,42952,187059,0,230011
200232802400000,SW 432,Residential,42157,0,42157,188064,0,230221
200232802500000,SW 432,Residential,4140,0,4140,0,0,4140
200232802600000,SW 432,Residential,5300,0,5300,0,0,5300
200232900100000,SW 432,Residential,35000,0,35000,168141,0,203141
200232900200000,SW 432,Residential,43600,0,43600,194562,0,238162
200232900300000,SW 432,Residential,33600,0,33600,0,0,33600
200232900400000,SW 432,Residential,31167,0,31167,148890,0,180057
200232900500000,SW 432,Residential,31960,0,31960,148393,0,180353
200232900600000,SW 432,Residential,30680,0,30680,177747,0,208427
200232900700000,SW 432,Residential,33800,0,33800,184391,0,218191
200232900800000,SW 432,Residential,40400,0,40400,254702,0,295102
200232900900000,SW 432,Residential,34300,0,34300,158818,0,193118
200240100200000,SW 422,Ag Land,43812,0,43812,0,0,43812
200245100600000,SW 422,Ag Dwelling,3953,0,3953,94897,2601,101451
200247600100000,SW 422,Residential,37967,0,37967,155708,0,193675
200247600200000,SW 422,Residential,38232,0,38232,118886,0,157118
200247600300000,SW 422,Residential,38232,0,38232,94749,0,132981
200247600400000,SW 422,Residential,38232,0,38232,104642,0,142874
200247600500000,SW 422,Residential,38232,0,38232,146828,0,185060
200247600600000,SW 422,Residential,38232,0,38232,90891,0,129123
200247600700000,SW 422,Residential,46463,0,46463,143346,0,189809
200247600800000,SW 422,Residential,39825,0,39825,128336,0,168161
200247600900000,SW 422,Residential,34515,0,34515,84386,0,118901
200247601000000,SW 422,Residential,78273,0,78273,8870,0,87143
200247601100000,SW 422,Residential,46058,0,46058,140605,0,186663
200247601300000,SW 422,Ag Land,9029,0,9029,0,0,9029
200247601400000,SW 422,Ag Land,25679,0,25679,0,0,25679
200247601500000,SW 422,Residential,82010,0,82010,100094,0,182104
200310100200000,SW 432,Residential,28900,0,28900,290866,0,319766
200310100300000,SW 432,Residential,29207,0,29207,198762,0,227969
200310100400000,SW 432,Residential,29189,0,29189,237657,0,266846
200310100500000,SW 432,Residential,25763,0,25763,206237,0,232000
200310100600000,SW 432,Residential,27907,0,27907,182675,0,210582
200310100700000,SW 432,Residential,27791,0,27791,212694,0,240485
200310100800000,SW 432,Residential,28635,0,28635,224763,0,253398
200310100900000,SW 432,Residential,31282,0,31282,223915,0,255197
200310101000000,SW 432,Residential,30361,0,30361,0,0,30361
200310101100000,SW 432,Residential,29146,0,29146,162076,0,191222
200310101200000,SW 432,Residential,28035,0,28035,224540,0,252575
200310101300000,SW 432,Residential,27795,0,27795,198848,0,226643
200310101400000,SW 432,Residential,30520,0,30520,190008,0,220528
200310101500000,SW 432,Residential,31666,0,31666,137497,0,169163
200310101600000,SW 432,Residential,31051,0,31051,134646,0,165697
200310101700000,SW 432,Residential,30240,0,30240,137497,0,167737
200310101800000,SW 432,Residential,30240,0,30240,49263,0,79503
200310101900000,SW 432,Residential,31179,0,31179,0,0,31179
200310102000000,SW 432,Residential,30320,0,30320,0,0,30320
200310102100000,SW 432,Residential,30400,0,30400,0,0,30400
200310102200000,SW 432,Residential,495,0,495,0,0,495
200310200100000,SW 432,Residential,25200,0,25200,190423,0,215623
200310200200000,SW 432,Residential,26775,0,26775,209144,0,235919
200310300200000,SW 432,Residential,30210,0,30210,188544,0,218754
200310300300000,SW 432,Residential,27608,0,27608,228481,0,256089
200310300400000,SW 432,Residential,27548,0,27548,216967,0,244515
200310300500000,SW 432,Residential,29786,0,29786,194944,0,224730
200310300600000,SW 432,Residential,28560,0,28560,175055,0,203615
200310300700000,SW 432,Residential,25059,0,25059,164908,0,189967
200310300800000,SW 432,Residential,25200,0,25200,187882,0,213082
200310400100000,SW 432,Residential,27821,0,27821,172402,0,200223
200310400200000,SW 432,Residential,27216,0,27216,145940,0,173156
200310400300000,SW 432,Residential,25200,0,25200,136013,0,161213
200310400400000,SW 432,Residential,25200,0,25200,174209,0,199409
200310500100000,SW 432,Residential,28119,0,28119,141412,0,169531
200310500200000,SW 432,Residential,28960,0,28960,251980,0,280940
200310500300000,SW 432,Residential,29700,0,29700,197826,0,227526
200310500400000,SW 432,Residential,29453,0,29453,33974,0,63427
200310500500000,SW 432,Residential,28304,0,28304,231681,0,259985
200310500600000,SW 432,Residential,47390,0,47390,242037,0,289427
200310500700000,SW 432,Residential,29736,0,29736,198778,0,228514
200310500800000,SW 432,Residential,31824,0,31824,218816,0,250640
200310500900000,SW 432,Residential,29484,0,29484,0,0,29484
200310501000000,SW 432,Residential,31824,0,31824,249661,0,281485
200310501100000,SW 432,Residential,29484,0,29484,208748,0,238232
200310501200000,SW 432,Residential,30372,0,30372,0,0,30372
200310501300000,SW 432,Residential,32130,0,32130,0,0,32130
200310501400000,SW 432,Residential,29760,0,29760,0,0,29760
200310501500000,SW 432,Residential,30498,0,30498,0,0,30498
200310501600000,SW 432,Residential,38802,0,38802,193479,0,232281
200310501700000,SW 432,Residential,30111,0,30111,239842,0,269953
200310501800000,SW 432,Residential,25841,0,25841,0,0,25841
200310501900000,SW 432,Residential,28580,0,28580,0,0,28580
200310502000000,SW 432,Residential,31606,0,31606,0,0,31606
200310502100000,SW 432,Residential,30078,0,30078,0,0,30078
200310502200000,SW 432,Residential,31000,0,31000,241274,0,272274
200310502300000,SW 432,Residential,32195,0,32195,0,0,32195
200310502400000,SW 432,Residential,27720,0,27720,0,0,27720
200310502500000,SW 432,Residential,32320,0,32320,284924,0,317244
200310502600000,SW 432,Residential,28280,0,28280,0,0,28280
200310502700000,SW 432,Residential,31011,0,31011,0,0,31011
200310502800000,SW 432,Residential,29589,0,29589,248021,0,277610
200310502900000,SW 432,Residential,30572,0,30572,190393,0,220965
200310503000000,SW 432,Residential,30527,0,30527,255589,0,286116
200310503100000,SW 432,Residential,30240,0,30240,196868,0,227108
200310503200000,SW 432,Residential,29400,0,29400,269828,0,299228
200310503300000,SW 432,Residential,30325,0,30325,195973,0,226298
200310503400000,STATE PROPERTY,Other,0,0,0,0,0,0
200317600200000,SW 432,Residential,29158,0,29158,236456,0,265614
200317600300000,SW 432,Residential,33640,0,33640,270539,0,304179
200317600400000,SW 432,Residential,29746,0,29746,248541,0,278287
200317600500000,SW 432,Residential,30576,0,30576,0,0,30576
200317600600000,SW 432,Residential,28941,0,28941,222345,0,251286
200317600700000,SW 432,Residential,28280,0,28280,233505,0,261785
200317600800000,SW 432,Residential,27997,0,27997,224952,0,252949
200317600900000,SW 432,Residential,29817,0,29817,190632,0,220449
200317601100000,SW 432,Residential,25840,0,25840,179536,0,205376
200317601200000,SW 432,Residential,25840,0,25840,150936,0,176776
200317601300000,SW 432,Residential,25745,0,25745,182192,0,207937
200317601400000,SW 432,Residential,27436,0,27436,176904,0,204340
200317601500000,SW 432,Residential,24941,0,24941,166928,0,191869
200317601600000,SW 432,Residential,31284,0,31284,179004,0,210288
200317601700000,SW 432,Residential,28188,0,28188,191388,0,219576
200317601800000,SW 432,Residential,26996,0,26996,118004,0,145000
200317601900000,SW 432,Residential,26309,0,26309,151588,0,177897
200317602000000,SW 432,Residential,25440,0,25440,139168,0,164608
200317602100000,SW 432,Residential,25440,0,25440,144689,0,170129
200317602200000,SW 432,Residential,25440,0,25440,139563,0,165003
200317602300000,SW 432,Residential,25440,0,25440,135432,0,160872
200317602500000,SW 432,Residential,25440,0,25440,154694,0,180134
200317602600000,SW 432,Residential,25440,0,25440,138076,0,163516
200317602700000,SW 432,Residential,28166,0,28166,209147,0,237313
200317602800000,SW 432,Residential,29158,0,29158,154800,0,183958
200317602900000,SW 432,Residential,28698,0,28698,170313,0,199011
200317603000000,SW 432,Residential,28559,0,28559,149622,0,178181
200317603100000,SW 432,Residential,28792,0,28792,150766,0,179558
200317603200000,SW 432,Residential,28405,0,28405,188524,0,216929
200317603300000,SW 432,Residential,27846,0,27846,155780,0,183626
200317603400000,SW 432,Residential,39224,0,39224,259014,0,298238
200317700100000,SW 432,Residential,27216,0,27216,169144,0,196360
200317700200000,SW 432,Residential,25200,0,25200,170062,0,195262
200317700300000,SW 432,Residential,25200,0,25200,160622,0,185822
200317700400000,SW 432,Residential,27216,0,27216,149190,0,176406
200317700500000,SW 432,Residential,25200,0,25200,151388,0,176588
200317700600000,SW 432,Residential,25200,0,25200,155373,0,180573
200317700700000,SW 432,Residential,27216,0,27216,169656,0,196872
200317700800000,SW 432,Residential,25200,0,25200,154465,0,179665
200317700900000,SW 432,Residential,25200,0,25200,133762,0,158962
200317701000000,SW 432,Residential,27216,0,27216,171846,0,199062
200317701100000,SW 432,Residential,25200,0,25200,152574,0,177774
200317701200000,SW 432,Residential,25200,0,25200,152587,0,177787
200317701300000,SW 432,Residential,27216,0,27216,124344,0,151560
200317701400000,SW 432,Residential,25200,0,25200,156385,0,181585
200317701500000,SW 432,Residential,25200,0,25200,158975,0,184175
200317701600000,SW 432,Residential,27543,0,27543,174655,0,202198
200317800100000,SW 432,Residential,28240,0,28240,149544,0,177784
200317800200000,SW 432,Residential,26993,0,26993,173930,0,200923
200317800300000,SW 432,Residential,26723,0,26723,154477,0,181200
200317800400000,SW 432,Residential,27931,0,27931,161283,0,189214
200317800500000,SW 432,Residential,25816,0,25816,197830,0,223646
200317800600000,SW 432,Residential,28464,0,28464,139822,0,168286
200317800700000,SW 432,Residential,25680,0,25680,137528,0,163208
200317800800000,SW 432,Residential,25680,0,25680,127157,0,152837
200317800900000,SW 432,Residential,25680,0,25680,137612,0,163292
200317801000000,SW 432,Residential,25680,0,25680,125497,0,151177
200317801100000,SW 432,Residential,26311,0,26311,142159,0,168470
200317801200000,SW 432,Residential,26418,0,26418,151688,0,178106
200317801300000,SW 432,Residential,28665,0,28665,132982,0,161647
200317801400000,SW 432,Residential,29160,0,29160,191468,0,220628
200317801500000,SW 432,Residential,26366,0,26366,176596,0,202962
200317801600000,SW 432,Residential,25680,0,25680,162408,0,188088
200317801700000,SW 432,Residential,25680,0,25680,151532,0,177212
200317900100000,SW 432,Residential,28143,0,28143,163604,0,191747
200317900200000,SW 432,Residential,25445,0,25445,133477,0,158922
200317900300000,SW 432,Residential,25445,0,25445,160784,0,186229
200317900400000,SW 432,Residential,25445,0,25445,143292,0,168737
200317900500000,SW 432,Residential,24752,0,24752,152248,0,177000
200317900600000,SW 432,Residential,25445,0,25445,146323,0,171768
200317900700000,SW 432,Residential,25445,0,25445,168630,0,194075
200317900800000,SW 432,Residential,25445,0,25445,158773,0,184218
200317900900000,SW 432,Residential,25445,0,25445,152590,0,178035
200317901000000,SW 432,Residential,25445,0,25445,138905,0,164350
200317901100000,SW 432,Residential,26721,0,26721,173941,0,200662
200317901200000,SW 432,Residential,26730,0,26730,175571,0,202301
200317901300000,SW 432,Residential,27000,0,27000,151889,0,178889
200317901400000,SW 432,Residential,27252,0,27252,165367,0,192619
200317901500000,SW 432,Residential,26957,0,26957,212860,0,239817
200317901600000,SW 432,Residential,25200,0,25200,147810,0,173010
200317901700000,SW 432,Residential,25890,0,25890,139623,0,165513
200317901800000,SW 432,Residential,25661,0,25661,138102,0,163763
200317901900000,SW 432,Residential,25661,0,25661,161268,0,186929
200317902000000,SW 432,Residential,25661,0,25661,174457,0,200118
200317902100000,SW 432,Residential,25661,0,25661,199386,0,225047
200317902200000,SW 432,Residential,25661,0,25661,168353,0,194014
200317902300000,SW 432,Residential,28685,0,28685,186901,0,215586
200318000100000,SW 432,Residential,39424,0,39424,151832,0,191256
200318000200000,SW 432,Residential,28560,0,28560,158604,0,187164
200318000300000,SW 432,Residential,28560,0,28560,142355,0,170915
200318000400000,SW 432,Residential,28560,0,28560,121811,0,150371
200318000500000,SW 432,Residential,28560,0,28560,140925,0,169485
200318000600000,SW 432,Residential,28560,0,28560,151577,0,180137
200318000700000,SW 432,Residential,28560,0,28560,129201,0,157761
200318000800000,SW 432,Residential,28911,0,28911,155951,0,184862
200318100100000,SW 432,Residential,28053,0,28053,153727,0,181780
200318100200000,SW 432,Residential,25536,0,25536,189427,0,214963
200318100300000,SW 432,Residential,25536,0,25536,150346,0,175882
200318100400000,SW 432,Residential,25536,0,25536,172033,0,197569
200318100500000,SW 432,Residential,25536,0,25536,150035,0,175571
200318100600000,SW 432,Residential,25536,0,25536,162062,0,187598
200318100700000,SW 432,Residential,25536,0,25536,143006,0,168542
200318100800000,SW 432,Residential,26941,0,26941,184064,0,211005
200340100200000,SW 432,Residential,38053,0,38053,179894,0,217947
200340100300000,SW 432,Residential,30600,0,30600,169325,0,199925
200340100400000,SW 432,Residential,30600,0,30600,166286,0,196886
200340100500000,SW 432,Residential,30600,0,30600,168324,0,198924
200340100600000,SW 432,Residential,30600,0,30600,138111,0,168711
200340100700000,SW 432,Residential,30600,0,30600,198074,0,228674
200340100800000,SW 432,Residential,30600,0,30600,155631,0,186231
200340100900000,SW 432,Residential,30600,0,30600,193964,0,224564
200340101000000,SW 432,Residential,30600,0,30600,163626,0,194226
200340101100000,SW 432,Residential,30600,0,30600,172893,0,203493
200340101300000,SW 432,Residential,20,0,20,0,0,20
200340101500000,SW 432,Residential,6338,0,6338,0,0,6338
200340101600000,SW 432,Residential,19035,0,19035,0,0,19035
200340102300000,SW 432,Residential,184000,0,184000,149797,0,333797
200340102500000,SW 432,Residential,58250,0,58250,0,0,58250
200340102600000,SW 432,Residential,176000,0,176000,0,0,176000
200342600400000,SW 432,Residential,20,0,20,0,0,20
200342600500000,SW 432,Residential,20,0,20,0,0,20
201110100100000,SW 422,Ag Land,62755,0,62755,0,0,62755
201112600300000,SW 422,Ag Land,71315,0,71315,0,0,71315
201212600100000,FOOD GRADE;INDUST,Industrial,0,1417372,1417372,0,22470459,23887831
201237600100000,SW 418,Ag Land,19387,0,19387,0,0,19387
201237700100000,SW 418,Ag Land,917,0,917,0,0,917
201240100100000,SW 418,Ag Land,19780,0,19780,0,0,19780
201240100200000,CENTRALLY ASSESSED,Other,0,0,0,0,0,0
201240200100000,SW 418,Ag Land,15632,0,15632,0,0,15632
201242600100000,SW 418,Ag Land,33928,0,33928,0,0,33928
201245100100000,SW 418,Ag Land,38690,0,38690,0,0,38690
201245200100000,SW 418,Ag Land,7962,0,7962,0,0,7962
201247600100000,SW 418,Ag Land,64604,0,64604,0,0,64604
202410100100000,CITY PROPERTY,Exempt,0,0,0,0,0,0
202525100100000,CITY PROPERTY,Exempt,0,0,0,0,0,0
202610100100000,CITY PROPERTY,Exempt,0,0,0,0,0,0
202612600100000,CITY PROPERTY,Exempt,0,0,0,0,0,0
