GIS_Number_valuations,Map_Name_valuations,Class_valuations,2013 Land Res,2013 Land Comm,2013 Total Land,2013 Dwlg,2013 Improv,2013 Total
112235302100000,NE 175,AG LAND,30955,0,30955,0,0,30955
112625100100000,CHURCH,EXEMPT,0,464400,464400,0,518023,982423
112625100200000,CHURCH,EXEMPT,0,663984,663984,0,9055210,9719194
112630300100000,NE 160,RESIDENTIAL,30870,0,30870,176889,0,207759
112630300200000,NE 160,RESIDENTIAL,29734,0,29734,208005,0,237739
112630300300000,NE 160,RESIDENTIAL,29070,0,29070,204855,0,233925
112630400100000,NE 160,RESIDENTIAL,30345,0,30345,268557,0,298902
112630400200000,NE 160,RESIDENTIAL,28560,0,28560,210846,0,239406
112630400300000,NE 160,RESIDENTIAL,28666,0,28666,208941,0,237607
112630400400000,NE 160,RESIDENTIAL,29988,0,29988,216979,0,246967
112630400500000,NE 160,RESIDENTIAL,28882,0,28882,217385,0,246267
112630400600000,NE 160,RESIDENTIAL,28759,0,28759,211945,0,240704
112630400700000,NE 160,RESIDENTIAL,26600,0,26600,197134,0,223734
112630400800000,NE 160,RESIDENTIAL,28000,0,28000,206133,0,234133
112630400900000,NE 160,RESIDENTIAL,29506,0,29506,218494,0,248000
112630401000000,NE 160,RESIDENTIAL,29144,0,29144,224702,0,253846
112630401100000,NE 160,RESIDENTIAL,30366,0,30366,177932,0,208298
112630401200000,NE 160,RESIDENTIAL,30607,0,30607,164156,0,194763
112630500100000,NE 160,RESIDENTIAL,30576,0,30576,245608,0,276184
112630500200000,NE 160,RESIDENTIAL,28657,0,28657,200356,0,229013
112630500300000,NE 160,RESIDENTIAL,28935,0,28935,197810,0,226745
112630500400000,NE 160,RESIDENTIAL,29988,0,29988,216702,0,246690
112630500500000,NE 160,RESIDENTIAL,28560,0,28560,203883,0,232443
112630500600000,NE 160,RESIDENTIAL,28560,0,28560,202105,0,230665
112630500700000,NE 160,RESIDENTIAL,32779,0,32779,199271,0,232050
112630600100000,NE 160,RESIDENTIAL,29404,0,29404,204018,0,233422
112630600200000,NE 160,RESIDENTIAL,29447,0,29447,220135,0,249582
112630600300000,NE 160,RESIDENTIAL,29125,0,29125,194847,0,223972
112630600400000,NE 160,RESIDENTIAL,30329,0,30329,247355,0,277684
112630600500000,NE 160,RESIDENTIAL,30031,0,30031,196992,0,227023
112630600600000,NE 160,RESIDENTIAL,26375,0,26375,197418,0,223793
112630600700000,NE 160,RESIDENTIAL,28546,0,28546,249256,0,277802
112630600800000,NE 160,RESIDENTIAL,27849,0,27849,238397,0,266246
112630600900000,NE 160,RESIDENTIAL,29400,0,29400,211508,0,240908
112630601000000,NE 160,RESIDENTIAL,26600,0,26600,208575,0,235175
112630601100000,NE 160,RESIDENTIAL,29400,0,29400,259628,0,289028
112630601200000,NE 160,RESIDENTIAL,28000,0,28000,225231,0,253231
112630601300000,NE 160,RESIDENTIAL,26600,0,26600,226353,0,252953
112630601400000,NE 160,RESIDENTIAL,29050,0,29050,243577,0,272627
112630601500000,NE 160,RESIDENTIAL,27687,0,27687,215820,0,243507
112630601600000,NE 160,RESIDENTIAL,29458,0,29458,216131,0,245589
112630601700000,NE 160,RESIDENTIAL,26781,0,26781,199314,0,226095
112630601800000,NE 160,RESIDENTIAL,27776,0,27776,236658,0,264434
112630601900000,NE 160,RESIDENTIAL,30048,0,30048,193622,0,223670
112630700100000,NE 160,RESIDENTIAL,30941,0,30941,191056,0,221997
112632700100000,NE 160,RESIDENTIAL,29747,0,29747,224805,0,254552
112632700200000,NE 160,RESIDENTIAL,31468,0,31468,238613,0,270081
112632700300000,NE 160,RESIDENTIAL,31890,0,31890,233325,0,265215
112632700400000,NE 160,RESIDENTIAL,27573,0,27573,206694,0,234267
112632700500000,NE 160,RESIDENTIAL,28881,0,28881,199235,0,228116
112632700600000,NE 160,RESIDENTIAL,28952,0,28952,211759,0,240711
112632700700000,NE 160,RESIDENTIAL,27927,0,27927,177047,0,204974
112632700800000,NE 160,RESIDENTIAL,29694,0,29694,187192,0,216886
112632700900000,NE 160,RESIDENTIAL,29610,0,29610,204410,0,234020
112632701000000,NE 160,RESIDENTIAL,29121,0,29121,175468,0,204589
112632701100000,NE 160,RESIDENTIAL,27846,0,27846,191760,0,219606
112632701200000,NE 160,RESIDENTIAL,29000,0,29000,224240,0,253240
112632701300000,NE 160,RESIDENTIAL,28960,0,28960,206754,0,235714
112632701400000,NE 160,RESIDENTIAL,30560,0,30560,205817,0,236377
112632701500000,NE 160,RESIDENTIAL,28560,0,28560,215113,0,243673
112632701600000,NE 160,RESIDENTIAL,29506,0,29506,210331,0,239837
112632701700000,NE 160,RESIDENTIAL,28960,0,28960,272737,0,301697
112632701800000,NE 160,RESIDENTIAL,26081,0,26081,224708,0,250789
112632701900000,NE 160,RESIDENTIAL,29299,0,29299,280154,0,309453
112632702000000,NE 160,RESIDENTIAL,28720,0,28720,195028,0,223748
112632702100000,NE 160,RESIDENTIAL,28885,0,28885,242360,0,271245
112632702200000,NE 160,RESIDENTIAL,26866,0,26866,187673,0,214539
112632702300000,NE 160,RESIDENTIAL,29694,0,29694,208979,0,238673
112632702400000,NE 160,RESIDENTIAL,29826,0,29826,258361,0,288187
112632800100000,NE 160,RESIDENTIAL,30245,0,30245,218997,0,249242
112632800200000,NE 160,RESIDENTIAL,71200,0,71200,41987,0,113187
112632800300000,NE 160,RESIDENTIAL,55350,0,55350,264343,0,319693
112632800400000,NE 160,RESIDENTIAL,53450,0,53450,175119,0,228569
112632800500000,NE 160,RESIDENTIAL,30594,0,30594,188748,0,219342
112632800600000,NE 160,RESIDENTIAL,30154,0,30154,236577,0,266731
112632800700000,NE 160,RESIDENTIAL,28560,0,28560,192501,0,221061
112632800800000,NE 160,RESIDENTIAL,30345,0,30345,208778,0,239123
112632800900000,NE 160,RESIDENTIAL,29850,0,29850,212497,0,242347
112632801000000,NE 160,RESIDENTIAL,32523,0,32523,215979,0,248502
112632801100000,NE 160,RESIDENTIAL,30358,0,30358,228133,0,258491
112632801200000,NE 160,RESIDENTIAL,29960,0,29960,209539,0,239499
112632801300000,NE 160,RESIDENTIAL,30749,0,30749,238554,0,269303
112632801400000,NE 160,RESIDENTIAL,29753,0,29753,266341,0,296094
112632801500000,NE 160,RESIDENTIAL,29724,0,29724,191923,0,221647
112632801600000,NE 160,RESIDENTIAL,28650,0,28650,208036,0,236686
112632801700000,NE 160,RESIDENTIAL,29613,0,29613,201381,0,230994
112632801800000,NE 160,RESIDENTIAL,28636,0,28636,199288,0,227924
112632801900000,NE 160,RESIDENTIAL,29441,0,29441,186331,0,215772
112632802000000,NE 160,RESIDENTIAL,30118,0,30118,206654,0,236772
112632802100000,NE 160,RESIDENTIAL,28560,0,28560,208192,0,236752
112632802200000,NE 160,RESIDENTIAL,29167,0,29167,169066,0,198233
112632802300000,NE 160,RESIDENTIAL,27846,0,27846,213612,0,241458
112632802400000,NE 160,RESIDENTIAL,29988,0,29988,209595,0,239583
112632802500000,NE 160,RESIDENTIAL,28560,0,28560,211165,0,239725
112632900100000,NE 160,RESIDENTIAL,30941,0,30941,227110,0,258051
112632900200000,NE 160,RESIDENTIAL,28595,0,28595,217907,0,246502
112632900300000,NE 160,RESIDENTIAL,27418,0,27418,203673,0,231091
112632900400000,NE 160,RESIDENTIAL,29057,0,29057,189744,0,218801
112632900500000,NE 160,RESIDENTIAL,29204,0,29204,227165,0,256369
112632900600000,NE 160,RESIDENTIAL,27569,0,27569,253510,0,281079
112632900700000,NE 160,RESIDENTIAL,29416,0,29416,215695,0,245111
112632900800000,NE 160,RESIDENTIAL,27132,0,27132,212171,0,239303
112632900900000,NE 160,RESIDENTIAL,28560,0,28560,212982,0,241542
112632901000000,NE 160,RESIDENTIAL,29988,0,29988,243206,0,273194
112632901100000,NE 160,RESIDENTIAL,28152,0,28152,191789,0,219941
112632901200000,NE 160,RESIDENTIAL,28768,0,28768,201881,0,230649
112632901300000,NE 160,RESIDENTIAL,29077,0,29077,212510,0,241587
112635100100000,NE 160,RESIDENTIAL,30358,0,30358,214685,0,245043
112635100200000,NE 160,RESIDENTIAL,28628,0,28628,200516,0,229144
112635100300000,NE 160,RESIDENTIAL,29799,0,29799,209948,0,239747
112635100400000,NE 160,RESIDENTIAL,28117,0,28117,218744,0,246861
112635100500000,NE 160,RESIDENTIAL,31091,0,31091,263263,0,294354
112635100600000,NE 160,RESIDENTIAL,30677,0,30677,264295,0,294972
112635100700000,NE 160,RESIDENTIAL,28591,0,28591,186644,0,215235
112635100800000,NE 160,RESIDENTIAL,29757,0,29757,204223,0,233980
112635200100000,NE 160,RESIDENTIAL,28679,0,28679,189295,0,217974
112635200200000,NE 160,RESIDENTIAL,30891,0,30891,213110,0,244001
112635200300000,NE 160,RESIDENTIAL,29106,0,29106,202449,0,231555
112635200400000,NE 160,RESIDENTIAL,30345,0,30345,228937,0,259282
112635300100000,NE 160,RESIDENTIAL,30184,0,30184,203895,0,234079
112635300200000,NE 160,RESIDENTIAL,28566,0,28566,194810,0,223376
112635300300000,NE 160,RESIDENTIAL,30297,0,30297,182965,0,213262
112635300400000,NE 160,RESIDENTIAL,28560,0,28560,187101,0,215661
112635300500000,NE 160,RESIDENTIAL,28560,0,28560,207100,0,235660
112635300600000,NE 160,RESIDENTIAL,28842,0,28842,194745,0,223587
112635300700000,NE 160,RESIDENTIAL,28828,0,28828,204088,0,232916
112635300800000,NE 160,RESIDENTIAL,29225,0,29225,202985,0,232210
112635300900000,NE 160,RESIDENTIAL,28538,0,28538,204073,0,232611
112635301000000,NE 160,RESIDENTIAL,28560,0,28560,185997,0,214557
112635301100000,NE 160,RESIDENTIAL,28560,0,28560,175876,0,204436
112635301200000,NE 160,RESIDENTIAL,28190,0,28190,221658,0,249848
112635301300000,NE 160,RESIDENTIAL,29939,0,29939,200544,0,230483
112635301400000,NE 160,RESIDENTIAL,30316,0,30316,189004,0,219320
112635301500000,NE 160,RESIDENTIAL,29925,0,29925,205389,0,235314
112635301600000,NE 160,RESIDENTIAL,30330,0,30330,208230,0,238560
112635301700000,NE 160,RESIDENTIAL,28574,0,28574,218721,0,247295
112635301800000,NE 160,RESIDENTIAL,29988,0,29988,235521,0,265509
112635301900000,NE 160,RESIDENTIAL,27132,0,27132,195075,0,222207
112635302000000,NE 160,RESIDENTIAL,29432,0,29432,258793,0,288225
112635302100000,NE 160,RESIDENTIAL,29869,0,29869,210635,0,240504
112635302200000,NE 160,RESIDENTIAL,29869,0,29869,213991,0,243860
112635302300000,NE 160,RESIDENTIAL,29234,0,29234,208447,0,237681
112635302400000,NE 160,RESIDENTIAL,28870,0,28870,209679,0,238549
112635302500000,NE 160,RESIDENTIAL,29080,0,29080,196211,0,225291
112635302600000,NE 160,RESIDENTIAL,30715,0,30715,193348,0,224063
112635302700000,NE 160,RESIDENTIAL,31395,0,31395,212564,0,243959
112635302800000,NE 160,RESIDENTIAL,29400,0,29400,210290,0,239690
112635400100000,NE 160,RESIDENTIAL,28333,0,28333,177127,0,205460
112635400200000,NE 160,RESIDENTIAL,28560,0,28560,211163,0,239723
112635400300000,NE 160,RESIDENTIAL,29466,0,29466,209878,0,239344
112635400400000,NE 160,RESIDENTIAL,29938,0,29938,214559,0,244497
112635400500000,NE 160,RESIDENTIAL,30381,0,30381,218446,0,248827
112635400600000,NE 160,RESIDENTIAL,33005,0,33005,186865,0,219870
112635400700000,NE 160,RESIDENTIAL,32452,0,32452,226094,0,258546
112635400800000,NE 160,RESIDENTIAL,29976,0,29976,209894,0,239870
112635400900000,NE 160,RESIDENTIAL,29420,0,29420,249305,0,278725
112635401000000,NE 160,RESIDENTIAL,29267,0,29267,218017,0,247284
112635401100000,NE 160,RESIDENTIAL,28854,0,28854,213316,0,242170
112635401200000,NE 160,RESIDENTIAL,29566,0,29566,191068,0,220634
112635401300000,NE 160,RESIDENTIAL,29830,0,29830,200084,0,229914
112635401400000,NE 160,RESIDENTIAL,30444,0,30444,245727,0,276171
112635401500000,NE 160,RESIDENTIAL,30559,0,30559,213330,0,243889
112635401600000,NE 160,RESIDENTIAL,30667,0,30667,234100,0,264767
112635401700000,NE 160,RESIDENTIAL,46350,0,46350,272371,0,318721
112635401800000,NE 160,RESIDENTIAL,31601,0,31601,255321,0,286922
112635401900000,NE 160,RESIDENTIAL,30521,0,30521,214297,0,244818
112635402000000,NE 160,RESIDENTIAL,30523,0,30523,213880,0,244403
112635402100000,NE 160,RESIDENTIAL,30674,0,30674,235871,0,266545
112635402200000,NE 160,RESIDENTIAL,29130,0,29130,205776,0,234906
112635402300000,NE 160,RESIDENTIAL,30800,0,30800,223054,0,253854
112635402400000,NE 160,RESIDENTIAL,29188,0,29188,196940,0,226128
112635402500000,NE 160,RESIDENTIAL,28000,0,28000,237944,0,265944
112635402600000,NE 160,RESIDENTIAL,29792,0,29792,220840,0,250632
112635402700000,NE 160,RESIDENTIAL,29792,0,29792,195996,0,225788
112635402800000,NE 160,RESIDENTIAL,29792,0,29792,223399,0,253191
112635402900000,NE 160,RESIDENTIAL,29420,0,29420,197882,0,227302
112635403000000,NE 160,RESIDENTIAL,28616,0,28616,190507,0,219123
112635403100000,NE 160,RESIDENTIAL,29715,0,29715,191251,0,220966
112635403200000,NE 160,RESIDENTIAL,30164,0,30164,257381,0,287545
112635403300000,NE 160,RESIDENTIAL,30264,0,30264,213819,0,244083
112635403400000,NE 160,RESIDENTIAL,29543,0,29543,171209,0,200752
112635403500000,NE 160,RESIDENTIAL,28989,0,28989,217954,0,246943
112635403600000,NE 160,RESIDENTIAL,30070,0,30070,208351,0,238421
112635403700000,NE 160,RESIDENTIAL,31086,0,31086,212387,0,243473
112635403800000,NE 160,RESIDENTIAL,30070,0,30070,236651,0,266721
112635403900000,NE 160,RESIDENTIAL,29096,0,29096,224472,0,253568
112635404000000,NE 160,RESIDENTIAL,30807,0,30807,182169,0,212976
112635404100000,NE 160,RESIDENTIAL,28613,0,28613,219537,0,248150
112635404200000,NE 160,RESIDENTIAL,29318,0,29318,202027,0,231345
112635500100000,NE 160,RESIDENTIAL,30446,0,30446,186040,0,216486
112635600100000,NE 160,RESIDENTIAL,31118,0,31118,197421,0,228539
112635700100000,NE 160,RESIDENTIAL,32879,0,32879,272811,0,305690
112635700300000,NE 160,RESIDENTIAL,29605,0,29605,202670,0,232275
112635700400000,NE 160,RESIDENTIAL,29393,0,29393,198729,0,228122
112635700500000,NE 160,RESIDENTIAL,28561,0,28561,199681,0,228242
112637600100000,NE 160,RESIDENTIAL,28938,0,28938,202626,0,231564
112637600200000,NE 160,RESIDENTIAL,29481,0,29481,210435,0,239916
112637600300000,NE 160,RESIDENTIAL,29451,0,29451,166852,0,196303
112637600400000,NE 160,RESIDENTIAL,29724,0,29724,180379,0,210103
112637600500000,NE 160,RESIDENTIAL,29684,0,29684,191498,0,221182
112637600600000,NE 160,RESIDENTIAL,28817,0,28817,227568,0,256385
112637600700000,NE 160,RESIDENTIAL,29840,0,29840,171413,0,201253
112637600800000,NE 160,RESIDENTIAL,29345,0,29345,211010,0,240355
112637600900000,NE 160,RESIDENTIAL,26671,0,26671,179849,0,206520
112637601000000,NE 160,RESIDENTIAL,29925,0,29925,222655,0,252580
112637700100000,NE 160,RESIDENTIAL,28932,0,28932,188339,0,217271
112637700200000,NE 160,RESIDENTIAL,26866,0,26866,211032,0,237898
112637700300000,NE 160,RESIDENTIAL,29200,0,29200,224635,0,253835
112637700400000,NE 160,RESIDENTIAL,29645,0,29645,194508,0,224153
112637700500000,NE 160,RESIDENTIAL,29694,0,29694,230030,0,259724
112637700600000,NE 160,RESIDENTIAL,27743,0,27743,181221,0,208964
112637700700000,NE 160,RESIDENTIAL,29283,0,29283,197716,0,226999
112637700800000,NE 160,RESIDENTIAL,26437,0,26437,205738,0,232175
112637700900000,NE 160,RESIDENTIAL,27916,0,27916,189290,0,217206
112637701000000,NE 160,RESIDENTIAL,26950,0,26950,187400,0,214350
112637701100000,NE 160,RESIDENTIAL,29988,0,29988,197262,0,227250
112637701200000,NE 160,RESIDENTIAL,29686,0,29686,232785,0,262471
112637701300000,NE 160,RESIDENTIAL,29377,0,29377,226770,0,256147
112637701400000,NE 160,RESIDENTIAL,28469,0,28469,166681,0,195150
112637701500000,NE 160,RESIDENTIAL,30680,0,30680,223852,0,254532
112637701600000,NE 160,RESIDENTIAL,30721,0,30721,193489,0,224210
112637701700000,NE 160,RESIDENTIAL,29054,0,29054,179023,0,208077
112637701800000,NE 160,RESIDENTIAL,29155,0,29155,182395,0,211550
112637701900000,NE 160,RESIDENTIAL,29260,0,29260,184872,0,214132
112637702000000,NE 160,RESIDENTIAL,27720,0,27720,195557,0,223277
112637702100000,NE 160,RESIDENTIAL,27720,0,27720,207734,0,235454
112637702200000,NE 160,RESIDENTIAL,29400,0,29400,193929,0,223329
112637702300000,NE 160,RESIDENTIAL,28392,0,28392,198782,0,227174
112637702400000,NE 160,RESIDENTIAL,29136,0,29136,185286,0,214422
112637702500000,NE 160,RESIDENTIAL,28978,0,28978,215640,0,244618
112637702600000,NE 160,RESIDENTIAL,30315,0,30315,197083,0,227398
112637702700000,NE 160,RESIDENTIAL,28946,0,28946,208754,0,237700
112637800100000,NE 160,RESIDENTIAL,28560,0,28560,216134,0,244694
112637800200000,NE 160,RESIDENTIAL,27132,0,27132,214274,0,241406
112637800300000,NE 160,RESIDENTIAL,29631,0,29631,219344,0,248975
112637800400000,NE 160,RESIDENTIAL,29047,0,29047,245357,0,274404
112637800500000,NE 160,RESIDENTIAL,28679,0,28679,235425,0,264104
112637800600000,NE 160,RESIDENTIAL,29370,0,29370,211905,0,241275
112637800700000,NE 160,RESIDENTIAL,28233,0,28233,216522,0,244755
112637800800000,NE 160,RESIDENTIAL,28053,0,28053,181418,0,209471
112637800900000,NE 160,RESIDENTIAL,28700,0,28700,218987,0,247687
112637801000000,NE 160,RESIDENTIAL,29223,0,29223,201117,0,230340
112637801100000,NE 160,RESIDENTIAL,30356,0,30356,213989,0,244345
112637801200000,NE 160,RESIDENTIAL,28583,0,28583,205462,0,234045
112637801300000,NE 160,RESIDENTIAL,28382,0,28382,214805,0,243187
112637801400000,NE 160,RESIDENTIAL,28000,0,28000,213168,0,241168
112637801500000,NE 160,RESIDENTIAL,28000,0,28000,200752,0,228752
112637801600000,NE 160,RESIDENTIAL,26984,0,26984,206842,0,233826
112637801700000,NE 160,RESIDENTIAL,28827,0,28827,197184,0,226011
112637801800000,NE 160,RESIDENTIAL,28916,0,28916,206049,0,234965
112637801900000,NE 160,RESIDENTIAL,29825,0,29825,192287,0,222112
112637802000000,NE 160,RESIDENTIAL,28560,0,28560,186980,0,215540
112637900100000,NE 160,RESIDENTIAL,30047,0,30047,229953,0,260000
112637900200000,NE 160,RESIDENTIAL,28541,0,28541,200877,0,229418
112637900300000,NE 160,RESIDENTIAL,29006,0,29006,206734,0,235740
112637900400000,NE 160,RESIDENTIAL,28009,0,28009,195268,0,223277
112637900500000,NE 160,RESIDENTIAL,29274,0,29274,196041,0,225315
112637900600000,NE 160,RESIDENTIAL,30307,0,30307,170940,0,201247
112637900700000,NE 160,RESIDENTIAL,29000,0,29000,198302,0,227302
112637900800000,NE 160,RESIDENTIAL,28280,0,28280,210987,0,239267
112637900900000,NE 160,RESIDENTIAL,31462,0,31462,250885,0,282347
112637901000000,NE 160,RESIDENTIAL,29662,0,29662,260597,0,290259
112638000100000,NE 160,RESIDENTIAL,29925,0,29925,201320,0,231245
112638000200000,NE 160,RESIDENTIAL,26600,0,26600,220987,0,247587
112638000300000,NE 160,RESIDENTIAL,29400,0,29400,192372,0,221772
112638000400000,NE 160,RESIDENTIAL,28000,0,28000,193241,0,221241
112638000500000,NE 160,RESIDENTIAL,28000,0,28000,189437,0,217437
112638100100000,NE 160,RESIDENTIAL,31424,0,31424,190091,0,221515
112638100200000,NE 160,RESIDENTIAL,29925,0,29925,160448,0,190373
112638100300000,NE 160,RESIDENTIAL,29568,0,29568,176978,0,206546
112638100400000,NE 160,RESIDENTIAL,30000,0,30000,202591,0,232591
112638100500000,NE 160,RESIDENTIAL,28185,0,28185,199941,0,228126
112638100600000,NE 160,RESIDENTIAL,27132,0,27132,187765,0,214897
112638100700000,NE 160,RESIDENTIAL,28560,0,28560,197260,0,225820
112638100800000,NE 160,RESIDENTIAL,28502,0,28502,179017,0,207519
112638100900000,NE 160,RESIDENTIAL,27190,0,27190,153366,0,180556
112638101000000,NE 160,RESIDENTIAL,28560,0,28560,177170,0,205730
112638101100000,NE 160,RESIDENTIAL,28560,0,28560,191004,0,219564
112638101200000,NE 160,RESIDENTIAL,27132,0,27132,205758,0,232890
112638101300000,NE 160,RESIDENTIAL,29988,0,29988,190617,0,220605
112638101400000,NE 160,RESIDENTIAL,28560,0,28560,200139,0,228699
112638101500000,NE 160,RESIDENTIAL,28560,0,28560,204849,0,233409
112638101600000,NE 160,RESIDENTIAL,27720,0,27720,204950,0,232670
112638101700000,NE 160,RESIDENTIAL,30030,0,30030,152939,0,182969
112638200100000,NE 160,RESIDENTIAL,30522,0,30522,195695,0,226217
112638200200000,NE 160,RESIDENTIAL,25100,0,25100,177126,0,202226
112638200300000,NE 160,RESIDENTIAL,29252,0,29252,212704,0,241956
112638200400000,NE 160,RESIDENTIAL,30430,0,30430,176728,0,207158
112638200500000,NE 160,RESIDENTIAL,29457,0,29457,205075,0,234532
112638200600000,NE 160,RESIDENTIAL,29512,0,29512,179659,0,209171
112638200700000,NE 160,RESIDENTIAL,29988,0,29988,193318,0,223306
112638200800000,NE 160,RESIDENTIAL,27132,0,27132,184183,0,211315
112638200900000,NE 160,RESIDENTIAL,27132,0,27132,194073,0,221205
112638201000000,NE 160,RESIDENTIAL,29988,0,29988,210046,0,240034
112638201100000,NE 160,RESIDENTIAL,31118,0,31118,247630,0,278748
112638201200000,NE 160,RESIDENTIAL,29988,0,29988,221662,0,251650
112638201300000,NE 160,RESIDENTIAL,28203,0,28203,216779,0,244982
112638201400000,NE 160,RESIDENTIAL,26061,0,26061,177899,0,203960
112638201500000,NE 160,RESIDENTIAL,29988,0,29988,187546,0,217534
112638201600000,NE 160,RESIDENTIAL,27132,0,27132,203882,0,231014
112638201700000,NE 160,RESIDENTIAL,29047,0,29047,201605,0,230652
112638201800000,NE 160,RESIDENTIAL,30953,0,30953,193775,0,224728
112638201900000,NE 160,RESIDENTIAL,31450,0,31450,229041,0,260491
112638202000000,NE 160,RESIDENTIAL,28560,0,28560,162772,0,191332
112638202100000,NE 160,RESIDENTIAL,28560,0,28560,153010,0,181570
112638202200000,NE 160,RESIDENTIAL,28560,0,28560,202322,0,230882
112638202300000,NE 160,RESIDENTIAL,30430,0,30430,208443,0,238873
112638300100000,NE 160,RESIDENTIAL,29792,0,29792,194271,0,224063
112638300200000,NE 160,RESIDENTIAL,29792,0,29792,188934,0,218726
112712600400000,NE 110,RESIDENTIAL,49600,0,49600,226409,0,276009
112712600500000,NE 110,RESIDENTIAL,51750,0,51750,160497,0,212247
112712600600000,NE 110,RESIDENTIAL,53750,0,53750,222194,0,275944
112712700200000,NE 173,RESIDENTIAL,48107,0,48107,179942,0,228049
112712700300000,NE 173,RESIDENTIAL,46283,0,46283,242814,0,289097
112712700400000,NE 173,RESIDENTIAL,46283,0,46283,212594,0,258877
112712700500000,NE 173,RESIDENTIAL,46283,0,46283,222823,0,269106
112712800100000,NE 173,RESIDENTIAL,48620,0,48620,218912,0,267532
112715200100000,NE 101,AG LAND,26439,0,26439,0,0,26439
112715200200000,NE 173,RESIDENTIAL,59796,0,59796,251095,0,310891
112715200300000,NE 173,RESIDENTIAL,52470,0,52470,259669,0,312139
112715200400000,NE 173,RESIDENTIAL,71058,0,71058,273585,0,344643
112715200500000,NE 173,RESIDENTIAL,47218,0,47218,189515,0,236733
112715200600000,NE 173,RESIDENTIAL,48620,0,48620,234334,0,282954
112715200700000,NE 173,RESIDENTIAL,53387,0,53387,237105,0,290492
112715200800000,NE 173,RESIDENTIAL,45760,0,45760,229619,0,275379
112715200900000,NE 173,RESIDENTIAL,45760,0,45760,243342,0,289102
112715201000000,NE 173,RESIDENTIAL,45760,0,45760,242529,0,288289
112715201100000,NE 173,RESIDENTIAL,45760,0,45760,259040,0,304800
112715201200000,NE 173,RESIDENTIAL,45760,0,45760,226059,0,271819
112715201300000,NE 173,RESIDENTIAL,45760,0,45760,240815,0,286575
112715201400000,NE 173,RESIDENTIAL,50490,0,50490,251355,0,301845
112715201500000,NE 173,RESIDENTIAL,62770,0,62770,246588,0,309358
112715201600000,NE 173,RESIDENTIAL,60048,0,60048,235382,0,295430
112715201700000,NE 173,RESIDENTIAL,225,0,225,0,0,225
112715201800000,NE 173,RESIDENTIAL,62729,0,62729,243242,0,305971
112715201900000,NE 173,RESIDENTIAL,56940,0,56940,253338,0,310278
112715202000000,NE 173,RESIDENTIAL,48620,0,48620,254337,0,302957
112715202100000,NE 173,RESIDENTIAL,46130,0,46130,248568,0,294698
112715202200000,NE 173,RESIDENTIAL,61371,0,61371,253390,0,314761
112715202300000,NE 173,RESIDENTIAL,75295,0,75295,328807,0,404102
112715202400000,NE 173,RESIDENTIAL,59253,0,59253,245321,0,304574
112715202500000,NE 173,RESIDENTIAL,52515,0,52515,261139,0,313654
112715202600000,NE 173,RESIDENTIAL,318,0,318,0,0,318
112715300100000,NE 173,RESIDENTIAL,48895,0,48895,237343,0,286238
112715300200000,NE 173,RESIDENTIAL,48739,0,48739,217011,0,265750
112715300300000,NE 173,RESIDENTIAL,45760,0,45760,230105,0,275865
112715300400000,NE 173,RESIDENTIAL,45320,0,45320,250846,0,296166
112715300500000,NE 173,RESIDENTIAL,193,0,193,0,0,193
112715300600000,NE 173,RESIDENTIAL,192,0,192,0,0,192
112715300700000,NE 173,RESIDENTIAL,191,0,191,0,0,191
112715300800000,NE 173,RESIDENTIAL,44880,0,44880,237152,0,282032
112715300900000,NE 173,RESIDENTIAL,44880,0,44880,235486,0,280366
112715301000000,NE 173,RESIDENTIAL,51333,0,51333,244263,0,295596
112715301100000,NE 173,RESIDENTIAL,54230,0,54230,247738,0,301968
112715301200000,NE 173,RESIDENTIAL,55440,0,55440,221283,0,276723
112715301300000,NE 173,RESIDENTIAL,60236,0,60236,256923,0,317159
112715400100000,NE 173,RESIDENTIAL,245,0,245,0,0,245
112715400200000,NE 173,RESIDENTIAL,214,0,214,0,0,214
112715400300000,NE 173,RESIDENTIAL,218,0,218,0,0,218
112715400400000,NE 173,RESIDENTIAL,46750,0,46750,224093,0,270843
112715400500000,NE 173,RESIDENTIAL,46750,0,46750,224690,0,271440
112715400600000,NE 173,RESIDENTIAL,46750,0,46750,221840,0,268590
112715400700000,NE 173,RESIDENTIAL,186,0,186,0,0,186
112715400800000,NE 173,RESIDENTIAL,46750,0,46750,246605,0,293355
112715400900000,NE 173,RESIDENTIAL,46750,0,46750,232419,0,279169
112715401000000,NE 173,RESIDENTIAL,46750,0,46750,258204,0,304954
112715401100000,NE 173,RESIDENTIAL,46750,0,46750,201904,0,248654
112715401200000,NE 173,RESIDENTIAL,46750,0,46750,211314,0,258064
112715401300000,NE 173,RESIDENTIAL,58542,0,58542,204312,0,262854
112717700100000,NE 101,AG LAND,19043,0,19043,0,0,19043
112720401600000,SCHOOL,EXEMPT,0,0,0,0,0,0
112720401800000,SCHOOL,EXEMPT,0,0,0,0,0,0
112720402000000,NE 101,AG LAND,13503,0,13503,0,0,13503
112722600500000,NE 175,AG LAND,13530,0,13530,0,0,13530
112722700100000,NE 175,RESIDENTIAL,29430,0,29430,151912,0,181342
112722700200000,NE 175,RESIDENTIAL,28253,0,28253,144177,0,172430
112722700300000,NE 175,RESIDENTIAL,27972,0,27972,164034,0,192006
112722700400000,NE 175,RESIDENTIAL,26000,0,26000,144870,0,170870
112722700500000,NE 175,RESIDENTIAL,173,0,173,0,0,173
112722700600000,NE 175,RESIDENTIAL,173,0,173,0,0,173
112722700700000,NE 175,RESIDENTIAL,173,0,173,0,0,173
112722700800000,NE 175,RESIDENTIAL,173,0,173,0,0,173
112722700900000,NE 175,RESIDENTIAL,202,0,202,0,0,202
112722800100000,NE 175,RESIDENTIAL,194,0,194,0,0,194
112722800200000,NE 175,RESIDENTIAL,193,0,193,0,0,193
112722900100000,NE 175,RESIDENTIAL,188,0,188,0,0,188
112722900200000,NE 175,RESIDENTIAL,188,0,188,0,0,188
112722900300000,NE 175,RESIDENTIAL,188,0,188,0,0,188
112722900400000,NE 175,RESIDENTIAL,188,0,188,0,0,188
112722900500000,NE 175,RESIDENTIAL,26208,0,26208,10500,0,36708
112722900600000,NE 175,RESIDENTIAL,26208,0,26208,131085,0,157293
112722900700000,NE 175,RESIDENTIAL,188,0,188,0,0,188
112722900800000,NE 175,RESIDENTIAL,188,0,188,0,0,188
112722900900000,NE 175,RESIDENTIAL,26208,0,26208,181268,0,207476
112722901000000,NE 175,RESIDENTIAL,188,0,188,0,0,188
112723000100000,NE 175,RESIDENTIAL,212,0,212,0,0,212
112723000200000,NE 175,RESIDENTIAL,28724,0,28724,144532,0,173256
112723000300000,NE 175,RESIDENTIAL,24240,0,24240,128498,0,152738
112723000400000,NE 175,RESIDENTIAL,24240,0,24240,117202,0,141442
112723000500000,NE 175,RESIDENTIAL,165,0,165,0,0,165
112723000600000,NE 175,RESIDENTIAL,24240,0,24240,131928,0,156168
112723000700000,NE 175,RESIDENTIAL,212,0,212,0,0,212
112723000800000,NE 175,RESIDENTIAL,212,0,212,0,0,212
112723000900000,NE 175,RESIDENTIAL,165,0,165,0,0,165
112723001000000,NE 175,RESIDENTIAL,165,0,165,0,0,165
112723001100000,NE 175,RESIDENTIAL,165,0,165,0,0,165
112723001200000,NE 175,RESIDENTIAL,165,0,165,0,0,165
112723100100000,NE 175,RESIDENTIAL,206,0,206,0,0,206
112723100200000,NE 175,RESIDENTIAL,302,0,302,0,0,302
112723100300000,NE 175,RESIDENTIAL,226,0,226,0,0,226
112723100400000,NE 175,RESIDENTIAL,233,0,233,0,0,233
112723100500000,NE 175,RESIDENTIAL,202,0,202,0,0,202
112723100600000,NE 175,RESIDENTIAL,153,0,153,0,0,153
112723100700000,NE 175,RESIDENTIAL,153,0,153,0,0,153
112723100800000,NE 175,RESIDENTIAL,154,0,154,0,0,154
112723100900000,NE 175,RESIDENTIAL,235,0,235,0,0,235
112723101000000,NE 175,RESIDENTIAL,24240,0,24240,132511,0,156751
112723101100000,NE 175,RESIDENTIAL,24240,0,24240,126980,0,151220
112723101200000,NE 175,RESIDENTIAL,24240,0,24240,119121,0,143361
112723101300000,NE 175,RESIDENTIAL,167,0,167,0,0,167
112723101400000,NE 175,RESIDENTIAL,167,0,167,0,0,167
112723101500000,NE 175,RESIDENTIAL,184,0,184,0,0,184
112723101600000,NE 175,RESIDENTIAL,194,0,194,0,0,194
112723200100000,NE 175,RESIDENTIAL,186,0,186,0,0,186
112723300100000,NE 175,RESIDENTIAL,180,0,180,0,0,180
112723300200000,NE 175,RESIDENTIAL,189,0,189,0,0,189
112723400100000,NE 175,RESIDENTIAL,27440,0,27440,117270,0,144710
112723400200000,NE 175,RESIDENTIAL,23520,0,23520,107034,0,130554
112723400300000,NE 175,RESIDENTIAL,23520,0,23520,136792,0,160312
112723400400000,NE 175,RESIDENTIAL,23520,0,23520,106544,0,130064
112723400500000,NE 175,RESIDENTIAL,23520,0,23520,120146,0,143666
112723400600000,NE 175,RESIDENTIAL,23520,0,23520,119477,0,142997
112723400700000,NE 175,RESIDENTIAL,23280,0,23280,107034,0,130314
112723400800000,NE 175,RESIDENTIAL,23040,0,23040,120146,0,143186
112723400900000,NE 175,RESIDENTIAL,23040,0,23040,105622,0,128662
112723401000000,NE 175,RESIDENTIAL,23520,0,23520,120800,0,144320
112723401100000,NE 175,RESIDENTIAL,24000,0,24000,99558,0,123558
112723401200000,NE 175,RESIDENTIAL,24240,0,24240,116430,0,140670
112723401300000,NE 175,RESIDENTIAL,24480,0,24480,100215,0,124695
112723401400000,NE 175,RESIDENTIAL,26520,0,26520,123045,0,149565
112723500100000,NE 175,RESIDENTIAL,27072,0,27072,99558,0,126630
112723500200000,NE 175,RESIDENTIAL,27072,0,27072,107319,0,134391
112723500300000,NE 175,RESIDENTIAL,27824,0,27824,99380,0,127204
112723500400000,CITY PROPERTY,EXEMPT,0,0,0,0,0,0
112725100400000,NE 101,AG DWELLING,57413,0,57413,228324,0,285737
112725100500000,NE 175,AG LAND,36645,0,36645,0,0,36645
112727600200000,NE 173,RESIDENTIAL,178,0,178,0,0,178
112727600300000,NE 173,RESIDENTIAL,46283,0,46283,226798,0,273081
112727600400000,NE 173,RESIDENTIAL,46283,0,46283,246776,0,293059
112727600500000,NE 173,RESIDENTIAL,46283,0,46283,239044,0,285327
112727600600000,NE 173,RESIDENTIAL,49005,0,49005,238654,0,287659
112727700100000,NE 173,RESIDENTIAL,52250,0,52250,296926,0,349176
112727700200000,NE 173,RESIDENTIAL,47300,0,47300,225200,0,272500
112727700300000,NE 173,RESIDENTIAL,47300,0,47300,260876,0,308176
112727700400000,NE 173,RESIDENTIAL,47300,0,47300,274152,0,321452
112727800100000,NE 173,RESIDENTIAL,57826,0,57826,252174,0,310000
112727800200000,NE 173,RESIDENTIAL,61050,0,61050,239183,0,300233
112727800300000,NE 173,RESIDENTIAL,66385,0,66385,236786,0,303171
112727800400000,NE 173,RESIDENTIAL,60060,0,60060,254776,0,314836
112727900100000,NE 173,RESIDENTIAL,47850,0,47850,235744,0,283594
112727900200000,NE 173,RESIDENTIAL,47850,0,47850,241639,0,289489
112727900300000,NE 173,RESIDENTIAL,44000,0,44000,300513,0,344513
112727900400000,NE 173,RESIDENTIAL,44000,0,44000,225369,0,269369
112727900500000,NE 173,RESIDENTIAL,43633,0,43633,242056,0,285689
112727900600000,NE 173,RESIDENTIAL,43083,0,43083,238274,0,281357
112727900700000,NE 173,RESIDENTIAL,42289,0,42289,239974,0,282263
112727900800000,NE 173,RESIDENTIAL,41701,0,41701,268451,0,310152
112727900900000,NE 173,RESIDENTIAL,46332,0,46332,209310,0,255642
112727901000000,NE 173,RESIDENTIAL,46640,0,46640,226071,0,272711
112727901100000,NE 173,RESIDENTIAL,47080,0,47080,266797,0,313877
112727901200000,NE 173,RESIDENTIAL,45760,0,45760,276858,0,322618
112727901300000,NE 173,RESIDENTIAL,44880,0,44880,10080,0,54960
112727901400000,NE 173,RESIDENTIAL,3612,0,3612,0,0,3612
112727901500000,NE 173,RESIDENTIAL,44000,0,44000,58441,0,102441
112727901600000,NE 173,RESIDENTIAL,44000,0,44000,239827,0,283827
112727901700000,NE 173,RESIDENTIAL,44000,0,44000,237219,0,281219
112728100100000,NE 173,RESIDENTIAL,48950,0,48950,236073,0,285023
112728100200000,NE 101,AG LAND,51050,0,51050,0,0,51050
112728200100000,NE 173,RESIDENTIAL,48950,0,48950,208147,0,257097
112728200200000,NE 173,RESIDENTIAL,48950,0,48950,207706,0,256656
112728200300000,NE 173,RESIDENTIAL,44000,0,44000,237812,0,281812
112728200400000,NE 173,RESIDENTIAL,44000,0,44000,245298,0,289298
112728200500000,NE 173,RESIDENTIAL,44440,0,44440,10080,0,54520
112728200600000,NE 173,RESIDENTIAL,3646,0,3646,0,0,3646
112728200700000,NE 173,RESIDENTIAL,44440,0,44440,4234,0,48674
112728200800000,NE 173,RESIDENTIAL,44440,0,44440,265064,0,309504
112728200900000,NE 173,RESIDENTIAL,44000,0,44000,262515,0,306515
112730100100000,NE 101,AG LAND,26334,0,26334,0,0,26334
112730100300000,NE 163,RESIDENTIAL,30269,0,30269,131667,0,161936
112730100400000,NE 163,RESIDENTIAL,26948,0,26948,147497,0,174445
112730100500000,NE 163,RESIDENTIAL,26948,0,26948,157198,0,184146
112730100600000,NE 163,RESIDENTIAL,26948,0,26948,151841,0,178789
112730100700000,NE 163,RESIDENTIAL,26948,0,26948,150830,0,177778
112730100800000,NE 163,RESIDENTIAL,26948,0,26948,135413,0,162361
112730100900000,NE 163,RESIDENTIAL,26948,0,26948,141363,0,168311
112730101000000,NE 163,RESIDENTIAL,26948,0,26948,178861,0,205809
112730101100000,NE 163,RESIDENTIAL,26948,0,26948,135932,0,162880
112730101200000,NE 163,RESIDENTIAL,26948,0,26948,152341,0,179289
112730101300000,NE 163,RESIDENTIAL,26948,0,26948,136011,0,162959
112730101400000,NE 163,RESIDENTIAL,26948,0,26948,113594,0,140542
112730101500000,NE 163,RESIDENTIAL,26948,0,26948,136689,0,163637
112730101600000,NE 163,RESIDENTIAL,26948,0,26948,128851,0,155799
112730101700000,NE 163,RESIDENTIAL,26948,0,26948,151017,0,177965
112730101800000,NE 163,RESIDENTIAL,26948,0,26948,136326,0,163274
112730101900000,NE 163,RESIDENTIAL,30000,0,30000,179691,0,209691
112730102000000,NE 163,RESIDENTIAL,30000,0,30000,149916,0,179916
112730102100000,NE 163,RESIDENTIAL,26948,0,26948,138477,0,165425
112730102200000,NE 163,RESIDENTIAL,26948,0,26948,148158,0,175106
112730102300000,NE 163,RESIDENTIAL,26948,0,26948,152814,0,179762
112730102400000,NE 163,RESIDENTIAL,26948,0,26948,165157,0,192105
112730102500000,NE 163,RESIDENTIAL,26948,0,26948,152752,0,179700
112730102600000,NE 163,RESIDENTIAL,26948,0,26948,160719,0,187667
112730102700000,NE 163,RESIDENTIAL,26948,0,26948,162997,0,189945
112730102800000,NE 163,RESIDENTIAL,26948,0,26948,156142,0,183090
112730102900000,NE 163,RESIDENTIAL,26948,0,26948,140176,0,167124
112730103000000,NE 163,RESIDENTIAL,26948,0,26948,139803,0,166751
112730103100000,NE 163,RESIDENTIAL,26948,0,26948,159058,0,186006
112730103200000,NE 163,RESIDENTIAL,26948,0,26948,176305,0,203253
112730103300000,NE 163,RESIDENTIAL,26948,0,26948,164907,0,191855
112730103400000,NE 163,RESIDENTIAL,26948,0,26948,179148,0,206096
112730103500000,NE 163,RESIDENTIAL,26948,0,26948,163231,0,190179
112730103600000,NE 163,RESIDENTIAL,31349,0,31349,151099,0,182448
112730200100000,NE 163,RESIDENTIAL,26000,0,26000,153108,0,179108
112730200200000,NE 163,RESIDENTIAL,31532,0,31532,152699,0,184231
112730200300000,NE 163,RESIDENTIAL,28620,0,28620,157830,0,186450
112730200400000,NE 163,RESIDENTIAL,28620,0,28620,156281,0,184901
112730200500000,NE 163,RESIDENTIAL,28620,0,28620,170490,0,199110
112730200600000,NE 163,RESIDENTIAL,30600,0,30600,176804,0,207404
112730200700000,NE 163,RESIDENTIAL,32980,0,32980,161837,0,194817
112730200800000,NE 163,RESIDENTIAL,32000,0,32000,152734,0,184734
112730200900000,NE 163,RESIDENTIAL,31040,0,31040,154064,0,185104
112730201000000,NE 163,RESIDENTIAL,20,0,20,0,0,20
112730201100000,NE 163,RESIDENTIAL,15,0,15,0,0,15
112730300100000,NE 163,RESIDENTIAL,30000,0,30000,147872,0,177872
112730300200000,NE 163,RESIDENTIAL,420,0,420,0,0,420
112730300300000,NE 163,RESIDENTIAL,420,0,420,0,0,420
112730300400000,NE 163,RESIDENTIAL,396,0,396,0,0,396
112730300500000,NE 163,RESIDENTIAL,26400,0,26400,153922,0,180322
112730300600000,NE 163,RESIDENTIAL,26400,0,26400,160638,0,187038
112730300700000,NE 163,RESIDENTIAL,26400,0,26400,150016,0,176416
112730300800000,NE 163,RESIDENTIAL,26400,0,26400,149014,0,175414
112730300900000,NE 163,RESIDENTIAL,26400,0,26400,130699,0,157099
112730301000000,NE 163,RESIDENTIAL,26400,0,26400,153847,0,180247
112730301100000,NE 163,RESIDENTIAL,26400,0,26400,129355,0,155755
112730301200000,NE 163,RESIDENTIAL,26400,0,26400,151516,0,177916
112730301300000,NE 163,RESIDENTIAL,26400,0,26400,148870,0,175270
112730301400000,NE 163,RESIDENTIAL,26400,0,26400,131135,0,157535
112730301500000,NE 163,RESIDENTIAL,26400,0,26400,153645,0,180045
112730301600000,NE 163,RESIDENTIAL,26400,0,26400,145203,0,171603
112730301700000,NE 163,RESIDENTIAL,26400,0,26400,130662,0,157062
112730301800000,NE 163,RESIDENTIAL,26400,0,26400,138372,0,164772
112730301900000,NE 163,RESIDENTIAL,26403,0,26403,130834,0,157237
112730302000000,NE 163,RESIDENTIAL,27141,0,27141,135473,0,162614
112730400100000,NE 163,RESIDENTIAL,31200,0,31200,166171,0,197371
112730400200000,NE 163,RESIDENTIAL,26948,0,26948,146466,0,173414
112730400300000,NE 163,RESIDENTIAL,26948,0,26948,166774,0,193722
112730400400000,NE 163,RESIDENTIAL,26948,0,26948,131298,0,158246
112730400500000,NE 163,RESIDENTIAL,26948,0,26948,153336,0,180284
112730400600000,NE 163,RESIDENTIAL,26948,0,26948,137263,0,164211
112730400700000,NE 163,RESIDENTIAL,26948,0,26948,154598,0,181546
112730400800000,NE 163,RESIDENTIAL,26948,0,26948,138948,0,165896
112730400900000,NE 163,RESIDENTIAL,26948,0,26948,171552,0,198500
112730401000000,NE 163,RESIDENTIAL,26948,0,26948,171206,0,198154
112730401100000,NE 163,RESIDENTIAL,26948,0,26948,139815,0,166763
112730401200000,NE 163,RESIDENTIAL,26948,0,26948,153972,0,180920
112730401300000,NE 163,RESIDENTIAL,26948,0,26948,154659,0,181607
112730401400000,NE 163,RESIDENTIAL,26948,0,26948,151171,0,178119
112730401500000,NE 163,RESIDENTIAL,26948,0,26948,153365,0,180313
112730401600000,NE 163,RESIDENTIAL,26948,0,26948,153870,0,180818
112730401700000,NE 163,RESIDENTIAL,31093,0,31093,165856,0,196949
112730401800000,NE 101,RESIDENTIAL,122,0,122,0,0,122
112730401900000,NE 163,RESIDENTIAL,32173,0,32173,137388,0,169561
112730402000000,NE 163,RESIDENTIAL,26948,0,26948,132205,0,159153
112730402100000,NE 163,RESIDENTIAL,26948,0,26948,144675,0,171623
112730402200000,NE 163,RESIDENTIAL,26948,0,26948,137232,0,164180
112730402300000,NE 163,RESIDENTIAL,26948,0,26948,157115,0,184063
112730402400000,NE 163,RESIDENTIAL,26948,0,26948,151104,0,178052
112730402500000,NE 163,RESIDENTIAL,26948,0,26948,156285,0,183233
112730402600000,NE 163,RESIDENTIAL,26948,0,26948,142697,0,169645
112730402700000,NE 163,RESIDENTIAL,26948,0,26948,166285,0,193233
112730402800000,NE 163,RESIDENTIAL,26948,0,26948,155537,0,182485
112730402900000,NE 163,RESIDENTIAL,26948,0,26948,173379,0,200327
112730403000000,NE 163,RESIDENTIAL,26948,0,26948,134873,0,161821
112730403100000,NE 163,RESIDENTIAL,26948,0,26948,150909,0,177857
112730403200000,NE 163,RESIDENTIAL,26948,0,26948,168021,0,194969
112730403300000,NE 163,RESIDENTIAL,26948,0,26948,163667,0,190615
112730403400000,NE 163,RESIDENTIAL,26948,0,26948,149566,0,176514
112730403500000,NE 163,RESIDENTIAL,31200,0,31200,146881,0,178081
112730500100000,NE 163,RESIDENTIAL,30000,0,30000,139500,0,169500
112730500200000,NE 163,RESIDENTIAL,26152,0,26152,168356,0,194508
112730500300000,NE 163,RESIDENTIAL,26152,0,26152,158834,0,184986
112730500400000,NE 163,RESIDENTIAL,26152,0,26152,136103,0,162255
112730500500000,NE 163,RESIDENTIAL,26152,0,26152,163462,0,189614
112730500600000,NE 163,RESIDENTIAL,26152,0,26152,148713,0,174865
112730500700000,NE 163,RESIDENTIAL,26152,0,26152,185136,0,211288
112730500800000,NE 163,RESIDENTIAL,26152,0,26152,137857,0,164009
112730500900000,NE 163,RESIDENTIAL,26152,0,26152,157993,0,184145
112730501000000,NE 163,RESIDENTIAL,26152,0,26152,151667,0,177819
112730501100000,NE 163,RESIDENTIAL,26152,0,26152,164059,0,190211
112730501200000,NE 163,RESIDENTIAL,26144,0,26144,158793,0,184937
112730501300000,NE 163,RESIDENTIAL,26152,0,26152,172541,0,198693
112730501400000,NE 163,RESIDENTIAL,26152,0,26152,171984,0,198136
112730501500000,NE 163,RESIDENTIAL,26152,0,26152,184171,0,210323
112730501600000,NE 163,RESIDENTIAL,26152,0,26152,155857,0,182009
112730501700000,NE 163,RESIDENTIAL,30269,0,30269,169406,0,199675
112732600200000,NE 162,RESIDENTIAL,42480,0,42480,217221,0,259701
112732600300000,NE 162,RESIDENTIAL,49240,0,49240,192239,0,241479
112732600400000,NE 162,RESIDENTIAL,45720,0,45720,192721,0,238441
112732600500000,CITY PROPERTY,EXEMPT,0,0,0,0,0,0
112732600600000,NE 162,RESIDENTIAL,32912,0,32912,151885,0,184797
112732600700000,NE 162,RESIDENTIAL,31680,0,31680,158097,0,189777
112732600800000,NE 162,RESIDENTIAL,31640,0,31640,152530,0,184170
112732600900000,NE 162,RESIDENTIAL,32160,0,32160,200438,0,232598
112732601000000,NE 162,RESIDENTIAL,33070,0,33070,171591,0,204661
112732601100000,NE 162,RESIDENTIAL,35075,0,35075,175715,0,210790
112732601200000,NE 162,RESIDENTIAL,31304,0,31304,168491,0,199795
112732601300000,NE 162,RESIDENTIAL,30633,0,30633,148671,0,179304
112732601400000,NE 162,RESIDENTIAL,33535,0,33535,177736,0,211271
112732601500000,CITY PROPERTY,EXEMPT,0,0,0,0,0,0
112732601600000,NE 162,RESIDENTIAL,32368,0,32368,145718,0,178086
112732601700000,NE 162,RESIDENTIAL,33120,0,33120,174398,0,207518
112732601800000,NE 162,RESIDENTIAL,33424,0,33424,151453,0,184877
112732601900000,NE 162,RESIDENTIAL,31272,0,31272,152544,0,183816
112732602000000,NE 162,RESIDENTIAL,30501,0,30501,165219,0,195720
112732602100000,NE 162,RESIDENTIAL,31919,0,31919,154983,0,186902
112732602200000,NE 101,AG LAND,21127,0,21127,0,0,21127
112732700100000,NE 162,RESIDENTIAL,28527,0,28527,162289,0,190816
112732700200000,NE 162,RESIDENTIAL,30620,0,30620,158562,0,189182
112735100100000,NE 162,RESIDENTIAL,28811,0,28811,160691,0,189502
112735100200000,NE 162,RESIDENTIAL,29120,0,29120,177253,0,206373
112735100300000,NE 162,RESIDENTIAL,29120,0,29120,144629,0,173749
112735100400000,NE 162,RESIDENTIAL,29120,0,29120,131951,0,161071
112735100500000,NE 162,RESIDENTIAL,29447,0,29447,159569,0,189016
112735100600000,NE 162,RESIDENTIAL,31121,0,31121,170728,0,201849
112735100700000,NE 162,RESIDENTIAL,26637,0,26637,155944,0,182581
112735200100000,NE 162,RESIDENTIAL,26920,0,26920,152822,0,179742
112735200200000,NE 162,RESIDENTIAL,30845,0,30845,183153,0,213998
112735200300000,NE 162,RESIDENTIAL,27456,0,27456,162933,0,190389
112735200400000,NE 162,RESIDENTIAL,29781,0,29781,148902,0,178683
112735200500000,NE 162,RESIDENTIAL,29120,0,29120,159009,0,188129
112735200600000,NE 162,RESIDENTIAL,27456,0,27456,160714,0,188170
112735200700000,NE 162,RESIDENTIAL,29120,0,29120,159739,0,188859
112735200800000,NE 162,RESIDENTIAL,29536,0,29536,147750,0,177286
112735200900000,NE 162,RESIDENTIAL,29536,0,29536,181293,0,210829
112735201000000,NE 162,RESIDENTIAL,29120,0,29120,146822,0,175942
112735201100000,NE 162,RESIDENTIAL,27456,0,27456,173246,0,200702
112735201200000,NE 162,RESIDENTIAL,29120,0,29120,175391,0,204511
112735201300000,NE 162,RESIDENTIAL,29120,0,29120,155464,0,184584
112735201400000,NE 162,RESIDENTIAL,31175,0,31175,163750,0,194925
112735201500000,NE 162,RESIDENTIAL,31650,0,31650,137570,0,169220
112735300100000,NE 162,RESIDENTIAL,30477,0,30477,158866,0,189343
112735300200000,NE 162,RESIDENTIAL,28560,0,28560,170138,0,198698
112735300300000,NE 162,RESIDENTIAL,28560,0,28560,132796,0,161356
112735300400000,NE 162,RESIDENTIAL,26928,0,26928,158507,0,185435
112735300500000,NE 162,RESIDENTIAL,28560,0,28560,155254,0,183814
112735300600000,NE 162,RESIDENTIAL,28560,0,28560,162805,0,191365
112735300700000,NE 162,RESIDENTIAL,26928,0,26928,162929,0,189857
112735300800000,NE 162,RESIDENTIAL,28560,0,28560,121055,0,149615
112735300900000,NE 162,RESIDENTIAL,28560,0,28560,155521,0,184081
112735301000000,NE 162,RESIDENTIAL,26928,0,26928,146187,0,173115
112735301100000,NE 162,RESIDENTIAL,28560,0,28560,150323,0,178883
112735301200000,NE 162,RESIDENTIAL,28560,0,28560,150766,0,179326
112735301300000,NE 162,RESIDENTIAL,26928,0,26928,131025,0,157953
112735301400000,NE 162,RESIDENTIAL,28840,0,28840,155110,0,183950
112735301500000,NE 162,RESIDENTIAL,32916,0,32916,166977,0,199893
112735301600000,NE 162,RESIDENTIAL,31492,0,31492,139224,0,170716
112735301700000,NE 162,RESIDENTIAL,28560,0,28560,169771,0,198331
112735301800000,NE 162,RESIDENTIAL,26928,0,26928,163013,0,189941
112735301900000,NE 162,RESIDENTIAL,28560,0,28560,151912,0,180472
112735302000000,NE 162,RESIDENTIAL,28560,0,28560,158089,0,186649
112735302100000,NE 162,RESIDENTIAL,26928,0,26928,174980,0,201908
112735302200000,NE 162,RESIDENTIAL,28560,0,28560,181475,0,210035
112735302300000,NE 162,RESIDENTIAL,28560,0,28560,164967,0,193527
112735302400000,NE 162,RESIDENTIAL,26928,0,26928,157122,0,184050
112735302500000,NE 162,RESIDENTIAL,28560,0,28560,175825,0,204385
112735302600000,NE 162,RESIDENTIAL,28560,0,28560,164764,0,193324
112735302700000,NE 162,RESIDENTIAL,21114,0,21114,166291,0,187405
112735302800000,NE 162,RESIDENTIAL,26932,0,26932,152879,0,179811
112735302900000,NE 162,RESIDENTIAL,28560,0,28560,151504,0,180064
112735303000000,NE 162,RESIDENTIAL,30965,0,30965,149405,0,180370
112735400100000,NE 162,RESIDENTIAL,27218,0,27218,131665,0,158883
112735400200000,NE 162,RESIDENTIAL,28560,0,28560,166822,0,195382
112735400300000,NE 162,RESIDENTIAL,28560,0,28560,157224,0,185784
112735400400000,NE 162,RESIDENTIAL,30192,0,30192,160010,0,190202
112735400500000,NE 162,RESIDENTIAL,30192,0,30192,169985,0,200177
112735400600000,NE 162,RESIDENTIAL,26928,0,26928,151273,0,178201
112735400700000,NE 162,RESIDENTIAL,28560,0,28560,147524,0,176084
112735400800000,NE 162,RESIDENTIAL,30192,0,30192,152026,0,182218
112735400900000,NE 162,RESIDENTIAL,27520,0,27520,151987,0,179507
112735401000000,NE 162,RESIDENTIAL,27532,0,27532,183069,0,210601
112735401100000,NE 162,RESIDENTIAL,30192,0,30192,162703,0,192895
112735401200000,NE 162,RESIDENTIAL,28560,0,28560,175831,0,204391
112735401300000,NE 162,RESIDENTIAL,26928,0,26928,161821,0,188749
112735401400000,NE 162,RESIDENTIAL,30192,0,30192,158228,0,188420
112735401500000,NE 162,RESIDENTIAL,30192,0,30192,172216,0,202408
112735401600000,NE 162,RESIDENTIAL,28560,0,28560,171474,0,200034
112735401700000,NE 162,RESIDENTIAL,26928,0,26928,164233,0,191161
112735401800000,NE 162,RESIDENTIAL,30931,0,30931,151936,0,182867
112735402100000,NE 162,RESIDENTIAL,30625,0,30625,169368,0,199993
112735402200000,NE 162,RESIDENTIAL,30488,0,30488,167279,0,197767
112735402300000,NE 162,RESIDENTIAL,30001,0,30001,191599,0,221600
112735402400000,NE 162,RESIDENTIAL,30282,0,30282,194779,0,225061
112735402500000,NE 162,RESIDENTIAL,29786,0,29786,214412,0,244198
112735402600000,NE 162,RESIDENTIAL,31239,0,31239,159493,0,190732
112735402700000,NE 162,RESIDENTIAL,32844,0,32844,177769,0,210613
112735402800000,NE 162,RESIDENTIAL,30750,0,30750,197718,0,228468
112735402900000,NE 162,RESIDENTIAL,32947,0,32947,198609,0,231556
112735403000000,NE 162,RESIDENTIAL,30186,0,30186,169646,0,199832
112735403100000,NE 162,RESIDENTIAL,29813,0,29813,191762,0,221575
112735403200000,NE 162,RESIDENTIAL,32634,0,32634,196098,0,228732
112735403300000,NE 162,RESIDENTIAL,33415,0,33415,190514,0,223929
112735403400000,NE 162,RESIDENTIAL,34243,0,34243,186112,0,220355
112735403500000,NE 162,RESIDENTIAL,33832,0,33832,147688,0,181520
112735403600000,NE 162,RESIDENTIAL,32401,0,32401,173524,0,205925
112735403700000,NE 162,RESIDENTIAL,31920,0,31920,147826,0,179746
112735403800000,NE 162,RESIDENTIAL,29934,0,29934,164317,0,194251
112735403900000,NE 162,RESIDENTIAL,31135,0,31135,211276,0,242411
112735404000000,NE 174,RESIDENTIAL,65550,0,65550,153289,0,218839
112735404100000,CITY PROPERTY,EXEMPT,0,0,0,0,0,0
112737600300000,NE 174,AG LAND,9122,0,9122,0,0,9122
112737700100000,NE 174,RESIDENTIAL,25452,0,25452,143392,0,168844
112737700200000,NE 174,RESIDENTIAL,25452,0,25452,159985,0,185437
112737700300000,NE 174,RESIDENTIAL,25452,0,25452,147435,0,172887
112737700400000,NE 174,RESIDENTIAL,25452,0,25452,140748,0,166200
112737700500000,NE 174,RESIDENTIAL,25452,0,25452,145348,0,170800
112737700600000,NE 174,RESIDENTIAL,25452,0,25452,144707,0,170159
112737700700000,NE 174,RESIDENTIAL,25452,0,25452,143849,0,169301
112737700800000,NE 174,RESIDENTIAL,25452,0,25452,153167,0,178619
112737700900000,NE 174,RESIDENTIAL,25452,0,25452,153145,0,178597
112737701000000,NE 174,RESIDENTIAL,25317,0,25317,141866,0,167183
112737701100000,NE 174,RESIDENTIAL,27232,0,27232,153145,0,180377
112737701200000,NE 174,RESIDENTIAL,29400,0,29400,153076,0,182476
112737701300000,NE 174,RESIDENTIAL,31356,0,31356,151260,0,182616
112737701400000,NE 174,RESIDENTIAL,28330,0,28330,142380,0,170710
112737701500000,NE 174,RESIDENTIAL,27336,0,27336,165112,0,192448
112737701600000,NE 174,RESIDENTIAL,25704,0,25704,142064,0,167768
112737701700000,NE 174,RESIDENTIAL,25452,0,25452,160953,0,186405
112737701800000,NE 174,RESIDENTIAL,25856,0,25856,153412,0,179268
112737800100000,NE 174,RESIDENTIAL,214,0,214,0,0,214
112737800200000,NE 174,RESIDENTIAL,214,0,214,0,0,214
112737800300000,NE 174,RESIDENTIAL,214,0,214,0,0,214
112737800400000,NE 174,RESIDENTIAL,214,0,214,0,0,214
112737800500000,NE 174,RESIDENTIAL,214,0,214,0,0,214
112737800600000,NE 174,RESIDENTIAL,214,0,214,0,0,214
112737800700000,NE 174,RESIDENTIAL,20200,0,20200,146462,0,166662
112737800800000,NE 174,RESIDENTIAL,20200,0,20200,161994,0,182194
112737800900000,NE 174,RESIDENTIAL,20200,0,20200,145753,0,165953
112737801000000,NE 174,RESIDENTIAL,20200,0,20200,132666,0,152866
112737801100000,NE 174,RESIDENTIAL,20200,0,20200,135422,0,155622
112737801200000,NE 174,RESIDENTIAL,20200,0,20200,133245,0,153445
112737801300000,NE 174,RESIDENTIAL,21274,0,21274,163217,0,184491
112737801400000,NE 174,RESIDENTIAL,20745,0,20745,135744,0,156489
112737801500000,NE 174,RESIDENTIAL,220,0,220,0,0,220
112737801600000,NE 174,RESIDENTIAL,24240,0,24240,113481,0,137721
112737804600000,NE 174,RESIDENTIAL,192000,0,192000,0,0,192000
112737900100000,NE 174,RESIDENTIAL,5522,0,5522,0,0,5522
112737900200000,NE 174,RESIDENTIAL,228,0,228,0,0,228
112737900300000,NE 174,RESIDENTIAL,208,0,208,0,0,208
112737900400000,NE 174,RESIDENTIAL,208,0,208,0,0,208
112737900500000,NE 174,RESIDENTIAL,214,0,214,0,0,214
112737900600000,NE 174,RESIDENTIAL,214,0,214,0,0,214
112737900700000,NE 174,RESIDENTIAL,214,0,214,0,0,214
112737900800000,NE 174,RESIDENTIAL,214,0,214,0,0,214
112737900900000,NE 174,RESIDENTIAL,263,0,263,0,0,263
112737901000000,NE 174,RESIDENTIAL,23971,0,23971,182606,0,206577
112737901100000,NE 174,RESIDENTIAL,249,0,249,0,0,249
112737901200000,NE 174,RESIDENTIAL,249,0,249,0,0,249
112737901300000,NE 174,RESIDENTIAL,249,0,249,0,0,249
112737901400000,NE 174,RESIDENTIAL,300,0,300,0,0,300
112737901500000,NE 174,RESIDENTIAL,277,0,277,0,0,277
112738000200000,NE 174,RESIDENTIAL,348000,0,348000,0,0,348000
112740100200000,NE 101,AG LAND,25862,0,25862,0,0,25862
112740100300000,NE 101,AG LAND,21185,0,21185,0,0,21185
112740200100000,NE 163,RESIDENTIAL,30149,0,30149,147811,0,177960
112740200200000,NE 163,RESIDENTIAL,27384,0,27384,157637,0,185021
112740200300000,NE 163,RESIDENTIAL,27384,0,27384,132432,0,159816
112740200400000,NE 163,RESIDENTIAL,27384,0,27384,168878,0,196262
112740200500000,CITY PROPERTY,EXEMPT,0,0,0,0,0,0
112740200600000,NE 163,RESIDENTIAL,29052,0,29052,170491,0,199543
112740200700000,NE 163,RESIDENTIAL,28172,0,28172,147345,0,175517
112740200800000,NE 163,RESIDENTIAL,28680,0,28680,163420,0,192100
112740200900000,NE 163,RESIDENTIAL,28680,0,28680,156645,0,185325
112740201000000,NE 163,RESIDENTIAL,28680,0,28680,179667,0,208347
112740201100000,NE 163,RESIDENTIAL,25587,0,25587,146991,0,172578
112740300100000,NE 163,RESIDENTIAL,31351,0,31351,150682,0,182033
112740300200000,NE 163,RESIDENTIAL,25800,0,25800,152896,0,178696
112740300300000,NE 163,RESIDENTIAL,25800,0,25800,138652,0,164452
112740300400000,NE 163,RESIDENTIAL,25800,0,25800,151894,0,177694
112740300500000,NE 163,RESIDENTIAL,25800,0,25800,141672,0,167472
112740300600000,NE 163,RESIDENTIAL,25800,0,25800,130940,0,156740
112740300700000,NE 163,RESIDENTIAL,30000,0,30000,136661,0,166661
112740300800000,NE 163,RESIDENTIAL,25800,0,25800,143515,0,169315
112740300900000,NE 163,RESIDENTIAL,25800,0,25800,148266,0,174066
112740301000000,NE 163,RESIDENTIAL,25800,0,25800,135986,0,161786
112740301100000,NE 163,RESIDENTIAL,25800,0,25800,133432,0,159232
112740301200000,NE 163,RESIDENTIAL,25800,0,25800,159921,0,185721
112740301300000,NE 163,RESIDENTIAL,25800,0,25800,150610,0,176410
112740301400000,NE 163,RESIDENTIAL,25800,0,25800,120251,0,146051
112740301500000,NE 163,RESIDENTIAL,25800,0,25800,150107,0,175907
112740301600000,NE 163,RESIDENTIAL,25800,0,25800,129210,0,155010
112740301700000,NE 163,RESIDENTIAL,31596,0,31596,152000,0,183596
112740301800000,NE 163,RESIDENTIAL,25800,0,25800,164351,0,190151
112740301900000,NE 163,RESIDENTIAL,25800,0,25800,150283,0,176083
112740302000000,NE 163,RESIDENTIAL,25800,0,25800,141414,0,167214
112740302100000,NE 163,RESIDENTIAL,25800,0,25800,174177,0,199977
112740302200000,NE 163,RESIDENTIAL,30000,0,30000,177639,0,207639
112740400100000,NE 163,RESIDENTIAL,31292,0,31292,149819,0,181111
112740400200000,NE 163,RESIDENTIAL,26372,0,26372,114098,0,140470
112740400300000,NE 163,RESIDENTIAL,26372,0,26372,150552,0,176924
112740400400000,NE 163,RESIDENTIAL,26372,0,26372,154101,0,180473
112740400500000,NE 163,RESIDENTIAL,26372,0,26372,130370,0,156742
112740400600000,NE 163,RESIDENTIAL,26372,0,26372,133729,0,160101
112740400700000,NE 163,RESIDENTIAL,26372,0,26372,131165,0,157537
112740400800000,NE 163,RESIDENTIAL,26372,0,26372,124811,0,151183
112740400900000,NE 163,RESIDENTIAL,26372,0,26372,147494,0,173866
112740401000000,NE 163,RESIDENTIAL,26372,0,26372,127631,0,154003
112740401100000,NE 163,RESIDENTIAL,26372,0,26372,160412,0,186784
112742600100000,NE 101,AG LAND,27826,0,27826,0,0,27826
112742800800000,NE 163,RESIDENTIAL,30000,0,30000,141826,0,171826
112742800900000,NE 163,RESIDENTIAL,25600,0,25600,127644,0,153244
112742801000000,NE 163,RESIDENTIAL,25600,0,25600,139817,0,165417
112742801100000,NE 163,RESIDENTIAL,25600,0,25600,146179,0,171779
112742801200000,NE 163,RESIDENTIAL,25600,0,25600,140687,0,166287
112742801300000,NE 163,RESIDENTIAL,25600,0,25600,129260,0,154860
112742801400000,NE 163,RESIDENTIAL,25600,0,25600,146766,0,172366
112742801500000,NE 163,RESIDENTIAL,25600,0,25600,142908,0,168508
112742801600000,NE 163,RESIDENTIAL,25600,0,25600,158957,0,184557
112742801700000,NE 163,RESIDENTIAL,25600,0,25600,145158,0,170758
112742801800000,NE 163,RESIDENTIAL,25600,0,25600,147694,0,173294
112742801900000,NE 163,RESIDENTIAL,25600,0,25600,152435,0,178035
112742802000000,NE 163,RESIDENTIAL,25600,0,25600,152360,0,177960
112742802100000,NE 163,RESIDENTIAL,30000,0,30000,148766,0,178766
112742900300000,NE 163,RESIDENTIAL,30400,0,30400,172644,0,203044
112742900400000,NE 163,RESIDENTIAL,30400,0,30400,153300,0,183700
112742900500000,NE 163,RESIDENTIAL,30400,0,30400,165716,0,196116
112742900600000,NE 163,RESIDENTIAL,26668,0,26668,157148,0,183816
112742900700000,NE 163,RESIDENTIAL,26668,0,26668,172556,0,199224
112742900800000,NE 163,RESIDENTIAL,26668,0,26668,165038,0,191706
112742900900000,NE 163,RESIDENTIAL,26668,0,26668,171157,0,197825
112742901000000,NE 163,RESIDENTIAL,26668,0,26668,146641,0,173309
112742901100000,NE 163,RESIDENTIAL,26700,0,26700,139542,0,166242
112742901200000,NE 163,RESIDENTIAL,26700,0,26700,178240,0,204940
112742901300000,NE 163,RESIDENTIAL,26700,0,26700,152488,0,179188
112742901400000,NE 163,RESIDENTIAL,26560,0,26560,150276,0,176836
112743000100000,NE 163,RESIDENTIAL,26380,0,26380,131131,0,157511
112743000200000,NE 163,RESIDENTIAL,30000,0,30000,152607,0,182607
112743100100000,NE 163,RESIDENTIAL,30000,0,30000,151321,0,181321
112743100200000,NE 163,RESIDENTIAL,26800,0,26800,124357,0,151157
112743100300000,NE 163,RESIDENTIAL,26800,0,26800,129460,0,156260
112743100400000,NE 163,RESIDENTIAL,26800,0,26800,125986,0,152786
112743100500000,NE 163,RESIDENTIAL,26800,0,26800,145748,0,172548
112743100600000,NE 163,RESIDENTIAL,26800,0,26800,184962,0,211762
112743100700000,NE 163,RESIDENTIAL,26800,0,26800,150934,0,177734
112743100800000,NE 163,RESIDENTIAL,26800,0,26800,139011,0,165811
112743100900000,NE 163,RESIDENTIAL,26800,0,26800,139146,0,165946
112743101000000,NE 163,RESIDENTIAL,26800,0,26800,149963,0,176763
112743101100000,NE 163,RESIDENTIAL,26800,0,26800,134549,0,161349
112743101200000,NE 163,RESIDENTIAL,26800,0,26800,151012,0,177812
112743101300000,NE 163,RESIDENTIAL,26800,0,26800,157919,0,184719
112743101400000,NE 163,RESIDENTIAL,26800,0,26800,142582,0,169382
112743101500000,NE 163,RESIDENTIAL,26800,0,26800,132512,0,159312
112743101600000,NE 163,RESIDENTIAL,30000,0,30000,144298,0,174298
112743200100000,NE 163,RESIDENTIAL,26000,0,26000,0,0,26000
112745100200000,NE 174,RESIDENTIAL,63700,0,63700,221337,0,285037
112745100300000,NE 174,AG LAND,65002,0,65002,0,0,65002
112747600100000,CITY PROPERTY,EXEMPT,0,0,0,0,0,0
112747600200000,NE 163,RESIDENTIAL,25867,0,25867,130094,0,155961
112747600300000,NE 163,RESIDENTIAL,26000,0,26000,140196,0,166196
112747600400000,NE 163,RESIDENTIAL,28000,0,28000,150288,0,178288
112747600500000,NE 163,RESIDENTIAL,28000,0,28000,140545,0,168545
112747600600000,NE 163,RESIDENTIAL,26000,0,26000,127014,0,153014
112747600700000,NE 163,RESIDENTIAL,26000,0,26000,144057,0,170057
112747600800000,NE 163,RESIDENTIAL,26000,0,26000,144636,0,170636
112747600900000,NE 163,RESIDENTIAL,26000,0,26000,131252,0,157252
112747601000000,NE 163,RESIDENTIAL,26000,0,26000,112384,0,138384
112747601100000,NE 163,RESIDENTIAL,30333,0,30333,142217,0,172550
112747601200000,NE 163,RESIDENTIAL,30526,0,30526,140078,0,170604
112747601300000,NE 163,RESIDENTIAL,30800,0,30800,163925,0,194725
112747601400000,NE 163,RESIDENTIAL,30400,0,30400,127619,0,158019
112747601500000,NE 163,RESIDENTIAL,30400,0,30400,132523,0,162923
112747601600000,NE 163,RESIDENTIAL,30905,0,30905,136332,0,167237
112747700100000,NE 163,RESIDENTIAL,31716,0,31716,132515,0,164231
112747700200000,NE 163,RESIDENTIAL,28152,0,28152,134280,0,162432
112747700300000,NE 163,RESIDENTIAL,28152,0,28152,124401,0,152553
112747700400000,NE 163,RESIDENTIAL,28152,0,28152,135469,0,163621
112747700500000,NE 163,RESIDENTIAL,28152,0,28152,174083,0,202235
112747700600000,NE 163,RESIDENTIAL,28152,0,28152,136801,0,164953
112747700700000,NE 163,RESIDENTIAL,28152,0,28152,135742,0,163894
112747700800000,NE 163,RESIDENTIAL,28152,0,28152,139156,0,167308
112747700900000,NE 163,RESIDENTIAL,28152,0,28152,168964,0,197116
112747701000000,NE 163,RESIDENTIAL,28152,0,28152,142661,0,170813
112747701100000,NE 163,RESIDENTIAL,29995,0,29995,130940,0,160935
112747800100000,NE 163,RESIDENTIAL,31486,0,31486,155520,0,187006
112747800200000,NE 163,RESIDENTIAL,26260,0,26260,140429,0,166689
112747800300000,NE 163,RESIDENTIAL,26260,0,26260,142030,0,168290
112747800400000,NE 163,RESIDENTIAL,26260,0,26260,136889,0,163149
112747800500000,NE 163,RESIDENTIAL,26260,0,26260,137850,0,164110
112747800600000,NE 163,RESIDENTIAL,26260,0,26260,129852,0,156112
112747800700000,NE 163,RESIDENTIAL,26260,0,26260,162956,0,189216
112747800800000,NE 163,RESIDENTIAL,30516,0,30516,160282,0,190798
112747800900000,NE 163,RESIDENTIAL,26839,0,26839,112050,0,138889
112747801000000,NE 163,RESIDENTIAL,26260,0,26260,140779,0,167039
112747801100000,NE 163,RESIDENTIAL,26260,0,26260,160147,0,186407
112747801200000,NE 163,RESIDENTIAL,26260,0,26260,139325,0,165585
112747801300000,NE 163,RESIDENTIAL,26480,0,26480,141096,0,167576
112747801400000,NE 163,RESIDENTIAL,30602,0,30602,141472,0,172074
112747801500000,NE 163,RESIDENTIAL,26000,0,26000,133333,0,159333
112747801600000,NE 163,RESIDENTIAL,26000,0,26000,113927,0,139927
112747801700000,NE 163,RESIDENTIAL,26000,0,26000,144904,0,170904
112747801800000,NE 163,RESIDENTIAL,26000,0,26000,137210,0,163210
112747801900000,NE 163,RESIDENTIAL,26000,0,26000,129063,0,155063
112747802000000,NE 163,RESIDENTIAL,27367,0,27367,134381,0,161748
112747802100000,NE 163,RESIDENTIAL,29422,0,29422,141943,0,171365
112747802200000,NE 163,RESIDENTIAL,31484,0,31484,159333,0,190817
112747802300000,NE 163,RESIDENTIAL,30897,0,30897,135109,0,166006
112747802400000,NE 163,RESIDENTIAL,28323,0,28323,170947,0,199270
112747802500000,NE 163,RESIDENTIAL,28323,0,28323,159203,0,187526
112747802600000,NE 163,RESIDENTIAL,28262,0,28262,138600,0,166862
112747802700000,NE 163,RESIDENTIAL,24365,0,24365,153777,0,178142
112747802800000,NE 163,RESIDENTIAL,30031,0,30031,163238,0,193269
112747802900000,NE 163,RESIDENTIAL,28804,0,28804,160406,0,189210
112747803000000,NE 163,RESIDENTIAL,29180,0,29180,129059,0,158239
112747803100000,NE 163,RESIDENTIAL,31280,0,31280,168505,0,199785
112747803200000,NE 163,RESIDENTIAL,25810,0,25810,135350,0,161160
112747803300000,NE 163,RESIDENTIAL,27300,0,27300,174911,0,202211
112747803400000,NE 163,RESIDENTIAL,27300,0,27300,138301,0,165601
112747803500000,NE 163,RESIDENTIAL,25740,0,25740,163024,0,188764
112747803600000,NE 163,RESIDENTIAL,30057,0,30057,130406,0,160463
112747803700000,NE 163,RESIDENTIAL,28157,0,28157,147522,0,175679
112747900100000,NE 163,RESIDENTIAL,31208,0,31208,143147,0,174355
112747900200000,NE 163,RESIDENTIAL,27263,0,27263,154986,0,182249
112747900300000,NE 163,RESIDENTIAL,27263,0,27263,137366,0,164629
112747900400000,NE 163,RESIDENTIAL,27263,0,27263,136750,0,164013
112747900500000,NE 163,RESIDENTIAL,27263,0,27263,144456,0,171719
112747900600000,NE 163,RESIDENTIAL,27263,0,27263,117517,0,144780
112747900700000,NE 163,RESIDENTIAL,26928,0,26928,142995,0,169923
112747900800000,NE 163,RESIDENTIAL,28152,0,28152,165437,0,193589
112747900900000,NE 163,RESIDENTIAL,28152,0,28152,154141,0,182293
112747901000000,NE 163,RESIDENTIAL,26928,0,26928,135179,0,162107
112747901100000,NE 163,RESIDENTIAL,26928,0,26928,141976,0,168904
112747901200000,NE 163,RESIDENTIAL,26928,0,26928,131986,0,158914
112747901300000,NE 163,RESIDENTIAL,26928,0,26928,136192,0,163120
112747901400000,NE 163,RESIDENTIAL,26928,0,26928,157977,0,184905
112747901500000,NE 163,RESIDENTIAL,26928,0,26928,148006,0,174934
112747901600000,NE 163,RESIDENTIAL,30785,0,30785,143344,0,174129
112748000100000,NE 163,RESIDENTIAL,30853,0,30853,139382,0,170235
112748000200000,NE 163,RESIDENTIAL,27300,0,27300,124424,0,151724
112748000300000,NE 163,RESIDENTIAL,30263,0,30263,132296,0,162559
112748000400000,NE 163,RESIDENTIAL,30562,0,30562,133026,0,163588
112748000500000,NE 163,RESIDENTIAL,32257,0,32257,170285,0,202542
112748000600000,NE 163,RESIDENTIAL,30872,0,30872,136395,0,167267
112748000700000,NE 163,RESIDENTIAL,30471,0,30471,144302,0,174773
112748000800000,NE 163,RESIDENTIAL,29208,0,29208,143472,0,172680
112748000900000,NE 163,RESIDENTIAL,30492,0,30492,137159,0,167651
112748001000000,NE 163,RESIDENTIAL,30805,0,30805,174658,0,205463
112748001100000,NE 163,RESIDENTIAL,30523,0,30523,118586,0,149109
112748001200000,NE 163,RESIDENTIAL,28379,0,28379,158993,0,187372
112748001300000,NE 163,RESIDENTIAL,26693,0,26693,159377,0,186070
112748001400000,NE 163,RESIDENTIAL,26000,0,26000,148527,0,174527
112748001500000,NE 163,RESIDENTIAL,26000,0,26000,133434,0,159434
112748001600000,NE 163,RESIDENTIAL,30561,0,30561,143449,0,174010
112748100100000,NE 163,RESIDENTIAL,30722,0,30722,123383,0,154105
112748100200000,NE 163,RESIDENTIAL,26000,0,26000,140016,0,166016
112748100300000,NE 163,RESIDENTIAL,26000,0,26000,107372,0,133372
112748100400000,NE 163,RESIDENTIAL,26359,0,26359,151923,0,178282
112748100500000,NE 163,RESIDENTIAL,27300,0,27300,108625,0,135925
112748100600000,NE 163,RESIDENTIAL,30720,0,30720,130004,0,160724
112748100700000,NE 163,RESIDENTIAL,30934,0,30934,132044,0,162978
112748100800000,NE 163,RESIDENTIAL,31787,0,31787,164455,0,196242
112748100900000,NE 163,RESIDENTIAL,26000,0,26000,126994,0,152994
112748101000000,NE 163,RESIDENTIAL,26520,0,26520,162260,0,188780
112748101100000,NE 163,RESIDENTIAL,31456,0,31456,142259,0,173715
112748101200000,NE 163,RESIDENTIAL,32191,0,32191,130044,0,162235
112748101300000,NE 163,RESIDENTIAL,31353,0,31353,159917,0,191270
112748101400000,NE 163,RESIDENTIAL,32634,0,32634,147422,0,180056
112748101500000,NE 163,RESIDENTIAL,30172,0,30172,148770,0,178942
112748101600000,NE 163,RESIDENTIAL,29568,0,29568,135585,0,165153
112748101700000,NE 163,RESIDENTIAL,26520,0,26520,161130,0,187650
112748101800000,NE 163,RESIDENTIAL,26000,0,26000,143351,0,169351
112748101900000,NE 163,RESIDENTIAL,30905,0,30905,153082,0,183987
112748102000000,NE 163,RESIDENTIAL,26260,0,26260,133056,0,159316
112748102100000,NE 163,RESIDENTIAL,30704,0,30704,164708,0,195412
112748102200000,NE 163,RESIDENTIAL,27300,0,27300,118467,0,145767
112748102300000,NE 163,RESIDENTIAL,26260,0,26260,120454,0,146714
112748102400000,NE 163,RESIDENTIAL,26000,0,26000,125937,0,151937
112748102500000,NE 163,RESIDENTIAL,26000,0,26000,145452,0,171452
112748102600000,NE 163,RESIDENTIAL,30601,0,30601,117453,0,148054
112817600100000,CENTRALLY ASSESSED,OTHER,0,0,0,0,0,0
112817600200000,NE 162,AG DWELLING,76723,0,76723,85765,14627,177115
112840100100000,NE 162,AG LAND,41324,0,41324,0,0,41324
112840100200000,NE 162,RESIDENTIAL,40513,0,40513,310397,0,350910
112840100300000,NE 162,RESIDENTIAL,40400,0,40400,216473,0,256873
112840100400000,NE 162,RESIDENTIAL,40400,0,40400,237121,0,277521
112840100500000,NE 162,RESIDENTIAL,40400,0,40400,232284,0,272684
112840100600000,NE 162,RESIDENTIAL,40400,0,40400,222917,0,263317
112840100700000,NE 162,RESIDENTIAL,40400,0,40400,232536,0,272936
112840100800000,NE 162,RESIDENTIAL,40400,0,40400,239761,0,280161
112840100900000,NE 162,RESIDENTIAL,40400,0,40400,197121,0,237521
112840101000000,NE 162,RESIDENTIAL,40400,0,40400,227118,0,267518
112840101100000,NE 162,RESIDENTIAL,40400,0,40400,230905,0,271305
112840101200000,NE 162,RESIDENTIAL,40400,0,40400,204511,0,244911
112840101300000,NE 162,RESIDENTIAL,29444,0,29444,149882,0,179326
112840200100000,NE 162,RESIDENTIAL,27120,0,27120,304329,0,331449
112840200200000,NE 162,RESIDENTIAL,30300,0,30300,183209,0,213509
112840200300000,NE 162,RESIDENTIAL,40400,0,40400,212670,0,253070
112840200400000,NE 162,RESIDENTIAL,40400,0,40400,205118,0,245518
112840200500000,NE 162,RESIDENTIAL,40400,0,40400,225220,0,265620
112840200600000,NE 162,RESIDENTIAL,40400,0,40400,208216,0,248616
112840200700000,NE 162,RESIDENTIAL,42218,0,42218,221165,0,263383
112840200800000,NE 162,RESIDENTIAL,42218,0,42218,359168,0,401386
112840200900000,NE 162,RESIDENTIAL,42218,0,42218,204609,0,246827
112840201000000,NE 162,RESIDENTIAL,41204,0,41204,209854,0,251058
112840201100000,NE 162,RESIDENTIAL,71000,0,71000,165662,0,236662
112840201200000,NE 162,RESIDENTIAL,40000,0,40000,85959,0,125959
112842600100000,NE 162,RESIDENTIAL,39097,0,39097,220370,0,259467
112842600200000,NE 162,RESIDENTIAL,34884,0,34884,187697,0,222581
112842600300000,NE 162,RESIDENTIAL,34884,0,34884,197220,0,232104
112842600400000,NE 162,RESIDENTIAL,34884,0,34884,245317,0,280201
112842600500000,NE 162,RESIDENTIAL,36720,0,36720,198467,0,235187
112842600600000,NE 162,RESIDENTIAL,36720,0,36720,202749,0,239469
112842600700000,NE 162,RESIDENTIAL,38556,0,38556,205394,0,243950
112842600800000,NE 162,RESIDENTIAL,38556,0,38556,212920,0,251476
112842600900000,NE 162,RESIDENTIAL,42151,0,42151,173191,0,215342
112842700100000,NE 162,RESIDENTIAL,42120,0,42120,210600,0,252720
112842700200000,NE 162,RESIDENTIAL,37440,0,37440,219234,0,256674
112842700300000,NE 162,RESIDENTIAL,37440,0,37440,194861,0,232301
112842700400000,NE 162,RESIDENTIAL,34020,0,34020,198098,0,232118
112842700500000,NE 162,RESIDENTIAL,37800,0,37800,192186,0,229986
112842700600000,NE 162,RESIDENTIAL,43578,0,43578,219862,0,263440
112842700700000,NE 162,RESIDENTIAL,42642,0,42642,213945,0,256587
112842700800000,NE 162,RESIDENTIAL,34884,0,34884,203111,0,237995
112842700900000,NE 162,RESIDENTIAL,36720,0,36720,207902,0,244622
112842701000000,NE 162,RESIDENTIAL,36720,0,36720,271427,0,308147
112842701100000,NE 162,RESIDENTIAL,33048,0,33048,148954,0,182002
112842701200000,NE 162,RESIDENTIAL,36720,0,36720,220246,0,256966
112842701300000,NE 162,RESIDENTIAL,36720,0,36720,227465,0,264185
112842701400000,NE 162,RESIDENTIAL,34884,0,34884,169395,0,204279
112842701500000,NE 162,RESIDENTIAL,36720,0,36720,201763,0,238483
112842701600000,NE 162,RESIDENTIAL,33966,0,33966,177792,0,211758
112842701700000,NE 162,RESIDENTIAL,36720,0,36720,189081,0,225801
112842701800000,NE 162,RESIDENTIAL,37122,0,37122,180283,0,217405
112842701900000,NE 162,RESIDENTIAL,40500,0,40500,226100,0,266600
112842702000000,NE 162,RESIDENTIAL,50398,0,50398,194612,0,245010
112842702100000,NE 162,RESIDENTIAL,42793,0,42793,229156,0,271949
112842702200000,NE 162,RESIDENTIAL,41518,0,41518,214622,0,256140
112842800200000,CENTRALLY ASSESSED,OTHER,0,0,0,0,0,0
112842900100000,NE 162,RESIDENTIAL,41310,0,41310,176187,0,217497
112842900200000,NE 162,RESIDENTIAL,34425,0,34425,190879,0,225304
112842900300000,NE 162,RESIDENTIAL,35802,0,35802,220689,0,256491
112842900400000,NE 162,RESIDENTIAL,34344,0,34344,164463,0,198807
112842900500000,NE 162,RESIDENTIAL,48769,0,48769,172246,0,221015
112842900600000,NE 162,RESIDENTIAL,36252,0,36252,177430,0,213682
112842900700000,NE 162,RESIDENTIAL,36720,0,36720,222453,0,259173
112842900800000,NE 162,RESIDENTIAL,33048,0,33048,176435,0,209483
112842900900000,NE 162,RESIDENTIAL,34884,0,34884,222385,0,257269
112842901000000,NE 162,RESIDENTIAL,36720,0,36720,166487,0,203207
112842901100000,NE 162,RESIDENTIAL,33048,0,33048,159980,0,193028
112842901200000,NE 162,RESIDENTIAL,34884,0,34884,212049,0,246933
112842901300000,NE 162,RESIDENTIAL,33048,0,33048,155125,0,188173
112842901400000,NE 162,RESIDENTIAL,36720,0,36720,209091,0,245811
112842901500000,NE 162,RESIDENTIAL,32576,0,32576,155708,0,188284
112842901600000,NE 162,RESIDENTIAL,44960,0,44960,197905,0,242865
112842901700000,NE 162,RESIDENTIAL,41616,0,41616,168978,0,210594
112842901800000,NE 162,RESIDENTIAL,43012,0,43012,195988,0,239000
112842901900000,NE 162,RESIDENTIAL,35256,0,35256,166668,0,201924
112842902000000,NE 162,RESIDENTIAL,38473,0,38473,183122,0,221595
112842902100000,NE 162,RESIDENTIAL,33507,0,33507,194026,0,227533
112842902200000,NE 162,RESIDENTIAL,36720,0,36720,216696,0,253416
112842902300000,NE 162,RESIDENTIAL,33048,0,33048,191937,0,224985
112842902400000,NE 162,RESIDENTIAL,38556,0,38556,221681,0,260237
112842902500000,NE 162,RESIDENTIAL,35263,0,35263,197434,0,232697
112842902600000,NE 162,RESIDENTIAL,41004,0,41004,235743,0,276747
112842902700000,NE 162,RESIDENTIAL,38604,0,38604,197680,0,236284
112842902800000,NE 162,RESIDENTIAL,34425,0,34425,170821,0,205246
112842902900000,NE 162,RESIDENTIAL,41310,0,41310,217071,0,258381
112843000100000,NE 162,RESIDENTIAL,43650,0,43650,260754,0,304404
112843000200000,NE 162,RESIDENTIAL,48323,0,48323,215732,0,264055
112843000300000,NE 162,RESIDENTIAL,32400,0,32400,164294,0,196694
112843000400000,NE 162,RESIDENTIAL,37179,0,37179,192297,0,229476
112843000500000,NE 162,RESIDENTIAL,31212,0,31212,178476,0,209688
112843000600000,NE 162,RESIDENTIAL,33048,0,33048,189428,0,222476
112843000700000,NE 162,RESIDENTIAL,33201,0,33201,212858,0,246059
112843000800000,NE 162,RESIDENTIAL,33222,0,33222,165660,0,198882
112843000900000,NE 162,RESIDENTIAL,41623,0,41623,177638,0,219261
112843001000000,NE 162,RESIDENTIAL,32521,0,32521,222942,0,255463
112843001100000,NE 162,RESIDENTIAL,42900,0,42900,196743,0,239643
112843001200000,NE 162,RESIDENTIAL,33824,0,33824,195891,0,229715
112843001300000,NE 162,RESIDENTIAL,33118,0,33118,176091,0,209209
112843001400000,NE 162,RESIDENTIAL,35880,0,35880,179206,0,215086
112843001500000,NE 162,RESIDENTIAL,34845,0,34845,170919,0,205764
112843001600000,NE 162,RESIDENTIAL,34050,0,34050,180020,0,214070
112843100100000,NE 162,RESIDENTIAL,43886,0,43886,218324,0,262210
112843100200000,NE 162,RESIDENTIAL,36259,0,36259,241060,0,277319
112843100300000,NE 162,RESIDENTIAL,41769,0,41769,224781,0,266550
112843100400000,NE 162,RESIDENTIAL,40117,0,40117,224975,0,265092
112843100500000,NE 162,RESIDENTIAL,35166,0,35166,199994,0,235160
112843100600000,NE 162,RESIDENTIAL,44860,0,44860,216062,0,260922
112845100100000,NE 162,RESIDENTIAL,49459,0,49459,237578,0,287037
112845100200000,NE 162,RESIDENTIAL,35802,0,35802,231481,0,267283
112845100300000,NE 162,RESIDENTIAL,39750,0,39750,185228,0,224978
112845100400000,NE 162,RESIDENTIAL,41148,0,41148,174647,0,215795
112845100500000,NE 162,RESIDENTIAL,37620,0,37620,212924,0,250544
112845100600000,NE 162,RESIDENTIAL,37796,0,37796,192646,0,230442
112845100700000,NE 162,RESIDENTIAL,38260,0,38260,211202,0,249462
112845100800000,NE 162,RESIDENTIAL,41835,0,41835,264764,0,306599
112845100900000,NE 162,RESIDENTIAL,40682,0,40682,204899,0,245581
112845101000000,NE 162,RESIDENTIAL,43734,0,43734,219870,0,263604
112845101100000,NE 162,RESIDENTIAL,43000,0,43000,240757,0,283757
112845101200000,CITY PROPERTY,EXEMPT,0,0,0,0,0,0
112845101400000,CITY PROPERTY,EXEMPT,0,0,0,0,0,0
112845101500000,CITY PROPERTY,EXEMPT,0,0,0,0,0,0
112847600100000,NE 162,RESIDENTIAL,38681,0,38681,152371,0,191052
112847600200000,NE 162,RESIDENTIAL,28373,0,28373,142338,0,170711
112847600300000,NE 162,RESIDENTIAL,30555,0,30555,168540,0,199095
112847600400000,NE 162,RESIDENTIAL,28373,0,28373,145563,0,173936
112847600500000,NE 162,RESIDENTIAL,30555,0,30555,169961,0,200516
112847600600000,NE 162,RESIDENTIAL,28373,0,28373,165253,0,193626
112847600700000,NE 162,RESIDENTIAL,30555,0,30555,182564,0,213119
112847600800000,NE 162,RESIDENTIAL,28373,0,28373,162671,0,191044
112847600900000,NE 162,RESIDENTIAL,32738,0,32738,183401,0,216139
112847601000000,NE 162,RESIDENTIAL,28373,0,28373,154991,0,183364
112847601100000,NE 162,RESIDENTIAL,32738,0,32738,171905,0,204643
112847601200000,NE 162,RESIDENTIAL,32738,0,32738,176675,0,209413
112847601300000,NE 162,RESIDENTIAL,34920,0,34920,172060,0,206980
112847601400000,NE 162,RESIDENTIAL,40592,0,40592,268746,0,309338
112847601500000,CITY PROPERTY,EXEMPT,0,0,0,0,0,0
112847700100000,NE 162,RESIDENTIAL,39079,0,39079,201816,0,240895
112847700200000,NE 162,RESIDENTIAL,28512,0,28512,164602,0,193114
112847700300000,NE 162,RESIDENTIAL,32400,0,32400,174079,0,206479
112847700400000,NE 162,RESIDENTIAL,28512,0,28512,159350,0,187862
112847700500000,NE 162,RESIDENTIAL,32400,0,32400,144684,0,177084
112847700600000,NE 162,RESIDENTIAL,28512,0,28512,186738,0,215250
112847700700000,NE 162,RESIDENTIAL,32400,0,32400,177926,0,210326
112847700800000,NE 162,RESIDENTIAL,28512,0,28512,155595,0,184107
112847700900000,NE 162,RESIDENTIAL,32400,0,32400,171513,0,203913
112847701000000,NE 162,RESIDENTIAL,28512,0,28512,175907,0,204419
112847701100000,NE 162,RESIDENTIAL,32400,0,32400,151798,0,184198
112847701200000,NE 162,RESIDENTIAL,34560,0,34560,180053,0,214613
112847701300000,NE 162,RESIDENTIAL,34560,0,34560,183300,0,217860
112847701400000,NE 162,RESIDENTIAL,42052,0,42052,168975,0,211027
112847701500000,CITY PROPERTY,EXEMPT,0,0,0,0,0,0
112847701600000,WAREHOUSE;MINI STORG,COMMERCIAL,0,138260,138260,0,143509,281769
112847701700000,NE 162,RESIDENTIAL,7400,0,7400,0,0,7400
112847701800000,NE 103,RESIDENTIAL,17120,0,17120,130546,0,147666
112847701900000,NE 103,RESIDENTIAL,20330,0,20330,121397,0,141727
112847702000000,NE 103,RESIDENTIAL,20330,0,20330,154501,0,174831
112847702100000,NE 103,RESIDENTIAL,20351,0,20351,136298,0,156649
112847702200000,NE 103,RESIDENTIAL,22967,0,22967,127417,0,150384
112847702300000,NE 103,RESIDENTIAL,24120,0,24120,140020,0,164140
112847702400000,NE 102,RESIDENTIAL,20738,0,20738,196155,0,216893
112847702500000,NE 102,RESIDENTIAL,20738,0,20738,139620,0,160358
112847702600000,NE 102,RESIDENTIAL,28980,0,28980,140015,0,168995
112847702700000,NE 102,RESIDENTIAL,31273,0,31273,183822,0,215095
112847702800000,NE 102,RESIDENTIAL,31363,0,31363,205306,0,236669
112847702900000,NE 102,RESIDENTIAL,32151,0,32151,170758,0,202909
112847703000000,NE 102,RESIDENTIAL,27720,0,27720,179813,0,207533
112847703100000,NE 102,RESIDENTIAL,30096,0,30096,179074,0,209170
112847703200000,NE 102,RESIDENTIAL,26928,0,26928,154854,0,181782
112847703300000,NE 102,RESIDENTIAL,30888,0,30888,167306,0,198194
112847703400000,NE 102,RESIDENTIAL,27720,0,27720,160984,0,188704
112847703500000,NE 102,RESIDENTIAL,34984,0,34984,136054,0,171038
112847800100000,NE 102,RESIDENTIAL,31301,0,31301,130357,0,161658
112847800200000,NE 102,RESIDENTIAL,30096,0,30096,144293,0,174389
112847800300000,NE 102,RESIDENTIAL,26136,0,26136,174201,0,200337
112847800400000,NE 102,RESIDENTIAL,30096,0,30096,165357,0,195453
112847800500000,NE 102,RESIDENTIAL,25872,0,25872,156041,0,181913
112847800600000,NE 102,RESIDENTIAL,25344,0,25344,176529,0,201873
112847800700000,NE 102,RESIDENTIAL,31775,0,31775,150846,0,182621
112847800800000,NE 102,RESIDENTIAL,24938,0,24938,176592,0,201530
112847800900000,NE 102,RESIDENTIAL,16560,0,16560,124818,0,141378
112847801000000,NE 102,RESIDENTIAL,19319,0,19319,178030,0,197349
112847801100000,NE 102,RESIDENTIAL,16987,0,16987,147112,0,164099
112847801200000,NE 102,RESIDENTIAL,20553,0,20553,144227,0,164780
112847801300000,NE 102,RESIDENTIAL,21500,0,21500,150186,0,171686
112847801400000,NE 102,RESIDENTIAL,20037,0,20037,130618,0,150655
112847801500000,NE 102,RESIDENTIAL,19380,0,19380,148484,0,167864
112847801600000,NE 103,RESIDENTIAL,19380,0,19380,178130,0,197510
112847900100000,NE 102,RESIDENTIAL,20849,0,20849,144479,0,165328
112847900200000,NE 102,RESIDENTIAL,16995,0,16995,142972,0,159967
112847900300000,NE 102,RESIDENTIAL,18865,0,18865,162076,0,180941
112847900400000,NE 102,RESIDENTIAL,18208,0,18208,144458,0,162666
112847900500000,NE 102,RESIDENTIAL,20449,0,20449,134003,0,154452
112847900600000,NE 103,RESIDENTIAL,20672,0,20672,148219,0,168891
112847900700000,NE 103,RESIDENTIAL,19250,0,19250,161424,0,180674
112847900800000,NE 103,RESIDENTIAL,20325,0,20325,146642,0,166967
112847900900000,NE 103,RESIDENTIAL,16665,0,16665,128995,0,145660
112847901000000,NE 103,RESIDENTIAL,18724,0,18724,139460,0,158184
112847901100000,NE 103,RESIDENTIAL,20825,0,20825,146624,0,167449
112848000100000,NE 103,RESIDENTIAL,20766,0,20766,147971,0,168737
113015100100000,NE 168,AG LAND,51394,0,51394,0,1358,52752
113017600100000,NE 168,AG LAND,43713,0,43713,0,0,43713
113025200100000,NE 168,AG LAND,1105,0,1105,0,0,1105
113025200700000,NE 168,AG LAND,16358,0,16358,0,0,16358
113027700100000,NE 168,AG LAND,12913,0,12913,0,0,12913
113030100100000,NE 168,AG LAND,78239,0,78239,0,0,78239
113030100200000,NE 168,RESIDENTIAL,36600,0,36600,0,0,36600
113032600100000,NE 168,AG LAND,74349,0,74349,0,0,74349
113035100100000,NE 169,RESIDENTIAL,75750,0,75750,228101,0,303851
113035100200000,NE 169,RESIDENTIAL,75600,0,75600,258564,0,334164
113035100300000,NE 168,RESIDENTIAL,440,0,440,0,0,440
113035100400000,NE 169,RESIDENTIAL,76000,0,76000,265532,0,341532
113035100500000,NE 169,RESIDENTIAL,76000,0,76000,249692,0,325692
113035100600000,NE 169,RESIDENTIAL,76000,0,76000,224425,0,300425
113035100700000,NE 169,RESIDENTIAL,75550,0,75550,239668,0,315218
113035100800000,NE 169,RESIDENTIAL,75550,0,75550,230737,0,306287
113035100900000,NE 168,RESIDENTIAL,900,0,900,0,0,900
113035200100000,NE 169,RESIDENTIAL,75000,0,75000,276800,0,351800
113035200200000,NE 169,RESIDENTIAL,75800,0,75800,294024,0,369824
113035200300000,NE 168,AG LAND,32674,0,32674,0,0,32674
113035300100000,NE 169,RESIDENTIAL,77050,0,77050,263994,0,341044
113035300200000,NE 169,RESIDENTIAL,77050,0,77050,219726,0,296776
113035300300000,NE 169,RESIDENTIAL,75000,0,75000,243350,0,318350
113035300400000,NE 169,RESIDENTIAL,75000,0,75000,249870,0,324870
113037600100000,NE 168,AG LAND,90049,0,90049,0,0,90049
113042600100000,NE 168,RESIDENTIAL,106600,0,106600,115412,0,222012
113042600200000,CHURCH,EXEMPT,0,10175,10175,0,0,10175
113042600300000,CHURCH,EXEMPT,0,13740,13740,0,5527,19267
113042600400000,NE 168,RESIDENTIAL,100450,0,100450,140582,0,241032
113045100200000,NE 168,RESIDENTIAL,5057,0,5057,0,0,5057
113045100300000,NE 168,RESIDENTIAL,58600,0,58600,73062,0,131662
113045100400000,NE 168,AG LAND,68522,0,68522,0,0,68522
113112600100000,NE 168,AG LAND,11975,0,11975,0,0,11975
113112600200000,NE 168,AG LAND,67847,0,67847,0,0,67847
113120100100000,NE 168,AG LAND,79159,0,79159,0,33711,112870
113122600100000,NE 168,RESIDENTIAL,12200,0,12200,0,0,12200
113122600200000,NE 168,AG LAND,53917,0,53917,0,0,53917
113125100100000,NE 168,RESIDENTIAL,50150,0,50150,145034,0,195184
113125100200000,NE 168,RESIDENTIAL,50200,0,50200,158482,0,208682
113125100300000,NE 168,RESIDENTIAL,50200,0,50200,185680,0,235880
113125100400000,NE 168,RESIDENTIAL,50250,0,50250,203441,0,253691
113125200100000,NE 168,RESIDENTIAL,50300,0,50300,0,0,50300
113125200200000,NE 168,RESIDENTIAL,50350,0,50350,0,0,50350
113125300100000,NE 168,RESIDENTIAL,50100,0,50100,159593,0,209693
113125300200000,NE 168,RESIDENTIAL,50100,0,50100,250958,0,301058
113125300300000,NE 168,RESIDENTIAL,40040,0,40040,358183,0,398223
113125300400000,NE 168,RESIDENTIAL,50050,0,50050,0,0,50050
113125300600000,NE 168,AG LAND,34557,0,34557,0,0,34557
113125300700000,NE 168,AG LAND,4968,0,4968,0,0,4968
113125400100000,NE 168,RESIDENTIAL,50300,0,50300,187608,0,237908
113125400200000,NE 168,RESIDENTIAL,50500,0,50500,156431,0,206931
113130100100000,NE 168,RESIDENTIAL,50000,0,50000,184412,0,234412
113130100200000,NE 168,RESIDENTIAL,50250,0,50250,265223,0,315473
113130100300000,NE 168,RESIDENTIAL,50250,0,50250,206885,0,257135
113130100400000,NE 168,RESIDENTIAL,50250,0,50250,254794,0,305044
113130100500000,NE 172,RESIDENTIAL,59500,0,59500,177233,0,236733
113130100600000,NE 172,RESIDENTIAL,62448,0,62448,179871,0,242319
113130100700000,NE 172,RESIDENTIAL,64410,0,64410,182776,0,247186
113130100800000,NE 172,RESIDENTIAL,62500,0,62500,201676,0,264176
113130200100000,NE 172,RESIDENTIAL,60597,0,60597,211702,0,272299
113130200200000,NE 172,RESIDENTIAL,63281,0,63281,223116,0,286397
113130200300000,NE 172,RESIDENTIAL,54272,0,54272,288850,0,343122
113130300100000,NE 168,RESIDENTIAL,50150,0,50150,132450,0,182600
113130300200000,NE 168,RESIDENTIAL,50150,0,50150,180424,0,230574
113130300300000,NE 168,RESIDENTIAL,50150,0,50150,295382,0,345532
113130300400000,NE 168,RESIDENTIAL,50150,0,50150,272994,0,323144
113130300500000,NE 168,RESIDENTIAL,50150,0,50150,215033,0,265183
113130300600000,NE 172,RESIDENTIAL,59500,0,59500,165674,0,225174
113130300700000,NE 172,RESIDENTIAL,61762,0,61762,212650,0,274412
113130300800000,NE 172,RESIDENTIAL,63270,0,63270,252498,0,315768
113130300900000,NE 172,RESIDENTIAL,62700,0,62700,178213,0,240913
113130301300000,NE 168,RESIDENTIAL,50100,0,50100,135282,0,185382
113130301400000,NE 168,RESIDENTIAL,50100,0,50100,163666,0,213766
113130301500000,NE 168,RESIDENTIAL,50100,0,50100,178532,0,228632
113130301600000,NE 168,RESIDENTIAL,50100,0,50100,214824,0,264924
113130301700000,NE 168,RESIDENTIAL,50100,0,50100,206540,0,256640
113130400100000,NE 168,RESIDENTIAL,50150,0,50150,158060,0,208210
113130400200000,NE 168,RESIDENTIAL,50150,0,50150,266645,0,316795
113130400300000,NE 168,RESIDENTIAL,50150,0,50150,276387,0,326537
113130400400000,NE 168,RESIDENTIAL,50200,0,50200,145627,0,195827
113130401200000,NE 172,RESIDENTIAL,60491,0,60491,174212,0,234703
113130401300000,NE 172,RESIDENTIAL,60491,0,60491,171966,0,232457
113130401400000,NE 172,RESIDENTIAL,60275,0,60275,255570,0,315845
113132600200000,NE 168,RESIDENTIAL,5250,0,5250,0,0,5250
113132600300000,NE 168,RESIDENTIAL,32625,0,32625,0,0,32625
113132600400000,NE 168,RESIDENTIAL,100,0,100,0,0,100
113132700100000,CITY PROPERTY,EXEMPT,0,0,0,0,0,0
113132700200000,NE 172,RESIDENTIAL,46200,0,46200,214913,0,261113
113132700300000,NE 172,RESIDENTIAL,44400,0,44400,210365,0,254765
113132700400000,NE 172,RESIDENTIAL,44400,0,44400,222713,0,267113
113132700500000,NE 172,RESIDENTIAL,44400,0,44400,268871,0,313271
113132700600000,NE 172,RESIDENTIAL,45600,0,45600,248357,0,293957
113132700700000,NE 172,RESIDENTIAL,43962,0,43962,259038,0,303000
113132700800000,NE 172,RESIDENTIAL,46035,0,46035,299305,0,345340
113132700900000,NE 172,RESIDENTIAL,50437,0,50437,187770,0,238207
113132701000000,CITY PROPERTY,EXEMPT,0,0,0,0,0,0
113132800100000,NE 172,RESIDENTIAL,48844,0,48844,238710,0,287554
113132800200000,NE 172,RESIDENTIAL,48480,0,48480,227759,0,276239
113132800300000,NE 172,RESIDENTIAL,48480,0,48480,243826,0,292306
113132800400000,NE 172,RESIDENTIAL,48480,0,48480,232302,0,280782
113132800500000,NE 172,RESIDENTIAL,48480,0,48480,216855,0,265335
113132800600000,NE 172,RESIDENTIAL,48480,0,48480,183871,0,232351
113132800700000,NE 172,RESIDENTIAL,46317,0,46317,244893,0,291210
113132800800000,NE 172,RESIDENTIAL,46627,0,46627,223256,0,269883
113132800900000,NE 172,RESIDENTIAL,48680,0,48680,228748,0,277428
113132801000000,NE 172,RESIDENTIAL,48156,0,48156,266303,0,314459
113132801100000,NE 172,RESIDENTIAL,47271,0,47271,237400,0,284671
113132801200000,NE 172,RESIDENTIAL,48960,0,48960,214940,0,263900
113132801300000,NE 172,RESIDENTIAL,48960,0,48960,237185,0,286145
113132801400000,NE 172,RESIDENTIAL,48642,0,48642,220415,0,269057
113132801500000,NE 172,RESIDENTIAL,214,0,214,0,0,214
113132801600000,NE 172,RESIDENTIAL,183,0,183,0,0,183
113132801700000,NE 172,RESIDENTIAL,177,0,177,0,0,177
113132801800000,NE 172,RESIDENTIAL,61554,0,61554,202909,0,264463
113132801900000,NE 172,RESIDENTIAL,60449,0,60449,184738,0,245187
113132802000000,NE 172,RESIDENTIAL,50490,0,50490,234648,0,285138
113132802100000,NE 172,RESIDENTIAL,64796,0,64796,225567,0,290363
113132802200000,NE 172,RESIDENTIAL,64480,0,64480,286239,0,350719
113132802300000,NE 172,RESIDENTIAL,50708,0,50708,268663,0,319371
113132802400000,NE 172,RESIDENTIAL,50634,0,50634,192873,0,243507
113132802500000,NE 172,RESIDENTIAL,51430,0,51430,204264,0,255694
113132802600000,NE 172,RESIDENTIAL,299,0,299,0,0,299
113132802700000,NE 172,RESIDENTIAL,329,0,329,0,0,329
113132802800000,NE 172,RESIDENTIAL,58092,0,58092,269340,0,327432
113132802900000,NE 172,RESIDENTIAL,58032,0,58032,333346,0,391378
113132803000000,NE 172,RESIDENTIAL,71136,0,71136,277440,0,348576
113132803100000,NE 172,RESIDENTIAL,75159,0,75159,267890,0,343049
113132803200000,NE 172,RESIDENTIAL,214,0,214,0,0,214
113132900100000,NE 172,RESIDENTIAL,49432,0,49432,205013,0,254445
113132900200000,NE 172,RESIDENTIAL,48480,0,48480,202829,0,251309
113132900300000,NE 172,RESIDENTIAL,48480,0,48480,201467,0,249947
113132900400000,NE 172,RESIDENTIAL,48480,0,48480,255515,0,303995
113132900500000,NE 172,RESIDENTIAL,48480,0,48480,175844,0,224324
113132900600000,NE 172,RESIDENTIAL,48480,0,48480,182959,0,231439
113132900700000,NE 172,RESIDENTIAL,56679,0,56679,364325,0,421004
113132900800000,NE 172,RESIDENTIAL,49909,0,49909,233505,0,283414
113132900900000,NE 172,RESIDENTIAL,48480,0,48480,206714,0,255194
113132901000000,NE 172,RESIDENTIAL,48480,0,48480,238043,0,286523
113132901100000,NE 172,RESIDENTIAL,48480,0,48480,211444,0,259924
113132901200000,NE 172,RESIDENTIAL,48480,0,48480,188926,0,237406
113132901300000,NE 172,RESIDENTIAL,48480,0,48480,186291,0,234771
113132901400000,NE 172,RESIDENTIAL,48424,0,48424,176545,0,224969
113133000100000,NE 172,RESIDENTIAL,62868,0,62868,286959,0,349827
113133000200000,NE 172,RESIDENTIAL,293,0,293,0,0,293
113133000300000,NE 172,RESIDENTIAL,48558,0,48558,185794,0,234352
113133000400000,NE 172,RESIDENTIAL,159,0,159,0,0,159
113133000500000,NE 172,RESIDENTIAL,152,0,152,0,0,152
113133100100000,NE 172,RESIDENTIAL,165,0,165,0,0,165
113133100200000,NE 172,RESIDENTIAL,50490,0,50490,215511,0,266001
113133100300000,NE 172,RESIDENTIAL,50490,0,50490,199373,0,249863
113133100400000,NE 172,RESIDENTIAL,63247,0,63247,227128,0,290375
113133100500000,NE 172,RESIDENTIAL,58828,0,58828,219022,0,277850
113133100600000,NE 172,RESIDENTIAL,50490,0,50490,291406,0,341896
113133200100000,NE 172,RESIDENTIAL,159,0,159,0,0,159
113133200200000,NE 172,RESIDENTIAL,51000,0,51000,294736,0,345736
113133200300000,NE 172,RESIDENTIAL,48000,0,48000,188686,0,236686
113133200400000,NE 172,RESIDENTIAL,48000,0,48000,205517,0,253517
113133200500000,NE 172,RESIDENTIAL,48000,0,48000,264145,0,312145
113133200600000,NE 172,RESIDENTIAL,48000,0,48000,204859,0,252859
113133200700000,NE 172,RESIDENTIAL,159,0,159,0,0,159
113133200800000,NE 172,RESIDENTIAL,214,0,214,0,0,214
113133200900000,NE 172,RESIDENTIAL,51000,0,51000,225097,0,276097
113133201000000,NE 172,RESIDENTIAL,51000,0,51000,230340,0,281340
113133201100000,NE 172,RESIDENTIAL,159,0,159,0,0,159
113133201200000,NE 172,RESIDENTIAL,48000,0,48000,219176,0,267176
113135100300000,SCHOOL,EXEMPT,0,0,0,0,0,0
113135100500000,NE 172,RESIDENTIAL,42271,0,42271,156672,0,198943
113135100600000,NE 172,RESIDENTIAL,41630,0,41630,157744,0,199374
113135100700000,NE 172,RESIDENTIAL,39780,0,39780,154897,0,194677
113135100800000,NE 172,RESIDENTIAL,38355,0,38355,153620,0,191975
113135100900000,NE 172,RESIDENTIAL,46703,0,46703,143590,0,190293
113135101000000,NE 172,RESIDENTIAL,44496,0,44496,148053,0,192549
113135101100000,NE 172,RESIDENTIAL,43543,0,43543,174334,0,217877
113135101200000,NE 172,RESIDENTIAL,45410,0,45410,180276,0,225686
113135101300000,NE 172,RESIDENTIAL,43956,0,43956,167015,0,210971
113135101400000,NE 172,RESIDENTIAL,45931,0,45931,180066,0,225997
113135101500000,NE 172,RESIDENTIAL,43507,0,43507,137626,0,181133
113135101600000,NE 172,RESIDENTIAL,36660,0,36660,150233,0,186893
113135101700000,NE 172,RESIDENTIAL,39900,0,39900,172842,0,212742
113135101800000,NE 172,RESIDENTIAL,38610,0,38610,146785,0,185395
113135101900000,NE 172,RESIDENTIAL,38760,0,38760,153578,0,192338
113135102000000,NE 172,RESIDENTIAL,43940,0,43940,147216,0,191156
113135102100000,NE 172,RESIDENTIAL,46620,0,46620,173121,0,219741
113135102200000,NE 172,RESIDENTIAL,47177,0,47177,143187,0,190364
113135102300000,NE 172,RESIDENTIAL,41627,0,41627,183060,0,224687
113135102400000,NE 172,RESIDENTIAL,44015,0,44015,166180,0,210195
113135102500000,NE 172,RESIDENTIAL,43330,0,43330,194231,0,237561
113135102600000,NE 172,RESIDENTIAL,39984,0,39984,158421,0,198405
113135102700000,NE 172,RESIDENTIAL,44036,0,44036,168476,0,212512
113135102800000,NE 172,RESIDENTIAL,38986,0,38986,155203,0,194189
113135102900000,NE 172,RESIDENTIAL,38110,0,38110,156665,0,194775
113135103000000,NE 172,RESIDENTIAL,42840,0,42840,160056,0,202896
113135103100000,NE 172,RESIDENTIAL,38755,0,38755,150682,0,189437
113135103200000,NE 172,RESIDENTIAL,46810,0,46810,217087,0,263897
113135103300000,NE 172,RESIDENTIAL,48000,0,48000,203424,0,251424
113135103400000,NE 172,RESIDENTIAL,48000,0,48000,219202,0,267202
113135103500000,NE 172,RESIDENTIAL,48000,0,48000,217617,0,265617
113135103600000,NE 172,RESIDENTIAL,48000,0,48000,255999,0,303999
113135103700000,NE 172,RESIDENTIAL,48000,0,48000,206242,0,254242
113135103800000,NE 172,RESIDENTIAL,47221,0,47221,206750,0,253971
113135200100000,NE 172,RESIDENTIAL,48000,0,48000,347750,0,395750
113135200200000,NE 172,RESIDENTIAL,48000,0,48000,178471,0,226471
113135200300000,NE 172,RESIDENTIAL,48000,0,48000,273039,0,321039
113135200400000,NE 172,RESIDENTIAL,48000,0,48000,267579,0,315579
113135200500000,NE 172,RESIDENTIAL,48000,0,48000,282577,0,330577
113135200600000,NE 172,RESIDENTIAL,48000,0,48000,272703,0,320703
113135200700000,NE 172,RESIDENTIAL,48000,0,48000,279312,0,327312
113135200800000,NE 172,RESIDENTIAL,48000,0,48000,242189,0,290189
113135200900000,NE 172,RESIDENTIAL,48000,0,48000,180791,0,228791
113135201000000,NE 172,RESIDENTIAL,48000,0,48000,213496,0,261496
113135201100000,NE 172,RESIDENTIAL,42000,0,42000,160238,0,202238
113135201200000,NE 172,RESIDENTIAL,20,0,20,0,0,20
113135201300000,NE 172,RESIDENTIAL,48000,0,48000,254969,0,302969
113135201400000,NE 172,RESIDENTIAL,40720,0,40720,0,0,40720
113135201500000,NE 172,RESIDENTIAL,520,0,520,0,0,520
113135201600000,NE 172,RESIDENTIAL,580,0,580,0,0,580
113135201700000,NE 172,RESIDENTIAL,48000,0,48000,216880,0,264880
113135300100000,NE 172,RESIDENTIAL,44694,0,44694,195050,0,239744
113135300200000,NE 172,RESIDENTIAL,42522,0,42522,121423,0,163945
113142600100000,NE 168,RESIDENTIAL,50750,0,50750,181574,0,232324
113142600200000,NE 168,RESIDENTIAL,50000,0,50000,135068,0,185068
113142600300000,NE 168,RESIDENTIAL,50050,0,50050,155103,0,205153
113142600400000,NE 168,RESIDENTIAL,50050,0,50050,137511,0,187561
113142600500000,NE 168,RESIDENTIAL,50000,0,50000,149781,0,199781
113142700100000,NE 168,RESIDENTIAL,50450,0,50450,159186,0,209636
113142700200000,NE 168,RESIDENTIAL,50350,0,50350,204156,0,254506
113142700300000,NE 168,RESIDENTIAL,50550,0,50550,194184,0,244734
113142700400000,NE 168,RESIDENTIAL,51100,0,51100,178667,0,229767
113142700500000,NE 168,RESIDENTIAL,50000,0,50000,181536,0,231536
113142700600000,NE 168,RESIDENTIAL,50000,0,50000,155184,0,205184
113142700700000,NE 168,RESIDENTIAL,50000,0,50000,202626,0,252626
113142700800000,NE 168,RESIDENTIAL,77850,0,77850,269574,0,347424
113142700900000,NE 168,RESIDENTIAL,58600,0,58600,245511,0,304111
113142800100000,NE 168,RESIDENTIAL,50250,0,50250,151698,0,201948
113142800200000,NE 168,RESIDENTIAL,50150,0,50150,198336,0,248486
113142800300000,NE 168,RESIDENTIAL,50150,0,50150,162629,0,212779
113142800400000,NE 168,RESIDENTIAL,50300,0,50300,165948,0,216248
113143000100000,NE 168,RESIDENTIAL,50250,0,50250,181015,0,231265
113143000200000,NE 168,RESIDENTIAL,50200,0,50200,225762,0,275962
113143000300000,NE 168,RESIDENTIAL,50150,0,50150,225864,0,276014
113143000400000,NE 168,RESIDENTIAL,50150,0,50150,224138,0,274288
113143000500000,NE 168,RESIDENTIAL,50150,0,50150,143279,0,193429
113310100100000,NE 103,RESIDENTIAL,19703,0,19703,146845,0,166548
113310100200000,NE 103,RESIDENTIAL,21510,0,21510,173213,0,194723
113310100300000,NE 103,RESIDENTIAL,16914,0,16914,149745,0,166659
113310100400000,NE 103,RESIDENTIAL,18810,0,18810,137229,0,156039
113310100500000,NE 103,RESIDENTIAL,16284,0,16284,127152,0,143436
113310100600000,NE 103,RESIDENTIAL,19863,0,19863,132872,0,152735
113310100700000,NE 103,RESIDENTIAL,16830,0,16830,139775,0,156605
113310100800000,NE 103,RESIDENTIAL,19192,0,19192,139301,0,158493
113310100900000,NE 103,RESIDENTIAL,18394,0,18394,116058,0,134452
113310101000000,NE 103,RESIDENTIAL,21375,0,21375,147430,0,168805
113310101100000,NE 103,RESIDENTIAL,16497,0,16497,106857,0,123354
113310101200000,NE 103,RESIDENTIAL,15641,0,15641,148994,0,164635
113310101300000,NE 103,RESIDENTIAL,15641,0,15641,141142,0,156783
113310101400000,NE 103,RESIDENTIAL,18845,0,18845,137149,0,155994
113310101500000,NE 103,RESIDENTIAL,19680,0,19680,123606,0,143286
113310101600000,NE 103,RESIDENTIAL,19338,0,19338,127145,0,146483
113310101700000,NE 103,RESIDENTIAL,18810,0,18810,138388,0,157198
113310101800000,NE 103,RESIDENTIAL,18790,0,18790,138294,0,157084
113310101900000,NE 103,RESIDENTIAL,20808,0,20808,125384,0,146192
113310102000000,NE 103,RESIDENTIAL,20460,0,20460,152299,0,172759
113310102100000,NE 103,RESIDENTIAL,20218,0,20218,121325,0,141543
113310102200000,NE 103,RESIDENTIAL,16369,0,16369,151039,0,167408
113310102300000,NE 103,RESIDENTIAL,20479,0,20479,131378,0,151857
113310102400000,NE 103,RESIDENTIAL,19541,0,19541,135882,0,155423
113310102500000,NE 103,RESIDENTIAL,20924,0,20924,131492,0,152416
113310102600000,NE 103,RESIDENTIAL,18473,0,18473,123006,0,141479
113310102700000,NE 103,RESIDENTIAL,17820,0,17820,118571,0,136391
113310102800000,NE 103,RESIDENTIAL,19868,0,19868,134149,0,154017
113310102900000,NE 103,RESIDENTIAL,20971,0,20971,145064,0,166035
113310103000000,NE 103,RESIDENTIAL,18563,0,18563,148332,0,166895
113310103100000,NE 103,RESIDENTIAL,18563,0,18563,133338,0,151901
113310103200000,NE 103,RESIDENTIAL,19800,0,19800,129556,0,149356
113310103300000,NE 103,RESIDENTIAL,19513,0,19513,148669,0,168182
113310200100000,NE 103,RESIDENTIAL,20861,0,20861,144353,0,165214
113310200200000,NE 103,RESIDENTIAL,18810,0,18810,124341,0,143151
113310200300000,NE 103,RESIDENTIAL,18810,0,18810,130656,0,149466
113310200400000,NE 103,RESIDENTIAL,17417,0,17417,139809,0,157226
113310200500000,NE 103,RESIDENTIAL,20116,0,20116,144203,0,164319
113310200600000,NE 103,RESIDENTIAL,19192,0,19192,146493,0,165685
113310200700000,NE 103,RESIDENTIAL,19885,0,19885,138536,0,158421
113310200800000,NE 103,RESIDENTIAL,14550,0,14550,106650,0,121200
113310200900000,NE 103,RESIDENTIAL,18915,0,18915,126641,0,145556
113310201000000,NE 103,RESIDENTIAL,18430,0,18430,150230,0,168660
113310201100000,NE 103,RESIDENTIAL,17770,0,17770,147340,0,165110
113310201200000,NE 103,RESIDENTIAL,14308,0,14308,106455,0,120763
113310201300000,NE 103,RESIDENTIAL,14773,0,14773,113751,0,128524
113310201400000,NE 103,RESIDENTIAL,14850,0,14850,134939,0,149789
113310201500000,NE 103,RESIDENTIAL,18810,0,18810,137600,0,156410
113310201600000,NE 103,RESIDENTIAL,17325,0,17325,133533,0,150858
113310201700000,NE 103,RESIDENTIAL,19757,0,19757,123906,0,143663
113310300100000,NE 103,RESIDENTIAL,20206,0,20206,142304,0,162510
113310300200000,NE 103,RESIDENTIAL,17500,0,17500,123799,0,141299
113310300300000,NE 103,RESIDENTIAL,16250,0,16250,146435,0,162685
113310300400000,NE 103,RESIDENTIAL,17636,0,17636,131285,0,148921
113310300500000,NE 103,RESIDENTIAL,14850,0,14850,138679,0,153529
113310300600000,NE 103,RESIDENTIAL,18315,0,18315,125898,0,144213
113310300700000,NE 103,RESIDENTIAL,17737,0,17737,135577,0,153314
113310300800000,NE 103,RESIDENTIAL,20327,0,20327,139281,0,159608
113310300900000,NE 103,RESIDENTIAL,18902,0,18902,147847,0,166749
113310301000000,NE 103,RESIDENTIAL,16125,0,16125,132761,0,148886
113310301100000,NE 103,RESIDENTIAL,20715,0,20715,155134,0,175849
113310301200000,NE 103,RESIDENTIAL,21064,0,21064,133553,0,154617
113310301300000,NE 103,RESIDENTIAL,20149,0,20149,134919,0,155068
113310301400000,NE 103,RESIDENTIAL,20026,0,20026,133523,0,153549
113310301500000,NE 103,RESIDENTIAL,20167,0,20167,129578,0,149745
113310301600000,NE 103,RESIDENTIAL,20071,0,20071,141426,0,161497
113310301700000,NE 103,RESIDENTIAL,20100,0,20100,123712,0,143812
113310301800000,NE 103,RESIDENTIAL,20667,0,20667,125078,0,145745
113310301900000,NE 103,RESIDENTIAL,18150,0,18150,113488,0,131638
113310302000000,NE 103,RESIDENTIAL,16830,0,16830,138188,0,155018
113310302100000,NE 103,RESIDENTIAL,16063,0,16063,140030,0,156093
113310302200000,NE 103,RESIDENTIAL,16063,0,16063,132741,0,148804
113310302300000,NE 103,RESIDENTIAL,17445,0,17445,107880,0,125325
113310302400000,NE 103,RESIDENTIAL,18398,0,18398,113074,0,131472
113310302500000,NE 103,RESIDENTIAL,17677,0,17677,133080,0,150757
113310302600000,NE 103,RESIDENTIAL,21505,0,21505,145486,0,166991
113310400100000,NE 103,RESIDENTIAL,21780,0,21780,126321,0,148101
113310400200000,NE 103,RESIDENTIAL,19075,0,19075,135699,0,154774
113310400300000,NE 103,RESIDENTIAL,26626,0,26626,124845,0,151471
113310400400000,NE 103,RESIDENTIAL,22064,0,22064,135141,0,157205
113310400500000,NE 103,RESIDENTIAL,20701,0,20701,136517,0,157218
113310400600000,NE 103,RESIDENTIAL,20531,0,20531,133925,0,154456
113310400700000,NE 103,RESIDENTIAL,24302,0,24302,146728,0,171030
113310400800000,NE 103,RESIDENTIAL,19568,0,19568,121977,0,141545
113310500100000,NE 103,RESIDENTIAL,19520,0,19520,144129,0,163649
113310500200000,NE 103,RESIDENTIAL,16413,0,16413,120790,0,137203
113310500300000,NE 103,RESIDENTIAL,18061,0,18061,120342,0,138403
113310500400000,NE 103,RESIDENTIAL,19635,0,19635,142652,0,162287
113310500500000,NE 103,RESIDENTIAL,19617,0,19617,132338,0,151955
113310500600000,NE 103,RESIDENTIAL,15449,0,15449,136545,0,151994
113310500700000,NE 103,RESIDENTIAL,14550,0,14550,130427,0,144977
113310500800000,NE 103,RESIDENTIAL,14550,0,14550,135887,0,150437
113310500900000,NE 103,RESIDENTIAL,16170,0,16170,135713,0,151883
113310501000000,NE 103,RESIDENTIAL,19963,0,19963,137701,0,157664
113310501100000,NE 103,RESIDENTIAL,17298,0,17298,137013,0,154311
113310501200000,NE 103,RESIDENTIAL,15158,0,15158,113386,0,128544
113310501300000,NE 103,RESIDENTIAL,14100,0,14100,119667,0,133767
113310501400000,NE 103,RESIDENTIAL,18080,0,18080,125866,0,143946
113310501500000,NE 103,RESIDENTIAL,17636,0,17636,122740,0,140376
113310501600000,NE 103,RESIDENTIAL,17595,0,17595,133703,0,151298
113310501700000,NE 103,RESIDENTIAL,17338,0,17338,131542,0,148880
113310501800000,NE 103,RESIDENTIAL,16289,0,16289,123159,0,139448
113310501900000,NE 103,RESIDENTIAL,17500,0,17500,102324,0,119824
113310502000000,NE 103,RESIDENTIAL,15500,0,15500,106288,0,121788
113310502100000,NE 103,RESIDENTIAL,15725,0,15725,137702,0,153427
113310502200000,NE 103,RESIDENTIAL,15000,0,15000,139690,0,154690
113310502300000,NE 103,RESIDENTIAL,15620,0,15620,134086,0,149706
113310502400000,NE 103,RESIDENTIAL,21350,0,21350,126370,0,147720
113310502500000,CHURCH,EXEMPT,0,387450,387450,0,1254334,1641784
113310502600000,NE 103,RESIDENTIAL,25200,0,25200,175634,0,200834
113310502700000,NE 103,RESIDENTIAL,25052,0,25052,162479,0,187531
113310502800000,NE 103,RESIDENTIAL,26125,0,26125,141511,0,167636
113310502900000,NE 103,RESIDENTIAL,25200,0,25200,166587,0,191787
113310503000000,NE 103,RESIDENTIAL,24860,0,24860,161002,0,185862
113310503100000,NE 103,RESIDENTIAL,24900,0,24900,133518,0,158418
113310600100000,NE 103,RESIDENTIAL,21261,0,21261,134628,0,155889
113310600200000,NE 103,RESIDENTIAL,20459,0,20459,116770,0,137229
113310600300000,NE 103,RESIDENTIAL,16320,0,16320,118127,0,134447
113310600400000,NE 103,RESIDENTIAL,20014,0,20014,117519,0,137533
113310600500000,NE 103,RESIDENTIAL,21026,0,21026,136628,0,157654
113310600600000,NE 103,RESIDENTIAL,16830,0,16830,136180,0,153010
113312600100000,VACANT LAND,EXEMPT,0,712422,712422,0,0,712422
113312600200000,NE 108,EXEMPT,0,128520,128520,0,327152,455672
113312600300000,NE 108,RESIDENTIAL,40113,0,40113,134829,0,174942
113315100100000,NE 108,RESIDENTIAL,26471,0,26471,142044,0,168515
113315100200000,NE 108,RESIDENTIAL,25542,0,25542,112372,0,137914
113315100300000,NE 108,RESIDENTIAL,26460,0,26460,110696,0,137156
113315100400000,NE 108,RESIDENTIAL,26460,0,26460,110525,0,136985
113315100500000,NE 108,RESIDENTIAL,26460,0,26460,129105,0,155565
113315100600000,NE 108,RESIDENTIAL,25284,0,25284,100982,0,126266
113315100700000,NE 108,RESIDENTIAL,26880,0,26880,126259,0,153139
113315100800000,NE 108,RESIDENTIAL,27178,0,27178,111688,0,138866
113315100900000,NE 108,RESIDENTIAL,24452,0,24452,85476,0,109928
113315101000000,NE 108,RESIDENTIAL,25284,0,25284,115327,0,140611
113315101100000,NE 108,RESIDENTIAL,25284,0,25284,109065,0,134349
113315101200000,NE 108,RESIDENTIAL,25284,0,25284,114180,0,139464
113315101300000,NE 108,RESIDENTIAL,26460,0,26460,119685,0,146145
113315101400000,NE 108,RESIDENTIAL,26460,0,26460,118035,0,144495
113315101500000,NE 108,RESIDENTIAL,24126,0,24126,110500,0,134626
113315101600000,NE 108,RESIDENTIAL,26068,0,26068,94223,0,120291
113315101700000,NE 108,RESIDENTIAL,23716,0,23716,106680,0,130396
113315101800000,NE 108,RESIDENTIAL,23716,0,23716,102647,0,126363
113315101900000,NE 108,RESIDENTIAL,23716,0,23716,126505,0,150221
113315102000000,NE 108,RESIDENTIAL,24466,0,24466,104199,0,128665
113315102100000,NE 108,RESIDENTIAL,27560,0,27560,124874,0,152434
113315102200000,NE 108,RESIDENTIAL,26342,0,26342,102221,0,128563
113315102300000,NE 108,RESIDENTIAL,24514,0,24514,88562,0,113076
113315102400000,NE 108,RESIDENTIAL,24514,0,24514,99678,0,124192
113315102500000,NE 108,RESIDENTIAL,22614,0,22614,152052,0,174666
113315102600000,NE 108,RESIDENTIAL,22614,0,22614,105020,0,127634
113315102700000,NE 108,RESIDENTIAL,22987,0,22987,112996,0,135983
113315102800000,NE 108,RESIDENTIAL,26530,0,26530,88915,0,115445
113315102900000,NE 108,RESIDENTIAL,25737,0,25737,98324,0,124061
113315103000000,NE 108,RESIDENTIAL,26724,0,26724,100391,0,127115
113315103100000,NE 108,RESIDENTIAL,25280,0,25280,87689,0,112969
113315103200000,NE 108,RESIDENTIAL,27440,0,27440,110096,0,137536
113315103300000,NE 108,RESIDENTIAL,27456,0,27456,136244,0,163700
113315103400000,NE 108,RESIDENTIAL,25536,0,25536,90474,0,116010
113315103500000,NE 108,RESIDENTIAL,25574,0,25574,101257,0,126831
113315103600000,NE 108,RESIDENTIAL,26074,0,26074,108736,0,134810
113315103700000,NE 108,RESIDENTIAL,25545,0,25545,99836,0,125381
113315103800000,NE 108,RESIDENTIAL,26923,0,26923,99945,0,126868
113315103900000,CITY PROPERTY,EXEMPT,0,0,0,0,0,0
113315104000000,CITY PROPERTY,EXEMPT,0,0,0,0,0,0
113315200100000,NE 108,RESIDENTIAL,26460,0,26460,122259,0,148719
113315200200000,NE 108,RESIDENTIAL,24304,0,24304,109444,0,133748
113315200300000,NE 108,RESIDENTIAL,26460,0,26460,99643,0,126103
113315200400000,NE 108,RESIDENTIAL,25920,0,25920,113008,0,138928
113315200500000,NE 108,RESIDENTIAL,24768,0,24768,102181,0,126949
113315200600000,NE 108,RESIDENTIAL,24768,0,24768,111265,0,136033
113315200700000,NE 108,RESIDENTIAL,24653,0,24653,106343,0,130996
113315200800000,NE 108,RESIDENTIAL,26398,0,26398,109845,0,136243
113315200900000,NE 108,RESIDENTIAL,24768,0,24768,94636,0,119404
113315201000000,NE 108,RESIDENTIAL,23232,0,23232,94782,0,118014
113315201100000,NE 108,RESIDENTIAL,23232,0,23232,99334,0,122566
113315201200000,NE 108,RESIDENTIAL,23232,0,23232,83356,0,106588
113315201300000,NE 108,RESIDENTIAL,24960,0,24960,93036,0,117996
113315201400000,NE 108,RESIDENTIAL,24440,0,24440,93266,0,117706
113315201500000,NE 108,RESIDENTIAL,23232,0,23232,88771,0,112003
113315201600000,NE 108,RESIDENTIAL,23232,0,23232,83367,0,106599
113315201700000,NE 108,RESIDENTIAL,23232,0,23232,88543,0,111775
113315201800000,NE 108,RESIDENTIAL,24768,0,24768,98905,0,123673
113315201900000,NE 108,RESIDENTIAL,26015,0,26015,113879,0,139894
113315202000000,NE 108,RESIDENTIAL,24653,0,24653,105165,0,129818
113315202100000,NE 108,RESIDENTIAL,24768,0,24768,110448,0,135216
113315202200000,NE 108,RESIDENTIAL,24768,0,24768,84004,0,108772
113315202300000,NE 108,RESIDENTIAL,25920,0,25920,93786,0,119706
113315300100000,NE 108,RESIDENTIAL,26460,0,26460,129947,0,156407
113315300200000,NE 108,RESIDENTIAL,24304,0,24304,99779,0,124083
113315300300000,NE 108,RESIDENTIAL,25920,0,25920,101053,0,126973
113315300400000,NE 108,RESIDENTIAL,22241,0,22241,99002,0,121243
113315300500000,NE 108,RESIDENTIAL,22272,0,22272,100520,0,122792
113315300600000,NE 108,RESIDENTIAL,22272,0,22272,111578,0,133850
113315300700000,NE 108,RESIDENTIAL,22272,0,22272,98955,0,121227
113315300800000,NE 108,RESIDENTIAL,22272,0,22272,103339,0,125611
113315300900000,NE 108,RESIDENTIAL,21782,0,21782,103284,0,125066
113315301000000,NE 108,RESIDENTIAL,25920,0,25920,102264,0,128184
113315301100000,NE 108,RESIDENTIAL,21888,0,21888,101446,0,123334
113315301200000,NE 108,RESIDENTIAL,21888,0,21888,93498,0,115386
113315301300000,NE 108,RESIDENTIAL,21888,0,21888,92832,0,114720
113315301400000,NE 108,RESIDENTIAL,24440,0,24440,122432,0,146872
113315301500000,NE 108,RESIDENTIAL,24960,0,24960,90945,0,115905
113315301600000,NE 108,RESIDENTIAL,21888,0,21888,100684,0,122572
113315301700000,NE 108,RESIDENTIAL,21888,0,21888,109086,0,130974
113315301800000,NE 108,RESIDENTIAL,21888,0,21888,91665,0,113553
113315301900000,NE 108,RESIDENTIAL,25920,0,25920,104062,0,129982
113315302000000,NE 108,RESIDENTIAL,26015,0,26015,116489,0,142504
113315302100000,NE 108,RESIDENTIAL,24768,0,24768,97749,0,122517
113315302200000,NE 108,RESIDENTIAL,24768,0,24768,105356,0,130124
113315302300000,NE 108,RESIDENTIAL,24768,0,24768,121611,0,146379
113315302400000,NE 108,RESIDENTIAL,26528,0,26528,125221,0,151749
113315400100000,NE 108,RESIDENTIAL,24876,0,24876,117828,0,142704
113315400200000,NE 108,RESIDENTIAL,25133,0,25133,100733,0,125866
113315500100000,NE 108,RESIDENTIAL,25718,0,25718,95772,0,121490
113315500200000,NE 108,RESIDENTIAL,25718,0,25718,89386,0,115104
113315600100000,NE 108,RESIDENTIAL,25718,0,25718,98249,0,123967
113315600200000,NE 108,RESIDENTIAL,25718,0,25718,90541,0,116259
113317600100000,CHURCH,EXEMPT,0,456192,456192,0,450812,907004
113317600200000,NE 103,RESIDENTIAL,13128,0,13128,74556,0,87684
113317600300000,NE 103,RESIDENTIAL,11992,0,11992,72008,0,84000
113317600400000,NE 103,RESIDENTIAL,12632,0,12632,71610,0,84242
113317600500000,NE 103,RESIDENTIAL,13281,0,13281,71707,0,84988
113317600600000,NE 103,RESIDENTIAL,25359,0,25359,143176,0,168535
113317700100000,NE 103,RESIDENTIAL,26089,0,26089,179166,0,205255
113317700200000,NE 103,RESIDENTIAL,14910,0,14910,71634,0,86544
113317700300000,NE 103,RESIDENTIAL,18683,0,18683,74875,0,93558
113317800100000,NE 108,RESIDENTIAL,25860,0,25860,148487,0,174347
113317800200000,NE 108,RESIDENTIAL,25160,0,25160,94361,0,119521
113317800300000,NE 108,RESIDENTIAL,23808,0,23808,100241,0,124049
113317800400000,NE 108,RESIDENTIAL,23040,0,23040,98733,0,121773
113317800500000,NE 108,RESIDENTIAL,22272,0,22272,93668,0,115940
113317800600000,NE 108,RESIDENTIAL,23808,0,23808,97115,0,120923
113317800700000,NE 108,RESIDENTIAL,22272,0,22272,90248,0,112520
113317800800000,NE 108,RESIDENTIAL,23808,0,23808,104964,0,128772
113317800900000,NE 108,RESIDENTIAL,23040,0,23040,93458,0,116498
113317801000000,NE 108,RESIDENTIAL,23808,0,23808,98179,0,121987
113317801100000,NE 108,RESIDENTIAL,25187,0,25187,91606,0,116793
113317801200000,NE 108,RESIDENTIAL,27030,0,27030,105304,0,132334
113317801300000,NE 108,RESIDENTIAL,25107,0,25107,102261,0,127368
113317801400000,NE 108,RESIDENTIAL,25536,0,25536,96794,0,122330
113317801500000,NE 108,RESIDENTIAL,25536,0,25536,94165,0,119701
113317801600000,NE 108,RESIDENTIAL,25206,0,25206,103015,0,128221
113317801700000,NE 108,RESIDENTIAL,27136,0,27136,93521,0,120657
113317801800000,NE 108,RESIDENTIAL,24055,0,24055,108592,0,132647
113317801900000,NE 108,RESIDENTIAL,23808,0,23808,94316,0,118124
113317802000000,NE 108,RESIDENTIAL,23040,0,23040,103261,0,126301
113317802100000,NE 108,RESIDENTIAL,23808,0,23808,99911,0,123719
113317802200000,NE 108,RESIDENTIAL,23808,0,23808,104620,0,128428
113317802300000,NE 108,RESIDENTIAL,22272,0,22272,99467,0,121739
113317802400000,NE 108,RESIDENTIAL,22272,0,22272,93398,0,115670
113317802500000,NE 108,RESIDENTIAL,23040,0,23040,95290,0,118330
113317802600000,NE 108,RESIDENTIAL,23808,0,23808,106201,0,130009
113317802700000,NE 108,RESIDENTIAL,24616,0,24616,95793,0,120409
113317802800000,NE 108,RESIDENTIAL,24990,0,24990,94906,0,119896
113317802900000,NE 108,RESIDENTIAL,23808,0,23808,87781,0,111589
113317803000000,NE 108,RESIDENTIAL,23040,0,23040,87217,0,110257
113317803100000,NE 108,RESIDENTIAL,22272,0,22272,85689,0,107961
113317803200000,NE 108,RESIDENTIAL,22272,0,22272,97495,0,119767
113317803300000,NE 108,RESIDENTIAL,23808,0,23808,89953,0,113761
113317803400000,NE 108,RESIDENTIAL,23808,0,23808,138070,0,161878
113317803500000,NE 108,RESIDENTIAL,23040,0,23040,103816,0,126856
113317803600000,NE 108,RESIDENTIAL,23808,0,23808,95774,0,119582
113317803700000,NE 108,RESIDENTIAL,25144,0,25144,90176,0,115320
113317803800000,NE 108,RESIDENTIAL,26355,0,26355,95174,0,121529
113317803900000,NE 108,RESIDENTIAL,25107,0,25107,104273,0,129380
113317804000000,NE 108,RESIDENTIAL,25536,0,25536,96275,0,121811
113317804100000,NE 108,RESIDENTIAL,25536,0,25536,100096,0,125632
113317804200000,NE 108,RESIDENTIAL,25610,0,25610,106503,0,132113
113317804300000,NE 108,RESIDENTIAL,29295,0,29295,112801,0,142096
113317804400000,NE 108,RESIDENTIAL,24589,0,24589,108616,0,133205
113317804500000,NE 108,RESIDENTIAL,23040,0,23040,86570,0,109610
113317804600000,NE 108,RESIDENTIAL,23040,0,23040,93731,0,116771
113317804700000,NE 108,RESIDENTIAL,25920,0,25920,101586,0,127506
113317804800000,NE 108,RESIDENTIAL,25822,0,25822,113172,0,138994
113317804900000,NE 108,RESIDENTIAL,23040,0,23040,104621,0,127661
113317805000000,NE 108,RESIDENTIAL,22800,0,22800,94408,0,117208
113317805100000,NE 108,RESIDENTIAL,23122,0,23122,101423,0,124545
113317805200000,NE 108,RESIDENTIAL,25584,0,25584,105357,0,130941
113317805300000,NE 108,RESIDENTIAL,25386,0,25386,112090,0,137476
113317805400000,NE 108,RESIDENTIAL,26460,0,26460,109429,0,135889
113317805500000,NE 108,RESIDENTIAL,25600,0,25600,93444,0,119044
113317805600000,NE 108,RESIDENTIAL,25011,0,25011,104017,0,129028
113317805700000,NE 108,RESIDENTIAL,27136,0,27136,108813,0,135949
113317805800000,NE 108,RESIDENTIAL,26255,0,26255,104978,0,131233
113317805900000,NE 108,RESIDENTIAL,25574,0,25574,90497,0,116071
113317806000000,NE 108,RESIDENTIAL,25536,0,25536,87602,0,113138
113317806100000,NE 108,RESIDENTIAL,26211,0,26211,106248,0,132459
113317806200000,NE 108,RESIDENTIAL,26460,0,26460,89237,0,115697
113317806300000,NE 108,RESIDENTIAL,25862,0,25862,92173,0,118035
113317806400000,NE 108,RESIDENTIAL,26602,0,26602,103474,0,130076
113317806500000,NE 108,RESIDENTIAL,28112,0,28112,111844,0,139956
113317806600000,NE 108,RESIDENTIAL,26255,0,26255,90943,0,117198
113317806700000,NE 108,RESIDENTIAL,25574,0,25574,96407,0,121981
113317806800000,NE 108,RESIDENTIAL,25536,0,25536,101344,0,126880
113317806900000,NE 108,RESIDENTIAL,25386,0,25386,102733,0,128119
113317807000000,NE 108,RESIDENTIAL,26460,0,26460,96699,0,123159
113317807100000,NE 108,RESIDENTIAL,25953,0,25953,93786,0,119739
113317807200000,NE 108,RESIDENTIAL,27086,0,27086,97598,0,124684
113317807300000,NE 108,RESIDENTIAL,27086,0,27086,104452,0,131538
113317807400000,NE 108,RESIDENTIAL,26348,0,26348,108813,0,135161
113317807500000,NE 108,RESIDENTIAL,24508,0,24508,123031,0,147539
113317807600000,NE 108,RESIDENTIAL,22176,0,22176,110871,0,133047
113317807700000,NE 108,RESIDENTIAL,24235,0,24235,90728,0,114963
113317807800000,NE 108,RESIDENTIAL,24265,0,24265,102978,0,127243
113317807900000,NE 108,RESIDENTIAL,23760,0,23760,107588,0,131348
113317808000000,NE 108,RESIDENTIAL,24265,0,24265,100320,0,124585
113317808100000,NE 108,RESIDENTIAL,25017,0,25017,118236,0,143253
113317808200000,NE 108,RESIDENTIAL,24908,0,24908,108619,0,133527
113317808300000,NE 108,RESIDENTIAL,24592,0,24592,120202,0,144794
113317808400000,NE 108,RESIDENTIAL,25344,0,25344,123866,0,149210
113317900100000,NE 108,RESIDENTIAL,25447,0,25447,92152,0,117599
113317900200000,NE 108,RESIDENTIAL,25114,0,25114,112262,0,137376
113317900300000,NE 108,RESIDENTIAL,23040,0,23040,92059,0,115099
113317900400000,NE 108,RESIDENTIAL,21120,0,21120,90354,0,111474
113317900500000,NE 108,RESIDENTIAL,21120,0,21120,90646,0,111766
113317900600000,NE 108,RESIDENTIAL,22272,0,22272,92632,0,114904
113317900700000,NE 108,RESIDENTIAL,23040,0,23040,88896,0,111936
113317900800000,NE 108,RESIDENTIAL,23040,0,23040,92770,0,115810
113317900900000,NE 108,RESIDENTIAL,21120,0,21120,103170,0,124290
113317901000000,NE 108,RESIDENTIAL,23040,0,23040,96206,0,119246
113317901100000,NE 108,RESIDENTIAL,24440,0,24440,94937,0,119377
113317901200000,NE 108,RESIDENTIAL,24440,0,24440,92399,0,116839
113317901300000,NE 108,RESIDENTIAL,23040,0,23040,111225,0,134265
113317901400000,NE 108,RESIDENTIAL,21120,0,21120,78998,0,100118
113317901500000,NE 108,RESIDENTIAL,23040,0,23040,84479,0,107519
113317901600000,NE 108,RESIDENTIAL,23040,0,23040,100430,0,123470
113317901700000,NE 108,RESIDENTIAL,22272,0,22272,105044,0,127316
113317901800000,NE 108,RESIDENTIAL,21120,0,21120,91949,0,113069
113317901900000,NE 108,RESIDENTIAL,21120,0,21120,97736,0,118856
113317902000000,NE 108,RESIDENTIAL,23040,0,23040,99688,0,122728
113318000100000,NE 108,RESIDENTIAL,30838,0,30838,112245,0,143083
113318000200000,NE 108,RESIDENTIAL,24817,0,24817,95316,0,120133
113318000300000,NE 108,RESIDENTIAL,24768,0,24768,93166,0,117934
113318000400000,NE 108,RESIDENTIAL,23040,0,23040,97194,0,120234
113318000500000,NE 108,RESIDENTIAL,24768,0,24768,95175,0,119943
113318000600000,NE 108,RESIDENTIAL,25536,0,25536,107392,0,132928
113318000700000,NE 108,RESIDENTIAL,24768,0,24768,86030,0,110798
113318000800000,NE 108,RESIDENTIAL,23040,0,23040,98690,0,121730
113318000900000,NE 108,RESIDENTIAL,23040,0,23040,142342,0,165382
113318001000000,NE 108,RESIDENTIAL,23040,0,23040,93241,0,116281
113318001100000,NE 108,RESIDENTIAL,24440,0,24440,106404,0,130844
113318001200000,NE 108,RESIDENTIAL,24440,0,24440,96838,0,121278
113318001300000,NE 108,RESIDENTIAL,23040,0,23040,106112,0,129152
113318001400000,NE 108,RESIDENTIAL,23040,0,23040,103419,0,126459
113318001500000,NE 108,RESIDENTIAL,23040,0,23040,97551,0,120591
113318001600000,NE 108,RESIDENTIAL,24768,0,24768,95595,0,120363
113318001700000,NE 108,RESIDENTIAL,25536,0,25536,110121,0,135657
113318001800000,NE 108,RESIDENTIAL,24768,0,24768,94799,0,119567
113318001900000,NE 108,RESIDENTIAL,23040,0,23040,104615,0,127655
113318002000000,NE 108,RESIDENTIAL,24768,0,24768,95043,0,119811
113318002100000,NE 108,RESIDENTIAL,25150,0,25150,99622,0,124772
113318100100000,NE 108,RESIDENTIAL,27034,0,27034,119750,0,146784
113318100200000,NE 108,RESIDENTIAL,26101,0,26101,106317,0,132418
113318100300000,NE 108,RESIDENTIAL,27300,0,27300,107785,0,135085
113318100400000,NE 108,RESIDENTIAL,24768,0,24768,101004,0,125772
113318100500000,NE 108,RESIDENTIAL,24768,0,24768,105869,0,130637
113318100600000,NE 108,RESIDENTIAL,25463,0,25463,99977,0,125440
113318100700000,NE 108,RESIDENTIAL,26104,0,26104,103413,0,129517
113318100800000,NE 108,RESIDENTIAL,24576,0,24576,98582,0,123158
113318100900000,NE 108,RESIDENTIAL,23040,0,23040,100791,0,123831
113318101000000,NE 108,RESIDENTIAL,23040,0,23040,102525,0,125565
113318101100000,NE 108,RESIDENTIAL,25511,0,25511,105060,0,130571
113318101200000,NE 108,RESIDENTIAL,25920,0,25920,100281,0,126201
113318101300000,NE 108,RESIDENTIAL,24768,0,24768,93926,0,118694
113318101400000,NE 108,RESIDENTIAL,23808,0,23808,100000,0,123808
113318101500000,NE 108,RESIDENTIAL,24768,0,24768,92786,0,117554
113318101600000,NE 108,RESIDENTIAL,24627,0,24627,93390,0,118017
113318101700000,NE 108,RESIDENTIAL,24942,0,24942,129412,0,154354
113318101800000,NE 108,RESIDENTIAL,22400,0,22400,100612,0,123012
113318200100000,NE 108,RESIDENTIAL,25718,0,25718,81902,0,107620
113318200200000,NE 108,RESIDENTIAL,25718,0,25718,94732,0,120450
113318300100000,NE 108,RESIDENTIAL,25718,0,25718,106982,0,132700
113318300200000,NE 108,RESIDENTIAL,25718,0,25718,105379,0,131097
113340100100000,NE 108,RESIDENTIAL,25542,0,25542,88228,0,113770
113340100200000,NE 108,RESIDENTIAL,24768,0,24768,98680,0,123448
113340100300000,NE 108,RESIDENTIAL,26266,0,26266,108003,0,134269
113340100400000,NE 108,RESIDENTIAL,24768,0,24768,92503,0,117271
113340100500000,NE 108,RESIDENTIAL,25536,0,25536,93623,0,119159
113340100600000,NE 108,RESIDENTIAL,26266,0,26266,108326,0,134592
113340100700000,NE 108,RESIDENTIAL,25920,0,25920,112734,0,138654
113340100800000,NE 108,RESIDENTIAL,26460,0,26460,105301,0,131761
113340100900000,NE 108,RESIDENTIAL,26813,0,26813,94693,0,121506
113340101000000,NE 108,RESIDENTIAL,26068,0,26068,111466,0,137534
113340101100000,NE 108,RESIDENTIAL,25284,0,25284,91254,0,116538
113340101200000,NE 108,RESIDENTIAL,26813,0,26813,89916,0,116729
113340200100000,NE 108,RESIDENTIAL,25536,0,25536,100959,0,126495
113340200200000,NE 108,RESIDENTIAL,25536,0,25536,98073,0,123609
113340200300000,NE 108,RESIDENTIAL,24768,0,24768,90568,0,115336
113340200400000,NE 108,RESIDENTIAL,24576,0,24576,100604,0,125180
113340200500000,NE 108,RESIDENTIAL,24768,0,24768,86349,0,111117
113340200600000,NE 108,RESIDENTIAL,25536,0,25536,107145,0,132681
113340200700000,NE 108,RESIDENTIAL,25920,0,25920,100403,0,126323
113340200800000,NE 108,RESIDENTIAL,25920,0,25920,97016,0,122936
113340200900000,NE 108,RESIDENTIAL,25536,0,25536,101575,0,127111
113340201000000,NE 108,RESIDENTIAL,24768,0,24768,90500,0,115268
113340201100000,NE 108,RESIDENTIAL,24576,0,24576,92955,0,117531
113340201200000,NE 108,RESIDENTIAL,24768,0,24768,90486,0,115254
113340300100000,NE 108,RESIDENTIAL,25536,0,25536,105130,0,130666
113340300200000,NE 108,RESIDENTIAL,25536,0,25536,94962,0,120498
113340300300000,NE 108,RESIDENTIAL,24768,0,24768,95233,0,120001
113340300400000,NE 108,RESIDENTIAL,24576,0,24576,93267,0,117843
113340300500000,NE 108,RESIDENTIAL,24768,0,24768,96369,0,121137
113340300600000,NE 108,RESIDENTIAL,25536,0,25536,114504,0,140040
113340300700000,NE 108,RESIDENTIAL,25920,0,25920,94031,0,119951
113340300800000,NE 108,RESIDENTIAL,25920,0,25920,101623,0,127543
113340300900000,NE 108,RESIDENTIAL,25536,0,25536,71376,0,96912
113340301000000,NE 108,RESIDENTIAL,24768,0,24768,97302,0,122070
113340301100000,NE 108,RESIDENTIAL,24576,0,24576,90575,0,115151
113340301200000,NE 108,RESIDENTIAL,24768,0,24768,91555,0,116323
113340400100000,NE 108,RESIDENTIAL,25536,0,25536,100489,0,126025
113340400200000,NE 108,RESIDENTIAL,25536,0,25536,102536,0,128072
113340400300000,NE 108,RESIDENTIAL,24768,0,24768,107306,0,132074
113340400400000,NE 108,RESIDENTIAL,24576,0,24576,106043,0,130619
113340400500000,NE 108,RESIDENTIAL,24768,0,24768,94206,0,118974
113340400600000,NE 108,RESIDENTIAL,25536,0,25536,74244,0,99780
113340400700000,NE 108,RESIDENTIAL,25920,0,25920,102755,0,128675
113340400800000,NE 108,RESIDENTIAL,25920,0,25920,92867,0,118787
113340400900000,NE 108,RESIDENTIAL,25536,0,25536,95897,0,121433
113340401000000,NE 108,RESIDENTIAL,24768,0,24768,99367,0,124135
113340401100000,NE 108,RESIDENTIAL,24576,0,24576,95844,0,120420
113340401200000,NE 108,RESIDENTIAL,24768,0,24768,91527,0,116295
113340500100000,NE 108,RESIDENTIAL,25536,0,25536,98862,0,124398
113340500200000,NE 108,RESIDENTIAL,22739,0,22739,94002,0,116741
113340500300000,NE 108,RESIDENTIAL,23040,0,23040,85242,0,108282
113340500400000,NE 108,RESIDENTIAL,24768,0,24768,91908,0,116676
113340500500000,NE 108,RESIDENTIAL,24576,0,24576,94239,0,118815
113340500600000,NE 108,RESIDENTIAL,24768,0,24768,97809,0,122577
113340500700000,NE 108,RESIDENTIAL,25536,0,25536,105017,0,130553
113340500800000,NE 108,RESIDENTIAL,25920,0,25920,96003,0,121923
113340500900000,NE 108,RESIDENTIAL,25920,0,25920,99053,0,124973
113340501000000,NE 108,RESIDENTIAL,25536,0,25536,100961,0,126497
113340501100000,NE 108,RESIDENTIAL,24768,0,24768,101427,0,126195
113340501200000,NE 108,RESIDENTIAL,24576,0,24576,99629,0,124205
113340501300000,NE 108,RESIDENTIAL,24768,0,24768,77342,0,102110
113340600100000,NE 108,RESIDENTIAL,26928,0,26928,117332,0,144260
113340600200000,NE 108,RESIDENTIAL,27834,0,27834,112439,0,140273
113340600300000,NE 108,RESIDENTIAL,27381,0,27381,113088,0,140469
113340600400000,NE 108,RESIDENTIAL,26160,0,26160,98212,0,124372
113340600500000,NE 108,RESIDENTIAL,26160,0,26160,98078,0,124238
113340600600000,NE 108,RESIDENTIAL,26160,0,26160,112390,0,138550
113340600700000,NE 108,RESIDENTIAL,26160,0,26160,116457,0,142617
113340600800000,NE 108,RESIDENTIAL,26160,0,26160,104106,0,130266
113340600900000,NE 108,RESIDENTIAL,26160,0,26160,104293,0,130453
113340601000000,NE 108,RESIDENTIAL,26160,0,26160,116280,0,142440
113340601100000,NE 108,RESIDENTIAL,26160,0,26160,106164,0,132324
113340601200000,NE 108,RESIDENTIAL,26160,0,26160,102121,0,128281
113340601300000,NE 108,RESIDENTIAL,26160,0,26160,105577,0,131737
113340601400000,NE 108,RESIDENTIAL,26160,0,26160,115628,0,141788
113340601500000,NE 108,RESIDENTIAL,26160,0,26160,106735,0,132895
113340601600000,NE 108,RESIDENTIAL,26160,0,26160,113301,0,139461
113340601700000,NE 108,RESIDENTIAL,26160,0,26160,107888,0,134048
113340601800000,NE 108,RESIDENTIAL,28994,0,28994,106857,0,135851
113340601900000,NE 108,RESIDENTIAL,30121,0,30121,115740,0,145861
113340602000000,NE 108,RESIDENTIAL,26160,0,26160,94552,0,120712
113340602200000,NE 108,RESIDENTIAL,26928,0,26928,80072,0,107000
113342600100000,NE 108,RESIDENTIAL,25536,0,25536,97289,0,122825
113342600200000,NE 108,RESIDENTIAL,24768,0,24768,90688,0,115456
113342600300000,NE 108,RESIDENTIAL,25536,0,25536,94887,0,120423
113342600400000,NE 108,RESIDENTIAL,24576,0,24576,87129,0,111705
113342600500000,NE 108,RESIDENTIAL,24768,0,24768,103319,0,128087
113342600600000,NE 108,RESIDENTIAL,25536,0,25536,100078,0,125614
113342600700000,NE 108,RESIDENTIAL,25920,0,25920,105659,0,131579
113342600800000,NE 108,RESIDENTIAL,25920,0,25920,95379,0,121299
113342600900000,NE 108,RESIDENTIAL,25536,0,25536,98187,0,123723
113342601000000,NE 108,RESIDENTIAL,24768,0,24768,98278,0,123046
113342601100000,NE 108,RESIDENTIAL,24576,0,24576,90279,0,114855
113342601200000,NE 108,RESIDENTIAL,24768,0,24768,101282,0,126050
113342700100000,NE 108,RESIDENTIAL,22852,0,22852,92590,0,115442
113342700200000,NE 108,RESIDENTIAL,24768,0,24768,99114,0,123882
113342700300000,NE 108,RESIDENTIAL,25536,0,25536,105463,0,130999
113342700400000,NE 108,RESIDENTIAL,24576,0,24576,123557,0,148133
113342700500000,NE 108,RESIDENTIAL,24768,0,24768,104139,0,128907
113342700600000,NE 108,RESIDENTIAL,25536,0,25536,111422,0,136958
113342700700000,NE 108,RESIDENTIAL,25920,0,25920,87750,0,113670
113342700800000,NE 108,RESIDENTIAL,25920,0,25920,81567,0,107487
113342700900000,NE 108,RESIDENTIAL,25536,0,25536,94636,0,120172
113342701000000,NE 108,RESIDENTIAL,24768,0,24768,102222,0,126990
113342701100000,NE 108,RESIDENTIAL,24576,0,24576,81108,0,105684
113342701200000,NE 108,RESIDENTIAL,24768,0,24768,85039,0,109807
113342701300000,NE 108,RESIDENTIAL,23040,0,23040,95848,0,118888
113342800100000,NE 108,RESIDENTIAL,24768,0,24768,100407,0,125175
113342800200000,NE 108,RESIDENTIAL,24768,0,24768,92872,0,117640
113342800300000,NE 108,RESIDENTIAL,25536,0,25536,86614,0,112150
113342800400000,NE 108,RESIDENTIAL,24576,0,24576,99111,0,123687
113342800500000,NE 108,RESIDENTIAL,24768,0,24768,88754,0,113522
113342800600000,NE 108,RESIDENTIAL,25536,0,25536,97407,0,122943
113342800700000,NE 108,RESIDENTIAL,25920,0,25920,95448,0,121368
113342800800000,NE 108,RESIDENTIAL,25920,0,25920,94740,0,120660
113342800900000,NE 108,RESIDENTIAL,25536,0,25536,98715,0,124251
113342801000000,NE 108,RESIDENTIAL,24768,0,24768,93623,0,118391
113342801100000,NE 108,RESIDENTIAL,24576,0,24576,84468,0,109044
113342801200000,NE 108,RESIDENTIAL,25536,0,25536,96338,0,121874
113342900100000,NE 108,RESIDENTIAL,26068,0,26068,104044,0,130112
113342900200000,NE 108,RESIDENTIAL,25284,0,25284,96498,0,121782
113342900300000,NE 108,RESIDENTIAL,25088,0,25088,93714,0,118802
113342900400000,NE 108,RESIDENTIAL,25284,0,25284,98307,0,123591
113342900500000,NE 108,RESIDENTIAL,26068,0,26068,97709,0,123777
113342900600000,NE 108,RESIDENTIAL,26460,0,26460,102499,0,128959
113343000100000,NE 108,RESIDENTIAL,28166,0,28166,115326,0,143492
113343000200000,NE 108,RESIDENTIAL,28166,0,28166,116109,0,144275
113343000300000,NE 108,RESIDENTIAL,26160,0,26160,96016,0,122176
113343000400000,NE 108,RESIDENTIAL,26160,0,26160,96691,0,122851
113343000500000,NE 108,RESIDENTIAL,27032,0,27032,88184,0,115216
113343000600000,NE 108,RESIDENTIAL,27032,0,27032,97655,0,124687
113343000700000,NE 108,RESIDENTIAL,27032,0,27032,90686,0,117718
113343000800000,NE 108,RESIDENTIAL,26160,0,26160,103122,0,129282
113343000900000,NE 108,RESIDENTIAL,26160,0,26160,107287,0,133447
113343001000000,NE 108,RESIDENTIAL,26160,0,26160,98862,0,125022
113343001100000,NE 108,RESIDENTIAL,26160,0,26160,107008,0,133168
113343001200000,NE 108,RESIDENTIAL,26160,0,26160,95620,0,121780
113343001300000,NE 108,RESIDENTIAL,26160,0,26160,107013,0,133173
113343001400000,NE 108,RESIDENTIAL,29231,0,29231,70548,0,99779
113343100100000,NE 108,RESIDENTIAL,28560,0,28560,133965,0,162525
113343100200000,NE 108,RESIDENTIAL,28560,0,28560,124737,0,153297
113347600100000,GOLF COURSE,COMMERCIAL,0,677150,677150,0,780882,1458032
113347700100000,OFFICE; MEDICAL,COMMERCIAL,0,286000,286000,0,616688,902688
113347700300000,VACANT LAND,COMMERCIAL,0,4500,4500,0,0,4500
113347700400000,OFFICE,COMMERCIAL,0,284000,284000,0,1134867,1418867
113410100100000,NE 163,RESIDENTIAL,40308,0,40308,64723,0,105031
113410100200000,CHURCH,EXEMPT,0,625968,625968,0,1366210,1992178
113410100300000,NE 163,RESIDENTIAL,27802,0,27802,149381,0,177183
113410100400000,NE 163,RESIDENTIAL,24480,0,24480,156783,0,181263
113410100500000,NE 163,RESIDENTIAL,24480,0,24480,143267,0,167747
113410100600000,NE 163,RESIDENTIAL,27120,0,27120,153495,0,180615
113410100700000,NE 163,RESIDENTIAL,27120,0,27120,154289,0,181409
113410100800000,NE 163,RESIDENTIAL,28928,0,28928,146412,0,175340
113410100900000,NE 163,RESIDENTIAL,26400,0,26400,140961,0,167361
113410101000000,NE 163,RESIDENTIAL,30103,0,30103,153736,0,183839
113410101100000,NE 163,RESIDENTIAL,28728,0,28728,160003,0,188731
113410101200000,NE 163,RESIDENTIAL,27157,0,27157,158914,0,186071
113410101300000,NE 163,RESIDENTIAL,27157,0,27157,140943,0,168100
113410101400000,NE 163,RESIDENTIAL,29400,0,29400,166211,0,195611
113410101500000,NE 163,RESIDENTIAL,25200,0,25200,159698,0,184898
113410101600000,NE 163,RESIDENTIAL,29820,0,29820,165126,0,194946
113410200100000,NE 163,RESIDENTIAL,28560,0,28560,188256,0,216816
113410200200000,NE 163,RESIDENTIAL,27030,0,27030,156101,0,183131
113410200300000,NE 163,RESIDENTIAL,27030,0,27030,153256,0,180286
113410200400000,NE 163,RESIDENTIAL,30031,0,30031,155953,0,185984
113410300100000,NE 163,RESIDENTIAL,33835,0,33835,170807,0,204642
113410300200000,NE 163,RESIDENTIAL,24480,0,24480,176556,0,201036
113410300300000,NE 163,RESIDENTIAL,25704,0,25704,186559,0,212263
113410300400000,NE 163,RESIDENTIAL,24888,0,24888,170982,0,195870
113410300500000,NE 163,RESIDENTIAL,28424,0,28424,166023,0,194447
113410400200000,CITY PROPERTY,EXEMPT,0,0,0,0,0,0
113410400300000,NE 163,RESIDENTIAL,30715,0,30715,159378,0,190093
113410400400000,NE 163,RESIDENTIAL,28711,0,28711,164925,0,193636
113410400500000,OFFICE; MEDICAL,COMMERCIAL,0,250000,250000,0,696039,946039
113410400701000,NBHD SHOPPING CENTER,COMMERCIAL,0,43502,43502,0,114703,158205
113410400701001,NBHD SHOPPING CENTER,COMMERCIAL,0,43502,43502,0,80292,123794
113410400701002,NBHD SHOPPING CENTER,COMMERCIAL,0,43502,43502,0,109462,152964
113410400701003,NBHD SHOPPING CENTER,COMMERCIAL,0,43502,43502,0,121624,165126
113410400701004,NBHD SHOPPING CENTER,COMMERCIAL,0,43502,43502,0,121624,165126
113410400701005,NBHD SHOPPING CENTER,COMMERCIAL,0,57821,57821,0,161627,219448
113410400701006,NBHD SHOPPING CENTER,COMMERCIAL,0,72747,72747,0,203242,275989
113410400701007,VACANT LAND,COMMERCIAL,0,40541,40541,0,0,40541
113410400701008,VACANT LAND,COMMERCIAL,0,40541,40541,0,0,40541
113410400701009,VACANT LAND,COMMERCIAL,0,40541,40541,0,0,40541
113410400701010,VACANT LAND,COMMERCIAL,0,40541,40541,0,0,40541
113410400701011,NBHD SHOPPING CENTER,COMMERCIAL,0,40541,40541,0,113148,153689
113410400701012,NBHD SHOPPING CENTER,COMMERCIAL,0,35771,35771,0,99926,135697
113410400701013,NBHD SHOPPING CENTER,COMMERCIAL,0,85793,85793,0,239941,325734
113410401000000,FLAT PARKING,COMMERCIAL,0,152450,152450,0,0,152450
113410401101000,NBHD SHOPPING CENTER,COMMERCIAL,0,310668,310668,0,1181366,1492034
113410401101001,NBHD SHOPPING CENTER,COMMERCIAL,0,260063,260063,0,861885,1121948
113410401101002,FLAT PARKING,COMMERCIAL,0,260063,260063,0,0,260063
113410401101003,NBHD SHOPPING CENTER,COMMERCIAL,0,104078,104078,0,439083,543161
113410401200000,BRANCH BANK/CU,COMMERCIAL,0,307500,307500,0,769726,1077226
113410401300000,NBHD SHOPPING CENTER,COMMERCIAL,0,167500,167500,0,409858,577358
113410500100000,NE 163,RESIDENTIAL,29680,0,29680,145467,0,175147
113410500200000,NE 163,RESIDENTIAL,25864,0,25864,166411,0,192275
113410500300000,NE 163,RESIDENTIAL,25822,0,25822,157574,0,183396
113410500400000,NE 163,RESIDENTIAL,26712,0,26712,151242,0,177954
113410500500000,NE 163,RESIDENTIAL,26712,0,26712,145239,0,171951
113410500600000,NE 163,RESIDENTIAL,31428,0,31428,127273,0,158701
113412600100000,NE 163,RESIDENTIAL,27030,0,27030,146476,0,173506
113412600200000,NE 163,RESIDENTIAL,27030,0,27030,131958,0,158988
113412600300000,NE 163,RESIDENTIAL,27030,0,27030,166221,0,193251
113412600400000,NE 163,RESIDENTIAL,27030,0,27030,139514,0,166544
113412600500000,NE 163,RESIDENTIAL,27030,0,27030,159912,0,186942
113412600600000,NE 163,RESIDENTIAL,27030,0,27030,132149,0,159179
113412600700000,NE 163,RESIDENTIAL,27030,0,27030,146865,0,173895
113412600800000,NE 163,RESIDENTIAL,28560,0,28560,136317,0,164877
113412600900000,NE 163,RESIDENTIAL,30704,0,30704,140052,0,170756
113412601000000,NE 163,RESIDENTIAL,27030,0,27030,133893,0,160923
113412601100000,NE 163,RESIDENTIAL,27030,0,27030,138772,0,165802
113412601200000,NE 163,RESIDENTIAL,27030,0,27030,127253,0,154283
113412601300000,NE 163,RESIDENTIAL,27030,0,27030,138395,0,165425
113412601400000,NE 163,RESIDENTIAL,27030,0,27030,151305,0,178335
113412601500000,NE 163,RESIDENTIAL,27030,0,27030,163302,0,190332
113412601600000,NE 163,RESIDENTIAL,27030,0,27030,166162,0,193192
113412700100000,NE 163,RESIDENTIAL,30600,0,30600,151680,0,182280
113412700200000,NE 163,RESIDENTIAL,28560,0,28560,156054,0,184614
113412700300000,NE 163,RESIDENTIAL,28560,0,28560,162101,0,190661
113412700500000,NE 163,RESIDENTIAL,31981,0,31981,152492,0,184473
113412700600000,NE 163,RESIDENTIAL,24480,0,24480,148904,0,173384
113412700700000,NE 163,RESIDENTIAL,25671,0,25671,157365,0,183036
113412700800000,NE 163,RESIDENTIAL,28549,0,28549,161602,0,190151
113412700900000,NE 163,RESIDENTIAL,31172,0,31172,183544,0,214716
113412701000000,NE 163,RESIDENTIAL,30636,0,30636,157314,0,187950
113412701100000,NE 163,RESIDENTIAL,28973,0,28973,166443,0,195416
113412701200000,NE 163,RESIDENTIAL,28004,0,28004,151153,0,179157
113412701300000,NE 163,RESIDENTIAL,25000,0,25000,140896,0,165896
113412701400000,NE 163,RESIDENTIAL,25000,0,25000,160374,0,185374
113412701500000,NE 163,RESIDENTIAL,25000,0,25000,161522,0,186522
113412701600000,NE 163,RESIDENTIAL,25000,0,25000,155361,0,180361
113412701700000,NE 163,RESIDENTIAL,28000,0,28000,163716,0,191716
113412701800000,NE 163,RESIDENTIAL,30426,0,30426,167677,0,198103
113412701900000,NE 163,RESIDENTIAL,30360,0,30360,173446,0,203806
113412702000000,NE 163,RESIDENTIAL,29921,0,29921,183015,0,212936
113412702100000,NE 163,EXEMPT,0,27840,27840,0,174981,202821
113412702200000,NE 163,RESIDENTIAL,28080,0,28080,172033,0,200113
113412800200000,NE 163,RESIDENTIAL,29536,0,29536,176705,0,206241
113412800300000,NE 163,RESIDENTIAL,28560,0,28560,176333,0,204893
113412800400000,NE 163,RESIDENTIAL,23582,0,23582,170402,0,193984
113412800500000,NE 163,RESIDENTIAL,26112,0,26112,167210,0,193322
113412800600000,NE 163,RESIDENTIAL,24847,0,24847,157655,0,182502
113412800700000,NE 163,RESIDENTIAL,24480,0,24480,163072,0,187552
113412800800000,NE 163,RESIDENTIAL,25582,0,25582,178404,0,203986
113412800900000,NE 163,RESIDENTIAL,24480,0,24480,144127,0,168607
113412801000000,NE 163,RESIDENTIAL,24847,0,24847,163793,0,188640
113412801100000,NE 163,RESIDENTIAL,24847,0,24847,160179,0,185026
113412801200000,NE 163,RESIDENTIAL,23990,0,23990,160983,0,184973
113412801300000,NE 163,RESIDENTIAL,24480,0,24480,155990,0,180470
113412801400000,NE 163,RESIDENTIAL,24480,0,24480,163094,0,187574
113412801500000,NE 163,RESIDENTIAL,24480,0,24480,166941,0,191421
113412801600000,NE 163,RESIDENTIAL,24480,0,24480,133406,0,157886
113412801700000,NE 163,RESIDENTIAL,26520,0,26520,162600,0,189120
113412801800000,NE 163,RESIDENTIAL,22440,0,22440,131372,0,153812
113412801900000,NE 163,RESIDENTIAL,24480,0,24480,160814,0,185294
113412802000000,NE 163,RESIDENTIAL,24480,0,24480,135090,0,159570
113412802100000,NE 163,RESIDENTIAL,24480,0,24480,151568,0,176048
113412900100000,NE 163,RESIDENTIAL,25822,0,25822,147973,0,173795
113412900200000,NE 163,RESIDENTIAL,25822,0,25822,132557,0,158379
113412900300000,NE 163,RESIDENTIAL,25822,0,25822,145920,0,171742
113412900400000,NE 163,RESIDENTIAL,25822,0,25822,150527,0,176349
113412900500000,NE 163,RESIDENTIAL,25822,0,25822,154514,0,180336
113412900600000,NE 163,RESIDENTIAL,25822,0,25822,164093,0,189915
113412900700000,NE 163,RESIDENTIAL,25822,0,25822,172868,0,198690
113412900800000,NE 163,RESIDENTIAL,25822,0,25822,151013,0,176835
113412900900000,NE 163,RESIDENTIAL,25822,0,25822,135933,0,161755
113412901000000,NE 163,RESIDENTIAL,29680,0,29680,173841,0,203521
113412901100000,NE 163,RESIDENTIAL,31428,0,31428,156168,0,187596
113412901200000,NE 163,RESIDENTIAL,26712,0,26712,147350,0,174062
113412901300000,NE 163,RESIDENTIAL,26712,0,26712,173313,0,200025
113412901400000,NE 163,RESIDENTIAL,26712,0,26712,153421,0,180133
113412901500000,NE 163,RESIDENTIAL,26712,0,26712,152715,0,179427
113412901600000,NE 163,RESIDENTIAL,26712,0,26712,169273,0,195985
113412901700000,NE 163,RESIDENTIAL,26712,0,26712,155531,0,182243
113412901800000,NE 163,RESIDENTIAL,26712,0,26712,151535,0,178247
113412901900000,NE 163,RESIDENTIAL,26712,0,26712,181364,0,208076
113413000100000,NE 163,RESIDENTIAL,25201,0,25201,162150,0,187351
113413000200000,NE 163,RESIDENTIAL,25217,0,25217,180196,0,205413
113413000300000,NE 163,RESIDENTIAL,26337,0,26337,173978,0,200315
113413000400000,NE 163,RESIDENTIAL,26460,0,26460,181235,0,207695
113413000500000,NE 163,RESIDENTIAL,26460,0,26460,157380,0,183840
113413000600000,NE 163,RESIDENTIAL,26460,0,26460,171444,0,197904
113413000700000,NE 163,RESIDENTIAL,26460,0,26460,181710,0,208170
113413000800000,NE 163,RESIDENTIAL,26460,0,26460,175393,0,201853
113413000900000,NE 163,RESIDENTIAL,26460,0,26460,178891,0,205351
113413001000000,NE 163,RESIDENTIAL,31104,0,31104,152692,0,183796
113413001100000,NE 163,RESIDENTIAL,31378,0,31378,223748,0,255126
113413001200000,NE 163,RESIDENTIAL,31408,0,31408,198309,0,229717
113413001300000,NE 163,RESIDENTIAL,31527,0,31527,180897,0,212424
113413001400000,NE 163,RESIDENTIAL,31500,0,31500,161790,0,193290
113413001500000,NE 163,RESIDENTIAL,32340,0,32340,164710,0,197050
113413001600000,NE 163,RESIDENTIAL,32832,0,32832,180111,0,212943
113413001700000,NE 163,RESIDENTIAL,32477,0,32477,183294,0,215771
113413001800000,NE 163,RESIDENTIAL,33101,0,33101,171643,0,204744
113413001900000,NE 163,RESIDENTIAL,28307,0,28307,154389,0,182696
113413002000000,NE 163,RESIDENTIAL,28453,0,28453,156156,0,184609
113413002100000,NE 163,RESIDENTIAL,30932,0,30932,139795,0,170727
113413002200000,CITY PROPERTY,EXEMPT,0,0,0,0,0,0
113413002300000,NE 163,RESIDENTIAL,33182,0,33182,181386,0,214568
113413002400000,NE 163,RESIDENTIAL,32308,0,32308,159310,0,191618
113413002500000,NE 163,RESIDENTIAL,29963,0,29963,146379,0,176342
113413002600000,NE 163,RESIDENTIAL,24752,0,24752,151197,0,175949
113415100100000,CHURCH,EXEMPT,0,582552,582552,0,928548,1511100
113415100300000,NE 163,RESIDENTIAL,42050,0,42050,294328,0,336378
113415100400000,NE 163,RESIDENTIAL,40675,0,40675,267976,0,308651
113415100500000,NE 163,RESIDENTIAL,28000,0,28000,299336,0,327336
113415100600000,NE 163,RESIDENTIAL,8443,0,8443,0,0,8443
113415200100000,VACANT LAND,COMMERCIAL,0,191225,191225,0,0,191225
113415200200000,ANTENNAS/TOWERS(BLL),COMMERCIAL,0,350600,350600,0,524962,875562
113417600500000,SMALL RETAIL,COMMERCIAL,0,448000,448000,0,650483,1098483
113417600600000,NBHD SHOPPING CENTER,COMMERCIAL,0,145039,145039,0,369083,514122
113417600700000,VACANT LAND,COMMERCIAL,0,186980,186980,0,0,186980
113417600800000,BRANCH BANK/CU,COMMERCIAL,0,338500,338500,0,1813298,2151798
113417600900000,CARWASH,COMMERCIAL,0,35000,35000,0,162969,197969
113417700100000,LG DISCOUNT/RETAIL,COMMERCIAL,0,506000,506000,0,672673,1178673
113417700300000,CITY PROPERTY,EXEMPT,0,0,0,0,0,0
113417700400000,CHURCH,EXEMPT,0,458525,458525,0,467314,925839
113420100800000,NE 159,RESIDENTIAL,26384,0,26384,186512,0,212896
113420100900000,NE 159,RESIDENTIAL,26384,0,26384,180516,0,206900
113420101000000,NE 159,RESIDENTIAL,26384,0,26384,213435,0,239819
113420101100000,NE 159,RESIDENTIAL,26384,0,26384,198333,0,224717
113420101200000,NE 159,RESIDENTIAL,27146,0,27146,227953,0,255099
113420101300000,NE 159,RESIDENTIAL,28660,0,28660,201439,0,230099
113420101400000,NE 159,RESIDENTIAL,30531,0,30531,205175,0,235706
113420101500000,NE 159,RESIDENTIAL,32544,0,32544,195317,0,227861
113420101600000,NE 159,RESIDENTIAL,29627,0,29627,196393,0,226020
113420101700000,NE 159,RESIDENTIAL,31920,0,31920,215833,0,247753
113420101800000,NE 159,RESIDENTIAL,28000,0,28000,217165,0,245165
113420101900000,NE 159,RESIDENTIAL,30000,0,30000,217173,0,247173
113420102000000,NE 159,RESIDENTIAL,31387,0,31387,174298,0,205685
113420102100000,NE 159,RESIDENTIAL,33277,0,33277,191123,0,224400
113420102200000,NE 159,RESIDENTIAL,32301,0,32301,165423,0,197724
113420102300000,NE 159,RESIDENTIAL,32556,0,32556,199995,0,232551
113420102400000,NE 159,RESIDENTIAL,31062,0,31062,207043,0,238105
113420102500000,NE 159,RESIDENTIAL,31108,0,31108,175941,0,207049
113420102600000,NE 159,RESIDENTIAL,27624,0,27624,178553,0,206177
113420102700000,NE 159,RESIDENTIAL,28560,0,28560,184641,0,213201
113420102800000,NE 159,RESIDENTIAL,32781,0,32781,176415,0,209196
113420102900000,NE 159,RESIDENTIAL,32769,0,32769,181551,0,214320
113420103000000,NE 159,RESIDENTIAL,33850,0,33850,202713,0,236563
113420103100000,NE 159,RESIDENTIAL,32436,0,32436,222516,0,254952
113420103200000,NE 159,RESIDENTIAL,33266,0,33266,203708,0,236974
113420103300000,NE 159,RESIDENTIAL,31956,0,31956,250832,0,282788
113420103400000,NE 159,RESIDENTIAL,28280,0,28280,182280,0,210560
113420103500000,NE 159,RESIDENTIAL,28280,0,28280,201208,0,229488
113420103600000,NE 159,RESIDENTIAL,28280,0,28280,177875,0,206155
113420103700000,NE 159,RESIDENTIAL,32549,0,32549,177775,0,210324
113420200200000,NE 159,RESIDENTIAL,34560,0,34560,203303,0,237863
113420200300000,NE 159,RESIDENTIAL,33589,0,33589,200221,0,233810
113420200400000,NE 159,RESIDENTIAL,32400,0,32400,159423,0,191823
113420200500000,NE 159,RESIDENTIAL,34043,0,34043,194769,0,228812
113420200600000,NE 159,RESIDENTIAL,37394,0,37394,184780,0,222174
113420200700000,NE 159,RESIDENTIAL,37645,0,37645,196948,0,234593
113420200800000,NE 159,RESIDENTIAL,34191,0,34191,196644,0,230835
113420200900000,NE 159,RESIDENTIAL,31040,0,31040,196798,0,227838
113420201000000,NE 159,RESIDENTIAL,29255,0,29255,174404,0,203659
113420201100000,NE 159,RESIDENTIAL,31601,0,31601,198435,0,230036
113420201200000,NE 159,RESIDENTIAL,31279,0,31279,210322,0,241601
113420201300000,NE 159,RESIDENTIAL,32172,0,32172,223126,0,255298
113420201400000,NE 159,RESIDENTIAL,29044,0,29044,188745,0,217789
113420201500000,NE 159,RESIDENTIAL,32187,0,32187,200120,0,232307
113420201600000,NE 159,RESIDENTIAL,28000,0,28000,176479,0,204479
113420300100000,NE 159,RESIDENTIAL,27936,0,27936,170007,0,197943
113420300200000,NE 159,RESIDENTIAL,27936,0,27936,171486,0,199422
113420300300000,NE 159,RESIDENTIAL,29100,0,29100,149003,0,178103
113420300400000,NE 159,RESIDENTIAL,35578,0,35578,203546,0,239124
113420300500000,NE 159,RESIDENTIAL,33799,0,33799,249505,0,283304
113420300600000,NE 159,RESIDENTIAL,34885,0,34885,208481,0,243366
113420300700000,NE 159,RESIDENTIAL,34064,0,34064,183796,0,217860
113420400100000,NE 159,RESIDENTIAL,34992,0,34992,198439,0,233431
113420400200000,NE 159,RESIDENTIAL,32560,0,32560,184736,0,217296
113420400300000,NE 159,RESIDENTIAL,31803,0,31803,177446,0,209249
113420400400000,NE 159,RESIDENTIAL,30384,0,30384,220379,0,250763
113420400500000,NE 159,RESIDENTIAL,33589,0,33589,190197,0,223786
113420400600000,NE 159,RESIDENTIAL,29476,0,29476,215078,0,244554
113420400700000,NE 159,RESIDENTIAL,29120,0,29120,197420,0,226540
113420400800000,NE 159,RESIDENTIAL,33688,0,33688,170946,0,204634
113420400900000,NE 159,RESIDENTIAL,33283,0,33283,194953,0,228236
113420500100000,NE 159,RESIDENTIAL,34706,0,34706,184175,0,218881
113420500200000,NE 159,RESIDENTIAL,46353,0,46353,204779,0,251132
113420500300000,NE 159,RESIDENTIAL,34454,0,34454,182752,0,217206
113420500400000,NE 159,RESIDENTIAL,37178,0,37178,253226,0,290404
113420500500000,NE 159,RESIDENTIAL,37901,0,37901,210663,0,248564
113420500600000,NE 159,RESIDENTIAL,33451,0,33451,201852,0,235303
113420500700000,NE 159,RESIDENTIAL,30720,0,30720,230122,0,260842
113420500800000,NE 159,RESIDENTIAL,31799,0,31799,187286,0,219085
113420500900000,NE 159,RESIDENTIAL,36557,0,36557,270545,0,307102
113420501000000,NE 159,RESIDENTIAL,33878,0,33878,226711,0,260589
113420501100000,NE 159,RESIDENTIAL,34344,0,34344,242433,0,276777
113420501200000,NE 159,RESIDENTIAL,37255,0,37255,258081,0,295336
113422600100000,NE 159,RESIDENTIAL,32866,0,32866,189297,0,222163
113422600200000,NE 159,RESIDENTIAL,29767,0,29767,194249,0,224016
113422600300000,NE 159,RESIDENTIAL,26000,0,26000,192700,0,218700
113422600400000,NE 159,RESIDENTIAL,24400,0,24400,172761,0,197161
113422600500000,NE 159,RESIDENTIAL,27600,0,27600,209139,0,236739
113422600600000,NE 159,RESIDENTIAL,27467,0,27467,174065,0,201532
113422600700000,NE 159,RESIDENTIAL,30736,0,30736,166865,0,197601
113422600800000,NE 159,RESIDENTIAL,29784,0,29784,167166,0,196950
113422600900000,NE 159,RESIDENTIAL,28661,0,28661,165057,0,193718
113422601000000,NE 159,RESIDENTIAL,28280,0,28280,176884,0,205164
113422601100000,NE 159,RESIDENTIAL,32070,0,32070,219066,0,251136
113422601200000,NE 159,RESIDENTIAL,31360,0,31360,164254,0,195614
113422601300000,NE 159,RESIDENTIAL,32739,0,32739,199773,0,232512
113422601400000,NE 159,RESIDENTIAL,31328,0,31328,185886,0,217214
113422601500000,NE 159,RESIDENTIAL,30720,0,30720,203223,0,233943
113422601600000,NE 159,RESIDENTIAL,28616,0,28616,171036,0,199652
113422601700000,NE 159,RESIDENTIAL,27160,0,27160,169389,0,196549
113422601800000,NE 159,RESIDENTIAL,32635,0,32635,177641,0,210276
113422601900000,NE 159,RESIDENTIAL,32849,0,32849,196433,0,229282
113422602000000,NE 159,RESIDENTIAL,27160,0,27160,213189,0,240349
113422602100000,NE 159,RESIDENTIAL,27160,0,27160,184093,0,211253
113422700100000,NE 159,RESIDENTIAL,32823,0,32823,185198,0,218021
113422700200000,NE 159,RESIDENTIAL,31312,0,31312,186834,0,218146
113422700300000,NE 159,RESIDENTIAL,27160,0,27160,177496,0,204656
113422700400000,NE 159,RESIDENTIAL,27160,0,27160,180317,0,207477
113422700500000,NE 159,RESIDENTIAL,27160,0,27160,189899,0,217059
113422700600000,NE 159,RESIDENTIAL,31393,0,31393,175407,0,206800
113422700700000,NE 159,RESIDENTIAL,31596,0,31596,173716,0,205312
113422700800000,NE 159,RESIDENTIAL,27160,0,27160,179516,0,206676
113422700900000,NE 159,RESIDENTIAL,27160,0,27160,174194,0,201354
113422701000000,NE 159,RESIDENTIAL,27160,0,27160,171567,0,198727
113422701100000,NE 159,RESIDENTIAL,27160,0,27160,200228,0,227388
113422701200000,NE 159,RESIDENTIAL,29488,0,29488,181741,0,211229
113422701300000,NE 159,RESIDENTIAL,30653,0,30653,187047,0,217700
113422701400000,NE 159,RESIDENTIAL,29780,0,29780,172492,0,202272
113422800100000,NE 162,RESIDENTIAL,41350,0,41350,143810,0,185160
113422800200000,NE 159,RESIDENTIAL,36000,0,36000,97671,0,133671
113422800300000,NE 159,RESIDENTIAL,34800,0,34800,149419,0,184219
113422800400000,NE 159,RESIDENTIAL,30000,0,30000,168522,0,198522
113422800500000,NE 159,RESIDENTIAL,30000,0,30000,165126,0,195126
113422800600000,NE 101,RESIDENTIAL,25200,0,25200,150449,0,175649
113422800700000,NE 101,RESIDENTIAL,30400,0,30400,181718,0,212118
113422800800000,NE 159,RESIDENTIAL,31416,0,31416,152035,0,183451
113422800900000,NE 159,RESIDENTIAL,31416,0,31416,166294,0,197710
113422801000000,NE 159,RESIDENTIAL,31416,0,31416,157521,0,188937
113422801100000,NE 159,RESIDENTIAL,31108,0,31108,152210,0,183318
113422801200000,NE 159,RESIDENTIAL,31108,0,31108,151171,0,182279
113422801300000,NE 159,RESIDENTIAL,31108,0,31108,158070,0,189178
113422801400000,NE 159,RESIDENTIAL,32623,0,32623,168679,0,201302
113422801500000,NE 159,RESIDENTIAL,31512,0,31512,188565,0,220077
113422801600000,NE 159,RESIDENTIAL,31512,0,31512,158255,0,189767
113422801700000,NE 159,RESIDENTIAL,31512,0,31512,158750,0,190262
113422801800000,NE 159,RESIDENTIAL,31512,0,31512,193954,0,225466
113422801900000,NE 159,RESIDENTIAL,31200,0,31200,180943,0,212143
113422802000000,NE 159,RESIDENTIAL,31200,0,31200,166087,0,197287
113422802100000,NE 159,RESIDENTIAL,31200,0,31200,180105,0,211305
113422802200000,NE 159,RESIDENTIAL,31200,0,31200,176912,0,208112
113422802300000,NE 159,RESIDENTIAL,32492,0,32492,133181,0,165673
113422900100000,NE 159,RESIDENTIAL,33712,0,33712,166164,0,199876
113422900200000,NE 159,RESIDENTIAL,32485,0,32485,174745,0,207230
113422900300000,NE 159,RESIDENTIAL,32190,0,32190,180762,0,212952
113422900400000,NE 159,RESIDENTIAL,32362,0,32362,161515,0,193877
113422900500000,NE 159,RESIDENTIAL,33863,0,33863,206494,0,240357
113422900600000,NE 159,RESIDENTIAL,32660,0,32660,169953,0,202613
113422900700000,NE 159,RESIDENTIAL,31808,0,31808,172706,0,204514
113422900800000,NE 159,RESIDENTIAL,33320,0,33320,165416,0,198736
113422900900000,NE 159,RESIDENTIAL,30133,0,30133,163968,0,194101
113422901000000,NE 159,RESIDENTIAL,31311,0,31311,170342,0,201653
113422901100000,NE 159,RESIDENTIAL,32365,0,32365,146808,0,179173
113422901200000,NE 159,RESIDENTIAL,30450,0,30450,162954,0,193404
113422901300000,NE 159,RESIDENTIAL,29120,0,29120,142499,0,171619
113422901400000,NE 159,RESIDENTIAL,29120,0,29120,166713,0,195833
113422901500000,NE 159,RESIDENTIAL,29120,0,29120,146672,0,175792
113422901600000,NE 159,RESIDENTIAL,29120,0,29120,164015,0,193135
113422901700000,NE 159,RESIDENTIAL,28574,0,28574,150132,0,178706
113422901800000,NE 159,RESIDENTIAL,32893,0,32893,176444,0,209337
113422901900000,NE 159,RESIDENTIAL,28549,0,28549,158749,0,187298
113422902000000,NE 159,RESIDENTIAL,32472,0,32472,180148,0,212620
113422902100000,NE 159,RESIDENTIAL,30456,0,30456,174148,0,204604
113422902200000,NE 159,RESIDENTIAL,28800,0,28800,176129,0,204929
113422902300000,NE 159,RESIDENTIAL,26000,0,26000,156416,0,182416
113422902400000,NE 159,RESIDENTIAL,26000,0,26000,167137,0,193137
113423000100000,NE 159,RESIDENTIAL,32171,0,32171,169071,0,201242
113423000200000,NE 159,RESIDENTIAL,32473,0,32473,152233,0,184706
113423000300000,NE 159,RESIDENTIAL,33048,0,33048,170501,0,203549
113423000400000,NE 159,RESIDENTIAL,33928,0,33928,171094,0,205022
113423000500000,NE 159,RESIDENTIAL,34508,0,34508,179636,0,214144
113423000600000,NE 159,RESIDENTIAL,31920,0,31920,184024,0,215944
113423100100000,NE 159,RESIDENTIAL,31280,0,31280,198697,0,229977
113423100200000,NE 159,RESIDENTIAL,28980,0,28980,171241,0,200221
113423100300000,NE 159,RESIDENTIAL,30940,0,30940,161413,0,192353
113423100400000,NE 159,RESIDENTIAL,29744,0,29744,180436,0,210180
113423100500000,NE 159,RESIDENTIAL,26000,0,26000,155187,0,181187
113423100600000,NE 159,RESIDENTIAL,26000,0,26000,163366,0,189366
113423100700000,NE 159,RESIDENTIAL,26000,0,26000,164774,0,190774
113423100800000,NE 159,RESIDENTIAL,26000,0,26000,182628,0,208628
113423100900000,NE 159,RESIDENTIAL,26000,0,26000,143570,0,169570
113423101000000,NE 159,RESIDENTIAL,32535,0,32535,173407,0,205942
113423101100000,NE 159,RESIDENTIAL,30873,0,30873,159714,0,190587
113423101200000,NE 159,RESIDENTIAL,30520,0,30520,175566,0,206086
113423200100000,NE 159,RESIDENTIAL,33002,0,33002,243563,0,276565
113423200200000,NE 159,RESIDENTIAL,32438,0,32438,149767,0,182205
113423200300000,NE 159,RESIDENTIAL,27160,0,27160,160152,0,187312
113423200400000,NE 159,RESIDENTIAL,33326,0,33326,170671,0,203997
113423200500000,NE 159,RESIDENTIAL,32736,0,32736,169974,0,202710
113423200600000,NE 159,RESIDENTIAL,32742,0,32742,190572,0,223314
113423200700000,NE 159,RESIDENTIAL,32695,0,32695,216509,0,249204
113423200800000,NE 159,RESIDENTIAL,26384,0,26384,176689,0,203073
113423200900000,NE 159,RESIDENTIAL,296,0,296,0,0,296
113423300200000,NE 159,RESIDENTIAL,29999,0,29999,185975,0,215974
113425100100000,CITY PROPERTY,EXEMPT,0,0,0,0,0,0
113425200100000,NE 159,RESIDENTIAL,29328,0,29328,148160,0,177488
113425200200000,NE 159,RESIDENTIAL,35752,0,35752,170208,0,205960
113425200300000,NE 159,RESIDENTIAL,34200,0,34200,146178,0,180378
113425300100000,NE 159,RESIDENTIAL,31500,0,31500,163395,0,194895
113425300200000,NE 159,RESIDENTIAL,30000,0,30000,159816,0,189816
113425400100000,NE 159,RESIDENTIAL,31416,0,31416,175290,0,206706
113425400200000,NE 101,RESIDENTIAL,30400,0,30400,170104,0,200504
113425400300000,CITY PROPERTY,EXEMPT,0,0,0,0,0,0
113425400400000,NE 159,RESIDENTIAL,32724,0,32724,168343,0,201067
113425400500000,NE 159,RESIDENTIAL,31416,0,31416,170746,0,202162
113425400600000,NE 159,RESIDENTIAL,31416,0,31416,164131,0,195547
113425500100000,NE 159,RESIDENTIAL,32000,0,32000,167731,0,199731
113425500200000,NE 159,RESIDENTIAL,28000,0,28000,148400,0,176400
113425500300000,NE 159,RESIDENTIAL,28000,0,28000,155356,0,183356
113425500400000,NE 159,RESIDENTIAL,28000,0,28000,177833,0,205833
113425500500000,NE 159,RESIDENTIAL,28000,0,28000,154558,0,182558
113425500600000,NE 159,RESIDENTIAL,28000,0,28000,161979,0,189979
113425500700000,NE 159,RESIDENTIAL,28000,0,28000,158397,0,186397
113425500800000,NE 159,RESIDENTIAL,28000,0,28000,155073,0,183073
113425500900000,NE 159,RESIDENTIAL,32000,0,32000,177943,0,209943
113425600200000,DAY CARE CENTER,COMMERCIAL,0,70500,70500,0,141146,211646
113425700101000,DAY CARE CENTER,COMMERCIAL,0,83799,83799,0,362019,445818
113425700101001,OFFICE,COMMERCIAL,0,83799,83799,0,376720,460519
113425700200000,VACANT LAND,COMMERCIAL,0,136300,136300,0,0,136300
113425700300000,VACANT LAND,COMMERCIAL,0,161500,161500,0,0,161500
113425800100000,CITY PROPERTY,EXEMPT,0,0,0,0,0,0
113425900100000,CITY PROPERTY,EXEMPT,0,0,0,0,0,0
113427600200000,NE 159,RESIDENTIAL,129200,0,129200,0,0,129200
113427700300000,NE 159,RESIDENTIAL,20,0,20,0,0,20
113427800200000,NE 159,RESIDENTIAL,34200,0,34200,93697,0,127897
113427800300000,NE 159,RESIDENTIAL,34200,0,34200,81745,0,115945
113427800400000,NE 159,RESIDENTIAL,29963,0,29963,137979,0,167942
113427800500000,NE 159,RESIDENTIAL,27044,0,27044,149063,0,176107
113427800600000,NE 159,RESIDENTIAL,27040,0,27040,185449,0,212489
113427800700000,NE 159,RESIDENTIAL,27040,0,27040,198839,0,225879
113427800800000,NE 159,RESIDENTIAL,26484,0,26484,183742,0,210226
113427800900000,NE 159,RESIDENTIAL,27004,0,27004,169643,0,196647
113427801000000,NE 159,RESIDENTIAL,28000,0,28000,183489,0,211489
113427801100000,NE 159,RESIDENTIAL,27972,0,27972,138253,0,166225
113427801200000,NE 159,RESIDENTIAL,27960,0,27960,153559,0,181519
113427801300000,NE 159,RESIDENTIAL,27937,0,27937,132428,0,160365
113427801400000,NE 159,RESIDENTIAL,29653,0,29653,164106,0,193759
113427801500000,NE 159,RESIDENTIAL,33914,0,33914,243987,0,277901
113427801600000,NE 159,RESIDENTIAL,28859,0,28859,147857,0,176716
113427801700000,NE 159,RESIDENTIAL,27958,0,27958,190901,0,218859
113427801800000,NE 159,RESIDENTIAL,27300,0,27300,168381,0,195681
113427801900000,NE 159,RESIDENTIAL,25740,0,25740,145692,0,171432
113427802000000,NE 159,RESIDENTIAL,29104,0,29104,167873,0,196977
113427802100000,NE 159,RESIDENTIAL,32429,0,32429,152665,0,185094
113427802200000,NE 159,RESIDENTIAL,33223,0,33223,165372,0,198595
113427802300000,NE 159,RESIDENTIAL,32308,0,32308,148867,0,181175
113427802400000,NE 159,RESIDENTIAL,29680,0,29680,182876,0,212556
113427802500000,NE 159,RESIDENTIAL,32000,0,32000,165116,0,197116
113427802600000,NE 159,RESIDENTIAL,26000,0,26000,160812,0,186812
113427802700000,NE 159,RESIDENTIAL,27820,0,27820,146086,0,173906
113427802800000,NE 159,RESIDENTIAL,27820,0,27820,170972,0,198792
113427802900000,NE 159,RESIDENTIAL,27820,0,27820,192143,0,219963
113427803000000,NE 159,RESIDENTIAL,27420,0,27420,163957,0,191377
113427803100000,NE 159,RESIDENTIAL,26520,0,26520,148902,0,175422
113427803200000,NE 159,RESIDENTIAL,26520,0,26520,138905,0,165425
113427803300000,NE 159,RESIDENTIAL,26520,0,26520,164416,0,190936
113427803400000,NE 159,RESIDENTIAL,26520,0,26520,159905,0,186425
113427803500000,NE 159,RESIDENTIAL,112800,0,112800,0,0,112800
113427900100000,NE 159,RESIDENTIAL,40068,0,40068,136692,0,176760
113427900200000,NE 159,RESIDENTIAL,32528,0,32528,196823,0,229351
113427900300000,NE 159,RESIDENTIAL,32528,0,32528,178116,0,210644
113427900400000,NE 159,RESIDENTIAL,32224,0,32224,194166,0,226390
113427900500000,NE 159,RESIDENTIAL,37122,0,37122,211181,0,248303
113427900600000,NE 159,RESIDENTIAL,36520,0,36520,207191,0,243711
113427900700000,NE 159,RESIDENTIAL,39936,0,39936,193058,0,232994
113427900800000,NE 159,RESIDENTIAL,40147,0,40147,184745,0,224892
113427900900000,NE 159,RESIDENTIAL,40768,0,40768,230030,0,270798
113427901000000,NE 159,RESIDENTIAL,38608,0,38608,219661,0,258269
113427901100000,NE 159,RESIDENTIAL,38196,0,38196,248398,0,286594
113427901200000,NE 159,RESIDENTIAL,38991,0,38991,239272,0,278263
113427901300000,NE 159,RESIDENTIAL,40012,0,40012,214457,0,254469
113427901400000,NE 159,RESIDENTIAL,38236,0,38236,233325,0,271561
113427901500000,NE 159,RESIDENTIAL,38236,0,38236,227554,0,265790
113427901600000,NE 159,RESIDENTIAL,38236,0,38236,192250,0,230486
113427901700000,NE 159,RESIDENTIAL,38236,0,38236,226612,0,264848
113427901800000,NE 159,RESIDENTIAL,38236,0,38236,232843,0,271079
113427901900000,NE 159,RESIDENTIAL,38236,0,38236,221764,0,260000
113427902000000,NE 159,RESIDENTIAL,38236,0,38236,175404,0,213640
113427902100000,NE 159,RESIDENTIAL,38236,0,38236,251276,0,289512
113427902200000,NE 159,RESIDENTIAL,39019,0,39019,212874,0,251893
113428000100000,NE 159,RESIDENTIAL,31712,0,31712,210616,0,242328
113428000200000,NE 159,RESIDENTIAL,26000,0,26000,195179,0,221179
113428000300000,NE 159,RESIDENTIAL,26000,0,26000,169614,0,195614
113428000400000,NE 159,RESIDENTIAL,26000,0,26000,176766,0,202766
113428000500000,NE 159,RESIDENTIAL,26000,0,26000,158986,0,184986
113428000600000,NE 159,RESIDENTIAL,26000,0,26000,140356,0,166356
113428000700000,NE 159,RESIDENTIAL,26000,0,26000,167673,0,193673
113428000800000,NE 159,RESIDENTIAL,26000,0,26000,162243,0,188243
113428000900000,NE 159,RESIDENTIAL,26000,0,26000,138244,0,164244
113428001000000,NE 159,RESIDENTIAL,26055,0,26055,151560,0,177615
113428001100000,NE 159,RESIDENTIAL,26323,0,26323,163887,0,190210
113428001200000,NE 159,RESIDENTIAL,25930,0,25930,187281,0,213211
113428001300000,NE 159,RESIDENTIAL,25740,0,25740,195192,0,220932
113428001400000,NE 159,RESIDENTIAL,26000,0,26000,192642,0,218642
113428001500000,NE 159,RESIDENTIAL,26000,0,26000,180901,0,206901
113428001600000,NE 159,RESIDENTIAL,26000,0,26000,169266,0,195266
113428001700000,NE 159,RESIDENTIAL,26000,0,26000,154244,0,180244
113428001800000,NE 159,RESIDENTIAL,26000,0,26000,151973,0,177973
113428001900000,NE 159,RESIDENTIAL,26000,0,26000,196338,0,222338
113428002000000,NE 159,RESIDENTIAL,26000,0,26000,226482,0,252482
113428002100000,NE 159,RESIDENTIAL,26000,0,26000,164002,0,190002
113428002200000,NE 159,RESIDENTIAL,31712,0,31712,198461,0,230173
113430100100000,VACANT LAND,COMMERCIAL,0,308770,308770,0,130252,439022
113430100200000,OFFICE,EXEMPT,0,354250,354250,0,2099539,2453789
113430100300000,VACANT LAND,COMMERCIAL,0,2400,2400,0,0,2400
113430200100000,VACANT LAND,COMMERCIAL,0,417525,417525,0,0,417525
113430200200000,SR/NURSING/ASSTD LIV,COMMERCIAL,0,311000,311000,0,5151293,5462293
113432700200000,NE 101,RESIDENTIAL,92700,0,92700,0,0,92700
113432700300000,NE 108,RESIDENTIAL,22277,0,22277,82121,0,104398
113432800200000,NE 101,RESIDENTIAL,51050,0,51050,0,0,51050
113432800400000,SR/NURSING/ASSTD LIV,COMMERCIAL,0,310000,310000,0,2469063,2779063
113432800600000,APARTMENT,COMMERCIAL,0,403000,403000,0,1184229,1587229
113432900200000,OFFICE,COMMERCIAL,0,595000,595000,0,1791116,2386116
113432900300000,GOLF COURSE,COMMERCIAL,0,40500,40500,0,59924,100424
113435100100000,OFFICE,COMMERCIAL,0,399625,399625,0,1012126,1411751
113435100200000,OFFICE,COMMERCIAL,0,263380,263380,0,1225388,1488768
113435100300000,GOLF COURSE,COMMERCIAL,0,33900,33900,0,56468,90368
113435100400000,FEDERAL PROPERTY,EXEMPT,0,0,0,0,0,0
113435100500000,SHOP,COMMERCIAL,0,288020,288020,0,625853,913873
113435100600000,MATERIALS MFG;INDUST,INDUSTRIAL,0,398952,398952,0,2495611,2894563
113435100700000,MATERIALS MFG;INDUST,INDUSTRIAL,0,288792,288792,0,1363488,1652280
113435100900000,SHOP,COMMERCIAL,0,82635,82635,0,308587,391222
113435200100000,OFFICE,COMMERCIAL,0,253500,253500,0,533264,786764
113435200200000,OFFICE,COMMERCIAL,0,523000,523000,0,3551578,4074578
113435200300000,OFFICE,COMMERCIAL,0,135450,135450,0,354868,490318
113437600100000,OFFICE,COMMERCIAL,0,154500,154500,0,753348,907848
113437600300000,OFFICE,COMMERCIAL,0,202500,202500,0,541496,743996
113437600400000,OFFICE,COMMERCIAL,0,157500,157500,0,727556,885056
113437600600000,HIGH TECH/RESEARCH,INDUSTRIAL,0,462213,462213,0,4922049,5384262
113437700100000,OFFICE,COMMERCIAL,0,130200,130200,0,316922,447122
113437700200000,OFFICE,COMMERCIAL,0,133400,133400,0,288260,421660
113437700300000,VACANT LAND,COMMERCIAL,0,189600,189600,0,0,189600
113437700400000,VACANT LAND,COMMERCIAL,0,256800,256800,0,0,256800
113437800300000,NE 101,RESIDENTIAL,3700,0,3700,0,0,3700
113437900100000,VACANT LAND,COMMERCIAL,0,5360,5360,0,0,5360
113437900200000,CENTRALLY ASSESSED,OTHER,0,0,0,0,0,0
113437900300000,VACANT LAND,COMMERCIAL,0,415250,415250,0,0,415250
113440100100000,NE 110,EXEMPT,0,44895,44895,0,187906,232801
113440100300000,NE 110,RESIDENTIAL,36360,0,36360,153851,0,190211
113440100400000,NE 110,RESIDENTIAL,36360,0,36360,177056,0,213416
113440100500000,NE 110,RESIDENTIAL,36360,0,36360,177727,0,214087
113440100600000,NE 110,RESIDENTIAL,37774,0,37774,126167,0,163941
113440200100000,NE 110,RESIDENTIAL,16014,0,16014,101263,0,117277
113440200200000,NE 110,RESIDENTIAL,15908,0,15908,110717,0,126625
113440200300000,NE 110,RESIDENTIAL,15908,0,15908,117875,0,133783
113440200400000,NE 110,RESIDENTIAL,15908,0,15908,117388,0,133296
113440200500000,NE 110,RESIDENTIAL,15908,0,15908,117832,0,133740
113440200600000,NE 110,RESIDENTIAL,15908,0,15908,114061,0,129969
113440200700000,NE 110,RESIDENTIAL,15908,0,15908,120774,0,136682
113440200800000,NE 110,RESIDENTIAL,15908,0,15908,103706,0,119614
113440200900000,NE 110,RESIDENTIAL,15908,0,15908,111207,0,127115
113440201000000,NE 110,RESIDENTIAL,15908,0,15908,112878,0,128786
113440300100000,CITY PROPERTY,EXEMPT,0,0,0,0,0,0
113440300200000,APARTMENT,COMMERCIAL,0,588000,588000,0,4021729,4609729
113440300301000,OFFICE; MEDICAL,COMMERCIAL,0,87105,87105,0,483149,570254
113440300301001,OFFICE; MEDICAL,COMMERCIAL,0,55223,55223,0,295251,350474
113440400100000,NE 110,RESIDENTIAL,19980,0,19980,122442,0,142422
113440400200000,NE 110,RESIDENTIAL,15750,0,15750,116952,0,132702
113440400300000,NE 110,RESIDENTIAL,15750,0,15750,106619,0,122369
113440400400000,NE 110,RESIDENTIAL,15750,0,15750,106619,0,122369
113440400500000,NE 110,RESIDENTIAL,15750,0,15750,97345,0,113095
113440400600000,NE 110,RESIDENTIAL,15750,0,15750,111530,0,127280
113440400700000,NE 110,RESIDENTIAL,15750,0,15750,120992,0,136742
113440400800000,NE 110,RESIDENTIAL,15750,0,15750,122865,0,138615
113440400900000,NE 110,RESIDENTIAL,15750,0,15750,115458,0,131208
113440401000000,NE 110,RESIDENTIAL,15750,0,15750,119719,0,135469
113440401100000,SECTION 42,COMMERCIAL,0,523000,523000,0,1827545,2350545
113440401200000,SECTION 42,COMMERCIAL,0,540500,540500,0,1870346,2410846
113442600100000,APARTMENT,COMMERCIAL,0,948000,948000,0,7196135,8144135
113445100100000,NE 110,RESIDENTIAL,20358,0,20358,96782,0,117140
113445100200000,NE 110,RESIDENTIAL,20370,0,20370,137969,0,158339
113445100300000,NE 110,RESIDENTIAL,20370,0,20370,113065,0,133435
113445100400000,NE 110,RESIDENTIAL,20370,0,20370,129609,0,149979
113445100500000,NE 110,RESIDENTIAL,20370,0,20370,145564,0,165934
113445100600000,NE 110,RESIDENTIAL,20370,0,20370,133299,0,153669
113445100700000,NE 110,RESIDENTIAL,20370,0,20370,131265,0,151635
113445100800000,NE 110,RESIDENTIAL,20370,0,20370,122818,0,143188
113445100900000,NE 110,RESIDENTIAL,20370,0,20370,113140,0,133510
113445101000000,NE 110,RESIDENTIAL,20370,0,20370,138998,0,159368
113445101100000,NE 110,RESIDENTIAL,20790,0,20790,149752,0,170542
113445101200000,NE 110,RESIDENTIAL,21420,0,21420,175134,0,196554
113445101300000,NE 110,RESIDENTIAL,20318,0,20318,113841,0,134159
113445101400000,NE 110,RESIDENTIAL,24236,0,24236,111527,0,135763
113445101500000,NE 110,RESIDENTIAL,24240,0,24240,131954,0,156194
113445101600000,NE 110,RESIDENTIAL,25785,0,25785,138289,0,164074
113445200100000,NE 110,RESIDENTIAL,20532,0,20532,118876,0,139408
113445200200000,NE 110,RESIDENTIAL,19200,0,19200,114574,0,133774
113445200300000,NE 110,RESIDENTIAL,19200,0,19200,88090,0,107290
113445200400000,NE 110,RESIDENTIAL,19200,0,19200,98274,0,117474
113445200500000,NE 110,RESIDENTIAL,19200,0,19200,108214,0,127414
113445200600000,NE 110,RESIDENTIAL,19200,0,19200,122281,0,141481
113445200700000,NE 110,RESIDENTIAL,19200,0,19200,87945,0,107145
113445200800000,NE 110,RESIDENTIAL,19200,0,19200,100336,0,119536
113445200900000,NE 110,RESIDENTIAL,19206,0,19206,125636,0,144842
113445201000000,NE 110,RESIDENTIAL,36600,0,36600,152796,0,189396
113445300100000,NE 110,RESIDENTIAL,21823,0,21823,135245,0,157068
113445300200000,NE 110,RESIDENTIAL,21750,0,21750,139261,0,161011
113445300300000,NE 110,RESIDENTIAL,21750,0,21750,98492,0,120242
113445300400000,NE 110,RESIDENTIAL,21750,0,21750,90150,0,111900
113445300500000,NE 110,RESIDENTIAL,21750,0,21750,146823,0,168573
113445300600000,NE 110,RESIDENTIAL,21750,0,21750,129575,0,151325
113445300700000,NE 110,RESIDENTIAL,21750,0,21750,104497,0,126247
113445300800000,NE 110,RESIDENTIAL,21835,0,21835,147770,0,169605
113445300900000,NE 110,RESIDENTIAL,21805,0,21805,145747,0,167552
113445301000000,NE 110,RESIDENTIAL,21750,0,21750,137435,0,159185
113445301100000,NE 110,RESIDENTIAL,21750,0,21750,125163,0,146913
113445301200000,NE 110,RESIDENTIAL,21750,0,21750,137110,0,158860
113445301300000,NE 110,RESIDENTIAL,21750,0,21750,139029,0,160779
113445301400000,NE 110,RESIDENTIAL,21750,0,21750,139252,0,161002
113445301500000,NE 110,RESIDENTIAL,21750,0,21750,112131,0,133881
113445301600000,NE 110,RESIDENTIAL,21900,0,21900,136499,0,158399
113445301800000,SR/NURSING/ASSTD LIV,COMMERCIAL,0,500320,500320,0,7444659,7944979
113445301900000,NE 110,RESIDENTIAL,22320,0,22320,204828,0,227148
113445302000000,NE 110,RESIDENTIAL,23760,0,23760,164785,0,188545
113445302100000,NE 110,RESIDENTIAL,23760,0,23760,170911,0,194671
113445302200000,NE 110,RESIDENTIAL,23760,0,23760,192954,0,216714
113445302300000,NE 110,RESIDENTIAL,24934,0,24934,174925,0,199859
113445302400000,NE 110,RESIDENTIAL,28044,0,28044,207052,0,235096
113445400100000,NE 110,RESIDENTIAL,22418,0,22418,134181,0,156599
113445400200000,NE 110,RESIDENTIAL,21750,0,21750,126684,0,148434
113445400300000,NE 110,RESIDENTIAL,21750,0,21750,112046,0,133796
113445400400000,NE 110,RESIDENTIAL,21750,0,21750,110650,0,132400
113445400500000,NE 110,RESIDENTIAL,21750,0,21750,108291,0,130041
113445400600000,NE 110,RESIDENTIAL,21750,0,21750,84528,0,106278
113445400700000,NE 110,RESIDENTIAL,21750,0,21750,124743,0,146493
113445400800000,NE 110,RESIDENTIAL,21779,0,21779,130836,0,152615
113445401000000,NE 110,RESIDENTIAL,21966,0,21966,93333,0,115299
113445401100000,NE 110,RESIDENTIAL,21210,0,21210,106826,0,128036
113445401200000,NE 110,RESIDENTIAL,21210,0,21210,104969,0,126179
113445401300000,NE 110,RESIDENTIAL,21210,0,21210,96567,0,117777
113445401400000,NE 110,RESIDENTIAL,21210,0,21210,147669,0,168879
113445401500000,NE 110,RESIDENTIAL,21210,0,21210,114677,0,135887
113445401600000,NE 110,RESIDENTIAL,21210,0,21210,123792,0,145002
113445401700000,NE 110,RESIDENTIAL,24795,0,24795,109486,0,134281
113445500100000,NE 110,RESIDENTIAL,23562,0,23562,123199,0,146761
113445500200000,NE 110,RESIDENTIAL,20502,0,20502,114685,0,135187
113445500300000,NE 110,RESIDENTIAL,20502,0,20502,122401,0,142903
113445500400000,NE 110,RESIDENTIAL,20502,0,20502,112034,0,132536
113445500500000,NE 110,RESIDENTIAL,20502,0,20502,78759,0,99261
113445500600000,NE 110,RESIDENTIAL,20502,0,20502,112036,0,132538
113445500700000,NE 110,RESIDENTIAL,20502,0,20502,105655,0,126157
113445500800000,NE 110,RESIDENTIAL,20518,0,20518,130244,0,150762
113445500900000,NE 110,RESIDENTIAL,21624,0,21624,99138,0,120762
113445501000000,NE 110,RESIDENTIAL,21624,0,21624,84453,0,106077
113445501100000,NE 110,RESIDENTIAL,21624,0,21624,74333,0,95957
113445501200000,NE 110,RESIDENTIAL,21624,0,21624,82718,0,104342
113445501300000,NE 110,RESIDENTIAL,21624,0,21624,118483,0,140107
113445501400000,NE 110,RESIDENTIAL,17479,0,17479,239766,0,257245
113445501500000,NE 110,RESIDENTIAL,23943,0,23943,227679,0,251622
113445501700000,OFFICE; MEDICAL,COMMERCIAL,0,317060,317060,0,2480132,2797192
113445501900000,FLAT PARKING,COMMERCIAL,0,45000,45000,0,56079,101079
113445502000000,VACANT LAND,COMMERCIAL,0,341300,341300,0,0,341300
113445600100000,NE 110,RESIDENTIAL,25680,0,25680,94705,0,120385
113445700100000,NE 110,RESIDENTIAL,21624,0,21624,121975,0,143599
113445700200000,NE 110,RESIDENTIAL,21624,0,21624,87349,0,108973
113445700300000,NE 110,RESIDENTIAL,21624,0,21624,87146,0,108770
113445700400000,NE 110,RESIDENTIAL,21624,0,21624,100611,0,122235
113445700500000,NE 110,RESIDENTIAL,21624,0,21624,78249,0,99873
113445700700000,NE 110,RESIDENTIAL,34339,0,34339,196488,0,230827
113445700800000,NE 110,EXEMPT,0,44215,44215,0,166919,211134
113445800100000,NE 110,RESIDENTIAL,40525,0,40525,49523,0,90048
113447600100000,CITY PROPERTY,EXEMPT,0,0,0,0,0,0
113447600400000,NE 110,RESIDENTIAL,23400,0,23400,153892,0,177292
113447600500000,NE 110,RESIDENTIAL,22050,0,22050,153532,0,175582
113447600600000,NE 110,RESIDENTIAL,24570,0,24570,144717,0,169287
113447600700000,NE 110,RESIDENTIAL,23280,0,23280,157094,0,180374
113447600800000,NE 110,RESIDENTIAL,23280,0,23280,139941,0,163221
113447600900000,NE 110,RESIDENTIAL,23280,0,23280,119719,0,142999
113447601000000,CITY PROPERTY,EXEMPT,0,0,0,0,0,0
113447601100000,NE 110,RESIDENTIAL,23280,0,23280,134477,0,157757
113447601200000,NE 110,RESIDENTIAL,23280,0,23280,145002,0,168282
113447601300000,NE 110,RESIDENTIAL,23280,0,23280,159281,0,182561
113447601400000,NE 110,RESIDENTIAL,23280,0,23280,157977,0,181257
113447601500000,NE 110,RESIDENTIAL,23280,0,23280,133696,0,156976
113447601600000,NE 110,RESIDENTIAL,23280,0,23280,149035,0,172315
113447601700000,NE 110,RESIDENTIAL,26308,0,26308,181218,0,207526
113447601900000,CITY PROPERTY,EXEMPT,0,0,0,0,0,0
113447602000000,NE 110,RESIDENTIAL,29995,0,29995,137420,0,167415
113447602100000,NE 110,RESIDENTIAL,25543,0,25543,162007,0,187550
113447602200000,NE 110,RESIDENTIAL,22407,0,22407,167017,0,189424
113447602300000,NE 110,RESIDENTIAL,26279,0,26279,140675,0,166954
113447602400000,NE 110,RESIDENTIAL,27535,0,27535,222251,0,249786
113447602500000,NE 110,RESIDENTIAL,24444,0,24444,112889,0,137333
113447602600000,NE 110,RESIDENTIAL,24444,0,24444,139055,0,163499
113447602700000,NE 110,RESIDENTIAL,24444,0,24444,155785,0,180229
113447602800000,NE 110,RESIDENTIAL,24444,0,24444,151453,0,175897
113447602900000,NE 110,RESIDENTIAL,24444,0,24444,171563,0,196007
113447603000000,NE 110,RESIDENTIAL,24668,0,24668,164008,0,188676
113447603100000,NE 110,RESIDENTIAL,22407,0,22407,129369,0,151776
113447603200000,NE 110,RESIDENTIAL,22344,0,22344,142662,0,165006
113447700100000,NE 110,RESIDENTIAL,25180,0,25180,157387,0,182567
113447700200000,NE 110,RESIDENTIAL,22135,0,22135,139954,0,162089
113447700300000,NE 110,RESIDENTIAL,25235,0,25235,168489,0,193724
113447700400000,NE 110,RESIDENTIAL,25645,0,25645,140231,0,165876
113447700500000,NE 110,RESIDENTIAL,25584,0,25584,146387,0,171971
113447700600000,NE 110,RESIDENTIAL,23456,0,23456,160666,0,184122
113447700700000,NE 110,RESIDENTIAL,23280,0,23280,181056,0,204336
113447700800000,NE 110,RESIDENTIAL,23280,0,23280,128130,0,151410
113447700900000,NE 110,RESIDENTIAL,23280,0,23280,141502,0,164782
113447701000000,NE 110,RESIDENTIAL,23280,0,23280,153669,0,176949
113447701100000,NE 110,RESIDENTIAL,23280,0,23280,153519,0,176799
113447701200000,NE 110,RESIDENTIAL,23280,0,23280,126220,0,149500
113447701300000,NE 110,RESIDENTIAL,23280,0,23280,146724,0,170004
113447701400000,NE 110,RESIDENTIAL,23280,0,23280,140947,0,164227
113447701500000,NE 110,RESIDENTIAL,23280,0,23280,132138,0,155418
113447701600000,NE 110,RESIDENTIAL,24925,0,24925,166693,0,191618
113447701700000,NE 110,RESIDENTIAL,23026,0,23026,148994,0,172020
113447701800000,NE 110,RESIDENTIAL,22050,0,22050,106003,0,128053
113447701900000,NE 110,RESIDENTIAL,22680,0,22680,121318,0,143998
113447702000000,NE 110,RESIDENTIAL,22365,0,22365,88871,0,111236
113447702100000,NE 110,RESIDENTIAL,22365,0,22365,106196,0,128561
113447702200000,NE 110,RESIDENTIAL,22365,0,22365,132145,0,154510
113447702300000,NE 110,RESIDENTIAL,22365,0,22365,0,0,22365
113447702400000,NE 110,RESIDENTIAL,22680,0,22680,105861,0,128541
113447702500000,NE 110,RESIDENTIAL,22050,0,22050,143868,0,165918
113447702600000,NE 110,RESIDENTIAL,22578,0,22578,139798,0,162376
113447702700000,NE 110,RESIDENTIAL,23004,0,23004,123834,0,146838
113447702800000,NE 110,RESIDENTIAL,23430,0,23430,127677,0,151107
113447702900000,NE 110,RESIDENTIAL,22650,0,22650,157164,0,179814
113447703000000,NE 110,RESIDENTIAL,20661,0,20661,135647,0,156308
113447703100000,NE 110,RESIDENTIAL,20661,0,20661,108724,0,129385
113447703200000,NE 110,RESIDENTIAL,21880,0,21880,96207,0,118087
113447703300000,NE 110,RESIDENTIAL,22968,0,22968,48687,0,71655
113447800100000,NE 110,RESIDENTIAL,18793,0,18793,88771,0,107564
113447800200000,NE 110,RESIDENTIAL,19176,0,19176,129950,0,149126
113447800300000,NE 110,RESIDENTIAL,19176,0,19176,136725,0,155901
113447800400000,NE 110,RESIDENTIAL,19176,0,19176,109410,0,128586
113447800500000,NE 110,RESIDENTIAL,19380,0,19380,110084,0,129464
113447800600000,NE 110,RESIDENTIAL,19992,0,19992,110767,0,130759
113447800700000,NE 110,RESIDENTIAL,20400,0,20400,124954,0,145354
113447800800000,NE 110,RESIDENTIAL,20554,0,20554,144976,0,165530
113447800900000,NE 110,RESIDENTIAL,22842,0,22842,112272,0,135114
113447801000000,NE 110,RESIDENTIAL,22312,0,22312,116525,0,138837
113447900100000,NE 110,RESIDENTIAL,20370,0,20370,140836,0,161206
113447900200000,NE 110,RESIDENTIAL,20370,0,20370,118880,0,139250
113447900300000,NE 110,RESIDENTIAL,22464,0,22464,130560,0,153024
113447900400000,NE 110,RESIDENTIAL,22464,0,22464,130692,0,153156
113447900500000,NE 110,RESIDENTIAL,21216,0,21216,114873,0,136089
113447900600000,NE 110,RESIDENTIAL,23712,0,23712,131808,0,155520
113447900700000,NE 110,RESIDENTIAL,22464,0,22464,139655,0,162119
113447900800000,NE 110,RESIDENTIAL,22464,0,22464,108510,0,130974
113447900900000,NE 110,RESIDENTIAL,23850,0,23850,114385,0,138235
113512600200000,NE 107,RESIDENTIAL,24629,0,24629,138183,0,162812
113512600300000,NE 107,RESIDENTIAL,21420,0,21420,156919,0,178339
113512600400000,NE 107,RESIDENTIAL,22950,0,22950,149612,0,172562
113512600500000,NE 107,RESIDENTIAL,21806,0,21806,152892,0,174698
113512600600000,NE 107,RESIDENTIAL,23868,0,23868,156936,0,180804
113512600700000,NE 107,RESIDENTIAL,22360,0,22360,148202,0,170562
113512600800000,NE 107,RESIDENTIAL,21945,0,21945,157186,0,179131
113512600900000,NE 107,RESIDENTIAL,22091,0,22091,143082,0,165173
113512601000000,NE 107,RESIDENTIAL,23532,0,23532,155066,0,178598
113512601100000,NE 107,RESIDENTIAL,23714,0,23714,152255,0,175969
113512601200000,NE 107,RESIDENTIAL,24033,0,24033,150791,0,174824
113512601300000,NE 107,RESIDENTIAL,24720,0,24720,150869,0,175589
113512601400000,NE 107,RESIDENTIAL,26249,0,26249,158445,0,184694
113512601500000,NE 107,RESIDENTIAL,25509,0,25509,142272,0,167781
113512601600000,NE 107,RESIDENTIAL,722,0,722,0,0,722
113512601700000,NE 107,RESIDENTIAL,699,0,699,0,0,699
113512700100000,NE 107,RESIDENTIAL,690,0,690,0,0,690
113512700200000,NE 107,RESIDENTIAL,495,0,495,0,0,495
113512700300000,NE 107,RESIDENTIAL,23460,0,23460,141805,0,165265
113512700400000,NE 107,RESIDENTIAL,25086,0,25086,167481,0,192567
113512700500000,NE 107,RESIDENTIAL,25335,0,25335,115931,0,141266
113512700600000,NE 107,RESIDENTIAL,24840,0,24840,144818,0,169658
113512700700000,NE 107,RESIDENTIAL,24920,0,24920,136478,0,161398
113512700800000,NE 107,RESIDENTIAL,4625,0,4625,0,0,4625
113512800100000,NE 107,RESIDENTIAL,26006,0,26006,141490,0,167496
113512800200000,NE 107,RESIDENTIAL,18900,0,18900,112598,0,131498
113512800300000,NE 107,RESIDENTIAL,25233,0,25233,154801,0,180034
113512800400000,NE 107,RESIDENTIAL,20867,0,20867,156952,0,177819
113512800500000,NE 107,RESIDENTIAL,22087,0,22087,142329,0,164416
113512800600000,NE 107,RESIDENTIAL,21534,0,21534,145101,0,166635
113512800700000,NE 107,RESIDENTIAL,21825,0,21825,145622,0,167447
113512800800000,NE 107,RESIDENTIAL,22795,0,22795,125912,0,148707
113512800900000,NE 107,RESIDENTIAL,21470,0,21470,132801,0,154271
113512801000000,NE 107,RESIDENTIAL,25568,0,25568,128537,0,154105
113512801100000,NE 107,RESIDENTIAL,26706,0,26706,151978,0,178684
113512801200000,NE 107,RESIDENTIAL,23128,0,23128,127785,0,150913
113512801300000,NE 107,RESIDENTIAL,24726,0,24726,156527,0,181253
113512801400000,NE 107,RESIDENTIAL,23280,0,23280,136464,0,159744
113512801500000,NE 107,RESIDENTIAL,22800,0,22800,159136,0,181936
113512801600000,NE 107,RESIDENTIAL,22922,0,22922,163629,0,186551
113512801700000,NE 107,RESIDENTIAL,20756,0,20756,141597,0,162353
113512801800000,NE 107,RESIDENTIAL,23467,0,23467,133457,0,156924
113512801900000,NE 107,RESIDENTIAL,25346,0,25346,139654,0,165000
113512900100000,NE 107,RESIDENTIAL,24225,0,24225,149138,0,173363
113512900200000,NE 107,RESIDENTIAL,21473,0,21473,161828,0,183301
113512900300000,NE 107,RESIDENTIAL,23981,0,23981,146991,0,170972
113512900400000,NE 107,RESIDENTIAL,24990,0,24990,146821,0,171811
113512900500000,NE 107,RESIDENTIAL,23265,0,23265,140673,0,163938
113512900600000,NE 107,RESIDENTIAL,22610,0,22610,145742,0,168352
113512900700000,NE 107,RESIDENTIAL,22543,0,22543,146885,0,169428
113512900800000,NE 107,RESIDENTIAL,23086,0,23086,133198,0,156284
113512900900000,NE 107,RESIDENTIAL,23302,0,23302,154438,0,177740
113512901000000,NE 107,RESIDENTIAL,21630,0,21630,143337,0,164967
113512901100000,NE 107,RESIDENTIAL,25245,0,25245,163945,0,189190
113512901200000,NE 107,RESIDENTIAL,26124,0,26124,110390,0,136514
113512901300000,NE 107,RESIDENTIAL,21459,0,21459,125127,0,146586
113512901400000,NE 107,RESIDENTIAL,22800,0,22800,160859,0,183659
113512901500000,NE 107,RESIDENTIAL,24336,0,24336,141833,0,166169
113515100100000,NE 107,RESIDENTIAL,4100,0,4100,0,0,4100
113515100200000,NE 107,RESIDENTIAL,24211,0,24211,144802,0,169013
113515100300000,NE 107,RESIDENTIAL,23250,0,23250,156402,0,179652
113515100400000,NE 107,RESIDENTIAL,22816,0,22816,144007,0,166823
113515100500000,NE 107,RESIDENTIAL,22560,0,22560,134838,0,157398
113515100600000,NE 107,RESIDENTIAL,21181,0,21181,110105,0,131286
113515100700000,NE 107,RESIDENTIAL,22295,0,22295,118585,0,140880
113515100800000,NE 107,RESIDENTIAL,19600,0,19600,135645,0,155245
113515100900000,NE 107,RESIDENTIAL,23616,0,23616,141503,0,165119
113515101000000,NE 107,RESIDENTIAL,24057,0,24057,121771,0,145828
113515200100000,NE 107,RESIDENTIAL,20807,0,20807,148556,0,169363
113515200200000,NE 107,RESIDENTIAL,21298,0,21298,142416,0,163714
113515200300000,NE 107,RESIDENTIAL,19896,0,19896,135665,0,155561
113515200400000,NE 107,RESIDENTIAL,24582,0,24582,148127,0,172709
113515200500000,NE 107,RESIDENTIAL,24000,0,24000,128532,0,152532
113515200600000,NE 107,RESIDENTIAL,19080,0,19080,114845,0,133925
113515200700000,NE 107,RESIDENTIAL,17395,0,17395,141578,0,158973
113515200800000,NE 107,RESIDENTIAL,18334,0,18334,111690,0,130024
113515200900000,NE 107,RESIDENTIAL,18612,0,18612,113700,0,132312
113515201000000,NE 107,RESIDENTIAL,18246,0,18246,107431,0,125677
113515201100000,NE 107,RESIDENTIAL,23226,0,23226,111350,0,134576
113515201200000,NE 107,RESIDENTIAL,23226,0,23226,110383,0,133609
113515201300000,NE 107,RESIDENTIAL,23226,0,23226,122718,0,145944
113515201400000,NE 107,RESIDENTIAL,18963,0,18963,133867,0,152830
113515201500000,NE 107,RESIDENTIAL,23520,0,23520,121407,0,144927
113515201600000,NE 107,RESIDENTIAL,22089,0,22089,123679,0,145768
113515201700000,NE 107,RESIDENTIAL,23610,0,23610,113010,0,136620
113515201800000,NE 107,RESIDENTIAL,25114,0,25114,151649,0,176763
113515201900000,NE 106,RESIDENTIAL,47040,0,47040,245873,0,292913
113515202000000,NE 106,RESIDENTIAL,44109,0,44109,167826,0,211935
113515202100000,NE 106,RESIDENTIAL,45485,0,45485,230244,0,275729
113515202200000,NE 106,RESIDENTIAL,47740,0,47740,193510,0,241250
113515202300000,NE 106,RESIDENTIAL,46464,0,46464,212982,0,259446
113515202400000,NE 106,RESIDENTIAL,45148,0,45148,219316,0,264464
113515202500000,NE 106,RESIDENTIAL,42984,0,42984,213067,0,256051
113515202600000,NE 106,RESIDENTIAL,41333,0,41333,229084,0,270417
113515202700000,NE 106,RESIDENTIAL,42432,0,42432,274803,0,317235
113515202800000,NE 106,RESIDENTIAL,40000,0,40000,227699,0,267699
113515203100000,NE 106,RESIDENTIAL,48433,0,48433,185086,0,233519
113515203200000,NE 106,RESIDENTIAL,45256,0,45256,287876,0,333132
113515203300000,NE 106,RESIDENTIAL,42213,0,42213,287595,0,329808
113515203400000,NE 106,RESIDENTIAL,36000,0,36000,216906,0,252906
113515203500000,NE 106,RESIDENTIAL,45150,0,45150,239834,0,284984
113515203600000,NE 106,RESIDENTIAL,48062,0,48062,222445,0,270507
113515203700000,NE 106,RESIDENTIAL,46652,0,46652,266047,0,312699
113515203800000,NE 106,RESIDENTIAL,43200,0,43200,237558,0,280758
113515203900000,NE 106,RESIDENTIAL,44336,0,44336,221674,0,266010
113515204000000,NE 106,RESIDENTIAL,46512,0,46512,240371,0,286883
113515204100000,NE 106,RESIDENTIAL,40307,0,40307,227679,0,267986
113515204200000,NE 106,RESIDENTIAL,40280,0,40280,218301,0,258581
113515204300000,NE 106,RESIDENTIAL,42400,0,42400,234581,0,276981
113515204400000,NE 106,RESIDENTIAL,40280,0,40280,242722,0,283002
113515204500000,NE 106,RESIDENTIAL,40280,0,40280,267415,0,307695
113515204600000,NE 106,RESIDENTIAL,47064,0,47064,237699,0,284763
113515204700000,NE 106,RESIDENTIAL,60773,0,60773,247499,0,308272
113515300100000,NE 106,RESIDENTIAL,42776,0,42776,222067,0,264843
113515300200000,NE 106,RESIDENTIAL,43200,0,43200,279302,0,322502
113515300300000,NE 106,RESIDENTIAL,46080,0,46080,261625,0,307705
113515300400000,NE 106,RESIDENTIAL,40615,0,40615,227676,0,268291
113515300500000,NE 106,RESIDENTIAL,43228,0,43228,208883,0,252111
113515300600000,NE 106,RESIDENTIAL,40400,0,40400,246128,0,286528
113515300700000,NE 106,RESIDENTIAL,40400,0,40400,262485,0,302885
113515300800000,NE 106,RESIDENTIAL,40400,0,40400,196522,0,236922
113515300900000,NE 106,RESIDENTIAL,39053,0,39053,245359,0,284412
113515301000000,NE 106,RESIDENTIAL,47700,0,47700,194259,0,241959
113515301100000,NE 106,RESIDENTIAL,48434,0,48434,273487,0,321921
113515301200000,NE 106,RESIDENTIAL,42420,0,42420,265593,0,308013
113515301300000,NE 106,RESIDENTIAL,43313,0,43313,279546,0,322859
113515301400000,NE 106,RESIDENTIAL,45640,0,45640,267184,0,312824
113515400100000,NE 107,RESIDENTIAL,22080,0,22080,111191,0,133271
113515400200000,NE 107,RESIDENTIAL,17802,0,17802,124729,0,142531
113515400300000,NE 107,RESIDENTIAL,17802,0,17802,153054,0,170856
113515400400000,NE 107,RESIDENTIAL,20976,0,20976,152609,0,173585
113515400500000,NE 107,RESIDENTIAL,21925,0,21925,172465,0,194390
113515400600000,FITNESS CENTER,COMMERCIAL,0,63200,63200,0,108650,171850
113515500100000,SCHOOL,EXEMPT,0,0,0,0,0,0
113520100100000,NE 160,RESIDENTIAL,29191,0,29191,168455,0,197646
113520100200000,NE 160,RESIDENTIAL,29565,0,29565,225080,0,254645
113520100300000,NE 160,RESIDENTIAL,29021,0,29021,166424,0,195445
113520200100000,NE 160,RESIDENTIAL,30047,0,30047,214562,0,244609
113520200200000,NE 160,RESIDENTIAL,30256,0,30256,229721,0,259977
113520300100000,NE 160,RESIDENTIAL,376,0,376,0,0,376
113520300200000,NE 160,RESIDENTIAL,39700,0,39700,210829,0,250529
113520300300000,NE 107,RESIDENTIAL,23256,0,23256,159700,0,182956
113520300400000,NE 107,RESIDENTIAL,19585,0,19585,129087,0,148672
113520400100000,NE 160,RESIDENTIAL,29820,0,29820,160180,0,190000
113520400200000,NE 160,RESIDENTIAL,28728,0,28728,209443,0,238171
113520400300000,NE 160,RESIDENTIAL,28728,0,28728,175986,0,204714
113520400400000,NE 160,RESIDENTIAL,28728,0,28728,196831,0,225559
113520400500000,NE 160,RESIDENTIAL,30164,0,30164,188134,0,218298
113520400600000,NE 160,RESIDENTIAL,29566,0,29566,200214,0,229780
113520400700000,NE 160,RESIDENTIAL,28998,0,28998,159202,0,188200
113520400800000,NE 160,RESIDENTIAL,30444,0,30444,194043,0,224487
113520400900000,NE 160,RESIDENTIAL,28994,0,28994,190189,0,219183
113520401000000,NE 160,RESIDENTIAL,28994,0,28994,189042,0,218036
113520401100000,NE 160,RESIDENTIAL,30444,0,30444,209014,0,239458
113520401200000,NE 160,RESIDENTIAL,30479,0,30479,209906,0,240385
113520401300000,NE 160,RESIDENTIAL,31696,0,31696,208121,0,239817
113520401400000,NE 160,RESIDENTIAL,28616,0,28616,188639,0,217255
113520401500000,NE 160,RESIDENTIAL,31371,0,31371,214073,0,245444
113520401600000,NE 105,RESIDENTIAL,25524,0,25524,193309,0,218833
113520401700000,NE 105,RESIDENTIAL,24960,0,24960,168735,0,193695
113520401800000,NE 105,RESIDENTIAL,24450,0,24450,168085,0,192535
113520401900000,NE 105,RESIDENTIAL,25380,0,25380,176347,0,201727
113520402000000,NE 160,RESIDENTIAL,24486,0,24486,193780,0,218266
113520402100000,NE 160,RESIDENTIAL,25583,0,25583,178610,0,204193
113520402200000,NE 160,RESIDENTIAL,25405,0,25405,182222,0,207627
113520402300000,NE 160,RESIDENTIAL,25112,0,25112,174823,0,199935
113520402400000,NE 160,RESIDENTIAL,25304,0,25304,179022,0,204326
113520402500000,NE 160,RESIDENTIAL,25310,0,25310,181372,0,206682
113520402600000,NE 160,RESIDENTIAL,25511,0,25511,179960,0,205471
113520402700000,NE 160,RESIDENTIAL,26573,0,26573,160632,0,187205
113520402800000,NE 160,RESIDENTIAL,26732,0,26732,199481,0,226213
113520402900000,NE 160,RESIDENTIAL,25582,0,25582,146622,0,172204
113520403000000,NE 160,RESIDENTIAL,24716,0,24716,157707,0,182423
113520403100000,NE 160,RESIDENTIAL,23188,0,23188,157827,0,181015
113520403200000,NE 160,RESIDENTIAL,23410,0,23410,192965,0,216375
113520403300000,NE 160,RESIDENTIAL,23760,0,23760,181898,0,205658
113520403400000,NE 160,RESIDENTIAL,24415,0,24415,193219,0,217634
113520403500000,NE 160,RESIDENTIAL,23661,0,23661,176698,0,200359
113520403600000,NE 160,RESIDENTIAL,23923,0,23923,195505,0,219428
113520403700000,NE 105,RESIDENTIAL,25140,0,25140,164080,0,189220
113520403800000,NE 105,RESIDENTIAL,25029,0,25029,153104,0,178133
113520403900000,NE 105,RESIDENTIAL,23175,0,23175,156295,0,179470
113520404000000,NE 107,RESIDENTIAL,23175,0,23175,141833,0,165008
113520404100000,NE 107,RESIDENTIAL,24952,0,24952,164781,0,189733
113520404200000,NE 107,RESIDENTIAL,24720,0,24720,151855,0,176575
113520404300000,NE 107,RESIDENTIAL,25029,0,25029,164152,0,189181
113520404400000,NE 107,RESIDENTIAL,24658,0,24658,167395,0,192053
113520404500000,NE 107,RESIDENTIAL,24720,0,24720,163791,0,188511
113520404600000,NE 107,RESIDENTIAL,22681,0,22681,154137,0,176818
113520404700000,NE 107,RESIDENTIAL,24720,0,24720,148799,0,173519
113520404800000,NE 107,RESIDENTIAL,24720,0,24720,172436,0,197156
113520404900000,NE 107,RESIDENTIAL,23175,0,23175,163070,0,186245
113520405000000,NE 107,RESIDENTIAL,26164,0,26164,178194,0,204358
113520405100000,NE 160,RESIDENTIAL,30234,0,30234,171054,0,201288
113520405200000,NE 160,RESIDENTIAL,33088,0,33088,202618,0,235706
113520500100000,NE 107,RESIDENTIAL,25650,0,25650,164404,0,190054
113520500200000,NE 107,RESIDENTIAL,21000,0,21000,144743,0,165743
113520500300000,NE 107,RESIDENTIAL,21000,0,21000,139040,0,160040
113520500400000,NE 107,RESIDENTIAL,21000,0,21000,186905,0,207905
113520500500000,NE 107,RESIDENTIAL,24000,0,24000,150116,0,174116
113520500600000,NE 107,RESIDENTIAL,24000,0,24000,163683,0,187683
113520600100000,NE 107,RESIDENTIAL,25650,0,25650,170960,0,196610
113520600200000,NE 107,RESIDENTIAL,20909,0,20909,151385,0,172294
113520600300000,NE 107,RESIDENTIAL,23760,0,23760,150034,0,173794
113520600400000,NE 107,RESIDENTIAL,22275,0,22275,148593,0,170868
113520600500000,NE 107,RESIDENTIAL,23760,0,23760,170869,0,194629
113520600600000,NE 107,RESIDENTIAL,22275,0,22275,141212,0,163487
113520600700000,NE 107,RESIDENTIAL,22050,0,22050,154059,0,176109
113520600800000,NE 107,RESIDENTIAL,25707,0,25707,140113,0,165820
113520600900000,NE 107,RESIDENTIAL,22725,0,22725,155194,0,177919
113520601000000,NE 107,RESIDENTIAL,22671,0,22671,166193,0,188864
113520601100000,NE 107,RESIDENTIAL,25688,0,25688,162568,0,188256
113520601200000,NE 107,RESIDENTIAL,25618,0,25618,171576,0,197194
113520601300000,NE 107,RESIDENTIAL,24948,0,24948,191939,0,216887
113520601400000,NE 107,RESIDENTIAL,25531,0,25531,146024,0,171555
113520601500000,NE 107,RESIDENTIAL,26283,0,26283,144654,0,170937
113520601600000,NE 107,RESIDENTIAL,27078,0,27078,183274,0,210352
113520601700000,NE 107,RESIDENTIAL,25393,0,25393,183816,0,209209
113520601800000,NE 107,RESIDENTIAL,25554,0,25554,172947,0,198501
113520601900000,NE 107,RESIDENTIAL,25650,0,25650,169880,0,195530
113520602000000,NE 107,RESIDENTIAL,22800,0,22800,144262,0,167062
113520700100000,NE 107,RESIDENTIAL,25920,0,25920,166770,0,192690
113520700200000,NE 107,RESIDENTIAL,20790,0,20790,150379,0,171169
113520700300000,NE 105,RESIDENTIAL,22119,0,22119,130682,0,152801
113520700400000,NE 105,RESIDENTIAL,25755,0,25755,172061,0,197816
113520700500000,NE 105,RESIDENTIAL,25436,0,25436,162185,0,187621
113520700600000,NE 105,RESIDENTIAL,25440,0,25440,162999,0,188439
113520700700000,NE 105,RESIDENTIAL,25758,0,25758,176576,0,202334
113520700800000,NE 105,RESIDENTIAL,25492,0,25492,161469,0,186961
113520700900000,NE 107,RESIDENTIAL,21879,0,21879,158529,0,180408
113520701000000,NE 107,RESIDENTIAL,23520,0,23520,164721,0,188241
113520701100000,NE 107,RESIDENTIAL,22134,0,22134,144053,0,166187
113520701200000,NE 107,RESIDENTIAL,21420,0,21420,156506,0,177926
113520800100000,NE 107,RESIDENTIAL,25398,0,25398,155332,0,180730
113520800200000,NE 107,RESIDENTIAL,19081,0,19081,139270,0,158351
113520800300000,NE 107,RESIDENTIAL,19740,0,19740,172874,0,192614
113520800400000,NE 107,RESIDENTIAL,26289,0,26289,151037,0,177326
113522600100000,NE 105,RESIDENTIAL,24359,0,24359,171215,0,195574
113522600200000,NE 105,RESIDENTIAL,25175,0,25175,197606,0,222781
113522600300000,NE 105,RESIDENTIAL,23979,0,23979,150135,0,174114
113522600400000,NE 105,RESIDENTIAL,24122,0,24122,157605,0,181727
113522600500000,NE 105,RESIDENTIAL,23562,0,23562,161987,0,185549
113522600600000,NE 105,RESIDENTIAL,23256,0,23256,196154,0,219410
113522600700000,NE 105,RESIDENTIAL,22644,0,22644,179677,0,202321
113522600800000,NE 105,RESIDENTIAL,24174,0,24174,178225,0,202399
113522600900000,NE 105,RESIDENTIAL,23890,0,23890,140580,0,164470
113522601000000,NE 105,RESIDENTIAL,25420,0,25420,162899,0,188319
113522601100000,NE 105,RESIDENTIAL,29057,0,29057,167766,0,196823
113522601200000,NE 105,RESIDENTIAL,24800,0,24800,179817,0,204617
113522601300000,NE 105,RESIDENTIAL,25741,0,25741,192768,0,218509
113522700100000,NE 105,RESIDENTIAL,28187,0,28187,170409,0,198596
113522700200000,NE 105,RESIDENTIAL,26386,0,26386,203640,0,230026
113522700300000,NE 105,RESIDENTIAL,25962,0,25962,198770,0,224732
113522700400000,NE 105,RESIDENTIAL,25756,0,25756,175804,0,201560
113522700500000,NE 105,RESIDENTIAL,25436,0,25436,168012,0,193448
113522700600000,NE 105,RESIDENTIAL,25596,0,25596,168644,0,194240
113522700700000,NE 105,RESIDENTIAL,23400,0,23400,173834,0,197234
113522700800000,NE 105,RESIDENTIAL,25463,0,25463,182390,0,207853
113522800100000,NE 105,RESIDENTIAL,27343,0,27343,155292,0,182635
113522800200000,NE 105,RESIDENTIAL,25970,0,25970,177249,0,203219
113522800300000,NE 105,RESIDENTIAL,26365,0,26365,107777,0,134142
113522800400000,NE 105,RESIDENTIAL,22567,0,22567,173028,0,195595
113522800500000,NE 105,RESIDENTIAL,20677,0,20677,160517,0,181194
113522800600000,NE 105,RESIDENTIAL,24627,0,24627,164289,0,188916
113522800700000,NE 105,RESIDENTIAL,22746,0,22746,151864,0,174610
113522800800000,NE 105,RESIDENTIAL,24523,0,24523,172675,0,197198
113522800900000,NE 105,RESIDENTIAL,24232,0,24232,159181,0,183413
113522801000000,NE 105,RESIDENTIAL,23634,0,23634,149062,0,172696
113522801100000,NE 105,RESIDENTIAL,25858,0,25858,167767,0,193625
113522801200000,NE 105,RESIDENTIAL,25188,0,25188,141021,0,166209
113522801300000,NE 105,RESIDENTIAL,24480,0,24480,139479,0,163959
113522801400000,NE 105,RESIDENTIAL,22950,0,22950,141286,0,164236
113522801500000,NE 105,RESIDENTIAL,24480,0,24480,134959,0,159439
113522801600000,NE 105,RESIDENTIAL,22950,0,22950,141755,0,164705
113522801700000,NE 105,RESIDENTIAL,24480,0,24480,159481,0,183961
113522801800000,NE 105,RESIDENTIAL,22950,0,22950,143816,0,166766
113522801900000,NE 105,RESIDENTIAL,26010,0,26010,164914,0,190924
113522802000000,NE 105,RESIDENTIAL,25102,0,25102,173295,0,198397
113522802100000,NE 105,RESIDENTIAL,23406,0,23406,151200,0,174606
113522900100000,NE 105,RESIDENTIAL,25718,0,25718,169071,0,194789
113522900200000,NE 105,RESIDENTIAL,22680,0,22680,164818,0,187498
113522900300000,NE 105,RESIDENTIAL,25200,0,25200,161271,0,186471
113522900400000,NE 105,RESIDENTIAL,25941,0,25941,149269,0,175210
113522900500000,NE 105,RESIDENTIAL,22344,0,22344,155512,0,177856
113522900600000,NE 105,RESIDENTIAL,22344,0,22344,129363,0,151707
113522900700000,NE 105,RESIDENTIAL,25380,0,25380,149343,0,174723
113522900800000,NE 105,RESIDENTIAL,24255,0,24255,186465,0,210720
113522900900000,NE 105,RESIDENTIAL,23625,0,23625,132802,0,156427
113522901000000,NE 105,RESIDENTIAL,25291,0,25291,141158,0,166449
113522901100000,NE 105,RESIDENTIAL,23573,0,23573,157233,0,180806
113522901200000,NE 105,RESIDENTIAL,22990,0,22990,180626,0,203616
113523000100000,NE 105,RESIDENTIAL,25273,0,25273,173577,0,198850
113523000200000,NE 105,RESIDENTIAL,24243,0,24243,190310,0,214553
113523000300000,NE 105,RESIDENTIAL,24354,0,24354,169222,0,193576
113523000400000,NE 105,RESIDENTIAL,24857,0,24857,151818,0,176675
113523000500000,NE 105,RESIDENTIAL,24960,0,24960,153634,0,178594
113523000600000,NE 105,RESIDENTIAL,24960,0,24960,190229,0,215189
113523000700000,NE 105,RESIDENTIAL,23712,0,23712,169616,0,193328
113523000800000,NE 105,RESIDENTIAL,26076,0,26076,181835,0,207911
113523000900000,NE 105,RESIDENTIAL,24597,0,24597,183872,0,208469
113523001000000,NE 105,RESIDENTIAL,24388,0,24388,158988,0,183376
113523001100000,NE 105,RESIDENTIAL,24480,0,24480,156293,0,180773
113523001200000,NE 105,RESIDENTIAL,24072,0,24072,157288,0,181360
113523001300000,NE 105,RESIDENTIAL,23358,0,23358,172781,0,196139
113523001400000,NE 105,RESIDENTIAL,23690,0,23690,164603,0,188293
113523001500000,NE 105,RESIDENTIAL,22725,0,22725,158259,0,180984
113523001600000,NE 105,RESIDENTIAL,25236,0,25236,172844,0,198080
113523001700000,NE 105,RESIDENTIAL,22500,0,22500,131608,0,154108
113523001800000,NE 105,RESIDENTIAL,24452,0,24452,155107,0,179559
113523001900000,NE 105,RESIDENTIAL,25532,0,25532,124863,0,150395
113523002000000,NE 105,RESIDENTIAL,25271,0,25271,178123,0,203394
113523002100000,NE 105,RESIDENTIAL,22725,0,22725,126853,0,149578
113523002200000,NE 105,RESIDENTIAL,24240,0,24240,159147,0,183387
113523002300000,NE 105,RESIDENTIAL,26260,0,26260,158968,0,185228
113523002400000,NE 105,RESIDENTIAL,22725,0,22725,159343,0,182068
113523002500000,NE 105,RESIDENTIAL,24240,0,24240,122324,0,146564
113523002600000,NE 105,RESIDENTIAL,25927,0,25927,157922,0,183849
113523002700000,NE 105,RESIDENTIAL,25650,0,25650,167743,0,193393
113523002800000,NE 105,RESIDENTIAL,25398,0,25398,121870,0,147268
113523002900000,NE 105,RESIDENTIAL,24824,0,24824,151536,0,176360
113523003000000,NE 105,RESIDENTIAL,26190,0,26190,141853,0,168043
113523003100000,NE 105,RESIDENTIAL,23680,0,23680,155334,0,179014
113523003200000,NE 105,RESIDENTIAL,24174,0,24174,142483,0,166657
113523003300000,NE 105,RESIDENTIAL,20624,0,20624,125621,0,146245
113523003400000,NE 105,RESIDENTIAL,25264,0,25264,120377,0,145641
113523003500000,NE 105,RESIDENTIAL,26275,0,26275,159818,0,186093
113523003600000,NE 105,RESIDENTIAL,21930,0,21930,122339,0,144269
113523003700000,NE 105,RESIDENTIAL,24585,0,24585,158946,0,183531
113523003800000,NE 105,RESIDENTIAL,22800,0,22800,153217,0,176017
113523003900000,NE 105,RESIDENTIAL,24558,0,24558,152054,0,176612
113523004000000,NE 105,RESIDENTIAL,23833,0,23833,125508,0,149341
113523004100000,NE 105,RESIDENTIAL,25789,0,25789,183688,0,209477
113523004200000,NE 105,RESIDENTIAL,25586,0,25586,174289,0,199875
113523004300000,NE 105,RESIDENTIAL,25137,0,25137,175336,0,200473
113523004400000,NE 105,RESIDENTIAL,25200,0,25200,164587,0,189787
113523004500000,NE 105,RESIDENTIAL,25224,0,25224,156509,0,181733
113523004600000,NE 105,RESIDENTIAL,24648,0,24648,155709,0,180357
113523004700000,NE 105,RESIDENTIAL,24495,0,24495,124375,0,148870
113523004800000,NE 105,RESIDENTIAL,24735,0,24735,178549,0,203284
113523100100000,NE 105,RESIDENTIAL,26254,0,26254,163922,0,190176
113523100200000,NE 105,RESIDENTIAL,23814,0,23814,166434,0,190248
113523100300000,NE 105,RESIDENTIAL,23955,0,23955,163389,0,187344
113523100400000,NE 105,RESIDENTIAL,25800,0,25800,171601,0,197401
113523100500000,NE 105,RESIDENTIAL,26343,0,26343,185015,0,211358
113523100600000,NE 105,RESIDENTIAL,25440,0,25440,173605,0,199045
113523100700000,NE 105,RESIDENTIAL,25393,0,25393,167571,0,192964
113523100800000,NE 105,RESIDENTIAL,26299,0,26299,143270,0,169569
113523100900000,NE 105,RESIDENTIAL,25494,0,25494,174592,0,200086
113525100100000,NE 107,RESIDENTIAL,25240,0,25240,140347,0,165587
113525100200000,NE 107,RESIDENTIAL,23197,0,23197,146951,0,170148
113525100300000,NE 107,RESIDENTIAL,22800,0,22800,180154,0,202954
113525100400000,NE 107,RESIDENTIAL,23040,0,23040,163071,0,186111
113525100500000,NE 107,RESIDENTIAL,23280,0,23280,156782,0,180062
113525100600000,NE 107,RESIDENTIAL,22275,0,22275,144389,0,166664
113525100700000,NE 107,RESIDENTIAL,24000,0,24000,155287,0,179287
113525100800000,NE 107,RESIDENTIAL,25500,0,25500,161466,0,186966
113525100900000,NE 107,RESIDENTIAL,24000,0,24000,179871,0,203871
113525101000000,NE 107,RESIDENTIAL,28350,0,28350,169183,0,197533
113525101100000,NE 107,RESIDENTIAL,24000,0,24000,174914,0,198914
113525101200000,NE 107,RESIDENTIAL,24000,0,24000,182698,0,206698
113525101300000,NE 107,RESIDENTIAL,24000,0,24000,154208,0,178208
113525101400000,NE 107,RESIDENTIAL,21600,0,21600,0,0,21600
113525101500000,NE 107,RESIDENTIAL,24000,0,24000,166685,0,190685
113525101600000,NE 107,RESIDENTIAL,23818,0,23818,134093,0,157911
113525101700000,NE 107,RESIDENTIAL,26196,0,26196,141056,0,167252
113525101800000,NE 107,RESIDENTIAL,23180,0,23180,167903,0,191083
113525200100000,NE 107,RESIDENTIAL,25888,0,25888,151806,0,177694
113525200200000,NE 107,RESIDENTIAL,25942,0,25942,178215,0,204157
113525200300000,NE 107,RESIDENTIAL,27841,0,27841,200083,0,227924
113525200400000,NE 107,RESIDENTIAL,29129,0,29129,182227,0,211356
113525200500000,NE 107,RESIDENTIAL,26058,0,26058,198955,0,225013
113525200600000,NE 107,RESIDENTIAL,23886,0,23886,176861,0,200747
113525200700000,NE 107,RESIDENTIAL,23496,0,23496,0,0,23496
113525200800000,NE 107,RESIDENTIAL,23100,0,23100,172031,0,195131
113525300100000,NE 107,RESIDENTIAL,20952,0,20952,115556,0,136508
113525300200000,NE 107,RESIDENTIAL,20708,0,20708,122822,0,143530
113525300300000,NE 107,RESIDENTIAL,24948,0,24948,104361,0,129309
113525300400000,NE 107,RESIDENTIAL,20790,0,20790,119655,0,140445
113525300500000,NE 107,RESIDENTIAL,25200,0,25200,108090,0,133290
113525300600000,NE 107,RESIDENTIAL,23400,0,23400,136247,0,159647
113525300700000,NE 107,RESIDENTIAL,21210,0,21210,137873,0,159083
113525300800000,NE 107,RESIDENTIAL,21420,0,21420,124935,0,146355
113525300900000,NE 107,RESIDENTIAL,19931,0,19931,120619,0,140550
113525301000000,NE 107,RESIDENTIAL,25404,0,25404,122660,0,148064
113525301100000,NE 107,RESIDENTIAL,24150,0,24150,137272,0,161422
113525301200000,NE 107,RESIDENTIAL,23833,0,23833,135058,0,158891
113525301300000,NE 107,RESIDENTIAL,22157,0,22157,101091,0,123248
113525301400000,NE 107,RESIDENTIAL,25975,0,25975,124919,0,150894
113525301500000,NE 107,RESIDENTIAL,23310,0,23310,96053,0,119363
113525301600000,NE 107,RESIDENTIAL,25260,0,25260,109665,0,134925
113525301700000,NE 107,RESIDENTIAL,25210,0,25210,131900,0,157110
113525301800000,NE 107,RESIDENTIAL,25525,0,25525,137084,0,162609
113525301900000,NE 107,RESIDENTIAL,26031,0,26031,114951,0,140982
113525302000000,NE 107,RESIDENTIAL,24010,0,24010,101853,0,125863
113525302100000,NE 107,RESIDENTIAL,24010,0,24010,124435,0,148445
113525302200000,NE 107,RESIDENTIAL,24010,0,24010,112215,0,136225
113525302300000,NE 107,RESIDENTIAL,24010,0,24010,118692,0,142702
113525400100000,NE 107,RESIDENTIAL,30278,0,30278,238487,0,268765
113525400200000,NE 107,RESIDENTIAL,28080,0,28080,193247,0,221327
113525400300000,NE 107,RESIDENTIAL,31489,0,31489,215665,0,247154
113525400400000,NE 107,RESIDENTIAL,26634,0,26634,120364,0,146998
113525400500000,NE 107,RESIDENTIAL,25725,0,25725,134165,0,159890
113525400600000,NE 107,RESIDENTIAL,24873,0,24873,118578,0,143451
113525400700000,NE 107,RESIDENTIAL,24417,0,24417,122648,0,147065
113525400800000,NE 107,RESIDENTIAL,24512,0,24512,122279,0,146791
113525400900000,NE 107,RESIDENTIAL,24907,0,24907,132965,0,157872
113525401000000,NE 107,RESIDENTIAL,23802,0,23802,126929,0,150731
113525401100000,NE 107,RESIDENTIAL,25323,0,25323,131246,0,156569
113525401200000,NE 107,RESIDENTIAL,25606,0,25606,114106,0,139712
113525401300000,NE 107,RESIDENTIAL,21612,0,21612,121633,0,143245
113525401400000,NE 107,RESIDENTIAL,22869,0,22869,104683,0,127552
113525401500000,NE 107,RESIDENTIAL,25916,0,25916,100233,0,126149
113525401600000,NE 107,RESIDENTIAL,23688,0,23688,104267,0,127955
113525401700000,NE 107,RESIDENTIAL,30216,0,30216,164858,0,195074
113525401800000,NE 107,RESIDENTIAL,31741,0,31741,166249,0,197990
113525401900000,NE 107,RESIDENTIAL,30059,0,30059,190852,0,220911
113525402000000,NE 107,RESIDENTIAL,29568,0,29568,167785,0,197353
113525402100000,NE 107,RESIDENTIAL,30696,0,30696,204466,0,235162
113525402200000,NE 107,RESIDENTIAL,24938,0,24938,115054,0,139992
113525402300000,NE 107,RESIDENTIAL,24938,0,24938,106058,0,130996
113525500100000,NE 107,RESIDENTIAL,22511,0,22511,119585,0,142096
113525500200000,NE 107,RESIDENTIAL,22290,0,22290,117408,0,139698
113525500300000,NE 107,RESIDENTIAL,22270,0,22270,114974,0,137244
113525500400000,NE 107,RESIDENTIAL,23896,0,23896,123847,0,147743
113525500500000,NE 107,RESIDENTIAL,24544,0,24544,119682,0,144226
113525500600000,NE 107,RESIDENTIAL,24197,0,24197,143219,0,167416
113525500700000,NE 107,RESIDENTIAL,24393,0,24393,120432,0,144825
113525500800000,NE 107,RESIDENTIAL,21258,0,21258,105233,0,126491
113525500900000,NE 107,RESIDENTIAL,20671,0,20671,131702,0,152373
113525501000000,NE 107,RESIDENTIAL,24498,0,24498,131507,0,156005
113525501100000,NE 107,RESIDENTIAL,23140,0,23140,107162,0,130302
113525501200000,NE 107,RESIDENTIAL,21868,0,21868,126675,0,148543
113525501300000,NE 107,RESIDENTIAL,25267,0,25267,164918,0,190185
113525501400000,NE 107,RESIDENTIAL,24872,0,24872,117303,0,142175
113525501500000,NE 107,RESIDENTIAL,25841,0,25841,110447,0,136288
113525501600000,NE 107,RESIDENTIAL,25906,0,25906,121324,0,147230
113525501700000,NE 107,RESIDENTIAL,26250,0,26250,124650,0,150900
113525501800000,NE 107,RESIDENTIAL,26003,0,26003,116352,0,142355
113525501900000,NE 107,RESIDENTIAL,25988,0,25988,136770,0,162758
113525502000000,NE 107,RESIDENTIAL,25988,0,25988,138564,0,164552
113525502100000,NE 107,RESIDENTIAL,25988,0,25988,132403,0,158391
113525600100000,NE 107,RESIDENTIAL,23478,0,23478,126265,0,149743
113525600200000,NE 107,RESIDENTIAL,25686,0,25686,111285,0,136971
113525600300000,NE 107,RESIDENTIAL,25436,0,25436,108341,0,133777
113525600400000,NE 107,RESIDENTIAL,26489,0,26489,123304,0,149793
113525600500000,NE 107,RESIDENTIAL,26307,0,26307,105670,0,131977
113525600600000,NE 107,RESIDENTIAL,25599,0,25599,114076,0,139675
113525600700000,NE 107,RESIDENTIAL,25416,0,25416,117944,0,143360
113525600800000,NE 107,RESIDENTIAL,25305,0,25305,134380,0,159685
113525600900000,NE 107,RESIDENTIAL,26813,0,26813,166604,0,193417
113525601000000,NE 107,RESIDENTIAL,26281,0,26281,122089,0,148370
113525601100000,NE 107,RESIDENTIAL,24038,0,24038,103368,0,127406
113525700100000,NE 107,RESIDENTIAL,25490,0,25490,92460,0,117950
113525700200000,NE 107,RESIDENTIAL,25827,0,25827,137218,0,163045
113525700300000,NE 107,RESIDENTIAL,25358,0,25358,105712,0,131070
113525700400000,NE 107,RESIDENTIAL,25917,0,25917,135639,0,161556
113525800100000,NE 107,RESIDENTIAL,26726,0,26726,122074,0,148800
113525800200000,NE 107,RESIDENTIAL,26006,0,26006,119430,0,145436
113525800300000,NE 107,RESIDENTIAL,25235,0,25235,125095,0,150330
113525800400000,NE 107,RESIDENTIAL,25988,0,25988,114263,0,140251
113525800500000,NE 107,RESIDENTIAL,25436,0,25436,113229,0,138665
113525800600000,NE 107,RESIDENTIAL,23559,0,23559,115746,0,139305
113525800700000,NE 107,RESIDENTIAL,20447,0,20447,117427,0,137874
113527600100000,NE 107,RESIDENTIAL,21000,0,21000,153660,0,174660
113527600200000,NE 107,RESIDENTIAL,22500,0,22500,159225,0,181725
113527600300000,NE 107,RESIDENTIAL,24898,0,24898,153253,0,178151
113527600400000,NE 107,RESIDENTIAL,23910,0,23910,159579,0,183489
113527700100000,NE 107,RESIDENTIAL,26507,0,26507,159620,0,186127
113527700200000,NE 107,RESIDENTIAL,22104,0,22104,147523,0,169627
113527700300000,NE 107,RESIDENTIAL,22998,0,22998,159464,0,182462
113527700400000,NE 107,RESIDENTIAL,23994,0,23994,146894,0,170888
113527700500000,NE 107,RESIDENTIAL,23760,0,23760,158311,0,182071
113527700600000,NE 107,RESIDENTIAL,19200,0,19200,150786,0,169986
113527700700000,NE 107,RESIDENTIAL,21420,0,21420,166135,0,187555
113527700800000,NE 107,RESIDENTIAL,24480,0,24480,156144,0,180624
113527700900000,NE 107,RESIDENTIAL,26163,0,26163,144814,0,170977
113527701000000,NE 107,RESIDENTIAL,23520,0,23520,162687,0,186207
113527701100000,NE 107,RESIDENTIAL,23520,0,23520,180023,0,203543
113527701200000,NE 107,RESIDENTIAL,20580,0,20580,139910,0,160490
113527701300000,NE 107,RESIDENTIAL,22950,0,22950,161308,0,184258
113527701400000,NE 107,RESIDENTIAL,26365,0,26365,144188,0,170553
113527701500000,NE 107,RESIDENTIAL,23427,0,23427,176551,0,199978
113527701600000,NE 107,RESIDENTIAL,20332,0,20332,157927,0,178259
113527701700000,NE 107,RESIDENTIAL,25718,0,25718,164519,0,190237
113527701800000,NE 107,RESIDENTIAL,22295,0,22295,149110,0,171405
113527701900000,NE 107,RESIDENTIAL,25317,0,25317,168203,0,193520
113527702000000,NE 107,RESIDENTIAL,25004,0,25004,156335,0,181339
113527800100000,NE 107,RESIDENTIAL,22116,0,22116,156811,0,178927
113527800200000,NE 107,RESIDENTIAL,21462,0,21462,163302,0,184764
113527800300000,NE 107,RESIDENTIAL,20988,0,20988,154290,0,175278
113527800400000,NE 107,RESIDENTIAL,18563,0,18563,153144,0,171707
113527800500000,NE 107,RESIDENTIAL,21518,0,21518,173439,0,194957
113527800600000,NE 107,RESIDENTIAL,25650,0,25650,152874,0,178524
113527800700000,NE 107,RESIDENTIAL,25650,0,25650,140566,0,166216
113527800800000,NE 107,RESIDENTIAL,22800,0,22800,162545,0,185345
113527800900000,NE 107,RESIDENTIAL,18303,0,18303,149921,0,168224
113527801000000,NE 107,RESIDENTIAL,18330,0,18330,154717,0,173047
113527900100000,NE 107,RESIDENTIAL,21375,0,21375,162709,0,184084
113527900200000,NE 107,RESIDENTIAL,24500,0,24500,154044,0,178544
113527900300000,NE 107,RESIDENTIAL,25602,0,25602,147534,0,173136
113527900400000,NE 107,RESIDENTIAL,25625,0,25625,152104,0,177729
113527900500000,NE 107,RESIDENTIAL,25650,0,25650,162352,0,188002
113527900600000,NE 107,RESIDENTIAL,22800,0,22800,170449,0,193249
113527900700000,NE 107,RESIDENTIAL,19950,0,19950,160264,0,180214
113527900800000,NE 107,RESIDENTIAL,19665,0,19665,152944,0,172609
113528000100000,NE 107,RESIDENTIAL,25578,0,25578,162455,0,188033
113528000200000,NE 107,RESIDENTIAL,21898,0,21898,149731,0,171629
113528000300000,NE 107,RESIDENTIAL,25293,0,25293,110313,0,135606
113528000400000,NE 107,RESIDENTIAL,26074,0,26074,116092,0,142166
113528000500000,NE 107,RESIDENTIAL,26068,0,26068,158208,0,184276
113528000600000,NE 107,RESIDENTIAL,25313,0,25313,134361,0,159674
113528000700000,NE 107,RESIDENTIAL,25468,0,25468,127437,0,152905
113528000800000,NE 107,RESIDENTIAL,26277,0,26277,154776,0,181053
113528000900000,NE 107,RESIDENTIAL,25463,0,25463,115921,0,141384
113528100100000,NE 107,RESIDENTIAL,28952,0,28952,125131,0,154083
113528100200000,NE 107,RESIDENTIAL,20424,0,20424,137870,0,158294
113528100300000,NE 107,RESIDENTIAL,22843,0,22843,165274,0,188117
113528100400000,NE 107,RESIDENTIAL,18612,0,18612,141804,0,160416
113528100500000,NE 107,RESIDENTIAL,23124,0,23124,130293,0,153417
113528100600000,NE 107,RESIDENTIAL,19740,0,19740,136530,0,156270
113528100700000,NE 107,RESIDENTIAL,18189,0,18189,145288,0,163477
113528100800000,NE 107,RESIDENTIAL,19740,0,19740,137203,0,156943
113528100900000,NE 107,RESIDENTIAL,23688,0,23688,114844,0,138532
113528101000000,NE 107,RESIDENTIAL,19740,0,19740,114441,0,134181
113528101100000,NE 107,RESIDENTIAL,26436,0,26436,129233,0,155669
113528101200000,NE 107,RESIDENTIAL,20898,0,20898,111005,0,131903
113528101300000,NE 107,RESIDENTIAL,22908,0,22908,126463,0,149371
113528101400000,NE 107,RESIDENTIAL,21221,0,21221,120872,0,142093
113528101500000,NE 107,RESIDENTIAL,21221,0,21221,109515,0,130736
113528101600000,NE 107,RESIDENTIAL,21221,0,21221,150119,0,171340
113528101700000,NE 107,RESIDENTIAL,21221,0,21221,119213,0,140434
113528101800000,NE 107,RESIDENTIAL,21221,0,21221,118441,0,139662
113528101900000,NE 107,RESIDENTIAL,19740,0,19740,110561,0,130301
113528102000000,NE 107,RESIDENTIAL,19740,0,19740,121968,0,141708
113528102100000,NE 107,RESIDENTIAL,19740,0,19740,109144,0,128884
113528102200000,NE 107,RESIDENTIAL,21824,0,21824,126817,0,148641
113528102300000,NE 107,RESIDENTIAL,20676,0,20676,129935,0,150611
113528102400000,NE 107,RESIDENTIAL,22932,0,22932,139781,0,162713
113528102500000,NE 107,RESIDENTIAL,20898,0,20898,136212,0,157110
113528200100000,NE 107,RESIDENTIAL,25114,0,25114,117949,0,143063
113528200200000,NE 107,RESIDENTIAL,20700,0,20700,125775,0,146475
113528200300000,NE 107,RESIDENTIAL,19997,0,19997,134916,0,154913
113528200400000,NE 107,RESIDENTIAL,21728,0,21728,104882,0,126610
113528200500000,NE 107,RESIDENTIAL,22035,0,22035,122077,0,144112
113528200600000,NE 107,RESIDENTIAL,26150,0,26150,151855,0,178005
113528200700000,NE 107,RESIDENTIAL,21363,0,21363,114189,0,135552
113528300100000,NE 107,RESIDENTIAL,25035,0,25035,118071,0,143106
113528300200000,NE 107,RESIDENTIAL,24631,0,24631,130469,0,155100
113528300300000,NE 107,RESIDENTIAL,23545,0,23545,131476,0,155021
113528300400000,NE 107,RESIDENTIAL,22860,0,22860,110528,0,133388
113528300500000,NE 107,RESIDENTIAL,22349,0,22349,129506,0,151855
113528300600000,NE 107,RESIDENTIAL,21672,0,21672,127552,0,149224
113528300700000,NE 107,RESIDENTIAL,21221,0,21221,106993,0,128214
113528300800000,NE 107,RESIDENTIAL,21221,0,21221,126544,0,147765
113528300900000,NE 107,RESIDENTIAL,21221,0,21221,110732,0,131953
113528301000000,NE 107,RESIDENTIAL,21221,0,21221,127251,0,148472
113528301100000,NE 107,RESIDENTIAL,21221,0,21221,112807,0,134028
113528301200000,NE 107,RESIDENTIAL,21446,0,21446,115054,0,136500
113528301300000,NE 107,RESIDENTIAL,21898,0,21898,126677,0,148575
113528301400000,NE 107,RESIDENTIAL,22153,0,22153,109080,0,131233
113528301500000,NE 107,RESIDENTIAL,21093,0,21093,138482,0,159575
113528301600000,NE 107,RESIDENTIAL,20836,0,20836,127604,0,148440
113528301700000,NE 107,RESIDENTIAL,20790,0,20790,124760,0,145550
113528301800000,NE 107,RESIDENTIAL,20790,0,20790,106951,0,127741
113528301900000,NE 107,RESIDENTIAL,22181,0,22181,102643,0,124824
113528302000000,NE 107,RESIDENTIAL,22181,0,22181,122210,0,144391
113528302100000,NE 107,RESIDENTIAL,22181,0,22181,118955,0,141136
113528302200000,NE 107,RESIDENTIAL,22942,0,22942,127402,0,150344
113528302300000,NE 107,RESIDENTIAL,22180,0,22180,118848,0,141028
113528302400000,NE 107,RESIDENTIAL,21221,0,21221,108547,0,129768
113528302500000,NE 107,RESIDENTIAL,21714,0,21714,127554,0,149268
113528302600000,NE 107,RESIDENTIAL,25481,0,25481,145233,0,170714
113528302700000,NE 107,RESIDENTIAL,24384,0,24384,128965,0,153349
113528302800000,NE 107,RESIDENTIAL,25164,0,25164,129696,0,154860
113528302900000,NE 107,RESIDENTIAL,21221,0,21221,106180,0,127401
113528303000000,NE 107,RESIDENTIAL,20069,0,20069,125203,0,145272
113528303100000,NE 107,RESIDENTIAL,21735,0,21735,124810,0,146545
113528400100000,NE 107,RESIDENTIAL,26085,0,26085,101711,0,127796
113528400200000,NE 107,RESIDENTIAL,25930,0,25930,131323,0,157253
113528400300000,NE 107,RESIDENTIAL,25463,0,25463,124553,0,150016
113528400400000,NE 107,RESIDENTIAL,25187,0,25187,104327,0,129514
113528500100000,NE 107,RESIDENTIAL,26639,0,26639,125861,0,152500
113528500200000,NE 107,RESIDENTIAL,25420,0,25420,123242,0,148662
113528500300000,NE 107,RESIDENTIAL,23417,0,23417,125056,0,148473
113528500400000,NE 107,RESIDENTIAL,24948,0,24948,109151,0,134099
113528500500000,NE 107,RESIDENTIAL,24570,0,24570,132366,0,156936
113528500600000,NE 107,RESIDENTIAL,24381,0,24381,108471,0,132852
113528500700000,NE 107,RESIDENTIAL,24155,0,24155,159166,0,183321
113528500800000,NE 107,RESIDENTIAL,23930,0,23930,119133,0,143063
113528500900000,NE 107,RESIDENTIAL,23704,0,23704,113408,0,137112
113528501000000,NE 107,RESIDENTIAL,25491,0,25491,132386,0,157877
113528501100000,NE 107,RESIDENTIAL,22801,0,22801,129141,0,151942
113528501200000,NE 107,RESIDENTIAL,25436,0,25436,106771,0,132207
113528501300000,NE 107,RESIDENTIAL,23478,0,23478,105453,0,128931
113528501400000,NE 107,RESIDENTIAL,25370,0,25370,142845,0,168215
113528501500000,NE 107,RESIDENTIAL,26088,0,26088,140370,0,166458
113528501600000,NE 107,RESIDENTIAL,25881,0,25881,117184,0,143065
113530100100000,NE 107,RESIDENTIAL,30544,0,30544,118498,0,149042
113530100200000,NE 107,RESIDENTIAL,24010,0,24010,116388,0,140398
113530100300000,NE 107,RESIDENTIAL,25063,0,25063,143137,0,168200
113530100400000,NE 107,RESIDENTIAL,25407,0,25407,131887,0,157294
113530100500000,NE 107,RESIDENTIAL,25099,0,25099,126387,0,151486
113530200100000,NE 107,RESIDENTIAL,25987,0,25987,154987,0,180974
113530200200000,NE 107,RESIDENTIAL,25440,0,25440,126056,0,151496
113530200300000,NE 107,RESIDENTIAL,23793,0,23793,110697,0,134490
113530200400000,NE 107,RESIDENTIAL,26156,0,26156,126918,0,153074
113530200500000,NE 107,RESIDENTIAL,25952,0,25952,110867,0,136819
113530200600000,NE 107,RESIDENTIAL,25867,0,25867,120226,0,146093
113530200700000,NE 107,RESIDENTIAL,26082,0,26082,137598,0,163680
113530200800000,NE 107,RESIDENTIAL,26065,0,26065,117383,0,143448
113530200900000,NE 107,RESIDENTIAL,26301,0,26301,155688,0,181989
113530201000000,NE 107,RESIDENTIAL,25704,0,25704,153518,0,179222
113530201100000,NE 107,RESIDENTIAL,25711,0,25711,131250,0,156961
113530201200000,NE 107,RESIDENTIAL,23426,0,23426,125244,0,148670
113530201300000,NE 107,RESIDENTIAL,21280,0,21280,115880,0,137160
113530201400000,NE 107,RESIDENTIAL,24938,0,24938,106605,0,131543
113530201500000,NE 107,RESIDENTIAL,21056,0,21056,124751,0,145807
113530201600000,NE 107,RESIDENTIAL,21359,0,21359,147527,0,168886
113530201700000,NE 107,RESIDENTIAL,22277,0,22277,135734,0,158011
113530201800000,NE 107,RESIDENTIAL,23683,0,23683,141948,0,165631
113530201900000,NE 107,RESIDENTIAL,24514,0,24514,117244,0,141758
113530202000000,NE 107,RESIDENTIAL,25268,0,25268,132700,0,157968
113530202100000,NE 107,RESIDENTIAL,26264,0,26264,107641,0,133905
113530202200000,NE 107,RESIDENTIAL,24239,0,24239,112161,0,136400
113530202300000,NE 107,RESIDENTIAL,22977,0,22977,110985,0,133962
113530202400000,NE 107,RESIDENTIAL,25010,0,25010,125375,0,150385
113530202500000,NE 107,RESIDENTIAL,24897,0,24897,127610,0,152507
113530202600000,NE 107,RESIDENTIAL,20809,0,20809,98049,0,118858
113530202700000,NE 107,RESIDENTIAL,25684,0,25684,107051,0,132735
113530202800000,NE 107,RESIDENTIAL,25115,0,25115,116986,0,142101
113530202900000,NE 107,RESIDENTIAL,24733,0,24733,119891,0,144624
113530203000000,NE 107,RESIDENTIAL,28088,0,28088,150241,0,178329
113530203100000,NE 107,RESIDENTIAL,26214,0,26214,135855,0,162069
113530203200000,NE 107,RESIDENTIAL,25853,0,25853,100252,0,126105
113530300100000,NE 107,RESIDENTIAL,25004,0,25004,131153,0,156157
113530400100000,NE 107,RESIDENTIAL,26565,0,26565,151927,0,178492
113530400200000,NE 107,RESIDENTIAL,25116,0,25116,136225,0,161341
113530400300000,NE 107,RESIDENTIAL,25725,0,25725,100599,0,126324
113530400400000,NE 107,RESIDENTIAL,26225,0,26225,147988,0,174213
113530400500000,NE 107,RESIDENTIAL,26239,0,26239,122766,0,149005
113530400600000,NE 107,RESIDENTIAL,25436,0,25436,115475,0,140911
113530400700000,NE 107,RESIDENTIAL,26185,0,26185,117000,0,143185
113530400800000,NE 107,RESIDENTIAL,25502,0,25502,124750,0,150252
113530400900000,NE 107,RESIDENTIAL,24514,0,24514,125496,0,150010
113530401000000,NE 107,RESIDENTIAL,24148,0,24148,104679,0,128827
113530401100000,NE 107,RESIDENTIAL,25436,0,25436,129098,0,154534
113530401200000,NE 107,RESIDENTIAL,26567,0,26567,181254,0,207821
113530401300000,NE 107,RESIDENTIAL,25853,0,25853,140081,0,165934
113530401400000,NE 107,RESIDENTIAL,26973,0,26973,116074,0,143047
113530401500000,NE 107,RESIDENTIAL,21929,0,21929,101107,0,123036
113530500100000,NE 107,RESIDENTIAL,25780,0,25780,110544,0,136324
113530500200000,NE 107,RESIDENTIAL,23053,0,23053,104541,0,127594
113530500300000,NE 107,RESIDENTIAL,21162,0,21162,109957,0,131119
113530500400000,NE 107,RESIDENTIAL,21851,0,21851,131853,0,153704
113530500500000,NE 107,RESIDENTIAL,21446,0,21446,115253,0,136699
113530500600000,NE 107,RESIDENTIAL,21446,0,21446,113553,0,134999
113530500700000,NE 107,RESIDENTIAL,24938,0,24938,128515,0,153453
113530500800000,NE 107,RESIDENTIAL,24938,0,24938,123943,0,148881
113530500900000,NE 107,RESIDENTIAL,24938,0,24938,123765,0,148703
113530501000000,NE 107,RESIDENTIAL,24938,0,24938,105651,0,130589
113530501100000,NE 107,RESIDENTIAL,26250,0,26250,129749,0,155999
113530501200000,NE 107,RESIDENTIAL,22261,0,22261,109398,0,131659
113530501300000,NE 107,RESIDENTIAL,26549,0,26549,145341,0,171890
113530501400000,NE 107,RESIDENTIAL,21446,0,21446,137289,0,158735
113530501500000,NE 107,RESIDENTIAL,21446,0,21446,137502,0,158948
113530501600000,NE 107,RESIDENTIAL,21446,0,21446,132016,0,153462
113530501700000,NE 107,RESIDENTIAL,21446,0,21446,122199,0,143645
113530501800000,NE 107,RESIDENTIAL,24938,0,24938,144529,0,169467
113530501900000,NE 107,RESIDENTIAL,21446,0,21446,130919,0,152365
113530502000000,NE 107,RESIDENTIAL,21673,0,21673,120642,0,142315
113530502100000,NE 107,RESIDENTIAL,23327,0,23327,130847,0,154174
113530502200000,NE 107,RESIDENTIAL,25888,0,25888,110054,0,135942
113530502300000,NE 107,RESIDENTIAL,21125,0,21125,123859,0,144984
113530600100000,NE 107,RESIDENTIAL,27370,0,27370,127630,0,155000
113530600200000,NE 107,RESIDENTIAL,25157,0,25157,128811,0,153968
113530600300000,NE 107,RESIDENTIAL,22575,0,22575,139972,0,162547
113530600400000,NE 107,RESIDENTIAL,18060,0,18060,126063,0,144123
113530600500000,NE 107,RESIDENTIAL,22575,0,22575,140532,0,163107
113530600600000,NE 107,RESIDENTIAL,22575,0,22575,118836,0,141411
113530600700000,NE 107,RESIDENTIAL,22575,0,22575,117070,0,139645
113530600800000,NE 107,RESIDENTIAL,22575,0,22575,125113,0,147688
113530600900000,NE 107,RESIDENTIAL,24627,0,24627,123491,0,148118
113530601000000,NE 107,RESIDENTIAL,25722,0,25722,130010,0,155732
113530601100000,NE 107,RESIDENTIAL,25935,0,25935,129528,0,155463
113530601200000,NE 107,RESIDENTIAL,25915,0,25915,115917,0,141832
113530601300000,NE 107,RESIDENTIAL,28224,0,28224,133348,0,161572
113530601400000,NE 107,RESIDENTIAL,29260,0,29260,132895,0,162155
113530601500000,NE 107,RESIDENTIAL,27899,0,27899,110104,0,138003
113530601600000,NE 107,RESIDENTIAL,25545,0,25545,109781,0,135326
113530601700000,NE 107,RESIDENTIAL,23520,0,23520,132791,0,156311
113530601800000,NE 107,RESIDENTIAL,25984,0,25984,101818,0,127802
113530601900000,NE 107,RESIDENTIAL,25802,0,25802,134162,0,159964
113530602000000,NE 107,RESIDENTIAL,27812,0,27812,119095,0,146907
113530602100000,NE 107,RESIDENTIAL,30269,0,30269,126282,0,156551
113530602200000,NE 107,RESIDENTIAL,31818,0,31818,159707,0,191525
113530602300000,NE 107,RESIDENTIAL,26454,0,26454,127685,0,154139
113530602400000,NE 107,RESIDENTIAL,25595,0,25595,104691,0,130286
113530602500000,NE 107,RESIDENTIAL,19396,0,19396,128660,0,148056
113530602600000,NE 107,RESIDENTIAL,24868,0,24868,126118,0,150986
113530602700000,NE 107,RESIDENTIAL,21221,0,21221,107294,0,128515
113530602800000,NE 107,RESIDENTIAL,25148,0,25148,140299,0,165447
113530602900000,NE 107,RESIDENTIAL,21039,0,21039,127795,0,148834
113530603000000,NE 107,RESIDENTIAL,19866,0,19866,112015,0,131881
113530700100000,NE 107,RESIDENTIAL,25725,0,25725,128190,0,153915
113530700200000,NE 107,RESIDENTIAL,26185,0,26185,138155,0,164340
113530700300000,NE 107,RESIDENTIAL,26460,0,26460,141013,0,167473
113530700400000,NE 107,RESIDENTIAL,26056,0,26056,131270,0,157326
113530700500000,NE 107,RESIDENTIAL,27232,0,27232,130574,0,157806
113530700600000,NE 107,RESIDENTIAL,27930,0,27930,134140,0,162070
113530800100000,NE 107,RESIDENTIAL,26460,0,26460,114673,0,141133
113530800200000,NE 107,RESIDENTIAL,25468,0,25468,140196,0,165664
113530800300000,NE 107,RESIDENTIAL,25358,0,25358,124414,0,149772
113530800400000,NE 107,RESIDENTIAL,23888,0,23888,122140,0,146028
113530800500000,NE 107,RESIDENTIAL,25468,0,25468,118656,0,144124
113530800600000,NE 107,RESIDENTIAL,26521,0,26521,118455,0,144976
113530800700000,NE 107,RESIDENTIAL,30243,0,30243,131800,0,162043
113530800800000,NE 107,RESIDENTIAL,28538,0,28538,157248,0,185786
113530800900000,NE 107,RESIDENTIAL,28839,0,28839,167254,0,196093
113530801000000,NE 107,RESIDENTIAL,26347,0,26347,163114,0,189461
113532600100000,NE 107,RESIDENTIAL,26649,0,26649,122804,0,149453
113532600600000,NE 107,RESIDENTIAL,25347,0,25347,104272,0,129619
113532700100000,NE 107,RESIDENTIAL,26370,0,26370,142268,0,168638
113532700200000,NE 107,RESIDENTIAL,26422,0,26422,111868,0,138290
113532700300000,NE 107,RESIDENTIAL,24444,0,24444,127249,0,151693
113532700400000,NE 107,RESIDENTIAL,23940,0,23940,96070,0,120010
113532700500000,NE 107,RESIDENTIAL,26355,0,26355,133995,0,160350
113532700600000,NE 107,RESIDENTIAL,25366,0,25366,137094,0,162460
113532700700000,NE 107,RESIDENTIAL,25257,0,25257,94884,0,120141
113532700800000,NE 107,RESIDENTIAL,25071,0,25071,106336,0,131407
113532700900000,NE 107,RESIDENTIAL,24871,0,24871,125986,0,150857
113532701000000,NE 107,RESIDENTIAL,24010,0,24010,118591,0,142601
113532800100000,CHURCH,EXEMPT,0,421632,421632,0,474234,895866
113532800200000,NE 107,RESIDENTIAL,25464,0,25464,122650,0,148114
113532800300000,NE 107,RESIDENTIAL,25436,0,25436,137727,0,163163
113532800400000,NE 107,RESIDENTIAL,23134,0,23134,137158,0,160292
113532800500000,NE 107,RESIDENTIAL,23134,0,23134,127118,0,150252
113532800600000,NE 107,RESIDENTIAL,24276,0,24276,127987,0,152263
113532800700000,NE 107,RESIDENTIAL,25061,0,25061,134511,0,159572
113532800800000,NE 107,RESIDENTIAL,25806,0,25806,143469,0,169275
113532800900000,NE 107,RESIDENTIAL,26979,0,26979,130426,0,157405
113532900100000,NE 107,RESIDENTIAL,25836,0,25836,131958,0,157794
113532900200000,NE 107,RESIDENTIAL,23399,0,23399,93971,0,117370
113532900300000,NE 107,RESIDENTIAL,26855,0,26855,127566,0,154421
113532900400000,NE 107,RESIDENTIAL,22540,0,22540,103646,0,126186
113532900500000,NE 107,RESIDENTIAL,25123,0,25123,110642,0,135765
113533000100000,NE 107,RESIDENTIAL,25728,0,25728,111059,0,136787
113533000200000,NE 107,RESIDENTIAL,25430,0,25430,116402,0,141832
113533000300000,NE 107,RESIDENTIAL,25760,0,25760,130009,0,155769
113533000400000,NE 107,RESIDENTIAL,25161,0,25161,121404,0,146565
113533000500000,NE 107,RESIDENTIAL,25108,0,25108,93096,0,118204
113533000600000,NE 107,RESIDENTIAL,26250,0,26250,123613,0,149863
113533000700000,NE 107,RESIDENTIAL,26972,0,26972,100032,0,127004
113533000800000,NE 107,RESIDENTIAL,26239,0,26239,117701,0,143940
113533000900000,NE 107,RESIDENTIAL,25794,0,25794,124903,0,150697
113533001000000,NE 107,RESIDENTIAL,25490,0,25490,130939,0,156429
113533001100000,NE 107,RESIDENTIAL,25935,0,25935,121206,0,147141
113533001200000,NE 107,RESIDENTIAL,24938,0,24938,96572,0,121510
113533001300000,NE 107,RESIDENTIAL,25704,0,25704,102594,0,128298
113533001400000,NE 107,RESIDENTIAL,25933,0,25933,107556,0,133489
113533001500000,NE 107,RESIDENTIAL,25379,0,25379,121479,0,146858
113533001600000,NE 107,RESIDENTIAL,26712,0,26712,134746,0,161458
113533001700000,NE 107,RESIDENTIAL,26040,0,26040,136498,0,162538
113533001800000,NE 107,RESIDENTIAL,26101,0,26101,135096,0,161197
113533001900000,NE 107,RESIDENTIAL,25400,0,25400,125679,0,151079
113533002000000,NE 107,RESIDENTIAL,24881,0,24881,115140,0,140021
113533002100000,NE 107,RESIDENTIAL,24494,0,24494,124003,0,148497
113533002200000,NE 107,RESIDENTIAL,23828,0,23828,128027,0,151855
113533002300000,NE 107,RESIDENTIAL,26184,0,26184,114162,0,140346
113533100100000,NE 107,RESIDENTIAL,25558,0,25558,138670,0,164228
113533100200000,NE 107,RESIDENTIAL,27070,0,27070,122152,0,149222
113533100300000,NE 107,RESIDENTIAL,25565,0,25565,152121,0,177686
113533100400000,NE 107,RESIDENTIAL,25565,0,25565,111682,0,137247
113533100500000,NE 107,EXEMPT,0,25456,25456,0,122978,148434
113533100600000,NE 107,RESIDENTIAL,25294,0,25294,106077,0,131371
113533100700000,NE 107,RESIDENTIAL,25550,0,25550,98685,0,124235
113533100800000,NE 107,RESIDENTIAL,26567,0,26567,97134,0,123701
113533100900000,NE 107,RESIDENTIAL,26371,0,26371,131333,0,157704
113533101000000,NE 107,RESIDENTIAL,25187,0,25187,141747,0,166934
113533101100000,NE 107,RESIDENTIAL,26419,0,26419,102696,0,129115
113533101200000,NE 107,RESIDENTIAL,26068,0,26068,129413,0,155481
113533101300000,NE 107,RESIDENTIAL,25159,0,25159,139602,0,164761
113533101400000,NE 107,RESIDENTIAL,26567,0,26567,109408,0,135975
113533101500000,NE 107,RESIDENTIAL,23027,0,23027,117714,0,140741
113533101600000,NE 107,RESIDENTIAL,25760,0,25760,120050,0,145810
113533101700000,NE 107,RESIDENTIAL,22540,0,22540,110197,0,132737
113533101800000,NE 107,RESIDENTIAL,25430,0,25430,165171,0,190601
113533101900000,NE 107,RESIDENTIAL,25855,0,25855,132403,0,158258
113533102000000,NE 107,RESIDENTIAL,26697,0,26697,141407,0,168104
113533102100000,NE 107,RESIDENTIAL,25872,0,25872,119489,0,145361
113533102200000,NE 107,RESIDENTIAL,23660,0,23660,128306,0,151966
113533102300000,NE 107,RESIDENTIAL,25073,0,25073,135774,0,160847
113533102400000,NE 107,RESIDENTIAL,26712,0,26712,141807,0,168519
113533102500000,NE 107,RESIDENTIAL,30642,0,30642,150101,0,180743
113533102600000,NE 107,RESIDENTIAL,29575,0,29575,117372,0,146947
113533102700000,NE 107,RESIDENTIAL,26444,0,26444,78781,0,105225
113533102800000,NE 107,RESIDENTIAL,26185,0,26185,109552,0,135737
113533102900000,NE 107,RESIDENTIAL,26434,0,26434,132483,0,158917
113533103000000,NE 107,RESIDENTIAL,26250,0,26250,105209,0,131459
113533103100000,NE 107,RESIDENTIAL,26507,0,26507,119318,0,145825
113533103200000,NE 107,RESIDENTIAL,27741,0,27741,145440,0,173181
113533103300000,NE 107,RESIDENTIAL,34726,0,34726,117886,0,152612
113533103400000,NE 107,RESIDENTIAL,32889,0,32889,125351,0,158240
113533200100000,NE 107,RESIDENTIAL,25035,0,25035,134571,0,159606
113533200200000,NE 107,RESIDENTIAL,25725,0,25725,127671,0,153396
113533200300000,NE 107,RESIDENTIAL,25725,0,25725,159709,0,185434
113533200400000,NE 107,RESIDENTIAL,26250,0,26250,137762,0,164012
113533200500000,NE 107,RESIDENTIAL,26250,0,26250,143851,0,170101
113533200600000,NE 107,RESIDENTIAL,26250,0,26250,133822,0,160072
113533200700000,NE 107,RESIDENTIAL,22750,0,22750,121420,0,144170
113533200800000,NE 107,RESIDENTIAL,26250,0,26250,123949,0,150199
113533200900000,NE 107,RESIDENTIAL,25725,0,25725,130434,0,156159
113533201000000,NE 107,RESIDENTIAL,25802,0,25802,156570,0,182372
113533201100000,NE 107,RESIDENTIAL,26334,0,26334,146692,0,173026
113533201200000,NE 107,RESIDENTIAL,26233,0,26233,137064,0,163297
113533201300000,NE 107,RESIDENTIAL,22727,0,22727,129598,0,152325
113533201400000,NE 107,RESIDENTIAL,22680,0,22680,139971,0,162651
113533201500000,NE 107,RESIDENTIAL,22680,0,22680,132360,0,155040
113533201600000,NE 107,RESIDENTIAL,22680,0,22680,120293,0,142973
113533201700000,NE 107,RESIDENTIAL,26934,0,26934,110552,0,137486
113535100300000,NE 164,RESIDENTIAL,31442,0,31442,206637,0,238079
113535100400000,NE 164,RESIDENTIAL,30453,0,30453,132573,0,163026
113535100500000,NE 164,RESIDENTIAL,30294,0,30294,133924,0,164218
113535100600000,NE 164,RESIDENTIAL,30972,0,30972,153405,0,184377
113535100700000,NE 164,RESIDENTIAL,31580,0,31580,205898,0,237478
113535100800000,NE 164,RESIDENTIAL,32742,0,32742,174281,0,207023
113535100900000,NE 164,RESIDENTIAL,29964,0,29964,172694,0,202658
113535101000000,NE 164,RESIDENTIAL,30251,0,30251,169018,0,199269
113535101100000,NE 164,RESIDENTIAL,31167,0,31167,207433,0,238600
113535101200000,NE 164,RESIDENTIAL,28000,0,28000,182309,0,210309
113535101300000,NE 164,RESIDENTIAL,32040,0,32040,167371,0,199411
113535101400000,NE 164,RESIDENTIAL,29433,0,29433,192116,0,221549
113535101500000,NE 164,RESIDENTIAL,28062,0,28062,173973,0,202035
113535101600000,NE 164,RESIDENTIAL,57442,0,57442,256978,0,314420
113535101700000,NE 164,RESIDENTIAL,53996,0,53996,240504,0,294500
113535101800000,NE 164,RESIDENTIAL,50400,0,50400,236836,0,287236
113535101900000,NE 164,RESIDENTIAL,56700,0,56700,247524,0,304224
113535102000000,NE 164,RESIDENTIAL,55590,0,55590,227454,0,283044
113535102100000,NE 164,RESIDENTIAL,54519,0,54519,201378,0,255897
113535102200000,NE 164,RESIDENTIAL,57969,0,57969,278428,0,336397
113535102300000,NE 164,RESIDENTIAL,59340,0,59340,238319,0,297659
113535102400000,NE 164,RESIDENTIAL,55501,0,55501,196578,0,252079
113535102600000,NE 164,RESIDENTIAL,57085,0,57085,219923,0,277008
113535102700000,NE 164,RESIDENTIAL,54943,0,54943,264616,0,319559
113535102900000,NE 164,RESIDENTIAL,56732,0,56732,221648,0,278380
113535103000000,NE 164,RESIDENTIAL,53000,0,53000,245221,0,298221
113535103100000,NE 164,RESIDENTIAL,56026,0,56026,209409,0,265435
113535103200000,NE 164,RESIDENTIAL,51072,0,51072,236720,0,287792
113535103300000,NE 164,RESIDENTIAL,56618,0,56618,213489,0,270107
113535103400000,NE 164,RESIDENTIAL,57818,0,57818,218458,0,276276
113535103500000,NE 164,RESIDENTIAL,48323,0,48323,175474,0,223797
113535103600000,NE 164,RESIDENTIAL,51480,0,51480,225844,0,277324
113535103700000,NE 164,RESIDENTIAL,54936,0,54936,260026,0,314962
113535103800000,NE 164,RESIDENTIAL,55388,0,55388,231469,0,286857
113535103900000,NE 164,RESIDENTIAL,57215,0,57215,272126,0,329341
113535104000000,NE 164,RESIDENTIAL,54570,0,54570,247988,0,302558
113535104100000,NE 164,RESIDENTIAL,57780,0,57780,275464,0,333244
113535104200000,NE 164,RESIDENTIAL,55590,0,55590,219336,0,274926
113535104300000,NE 164,RESIDENTIAL,56943,0,56943,271697,0,328640
113535104400000,NE 164,RESIDENTIAL,47520,0,47520,0,0,47520
113535104500000,NE 164,RESIDENTIAL,15299,0,15299,0,0,15299
113535200100000,NE 164,RESIDENTIAL,31210,0,31210,191031,0,222241
113535200200000,NE 164,RESIDENTIAL,31016,0,31016,214502,0,245518
113535200300000,CITY PROPERTY,EXEMPT,0,0,0,0,0,0
113535200400000,NE 164,RESIDENTIAL,51660,0,51660,271513,0,323173
113535200500000,NE 164,RESIDENTIAL,53550,0,53550,257110,0,310660
113535200600000,NE 164,RESIDENTIAL,52920,0,52920,238298,0,291218
113535200700000,NE 164,RESIDENTIAL,47250,0,47250,226382,0,273632
113535200800000,NE 164,RESIDENTIAL,50400,0,50400,282632,0,333032
113535200900000,NE 164,RESIDENTIAL,52296,0,52296,241055,0,293351
113535201000000,NE 164,RESIDENTIAL,53372,0,53372,277458,0,330830
113535201100000,NE 164,RESIDENTIAL,54773,0,54773,305097,0,359870
113535201200000,NE 164,RESIDENTIAL,50400,0,50400,302247,0,352647
113535201300000,NE 164,RESIDENTIAL,53550,0,53550,238042,0,291592
113535201400000,NE 164,RESIDENTIAL,53934,0,53934,225939,0,279873
113535201500000,NE 164,RESIDENTIAL,54167,0,54167,283873,0,338040
113535201600000,NE 164,RESIDENTIAL,54167,0,54167,251482,0,305649
113535201700000,NE 164,RESIDENTIAL,54167,0,54167,267791,0,321958
113535201800000,NE 164,RESIDENTIAL,53382,0,53382,241130,0,294512
113535201900000,NE 164,RESIDENTIAL,47700,0,47700,229786,0,277486
113535300500000,NE 164,RESIDENTIAL,30131,0,30131,147067,0,177198
113535300600000,NE 164,RESIDENTIAL,30210,0,30210,154217,0,184427
113535300700000,NE 164,RESIDENTIAL,31747,0,31747,212336,0,244083
113535300800000,NE 164,RESIDENTIAL,31503,0,31503,173199,0,204702
113535400100000,NE 164,RESIDENTIAL,51012,0,51012,307029,0,358041
113535400200000,NE 164,RESIDENTIAL,54734,0,54734,222373,0,277107
113535400300000,NE 164,RESIDENTIAL,50400,0,50400,241222,0,291622
113535400400000,NE 164,RESIDENTIAL,46809,0,46809,242870,0,289679
113535400500000,NE 164,RESIDENTIAL,50400,0,50400,278491,0,328891
113535400600000,NE 164,RESIDENTIAL,53550,0,53550,264217,0,317767
113535400700000,NE 164,RESIDENTIAL,47250,0,47250,311343,0,358593
113535400800000,NE 164,RESIDENTIAL,50400,0,50400,216476,0,266876
113537600100000,NE 164,RESIDENTIAL,36777,0,36777,211126,0,247903
113537600200000,NE 164,RESIDENTIAL,35700,0,35700,225252,0,260952
113537600300000,NE 164,RESIDENTIAL,35700,0,35700,175857,0,211557
113537600400000,NE 164,RESIDENTIAL,35700,0,35700,176893,0,212593
113537600500000,NE 164,RESIDENTIAL,37928,0,37928,162173,0,200101
113537700100000,NE 164,RESIDENTIAL,36847,0,36847,182583,0,219430
113537700300000,NE 115,RESIDENTIAL,38540,0,38540,0,0,38540
113537700400000,NE 164,RESIDENTIAL,37312,0,37312,202621,0,239933
113537700500000,NE 164,RESIDENTIAL,35750,0,35750,213648,0,249398
113537700600000,NE 164,RESIDENTIAL,35446,0,35446,199985,0,235431
113537700700000,NE 164,RESIDENTIAL,36309,0,36309,240145,0,276454
113537700800000,NE 164,RESIDENTIAL,36608,0,36608,239312,0,275920
113537700900000,NE 164,RESIDENTIAL,37271,0,37271,208738,0,246009
113537701000000,NE 164,RESIDENTIAL,36105,0,36105,178426,0,214531
113537701200000,NE 164,RESIDENTIAL,49864,0,49864,312188,0,362052
113537701300000,NE 164,RESIDENTIAL,53550,0,53550,274432,0,327982
113537701400000,NE 164,RESIDENTIAL,53352,0,53352,223001,0,276353
113537701500000,NE 164,RESIDENTIAL,53352,0,53352,258275,0,311627
113537701600000,NE 164,RESIDENTIAL,54264,0,54264,273269,0,327533
113537701700000,NE 164,RESIDENTIAL,53736,0,53736,259251,0,312987
113537701800000,NE 164,RESIDENTIAL,49140,0,49140,254991,0,304131
113537701900000,NE 164,RESIDENTIAL,54998,0,54998,290260,0,345258
113537702000000,NE 164,RESIDENTIAL,57655,0,57655,280038,0,337693
113537800100000,NE 164,RESIDENTIAL,37713,0,37713,210294,0,248007
113537800200000,NE 164,RESIDENTIAL,35360,0,35360,253004,0,288364
113537800300000,NE 164,RESIDENTIAL,35360,0,35360,237318,0,272678
113537800400000,NE 164,RESIDENTIAL,35012,0,35012,196351,0,231363
113537800500000,NE 164,RESIDENTIAL,37207,0,37207,212481,0,249688
113537800600000,NE 164,RESIDENTIAL,38909,0,38909,180519,0,219428
113537800700000,NE 164,RESIDENTIAL,35994,0,35994,184833,0,220827
113537800800000,NE 164,RESIDENTIAL,30368,0,30368,167341,0,197709
113537800900000,NE 164,RESIDENTIAL,36608,0,36608,186424,0,223032
113537801000000,NE 164,RESIDENTIAL,36908,0,36908,176756,0,213664
113537900100000,NE 164,RESIDENTIAL,35784,0,35784,217538,0,253322
113537900200000,NE 164,RESIDENTIAL,31616,0,31616,191506,0,223122
113537900300000,NE 164,RESIDENTIAL,36608,0,36608,192717,0,229325
113542600100000,NE 107,RESIDENTIAL,29216,0,29216,136744,0,165960
113542600200000,NE 107,RESIDENTIAL,26347,0,26347,143768,0,170115
113542600300000,NE 107,RESIDENTIAL,26132,0,26132,132676,0,158808
113542600500000,NE 107,RESIDENTIAL,25578,0,25578,147425,0,173003
113542600600000,NE 107,RESIDENTIAL,26025,0,26025,137969,0,163994
113542600700000,NE 107,RESIDENTIAL,25490,0,25490,132345,0,157835
113542600800000,NE 107,RESIDENTIAL,25704,0,25704,137754,0,163458
113542600900000,NE 107,RESIDENTIAL,25704,0,25704,118834,0,144538
113542601000000,NE 107,RESIDENTIAL,25704,0,25704,125362,0,151066
113542601100000,NE 107,RESIDENTIAL,25704,0,25704,156083,0,181787
113542601200000,NE 107,RESIDENTIAL,25793,0,25793,157642,0,183435
113542601300000,NE 107,RESIDENTIAL,27132,0,27132,142007,0,169139
113542601400000,NE 107,RESIDENTIAL,27132,0,27132,119439,0,146571
113542601500000,NE 107,RESIDENTIAL,25793,0,25793,137167,0,162960
113542601600000,NE 107,RESIDENTIAL,25287,0,25287,137886,0,163173
113542601700000,NE 107,RESIDENTIAL,26019,0,26019,114378,0,140397
113542601800000,NE 107,RESIDENTIAL,26450,0,26450,126941,0,153391
113542601900000,NE 107,RESIDENTIAL,26490,0,26490,149996,0,176486
113542602000000,NE 107,RESIDENTIAL,24794,0,24794,112947,0,137741
113542602100000,NE 107,RESIDENTIAL,25725,0,25725,114659,0,140384
113542602200000,NE 107,RESIDENTIAL,26460,0,26460,104874,0,131334
113542602300000,NE 107,RESIDENTIAL,25725,0,25725,106043,0,131768
113542602400000,NE 107,RESIDENTIAL,26460,0,26460,110544,0,137004
113542700100000,NE 107,RESIDENTIAL,25411,0,25411,118820,0,144231
113542700200000,NE 107,RESIDENTIAL,22517,0,22517,122513,0,145030
113542700300000,NE 107,RESIDENTIAL,22407,0,22407,106117,0,128524
113542700400000,NE 107,RESIDENTIAL,25270,0,25270,120911,0,146181
113542800100000,NE 107,RESIDENTIAL,24529,0,24529,135087,0,159616
113542800200000,CITY PROPERTY,EXEMPT,0,0,0,0,0,0
113542800300000,NE 107,RESIDENTIAL,24967,0,24967,111326,0,136293
113542800400000,NE 107,RESIDENTIAL,24969,0,24969,131097,0,156066
113542800500000,NE 107,RESIDENTIAL,22919,0,22919,107312,0,130231
113542800600000,NE 107,RESIDENTIAL,25704,0,25704,138807,0,164511
113542800700000,NE 107,RESIDENTIAL,23098,0,23098,109718,0,132816
113542800800000,NE 107,RESIDENTIAL,22491,0,22491,146192,0,168683
113542800900000,NE 107,RESIDENTIAL,22491,0,22491,117374,0,139865
113542801000000,NE 107,RESIDENTIAL,22491,0,22491,114363,0,136854
113542801100000,NE 107,RESIDENTIAL,25187,0,25187,146325,0,171512
113542801200000,NE 107,RESIDENTIAL,24817,0,24817,143566,0,168383
113542801300000,NE 107,RESIDENTIAL,20160,0,20160,105894,0,126054
113542801400000,NE 107,RESIDENTIAL,20160,0,20160,104077,0,124237
113542801500000,NE 107,RESIDENTIAL,22034,0,22034,112170,0,134204
113542801600000,NE 107,RESIDENTIAL,20370,0,20370,127032,0,147402
113542801700000,NE 107,RESIDENTIAL,23765,0,23765,112433,0,136198
113542801800000,NE 107,RESIDENTIAL,20370,0,20370,111534,0,131904
113542801900000,NE 107,RESIDENTIAL,21932,0,21932,130575,0,152507
113542802000000,NE 107,RESIDENTIAL,20370,0,20370,110986,0,131356
113542900100000,NE 107,RESIDENTIAL,26241,0,26241,127741,0,153982
113542900200000,NE 107,RESIDENTIAL,21945,0,21945,126490,0,148435
113542900300000,NE 107,RESIDENTIAL,20580,0,20580,116444,0,137024
113542900400000,NE 107,RESIDENTIAL,20503,0,20503,103158,0,123661
113542900500000,NE 107,RESIDENTIAL,25725,0,25725,158867,0,184592
113542900600000,NE 107,RESIDENTIAL,22680,0,22680,119374,0,142054
113542900700000,NE 107,RESIDENTIAL,23520,0,23520,104853,0,128373
113542900800000,NE 107,RESIDENTIAL,25357,0,25357,126528,0,151885
113542900900000,NE 107,RESIDENTIAL,22591,0,22591,134618,0,157209
113542901000000,NE 107,RESIDENTIAL,21840,0,21840,119499,0,141339
113542901100000,NE 107,RESIDENTIAL,23072,0,23072,113785,0,136857
113542901200000,NE 107,RESIDENTIAL,21210,0,21210,108392,0,129602
113542901300000,NE 107,RESIDENTIAL,20790,0,20790,104017,0,124807
113542901400000,NE 107,RESIDENTIAL,20370,0,20370,106804,0,127174
113542901500000,NE 107,RESIDENTIAL,21714,0,21714,111276,0,132990
113542901600000,NE 107,RESIDENTIAL,25316,0,25316,134022,0,159338
122447800100000,NE 168,AG LAND,5174,0,5174,0,0,5174
122447800200000,NE 168,RESIDENTIAL,59700,0,59700,237644,0,297344
122510200200000,NE 168,RESIDENTIAL,69600,0,69600,0,0,69600
122510200700000,NE 168,AG DWELLING,40623,0,40623,65478,10260,116361
122517600400000,NE 168,AG LAND,44284,0,44284,0,0,44284
122517600500000,NE 168,RESIDENTIAL,98750,0,98750,316415,0,415165
122517600600000,NE 168,RESIDENTIAL,83550,0,83550,319612,0,403162
122540100100000,NE 168,AG DWELLING,95999,0,95999,103464,12338,211801
122547600100000,NE 168,RESIDENTIAL,1440,0,1440,0,0,1440
122547600200000,NE 169,RESIDENTIAL,75550,0,75550,215332,0,290882
122547600300000,NE 169,RESIDENTIAL,75500,0,75500,217087,0,292587
122547600400000,NE 169,RESIDENTIAL,75500,0,75500,201908,0,277408
122547600500000,NE 169,RESIDENTIAL,75500,0,75500,252127,0,327627
122547600600000,NE 169,RESIDENTIAL,75500,0,75500,185117,0,260617
122547600700000,NE 169,RESIDENTIAL,75500,0,75500,233254,0,308754
122547600800000,NE 169,RESIDENTIAL,75500,0,75500,257706,0,333206
122547600900000,NE 169,RESIDENTIAL,75550,0,75550,236417,0,311967
122547601000000,NE 169,RESIDENTIAL,75550,0,75550,286391,0,361941
122547700100000,NE 169,RESIDENTIAL,75000,0,75000,237082,0,312082
122547700200000,NE 169,RESIDENTIAL,75000,0,75000,223832,0,298832
122547700300000,NE 169,RESIDENTIAL,75000,0,75000,275071,0,350071
122547700400000,NE 169,RESIDENTIAL,75000,0,75000,197715,0,272715
122547700500000,NE 169,RESIDENTIAL,75000,0,75000,222517,0,297517
122547700600000,NE 169,RESIDENTIAL,74900,0,74900,208594,0,283494
122547700700000,NE 169,RESIDENTIAL,75000,0,75000,255246,0,330246
122547700800000,NE 169,RESIDENTIAL,75000,0,75000,169877,0,244877
122547700900000,NE 169,RESIDENTIAL,75750,0,75750,223704,0,299454
122547701000000,NE 168,AG LAND,34860,0,34860,0,27932,62792
123610100100000,NE 168,AG DWELLING,29658,0,29658,108428,1306,139392
123610100200000,NE 168,RESIDENTIAL,93700,0,93700,4222,0,97922
123610100300000,NE 168,RESIDENTIAL,52800,0,52800,146453,0,199253
123610100500000,NE 169,RESIDENTIAL,45540,0,45540,280007,0,325547
123610100600000,NE 169,RESIDENTIAL,45540,0,45540,293822,0,339362
123610100700000,NE 169,RESIDENTIAL,45540,0,45540,285870,0,331410
123610100800000,NE 169,RESIDENTIAL,45540,0,45540,295024,0,340564
123610100900000,NE 169,RESIDENTIAL,45540,0,45540,297972,0,343512
123610101000000,NE 169,RESIDENTIAL,45540,0,45540,299702,0,345242
123610101100000,NE 169,RESIDENTIAL,45540,0,45540,273753,0,319293
123610101200000,NE 169,RESIDENTIAL,45540,0,45540,261643,0,307183
123610101300000,NE 169,RESIDENTIAL,46000,0,46000,300602,0,346602
123610101400000,NE 169,RESIDENTIAL,46000,0,46000,320485,0,366485
123610101500000,NE 169,RESIDENTIAL,46000,0,46000,0,0,46000
123610101600000,NE 168,RESIDENTIAL,49291,0,49291,139991,0,189282
123610200100000,NE 169,RESIDENTIAL,48251,0,48251,256929,0,305180
123610200200000,NE 169,RESIDENTIAL,48114,0,48114,292541,0,340655
123610200300000,NE 169,RESIDENTIAL,48114,0,48114,315785,0,363899
123610200400000,NE 169,RESIDENTIAL,48114,0,48114,305692,0,353806
123610200500000,NE 169,RESIDENTIAL,48114,0,48114,313382,0,361496
123610200600000,NE 169,RESIDENTIAL,48114,0,48114,312522,0,360636
123610200700000,NE 169,RESIDENTIAL,48114,0,48114,293310,0,341424
123610200800000,NE 169,RESIDENTIAL,48114,0,48114,270368,0,318482
123610200900000,NE 169,RESIDENTIAL,48114,0,48114,297810,0,345924
123610201000000,NE 169,RESIDENTIAL,48114,0,48114,340806,0,388920
123610201100000,NE 169,RESIDENTIAL,48114,0,48114,238304,0,286418
123610201200000,CITY PROPERTY,EXEMPT,0,0,0,0,0,0
123612600100000,NE 168,RESIDENTIAL,16300,0,16300,0,0,16300
123612600700000,NE 168,RESIDENTIAL,72100,0,72100,312034,0,384134
123617600100000,NE 168,RESIDENTIAL,52300,0,52300,186694,0,238994
123617600200000,NE 168,RESIDENTIAL,51850,0,51850,186254,0,238104
123617600300000,NE 168,RESIDENTIAL,51850,0,51850,232417,0,284267
123617600400000,NE 168,RESIDENTIAL,51850,0,51850,172444,0,224294
123617600500000,NE 168,RESIDENTIAL,51850,0,51850,197334,0,249184
123617600600000,NE 168,RESIDENTIAL,51850,0,51850,202416,0,254266
123617600700000,NE 168,RESIDENTIAL,51850,0,51850,172745,0,224595
123617600800000,NE 168,RESIDENTIAL,51850,0,51850,179782,0,231632
123617700100000,NE 168,RESIDENTIAL,51100,0,51100,263282,0,314382
123617700200000,NE 168,RESIDENTIAL,50600,0,50600,198737,0,249337
123617700300000,NE 168,RESIDENTIAL,50600,0,50600,199263,0,249863
123617700400000,NE 168,RESIDENTIAL,50600,0,50600,188945,0,239545
123617700500000,NE 168,RESIDENTIAL,50600,0,50600,201223,0,251823
123617700600000,NE 168,RESIDENTIAL,50600,0,50600,148129,0,198729
123617700700000,NE 168,RESIDENTIAL,50600,0,50600,174821,0,225421
123617700800000,NE 168,RESIDENTIAL,50600,0,50600,128652,0,179252
123617700900000,NE 168,RESIDENTIAL,50400,0,50400,281580,0,331980
123617701000000,NE 168,RESIDENTIAL,50150,0,50150,213608,0,263758
123617701100000,NE 168,RESIDENTIAL,50600,0,50600,187383,0,237983
123617701200000,NE 168,RESIDENTIAL,50600,0,50600,187312,0,237912
123617701300000,NE 168,RESIDENTIAL,50600,0,50600,263699,0,314299
123617701400000,NE 168,RESIDENTIAL,50600,0,50600,212464,0,263064
123617701500000,NE 168,RESIDENTIAL,50600,0,50600,221626,0,272226
123617701600000,NE 168,RESIDENTIAL,51450,0,51450,239344,0,290794
123617800100000,NE 168,RESIDENTIAL,50850,0,50850,214257,0,265107
123617800200000,NE 168,RESIDENTIAL,50800,0,50800,275480,0,326280
123617800300000,NE 168,RESIDENTIAL,50800,0,50800,203785,0,254585
123617800400000,NE 168,RESIDENTIAL,51100,0,51100,207761,0,258861
123617800500000,NE 168,RESIDENTIAL,50550,0,50550,262052,0,312602
123617800600000,NE 168,RESIDENTIAL,51900,0,51900,128079,0,179979
123617800700000,NE 168,RESIDENTIAL,50350,0,50350,190999,0,241349
123617800800000,NE 168,RESIDENTIAL,50300,0,50300,176107,0,226407
123640100100000,NE 168,RESIDENTIAL,50020,0,50020,169897,0,219917
123640100200000,NE 168,RESIDENTIAL,50020,0,50020,169292,0,219312
123640100300000,NE 168,RESIDENTIAL,50020,0,50020,176266,0,226286
123640100400000,NE 168,RESIDENTIAL,50020,0,50020,165564,0,215584
123640100500000,NE 168,RESIDENTIAL,50020,0,50020,189953,0,239973
123640100600000,NE 168,RESIDENTIAL,50020,0,50020,164774,0,214794
123640200100000,NE 168,RESIDENTIAL,50720,0,50720,138755,0,189475
123640200200000,NE 168,RESIDENTIAL,50720,0,50720,197732,0,248452
123640200300000,NE 168,RESIDENTIAL,50720,0,50720,185190,0,235910
123640200400000,NE 168,RESIDENTIAL,50720,0,50720,249572,0,300292
123640200500000,NE 168,RESIDENTIAL,50720,0,50720,168345,0,219065
123640200700000,NE 168,RESIDENTIAL,50000,0,50000,223123,0,273123
123640200800000,NE 168,RESIDENTIAL,50000,0,50000,169915,0,219915
123640200900000,NE 168,RESIDENTIAL,50000,0,50000,106707,0,156707
123640201000000,NE 168,RESIDENTIAL,45496,0,45496,169095,0,214591
123640201100000,COUNTY PROPERTY,EXEMPT,0,0,0,0,0,0
123640201300000,NE 172,RESIDENTIAL,134,0,134,0,0,134
123640201400000,NE 172,RESIDENTIAL,35672,0,35672,120225,0,155897
123640201500000,NE 172,RESIDENTIAL,35672,0,35672,124664,0,160336
123640201600000,NE 172,RESIDENTIAL,35252,0,35252,134779,0,170031
123640201700000,NE 172,AG LAND,2550,0,2550,0,0,2550
123640300100000,NE 172,RESIDENTIAL,43900,0,43900,171892,0,215792
123640300200000,NE 172,RESIDENTIAL,44680,0,44680,212347,0,257027
123640300300000,NE 172,RESIDENTIAL,45746,0,45746,185100,0,230846
123640300400000,NE 172,RESIDENTIAL,52458,0,52458,210669,0,263127
123640300500000,NE 172,RESIDENTIAL,49599,0,49599,199806,0,249405
123640300600000,NE 172,RESIDENTIAL,48960,0,48960,260113,0,309073
123640300700000,CITY PROPERTY,EXEMPT,0,0,0,0,0,0
123640300800000,NE 172,RESIDENTIAL,56783,0,56783,202702,0,259485
123640300900000,NE 172,RESIDENTIAL,58214,0,58214,62279,0,120493
123640301000000,NE 172,RESIDENTIAL,56769,0,56769,240928,0,297697
123640301100000,NE 172,RESIDENTIAL,60420,0,60420,280463,0,340883
123640301200000,NE 172,RESIDENTIAL,51938,0,51938,230305,0,282243
123640301300000,NE 172,RESIDENTIAL,56160,0,56160,229302,0,285462
123640301400000,NE 172,RESIDENTIAL,57970,0,57970,240521,0,298491
123640301500000,NE 172,RESIDENTIAL,53000,0,53000,252680,0,305680
123640301600000,NE 172,RESIDENTIAL,58320,0,58320,252819,0,311139
123640301700000,NE 172,RESIDENTIAL,58982,0,58982,140059,0,199041
123640301800000,NE 172,RESIDENTIAL,57995,0,57995,226816,0,284811
123640302000000,NE 172,RESIDENTIAL,4623,0,4623,0,0,4623
123640400100000,NE 172,RESIDENTIAL,43026,0,43026,170361,0,213387
123640400200000,NE 172,RESIDENTIAL,42926,0,42926,172324,0,215250
123640400300000,NE 172,RESIDENTIAL,42400,0,42400,0,0,42400
123640400400000,NE 172,RESIDENTIAL,43262,0,43262,191053,0,234315
123640400500000,NE 172,RESIDENTIAL,40836,0,40836,197944,0,238780
123640400600000,NE 172,RESIDENTIAL,43552,0,43552,174389,0,217941
123640400700000,NE 172,RESIDENTIAL,54475,0,54475,210770,0,265245
123640400800000,NE 172,RESIDENTIAL,49613,0,49613,131673,0,181286
123640400900000,NE 172,RESIDENTIAL,47951,0,47951,196860,0,244811
123640401000000,NE 172,RESIDENTIAL,56802,0,56802,182436,0,239238
123640401100000,NE 172,RESIDENTIAL,45578,0,45578,193596,0,239174
123640401200000,NE 172,RESIDENTIAL,49500,0,49500,221297,0,270797
123640401300000,NE 172,RESIDENTIAL,49028,0,49028,217044,0,266072
123640401400000,NE 172,RESIDENTIAL,60221,0,60221,225579,0,285800
123640401500000,NE 172,RESIDENTIAL,66240,0,66240,261869,0,328109
123640401600000,NE 172,RESIDENTIAL,54621,0,54621,280927,0,335548
123640401700000,NE 172,RESIDENTIAL,6358,0,6358,0,0,6358
123640401800000,NE 172,RESIDENTIAL,58752,0,58752,227212,0,285964
123640401900000,NE 172,RESIDENTIAL,55854,0,55854,8952,0,64806
123640402000000,NE 172,RESIDENTIAL,4678,0,4678,0,0,4678
123640402100000,NE 172,RESIDENTIAL,5336,0,5336,0,0,5336
123640402200000,NE 172,RESIDENTIAL,4588,0,4588,0,0,4588
123640402300000,NE 172,RESIDENTIAL,6830,0,6830,0,0,6830
123640402400000,NE 172,RESIDENTIAL,3855,0,3855,0,0,3855
123640402500000,NE 172,RESIDENTIAL,4257,0,4257,0,0,4257
123640402600000,NE 172,RESIDENTIAL,53040,0,53040,45533,0,98573
123640402700000,NE 172,RESIDENTIAL,4162,0,4162,0,0,4162
123642600700000,NE 170,RESIDENTIAL,62024,0,62024,333816,0,395840
123642600800000,NE 170,RESIDENTIAL,61476,0,61476,257631,0,319107
123642600900000,NE 170,RESIDENTIAL,60348,0,60348,295733,0,356081
123642601000000,NE 170,RESIDENTIAL,59220,0,59220,275272,0,334492
123642601100000,NE 170,RESIDENTIAL,61632,0,61632,265817,0,327449
123642601200000,NE 170,RESIDENTIAL,61040,0,61040,295392,0,356432
123642601300000,NE 170,RESIDENTIAL,62130,0,62130,322003,0,384133
123642601400000,NE 170,RESIDENTIAL,6152,0,6152,0,0,6152
123642700100000,NE 170,RESIDENTIAL,63070,0,63070,292261,0,355331
123642700200000,NE 170,RESIDENTIAL,61880,0,61880,320789,0,382669
123642700300000,NE 170,RESIDENTIAL,60690,0,60690,286618,0,347308
123642700400000,NE 170,RESIDENTIAL,46408,0,46408,231974,0,278382
123642700500000,NE 170,RESIDENTIAL,5200,0,5200,0,0,5200
123642700600000,NE 170,RESIDENTIAL,78624,0,78624,274457,0,353081
123642700700000,NE 170,RESIDENTIAL,69930,0,69930,297835,0,367765
123642700800000,NE 170,RESIDENTIAL,82656,0,82656,294486,0,377142
123642700900000,NE 170,RESIDENTIAL,58525,0,58525,293354,0,351879
123642701000000,NE 170,RESIDENTIAL,73920,0,73920,392283,0,466203
123642701100000,NE 170,RESIDENTIAL,73248,0,73248,337389,0,410637
123642701200000,NE 170,RESIDENTIAL,67200,0,67200,332912,0,400112
123642701300000,NE 170,RESIDENTIAL,5453,0,5453,0,0,5453
123642701400000,NE 170,RESIDENTIAL,65835,0,65835,10702,0,76537
123642701500000,NE 170,RESIDENTIAL,65835,0,65835,319556,0,385391
123642701600000,NE 170,RESIDENTIAL,65835,0,65835,263692,0,329527
123642701700000,NE 170,RESIDENTIAL,99922,0,99922,115394,0,215316
123642800100000,NE 170,RESIDENTIAL,51666,0,51666,257510,0,309176
123642800200000,NE 170,RESIDENTIAL,45500,0,45500,269079,0,314579
123642800300000,NE 170,RESIDENTIAL,46000,0,46000,286921,0,332921
123642800400000,NE 170,RESIDENTIAL,53500,0,53500,266875,0,320375
123642800500000,NE 170,RESIDENTIAL,61525,0,61525,271295,0,332820
123642800800000,NE 170,RESIDENTIAL,47025,0,47025,293385,0,340410
123642800900000,NE 170,RESIDENTIAL,4335,0,4335,0,0,4335
123642801000000,NE 170,RESIDENTIAL,6152,0,6152,0,0,6152
123642801100000,NE 170,RESIDENTIAL,4614,0,4614,0,0,4614
123642801200000,NE 170,RESIDENTIAL,51000,0,51000,81404,0,132404
123642801300000,NE 170,RESIDENTIAL,5174,0,5174,0,0,5174
123642801400000,NE 170,RESIDENTIAL,5174,0,5174,0,0,5174
123642801500000,NE 170,RESIDENTIAL,5314,0,5314,0,0,5314
123642801600000,NE 170,RESIDENTIAL,52000,0,52000,412354,0,464354
123642801700000,NE 170,RESIDENTIAL,52500,0,52500,270440,0,322940
123642801800000,NE 170,RESIDENTIAL,52500,0,52500,318345,0,370845
123642801900000,NE 170,RESIDENTIAL,52000,0,52000,285719,0,337719
123642802000000,NE 170,RESIDENTIAL,6152,0,6152,0,0,6152
123642802100000,NE 170,RESIDENTIAL,73477,0,73477,359820,0,433297
123645100300000,NE 170,RESIDENTIAL,47530,0,47530,252825,0,300355
123645100400000,NE 170,RESIDENTIAL,620,0,620,0,0,620
123645100500000,NE 170,RESIDENTIAL,44100,0,44100,339065,0,383165
123645100600000,NE 170,RESIDENTIAL,7375,0,7375,0,0,7375
123645100700000,NE 170,RESIDENTIAL,52866,0,52866,311991,0,364857
123645100800000,NE 170,RESIDENTIAL,43650,0,43650,278293,0,321943
123645100900000,NE 170,RESIDENTIAL,53000,0,53000,278274,0,331274
123645101000000,NE 170,RESIDENTIAL,6013,0,6013,0,0,6013
123645101100000,NE 170,RESIDENTIAL,6292,0,6292,0,0,6292
123647600300000,NE 172,RESIDENTIAL,42120,0,42120,120241,0,162361
123647600400000,NE 172,RESIDENTIAL,42120,0,42120,102801,0,144921
123647600500000,NE 172,RESIDENTIAL,48731,0,48731,137392,0,186123
123647600600000,NE 172,RESIDENTIAL,46592,0,46592,160451,0,207043
123647600700000,NE 172,RESIDENTIAL,52668,0,52668,208077,0,260745
123647600800000,NE 172,RESIDENTIAL,45120,0,45120,175314,0,220434
123647600900000,NE 172,RESIDENTIAL,40656,0,40656,173597,0,214253
123647601000000,NE 172,RESIDENTIAL,44965,0,44965,227669,0,272634
123647601100000,NE 172,RESIDENTIAL,43033,0,43033,211530,0,254563
123647601200000,NE 172,RESIDENTIAL,42846,0,42846,252816,0,295662
123647601300000,NE 172,RESIDENTIAL,36375,0,36375,174181,0,210556
123647601400000,NE 172,RESIDENTIAL,33487,0,33487,165674,0,199161
123647601500000,NE 172,RESIDENTIAL,44940,0,44940,185164,0,230104
123647601600000,NE 172,RESIDENTIAL,199,0,199,0,0,199
123647601700000,NE 172,RESIDENTIAL,325,0,325,0,0,325
123647601800000,NE 172,RESIDENTIAL,327,0,327,0,0,327
123647601900000,NE 172,RESIDENTIAL,50616,0,50616,189131,0,239747
123647602400000,NE 172,RESIDENTIAL,160,0,160,0,0,160
123647602600000,NE 172,RESIDENTIAL,30912,0,30912,8952,0,39864
123647602700000,NE 172,RESIDENTIAL,33581,0,33581,119097,0,152678
123647602800000,NE 172,RESIDENTIAL,288,0,288,0,0,288
123647602900000,NE 172,RESIDENTIAL,35056,0,35056,116161,0,151217
123647603000000,NE 172,RESIDENTIAL,32928,0,32928,118431,0,151359
123647603100000,NE 172,RESIDENTIAL,33339,0,33339,132735,0,166074
123647603200000,NE 172,RESIDENTIAL,35129,0,35129,135598,0,170727
123647603300000,NE 172,RESIDENTIAL,37240,0,37240,135048,0,172288
123647603400000,NE 172,RESIDENTIAL,37800,0,37800,135787,0,173587
123647603500000,NE 172,RESIDENTIAL,37800,0,37800,106529,0,144329
123647603600000,NE 172,RESIDENTIAL,37800,0,37800,111210,0,149010
123647603700000,NE 172,RESIDENTIAL,37100,0,37100,118790,0,155890
123647603800000,NE 172,RESIDENTIAL,35700,0,35700,107238,0,142938
123647603900000,NE 172,RESIDENTIAL,35534,0,35534,108102,0,143636
123647604000000,NE 172,RESIDENTIAL,33273,0,33273,114585,0,147858
123647604100000,NE 172,RESIDENTIAL,31500,0,31500,114585,0,146085
123647604200000,NE 172,RESIDENTIAL,34561,0,34561,115124,0,149685
123647604300000,NE 172,RESIDENTIAL,37838,0,37838,107694,0,145532
123647604400000,NE 172,RESIDENTIAL,95,0,95,0,0,95
123647604500000,NE 172,RESIDENTIAL,47,0,47,0,0,47
123647900100000,NE 172,RESIDENTIAL,46180,0,46180,171849,0,218029
123647900200000,NE 172,RESIDENTIAL,41552,0,41552,217333,0,258885
123647900300000,NE 172,RESIDENTIAL,41370,0,41370,228772,0,270142
123647900400000,NE 172,RESIDENTIAL,44642,0,44642,182441,0,227083
123647900500000,NE 172,RESIDENTIAL,42192,0,42192,177842,0,220034
123647900600000,NE 172,RESIDENTIAL,41405,0,41405,171151,0,212556
123647900700000,NE 172,RESIDENTIAL,42675,0,42675,137322,0,179997
123647900800000,NE 172,RESIDENTIAL,45938,0,45938,167540,0,213478
123647900900000,NE 172,RESIDENTIAL,47480,0,47480,210803,0,258283
123647901000000,NE 172,RESIDENTIAL,32982,0,32982,173547,0,206529
123647901100000,NE 172,RESIDENTIAL,27713,0,27713,158507,0,186220
123647901200000,NE 172,RESIDENTIAL,44909,0,44909,170520,0,215429
123647901300000,NE 172,RESIDENTIAL,43177,0,43177,189756,0,232933
123647901400000,NE 172,RESIDENTIAL,42531,0,42531,215806,0,258337
123647901500000,NE 172,RESIDENTIAL,47168,0,47168,207412,0,254580
123647901600000,NE 172,RESIDENTIAL,43894,0,43894,221586,0,265480
123647901700000,NE 172,RESIDENTIAL,44606,0,44606,218398,0,263004
123648000100000,NE 172,RESIDENTIAL,40352,0,40352,176784,0,217136
123648000200000,NE 172,RESIDENTIAL,40940,0,40940,175424,0,216364
123648000300000,NE 172,RESIDENTIAL,40319,0,40319,205586,0,245905
123648000400000,NE 172,RESIDENTIAL,41006,0,41006,182604,0,223610
123648000500000,NE 172,RESIDENTIAL,36266,0,36266,183714,0,219980
123648000600000,NE 172,RESIDENTIAL,7,0,7,0,0,7
123648000700000,NE 172,RESIDENTIAL,16,0,16,0,0,16
123648000800000,NE 172,RESIDENTIAL,170,0,170,0,0,170
123648000900000,NE 172,RESIDENTIAL,51596,0,51596,181049,0,232645
123648001000000,NE 172,RESIDENTIAL,51656,0,51656,193517,0,245173
123648001100000,NE 172,RESIDENTIAL,183,0,183,0,0,183
123648001200000,NE 172,RESIDENTIAL,161,0,161,0,0,161
123648001300000,NE 172,RESIDENTIAL,47520,0,47520,214021,0,261541
123648001400000,NE 172,RESIDENTIAL,44640,0,44640,221787,0,266427
123648001500000,NE 172,RESIDENTIAL,42960,0,42960,199815,0,242775
123648001600000,NE 172,RESIDENTIAL,52590,0,52590,196577,0,249167
123648001700000,NE 172,RESIDENTIAL,52608,0,52608,187556,0,240164
123648001800000,NE 172,RESIDENTIAL,56114,0,56114,190821,0,246935
123648001900000,NE 172,RESIDENTIAL,50880,0,50880,213052,0,263932
123648002000000,NE 172,RESIDENTIAL,53352,0,53352,232557,0,285909
123648002100000,NE 172,RESIDENTIAL,204,0,204,0,0,204
123648100100000,NE 172,RESIDENTIAL,239,0,239,0,0,239
123648100200000,NE 172,RESIDENTIAL,33600,0,33600,110452,0,144052
123648100300000,NE 172,RESIDENTIAL,33950,0,33950,120698,0,154648
123648100400000,NE 172,RESIDENTIAL,289,0,289,0,0,289
123648100500000,NE 172,RESIDENTIAL,36751,0,36751,113530,0,150281
123648100600000,NE 172,RESIDENTIAL,34494,0,34494,114278,0,148772
123648100700000,NE 172,RESIDENTIAL,33124,0,33124,114585,0,147709
123648100800000,NE 172,RESIDENTIAL,33488,0,33488,113370,0,146858
123648100900000,NE 172,RESIDENTIAL,38734,0,38734,111526,0,150260
123648101000000,NE 172,RESIDENTIAL,221,0,221,0,0,221
123648101100000,NE 172,RESIDENTIAL,236,0,236,0,0,236
123648101200000,NE 172,RESIDENTIAL,32900,0,32900,149892,0,182792
123648101300000,NE 172,RESIDENTIAL,150,0,150,0,0,150
123648101400000,NE 172,RESIDENTIAL,169,0,169,0,0,169
123648101500000,NE 172,RESIDENTIAL,247,0,247,0,0,247
130140100100000,NE 161,RESIDENTIAL,42575,0,42575,220277,0,262852
130140100200000,NE 161,RESIDENTIAL,42500,0,42500,226130,0,268630
130140100300000,NE 161,RESIDENTIAL,42500,0,42500,201974,0,244474
130140100400000,NE 161,RESIDENTIAL,42500,0,42500,160118,0,202618
130140100500000,NE 161,RESIDENTIAL,42500,0,42500,245007,0,287507
130140100600000,NE 161,RESIDENTIAL,42500,0,42500,220829,0,263329
130140100700000,NE 161,RESIDENTIAL,42500,0,42500,231029,0,273529
130140100800000,NE 161,RESIDENTIAL,42500,0,42500,207827,0,250327
130140100900000,NE 161,RESIDENTIAL,47667,0,47667,175065,0,222732
130140101000000,NE 161,RESIDENTIAL,42500,0,42500,234024,0,276524
130140101100000,NE 161,RESIDENTIAL,42500,0,42500,0,0,42500
130140200100000,NE 161,RESIDENTIAL,43350,0,43350,216671,0,260021
130140200200000,NE 161,RESIDENTIAL,46750,0,46750,232012,0,278762
130140200300000,NE 161,RESIDENTIAL,46027,0,46027,238761,0,284788
130140200400000,NE 161,RESIDENTIAL,44752,0,44752,292989,0,337741
130140200500000,NE 161,RESIDENTIAL,42349,0,42349,262544,0,304893
130140200600000,NE 161,RESIDENTIAL,48675,0,48675,203174,0,251849
130140200700000,NE 161,RESIDENTIAL,46315,0,46315,292346,0,338661
130140200800000,NE 161,RESIDENTIAL,45591,0,45591,209653,0,255244
130140200900000,NE 161,RESIDENTIAL,44752,0,44752,209112,0,253864
130140201000000,NE 161,RESIDENTIAL,48150,0,48150,0,0,48150
130140201200000,NE 161,RESIDENTIAL,1110,0,1110,0,0,1110
130140201300000,NE 161,RESIDENTIAL,1090,0,1090,0,0,1090
130140201400000,NE 161,RESIDENTIAL,1045,0,1045,0,0,1045
130140201500000,NE 161,RESIDENTIAL,1050,0,1050,0,0,1050
130140201600000,NE 161,RESIDENTIAL,55539,0,55539,299846,0,355385
130140201700000,NE 161,RESIDENTIAL,58810,0,58810,244332,0,303142
130140201800000,NE 161,RESIDENTIAL,55242,0,55242,214166,0,269408
130140201900000,NE 161,RESIDENTIAL,61778,0,61778,377157,0,438935
130140202000000,NE 161,RESIDENTIAL,59836,0,59836,223440,0,283276
130140202100000,NE 161,RESIDENTIAL,73489,0,73489,284343,0,357832
130140202200000,NE 161,RESIDENTIAL,65016,0,65016,265468,0,330484
130140202300000,NE 161,RESIDENTIAL,61603,0,61603,320853,0,382456
130140202400000,NE 161,RESIDENTIAL,56644,0,56644,0,0,56644
130140202500000,NE 161,RESIDENTIAL,54683,0,54683,214336,0,269019
130140202600000,NE 161,RESIDENTIAL,55080,0,55080,0,0,55080
130140202700000,NE 161,RESIDENTIAL,55080,0,55080,210872,0,265952
130140300100000,NE 161,RESIDENTIAL,53742,0,53742,226571,0,280313
130140300200000,NE 161,RESIDENTIAL,42797,0,42797,250222,0,293019
130140300300000,NE 161,RESIDENTIAL,44550,0,44550,214804,0,259354
130140300400000,NE 161,RESIDENTIAL,46863,0,46863,238351,0,285214
130140300500000,NE 161,RESIDENTIAL,54000,0,54000,0,0,54000
130140300600000,NE 161,RESIDENTIAL,54900,0,54900,237721,0,292621
130140300700000,NE 161,RESIDENTIAL,53244,0,53244,265891,0,319135
130140300800000,NE 161,RESIDENTIAL,56304,0,56304,208448,0,264752
130140300900000,NE 161,RESIDENTIAL,53489,0,53489,256081,0,309570
130140400100000,NE 128,RESIDENTIAL,12000,0,12000,0,0,12000
130142700100000,NE 161,RESIDENTIAL,78100,0,78100,0,0,78100
130142700200000,NE 161,RESIDENTIAL,47736,0,47736,0,0,47736
130142700300000,NE 161,RESIDENTIAL,47974,0,47974,207296,0,255270
130142700400000,NE 161,RESIDENTIAL,48960,0,48960,0,0,48960
130142700500000,NE 161,RESIDENTIAL,47124,0,47124,232882,0,280006
130142700600000,NE 161,RESIDENTIAL,47124,0,47124,220173,0,267297
130142700700000,NE 161,RESIDENTIAL,48960,0,48960,272268,0,321228
130142700800000,NE 161,RESIDENTIAL,47736,0,47736,296617,0,344353
130142700900000,NE 161,RESIDENTIAL,43834,0,43834,0,0,43834
130142701000000,NE 161,RESIDENTIAL,54810,0,54810,233181,0,287991
130142701100000,NE 161,RESIDENTIAL,55003,0,55003,201457,0,256460
130142701200000,NE 161,RESIDENTIAL,62550,0,62550,286397,0,348947
130142701300000,NE 161,RESIDENTIAL,56222,0,56222,0,0,56222
130142701400000,NE 161,RESIDENTIAL,52020,0,52020,194597,0,246617
130142701500000,NE 161,RESIDENTIAL,52020,0,52020,0,0,52020
130142701600000,NE 161,RESIDENTIAL,57900,0,57900,0,0,57900
130142800100000,NE 161,RESIDENTIAL,53489,0,53489,233411,0,286900
130142800200000,NE 161,RESIDENTIAL,53560,0,53560,206550,0,260110
130145100100000,SCHOOL,EXEMPT,0,1173960,1173960,0,14363622,15537582
130145200100000,NE 128,RESIDENTIAL,21470,0,21470,86136,0,107606
130147600100000,NE 128,RESIDENTIAL,80028,0,80028,331777,0,411805
130147600200000,NE 128,RESIDENTIAL,38703,0,38703,0,0,38703
130147600300000,NE 128,RESIDENTIAL,100000,0,100000,554215,0,654215
130147600400000,NE 128,RESIDENTIAL,81179,0,81179,535143,0,616322
130147600500000,NE 128,RESIDENTIAL,77234,0,77234,454930,0,532164
130147600600000,NE 128,RESIDENTIAL,76333,0,76333,290335,0,366668
130147600700000,NE 128,RESIDENTIAL,83000,0,83000,460448,0,543448
130147600800000,NE 128,RESIDENTIAL,98372,0,98372,509684,0,608056
130147600900000,NE 128,RESIDENTIAL,93501,0,93501,566565,0,660066
130147601000000,NE 128,RESIDENTIAL,101700,0,101700,437658,0,539358
130147601100000,NE 128,RESIDENTIAL,85610,0,85610,514847,0,600457
130147601200000,NE 128,RESIDENTIAL,81619,0,81619,341855,0,423474
130147601300000,NE 128,RESIDENTIAL,76253,0,76253,372449,0,448702
130147601400000,NE 128,RESIDENTIAL,74066,0,74066,308807,0,382873
130147601500000,NE 128,RESIDENTIAL,74880,0,74880,426687,0,501567
130147601600000,NE 128,RESIDENTIAL,74160,0,74160,491676,0,565836
130147601700000,NE 128,RESIDENTIAL,47982,0,47982,0,0,47982
130147602000000,NE 128,RESIDENTIAL,43120,0,43120,146287,0,189407
130147602700000,NE 128,RESIDENTIAL,1400,0,1400,0,0,1400
130147800100000,NE 128,RESIDENTIAL,72691,0,72691,389825,0,462516
130147800200000,NE 128,RESIDENTIAL,68640,0,68640,365092,0,433732
130147800300000,NE 128,RESIDENTIAL,74880,0,74880,524683,0,599563
130147800400000,NE 128,RESIDENTIAL,71072,0,71072,370643,0,441715
130147800500000,NE 128,RESIDENTIAL,20,0,20,0,0,20
130147900100000,NE 128,RESIDENTIAL,73426,0,73426,408988,0,482414
130147900200000,NE 128,RESIDENTIAL,74880,0,74880,307330,0,382210
130147900300000,NE 128,RESIDENTIAL,74160,0,74160,625880,0,700040
130147900400000,NE 128,RESIDENTIAL,53227,0,53227,0,0,53227
131140100100000,NE 165,RESIDENTIAL,787600,0,787600,1447710,0,2235310
131147600100000,CITY PROPERTY,EXEMPT,0,0,0,0,0,0
131212600300000,NE 128,RESIDENTIAL,33660,0,33660,126690,0,160350
131220100100000,NE 165,RESIDENTIAL,44458,0,44458,259100,0,303558
131220100200000,NE 165,RESIDENTIAL,43289,0,43289,302568,0,345857
131220100300000,NE 165,RESIDENTIAL,48053,0,48053,244023,0,292076
131220100400000,NE 165,RESIDENTIAL,46060,0,46060,265745,0,311805
131220100500000,NE 165,RESIDENTIAL,49680,0,49680,306126,0,355806
131220100600000,NE 165,RESIDENTIAL,51187,0,51187,296437,0,347624
131220100700000,NE 165,RESIDENTIAL,49440,0,49440,346654,0,396094
131220100800000,NE 165,RESIDENTIAL,60233,0,60233,348081,0,408314
131220101000000,NE 165,RESIDENTIAL,61803,0,61803,360218,0,422021
131220101100000,NE 165,RESIDENTIAL,60690,0,60690,341546,0,402236
131220101200000,NE 165,RESIDENTIAL,61803,0,61803,361105,0,422908
131220101300000,NE 165,RESIDENTIAL,64065,0,64065,359324,0,423389
131220101400000,NE 165,RESIDENTIAL,61651,0,61651,314982,0,376633
131220101500000,NE 165,RESIDENTIAL,58743,0,58743,289536,0,348279
131220101600000,NE 165,RESIDENTIAL,59863,0,59863,0,0,59863
131220101700000,NE 165,RESIDENTIAL,69572,0,69572,379999,0,449571
131220101800000,NE 165,RESIDENTIAL,62510,0,62510,378227,0,440737
131220101900000,NE 165,RESIDENTIAL,64365,0,64365,347697,0,412062
131220102000000,NE 165,RESIDENTIAL,100400,0,100400,466748,0,567148
131220102100000,NE 165,RESIDENTIAL,77974,0,77974,0,0,77974
131220102200000,NE 165,RESIDENTIAL,104500,0,104500,581650,0,686150
131220102300000,NE 165,RESIDENTIAL,86672,0,86672,519722,0,606394
131220102400000,NE 165,RESIDENTIAL,86469,0,86469,345634,0,432103
131220102500000,NE 165,RESIDENTIAL,100700,0,100700,337712,0,438412
131220102600000,NE 165,RESIDENTIAL,84179,0,84179,434821,0,519000
131220102900000,NE 165,RESIDENTIAL,46500,0,46500,1540,0,48040
131220103000000,NE 165,RESIDENTIAL,50000,0,50000,466659,0,516659
131220103100000,NE 165,RESIDENTIAL,56863,0,56863,390841,0,447704
131220103200000,NE 165,RESIDENTIAL,51493,0,51493,393580,0,445073
131220103300000,NE 165,RESIDENTIAL,51300,0,51300,316759,0,368059
131220103400000,NE 165,RESIDENTIAL,51775,0,51775,396730,0,448505
131220103500000,NE 165,RESIDENTIAL,63588,0,63588,349077,0,412665
131220103600000,NE 165,RESIDENTIAL,63750,0,63750,358499,0,422249
131220103700000,NE 165,RESIDENTIAL,63142,0,63142,422890,0,486032
131220103800000,NE 165,RESIDENTIAL,61994,0,61994,298170,0,360164
131220103900000,NE 165,RESIDENTIAL,48384,0,48384,243518,0,291902
131220104000000,NE 165,RESIDENTIAL,49169,0,49169,0,0,49169
131220104100000,NE 165,RESIDENTIAL,63832,0,63832,429919,0,493751
131220104200000,NE 165,RESIDENTIAL,60180,0,60180,313108,0,373288
131220104300000,NE 165,RESIDENTIAL,62006,0,62006,339197,0,401203
131220104400000,NE 165,RESIDENTIAL,55767,0,55767,350852,0,406619
131220104500000,NE 165,RESIDENTIAL,45900,0,45900,0,0,45900
131220104600000,NE 165,RESIDENTIAL,58154,0,58154,347237,0,405391
131220104700000,NE 165,RESIDENTIAL,49379,0,49379,263313,0,312692
131220104800000,NE 165,RESIDENTIAL,50575,0,50575,391240,0,441815
131220104900000,NE 165,RESIDENTIAL,52351,0,52351,404029,0,456380
131220105000000,NE 165,RESIDENTIAL,56206,0,56206,323802,0,380008
131220105100000,NE 165,RESIDENTIAL,49147,0,49147,323270,0,372417
131220105200000,NE 165,RESIDENTIAL,10,0,10,0,0,10
131220105300000,NE 165,RESIDENTIAL,58594,0,58594,0,0,58594
131222700100000,NE 165,RESIDENTIAL,81280,0,81280,325949,0,407229
131222700200000,NE 165,RESIDENTIAL,78511,0,78511,292794,0,371305
131222700300000,NE 165,RESIDENTIAL,70612,0,70612,0,0,70612
131222700400000,NE 165,RESIDENTIAL,76152,0,76152,0,0,76152
131222700500000,NE 165,RESIDENTIAL,82536,0,82536,321522,0,404058
131222700600000,NE 165,RESIDENTIAL,80520,0,80520,0,0,80520
131222700700000,NE 165,RESIDENTIAL,92500,0,92500,0,0,92500
131222700800000,NE 165,RESIDENTIAL,87840,0,87840,503538,0,591378
131222700900000,NE 165,RESIDENTIAL,100100,0,100100,470865,0,570965
131222701000000,NE 165,RESIDENTIAL,74412,0,74412,356838,0,431250
131222701100000,NE 165,RESIDENTIAL,81058,0,81058,405354,0,486412
131222701200000,NE 165,RESIDENTIAL,82280,0,82280,430477,0,512757
131222701300000,NE 165,RESIDENTIAL,104300,0,104300,453162,0,557462
131222701400000,NE 165,RESIDENTIAL,104400,0,104400,447026,0,551426
131222701500000,NE 165,RESIDENTIAL,92207,0,92207,0,0,92207
131222701600000,NE 165,RESIDENTIAL,68972,0,68972,0,0,68972
131222701700000,NE 165,RESIDENTIAL,83402,0,83402,443825,0,527227
131222701800000,NE 165,RESIDENTIAL,92862,0,92862,367908,0,460770
131222702000000,NE 151,RESIDENTIAL,3640,0,3640,0,0,3640
131222702100000,NE 151,RESIDENTIAL,86580,0,86580,536494,0,623074
131222702200000,NE 151,RESIDENTIAL,5421,0,5421,0,0,5421
131222702300000,NE 151,RESIDENTIAL,84180,0,84180,292152,0,376332
131222702400000,NE 151,RESIDENTIAL,5685,0,5685,0,0,5685
131222800100000,NE 151,RESIDENTIAL,3725,0,3725,0,0,3725
131225100100000,NE 165,RESIDENTIAL,96289,0,96289,0,0,96289
131225100500000,NE 165,RESIDENTIAL,97674,0,97674,560835,0,658509
131225100600000,NE 165,RESIDENTIAL,1500,0,1500,0,0,1500
131225100700000,NE 165,RESIDENTIAL,440,0,440,0,0,440
131225100800000,NE 165,RESIDENTIAL,123980,0,123980,488245,0,612225
131225100900000,NE 165,RESIDENTIAL,86550,0,86550,0,0,86550
131225101000000,NE 165,RESIDENTIAL,86894,0,86894,0,0,86894
131225101100000,NE 165,RESIDENTIAL,75000,0,75000,0,0,75000
131225101200000,NE 165,RESIDENTIAL,127900,0,127900,476049,0,603949
131225101300000,NE 165,RESIDENTIAL,101600,0,101600,825939,0,927539
131225101400000,NE 165,RESIDENTIAL,128360,0,128360,621329,0,749689
131225101500000,NE 165,RESIDENTIAL,101440,0,101440,540099,0,641539
131225101600000,NE 165,RESIDENTIAL,102160,0,102160,381874,0,484034
131225101700000,NE 165,RESIDENTIAL,103040,0,103040,420157,0,523197
131225101800000,NE 165,RESIDENTIAL,102480,0,102480,490215,0,592695
131225101900000,NE 165,RESIDENTIAL,86275,0,86275,0,0,86275
131225102000000,NE 165,RESIDENTIAL,101250,0,101250,411508,0,512758
131225102200000,NE 151,RESIDENTIAL,9006,0,9006,0,0,9006
131225102300000,NE 151,RESIDENTIAL,19943,0,19943,0,0,19943
131225102400000,NE 151,RESIDENTIAL,127800,0,127800,511803,0,639603
131225102500000,NE 151,RESIDENTIAL,9176,0,9176,0,0,9176
131225102600000,NE 151,RESIDENTIAL,94154,0,94154,488627,0,582781
131225102700000,NE 151,RESIDENTIAL,26897,0,26897,0,0,26897
131225102800000,NE 151,RESIDENTIAL,90476,0,90476,444818,0,535294
131225102900000,NE 151,RESIDENTIAL,3373,0,3373,0,0,3373
131225103000000,NE 151,RESIDENTIAL,3223,0,3223,0,0,3223
131225103100000,NE 151,RESIDENTIAL,68384,0,68384,419142,0,487526
131225103200000,NE 151,RESIDENTIAL,69156,0,69156,329379,0,398535
131225103400000,NE 151,RESIDENTIAL,11980,0,11980,0,0,11980
131225103500000,NE 151,RESIDENTIAL,8497,0,8497,0,0,8497
131225103600000,NE 151,RESIDENTIAL,73915,0,73915,352775,0,426690
131225103700000,NE 151,RESIDENTIAL,65312,0,65312,365008,0,430320
131225103800000,NE 165,RESIDENTIAL,145000,0,145000,724107,0,869107
131227600100000,NE 151,RESIDENTIAL,65000,0,65000,148858,0,213858
131227600200000,NE 151,RESIDENTIAL,84900,0,84900,189373,0,274273
131227600300000,NE 165,RESIDENTIAL,100000,0,100000,408096,0,508096
131227600400000,NE 165,RESIDENTIAL,85428,0,85428,411056,0,496484
131227600500000,NE 165,RESIDENTIAL,100400,0,100400,386402,0,486802
131227600600000,NE 165,RESIDENTIAL,100960,0,100960,458716,0,559676
131227600700000,NE 165,RESIDENTIAL,95957,0,95957,425405,0,521362
131227600800000,NE 165,RESIDENTIAL,100080,0,100080,445306,0,545386
131227700100000,NE 165,RESIDENTIAL,89154,0,89154,504271,0,593425
131227700200000,NE 165,RESIDENTIAL,93380,0,93380,495387,0,588767
131227800100000,NE 151,RESIDENTIAL,166800,0,166800,0,0,166800
131227900100000,NE 165,RESIDENTIAL,93816,0,93816,0,0,93816
131227900200000,NE 165,RESIDENTIAL,88920,0,88920,420065,0,508985
131227900300000,NE 165,RESIDENTIAL,94160,0,94160,637375,0,731535
131227900400000,NE 165,RESIDENTIAL,101200,0,101200,0,0,101200
131227900600000,NE 151,RESIDENTIAL,60000,0,60000,136226,0,196226
131227900700000,NE 151,RESIDENTIAL,60000,0,60000,132655,0,192655
131227900800000,NE 165,RESIDENTIAL,100960,0,100960,412834,0,513794
131227901100000,NE 165,RESIDENTIAL,5200,0,5200,0,0,5200
131227901200000,NE 165,RESIDENTIAL,90059,0,90059,0,0,90059
131227901300000,NE 165,RESIDENTIAL,86206,0,86206,0,0,86206
131230100300000,NE 151,RESIDENTIAL,48009,0,48009,285629,0,333638
131230100400000,NE 151,RESIDENTIAL,36448,0,36448,0,0,36448
131230100500000,NE 151,RESIDENTIAL,48598,0,48598,231618,0,280216
131230100600000,NE 151,RESIDENTIAL,36448,0,36448,0,0,36448
131230100700000,NE 151,RESIDENTIAL,38473,0,38473,0,0,38473
131230100800000,NE 151,RESIDENTIAL,48598,0,48598,277943,0,326541
131230100900000,NE 151,RESIDENTIAL,39586,0,39586,0,0,39586
131230101000000,NE 151,RESIDENTIAL,43150,0,43150,0,0,43150
131230200200000,NE 151,RESIDENTIAL,11500,0,11500,0,0,11500
131230200300000,NE 151,RESIDENTIAL,72000,0,72000,114010,0,186010
131230200600000,NE 151,RESIDENTIAL,13324,0,13324,0,0,13324
131230200700000,NE 151,RESIDENTIAL,3841,0,3841,0,0,3841
131230200800000,NE 151,RESIDENTIAL,10109,0,10109,0,0,10109
131230200900000,NE 151,RESIDENTIAL,8636,0,8636,0,0,8636
131230201100000,NE 151,RESIDENTIAL,107799,0,107799,308456,0,416255
131230201200000,NE 151,RESIDENTIAL,61600,0,61600,290114,0,351714
131230201300000,NE 151,RESIDENTIAL,68640,0,68640,307210,0,375850
131230201400000,NE 151,RESIDENTIAL,68640,0,68640,321218,0,389858
131230201500000,NE 151,RESIDENTIAL,62400,0,62400,344809,0,407209
131230201600000,NE 151,RESIDENTIAL,61182,0,61182,266612,0,327794
131230201700000,NE 151,RESIDENTIAL,9157,0,9157,0,0,9157
131230201800000,NE 151,RESIDENTIAL,109925,0,109925,468595,0,578520
131230201900000,NE 151,RESIDENTIAL,1620,0,1620,0,0,1620
131230202000000,NE 151,RESIDENTIAL,70152,0,70152,0,0,70152
131230300100000,NE 151,RESIDENTIAL,52992,0,52992,250482,0,303474
131230300200000,NE 151,RESIDENTIAL,43512,0,43512,194709,0,238221
131230300300000,NE 151,RESIDENTIAL,43512,0,43512,218138,0,261650
131230300400000,NE 151,RESIDENTIAL,43512,0,43512,195912,0,239424
131230300500000,NE 151,RESIDENTIAL,33590,0,33590,0,0,33590
131230300600000,NE 151,RESIDENTIAL,46704,0,46704,234985,0,281689
131230300900000,NE 151,RESIDENTIAL,34485,0,34485,0,0,34485
131230301000000,NE 151,RESIDENTIAL,38220,0,38220,0,0,38220
131230301100000,NE 151,RESIDENTIAL,35339,0,35339,0,0,35339
131230301200000,NE 151,RESIDENTIAL,35344,0,35344,0,0,35344
131230301300000,NE 151,RESIDENTIAL,33727,0,33727,0,0,33727
131230301400000,NE 151,RESIDENTIAL,35968,0,35968,0,0,35968
131230301500000,NE 151,RESIDENTIAL,46920,0,46920,249548,0,296468
131230301600000,NE 151,RESIDENTIAL,45082,0,45082,254282,0,299364
131230301900000,NE 151,RESIDENTIAL,39984,0,39984,229393,0,269377
131230302000000,NE 151,RESIDENTIAL,39396,0,39396,237826,0,277222
131230302100000,NE 151,RESIDENTIAL,42336,0,42336,241623,0,283959
131230302200000,NE 151,RESIDENTIAL,52794,0,52794,278887,0,331681
131230302300000,NE 151,RESIDENTIAL,51840,0,51840,280866,0,332706
131230302400000,NE 151,RESIDENTIAL,48960,0,48960,277709,0,326669
131230302500000,NE 151,RESIDENTIAL,38051,0,38051,0,0,38051
131230302600000,NE 151,RESIDENTIAL,2350,0,2350,0,0,2350
131230302700000,NE 151,RESIDENTIAL,850,0,850,0,0,850
131230302800000,NE 151,RESIDENTIAL,41376,0,41376,254634,0,296010
131230302900000,NE 151,RESIDENTIAL,42372,0,42372,223754,0,266126
131230303100000,NE 151,RESIDENTIAL,38938,0,38938,0,0,38938
131230303200000,NE 151,RESIDENTIAL,63650,0,63650,242573,0,306223
131230400100000,NE 151,RESIDENTIAL,3806,0,3806,0,0,3806
131230400200000,NE 151,RESIDENTIAL,4044,0,4044,0,0,4044
131230400300000,NE 151,RESIDENTIAL,63648,0,63648,258111,0,321759
131230400400000,NE 151,RESIDENTIAL,59280,0,59280,314673,0,373953
131232600200000,NE 151,RESIDENTIAL,212800,0,212800,308063,0,520863
131232600300000,NE 151,RESIDENTIAL,15901,0,15901,0,0,15901
131232600400000,NE 151,RESIDENTIAL,3893,0,3893,0,0,3893
131232600500000,NE 151,RESIDENTIAL,3964,0,3964,0,0,3964
131232600600000,NE 151,RESIDENTIAL,4359,0,4359,0,0,4359
131232600900000,NE 151,RESIDENTIAL,73260,0,73260,356050,0,429310
131232601000000,NE 151,RESIDENTIAL,57780,0,57780,324526,0,382306
131232601100000,NE 151,RESIDENTIAL,56160,0,56160,361471,0,417631
131232601200000,NE 151,RESIDENTIAL,62400,0,62400,289933,0,352333
131232601300000,NE 151,RESIDENTIAL,2109,0,2109,0,0,2109
131232601400000,NE 151,RESIDENTIAL,103679,0,103679,333866,0,437545
131232601500000,NE 151,RESIDENTIAL,10117,0,10117,0,0,10117
131232601600000,NE 151,RESIDENTIAL,98342,0,98342,340827,0,439169
131232601700000,NE 151,RESIDENTIAL,82,0,82,0,0,82
131232601800000,NE 151,RESIDENTIAL,63,0,63,0,0,63
131232601900000,NE 151,RESIDENTIAL,93004,0,93004,454950,0,547954
131232602000000,NE 151,RESIDENTIAL,70,0,70,0,0,70
131232602100000,NE 151,RESIDENTIAL,63656,0,63656,79727,0,143383
131232602200000,NE 151,RESIDENTIAL,73872,0,73872,348807,0,422679
131232602300000,NE 151,RESIDENTIAL,78343,0,78343,330429,0,408772
131232602400000,NE 151,RESIDENTIAL,67592,0,67592,292268,0,359860
131232602500000,NE 151,RESIDENTIAL,71400,0,71400,473288,0,544688
131232700100000,NE 151,RESIDENTIAL,59280,0,59280,303663,0,362943
131232700200000,NE 151,RESIDENTIAL,59280,0,59280,290627,0,349907
131232700300000,NE 151,RESIDENTIAL,59280,0,59280,291647,0,350927
131232700400000,NE 151,RESIDENTIAL,59280,0,59280,148333,0,207613
131232700500000,NE 151,RESIDENTIAL,65730,0,65730,312852,0,378582
131232700600000,NE 151,RESIDENTIAL,65084,0,65084,287843,0,352927
131232700700000,NE 151,RESIDENTIAL,63024,0,63024,368817,0,431841
131232700800000,NE 151,RESIDENTIAL,58656,0,58656,388722,0,447378
131232700900000,NE 151,RESIDENTIAL,98,0,98,0,0,98
131232701000000,NE 151,RESIDENTIAL,92,0,92,0,0,92
131232701100000,NE 151,RESIDENTIAL,59280,0,59280,299951,0,359231
131232701200000,NE 151,RESIDENTIAL,61984,0,61984,348549,0,410533
131232701300000,NE 151,RESIDENTIAL,90,0,90,0,0,90
131232701400000,NE 151,RESIDENTIAL,67560,0,67560,311237,0,378797
131232701500000,NE 151,RESIDENTIAL,89,0,89,0,0,89
131232701600000,NE 151,RESIDENTIAL,1186,0,1186,0,0,1186
131235100300000,NE 150,RESIDENTIAL,46545,0,46545,226516,0,273061
131235100400000,NE 150,RESIDENTIAL,46545,0,46545,295612,0,342157
131235100500000,NE 150,RESIDENTIAL,47952,0,47952,258281,0,306233
131235100600000,NE 150,RESIDENTIAL,45842,0,45842,288828,0,334670
131235100700000,NE 150,RESIDENTIAL,45450,0,45450,253567,0,299017
131235100800000,NE 150,RESIDENTIAL,50058,0,50058,304166,0,354224
131235100900000,NE 150,RESIDENTIAL,48875,0,48875,267229,0,316104
131235101000000,NE 150,RESIDENTIAL,57881,0,57881,491963,0,549844
131235101100000,NE 150,RESIDENTIAL,56475,0,56475,221516,0,277991
131235101200000,NE 150,RESIDENTIAL,48386,0,48386,204093,0,252479
131235101400000,NE 150,RESIDENTIAL,40388,0,40388,260357,0,300745
131235101500000,NE 150,RESIDENTIAL,59676,0,59676,260790,0,320466
131235101600000,NE 150,RESIDENTIAL,52877,0,52877,0,0,52877
131235101700000,NE 150,RESIDENTIAL,55080,0,55080,279656,0,334736
131235101800000,NE 150,RESIDENTIAL,55892,0,55892,261529,0,317421
131235101900000,NE 150,RESIDENTIAL,71410,0,71410,298733,0,370143
131235102000000,NE 150,RESIDENTIAL,56150,0,56150,279165,0,335315
131235102100000,NE 150,RESIDENTIAL,58629,0,58629,374090,0,432719
131235102200000,NE 150,RESIDENTIAL,66980,0,66980,320437,0,387417
131235102300000,NE 150,RESIDENTIAL,63625,0,63625,313239,0,376864
131235102400000,NE 150,RESIDENTIAL,57270,0,57270,404680,0,461950
131235102500000,NE 150,RESIDENTIAL,61608,0,61608,359697,0,421305
131235102600000,NE 150,RESIDENTIAL,55080,0,55080,295570,0,350650
131235102700000,NE 150,RESIDENTIAL,55262,0,55262,304497,0,359759
131235102800000,NE 150,RESIDENTIAL,24500,0,24500,0,0,24500
131235102900000,NE 150,RESIDENTIAL,23240,0,23240,0,0,23240
131235103000000,NE 150,RESIDENTIAL,56150,0,56150,341678,0,397828
131235103100000,NE 150,RESIDENTIAL,56160,0,56160,279683,0,335843
131235103200000,NE 150,RESIDENTIAL,56160,0,56160,285492,0,341652
131235103300000,NE 150,RESIDENTIAL,56160,0,56160,204806,0,260966
131235103400000,NE 150,RESIDENTIAL,56160,0,56160,219864,0,276024
131235103500000,NE 150,RESIDENTIAL,59193,0,59193,252923,0,312116
131235103600000,NE 151,RESIDENTIAL,1250,0,1250,0,0,1250
131235103700000,NE 150,RESIDENTIAL,3340,0,3340,1105,0,4445
131235103800000,NE 150,RESIDENTIAL,62266,0,62266,213997,0,276263
131235200100000,NE 150,RESIDENTIAL,46980,0,46980,232976,0,279956
131235200200000,NE 150,RESIDENTIAL,45360,0,45360,273504,0,318864
131235200300000,NE 150,RESIDENTIAL,45081,0,45081,269273,0,314354
131235200400000,NE 150,RESIDENTIAL,45360,0,45360,220857,0,266217
131235200500000,NE 150,RESIDENTIAL,45360,0,45360,272148,0,317508
131235200600000,NE 150,RESIDENTIAL,44012,0,44012,276382,0,320394
131235200700000,NE 150,RESIDENTIAL,44779,0,44779,272732,0,317511
131235200800000,NE 150,RESIDENTIAL,46638,0,46638,179715,0,226353
131235200900000,NE 150,RESIDENTIAL,46332,0,46332,167357,0,213689
131235201000000,NE 150,RESIDENTIAL,45360,0,45360,155632,0,200992
131235201100000,NE 150,RESIDENTIAL,45360,0,45360,181964,0,227324
131235201200000,NE 150,RESIDENTIAL,39162,0,39162,211448,0,250610
131235201300000,NE 150,RESIDENTIAL,44409,0,44409,208468,0,252877
131235201400000,NE 150,RESIDENTIAL,45894,0,45894,200286,0,246180
131235300100000,NE 150,RESIDENTIAL,57339,0,57339,337132,0,394471
131235300200000,NE 150,RESIDENTIAL,56844,0,56844,290429,0,347273
131235300300000,NE 150,RESIDENTIAL,56844,0,56844,251230,0,308074
131235300400000,NE 150,RESIDENTIAL,56652,0,56652,365549,0,422201
131237600100000,NE 150,RESIDENTIAL,45720,0,45720,127456,0,173176
131237600200000,NE 150,RESIDENTIAL,44300,0,44300,107589,0,151889
131237600300000,NE 150,RESIDENTIAL,45020,0,45020,165689,0,210709
131237600500000,NE 150,RESIDENTIAL,20,0,20,0,0,20
131237600600000,NE 150,RESIDENTIAL,45920,0,45920,174691,0,220611
131237600700000,NE 150,RESIDENTIAL,44300,0,44300,173948,0,218248
131237600800000,NE 150,RESIDENTIAL,43670,0,43670,296612,0,340282
131237600900000,NE 150,RESIDENTIAL,52826,0,52826,0,0,52826
131237601000000,NE 150,RESIDENTIAL,52568,0,52568,301728,0,354296
131237601100000,NE 150,RESIDENTIAL,52559,0,52559,340915,0,393474
131237601200000,NE 150,RESIDENTIAL,70100,0,70100,368479,0,438579
131237601300000,NE 150,RESIDENTIAL,16900,0,16900,0,0,16900
131237601500000,NE 150,RESIDENTIAL,62000,0,62000,143872,0,205872
131237700100000,NE 150,RESIDENTIAL,40363,0,40363,216865,0,257228
131237700200000,NE 150,RESIDENTIAL,36504,0,36504,221960,0,258464
131237700300000,NE 150,RESIDENTIAL,36188,0,36188,212759,0,248947
131237700400000,NE 150,RESIDENTIAL,37736,0,37736,217089,0,254825
131237700500000,NE 150,RESIDENTIAL,39312,0,39312,245161,0,284473
131237800100000,NE 150,RESIDENTIAL,49401,0,49401,189557,0,238958
131237800200000,NE 150,RESIDENTIAL,47669,0,47669,239797,0,287466
131237800300000,NE 150,RESIDENTIAL,52200,0,52200,167410,0,219610
131237800400000,NE 150,RESIDENTIAL,52200,0,52200,258259,0,310459
131237800500000,NE 150,RESIDENTIAL,52200,0,52200,359661,0,411861
131237800600000,NE 150,RESIDENTIAL,46980,0,46980,193935,0,240915
131237800700000,NE 150,RESIDENTIAL,51750,0,51750,229089,0,280839
131237900100000,NE 150,RESIDENTIAL,41724,0,41724,261059,0,302783
131237900200000,NE 150,RESIDENTIAL,42066,0,42066,295910,0,337976
131237900300000,NE 150,RESIDENTIAL,46545,0,46545,262169,0,308714
131237900400000,NE 150,RESIDENTIAL,49755,0,49755,284045,0,333800
131237900500000,NE 150,RESIDENTIAL,45765,0,45765,307893,0,353658
131238000100000,NE 150,RESIDENTIAL,50220,0,50220,280900,0,331120
131238000200000,NE 150,RESIDENTIAL,46980,0,46980,288194,0,335174
131238000300000,NE 150,RESIDENTIAL,44298,0,44298,227281,0,271579
131238000400000,NE 150,RESIDENTIAL,48600,0,48600,190430,0,239030
131240100200000,NE 151,RESIDENTIAL,10000,0,10000,0,0,10000
131240100700000,NE 151,RESIDENTIAL,3550,0,3550,0,0,3550
131240100800000,NE 151,RESIDENTIAL,100250,0,100250,0,0,100250
131240100900000,NE 151,RESIDENTIAL,23444,0,23444,0,0,23444
131240101000000,NE 151,RESIDENTIAL,14539,0,14539,0,0,14539
131240101100000,NE 151,RESIDENTIAL,12632,0,12632,0,0,12632
131240101200000,NE 151,RESIDENTIAL,97200,0,97200,494362,0,591562
131240101300000,NE 151,RESIDENTIAL,13167,0,13167,0,0,13167
131240101400000,NE 151,RESIDENTIAL,11776,0,11776,0,0,11776
131240101500000,NE 151,RESIDENTIAL,11421,0,11421,0,0,11421
131240101600000,NE 151,RESIDENTIAL,11218,0,11218,0,0,11218
131240101700000,NE 151,RESIDENTIAL,10996,0,10996,0,0,10996
131240200100000,NE 151,RESIDENTIAL,13584,0,13584,0,0,13584
131240200200000,NE 151,RESIDENTIAL,17739,0,17739,0,0,17739
131240200300000,NE 151,RESIDENTIAL,15633,0,15633,0,0,15633
131240200400000,NE 151,RESIDENTIAL,15403,0,15403,0,0,15403
131240200500000,NE 151,RESIDENTIAL,17165,0,17165,0,0,17165
131240200600000,NE 151,RESIDENTIAL,17307,0,17307,0,0,17307
131242700100000,NE 151,RESIDENTIAL,58813,0,58813,294009,0,352822
131242700200000,NE 151,RESIDENTIAL,51869,0,51869,273131,0,325000
131242700300000,NE 151,RESIDENTIAL,57662,0,57662,391442,0,449104
131242700400000,NE 151,RESIDENTIAL,51209,0,51209,348339,0,399548
131242700500000,NE 151,RESIDENTIAL,62172,0,62172,323075,0,385247
131242700700000,NE 151,RESIDENTIAL,4081,0,4081,0,0,4081
131242700800000,NE 151,RESIDENTIAL,68800,0,68800,324364,0,393164
131242700900000,NE 151,RESIDENTIAL,90600,0,90600,461864,0,552464
131242701000000,NE 151,RESIDENTIAL,57800,0,57800,300264,0,358064
131242701100000,NE 151,RESIDENTIAL,59850,0,59850,268104,0,327954
131242800100000,NE 151,RESIDENTIAL,58672,0,58672,271158,0,329830
131242800200000,NE 151,RESIDENTIAL,74899,0,74899,0,0,74899
131242800300000,NE 151,RESIDENTIAL,58800,0,58800,291339,0,350139
131242800500000,NE 151,RESIDENTIAL,84944,0,84944,309404,0,394348
131242800600000,NE 151,RESIDENTIAL,76860,0,76860,294026,0,370886
131242800700000,NE 151,RESIDENTIAL,63774,0,63774,274200,0,337974
131242800800000,NE 151,RESIDENTIAL,52724,0,52724,290077,0,342801
131242800900000,NE 151,RESIDENTIAL,52920,0,52920,286324,0,339244
131242801000000,NE 151,RESIDENTIAL,52920,0,52920,310322,0,363242
131242801100000,NE 151,RESIDENTIAL,52920,0,52920,287517,0,340437
131242801300000,NE 151,RESIDENTIAL,1505,0,1505,0,0,1505
131242801400000,NE 151,RESIDENTIAL,52920,0,52920,274653,0,327573
131242801500000,NE 151,RESIDENTIAL,1503,0,1503,0,0,1503
131242801600000,NE 151,RESIDENTIAL,55984,0,55984,330501,0,386485
131242801700000,NE 151,RESIDENTIAL,75087,0,75087,355548,0,430635
131242801800000,NE 151,RESIDENTIAL,80100,0,80100,359469,0,439569
131242801900000,NE 151,RESIDENTIAL,69120,0,69120,333113,0,402233
131242802000000,NE 151,RESIDENTIAL,70800,0,70800,377675,0,448475
131242802200000,NE 151,RESIDENTIAL,57820,0,57820,323630,0,381450
131242802400000,NE 151,RESIDENTIAL,61984,0,61984,346585,0,408569
131242802500000,NE 151,RESIDENTIAL,49657,0,49657,347712,0,397369
131242802600000,NE 151,RESIDENTIAL,1176,0,1176,0,0,1176
131242802700000,NE 151,RESIDENTIAL,51744,0,51744,189866,0,241610
131242802800000,NE 151,RESIDENTIAL,99192,0,99192,350721,0,449913
131242802900000,NE 151,RESIDENTIAL,99204,0,99204,423880,0,523084
131242803000000,NE 151,RESIDENTIAL,98280,0,98280,307801,0,406081
131242900100000,NE 151,RESIDENTIAL,52322,0,52322,271479,0,323801
131242900200000,NE 151,RESIDENTIAL,54540,0,54540,272187,0,326727
131242900300000,NE 151,RESIDENTIAL,53928,0,53928,273399,0,327327
131242900400000,NE 151,RESIDENTIAL,59811,0,59811,0,0,59811
131242900500000,NE 151,RESIDENTIAL,52920,0,52920,0,0,52920
131242900600000,NE 151,RESIDENTIAL,52920,0,52920,300249,0,353169
131242900700000,NE 151,RESIDENTIAL,52920,0,52920,292383,0,345303
131242900800000,NE 151,RESIDENTIAL,52920,0,52920,307872,0,360792
131242900900000,NE 151,RESIDENTIAL,52380,0,52380,293670,0,346050
131242901000000,NE 151,RESIDENTIAL,1568,0,1568,0,0,1568
131242901100000,NE 151,RESIDENTIAL,59956,0,59956,246564,0,306520
131242901200000,NE 151,RESIDENTIAL,1362,0,1362,0,0,1362
131242901300000,NE 151,RESIDENTIAL,46412,0,46412,275271,0,321683
131242901400000,NE 151,RESIDENTIAL,46699,0,46699,202300,0,248999
131242901500000,NE 151,RESIDENTIAL,55814,0,55814,242496,0,298310
131242901600000,NE 151,RESIDENTIAL,41706,0,41706,233524,0,275230
131242901700000,NE 151,RESIDENTIAL,1500,0,1500,0,0,1500
131242901800000,NE 151,RESIDENTIAL,58770,0,58770,343419,0,402189
131242901900000,NE 151,RESIDENTIAL,57722,0,57722,207882,0,265604
131242902000000,NE 151,RESIDENTIAL,51000,0,51000,259187,0,310187
131242902100000,NE 151,RESIDENTIAL,42174,0,42174,237423,0,279597
131242902200000,NE 151,RESIDENTIAL,41580,0,41580,197481,0,239061
131242902300000,NE 151,RESIDENTIAL,42828,0,42828,232018,0,274846
131242902400000,NE 151,RESIDENTIAL,2658,0,2658,0,0,2658
131243000100000,NE 151,RESIDENTIAL,49600,0,49600,0,0,49600
131243000200000,NE 151,RESIDENTIAL,53087,0,53087,0,0,53087
131243000300000,NE 151,RESIDENTIAL,53928,0,53928,0,0,53928
131243000400000,NE 151,RESIDENTIAL,49157,0,49157,0,0,49157
131243000500000,NE 151,RESIDENTIAL,57920,0,57920,0,0,57920
131243000600000,NE 151,RESIDENTIAL,59160,0,59160,0,0,59160
131243100100000,NE 151,RESIDENTIAL,57154,0,57154,301898,0,359052
131243100200000,NE 151,RESIDENTIAL,1480,0,1480,0,0,1480
131243100300000,NE 151,RESIDENTIAL,46007,0,46007,0,0,46007
131243200100000,NE 151,RESIDENTIAL,12876,0,12876,0,0,12876
131245100200000,NE 150,RESIDENTIAL,60350,0,60350,209237,0,269587
131245100300000,NE 150,RESIDENTIAL,60300,0,60300,159888,0,220188
131245100400000,NE 150,RESIDENTIAL,60250,0,60250,176717,0,236967
131245100500000,NE 150,RESIDENTIAL,20,0,20,0,0,20
131245100600000,NE 150,RESIDENTIAL,20,0,20,0,0,20
131245200100000,NE 150,RESIDENTIAL,60700,0,60700,152323,0,213023
131245200200000,NE 150,RESIDENTIAL,61100,0,61100,155910,0,217010
131245200300000,NE 150,RESIDENTIAL,60100,0,60100,184553,0,244653
131245200400000,NE 150,RESIDENTIAL,20,0,20,0,0,20
131245200500000,NE 150,RESIDENTIAL,55370,0,55370,173112,0,228482
131245200600000,NE 150,RESIDENTIAL,60300,0,60300,150508,0,210808
131245200700000,NE 150,RESIDENTIAL,61050,0,61050,219424,0,280474
131245200800000,NE 150,RESIDENTIAL,61150,0,61150,185847,0,246997
131245201000000,NE 150,RESIDENTIAL,43721,0,43721,159344,0,203065
131245201100000,NE 150,RESIDENTIAL,46446,0,46446,161045,0,207491
131245201200000,NE 150,RESIDENTIAL,61750,0,61750,212898,0,274648
131245201300000,NE 150,RESIDENTIAL,22000,0,22000,0,0,22000
131245201400000,NE 150,RESIDENTIAL,57060,0,57060,152291,0,209351
131245201500000,NE 150,RESIDENTIAL,60300,0,60300,181234,0,241534
131245201600000,NE 150,RESIDENTIAL,20,0,20,0,0,20
131245300200000,NE 151,RESIDENTIAL,60588,0,60588,0,0,60588
131245300900000,NE 151,RESIDENTIAL,970,0,970,0,0,970
131245301000000,NE 151,RESIDENTIAL,64980,0,64980,4498,0,69478
131245301100000,NE 151,RESIDENTIAL,71604,0,71604,393081,0,464685
131245301600000,NE 151,RESIDENTIAL,77760,0,77760,391409,0,469169
131245301700000,NE 151,RESIDENTIAL,126062,0,126062,365149,0,491211
131245400100000,NE 151,RESIDENTIAL,60234,0,60234,0,0,60234
131245400200000,NE 151,RESIDENTIAL,58406,0,58406,0,0,58406
131245400300000,NE 151,RESIDENTIAL,59296,0,59296,0,0,59296
131245400400000,NE 151,RESIDENTIAL,60950,0,60950,351354,0,412304
131245400500000,NE 151,RESIDENTIAL,58338,0,58338,0,0,58338
131245400600000,NE 151,RESIDENTIAL,56636,0,56636,358749,0,415385
131245400800000,NE 151,RESIDENTIAL,66708,0,66708,0,0,66708
131245400900000,NE 151,RESIDENTIAL,71300,0,71300,338304,0,409604
131245401000000,NE 151,RESIDENTIAL,2220,0,2220,0,0,2220
131247600500000,NE 151,RESIDENTIAL,111300,0,111300,611708,0,723008
131247600600000,NE 151,RESIDENTIAL,104000,0,104000,475211,0,579211
131247600700000,NE 151,RESIDENTIAL,92131,0,92131,76198,0,168329
131247600800000,NE 151,RESIDENTIAL,4828,0,4828,0,0,4828
131247600900000,NE 151,RESIDENTIAL,97468,0,97468,458951,0,556419
131247601000000,NE 151,RESIDENTIAL,88200,0,88200,409986,0,498186
131247601100000,NE 151,RESIDENTIAL,127925,0,127925,523010,0,650935
131247601200000,NE 151,RESIDENTIAL,97249,0,97249,637975,0,735224
131247601300000,NE 151,RESIDENTIAL,4051,0,4051,0,0,4051
131247601400000,NE 151,RESIDENTIAL,2718,0,2718,0,0,2718
131247601500000,NE 151,RESIDENTIAL,2575,0,2575,0,0,2575
131247601600000,NE 151,RESIDENTIAL,75600,0,75600,350176,0,425776
131247601700000,NE 151,RESIDENTIAL,114800,0,114800,0,0,114800
131247601900000,NE 151,RESIDENTIAL,8300,0,8300,0,0,8300
131247602000000,NE 151,RESIDENTIAL,72850,0,72850,0,0,72850
131312700100000,NE 150,AG LAND,32889,0,32889,0,0,32889
131320100100000,NE 150,AG DWELLING,15336,0,15336,107744,0,123080
131320200100000,NE 150,RESIDENTIAL,51750,0,51750,266917,0,318667
131320200200000,NE 150,RESIDENTIAL,35313,0,35313,116982,0,152295
131320200300000,NE 150,RESIDENTIAL,36563,0,36563,146860,0,183423
131320300100000,NE 150,RESIDENTIAL,49050,0,49050,217418,0,266468
131320300200000,NE 150,RESIDENTIAL,44712,0,44712,296823,0,341535
131320300300000,NE 150,RESIDENTIAL,40875,0,40875,148261,0,189136
131320300400000,NE 150,RESIDENTIAL,40875,0,40875,128150,0,169025
131320400100000,NE 150,RESIDENTIAL,39360,0,39360,146110,0,185470
131320400200000,NE 150,RESIDENTIAL,41605,0,41605,190139,0,231744
131320400300000,NE 150,RESIDENTIAL,39322,0,39322,191934,0,231256
131320400400000,NE 150,RESIDENTIAL,45985,0,45985,188735,0,234720
131322600100000,NE 150,RESIDENTIAL,46539,0,46539,212731,0,259270
131322600200000,NE 150,RESIDENTIAL,45412,0,45412,156568,0,201980
131322600300000,NE 150,RESIDENTIAL,41053,0,41053,188829,0,229882
131322600400000,NE 150,RESIDENTIAL,45126,0,45126,148368,0,193494
131322600500000,NE 150,RESIDENTIAL,47087,0,47087,234808,0,281895
131322600600000,NE 150,RESIDENTIAL,46105,0,46105,181252,0,227357
131322600700000,NE 150,RESIDENTIAL,46091,0,46091,224718,0,270809
131322600800000,NE 150,RESIDENTIAL,37427,0,37427,148010,0,185437
131322600900000,NE 150,RESIDENTIAL,40875,0,40875,189789,0,230664
131322601000000,NE 150,RESIDENTIAL,40875,0,40875,168177,0,209052
131322601100000,NE 150,RESIDENTIAL,40875,0,40875,149972,0,190847
131322601200000,NE 150,RESIDENTIAL,40875,0,40875,167938,0,208813
131322601300000,NE 150,RESIDENTIAL,40875,0,40875,123842,0,164717
131322601400000,NE 150,RESIDENTIAL,40875,0,40875,147347,0,188222
131322700100000,NE 150,RESIDENTIAL,45985,0,45985,238728,0,284713
131322700200000,NE 150,RESIDENTIAL,40875,0,40875,252767,0,293642
131322700300000,NE 150,RESIDENTIAL,40875,0,40875,165071,0,205946
131322700400000,NE 150,RESIDENTIAL,40875,0,40875,219965,0,260840
131322700500000,NE 150,RESIDENTIAL,40875,0,40875,293012,0,333887
131322700600000,NE 150,RESIDENTIAL,39967,0,39967,171059,0,211026
131322700700000,NE 150,RESIDENTIAL,45075,0,45075,220002,0,265077
131322700800000,NE 150,RESIDENTIAL,34960,0,34960,227189,0,262149
131322700900000,NE 150,RESIDENTIAL,33656,0,33656,179465,0,213121
131322701000000,NE 150,RESIDENTIAL,44887,0,44887,178719,0,223606
131322701100000,NE 150,RESIDENTIAL,44799,0,44799,233534,0,278333
131327600100000,CITY PROPERTY,EXEMPT,0,0,0,0,0,0
131330100100000,NW 302,RESIDENTIAL,85680,0,85680,237617,0,323297
131335100700000,NW 309,RESIDENTIAL,110950,0,110950,750058,0,861008
131335100800000,NW 309,RESIDENTIAL,2700,0,2700,0,0,2700
131335100900000,NW 302,RESIDENTIAL,12250,0,12250,0,0,12250
131337600500000,NW 353,RESIDENTIAL,1917,0,1917,0,0,1917
131337600600000,NW 353,RESIDENTIAL,2637,0,2637,0,0,2637
131337600700000,NW 353,RESIDENTIAL,50400,0,50400,288207,0,338607
131337600800000,NW 353,RESIDENTIAL,3173,0,3173,0,0,3173
131337600900000,NW 353,RESIDENTIAL,4951,0,4951,0,0,4951
131337601000000,NW 353,RESIDENTIAL,7798,0,7798,0,0,7798
131337601100000,NW 353,RESIDENTIAL,110287,0,110287,0,0,110287
131337601700000,NW 353,RESIDENTIAL,24863,0,24863,0,0,24863
131337601800000,NW 302,RESIDENTIAL,84700,0,84700,0,0,84700
131337602000000,NW 353,RESIDENTIAL,83160,0,83160,561382,0,644542
131337700100000,NW 353,RESIDENTIAL,2218,0,2218,0,0,2218
131337700200000,NW 353,RESIDENTIAL,36380,0,36380,7840,0,44220
131337700300000,NW 353,RESIDENTIAL,2286,0,2286,0,0,2286
131337700400000,NW 353,RESIDENTIAL,2260,0,2260,0,0,2260
131337700500000,NW 353,RESIDENTIAL,36380,0,36380,268558,0,304938
131337700600000,NW 353,RESIDENTIAL,3894,0,3894,0,0,3894
131342600100000,NW 302,RESIDENTIAL,10500,0,10500,0,0,10500
131342600200000,NW 353,RESIDENTIAL,10500,0,10500,0,0,10500
131342600300000,NW 302,RESIDENTIAL,144400,0,144400,94760,0,239160
131342600400000,NW 302,RESIDENTIAL,78250,0,78250,173792,0,252042
131345100300000,NW 353,RESIDENTIAL,35272,0,35272,0,0,35272
131345100400000,NW 353,RESIDENTIAL,36480,0,36480,235773,0,272253
131345100500000,NW 353,RESIDENTIAL,39317,0,39317,241453,0,280770
131345100600000,NW 353,RESIDENTIAL,37240,0,37240,0,0,37240
131345100700000,NW 353,RESIDENTIAL,37813,0,37813,229290,0,267103
131345100800000,NW 353,RESIDENTIAL,28000,0,28000,209310,0,237310
131345100900000,NW 353,RESIDENTIAL,2754,0,2754,0,0,2754
131345101000000,CITY PROPERTY,EXEMPT,0,0,0,0,0,0
131345101400000,NW 353,RESIDENTIAL,1918,0,1918,0,0,1918
131345101800000,NW 353,RESIDENTIAL,33660,0,33660,264378,0,298038
131345101900000,NW 353,RESIDENTIAL,33660,0,33660,266967,0,300627
131345102000000,NW 353,RESIDENTIAL,2776,0,2776,0,0,2776
131345102100000,NW 353,RESIDENTIAL,34848,0,34848,254211,0,289059
131345102200000,NW 353,RESIDENTIAL,11367,0,11367,0,0,11367
131345102300000,NW 353,RESIDENTIAL,34828,0,34828,0,0,34828
131345102400000,NW 353,RESIDENTIAL,99658,0,99658,0,0,99658
131345200100000,NW 353,RESIDENTIAL,38080,0,38080,334203,0,372283
131345200200000,NW 353,RESIDENTIAL,37248,0,37248,236309,0,273557
131345200300000,NW 353,RESIDENTIAL,37800,0,37800,238355,0,276155
131345200400000,NW 353,RESIDENTIAL,34340,0,34340,244398,0,278738
131345200500000,NW 353,RESIDENTIAL,36360,0,36360,215057,0,251417
131345200600000,NW 353,RESIDENTIAL,35304,0,35304,226212,0,261516
131345200700000,NW 353,RESIDENTIAL,35812,0,35812,239434,0,275246
131345200800000,NW 353,RESIDENTIAL,36860,0,36860,292958,0,329818
131345200900000,NW 353,RESIDENTIAL,38409,0,38409,244075,0,282484
131345201000000,NW 353,RESIDENTIAL,5635,0,5635,0,0,5635
131345201100000,NW 353,RESIDENTIAL,4821,0,4821,0,0,4821
131345300100000,NW 353,RESIDENTIAL,38189,0,38189,289024,0,327213
131345300200000,NW 353,RESIDENTIAL,37451,0,37451,329386,0,366837
131345300300000,NW 353,RESIDENTIAL,34000,0,34000,258647,0,292647
131345300400000,NW 353,RESIDENTIAL,81800,0,81800,262578,0,344378
131345400200000,NW 353,RESIDENTIAL,41801,0,41801,239548,0,281349
131345400300000,NW 353,RESIDENTIAL,42293,0,42293,276658,0,318951
131345400400000,NW 353,RESIDENTIAL,40400,0,40400,294636,0,335036
131345400600000,NW 353,RESIDENTIAL,13790,0,13790,0,0,13790
131345400700000,NW 353,RESIDENTIAL,11012,0,11012,0,0,11012
131345400800000,NW 353,RESIDENTIAL,9504,0,9504,0,0,9504
131345400900000,NW 353,RESIDENTIAL,13597,0,13597,0,0,13597
131347600200000,NW 353,RESIDENTIAL,96000,0,96000,0,0,96000
131347600300000,NW 302,RESIDENTIAL,41850,0,41850,65156,0,107006
131347600400000,NW 337,RESIDENTIAL,52250,0,52250,108362,0,160612
131347600500000,NW 337,RESIDENTIAL,52250,0,52250,84339,0,136589
131347600600000,NW 337,RESIDENTIAL,52600,0,52600,188992,0,241592
131347600700000,NW 302,RESIDENTIAL,33962,0,33962,145736,0,179698
131347600800000,NW 302,RESIDENTIAL,25245,0,25245,44564,0,69809
131410100100000,CITY PROPERTY,EXEMPT,0,0,0,0,0,0
131515200500000,NW 332,RESIDENTIAL,7050,0,7050,0,0,7050
131515200600000,NW 332,RESIDENTIAL,54450,0,54450,260403,0,314853
131515200700000,NW 332,RESIDENTIAL,61468,0,61468,209545,0,271013
131515200800000,NW 332,RESIDENTIAL,62920,0,62920,239176,0,302096
131515200900000,CITY PROPERTY,EXEMPT,0,0,0,0,0,0
131515201000000,NW 332,RESIDENTIAL,62693,0,62693,208908,0,271601
131515201100000,NW 332,RESIDENTIAL,66330,0,66330,196370,0,262700
131515201200000,NW 332,RESIDENTIAL,67943,0,67943,202032,0,269975
131515201300000,NW 332,RESIDENTIAL,7140,0,7140,0,0,7140
131515201400000,NW 332,RESIDENTIAL,6985,0,6985,0,0,6985
131515201500000,NW 332,RESIDENTIAL,6697,0,6697,0,0,6697
131515201600000,NW 332,RESIDENTIAL,6645,0,6645,0,0,6645
131515201700000,NW 332,RESIDENTIAL,9321,0,9321,0,0,9321
131515201800000,NW 332,RESIDENTIAL,12875,0,12875,0,0,12875
131515201900000,NW 332,RESIDENTIAL,55869,0,55869,224593,0,280462
131515202000000,NW 332,RESIDENTIAL,49742,0,49742,206487,0,256229
131515202100000,NW 332,RESIDENTIAL,44880,0,44880,146840,0,191720
131515202200000,NW 332,RESIDENTIAL,5492,0,5492,0,0,5492
131515202300000,NW 332,RESIDENTIAL,5835,0,5835,0,0,5835
131515202400000,NW 332,RESIDENTIAL,5835,0,5835,0,0,5835
131515202500000,NW 332,RESIDENTIAL,5141,0,5141,0,0,5141
131515300100000,NW 332,RESIDENTIAL,50490,0,50490,297780,0,348270
131515300200000,NW 332,RESIDENTIAL,44880,0,44880,160718,0,205598
131515300300000,NW 332,RESIDENTIAL,5424,0,5424,0,0,5424
131515300400000,NW 332,RESIDENTIAL,8228,0,8228,0,0,8228
131515300500000,NW 332,RESIDENTIAL,56763,0,56763,230442,0,287205
131515300600000,NW 332,RESIDENTIAL,47498,0,47498,226323,0,273821
131515300700000,NW 332,RESIDENTIAL,47685,0,47685,249109,0,296794
131515300800000,NW 332,RESIDENTIAL,6179,0,6179,0,0,6179
131515300900000,NW 332,RESIDENTIAL,5835,0,5835,0,0,5835
131515301000000,NW 332,RESIDENTIAL,6179,0,6179,0,0,6179
131515301100000,NW 332,RESIDENTIAL,6179,0,6179,0,0,6179
131515301200000,NW 332,RESIDENTIAL,5985,0,5985,0,0,5985
131515301300000,NW 332,RESIDENTIAL,7268,0,7268,0,0,7268
131515301400000,NW 332,RESIDENTIAL,7978,0,7978,0,0,7978
131515301500000,NW 332,RESIDENTIAL,6865,0,6865,0,0,6865
131515301600000,NW 332,RESIDENTIAL,6865,0,6865,0,0,6865
131515301700000,NW 332,RESIDENTIAL,6865,0,6865,0,0,6865
131515400100000,NW 332,RESIDENTIAL,49555,0,49555,181217,0,230772
131515400200000,NW 332,RESIDENTIAL,49665,0,49665,210557,0,260222
131515400300000,NW 332,RESIDENTIAL,54841,0,54841,201878,0,256719
131515400400000,NW 332,RESIDENTIAL,7002,0,7002,0,0,7002
131515400500000,NW 332,RESIDENTIAL,6613,0,6613,0,0,6613
131515400600000,NW 332,RESIDENTIAL,6613,0,6613,0,0,6613
131515400700000,NW 332,RESIDENTIAL,7002,0,7002,0,0,7002
131515400800000,NW 332,RESIDENTIAL,7565,0,7565,0,0,7565
131515400900000,NW 332,RESIDENTIAL,8877,0,8877,0,0,8877
131515500100000,NW 332,RESIDENTIAL,8087,0,8087,0,0,8087
131515500200000,NW 332,RESIDENTIAL,53460,0,53460,189759,0,243219
131515500300000,NW 332,RESIDENTIAL,55791,0,55791,182281,0,238072
131522600100000,CITY PROPERTY,EXEMPT,0,0,0,0,0,0
131522600200000,NW 332,AG LAND,50917,0,50917,0,0,50917
131522600300000,NW 332,AG LAND,31111,0,31111,0,0,31111
131525100200000,NW 332,AG LAND,75481,0,75481,0,0,75481
131527600300000,NW 332,AG LAND,42384,0,42384,0,0,42384
131527600500000,NW 332,AG LAND,16141,0,16141,0,0,16141
131527600600000,NW 332,AG LAND,31408,0,31408,0,0,31408
131527600700000,NW 332,AG LAND,5270,0,5270,0,0,5270
131527600800000,NW 332,RESIDENTIAL,5980,0,5980,0,0,5980
131527700100000,NW 332,RESIDENTIAL,5833,0,5833,0,0,5833
131527700200000,NW 332,RESIDENTIAL,5803,0,5803,0,0,5803
131527700300000,NW 332,RESIDENTIAL,5782,0,5782,0,0,5782
131527700400000,NW 332,RESIDENTIAL,5422,0,5422,0,0,5422
131527800100000,NW 332,RESIDENTIAL,7412,0,7412,0,0,7412
131527800200000,NW 332,RESIDENTIAL,6024,0,6024,0,0,6024
131527900100000,NW 332,RESIDENTIAL,7323,0,7323,0,0,7323
131527900200000,NW 332,RESIDENTIAL,5858,0,5858,0,0,5858
131532600100000,CITY PROPERTY,EXEMPT,0,0,0,0,0,0
131542600200000,NW 332,AG DWELLING,62025,0,62025,95743,16675,174443
131542600400000,NW 332,RESIDENTIAL,52106,0,52106,193068,0,245174
131542600500000,NW 332,RESIDENTIAL,4791,0,4791,0,0,4791
131542600600000,NW 332,RESIDENTIAL,4775,0,4775,0,0,4775
131542600700000,NW 332,RESIDENTIAL,4758,0,4758,0,0,4758
131542600800000,NW 332,RESIDENTIAL,6044,0,6044,0,0,6044
131542600900000,NW 332,RESIDENTIAL,6437,0,6437,0,0,6437
131542601000000,NW 332,RESIDENTIAL,6049,0,6049,0,0,6049
131542601100000,NW 332,RESIDENTIAL,9217,0,9217,0,0,9217
131542601200000,CITY PROPERTY,EXEMPT,0,0,0,0,0,0
131542700100000,NW 332,RESIDENTIAL,5283,0,5283,0,0,5283
131542700200000,NW 332,RESIDENTIAL,4870,0,4870,0,0,4870
131542700300000,NW 332,RESIDENTIAL,5562,0,5562,0,0,5562
131542700400000,NW 332,RESIDENTIAL,52360,0,52360,176300,0,228660
131542700500000,NW 332,RESIDENTIAL,4755,0,4755,0,0,4755
131542700600000,NW 332,RESIDENTIAL,49544,0,49544,182109,0,231653
131542700700000,NW 332,RESIDENTIAL,47130,0,47130,161509,0,208639
131542700800000,NW 332,RESIDENTIAL,50490,0,50490,181202,0,231692
131542700900000,NW 332,RESIDENTIAL,54361,0,54361,162279,0,216640
131542800100000,NW 332,RESIDENTIAL,4520,0,4520,0,0,4520
131542800200000,NW 332,RESIDENTIAL,4000,0,4000,0,0,4000
131542800300000,NW 332,RESIDENTIAL,4155,0,4155,0,0,4155
131542800400000,NW 332,RESIDENTIAL,57693,0,57693,230882,0,288575
132222600100000,NW 332,AG LAND,44952,0,44952,0,0,44952
132222600200000,NW 332,AG LAND,42102,0,42102,0,0,42102
132225100100000,NW 332,AG LAND,83103,0,83103,0,0,83103
132225100200000,NW 332,RESIDENTIAL,45144,0,45144,75846,0,120990
132232600100000,NW 332,AG LAND,67288,0,67288,0,0,67288
132235100100000,NW 332,AG LAND,82965,0,82965,0,0,82965
132237600100000,COUNTY PROPERTY,EXEMPT,0,0,0,0,0,0
132245100100000,COUNTY PROPERTY,EXEMPT,0,0,0,0,0,0
132245100200000,NW 332,AG LAND,83268,0,83268,0,0,83268
132247600200000,NW 332,AG LAND,29387,0,29387,0,0,29387
132247600500000,NW 332,RESIDENTIAL,55726,0,55726,169199,0,224925
132247600600000,NW 332,RESIDENTIAL,46750,0,46750,194705,0,241455
132247600700000,NW 332,RESIDENTIAL,48279,0,48279,163317,0,211596
132247600800000,NW 332,RESIDENTIAL,45456,0,45456,156234,0,201690
132247600900000,NW 332,RESIDENTIAL,42350,0,42350,151578,0,193928
132247601000000,NW 332,RESIDENTIAL,44000,0,44000,144687,0,188687
132247601100000,NW 332,RESIDENTIAL,44000,0,44000,153249,0,197249
132247601200000,NW 332,RESIDENTIAL,40392,0,40392,150023,0,190415
132247601300000,NW 332,RESIDENTIAL,42962,0,42962,176047,0,219009
132247601400000,NW 332,RESIDENTIAL,276,0,276,0,0,276
132247601500000,NW 332,RESIDENTIAL,63393,0,63393,166687,0,230080
132247601600000,NW 332,RESIDENTIAL,58718,0,58718,254446,0,313164
132247601700000,NW 322,RESIDENTIAL,55609,0,55609,9975,0,65584
132247601800000,NW 322,RESIDENTIAL,52360,0,52360,256701,0,309061
132247601900000,NW 332,RESIDENTIAL,44000,0,44000,162103,0,206103
132247602000000,NW 332,RESIDENTIAL,39600,0,39600,156314,0,195914
132247602100000,NW 332,RESIDENTIAL,49500,0,49500,215331,0,264831
132247602200000,NW 322,RESIDENTIAL,488,0,488,0,0,488
132247602300000,NW 322,RESIDENTIAL,557,0,557,0,0,557
132247602400000,NW 332,RESIDENTIAL,68838,0,68838,251507,0,320345
132247602500000,NW 322,RESIDENTIAL,1900,0,1900,0,0,1900
132247602600000,NW 332,RESIDENTIAL,69828,0,69828,235752,0,305580
132247602700000,NW 332,RESIDENTIAL,44213,0,44213,168742,0,212955
132247602800000,NW 332,RESIDENTIAL,44880,0,44880,244542,0,289422
132247602900000,NW 332,RESIDENTIAL,41587,0,41587,182713,0,224300
132247603000000,NW 332,RESIDENTIAL,52910,0,52910,277530,0,330440
132247700100000,NW 332,RESIDENTIAL,42756,0,42756,172959,0,215715
132247700200000,NW 332,RESIDENTIAL,43472,0,43472,155214,0,198686
132247700300000,NW 332,RESIDENTIAL,46750,0,46750,166203,0,212953
132247700400000,NW 332,RESIDENTIAL,32538,0,32538,184846,0,217384
132247700500000,NW 332,RESIDENTIAL,44319,0,44319,161251,0,205570
132247700600000,NW 332,RESIDENTIAL,48807,0,48807,210206,0,259013
132247700700000,NW 332,RESIDENTIAL,283,0,283,0,0,283
132247700800000,NW 332,RESIDENTIAL,40146,0,40146,184326,0,224472
132247700900000,NW 332,RESIDENTIAL,46874,0,46874,199030,0,245904
132247701000000,NW 332,RESIDENTIAL,325,0,325,0,0,325
132247701100000,NW 332,RESIDENTIAL,45100,0,45100,150826,0,195926
132247701200000,NW 332,RESIDENTIAL,45980,0,45980,172502,0,218482
132247701300000,NW 332,RESIDENTIAL,57299,0,57299,175431,0,232730
132247701400000,NW 332,RESIDENTIAL,421,0,421,0,0,421
132247701500000,CITY PROPERTY,EXEMPT,0,0,0,0,0,0
132247701600000,NW 322,RESIDENTIAL,522,0,522,0,0,522
132247701700000,NW 322,RESIDENTIAL,453,0,453,0,0,453
132247701800000,NW 322,RESIDENTIAL,425,0,425,0,0,425
132247701900000,NW 322,RESIDENTIAL,345,0,345,0,0,345
132247702000000,NW 322,RESIDENTIAL,46200,0,46200,9975,0,56175
132247702100000,NW 322,RESIDENTIAL,356,0,356,0,0,356
132247702200000,NW 322,RESIDENTIAL,401,0,401,0,0,401
132247702300000,NW 322,RESIDENTIAL,414,0,414,0,0,414
132247702400000,NW 322,RESIDENTIAL,1194,0,1194,0,0,1194
132247702500000,NW 322,RESIDENTIAL,210,0,210,0,0,210
132247800100000,NW 322,RESIDENTIAL,700,0,700,0,0,700
132247800200000,NW 332,RESIDENTIAL,54230,0,54230,218354,0,272584
132247800300000,NW 332,RESIDENTIAL,44880,0,44880,212209,0,257089
132247800400000,NW 322,RESIDENTIAL,42372,0,42372,148661,0,191033
132247800500000,NW 332,RESIDENTIAL,50864,0,50864,139358,0,190222
132247800600000,NW 322,RESIDENTIAL,566,0,566,0,0,566
132247800700000,NW 322,RESIDENTIAL,453,0,453,0,0,453
132247800800000,NW 322,RESIDENTIAL,178,0,178,0,0,178
132247900100000,NW 332,RESIDENTIAL,48217,0,48217,184395,0,232612
132247900200000,NW 332,RESIDENTIAL,44403,0,44403,171178,0,215581
132247900300000,NW 332,RESIDENTIAL,52057,0,52057,197037,0,249094
132340200200000,SCHOOL,EXEMPT,0,0,0,0,0,0
132340200300000,NW 329,RESIDENTIAL,24056,0,24056,96017,0,120073
132340200400000,NW 329,RESIDENTIAL,23914,0,23914,100771,0,124685
132340200500000,NW 329,RESIDENTIAL,26025,0,26025,88156,0,114181
132340200600000,NW 329,RESIDENTIAL,27390,0,27390,101291,0,128681
132340200700000,NW 329,RESIDENTIAL,26536,0,26536,92344,0,118880
132340200800000,NW 329,RESIDENTIAL,26683,0,26683,118152,0,144835
132340200900000,NW 329,RESIDENTIAL,26670,0,26670,75642,0,102312
132340201000000,NW 329,RESIDENTIAL,29316,0,29316,104904,0,134220
132340300100000,NW 329,RESIDENTIAL,25995,0,25995,99837,0,125832
132340300200000,NW 329,RESIDENTIAL,24832,0,24832,113453,0,138285
132340300300000,NW 329,RESIDENTIAL,27645,0,27645,114246,0,141891
132340300400000,NW 329,RESIDENTIAL,27645,0,27645,95936,0,123581
132340300500000,NW 329,RESIDENTIAL,25175,0,25175,95031,0,120206
132340400100000,NW 329,RESIDENTIAL,26293,0,26293,106452,0,132745
132340400200000,NW 329,RESIDENTIAL,27234,0,27234,99980,0,127214
132340400300000,NW 329,RESIDENTIAL,26937,0,26937,94580,0,121517
132340400400000,NW 329,RESIDENTIAL,25867,0,25867,86618,0,112485
132340400500000,NW 329,RESIDENTIAL,24522,0,24522,104657,0,129179
132340400600000,NW 329,RESIDENTIAL,24522,0,24522,98702,0,123224
132340400700000,NW 329,RESIDENTIAL,27791,0,27791,101232,0,129023
132347600100000,NW 329,RESIDENTIAL,25175,0,25175,96086,0,121261
132347600200000,NW 329,RESIDENTIAL,25175,0,25175,101004,0,126179
132347600300000,NW 329,RESIDENTIAL,25175,0,25175,136341,0,161516
132347600400000,NW 329,RESIDENTIAL,25175,0,25175,108020,0,133195
132347600500000,NW 329,RESIDENTIAL,25175,0,25175,112664,0,137839
132347600600000,NW 329,RESIDENTIAL,27645,0,27645,112590,0,140235
132347700100000,NW 329,RESIDENTIAL,24522,0,24522,89609,0,114131
132347700200000,NW 329,RESIDENTIAL,24522,0,24522,93369,0,117891
132347700300000,NW 329,RESIDENTIAL,24522,0,24522,89899,0,114421
132347700400000,NW 329,RESIDENTIAL,24522,0,24522,110871,0,135393
132347700500000,NW 329,RESIDENTIAL,24522,0,24522,100998,0,125520
132347700600000,NW 329,RESIDENTIAL,24522,0,24522,89457,0,113979
132347700700000,NW 329,RESIDENTIAL,27238,0,27238,96858,0,124096
132347700800000,NW 329,RESIDENTIAL,24832,0,24832,98461,0,123293
132347700900000,NW 329,RESIDENTIAL,27238,0,27238,112836,0,140074
132347701000000,NW 329,RESIDENTIAL,24522,0,24522,90529,0,115051
132347701100000,NW 329,RESIDENTIAL,24522,0,24522,92886,0,117408
132347701200000,NW 329,RESIDENTIAL,24522,0,24522,106813,0,131335
132347701300000,NW 329,RESIDENTIAL,24522,0,24522,83068,0,107590
132347800100000,NW 329,RESIDENTIAL,24056,0,24056,103078,0,127134
132347800200000,NW 329,RESIDENTIAL,24056,0,24056,83891,0,107947
132347800300000,NW 329,RESIDENTIAL,25802,0,25802,128350,0,154152
132347800400000,NW 329,RESIDENTIAL,25802,0,25802,103311,0,129113
132347800500000,NW 329,RESIDENTIAL,24832,0,24832,113449,0,138281
132347800600000,NW 329,RESIDENTIAL,24832,0,24832,96388,0,121220
132347800700000,NW 329,RESIDENTIAL,24832,0,24832,98303,0,123135
132347800800000,NW 329,RESIDENTIAL,24832,0,24832,108151,0,132983
132347800900000,NW 329,RESIDENTIAL,26384,0,26384,117571,0,143955
132347801000000,SCHOOL,EXEMPT,0,0,0,0,0,0
132347900100000,NW 329,RESIDENTIAL,27373,0,27373,109771,0,137144
132347900200000,NW 329,RESIDENTIAL,24832,0,24832,95841,0,120673
132347900300000,NW 329,RESIDENTIAL,24832,0,24832,101716,0,126548
132347900400000,NW 329,RESIDENTIAL,24832,0,24832,119086,0,143918
132347900500000,NW 329,RESIDENTIAL,24832,0,24832,104384,0,129216
132347900600000,NW 329,RESIDENTIAL,24832,0,24832,105359,0,130191
132347900700000,NW 329,RESIDENTIAL,24832,0,24832,94394,0,119226
132347900800000,NW 329,RESIDENTIAL,24832,0,24832,94829,0,119661
132347900900000,NW 329,RESIDENTIAL,24832,0,24832,89591,0,114423
132347901000000,NW 329,RESIDENTIAL,24832,0,24832,97443,0,122275
132347901100000,NW 329,RESIDENTIAL,24832,0,24832,98841,0,123673
132347901200000,NW 329,RESIDENTIAL,27373,0,27373,107323,0,134696
132348000100000,NW 329,RESIDENTIAL,27238,0,27238,99449,0,126687
132348000200000,NW 329,RESIDENTIAL,24832,0,24832,98740,0,123572
132348000300000,NW 329,RESIDENTIAL,27238,0,27238,79060,0,106298
132348000400000,NW 329,RESIDENTIAL,25802,0,25802,99430,0,125232
132348000500000,NW 329,RESIDENTIAL,24716,0,24716,99188,0,123904
132348000600000,NW 329,RESIDENTIAL,24716,0,24716,92206,0,116922
132348000700000,NW 329,RESIDENTIAL,24716,0,24716,100041,0,124757
132348000800000,NW 329,RESIDENTIAL,24716,0,24716,116088,0,140804
132348000900000,NW 329,RESIDENTIAL,24716,0,24716,99472,0,124188
132348001000000,NW 329,RESIDENTIAL,24716,0,24716,89174,0,113890
132348001100000,NW 329,RESIDENTIAL,24716,0,24716,103435,0,128151
132348001200000,NW 329,RESIDENTIAL,25802,0,25802,96588,0,122390
132348001300000,NW 329,RESIDENTIAL,27238,0,27238,96720,0,123958
132348001400000,NW 329,RESIDENTIAL,24832,0,24832,114069,0,138901
132348001500000,NW 329,RESIDENTIAL,27238,0,27238,114788,0,142026
132348001600000,NW 329,RESIDENTIAL,25802,0,25802,102588,0,128390
132348001700000,NW 329,RESIDENTIAL,24716,0,24716,107887,0,132603
132348001800000,NW 329,RESIDENTIAL,24716,0,24716,96664,0,121380
132348001900000,NW 329,RESIDENTIAL,24716,0,24716,117460,0,142176
132348002000000,NW 329,RESIDENTIAL,24716,0,24716,101490,0,126206
132348002100000,NW 329,RESIDENTIAL,24716,0,24716,111847,0,136563
132348002200000,NW 329,RESIDENTIAL,24716,0,24716,109875,0,134591
132348002300000,NW 329,RESIDENTIAL,24716,0,24716,94441,0,119157
132348002400000,NW 329,RESIDENTIAL,25802,0,25802,100701,0,126503
132348100100000,NW 329,RESIDENTIAL,28557,0,28557,116349,0,144906
132348100200000,NW 329,RESIDENTIAL,25802,0,25802,85049,0,110851
132348100300000,NW 329,RESIDENTIAL,25802,0,25802,88674,0,114476
132348100400000,NW 329,RESIDENTIAL,25802,0,25802,104805,0,130607
132348100500000,NW 329,RESIDENTIAL,25802,0,25802,106929,0,132731
132348100600000,NW 329,RESIDENTIAL,25802,0,25802,112547,0,138349
132348100700000,NW 329,RESIDENTIAL,25802,0,25802,100611,0,126413
132348100800000,NW 329,RESIDENTIAL,26772,0,26772,127779,0,154551
132410100100000,NW 337,RESIDENTIAL,28000,0,28000,129046,0,157046
132410100200000,NW 337,RESIDENTIAL,67700,0,67700,2128,0,69828
132410100300000,NW 309,RESIDENTIAL,142332,0,142332,0,0,142332
132410100400000,NW 337,RESIDENTIAL,64800,0,64800,10778,0,75578
132410100402000,ANTENNAS/TOWERS(BLL),COMMERCIAL,0,0,0,0,13715,13715
132410100402001,ANTENNAS/TOWERS(BLL),COMMERCIAL,0,0,0,0,101123,101123
132410100402003,ANTENNAS/TOWERS(BLL),COMMERCIAL,0,0,0,0,17353,17353
132410100402004,ANTENNAS/TOWERS(BLL),COMMERCIAL,0,0,0,0,33251,33251
132410100402005,ANTENNAS/TOWERS(BLL),COMMERCIAL,0,0,0,0,48943,48943
132410100402006,ANTENNAS/TOWERS(BLL),COMMERCIAL,0,0,0,0,34748,34748
132410100500000,CITY PROPERTY,EXEMPT,0,0,0,0,0,0
132410100600000,NW 337,RESIDENTIAL,72850,0,72850,0,0,72850
132410100700000,NW 337,RESIDENTIAL,51100,0,51100,151410,0,202510
132410100800000,NW 337,RESIDENTIAL,53500,0,53500,94794,0,148294
132410100900000,NW 337,RESIDENTIAL,38640,0,38640,164909,0,203549
132410200400000,NW 309,RESIDENTIAL,38080,0,38080,224886,0,262966
132412600100000,NW 309,RESIDENTIAL,40375,0,40375,156629,0,197004
132412600200000,NW 309,RESIDENTIAL,40800,0,40800,166885,0,207685
132412600300000,NW 309,RESIDENTIAL,40800,0,40800,169176,0,209976
132412600400000,NW 309,RESIDENTIAL,40800,0,40800,191469,0,232269
132412600500000,NW 309,RESIDENTIAL,41650,0,41650,173830,0,215480
132412600600000,NW 309,RESIDENTIAL,39200,0,39200,123560,0,162760
132412600700000,NW 309,RESIDENTIAL,39200,0,39200,144726,0,183926
132412600800000,NW 309,RESIDENTIAL,42957,0,42957,168560,0,211517
132412600900000,NW 309,RESIDENTIAL,37939,0,37939,199127,0,237066
132412601000000,NW 309,RESIDENTIAL,38079,0,38079,187277,0,225356
132412601100000,NW 309,RESIDENTIAL,42013,0,42013,155070,0,197083
132412601200000,NW 309,RESIDENTIAL,40415,0,40415,234929,0,275344
132412700100000,NW 309,RESIDENTIAL,44296,0,44296,176812,0,221108
132412700200000,NW 309,RESIDENTIAL,44472,0,44472,127250,0,171722
132412700300000,NW 309,RESIDENTIAL,43619,0,43619,121798,0,165417
132412800200000,NW 309,RESIDENTIAL,38990,0,38990,198448,0,237438
132412800300000,NW 309,RESIDENTIAL,36800,0,36800,206147,0,242947
132412800400000,NW 309,RESIDENTIAL,36800,0,36800,220190,0,256990
132412800500000,NW 309,RESIDENTIAL,37200,0,37200,175660,0,212860
132412800600000,NW 309,RESIDENTIAL,38022,0,38022,164081,0,202103
132412800700000,NW 309,RESIDENTIAL,34979,0,34979,175095,0,210074
132412800800000,NW 342,AG LAND,22929,0,22929,0,2650,25579
132412800900000,NW 309,RESIDENTIAL,38116,0,38116,0,0,38116
132412801000000,NW 309,RESIDENTIAL,38116,0,38116,227112,0,265228
132412801100000,NW 309,RESIDENTIAL,38015,0,38015,163651,0,201666
132412801200000,NW 309,RESIDENTIAL,37694,0,37694,205833,0,243527
132412801400000,NW 309,RESIDENTIAL,36860,0,36860,187112,0,223972
132412801500000,NW 309,RESIDENTIAL,13887,0,13887,0,0,13887
132412801600000,NW 309,RESIDENTIAL,13734,0,13734,0,0,13734
132412900100000,NW 309,RESIDENTIAL,39285,0,39285,175918,0,215203
132412900200000,NW 309,RESIDENTIAL,40185,0,40185,218641,0,258826
132412900300000,NW 309,RESIDENTIAL,38002,0,38002,173692,0,211694
132412900400000,NW 309,RESIDENTIAL,37588,0,37588,148092,0,185680
132412900500000,NW 309,RESIDENTIAL,41580,0,41580,149928,0,191508
132412900600000,NW 309,RESIDENTIAL,41496,0,41496,121883,0,163379
132412900700000,NW 309,RESIDENTIAL,40099,0,40099,153563,0,193662
132412900800000,NW 309,RESIDENTIAL,42388,0,42388,213619,0,256007
132412900900000,NW 309,RESIDENTIAL,40984,0,40984,205149,0,246133
132412901000000,NW 309,RESIDENTIAL,41890,0,41890,152290,0,194180
132412901100000,NW 309,RESIDENTIAL,42344,0,42344,163177,0,205521
132412901200000,NW 309,RESIDENTIAL,41552,0,41552,175197,0,216749
132412901300000,NW 309,RESIDENTIAL,41652,0,41652,198036,0,239688
132412901400000,NW 309,RESIDENTIAL,40019,0,40019,154349,0,194368
132412901500000,NW 309,RESIDENTIAL,63700,0,63700,14248,0,77948
132412901600000,NW 309,RESIDENTIAL,32013,0,32013,0,0,32013
132412901700000,NW 309,RESIDENTIAL,39305,0,39305,246516,0,285821
132412901800000,NW 309,RESIDENTIAL,38897,0,38897,187572,0,226469
132412901900000,NW 309,RESIDENTIAL,38824,0,38824,225934,0,264758
132412902000000,NW 309,RESIDENTIAL,38802,0,38802,167156,0,205958
132413000100000,NW 309,RESIDENTIAL,39911,0,39911,98338,0,138249
132413000200000,NW 309,RESIDENTIAL,39448,0,39448,108866,0,148314
132413000300000,NW 309,RESIDENTIAL,41394,0,41394,162019,0,203413
132413000400000,NW 309,RESIDENTIAL,36509,0,36509,156442,0,192951
132413000500000,NW 309,RESIDENTIAL,38543,0,38543,147052,0,185595
132413000600000,NW 309,RESIDENTIAL,41400,0,41400,115120,0,156520
132413000700000,NW 309,RESIDENTIAL,39680,0,39680,183651,0,223331
132413000800000,NW 309,RESIDENTIAL,37740,0,37740,154343,0,192083
132413000900000,NW 309,RESIDENTIAL,40911,0,40911,140538,0,181449
132413001000000,NW 309,RESIDENTIAL,41650,0,41650,162253,0,203903
132413001100000,NW 309,RESIDENTIAL,41676,0,41676,183832,0,225508
132413001200000,NW 309,RESIDENTIAL,40533,0,40533,209699,0,250232
132413001300000,NW 309,RESIDENTIAL,41854,0,41854,0,0,41854
132413001400000,NW 309,RESIDENTIAL,39750,0,39750,236169,0,275919
132413001500000,NW 309,RESIDENTIAL,41904,0,41904,162128,0,204032
132413001600000,NW 309,RESIDENTIAL,42874,0,42874,191193,0,234067
132413001700000,NW 309,RESIDENTIAL,44982,0,44982,191804,0,236786
132413001800000,NW 309,RESIDENTIAL,42951,0,42951,201050,0,244001
132413001900000,NW 309,RESIDENTIAL,40786,0,40786,153442,0,194228
132413002000000,NW 309,RESIDENTIAL,41359,0,41359,165150,0,206509
132413002100000,NW 309,RESIDENTIAL,40610,0,40610,147159,0,187769
132413002200000,NW 309,RESIDENTIAL,40890,0,40890,174896,0,215786
132413002300000,NW 309,RESIDENTIAL,43600,0,43600,144724,0,188324
132413002400000,NW 337,RESIDENTIAL,64200,0,64200,85597,0,149797
132413100100000,NW 337,RESIDENTIAL,20485,0,20485,130798,0,151283
132413200100000,NW 309,RESIDENTIAL,44083,0,44083,207882,0,251965
132413200700000,NW 309,RESIDENTIAL,43019,0,43019,235603,0,278622
132413200900000,NW 309,RESIDENTIAL,38880,0,38880,167683,0,206563
132413201000000,NW 309,RESIDENTIAL,43200,0,43200,0,0,43200
132413201200000,NW 309,RESIDENTIAL,42579,0,42579,211457,0,254036
132415100200000,NW 337,RESIDENTIAL,61250,0,61250,141008,0,202258
132415200100000,NW 309,RESIDENTIAL,61950,0,61950,36472,0,98422
132415200200000,NW 309,RESIDENTIAL,72950,0,72950,33806,0,106756
132415200300000,NW 309,RESIDENTIAL,64450,0,64450,144911,0,209361
132415200500000,NW 342,RESIDENTIAL,900,0,900,0,0,900
132415200600000,NW 342,RESIDENTIAL,34000,0,34000,151098,0,185098
132415200700000,NW 342,RESIDENTIAL,34200,0,34200,187265,0,221465
132415200800000,NW 342,RESIDENTIAL,33300,0,33300,159891,0,193191
132415200900000,NW 342,RESIDENTIAL,32300,0,32300,186441,0,218741
132415201000000,NW 342,RESIDENTIAL,33300,0,33300,147019,0,180319
132415201100000,NW 342,RESIDENTIAL,31000,0,31000,117852,0,148852
132415201200000,NW 342,RESIDENTIAL,31000,0,31000,117217,0,148217
132415201300000,NW 342,RESIDENTIAL,31000,0,31000,117307,0,148307
132415201400000,NW 309,RESIDENTIAL,45040,0,45040,197742,0,242782
132415201500000,NW 309,RESIDENTIAL,44887,0,44887,218540,0,263427
132415201600000,NW 309,RESIDENTIAL,44460,0,44460,0,0,44460
132415201700000,NW 309,RESIDENTIAL,56120,0,56120,537438,0,593558
132415201800000,NW 309,RESIDENTIAL,64521,0,64521,1349225,0,1413746
132415201900000,NW 309,RESIDENTIAL,59816,0,59816,318013,0,377829
132415202000000,NW 309,RESIDENTIAL,39351,0,39351,0,0,39351
132415202100000,NW 309,RESIDENTIAL,39900,0,39900,0,0,39900
132415202200000,NW 309,RESIDENTIAL,39900,0,39900,245644,0,285544
132415202300000,NW 309,RESIDENTIAL,39900,0,39900,0,0,39900
132415202400000,CITY PROPERTY,EXEMPT,0,0,0,0,0,0
132415300100000,SCHOOL,EXEMPT,0,0,0,0,0,0
132415300200000,CITY PROPERTY,EXEMPT,0,0,0,0,0,0
132415300300000,NW 342,RESIDENTIAL,32724,0,32724,138436,0,171160
132415300400000,NW 342,RESIDENTIAL,31371,0,31371,127120,0,158491
132415300500000,NW 342,RESIDENTIAL,32934,0,32934,153501,0,186435
132415300600000,NW 342,RESIDENTIAL,33479,0,33479,152782,0,186261
132415300700000,NW 342,RESIDENTIAL,34632,0,34632,148886,0,183518
132415300800000,NW 342,RESIDENTIAL,33048,0,33048,150725,0,183773
132415300900000,NW 342,RESIDENTIAL,32963,0,32963,141163,0,174126
132415301000000,NW 342,RESIDENTIAL,30742,0,30742,136795,0,167537
132415301100000,NW 342,RESIDENTIAL,30500,0,30500,157070,0,187570
132415301200000,NW 342,RESIDENTIAL,30500,0,30500,149570,0,180070
132415301300000,NW 342,RESIDENTIAL,30500,0,30500,142636,0,173136
132415301400000,NW 342,RESIDENTIAL,32400,0,32400,127193,0,159593
132415301500000,CITY PROPERTY,EXEMPT,0,0,0,0,0,0
132415301600000,NW 337,RESIDENTIAL,28994,0,28994,64144,0,93138
132415400100000,NW 342,RESIDENTIAL,36003,0,36003,160630,0,196633
132415400200000,NW 342,RESIDENTIAL,30250,0,30250,136887,0,167137
132415400300000,NW 342,RESIDENTIAL,33000,0,33000,118121,0,151121
132415400400000,NW 342,RESIDENTIAL,33000,0,33000,136767,0,169767
132415400500000,NW 342,RESIDENTIAL,31250,0,31250,167994,0,199244
132415400600000,NW 342,RESIDENTIAL,22932,0,22932,159720,0,182652
132415400700000,NW 342,RESIDENTIAL,21943,0,21943,160501,0,182444
132415400800000,NW 342,RESIDENTIAL,22698,0,22698,138186,0,160884
132415400900000,NW 342,RESIDENTIAL,30314,0,30314,142925,0,173239
132415401000000,NW 342,RESIDENTIAL,32713,0,32713,135957,0,168670
132415401100000,NW 342,RESIDENTIAL,35648,0,35648,116390,0,152038
132415401200000,NW 342,RESIDENTIAL,33590,0,33590,131239,0,164829
132417600100000,NW 337,RESIDENTIAL,54000,0,54000,111350,0,165350
132417600200000,NW 309,RESIDENTIAL,51926,0,51926,146447,0,198373
132417600300000,NW 309,RESIDENTIAL,46979,0,46979,149406,0,196385
132417600400000,NW 309,RESIDENTIAL,55590,0,55590,136324,0,191914
132417600500000,NW 309,RESIDENTIAL,56090,0,56090,129156,0,185246
132417600600000,NW 309,RESIDENTIAL,60020,0,60020,291889,0,351909
132417600700000,NW 309,RESIDENTIAL,50150,0,50150,154600,0,204750
132417600800000,NW 309,RESIDENTIAL,67135,0,67135,97655,0,164790
132417600900000,NW 309,RESIDENTIAL,76550,0,76550,0,0,76550
132417601000000,NW 309,RESIDENTIAL,71300,0,71300,162664,0,233964
132417601100000,NW 337,RESIDENTIAL,57000,0,57000,139523,0,196523
132417601200000,NW 309,RESIDENTIAL,20,0,20,0,0,20
132417601300000,NW 309,RESIDENTIAL,20,0,20,0,0,20
132417601400000,NW 309,RESIDENTIAL,20,0,20,0,0,20
132417601500000,NW 309,RESIDENTIAL,20,0,20,0,0,20
132417601600000,NW 309,RESIDENTIAL,20,0,20,0,0,20
132417700100000,APARTMENT,COMMERCIAL,0,416300,416300,0,3055822,3472122
132417700200000,NW 309,RESIDENTIAL,34333,0,34333,158774,0,193107
132417700300000,NW 309,RESIDENTIAL,36005,0,36005,195703,0,231708
132417700400000,NW 309,RESIDENTIAL,41306,0,41306,160006,0,201312
132417700500000,NW 309,RESIDENTIAL,36892,0,36892,172041,0,208933
132417700600000,NW 309,RESIDENTIAL,36685,0,36685,146784,0,183469
132417700800000,NW 309,RESIDENTIAL,44699,0,44699,209809,0,254508
132417700900000,NW 309,RESIDENTIAL,36935,0,36935,174692,0,211627
132417701000000,NW 309,RESIDENTIAL,42486,0,42486,166711,0,209197
132417701100000,NW 309,RESIDENTIAL,41872,0,41872,193755,0,235627
132417701200000,NW 309,RESIDENTIAL,39216,0,39216,193451,0,232667
132417701300000,NW 309,RESIDENTIAL,39450,0,39450,140205,0,179655
132417701400000,NW 309,RESIDENTIAL,38400,0,38400,173445,0,211845
132417701500000,NW 309,RESIDENTIAL,38400,0,38400,162313,0,200713
132417701600000,NW 309,RESIDENTIAL,42274,0,42274,194078,0,236352
132417701700000,NW 309,RESIDENTIAL,37235,0,37235,198469,0,235704
132417701800000,NW 309,RESIDENTIAL,40056,0,40056,134309,0,174365
132417701900000,NW 309,RESIDENTIAL,38965,0,38965,142247,0,181212
132417702000000,NW 309,RESIDENTIAL,58255,0,58255,42909,0,101164
132417702100000,NW 309,RESIDENTIAL,39002,0,39002,180026,0,219028
132417702200000,NW 309,RESIDENTIAL,33553,0,33553,172383,0,205936
132417702300000,NW 309,RESIDENTIAL,34833,0,34833,168144,0,202977
132417702400000,NW 309,RESIDENTIAL,38800,0,38800,184067,0,222867
132417702500000,NW 309,RESIDENTIAL,38400,0,38400,177101,0,215501
132417702600000,NW 309,RESIDENTIAL,38400,0,38400,150292,0,188692
132417702700000,NW 309,RESIDENTIAL,43200,0,43200,170817,0,214017
132417702800000,NW 309,RESIDENTIAL,41827,0,41827,172345,0,214172
132417702900000,NW 309,RESIDENTIAL,40972,0,40972,201302,0,242274
132417703000000,NW 309,RESIDENTIAL,42851,0,42851,174938,0,217789
132417703100000,NW 309,RESIDENTIAL,48663,0,48663,142266,0,190929
132417703200000,NW 309,RESIDENTIAL,160,0,160,0,0,160
132420100300000,NW 309,RESIDENTIAL,575,0,575,0,0,575
132420100400000,NW 309,RESIDENTIAL,575,0,575,0,0,575
132420100500000,NW 309,RESIDENTIAL,1255,0,1255,0,0,1255
132420100600000,NW 309,RESIDENTIAL,49784,0,49784,229833,0,279617
132420100700000,NW 309,RESIDENTIAL,49920,0,49920,170135,0,220055
132420100800000,NW 309,RESIDENTIAL,52105,0,52105,227638,0,279743
132420100900000,NW 309,RESIDENTIAL,57587,0,57587,0,0,57587
132420101000000,NW 309,RESIDENTIAL,38250,0,38250,158838,0,197088
132420101100000,NW 309,RESIDENTIAL,38250,0,38250,95530,0,133780
132420101200000,NW 309,RESIDENTIAL,155,0,155,0,0,155
132420101300000,NW 309,RESIDENTIAL,39150,0,39150,155839,0,194989
132420101400000,NW 309,RESIDENTIAL,44112,0,44112,164408,0,208520
132420200100000,NW 309,RESIDENTIAL,49915,0,49915,194769,0,244684
132420200200000,NW 309,RESIDENTIAL,43680,0,43680,180625,0,224305
132420200300000,NW 309,RESIDENTIAL,44928,0,44928,202710,0,247638
132420200500000,NW 309,RESIDENTIAL,53339,0,53339,208521,0,261860
132420200600000,NW 309,RESIDENTIAL,48838,0,48838,232310,0,281148
132420200700000,NW 309,RESIDENTIAL,56050,0,56050,244004,0,300054
132420300100000,NW 309,RESIDENTIAL,41850,0,41850,120205,0,162055
132420300200000,NW 309,RESIDENTIAL,30000,0,30000,121077,0,151077
132420300300000,NW 309,RESIDENTIAL,30000,0,30000,142173,0,172173
132420300400000,NW 309,RESIDENTIAL,30000,0,30000,133131,0,163131
132420300500000,NW 309,RESIDENTIAL,30000,0,30000,116482,0,146482
132420300600000,NW 309,RESIDENTIAL,30000,0,30000,123637,0,153637
132420300700000,NW 309,RESIDENTIAL,30000,0,30000,126770,0,156770
132420300800000,NW 309,RESIDENTIAL,29777,0,29777,150856,0,180633
132420300900000,NW 309,RESIDENTIAL,31282,0,31282,150688,0,181970
132420301000000,NW 309,RESIDENTIAL,26640,0,26640,101739,0,128379
132420400100000,NW 309,RESIDENTIAL,32717,0,32717,117313,0,150030
132420400200000,NW 309,RESIDENTIAL,43007,0,43007,179436,0,222443
132420400300000,NW 309,RESIDENTIAL,46011,0,46011,214982,0,260993
132420400400000,NW 309,RESIDENTIAL,43065,0,43065,223948,0,267013
132420400500000,NW 309,RESIDENTIAL,41280,0,41280,158060,0,199340
132420400600000,NW 309,RESIDENTIAL,43680,0,43680,221324,0,265004
132420400700000,NW 309,RESIDENTIAL,43680,0,43680,225074,0,268754
132420400800000,NW 309,RESIDENTIAL,41760,0,41760,219356,0,261116
132420400900000,NW 309,RESIDENTIAL,41280,0,41280,209528,0,250808
132420401000000,NW 309,RESIDENTIAL,43680,0,43680,196156,0,239836
132420401100000,NW 309,RESIDENTIAL,49508,0,49508,344350,0,393858
132420401700000,NW 309,RESIDENTIAL,51400,0,51400,116602,0,168002
132420402000000,NW 309,RESIDENTIAL,25600,0,25600,93850,0,119450
132420402100000,NW 309,RESIDENTIAL,27934,0,27934,130470,0,158404
132420402200000,NW 309,RESIDENTIAL,30000,0,30000,109103,0,139103
132420402300000,NW 309,RESIDENTIAL,30000,0,30000,134764,0,164764
132420402400000,NW 309,RESIDENTIAL,30000,0,30000,144283,0,174283
132420402500000,NW 309,RESIDENTIAL,30000,0,30000,108838,0,138838
132420402600000,NW 309,RESIDENTIAL,29483,0,29483,115010,0,144493
132420402700000,NW 309,RESIDENTIAL,29940,0,29940,118288,0,148228
132420500600000,NW 337,RESIDENTIAL,60000,0,60000,216512,0,276512
132422600200000,NW 309,RESIDENTIAL,51982,0,51982,227617,0,279599
132422600300000,NW 309,RESIDENTIAL,65500,0,65500,125364,0,190864
132422601300000,NW 309,RESIDENTIAL,56705,0,56705,261988,0,318693
132422601400000,NW 309,RESIDENTIAL,53681,0,53681,247954,0,301635
132422601500000,NW 309,RESIDENTIAL,51739,0,51739,0,0,51739
132422601600000,NW 309,RESIDENTIAL,12337,0,12337,0,0,12337
132422601700000,NW 309,RESIDENTIAL,12337,0,12337,0,0,12337
132422800100000,NW 309,RESIDENTIAL,57633,0,57633,263511,0,321144
132422800200000,NW 309,RESIDENTIAL,54540,0,54540,254172,0,308712
132422800300000,NW 309,RESIDENTIAL,53530,0,53530,278697,0,332227
132422800400000,NW 309,RESIDENTIAL,43240,0,43240,0,0,43240
132422800500000,NW 309,RESIDENTIAL,42804,0,42804,0,0,42804
132422900100000,NW 309,RESIDENTIAL,50500,0,50500,0,0,50500
132422900200000,NW 309,RESIDENTIAL,16948,0,16948,0,0,16948
132422900300000,NW 309,RESIDENTIAL,51360,0,51360,218681,0,270041
132422900400000,NW 309,RESIDENTIAL,55229,0,55229,0,0,55229
132422900500000,NW 309,RESIDENTIAL,51871,0,51871,0,0,51871
132422900600000,NW 309,RESIDENTIAL,56270,0,56270,0,0,56270
132422900700000,NW 309,RESIDENTIAL,40320,0,40320,0,0,40320
132422900800000,NW 309,RESIDENTIAL,1341,0,1341,0,0,1341
132423000100000,NW 345,RESIDENTIAL,28710,0,28710,149934,0,178644
132423000200000,NW 345,RESIDENTIAL,30468,0,30468,0,0,30468
132423000300000,NW 345,RESIDENTIAL,30720,0,30720,119053,0,149773
132423000400000,NW 345,RESIDENTIAL,34162,0,34162,133953,0,168115
132423000500000,NW 345,RESIDENTIAL,39376,0,39376,135129,0,174505
132423000600000,NW 345,RESIDENTIAL,60010,0,60010,0,0,60010
132423000700000,NW 345,RESIDENTIAL,45113,0,45113,160589,0,205702
132423000800000,NW 345,RESIDENTIAL,36358,0,36358,179873,0,216231
132423000900000,NW 345,RESIDENTIAL,35434,0,35434,151489,0,186923
132423001000000,NW 345,RESIDENTIAL,37697,0,37697,155483,0,193180
132423001100000,NW 345,RESIDENTIAL,36133,0,36133,165545,0,201678
132423001200000,NW 345,RESIDENTIAL,28723,0,28723,123159,0,151882
132423001300000,NW 345,RESIDENTIAL,28710,0,28710,153676,0,182386
132423001400000,NW 345,RESIDENTIAL,28600,0,28600,157031,0,185631
132423001500000,NW 345,RESIDENTIAL,29575,0,29575,173539,0,203114
132423001600000,NW 345,RESIDENTIAL,31350,0,31350,161750,0,193100
132423001700000,NW 345,RESIDENTIAL,32340,0,32340,145422,0,177762
132423001800000,NW 345,RESIDENTIAL,33000,0,33000,162821,0,195821
132423001900000,NW 345,RESIDENTIAL,33660,0,33660,177981,0,211641
132423002000000,NW 345,RESIDENTIAL,34861,0,34861,181946,0,216807
132423100100000,NW 345,RESIDENTIAL,40050,0,40050,168132,0,208182
132423100200000,NW 345,RESIDENTIAL,33330,0,33330,173754,0,207084
132423100300000,NW 345,RESIDENTIAL,34320,0,34320,145010,0,179330
132423100400000,NW 345,RESIDENTIAL,33990,0,33990,153315,0,187305
132423100500000,NW 345,RESIDENTIAL,32670,0,32670,161207,0,193877
132423100600000,NW 345,RESIDENTIAL,35620,0,35620,137364,0,172984
132423100700000,NW 345,RESIDENTIAL,34320,0,34320,148019,0,182339
132423100800000,NW 345,RESIDENTIAL,34320,0,34320,151319,0,185639
132423100900000,NW 345,RESIDENTIAL,34320,0,34320,133475,0,167795
132423101000000,NW 345,RESIDENTIAL,34320,0,34320,124845,0,159165
132423200100000,NW 345,RESIDENTIAL,42588,0,42588,166443,0,209031
132423200200000,NW 345,RESIDENTIAL,32200,0,32200,155027,0,187227
132423200300000,NW 345,RESIDENTIAL,33585,0,33585,159919,0,193504
132423200400000,NW 345,RESIDENTIAL,40866,0,40866,183566,0,224432
132423200500000,NW 345,RESIDENTIAL,5700,0,5700,0,0,5700
132423200600000,NW 345,RESIDENTIAL,7633,0,7633,0,0,7633
132423200700000,NW 345,RESIDENTIAL,7286,0,7286,0,0,7286
132423200800000,NW 345,RESIDENTIAL,6390,0,6390,0,0,6390
132423200900000,NW 345,RESIDENTIAL,6098,0,6098,0,0,6098
132423300100000,NW 345,RESIDENTIAL,5500,0,5500,0,0,5500
132423300200000,NW 345,RESIDENTIAL,31500,0,31500,176252,0,207752
132423300300000,NW 345,RESIDENTIAL,31500,0,31500,171009,0,202509
132423300400000,NW 345,RESIDENTIAL,31500,0,31500,186406,0,217906
132423300500000,NW 345,RESIDENTIAL,67879,0,67879,0,0,67879
132423400100000,NW 345,RESIDENTIAL,32200,0,32200,168126,0,200326
132423400200000,NW 345,RESIDENTIAL,33953,0,33953,179021,0,212974
132423400300000,NW 345,RESIDENTIAL,36000,0,36000,176929,0,212929
132423400400000,NW 345,RESIDENTIAL,36000,0,36000,174090,0,210090
132423400500000,NW 345,RESIDENTIAL,7683,0,7683,0,0,7683
132425100200000,NW 345,RESIDENTIAL,31676,0,31676,148364,0,180040
132425100300000,NW 345,RESIDENTIAL,30690,0,30690,145146,0,175836
132425100400000,NW 345,RESIDENTIAL,33898,0,33898,145348,0,179246
132425100500000,NW 345,RESIDENTIAL,37153,0,37153,154565,0,191718
132425100600000,NW 345,RESIDENTIAL,29458,0,29458,142402,0,171860
132425100700000,NW 345,RESIDENTIAL,35960,0,35960,193751,0,229711
132425100800000,NW 345,RESIDENTIAL,23310,0,23310,152090,0,175400
132425100900000,NW 345,RESIDENTIAL,27027,0,27027,155489,0,182516
132425101000000,NW 345,RESIDENTIAL,35046,0,35046,154973,0,190019
132425101100000,CITY PROPERTY,EXEMPT,0,0,0,0,0,0
132425200200000,NW 345,RESIDENTIAL,33476,0,33476,142471,0,175947
132425300200000,NW 345,RESIDENTIAL,42541,0,42541,165019,0,207560
132425300300000,NW 345,RESIDENTIAL,32980,0,32980,154887,0,187867
132425300400000,NW 345,RESIDENTIAL,33544,0,33544,140753,0,174297
132425300500000,NW 345,RESIDENTIAL,49878,0,49878,158315,0,208193
132425300800000,NW 345,RESIDENTIAL,36969,0,36969,144926,0,181895
132425300900000,NW 345,RESIDENTIAL,33645,0,33645,142879,0,176524
132425301000000,NW 345,RESIDENTIAL,32235,0,32235,184904,0,217139
132425301100000,NW 345,RESIDENTIAL,40170,0,40170,204382,0,244552
132425301200000,NW 345,RESIDENTIAL,40170,0,40170,4230,0,44400
132425301400000,NW 345,RESIDENTIAL,43775,0,43775,169498,0,213273
132425301500000,NW 345,RESIDENTIAL,38000,0,38000,167321,0,205321
132425301600000,NW 345,RESIDENTIAL,38880,0,38880,167321,0,206201
132425301700000,CITY PROPERTY,EXEMPT,0,0,0,0,0,0
132425301800000,NW 345,RESIDENTIAL,34680,0,34680,132040,0,166720
132425301900000,NW 345,RESIDENTIAL,25500,0,25500,144943,0,170443
132425302000000,NW 345,RESIDENTIAL,25500,0,25500,129857,0,155357
132425302100000,NW 345,RESIDENTIAL,25500,0,25500,132065,0,157565
132425302200000,NW 345,RESIDENTIAL,25500,0,25500,132065,0,157565
132425302300000,NW 345,RESIDENTIAL,25500,0,25500,131314,0,156814
132425302400000,NW 345,RESIDENTIAL,25250,0,25250,132065,0,157315
132425302500000,NW 345,RESIDENTIAL,25250,0,25250,132378,0,157628
132425302600000,NW 345,RESIDENTIAL,25250,0,25250,139811,0,165061
132425302700000,NW 345,RESIDENTIAL,25250,0,25250,137744,0,162994
132425302800000,NW 345,RESIDENTIAL,25250,0,25250,97932,0,123182
132425302900000,NW 345,RESIDENTIAL,25000,0,25000,96047,0,121047
132425303000000,NW 345,RESIDENTIAL,25000,0,25000,95880,0,120880
132425303100000,NW 345,RESIDENTIAL,25000,0,25000,97932,0,122932
132425303200000,NW 345,RESIDENTIAL,25000,0,25000,97932,0,122932
132425303300000,NW 345,RESIDENTIAL,25000,0,25000,97932,0,122932
132425303400000,NW 345,RESIDENTIAL,24750,0,24750,97932,0,122682
132425303500000,NW 345,RESIDENTIAL,7309,0,7309,0,0,7309
132425303600000,NW 345,RESIDENTIAL,7309,0,7309,0,0,7309
132425303700000,NW 345,RESIDENTIAL,7309,0,7309,0,0,7309
132425303800000,NW 345,RESIDENTIAL,7309,0,7309,0,0,7309
132425303900000,NW 345,RESIDENTIAL,8005,0,8005,0,0,8005
132425304000000,NW 345,RESIDENTIAL,9745,0,9745,0,0,9745
132425304100000,NW 345,RESIDENTIAL,10232,0,10232,0,0,10232
132425400100000,NW 345,RESIDENTIAL,34615,0,34615,164119,0,198734
132425400200000,NW 345,RESIDENTIAL,34555,0,34555,141418,0,175973
132425400300000,NW 345,RESIDENTIAL,34555,0,34555,141870,0,176425
132425400400000,NW 345,RESIDENTIAL,34901,0,34901,148284,0,183185
132425400500000,NW 345,RESIDENTIAL,34901,0,34901,165612,0,200513
132425400600000,NW 345,RESIDENTIAL,34901,0,34901,141418,0,176319
132425400700000,NW 345,RESIDENTIAL,34901,0,34901,162796,0,197697
132425400800000,NW 345,RESIDENTIAL,35246,0,35246,159521,0,194767
132425400900000,NW 345,RESIDENTIAL,35246,0,35246,139094,0,174340
132425401000000,NW 345,RESIDENTIAL,35246,0,35246,154553,0,189799
132425401100000,NW 345,RESIDENTIAL,34639,0,34639,137082,0,171721
132425500100000,NW 345,RESIDENTIAL,33278,0,33278,157582,0,190860
132425500200000,NW 345,RESIDENTIAL,34439,0,34439,152108,0,186547
132425500300000,NW 345,RESIDENTIAL,31699,0,31699,141418,0,173117
132425500400000,NW 345,RESIDENTIAL,31699,0,31699,139161,0,170860
132425500500000,NW 345,RESIDENTIAL,31699,0,31699,141418,0,173117
132425500600000,NW 345,RESIDENTIAL,31699,0,31699,143651,0,175350
132425500700000,NW 345,RESIDENTIAL,31699,0,31699,164677,0,196376
132425500800000,NW 345,RESIDENTIAL,31699,0,31699,160645,0,192344
132425500900000,NW 345,RESIDENTIAL,31699,0,31699,152423,0,184122
132425501000000,NW 345,RESIDENTIAL,31699,0,31699,171430,0,203129
132425501100000,NW 345,RESIDENTIAL,31699,0,31699,140529,0,172228
132425501200000,NW 345,RESIDENTIAL,31699,0,31699,153583,0,185282
132425501300000,NW 345,RESIDENTIAL,32932,0,32932,159354,0,192286
132425501400000,NW 345,RESIDENTIAL,33278,0,33278,140867,0,174145
132425501500000,NW 345,RESIDENTIAL,33278,0,33278,141418,0,174696
132425501600000,NW 345,RESIDENTIAL,33278,0,33278,142271,0,175549
132425501700000,NW 345,RESIDENTIAL,33278,0,33278,151489,0,184767
132425501800000,NW 345,RESIDENTIAL,33278,0,33278,142020,0,175298
132425501900000,NW 345,RESIDENTIAL,33278,0,33278,152043,0,185321
132425502000000,NW 345,RESIDENTIAL,33278,0,33278,141418,0,174696
132425502100000,NW 345,RESIDENTIAL,33278,0,33278,137528,0,170806
132425502200000,NW 345,RESIDENTIAL,33278,0,33278,158947,0,192225
132425600100000,NW 345,RESIDENTIAL,36484,0,36484,144003,0,180487
132425600300000,NW 345,RESIDENTIAL,33168,0,33168,121451,0,154619
132425600400000,NW 345,RESIDENTIAL,33168,0,33168,138360,0,171528
132425600500000,NW 345,RESIDENTIAL,33168,0,33168,152170,0,185338
132425600600000,NW 345,RESIDENTIAL,33168,0,33168,156233,0,189401
132425600700000,NW 345,RESIDENTIAL,33168,0,33168,164568,0,197736
132425600800000,NW 345,RESIDENTIAL,33168,0,33168,151660,0,184828
132425600900000,NW 345,RESIDENTIAL,33168,0,33168,158669,0,191837
132425601000000,NW 345,RESIDENTIAL,33168,0,33168,144008,0,177176
132425601100000,NW 345,RESIDENTIAL,33168,0,33168,143955,0,177123
132425601200000,NW 345,RESIDENTIAL,33168,0,33168,156735,0,189903
132425601300000,NW 345,RESIDENTIAL,34961,0,34961,151702,0,186663
132425601400000,NW 345,RESIDENTIAL,33320,0,33320,164463,0,197783
132425601500000,NW 345,RESIDENTIAL,33168,0,33168,157453,0,190621
132425601600000,NW 345,RESIDENTIAL,33168,0,33168,154836,0,188004
132425601700000,NW 345,RESIDENTIAL,33168,0,33168,146239,0,179407
132425601800000,NW 345,RESIDENTIAL,33168,0,33168,149891,0,183059
132425601900000,NW 345,RESIDENTIAL,33168,0,33168,167592,0,200760
132425602000000,NW 345,RESIDENTIAL,33168,0,33168,146477,0,179645
132425602100000,NW 345,RESIDENTIAL,33168,0,33168,174295,0,207463
132425602200000,NW 345,RESIDENTIAL,33168,0,33168,163347,0,196515
132425602300000,NW 345,RESIDENTIAL,33168,0,33168,162544,0,195712
132425602400000,NW 345,RESIDENTIAL,33168,0,33168,147691,0,180859
132425700400000,NW 345,RESIDENTIAL,37440,0,37440,188791,0,226231
132425700500000,NW 345,RESIDENTIAL,37440,0,37440,170002,0,207442
132425700600000,NW 345,RESIDENTIAL,37440,0,37440,132279,0,169719
132425700700000,NW 345,RESIDENTIAL,37440,0,37440,166214,0,203654
132425700800000,NW 345,RESIDENTIAL,37440,0,37440,164366,0,201806
132425700900000,NW 345,RESIDENTIAL,37440,0,37440,204529,0,241969
132425701000000,NW 345,RESIDENTIAL,37440,0,37440,205291,0,242731
132425701100000,NW 345,RESIDENTIAL,37440,0,37440,173457,0,210897
132425701200000,NW 345,RESIDENTIAL,37440,0,37440,174319,0,211759
132425701300000,NW 345,RESIDENTIAL,37440,0,37440,151515,0,188955
132425701400000,NW 345,RESIDENTIAL,37440,0,37440,211771,0,249211
132425701700000,NW 345,RESIDENTIAL,24000,0,24000,142779,0,166779
132425701800000,NW 345,RESIDENTIAL,24000,0,24000,129302,0,153302
132425701900000,NW 345,RESIDENTIAL,24000,0,24000,142613,0,166613
132425702000000,NW 345,RESIDENTIAL,24000,0,24000,140934,0,164934
132425702100000,NW 345,RESIDENTIAL,24000,0,24000,128579,0,152579
132425702200000,NW 345,RESIDENTIAL,24000,0,24000,142818,0,166818
132425702300000,NW 345,RESIDENTIAL,24000,0,24000,157245,0,181245
132425702400000,NW 345,RESIDENTIAL,24000,0,24000,131537,0,155537
132425702500000,NW 345,RESIDENTIAL,24000,0,24000,138693,0,162693
132425702600000,NW 345,RESIDENTIAL,24000,0,24000,138693,0,162693
132425702700000,NW 345,RESIDENTIAL,24000,0,24000,138693,0,162693
132425702800000,NW 345,RESIDENTIAL,24000,0,24000,138693,0,162693
132425702900000,NW 345,RESIDENTIAL,24000,0,24000,138693,0,162693
132425703000000,NW 345,RESIDENTIAL,24000,0,24000,138693,0,162693
132425703100000,NW 345,RESIDENTIAL,24000,0,24000,138693,0,162693
132425703200000,NW 345,RESIDENTIAL,24000,0,24000,141516,0,165516
132425703300000,NW 345,RESIDENTIAL,22880,0,22880,136391,0,159271
132425800100000,NW 345,RESIDENTIAL,35144,0,35144,140493,0,175637
132425800200000,NW 345,RESIDENTIAL,36557,0,36557,146482,0,183039
132427600100000,NW 337,RESIDENTIAL,39195,0,39195,103183,0,142378
132427600200000,NW 337,RESIDENTIAL,26964,0,26964,43244,0,70208
132427600300000,NW 337,RESIDENTIAL,31640,0,31640,151867,0,183507
132427600400000,NW 337,RESIDENTIAL,31640,0,31640,172246,0,203886
132427600500000,NW 337,RESIDENTIAL,33600,0,33600,187901,0,221501
132427600600000,NW 337,RESIDENTIAL,33967,0,33967,82542,0,116509
132427600800000,NW 337,RESIDENTIAL,35280,0,35280,102309,0,137589
132427600900000,NW 337,RESIDENTIAL,35280,0,35280,155672,0,190952
132427601000000,NW 337,RESIDENTIAL,35280,0,35280,78721,0,114001
132427601100000,NW 337,RESIDENTIAL,21168,0,21168,0,0,21168
132427601200000,NW 337,RESIDENTIAL,35280,0,35280,118964,0,154244
132427601300000,NW 337,RESIDENTIAL,35280,0,35280,121889,0,157169
132427601400000,NW 337,RESIDENTIAL,35280,0,35280,85428,0,120708
132427601500000,NW 337,RESIDENTIAL,35280,0,35280,88761,0,124041
132427601600000,NW 337,RESIDENTIAL,32276,0,32276,134095,0,166371
132427700100000,NW 337,RESIDENTIAL,39803,0,39803,80107,0,119910
132427700200000,NW 337,RESIDENTIAL,29484,0,29484,114273,0,143757
132427700300000,NW 337,RESIDENTIAL,32760,0,32760,87402,0,120162
132427700400000,NW 337,RESIDENTIAL,32760,0,32760,147877,0,180637
132427700500000,NW 337,RESIDENTIAL,32760,0,32760,118447,0,151207
132427700600000,NW 337,RESIDENTIAL,32760,0,32760,159928,0,192688
132427700700000,NW 337,RESIDENTIAL,29049,0,29049,189074,0,218123
132427700800000,NW 337,RESIDENTIAL,21420,0,21420,83931,0,105351
132427700900000,NW 337,RESIDENTIAL,27469,0,27469,135481,0,162950
132427701000000,NW 337,RESIDENTIAL,27972,0,27972,113774,0,141746
132427701100000,NW 337,RESIDENTIAL,27972,0,27972,98164,0,126136
132427701200000,NW 337,RESIDENTIAL,27972,0,27972,105525,0,133497
132427701300000,NW 337,RESIDENTIAL,27972,0,27972,82765,0,110737
132427701500000,NW 337,RESIDENTIAL,27972,0,27972,130807,0,158779
132427701600000,NW 337,RESIDENTIAL,27972,0,27972,96047,0,124019
132427701700000,NW 337,RESIDENTIAL,27972,0,27972,98727,0,126699
132427701800000,NW 337,RESIDENTIAL,27972,0,27972,117631,0,145603
132427701900000,NW 337,RESIDENTIAL,27578,0,27578,87884,0,115462
132427702000000,NW 337,RESIDENTIAL,28661,0,28661,104881,0,133542
132427702100000,NW 337,RESIDENTIAL,28661,0,28661,89180,0,117841
132427702200000,NW 337,RESIDENTIAL,27578,0,27578,93454,0,121032
132427702300000,NW 337,RESIDENTIAL,27972,0,27972,102746,0,130718
132427702400000,NW 337,RESIDENTIAL,27972,0,27972,128063,0,156035
132427702500000,NW 337,RESIDENTIAL,27972,0,27972,105800,0,133772
132427702600000,NW 337,RESIDENTIAL,27972,0,27972,139259,0,167231
132427702700000,NW 337,RESIDENTIAL,19895,0,19895,139632,0,159527
132427702800000,NW 337,RESIDENTIAL,22496,0,22496,125305,0,147801
132427800100000,NW 337,RESIDENTIAL,30901,0,30901,98434,0,129335
132427800200000,NW 337,RESIDENTIAL,31040,0,31040,60466,0,91506
132427800300000,NW 337,RESIDENTIAL,35000,0,35000,134743,0,169743
132427800400000,NW 337,RESIDENTIAL,35000,0,35000,136213,0,171213
132427800500000,NW 337,RESIDENTIAL,35000,0,35000,144006,0,179006
132427800600000,NW 337,RESIDENTIAL,35000,0,35000,146156,0,181156
132427800700000,NW 337,RESIDENTIAL,28000,0,28000,0,0,28000
132427800800000,NW 337,RESIDENTIAL,35000,0,35000,85589,0,120589
132430100100000,NW 337,RESIDENTIAL,34300,0,34300,91249,0,125549
132430100200000,NW 337,RESIDENTIAL,37576,0,37576,78371,0,115947
132430100300000,NW 337,RESIDENTIAL,32432,0,32432,116798,0,149230
132430100400000,NW 337,RESIDENTIAL,29736,0,29736,146451,0,176187
132430100500000,NW 337,RESIDENTIAL,26964,0,26964,151585,0,178549
132430100600000,NW 337,RESIDENTIAL,22176,0,22176,0,0,22176
132430100700000,NW 337,RESIDENTIAL,23654,0,23654,0,0,23654
132430100800000,NW 337,RESIDENTIAL,25092,0,25092,69301,0,94393
132430100900000,NW 337,RESIDENTIAL,34944,0,34944,82173,0,117117
132430101000000,NW 337,RESIDENTIAL,23497,0,23497,145738,0,169235
132430101100000,NW 337,RESIDENTIAL,24380,0,24380,96017,0,120397
132430101200000,NW 337,RESIDENTIAL,18916,0,18916,116751,0,135667
132430101300000,NW 337,RESIDENTIAL,35000,0,35000,156288,0,191288
132430200100000,NW 337,RESIDENTIAL,49640,0,49640,53466,0,103106
132430200200000,NW 337,RESIDENTIAL,16308,0,16308,108337,0,124645
132430200300000,NW 337,RESIDENTIAL,39487,0,39487,80935,0,120422
132430200400000,NW 337,RESIDENTIAL,71300,0,71300,92451,0,163751
132430200600000,NW 337,RESIDENTIAL,63850,0,63850,114214,0,178064
132430200700000,NW 345,RESIDENTIAL,38162,0,38162,123986,0,162148
132430200800000,NW 345,RESIDENTIAL,35700,0,35700,124145,0,159845
132430200900000,NW 345,RESIDENTIAL,35700,0,35700,131931,0,167631
132430201000000,NW 345,RESIDENTIAL,35700,0,35700,123654,0,159354
132430201100000,NW 345,RESIDENTIAL,24255,0,24255,155666,0,179921
132430201200000,NW 345,RESIDENTIAL,24255,0,24255,170319,0,194574
132430201300000,NW 345,RESIDENTIAL,24435,0,24435,144904,0,169339
132430201400000,NW 345,RESIDENTIAL,25187,0,25187,135673,0,160860
132430201500000,NW 345,RESIDENTIAL,27386,0,27386,147086,0,174472
132430201600000,NW 345,RESIDENTIAL,28006,0,28006,124520,0,152526
132430201700000,NW 345,RESIDENTIAL,27386,0,27386,182532,0,209918
132430201800000,NW 345,RESIDENTIAL,24482,0,24482,167803,0,192285
132430201900000,NW 345,RESIDENTIAL,24255,0,24255,156682,0,180937
132430202000000,NW 345,RESIDENTIAL,24255,0,24255,156688,0,180943
132430202100000,NW 345,RESIDENTIAL,1150,0,1150,0,0,1150
132430300200000,NW 337,RESIDENTIAL,35818,0,35818,101833,0,137651
132430300300000,NW 337,RESIDENTIAL,25637,0,25637,106918,0,132555
132430300400000,NW 337,RESIDENTIAL,25637,0,25637,139567,0,165204
132430300500000,NW 337,RESIDENTIAL,34650,0,34650,122971,0,157621
132430300700000,NW 337,RESIDENTIAL,34650,0,34650,110882,0,145532
132430300800000,NW 337,RESIDENTIAL,34650,0,34650,112483,0,147133
132430300900000,NW 337,RESIDENTIAL,34650,0,34650,99487,0,134137
132430301000000,NW 337,RESIDENTIAL,28594,0,28594,82820,0,111414
132430301100000,NW 337,RESIDENTIAL,36031,0,36031,93789,0,129820
132430301200000,NW 337,RESIDENTIAL,34650,0,34650,122441,0,157091
132430301300000,NW 337,RESIDENTIAL,34650,0,34650,110465,0,145115
132430301400000,NW 337,RESIDENTIAL,34650,0,34650,96542,0,131192
132430301500000,NW 337,RESIDENTIAL,34650,0,34650,73176,0,107826
132430301600000,NW 337,RESIDENTIAL,34650,0,34650,71575,0,106225
132430301700000,NW 337,RESIDENTIAL,34650,0,34650,198671,0,233321
132430301800000,NW 337,RESIDENTIAL,29400,0,29400,103628,0,133028
132430301900000,NW 337,RESIDENTIAL,25637,0,25637,70858,0,96495
132430302100000,NW 337,RESIDENTIAL,25576,0,25576,156125,0,181701
132430302200000,NW 337,RESIDENTIAL,55800,0,55800,0,0,55800
132430302300000,NW 337,RESIDENTIAL,55800,0,55800,109310,0,165110
132432600100000,NW 345,RESIDENTIAL,36863,0,36863,135922,0,172785
132432600200000,NW 345,RESIDENTIAL,37944,0,37944,144450,0,182394
132432600300000,NW 345,RESIDENTIAL,39784,0,39784,152783,0,192567
132432600400000,NW 345,RESIDENTIAL,36720,0,36720,150525,0,187245
132432600500000,NW 345,RESIDENTIAL,34629,0,34629,159339,0,193968
132432600600000,NW 345,RESIDENTIAL,32152,0,32152,162417,0,194569
132432600700000,CITY PROPERTY,EXEMPT,0,0,0,0,0,0
132432600800000,NW 345,RESIDENTIAL,33663,0,33663,156306,0,189969
132432600900000,NW 345,RESIDENTIAL,34650,0,34650,162927,0,197577
132432601000000,NW 345,RESIDENTIAL,39531,0,39531,139338,0,178869
132432601100000,NW 345,RESIDENTIAL,41296,0,41296,169848,0,211144
132432601200000,NW 345,RESIDENTIAL,42432,0,42432,160774,0,203206
132432601300000,NW 345,RESIDENTIAL,38654,0,38654,143403,0,182057
132432601400000,NW 345,RESIDENTIAL,38230,0,38230,156352,0,194582
132432700100000,NW 345,RESIDENTIAL,32585,0,32585,164381,0,196966
132432700200000,NW 345,RESIDENTIAL,31699,0,31699,124150,0,155849
132432700300000,NW 345,RESIDENTIAL,31958,0,31958,141076,0,173034
132432700400000,NW 345,RESIDENTIAL,33756,0,33756,146651,0,180407
132432700500000,NW 345,RESIDENTIAL,33465,0,33465,152130,0,185595
132432700600000,NW 345,RESIDENTIAL,33684,0,33684,139960,0,173644
132432800100000,NW 345,RESIDENTIAL,33168,0,33168,163184,0,196352
132432800200000,NW 345,RESIDENTIAL,33165,0,33165,159218,0,192383
132432800300000,NW 345,RESIDENTIAL,37469,0,37469,160043,0,197512
132432800400000,NW 345,RESIDENTIAL,35431,0,35431,135601,0,171032
132432800500000,NW 345,RESIDENTIAL,35615,0,35615,158149,0,193764
132432800900000,NW 345,RESIDENTIAL,30600,0,30600,136348,0,166948
132432801000000,NW 345,RESIDENTIAL,37950,0,37950,156830,0,194780
132432801100000,NW 345,RESIDENTIAL,33450,0,33450,139911,0,173361
132432801200000,NW 345,RESIDENTIAL,33168,0,33168,161377,0,194545
132432801300000,NW 345,RESIDENTIAL,33168,0,33168,158191,0,191359
132432801400000,NW 345,RESIDENTIAL,35203,0,35203,183919,0,219122
132432801500000,NW 345,RESIDENTIAL,33408,0,33408,158445,0,191853
132432801600000,NW 345,RESIDENTIAL,34000,0,34000,153739,0,187739
132432900200000,NW 345,RESIDENTIAL,34566,0,34566,142263,0,176829
132432901000000,NW 345,RESIDENTIAL,37440,0,37440,161269,0,198709
132432901100000,NW 345,RESIDENTIAL,37440,0,37440,180314,0,217754
132432901200000,NW 345,RESIDENTIAL,37440,0,37440,170066,0,207506
132432901300000,NW 345,RESIDENTIAL,35880,0,35880,162466,0,198346
132432901500000,NW 345,RESIDENTIAL,8901,0,8901,0,0,8901
132432901600000,NW 345,RESIDENTIAL,23250,0,23250,149839,0,173089
132432901700000,NW 345,RESIDENTIAL,23750,0,23750,131886,0,155636
132432901800000,NW 345,RESIDENTIAL,24000,0,24000,141516,0,165516
132432901900000,NW 345,RESIDENTIAL,24000,0,24000,140900,0,164900
132432902000000,NW 345,RESIDENTIAL,24000,0,24000,141132,0,165132
132433000100000,NW 345,RESIDENTIAL,34240,0,34240,158995,0,193235
132433000200000,NW 345,RESIDENTIAL,32107,0,32107,150925,0,183032
132433000300000,NW 345,RESIDENTIAL,29367,0,29367,128872,0,158239
132433000400000,NW 345,RESIDENTIAL,31083,0,31083,130462,0,161545
132433000500000,NW 345,RESIDENTIAL,16226,0,16226,0,0,16226
132433000600000,NW 345,RESIDENTIAL,12675,0,12675,0,0,12675
132433000700000,NW 345,RESIDENTIAL,16050,0,16050,0,0,16050
132433000800000,NW 345,RESIDENTIAL,27225,0,27225,97932,0,125157
132433000900000,NW 345,RESIDENTIAL,24750,0,24750,96047,0,120797
132433001000000,NW 345,RESIDENTIAL,24750,0,24750,97932,0,122682
132433001100000,NW 345,RESIDENTIAL,24750,0,24750,106600,0,131350
132433100100000,NW 326,RESIDENTIAL,69750,0,69750,92271,0,162021
132433100200000,NW 326,AG LAND,6560,0,6560,0,0,6560
132435100100000,NW 326,RESIDENTIAL,30247,0,30247,120293,0,150540
132435100200000,NW 326,RESIDENTIAL,26226,0,26226,82244,0,108470
132435100300000,NW 326,RESIDENTIAL,30065,0,30065,97419,0,127484
132435100400000,NW 326,RESIDENTIAL,32818,0,32818,106390,0,139208
132435100500000,NW 326,RESIDENTIAL,27849,0,27849,102445,0,130294
132435100600000,NW 326,RESIDENTIAL,31059,0,31059,115537,0,146596
132435100700000,NW 326,RESIDENTIAL,25920,0,25920,109920,0,135840
132435100800000,NW 326,RESIDENTIAL,28080,0,28080,101803,0,129883
132435100900000,NW 326,RESIDENTIAL,27621,0,27621,93648,0,121269
132435101000000,NW 326,RESIDENTIAL,29700,0,29700,89574,0,119274
132435101100000,NW 326,RESIDENTIAL,28704,0,28704,92917,0,121621
132435101200000,NW 326,RESIDENTIAL,28905,0,28905,96709,0,125614
132435101300000,NW 326,RESIDENTIAL,26676,0,26676,112018,0,138694
132435101400000,NW 326,RESIDENTIAL,27745,0,27745,97528,0,125273
132435101500000,NW 326,RESIDENTIAL,26505,0,26505,92633,0,119138
132435101600000,NW 326,RESIDENTIAL,30460,0,30460,110968,0,141428
132435101700000,NW 326,RESIDENTIAL,30460,0,30460,105732,0,136192
132435101800000,NW 326,RESIDENTIAL,27453,0,27453,103050,0,130503
132435101900000,NW 326,RESIDENTIAL,30139,0,30139,96660,0,126799
132435102000000,NW 326,RESIDENTIAL,30246,0,30246,103379,0,133625
132435200100000,NW 326,RESIDENTIAL,29443,0,29443,110560,0,140003
132435200200000,NW 326,RESIDENTIAL,28037,0,28037,100229,0,128266
132435200300000,NW 326,RESIDENTIAL,26784,0,26784,98217,0,125001
132435200400000,NW 326,RESIDENTIAL,28037,0,28037,111967,0,140004
132435200500000,NW 326,RESIDENTIAL,26784,0,26784,114724,0,141508
132435200600000,NW 326,RESIDENTIAL,29677,0,29677,118451,0,148128
132435300100000,NW 326,RESIDENTIAL,29797,0,29797,126780,0,156577
132435300200000,NW 326,RESIDENTIAL,26226,0,26226,89633,0,115859
132435300300000,NW 326,RESIDENTIAL,27453,0,27453,97230,0,124683
132435300400000,NW 326,RESIDENTIAL,30139,0,30139,102287,0,132426
132435300500000,NW 326,RESIDENTIAL,27453,0,27453,106034,0,133487
132435300600000,NW 326,RESIDENTIAL,29335,0,29335,100178,0,129513
132435300700000,NW 326,RESIDENTIAL,19247,0,19247,109541,0,128788
132435300800000,NW 326,RESIDENTIAL,25803,0,25803,95646,0,121449
132435300900000,NW 326,RESIDENTIAL,27721,0,27721,98481,0,126202
132435301000000,NW 326,RESIDENTIAL,27213,0,27213,92635,0,119848
132435301100000,NW 326,RESIDENTIAL,26226,0,26226,114969,0,141195
132435301200000,NW 326,RESIDENTIAL,30139,0,30139,118278,0,148417
132435301300000,NW 326,RESIDENTIAL,26226,0,26226,116929,0,143155
132435301400000,NW 326,RESIDENTIAL,27453,0,27453,104214,0,131667
132435301500000,NW 326,RESIDENTIAL,30139,0,30139,109917,0,140056
132435301600000,NW 326,RESIDENTIAL,27453,0,27453,113665,0,141118
132435301700000,NW 326,RESIDENTIAL,27453,0,27453,111526,0,138979
132435301800000,NW 326,RESIDENTIAL,28271,0,28271,117999,0,146270
132435400100000,NW 326,RESIDENTIAL,30789,0,30789,100812,0,131601
132435400200000,NW 326,RESIDENTIAL,26611,0,26611,97278,0,123889
132435400300000,NW 326,RESIDENTIAL,32023,0,32023,115708,0,147731
132435400400000,NW 326,RESIDENTIAL,28737,0,28737,98376,0,127113
132435400500000,NW 326,RESIDENTIAL,30258,0,30258,116133,0,146391
132435400600000,NW 326,RESIDENTIAL,29857,0,29857,106892,0,136749
132435400700000,NW 326,RESIDENTIAL,29070,0,29070,105873,0,134943
132435400800000,NW 326,RESIDENTIAL,32466,0,32466,95047,0,127513
132435500100000,NW 326,RESIDENTIAL,31090,0,31090,114493,0,145583
132435500200000,NW 326,RESIDENTIAL,27540,0,27540,102972,0,130512
132435500300000,NW 326,RESIDENTIAL,27540,0,27540,95071,0,122611
132435500400000,NW 326,RESIDENTIAL,29789,0,29789,125760,0,155549
132435500500000,NW 326,RESIDENTIAL,29789,0,29789,95757,0,125546
132435500600000,NW 326,RESIDENTIAL,29789,0,29789,99900,0,129689
132435500700000,NW 326,RESIDENTIAL,29789,0,29789,105899,0,135688
132435500800000,NW 326,RESIDENTIAL,30766,0,30766,104488,0,135254
132435500900000,NW 326,RESIDENTIAL,32665,0,32665,101779,0,134444
132435501000000,NW 326,RESIDENTIAL,30927,0,30927,102773,0,133700
132435501100000,NW 326,RESIDENTIAL,30135,0,30135,98295,0,128430
132435501200000,NW 326,RESIDENTIAL,28913,0,28913,100001,0,128914
132435501300000,NW 326,RESIDENTIAL,28913,0,28913,118022,0,146935
132435501400000,NW 326,RESIDENTIAL,29408,0,29408,105942,0,135350
132435501500000,NW 326,RESIDENTIAL,30576,0,30576,100376,0,130952
132435501600000,NW 326,RESIDENTIAL,32100,0,32100,104420,0,136520
132435501700000,NW 326,RESIDENTIAL,29877,0,29877,126483,0,156360
132435501800000,NW 326,RESIDENTIAL,26100,0,26100,113910,0,140010
132435501900000,NW 326,RESIDENTIAL,31059,0,31059,117356,0,148415
132435502000000,NW 326,RESIDENTIAL,24975,0,24975,113960,0,138935
132435502100000,NW 326,RESIDENTIAL,29205,0,29205,120896,0,150101
132435502200000,NW 326,RESIDENTIAL,27405,0,27405,145969,0,173374
132435502300000,NW 326,RESIDENTIAL,30780,0,30780,112749,0,143529
132435502400000,NW 326,RESIDENTIAL,31867,0,31867,117814,0,149681
132435502500000,NW 326,RESIDENTIAL,33106,0,33106,126503,0,159609
132435502600000,NW 326,RESIDENTIAL,30586,0,30586,108551,0,139137
132435502700000,NW 326,RESIDENTIAL,30467,0,30467,134040,0,164507
132435502800000,NW 326,RESIDENTIAL,31090,0,31090,117735,0,148825
132435502900000,NW 326,RESIDENTIAL,30613,0,30613,120674,0,151287
132435503000000,NW 326,RESIDENTIAL,29187,0,29187,119095,0,148282
132435503100000,NW 326,RESIDENTIAL,31975,0,31975,142182,0,174157
132435503200000,NW 326,RESIDENTIAL,33415,0,33415,128135,0,161550
132435503300000,NW 326,RESIDENTIAL,32724,0,32724,109668,0,142392
132435503400000,NW 326,RESIDENTIAL,33415,0,33415,129763,0,163178
132435503500000,NW 326,RESIDENTIAL,31244,0,31244,123289,0,154533
132435503600000,NW 326,RESIDENTIAL,29975,0,29975,118498,0,148473
132435503700000,NW 326,RESIDENTIAL,31036,0,31036,129838,0,160874
132435503800000,NW 326,RESIDENTIAL,29839,0,29839,141268,0,171107
132435503900000,NW 326,RESIDENTIAL,30053,0,30053,144794,0,174847
132435504000000,NW 326,RESIDENTIAL,29885,0,29885,106056,0,135941
132435504100000,NW 326,RESIDENTIAL,30294,0,30294,105049,0,135343
132435504200000,NW 326,RESIDENTIAL,29908,0,29908,109723,0,139631
132435504300000,NW 326,RESIDENTIAL,30693,0,30693,105377,0,136070
132435504400000,NW 326,RESIDENTIAL,30178,0,30178,112494,0,142672
132435504500000,NW 326,RESIDENTIAL,26730,0,26730,110322,0,137052
132435504600000,NW 326,RESIDENTIAL,28512,0,28512,106998,0,135510
132435504700000,NW 326,RESIDENTIAL,31319,0,31319,102746,0,134065
132435504800000,NW 326,RESIDENTIAL,31319,0,31319,108355,0,139674
132435504900000,NW 326,RESIDENTIAL,30472,0,30472,112648,0,143120
132435505000000,NW 326,RESIDENTIAL,24453,0,24453,131347,0,155800
132435505100000,NW 326,RESIDENTIAL,30472,0,30472,98185,0,128657
132435505200000,NW 326,RESIDENTIAL,26730,0,26730,97604,0,124334
132435505300000,NW 326,RESIDENTIAL,30811,0,30811,104048,0,134859
132435505400000,NW 326,RESIDENTIAL,26237,0,26237,108760,0,134997
132435505500000,NW 326,RESIDENTIAL,22672,0,22672,97217,0,119889
132435505600000,NW 326,RESIDENTIAL,27904,0,27904,88720,0,116624
132435505700000,NW 326,RESIDENTIAL,25920,0,25920,91805,0,117725
132435505800000,NW 326,RESIDENTIAL,25920,0,25920,106620,0,132540
132435505900000,NW 326,RESIDENTIAL,25920,0,25920,94131,0,120051
132435506000000,NW 326,RESIDENTIAL,25920,0,25920,96351,0,122271
132435506100000,NW 326,RESIDENTIAL,28037,0,28037,96245,0,124282
132435506200000,NW 326,RESIDENTIAL,29160,0,29160,90901,0,120061
132435506300000,NW 326,RESIDENTIAL,29160,0,29160,96604,0,125764
132435506400000,NW 326,RESIDENTIAL,28037,0,28037,107719,0,135756
132435506500000,NW 326,RESIDENTIAL,29160,0,29160,113462,0,142622
132435506600000,NW 326,RESIDENTIAL,29160,0,29160,80167,0,109327
132435506700000,NW 326,RESIDENTIAL,21579,0,21579,109441,0,131020
132435506800000,NW 326,RESIDENTIAL,29726,0,29726,102960,0,132686
132435506900000,NW 326,RESIDENTIAL,32239,0,32239,109046,0,141285
132435600100000,NW 326,RESIDENTIAL,30597,0,30597,99499,0,130096
132435600200000,NW 326,RESIDENTIAL,30597,0,30597,95054,0,125651
132435600300000,NW 326,RESIDENTIAL,27000,0,27000,102253,0,129253
132435600400000,NW 326,RESIDENTIAL,29205,0,29205,88713,0,117918
132435600500000,NW 326,RESIDENTIAL,29205,0,29205,101710,0,130915
132435600600000,NW 326,RESIDENTIAL,29205,0,29205,99602,0,128807
132435600700000,NW 326,RESIDENTIAL,29205,0,29205,101229,0,130434
132435600800000,NW 326,RESIDENTIAL,30780,0,30780,95210,0,125990
132435600900000,NW 326,RESIDENTIAL,29921,0,29921,112500,0,142421
132435601000000,NW 326,RESIDENTIAL,30970,0,30970,107012,0,137982
132435601100000,NW 326,RESIDENTIAL,32474,0,32474,116387,0,148861
132435601200000,NW 326,RESIDENTIAL,32474,0,32474,107506,0,139980
132435601300000,NW 326,RESIDENTIAL,29205,0,29205,105130,0,134335
132435601400000,NW 326,RESIDENTIAL,29205,0,29205,95432,0,124637
132435601500000,NW 326,RESIDENTIAL,27000,0,27000,100398,0,127398
132435700100000,NW 326,RESIDENTIAL,25110,0,25110,110375,0,135485
132435700200000,NW 326,RESIDENTIAL,29819,0,29819,106841,0,136660
132435700300000,NW 326,RESIDENTIAL,27270,0,27270,115141,0,142411
132435700400000,NW 326,RESIDENTIAL,24998,0,24998,102385,0,127383
132435700500000,NW 326,RESIDENTIAL,26816,0,26816,109401,0,136217
132435700600000,NW 326,RESIDENTIAL,24998,0,24998,98034,0,123032
132435700700000,NW 326,RESIDENTIAL,27725,0,27725,116103,0,143828
132435700800000,NW 326,RESIDENTIAL,27270,0,27270,121129,0,148399
132435700900000,NW 326,RESIDENTIAL,31041,0,31041,95833,0,126874
132437600100000,NW 337,RESIDENTIAL,37626,0,37626,104385,0,142011
132437600200000,NW 337,RESIDENTIAL,20250,0,20250,108051,0,128301
132437600300000,NW 337,RESIDENTIAL,40360,0,40360,53864,0,94224
132437600400000,NW 337,RESIDENTIAL,30160,0,30160,173275,0,203435
132437600500000,NW 337,RESIDENTIAL,31017,0,31017,0,0,31017
132437600600000,NW 337,RESIDENTIAL,27468,0,27468,0,0,27468
132437600700000,NW 337,RESIDENTIAL,64350,0,64350,185773,0,250123
132437600800000,NW 337,RESIDENTIAL,50760,0,50760,188124,0,238884
132437600900000,NW 337,RESIDENTIAL,60750,0,60750,74753,0,135503
132437700100000,NW 345,RESIDENTIAL,59670,0,59670,155513,0,215183
132437800100000,VACANT LAND,COMMERCIAL,0,49800,49800,0,486,50286
132437800200000,NW 326,RESIDENTIAL,33015,0,33015,66526,0,99541
132437800300000,NW 326,RESIDENTIAL,32423,0,32423,105565,0,137988
132437800400000,NW 326,RESIDENTIAL,30982,0,30982,106081,0,137063
132437800500000,NW 326,RESIDENTIAL,30513,0,30513,109071,0,139584
132437800600000,NW 326,RESIDENTIAL,30906,0,30906,132047,0,162953
132437800700000,NW 326,RESIDENTIAL,31518,0,31518,128142,0,159660
132437800800000,NW 326,RESIDENTIAL,31840,0,31840,115200,0,147040
132437800900000,NW 326,RESIDENTIAL,32004,0,32004,124878,0,156882
132437801000000,NW 326,RESIDENTIAL,31699,0,31699,105215,0,136914
132437801100000,NW 326,RESIDENTIAL,31747,0,31747,122679,0,154426
132437801200000,NW 326,RESIDENTIAL,31169,0,31169,123329,0,154498
132437801300000,NW 326,RESIDENTIAL,30994,0,30994,112003,0,142997
132437801400000,NW 326,RESIDENTIAL,32472,0,32472,132704,0,165176
132437801500000,NW 326,RESIDENTIAL,32818,0,32818,122808,0,155626
132437801600000,NW 326,RESIDENTIAL,32520,0,32520,113058,0,145578
132437801700000,NW 326,RESIDENTIAL,32222,0,32222,124544,0,156766
132437801800000,NW 326,RESIDENTIAL,31923,0,31923,104606,0,136529
132437801900000,NW 326,RESIDENTIAL,31625,0,31625,115484,0,147109
132437802000000,NW 326,RESIDENTIAL,31875,0,31875,104006,0,135881
132437802100000,NW 326,RESIDENTIAL,33784,0,33784,117567,0,151351
132437900100000,NW 326,RESIDENTIAL,30921,0,30921,110970,0,141891
132437900200000,NW 326,RESIDENTIAL,30561,0,30561,122205,0,152766
132437900300000,NW 326,RESIDENTIAL,31028,0,31028,117456,0,148484
132437900400000,NW 326,RESIDENTIAL,30901,0,30901,132936,0,163837
132437900500000,NW 326,RESIDENTIAL,31447,0,31447,113993,0,145440
132437900600000,NW 326,RESIDENTIAL,32268,0,32268,115189,0,147457
132437900700000,NW 326,RESIDENTIAL,30332,0,30332,122692,0,153024
132437900800000,NW 326,RESIDENTIAL,30965,0,30965,133055,0,164020
132437900900000,NW 326,RESIDENTIAL,30748,0,30748,117954,0,148702
132437901000000,NW 326,RESIDENTIAL,30804,0,30804,117611,0,148415
132437901100000,NW 326,RESIDENTIAL,29315,0,29315,136260,0,165575
132438000100000,NW 326,RESIDENTIAL,31644,0,31644,130610,0,162254
132438000200000,NW 326,RESIDENTIAL,30118,0,30118,119798,0,149916
132438000300000,NW 326,RESIDENTIAL,31894,0,31894,116549,0,148443
132438000400000,NW 326,RESIDENTIAL,27203,0,27203,102074,0,129277
132438000500000,NW 326,RESIDENTIAL,30985,0,30985,117022,0,148007
132438000600000,NW 326,RESIDENTIAL,28841,0,28841,121347,0,150188
132438000700000,NW 326,RESIDENTIAL,29136,0,29136,122585,0,151721
132438000800000,NW 326,RESIDENTIAL,21528,0,21528,158162,0,179690
132438000900000,NW 326,RESIDENTIAL,32965,0,32965,113993,0,146958
132438001000000,NW 326,RESIDENTIAL,31136,0,31136,121732,0,152868
132438001100000,NW 326,RESIDENTIAL,32299,0,32299,107013,0,139312
132438001200000,NW 326,RESIDENTIAL,33905,0,33905,133906,0,167811
132438001300000,NW 326,RESIDENTIAL,30381,0,30381,113494,0,143875
132438001400000,NW 326,RESIDENTIAL,30010,0,30010,122473,0,152483
132438001500000,NW 326,RESIDENTIAL,32588,0,32588,120611,0,153199
132438001600000,NW 326,RESIDENTIAL,30432,0,30432,108832,0,139264
132438001700000,NW 326,RESIDENTIAL,31135,0,31135,112271,0,143406
132438001800000,NW 326,RESIDENTIAL,31416,0,31416,106920,0,138336
132438001900000,NW 326,RESIDENTIAL,30459,0,30459,106921,0,137380
132438002000000,NW 326,RESIDENTIAL,31696,0,31696,104401,0,136097
132438002100000,NW 326,RESIDENTIAL,32273,0,32273,119767,0,152040
132438002200000,NW 326,RESIDENTIAL,30256,0,30256,125766,0,156022
132438002300000,NW 326,RESIDENTIAL,32062,0,32062,34135,0,66197
132438002400000,NW 326,RESIDENTIAL,35904,0,35904,61658,0,97562
132438002500000,NW 326,RESIDENTIAL,44282,0,44282,107314,0,151596
132438002600000,NW 326,RESIDENTIAL,64500,0,64500,100596,0,165096
132438002700000,CITY PROPERTY,EXEMPT,0,0,0,0,0,0
132438002702000,ANTENNAS/TOWERS(BLL),COMMERCIAL,0,0,0,0,9623,9623
132438002800000,NW 326,RESIDENTIAL,64150,0,64150,100279,0,164429
132438002900000,NW 326,RESIDENTIAL,33696,0,33696,91990,0,125686
132438003000000,NW 326,RESIDENTIAL,25680,0,25680,125540,0,151220
132440100100000,NW 309,RESIDENTIAL,37462,0,37462,156497,0,193959
132440200100000,CITY PROPERTY,EXEMPT,0,0,0,0,0,0
132440200300000,CITY PROPERTY,EXEMPT,0,0,0,0,0,0
132440200400000,NW 337,RESIDENTIAL,8550,0,8550,0,0,8550
132440200500000,NW 337,RESIDENTIAL,5050,0,5050,0,0,5050
132440200600000,NW 309,RESIDENTIAL,35137,0,35137,147462,0,182599
132440200700000,NW 309,RESIDENTIAL,41634,0,41634,154871,0,196505
132440200800000,NW 309,RESIDENTIAL,41100,0,41100,124573,0,165673
132440200900000,NW 309,RESIDENTIAL,32042,0,32042,159774,0,191816
132440201000000,NW 309,RESIDENTIAL,42780,0,42780,156996,0,199776
132440201100000,NW 309,RESIDENTIAL,34542,0,34542,136983,0,171525
132440201200000,NW 309,RESIDENTIAL,35581,0,35581,148007,0,183588
132440201300000,NW 309,RESIDENTIAL,56050,0,56050,135093,0,191143
132440201400000,NW 309,RESIDENTIAL,38350,0,38350,125681,0,164031
132440201500000,NW 337,RESIDENTIAL,29322,0,29322,101527,0,130849
132440201600000,NW 337,RESIDENTIAL,29322,0,29322,156427,0,185749
132440201700000,NW 337,RESIDENTIAL,29821,0,29821,85265,0,115086
132440201800000,NW 337,RESIDENTIAL,28414,0,28414,155749,0,184163
132440201900000,NW 337,RESIDENTIAL,30325,0,30325,109190,0,139515
132440202000000,NW 337,RESIDENTIAL,23348,0,23348,197037,0,220385
132440202100000,NW 337,RESIDENTIAL,21476,0,21476,49462,0,70938
132440202200000,NW 337,RESIDENTIAL,11400,0,11400,8791,0,20191
132440202300000,NW 337,RESIDENTIAL,18480,0,18480,67872,0,86352
132440202400000,CITY PROPERTY,EXEMPT,0,0,0,0,0,0
132440300100000,NW 337,RESIDENTIAL,52100,0,52100,77695,0,129795
132440300200000,NW 337,RESIDENTIAL,29484,0,29484,98236,0,127720
132440300300000,NW 305,RESIDENTIAL,27216,0,27216,155950,0,183166
132440300400000,NW 305,RESIDENTIAL,27136,0,27136,107703,0,134839
132440300500000,NW 305,RESIDENTIAL,26880,0,26880,138315,0,165195
132440300600000,NW 305,RESIDENTIAL,26624,0,26624,153057,0,179681
132440300700000,NW 305,RESIDENTIAL,26624,0,26624,156120,0,182744
132440300800000,NW 305,RESIDENTIAL,26463,0,26463,152740,0,179203
132440300900000,NW 337,RESIDENTIAL,29680,0,29680,0,0,29680
132440301000000,NW 305,RESIDENTIAL,27454,0,27454,179041,0,206495
132440301100000,NW 337,RESIDENTIAL,30397,0,30397,266284,0,296681
132440301200000,NW 337,RESIDENTIAL,30397,0,30397,0,0,30397
132440301300000,NW 337,RESIDENTIAL,71750,0,71750,222536,0,294286
132440301400000,NW 337,RESIDENTIAL,40332,0,40332,87736,0,128068
132440301500000,NW 337,RESIDENTIAL,34051,0,34051,107233,0,141284
132440301600000,NW 337,RESIDENTIAL,60520,0,60520,0,0,60520
132440301700000,NW 305,RESIDENTIAL,28561,0,28561,179020,0,207581
132440301800000,NW 305,RESIDENTIAL,26733,0,26733,151763,0,178496
132440301900000,NW 305,RESIDENTIAL,27832,0,27832,174985,0,202817
132440302000000,NW 305,RESIDENTIAL,28547,0,28547,179392,0,207939
132440302100000,NW 305,RESIDENTIAL,26624,0,26624,157164,0,183788
132440302200000,NW 305,RESIDENTIAL,26624,0,26624,159207,0,185831
132440302300000,NW 305,RESIDENTIAL,26624,0,26624,146867,0,173491
132440302400000,NW 305,RESIDENTIAL,26624,0,26624,171031,0,197655
132440302500000,NW 305,RESIDENTIAL,25856,0,25856,155131,0,180987
132440302600000,NW 305,RESIDENTIAL,26334,0,26334,176071,0,202405
132442600100000,NW 315,RESIDENTIAL,34406,0,34406,126382,0,160788
132442600200000,NW 315,RESIDENTIAL,29718,0,29718,116339,0,146057
132442600300000,NW 315,RESIDENTIAL,29718,0,29718,104714,0,134432
132442600400000,NW 315,RESIDENTIAL,29718,0,29718,118758,0,148476
132442600500000,NW 315,RESIDENTIAL,29718,0,29718,119767,0,149485
132442600600000,NW 315,RESIDENTIAL,29718,0,29718,106202,0,135920
132442600700000,NW 315,RESIDENTIAL,29718,0,29718,114249,0,143967
132442600800000,NW 315,RESIDENTIAL,20424,0,20424,116890,0,137314
132442600900000,NW 315,RESIDENTIAL,20424,0,20424,4801,0,25225
132442700100000,NW 315,RESIDENTIAL,29673,0,29673,115376,0,145049
132442700200000,NW 315,RESIDENTIAL,40848,0,40848,166923,0,207771
132442700300000,NW 315,RESIDENTIAL,17780,0,17780,46902,0,64682
132442700400000,NW 315,RESIDENTIAL,16490,0,16490,70208,0,86698
132442700500000,NW 315,RESIDENTIAL,12610,0,12610,128353,0,140963
132442700600000,NW 315,RESIDENTIAL,50017,0,50017,90014,0,140031
132442700700000,NW 315,RESIDENTIAL,47132,0,47132,114729,0,161861
132442700800000,NW 315,RESIDENTIAL,29718,0,29718,112767,0,142485
132442700900000,NW 315,RESIDENTIAL,29718,0,29718,120946,0,150664
132442701000000,NW 315,RESIDENTIAL,29718,0,29718,110355,0,140073
132442701100000,NW 315,RESIDENTIAL,29718,0,29718,117053,0,146771
132442701200000,NW 315,RESIDENTIAL,29718,0,29718,118795,0,148513
132442701300000,NW 315,RESIDENTIAL,29718,0,29718,124020,0,153738
132442800100000,NW 315,RESIDENTIAL,17460,0,17460,115302,0,132762
132442800200000,NW 315,RESIDENTIAL,31464,0,31464,133318,0,164782
132442800300000,NW 315,RESIDENTIAL,39330,0,39330,150656,0,189986
132442800400000,NW 315,RESIDENTIAL,39330,0,39330,157208,0,196538
132442800500000,NW 315,RESIDENTIAL,40109,0,40109,143160,0,183269
132442800700000,NW 315,RESIDENTIAL,41858,0,41858,170301,0,212159
132442800800000,NW 315,RESIDENTIAL,41407,0,41407,183534,0,224941
132442800900000,NW 315,RESIDENTIAL,41287,0,41287,181956,0,223243
132442801000000,NW 315,RESIDENTIAL,38475,0,38475,130108,0,168583
132442801100000,NW 315,RESIDENTIAL,38475,0,38475,146117,0,184592
132442801200000,NW 309,RESIDENTIAL,36675,0,36675,0,0,36675
132442801300000,NW 309,RESIDENTIAL,36120,0,36120,190269,0,226389
132442801400000,NW 309,RESIDENTIAL,34708,0,34708,192400,0,227108
132442801500000,NW 337,RESIDENTIAL,35502,0,35502,99791,0,135293
132442801600000,NW 309,RESIDENTIAL,37777,0,37777,173013,0,210790
132442801700000,NW 309,RESIDENTIAL,38640,0,38640,126749,0,165389
132442801800000,NW 309,RESIDENTIAL,38583,0,38583,129539,0,168122
132442801900000,NW 315,RESIDENTIAL,32603,0,32603,101746,0,134349
132442802000000,NW 315,RESIDENTIAL,37087,0,37087,138660,0,175747
132442802100000,NW 315,RESIDENTIAL,28529,0,28529,118642,0,147171
132442802200000,NW 315,RESIDENTIAL,28529,0,28529,0,0,28529
132442802300000,APARTMENT,COMMERCIAL,0,30624,30624,0,251976,282600
132442802400000,NW 315,RESIDENTIAL,28529,0,28529,111854,0,140383
132442802500000,NW 315,RESIDENTIAL,28529,0,28529,110863,0,139392
132442802600000,NW 315,RESIDENTIAL,29498,0,29498,51796,0,81294
132442802700000,NW 315,RESIDENTIAL,29498,0,29498,38489,0,67987
132442802800000,NW 315,RESIDENTIAL,14684,0,14684,41098,0,55782
132442802900000,NW 315,RESIDENTIAL,17460,0,17460,139006,0,156466
132442803000000,NW 315,RESIDENTIAL,17460,0,17460,89484,0,106944
132442803100000,NW 315,RESIDENTIAL,17460,0,17460,132059,0,149519
132442803200000,NW 315,RESIDENTIAL,20,0,20,0,0,20
132442803300000,NW 337,RESIDENTIAL,26022,0,26022,182869,0,208891
132442803400000,NW 337,RESIDENTIAL,25861,0,25861,211206,0,237067
132442803500000,NW 337,RESIDENTIAL,37246,0,37246,250682,0,287928
132442900100000,NW 337,RESIDENTIAL,67050,0,67050,147416,0,214466
132442900200000,NW 337,RESIDENTIAL,67050,0,67050,59140,0,126190
132442900400000,NW 337,RESIDENTIAL,23744,0,23744,80454,0,104198
132442900500000,NW 337,AG LAND,17317,0,17317,0,0,17317
132442900600000,NW 337,RESIDENTIAL,61250,0,61250,73823,0,135073
132442900700000,NW 337,RESIDENTIAL,60000,0,60000,112417,0,172417
132442900800000,NW 337,RESIDENTIAL,22400,0,22400,0,0,22400
132445100100000,NW 337,RESIDENTIAL,33280,0,33280,0,0,33280
132445100200000,NW 337,RESIDENTIAL,14952,0,14952,37723,0,52675
132445100300000,NW 337,RESIDENTIAL,26861,0,26861,21876,0,48737
132445100400000,NW 337,RESIDENTIAL,21806,0,21806,43413,0,65219
132445100500000,NW 337,RESIDENTIAL,54100,0,54100,152711,0,206811
132445100600000,NW 337,RESIDENTIAL,56750,0,56750,66600,0,123350
132445100700000,NW 337,RESIDENTIAL,68800,0,68800,91143,0,159943
132445100800000,NW 337,RESIDENTIAL,19824,0,19824,39037,0,58861
132445100900000,NW 337,RESIDENTIAL,19824,0,19824,114262,0,134086
132445101000000,NW 337,RESIDENTIAL,19824,0,19824,94135,0,113959
132445101100000,NW 337,RESIDENTIAL,26432,0,26432,104287,0,130719
132445101200000,SHOP,COMMERCIAL,0,181250,181250,0,469490,650740
132445101300000,NW 337,RESIDENTIAL,30628,0,30628,44229,0,74857
132445200100000,NW 337,RESIDENTIAL,28084,0,28084,124630,0,152714
132445200200000,NW 337,RESIDENTIAL,26432,0,26432,67116,0,93548
132445200300000,NW 337,RESIDENTIAL,29819,0,29819,96888,0,126707
132445200400000,NW 337,RESIDENTIAL,23128,0,23128,128150,0,151278
132445200500000,NW 337,RESIDENTIAL,27258,0,27258,99844,0,127102
132445200600000,NW 337,RESIDENTIAL,27258,0,27258,101451,0,128709
132445200700000,NW 337,RESIDENTIAL,31223,0,31223,95173,0,126396
132445200800000,VACANT LAND,COMMERCIAL,0,48750,48750,0,0,48750
132445200900000,SHOP,COMMERCIAL,0,270000,270000,0,374067,644067
132445201000000,NW 337,RESIDENTIAL,30780,0,30780,81752,0,112532
132445201100000,NW 337,RESIDENTIAL,31824,0,31824,40038,0,71862
132445201200000,NW 337,RESIDENTIAL,29736,0,29736,5032,0,34768
132445201300000,NW 337,RESIDENTIAL,31586,0,31586,39047,0,70633
132445201400000,SMALL RET; CTRL CR,COMMERCIAL,0,39634,39634,0,81403,121037
132445201500000,NW 337,RESIDENTIAL,20370,0,20370,115955,0,136325
132445201600000,NW 337,RESIDENTIAL,20098,0,20098,80315,0,100413
132445201700000,NW 337,RESIDENTIAL,27115,0,27115,90556,0,117671
132445201800000,NW 337,RESIDENTIAL,21806,0,21806,0,0,21806
132445201900000,NW 337,RESIDENTIAL,27258,0,27258,191716,0,218974
132445202000000,NW 337,RESIDENTIAL,51552,0,51552,74616,0,126168
132445202100000,NW 337,RESIDENTIAL,51552,0,51552,75666,0,127218
132445202200000,NW 337,RESIDENTIAL,31223,0,31223,141931,0,173154
132445202300000,NW 337,RESIDENTIAL,19824,0,19824,100766,0,120590
132445202400000,NW 337,RESIDENTIAL,28084,0,28084,105138,0,133222
132445202500000,NW 337,RESIDENTIAL,26432,0,26432,64228,0,90660
132445202600000,NW 337,RESIDENTIAL,51552,0,51552,88851,0,140403
132447600100000,NW 337,RESIDENTIAL,37125,0,37125,0,0,37125
132447600200000,NW 337,RESIDENTIAL,18312,0,18312,86262,0,104574
132447600300000,NW 324,RESIDENTIAL,23436,0,23436,94096,0,117532
132447600400000,NW 324,RESIDENTIAL,23180,0,23180,105453,0,128633
132447600500000,NW 324,RESIDENTIAL,23180,0,23180,105565,0,128745
132447600600000,NW 324,RESIDENTIAL,23180,0,23180,93738,0,116918
132447600700000,NW 324,RESIDENTIAL,23180,0,23180,85557,0,108737
132447600800000,NW 324,RESIDENTIAL,23180,0,23180,102067,0,125247
132447600900000,NW 324,RESIDENTIAL,23180,0,23180,101894,0,125074
132447601000000,NW 324,RESIDENTIAL,23180,0,23180,114066,0,137246
132447601100000,NW 324,RESIDENTIAL,23180,0,23180,95982,0,119162
132447601200000,NW 324,RESIDENTIAL,23962,0,23962,117903,0,141865
132447601300000,NW 337,RESIDENTIAL,75700,0,75700,0,0,75700
132447601400000,CHURCH,EXEMPT,0,382428,382428,0,520192,902620
132447700100000,NW 324,RESIDENTIAL,23894,0,23894,86170,0,110064
132447700200000,NW 324,RESIDENTIAL,23180,0,23180,99932,0,123112
132447700300000,NW 324,RESIDENTIAL,23180,0,23180,99474,0,122654
132447700400000,NW 324,RESIDENTIAL,23180,0,23180,114068,0,137248
132447700500000,NW 324,RESIDENTIAL,23180,0,23180,93598,0,116778
132447700600000,NW 324,RESIDENTIAL,23180,0,23180,108278,0,131458
132447700700000,NW 324,RESIDENTIAL,23180,0,23180,93125,0,116305
132447700800000,NW 324,RESIDENTIAL,23180,0,23180,87006,0,110186
132447700900000,NW 324,RESIDENTIAL,23180,0,23180,101177,0,124357
132447701000000,NW 324,RESIDENTIAL,23556,0,23556,159345,0,182901
132447701100000,NW 337,RESIDENTIAL,31158,0,31158,57896,0,89054
132447701200000,NW 337,RESIDENTIAL,29326,0,29326,23666,0,52992
132447701300000,NW 337,RESIDENTIAL,33075,0,33075,98323,0,131398
132447701400000,OFFICE,COMMERCIAL,0,62353,62353,0,283062,345415
132447701500000,BRANCH BANK/CU,COMMERCIAL,0,416000,416000,0,553874,969874
132447800200000,NW 301,RESIDENTIAL,33408,0,33408,113875,0,147283
132447800300000,NW 337,RESIDENTIAL,26180,0,26180,115114,0,141294
132447800400000,NW 337,RESIDENTIAL,30234,0,30234,109894,0,140128
132447800500000,NW 337,RESIDENTIAL,27258,0,27258,94473,0,121731
132447800600000,NW 337,RESIDENTIAL,27313,0,27313,97432,0,124745
132447800700000,NW 337,RESIDENTIAL,23562,0,23562,108281,0,131843
132447800800000,NW 337,RESIDENTIAL,23562,0,23562,48009,0,71571
132447800900000,NW 337,RESIDENTIAL,22211,0,22211,86179,0,108390
132447801000000,NW 337,RESIDENTIAL,22280,0,22280,86843,0,109123
132447801100000,NW 337,RESIDENTIAL,27384,0,27384,199789,0,227173
132447801200000,NW 337,RESIDENTIAL,27384,0,27384,162614,0,189998
132447801300000,NW 337,RESIDENTIAL,33862,0,33862,135011,0,168873
132447801400000,NW 337,RESIDENTIAL,35162,0,35162,119043,0,154205
132447801500000,NW 324,RESIDENTIAL,28403,0,28403,102711,0,131114
132447801600000,NW 324,RESIDENTIAL,26858,0,26858,120432,0,147290
132447801700000,NW 324,RESIDENTIAL,26858,0,26858,93669,0,120527
132447801800000,NW 324,RESIDENTIAL,27454,0,27454,126688,0,154142
132447801900000,NW 324,RESIDENTIAL,26040,0,26040,121127,0,147167
132447802000000,NW 324,RESIDENTIAL,26858,0,26858,94141,0,120999
132447802300000,CHURCH,EXEMPT,0,550800,550800,0,553520,1104320
132447900100000,NW 324,RESIDENTIAL,27637,0,27637,112835,0,140472
132447900200000,NW 324,RESIDENTIAL,27900,0,27900,111572,0,139472
132447900300000,NW 324,RESIDENTIAL,27900,0,27900,106827,0,134727
132447900400000,NW 324,RESIDENTIAL,27900,0,27900,108054,0,135954
132447900500000,NW 324,RESIDENTIAL,26040,0,26040,84289,0,110329
132447900600000,NW 324,RESIDENTIAL,26784,0,26784,127114,0,153898
132447900700000,NW 324,RESIDENTIAL,27900,0,27900,114045,0,141945
132447900800000,NW 324,RESIDENTIAL,27900,0,27900,105008,0,132908
132447900900000,NW 324,RESIDENTIAL,27900,0,27900,110203,0,138103
132447901000000,NW 324,RESIDENTIAL,27900,0,27900,116835,0,144735
132447901100000,NW 324,RESIDENTIAL,27900,0,27900,125923,0,153823
132447901200000,NW 324,RESIDENTIAL,28165,0,28165,102335,0,130500
132448000100000,NW 324,RESIDENTIAL,36190,0,36190,130284,0,166474
132448000200000,NW 337,RESIDENTIAL,27258,0,27258,75309,0,102567
132448000300000,NW 337,RESIDENTIAL,43920,0,43920,78533,0,122453
132448000400000,NW 337,RESIDENTIAL,24119,0,24119,112881,0,137000
132448000500000,NW 337,RESIDENTIAL,28335,0,28335,44978,0,73313
132448000600000,NW 337,RESIDENTIAL,26432,0,26432,205386,0,231818
132448000700000,NW 337,RESIDENTIAL,22023,0,22023,95576,0,117599
132448000800000,NW 337,RESIDENTIAL,19278,0,19278,115174,0,134452
132448000900000,NW 337,RESIDENTIAL,17850,0,17850,98115,0,115965
132448001000000,NW 337,RESIDENTIAL,19635,0,19635,61061,0,80696
132448001100000,NW 324,RESIDENTIAL,25760,0,25760,86629,0,112389
132448001200000,NW 324,RESIDENTIAL,25760,0,25760,92126,0,117886
132510100100000,NW 324,RESIDENTIAL,27743,0,27743,72954,0,100697
132510100200000,VACANT LAND,COMMERCIAL,0,43749,43749,0,0,43749
132510100300000,LAUNDROMAT/CLEANERS,COMMERCIAL,0,43749,43749,0,53470,97219
132510100400000,VACANT LAND,COMMERCIAL,0,43749,43749,0,0,43749
132510100700000,NW 324,RESIDENTIAL,56700,0,56700,0,0,56700
132510100800000,NW 324,RESIDENTIAL,56700,0,56700,0,0,56700
132510100900000,NW 324,RESIDENTIAL,68000,0,68000,112028,0,180028
132510101000000,NW 324,RESIDENTIAL,68500,0,68500,568390,0,636890
132510101100000,NW 324,RESIDENTIAL,55400,0,55400,112474,0,167874
132510101200000,NW 324,RESIDENTIAL,20265,0,20265,68584,0,88849
132510101300000,NW 324,RESIDENTIAL,50850,0,50850,96006,0,146856
132510101400000,NW 324,RESIDENTIAL,50850,0,50850,127608,0,178458
132510101500000,NW 324,RESIDENTIAL,50850,0,50850,156058,0,206908
132510101600000,NW 324,RESIDENTIAL,50850,0,50850,146612,0,197462
132510102000000,SMALL RETAIL,COMMERCIAL,0,382000,382000,0,258642,640642
132510102100000,RESTAURANT,COMMERCIAL,0,428020,428020,0,148158,576178
132510102200000,AUTO REPAIR/SALES,COMMERCIAL,0,360020,360020,0,215531,575551
132510102300000,FAST FOOD,COMMERCIAL,0,400020,400020,0,812810,1212830
132510102400000,VETERINARY CLINIC,COMMERCIAL,0,175560,175560,0,120655,296215
132510102500000,NBHD SHOPPING CENTER,COMMERCIAL,0,465000,465000,0,452178,917178
132510102502000,BILLBOARD(BLL),COMMERCIAL,0,0,0,0,62175,62175
132510102600000,VETERINARY CLINIC,COMMERCIAL,0,97500,97500,0,413818,511318
132510102700000,NW 324,RESIDENTIAL,54650,0,54650,0,0,54650
132510102800000,LG DISCOUNT/RETAIL,COMMERCIAL,0,935000,935000,0,1277656,2212656
132512600100000,NW 324,RESIDENTIAL,56700,0,56700,133237,0,189937
132512600200000,NW 324,RESIDENTIAL,60500,0,60500,198536,0,259036
132512600300000,NW 324,RESIDENTIAL,5950,0,5950,0,0,5950
132512600400000,NW 324,RESIDENTIAL,82500,0,82500,0,0,82500
132512600600000,CENTRALLY ASSESSED,OTHER,0,0,0,0,0,0
132512600700000,CENTRALLY ASSESSED,OTHER,0,0,0,0,0,0
132512600800000,NW 324,RESIDENTIAL,58200,0,58200,135582,0,193782
132512600900000,NW 327,RESIDENTIAL,30464,0,30464,110135,0,140599
132512601000000,NW 327,RESIDENTIAL,30464,0,30464,119107,0,149571
132512601100000,NW 327,RESIDENTIAL,30464,0,30464,101444,0,131908
132512601200000,NW 327,RESIDENTIAL,30464,0,30464,102963,0,133427
132512601300000,NW 327,RESIDENTIAL,22855,0,22855,102865,0,125720
132512601400000,NW 327,RESIDENTIAL,22855,0,22855,101214,0,124069
132512601500000,NW 324,RESIDENTIAL,34957,0,34957,106580,0,141537
132512601600000,NW 324,RESIDENTIAL,41269,0,41269,118435,0,159704
132512601700000,NW 324,RESIDENTIAL,56700,0,56700,201126,0,257826
132512601800000,NW 324,RESIDENTIAL,56700,0,56700,131767,0,188467
132512601900000,NW 324,RESIDENTIAL,56700,0,56700,53568,0,110268
132512602000000,NW 324,RESIDENTIAL,56700,0,56700,193375,0,250075
132512602100000,NW 324,RESIDENTIAL,56700,0,56700,308437,0,365137
132512602200000,NW 324,RESIDENTIAL,46062,0,46062,95746,0,141808
132512602300000,NW 324,RESIDENTIAL,48835,0,48835,0,0,48835
132512602400000,NW 324,RESIDENTIAL,44540,0,44540,363275,0,407815
132512602500000,NW 324,RESIDENTIAL,42556,0,42556,315872,0,358428
132512602600000,NW 324,RESIDENTIAL,42567,0,42567,281337,0,323904
132515100100000,CITY PROPERTY,EXEMPT,0,0,0,0,0,0
132515100200000,CITY PROPERTY,EXEMPT,0,0,0,0,0,0
132515100300000,CITY PROPERTY,EXEMPT,0,0,0,0,0,0
132515200100000,CITY PROPERTY,EXEMPT,0,0,0,0,0,0
132515300500000,NW 335,RESIDENTIAL,27300,0,27300,82037,0,109337
132515300600000,NW 335,RESIDENTIAL,27300,0,27300,76416,0,103716
132515300700000,NW 335,RESIDENTIAL,31158,0,31158,56253,0,87411
132515300800000,CITY PROPERTY,EXEMPT,0,0,0,0,0,0
132515300900000,NW 335,RESIDENTIAL,35280,0,35280,119279,0,154559
132515301000000,NW 335,RESIDENTIAL,33135,0,33135,76080,0,109215
132515301100000,NW 335,RESIDENTIAL,32330,0,32330,88755,0,121085
132515301200000,NW 335,RESIDENTIAL,25235,0,25235,54388,0,79623
132515301300000,NW 335,RESIDENTIAL,24255,0,24255,48127,0,72382
132515400200000,NW 335,RESIDENTIAL,23836,0,23836,80812,0,104648
132515400300000,NW 335,RESIDENTIAL,30406,0,30406,71820,0,102226
132515500100000,NW 335,RESIDENTIAL,32130,0,32130,72591,0,104721
132515500200000,NW 335,RESIDENTIAL,26932,0,26932,63721,0,90653
132515500300000,NW 335,RESIDENTIAL,27846,0,27846,83383,0,111229
132515500400000,NW 335,RESIDENTIAL,24525,0,24525,69540,0,94065
132515500500000,NW 335,RESIDENTIAL,22295,0,22295,0,0,22295
132515500600000,NW 335,RESIDENTIAL,20790,0,20790,0,0,20790
132515500700000,NW 335,RESIDENTIAL,27191,0,27191,98001,0,125192
132515500800000,NW 335,RESIDENTIAL,21840,0,21840,94975,0,116815
132515500900000,NW 335,RESIDENTIAL,21840,0,21840,103412,0,125252
132515501000000,NW 335,RESIDENTIAL,21840,0,21840,85749,0,107589
132515501100000,APARTMENT,COMMERCIAL,0,22356,22356,0,127368,149724
132515501200000,NW 335,RESIDENTIAL,25074,0,25074,64488,0,89562
132515501300000,NW 335,RESIDENTIAL,24967,0,24967,62287,0,87254
132515501400000,CONVERSION,COMMERCIAL,0,17360,17360,0,86772,104132
132515501500000,NW 335,RESIDENTIAL,32214,0,32214,111304,0,143518
132515501600000,APARTMENT,COMMERCIAL,0,21000,21000,0,123102,144102
132515501700000,NW 335,RESIDENTIAL,27685,0,27685,56470,0,84155
132515501800000,NW 335,RESIDENTIAL,28931,0,28931,74958,0,103889
132515501900000,NW 335,RESIDENTIAL,29890,0,29890,92745,0,122635
132515502000000,NW 335,RESIDENTIAL,29484,0,29484,112799,0,142283
132515502100000,NW 335,RESIDENTIAL,31468,0,31468,91543,0,123011
132515502200000,NW 335,RESIDENTIAL,24716,0,24716,113228,0,137944
132515600100000,NW 335,RESIDENTIAL,29669,0,29669,132594,0,162263
132515600200000,NW 335,RESIDENTIAL,39981,0,39981,112483,0,152464
132515600300000,NW 335,RESIDENTIAL,37622,0,37622,125081,0,162703
132515600400000,NW 335,RESIDENTIAL,37440,0,37440,103071,0,140511
132515600500000,NW 335,RESIDENTIAL,39682,0,39682,140274,0,179956
132515600600000,NW 335,RESIDENTIAL,33760,0,33760,116975,0,150735
132515600700000,NW 335,RESIDENTIAL,36315,0,36315,145491,0,181806
132515600800000,NW 335,RESIDENTIAL,36328,0,36328,146775,0,183103
132515600900000,NW 335,RESIDENTIAL,37772,0,37772,156523,0,194295
132515601000000,NW 335,RESIDENTIAL,30555,0,30555,111523,0,142078
132515601100000,NW 335,RESIDENTIAL,34920,0,34920,144245,0,179165
132515601200000,NW 335,RESIDENTIAL,35317,0,35317,140710,0,176027
132515601300000,NW 335,RESIDENTIAL,35381,0,35381,145070,0,180451
132515601400000,NW 335,RESIDENTIAL,20,0,20,0,0,20
132515601500000,NW 335,RESIDENTIAL,36859,0,36859,142661,0,179520
132515601600000,NW 335,RESIDENTIAL,36000,0,36000,118754,0,154754
132515601700000,NW 335,RESIDENTIAL,37573,0,37573,151671,0,189244
132515601800000,NW 335,RESIDENTIAL,57002,0,57002,116140,0,173142
132515601900000,SCHOOL,EXEMPT,0,0,0,0,0,0
132515700100000,NW 335,RESIDENTIAL,36726,0,36726,160085,0,196811
132515700200000,NW 335,RESIDENTIAL,27132,0,27132,122277,0,149409
132515700300000,NW 335,RESIDENTIAL,36118,0,36118,146555,0,182673
132515700400000,NW 335,RESIDENTIAL,36771,0,36771,147933,0,184704
132515700500000,NW 335,RESIDENTIAL,36338,0,36338,143227,0,179565
132515700600000,NW 335,RESIDENTIAL,28329,0,28329,126899,0,155228
132515700700000,NW 335,RESIDENTIAL,32781,0,32781,126178,0,158959
132515700800000,NW 335,RESIDENTIAL,36410,0,36410,131041,0,167451
132515700900000,NW 335,RESIDENTIAL,33258,0,33258,111112,0,144370
132515701000000,NW 335,RESIDENTIAL,35527,0,35527,111664,0,147191
132517600200000,CITY PROPERTY,EXEMPT,0,0,0,0,0,0
132517600400000,NW 324,RESIDENTIAL,20700,0,20700,89772,0,110472
132517600500000,NW 324,RESIDENTIAL,21060,0,21060,74764,0,95824
132517600600000,NW 324,RESIDENTIAL,21420,0,21420,82860,0,104280
132517600700000,NW 324,RESIDENTIAL,21780,0,21780,93702,0,115482
132517600800000,NW 324,RESIDENTIAL,26077,0,26077,92932,0,119009
132517600900000,NW 324,RESIDENTIAL,20820,0,20820,94043,0,114863
132517601000000,NW 324,RESIDENTIAL,16865,0,16865,101917,0,118782
132517700100000,FAST FOOD,COMMERCIAL,0,146010,146010,0,207306,353316
132517700200000,NBHD SHOPPING CENTER,COMMERCIAL,0,338400,338400,0,474760,813160
132517700300000,NW 324,RESIDENTIAL,22806,0,22806,99616,0,122422
132517700400000,NW 324,RESIDENTIAL,23552,0,23552,116681,0,140233
132517700500000,NW 324,RESIDENTIAL,23552,0,23552,92695,0,116247
132517700600000,NW 324,RESIDENTIAL,23257,0,23257,95544,0,118801
132517700700000,NW 324,RESIDENTIAL,24437,0,24437,96411,0,120848
132517700800000,NW 324,RESIDENTIAL,25080,0,25080,87892,0,112972
132517700900000,NW 324,RESIDENTIAL,25194,0,25194,133149,0,158343
132517701000000,NW 324,RESIDENTIAL,22560,0,22560,98604,0,121164
132517701100000,NW 324,RESIDENTIAL,23552,0,23552,106646,0,130198
132517701200000,NW 324,RESIDENTIAL,23296,0,23296,105172,0,128468
132517701300000,NW 324,RESIDENTIAL,23296,0,23296,85100,0,108396
132517701400000,NW 324,EXEMPT,0,23296,23296,0,110691,133987
132517701500000,NW 324,RESIDENTIAL,23296,0,23296,103466,0,126762
132517701600000,NW 324,RESIDENTIAL,23296,0,23296,101080,0,124376
132517701700000,NW 324,RESIDENTIAL,23332,0,23332,97601,0,120933
132517701800000,NW 324,RESIDENTIAL,24315,0,24315,94628,0,118943
132517701900000,NW 324,RESIDENTIAL,24064,0,24064,95383,0,119447
132517702000000,NW 324,RESIDENTIAL,24064,0,24064,86329,0,110393
132517702100000,NW 324,RESIDENTIAL,24064,0,24064,90769,0,114833
132517702200000,NW 324,RESIDENTIAL,24064,0,24064,96922,0,120986
132517702300000,NW 324,RESIDENTIAL,24064,0,24064,97991,0,122055
132517702400000,NW 324,RESIDENTIAL,24064,0,24064,96925,0,120989
132517702500000,NW 324,RESIDENTIAL,27072,0,27072,116687,0,143759
132517702600000,NW 324,RESIDENTIAL,26611,0,26611,107284,0,133895
132517702700000,FLAT PARKING,COMMERCIAL,0,162800,162800,0,8100,170900
132517702800000,OFFICE,COMMERCIAL,0,167276,167276,0,340814,508090
132517800100000,NW 324,RESIDENTIAL,24546,0,24546,105420,0,129966
132517800200000,NW 324,RESIDENTIAL,27615,0,27615,97270,0,124885
132517800300000,NW 324,RESIDENTIAL,23296,0,23296,98890,0,122186
132517800400000,NW 324,RESIDENTIAL,23296,0,23296,105504,0,128800
132517800500000,NW 324,RESIDENTIAL,23296,0,23296,97133,0,120429
132517800600000,NW 324,RESIDENTIAL,23296,0,23296,99300,0,122596
132517800700000,NW 324,RESIDENTIAL,23296,0,23296,97394,0,120690
132517800800000,NW 324,RESIDENTIAL,23296,0,23296,90197,0,113493
132517800900000,NW 324,RESIDENTIAL,25480,0,25480,88269,0,113749
132517801000000,NW 324,RESIDENTIAL,25480,0,25480,109367,0,134847
132517801100000,NW 324,RESIDENTIAL,25480,0,25480,97822,0,123302
132517801200000,NW 324,RESIDENTIAL,25480,0,25480,99482,0,124962
132517801300000,NW 324,RESIDENTIAL,23338,0,23338,97850,0,121188
132517801400000,NW 324,RESIDENTIAL,23338,0,23338,102436,0,125774
132517801500000,NW 324,RESIDENTIAL,23296,0,23296,93546,0,116842
132517801600000,NW 324,RESIDENTIAL,23296,0,23296,91971,0,115267
132517801700000,NW 324,RESIDENTIAL,25080,0,25080,94045,0,119125
132517801800000,NW 324,RESIDENTIAL,25480,0,25480,107094,0,132574
132517801900000,NW 324,RESIDENTIAL,27784,0,27784,105421,0,133205
132517802000000,NW 324,RESIDENTIAL,30560,0,30560,104291,0,134851
132517802100000,NW 324,RESIDENTIAL,30555,0,30555,101625,0,132180
132517802200000,NW 324,RESIDENTIAL,28208,0,28208,103828,0,132036
132517802300000,NW 324,RESIDENTIAL,25480,0,25480,117365,0,142845
132517802400000,NW 324,RESIDENTIAL,30781,0,30781,111995,0,142776
132517802500000,NW 324,RESIDENTIAL,29028,0,29028,107840,0,136868
132517802600000,NW 324,RESIDENTIAL,27873,0,27873,114667,0,142540
132517802700000,NW 324,RESIDENTIAL,28565,0,28565,93431,0,121996
132517802800000,NW 324,RESIDENTIAL,25216,0,25216,135658,0,160874
132517802900000,NW 324,RESIDENTIAL,22693,0,22693,98323,0,121016
132517803000000,NW 324,RESIDENTIAL,23296,0,23296,92831,0,116127
132517900100000,NW 324,RESIDENTIAL,28436,0,28436,99942,0,128378
132517900200000,NW 324,RESIDENTIAL,23138,0,23138,99081,0,122219
132517900300000,NW 324,RESIDENTIAL,21840,0,21840,95906,0,117746
132517900400000,NW 324,RESIDENTIAL,22444,0,22444,100079,0,122523
132517900500000,NW 324,RESIDENTIAL,23296,0,23296,89616,0,112912
132517900600000,NW 324,RESIDENTIAL,23296,0,23296,100211,0,123507
132517900700000,NW 324,RESIDENTIAL,23296,0,23296,95984,0,119280
132517900800000,NW 324,RESIDENTIAL,23296,0,23296,92417,0,115713
132517900900000,NW 324,RESIDENTIAL,23296,0,23296,88456,0,111752
132517901000000,NW 324,RESIDENTIAL,23296,0,23296,115024,0,138320
132517901100000,NW 324,RESIDENTIAL,23296,0,23296,106035,0,129331
132517901200000,NW 324,RESIDENTIAL,23338,0,23338,101042,0,124380
132517901300000,NW 324,RESIDENTIAL,23508,0,23508,91592,0,115100
132517901400000,NW 324,RESIDENTIAL,25480,0,25480,91335,0,116815
132517901500000,NW 324,RESIDENTIAL,25480,0,25480,104511,0,129991
132517901600000,NW 324,RESIDENTIAL,25480,0,25480,99011,0,124491
132517901700000,NW 324,RESIDENTIAL,25480,0,25480,93303,0,118783
132517901800000,NW 324,RESIDENTIAL,25480,0,25480,108330,0,133810
132517901900000,NW 324,RESIDENTIAL,23296,0,23296,99431,0,122727
132517902000000,NW 324,RESIDENTIAL,23296,0,23296,94858,0,118154
132517902100000,NW 324,RESIDENTIAL,23296,0,23296,100564,0,123860
132517902200000,NW 324,RESIDENTIAL,23296,0,23296,94525,0,117821
132518000100000,NW 324,RESIDENTIAL,24873,0,24873,111536,0,136409
132518000400000,NW 324,RESIDENTIAL,52600,0,52600,0,0,52600
132518000500000,NW 324,RESIDENTIAL,23381,0,23381,97042,0,120423
132518000600000,NW 324,RESIDENTIAL,23296,0,23296,95602,0,118898
132518000700000,NW 324,RESIDENTIAL,23296,0,23296,114374,0,137670
132518000800000,NW 324,RESIDENTIAL,23296,0,23296,140102,0,163398
132518000900000,NW 324,RESIDENTIAL,23296,0,23296,108484,0,131780
132518001000000,NW 324,RESIDENTIAL,23296,0,23296,86633,0,109929
132518001100000,NW 324,RESIDENTIAL,23296,0,23296,76972,0,100268
132518001200000,NW 324,RESIDENTIAL,22204,0,22204,94999,0,117203
132518001300000,NW 324,RESIDENTIAL,23296,0,23296,93081,0,116377
132518001400000,APARTMENT,RESIDENTIAL,78816,0,78816,452305,0,531121
132518100100000,NW 324,RESIDENTIAL,23280,0,23280,86601,0,109881
132518100200000,NW 324,RESIDENTIAL,23296,0,23296,103352,0,126648
132518100300000,NW 324,RESIDENTIAL,23296,0,23296,91711,0,115007
132518100400000,NW 324,RESIDENTIAL,22204,0,22204,92264,0,114468
132518100500000,NW 324,RESIDENTIAL,23296,0,23296,97889,0,121185
132518100600000,NW 324,RESIDENTIAL,23296,0,23296,113259,0,136555
132518100700000,NW 324,RESIDENTIAL,22168,0,22168,94577,0,116745
132518100800000,NW 324,RESIDENTIAL,23296,0,23296,92500,0,115796
132518100900000,NW 324,RESIDENTIAL,22204,0,22204,91206,0,113410
132518101000000,NW 324,RESIDENTIAL,23326,0,23326,85221,0,108547
132518200100000,NW 324,RESIDENTIAL,21810,0,21810,97862,0,119672
132518200200000,NW 324,RESIDENTIAL,21840,0,21840,94270,0,116110
132518200300000,NW 324,RESIDENTIAL,21840,0,21840,134766,0,156606
132518200400000,NW 324,RESIDENTIAL,21840,0,21840,105230,0,127070
132518200500000,NW 324,RESIDENTIAL,21840,0,21840,96708,0,118548
132518200600000,NW 324,RESIDENTIAL,21870,0,21870,94099,0,115969
132518200700000,APARTMENT,RESIDENTIAL,50040,0,50040,300644,0,350684
132520100100000,NW 328,RESIDENTIAL,34330,0,34330,156216,0,190546
132520100200000,NW 328,RESIDENTIAL,34344,0,34344,158036,0,192380
132520100300000,NW 328,RESIDENTIAL,32872,0,32872,165633,0,198505
132520100400000,NW 328,RESIDENTIAL,34361,0,34361,141982,0,176343
132520100500000,NW 328,RESIDENTIAL,34762,0,34762,159598,0,194360
132520100600000,NW 328,RESIDENTIAL,30555,0,30555,166209,0,196764
132520100700000,NW 328,RESIDENTIAL,30555,0,30555,134915,0,165470
132520100800000,NW 328,RESIDENTIAL,30555,0,30555,141441,0,171996
132520100900000,NW 328,RESIDENTIAL,30555,0,30555,156774,0,187329
132520101000000,NW 328,RESIDENTIAL,30555,0,30555,142484,0,173039
132520101100000,NW 328,RESIDENTIAL,30128,0,30128,141674,0,171802
132520101200000,NW 328,RESIDENTIAL,30128,0,30128,145134,0,175262
132520101300000,NW 328,RESIDENTIAL,32103,0,32103,168932,0,201035
132520101400000,NW 328,RESIDENTIAL,30870,0,30870,134532,0,165402
132520101500000,NW 328,RESIDENTIAL,28704,0,28704,133727,0,162431
132520101600000,NW 327,RESIDENTIAL,30233,0,30233,84834,0,115067
132520101700000,NW 327,RESIDENTIAL,29349,0,29349,94453,0,123802
132520101800000,NW 327,RESIDENTIAL,29002,0,29002,108635,0,137637
132520101900000,NW 327,RESIDENTIAL,24000,0,24000,105410,0,129410
132520102000000,NW 327,RESIDENTIAL,24000,0,24000,102417,0,126417
132520102100000,NW 327,RESIDENTIAL,24000,0,24000,97207,0,121207
132520102200000,NW 327,RESIDENTIAL,24000,0,24000,96842,0,120842
132520102300000,NW 327,RESIDENTIAL,24000,0,24000,109443,0,133443
132520102400000,NW 328,RESIDENTIAL,31196,0,31196,156877,0,188073
132520102500000,NW 328,RESIDENTIAL,30870,0,30870,138267,0,169137
132520102600000,NW 328,RESIDENTIAL,30870,0,30870,142592,0,173462
132520102700000,NW 328,RESIDENTIAL,30870,0,30870,136908,0,167778
132520102800000,NW 328,RESIDENTIAL,30555,0,30555,150875,0,181430
132520200100000,NW 328,RESIDENTIAL,42120,0,42120,152263,0,194383
132520200200000,NW 328,RESIDENTIAL,32760,0,32760,142809,0,175569
132520200300000,NW 328,RESIDENTIAL,32760,0,32760,144149,0,176909
132520200400000,NW 328,RESIDENTIAL,32760,0,32760,144953,0,177713
132520200500000,NW 328,RESIDENTIAL,32760,0,32760,146822,0,179582
132520200600000,NW 328,RESIDENTIAL,32760,0,32760,133834,0,166594
132520200700000,NW 328,RESIDENTIAL,32760,0,32760,149397,0,182157
132520200800000,NW 328,RESIDENTIAL,32760,0,32760,139010,0,171770
132520200900000,NW 328,RESIDENTIAL,32760,0,32760,141028,0,173788
132520201000000,NW 328,RESIDENTIAL,32760,0,32760,145997,0,178757
132520201100000,NW 328,RESIDENTIAL,32760,0,32760,152845,0,185605
132520201200000,NW 328,RESIDENTIAL,30420,0,30420,133268,0,163688
132520201300000,NW 328,RESIDENTIAL,32760,0,32760,146450,0,179210
132520201400000,NW 328,RESIDENTIAL,32760,0,32760,145453,0,178213
132520300100000,NW 328,RESIDENTIAL,33392,0,33392,152575,0,185967
132520300200000,NW 328,RESIDENTIAL,30555,0,30555,160785,0,191340
132520300300000,NW 328,RESIDENTIAL,30555,0,30555,167363,0,197918
132520300400000,NW 328,RESIDENTIAL,30555,0,30555,150204,0,180759
132520300500000,NW 328,RESIDENTIAL,30555,0,30555,159558,0,190113
132520300600000,NW 328,RESIDENTIAL,30555,0,30555,166854,0,197409
132520300700000,NW 328,RESIDENTIAL,30555,0,30555,187194,0,217749
132520300800000,NW 328,RESIDENTIAL,30555,0,30555,173706,0,204261
132520300900000,NW 328,RESIDENTIAL,30555,0,30555,154975,0,185530
132520301000000,NW 328,RESIDENTIAL,30555,0,30555,152116,0,182671
132520301100000,NW 328,RESIDENTIAL,31230,0,31230,151467,0,182697
132520301200000,NW 328,RESIDENTIAL,30420,0,30420,156000,0,186420
132520301300000,NW 328,RESIDENTIAL,32445,0,32445,158020,0,190465
132520301400000,NW 328,RESIDENTIAL,31185,0,31185,133553,0,164738
132520301500000,NW 328,RESIDENTIAL,33742,0,33742,148737,0,182479
132520301600000,NW 328,RESIDENTIAL,32760,0,32760,137015,0,169775
132520301700000,NW 328,RESIDENTIAL,34010,0,34010,133038,0,167048
132520301800000,NW 328,RESIDENTIAL,32196,0,32196,154892,0,187088
132520301900000,NW 328,RESIDENTIAL,30302,0,30302,145162,0,175464
132520302000000,NW 328,RESIDENTIAL,32152,0,32152,146946,0,179098
132520302100000,NW 328,RESIDENTIAL,28373,0,28373,156628,0,185001
132520302200000,NW 328,RESIDENTIAL,28373,0,28373,151950,0,180323
132520302300000,NW 328,RESIDENTIAL,28373,0,28373,162260,0,190633
132520302400000,NW 328,RESIDENTIAL,28373,0,28373,151415,0,179788
132520302500000,NW 328,RESIDENTIAL,28373,0,28373,151806,0,180179
132520302600000,NW 328,RESIDENTIAL,28373,0,28373,142799,0,171172
132520302700000,NW 328,RESIDENTIAL,28373,0,28373,166599,0,194972
132520302800000,NW 328,RESIDENTIAL,31428,0,31428,146649,0,178077
132520400100000,NW 328,RESIDENTIAL,31428,0,31428,173062,0,204490
132520400200000,NW 328,RESIDENTIAL,28373,0,28373,133521,0,161894
132520400300000,NW 328,RESIDENTIAL,32468,0,32468,161924,0,194392
132520400400000,NW 328,RESIDENTIAL,32760,0,32760,133731,0,166491
132520400500000,NW 328,RESIDENTIAL,31883,0,31883,143466,0,175349
132520400600000,NW 328,RESIDENTIAL,31005,0,31005,152835,0,183840
132520400700000,NW 328,RESIDENTIAL,30060,0,30060,148356,0,178416
132520400800000,NW 328,RESIDENTIAL,37170,0,37170,141821,0,178991
132520400900000,NW 328,RESIDENTIAL,34081,0,34081,150433,0,184514
132520401000000,NW 328,RESIDENTIAL,31185,0,31185,117714,0,148899
132520401100000,NW 328,RESIDENTIAL,31421,0,31421,133970,0,165391
132520401200000,NW 328,RESIDENTIAL,32384,0,32384,149336,0,181720
132520401300000,NW 328,RESIDENTIAL,33986,0,33986,121178,0,155164
132520401400000,NW 328,RESIDENTIAL,35269,0,35269,154800,0,190069
132520401500000,NW 328,RESIDENTIAL,35910,0,35910,140576,0,176486
132520401600000,CITY PROPERTY,EXEMPT,0,0,0,0,0,0
132520401700000,NW 327,RESIDENTIAL,41274,0,41274,132676,0,173950
132520401800000,NW 327,RESIDENTIAL,40400,0,40400,89370,0,129770
132520401900000,NW 328,RESIDENTIAL,32468,0,32468,142158,0,174626
132520402000000,NW 328,RESIDENTIAL,30128,0,30128,139377,0,169505
132520500100000,NW 328,RESIDENTIAL,37901,0,37901,133611,0,171512
132520500200000,NW 328,RESIDENTIAL,29835,0,29835,126196,0,156031
132520500300000,NW 328,RESIDENTIAL,32175,0,32175,128562,0,160737
132520500400000,NW 328,RESIDENTIAL,33638,0,33638,120567,0,154205
132520500500000,NW 328,RESIDENTIAL,34808,0,34808,115916,0,150724
132520500600000,NW 328,RESIDENTIAL,28373,0,28373,142597,0,170970
132520500700000,NW 328,RESIDENTIAL,28373,0,28373,135209,0,163582
132520500800000,NW 328,RESIDENTIAL,31428,0,31428,126366,0,157794
132520500900000,NW 328,RESIDENTIAL,33631,0,33631,142668,0,176299
132520501000000,NW 328,RESIDENTIAL,34086,0,34086,152611,0,186697
132520501100000,NW 328,RESIDENTIAL,33342,0,33342,158734,0,192076
132520501200000,NW 327,RESIDENTIAL,24800,0,24800,82786,0,107586
132520501300000,NW 327,RESIDENTIAL,24800,0,24800,85608,0,110408
132520501400000,NW 327,RESIDENTIAL,24800,0,24800,148891,0,173691
132520501500000,NW 327,RESIDENTIAL,24800,0,24800,90140,0,114940
132520501600000,NW 327,RESIDENTIAL,24800,0,24800,96075,0,120875
132520501700000,NW 327,RESIDENTIAL,24800,0,24800,95020,0,119820
132520501800000,NW 327,RESIDENTIAL,24800,0,24800,88227,0,113027
132520501900000,NW 327,RESIDENTIAL,24880,0,24880,118596,0,143476
132520502000000,NW 327,RESIDENTIAL,24800,0,24800,97707,0,122507
132520502100000,NW 327,RESIDENTIAL,26107,0,26107,99892,0,125999
132520502200000,NW 327,RESIDENTIAL,34320,0,34320,90948,0,125268
132520600100000,NW 328,RESIDENTIAL,33392,0,33392,169363,0,202755
132520600200000,NW 328,RESIDENTIAL,30555,0,30555,154091,0,184646
132520600300000,NW 328,RESIDENTIAL,35905,0,35905,122214,0,158119
132520700100000,NW 327,RESIDENTIAL,32680,0,32680,103014,0,135694
132520700200000,NW 327,RESIDENTIAL,26730,0,26730,97124,0,123854
132520700300000,NW 327,RESIDENTIAL,26933,0,26933,88852,0,115785
132520700400000,NW 327,RESIDENTIAL,25200,0,25200,94143,0,119343
132520700500000,NW 327,RESIDENTIAL,25200,0,25200,103548,0,128748
132520700600000,NW 327,RESIDENTIAL,25200,0,25200,86848,0,112048
132520700700000,NW 327,RESIDENTIAL,25200,0,25200,94571,0,119771
132520700800000,NW 327,RESIDENTIAL,25200,0,25200,103151,0,128351
132520700900000,NW 327,RESIDENTIAL,25200,0,25200,89039,0,114239
132520701000000,NW 327,RESIDENTIAL,25200,0,25200,90844,0,116044
132520701100000,NW 327,RESIDENTIAL,28000,0,28000,90781,0,118781
132520800100000,NW 327,RESIDENTIAL,24000,0,24000,75470,0,99470
132520800200000,NW 327,RESIDENTIAL,24000,0,24000,82909,0,106909
132520800300000,NW 327,RESIDENTIAL,24000,0,24000,98000,0,122000
132520800400000,NW 327,RESIDENTIAL,24000,0,24000,80235,0,104235
132520800500000,NW 327,RESIDENTIAL,24000,0,24000,83684,0,107684
132520800600000,NW 327,RESIDENTIAL,24240,0,24240,108553,0,132793
132522600100000,NW 328,RESIDENTIAL,32760,0,32760,168957,0,201717
132522600200000,NW 328,RESIDENTIAL,33598,0,33598,160266,0,193864
132522600300000,NW 328,RESIDENTIAL,33075,0,33075,149172,0,182247
132522600400000,NW 328,RESIDENTIAL,33705,0,33705,126517,0,160222
132522600500000,NW 328,RESIDENTIAL,34020,0,34020,114739,0,148759
132522600600000,NW 328,RESIDENTIAL,34992,0,34992,123768,0,158760
132522700100000,NW 328,RESIDENTIAL,36146,0,36146,172696,0,208842
132522700200000,NW 328,RESIDENTIAL,35802,0,35802,143408,0,179210
132522700300000,NW 328,RESIDENTIAL,33696,0,33696,132405,0,166101
132522700400000,NW 328,RESIDENTIAL,34020,0,34020,152816,0,186836
132522800100000,NW 328,RESIDENTIAL,36000,0,36000,131839,0,167839
132522800200000,NW 328,RESIDENTIAL,36000,0,36000,131550,0,167550
132522800300000,NW 328,RESIDENTIAL,31500,0,31500,120690,0,152190
132522800400000,NW 328,RESIDENTIAL,31500,0,31500,131994,0,163494
132522800500000,NW 328,RESIDENTIAL,31500,0,31500,128801,0,160301
132522800600000,NW 328,RESIDENTIAL,31500,0,31500,147849,0,179349
132522800700000,NW 328,RESIDENTIAL,31500,0,31500,136116,0,167616
132522800800000,NW 328,RESIDENTIAL,31500,0,31500,149795,0,181295
132522800900000,NW 328,RESIDENTIAL,31500,0,31500,124591,0,156091
132522801000000,NW 328,RESIDENTIAL,31500,0,31500,132968,0,164468
132522801100000,NW 328,RESIDENTIAL,30817,0,30817,135364,0,166181
132522801200000,NW 328,RESIDENTIAL,30748,0,30748,129027,0,159775
132522801300000,NW 328,RESIDENTIAL,30556,0,30556,120976,0,151532
132522801400000,NW 327,RESIDENTIAL,24800,0,24800,83917,0,108717
132522801500000,NW 327,RESIDENTIAL,24800,0,24800,99105,0,123905
132522801600000,NW 327,RESIDENTIAL,24800,0,24800,81929,0,106729
132522801700000,NW 327,RESIDENTIAL,25600,0,25600,94681,0,120281
132522801800000,NW 327,RESIDENTIAL,26000,0,26000,88639,0,114639
132522801900000,NW 327,RESIDENTIAL,24400,0,24400,84550,0,108950
132522802000000,NW 327,RESIDENTIAL,24800,0,24800,92758,0,117558
132522802100000,NW 327,RESIDENTIAL,24800,0,24800,101252,0,126052
132522802200000,NW 328,RESIDENTIAL,32940,0,32940,140784,0,173724
132522802300000,NW 328,RESIDENTIAL,31161,0,31161,146395,0,177556
132522802400000,NW 328,RESIDENTIAL,32714,0,32714,121094,0,153808
132522802500000,NW 328,RESIDENTIAL,31500,0,31500,137519,0,169019
132522802600000,NW 328,RESIDENTIAL,31500,0,31500,165527,0,197027
132522802700000,NW 328,RESIDENTIAL,31500,0,31500,129855,0,161355
132522802800000,NW 328,RESIDENTIAL,31500,0,31500,126120,0,157620
132522802900000,NW 328,RESIDENTIAL,31500,0,31500,133648,0,165148
132522803000000,NW 328,RESIDENTIAL,31500,0,31500,144728,0,176228
132522803100000,NW 328,RESIDENTIAL,31500,0,31500,127419,0,158919
132522803200000,NW 328,RESIDENTIAL,31500,0,31500,150369,0,181869
132522900100000,NW 328,RESIDENTIAL,36720,0,36720,148157,0,184877
132522900200000,NW 328,RESIDENTIAL,32130,0,32130,124659,0,156789
132522900300000,NW 328,RESIDENTIAL,32130,0,32130,119630,0,151760
132522900400000,NW 328,RESIDENTIAL,32130,0,32130,119183,0,151313
132522900500000,NW 328,RESIDENTIAL,32130,0,32130,120246,0,152376
132522900600000,NW 328,RESIDENTIAL,32130,0,32130,128824,0,160954
132522900700000,NW 328,RESIDENTIAL,32130,0,32130,138388,0,170518
132522900800000,NW 328,RESIDENTIAL,32130,0,32130,142877,0,175007
132522900900000,NW 328,RESIDENTIAL,32130,0,32130,121570,0,153700
132522901000000,NW 328,RESIDENTIAL,32075,0,32075,127928,0,160003
132522901100000,NW 328,RESIDENTIAL,32800,0,32800,135727,0,168527
132522901200000,NW 328,RESIDENTIAL,31310,0,31310,124612,0,155922
132522901300000,NW 327,RESIDENTIAL,26040,0,26040,120097,0,146137
132522901400000,NW 327,RESIDENTIAL,26040,0,26040,96342,0,122382
132522901500000,NW 327,RESIDENTIAL,26040,0,26040,85264,0,111304
132522901600000,NW 327,RESIDENTIAL,26880,0,26880,95096,0,121976
132523000100000,NW 328,RESIDENTIAL,29295,0,29295,126472,0,155767
132523000200000,NW 328,RESIDENTIAL,29683,0,29683,135777,0,165460
132523000300000,NW 328,RESIDENTIAL,39210,0,39210,126174,0,165384
132523000400000,NW 328,RESIDENTIAL,31806,0,31806,123038,0,154844
132523000500000,NW 328,RESIDENTIAL,31101,0,31101,130271,0,161372
132523000600000,NW 328,RESIDENTIAL,31246,0,31246,123746,0,154992
132523003000000,NW 328,RESIDENTIAL,30555,0,30555,144714,0,175269
132523100100000,NW 328,RESIDENTIAL,34140,0,34140,121562,0,155702
132523100200000,NW 328,RESIDENTIAL,36225,0,36225,121877,0,158102
132523100300000,NW 328,RESIDENTIAL,36225,0,36225,143710,0,179935
132523100400000,NW 328,RESIDENTIAL,33696,0,33696,130927,0,164623
132523100500000,NW 328,RESIDENTIAL,32760,0,32760,127389,0,160149
132523100600000,NW 328,RESIDENTIAL,32760,0,32760,124378,0,157138
132523100700000,NW 328,RESIDENTIAL,32760,0,32760,176376,0,209136
132523100800000,NW 328,RESIDENTIAL,32760,0,32760,133223,0,165983
132523100900000,NW 328,RESIDENTIAL,32760,0,32760,120020,0,152780
132523101000000,NW 328,RESIDENTIAL,32493,0,32493,136524,0,169017
132523101100000,NW 328,RESIDENTIAL,31076,0,31076,160322,0,191398
132523101200000,NW 328,RESIDENTIAL,30911,0,30911,124172,0,155083
132523101300000,NW 327,RESIDENTIAL,24800,0,24800,102221,0,127021
132523101400000,NW 327,RESIDENTIAL,24800,0,24800,90173,0,114973
132523101500000,NW 327,RESIDENTIAL,24000,0,24000,85870,0,109870
132523101600000,NW 327,RESIDENTIAL,26400,0,26400,87228,0,113628
132523101700000,NW 327,RESIDENTIAL,26400,0,26400,86466,0,112866
132523101800000,NW 328,RESIDENTIAL,30213,0,30213,151112,0,181325
132523101900000,NW 328,RESIDENTIAL,29046,0,29046,128552,0,157598
132523102000000,NW 328,RESIDENTIAL,29973,0,29973,129001,0,158974
132523102100000,NW 328,RESIDENTIAL,28373,0,28373,157317,0,185690
132523102200000,NW 328,RESIDENTIAL,28373,0,28373,152108,0,180481
132523102300000,NW 328,RESIDENTIAL,28665,0,28665,167873,0,196538
132523102400000,NW 328,RESIDENTIAL,35602,0,35602,180964,0,216566
132523102500000,NW 328,RESIDENTIAL,36450,0,36450,168350,0,204800
132523102600000,NW 328,RESIDENTIAL,33323,0,33323,150893,0,184216
132523102700000,NW 328,RESIDENTIAL,35162,0,35162,147933,0,183095
132523102800000,NW 328,RESIDENTIAL,35241,0,35241,157702,0,192943
132523102900000,NW 328,RESIDENTIAL,33668,0,33668,138239,0,171907
132523103100000,NW 328,RESIDENTIAL,30555,0,30555,119330,0,149885
132523103200000,NW 328,RESIDENTIAL,30555,0,30555,140833,0,171388
132523103300000,NW 328,RESIDENTIAL,35280,0,35280,162602,0,197882
132523103400000,NW 328,RESIDENTIAL,34965,0,34965,169230,0,204195
132523103500000,NW 328,RESIDENTIAL,35491,0,35491,170437,0,205928
132523103600000,NW 328,RESIDENTIAL,31815,0,31815,157142,0,188957
132523103700000,NW 328,RESIDENTIAL,34403,0,34403,119804,0,154207
132523103800000,NW 328,RESIDENTIAL,35590,0,35590,135934,0,171524
132523103900000,NW 328,RESIDENTIAL,33372,0,33372,131213,0,164585
132523104000000,NW 328,RESIDENTIAL,30364,0,30364,147772,0,178136
132523104100000,NW 328,RESIDENTIAL,31850,0,31850,139360,0,171210
132523104200000,NW 328,RESIDENTIAL,34188,0,34188,129847,0,164035
132523200100000,NW 328,RESIDENTIAL,32347,0,32347,145480,0,177827
132523200200000,NW 328,RESIDENTIAL,30730,0,30730,136006,0,166736
132523200300000,NW 328,RESIDENTIAL,28373,0,28373,166651,0,195024
132523200400000,NW 328,RESIDENTIAL,28373,0,28373,149439,0,177812
132523200500000,NW 328,RESIDENTIAL,28373,0,28373,128428,0,156801
132523200600000,NW 328,RESIDENTIAL,28373,0,28373,129496,0,157869
132523200700000,NW 328,RESIDENTIAL,28373,0,28373,126677,0,155050
132523200800000,NW 328,RESIDENTIAL,29340,0,29340,149374,0,178714
132523200900000,NW 328,RESIDENTIAL,34087,0,34087,144946,0,179033
132523201000000,NW 327,RESIDENTIAL,25600,0,25600,83469,0,109069
132523201100000,NW 327,RESIDENTIAL,24800,0,24800,89546,0,114346
132523201200000,NW 327,RESIDENTIAL,24800,0,24800,85363,0,110163
132523201300000,NW 327,RESIDENTIAL,24800,0,24800,86784,0,111584
132523201400000,NW 327,RESIDENTIAL,24800,0,24800,86167,0,110967
132523201500000,NW 327,RESIDENTIAL,24800,0,24800,91043,0,115843
132523201600000,NW 327,RESIDENTIAL,24800,0,24800,81657,0,106457
132523201700000,NW 327,RESIDENTIAL,24800,0,24800,82063,0,106863
132523201800000,NW 327,RESIDENTIAL,24800,0,24800,82316,0,107116
132523201900000,NW 327,RESIDENTIAL,24800,0,24800,99642,0,124442
132523300100000,NW 327,RESIDENTIAL,25960,0,25960,108596,0,134556
132523300200000,NW 327,RESIDENTIAL,25960,0,25960,86971,0,112931
132523300300000,NW 327,RESIDENTIAL,25960,0,25960,96640,0,122600
132523300400000,NW 327,RESIDENTIAL,25960,0,25960,84463,0,110423
132523300500000,NW 327,RESIDENTIAL,24800,0,24800,91843,0,116643
132523300600000,NW 327,RESIDENTIAL,24800,0,24800,83118,0,107918
132523300700000,NW 327,RESIDENTIAL,24800,0,24800,88659,0,113459
132523300800000,NW 327,RESIDENTIAL,24800,0,24800,80649,0,105449
132523300900000,NW 327,RESIDENTIAL,24800,0,24800,104626,0,129426
132523301000000,NW 327,RESIDENTIAL,24800,0,24800,87025,0,111825
132523301100000,NW 327,RESIDENTIAL,24800,0,24800,82962,0,107762
132523301200000,NW 327,RESIDENTIAL,24800,0,24800,92306,0,117106
132523301300000,NW 327,RESIDENTIAL,24800,0,24800,91307,0,116107
132523301400000,NW 327,RESIDENTIAL,26600,0,26600,102667,0,129267
132523400100000,NW 327,RESIDENTIAL,24000,0,24000,89032,0,113032
132523400200000,NW 327,RESIDENTIAL,24000,0,24000,83731,0,107731
132523400300000,NW 327,RESIDENTIAL,24000,0,24000,85437,0,109437
132523400400000,NW 327,RESIDENTIAL,24000,0,24000,102138,0,126138
132523400500000,NW 327,RESIDENTIAL,24000,0,24000,93756,0,117756
132523400600000,NW 327,RESIDENTIAL,29310,0,29310,80862,0,110172
132525100100000,NW 329,RESIDENTIAL,18330,0,18330,74105,0,92435
132525100200000,NW 329,RESIDENTIAL,18967,0,18967,84245,0,103212
132525100300000,NW 329,RESIDENTIAL,20163,0,20163,70899,0,91062
132525100400000,NW 329,RESIDENTIAL,18941,0,18941,75967,0,94908
132525100500000,NW 329,RESIDENTIAL,18330,0,18330,73456,0,91786
132525100600000,NW 329,RESIDENTIAL,18941,0,18941,88325,0,107266
132525100700000,NW 329,RESIDENTIAL,20163,0,20163,85766,0,105929
132525100800000,NW 329,RESIDENTIAL,18941,0,18941,81945,0,100886
132525100900000,NW 329,RESIDENTIAL,18330,0,18330,85096,0,103426
132525101000000,NW 329,RESIDENTIAL,17800,0,17800,76126,0,93926
132525101100000,NW 329,RESIDENTIAL,22522,0,22522,81190,0,103712
132525101200000,NW 329,RESIDENTIAL,23119,0,23119,104681,0,127800
132525101300000,NW 329,RESIDENTIAL,19450,0,19450,87283,0,106733
132525101400000,NW 329,RESIDENTIAL,19005,0,19005,71976,0,90981
132525101500000,NW 329,RESIDENTIAL,19817,0,19817,80948,0,100765
132525101600000,NW 329,RESIDENTIAL,18941,0,18941,67667,0,86608
132525101700000,NW 329,RESIDENTIAL,19814,0,19814,106825,0,126639
132525101800000,NW 329,RESIDENTIAL,19450,0,19450,74327,0,93777
132525101900000,NW 329,RESIDENTIAL,25856,0,25856,88847,0,114703
132525102000000,NW 329,RESIDENTIAL,23312,0,23312,81243,0,104555
132525102100000,NW 329,RESIDENTIAL,24800,0,24800,74566,0,99366
132525102200000,NW 329,RESIDENTIAL,23061,0,23061,81601,0,104662
132525102300000,NW 329,RESIDENTIAL,23061,0,23061,90225,0,113286
132525102400000,NW 329,RESIDENTIAL,22936,0,22936,88669,0,111605
132525102500000,NW 329,RESIDENTIAL,22936,0,22936,89002,0,111938
132525102600000,NW 329,RESIDENTIAL,22811,0,22811,87321,0,110132
132525102700000,NW 329,RESIDENTIAL,22685,0,22685,80592,0,103277
132525102800000,NW 329,RESIDENTIAL,21763,0,21763,85065,0,106828
132525200100000,NW 329,RESIDENTIAL,24350,0,24350,84711,0,109061
132525200200000,NW 329,RESIDENTIAL,26888,0,26888,89168,0,116056
132525200300000,NW 329,RESIDENTIAL,24218,0,24218,83507,0,107725
132525200400000,NW 329,RESIDENTIAL,24970,0,24970,73841,0,98811
132525200500000,NW 329,RESIDENTIAL,25393,0,25393,100710,0,126103
132525200600000,NW 329,RESIDENTIAL,24750,0,24750,88659,0,113409
132525200700000,NW 329,RESIDENTIAL,22560,0,22560,98699,0,121259
132525200800000,NW 329,RESIDENTIAL,23312,0,23312,75567,0,98879
132525200900000,NW 329,RESIDENTIAL,28723,0,28723,87811,0,116534
132525201000000,NW 329,RESIDENTIAL,28028,0,28028,80753,0,108781
132525201100000,NW 329,RESIDENTIAL,29040,0,29040,95758,0,124798
132525201200000,NW 329,RESIDENTIAL,28512,0,28512,82109,0,110621
132525201300000,NW 329,RESIDENTIAL,29132,0,29132,72956,0,102088
132525300100000,NW 329,RESIDENTIAL,19456,0,19456,78552,0,98008
132525300200000,NW 329,RESIDENTIAL,18941,0,18941,87895,0,106836
132525300300000,NW 329,RESIDENTIAL,20163,0,20163,88906,0,109069
132525300400000,NW 329,RESIDENTIAL,18941,0,18941,83548,0,102489
132525300500000,NW 329,RESIDENTIAL,18941,0,18941,79998,0,98939
132525300600000,NW 329,RESIDENTIAL,20163,0,20163,81637,0,101800
132525300700000,NW 329,RESIDENTIAL,18941,0,18941,75313,0,94254
132525300800000,NW 329,RESIDENTIAL,20163,0,20163,95728,0,115891
132525300900000,NW 329,RESIDENTIAL,18941,0,18941,74462,0,93403
132525301000000,NW 329,RESIDENTIAL,20163,0,20163,88782,0,108945
132525301100000,NW 329,RESIDENTIAL,18941,0,18941,76160,0,95101
132525301200000,NW 329,RESIDENTIAL,18941,0,18941,87116,0,106057
132525301300000,NW 329,RESIDENTIAL,20634,0,20634,87539,0,108173
132525301400000,NW 329,RESIDENTIAL,19717,0,19717,79530,0,99247
132525301500000,CITY PROPERTY,EXEMPT,0,0,0,0,0,0
132525301600000,CITY PROPERTY,EXEMPT,0,0,0,0,0,0
132525400100000,NW 329,RESIDENTIAL,19456,0,19456,66860,0,86316
132525400200000,NW 329,RESIDENTIAL,19456,0,19456,76476,0,95932
132525400300000,NW 329,RESIDENTIAL,20163,0,20163,86774,0,106937
132525400400000,NW 329,RESIDENTIAL,18941,0,18941,74448,0,93389
132525400500000,NW 329,RESIDENTIAL,18330,0,18330,75645,0,93975
132525400600000,NW 329,RESIDENTIAL,18941,0,18941,81292,0,100233
132525400700000,NW 329,RESIDENTIAL,20163,0,20163,87834,0,107997
132525400800000,NW 329,RESIDENTIAL,18941,0,18941,91700,0,110641
132525400900000,NW 329,RESIDENTIAL,18941,0,18941,78509,0,97450
132525401000000,NW 329,RESIDENTIAL,20163,0,20163,67589,0,87752
132525401100000,NW 329,RESIDENTIAL,18941,0,18941,74251,0,93192
132525401200000,NW 329,RESIDENTIAL,18330,0,18330,89509,0,107839
132525401300000,NW 329,RESIDENTIAL,20163,0,20163,91628,0,111791
132525401400000,NW 329,RESIDENTIAL,20742,0,20742,93678,0,114420
132525401500000,NW 329,RESIDENTIAL,20320,0,20320,82505,0,102825
132525401600000,NW 329,RESIDENTIAL,18941,0,18941,78702,0,97643
132525401700000,NW 329,RESIDENTIAL,18330,0,18330,79900,0,98230
132525401800000,NW 329,RESIDENTIAL,18941,0,18941,82558,0,101499
132525401900000,NW 329,RESIDENTIAL,20163,0,20163,90323,0,110486
132525402000000,NW 329,RESIDENTIAL,18941,0,18941,86029,0,104970
132525402100000,NW 329,RESIDENTIAL,18941,0,18941,84853,0,103794
132525402200000,NW 329,RESIDENTIAL,20163,0,20163,95763,0,115926
132525402300000,NW 329,RESIDENTIAL,18941,0,18941,92086,0,111027
132525402400000,NW 329,RESIDENTIAL,18330,0,18330,75326,0,93656
132525402500000,NW 329,RESIDENTIAL,18941,0,18941,79185,0,98126
132525402600000,NW 329,RESIDENTIAL,20163,0,20163,87064,0,107227
132525500100000,NW 329,RESIDENTIAL,18325,0,18325,77120,0,95445
132525500200000,NW 329,RESIDENTIAL,21667,0,21667,87912,0,109579
132525500300000,NW 329,RESIDENTIAL,21857,0,21857,75658,0,97515
132525500400000,NW 329,RESIDENTIAL,20428,0,20428,75168,0,95596
132525500500000,NW 329,RESIDENTIAL,20332,0,20332,80958,0,101290
132525500600000,NW 329,RESIDENTIAL,19285,0,19285,94128,0,113413
132525500700000,NW 329,RESIDENTIAL,20569,0,20569,69808,0,90377
132525500800000,NW 329,RESIDENTIAL,18720,0,18720,90523,0,109243
132525500900000,NW 329,RESIDENTIAL,20074,0,20074,79225,0,99299
132525501000000,NW 329,RESIDENTIAL,19597,0,19597,84168,0,103765
132525501100000,NW 329,RESIDENTIAL,25693,0,25693,75658,0,101351
132525501200000,NW 329,RESIDENTIAL,23312,0,23312,73753,0,97065
132525501300000,NW 329,RESIDENTIAL,24656,0,24656,73747,0,98403
132525501400000,NW 329,RESIDENTIAL,20803,0,20803,105766,0,126569
132525501500000,NW 329,RESIDENTIAL,21666,0,21666,81080,0,102746
132525501600000,NW 329,RESIDENTIAL,20850,0,20850,87047,0,107897
132525501700000,NW 329,RESIDENTIAL,21270,0,21270,87127,0,108397
132525501800000,NW 329,RESIDENTIAL,22080,0,22080,66413,0,88493
132525501900000,NW 329,RESIDENTIAL,22560,0,22560,81190,0,103750
132525502000000,NW 329,RESIDENTIAL,22560,0,22560,72536,0,95096
132525502100000,NW 329,RESIDENTIAL,23714,0,23714,73102,0,96816
132525502200000,NW 329,RESIDENTIAL,23827,0,23827,76304,0,100131
132525502300000,NW 329,RESIDENTIAL,21957,0,21957,74298,0,96255
132525502400000,NW 329,RESIDENTIAL,18941,0,18941,91875,0,110816
132525502500000,NW 329,RESIDENTIAL,18330,0,18330,71886,0,90216
132525502600000,NW 329,RESIDENTIAL,18941,0,18941,88711,0,107652
132525502700000,NW 329,RESIDENTIAL,20163,0,20163,88637,0,108800
132525502800000,NW 329,RESIDENTIAL,18941,0,18941,77830,0,96771
132525502900000,NW 329,RESIDENTIAL,18330,0,18330,72549,0,90879
132525503000000,NW 329,RESIDENTIAL,18941,0,18941,86191,0,105132
132525503100000,NW 329,RESIDENTIAL,20163,0,20163,87015,0,107178
132525503200000,NW 329,RESIDENTIAL,18941,0,18941,78025,0,96966
132525503300000,NW 329,RESIDENTIAL,18941,0,18941,81376,0,100317
132525503400000,NW 329,RESIDENTIAL,18941,0,18941,92273,0,111214
132525600100000,NW 329,RESIDENTIAL,28272,0,28272,93821,0,122093
132525600200000,NW 329,RESIDENTIAL,29703,0,29703,88224,0,117927
132525600300000,NW 329,RESIDENTIAL,25317,0,25317,84637,0,109954
132525600400000,NW 329,RESIDENTIAL,25587,0,25587,84485,0,110072
132525600500000,NW 329,RESIDENTIAL,25856,0,25856,83216,0,109072
132525600600000,NW 329,RESIDENTIAL,23940,0,23940,73602,0,97542
132525600700000,NW 329,RESIDENTIAL,25587,0,25587,83638,0,109225
132525600800000,NW 329,RESIDENTIAL,23940,0,23940,79821,0,103761
132525600900000,NW 329,RESIDENTIAL,25177,0,25177,93714,0,118891
132525601000000,NW 329,RESIDENTIAL,27072,0,27072,91096,0,118168
132525601100000,NW 329,RESIDENTIAL,26319,0,26319,98938,0,125257
132525601200000,NW 329,RESIDENTIAL,24941,0,24941,81479,0,106420
132525601300000,NW 329,RESIDENTIAL,27867,0,27867,86799,0,114666
132525601400000,NW 329,RESIDENTIAL,24498,0,24498,74737,0,99235
132525601500000,NW 329,RESIDENTIAL,23808,0,23808,82574,0,106382
132525601600000,NW 329,RESIDENTIAL,25958,0,25958,87154,0,113112
132525601700000,NW 329,RESIDENTIAL,23243,0,23243,93416,0,116659
132525601800000,NW 329,EXEMPT,0,23813,23813,0,115192,139005
132525601900000,NW 329,RESIDENTIAL,25587,0,25587,89088,0,114675
132525602000000,NW 329,RESIDENTIAL,22819,0,22819,87026,0,109845
132525602100000,NW 329,RESIDENTIAL,23851,0,23851,80241,0,104092
132525602200000,NW 329,RESIDENTIAL,25599,0,25599,90192,0,115791
132525602300000,NW 329,RESIDENTIAL,24105,0,24105,80802,0,104907
132525602400000,NW 329,RESIDENTIAL,24901,0,24901,82582,0,107483
132525700100000,NW 329,RESIDENTIAL,29421,0,29421,97035,0,126456
132525700200000,NW 329,RESIDENTIAL,32629,0,32629,106122,0,138751
132525700300000,NW 329,RESIDENTIAL,24008,0,24008,94723,0,118731
132525700400000,NW 329,RESIDENTIAL,24816,0,24816,97797,0,122613
132525700500000,NW 329,RESIDENTIAL,24064,0,24064,84442,0,108506
132525700600000,NW 329,RESIDENTIAL,23912,0,23912,84944,0,108856
132525700700000,NW 329,RESIDENTIAL,24548,0,24548,107782,0,132330
132525700800000,NW 329,RESIDENTIAL,26195,0,26195,77522,0,103717
132525700900000,NW 329,RESIDENTIAL,22560,0,22560,91691,0,114251
132525701000000,NW 329,RESIDENTIAL,23688,0,23688,108469,0,132157
132525701100000,NW 329,RESIDENTIAL,23312,0,23312,73361,0,96673
132525701200000,NW 329,RESIDENTIAL,22936,0,22936,76585,0,99521
132525701300000,NW 329,RESIDENTIAL,24067,0,24067,82487,0,106554
132525701400000,NW 329,RESIDENTIAL,23238,0,23238,89239,0,112477
132525701500000,NW 329,RESIDENTIAL,23823,0,23823,82154,0,105977
132525701600000,NW 329,RESIDENTIAL,23061,0,23061,102245,0,125306
132525800100000,CITY PROPERTY,EXEMPT,0,0,0,0,0,0
132525900100000,NW 329,RESIDENTIAL,29585,0,29585,89825,0,119410
132527600100000,NW 327,RESIDENTIAL,28850,0,28850,94967,0,123817
132527600200000,NW 327,RESIDENTIAL,26368,0,26368,96495,0,122863
132527600300000,NW 327,RESIDENTIAL,26368,0,26368,102925,0,129293
132527600400000,NW 327,RESIDENTIAL,26698,0,26698,100805,0,127503
132527600500000,NW 327,RESIDENTIAL,26698,0,26698,102092,0,128790
132527600600000,NW 327,RESIDENTIAL,26698,0,26698,95065,0,121763
132527600700000,NW 327,RESIDENTIAL,26698,0,26698,93155,0,119853
132527600800000,NW 327,RESIDENTIAL,26698,0,26698,94418,0,121116
132527600900000,NW 327,RESIDENTIAL,26438,0,26438,106699,0,133137
132527601000000,CITY PROPERTY,EXEMPT,0,0,0,0,0,0
132527601100000,APARTMENT,COMMERCIAL,0,25380,25380,0,142396,167776
132527700100000,NW 327,RESIDENTIAL,27650,0,27650,85204,0,112854
132527700200000,NW 327,RESIDENTIAL,22633,0,22633,91329,0,113962
132527700300000,NW 327,RESIDENTIAL,24500,0,24500,102857,0,127357
132527700400000,NW 327,RESIDENTIAL,23800,0,23800,106244,0,130044
132527700500000,NW 327,RESIDENTIAL,24500,0,24500,103753,0,128253
132527700600000,NW 327,RESIDENTIAL,24500,0,24500,106682,0,131182
132527700700000,NW 327,RESIDENTIAL,24500,0,24500,107046,0,131546
132527700800000,NW 327,RESIDENTIAL,24500,0,24500,97755,0,122255
132527700900000,NW 327,RESIDENTIAL,24500,0,24500,97652,0,122152
132527701000000,NW 327,RESIDENTIAL,24500,0,24500,83380,0,107880
132527800100000,NW 327,RESIDENTIAL,21000,0,21000,104658,0,125658
132527800200000,NW 327,RESIDENTIAL,21000,0,21000,94010,0,115010
132527800300000,NW 327,RESIDENTIAL,21000,0,21000,110207,0,131207
132527800400000,NW 327,RESIDENTIAL,21000,0,21000,88547,0,109547
132527800500000,NW 327,RESIDENTIAL,21000,0,21000,82750,0,103750
132527800600000,NW 327,RESIDENTIAL,21000,0,21000,70353,0,91353
132527900100000,NW 327,RESIDENTIAL,28000,0,28000,106007,0,134007
132527900200000,NW 327,RESIDENTIAL,24500,0,24500,92113,0,116613
132527900300000,NW 327,RESIDENTIAL,22643,0,22643,117112,0,139755
132527900400000,NW 327,RESIDENTIAL,22400,0,22400,93686,0,116086
132527900500000,NW 327,RESIDENTIAL,21700,0,21700,104975,0,126675
132527900600000,NW 327,RESIDENTIAL,22400,0,22400,93319,0,115719
132527900700000,NW 327,RESIDENTIAL,21700,0,21700,110682,0,132382
132527900800000,NW 327,RESIDENTIAL,22400,0,22400,109632,0,132032
132527900900000,NW 327,RESIDENTIAL,24238,0,24238,106524,0,130762
132527901000000,NW 327,RESIDENTIAL,27940,0,27940,98098,0,126038
132527901100000,NW 327,RESIDENTIAL,25600,0,25600,91320,0,116920
132527901200000,NW 327,RESIDENTIAL,24800,0,24800,93949,0,118749
132527901300000,NW 327,RESIDENTIAL,25600,0,25600,96621,0,122221
132527901400000,NW 327,RESIDENTIAL,24800,0,24800,100227,0,125027
132527901500000,NW 327,RESIDENTIAL,25600,0,25600,116852,0,142452
132527901600000,NW 327,RESIDENTIAL,25544,0,25544,81408,0,106952
132528000100000,NW 327,RESIDENTIAL,24500,0,24500,90921,0,115421
132528000200000,NW 327,RESIDENTIAL,24500,0,24500,107359,0,131859
132528000300000,NW 327,RESIDENTIAL,21946,0,21946,114543,0,136489
132528000400000,NW 327,RESIDENTIAL,22400,0,22400,102615,0,125015
132528000500000,NW 327,RESIDENTIAL,22400,0,22400,98855,0,121255
132528000600000,NW 327,RESIDENTIAL,22400,0,22400,92066,0,114466
132528000700000,NW 327,RESIDENTIAL,22400,0,22400,106909,0,129309
132528000800000,NW 327,RESIDENTIAL,22400,0,22400,106405,0,128805
132528000900000,NW 327,RESIDENTIAL,22400,0,22400,91307,0,113707
132528001000000,NW 327,RESIDENTIAL,22295,0,22295,98727,0,121022
132528001100000,NW 327,RESIDENTIAL,22505,0,22505,115130,0,137635
132528001200000,NW 327,RESIDENTIAL,22400,0,22400,106670,0,129070
132528001300000,NW 327,RESIDENTIAL,22400,0,22400,104613,0,127013
132528001400000,NW 327,RESIDENTIAL,22400,0,22400,104190,0,126590
132528001500000,NW 327,RESIDENTIAL,22400,0,22400,103111,0,125511
132528001600000,NW 327,RESIDENTIAL,22400,0,22400,96145,0,118545
132528001700000,NW 327,RESIDENTIAL,22400,0,22400,95085,0,117485
132528001800000,NW 327,RESIDENTIAL,21657,0,21657,112131,0,133788
132528100100000,NW 327,RESIDENTIAL,24500,0,24500,98665,0,123165
132528100200000,NW 327,RESIDENTIAL,24500,0,24500,109854,0,134354
132528100300000,NW 327,RESIDENTIAL,22049,0,22049,101933,0,123982
132528100400000,NW 327,RESIDENTIAL,22400,0,22400,105173,0,127573
132528100500000,NW 327,RESIDENTIAL,22400,0,22400,0,0,22400
132528100600000,NW 327,RESIDENTIAL,22400,0,22400,108592,0,130992
132528100700000,NW 327,RESIDENTIAL,22400,0,22400,91480,0,113880
132528100800000,NW 327,RESIDENTIAL,22400,0,22400,106553,0,128953
132528100900000,NW 327,RESIDENTIAL,24395,0,24395,93290,0,117685
132528101000000,NW 327,RESIDENTIAL,24605,0,24605,110856,0,135461
132528101100000,NW 327,RESIDENTIAL,22400,0,22400,84276,0,106676
132528101200000,NW 327,RESIDENTIAL,22400,0,22400,109230,0,131630
132528101300000,NW 327,RESIDENTIAL,21700,0,21700,95504,0,117204
132528101400000,NW 327,RESIDENTIAL,22400,0,22400,117674,0,140074
132528101500000,NW 327,RESIDENTIAL,22400,0,22400,94529,0,116929
132528101600000,NW 327,RESIDENTIAL,21818,0,21818,90061,0,111879
132528200100000,NW 327,RESIDENTIAL,24500,0,24500,79467,0,103967
132528200200000,NW 327,RESIDENTIAL,24500,0,24500,93634,0,118134
132528200300000,NW 327,RESIDENTIAL,22327,0,22327,94204,0,116531
132528200400000,NW 327,RESIDENTIAL,22400,0,22400,98099,0,120499
132528200500000,NW 327,RESIDENTIAL,22400,0,22400,116612,0,139012
132528200600000,NW 327,RESIDENTIAL,22400,0,22400,96553,0,118953
132528200700000,NW 327,RESIDENTIAL,22400,0,22400,109981,0,132381
132528200800000,NW 327,RESIDENTIAL,22575,0,22575,110527,0,133102
132528200900000,NW 327,RESIDENTIAL,22575,0,22575,84854,0,107429
132528201000000,NW 327,RESIDENTIAL,22575,0,22575,94399,0,116974
132528201100000,NW 327,RESIDENTIAL,22575,0,22575,86514,0,109089
132528201200000,NW 327,RESIDENTIAL,22610,0,22610,86631,0,109241
132528201300000,NW 327,RESIDENTIAL,24633,0,24633,90702,0,115335
132528201400000,NW 327,RESIDENTIAL,22351,0,22351,91058,0,113409
132528201500000,NW 327,RESIDENTIAL,24633,0,24633,108387,0,133020
132528201600000,NW 327,RESIDENTIAL,22820,0,22820,102985,0,125805
132528201700000,NW 327,RESIDENTIAL,22575,0,22575,100537,0,123112
132528201800000,NW 327,RESIDENTIAL,22575,0,22575,86340,0,108915
132528201900000,NW 327,RESIDENTIAL,22575,0,22575,85736,0,108311
132528202000000,NW 327,RESIDENTIAL,22575,0,22575,92155,0,114730
132528202100000,NW 327,RESIDENTIAL,22400,0,22400,109427,0,131827
132528202200000,NW 327,RESIDENTIAL,22400,0,22400,90844,0,113244
132528202300000,NW 327,RESIDENTIAL,22400,0,22400,98615,0,121015
132528202400000,NW 327,RESIDENTIAL,22400,0,22400,94481,0,116881
132528202500000,NW 327,RESIDENTIAL,22033,0,22033,89432,0,111465
132528300100000,NW 327,RESIDENTIAL,24500,0,24500,102371,0,126871
132528300200000,NW 327,RESIDENTIAL,22474,0,22474,92609,0,115083
132528300300000,NW 327,RESIDENTIAL,21700,0,21700,112833,0,134533
132528300400000,NW 327,RESIDENTIAL,22400,0,22400,104062,0,126462
132528300500000,NW 327,RESIDENTIAL,22400,0,22400,99183,0,121583
132528300600000,NW 327,RESIDENTIAL,22400,0,22400,88265,0,110665
132528300700000,NW 327,RESIDENTIAL,22400,0,22400,111490,0,133890
132528300800000,NW 327,RESIDENTIAL,22400,0,22400,92623,0,115023
132528300900000,NW 327,RESIDENTIAL,22400,0,22400,84772,0,107172
132528301000000,NW 327,RESIDENTIAL,22400,0,22400,87525,0,109925
132528301100000,NW 327,RESIDENTIAL,22400,0,22400,96771,0,119171
132528301200000,NW 327,RESIDENTIAL,22400,0,22400,79155,0,101555
132528301300000,NW 327,RESIDENTIAL,24979,0,24979,72497,0,97476
132528400100000,CITY PROPERTY,EXEMPT,0,0,0,0,0,0
132528400200000,CITY PROPERTY,EXEMPT,0,0,0,0,0,0
132528400300000,CHURCH,EXEMPT,0,437184,437184,0,661057,1098241
132528500100000,CITY PROPERTY,EXEMPT,0,0,0,0,0,0
132528600100000,NW 327,RESIDENTIAL,22015,0,22015,114199,0,136214
132528600200000,NW 327,RESIDENTIAL,24448,0,24448,101737,0,126185
132528600300000,NW 327,RESIDENTIAL,21700,0,21700,93021,0,114721
132528600400000,NW 327,RESIDENTIAL,21700,0,21700,90074,0,111774
132528600500000,NW 327,RESIDENTIAL,25514,0,25514,93278,0,118792
132528600600000,CITY PROPERTY,EXEMPT,0,0,0,0,0,0
132528700100000,CITY PROPERTY,EXEMPT,0,0,0,0,0,0
132528700200000,CITY PROPERTY,EXEMPT,0,0,0,0,0,0
132530100100000,CHURCH,EXEMPT,0,29268,29268,0,117322,146590
132530100200000,NW 329,RESIDENTIAL,57850,0,57850,118792,0,176642
132530100300000,NW 329,RESIDENTIAL,52350,0,52350,105478,0,157828
132530100400000,NW 329,RESIDENTIAL,58550,0,58550,0,0,58550
132530100500000,APARTMENT,COMMERCIAL,0,33600,33600,0,381793,415393
132530100600000,NW 329,RESIDENTIAL,33900,0,33900,213708,0,247608
132530200100000,NW 329,AG DWELLING,15341,0,15341,138727,23967,178035
132530200200000,NW 344,RESIDENTIAL,49811,0,49811,165492,0,215303
132530200300000,NW 344,RESIDENTIAL,46600,0,46600,243445,0,290045
132530200400000,NW 344,RESIDENTIAL,46354,0,46354,208948,0,255302
132530200500000,NW 344,RESIDENTIAL,48151,0,48151,207397,0,255548
132530200600000,NW 344,RESIDENTIAL,46713,0,46713,252944,0,299657
132530200700000,NW 344,RESIDENTIAL,46084,0,46084,267233,0,313317
132530200800000,NW 344,RESIDENTIAL,45815,0,45815,230931,0,276746
132530200900000,NW 344,RESIDENTIAL,45815,0,45815,207054,0,252869
132530201000000,NW 344,RESIDENTIAL,46609,0,46609,201618,0,248227
132530201100000,NW 344,RESIDENTIAL,47025,0,47025,233440,0,280465
132530201200000,NW 344,RESIDENTIAL,50860,0,50860,206874,0,257734
132530300100000,NW 344,RESIDENTIAL,48706,0,48706,260907,0,309613
132530300200000,CITY PROPERTY,EXEMPT,0,0,0,0,0,0
132530300300000,NW 344,RESIDENTIAL,51300,0,51300,82682,0,133982
132530300500000,NW 344,RESIDENTIAL,44280,0,44280,223980,0,268260
132530300600000,NW 344,RESIDENTIAL,46632,0,46632,215064,0,261696
132530300700000,NW 344,RESIDENTIAL,45815,0,45815,235747,0,281562
132530300800000,NW 344,RESIDENTIAL,45815,0,45815,231186,0,277001
132530300900000,NW 344,RESIDENTIAL,47669,0,47669,214640,0,262309
132530400100000,NW 344,RESIDENTIAL,50090,0,50090,230263,0,280353
132530400200000,NW 344,RESIDENTIAL,45012,0,45012,206851,0,251863
132530400300000,NW 344,RESIDENTIAL,46329,0,46329,199419,0,245748
132530400400000,NW 344,RESIDENTIAL,44000,0,44000,213258,0,257258
132530400500000,NW 344,RESIDENTIAL,47025,0,47025,226884,0,273909
132530400600000,NW 344,RESIDENTIAL,44000,0,44000,193356,0,237356
132530400700000,NW 344,RESIDENTIAL,45641,0,45641,206254,0,251895
132530400800000,NW 344,RESIDENTIAL,46550,0,46550,246785,0,293335
132530400900000,NW 344,RESIDENTIAL,51937,0,51937,309119,0,361056
132530401000000,NW 344,RESIDENTIAL,47667,0,47667,185138,0,232805
132530401200000,NW 344,RESIDENTIAL,48645,0,48645,212552,0,261197
132530401300000,NW 344,RESIDENTIAL,44550,0,44550,249848,0,294398
132530401400000,NW 344,RESIDENTIAL,46750,0,46750,206128,0,252878
132530401500000,NW 344,RESIDENTIAL,46750,0,46750,241212,0,287962
132530401600000,NW 344,RESIDENTIAL,46750,0,46750,176040,0,222790
132530401700000,NW 344,RESIDENTIAL,46750,0,46750,238263,0,285013
132530401800000,NW 344,RESIDENTIAL,46404,0,46404,209951,0,256355
132530401900000,NW 344,RESIDENTIAL,50935,0,50935,230584,0,281519
132530402000000,NW 344,RESIDENTIAL,52411,0,52411,242571,0,294982
132530402100000,NW 344,RESIDENTIAL,50330,0,50330,235802,0,286132
132530402200000,NW 344,RESIDENTIAL,50879,0,50879,216333,0,267212
132530402400000,NW 344,RESIDENTIAL,46750,0,46750,222762,0,269512
132530402500000,NW 344,RESIDENTIAL,46750,0,46750,191872,0,238622
132530402600000,NW 344,RESIDENTIAL,44000,0,44000,203455,0,247455
132530402700000,NW 344,RESIDENTIAL,46750,0,46750,196973,0,243723
132530402800000,NW 344,RESIDENTIAL,46750,0,46750,213250,0,260000
132530402900000,NW 344,RESIDENTIAL,44000,0,44000,208615,0,252615
132530403000000,NW 344,RESIDENTIAL,46750,0,46750,235299,0,282049
132530403100000,NW 344,RESIDENTIAL,48369,0,48369,225959,0,274328
132530403200000,NW 344,RESIDENTIAL,51275,0,51275,225966,0,277241
132530403300000,NW 344,RESIDENTIAL,53259,0,53259,221825,0,275084
132530403400000,NW 344,RESIDENTIAL,55566,0,55566,219554,0,275120
132530403500000,NW 344,RESIDENTIAL,52479,0,52479,205433,0,257912
132530403600000,NW 344,RESIDENTIAL,51414,0,51414,188220,0,239634
132530403700000,NW 344,RESIDENTIAL,48620,0,48620,188482,0,237102
132532600100000,APARTMENT,COMMERCIAL,0,78480,78480,0,1236059,1314539
132532600200000,BRANCH BANK/CU,COMMERCIAL,0,77760,77760,0,230556,308316
132532600300000,NBHD SHOPPING CENTER,COMMERCIAL,0,164800,164800,0,449414,614214
132532600400000,NBHD SHOPPING CENTER,COMMERCIAL,0,257920,257920,0,504653,762573
132532600500000,AUTO REPAIR/SALES,COMMERCIAL,0,50000,50000,0,52490,102490
132532700100000,NW 329,RESIDENTIAL,26483,0,26483,90627,0,117110
132532700200000,CITY PROPERTY,EXEMPT,0,0,0,0,0,0
132532700300000,NW 329,RESIDENTIAL,21301,0,21301,113012,0,134313
132532700400000,NW 329,RESIDENTIAL,21210,0,21210,128449,0,149659
132532700500000,NW 329,RESIDENTIAL,21210,0,21210,138733,0,159943
132532700600000,NW 329,RESIDENTIAL,21489,0,21489,110573,0,132062
132532700700000,NW 329,RESIDENTIAL,19695,0,19695,120007,0,139702
132532700800000,NW 329,RESIDENTIAL,19695,0,19695,122945,0,142640
132532700900000,NW 329,RESIDENTIAL,19695,0,19695,197148,0,216843
132532701200000,DAY CARE CENTER,COMMERCIAL,0,58545,58545,0,237741,296286
132532701300000,NW 340,RESIDENTIAL,22557,0,22557,127342,0,149899
132532701400000,NW 340,RESIDENTIAL,21631,0,21631,129201,0,150832
132532701500000,NW 340,RESIDENTIAL,20854,0,20854,131026,0,151880
132532701600000,NW 340,RESIDENTIAL,20924,0,20924,132011,0,152935
132532701700000,NW 340,RESIDENTIAL,19885,0,19885,153211,0,173096
132532701800000,NW 340,RESIDENTIAL,20272,0,20272,144715,0,164987
132532701900000,NW 340,RESIDENTIAL,20249,0,20249,136303,0,156552
132532702000000,NW 340,RESIDENTIAL,21321,0,21321,140201,0,161522
132532702100000,NW 340,RESIDENTIAL,22792,0,22792,158248,0,181040
132532702200000,NW 340,RESIDENTIAL,21039,0,21039,150406,0,171445
132532702300000,NW 340,RESIDENTIAL,19500,0,19500,141131,0,160631
132532702400000,NW 340,RESIDENTIAL,21725,0,21725,129632,0,151357
132532702600000,OFFICE; MEDICAL,COMMERCIAL,0,126250,126250,0,621326,747576
132532702700000,CONVENIENCE STORE,COMMERCIAL,0,72000,72000,0,236139,308139
132532702800000,RESTAURANT,COMMERCIAL,0,62400,62400,0,96437,158837
132532702900000,CHURCH,EXEMPT,0,14170,14170,0,0,14170
132532703000000,CHURCH,EXEMPT,0,188352,188352,0,530779,719131
132532703100000,NW 329,EXEMPT,0,36453,36453,0,63318,99771
132532703200000,NW 329,RESIDENTIAL,27233,0,27233,59460,0,86693
132532703300000,NW 329,RESIDENTIAL,26481,0,26481,85467,0,111948
132532703400000,NW 329,RESIDENTIAL,26481,0,26481,99478,0,125959
132532703500000,OFFICE,COMMERCIAL,0,30030,30030,0,44822,74852
132532800100000,NW 329,RESIDENTIAL,20447,0,20447,112681,0,133128
132532800200000,NW 329,RESIDENTIAL,20370,0,20370,106401,0,126771
132532800300000,NW 329,RESIDENTIAL,20370,0,20370,125255,0,145625
132532800400000,NW 329,RESIDENTIAL,20370,0,20370,118151,0,138521
132532800500000,NW 329,RESIDENTIAL,22484,0,22484,130441,0,152925
132532800600000,NW 329,RESIDENTIAL,22485,0,22485,132308,0,154793
132532900100000,NW 329,RESIDENTIAL,11754,0,11754,118886,0,130640
132532900200000,NW 329,RESIDENTIAL,9693,0,9693,114593,0,124286
132532900300000,APARTMENT,COMMERCIAL,0,24198,24198,0,174962,199160
132532900400000,APARTMENT,COMMERCIAL,0,24198,24198,0,140571,164769
132533000100000,SERVICE STATION,COMMERCIAL,0,103680,103680,0,65975,169655
132533000200000,WAREHOUSE;MINI STORG,COMMERCIAL,0,68860,68860,0,88799,157659
132533100200000,AUTO REPAIR/SALES,COMMERCIAL,0,160800,160800,0,202199,362999
132533100300000,LG DISCOUNT/RETAIL,COMMERCIAL,0,342400,342400,0,426566,768966
132533100400000,WAREHOUSE,COMMERCIAL,0,112250,112250,0,188182,300432
132533100500000,WAREHOUSE,COMMERCIAL,0,104125,104125,0,121662,225787
132533200400000,OFFICE,COMMERCIAL,0,52900,52900,0,185791,238691
132533200500000,NBHD SHOPPING CENTER,COMMERCIAL,0,48000,48000,0,204466,252466
132533200600000,OFFICE,COMMERCIAL,0,29741,29741,0,117856,147597
132533200700000,SHOP,COMMERCIAL,0,57600,57600,0,107613,165213
132533200800000,SECTION 42,COMMERCIAL,0,20000,20000,0,22314,42314
132533200900000,APARTMENT,EXEMPT,0,28836,28836,0,381975,410811
132535100300000,VACANT LAND,COMMERCIAL,0,12800,12800,0,0,12800
132535100400000,APARTMENT,COMMERCIAL,0,217600,217600,0,2325131,2542731
132535100500000,CITY PROPERTY,EXEMPT,0,0,0,0,0,0
132535200200000,APARTMENT,COMMERCIAL,0,483050,483050,0,3305253,3788303
132535200300000,SECTION 42,COMMERCIAL,0,379200,379200,0,1817961,2197161
132535200500000,FITNESS CENTER,COMMERCIAL,0,577750,577750,0,730174,1307924
132537600200000,NW 344,RESIDENTIAL,1646,0,1646,0,0,1646
132537700100000,CITY PROPERTY,EXEMPT,0,0,0,0,0,0
132537700201000,OFFICE,COMMERCIAL,0,34640,34640,0,149022,183662
132537700201001,OFFICE,COMMERCIAL,0,34640,34640,0,149022,183662
132537700201002,OFFICE; MEDICAL,COMMERCIAL,0,30940,30940,0,182015,212955
132537700201003,OFFICE,COMMERCIAL,0,34640,34640,0,149022,183662
132537700201004,OFFICE,COMMERCIAL,0,34640,34640,0,149022,183662
132537700300000,APARTMENT,COMMERCIAL,0,450000,450000,0,3568829,4018829
132537800100000,GROCERY STORE,COMMERCIAL,0,776200,776200,0,773800,1550000
132537800200000,VACANT LAND,COMMERCIAL,0,60370,60370,0,0,60370
132537800300000,VACANT LAND,COMMERCIAL,0,423225,423225,0,0,423225
132537800400000,NBHD SHOPPING CENTER,COMMERCIAL,0,362900,362900,0,967100,1330000
132540100100000,NW 335,RESIDENTIAL,26608,0,26608,114274,0,140882
132540100200000,NW 335,RESIDENTIAL,26505,0,26505,143780,0,170285
132540100300000,NW 335,RESIDENTIAL,27342,0,27342,133372,0,160714
132540100400000,NW 335,RESIDENTIAL,29016,0,29016,123889,0,152905
132540100500000,NW 335,RESIDENTIAL,29574,0,29574,110104,0,139678
132540100600000,NW 335,RESIDENTIAL,29574,0,29574,146832,0,176406
132540100700000,NW 335,RESIDENTIAL,29574,0,29574,94269,0,123843
132540100800000,NW 335,RESIDENTIAL,29574,0,29574,117482,0,147056
132540100900000,NW 335,RESIDENTIAL,29574,0,29574,116536,0,146110
132540101000000,NW 335,RESIDENTIAL,30199,0,30199,122413,0,152612
132540200100000,NW 335,RESIDENTIAL,41213,0,41213,169286,0,210499
132540200200000,NW 335,RESIDENTIAL,40545,0,40545,134824,0,175369
132540200300000,NW 335,RESIDENTIAL,31721,0,31721,108476,0,140197
132540200400000,NW 335,RESIDENTIAL,30767,0,30767,145357,0,176124
132540200500000,NW 335,RESIDENTIAL,33077,0,33077,171307,0,204384
132540200600000,NW 335,RESIDENTIAL,35521,0,35521,110572,0,146093
132540200700000,NW 335,RESIDENTIAL,33390,0,33390,98913,0,132303
132540300100000,NW 335,RESIDENTIAL,22785,0,22785,100815,0,123600
132540300200000,NW 335,RESIDENTIAL,32798,0,32798,92936,0,125734
132540300300000,NW 335,RESIDENTIAL,31347,0,31347,129445,0,160792
132540300400000,NW 335,RESIDENTIAL,30767,0,30767,113271,0,144038
132540300500000,NW 335,RESIDENTIAL,30767,0,30767,110033,0,140800
132540300600000,NW 335,RESIDENTIAL,30767,0,30767,110401,0,141168
132540300700000,NW 335,RESIDENTIAL,30767,0,30767,110218,0,140985
132540300800000,NW 335,RESIDENTIAL,30767,0,30767,84641,0,115408
132540300900000,NW 335,RESIDENTIAL,30767,0,30767,159995,0,190762
132540301000000,NW 335,RESIDENTIAL,30767,0,30767,0,0,30767
132540301100000,NW 335,RESIDENTIAL,32198,0,32198,113861,0,146059
132540301200000,NW 335,RESIDENTIAL,31959,0,31959,98646,0,130605
132540301300000,NW 335,RESIDENTIAL,31959,0,31959,110358,0,142317
132540301400000,NW 335,RESIDENTIAL,41547,0,41547,126631,0,168178
132540301500000,NW 335,RESIDENTIAL,32759,0,32759,94556,0,127315
132540301600000,NW 335,RESIDENTIAL,28868,0,28868,91407,0,120275
132540301700000,NW 335,RESIDENTIAL,26784,0,26784,119383,0,146167
132540301800000,NW 335,RESIDENTIAL,26519,0,26519,100044,0,126563
132540301900000,NW 335,RESIDENTIAL,26226,0,26226,101895,0,128121
132540302000000,NW 335,RESIDENTIAL,26226,0,26226,111267,0,137493
132540302100000,NW 335,RESIDENTIAL,26226,0,26226,113780,0,140006
132540302200000,NW 335,RESIDENTIAL,26226,0,26226,96730,0,122956
132540302300000,NW 335,RESIDENTIAL,26226,0,26226,125471,0,151697
132540302400000,NW 335,RESIDENTIAL,26226,0,26226,127776,0,154002
132540302500000,NW 335,RESIDENTIAL,26226,0,26226,110872,0,137098
132540302600000,NW 335,RESIDENTIAL,27072,0,27072,98341,0,125413
132540302700000,NW 335,RESIDENTIAL,37309,0,37309,153206,0,190515
132540302800000,NW 335,RESIDENTIAL,26226,0,26226,108741,0,134967
132540302900000,NW 335,RESIDENTIAL,26226,0,26226,93775,0,120001
132540303000000,NW 335,RESIDENTIAL,26226,0,26226,95730,0,121956
132540303100000,NW 335,RESIDENTIAL,27495,0,27495,120054,0,147549
132540303200000,SCHOOL,EXEMPT,0,499554,499554,0,1068533,1568087
132540303300000,SCHOOL,EXEMPT,0,979560,979560,0,2095520,3075080
132540303400000,NW 335,RESIDENTIAL,22785,0,22785,116954,0,139739
132540303500000,NW 335,RESIDENTIAL,22785,0,22785,112342,0,135127
132542600100000,NW 335,RESIDENTIAL,33390,0,33390,125904,0,159294
132542600200000,NW 335,RESIDENTIAL,35664,0,35664,96762,0,132426
132542600300000,NW 335,RESIDENTIAL,35775,0,35775,107031,0,142806
132542600400000,NW 335,RESIDENTIAL,38518,0,38518,110927,0,149445
132542600500000,NW 335,RESIDENTIAL,38518,0,38518,111727,0,150245
132542600600000,NW 335,RESIDENTIAL,31005,0,31005,126380,0,157385
132542600700000,NW 335,RESIDENTIAL,34929,0,34929,122928,0,157857
132542600800000,NW 335,RESIDENTIAL,38556,0,38556,138758,0,177314
132542600900000,NW 335,RESIDENTIAL,35568,0,35568,105611,0,141179
132542601000000,NW 335,RESIDENTIAL,37053,0,37053,97322,0,134375
132542601100000,NW 335,RESIDENTIAL,31752,0,31752,121524,0,153276
132542601200000,NW 335,RESIDENTIAL,29106,0,29106,122080,0,151186
132542601300000,NW 335,RESIDENTIAL,33516,0,33516,113281,0,146797
132542601400000,NW 335,RESIDENTIAL,28584,0,28584,111478,0,140062
132542601500000,NW 335,RESIDENTIAL,28312,0,28312,105133,0,133445
132542601600000,NW 335,RESIDENTIAL,28950,0,28950,105058,0,134008
132542601700000,NW 335,RESIDENTIAL,33561,0,33561,98983,0,132544
132542601800000,NW 335,RESIDENTIAL,28445,0,28445,134168,0,162613
132542601900000,NW 335,RESIDENTIAL,33311,0,33311,115481,0,148792
132542602000000,NW 335,RESIDENTIAL,31428,0,31428,121918,0,153346
132542602100000,NW 335,RESIDENTIAL,33174,0,33174,108920,0,142094
132542602200000,NW 335,RESIDENTIAL,28755,0,28755,125954,0,154709
132542602300000,NW 335,RESIDENTIAL,31894,0,31894,108105,0,139999
132542602400000,NW 335,RESIDENTIAL,36957,0,36957,133721,0,170678
132542602500000,NW 335,RESIDENTIAL,38236,0,38236,119497,0,157733
132542602600000,NW 335,RESIDENTIAL,35905,0,35905,106958,0,142863
132542602700000,NW 335,RESIDENTIAL,30510,0,30510,140414,0,170924
132542602800000,NW 335,RESIDENTIAL,29700,0,29700,128351,0,158051
132542602900000,NW 335,RESIDENTIAL,30600,0,30600,133782,0,164382
132542603000000,NW 335,RESIDENTIAL,29532,0,29532,131153,0,160685
132542603100000,NW 335,RESIDENTIAL,36546,0,36546,137006,0,173552
132542603200000,NW 335,RESIDENTIAL,37278,0,37278,112038,0,149316
132542603300000,NW 335,RESIDENTIAL,35380,0,35380,143561,0,178941
132542603400000,NW 335,RESIDENTIAL,33252,0,33252,120279,0,153531
132542603500000,NW 335,RESIDENTIAL,36000,0,36000,162649,0,198649
132542603600000,NW 335,RESIDENTIAL,36000,0,36000,137479,0,173479
132542603700000,NW 335,RESIDENTIAL,35550,0,35550,146572,0,182122
132542603800000,NW 335,RESIDENTIAL,36445,0,36445,118643,0,155088
132542603900000,SCHOOL,EXEMPT,0,0,0,0,0,0
132542700100000,NW 335,RESIDENTIAL,33221,0,33221,128318,0,161539
132542700200000,NW 335,RESIDENTIAL,28448,0,28448,98603,0,127051
132542700300000,NW 335,RESIDENTIAL,28373,0,28373,136186,0,164559
132542700400000,NW 335,RESIDENTIAL,34920,0,34920,102961,0,137881
132542700500000,NW 335,RESIDENTIAL,34920,0,34920,106859,0,141779
132542700600000,NW 335,RESIDENTIAL,36077,0,36077,97418,0,133495
132542700700000,NW 335,RESIDENTIAL,34872,0,34872,121822,0,156694
132542700800000,NW 335,RESIDENTIAL,32076,0,32076,106897,0,138973
132542700900000,NW 335,RESIDENTIAL,34992,0,34992,134025,0,169017
132542701000000,NW 335,RESIDENTIAL,34506,0,34506,113629,0,148135
132542701100000,NW 335,RESIDENTIAL,38404,0,38404,111299,0,149703
132542701200000,NW 335,RESIDENTIAL,31723,0,31723,121984,0,153707
132542701300000,NW 335,RESIDENTIAL,37620,0,37620,96410,0,134030
132542701400000,NW 335,RESIDENTIAL,34992,0,34992,132076,0,167068
132542701500000,NW 335,RESIDENTIAL,36252,0,36252,102740,0,138992
132542701600000,NW 335,RESIDENTIAL,37908,0,37908,124409,0,162317
132542701700000,NW 335,RESIDENTIAL,33784,0,33784,132825,0,166609
132542701800000,NW 335,RESIDENTIAL,34800,0,34800,112970,0,147770
132542701900000,NW 335,RESIDENTIAL,36015,0,36015,120513,0,156528
132542702000000,NW 335,RESIDENTIAL,37699,0,37699,128355,0,166054
132542702100000,NW 335,RESIDENTIAL,32218,0,32218,124511,0,156729
132542702200000,NW 335,RESIDENTIAL,32798,0,32798,116112,0,148910
132542702300000,NW 335,RESIDENTIAL,27284,0,27284,122692,0,149976
132542702400000,NW 335,RESIDENTIAL,29610,0,29610,129750,0,159360
132542702500000,NW 335,RESIDENTIAL,41418,0,41418,104804,0,146222
132542702600000,NW 335,RESIDENTIAL,34540,0,34540,129908,0,164448
132542702700000,NW 335,RESIDENTIAL,41927,0,41927,193096,0,235023
132542702800000,NW 335,RESIDENTIAL,42273,0,42273,168095,0,210368
132542702900000,NW 335,RESIDENTIAL,35701,0,35701,134446,0,170147
132542703000000,NW 335,RESIDENTIAL,32571,0,32571,113913,0,146484
132542703200000,NW 335,RESIDENTIAL,39634,0,39634,125829,0,165463
132542703300000,NW 335,RESIDENTIAL,27284,0,27284,103051,0,130335
132542703400000,NW 335,RESIDENTIAL,5558,0,5558,0,0,5558
132542703500000,NW 335,RESIDENTIAL,1252,0,1252,0,0,1252
132542703600000,NW 335,RESIDENTIAL,1788,0,1788,0,0,1788
132542703800000,NW 335,RESIDENTIAL,10049,0,10049,0,0,10049
132542703900000,NW 335,RESIDENTIAL,6930,0,6930,0,0,6930
132542704000000,NW 335,RESIDENTIAL,5805,0,5805,0,0,5805
132542704100000,NW 335,RESIDENTIAL,35701,0,35701,133786,0,169487
132542800100000,NW 335,RESIDENTIAL,37908,0,37908,130441,0,168349
132542800200000,NW 335,RESIDENTIAL,33149,0,33149,124042,0,157191
132542800300000,NW 335,RESIDENTIAL,32130,0,32130,129178,0,161308
132542800400000,NW 335,RESIDENTIAL,33750,0,33750,148764,0,182514
132542800500000,NW 335,RESIDENTIAL,38610,0,38610,131154,0,169764
132542800600000,NW 335,RESIDENTIAL,36697,0,36697,157003,0,193700
132542800700000,NW 335,RESIDENTIAL,36000,0,36000,142931,0,178931
132542800800000,NW 335,RESIDENTIAL,36000,0,36000,133862,0,169862
132542800900000,NW 335,RESIDENTIAL,35100,0,35100,132710,0,167810
132542801000000,NW 335,RESIDENTIAL,36231,0,36231,125623,0,161854
132542801100000,NW 335,RESIDENTIAL,27668,0,27668,142000,0,169668
132542801200000,NW 335,RESIDENTIAL,30682,0,30682,144931,0,175613
132542801300000,NW 335,RESIDENTIAL,32956,0,32956,265965,0,298921
132542801400000,NW 335,RESIDENTIAL,28981,0,28981,154431,0,183412
132542801500000,NW 335,RESIDENTIAL,30336,0,30336,196109,0,226445
132542801600000,NW 335,RESIDENTIAL,26313,0,26313,123825,0,150138
132542801700000,NW 335,RESIDENTIAL,29195,0,29195,170519,0,199714
132542801800000,NW 335,RESIDENTIAL,25536,0,25536,123629,0,149165
132545100100000,NW 335,RESIDENTIAL,29028,0,29028,218883,0,247911
132545100200000,NW 335,RESIDENTIAL,29028,0,29028,144154,0,173182
132545100300000,NW 335,RESIDENTIAL,26880,0,26880,117089,0,143969
132545100400000,NW 335,RESIDENTIAL,26880,0,26880,129897,0,156777
132545100500000,NW 335,RESIDENTIAL,26880,0,26880,113081,0,139961
132545100600000,NW 335,RESIDENTIAL,26481,0,26481,98478,0,124959
132545100700000,NW 335,RESIDENTIAL,26481,0,26481,100730,0,127211
132545200100000,SR/NURSING/ASSTD LIV,COMMERCIAL,0,452400,452400,0,3143753,3596153
132545200200000,NW 335,RESIDENTIAL,27081,0,27081,127645,0,154726
132545200300000,NW 335,RESIDENTIAL,25463,0,25463,125497,0,150960
132545200400000,NW 335,RESIDENTIAL,25463,0,25463,86223,0,111686
132545200500000,NW 335,RESIDENTIAL,25463,0,25463,143603,0,169066
132545200600000,NW 335,RESIDENTIAL,25393,0,25393,117259,0,142652
132545200700000,NW 335,RESIDENTIAL,25907,0,25907,145744,0,171651
132545200800000,NW 335,RESIDENTIAL,25815,0,25815,120268,0,146083
132545200900000,NW 335,RESIDENTIAL,25725,0,25725,125691,0,151416
132545201000000,NW 335,RESIDENTIAL,25725,0,25725,105061,0,130786
132545201100000,NW 335,RESIDENTIAL,25252,0,25252,123028,0,148280
132545201200000,NW 335,RESIDENTIAL,28873,0,28873,145887,0,174760
132545201300000,NW 335,RESIDENTIAL,27985,0,27985,152382,0,180367
132545201400000,NW 335,RESIDENTIAL,29286,0,29286,167994,0,197280
132545201500000,NW 335,RESIDENTIAL,25235,0,25235,110708,0,135943
132545201600000,NW 335,RESIDENTIAL,25725,0,25725,139755,0,165480
132545201700000,NW 335,RESIDENTIAL,25725,0,25725,125678,0,151403
132545201800000,NW 335,RESIDENTIAL,25906,0,25906,141332,0,167238
132545201900000,VACANT LAND,COMMERCIAL,0,257500,257500,0,0,257500
132545300100000,NW 335,RESIDENTIAL,25039,0,25039,113752,0,138791
132545300200000,NW 335,RESIDENTIAL,27440,0,27440,122152,0,149592
132545300300000,NW 335,RESIDENTIAL,26754,0,26754,107210,0,133964
132545300400000,NW 335,RESIDENTIAL,27309,0,27309,115178,0,142487
132545400200000,APARTMENT,RESIDENTIAL,74160,0,74160,607285,0,681445
132545500100000,OFFICE,COMMERCIAL,0,592500,592500,0,3029724,3622224
132545500200000,OFFICE,COMMERCIAL,0,310400,310400,0,348877,659277
132545500300000,VACANT LAND,COMMERCIAL,0,20800,20800,0,0,20800
132545500400000,VACANT LAND,COMMERCIAL,0,30250,30250,0,0,30250
132545500500000,FLAT PARKING,COMMERCIAL,0,51500,51500,0,35700,87200
132547600100000,NW 335,RESIDENTIAL,25536,0,25536,111629,0,137165
132547600200000,NW 335,RESIDENTIAL,23520,0,23520,112076,0,135596
132547600300000,NW 335,RESIDENTIAL,23275,0,23275,85140,0,108415
132547600400000,NW 335,RESIDENTIAL,21221,0,21221,108061,0,129282
132547600500000,NW 335,RESIDENTIAL,21221,0,21221,99700,0,120921
132547600600000,NW 335,RESIDENTIAL,23494,0,23494,118834,0,142328
132547600700000,NW 335,RESIDENTIAL,25004,0,25004,114496,0,139500
132547600800000,NW 335,RESIDENTIAL,25321,0,25321,152202,0,177523
132547600900000,NW 335,RESIDENTIAL,23373,0,23373,112311,0,135684
132547601000000,NW 335,RESIDENTIAL,23373,0,23373,94194,0,117567
132547601100000,NW 335,RESIDENTIAL,23373,0,23373,92261,0,115634
132547601200000,NW 335,RESIDENTIAL,23373,0,23373,107727,0,131100
132547601300000,NW 335,RESIDENTIAL,23373,0,23373,118402,0,141775
132547601400000,APARTMENT,COMMERCIAL,0,28224,28224,0,135968,164192
132547601500000,APARTMENT,COMMERCIAL,0,24192,24192,0,197432,221624
132547601600000,APARTMENT,COMMERCIAL,0,25200,25200,0,197883,223083
132547601700000,APARTMENT,COMMERCIAL,0,32256,32256,0,273527,305783
132547601800000,SR/NURSING/ASSTD LIV,COMMERCIAL,0,77840,77840,0,1078566,1156406
132547601900000,NW 335,RESIDENTIAL,21420,0,21420,96359,0,117779
132547602000000,NW 335,RESIDENTIAL,24990,0,24990,116187,0,141177
132547602100000,NW 335,RESIDENTIAL,24948,0,24948,117133,0,142081
132547602200000,NW 335,RESIDENTIAL,23870,0,23870,105672,0,129542
132547602300000,NW 335,RESIDENTIAL,26565,0,26565,116950,0,143515
132547602400000,NW 335,RESIDENTIAL,24472,0,24472,81980,0,106452
132547602500000,NW 335,RESIDENTIAL,25231,0,25231,104393,0,129624
132547602600000,NW 335,RESIDENTIAL,22295,0,22295,79174,0,101469
132547602700000,NW 335,RESIDENTIAL,23935,0,23935,114302,0,138237
132547602800000,NW 335,RESIDENTIAL,23765,0,23765,87997,0,111762
132547602900000,NW 335,RESIDENTIAL,24444,0,24444,86819,0,111263
132547700100000,NW 335,EXEMPT,0,33166,33166,0,161623,194789
132547700200000,NW 335,RESIDENTIAL,28904,0,28904,138493,0,167397
132547700300000,NW 335,RESIDENTIAL,27160,0,27160,150911,0,178071
132547700400000,NW 335,RESIDENTIAL,28857,0,28857,142617,0,171474
132547700500000,NW 335,RESIDENTIAL,27160,0,27160,158934,0,186094
132547700600000,NW 335,RESIDENTIAL,25802,0,25802,112658,0,138460
132547700700000,NW 335,RESIDENTIAL,25802,0,25802,109198,0,135000
132547700800000,NW 335,RESIDENTIAL,24784,0,24784,111023,0,135807
132547700900000,NW 335,RESIDENTIAL,27160,0,27160,117935,0,145095
132547701000000,NW 335,RESIDENTIAL,27500,0,27500,147944,0,175444
132547701100000,NW 335,RESIDENTIAL,27160,0,27160,110890,0,138050
132547701200000,NW 335,RESIDENTIAL,26481,0,26481,101872,0,128353
132547701300000,NW 335,RESIDENTIAL,22068,0,22068,91795,0,113863
132547701400000,NW 335,RESIDENTIAL,28968,0,28968,111180,0,140148
132547701500000,NW 335,RESIDENTIAL,30450,0,30450,95456,0,125906
132547800100000,NW 335,RESIDENTIAL,26811,0,26811,99216,0,126027
132547800200000,NW 335,RESIDENTIAL,26712,0,26712,129780,0,156492
132547800300000,NW 335,RESIDENTIAL,25725,0,25725,95725,0,121450
132547800400000,NW 335,RESIDENTIAL,27783,0,27783,130840,0,158623
132547800500000,NW 335,RESIDENTIAL,26754,0,26754,97052,0,123806
132547800600000,NW 335,RESIDENTIAL,26754,0,26754,98737,0,125491
132547800700000,NW 335,RESIDENTIAL,26754,0,26754,108504,0,135258
132547800800000,NW 335,RESIDENTIAL,25725,0,25725,94979,0,120704
132547800900000,APARTMENT,COMMERCIAL,0,57120,57120,0,455022,512142
132547801000000,APARTMENT,RESIDENTIAL,57440,0,57440,402560,0,460000
132547801100000,APARTMENT,RESIDENTIAL,57360,0,57360,402640,0,460000
132547900101000,SMALL RETAIL,COMMERCIAL,0,190000,190000,0,132185,322185
132547900101001,OFFICE,COMMERCIAL,0,190000,190000,0,147562,337562
132547900200000,OFFICE,COMMERCIAL,0,1256000,1256000,0,2103941,3359941
132547900300000,FAST FOOD,COMMERCIAL,0,201438,201438,0,329035,530473
132548000100000,APARTMENT,RESIDENTIAL,39920,0,39920,330080,0,370000
132548000200000,APARTMENT,RESIDENTIAL,111200,0,111200,758800,0,870000
132548000300000,APARTMENT,RESIDENTIAL,96000,0,96000,624000,0,720000
132548000400000,HOTEL,COMMERCIAL,0,254750,254750,0,3020882,3275632
132548000500000,APARTMENT,RESIDENTIAL,39760,0,39760,330240,0,370000
132548000600000,CITY PROPERTY,EXEMPT,0,0,0,0,0,0
132610100100000,NW 329,RESIDENTIAL,30080,0,30080,99157,0,129237
132610100200000,NW 329,RESIDENTIAL,24816,0,24816,94460,0,119276
132610100300000,NW 329,RESIDENTIAL,23688,0,23688,96993,0,120681
132610100400000,NW 329,RESIDENTIAL,23688,0,23688,102508,0,126196
132610100500000,NW 329,RESIDENTIAL,23688,0,23688,108672,0,132360
132610100600000,NW 329,RESIDENTIAL,23688,0,23688,97301,0,120989
132610100700000,NW 329,RESIDENTIAL,23688,0,23688,92200,0,115888
132610100800000,NW 329,RESIDENTIAL,23688,0,23688,87081,0,110769
132610100900000,NW 329,RESIDENTIAL,23688,0,23688,91360,0,115048
132610101000000,NW 329,RESIDENTIAL,23688,0,23688,88105,0,111793
132610101100000,NW 329,RESIDENTIAL,23688,0,23688,106409,0,130097
132610101200000,NW 329,RESIDENTIAL,23688,0,23688,95829,0,119517
132610101300000,NW 329,RESIDENTIAL,23688,0,23688,78434,0,102122
132610101400000,NW 329,RESIDENTIAL,23688,0,23688,100271,0,123959
132610101500000,NW 329,RESIDENTIAL,23688,0,23688,94390,0,118078
132610101600000,NW 329,RESIDENTIAL,23688,0,23688,95362,0,119050
132610101700000,NW 329,RESIDENTIAL,26846,0,26846,97816,0,124662
132610200100000,NW 329,RESIDENTIAL,28800,0,28800,98169,0,126969
132610200200000,NW 329,RESIDENTIAL,28800,0,28800,98641,0,127441
132610200300000,NW 329,RESIDENTIAL,24631,0,24631,85969,0,110600
132610200400000,NW 329,RESIDENTIAL,24192,0,24192,90957,0,115149
132610200500000,NW 329,RESIDENTIAL,24192,0,24192,87350,0,111542
132610200600000,NW 329,RESIDENTIAL,24192,0,24192,105232,0,129424
132610200700000,NW 329,RESIDENTIAL,24192,0,24192,91097,0,115289
132610200800000,NW 329,RESIDENTIAL,24192,0,24192,111182,0,135374
132610200900000,NW 329,RESIDENTIAL,24192,0,24192,86638,0,110830
132610201000000,NW 329,RESIDENTIAL,24192,0,24192,104041,0,128233
132610201100000,NW 329,RESIDENTIAL,24192,0,24192,100890,0,125082
132610201200000,NW 329,RESIDENTIAL,24192,0,24192,94709,0,118901
132610201300000,NW 329,RESIDENTIAL,24192,0,24192,93806,0,117998
132610201400000,NW 329,RESIDENTIAL,24192,0,24192,98978,0,123170
132610201500000,NW 329,RESIDENTIAL,23319,0,23319,89889,0,113208
132610201600000,NW 329,RESIDENTIAL,24832,0,24832,88132,0,112964
132610201700000,NW 329,RESIDENTIAL,26765,0,26765,101328,0,128093
132610201800000,NW 329,RESIDENTIAL,25216,0,25216,101396,0,126612
132610201900000,NW 329,RESIDENTIAL,25944,0,25944,88717,0,114661
132610202000000,NW 329,RESIDENTIAL,23688,0,23688,97307,0,120995
132610202100000,NW 329,RESIDENTIAL,24192,0,24192,87176,0,111368
132610202200000,NW 329,RESIDENTIAL,24192,0,24192,100509,0,124701
132610202300000,NW 329,RESIDENTIAL,24192,0,24192,91075,0,115267
132610202400000,NW 329,RESIDENTIAL,24192,0,24192,97287,0,121479
132610202500000,NW 329,RESIDENTIAL,24192,0,24192,86034,0,110226
132610202600000,NW 329,RESIDENTIAL,24192,0,24192,111007,0,135199
132610202700000,NW 329,RESIDENTIAL,24192,0,24192,88766,0,112958
132610202800000,NW 329,RESIDENTIAL,24192,0,24192,109427,0,133619
132610202900000,NW 329,RESIDENTIAL,24192,0,24192,101961,0,126153
132610203000000,NW 329,RESIDENTIAL,24192,0,24192,89191,0,113383
132610203100000,NW 329,RESIDENTIAL,24192,0,24192,94097,0,118289
132610203200000,NW 329,RESIDENTIAL,24192,0,24192,106270,0,130462
132610203300000,NW 329,RESIDENTIAL,24192,0,24192,97431,0,121623
132610203400000,NW 329,RESIDENTIAL,24847,0,24847,105293,0,130140
132610300100000,NW 329,RESIDENTIAL,24703,0,24703,66932,0,91635
132610300200000,NW 329,RESIDENTIAL,24064,0,24064,90803,0,114867
132610300300000,NW 329,RESIDENTIAL,24703,0,24703,92523,0,117226
132610300400000,NW 329,RESIDENTIAL,24631,0,24631,96799,0,121430
132610300500000,NW 329,RESIDENTIAL,24192,0,24192,89298,0,113490
132610300600000,NW 329,RESIDENTIAL,24192,0,24192,91371,0,115563
132610300700000,NW 329,RESIDENTIAL,24192,0,24192,102263,0,126455
132610300800000,NW 329,RESIDENTIAL,24192,0,24192,95589,0,119781
132610300900000,NW 329,RESIDENTIAL,24192,0,24192,103593,0,127785
132610301000000,NW 329,RESIDENTIAL,24192,0,24192,97984,0,122176
132610301100000,NW 329,RESIDENTIAL,24192,0,24192,93084,0,117276
132610301200000,NW 329,RESIDENTIAL,24192,0,24192,96777,0,120969
132610301300000,NW 329,RESIDENTIAL,24192,0,24192,91931,0,116123
132610301400000,NW 329,RESIDENTIAL,24192,0,24192,99614,0,123806
132610301500000,NW 329,RESIDENTIAL,24192,0,24192,99677,0,123869
132610301600000,NW 329,RESIDENTIAL,24192,0,24192,99585,0,123777
132610301700000,NW 329,RESIDENTIAL,26911,0,26911,100138,0,127049
132610301800000,NW 329,RESIDENTIAL,29702,0,29702,85966,0,115668
132610301900000,NW 329,RESIDENTIAL,25713,0,25713,101614,0,127327
132610302000000,NW 329,RESIDENTIAL,24192,0,24192,93358,0,117550
132610302100000,NW 329,RESIDENTIAL,24192,0,24192,93701,0,117893
132610302200000,NW 329,RESIDENTIAL,24192,0,24192,102836,0,127028
132610302300000,NW 329,RESIDENTIAL,24192,0,24192,93263,0,117455
132610302400000,NW 329,RESIDENTIAL,24192,0,24192,104281,0,128473
132610302500000,NW 329,RESIDENTIAL,24192,0,24192,87587,0,111779
132610302600000,NW 329,RESIDENTIAL,24192,0,24192,91403,0,115595
132610302700000,NW 329,RESIDENTIAL,24192,0,24192,91439,0,115631
132610302800000,NW 329,RESIDENTIAL,24192,0,24192,92334,0,116526
132610302900000,NW 329,RESIDENTIAL,24192,0,24192,95974,0,120166
132610303000000,NW 329,RESIDENTIAL,24192,0,24192,87281,0,111473
132610303100000,NW 329,RESIDENTIAL,24844,0,24844,75375,0,100219
132610400100000,NW 329,RESIDENTIAL,27002,0,27002,112485,0,139487
132610400200000,NW 329,RESIDENTIAL,24064,0,24064,87724,0,111788
132610400300000,NW 329,RESIDENTIAL,24064,0,24064,85096,0,109160
132610400400000,NW 329,RESIDENTIAL,24064,0,24064,96978,0,121042
132610400500000,NW 329,RESIDENTIAL,24064,0,24064,78478,0,102542
132610400600000,NW 329,RESIDENTIAL,23688,0,23688,103245,0,126933
132610400700000,NW 329,RESIDENTIAL,23702,0,23702,78913,0,102615
132610400800000,NW 329,RESIDENTIAL,28200,0,28200,170842,0,199042
132610400900000,NW 329,RESIDENTIAL,7520,0,7520,0,0,7520
132610401000000,SCHOOL,EXEMPT,0,0,0,0,0,0
132610401100000,NW 329,RESIDENTIAL,26676,0,26676,94864,0,121540
132610401200000,NW 329,RESIDENTIAL,26240,0,26240,74765,0,101005
132610401300000,NW 329,RESIDENTIAL,26458,0,26458,104548,0,131006
132610401400000,NW 329,RESIDENTIAL,26240,0,26240,96755,0,122995
132610401500000,NW 329,RESIDENTIAL,25587,0,25587,90084,0,115671
132610401600000,NW 329,RESIDENTIAL,28006,0,28006,90474,0,118480
132610401700000,NW 329,RESIDENTIAL,23688,0,23688,95305,0,118993
132610401800000,NW 329,RESIDENTIAL,23688,0,23688,92598,0,116286
132610401900000,NW 329,RESIDENTIAL,23688,0,23688,88054,0,111742
132610402000000,NW 329,RESIDENTIAL,23688,0,23688,84929,0,108617
132610402100000,NW 329,RESIDENTIAL,23688,0,23688,88151,0,111839
132610402200000,NW 329,RESIDENTIAL,23688,0,23688,85455,0,109143
132610402300000,NW 329,RESIDENTIAL,23688,0,23688,103418,0,127106
132610402400000,NW 329,RESIDENTIAL,23688,0,23688,78467,0,102155
132610402500000,NW 329,RESIDENTIAL,23688,0,23688,91538,0,115226
132610402600000,NW 329,RESIDENTIAL,23688,0,23688,90721,0,114409
132610402700000,NW 329,RESIDENTIAL,23688,0,23688,99852,0,123540
132610402800000,NW 329,RESIDENTIAL,23688,0,23688,94029,0,117717
132610402900000,NW 329,RESIDENTIAL,22886,0,22886,98393,0,121279
132610500100000,NW 329,RESIDENTIAL,30080,0,30080,98955,0,129035
132610600100000,NW 329,RESIDENTIAL,25568,0,25568,89120,0,114688
132610600200000,NW 329,RESIDENTIAL,22344,0,22344,88070,0,110414
132610600300000,NW 329,RESIDENTIAL,26000,0,26000,107556,0,133556
132610700100000,NW 329,RESIDENTIAL,27072,0,27072,99614,0,126686
132610700200000,NW 329,RESIDENTIAL,24320,0,24320,92037,0,116357
132610700300000,NW 329,RESIDENTIAL,28365,0,28365,91591,0,119956
132610700400000,NW 329,RESIDENTIAL,24986,0,24986,82047,0,107033
132610700500000,NW 329,RESIDENTIAL,23760,0,23760,89527,0,113287
132610700600000,NW 329,RESIDENTIAL,25549,0,25549,90090,0,115639
132610800100000,CHURCH,EXEMPT,0,86400,86400,0,885818,972218
132610900100000,NW 329,RESIDENTIAL,24832,0,24832,82192,0,107024
132610900200000,NW 329,RESIDENTIAL,24960,0,24960,95762,0,120722
132610900300000,NW 329,RESIDENTIAL,25679,0,25679,98809,0,124488
132610900400000,NW 329,RESIDENTIAL,25600,0,25600,102847,0,128447
132612600100000,NW 329,RESIDENTIAL,25908,0,25908,127559,0,153467
132612600200000,NW 329,RESIDENTIAL,24576,0,24576,149520,0,174096
132612600300000,NW 329,RESIDENTIAL,24576,0,24576,95286,0,119862
132612600400000,NW 329,RESIDENTIAL,24576,0,24576,131939,0,156515
132612600500000,NW 329,RESIDENTIAL,29696,0,29696,125344,0,155040
132612600600000,NW 329,RESIDENTIAL,24576,0,24576,146230,0,170806
132612600700000,NW 329,RESIDENTIAL,5120,0,5120,0,0,5120
132612600800000,NW 329,RESIDENTIAL,10240,0,10240,0,0,10240
132612600900000,NW 329,RESIDENTIAL,29696,0,29696,96516,0,126212
132612601000000,NW 329,RESIDENTIAL,5120,0,5120,0,0,5120
132612601100000,NW 329,RESIDENTIAL,5120,0,5120,0,0,5120
132612601200000,NW 329,RESIDENTIAL,5120,0,5120,0,0,5120
132612601300000,NW 329,RESIDENTIAL,5120,0,5120,0,0,5120
132612601400000,NW 329,RESIDENTIAL,6000,0,6000,0,0,6000
132612601500000,NW 329,RESIDENTIAL,25920,0,25920,95470,0,121390
132612601600000,NW 329,RESIDENTIAL,24576,0,24576,92198,0,116774
132612601700000,NW 329,RESIDENTIAL,24576,0,24576,103683,0,128259
132612601800000,NW 329,RESIDENTIAL,24576,0,24576,97297,0,121873
132612601900000,NW 329,RESIDENTIAL,24576,0,24576,97707,0,122283
132612602000000,NW 329,RESIDENTIAL,24576,0,24576,100094,0,124670
132612602100000,NW 329,RESIDENTIAL,24576,0,24576,107352,0,131928
132612602200000,NW 329,RESIDENTIAL,24576,0,24576,93724,0,118300
132612602300000,NW 329,RESIDENTIAL,24576,0,24576,86541,0,111117
132612602400000,NW 329,RESIDENTIAL,24576,0,24576,86788,0,111364
132612602500000,NW 329,RESIDENTIAL,24576,0,24576,88383,0,112959
132612602600000,NW 329,RESIDENTIAL,24576,0,24576,91485,0,116061
132612602700000,NW 329,RESIDENTIAL,25862,0,25862,107684,0,133546
132612700100000,NW 329,RESIDENTIAL,23985,0,23985,112367,0,136352
132612700200000,NW 329,RESIDENTIAL,27840,0,27840,100207,0,128047
132612700300000,NW 329,RESIDENTIAL,4800,0,4800,0,0,4800
132612700400000,NW 329,RESIDENTIAL,4840,0,4840,14275,0,19115
132612700500000,NW 329,RESIDENTIAL,23078,0,23078,125511,0,148589
132612700600000,NW 329,RESIDENTIAL,23040,0,23040,100621,0,123661
132612700800000,NW 329,RESIDENTIAL,23985,0,23985,90264,0,114249
132612800100000,NW 329,RESIDENTIAL,25974,0,25974,92863,0,118837
132612800200000,NW 329,RESIDENTIAL,23280,0,23280,88797,0,112077
132612800300000,NW 329,RESIDENTIAL,25802,0,25802,88656,0,114458
132612800400000,NW 329,RESIDENTIAL,24696,0,24696,80521,0,105217
132612800500000,NW 329,RESIDENTIAL,24064,0,24064,97406,0,121470
132612800600000,NW 329,RESIDENTIAL,24266,0,24266,80100,0,104366
132612800700000,NW 329,RESIDENTIAL,24056,0,24056,102709,0,126765
132612800800000,NW 329,RESIDENTIAL,24315,0,24315,95371,0,119686
132612800900000,NW 329,RESIDENTIAL,24189,0,24189,95946,0,120135
132612801000000,NW 329,RESIDENTIAL,24064,0,24064,89105,0,113169
132612801100000,NW 329,RESIDENTIAL,24320,0,24320,96998,0,121318
132612801200000,NW 329,RESIDENTIAL,25331,0,25331,115015,0,140346
132612801300000,NW 329,RESIDENTIAL,25349,0,25349,98350,0,123699
132612801400000,NW 329,RESIDENTIAL,25611,0,25611,92764,0,118375
132612801500000,NW 329,RESIDENTIAL,26395,0,26395,120248,0,146643
132612801600000,NW 329,RESIDENTIAL,25568,0,25568,106811,0,132379
132612801700000,NW 329,RESIDENTIAL,22560,0,22560,78354,0,100914
132612801800000,NW 329,RESIDENTIAL,25091,0,25091,114509,0,139600
132612801900000,NW 329,RESIDENTIAL,24576,0,24576,79315,0,103891
132612802000000,NW 329,RESIDENTIAL,24576,0,24576,100478,0,125054
132612802100000,NW 329,RESIDENTIAL,24827,0,24827,100266,0,125093
132612802200000,NW 329,RESIDENTIAL,24827,0,24827,94854,0,119681
132612802300000,NW 329,RESIDENTIAL,25088,0,25088,89365,0,114453
132612802400000,NW 329,RESIDENTIAL,24565,0,24565,81476,0,106041
132612802500000,NW 329,RESIDENTIAL,24271,0,24271,98243,0,122514
132612802600000,NW 329,RESIDENTIAL,24816,0,24816,93970,0,118786
132612900100000,NW 329,RESIDENTIAL,25802,0,25802,93734,0,119536
132612900200000,NW 329,RESIDENTIAL,23280,0,23280,83401,0,106681
132612900300000,NW 329,RESIDENTIAL,25986,0,25986,103293,0,129279
132612900400000,NW 329,RESIDENTIAL,24816,0,24816,88311,0,113127
132612900500000,NW 329,RESIDENTIAL,24064,0,24064,94999,0,119063
132612900600000,NW 329,RESIDENTIAL,23944,0,23944,105276,0,129220
132612900700000,NW 329,RESIDENTIAL,24189,0,24189,87904,0,112093
132612900800000,NW 329,RESIDENTIAL,24221,0,24221,88540,0,112761
132612900900000,NW 329,RESIDENTIAL,24208,0,24208,98593,0,122801
132612901000000,NW 329,RESIDENTIAL,23838,0,23838,84099,0,107937
132612901100000,NW 329,RESIDENTIAL,24320,0,24320,106559,0,130879
132612901200000,NW 329,RESIDENTIAL,24326,0,24326,92526,0,116852
132612901300000,NW 329,RESIDENTIAL,24832,0,24832,95986,0,120818
132612901400000,NW 329,RESIDENTIAL,25220,0,25220,92188,0,117408
132612901500000,NW 329,RESIDENTIAL,25996,0,25996,91062,0,117058
132612901600000,NW 329,RESIDENTIAL,25610,0,25610,92554,0,118164
132612901700000,NW 329,RESIDENTIAL,22560,0,22560,90669,0,113229
132612901800000,NW 329,RESIDENTIAL,25568,0,25568,111301,0,136869
132612901900000,NW 329,RESIDENTIAL,25475,0,25475,95375,0,120850
132612902000000,NW 329,RESIDENTIAL,25996,0,25996,90565,0,116561
132612902100000,NW 329,RESIDENTIAL,25349,0,25349,95844,0,121193
132612902200000,NW 329,RESIDENTIAL,24827,0,24827,89415,0,114242
132612902300000,NW 329,RESIDENTIAL,24832,0,24832,87999,0,112831
132612902400000,NW 329,RESIDENTIAL,24576,0,24576,94658,0,119234
132612902500000,NW 329,RESIDENTIAL,24700,0,24700,94504,0,119204
132612902600000,NW 329,RESIDENTIAL,24440,0,24440,100518,0,124958
132612902700000,NW 329,RESIDENTIAL,24440,0,24440,93717,0,118157
132612902800000,NW 329,RESIDENTIAL,24584,0,24584,89477,0,114061
132612902900000,NW 329,RESIDENTIAL,24064,0,24064,88821,0,112885
132612903000000,NW 329,RESIDENTIAL,24816,0,24816,82959,0,107775
132613000100000,NW 329,RESIDENTIAL,25802,0,25802,109880,0,135682
132613000200000,NW 329,RESIDENTIAL,23280,0,23280,91292,0,114572
132613000300000,NW 329,RESIDENTIAL,25986,0,25986,91385,0,117371
132613000400000,NW 329,RESIDENTIAL,24816,0,24816,87581,0,112397
132613000500000,NW 329,RESIDENTIAL,24064,0,24064,80621,0,104685
132613000600000,NW 329,RESIDENTIAL,24064,0,24064,92608,0,116672
132613000700000,NW 329,RESIDENTIAL,24064,0,24064,95821,0,119885
132613000800000,NW 329,RESIDENTIAL,24064,0,24064,90378,0,114442
132613000900000,NW 329,RESIDENTIAL,24960,0,24960,88021,0,112981
132613001000000,NW 329,RESIDENTIAL,24960,0,24960,83186,0,108146
132613001100000,NW 329,RESIDENTIAL,25480,0,25480,88665,0,114145
132613001200000,NW 329,RESIDENTIAL,24970,0,24970,82675,0,107645
132613001300000,NW 329,RESIDENTIAL,25088,0,25088,81822,0,106910
132613001400000,NW 329,RESIDENTIAL,24901,0,24901,97322,0,122223
132613001500000,NW 329,RESIDENTIAL,26097,0,26097,81668,0,107765
132613001600000,NW 329,RESIDENTIAL,25951,0,25951,84447,0,110398
132613001700000,NW 329,RESIDENTIAL,22560,0,22560,84866,0,107426
132613001800000,NW 329,RESIDENTIAL,25525,0,25525,93556,0,119081
132613001900000,NW 329,RESIDENTIAL,24892,0,24892,87260,0,112152
132613002000000,NW 329,RESIDENTIAL,25212,0,25212,97155,0,122367
132613002100000,NW 329,RESIDENTIAL,25852,0,25852,99148,0,125000
132613002200000,NW 329,RESIDENTIAL,25088,0,25088,102274,0,127362
132613002300000,NW 329,RESIDENTIAL,24832,0,24832,92100,0,116932
132613002400000,NW 329,RESIDENTIAL,25220,0,25220,94434,0,119654
132613002500000,NW 329,RESIDENTIAL,25088,0,25088,99372,0,124460
132613002600000,NW 329,RESIDENTIAL,24816,0,24816,86439,0,111255
132613002700000,NW 329,RESIDENTIAL,24189,0,24189,84863,0,109052
132613002800000,NW 329,RESIDENTIAL,24189,0,24189,96754,0,120943
132613002900000,NW 329,RESIDENTIAL,24064,0,24064,87705,0,111769
132613003000000,NW 329,RESIDENTIAL,24816,0,24816,84487,0,109303
132613100100000,NW 329,RESIDENTIAL,25802,0,25802,73534,0,99336
132613100200000,NW 329,RESIDENTIAL,23280,0,23280,91898,0,115178
132613100300000,NW 329,RESIDENTIAL,25894,0,25894,82283,0,108177
132613100400000,NW 329,RESIDENTIAL,24816,0,24816,95760,0,120576
132613100500000,NW 329,RESIDENTIAL,24064,0,24064,92171,0,116235
132613100600000,NW 329,RESIDENTIAL,24064,0,24064,87743,0,111807
132613100700000,NW 329,RESIDENTIAL,24064,0,24064,83613,0,107677
132613100800000,NW 329,RESIDENTIAL,24064,0,24064,93423,0,117487
132613100900000,NW 329,RESIDENTIAL,24064,0,24064,88449,0,112513
132613101000000,NW 329,RESIDENTIAL,24915,0,24915,108555,0,133470
132613101100000,NW 329,RESIDENTIAL,24573,0,24573,76531,0,101104
132613101200000,NW 329,RESIDENTIAL,26136,0,26136,101542,0,127678
132613101300000,NW 329,RESIDENTIAL,26568,0,26568,88911,0,115479
132613101400000,NW 329,RESIDENTIAL,26160,0,26160,103662,0,129822
132613101500000,NW 329,RESIDENTIAL,26334,0,26334,98363,0,124697
132613101600000,NW 329,RESIDENTIAL,28608,0,28608,89331,0,117939
132613101700000,NW 329,RESIDENTIAL,25802,0,25802,95614,0,121416
132613101800000,NW 329,RESIDENTIAL,25792,0,25792,91116,0,116908
132613101900000,NW 329,RESIDENTIAL,25412,0,25412,89777,0,115189
132613102000000,NW 329,RESIDENTIAL,28348,0,28348,103680,0,132028
132613102100000,NW 329,RESIDENTIAL,25349,0,25349,97876,0,123225
132613102200000,NW 329,RESIDENTIAL,25681,0,25681,98180,0,123861
132613102300000,NW 329,RESIDENTIAL,25452,0,25452,85033,0,110485
132613102400000,NW 329,RESIDENTIAL,25740,0,25740,87410,0,113150
132613102500000,NW 329,RESIDENTIAL,24960,0,24960,90970,0,115930
132613102600000,NW 329,RESIDENTIAL,24700,0,24700,85429,0,110129
132613102700000,NW 329,RESIDENTIAL,24410,0,24410,98019,0,122429
132613102800000,NW 329,RESIDENTIAL,24133,0,24133,105670,0,129803
132613102900000,NW 329,RESIDENTIAL,24064,0,24064,92820,0,116884
132613103000000,NW 329,RESIDENTIAL,24064,0,24064,88360,0,112424
132613103100000,NW 329,RESIDENTIAL,24064,0,24064,93590,0,117654
132613103200000,NW 329,RESIDENTIAL,24816,0,24816,83859,0,108675
132613200100000,NW 329,RESIDENTIAL,26190,0,26190,94648,0,120838
132613200200000,NW 329,RESIDENTIAL,23280,0,23280,89831,0,113111
132613200300000,NW 329,RESIDENTIAL,25876,0,25876,93894,0,119770
132613200400000,NW 329,RESIDENTIAL,25080,0,25080,91925,0,117005
132613200500000,NW 329,RESIDENTIAL,24320,0,24320,96214,0,120534
132613200600000,NW 329,RESIDENTIAL,24320,0,24320,90502,0,114822
132613200700000,NW 329,RESIDENTIAL,24320,0,24320,82686,0,107006
132613200800000,NW 329,RESIDENTIAL,23180,0,23180,85700,0,108880
132613200900000,NW 329,RESIDENTIAL,22800,0,22800,98190,0,120990
132613201000000,NW 329,RESIDENTIAL,22971,0,22971,82201,0,105172
132613201100000,NW 329,RESIDENTIAL,28765,0,28765,94103,0,122868
132613201200000,NW 329,RESIDENTIAL,25536,0,25536,80301,0,105837
132613201300000,NW 329,RESIDENTIAL,24448,0,24448,96658,0,121106
132613201400000,NW 329,RESIDENTIAL,23533,0,23533,99915,0,123448
132613201500000,NW 329,RESIDENTIAL,24576,0,24576,95994,0,120570
132613201600000,NW 329,RESIDENTIAL,24576,0,24576,98225,0,122801
132613201700000,NW 329,RESIDENTIAL,24576,0,24576,95327,0,119903
132613201800000,NW 329,RESIDENTIAL,24576,0,24576,97093,0,121669
132613201900000,NW 329,RESIDENTIAL,24576,0,24576,96069,0,120645
132613202000000,NW 329,RESIDENTIAL,25344,0,25344,97064,0,122408
132613300100000,NW 329,RESIDENTIAL,28106,0,28106,95796,0,123902
132613300200000,NW 329,RESIDENTIAL,26093,0,26093,115081,0,141174
132613300300000,NW 329,RESIDENTIAL,25840,0,25840,88901,0,114741
132613300400000,NW 329,RESIDENTIAL,26316,0,26316,89876,0,116192
132613300500000,NW 329,RESIDENTIAL,25080,0,25080,103945,0,129025
132615100100000,NW 329,RESIDENTIAL,22560,0,22560,83622,0,106182
132615100200000,NW 329,RESIDENTIAL,25568,0,25568,89491,0,115059
132615100300000,NW 329,RESIDENTIAL,23280,0,23280,96293,0,119573
132615100400000,NW 329,RESIDENTIAL,23383,0,23383,84662,0,108045
132615100500000,NW 329,RESIDENTIAL,23411,0,23411,71812,0,95223
132615100600000,NW 329,RESIDENTIAL,22861,0,22861,79557,0,102418
132615100700000,NW 329,RESIDENTIAL,22936,0,22936,93270,0,116206
132615100800000,NW 329,RESIDENTIAL,22861,0,22861,99389,0,122250
132615100900000,NW 329,RESIDENTIAL,23475,0,23475,86963,0,110438
132615101000000,NW 329,RESIDENTIAL,24420,0,24420,86258,0,110678
132615101100000,NW 329,RESIDENTIAL,25432,0,25432,86170,0,111602
132615101200000,NW 329,RESIDENTIAL,25237,0,25237,81055,0,106292
132615101300000,NW 329,RESIDENTIAL,27784,0,27784,103348,0,131132
132615101400000,NW 329,RESIDENTIAL,22927,0,22927,93366,0,116293
132615101500000,NW 329,RESIDENTIAL,23053,0,23053,86132,0,109185
132615101600000,NW 329,RESIDENTIAL,22927,0,22927,85144,0,108071
132615101700000,NW 329,RESIDENTIAL,27172,0,27172,91534,0,118706
132615101800000,NW 329,RESIDENTIAL,23120,0,23120,107499,0,130619
132615101900000,NW 329,RESIDENTIAL,23851,0,23851,90675,0,114526
132615102000000,NW 329,RESIDENTIAL,23163,0,23163,75463,0,98626
132615102100000,NW 329,RESIDENTIAL,22704,0,22704,85535,0,108239
132615102200000,NW 329,RESIDENTIAL,24304,0,24304,91114,0,115418
132615102300000,NW 329,RESIDENTIAL,25480,0,25480,95064,0,120544
132615102400000,NW 329,RESIDENTIAL,24696,0,24696,78459,0,103155
132615200100000,NW 329,RESIDENTIAL,32340,0,32340,103557,0,135897
132615200200000,NW 329,RESIDENTIAL,32340,0,32340,112415,0,144755
132615200300000,NW 329,RESIDENTIAL,23875,0,23875,99452,0,123327
132615200400000,NW 329,RESIDENTIAL,26240,0,26240,85892,0,112132
132615200500000,NW 329,RESIDENTIAL,22184,0,22184,79364,0,101548
132615200600000,NW 329,RESIDENTIAL,22171,0,22171,92159,0,114330
132615200700000,NW 329,RESIDENTIAL,24315,0,24315,87958,0,112273
132615200800000,NW 329,RESIDENTIAL,26813,0,26813,93463,0,120276
132615200900000,NW 329,RESIDENTIAL,23760,0,23760,78448,0,102208
132615201000000,NW 329,RESIDENTIAL,28745,0,28745,102774,0,131519
132615201100000,NW 329,RESIDENTIAL,26525,0,26525,94170,0,120695
132615201200000,NW 329,RESIDENTIAL,23760,0,23760,72030,0,95790
132615201300000,NW 329,RESIDENTIAL,24400,0,24400,81633,0,106033
132615201400000,NW 329,RESIDENTIAL,24400,0,24400,90382,0,114782
132615201500000,NW 329,RESIDENTIAL,24043,0,24043,99621,0,123664
132615201600000,NW 329,RESIDENTIAL,24043,0,24043,115391,0,139434
132615201700000,NW 329,RESIDENTIAL,25142,0,25142,86397,0,111539
132615300100000,NW 329,RESIDENTIAL,26384,0,26384,100294,0,126678
132615300200000,NW 329,RESIDENTIAL,24365,0,24365,91942,0,116307
132615300300000,NW 329,RESIDENTIAL,22560,0,22560,77559,0,100119
132615300400000,NW 329,RESIDENTIAL,23280,0,23280,86738,0,110018
132615300500000,NW 329,RESIDENTIAL,23760,0,23760,94414,0,118174
132615300600000,NW 329,RESIDENTIAL,23520,0,23520,96681,0,120201
132615300700000,NW 329,RESIDENTIAL,23280,0,23280,87726,0,111006
132615300800000,NW 329,RESIDENTIAL,23040,0,23040,92557,0,115597
132615300900000,NW 329,RESIDENTIAL,23808,0,23808,98284,0,122092
132615301000000,NW 329,RESIDENTIAL,26957,0,26957,94356,0,121313
132615301100000,NW 329,RESIDENTIAL,26957,0,26957,102149,0,129106
132615301200000,NW 329,RESIDENTIAL,23598,0,23598,95132,0,118730
132615301300000,NW 329,RESIDENTIAL,22400,0,22400,95207,0,117607
132615301400000,NW 329,RESIDENTIAL,22763,0,22763,95894,0,118657
132615301500000,NW 329,RESIDENTIAL,23971,0,23971,84064,0,108035
132615301600000,NW 329,RESIDENTIAL,24960,0,24960,89470,0,114430
132615301700000,NW 329,RESIDENTIAL,23971,0,23971,95957,0,119928
132615301800000,NW 329,RESIDENTIAL,24133,0,24133,90598,0,114731
132615301900000,NW 329,RESIDENTIAL,31693,0,31693,102271,0,133964
132615302000000,NW 329,RESIDENTIAL,26982,0,26982,96853,0,123835
132615302100000,NW 329,RESIDENTIAL,25452,0,25452,98479,0,123931
132615302200000,NW 329,RESIDENTIAL,22933,0,22933,90792,0,113725
132615302300000,NW 329,RESIDENTIAL,23280,0,23280,104434,0,127714
132615302400000,NW 329,RESIDENTIAL,24056,0,24056,112249,0,136305
132615400100000,NW 329,RESIDENTIAL,22811,0,22811,101567,0,124378
132615400200000,NW 329,RESIDENTIAL,24440,0,24440,102411,0,126851
132615400300000,NW 329,RESIDENTIAL,24440,0,24440,111988,0,136428
132615400400000,NW 329,RESIDENTIAL,22560,0,22560,90951,0,113511
132615400500000,NW 329,RESIDENTIAL,22560,0,22560,91866,0,114426
132615400600000,NW 329,RESIDENTIAL,22560,0,22560,102952,0,125512
132615400700000,NW 329,RESIDENTIAL,22560,0,22560,99984,0,122544
132615400800000,NW 329,RESIDENTIAL,25568,0,25568,95861,0,121429
132615500100000,NW 329,RESIDENTIAL,26090,0,26090,88784,0,114874
132615500200000,NW 329,RESIDENTIAL,25476,0,25476,88515,0,113991
132615500300000,NW 329,RESIDENTIAL,23364,0,23364,88824,0,112188
132615500400000,NW 329,RESIDENTIAL,24105,0,24105,98866,0,122971
132615500500000,NW 329,RESIDENTIAL,25099,0,25099,97258,0,122357
132615500600000,NW 329,RESIDENTIAL,25920,0,25920,79296,0,105216
132615500700000,NW 329,RESIDENTIAL,25680,0,25680,82206,0,107886
132615500800000,NW 329,RESIDENTIAL,23800,0,23800,104700,0,128500
132615500900000,NW 329,RESIDENTIAL,23067,0,23067,83809,0,106876
132615501000000,NW 329,RESIDENTIAL,21780,0,21780,97419,0,119199
132615501100000,NW 329,RESIDENTIAL,23520,0,23520,86221,0,109741
132615501200000,NW 329,RESIDENTIAL,23280,0,23280,78291,0,101571
132615501300000,NW 329,RESIDENTIAL,23040,0,23040,87018,0,110058
132615501400000,NW 329,RESIDENTIAL,23680,0,23680,85074,0,108754
132615501500000,NW 329,RESIDENTIAL,23267,0,23267,76764,0,100031
132615501600000,NW 329,RESIDENTIAL,23520,0,23520,84161,0,107681
132615501700000,NW 329,RESIDENTIAL,23520,0,23520,90260,0,113780
132615501800000,NW 329,RESIDENTIAL,23280,0,23280,80818,0,104098
132615501900000,NW 329,RESIDENTIAL,23409,0,23409,90868,0,114277
132615502000000,NW 329,RESIDENTIAL,23168,0,23168,90002,0,113170
132615502100000,NW 329,RESIDENTIAL,24320,0,24320,93711,0,118031
132615502200000,NW 329,RESIDENTIAL,26957,0,26957,88214,0,115171
132615502300000,NW 329,RESIDENTIAL,26980,0,26980,90029,0,117009
132615502400000,NW 329,RESIDENTIAL,24742,0,24742,97647,0,122389
132615502500000,NW 329,RESIDENTIAL,23936,0,23936,89876,0,113812
132615502600000,NW 329,RESIDENTIAL,23808,0,23808,93740,0,117548
132615502700000,NW 329,RESIDENTIAL,23808,0,23808,89615,0,113423
132615502800000,NW 329,RESIDENTIAL,23808,0,23808,101985,0,125793
132615502900000,NW 329,RESIDENTIAL,23424,0,23424,91281,0,114705
132615503000000,NW 329,RESIDENTIAL,23040,0,23040,104049,0,127089
132615503100000,NW 329,RESIDENTIAL,23205,0,23205,93135,0,116340
132615503200000,NW 329,RESIDENTIAL,22560,0,22560,91198,0,113758
132615503300000,NW 329,RESIDENTIAL,23168,0,23168,92894,0,116062
132615503400000,NW 329,RESIDENTIAL,23781,0,23781,97168,0,120949
132615503500000,NW 329,RESIDENTIAL,24133,0,24133,91490,0,115623
132615503600000,NW 329,RESIDENTIAL,25376,0,25376,82343,0,107719
132615503700000,NW 329,RESIDENTIAL,29798,0,29798,85268,0,115066
132615503800000,NW 329,RESIDENTIAL,26615,0,26615,92333,0,118948
132615503900000,NW 329,RESIDENTIAL,24819,0,24819,88682,0,113501
132615504000000,NW 329,RESIDENTIAL,23540,0,23540,105204,0,128744
132615504100000,NW 329,RESIDENTIAL,22800,0,22800,96334,0,119134
132615504200000,NW 329,RESIDENTIAL,22475,0,22475,95387,0,117862
132615504300000,NW 329,RESIDENTIAL,22527,0,22527,93877,0,116404
132615504400000,NW 329,RESIDENTIAL,25376,0,25376,87734,0,113110
132615504500000,NW 329,RESIDENTIAL,22573,0,22573,97152,0,119725
132615600100000,CHURCH,EXEMPT,0,58374,58374,0,981779,1040153
132615600200000,NW 329,RESIDENTIAL,23194,0,23194,98489,0,121683
132615600300000,NW 329,RESIDENTIAL,23898,0,23898,85009,0,108907
132615600400000,NW 329,RESIDENTIAL,23552,0,23552,89958,0,113510
132615600500000,NW 329,RESIDENTIAL,23923,0,23923,92636,0,116559
132615600600000,NW 329,RESIDENTIAL,24315,0,24315,105856,0,130171
132615600700000,NW 329,RESIDENTIAL,27234,0,27234,105163,0,132397
132615600800000,NW 329,RESIDENTIAL,23437,0,23437,101699,0,125136
132615600900000,NW 329,RESIDENTIAL,28231,0,28231,127432,0,155663
132615601000000,NW 329,RESIDENTIAL,26023,0,26023,84085,0,110108
132615601100000,NW 329,RESIDENTIAL,22784,0,22784,93909,0,116693
132615601200000,NW 329,RESIDENTIAL,22810,0,22810,89266,0,112076
132615601300000,NW 329,RESIDENTIAL,22784,0,22784,109098,0,131882
132615601400000,NW 329,RESIDENTIAL,21888,0,21888,92329,0,114217
132615601500000,NW 329,RESIDENTIAL,22736,0,22736,91701,0,114437
132615601600000,NW 329,RESIDENTIAL,23258,0,23258,91285,0,114543
132615700100000,NW 329,RESIDENTIAL,27719,0,27719,94236,0,121955
132615700200000,NW 329,RESIDENTIAL,23552,0,23552,105427,0,128979
132615700300000,NW 329,RESIDENTIAL,25568,0,25568,110021,0,135589
132615700400000,NW 329,RESIDENTIAL,27360,0,27360,83898,0,111258
132615700500000,NW 329,RESIDENTIAL,26835,0,26835,103986,0,130821
132615700600000,NW 329,RESIDENTIAL,26004,0,26004,86848,0,112852
132615700700000,NW 329,RESIDENTIAL,23788,0,23788,92525,0,116313
132615700800000,NW 329,RESIDENTIAL,24327,0,24327,93177,0,117504
132615700900000,NW 329,RESIDENTIAL,27454,0,27454,91635,0,119089
132615701000000,NW 329,RESIDENTIAL,27749,0,27749,104143,0,131892
132615701100000,NW 329,RESIDENTIAL,26334,0,26334,101945,0,128279
132615701200000,NW 329,RESIDENTIAL,24185,0,24185,86554,0,110739
132615701300000,NW 329,RESIDENTIAL,23651,0,23651,83907,0,107558
132615701400000,NW 329,RESIDENTIAL,24304,0,24304,89756,0,114060
132615701500000,NW 329,RESIDENTIAL,24800,0,24800,85781,0,110581
132615800100000,NW 329,RESIDENTIAL,25920,0,25920,99725,0,125645
132615800200000,NW 329,RESIDENTIAL,22784,0,22784,90666,0,113450
132615800300000,NW 329,RESIDENTIAL,23040,0,23040,89313,0,112353
132615800400000,NW 329,RESIDENTIAL,23520,0,23520,95535,0,119055
132615800500000,NW 329,RESIDENTIAL,24240,0,24240,84777,0,109017
132615800600000,NW 329,RESIDENTIAL,24960,0,24960,93781,0,118741
132615800700000,NW 329,RESIDENTIAL,25440,0,25440,79189,0,104629
132615800800000,NW 329,RESIDENTIAL,25440,0,25440,93267,0,118707
132615800900000,NW 329,RESIDENTIAL,24960,0,24960,100688,0,125648
132615801000000,NW 329,RESIDENTIAL,23760,0,23760,89503,0,113263
132615801100000,NW 329,RESIDENTIAL,23040,0,23040,99100,0,122140
132615801200000,NW 329,RESIDENTIAL,25568,0,25568,100435,0,126003
132615900100000,NW 329,RESIDENTIAL,25568,0,25568,86257,0,111825
132615900200000,NW 329,RESIDENTIAL,22560,0,22560,103037,0,125597
132615900300000,NW 329,RESIDENTIAL,22560,0,22560,81514,0,104074
132615900400000,NW 329,RESIDENTIAL,23280,0,23280,97199,0,120479
132615900500000,NW 329,RESIDENTIAL,24832,0,24832,92019,0,116851
132615900600000,NW 329,RESIDENTIAL,26585,0,26585,101549,0,128134
132615900700000,NW 329,RESIDENTIAL,26068,0,26068,97071,0,123139
132615900800000,NW 329,RESIDENTIAL,23296,0,23296,89274,0,112570
132617600100000,NW 329,RESIDENTIAL,28160,0,28160,83796,0,111956
132617600200000,NW 329,RESIDENTIAL,29184,0,29184,69016,0,98200
132617700100000,NW 329,RESIDENTIAL,25443,0,25443,86385,0,111828
132617700200000,NW 329,RESIDENTIAL,24440,0,24440,66426,0,90866
132617700300000,NW 329,RESIDENTIAL,25793,0,25793,96044,0,121837
132617700400000,NW 329,RESIDENTIAL,26880,0,26880,95983,0,122863
132617700500000,NW 329,RESIDENTIAL,27360,0,27360,88669,0,116029
132617700600000,NW 329,RESIDENTIAL,27044,0,27044,94830,0,121874
132617700700000,NW 329,RESIDENTIAL,24960,0,24960,83829,0,108789
132617700800000,NW 329,RESIDENTIAL,26017,0,26017,89449,0,115466
132617700900000,NW 329,RESIDENTIAL,23808,0,23808,83217,0,107025
132617701000000,NW 329,RESIDENTIAL,26320,0,26320,94169,0,120489
132617701100000,NW 329,RESIDENTIAL,26320,0,26320,75095,0,101415
132617701200000,NW 329,RESIDENTIAL,25925,0,25925,76759,0,102684
132617701300000,NW 329,RESIDENTIAL,25571,0,25571,76087,0,101658
132617701400000,NW 329,RESIDENTIAL,25269,0,25269,81230,0,106499
132617701500000,NW 329,RESIDENTIAL,24586,0,24586,73827,0,98413
132617701600000,NW 329,RESIDENTIAL,25967,0,25967,89433,0,115400
132617800100000,NW 329,RESIDENTIAL,27044,0,27044,79447,0,106491
132617800200000,NW 329,RESIDENTIAL,23808,0,23808,92037,0,115845
132617800300000,NW 329,RESIDENTIAL,23187,0,23187,70406,0,93593
132617800400000,NW 329,RESIDENTIAL,24417,0,24417,77159,0,101576
132617800500000,NW 329,RESIDENTIAL,26676,0,26676,82253,0,108929
132617800600000,NW 329,RESIDENTIAL,27211,0,27211,73492,0,100703
132617900100000,NW 329,RESIDENTIAL,26835,0,26835,90682,0,117517
132617900200000,NW 329,RESIDENTIAL,26474,0,26474,79135,0,105609
132617900300000,NW 329,RESIDENTIAL,27333,0,27333,87671,0,115004
132617900400000,NW 329,RESIDENTIAL,26656,0,26656,78285,0,104941
132617900500000,NW 329,RESIDENTIAL,25984,0,25984,87316,0,113300
132617900600000,NW 329,RESIDENTIAL,25443,0,25443,103104,0,128547
132617900700000,NW 329,RESIDENTIAL,25445,0,25445,81706,0,107151
132618000100000,NW 329,RESIDENTIAL,25568,0,25568,70940,0,96508
132618000200000,NW 329,RESIDENTIAL,23520,0,23520,98747,0,122267
132618000300000,NW 329,RESIDENTIAL,24185,0,24185,95164,0,119349
132618000400000,NW 329,RESIDENTIAL,24435,0,24435,75816,0,100251
132618000500000,NW 329,RESIDENTIAL,24435,0,24435,77032,0,101467
132618100100000,NW 329,RESIDENTIAL,29297,0,29297,102654,0,131951
132618200100000,NW 329,RESIDENTIAL,24440,0,24440,91232,0,115672
132618200200000,NW 329,RESIDENTIAL,25344,0,25344,84976,0,110320
132618200300000,NW 329,RESIDENTIAL,24256,0,24256,97978,0,122234
132618200400000,NW 329,RESIDENTIAL,23813,0,23813,92105,0,115918
132618200500000,NW 329,RESIDENTIAL,24067,0,24067,89790,0,113857
132618200600000,NW 329,RESIDENTIAL,25856,0,25856,84526,0,110382
132618200700000,NW 329,RESIDENTIAL,23168,0,23168,87405,0,110573
132618200800000,NW 329,RESIDENTIAL,23813,0,23813,106043,0,129856
132618200900000,NW 329,RESIDENTIAL,23813,0,23813,88632,0,112445
132618201000000,NW 329,RESIDENTIAL,25587,0,25587,102381,0,127968
132618201100000,NW 329,RESIDENTIAL,22927,0,22927,81445,0,104372
132618201200000,NW 329,RESIDENTIAL,23813,0,23813,69146,0,92959
132618201300000,NW 329,RESIDENTIAL,23813,0,23813,78980,0,102793
132618201400000,NW 329,RESIDENTIAL,25879,0,25879,1234,0,27113
132618201500000,NW 329,RESIDENTIAL,24067,0,24067,85794,0,109861
132618201600000,NW 329,RESIDENTIAL,22927,0,22927,78803,0,101730
132618201700000,NW 329,RESIDENTIAL,25523,0,25523,87820,0,113343
132618201800000,NW 329,RESIDENTIAL,25658,0,25658,147124,0,172782
132618201900000,NW 329,RESIDENTIAL,26112,0,26112,105407,0,131519
132618202000000,NW 329,RESIDENTIAL,24960,0,24960,96253,0,121213
132618202100000,NW 329,RESIDENTIAL,25220,0,25220,102547,0,127767
132618202200000,NW 329,RESIDENTIAL,26513,0,26513,95887,0,122400
132618202300000,NW 329,RESIDENTIAL,24960,0,24960,85963,0,110923
132618202400000,NW 329,RESIDENTIAL,24960,0,24960,88924,0,113884
132618202500000,NW 329,RESIDENTIAL,25996,0,25996,87663,0,113659
132618202600000,NW 329,RESIDENTIAL,24832,0,24832,95860,0,120692
132618202700000,NW 329,RESIDENTIAL,24700,0,24700,65942,0,90642
132618202800000,NW 329,RESIDENTIAL,25587,0,25587,97086,0,122673
132618202900000,NW 329,RESIDENTIAL,24953,0,24953,94299,0,119252
132618203000000,NW 329,RESIDENTIAL,24189,0,24189,87056,0,111245
132618203100000,NW 329,RESIDENTIAL,23949,0,23949,89854,0,113803
132618203200000,NW 329,RESIDENTIAL,25004,0,25004,82578,0,107582
132618300100000,NW 329,RESIDENTIAL,29356,0,29356,80571,0,109927
132618300200000,NW 329,RESIDENTIAL,24269,0,24269,102903,0,127172
132618300300000,NW 329,RESIDENTIAL,24440,0,24440,95055,0,119495
132618300400000,NW 329,RESIDENTIAL,24180,0,24180,94072,0,118252
132618300500000,NW 329,RESIDENTIAL,22415,0,22415,90010,0,112425
132618300600000,NW 329,RESIDENTIAL,23061,0,23061,93448,0,116509
132618300700000,NW 329,RESIDENTIAL,23940,0,23940,90170,0,114110
132618301500000,NW 329,RESIDENTIAL,26257,0,26257,88512,0,114769
132618301600000,NW 329,RESIDENTIAL,22272,0,22272,81205,0,103477
132618301700000,NW 329,RESIDENTIAL,22272,0,22272,86049,0,108321
132618301800000,NW 329,RESIDENTIAL,23048,0,23048,82392,0,105440
132618301900000,NW 329,RESIDENTIAL,22400,0,22400,83630,0,106030
132618302000000,NW 329,RESIDENTIAL,23680,0,23680,95834,0,119514
132618302100000,NW 329,RESIDENTIAL,22336,0,22336,89942,0,112278
132618302200000,NW 329,RESIDENTIAL,23462,0,23462,81016,0,104478
132618302300000,NW 329,RESIDENTIAL,24576,0,24576,95603,0,120179
132618302400000,NW 329,RESIDENTIAL,24704,0,24704,83180,0,107884
132618302500000,NW 329,RESIDENTIAL,23280,0,23280,83935,0,107215
132618302600000,NW 329,RESIDENTIAL,23520,0,23520,89789,0,113309
132618302700000,NW 329,RESIDENTIAL,26164,0,26164,78919,0,105083
132618302800000,NW 329,RESIDENTIAL,28258,0,28258,100967,0,129225
132618400100000,NW 329,RESIDENTIAL,25004,0,25004,69486,0,94490
132618400200000,NW 329,RESIDENTIAL,24051,0,24051,91793,0,115844
132618400300000,NW 329,RESIDENTIAL,26112,0,26112,79637,0,105749
132618400400000,NW 329,RESIDENTIAL,24832,0,24832,76123,0,100955
132618400500000,NW 329,RESIDENTIAL,26112,0,26112,75374,0,101486
132618400600000,NW 329,RESIDENTIAL,25840,0,25840,91047,0,116887
132618400700000,NW 329,RESIDENTIAL,25840,0,25840,97857,0,123697
132618400800000,NW 329,RESIDENTIAL,26112,0,26112,85177,0,111289
132618400900000,NW 329,RESIDENTIAL,24576,0,24576,85160,0,109736
132618401000000,NW 329,RESIDENTIAL,25568,0,25568,82467,0,108035
132618401100000,NW 329,RESIDENTIAL,25967,0,25967,96544,0,122511
132618401200000,NW 329,RESIDENTIAL,26112,0,26112,86415,0,112527
132618401300000,NW 329,RESIDENTIAL,26112,0,26112,92433,0,118545
132618401400000,NW 329,RESIDENTIAL,25805,0,25805,80628,0,106433
132618500100000,NW 329,RESIDENTIAL,26076,0,26076,87483,0,113559
132618500200000,NW 329,RESIDENTIAL,23590,0,23590,89828,0,113418
132618500300000,NW 329,RESIDENTIAL,24440,0,24440,103539,0,127979
132618500400000,NW 329,RESIDENTIAL,26689,0,26689,85097,0,111786
132618500500000,NW 329,RESIDENTIAL,25587,0,25587,81361,0,106948
132618500600000,NW 329,RESIDENTIAL,24684,0,24684,102650,0,127334
132618500700000,NW 329,RESIDENTIAL,24552,0,24552,81806,0,106358
132618500800000,NW 329,RESIDENTIAL,26624,0,26624,65424,0,92048
132618500900000,NW 329,RESIDENTIAL,26073,0,26073,82663,0,108736
132618501000000,NW 329,RESIDENTIAL,26216,0,26216,68262,0,94478
132618501100000,NW 329,RESIDENTIAL,26216,0,26216,93933,0,120149
132618501200000,NW 329,RESIDENTIAL,25579,0,25579,88104,0,113683
132618501300000,NW 329,RESIDENTIAL,23940,0,23940,82904,0,106844
132618501400000,NW 329,RESIDENTIAL,24576,0,24576,78341,0,102917
132618501500000,NW 329,RESIDENTIAL,25507,0,25507,88709,0,114216
132618501600000,NW 329,RESIDENTIAL,23187,0,23187,91833,0,115020
132618501700000,NW 329,RESIDENTIAL,24360,0,24360,100007,0,124367
132618501800000,NW 329,RESIDENTIAL,25984,0,25984,100078,0,126062
132618501900000,NW 329,RESIDENTIAL,27032,0,27032,102097,0,129129
132618502000000,NW 329,RESIDENTIAL,26143,0,26143,97174,0,123317
132618502100000,NW 329,RESIDENTIAL,24696,0,24696,91915,0,116611
132618502200000,NW 329,RESIDENTIAL,26460,0,26460,98709,0,125169
132618502300000,NW 329,RESIDENTIAL,26712,0,26712,93003,0,119715
132618502400000,NW 329,RESIDENTIAL,25704,0,25704,102359,0,128063
132618502500000,NW 329,RESIDENTIAL,24948,0,24948,96904,0,121852
132618502600000,NW 329,RESIDENTIAL,24192,0,24192,86388,0,110580
132618502700000,NW 329,RESIDENTIAL,24192,0,24192,114896,0,139088
132618502800000,NW 329,RESIDENTIAL,23808,0,23808,96777,0,120585
132618502900000,NW 329,RESIDENTIAL,26854,0,26854,102115,0,128969
132618503000000,NW 329,RESIDENTIAL,27064,0,27064,95589,0,122653
132618503100000,NW 329,RESIDENTIAL,24288,0,24288,94370,0,118658
132618503200000,NW 329,RESIDENTIAL,26266,0,26266,92154,0,118420
132618503300000,CHURCH,EXEMPT,0,41364,41364,0,517824,559188
132618503400000,NW 329,RESIDENTIAL,26928,0,26928,75619,0,102547
132618503500000,NW 329,RESIDENTIAL,26074,0,26074,78391,0,104465
132618503600000,NW 329,RESIDENTIAL,27581,0,27581,70097,0,97678
132618503700000,NW 329,RESIDENTIAL,29270,0,29270,76263,0,105533
132618600100000,NW 329,RESIDENTIAL,25355,0,25355,94281,0,119636
132618600200000,NW 329,RESIDENTIAL,23424,0,23424,89111,0,112535
132618600300000,NW 329,RESIDENTIAL,26384,0,26384,91295,0,117679
132618600400000,NW 329,RESIDENTIAL,24056,0,24056,99025,0,123081
132618600500000,NW 329,RESIDENTIAL,24056,0,24056,95982,0,120038
132618600600000,NW 329,RESIDENTIAL,24056,0,24056,97638,0,121694
132618600700000,NW 329,RESIDENTIAL,24056,0,24056,100043,0,124099
132618600800000,NW 329,RESIDENTIAL,25408,0,25408,97347,0,122755
132618600900000,NW 329,RESIDENTIAL,22936,0,22936,69156,0,92092
132618601000000,NW 329,RESIDENTIAL,25333,0,25333,95855,0,121188
132618601100000,NW 329,RESIDENTIAL,24056,0,24056,99991,0,124047
132618601200000,NW 329,RESIDENTIAL,24056,0,24056,96509,0,120565
132618601300000,NW 329,RESIDENTIAL,24056,0,24056,107282,0,131338
132618601400000,NW 329,RESIDENTIAL,24304,0,24304,101252,0,125556
132618700100000,NW 329,RESIDENTIAL,25318,0,25318,98067,0,123385
132618700200000,NW 329,RESIDENTIAL,22559,0,22559,94714,0,117273
132618700300000,NW 329,RESIDENTIAL,23424,0,23424,94235,0,117659
132618700400000,NW 329,RESIDENTIAL,22272,0,22272,89668,0,111940
132618700500000,NW 329,RESIDENTIAL,22272,0,22272,99555,0,121827
132618700600000,NW 329,RESIDENTIAL,22272,0,22272,85016,0,107288
132618700700000,NW 329,RESIDENTIAL,22272,0,22272,116965,0,139237
132618700800000,NW 329,RESIDENTIAL,23040,0,23040,107994,0,131034
132618700900000,NW 329,RESIDENTIAL,22272,0,22272,101499,0,123771
132618701000000,NW 329,RESIDENTIAL,22272,0,22272,84387,0,106659
132618701100000,NW 329,RESIDENTIAL,22272,0,22272,98127,0,120399
132618701200000,NW 329,RESIDENTIAL,22272,0,22272,94583,0,116855
132618701300000,NW 329,RESIDENTIAL,23040,0,23040,96752,0,119792
132618701400000,NW 329,RESIDENTIAL,23040,0,23040,91961,0,115001
132618701500000,NW 329,RESIDENTIAL,24981,0,24981,104608,0,129589
132620100100000,NW 329,RESIDENTIAL,51968,0,51968,138852,0,190820
132620100500000,NW 329,RESIDENTIAL,835,0,835,0,0,835
132620100600000,NW 329,RESIDENTIAL,29581,0,29581,187157,0,216738
132620100700000,NW 329,RESIDENTIAL,29581,0,29581,184766,0,214347
132620100800000,NW 329,RESIDENTIAL,30520,0,30520,164642,0,195162
132620100900000,NW 329,RESIDENTIAL,30240,0,30240,170107,0,200347
132620101000000,NW 329,RESIDENTIAL,216,0,216,0,0,216
132620101100000,NW 329,RESIDENTIAL,34272,0,34272,150690,0,184962
132620101200000,NW 329,RESIDENTIAL,34560,0,34560,166756,0,201316
132620101300000,NW 329,RESIDENTIAL,32544,0,32544,169080,0,201624
132620101400000,NW 329,RESIDENTIAL,44061,0,44061,151283,0,195344
132620101500000,NW 329,RESIDENTIAL,40333,0,40333,146102,0,186435
132620101600000,NW 329,RESIDENTIAL,31720,0,31720,157934,0,189654
132620101800000,NW 329,RESIDENTIAL,45136,0,45136,150205,0,195341
132620102000000,NW 329,RESIDENTIAL,26667,0,26667,175176,0,201843
132620102100000,NW 329,RESIDENTIAL,40024,0,40024,151468,0,191492
132620200100000,NW 329,RESIDENTIAL,26502,0,26502,82168,0,108670
132620200200000,NW 329,RESIDENTIAL,26000,0,26000,89747,0,115747
132620200300000,NW 329,RESIDENTIAL,24800,0,24800,90261,0,115061
132620200400000,NW 329,RESIDENTIAL,24800,0,24800,84959,0,109759
132620200500000,NW 329,RESIDENTIAL,24800,0,24800,98896,0,123696
132620200600000,NW 329,RESIDENTIAL,24800,0,24800,93227,0,118027
132620200700000,NW 329,RESIDENTIAL,24800,0,24800,75264,0,100064
132620200800000,NW 329,RESIDENTIAL,24800,0,24800,99698,0,124498
132620200900000,NW 329,RESIDENTIAL,24800,0,24800,90968,0,115768
132620201000000,NW 329,RESIDENTIAL,27139,0,27139,97185,0,124324
132620201100000,NW 329,RESIDENTIAL,38360,0,38360,181107,0,219467
132620201200000,NW 329,RESIDENTIAL,35700,0,35700,167616,0,203316
132620201300000,NW 329,RESIDENTIAL,39060,0,39060,153305,0,192365
132620201400000,NW 329,RESIDENTIAL,35700,0,35700,156350,0,192050
132620201500000,NW 329,RESIDENTIAL,35700,0,35700,162922,0,198622
132620201600000,NW 329,RESIDENTIAL,35700,0,35700,182820,0,218520
132620201700000,NW 329,RESIDENTIAL,35700,0,35700,165447,0,201147
132620201800000,NW 329,RESIDENTIAL,36380,0,36380,181640,0,218020
132620201900000,NW 329,RESIDENTIAL,41109,0,41109,173593,0,214702
132620202000000,NW 329,RESIDENTIAL,37924,0,37924,157450,0,195374
132620202100000,NW 329,RESIDENTIAL,41129,0,41129,184027,0,225156
132620202200000,NW 329,RESIDENTIAL,32224,0,32224,162378,0,194602
132620202300000,NW 329,RESIDENTIAL,32648,0,32648,165992,0,198640
132620202400000,NW 329,RESIDENTIAL,32648,0,32648,180395,0,213043
132620202500000,NW 329,RESIDENTIAL,256,0,256,0,0,256
132622600100000,CHURCH,EXEMPT,0,561535,561535,0,3579313,4140848
132625100100000,NW 329,RESIDENTIAL,24520,0,24520,88702,0,113222
132625100300000,NW 329,RESIDENTIAL,26543,0,26543,106898,0,133441
132625100400000,NW 329,RESIDENTIAL,24000,0,24000,93248,0,117248
132625100500000,NW 329,RESIDENTIAL,24000,0,24000,97743,0,121743
132625100600000,NW 329,RESIDENTIAL,21800,0,21800,114172,0,135972
132625100700000,NW 329,RESIDENTIAL,23000,0,23000,91424,0,114424
132625100800000,NW 329,RESIDENTIAL,20800,0,20800,98011,0,118811
132625100900000,NW 329,RESIDENTIAL,24000,0,24000,99914,0,123914
132625101000000,NW 329,RESIDENTIAL,20800,0,20800,114805,0,135605
132625200100000,NW 329,RESIDENTIAL,27075,0,27075,108354,0,135429
132625200200000,NW 329,RESIDENTIAL,31065,0,31065,221896,0,252961
132625200300000,NW 329,RESIDENTIAL,25800,0,25800,108743,0,134543
132625200400000,NW 329,RESIDENTIAL,25800,0,25800,112950,0,138750
132625200500000,NW 329,RESIDENTIAL,25800,0,25800,101791,0,127591
132625200600000,NW 329,RESIDENTIAL,25800,0,25800,95466,0,121266
132625200700000,NW 329,RESIDENTIAL,25800,0,25800,99818,0,125618
132625200800000,NW 329,RESIDENTIAL,25800,0,25800,102766,0,128566
132625200900000,NW 329,RESIDENTIAL,25800,0,25800,110452,0,136252
132625201000000,NW 329,RESIDENTIAL,25800,0,25800,94366,0,120166
132625201100000,NW 329,RESIDENTIAL,25800,0,25800,97390,0,123190
132625201200000,NW 329,RESIDENTIAL,25800,0,25800,100982,0,126782
132625201300000,NW 329,RESIDENTIAL,25800,0,25800,85631,0,111431
132625201400000,NW 329,RESIDENTIAL,25800,0,25800,99790,0,125590
132625201500000,NW 329,RESIDENTIAL,25800,0,25800,87435,0,113235
132625201600000,NW 329,RESIDENTIAL,25800,0,25800,97471,0,123271
132625201700000,NW 329,RESIDENTIAL,25800,0,25800,94202,0,120002
132625201800000,NW 329,RESIDENTIAL,25800,0,25800,102566,0,128366
132625201900000,NW 329,RESIDENTIAL,29726,0,29726,87998,0,117724
132625202000000,NW 329,RESIDENTIAL,23823,0,23823,89262,0,113085
132625202100000,NW 329,RESIDENTIAL,25200,0,25200,106946,0,132146
132625202200000,NW 329,RESIDENTIAL,24000,0,24000,97579,0,121579
132625202300000,NW 329,RESIDENTIAL,25200,0,25200,107239,0,132439
132625202400000,NW 329,RESIDENTIAL,24000,0,24000,89545,0,113545
132625202500000,NW 329,RESIDENTIAL,25600,0,25600,93985,0,119585
132625202600000,NW 329,RESIDENTIAL,24000,0,24000,104100,0,128100
132625202700000,NW 329,RESIDENTIAL,25920,0,25920,103171,0,129091
132627600100000,CITY PROPERTY,EXEMPT,0,0,0,0,0,0
132627600200000,NW 329,RESIDENTIAL,26527,0,26527,101745,0,128272
132627600300000,NW 329,RESIDENTIAL,24440,0,24440,92587,0,117027
132627600400000,NW 329,RESIDENTIAL,24440,0,24440,105074,0,129514
132627600500000,NW 329,RESIDENTIAL,24440,0,24440,99046,0,123486
132627600600000,NW 329,RESIDENTIAL,24440,0,24440,112793,0,137233
132627600700000,NW 329,RESIDENTIAL,24440,0,24440,101858,0,126298
132627700100000,NW 329,RESIDENTIAL,22960,0,22960,103710,0,126670
132627700200000,NW 329,RESIDENTIAL,23200,0,23200,87532,0,110732
132627700300000,NW 329,RESIDENTIAL,23200,0,23200,107675,0,130875
132627700400000,NW 329,RESIDENTIAL,23200,0,23200,81599,0,104799
132627700500000,NW 329,RESIDENTIAL,24320,0,24320,108520,0,132840
132627700600000,NW 329,RESIDENTIAL,24000,0,24000,93760,0,117760
132627700700000,NW 329,RESIDENTIAL,25158,0,25158,104927,0,130085
132627700800000,NW 329,RESIDENTIAL,24082,0,24082,98121,0,122203
132627700900000,NW 329,RESIDENTIAL,22560,0,22560,91359,0,113919
132627701000000,NW 329,RESIDENTIAL,22560,0,22560,108574,0,131134
132627701100000,NW 329,RESIDENTIAL,22560,0,22560,86479,0,109039
132627701200000,NW 329,RESIDENTIAL,23470,0,23470,87376,0,110846
132627701300000,NW 329,RESIDENTIAL,23970,0,23970,111133,0,135103
132627800100000,NW 329,RESIDENTIAL,28829,0,28829,103095,0,131924
132627800200000,NW 329,RESIDENTIAL,26532,0,26532,86525,0,113057
132627800300000,NW 329,RESIDENTIAL,26532,0,26532,94678,0,121210
132627800400000,NW 329,RESIDENTIAL,26532,0,26532,86078,0,112610
132627800500000,NW 329,RESIDENTIAL,26532,0,26532,88203,0,114735
132627800600000,NW 329,RESIDENTIAL,28544,0,28544,105761,0,134305
132627900100000,NW 329,RESIDENTIAL,26527,0,26527,113304,0,139831
132627900200000,NW 329,RESIDENTIAL,24064,0,24064,83913,0,107977
132627900300000,NW 329,RESIDENTIAL,26527,0,26527,97468,0,123995
132627900400000,NW 329,RESIDENTIAL,25344,0,25344,95222,0,120566
132627900500000,NW 329,RESIDENTIAL,25344,0,25344,85825,0,111169
132627900600000,NW 329,RESIDENTIAL,25344,0,25344,86537,0,111881
132627900700000,NW 329,RESIDENTIAL,25344,0,25344,105796,0,131140
132627900800000,NW 329,RESIDENTIAL,25344,0,25344,99206,0,124550
132627900900000,NW 329,RESIDENTIAL,25344,0,25344,105969,0,131313
132627901000000,NW 329,RESIDENTIAL,25344,0,25344,98964,0,124308
132627901100000,NW 329,RESIDENTIAL,25344,0,25344,96785,0,122129
132627901200000,NW 329,RESIDENTIAL,25740,0,25740,118086,0,143826
132627901300000,NW 329,RESIDENTIAL,25463,0,25463,98650,0,124113
132627901400000,NW 329,RESIDENTIAL,25898,0,25898,106373,0,132271
132627901500000,NW 329,RESIDENTIAL,25740,0,25740,82416,0,108156
132627901600000,NW 329,RESIDENTIAL,25344,0,25344,96120,0,121464
132627901700000,NW 329,RESIDENTIAL,25344,0,25344,106821,0,132165
132627901800000,NW 329,RESIDENTIAL,25344,0,25344,92119,0,117463
132627901900000,NW 329,RESIDENTIAL,25344,0,25344,98362,0,123706
132627902000000,NW 329,RESIDENTIAL,25344,0,25344,96022,0,121366
132627902100000,NW 329,RESIDENTIAL,25344,0,25344,87418,0,112762
132627902200000,NW 329,RESIDENTIAL,25344,0,25344,94421,0,119765
132627902300000,NW 329,RESIDENTIAL,25344,0,25344,95899,0,121243
132628000100000,NW 329,RESIDENTIAL,26527,0,26527,103075,0,129602
132628000200000,NW 329,RESIDENTIAL,24064,0,24064,103042,0,127106
132628000300000,NW 329,RESIDENTIAL,26527,0,26527,91109,0,117636
132628000400000,NW 329,RESIDENTIAL,25344,0,25344,94009,0,119353
132628000500000,NW 329,RESIDENTIAL,24948,0,24948,111618,0,136566
132628000600000,NW 329,RESIDENTIAL,24948,0,24948,99451,0,124399
132628000700000,NW 329,RESIDENTIAL,24948,0,24948,95923,0,120871
132628000800000,NW 329,RESIDENTIAL,24948,0,24948,96521,0,121469
132628000900000,NW 329,RESIDENTIAL,24948,0,24948,89594,0,114542
132628001000000,NW 329,RESIDENTIAL,24948,0,24948,91022,0,115970
132628001100000,NW 329,RESIDENTIAL,24948,0,24948,87444,0,112392
132628001200000,NW 329,RESIDENTIAL,26532,0,26532,97769,0,124301
132628001300000,NW 329,RESIDENTIAL,26638,0,26638,86896,0,113534
132628001400000,NW 329,RESIDENTIAL,25707,0,25707,89287,0,114994
132628001500000,NW 329,RESIDENTIAL,25205,0,25205,93638,0,118843
132628001600000,NW 329,RESIDENTIAL,24948,0,24948,94396,0,119344
132628001700000,NW 329,RESIDENTIAL,24948,0,24948,91954,0,116902
132628001800000,NW 329,RESIDENTIAL,24948,0,24948,102615,0,127563
132628001900000,NW 329,RESIDENTIAL,24948,0,24948,94139,0,119087
132628002000000,NW 329,RESIDENTIAL,24948,0,24948,94621,0,119569
132628002100000,NW 329,RESIDENTIAL,24948,0,24948,90349,0,115297
132628002200000,NW 329,RESIDENTIAL,24948,0,24948,90245,0,115193
132628002300000,NW 329,RESIDENTIAL,25344,0,25344,91902,0,117246
132628100100000,NW 329,RESIDENTIAL,26527,0,26527,102406,0,128933
132628100200000,NW 329,RESIDENTIAL,24064,0,24064,100908,0,124972
132628100300000,NW 329,RESIDENTIAL,26527,0,26527,114872,0,141399
132628100400000,NW 329,RESIDENTIAL,25700,0,25700,86797,0,112497
132628100500000,NW 329,RESIDENTIAL,22176,0,22176,115275,0,137451
132628100600000,NW 329,RESIDENTIAL,23760,0,23760,107069,0,130829
132628100700000,NW 329,RESIDENTIAL,22176,0,22176,78029,0,100205
132628100800000,NW 329,RESIDENTIAL,23760,0,23760,105518,0,129278
132628100900000,NW 329,RESIDENTIAL,22836,0,22836,95087,0,117923
132628101000000,NW 329,RESIDENTIAL,24684,0,24684,113064,0,137748
132628101100000,NW 329,RESIDENTIAL,24644,0,24644,101678,0,126322
132628101200000,NW 329,RESIDENTIAL,27182,0,27182,112606,0,139788
132628101300000,NW 329,RESIDENTIAL,28070,0,28070,114262,0,142332
132628101400000,NW 329,RESIDENTIAL,28560,0,28560,89807,0,118367
132628101500000,NW 329,RESIDENTIAL,26268,0,26268,96913,0,123181
132628101600000,NW 329,RESIDENTIAL,26532,0,26532,100067,0,126599
132628101700000,NW 329,RESIDENTIAL,24948,0,24948,83559,0,108507
132628101800000,NW 329,RESIDENTIAL,24948,0,24948,98472,0,123420
132628101900000,NW 329,RESIDENTIAL,24948,0,24948,102084,0,127032
132628102000000,NW 329,RESIDENTIAL,24948,0,24948,99504,0,124452
132628102100000,NW 329,RESIDENTIAL,24948,0,24948,95569,0,120517
132628102200000,NW 329,RESIDENTIAL,24948,0,24948,93294,0,118242
132628102300000,NW 329,RESIDENTIAL,24948,0,24948,107756,0,132704
132628102400000,NW 329,RESIDENTIAL,25344,0,25344,98275,0,123619
132628200100000,NW 329,RESIDENTIAL,24559,0,24559,81728,0,106287
132628200200000,NW 329,RESIDENTIAL,21340,0,21340,87209,0,108549
132628200300000,NW 329,RESIDENTIAL,21340,0,21340,87629,0,108969
132628200400000,NW 329,RESIDENTIAL,24392,0,24392,85205,0,109597
132628200500000,NW 329,RESIDENTIAL,24806,0,24806,103879,0,128685
132628200600000,NW 329,RESIDENTIAL,22220,0,22220,105685,0,127905
132628200700000,NW 329,RESIDENTIAL,22220,0,22220,88657,0,110877
132628200800000,NW 329,RESIDENTIAL,22220,0,22220,92679,0,114899
132628200900000,NW 329,RESIDENTIAL,24240,0,24240,98133,0,122373
132628201000000,NW 329,RESIDENTIAL,22220,0,22220,99178,0,121398
132628201100000,NW 329,RESIDENTIAL,22000,0,22000,103508,0,125508
132628201200000,NW 329,RESIDENTIAL,24415,0,24415,101527,0,125942
132628201300000,NW 329,RESIDENTIAL,29260,0,29260,92414,0,121674
132628201400000,NW 329,RESIDENTIAL,29203,0,29203,116659,0,145862
132628201500000,NW 329,RESIDENTIAL,23760,0,23760,92708,0,116468
132628201600000,NW 329,RESIDENTIAL,23701,0,23701,99169,0,122870
132628201700000,NW 329,RESIDENTIAL,21776,0,21776,90908,0,112684
132628201800000,NW 329,RESIDENTIAL,24240,0,24240,99641,0,123881
132628201900000,NW 329,RESIDENTIAL,22624,0,22624,95727,0,118351
132628202000000,NW 329,RESIDENTIAL,24240,0,24240,87912,0,112152
132628202100000,NW 329,RESIDENTIAL,22624,0,22624,89388,0,112012
132628202200000,NW 329,RESIDENTIAL,25088,0,25088,100744,0,125832
132628300100000,NW 329,RESIDENTIAL,28611,0,28611,99876,0,128487
132628300200000,NW 329,RESIDENTIAL,26730,0,26730,100668,0,127398
132628300300000,NW 329,RESIDENTIAL,26516,0,26516,105912,0,132428
132630100100000,NW 329,RESIDENTIAL,26707,0,26707,86649,0,113356
132630100200000,NW 329,RESIDENTIAL,26133,0,26133,86879,0,113012
132630100300000,NW 329,RESIDENTIAL,25951,0,25951,83928,0,109879
132630100400000,NW 329,RESIDENTIAL,26971,0,26971,83161,0,110132
132630100500000,NW 329,RESIDENTIAL,28120,0,28120,105995,0,134115
132630100600000,NW 329,RESIDENTIAL,29716,0,29716,91999,0,121715
132630100700000,NW 329,RESIDENTIAL,27478,0,27478,90138,0,117616
132630100800000,NW 329,RESIDENTIAL,27594,0,27594,104061,0,131655
132630100900000,NW 329,RESIDENTIAL,26112,0,26112,97860,0,123972
132630101000000,NW 329,RESIDENTIAL,30240,0,30240,106018,0,136258
132630101100000,NW 329,RESIDENTIAL,29440,0,29440,108353,0,137793
132630200100000,NW 329,RESIDENTIAL,28386,0,28386,110005,0,138391
132630200200000,NW 329,RESIDENTIAL,27912,0,27912,88984,0,116896
132630200300000,NW 329,RESIDENTIAL,25556,0,25556,97638,0,123194
132630200400000,NW 329,RESIDENTIAL,25283,0,25283,105176,0,130459
132630200500000,NW 329,RESIDENTIAL,26394,0,26394,87742,0,114136
132630200600000,NW 329,RESIDENTIAL,27618,0,27618,98748,0,126366
132630200700000,NW 329,RESIDENTIAL,24832,0,24832,90137,0,114969
132630200800000,NW 329,RESIDENTIAL,27179,0,27179,109805,0,136984
132630200900000,NW 329,RESIDENTIAL,26440,0,26440,97384,0,123824
132630201000000,NW 329,EXEMPT,0,27047,27047,0,82210,109257
132630201100000,NW 329,RESIDENTIAL,26813,0,26813,88960,0,115773
132630201200000,NW 329,RESIDENTIAL,27086,0,27086,104337,0,131423
132630300100000,NW 329,RESIDENTIAL,26094,0,26094,105383,0,131477
132630300200000,NW 329,RESIDENTIAL,26823,0,26823,100937,0,127760
132630300300000,NW 329,RESIDENTIAL,28054,0,28054,107833,0,135887
132630300400000,NW 329,RESIDENTIAL,25718,0,25718,99679,0,125397
132630300500000,NW 329,RESIDENTIAL,26313,0,26313,117201,0,143514
132630300600000,NW 329,RESIDENTIAL,27664,0,27664,84622,0,112286
132630300700000,NW 329,RESIDENTIAL,25359,0,25359,81238,0,106597
132630400100000,NW 329,RESIDENTIAL,26019,0,26019,104091,0,130110
132630500100000,NW 329,RESIDENTIAL,30614,0,30614,109284,0,139898
132630500200000,NW 329,RESIDENTIAL,27231,0,27231,87009,0,114240
132630500300000,NW 329,RESIDENTIAL,26928,0,26928,109079,0,136007
132630500400000,NW 329,RESIDENTIAL,26040,0,26040,96097,0,122137
132630500500000,NW 329,RESIDENTIAL,27249,0,27249,96511,0,123760
132630500600000,NW 329,RESIDENTIAL,27363,0,27363,105998,0,133361
132630500700000,NW 329,RESIDENTIAL,28533,0,28533,118099,0,146632
132630500800000,NW 329,RESIDENTIAL,29960,0,29960,107516,0,137476
132630500900000,NW 329,RESIDENTIAL,29680,0,29680,96715,0,126395
132630501000000,NW 329,RESIDENTIAL,29400,0,29400,99599,0,128999
132630501100000,NW 329,RESIDENTIAL,29845,0,29845,113387,0,143232
132630501200000,NW 329,RESIDENTIAL,31569,0,31569,96733,0,128302
132630600100000,NW 329,RESIDENTIAL,27373,0,27373,92386,0,119759
132630600200000,NW 329,RESIDENTIAL,26125,0,26125,107261,0,133386
132630600300000,NW 329,RESIDENTIAL,34791,0,34791,109652,0,144443
132630600400000,NW 329,RESIDENTIAL,27071,0,27071,100815,0,127886
132630600500000,NW 329,RESIDENTIAL,27588,0,27588,91212,0,118800
132630600600000,NW 329,RESIDENTIAL,26664,0,26664,93640,0,120304
132630600700000,NW 329,RESIDENTIAL,25333,0,25333,110955,0,136288
132630600800000,NW 329,RESIDENTIAL,25800,0,25800,103996,0,129796
132630600900000,NW 329,RESIDENTIAL,25800,0,25800,94345,0,120145
132630601000000,NW 329,RESIDENTIAL,25800,0,25800,109808,0,135608
132630601100000,NW 329,RESIDENTIAL,25800,0,25800,95825,0,121625
132630601200000,NW 329,RESIDENTIAL,25960,0,25960,101488,0,127448
132630601300000,NW 329,RESIDENTIAL,25960,0,25960,105414,0,131374
132630601400000,NW 329,RESIDENTIAL,25960,0,25960,94336,0,120296
132630601500000,NW 329,RESIDENTIAL,26928,0,26928,94277,0,121205
132630601600000,NW 329,RESIDENTIAL,26400,0,26400,100704,0,127104
132630601700000,NW 329,RESIDENTIAL,27106,0,27106,99951,0,127057
132630601800000,NW 329,RESIDENTIAL,25200,0,25200,106062,0,131262
132630601900000,NW 329,RESIDENTIAL,25200,0,25200,92469,0,117669
132630602000000,NW 329,RESIDENTIAL,26533,0,26533,93546,0,120079
132630602100000,NW 329,RESIDENTIAL,26533,0,26533,111702,0,138235
132630700100000,NW 329,RESIDENTIAL,27238,0,27238,102685,0,129923
132630700200000,NW 329,RESIDENTIAL,24832,0,24832,87474,0,112306
132630700300000,NW 329,RESIDENTIAL,27238,0,27238,114280,0,141518
132630700400000,NW 329,RESIDENTIAL,25097,0,25097,97602,0,122699
132630700500000,NW 329,RESIDENTIAL,25088,0,25088,97009,0,122097
132630700600000,NW 329,RESIDENTIAL,25060,0,25060,84082,0,109142
132630700700000,NW 329,RESIDENTIAL,24960,0,24960,85308,0,110268
132630700800000,NW 329,RESIDENTIAL,25856,0,25856,108562,0,134418
132630700900000,NW 329,RESIDENTIAL,25856,0,25856,92229,0,118085
132630701000000,NW 329,RESIDENTIAL,26042,0,26042,102932,0,128974
132630701100000,NW 329,RESIDENTIAL,24573,0,24573,92344,0,116917
132630701200000,NW 329,RESIDENTIAL,25441,0,25441,91960,0,117401
132630701300000,NW 329,RESIDENTIAL,25441,0,25441,97679,0,123120
132630701400000,NW 329,RESIDENTIAL,25441,0,25441,84458,0,109899
132630701500000,NW 329,RESIDENTIAL,26460,0,26460,99961,0,126421
132630701600000,NW 329,RESIDENTIAL,21278,0,21278,98749,0,120027
132630701700000,NW 329,RESIDENTIAL,23040,0,23040,84995,0,108035
132630701800000,NW 329,RESIDENTIAL,21130,0,21130,88647,0,109777
132630701900000,NW 329,RESIDENTIAL,23040,0,23040,89035,0,112075
132630702000000,NW 329,RESIDENTIAL,23808,0,23808,91296,0,115104
132630702100000,NW 329,RESIDENTIAL,22116,0,22116,91595,0,113711
132630702200000,NW 329,RESIDENTIAL,22507,0,22507,104359,0,126866
132630702300000,NW 329,RESIDENTIAL,23781,0,23781,88966,0,112747
132630702400000,NW 329,RESIDENTIAL,26813,0,26813,98330,0,125143
132630702500000,NW 329,RESIDENTIAL,25449,0,25449,106476,0,131925
132630702600000,NW 329,RESIDENTIAL,25449,0,25449,88166,0,113615
132630702700000,NW 329,RESIDENTIAL,25711,0,25711,102944,0,128655
132630702800000,NW 329,RESIDENTIAL,25711,0,25711,85735,0,111446
132630702900000,NW 329,RESIDENTIAL,25711,0,25711,99241,0,124952
132630703000000,NW 329,RESIDENTIAL,25711,0,25711,88507,0,114218
132630800100000,NW 329,RESIDENTIAL,27562,0,27562,114096,0,141658
132630800200000,NW 329,RESIDENTIAL,27962,0,27962,95533,0,123495
132630800300000,NW 329,RESIDENTIAL,27373,0,27373,101194,0,128567
132630800400000,NW 329,RESIDENTIAL,26700,0,26700,100956,0,127656
132630800500000,NW 329,RESIDENTIAL,26700,0,26700,119263,0,145963
132630800600000,NW 329,RESIDENTIAL,26928,0,26928,105441,0,132369
132630800700000,NW 329,RESIDENTIAL,26004,0,26004,124151,0,150155
132630800800000,NW 329,RESIDENTIAL,25220,0,25220,104947,0,130167
132630800900000,NW 329,RESIDENTIAL,25157,0,25157,103196,0,128353
132630801000000,NW 329,RESIDENTIAL,24832,0,24832,90611,0,115443
132630801100000,NW 329,RESIDENTIAL,24891,0,24891,112944,0,137835
132630801200000,NW 329,RESIDENTIAL,25872,0,25872,93502,0,119374
132630801300000,NW 329,RESIDENTIAL,23651,0,23651,112218,0,135869
132630801400000,NW 329,RESIDENTIAL,23245,0,23245,93367,0,116612
132630801500000,NW 329,RESIDENTIAL,21211,0,21211,97858,0,119069
132630801600000,NW 329,RESIDENTIAL,23280,0,23280,92007,0,115287
132630801700000,NW 329,RESIDENTIAL,21340,0,21340,92526,0,113866
132630801800000,NW 329,RESIDENTIAL,23280,0,23280,97654,0,120934
132630801900000,NW 329,RESIDENTIAL,21340,0,21340,106643,0,127983
132630802000000,NW 329,RESIDENTIAL,23332,0,23332,94504,0,117836
132630802100000,NW 329,RESIDENTIAL,23228,0,23228,89328,0,112556
132630802200000,NW 329,RESIDENTIAL,21340,0,21340,91271,0,112611
132630802300000,NW 329,RESIDENTIAL,23280,0,23280,127550,0,150830
132630802400000,NW 329,RESIDENTIAL,21340,0,21340,103312,0,124652
132630802500000,NW 329,RESIDENTIAL,23280,0,23280,98434,0,121714
132630802600000,NW 329,RESIDENTIAL,23781,0,23781,93401,0,117182
132630802700000,NW 329,RESIDENTIAL,21932,0,21932,86455,0,108387
132630802800000,NW 329,RESIDENTIAL,21991,0,21991,107424,0,129415
132630802900000,NW 329,RESIDENTIAL,21760,0,21760,87152,0,108912
132630803000000,NW 329,RESIDENTIAL,25216,0,25216,108557,0,133773
132630803100000,NW 329,RESIDENTIAL,25645,0,25645,100512,0,126157
132630803200000,NW 329,RESIDENTIAL,25349,0,25349,87036,0,112385
132630803300000,NW 329,RESIDENTIAL,25479,0,25479,93975,0,119454
132630803400000,NW 329,RESIDENTIAL,25088,0,25088,90600,0,115688
132630803500000,NW 329,RESIDENTIAL,25088,0,25088,93470,0,118558
132630803600000,NW 329,RESIDENTIAL,26667,0,26667,95654,0,122321
132630803700000,NW 329,RESIDENTIAL,26742,0,26742,97052,0,123794
132630803800000,NW 329,RESIDENTIAL,26964,0,26964,92400,0,119364
132630803900000,NW 329,RESIDENTIAL,28614,0,28614,104914,0,133528
132630804000000,NW 329,RESIDENTIAL,25856,0,25856,86513,0,112369
132630900100000,NW 329,RESIDENTIAL,29485,0,29485,111118,0,140603
132630900200000,NW 329,RESIDENTIAL,26996,0,26996,109914,0,136910
132630900300000,NW 329,RESIDENTIAL,25600,0,25600,98750,0,124350
132630900400000,NW 329,RESIDENTIAL,25600,0,25600,111990,0,137590
132630900500000,NW 329,RESIDENTIAL,25600,0,25600,91437,0,117037
132630900600000,NW 329,RESIDENTIAL,25600,0,25600,97162,0,122762
132630900700000,NW 329,RESIDENTIAL,25600,0,25600,89129,0,114729
132631000100000,NW 329,RESIDENTIAL,24832,0,24832,97071,0,121903
132631000200000,NW 329,RESIDENTIAL,24832,0,24832,91298,0,116130
132631000300000,NW 329,RESIDENTIAL,24832,0,24832,101109,0,125941
132631000400000,NW 329,RESIDENTIAL,27526,0,27526,113294,0,140820
132631000500000,NW 329,RESIDENTIAL,28912,0,28912,111569,0,140481
132631000600000,NW 329,RESIDENTIAL,29047,0,29047,91047,0,120094
132631000700000,NW 329,RESIDENTIAL,32116,0,32116,108215,0,140331
132631000800000,NW 329,RESIDENTIAL,29085,0,29085,96201,0,125286
132631000900000,NW 329,RESIDENTIAL,28550,0,28550,113697,0,142247
132631001000000,NW 329,RESIDENTIAL,27962,0,27962,101648,0,129610
132631001100000,NW 329,RESIDENTIAL,26640,0,26640,85483,0,112123
132631001200000,NW 329,RESIDENTIAL,27223,0,27223,104012,0,131235
132631001300000,NW 329,RESIDENTIAL,27440,0,27440,100298,0,127738
132631001400000,NW 329,RESIDENTIAL,27096,0,27096,102995,0,130091
132631100100000,NW 329,RESIDENTIAL,26730,0,26730,108574,0,135304
132631100200000,NW 329,RESIDENTIAL,25088,0,25088,99527,0,124615
132631100300000,NW 329,RESIDENTIAL,23520,0,23520,89726,0,113246
132631100400000,NW 329,RESIDENTIAL,25088,0,25088,100595,0,125683
132631100500000,NW 329,RESIDENTIAL,25088,0,25088,97679,0,122767
132631100600000,NW 329,RESIDENTIAL,25088,0,25088,102555,0,127643
132632600100000,NW 329,RESIDENTIAL,27951,0,27951,111134,0,139085
132632600200000,NW 329,RESIDENTIAL,24832,0,24832,94205,0,119037
132632600300000,NW 329,RESIDENTIAL,24832,0,24832,96622,0,121454
132632600400000,NW 329,RESIDENTIAL,28363,0,28363,104531,0,132894
132632700100000,NW 329,RESIDENTIAL,27234,0,27234,89243,0,116477
132632700200000,SCHOOL,EXEMPT,0,0,0,0,0,0
132632700300000,CITY PROPERTY,EXEMPT,0,0,0,0,0,0
132632700400000,NW 329,RESIDENTIAL,26826,0,26826,98239,0,125065
132632700500000,NW 329,RESIDENTIAL,25200,0,25200,107514,0,132714
132632700600000,NW 329,RESIDENTIAL,25200,0,25200,102667,0,127867
132632700700000,NW 329,RESIDENTIAL,25200,0,25200,102843,0,128043
132632700800000,NW 329,RESIDENTIAL,25200,0,25200,95222,0,120422
132632700900000,NW 329,RESIDENTIAL,25200,0,25200,97194,0,122394
132632701000000,NW 329,RESIDENTIAL,25200,0,25200,98112,0,123312
132632701100000,NW 329,RESIDENTIAL,25200,0,25200,96412,0,121612
132632800100000,NW 329,RESIDENTIAL,27529,0,27529,103034,0,130563
132632800200000,NW 332,RESIDENTIAL,48855,0,48855,190831,0,239686
132632800300000,NW 332,RESIDENTIAL,44413,0,44413,167466,0,211879
132632800400000,NW 332,RESIDENTIAL,44413,0,44413,184175,0,228588
132632800500000,NW 332,RESIDENTIAL,44413,0,44413,213579,0,257992
132632800600000,NW 332,RESIDENTIAL,44413,0,44413,172500,0,216913
132632800700000,NW 332,RESIDENTIAL,44413,0,44413,204468,0,248881
132632800800000,NW 332,RESIDENTIAL,48593,0,48593,176771,0,225364
132632801100000,NW 332,RESIDENTIAL,45980,0,45980,237736,0,283716
132632801200000,NW 332,RESIDENTIAL,45980,0,45980,233802,0,279782
132632801300000,NW 332,RESIDENTIAL,45980,0,45980,230217,0,276197
132632801400000,NW 332,RESIDENTIAL,45841,0,45841,271685,0,317526
132632801500000,NW 332,RESIDENTIAL,67914,0,67914,71524,0,139438
132632801600000,NW 329,RESIDENTIAL,26887,0,26887,104925,0,131812
132632801700000,NW 329,RESIDENTIAL,26479,0,26479,118724,0,145203
132632801800000,NW 329,RESIDENTIAL,24194,0,24194,99615,0,123809
132632801900000,NW 329,RESIDENTIAL,22440,0,22440,96115,0,118555
132632802000000,NW 329,RESIDENTIAL,26152,0,26152,92409,0,118561
132632802100000,NW 329,RESIDENTIAL,25856,0,25856,92143,0,117999
132632802200000,NW 329,RESIDENTIAL,23836,0,23836,87767,0,111603
132632802300000,NW 329,RESIDENTIAL,25937,0,25937,104520,0,130457
132632802400000,NW 329,RESIDENTIAL,24159,0,24159,91100,0,115259
132632802500000,NW 329,RESIDENTIAL,26842,0,26842,107549,0,134391
132632802600000,NW 329,RESIDENTIAL,27072,0,27072,89463,0,116535
132632802700000,NW 329,RESIDENTIAL,25452,0,25452,87410,0,112862
132632802800000,NW 329,RESIDENTIAL,25452,0,25452,84306,0,109758
132632802900000,NW 329,RESIDENTIAL,25452,0,25452,96875,0,122327
132632803000000,NW 329,RESIDENTIAL,25452,0,25452,92264,0,117716
132632803100000,NW 329,RESIDENTIAL,25452,0,25452,96155,0,121607
132632803200000,NW 329,RESIDENTIAL,25452,0,25452,92333,0,117785
132632803300000,NW 329,RESIDENTIAL,25452,0,25452,108363,0,133815
132632803400000,NW 332,RESIDENTIAL,53107,0,53107,225357,0,278464
132632900100000,NW 329,RESIDENTIAL,27315,0,27315,90022,0,117337
132632900200000,NW 329,RESIDENTIAL,24832,0,24832,89475,0,114307
132632900300000,NW 329,RESIDENTIAL,27626,0,27626,89997,0,117623
132633000100000,NW 329,RESIDENTIAL,27238,0,27238,95852,0,123090
132633000200000,NW 329,RESIDENTIAL,24832,0,24832,99139,0,123971
132633000300000,NW 329,RESIDENTIAL,27179,0,27179,101784,0,128963
132633100100000,NW 329,RESIDENTIAL,26577,0,26577,112477,0,139054
132633100200000,NW 329,RESIDENTIAL,25239,0,25239,99824,0,125063
132633100300000,NW 329,RESIDENTIAL,25181,0,25181,81451,0,106632
132633100400000,NW 329,RESIDENTIAL,25181,0,25181,86783,0,111964
132633100500000,NW 329,RESIDENTIAL,25181,0,25181,99888,0,125069
132633100600000,NW 329,RESIDENTIAL,25181,0,25181,90475,0,115656
132633100700000,NW 329,RESIDENTIAL,25181,0,25181,74998,0,100179
132633100800000,NW 329,RESIDENTIAL,25181,0,25181,91048,0,116229
132633100900000,NW 329,RESIDENTIAL,25181,0,25181,115102,0,140283
132633101000000,NW 329,RESIDENTIAL,25181,0,25181,98464,0,123645
132633101100000,NW 329,RESIDENTIAL,28275,0,28275,99787,0,128062
132633101200000,NW 329,RESIDENTIAL,26769,0,26769,97024,0,123793
132633101300000,NW 329,RESIDENTIAL,23280,0,23280,85239,0,108519
132633101400000,NW 329,RESIDENTIAL,23280,0,23280,93311,0,116591
132633101500000,NW 329,RESIDENTIAL,21340,0,21340,99015,0,120355
132633101600000,NW 329,RESIDENTIAL,23280,0,23280,96904,0,120184
132633101700000,NW 329,RESIDENTIAL,21340,0,21340,93938,0,115278
132633101800000,NW 329,RESIDENTIAL,23280,0,23280,91386,0,114666
132633101900000,NW 329,RESIDENTIAL,25026,0,25026,108396,0,133422
132633102000000,NW 329,RESIDENTIAL,21340,0,21340,85876,0,107216
132633102100000,NW 329,RESIDENTIAL,25026,0,25026,92165,0,117191
132633102200000,NW 329,RESIDENTIAL,21275,0,21275,85912,0,107187
132633102300000,NW 329,RESIDENTIAL,27146,0,27146,110660,0,137806
132633102400000,NW 329,RESIDENTIAL,22800,0,22800,98249,0,121049
132633200100000,NW 329,RESIDENTIAL,26453,0,26453,104163,0,130616
132633200200000,NW 329,RESIDENTIAL,24444,0,24444,94061,0,118505
132633200300000,NW 329,RESIDENTIAL,28110,0,28110,100234,0,128344
132633300100000,NW 329,RESIDENTIAL,25980,0,25980,96906,0,122886
132633300200000,NW 329,RESIDENTIAL,23345,0,23345,92511,0,115856
132633300300000,NW 329,RESIDENTIAL,21340,0,21340,84378,0,105718
132633300400000,NW 329,RESIDENTIAL,23280,0,23280,92096,0,115376
132633300500000,NW 329,RESIDENTIAL,25142,0,25142,100288,0,125430
132633300600000,NW 329,RESIDENTIAL,24250,0,24250,92817,0,117067
132633300700000,NW 329,RESIDENTIAL,24250,0,24250,102434,0,126684
132633300800000,NW 329,RESIDENTIAL,21340,0,21340,85096,0,106436
132633300900000,NW 329,RESIDENTIAL,23280,0,23280,104291,0,127571
132633301000000,NW 329,RESIDENTIAL,21340,0,21340,88768,0,110108
132633301100000,NW 329,RESIDENTIAL,21340,0,21340,96729,0,118069
132633301200000,NW 329,RESIDENTIAL,24020,0,24020,106758,0,130778
132633301300000,NW 329,RESIDENTIAL,23580,0,23580,110162,0,133742
132633301400000,NW 329,RESIDENTIAL,23520,0,23520,101337,0,124857
132633301500000,NW 329,RESIDENTIAL,23520,0,23520,105679,0,129199
132633301600000,NW 329,RESIDENTIAL,23520,0,23520,104294,0,127814
132633301700000,NW 329,RESIDENTIAL,23520,0,23520,95875,0,119395
132633301800000,NW 329,RESIDENTIAL,23520,0,23520,99768,0,123288
132633301900000,NW 329,RESIDENTIAL,24206,0,24206,98356,0,122562
132633302000000,NW 329,RESIDENTIAL,24206,0,24206,93219,0,117425
132633302100000,NW 329,RESIDENTIAL,23520,0,23520,100911,0,124431
132633302200000,NW 329,RESIDENTIAL,23520,0,23520,98714,0,122234
132633302300000,NW 329,RESIDENTIAL,23460,0,23460,81216,0,104676
132633302400000,NW 329,RESIDENTIAL,27264,0,27264,98319,0,125583
132633302500000,NW 329,RESIDENTIAL,25200,0,25200,104389,0,129589
132633400100000,NW 329,RESIDENTIAL,23520,0,23520,97341,0,120861
132633400200000,NW 329,RESIDENTIAL,24832,0,24832,98110,0,122942
132633400300000,NW 329,RESIDENTIAL,24832,0,24832,91865,0,116697
132633400400000,NW 329,RESIDENTIAL,24832,0,24832,92436,0,117268
132633400500000,NW 329,RESIDENTIAL,21399,0,21399,88842,0,110241
132633400600000,NW 329,RESIDENTIAL,21340,0,21340,99888,0,121228
132633400700000,NW 329,RESIDENTIAL,21340,0,21340,98369,0,119709
132633400800000,NW 329,RESIDENTIAL,21340,0,21340,83940,0,105280
132633400900000,NW 329,RESIDENTIAL,21340,0,21340,94010,0,115350
132633401000000,NW 329,RESIDENTIAL,21340,0,21340,96677,0,118017
132633401100000,NW 329,RESIDENTIAL,21340,0,21340,94773,0,116113
132633401200000,NW 329,RESIDENTIAL,21340,0,21340,85519,0,106859
132633401300000,NW 329,RESIDENTIAL,21340,0,21340,96424,0,117764
132633401400000,NW 329,RESIDENTIAL,21340,0,21340,113218,0,134558
132633401500000,NW 329,RESIDENTIAL,21340,0,21340,101776,0,123116
132633401600000,NW 329,RESIDENTIAL,25161,0,25161,97365,0,122526
132635100100000,NW 329,RESIDENTIAL,23280,0,23280,105723,0,129003
132635100200000,NW 329,RESIDENTIAL,24832,0,24832,90658,0,115490
132635100300000,NW 329,RESIDENTIAL,24832,0,24832,97412,0,122244
132635100400000,NW 329,RESIDENTIAL,24729,0,24729,96371,0,121100
132635100500000,NW 329,RESIDENTIAL,23221,0,23221,106615,0,129836
132635100600000,NW 329,RESIDENTIAL,23280,0,23280,92075,0,115355
132635100700000,NW 329,RESIDENTIAL,23280,0,23280,93853,0,117133
132635100800000,NW 329,RESIDENTIAL,23280,0,23280,105970,0,129250
132635100900000,NW 329,RESIDENTIAL,23280,0,23280,102129,0,125409
132635101000000,NW 329,RESIDENTIAL,23280,0,23280,119349,0,142629
132635101100000,NW 329,RESIDENTIAL,23280,0,23280,107690,0,130970
132635101200000,NW 329,RESIDENTIAL,23280,0,23280,110240,0,133520
132635101300000,NW 329,RESIDENTIAL,23280,0,23280,107193,0,130473
132635101400000,NW 329,RESIDENTIAL,23280,0,23280,108450,0,131730
132635101500000,NW 329,RESIDENTIAL,25858,0,25858,102365,0,128223
132635200100000,NW 329,RESIDENTIAL,26479,0,26479,97954,0,124433
132635200200000,NW 332,RESIDENTIAL,55704,0,55704,194626,0,250330
132635200300000,NW 329,RESIDENTIAL,27683,0,27683,106048,0,133731
132635300100000,NW 329,RESIDENTIAL,23280,0,23280,88280,0,111560
132635300200000,NW 329,RESIDENTIAL,24832,0,24832,84215,0,109047
132635300300000,NW 329,RESIDENTIAL,24832,0,24832,93588,0,118420
132635300400000,NW 329,RESIDENTIAL,24780,0,24780,86986,0,111766
132635300500000,NW 329,RESIDENTIAL,21399,0,21399,105599,0,126998
132635300600000,NW 329,RESIDENTIAL,21340,0,21340,98635,0,119975
132635300700000,NW 329,RESIDENTIAL,21340,0,21340,96939,0,118279
132635300800000,NW 329,RESIDENTIAL,21340,0,21340,100146,0,121486
132635300900000,NW 329,RESIDENTIAL,24871,0,24871,99884,0,124755
132635301000000,NW 329,RESIDENTIAL,24871,0,24871,100042,0,124913
132635301100000,NW 329,RESIDENTIAL,24871,0,24871,105266,0,130137
132635301200000,NW 329,RESIDENTIAL,24871,0,24871,106198,0,131069
132635301300000,NW 329,RESIDENTIAL,24871,0,24871,106503,0,131374
132635301400000,NW 329,RESIDENTIAL,24871,0,24871,105454,0,130325
132635301500000,NW 329,RESIDENTIAL,24871,0,24871,99375,0,124246
132635301600000,NW 329,RESIDENTIAL,24871,0,24871,99121,0,123992
132635301700000,NW 329,RESIDENTIAL,24871,0,24871,104792,0,129663
132635301800000,NW 329,RESIDENTIAL,24917,0,24917,77022,0,101939
132635301900000,NW 329,RESIDENTIAL,31234,0,31234,126958,0,158192
132635400500000,SW 407,RESIDENTIAL,20,0,20,0,0,20
132635502000000,SW 407,RESIDENTIAL,81600,0,81600,0,0,81600
132635502002000,BILLBOARD(BLL),COMMERCIAL,0,0,0,0,10203,10203
132637600100000,NW 329,RESIDENTIAL,25600,0,25600,96127,0,121727
132637600200000,NW 329,RESIDENTIAL,20747,0,20747,85581,0,106328
132637600300000,NW 329,RESIDENTIAL,24000,0,24000,102805,0,126805
132637600400000,NW 329,RESIDENTIAL,20800,0,20800,86607,0,107407
132637600500000,NW 329,RESIDENTIAL,23200,0,23200,101986,0,125186
132637600600000,NW 329,RESIDENTIAL,23253,0,23253,97962,0,121215
132637600700000,NW 329,RESIDENTIAL,24491,0,24491,88133,0,112624
132637600800000,NW 329,RESIDENTIAL,23280,0,23280,97460,0,120740
132637600900000,NW 329,RESIDENTIAL,23280,0,23280,94968,0,118248
132637601000000,NW 329,RESIDENTIAL,23280,0,23280,94953,0,118233
132637601100000,NW 329,RESIDENTIAL,23280,0,23280,95520,0,118800
132637601200000,NW 329,RESIDENTIAL,23280,0,23280,89444,0,112724
132637601300000,NW 329,RESIDENTIAL,23280,0,23280,93799,0,117079
132637601400000,NW 329,RESIDENTIAL,23280,0,23280,92475,0,115755
132637601500000,NW 329,RESIDENTIAL,23280,0,23280,94525,0,117805
132637601600000,NW 329,RESIDENTIAL,23280,0,23280,93124,0,116404
132637601700000,NW 329,RESIDENTIAL,23280,0,23280,85736,0,109016
132637601800000,NW 329,RESIDENTIAL,24397,0,24397,95496,0,119893
132637601900000,APARTMENT,COMMERCIAL,0,728600,728600,0,7503616,8232216
132637602000000,WAREHOUSE,COMMERCIAL,0,450720,450720,0,314250,764970
132637602002000,BILLBOARD(BLL),COMMERCIAL,0,0,0,0,5472,5472
132637602100000,WAREHOUSE;MINI STORG,COMMERCIAL,0,232550,232550,0,319252,551802
132637700100000,NW 329,RESIDENTIAL,24773,0,24773,92682,0,117455
132637700200000,NW 329,RESIDENTIAL,25753,0,25753,94874,0,120627
132637700300000,NW 329,RESIDENTIAL,23280,0,23280,90653,0,113933
132637700400000,NW 329,RESIDENTIAL,23280,0,23280,106106,0,129386
132637700500000,NW 329,RESIDENTIAL,23280,0,23280,98635,0,121915
132637700600000,NW 329,RESIDENTIAL,23280,0,23280,103356,0,126636
132637700700000,NW 329,RESIDENTIAL,23280,0,23280,86464,0,109744
132637700800000,NW 329,RESIDENTIAL,23280,0,23280,91124,0,114404
132637700900000,NW 329,RESIDENTIAL,23280,0,23280,104713,0,127993
132637701000000,NW 329,RESIDENTIAL,23280,0,23280,101695,0,124975
132637701100000,NW 329,RESIDENTIAL,23280,0,23280,88756,0,112036
132637701200000,NW 329,RESIDENTIAL,23280,0,23280,103954,0,127234
132637701300000,NW 329,RESIDENTIAL,25851,0,25851,107036,0,132887
132637800100000,NW 329,RESIDENTIAL,26283,0,26283,92022,0,118305
132637800200000,NW 329,RESIDENTIAL,24832,0,24832,97787,0,122619
132637800300000,NW 329,RESIDENTIAL,23280,0,23280,97618,0,120898
132637800400000,NW 329,RESIDENTIAL,24832,0,24832,102481,0,127313
132637800500000,NW 329,RESIDENTIAL,24832,0,24832,88724,0,113556
132637800600000,NW 329,RESIDENTIAL,24832,0,24832,105547,0,130379
132637900100000,NW 329,RESIDENTIAL,26237,0,26237,103705,0,129942
132637900200000,NW 329,RESIDENTIAL,24832,0,24832,95983,0,120815
132637900300000,NW 329,RESIDENTIAL,23280,0,23280,86530,0,109810
132637900400000,NW 329,RESIDENTIAL,24832,0,24832,101114,0,125946
132637900500000,NW 329,RESIDENTIAL,24832,0,24832,95340,0,120172
132637900600000,NW 329,RESIDENTIAL,24832,0,24832,85406,0,110238
132637901000000,DAY CARE CENTER,COMMERCIAL,0,50260,50260,0,210849,261109
132640100100000,NW 329,RESIDENTIAL,30293,0,30293,114939,0,145232
132640100200000,NW 329,RESIDENTIAL,30000,0,30000,142708,0,172708
132640100300000,NW 329,RESIDENTIAL,30000,0,30000,126909,0,156909
132640100400000,NW 329,RESIDENTIAL,30000,0,30000,119216,0,149216
132640100500000,NW 329,RESIDENTIAL,30000,0,30000,117590,0,147590
132640100600000,NW 329,RESIDENTIAL,30823,0,30823,118432,0,149255
132640200100000,NW 329,RESIDENTIAL,30526,0,30526,107565,0,138091
132640200200000,NW 329,RESIDENTIAL,29936,0,29936,133828,0,163764
132640200300000,NW 329,RESIDENTIAL,31203,0,31203,120520,0,151723
132640200400000,NW 329,RESIDENTIAL,31255,0,31255,132309,0,163564
132640200500000,NW 329,RESIDENTIAL,31916,0,31916,117636,0,149552
132640200600000,NW 329,RESIDENTIAL,31200,0,31200,121744,0,152944
132640200700000,NW 329,RESIDENTIAL,31200,0,31200,109070,0,140270
132640200800000,NW 329,RESIDENTIAL,31200,0,31200,124366,0,155566
132640200900000,NW 329,RESIDENTIAL,30000,0,30000,119204,0,149204
132640201000000,NW 329,RESIDENTIAL,31200,0,31200,134823,0,166023
132640201100000,NW 329,RESIDENTIAL,30000,0,30000,132032,0,162032
132640201200000,NW 329,RESIDENTIAL,30000,0,30000,129965,0,159965
132640201300000,NW 329,RESIDENTIAL,30000,0,30000,119333,0,149333
132640201400000,NW 329,RESIDENTIAL,30000,0,30000,152446,0,182446
132640201500000,NW 329,RESIDENTIAL,31338,0,31338,145239,0,176577
132640300100000,NW 329,RESIDENTIAL,32727,0,32727,135455,0,168182
132640300200000,NW 329,RESIDENTIAL,33716,0,33716,149534,0,183250
132640300300000,NW 329,RESIDENTIAL,31680,0,31680,125957,0,157637
132640300400000,NW 329,RESIDENTIAL,33359,0,33359,116894,0,150253
132640300500000,NW 329,RESIDENTIAL,26525,0,26525,113879,0,140404
132640300600000,NW 329,RESIDENTIAL,25568,0,25568,109914,0,135482
132640300700000,NW 329,RESIDENTIAL,25703,0,25703,103309,0,129012
132640300800000,NW 329,RESIDENTIAL,29169,0,29169,112632,0,141801
132640300900000,NW 329,RESIDENTIAL,35016,0,35016,160141,0,195157
132640400100000,NW 329,RESIDENTIAL,29777,0,29777,146896,0,176673
132640400200000,NW 329,RESIDENTIAL,33512,0,33512,120964,0,154476
132640400300000,NW 329,RESIDENTIAL,32640,0,32640,112150,0,144790
132640400400000,NW 329,RESIDENTIAL,32640,0,32640,109660,0,142300
132640400500000,NW 329,RESIDENTIAL,32640,0,32640,108737,0,141377
132640400600000,NW 329,RESIDENTIAL,31960,0,31960,106409,0,138369
132640400700000,NW 329,RESIDENTIAL,31960,0,31960,115834,0,147794
132640400800000,NW 329,RESIDENTIAL,31960,0,31960,112037,0,143997
132640400900000,NW 329,RESIDENTIAL,32640,0,32640,125759,0,158399
132640401000000,NW 329,RESIDENTIAL,32640,0,32640,150782,0,183422
132640401100000,NW 329,RESIDENTIAL,32640,0,32640,113229,0,145869
132640500100000,NW 329,RESIDENTIAL,30051,0,30051,107047,0,137098
132640500200000,NW 329,RESIDENTIAL,30378,0,30378,135512,0,165890
132640500300000,NW 329,RESIDENTIAL,30096,0,30096,114044,0,144140
132640500400000,NW 329,RESIDENTIAL,30096,0,30096,127483,0,157579
132640500500000,NW 329,RESIDENTIAL,30096,0,30096,126939,0,157035
132640500600000,NW 329,RESIDENTIAL,30096,0,30096,135824,0,165920
132640500700000,NW 329,RESIDENTIAL,30096,0,30096,144481,0,174577
132640500800000,NW 329,RESIDENTIAL,30096,0,30096,134462,0,164558
132640500900000,NW 329,RESIDENTIAL,30096,0,30096,148130,0,178226
132640501000000,NW 329,RESIDENTIAL,30096,0,30096,134947,0,165043
132640501100000,NW 329,RESIDENTIAL,30096,0,30096,120632,0,150728
132640501200000,NW 329,RESIDENTIAL,30096,0,30096,106814,0,136910
132640501300000,NW 329,RESIDENTIAL,30096,0,30096,118291,0,148387
132640501400000,NW 329,RESIDENTIAL,30096,0,30096,123311,0,153407
132640501500000,NW 329,RESIDENTIAL,30096,0,30096,111447,0,141543
132640501600000,NW 329,RESIDENTIAL,30096,0,30096,129154,0,159250
132640501700000,NW 329,RESIDENTIAL,28512,0,28512,130471,0,158983
132640501800000,NW 329,RESIDENTIAL,30096,0,30096,129580,0,159676
132640600100000,NW 329,RESIDENTIAL,30356,0,30356,144200,0,174556
132640600200000,NW 329,RESIDENTIAL,31334,0,31334,128971,0,160305
132640600300000,NW 329,RESIDENTIAL,30576,0,30576,113866,0,144442
132640600400000,NW 329,RESIDENTIAL,28224,0,28224,122338,0,150562
132640600500000,NW 329,RESIDENTIAL,30576,0,30576,141564,0,172140
132640600600000,NW 329,RESIDENTIAL,29400,0,29400,109493,0,138893
132640600700000,NW 329,RESIDENTIAL,30184,0,30184,104582,0,134766
132640600800000,NW 329,RESIDENTIAL,29792,0,29792,111117,0,140909
132640600900000,NW 329,RESIDENTIAL,29792,0,29792,119098,0,148890
132640601000000,NW 329,RESIDENTIAL,29633,0,29633,92310,0,121943
132640601100000,NW 329,RESIDENTIAL,29792,0,29792,132888,0,162680
132640601200000,NW 329,RESIDENTIAL,29792,0,29792,174664,0,204456
132640601300000,NW 329,RESIDENTIAL,29792,0,29792,144102,0,173894
132640601400000,NW 329,RESIDENTIAL,29792,0,29792,140113,0,169905
132640601500000,NW 329,RESIDENTIAL,29792,0,29792,124705,0,154497
132640601600000,NW 329,RESIDENTIAL,29792,0,29792,122677,0,152469
132640601700000,NW 329,RESIDENTIAL,29792,0,29792,114432,0,144224
132640601800000,NW 329,RESIDENTIAL,29792,0,29792,126139,0,155931
132640700100000,NW 329,RESIDENTIAL,30046,0,30046,124172,0,154218
132640700200000,NW 329,RESIDENTIAL,32393,0,32393,136986,0,169379
132640700300000,NW 329,RESIDENTIAL,32090,0,32090,132930,0,165020
132640700400000,NW 329,RESIDENTIAL,29700,0,29700,150338,0,180038
132640700500000,NW 329,RESIDENTIAL,28423,0,28423,108533,0,136956
132640700600000,NW 329,RESIDENTIAL,27448,0,27448,129316,0,156764
132640700700000,NW 329,RESIDENTIAL,27448,0,27448,117276,0,144724
132640700800000,NW 329,RESIDENTIAL,27448,0,27448,115324,0,142772
132640700900000,NW 329,RESIDENTIAL,27448,0,27448,115388,0,142836
132640701000000,NW 329,RESIDENTIAL,27448,0,27448,135175,0,162623
132640701100000,NW 329,RESIDENTIAL,27448,0,27448,106348,0,133796
132640701200000,NW 329,RESIDENTIAL,27448,0,27448,100789,0,128237
132640701300000,NW 329,RESIDENTIAL,27448,0,27448,125159,0,152607
132640701400000,NW 329,RESIDENTIAL,27448,0,27448,112567,0,140015
132640701500000,NW 329,RESIDENTIAL,27448,0,27448,105852,0,133300
132640701600000,NW 329,RESIDENTIAL,28208,0,28208,107353,0,135561
132640701700000,NW 329,RESIDENTIAL,29184,0,29184,108814,0,137998
132640701800000,NW 329,RESIDENTIAL,29328,0,29328,119720,0,149048
132640800100000,APARTMENT,COMMERCIAL,0,35300,35300,0,277329,312629
132640800200000,NW 329,RESIDENTIAL,33061,0,33061,106680,0,139741
132640800300000,NW 329,RESIDENTIAL,26320,0,26320,112028,0,138348
132640800400000,NW 329,RESIDENTIAL,26320,0,26320,121279,0,147599
132640800500000,NW 329,RESIDENTIAL,27720,0,27720,101886,0,129606
132640800600000,NW 329,RESIDENTIAL,29120,0,29120,99732,0,128852
132640800700000,NW 329,RESIDENTIAL,24700,0,24700,138064,0,162764
132640800800000,NW 329,RESIDENTIAL,22989,0,22989,103212,0,126201
132640800900000,NW 329,RESIDENTIAL,22232,0,22232,105768,0,128000
132640801000000,NW 329,RESIDENTIAL,22344,0,22344,143407,0,165751
132640801100000,NW 329,RESIDENTIAL,23092,0,23092,109789,0,132881
132640801200000,NW 329,RESIDENTIAL,21008,0,21008,143155,0,164163
132640801300000,NW 329,RESIDENTIAL,22230,0,22230,99942,0,122172
132640801400000,NW 329,RESIDENTIAL,22504,0,22504,119585,0,142089
132640801500000,NW 329,RESIDENTIAL,22560,0,22560,118241,0,140801
132640801600000,NW 329,RESIDENTIAL,19176,0,19176,120484,0,139660
132640801700000,NW 329,RESIDENTIAL,19740,0,19740,128564,0,148304
132640801800000,APARTMENT,COMMERCIAL,0,30734,30734,0,277516,308250
132640900100000,NW 329,RESIDENTIAL,22494,0,22494,103592,0,126086
132640900200000,NW 329,RESIDENTIAL,21243,0,21243,149852,0,171095
132640900300000,NW 329,RESIDENTIAL,22116,0,22116,128590,0,150706
132640900400000,NW 329,RESIDENTIAL,23491,0,23491,160519,0,184010
132640900500000,NW 329,RESIDENTIAL,29488,0,29488,117725,0,147213
132640900600000,NW 329,RESIDENTIAL,29488,0,29488,123953,0,153441
132640900700000,NW 329,RESIDENTIAL,29488,0,29488,104794,0,134282
132640900800000,NW 329,RESIDENTIAL,29488,0,29488,107825,0,137313
132640900900000,NW 329,RESIDENTIAL,29184,0,29184,106491,0,135675
132640901000000,NW 329,RESIDENTIAL,21825,0,21825,104709,0,126534
132640901100000,NW 329,RESIDENTIAL,22116,0,22116,123971,0,146087
132640901200000,NW 329,RESIDENTIAL,22896,0,22896,114551,0,137447
132640901300000,NW 329,RESIDENTIAL,23317,0,23317,125396,0,148713
132641000100000,NW 329,RESIDENTIAL,22133,0,22133,118365,0,140498
132641000200000,NW 329,RESIDENTIAL,20593,0,20593,140813,0,161406
132641000300000,NW 329,RESIDENTIAL,22185,0,22185,102825,0,125010
132642600100000,NW 329,RESIDENTIAL,28461,0,28461,103952,0,132413
132642600200000,NW 329,RESIDENTIAL,25700,0,25700,120442,0,146142
132642600300000,NW 329,RESIDENTIAL,25700,0,25700,91795,0,117495
132642600400000,NW 329,RESIDENTIAL,25700,0,25700,112287,0,137987
132642600500000,NW 329,RESIDENTIAL,25700,0,25700,86059,0,111759
132642600600000,NW 329,RESIDENTIAL,25700,0,25700,97880,0,123580
132642600700000,NW 329,RESIDENTIAL,25700,0,25700,99257,0,124957
132642600800000,NW 329,RESIDENTIAL,25700,0,25700,96171,0,121871
132642600900000,NW 329,RESIDENTIAL,25700,0,25700,91901,0,117601
132642601000000,NW 329,RESIDENTIAL,25700,0,25700,83986,0,109686
132642601100000,NW 329,RESIDENTIAL,27326,0,27326,93139,0,120465
132642700100000,NW 321,RESIDENTIAL,34936,0,34936,146264,0,181200
132642700200000,NW 321,RESIDENTIAL,33792,0,33792,150683,0,184475
132642700300000,NW 321,RESIDENTIAL,33792,0,33792,144306,0,178098
132642700400000,NW 321,RESIDENTIAL,33737,0,33737,157873,0,191610
132642700500000,NW 321,RESIDENTIAL,37297,0,37297,151510,0,188807
132642700600000,NW 321,RESIDENTIAL,36808,0,36808,154789,0,191597
132642700700000,NW 321,RESIDENTIAL,33657,0,33657,155503,0,189160
132642700800000,NW 321,RESIDENTIAL,33792,0,33792,131130,0,164922
132642700900000,NW 321,RESIDENTIAL,33792,0,33792,143988,0,177780
132642701000000,NW 321,RESIDENTIAL,34560,0,34560,134789,0,169349
132642701100000,NW 321,RESIDENTIAL,36986,0,36986,126409,0,163395
132642701200000,NW 329,RESIDENTIAL,28745,0,28745,92516,0,121261
132642701300000,NW 329,RESIDENTIAL,25700,0,25700,95126,0,120826
132642701400000,NW 329,RESIDENTIAL,25700,0,25700,101173,0,126873
132642701500000,NW 329,RESIDENTIAL,25700,0,25700,104830,0,130530
132642701600000,NW 329,RESIDENTIAL,25700,0,25700,94056,0,119756
132642701700000,NW 329,RESIDENTIAL,25700,0,25700,83522,0,109222
132642701800000,NW 329,RESIDENTIAL,25700,0,25700,96063,0,121763
132642701900000,NW 329,RESIDENTIAL,25700,0,25700,97490,0,123190
132642702000000,NW 329,RESIDENTIAL,25700,0,25700,92504,0,118204
132642702100000,NW 329,RESIDENTIAL,28054,0,28054,99900,0,127954
132642702200000,CITY PROPERTY,EXEMPT,0,0,0,0,0,0
132642800100000,NW 329,RESIDENTIAL,28079,0,28079,114018,0,142097
132642800200000,NW 329,RESIDENTIAL,25344,0,25344,99397,0,124741
132642800300000,NW 329,RESIDENTIAL,27797,0,27797,111609,0,139406
132642800400000,NW 329,RESIDENTIAL,25331,0,25331,88150,0,113481
132642800500000,NW 329,RESIDENTIAL,25502,0,25502,98268,0,123770
132642800600000,NW 329,RESIDENTIAL,25502,0,25502,98362,0,123864
132642800700000,NW 329,RESIDENTIAL,25502,0,25502,100034,0,125536
132642800800000,NW 329,RESIDENTIAL,25502,0,25502,89683,0,115185
132642800900000,NW 329,RESIDENTIAL,25502,0,25502,91377,0,116879
132642801000000,NW 329,RESIDENTIAL,30452,0,30452,107995,0,138447
132642801100000,NW 329,RESIDENTIAL,27975,0,27975,103536,0,131511
132642801200000,NW 329,RESIDENTIAL,25344,0,25344,110149,0,135493
132642801300000,NW 329,RESIDENTIAL,27900,0,27900,98517,0,126417
132642801400000,NW 329,RESIDENTIAL,26696,0,26696,113638,0,140334
132642801500000,NW 329,RESIDENTIAL,25502,0,25502,102812,0,128314
132642801600000,NW 329,RESIDENTIAL,25502,0,25502,122456,0,147958
132642801700000,NW 329,RESIDENTIAL,25502,0,25502,102893,0,128395
132642801800000,NW 329,RESIDENTIAL,25502,0,25502,87848,0,113350
132642801900000,NW 329,RESIDENTIAL,25502,0,25502,103259,0,128761
132642802000000,NW 329,RESIDENTIAL,25667,0,25667,123472,0,149139
132642900100000,NW 329,RESIDENTIAL,28079,0,28079,100401,0,128480
132642900200000,NW 329,RESIDENTIAL,25344,0,25344,87055,0,112399
132642900300000,NW 329,RESIDENTIAL,27797,0,27797,88330,0,116127
132642900400000,NW 329,RESIDENTIAL,25331,0,25331,114314,0,139645
132642900500000,NW 329,RESIDENTIAL,25502,0,25502,102824,0,128326
132642900600000,NW 329,RESIDENTIAL,25502,0,25502,101612,0,127114
132642900700000,NW 329,RESIDENTIAL,25502,0,25502,89539,0,115041
132642900800000,NW 329,RESIDENTIAL,25502,0,25502,97949,0,123451
132642900900000,NW 329,RESIDENTIAL,25502,0,25502,86649,0,112151
132642901000000,NW 329,RESIDENTIAL,28132,0,28132,108308,0,136440
132642901100000,NW 329,RESIDENTIAL,27975,0,27975,121154,0,149129
132642901200000,NW 329,RESIDENTIAL,25344,0,25344,103110,0,128454
132642901300000,NW 329,RESIDENTIAL,27900,0,27900,106204,0,134104
132642901400000,NW 329,RESIDENTIAL,27395,0,27395,103348,0,130743
132642901500000,NW 329,RESIDENTIAL,25502,0,25502,97140,0,122642
132642901600000,NW 329,RESIDENTIAL,25502,0,25502,95392,0,120894
132642901700000,NW 329,RESIDENTIAL,25502,0,25502,94484,0,119986
132642901800000,NW 329,RESIDENTIAL,25502,0,25502,84678,0,110180
132642901900000,NW 329,RESIDENTIAL,25502,0,25502,88349,0,113851
132642902000000,NW 329,RESIDENTIAL,25667,0,25667,91883,0,117550
132643000100000,NW 329,RESIDENTIAL,27975,0,27975,122568,0,150543
132643000200000,NW 329,RESIDENTIAL,25344,0,25344,121156,0,146500
132643000300000,NW 329,RESIDENTIAL,27900,0,27900,92890,0,120790
132643000400000,NW 329,RESIDENTIAL,25331,0,25331,127484,0,152815
132643000500000,NW 329,RESIDENTIAL,25423,0,25423,109023,0,134446
132643000600000,NW 329,RESIDENTIAL,25423,0,25423,78368,0,103791
132643000700000,NW 329,RESIDENTIAL,25423,0,25423,104570,0,129993
132643000800000,NW 329,RESIDENTIAL,25423,0,25423,99674,0,125097
132643000900000,NW 329,RESIDENTIAL,25423,0,25423,101655,0,127078
132643001000000,NW 329,RESIDENTIAL,25423,0,25423,99031,0,124454
132643001100000,NW 329,RESIDENTIAL,25423,0,25423,147548,0,172971
132643100100000,NW 329,RESIDENTIAL,27975,0,27975,90233,0,118208
132643100200000,NW 329,RESIDENTIAL,25085,0,25085,99182,0,124267
132643100300000,NW 329,RESIDENTIAL,26721,0,26721,110334,0,137055
132643100400000,NW 329,RESIDENTIAL,24288,0,24288,91499,0,115787
132643100500000,NW 329,RESIDENTIAL,24948,0,24948,99450,0,124398
132643100600000,NW 329,RESIDENTIAL,24948,0,24948,91436,0,116384
132643100700000,NW 329,RESIDENTIAL,24948,0,24948,95322,0,120270
132643100800000,NW 329,RESIDENTIAL,25700,0,25700,85516,0,111216
132643100900000,NW 329,RESIDENTIAL,25700,0,25700,97796,0,123496
132643101000000,NW 329,RESIDENTIAL,25700,0,25700,124233,0,149933
132643101100000,NW 329,RESIDENTIAL,25773,0,25773,112802,0,138575
132643200100000,NW 329,RESIDENTIAL,26817,0,26817,96439,0,123256
132643200200000,NW 329,RESIDENTIAL,25476,0,25476,84168,0,109644
132643200300000,NW 329,RESIDENTIAL,26928,0,26928,96458,0,123386
132643200400000,NW 329,RESIDENTIAL,25582,0,25582,98002,0,123584
132643200500000,NW 329,RESIDENTIAL,26334,0,26334,112005,0,138339
132643200600000,NW 329,RESIDENTIAL,21780,0,21780,97009,0,118789
132643200700000,NW 329,RESIDENTIAL,25344,0,25344,97766,0,123110
132643200800000,NW 329,RESIDENTIAL,24948,0,24948,88331,0,113279
132643200900000,NW 329,RESIDENTIAL,24948,0,24948,91897,0,116845
132643201000000,NW 329,RESIDENTIAL,24948,0,24948,106947,0,131895
132643201100000,NW 329,RESIDENTIAL,24740,0,24740,99189,0,123929
132643300100000,NW 329,RESIDENTIAL,28499,0,28499,118920,0,147419
132643300200000,NW 329,RESIDENTIAL,24779,0,24779,96749,0,121528
132643300300000,NW 329,RESIDENTIAL,26434,0,26434,105629,0,132063
132643300400000,NW 329,RESIDENTIAL,27868,0,27868,97542,0,125410
132643300500000,NW 329,RESIDENTIAL,25344,0,25344,99447,0,124791
132643300600000,NW 329,RESIDENTIAL,23760,0,23760,101442,0,125202
132643300700000,NW 329,RESIDENTIAL,21780,0,21780,97803,0,119583
132643300800000,NW 329,RESIDENTIAL,26334,0,26334,99403,0,125737
132643300900000,NW 329,RESIDENTIAL,25344,0,25344,93947,0,119291
132643301000000,NW 329,RESIDENTIAL,25344,0,25344,93314,0,118658
132643301100000,NW 329,RESIDENTIAL,23760,0,23760,107953,0,131713
132643301200000,NW 329,RESIDENTIAL,25344,0,25344,98494,0,123838
132643301300000,NW 329,RESIDENTIAL,26627,0,26627,92870,0,119497
132643400100000,NW 329,RESIDENTIAL,27751,0,27751,111593,0,139344
132643400200000,NW 329,RESIDENTIAL,26400,0,26400,105163,0,131563
132643400300000,NW 329,RESIDENTIAL,26233,0,26233,98660,0,124893
132643400400000,NW 329,RESIDENTIAL,22624,0,22624,90485,0,113109
132643400500000,NW 329,RESIDENTIAL,22624,0,22624,99347,0,121971
132643400600000,NW 329,RESIDENTIAL,24240,0,24240,88371,0,112611
132643400700000,NW 329,RESIDENTIAL,24240,0,24240,93477,0,117717
132643400800000,NW 329,RESIDENTIAL,25856,0,25856,96831,0,122687
132643400900000,NW 329,RESIDENTIAL,24240,0,24240,98789,0,123029
132645100100000,NW 329,RESIDENTIAL,25423,0,25423,99775,0,125198
132645100200000,NW 329,RESIDENTIAL,25423,0,25423,103658,0,129081
132645100300000,NW 329,RESIDENTIAL,25423,0,25423,107572,0,132995
132645100400000,NW 329,RESIDENTIAL,25423,0,25423,106848,0,132271
132645100500000,NW 329,RESIDENTIAL,25423,0,25423,105297,0,130720
132645100600000,NW 329,RESIDENTIAL,25423,0,25423,79968,0,105391
132645100700000,NW 329,RESIDENTIAL,25423,0,25423,77759,0,103182
132645100800000,NW 329,RESIDENTIAL,25423,0,25423,100045,0,125468
132645100900000,NW 329,RESIDENTIAL,25423,0,25423,99704,0,125127
132645101000000,NW 329,RESIDENTIAL,26651,0,26651,101494,0,128145
132645101100000,NW 329,RESIDENTIAL,26624,0,26624,100019,0,126643
132645101200000,NW 329,RESIDENTIAL,28242,0,28242,110448,0,138690
132645101300000,NW 329,RESIDENTIAL,28467,0,28467,108945,0,137412
132645101400000,NW 329,RESIDENTIAL,26730,0,26730,110457,0,137187
132645101500000,NW 329,RESIDENTIAL,25423,0,25423,102632,0,128055
132645101600000,NW 329,RESIDENTIAL,25423,0,25423,125116,0,150539
132645101700000,NW 329,RESIDENTIAL,25423,0,25423,100801,0,126224
132645101800000,NW 329,RESIDENTIAL,25423,0,25423,99590,0,125013
132645101900000,NW 329,RESIDENTIAL,25423,0,25423,92055,0,117478
132645102000000,NW 329,RESIDENTIAL,25423,0,25423,102050,0,127473
132645102100000,NW 329,RESIDENTIAL,25423,0,25423,119331,0,144754
132645200100000,NW 329,RESIDENTIAL,25700,0,25700,82087,0,107787
132645200200000,NW 329,RESIDENTIAL,24948,0,24948,95675,0,120623
132645200300000,NW 329,RESIDENTIAL,24948,0,24948,99277,0,124225
132645200400000,NW 329,RESIDENTIAL,24948,0,24948,94504,0,119452
132645200500000,NW 329,RESIDENTIAL,24948,0,24948,97882,0,122830
132645200600000,NW 329,RESIDENTIAL,24948,0,24948,84508,0,109456
132645200700000,NW 329,RESIDENTIAL,24948,0,24948,99419,0,124367
132645200800000,NW 329,RESIDENTIAL,24948,0,24948,88721,0,113669
132645200900000,NW 329,RESIDENTIAL,25054,0,25054,92362,0,117416
132645201000000,NW 329,RESIDENTIAL,24911,0,24911,106023,0,130934
132645201100000,NW 329,RESIDENTIAL,24902,0,24902,93200,0,118102
132645201200000,NW 329,RESIDENTIAL,24085,0,24085,93951,0,118036
132645201300000,NW 329,RESIDENTIAL,23680,0,23680,86103,0,109783
132645201400000,NW 329,RESIDENTIAL,24897,0,24897,93736,0,118633
132645201500000,NW 329,RESIDENTIAL,27571,0,27571,114343,0,141914
132645201600000,NW 329,RESIDENTIAL,29727,0,29727,125228,0,154955
132645201700000,NW 329,RESIDENTIAL,27930,0,27930,112773,0,140703
132645201800000,NW 329,RESIDENTIAL,27337,0,27337,114106,0,141443
132645201900000,NW 329,RESIDENTIAL,26730,0,26730,91694,0,118424
132645202000000,NW 329,RESIDENTIAL,26730,0,26730,98638,0,125368
132645202100000,NW 329,RESIDENTIAL,25700,0,25700,107902,0,133602
132645202200000,NW 329,RESIDENTIAL,25700,0,25700,110587,0,136287
132645202300000,NW 329,RESIDENTIAL,25700,0,25700,100060,0,125760
132645202400000,NW 329,RESIDENTIAL,25700,0,25700,100759,0,126459
132645202500000,NW 329,RESIDENTIAL,25700,0,25700,97511,0,123211
132645300100000,NW 329,RESIDENTIAL,24948,0,24948,95510,0,120458
132645300200000,NW 329,RESIDENTIAL,23760,0,23760,101562,0,125322
132645300300000,NW 329,RESIDENTIAL,23760,0,23760,89816,0,113576
132645300400000,NW 329,RESIDENTIAL,26334,0,26334,86017,0,112351
132645300500000,NW 329,RESIDENTIAL,26334,0,26334,113399,0,139733
132645300600000,NW 329,RESIDENTIAL,25344,0,25344,96661,0,122005
132645300700000,NW 329,RESIDENTIAL,25344,0,25344,110927,0,136271
132645300800000,NW 329,RESIDENTIAL,25344,0,25344,86320,0,111664
132645300900000,NW 329,RESIDENTIAL,21780,0,21780,95417,0,117197
132645301000000,NW 329,RESIDENTIAL,26334,0,26334,105935,0,132269
132645301100000,NW 329,RESIDENTIAL,26334,0,26334,97394,0,123728
132645301200000,NW 329,RESIDENTIAL,23760,0,23760,110270,0,134030
132645301300000,NW 329,RESIDENTIAL,25344,0,25344,87866,0,113210
132645301400000,NW 329,RESIDENTIAL,26440,0,26440,99763,0,126203
132645301500000,NW 329,RESIDENTIAL,22435,0,22435,103047,0,125482
132645301600000,NW 329,RESIDENTIAL,24064,0,24064,103962,0,128026
132645301700000,NW 329,RESIDENTIAL,25568,0,25568,96188,0,121756
132645301800000,NW 329,RESIDENTIAL,38880,0,38880,129046,0,167926
132645301900000,NW 329,RESIDENTIAL,26995,0,26995,110207,0,137202
132645302000000,NW 329,RESIDENTIAL,25452,0,25452,104755,0,130207
132645302100000,NW 329,RESIDENTIAL,24436,0,24436,89999,0,114435
132645302200000,NW 329,RESIDENTIAL,23760,0,23760,90672,0,114432
132645302300000,NW 329,RESIDENTIAL,23876,0,23876,82996,0,106872
132645302400000,NW 329,RESIDENTIAL,24865,0,24865,90298,0,115163
132645302500000,NW 329,RESIDENTIAL,24948,0,24948,80853,0,105801
132645302600000,NW 329,RESIDENTIAL,24948,0,24948,83046,0,107994
132645302700000,NW 329,RESIDENTIAL,24948,0,24948,89914,0,114862
132645302800000,NW 329,RESIDENTIAL,24948,0,24948,93035,0,117983
132645302900000,NW 329,RESIDENTIAL,24948,0,24948,88996,0,113944
132645303000000,NW 329,RESIDENTIAL,24948,0,24948,103785,0,128733
132645400100000,NW 329,RESIDENTIAL,23760,0,23760,91797,0,115557
132645400200000,NW 329,RESIDENTIAL,23760,0,23760,93395,0,117155
132645400300000,NW 329,RESIDENTIAL,22968,0,22968,88152,0,111120
132645400400000,NW 329,RESIDENTIAL,23760,0,23760,93044,0,116804
132645400500000,NW 329,RESIDENTIAL,26334,0,26334,90985,0,117319
132645400600000,NW 329,RESIDENTIAL,21780,0,21780,96011,0,117791
132645400700000,NW 329,RESIDENTIAL,25344,0,25344,103156,0,128500
132645400800000,NW 329,RESIDENTIAL,25344,0,25344,95657,0,121001
132645400900000,NW 329,RESIDENTIAL,23760,0,23760,90256,0,114016
132645401000000,NW 329,RESIDENTIAL,21780,0,21780,93593,0,115373
132645401100000,NW 329,RESIDENTIAL,26334,0,26334,97376,0,123710
132645401200000,NW 329,RESIDENTIAL,27018,0,27018,97036,0,124054
132645401300000,NW 329,RESIDENTIAL,26838,0,26838,106924,0,133762
132645401400000,NW 329,RESIDENTIAL,22176,0,22176,89227,0,111403
132645401500000,NW 329,RESIDENTIAL,23760,0,23760,97402,0,121162
132645401600000,NW 329,RESIDENTIAL,22176,0,22176,87390,0,109566
132645401700000,NW 329,RESIDENTIAL,22176,0,22176,103681,0,125857
132645401800000,NW 329,RESIDENTIAL,23760,0,23760,104862,0,128622
132645401900000,NW 329,RESIDENTIAL,22176,0,22176,83641,0,105817
132645402000000,NW 329,RESIDENTIAL,22176,0,22176,91683,0,113859
132645402100000,NW 329,RESIDENTIAL,23760,0,23760,85375,0,109135
132645402200000,NW 329,RESIDENTIAL,22176,0,22176,86912,0,109088
132645500100000,NW 329,RESIDENTIAL,22624,0,22624,99185,0,121809
132645500200000,NW 329,RESIDENTIAL,25856,0,25856,94813,0,120669
132645500300000,NW 329,RESIDENTIAL,22624,0,22624,87384,0,110008
132645500400000,NW 329,RESIDENTIAL,24240,0,24240,89055,0,113295
132645500500000,NW 329,RESIDENTIAL,22848,0,22848,96032,0,118880
132645500600000,NW 329,RESIDENTIAL,24480,0,24480,85737,0,110217
132645500700000,NW 329,RESIDENTIAL,22848,0,22848,89496,0,112344
132645500800000,NW 329,RESIDENTIAL,22848,0,22848,86221,0,109069
132645500900000,NW 329,RESIDENTIAL,24480,0,24480,92049,0,116529
132645501000000,NW 329,RESIDENTIAL,22848,0,22848,89391,0,112239
132645501100000,NW 329,RESIDENTIAL,25936,0,25936,94485,0,120421
132645600100000,NW 329,RESIDENTIAL,50000,0,50000,111617,0,161617
132645600200000,STATE PROPERTY,EXEMPT,0,0,0,0,0,0
132645700100000,NW 329,RESIDENTIAL,23331,0,23331,92466,0,115797
132645700200000,NW 329,RESIDENTIAL,23312,0,23312,88269,0,111581
132645700300000,NW 329,RESIDENTIAL,22247,0,22247,99642,0,121889
132645700400000,NW 329,RESIDENTIAL,23424,0,23424,94244,0,117668
132645700500000,NW 329,RESIDENTIAL,25979,0,25979,110378,0,136357
132645700600000,NW 329,RESIDENTIAL,23959,0,23959,88825,0,112784
132645700700000,NW 329,RESIDENTIAL,23280,0,23280,98148,0,121428
132645700800000,NW 329,RESIDENTIAL,24832,0,24832,83969,0,108801
132645700900000,NW 329,RESIDENTIAL,23280,0,23280,94225,0,117505
132645701000000,NW 329,RESIDENTIAL,24138,0,24138,103495,0,127633
132645701100000,NW 329,RESIDENTIAL,38563,0,38563,73917,0,112480
132647600100000,NW 329,RESIDENTIAL,28733,0,28733,158461,0,187194
132647600200000,NW 329,RESIDENTIAL,20445,0,20445,118696,0,139141
132647600300000,NW 329,RESIDENTIAL,22185,0,22185,162778,0,184963
132647600400000,NW 329,RESIDENTIAL,20445,0,20445,138466,0,158911
132647700100000,NW 329,RESIDENTIAL,22572,0,22572,124130,0,146702
132647700200000,NW 329,RESIDENTIAL,22275,0,22275,122418,0,144693
132647700300000,CHURCH,EXEMPT,0,423576,423576,0,1129329,1552905
132647700400000,NW 329,RESIDENTIAL,29184,0,29184,127484,0,156668
132647700500000,NW 329,RESIDENTIAL,22275,0,22275,107307,0,129582
132647700600000,NW 329,RESIDENTIAL,22572,0,22572,126084,0,148656
132647800300000,CONVENIENCE STORE,COMMERCIAL,0,276000,276000,0,483452,759452
132647800400000,VACANT LAND,COMMERCIAL,0,130760,130760,0,0,130760
132647800500000,VACANT LAND,COMMERCIAL,0,125020,125020,0,0,125020
132647800600000,VACANT LAND,COMMERCIAL,0,132840,132840,0,0,132840
132710300100000,CITY PROPERTY,EXEMPT,0,0,0,0,0,0
132710300200000,NW 332,RESIDENTIAL,48884,0,48884,154749,0,203633
132710300300000,NW 332,RESIDENTIAL,52001,0,52001,142508,0,194509
132710300400000,NW 332,RESIDENTIAL,45984,0,45984,205214,0,251198
132710300500000,NW 332,RESIDENTIAL,46189,0,46189,189611,0,235800
132710300600000,NW 332,RESIDENTIAL,39208,0,39208,171338,0,210546
132710300700000,NW 332,RESIDENTIAL,46376,0,46376,199196,0,245572
132710300800000,NW 332,RESIDENTIAL,61050,0,61050,207749,0,268799
132710300900000,NW 332,RESIDENTIAL,54413,0,54413,189921,0,244334
132710301000000,NW 332,RESIDENTIAL,37730,0,37730,164761,0,202491
132710301100000,NW 332,RESIDENTIAL,41800,0,41800,189368,0,231168
132710301200000,NW 332,RESIDENTIAL,44000,0,44000,152208,0,196208
132710301300000,NW 332,RESIDENTIAL,36300,0,36300,192567,0,228867
132710301400000,NW 332,RESIDENTIAL,54434,0,54434,199352,0,253786
132710301500000,NW 332,RESIDENTIAL,37583,0,37583,185587,0,223170
132710301600000,NW 332,RESIDENTIAL,38115,0,38115,167836,0,205951
132710301700000,NW 332,RESIDENTIAL,35937,0,35937,161978,0,197915
132710301800000,NW 332,RESIDENTIAL,41382,0,41382,168801,0,210183
132710301900000,NW 332,RESIDENTIAL,38115,0,38115,164124,0,202239
132710302000000,NW 332,RESIDENTIAL,38115,0,38115,192112,0,230227
132710302100000,NW 332,RESIDENTIAL,35937,0,35937,152115,0,188052
132710302200000,NW 332,RESIDENTIAL,6020,0,6020,0,0,6020
132710302300000,NW 332,RESIDENTIAL,46933,0,46933,203199,0,250132
132710302400000,NW 332,RESIDENTIAL,51480,0,51480,175999,0,227479
132710302500000,NW 332,RESIDENTIAL,44440,0,44440,152803,0,197243
132710302600000,NW 332,RESIDENTIAL,44000,0,44000,163401,0,207401
132710302700000,NW 332,RESIDENTIAL,55000,0,55000,161995,0,216995
132710400100000,NW 332,RESIDENTIAL,56518,0,56518,207794,0,264312
132710400200000,NW 332,RESIDENTIAL,41800,0,41800,206733,0,248533
132710400300000,NW 332,RESIDENTIAL,38500,0,38500,191353,0,229853
132710400400000,NW 332,RESIDENTIAL,45833,0,45833,200486,0,246319
132710400500000,NW 332,RESIDENTIAL,75615,0,75615,223820,0,299435
132710400600000,NW 332,RESIDENTIAL,71280,0,71280,221746,0,293026
132710400700000,CITY PROPERTY,EXEMPT,0,0,0,0,0,0
132710400800000,NW 332,RESIDENTIAL,56991,0,56991,194456,0,251447
132710400900000,NW 332,RESIDENTIAL,40205,0,40205,159316,0,199521
132710401000000,NW 332,RESIDENTIAL,43758,0,43758,184243,0,228001
132710401100000,NW 332,RESIDENTIAL,36300,0,36300,164503,0,200803
132710401200000,NW 332,RESIDENTIAL,47773,0,47773,169152,0,216925
132710401300000,NW 332,RESIDENTIAL,42167,0,42167,167878,0,210045
132710401400000,NW 332,RESIDENTIAL,43267,0,43267,143852,0,187119
132710401500000,NW 332,RESIDENTIAL,65179,0,65179,167636,0,232815
132710401800000,NW 332,RESIDENTIAL,44275,0,44275,156497,0,200772
132710401900000,NW 332,RESIDENTIAL,52525,0,52525,149471,0,201996
132710500100000,NW 332,RESIDENTIAL,55000,0,55000,161452,0,216452
132710500200000,NW 332,RESIDENTIAL,55550,0,55550,169577,0,225127
132710600100000,NW 332,RESIDENTIAL,52250,0,52250,191274,0,243524
132710600200000,NW 332,RESIDENTIAL,36300,0,36300,169009,0,205309
132710600300000,NW 332,RESIDENTIAL,44000,0,44000,158216,0,202216
132710600400000,NW 332,RESIDENTIAL,35750,0,35750,217799,0,253549
132710600500000,NW 332,RESIDENTIAL,55778,0,55778,145245,0,201023
132710600600000,NW 332,RESIDENTIAL,55539,0,55539,125312,0,180851
132710600700000,NW 332,RESIDENTIAL,38500,0,38500,168275,0,206775
132710600800000,NW 332,RESIDENTIAL,36300,0,36300,160860,0,197160
132710600900000,NW 332,RESIDENTIAL,41800,0,41800,174515,0,216315
132710601000000,NW 332,RESIDENTIAL,52250,0,52250,172750,0,225000
132712600100000,NW 332,RESIDENTIAL,59000,0,59000,57747,0,116747
132712600300000,NW 332,RESIDENTIAL,45329,0,45329,155210,0,200539
132712600400000,NW 332,RESIDENTIAL,35666,0,35666,141015,0,176681
132712600500000,NW 332,RESIDENTIAL,39886,0,39886,148836,0,188722
132712600600000,NW 332,RESIDENTIAL,38269,0,38269,138910,0,177179
132712600800000,NW 332,RESIDENTIAL,43524,0,43524,154935,0,198459
132712600900000,NW 332,RESIDENTIAL,43524,0,43524,178880,0,222404
132712601000000,NW 332,RESIDENTIAL,38269,0,38269,172839,0,211108
132712601100000,NW 332,RESIDENTIAL,39886,0,39886,187401,0,227287
132712601200000,NW 332,RESIDENTIAL,38988,0,38988,157868,0,196856
132712601300000,NW 332,RESIDENTIAL,45130,0,45130,192577,0,237707
132712601400000,NW 332,RESIDENTIAL,44367,0,44367,150253,0,194620
132712700100000,NW 332,RESIDENTIAL,49742,0,49742,181299,0,231041
132712700200000,NW 332,RESIDENTIAL,48285,0,48285,168334,0,216619
132712700300000,NW 332,RESIDENTIAL,50160,0,50160,199949,0,250109
132712700400000,NW 332,RESIDENTIAL,48250,0,48250,177657,0,225907
132712700500000,NW 332,RESIDENTIAL,50134,0,50134,221400,0,271534
132712700600000,NW 332,RESIDENTIAL,50756,0,50756,137008,0,187764
132712700700000,NW 332,RESIDENTIAL,51414,0,51414,173554,0,224968
132712700800000,NW 332,RESIDENTIAL,47025,0,47025,164509,0,211534
132712700900000,NW 332,RESIDENTIAL,47652,0,47652,155334,0,202986
132712701000000,NW 332,RESIDENTIAL,50787,0,50787,178040,0,228827
132712701100000,NW 332,RESIDENTIAL,47652,0,47652,172301,0,219953
132712701200000,NW 332,RESIDENTIAL,39870,0,39870,171040,0,210910
132712701300000,NW 332,RESIDENTIAL,46656,0,46656,177449,0,224105
132712701400000,NW 332,RESIDENTIAL,40024,0,40024,180554,0,220578
132712701500000,NW 332,RESIDENTIAL,41056,0,41056,227393,0,268449
132712701600000,NW 332,RESIDENTIAL,40953,0,40953,160625,0,201578
132712701700000,NW 332,RESIDENTIAL,42995,0,42995,190138,0,233133
132712701800000,CITY PROPERTY,EXEMPT,0,0,0,0,0,0
132712701900000,NW 332,RESIDENTIAL,41320,0,41320,248902,0,290222
132712702000000,NW 332,RESIDENTIAL,43725,0,43725,209080,0,252805
132712702100000,NW 332,RESIDENTIAL,48131,0,48131,492029,0,540160
132712702200000,NW 332,RESIDENTIAL,47880,0,47880,251507,0,299387
132712702300000,NW 332,RESIDENTIAL,44183,0,44183,279565,0,323748
132712702400000,NW 332,RESIDENTIAL,13700,0,13700,0,0,13700
132712800100000,NW 332,RESIDENTIAL,38269,0,38269,138560,0,176829
132712800200000,NW 332,RESIDENTIAL,42231,0,42231,185609,0,227840
132712800300000,NW 332,RESIDENTIAL,43237,0,43237,166290,0,209527
132712800400000,NW 332,RESIDENTIAL,43569,0,43569,173717,0,217286
132712800500000,NW 332,RESIDENTIAL,44384,0,44384,161947,0,206331
132712800600000,NW 332,RESIDENTIAL,43426,0,43426,181093,0,224519
132712800800000,NW 332,RESIDENTIAL,38269,0,38269,156088,0,194357
132712800900000,NW 332,RESIDENTIAL,41005,0,41005,181696,0,222701
132712801000000,NW 332,RESIDENTIAL,45833,0,45833,168665,0,214498
132712801100000,NW 332,RESIDENTIAL,43338,0,43338,162749,0,206087
132712801200000,NW 332,RESIDENTIAL,41983,0,41983,171576,0,213559
132712801300000,NW 332,RESIDENTIAL,48185,0,48185,168612,0,216797
132712801400000,NW 332,RESIDENTIAL,45760,0,45760,213040,0,258800
132712801500000,NW 332,RESIDENTIAL,45774,0,45774,199427,0,245201
132712801600000,NW 332,RESIDENTIAL,44550,0,44550,140394,0,184944
132712801700000,NW 332,RESIDENTIAL,39050,0,39050,160985,0,200035
132712801800000,NW 332,RESIDENTIAL,36300,0,36300,181128,0,217428
132712801900000,NW 332,RESIDENTIAL,40700,0,40700,160859,0,201559
132712802000000,NW 332,RESIDENTIAL,39050,0,39050,189602,0,228652
132712802100000,NW 332,RESIDENTIAL,41648,0,41648,160537,0,202185
132712802200000,NW 332,RESIDENTIAL,44020,0,44020,189835,0,233855
132712802300000,NW 332,RESIDENTIAL,42899,0,42899,162164,0,205063
132712802400000,NW 332,RESIDENTIAL,39305,0,39305,144290,0,183595
132712802500000,NW 332,RESIDENTIAL,40700,0,40700,156050,0,196750
132712802600000,NW 332,RESIDENTIAL,39050,0,39050,145863,0,184913
132712802700000,NW 332,RESIDENTIAL,44486,0,44486,168667,0,213153
132712802800000,NW 332,RESIDENTIAL,40251,0,40251,189504,0,229755
132712802900000,NW 332,RESIDENTIAL,40190,0,40190,173440,0,213630
132712803000000,NW 332,RESIDENTIAL,39886,0,39886,133135,0,173021
132712900100000,NW 332,RESIDENTIAL,43231,0,43231,177325,0,220556
132712900200000,NW 332,RESIDENTIAL,43917,0,43917,176287,0,220204
132712900300000,NW 332,RESIDENTIAL,46843,0,46843,152172,0,199015
132712900400000,NW 332,RESIDENTIAL,40656,0,40656,142206,0,182862
132712900500000,NW 332,RESIDENTIAL,42396,0,42396,191301,0,233697
132712900600000,NW 332,RESIDENTIAL,40391,0,40391,212517,0,252908
132712900700000,NW 332,RESIDENTIAL,41683,0,41683,146745,0,188428
132712900800000,NW 332,RESIDENTIAL,45301,0,45301,169155,0,214456
132712900900000,NW 332,RESIDENTIAL,40983,0,40983,151680,0,192663
132712901000000,NW 332,RESIDENTIAL,44294,0,44294,160624,0,204918
132712901100000,NW 332,RESIDENTIAL,35404,0,35404,148630,0,184034
132712901200000,NW 332,RESIDENTIAL,37350,0,37350,194245,0,231595
132713000100000,NW 332,RESIDENTIAL,44876,0,44876,153912,0,198788
132713000200000,NW 332,RESIDENTIAL,38665,0,38665,153854,0,192519
132713000300000,NW 332,RESIDENTIAL,39710,0,39710,169571,0,209281
132713000400000,NW 332,RESIDENTIAL,37784,0,37784,185991,0,223775
132713000500000,NW 332,RESIDENTIAL,44406,0,44406,168041,0,212447
132713000600000,NW 332,RESIDENTIAL,45905,0,45905,170172,0,216077
132713000700000,NW 332,RESIDENTIAL,39402,0,39402,167142,0,206544
132713000800000,NW 332,RESIDENTIAL,36300,0,36300,142824,0,179124
132713000900000,NW 332,RESIDENTIAL,39776,0,39776,158891,0,198667
132713001000000,NW 332,RESIDENTIAL,41292,0,41292,164177,0,205469
132713001100000,NW 332,RESIDENTIAL,43785,0,43785,151189,0,194974
132713001200000,NW 332,RESIDENTIAL,45085,0,45085,192172,0,237257
132715100100000,NW 331,RESIDENTIAL,31800,0,31800,132182,0,163982
132715100200000,NW 331,RESIDENTIAL,34026,0,34026,112967,0,146993
132715100300000,NW 331,RESIDENTIAL,36283,0,36283,159989,0,196272
132715100400000,NW 332,RESIDENTIAL,46410,0,46410,164401,0,210811
132715100500000,NW 332,RESIDENTIAL,42780,0,42780,112432,0,155212
132715100600000,NW 332,RESIDENTIAL,42002,0,42002,141857,0,183859
132715200100000,NW 332,RESIDENTIAL,42216,0,42216,215343,0,257559
132715200200000,NW 332,RESIDENTIAL,48642,0,48642,277671,0,326313
132715200300000,NW 332,RESIDENTIAL,41676,0,41676,156505,0,198181
132715200400000,NW 332,RESIDENTIAL,40120,0,40120,158251,0,198371
132715200500000,NW 332,RESIDENTIAL,35813,0,35813,148471,0,184284
132715200600000,NW 332,RESIDENTIAL,35582,0,35582,188764,0,224346
132715200700000,NW 332,RESIDENTIAL,39425,0,39425,157073,0,196498
132715200800000,NW 332,RESIDENTIAL,40139,0,40139,144883,0,185022
132715200900000,NW 332,RESIDENTIAL,38580,0,38580,167928,0,206508
132715201000000,NW 332,RESIDENTIAL,36210,0,36210,152657,0,188867
132715201100000,NW 332,RESIDENTIAL,35700,0,35700,154733,0,190433
132715201200000,NW 332,RESIDENTIAL,37740,0,37740,169332,0,207072
132715201300000,NW 332,RESIDENTIAL,39469,0,39469,160423,0,199892
132715201400000,NW 332,RESIDENTIAL,38325,0,38325,151216,0,189541
132715201500000,NW 332,RESIDENTIAL,37762,0,37762,150258,0,188020
132715201600000,NW 332,RESIDENTIAL,39884,0,39884,158519,0,198403
132715201700000,NW 332,RESIDENTIAL,37962,0,37962,138000,0,175962
132715201800000,NW 332,RESIDENTIAL,44009,0,44009,141586,0,185595
132715201900000,NW 332,RESIDENTIAL,35243,0,35243,140908,0,176151
132715202000000,NW 332,RESIDENTIAL,39659,0,39659,161836,0,201495
132715202100000,NW 332,RESIDENTIAL,41027,0,41027,157263,0,198290
132715202200000,NW 332,RESIDENTIAL,41040,0,41040,143186,0,184226
132715202300000,NW 332,RESIDENTIAL,41015,0,41015,154382,0,195397
132715202400000,NW 332,RESIDENTIAL,41316,0,41316,156125,0,197441
132715202500000,NW 332,RESIDENTIAL,42619,0,42619,149228,0,191847
132715202600000,NW 332,RESIDENTIAL,46700,0,46700,187218,0,233918
132715202700000,NW 332,RESIDENTIAL,44710,0,44710,169996,0,214706
132715202800000,NW 332,RESIDENTIAL,43457,0,43457,139531,0,182988
132715202900000,NW 332,RESIDENTIAL,44030,0,44030,131423,0,175453
132715203000000,NW 332,RESIDENTIAL,43633,0,43633,149642,0,193275
132715203100000,NW 332,RESIDENTIAL,42480,0,42480,135545,0,178025
132715203200000,NW 332,RESIDENTIAL,44679,0,44679,152368,0,197047
132715300100000,NW 332,RESIDENTIAL,37270,0,37270,159222,0,196492
132715300200000,NW 332,RESIDENTIAL,34810,0,34810,153795,0,188605
132715300300000,NW 332,RESIDENTIAL,33000,0,33000,126984,0,159984
132715300400000,NW 332,RESIDENTIAL,35000,0,35000,143410,0,178410
132715300500000,NW 332,RESIDENTIAL,40713,0,40713,166138,0,206851
132715400100000,NW 331,RESIDENTIAL,35298,0,35298,164334,0,199632
132715400200000,NW 331,RESIDENTIAL,36694,0,36694,141124,0,177818
132715400300000,NW 332,RESIDENTIAL,40636,0,40636,123882,0,164518
132715400400000,NW 332,RESIDENTIAL,42058,0,42058,148233,0,190291
132715400500000,NW 332,RESIDENTIAL,40425,0,40425,172574,0,212999
132715500100000,NW 332,RESIDENTIAL,37826,0,37826,170129,0,207955
132715500200000,NW 332,RESIDENTIAL,38717,0,38717,137900,0,176617
132715500300000,NW 332,RESIDENTIAL,39900,0,39900,156107,0,196007
132715500400000,NW 332,RESIDENTIAL,39983,0,39983,135955,0,175938
132715500500000,NW 332,RESIDENTIAL,37794,0,37794,163766,0,201560
132715500600000,NW 332,RESIDENTIAL,39819,0,39819,167555,0,207374
132715500700000,NW 332,RESIDENTIAL,40375,0,40375,135676,0,176051
132715500800000,NW 332,RESIDENTIAL,37500,0,37500,159368,0,196868
132715500900000,NW 332,RESIDENTIAL,34950,0,34950,157333,0,192283
132715501000000,NW 332,RESIDENTIAL,37145,0,37145,166854,0,203999
132715501100000,NW 332,RESIDENTIAL,39843,0,39843,158737,0,198580
132715501200000,NW 332,RESIDENTIAL,40676,0,40676,177831,0,218507
132715501300000,NW 332,RESIDENTIAL,37251,0,37251,161897,0,199148
132715501400000,NW 332,RESIDENTIAL,41846,0,41846,162594,0,204440
132715501500000,NW 332,RESIDENTIAL,38247,0,38247,164008,0,202255
132715501600000,NW 332,RESIDENTIAL,35689,0,35689,134812,0,170501
132715501700000,NW 332,RESIDENTIAL,37983,0,37983,160551,0,198534
132715501800000,NW 332,RESIDENTIAL,35500,0,35500,135000,0,170500
132715501900000,NW 332,RESIDENTIAL,37500,0,37500,139080,0,176580
132715502000000,NW 332,RESIDENTIAL,35500,0,35500,155446,0,190946
132715502100000,NW 332,RESIDENTIAL,37500,0,37500,115143,0,152643
132715502200000,NW 332,RESIDENTIAL,40375,0,40375,172193,0,212568
132715502300000,NW 332,RESIDENTIAL,39465,0,39465,167055,0,206520
132715502400000,NW 332,RESIDENTIAL,36711,0,36711,169141,0,205852
132715502500000,NW 332,RESIDENTIAL,35700,0,35700,145778,0,181478
132715502600000,NW 332,RESIDENTIAL,38314,0,38314,193863,0,232177
132715502700000,NW 332,RESIDENTIAL,36513,0,36513,152036,0,188549
132715600100000,NW 332,RESIDENTIAL,40800,0,40800,174122,0,214922
132715600200000,NW 332,RESIDENTIAL,38340,0,38340,150047,0,188387
132715600300000,NW 332,RESIDENTIAL,36865,0,36865,170601,0,207466
132715600400000,NW 332,RESIDENTIAL,38678,0,38678,189845,0,228523
132715600500000,NW 332,RESIDENTIAL,41904,0,41904,145476,0,187380
132715700100000,NW 332,RESIDENTIAL,41724,0,41724,154978,0,196702
132715700200000,NW 332,RESIDENTIAL,36705,0,36705,175427,0,212132
132715700300000,NW 332,RESIDENTIAL,37209,0,37209,166278,0,203487
132715700400000,NW 332,RESIDENTIAL,34581,0,34581,171783,0,206364
132715700500000,NW 332,RESIDENTIAL,34650,0,34650,153755,0,188405
132715700600000,NW 332,RESIDENTIAL,39174,0,39174,134421,0,173595
132715700700000,NW 332,RESIDENTIAL,42075,0,42075,167047,0,209122
132715700800000,NW 332,RESIDENTIAL,42500,0,42500,163658,0,206158
132715700900000,NW 332,RESIDENTIAL,43387,0,43387,121945,0,165332
132715701000000,NW 332,RESIDENTIAL,43890,0,43890,147283,0,191173
132715701100000,NW 332,RESIDENTIAL,47089,0,47089,196414,0,243503
132715701200000,NW 332,RESIDENTIAL,39541,0,39541,141961,0,181502
132715701300000,NW 332,RESIDENTIAL,42930,0,42930,166105,0,209035
132715800100000,NW 332,RESIDENTIAL,43875,0,43875,139747,0,183622
132715800200000,NW 332,RESIDENTIAL,39270,0,39270,149353,0,188623
132715800300000,NW 332,RESIDENTIAL,42004,0,42004,129692,0,171696
132715800400000,NW 332,RESIDENTIAL,42402,0,42402,128879,0,171281
132715800500000,NW 332,RESIDENTIAL,36819,0,36819,152910,0,189729
132715800600000,NW 332,RESIDENTIAL,40225,0,40225,158685,0,198910
132715800700000,NW 332,RESIDENTIAL,42649,0,42649,163624,0,206273
132715800800000,NW 332,RESIDENTIAL,42594,0,42594,149069,0,191663
132715800900000,NW 332,RESIDENTIAL,40680,0,40680,160214,0,200894
132715801000000,NW 332,RESIDENTIAL,42000,0,42000,179115,0,221115
132715801100000,NW 332,RESIDENTIAL,37060,0,37060,158600,0,195660
132715801200000,NW 332,EXEMPT,0,37000,37000,0,154044,191044
132715801300000,NW 332,RESIDENTIAL,37655,0,37655,149934,0,187589
132715801400000,NW 332,RESIDENTIAL,42750,0,42750,157428,0,200178
132715900100000,NW 332,RESIDENTIAL,42483,0,42483,204729,0,247212
132717600100000,NW 331,RESIDENTIAL,27552,0,27552,117595,0,145147
132717600200000,NW 331,RESIDENTIAL,29250,0,29250,112860,0,142110
132717600300000,NW 331,RESIDENTIAL,34200,0,34200,127678,0,161878
132717600400000,NW 331,RESIDENTIAL,31050,0,31050,112879,0,143929
132717600500000,NW 331,RESIDENTIAL,32400,0,32400,126640,0,159040
132717600600000,NW 331,RESIDENTIAL,36900,0,36900,111559,0,148459
132717600700000,NW 331,RESIDENTIAL,37350,0,37350,133860,0,171210
132717600800000,NW 331,RESIDENTIAL,34200,0,34200,128376,0,162576
132717600900000,NW 331,RESIDENTIAL,34200,0,34200,125273,0,159473
132717601000000,NW 331,RESIDENTIAL,30816,0,30816,123902,0,154718
132717601100000,NW 331,RESIDENTIAL,35100,0,35100,107664,0,142764
132717601200000,NW 331,RESIDENTIAL,35100,0,35100,143033,0,178133
132717601300000,NW 331,RESIDENTIAL,35100,0,35100,139752,0,174852
132717601400000,NW 331,RESIDENTIAL,35100,0,35100,124592,0,159692
132717601500000,NW 331,RESIDENTIAL,35100,0,35100,126175,0,161275
132717601600000,NW 331,RESIDENTIAL,35100,0,35100,165057,0,200157
132717601700000,NW 331,RESIDENTIAL,36450,0,36450,140401,0,176851
132717700100000,NW 331,RESIDENTIAL,27736,0,27736,157133,0,184869
132717700200000,NW 331,RESIDENTIAL,34606,0,34606,136715,0,171321
132717700300000,NW 331,RESIDENTIAL,29850,0,29850,121468,0,151318
132717700400000,NW 331,RESIDENTIAL,32433,0,32433,118091,0,150524
132717700500000,NW 331,RESIDENTIAL,32742,0,32742,121607,0,154349
132717700600000,NW 331,RESIDENTIAL,31664,0,31664,145283,0,176947
132717700700000,NW 331,RESIDENTIAL,36600,0,36600,108856,0,145456
132717700800000,NW 331,RESIDENTIAL,32314,0,32314,123502,0,155816
132717700900000,NW 331,RESIDENTIAL,31646,0,31646,130780,0,162426
132717701000000,NW 331,RESIDENTIAL,30491,0,30491,122165,0,152656
132717701100000,NW 331,RESIDENTIAL,28660,0,28660,125988,0,154648
132717701200000,NW 331,RESIDENTIAL,31536,0,31536,149517,0,181053
132717701300000,NW 331,RESIDENTIAL,29498,0,29498,123113,0,152611
132717701400000,NW 331,RESIDENTIAL,32490,0,32490,127094,0,159584
132717701500000,NW 331,RESIDENTIAL,29222,0,29222,149216,0,178438
132717701600000,NW 331,RESIDENTIAL,33901,0,33901,149907,0,183808
132717800100000,NW 331,RESIDENTIAL,36317,0,36317,132862,0,169179
132717800200000,NW 331,RESIDENTIAL,28958,0,28958,123529,0,152487
132717800300000,NW 331,RESIDENTIAL,30875,0,30875,133112,0,163987
132717800400000,NW 331,RESIDENTIAL,31333,0,31333,123922,0,155255
132717800500000,NW 331,RESIDENTIAL,27500,0,27500,159247,0,186747
132717800600000,NW 331,RESIDENTIAL,29088,0,29088,155759,0,184847
132717800700000,NW 331,RESIDENTIAL,32088,0,32088,169593,0,201681
132717800800000,NW 331,RESIDENTIAL,30223,0,30223,129813,0,160036
132717800900000,NW 331,RESIDENTIAL,31208,0,31208,141230,0,172438
132717801000000,NW 331,RESIDENTIAL,30033,0,30033,139008,0,169041
132717801100000,NW 331,RESIDENTIAL,31609,0,31609,133515,0,165124
132717801200000,NW 331,RESIDENTIAL,31185,0,31185,136006,0,167191
132717801300000,NW 331,RESIDENTIAL,32270,0,32270,146168,0,178438
132717801400000,NW 331,RESIDENTIAL,31055,0,31055,154115,0,185170
132717801500000,NW 331,RESIDENTIAL,36068,0,36068,150291,0,186359
132717801600000,NW 332,RESIDENTIAL,39222,0,39222,142269,0,181491
132717801700000,NW 331,RESIDENTIAL,37170,0,37170,147774,0,184944
132717801800000,NW 331,RESIDENTIAL,36000,0,36000,118963,0,154963
132717801900000,NW 331,RESIDENTIAL,34774,0,34774,119554,0,154328
132717802000000,NW 331,RESIDENTIAL,29536,0,29536,133937,0,163473
132717802100000,NW 331,RESIDENTIAL,34308,0,34308,100771,0,135079
132717802200000,NW 331,RESIDENTIAL,34655,0,34655,131175,0,165830
132717802300000,NW 331,RESIDENTIAL,32672,0,32672,149849,0,182521
132717802400000,NW 331,RESIDENTIAL,28512,0,28512,137720,0,166232
132717802500000,NW 331,RESIDENTIAL,32832,0,32832,110625,0,143457
132717802600000,NW 331,RESIDENTIAL,28659,0,28659,126001,0,154660
132717802700000,NW 331,RESIDENTIAL,33320,0,33320,134463,0,167783
132717802800000,NW 331,RESIDENTIAL,29400,0,29400,106547,0,135947
132717802900000,NW 331,RESIDENTIAL,36128,0,36128,132673,0,168801
132717900100000,NW 331,RESIDENTIAL,34494,0,34494,128691,0,163185
132717900200000,NW 331,RESIDENTIAL,29823,0,29823,139600,0,169423
132717900300000,NW 331,RESIDENTIAL,29491,0,29491,129861,0,159352
132717900400000,NW 331,RESIDENTIAL,28568,0,28568,132440,0,161008
132717900500000,NW 331,RESIDENTIAL,29376,0,29376,125851,0,155227
132717900600000,NW 331,RESIDENTIAL,29376,0,29376,130404,0,159780
132717900700000,NW 331,RESIDENTIAL,33748,0,33748,126503,0,160251
132717900800000,NW 331,RESIDENTIAL,32832,0,32832,124792,0,157624
132717900900000,NW 331,RESIDENTIAL,33012,0,33012,120173,0,153185
132717901000000,NW 331,RESIDENTIAL,34786,0,34786,130296,0,165082
132717901100000,NW 331,RESIDENTIAL,34779,0,34779,148063,0,182842
132717901200000,NW 331,RESIDENTIAL,35169,0,35169,124877,0,160046
132717901300000,NW 332,RESIDENTIAL,38592,0,38592,127042,0,165634
132717901400000,NW 332,RESIDENTIAL,39190,0,39190,176822,0,216012
132717901500000,NW 332,RESIDENTIAL,39560,0,39560,107323,0,146883
132717901600000,NW 332,RESIDENTIAL,35000,0,35000,117510,0,152510
132717901700000,NW 332,RESIDENTIAL,44188,0,44188,137585,0,181773
132717901800000,NW 331,RESIDENTIAL,36146,0,36146,118002,0,154148
132717901900000,NW 331,RESIDENTIAL,32729,0,32729,136626,0,169355
132717902000000,NW 331,RESIDENTIAL,34200,0,34200,123710,0,157910
132717902100000,NW 331,RESIDENTIAL,38013,0,38013,126327,0,164340
132717902200000,NW 331,RESIDENTIAL,37029,0,37029,120371,0,157400
132717902300000,NW 331,RESIDENTIAL,33587,0,33587,139831,0,173418
132717902400000,NW 331,RESIDENTIAL,28159,0,28159,119214,0,147373
132717902500000,NW 331,RESIDENTIAL,34047,0,34047,128457,0,162504
132717902600000,NW 331,RESIDENTIAL,34402,0,34402,142902,0,177304
132717902700000,NW 331,RESIDENTIAL,31741,0,31741,116223,0,147964
132717902800000,NW 331,RESIDENTIAL,35910,0,35910,155468,0,191378
132717902900000,NW 331,RESIDENTIAL,34556,0,34556,119231,0,153787
132717903000000,NW 331,RESIDENTIAL,33035,0,33035,129029,0,162064
132717903100000,NW 331,RESIDENTIAL,33487,0,33487,127965,0,161452
132717903200000,NW 331,RESIDENTIAL,29391,0,29391,118233,0,147624
132717903300000,NW 331,RESIDENTIAL,33995,0,33995,129347,0,163342
132717903400000,NW 331,RESIDENTIAL,35698,0,35698,110606,0,146304
132717903500000,NW 331,RESIDENTIAL,34075,0,34075,130927,0,165002
132717903600000,NW 331,RESIDENTIAL,34671,0,34671,104944,0,139615
132717903700000,NW 331,RESIDENTIAL,35405,0,35405,111086,0,146491
132717903800000,NW 331,RESIDENTIAL,33075,0,33075,140272,0,173347
132717903900000,NW 331,RESIDENTIAL,34992,0,34992,153079,0,188071
132717904000000,NW 331,RESIDENTIAL,32400,0,32400,125704,0,158104
132717904100000,NW 331,RESIDENTIAL,34560,0,34560,133660,0,168220
132717904200000,NW 331,RESIDENTIAL,28512,0,28512,105067,0,133579
132717904300000,NW 331,RESIDENTIAL,28983,0,28983,122792,0,151775
132718000100000,NW 332,RESIDENTIAL,41463,0,41463,142158,0,183621
132718000200000,NW 332,RESIDENTIAL,36050,0,36050,157329,0,193379
132718000300000,NW 332,RESIDENTIAL,43841,0,43841,137677,0,181518
132718100100000,NW 331,RESIDENTIAL,34007,0,34007,128881,0,162888
132718100200000,NW 331,RESIDENTIAL,27864,0,27864,130579,0,158443
132718100300000,NW 331,RESIDENTIAL,29088,0,29088,124527,0,153615
132718100400000,NW 331,RESIDENTIAL,33473,0,33473,143744,0,177217
132718100500000,NW 331,RESIDENTIAL,27648,0,27648,119110,0,146758
132718100600000,NW 331,RESIDENTIAL,25875,0,25875,97269,0,123144
132718100700000,NW 331,RESIDENTIAL,32785,0,32785,127883,0,160668
132718100800000,NW 331,RESIDENTIAL,32269,0,32269,118043,0,150312
132718100900000,NW 331,RESIDENTIAL,34547,0,34547,120575,0,155122
132718101000000,NW 331,RESIDENTIAL,28209,0,28209,146335,0,174544
132718101100000,NW 331,RESIDENTIAL,33435,0,33435,126039,0,159474
132718200100000,NW 331,RESIDENTIAL,35640,0,35640,118634,0,154274
132718200200000,NW 331,RESIDENTIAL,34128,0,34128,157395,0,191523
132718200300000,NW 331,RESIDENTIAL,35195,0,35195,104953,0,140148
132718200400000,NW 331,RESIDENTIAL,34997,0,34997,119008,0,154005
132718200500000,NW 331,RESIDENTIAL,36108,0,36108,114363,0,150471
132718200600000,NW 332,RESIDENTIAL,44506,0,44506,119551,0,164057
132718200700000,NW 332,RESIDENTIAL,47149,0,47149,160787,0,207936
132718200800000,NW 332,RESIDENTIAL,43746,0,43746,166325,0,210071
132720100200000,NW 332,RESIDENTIAL,37525,0,37525,184604,0,222129
132720200100000,NW 332,RESIDENTIAL,46517,0,46517,186807,0,233324
132720200200000,NW 332,RESIDENTIAL,37232,0,37232,172356,0,209588
132720200300000,NW 332,RESIDENTIAL,38252,0,38252,153378,0,191630
132725200100000,NW 332,RESIDENTIAL,46200,0,46200,259506,0,305706
132725200200000,NW 332,RESIDENTIAL,46200,0,46200,267115,0,313315
132725200300000,NW 332,RESIDENTIAL,46200,0,46200,309940,0,356140
132725200400000,NW 332,RESIDENTIAL,46200,0,46200,196250,0,242450
132725200500000,NW 332,RESIDENTIAL,46200,0,46200,277875,0,324075
132725200600000,NW 332,RESIDENTIAL,46200,0,46200,302583,0,348783
132725200700000,NW 332,RESIDENTIAL,44000,0,44000,261000,0,305000
132725200800000,NW 332,RESIDENTIAL,49133,0,49133,213347,0,262480
132725200900000,NW 332,RESIDENTIAL,61013,0,61013,243972,0,304985
132725201000000,NW 332,RESIDENTIAL,850,0,850,0,0,850
132725300100000,NW 332,RESIDENTIAL,72,0,72,0,0,72
132725300200000,NW 332,RESIDENTIAL,56247,0,56247,311005,0,367252
132725300300000,NW 332,RESIDENTIAL,49913,0,49913,254175,0,304088
132725300400000,NW 332,RESIDENTIAL,17,0,17,0,0,17
132725400100000,NW 332,RESIDENTIAL,44880,0,44880,277130,0,322010
132725400200000,NW 332,RESIDENTIAL,44880,0,44880,224660,0,269540
132725400300000,NW 332,RESIDENTIAL,41514,0,41514,204385,0,245899
132725400400000,NW 332,RESIDENTIAL,41514,0,41514,197758,0,239272
132725400500000,NW 332,RESIDENTIAL,44880,0,44880,204284,0,249164
132725400600000,NW 332,RESIDENTIAL,39270,0,39270,171272,0,210542
132725400700000,NW 332,RESIDENTIAL,44880,0,44880,227900,0,272780
132725400800000,NW 332,RESIDENTIAL,40018,0,40018,173199,0,213217
132725400900000,NW 332,RESIDENTIAL,235,0,235,0,0,235
132725401000000,NW 332,RESIDENTIAL,45188,0,45188,196893,0,242081
132725401100000,NW 332,RESIDENTIAL,54624,0,54624,210020,0,264644
132725401200000,NW 332,RESIDENTIAL,613,0,613,0,0,613
132725401300000,NW 332,RESIDENTIAL,512,0,512,0,0,512
132725401400000,NW 332,RESIDENTIAL,499,0,499,0,0,499
132725401500000,NW 332,RESIDENTIAL,474,0,474,0,0,474
132725401600000,NW 332,RESIDENTIAL,43197,0,43197,213323,0,256520
132725401700000,NW 332,RESIDENTIAL,502,0,502,0,0,502
132725401800000,NW 332,RESIDENTIAL,490,0,490,0,0,490
132725401900000,NW 332,RESIDENTIAL,472,0,472,0,0,472
132725402000000,NW 332,RESIDENTIAL,515,0,515,0,0,515
132725402100000,NW 332,RESIDENTIAL,490,0,490,0,0,490
132725402200000,NW 332,RESIDENTIAL,47124,0,47124,181494,0,228618
132725402300000,NW 332,RESIDENTIAL,46002,0,46002,224957,0,270959
132725500100000,NW 332,RESIDENTIAL,108,0,108,0,0,108
132725500200000,CITY PROPERTY,EXEMPT,0,0,0,0,0,0
132725500300000,NW 332,RESIDENTIAL,335,0,335,0,0,335
132725500400000,NW 332,RESIDENTIAL,47933,0,47933,291447,0,339380
132725500500000,NW 332,RESIDENTIAL,57845,0,57845,291155,0,349000
132725500600000,NW 332,RESIDENTIAL,47612,0,47612,278477,0,326089
132725500700000,NW 332,RESIDENTIAL,50846,0,50846,220600,0,271446
132725500800000,NW 332,RESIDENTIAL,66770,0,66770,294313,0,361083
132725500900000,NW 332,RESIDENTIAL,846,0,846,0,0,846
132725501000000,NW 332,RESIDENTIAL,262,0,262,0,0,262
132725600100000,NW 332,RESIDENTIAL,464,0,464,0,0,464
132725600200000,NW 332,RESIDENTIAL,494,0,494,0,0,494
132725600300000,NW 332,RESIDENTIAL,44880,0,44880,73757,0,118637
132725600400000,NW 332,RESIDENTIAL,46002,0,46002,177980,0,223982
132725600500000,NW 332,RESIDENTIAL,440,0,440,0,0,440
132725600600000,NW 332,RESIDENTIAL,470,0,470,0,0,470
132725600700000,NW 332,RESIDENTIAL,44880,0,44880,188796,0,233676
132725600800000,NW 332,RESIDENTIAL,44880,0,44880,194814,0,239694
132725600900000,NW 332,RESIDENTIAL,458,0,458,0,0,458
132725601000000,NW 332,RESIDENTIAL,539,0,539,0,0,539
132725601100000,NW 332,RESIDENTIAL,52580,0,52580,210586,0,263166
132725601200000,NW 332,RESIDENTIAL,53018,0,53018,211595,0,264613
132725601300000,NW 332,RESIDENTIAL,47894,0,47894,306556,0,354450
132725601400000,NW 332,RESIDENTIAL,497,0,497,0,0,497
132725601500000,NW 332,RESIDENTIAL,39270,0,39270,185467,0,224737
132725601600000,NW 332,RESIDENTIAL,564,0,564,0,0,564
132725601700000,NW 332,RESIDENTIAL,172,0,172,0,0,172
132725601800000,CITY PROPERTY,EXEMPT,0,0,0,0,0,0
132727600100000,NW 332,RESIDENTIAL,40000,0,40000,173090,0,213090
132727600200000,NW 332,RESIDENTIAL,40000,0,40000,180046,0,220046
132727600300000,NW 332,RESIDENTIAL,40000,0,40000,147106,0,187106
132727600400000,NW 332,RESIDENTIAL,40000,0,40000,194124,0,234124
132727600500000,NW 332,RESIDENTIAL,40350,0,40350,191544,0,231894
132727700100000,NW 332,RESIDENTIAL,45055,0,45055,162283,0,207338
132727700200000,NW 332,RESIDENTIAL,37500,0,37500,182523,0,220023
132727700300000,NW 332,RESIDENTIAL,37500,0,37500,161338,0,198838
132727700500000,NW 332,RESIDENTIAL,37500,0,37500,143425,0,180925
132727700600000,NW 332,RESIDENTIAL,37500,0,37500,170885,0,208385
132727700700000,NW 332,RESIDENTIAL,45055,0,45055,223968,0,269023
132727800100000,NW 332,RESIDENTIAL,42840,0,42840,187060,0,229900
132727800200000,NW 332,RESIDENTIAL,44253,0,44253,187423,0,231676
132727800300000,NW 332,RESIDENTIAL,45640,0,45640,166804,0,212444
132727900100000,NW 332,RESIDENTIAL,45055,0,45055,165417,0,210472
132727900200000,NW 332,RESIDENTIAL,37500,0,37500,168515,0,206015
132727900300000,NW 332,RESIDENTIAL,37500,0,37500,162577,0,200077
132727900400000,NW 332,RESIDENTIAL,37793,0,37793,156789,0,194582
132727900500000,NW 332,RESIDENTIAL,37502,0,37502,171005,0,208507
132727900600000,NW 332,RESIDENTIAL,41833,0,41833,178203,0,220036
132727900700000,NW 332,RESIDENTIAL,49181,0,49181,224547,0,273728
132727900800000,NW 332,RESIDENTIAL,49500,0,49500,201149,0,250649
132727900900000,NW 332,RESIDENTIAL,49500,0,49500,199246,0,248746
132727901000000,NW 332,RESIDENTIAL,44000,0,44000,241567,0,285567
132727901100000,NW 332,RESIDENTIAL,46200,0,46200,258044,0,304244
132727901200000,NW 332,RESIDENTIAL,45100,0,45100,218041,0,263141
132727901300000,NW 332,RESIDENTIAL,46519,0,46519,261600,0,308119
132727901400000,NW 332,RESIDENTIAL,44000,0,44000,322079,0,366079
132727901500000,NW 332,RESIDENTIAL,44000,0,44000,227617,0,271617
132727901600000,NW 332,RESIDENTIAL,44000,0,44000,235758,0,279758
132728000100000,NW 332,RESIDENTIAL,37860,0,37860,165656,0,203516
132728000200000,NW 332,RESIDENTIAL,38282,0,38282,179127,0,217409
132728000300000,NW 332,RESIDENTIAL,34868,0,34868,171280,0,206148
132728000400000,NW 332,RESIDENTIAL,38382,0,38382,181918,0,220300
132728000500000,NW 332,RESIDENTIAL,38252,0,38252,168505,0,206757
132728000600000,NW 332,RESIDENTIAL,37922,0,37922,161711,0,199633
132728000700000,NW 332,RESIDENTIAL,40033,0,40033,174206,0,214239
132728000800000,NW 332,RESIDENTIAL,36569,0,36569,166074,0,202643
132728000900000,NW 332,RESIDENTIAL,40720,0,40720,182519,0,223239
132728001000000,NW 332,RESIDENTIAL,37881,0,37881,161820,0,199701
132728001100000,NW 332,RESIDENTIAL,37541,0,37541,160516,0,198057
132728001200000,NW 332,RESIDENTIAL,38519,0,38519,172475,0,210994
132728001300000,NW 332,RESIDENTIAL,38331,0,38331,175462,0,213793
132728001400000,NW 332,RESIDENTIAL,44880,0,44880,246598,0,291478
132728001500000,NW 332,RESIDENTIAL,44880,0,44880,184627,0,229507
132728001600000,NW 332,RESIDENTIAL,64515,0,64515,409773,0,474288
132728001700000,NW 332,RESIDENTIAL,48807,0,48807,260198,0,309005
132728001800000,NW 332,RESIDENTIAL,47124,0,47124,230791,0,277915
132728001900000,NW 332,RESIDENTIAL,48063,0,48063,278260,0,326323
132728002000000,NW 332,RESIDENTIAL,43166,0,43166,311013,0,354179
132728002100000,NW 332,RESIDENTIAL,40800,0,40800,213585,0,254385
132728002200000,NW 332,RESIDENTIAL,42840,0,42840,243168,0,286008
132728002300000,NW 332,RESIDENTIAL,44880,0,44880,213327,0,258207
132728002400000,NW 332,RESIDENTIAL,44880,0,44880,214540,0,259420
132728002500000,NW 332,RESIDENTIAL,44880,0,44880,252245,0,297125
132728002600000,NW 332,RESIDENTIAL,44554,0,44554,195320,0,239874
132728002700000,NW 332,RESIDENTIAL,51000,0,51000,270488,0,321488
132728002800000,NW 332,RESIDENTIAL,51000,0,51000,181118,0,232118
132728100100000,NW 332,RESIDENTIAL,40197,0,40197,156084,0,196281
132728100200000,NW 332,RESIDENTIAL,41108,0,41108,200052,0,241160
132728100300000,NW 332,RESIDENTIAL,36980,0,36980,134053,0,171033
132728100400000,NW 332,RESIDENTIAL,39140,0,39140,162988,0,202128
132728100500000,NW 332,RESIDENTIAL,38967,0,38967,201226,0,240193
132728100600000,NW 332,RESIDENTIAL,39600,0,39600,172657,0,212257
132728100800000,NW 332,RESIDENTIAL,42941,0,42941,182951,0,225892
132728100900000,NW 332,RESIDENTIAL,42636,0,42636,218094,0,260730
132728101000000,NW 332,RESIDENTIAL,42636,0,42636,202364,0,245000
132728101100000,NW 332,RESIDENTIAL,42636,0,42636,198234,0,240870
132728101200000,NW 332,RESIDENTIAL,40698,0,40698,242664,0,283362
132728101300000,NW 332,RESIDENTIAL,40800,0,40800,171892,0,212692
132728101400000,NW 332,RESIDENTIAL,42519,0,42519,138242,0,180761
132728101500000,NW 332,RESIDENTIAL,462,0,462,0,0,462
132728101600000,NW 332,RESIDENTIAL,44319,0,44319,192277,0,236596
132728101700000,NW 332,RESIDENTIAL,476,0,476,0,0,476
132728200100000,NW 332,RESIDENTIAL,53108,0,53108,191544,0,244652
132728200200000,NW 332,RESIDENTIAL,581,0,581,0,0,581
132740100100000,NW 331,RESIDENTIAL,38283,0,38283,0,0,38283
132740100200000,NW 331,RESIDENTIAL,35100,0,35100,110178,0,145278
132740100300000,NW 331,RESIDENTIAL,35147,0,35147,122706,0,157853
132740100400000,NW 331,RESIDENTIAL,36237,0,36237,128162,0,164399
132740100500000,NW 331,RESIDENTIAL,30447,0,30447,155867,0,186314
132740100600000,NW 331,RESIDENTIAL,29818,0,29818,122700,0,152518
132740100700000,NW 331,RESIDENTIAL,34200,0,34200,139422,0,173622
132740100800000,NW 331,RESIDENTIAL,36118,0,36118,147794,0,183912
132740100900000,NW 331,RESIDENTIAL,40171,0,40171,127728,0,167899
132740101000000,NW 331,RESIDENTIAL,39132,0,39132,139057,0,178189
132740101100000,NW 331,RESIDENTIAL,32755,0,32755,133727,0,166482
132740101200000,NW 331,RESIDENTIAL,38556,0,38556,138573,0,177129
132740101300000,NW 331,RESIDENTIAL,34957,0,34957,156094,0,191051
132740101400000,NW 331,RESIDENTIAL,42707,0,42707,145966,0,188673
132740101500000,NW 331,RESIDENTIAL,41265,0,41265,142881,0,184146
132740101600000,NW 332,RESIDENTIAL,41063,0,41063,171075,0,212138
132740101700000,NW 332,RESIDENTIAL,41667,0,41667,177079,0,218746
132740101800000,NW 332,RESIDENTIAL,38380,0,38380,172926,0,211306
132740101900000,NW 332,RESIDENTIAL,38380,0,38380,206387,0,244767
132740102000000,NW 332,RESIDENTIAL,40500,0,40500,182092,0,222592
132740102100000,NW 332,RESIDENTIAL,41496,0,41496,194819,0,236315
132740102200000,NW 332,RESIDENTIAL,38380,0,38380,166662,0,205042
132740102300000,NW 332,RESIDENTIAL,40905,0,40905,206110,0,247015
132740102400000,NW 332,RESIDENTIAL,38380,0,38380,156168,0,194548
132740102500000,NW 332,RESIDENTIAL,41310,0,41310,197251,0,238561
132740102600000,NW 332,RESIDENTIAL,42000,0,42000,156831,0,198831
132740102700000,NW 332,RESIDENTIAL,40857,0,40857,163981,0,204838
132740102800000,NW 332,RESIDENTIAL,40857,0,40857,176408,0,217265
132740102900000,NW 332,RESIDENTIAL,39936,0,39936,166930,0,206866
132740103000000,NW 332,RESIDENTIAL,41310,0,41310,187860,0,229170
132740103100000,NW 332,RESIDENTIAL,41310,0,41310,177262,0,218572
132740103200000,NW 332,RESIDENTIAL,38359,0,38359,171737,0,210096
132740103400000,SCHOOL,EXEMPT,0,585090,585090,0,2086494,2671584
132740103500000,CITY PROPERTY,EXEMPT,0,0,0,0,0,0
132740200100000,NW 332,RESIDENTIAL,41225,0,41225,182589,0,223814
132740200200000,NW 332,RESIDENTIAL,39600,0,39600,169090,0,208690
132740200300000,NW 332,RESIDENTIAL,43917,0,43917,159141,0,203058
132740300100000,NW 332,RESIDENTIAL,41225,0,41225,194959,0,236184
132740300200000,NW 332,RESIDENTIAL,40595,0,40595,170297,0,210892
132740300300000,NW 332,RESIDENTIAL,11323,0,11323,0,0,11323
132740300400000,NW 332,RESIDENTIAL,39584,0,39584,161140,0,200724
132740300500000,NW 332,RESIDENTIAL,41225,0,41225,193163,0,234388
132740300600000,NW 332,RESIDENTIAL,39600,0,39600,169512,0,209112
132740400100000,NW 332,RESIDENTIAL,40419,0,40419,209924,0,250343
132740400200000,NW 332,RESIDENTIAL,36333,0,36333,167323,0,203656
132740400300000,NW 332,RESIDENTIAL,39878,0,39878,173698,0,213576
132740400400000,NW 332,RESIDENTIAL,1782,0,1782,0,0,1782
132740400500000,NW 332,RESIDENTIAL,4533,0,4533,0,0,4533
132740400600000,NW 332,RESIDENTIAL,39500,0,39500,173952,0,213452
132740400700000,NW 332,RESIDENTIAL,38191,0,38191,156911,0,195102
132740400800000,NW 332,RESIDENTIAL,39200,0,39200,165532,0,204732
132740400900000,NW 332,RESIDENTIAL,41511,0,41511,192639,0,234150
132740401000000,NW 332,RESIDENTIAL,39413,0,39413,168188,0,207601
132740500100000,NW 332,RESIDENTIAL,39947,0,39947,189357,0,229304
132740500200000,NW 332,RESIDENTIAL,40000,0,40000,158770,0,198770
132740500300000,NW 332,RESIDENTIAL,35055,0,35055,166717,0,201772
132740500400000,NW 332,RESIDENTIAL,38176,0,38176,156711,0,194887
132740500500000,NW 332,RESIDENTIAL,38730,0,38730,191800,0,230530
132740500600000,NW 332,RESIDENTIAL,1533,0,1533,0,0,1533
132742600100000,NW 332,RESIDENTIAL,43105,0,43105,166860,0,209965
132742600200000,NW 332,RESIDENTIAL,39979,0,39979,181015,0,220994
132742600300000,NW 332,RESIDENTIAL,39988,0,39988,170025,0,210013
132742600400000,NW 332,RESIDENTIAL,38860,0,38860,196012,0,234872
132742600500000,NW 332,RESIDENTIAL,40800,0,40800,174133,0,214933
132742600600000,NW 332,RESIDENTIAL,38760,0,38760,173988,0,212748
132742600700000,NW 332,RESIDENTIAL,40800,0,40800,194319,0,235119
132742600800000,NW 332,RESIDENTIAL,38760,0,38760,170129,0,208889
132742600900000,NW 332,RESIDENTIAL,38760,0,38760,203234,0,241994
132742601000000,NW 332,RESIDENTIAL,40800,0,40800,191434,0,232234
132742601100000,NW 332,RESIDENTIAL,38760,0,38760,156846,0,195606
132742601200000,NW 332,RESIDENTIAL,41815,0,41815,154471,0,196286
132742601300000,NW 332,RESIDENTIAL,41253,0,41253,169121,0,210374
132742601400000,NW 332,RESIDENTIAL,38830,0,38830,151168,0,189998
132742601500000,NW 332,RESIDENTIAL,41462,0,41462,181751,0,223213
132742700100000,CITY PROPERTY,EXEMPT,0,0,0,0,0,0
132742700200000,NW 332,RESIDENTIAL,50022,0,50022,219932,0,269954
132742700300000,NW 332,RESIDENTIAL,44689,0,44689,174783,0,219472
132742700400000,NW 332,RESIDENTIAL,44506,0,44506,175760,0,220266
132742700500000,NW 332,RESIDENTIAL,46084,0,46084,178303,0,224387
132742700600000,NW 332,RESIDENTIAL,45207,0,45207,162125,0,207332
132742700700000,NW 332,RESIDENTIAL,43727,0,43727,177442,0,221169
132742700800000,NW 332,RESIDENTIAL,40920,0,40920,183605,0,224525
132742700900000,NW 332,RESIDENTIAL,46750,0,46750,196818,0,243568
132742701000000,NW 332,RESIDENTIAL,44000,0,44000,177439,0,221439
132742701100000,NW 332,RESIDENTIAL,46750,0,46750,178809,0,225559
132742701200000,NW 332,RESIDENTIAL,44000,0,44000,190971,0,234971
132742701300000,NW 332,RESIDENTIAL,46750,0,46750,255444,0,302194
132742701400000,NW 332,RESIDENTIAL,44000,0,44000,199005,0,243005
132742701500000,NW 332,RESIDENTIAL,46750,0,46750,177613,0,224363
132742800100000,NW 332,RESIDENTIAL,40143,0,40143,152924,0,193067
132742800200000,NW 332,RESIDENTIAL,39232,0,39232,156065,0,195297
132742800300000,NW 332,RESIDENTIAL,40472,0,40472,197411,0,237883
132742800400000,NW 332,RESIDENTIAL,40375,0,40375,190880,0,231255
132742800500000,NW 332,RESIDENTIAL,37500,0,37500,155791,0,193291
132742800600000,NW 332,RESIDENTIAL,39900,0,39900,205423,0,245323
132742800700000,NW 332,RESIDENTIAL,38000,0,38000,169001,0,207001
132742800800000,NW 332,RESIDENTIAL,40000,0,40000,182258,0,222258
132742800900000,NW 332,RESIDENTIAL,40000,0,40000,178438,0,218438
132742801000000,NW 332,RESIDENTIAL,38000,0,38000,192612,0,230612
132742801100000,NW 332,RESIDENTIAL,41906,0,41906,195339,0,237245
132742801200000,NW 332,RESIDENTIAL,47829,0,47829,184445,0,232274
132742801300000,NW 332,RESIDENTIAL,42496,0,42496,174442,0,216938
132742801400000,NW 332,RESIDENTIAL,41314,0,41314,183509,0,224823
132742801500000,NW 332,RESIDENTIAL,46932,0,46932,161968,0,208900
132742801600000,NW 332,RESIDENTIAL,48787,0,48787,192213,0,241000
132742801700000,NW 332,RESIDENTIAL,42212,0,42212,232935,0,275147
132742801800000,NW 332,RESIDENTIAL,38966,0,38966,159553,0,198519
132742801900000,NW 332,RESIDENTIAL,40000,0,40000,180346,0,220346
132742802000000,NW 332,RESIDENTIAL,39000,0,39000,178989,0,217989
132742802100000,NW 332,RESIDENTIAL,40000,0,40000,185758,0,225758
132742802200000,NW 332,RESIDENTIAL,40000,0,40000,154918,0,194918
132742802300000,NW 332,RESIDENTIAL,39900,0,39900,203836,0,243736
132742802400000,NW 332,RESIDENTIAL,38000,0,38000,136841,0,174841
132742802500000,NW 332,RESIDENTIAL,38791,0,38791,176740,0,215531
132742802600000,NW 332,RESIDENTIAL,38104,0,38104,184422,0,222526
132742802700000,NW 332,RESIDENTIAL,41099,0,41099,175615,0,216714
132742900100000,NW 332,RESIDENTIAL,39333,0,39333,192497,0,231830
132742900200000,NW 332,RESIDENTIAL,41747,0,41747,192518,0,234265
132742900300000,NW 332,RESIDENTIAL,38265,0,38265,163389,0,201654
132742900400000,NW 332,RESIDENTIAL,39900,0,39900,186383,0,226283
132742900500000,NW 332,RESIDENTIAL,36000,0,36000,160165,0,196165
132742900600000,NW 332,RESIDENTIAL,40000,0,40000,191468,0,231468
132742900700000,NW 332,RESIDENTIAL,38000,0,38000,172501,0,210501
132742900800000,NW 332,RESIDENTIAL,39500,0,39500,153110,0,192610
132742900900000,NW 332,RESIDENTIAL,43817,0,43817,169610,0,213427
132742901000000,NW 332,RESIDENTIAL,44222,0,44222,198855,0,243077
132742901100000,NW 332,RESIDENTIAL,46751,0,46751,180352,0,227103
132742901200000,NW 332,RESIDENTIAL,467,0,467,0,0,467
132743000100000,NW 332,RESIDENTIAL,46838,0,46838,177467,0,224305
132743000200000,NW 332,RESIDENTIAL,42350,0,42350,190138,0,232488
132743000300000,NW 332,RESIDENTIAL,47226,0,47226,186701,0,233927
132743000400000,NW 332,RESIDENTIAL,43010,0,43010,170841,0,213851
132743000500000,NW 332,RESIDENTIAL,41250,0,41250,144501,0,185751
132743000600000,NW 332,RESIDENTIAL,44412,0,44412,200377,0,244789
132743000700000,NW 332,RESIDENTIAL,44000,0,44000,193530,0,237530
132743000800000,NW 332,RESIDENTIAL,41250,0,41250,162161,0,203411
132743000900000,NW 332,RESIDENTIAL,44412,0,44412,209075,0,253487
132743001000000,NW 332,RESIDENTIAL,44000,0,44000,180485,0,224485
132743001100000,NW 332,RESIDENTIAL,41663,0,41663,168985,0,210648
132743001200000,NW 332,RESIDENTIAL,42322,0,42322,142986,0,185308
132743001300000,NW 332,RESIDENTIAL,44329,0,44329,200804,0,245133
132743001400000,NW 332,RESIDENTIAL,44440,0,44440,211267,0,255707
132743001500000,NW 332,RESIDENTIAL,41107,0,41107,187211,0,228318
132743001600000,NW 332,RESIDENTIAL,44440,0,44440,191294,0,235734
132743001700000,NW 332,RESIDENTIAL,41107,0,41107,178356,0,219463
132743100100000,NW 332,RESIDENTIAL,46477,0,46477,222060,0,268537
132743100200000,NW 332,RESIDENTIAL,44935,0,44935,202624,0,247559
132743100300000,NW 332,RESIDENTIAL,45100,0,45100,219486,0,264586
132743100400000,NW 332,RESIDENTIAL,44412,0,44412,259548,0,303960
132743100500000,NW 332,RESIDENTIAL,44412,0,44412,224915,0,269327
132745100100000,NW 332,AG LAND,74265,0,74265,0,0,74265
132745100200000,NW 332,RESIDENTIAL,43890,0,43890,268412,0,312302
132745100300000,NW 332,RESIDENTIAL,49530,0,49530,209885,0,259415
132745200100000,NW 332,RESIDENTIAL,41663,0,41663,174426,0,216089
132745200200000,NW 332,RESIDENTIAL,44000,0,44000,201586,0,245586
132745200500000,NW 332,RESIDENTIAL,46030,0,46030,221386,0,267416
132745200600000,NW 332,RESIDENTIAL,46316,0,46316,226761,0,273077
132745300100000,NW 332,RESIDENTIAL,44407,0,44407,172645,0,217052
132745300300000,NW 332,RESIDENTIAL,140,0,140,0,0,140
132745300400000,NW 332,RESIDENTIAL,45852,0,45852,202174,0,248026
132745400100000,NW 332,RESIDENTIAL,44550,0,44550,270644,0,315194
132745400200000,NW 332,RESIDENTIAL,44000,0,44000,187483,0,231483
132745400300000,NW 332,RESIDENTIAL,38500,0,38500,170767,0,209267
132745400400000,NW 332,RESIDENTIAL,44000,0,44000,249597,0,293597
132745400500000,NW 332,RESIDENTIAL,38500,0,38500,161820,0,200320
132745400600000,NW 332,RESIDENTIAL,44000,0,44000,206904,0,250904
132745400700000,NW 332,RESIDENTIAL,42350,0,42350,178540,0,220890
132745400800000,NW 332,RESIDENTIAL,42900,0,42900,165429,0,208329
132745400900000,NW 332,RESIDENTIAL,44000,0,44000,186963,0,230963
132745401000000,NW 332,RESIDENTIAL,45108,0,45108,184196,0,229304
132745500100000,NW 332,RESIDENTIAL,46496,0,46496,220074,0,266570
132745500200000,NW 332,RESIDENTIAL,44996,0,44996,193625,0,238621
132745500300000,NW 332,RESIDENTIAL,36663,0,36663,175483,0,212146
132745500400000,NW 332,RESIDENTIAL,44440,0,44440,216555,0,260995
132745500500000,NW 332,RESIDENTIAL,44440,0,44440,223259,0,267699
132745500600000,NW 332,RESIDENTIAL,44440,0,44440,194841,0,239281
132745500700000,NW 332,RESIDENTIAL,36663,0,36663,163628,0,200291
132745500800000,NW 332,RESIDENTIAL,38885,0,38885,184939,0,223824
132745500900000,NW 332,RESIDENTIAL,44440,0,44440,202865,0,247305
132745501000000,NW 332,RESIDENTIAL,44460,0,44460,162156,0,206616
132745501100000,NW 332,RESIDENTIAL,44332,0,44332,274908,0,319240
132745501200000,NW 332,RESIDENTIAL,44151,0,44151,270696,0,314847
132745501300000,NW 332,RESIDENTIAL,42350,0,42350,184377,0,226727
132745501400000,NW 332,RESIDENTIAL,45925,0,45925,202019,0,247944
132745501500000,NW 332,RESIDENTIAL,46200,0,46200,222104,0,268304
132745501600000,NW 332,RESIDENTIAL,44000,0,44000,195221,0,239221
132745501700000,NW 332,RESIDENTIAL,45783,0,45783,214755,0,260538
132745501800000,NW 332,RESIDENTIAL,44550,0,44550,194535,0,239085
132745600100000,NW 332,RESIDENTIAL,46602,0,46602,163029,0,209631
132745600200000,NW 332,RESIDENTIAL,42900,0,42900,141470,0,184370
132745600300000,NW 332,RESIDENTIAL,47339,0,47339,170451,0,217790
132745600400000,NW 332,RESIDENTIAL,45373,0,45373,159588,0,204961
132745600500000,NW 332,RESIDENTIAL,46398,0,46398,181618,0,228016
132745600600000,NW 332,RESIDENTIAL,40884,0,40884,149064,0,189948
132745600700000,NW 332,RESIDENTIAL,46038,0,46038,168768,0,214806
132745600800000,NW 332,RESIDENTIAL,45336,0,45336,204092,0,249428
132745700100000,NW 332,RESIDENTIAL,46555,0,46555,268517,0,315072
132745700200000,NW 332,RESIDENTIAL,41382,0,41382,185288,0,226670
132745700300000,NW 332,RESIDENTIAL,45738,0,45738,195065,0,240803
132745700400000,NW 332,RESIDENTIAL,42743,0,42743,157057,0,199800
132745700500000,NW 332,RESIDENTIAL,46010,0,46010,269250,0,315260
132745700600000,NW 332,RESIDENTIAL,43560,0,43560,188836,0,232396
132745700700000,NW 332,RESIDENTIAL,43560,0,43560,253173,0,296733
132745700800000,NW 332,RESIDENTIAL,44580,0,44580,212268,0,256848
132747600100000,NW 332,RESIDENTIAL,45900,0,45900,0,0,45900
132747600200000,NW 332,RESIDENTIAL,43200,0,43200,0,0,43200
132747600300000,NW 332,RESIDENTIAL,43357,0,43357,0,0,43357
132747600400000,NW 332,RESIDENTIAL,42066,0,42066,171236,0,213302
132747600500000,NW 332,RESIDENTIAL,40731,0,40731,273329,0,314060
132747600600000,NW 332,RESIDENTIAL,40400,0,40400,227651,0,268051
132747600700000,NW 332,RESIDENTIAL,39384,0,39384,194103,0,233487
132747600800000,NW 332,RESIDENTIAL,38000,0,38000,193083,0,231083
132747600900000,NW 332,RESIDENTIAL,39499,0,39499,163345,0,202844
132747601000000,NW 332,RESIDENTIAL,41643,0,41643,193589,0,235232
132747700100000,NW 332,RESIDENTIAL,40017,0,40017,151173,0,191190
132747700200000,NW 332,RESIDENTIAL,38482,0,38482,188232,0,226714
132747700300000,NW 332,RESIDENTIAL,36624,0,36624,143323,0,179947
132747700400000,NW 332,RESIDENTIAL,41056,0,41056,155545,0,196601
132747800100000,NW 332,RESIDENTIAL,42840,0,42840,0,0,42840
132747800200000,NW 332,RESIDENTIAL,39818,0,39818,0,0,39818
132747800300000,NW 332,RESIDENTIAL,41773,0,41773,0,0,41773
132747800400000,NW 332,RESIDENTIAL,43776,0,43776,0,0,43776
132747800500000,NW 332,RESIDENTIAL,41255,0,41255,0,0,41255
132747800600000,NW 332,RESIDENTIAL,41299,0,41299,192663,0,233962
132747800700000,NW 332,RESIDENTIAL,42400,0,42400,177594,0,219994
132747800800000,NW 332,RESIDENTIAL,38885,0,38885,163787,0,202672
132747800900000,NW 332,RESIDENTIAL,43335,0,43335,196689,0,240024
132747801000000,NW 332,RESIDENTIAL,42293,0,42293,159135,0,201428
132747801100000,NW 332,RESIDENTIAL,39635,0,39635,168204,0,207839
132747801200000,NW 332,RESIDENTIAL,40800,0,40800,154854,0,195654
132747801300000,WAREHOUSE,COMMERCIAL,0,559600,559600,0,515400,1075000
132747801400000,NW 332,RESIDENTIAL,38760,0,38760,162126,0,200886
132747801500000,NW 332,RESIDENTIAL,41593,0,41593,200710,0,242303
132747801700000,NW 332,RESIDENTIAL,45880,0,45880,176717,0,222597
132747801800000,NW 332,RESIDENTIAL,41599,0,41599,180122,0,221721
132747801900000,NW 332,RESIDENTIAL,40800,0,40800,183792,0,224592
132747802000000,NW 332,RESIDENTIAL,38760,0,38760,139880,0,178640
132747802100000,NW 332,RESIDENTIAL,40698,0,40698,181382,0,222080
132747802200000,NW 332,RESIDENTIAL,38760,0,38760,140479,0,179239
132747802300000,NW 332,RESIDENTIAL,35537,0,35537,181471,0,217008
132747802400000,NW 332,RESIDENTIAL,44181,0,44181,166852,0,211033
132747802500000,NW 332,RESIDENTIAL,45418,0,45418,193575,0,238993
132747802600000,NW 332,RESIDENTIAL,37620,0,37620,172273,0,209893
132747802700000,NW 332,RESIDENTIAL,39600,0,39600,192981,0,232581
132747802800000,NW 332,RESIDENTIAL,45162,0,45162,209710,0,254872
132747802900000,NW 332,RESIDENTIAL,42401,0,42401,180895,0,223296
132747803000000,NW 332,RESIDENTIAL,40584,0,40584,167867,0,208451
132747803100000,NW 332,RESIDENTIAL,40256,0,40256,196744,0,237000
132747803200000,NW 332,RESIDENTIAL,38598,0,38598,185260,0,223858
132747803300000,NW 332,RESIDENTIAL,39180,0,39180,174926,0,214106
132747803400000,NW 332,RESIDENTIAL,41516,0,41516,163231,0,204747
132747803500000,NW 332,RESIDENTIAL,41904,0,41904,158080,0,199984
132747803600000,NW 332,RESIDENTIAL,36652,0,36652,139390,0,176042
132747803700000,NW 332,RESIDENTIAL,38115,0,38115,196662,0,234777
132747803800000,NW 332,RESIDENTIAL,37191,0,37191,189831,0,227022
132747803900000,NW 332,RESIDENTIAL,37933,0,37933,162433,0,200366
132747804000000,NW 332,RESIDENTIAL,38775,0,38775,172973,0,211748
132747804100000,NW 332,RESIDENTIAL,40517,0,40517,197589,0,238106
132747804200000,SHOP,COMMERCIAL,0,483200,483200,0,755376,1238576
132747804300000,NW 332,RESIDENTIAL,42500,0,42500,99953,0,142453
132747900100000,NW 332,RESIDENTIAL,42566,0,42566,168818,0,211384
132747900200000,NW 332,RESIDENTIAL,40333,0,40333,169763,0,210096
132747900300000,NW 332,RESIDENTIAL,41667,0,41667,176629,0,218296
132747900400000,NW 332,RESIDENTIAL,40573,0,40573,159775,0,200348
132747900500000,NW 332,RESIDENTIAL,43771,0,43771,195643,0,239414
132747900600000,NW 332,RESIDENTIAL,39782,0,39782,178197,0,217979
132747900700000,NW 332,RESIDENTIAL,37620,0,37620,180877,0,218497
132747900800000,NW 332,RESIDENTIAL,37620,0,37620,145804,0,183424
132747900900000,NW 332,RESIDENTIAL,37240,0,37240,182791,0,220031
132747901000000,NW 332,RESIDENTIAL,39943,0,39943,139048,0,178991
132747901100000,NW 332,RESIDENTIAL,37905,0,37905,151120,0,189025
133410100100000,GOLF COURSE,COMMERCIAL,0,466150,466150,0,165379,631529
133430100100000,SW 432,AG LAND,93954,0,93954,0,0,93954
133440100100000,SW 432,AG LAND,91743,0,91743,0,0,91743
133440100200000,SW 454,RESIDENTIAL,99000,0,99000,146448,0,245448
133442600100000,SW 432,AG LAND,99881,0,99881,0,0,99881
133445100100000,SW 432,AG LAND,43554,0,43554,0,0,43554
133447600100000,SW 432,AG LAND,63277,0,63277,0,0,63277
133447600200000,STATE PROPERTY,OTHER,0,0,0,0,0,0
133510100100000,CHURCH,EXEMPT,0,292032,292032,0,378963,670995
133510100200000,VACANT LAND,COMMERCIAL,0,175990,175990,0,0,175990
133510100300000,WAREHOUSE;MINI STORG,COMMERCIAL,0,350400,350400,0,729027,1079427
133510100400000,WAREHOUSE,COMMERCIAL,0,351200,351200,0,424628,775828
133510100500000,PRINTING,INDUSTRIAL,0,222912,222912,0,1160904,1383816
133510100600000,AUTO REPAIR/SALES,COMMERCIAL,0,308000,308000,0,356464,664464
133510100700000,SHOP,EXEMPT,0,93312,93312,0,334181,427493
133510200100000,WAREHOUSE,COMMERCIAL,0,340480,340480,0,978538,1319018
133510200200000,SHOP,COMMERCIAL,0,171000,171000,0,502141,673141
133510200300000,SHOP,COMMERCIAL,0,168000,168000,0,303762,471762
133510200400000,WAREHOUSE,COMMERCIAL,0,170000,170000,0,276158,446158
133510200500000,SHOP,COMMERCIAL,0,152242,152242,0,126037,278279
133510200600000,VACANT LAND,COMMERCIAL,0,155200,155200,0,0,155200
133510200700000,VACANT LAND,COMMERCIAL,0,92900,92900,0,0,92900
133510200800000,SHOP,COMMERCIAL,0,152100,152100,0,186825,338925
133510200900000,WAREHOUSE,COMMERCIAL,0,160360,160360,0,350084,510444
133512600100000,AUTO REPAIR/SALES,COMMERCIAL,0,294020,294020,0,264488,558508
133512600200000,CONVERSION,COMMERCIAL,0,54000,54000,0,132281,186281
133512600300000,SW 407,RESIDENTIAL,48000,0,48000,130939,0,178939
133512600400000,WAREHOUSE,COMMERCIAL,0,99020,99020,0,145184,244204
133512600500000,EQUIPMENT MFG;INDUST,INDUSTRIAL,0,383405,383405,0,1003204,1386609
133512600700000,SHOP,COMMERCIAL,0,378220,378220,0,241222,619442
133512600800000,SW 407,AG LAND,30805,0,30805,0,0,30805
133512600900000,FLAT PARKING,INDUSTRIAL,0,21060,21060,0,0,21060
133512601000000,FRATERNAL,EXEMPT,0,166752,166752,0,190073,356825
133512601100000,VACANT LAND,COMMERCIAL,0,146500,146500,0,0,146500
133512601200000,SHOP,COMMERCIAL,0,187200,187200,0,104984,292184
133512601300000,SHOP,COMMERCIAL,0,78600,78600,0,141969,220569
133515100100000,SW 407,AG LAND,91247,0,91247,0,0,91247
133515100300000,WAREHOUSE,COMMERCIAL,0,309600,309600,0,158378,467978
133515100400000,SW 407,RESIDENTIAL,60250,0,60250,121747,0,181997
133517600100000,CITY PROPERTY,EXEMPT,0,0,0,0,0,0
133517600200000,SW 407,AG LAND,20816,0,20816,0,0,20816
133517600300000,AUTO REPAIR/SALES,COMMERCIAL,0,153000,153000,0,164917,317917
133517600400000,SW 407,RESIDENTIAL,54000,0,54000,86656,0,140656
133517600500000,WAREHOUSE;MINI STORG,COMMERCIAL,0,401400,401400,0,259808,661208
133517600600000,CENTRALLY ASSESSED,OTHER,0,0,0,0,0,0
133520100100000,SHOP,COMMERCIAL,0,215538,215538,0,261806,477344
133520100200000,SMALL RETAIL,COMMERCIAL,0,152680,152680,0,163416,316096
133520100300000,VACANT LAND,COMMERCIAL,0,20,20,0,0,20
133520200100000,OFFICE,COMMERCIAL,0,94370,94370,0,264151,358521
133520200200000,WAREHOUSE,COMMERCIAL,0,93320,93320,0,44627,137947
133520200300000,OFFICE,COMMERCIAL,0,229520,229520,0,219932,449452
133520200400000,SHOP,COMMERCIAL,0,56880,56880,0,150135,207015
133520200500000,WAREHOUSE,COMMERCIAL,0,196900,196900,0,96865,293765
133520200600000,AUTO SALES,COMMERCIAL,0,120000,120000,0,21544,141544
133520200700000,SHOP,COMMERCIAL,0,138020,138020,0,241542,379562
133520200800000,CHURCH,EXEMPT,0,86400,86400,0,197162,283562
133522600100000,FLAT PARKING,COMMERCIAL,0,323200,323200,0,175104,498304
133522600200000,NW 332,RESIDENTIAL,54650,0,54650,126550,0,181200
133522600300000,NW 332,RESIDENTIAL,33615,0,33615,0,0,33615
133522600400000,CHURCH,EXEMPT,0,743580,743580,0,5374813,6118393
133525100500000,SW 407,RESIDENTIAL,53575,0,53575,145417,0,198992
133525200100000,SW 408,RESIDENTIAL,442,0,442,0,0,442
133525200200000,SW 408,RESIDENTIAL,441,0,441,0,0,441
133525200300000,SW 408,RESIDENTIAL,440,0,440,0,0,440
133525200400000,SW 408,AG LAND,533,0,533,0,0,533
133525200500000,SW 408,AG LAND,678,0,678,0,0,678
133525200600000,SW 408,AG LAND,654,0,654,0,0,654
133525200700000,SW 408,AG LAND,606,0,606,0,0,606
133525200800000,SW 408,AG LAND,630,0,630,0,0,630
133525200900000,SW 408,AG LAND,654,0,654,0,0,654
133525201000000,SW 408,AG LAND,678,0,678,0,0,678
133525201100000,SW 408,AG LAND,630,0,630,0,0,630
133525201200000,SW 408,EXEMPT,0,0,0,0,0,0
133525201300000,SW 408,AG LAND,484,0,484,0,0,484
133525201400000,SW 408,AG LAND,533,0,533,0,0,533
133525201500000,SW 408,AG LAND,920,0,920,0,0,920
133525201600000,SW 408,AG LAND,1429,0,1429,0,0,1429
133525201700000,SW 408,AG LAND,509,0,509,0,0,509
133525201800000,SW 408,AG LAND,751,0,751,0,0,751
133525201900000,SW 408,AG LAND,606,0,606,0,0,606
133525202000000,SW 408,AG LAND,460,0,460,0,0,460
133525202100000,SW 408,AG LAND,533,0,533,0,0,533
133525202200000,SW 408,AG LAND,460,0,460,0,0,460
133525202300000,SW 408,AG LAND,436,0,436,0,0,436
133525202400000,SW 408,AG LAND,484,0,484,0,0,484
133525202500000,SW 408,EXEMPT,0,0,0,0,0,0
133525202600000,SW 408,AG LAND,557,0,557,0,0,557
133525202700000,SW 408,AG LAND,509,0,509,0,0,509
133525202800000,SW 408,AG LAND,509,0,509,0,0,509
133525202900000,SW 408,AG LAND,557,0,557,0,0,557
133525300100000,SW 408,RESIDENTIAL,752,0,752,0,0,752
133525300200000,SW 408,RESIDENTIAL,678,0,678,0,0,678
133525300300000,SW 408,RESIDENTIAL,562,0,562,0,0,562
133525300400000,SW 408,RESIDENTIAL,696,0,696,0,0,696
133525400100000,SW 408,RESIDENTIAL,469,0,469,0,0,469
133525400200000,SW 408,RESIDENTIAL,467,0,467,0,0,467
133525400300000,SW 408,RESIDENTIAL,458,0,458,0,0,458
133525400400000,SW 408,RESIDENTIAL,458,0,458,0,0,458
133525400500000,SW 408,RESIDENTIAL,426,0,426,0,0,426
133525400600000,SW 408,RESIDENTIAL,38500,0,38500,136437,0,174937
133525400700000,SW 408,RESIDENTIAL,35750,0,35750,141414,0,177164
133525400800000,SW 408,RESIDENTIAL,38500,0,38500,72736,0,111236
133525400900000,SW 408,EXEMPT,0,0,0,0,0,0
133525500100000,SW 408,RESIDENTIAL,460,0,460,0,0,460
133525500200000,SW 408,RESIDENTIAL,464,0,464,0,0,464
133525500300000,SW 408,RESIDENTIAL,505,0,505,0,0,505
133525500400000,SW 408,RESIDENTIAL,565,0,565,0,0,565
133525500500000,SW 408,RESIDENTIAL,41663,0,41663,69612,0,111275
133525500600000,SW 408,RESIDENTIAL,435,0,435,0,0,435
133525500700000,SW 408,RESIDENTIAL,470,0,470,0,0,470
133525500800000,SW 408,RESIDENTIAL,36108,0,36108,10500,0,46608
133525500900000,SW 408,RESIDENTIAL,471,0,471,0,0,471
133525501000000,SW 408,RESIDENTIAL,506,0,506,0,0,506
133525501100000,SW 408,RESIDENTIAL,493,0,493,0,0,493
133525501200000,SW 408,AG LAND,511,0,511,0,0,511
133527600100000,SW 407,AG LAND,46567,0,46567,0,0,46567
133527600200000,MFG HOME PARK,COMMERCIAL,0,1756000,1756000,0,1443714,3199714
133530100100000,MFG HOME PARK,COMMERCIAL,0,3613000,3613000,0,2050286,5663286
133530100103000,MFG HOME PARK,COMMERCIAL,0,0,0,0,4432,4432
133530100103001,MFG HOME PARK,COMMERCIAL,0,0,0,0,3747,3747
133530100103002,MFG HOME PARK,COMMERCIAL,0,0,0,0,3903,3903
133530100103003,MFG HOME PARK,COMMERCIAL,0,0,0,0,5855,5855
133530100103004,MFG HOME PARK,COMMERCIAL,0,0,0,0,5503,5503
133530100103005,MFG HOME PARK,COMMERCIAL,0,0,0,0,5074,5074
133530100103006,MFG HOME PARK,COMMERCIAL,0,0,0,0,5074,5074
133530100103007,MFG HOME PARK,COMMERCIAL,0,0,0,0,3864,3864
133530100103008,MFG HOME PARK,COMMERCIAL,0,0,0,0,5074,5074
133530100103009,MFG HOME PARK,COMMERCIAL,0,0,0,0,4567,4567
133530100103010,MFG HOME PARK,COMMERCIAL,0,0,0,0,5223,5223
133530100103011,MFG HOME PARK,COMMERCIAL,0,0,0,0,5223,5223
133530100103012,MFG HOME PARK,COMMERCIAL,0,0,0,0,5223,5223
133530100103013,MFG HOME PARK,COMMERCIAL,0,0,0,0,5746,5746
133530100103014,MFG HOME PARK,COMMERCIAL,0,0,0,0,5223,5223
133530100103015,MFG HOME PARK,COMMERCIAL,0,0,0,0,6268,6268
133530100103016,MFG HOME PARK,COMMERCIAL,0,0,0,0,4701,4701
133530100103017,MFG HOME PARK,COMMERCIAL,0,0,0,0,5910,5910
133530100103018,MFG HOME PARK,COMMERCIAL,0,0,0,0,4091,4091
133530100103019,MFG HOME PARK,COMMERCIAL,0,0,0,0,5786,5786
133530100103020,MFG HOME PARK,COMMERCIAL,0,0,0,0,5910,5910
133530100103021,MFG HOME PARK,COMMERCIAL,0,0,0,0,4836,4836
133530100103022,MFG HOME PARK,COMMERCIAL,0,0,0,0,4091,4091
133530100103023,MFG HOME PARK,COMMERCIAL,0,0,0,0,3720,3720
133530100103024,MFG HOME PARK,COMMERCIAL,0,0,0,0,4836,4836
133530100103025,MFG HOME PARK,COMMERCIAL,0,0,0,0,5207,5207
133530100103026,MFG HOME PARK,COMMERCIAL,0,0,0,0,4091,4091
133530100103027,MFG HOME PARK,COMMERCIAL,0,0,0,0,4091,4091
133530100103028,MFG HOME PARK,COMMERCIAL,0,0,0,0,3968,3968
133530100103029,MFG HOME PARK,COMMERCIAL,0,0,0,0,6117,6117
133530100103030,MFG HOME PARK,COMMERCIAL,0,0,0,0,4672,4672
133530100103031,MFG HOME PARK,COMMERCIAL,0,0,0,0,4205,4205
133530100103032,MFG HOME PARK,COMMERCIAL,0,0,0,0,6074,6074
133530100103033,MFG HOME PARK,COMMERCIAL,0,0,0,0,4205,4205
133530100103034,MFG HOME PARK,COMMERCIAL,0,0,0,0,5607,5607
133530100103035,MFG HOME PARK,COMMERCIAL,0,0,0,0,4014,4014
133530100103036,MFG HOME PARK,COMMERCIAL,0,0,0,0,5820,5820
133530100103037,MFG HOME PARK,COMMERCIAL,0,0,0,0,4634,4634
133530100103038,MFG HOME PARK,COMMERCIAL,0,0,0,0,4319,4319
133530100103039,MFG HOME PARK,COMMERCIAL,0,0,0,0,5910,5910
133530100103040,MFG HOME PARK,COMMERCIAL,0,0,0,0,5910,5910
133530100103041,MFG HOME PARK,COMMERCIAL,0,0,0,0,5372,5372
133530100103042,MFG HOME PARK,COMMERCIAL,0,0,0,0,4432,4432
133530100103043,MFG HOME PARK,COMMERCIAL,0,0,0,0,4119,4119
133530100103044,MFG HOME PARK,COMMERCIAL,0,0,0,0,4836,4836
133530100103045,MFG HOME PARK,COMMERCIAL,0,0,0,0,5910,5910
133530100103046,MFG HOME PARK,COMMERCIAL,0,0,0,0,6985,6985
133530100103047,MFG HOME PARK,COMMERCIAL,0,0,0,0,4409,4409
133530100103048,MFG HOME PARK,COMMERCIAL,0,0,0,0,5970,5970
133530100103049,MFG HOME PARK,COMMERCIAL,0,0,0,0,5510,5510
133530100103050,MFG HOME PARK,COMMERCIAL,0,0,0,0,7577,7577
133530100103051,MFG HOME PARK,COMMERCIAL,0,0,0,0,4959,4959
133530100103052,MFG HOME PARK,COMMERCIAL,0,0,0,0,5507,5507
133530100103053,MFG HOME PARK,COMMERCIAL,0,0,0,0,6730,6730
133530100103054,MFG HOME PARK,COMMERCIAL,0,0,0,0,5648,5648
133530100103056,MFG HOME PARK,COMMERCIAL,0,0,0,0,4773,4773
133530100103057,MFG HOME PARK,COMMERCIAL,0,0,0,0,6750,6750
133530100103058,MFG HOME PARK,COMMERCIAL,0,0,0,0,6870,6870
133530100103059,MFG HOME PARK,COMMERCIAL,0,0,0,0,6919,6919
133530100103061,MFG HOME PARK,COMMERCIAL,0,0,0,0,6870,6870
133530100103062,MFG HOME PARK,COMMERCIAL,0,0,0,0,6413,6413
133530100103063,MFG HOME PARK,COMMERCIAL,0,0,0,0,4773,4773
133530100103064,MFG HOME PARK,COMMERCIAL,0,0,0,0,7232,7232
133530100103065,MFG HOME PARK,COMMERCIAL,0,0,0,0,5641,5641
133530100103066,MFG HOME PARK,COMMERCIAL,0,0,0,0,6096,6096
133530100103067,MFG HOME PARK,COMMERCIAL,0,0,0,0,4887,4887
133530100103068,MFG HOME PARK,COMMERCIAL,0,0,0,0,5923,5923
133530100103069,MFG HOME PARK,COMMERCIAL,0,0,0,0,7997,7997
133530100103070,MFG HOME PARK,COMMERCIAL,0,0,0,0,7108,7108
133530100103072,MFG HOME PARK,COMMERCIAL,0,0,0,0,5923,5923
133530100103073,MFG HOME PARK,COMMERCIAL,0,0,0,0,5158,5158
133530100103074,MFG HOME PARK,COMMERCIAL,0,0,0,0,8637,8637
133530100103075,MFG HOME PARK,COMMERCIAL,0,0,0,0,6516,6516
133530100103076,MFG HOME PARK,COMMERCIAL,0,0,0,0,4936,4936
133530100103077,MFG HOME PARK,COMMERCIAL,0,0,0,0,6516,6516
133530100103078,MFG HOME PARK,COMMERCIAL,0,0,0,0,10070,10070
133530100103079,MFG HOME PARK,COMMERCIAL,0,0,0,0,4091,4091
133530100103080,MFG HOME PARK,COMMERCIAL,0,0,0,0,8536,8536
133530100103082,MFG HOME PARK,COMMERCIAL,0,0,0,0,6061,6061
133530100103083,MFG HOME PARK,COMMERCIAL,0,0,0,0,3889,3889
133530100103084,MFG HOME PARK,COMMERCIAL,0,0,0,0,7577,7577
133530100103085,MFG HOME PARK,COMMERCIAL,0,0,0,0,6061,6061
133530100103086,MFG HOME PARK,COMMERCIAL,0,0,0,0,6895,6895
133530100103087,MFG HOME PARK,COMMERCIAL,0,0,0,0,7678,7678
133530100103088,MFG HOME PARK,COMMERCIAL,0,0,0,0,7556,7556
133530100103089,MFG HOME PARK,COMMERCIAL,0,0,0,0,4546,4546
133530100103091,MFG HOME PARK,COMMERCIAL,0,0,0,0,4647,4647
133530100103092,MFG HOME PARK,COMMERCIAL,0,0,0,0,8059,8059
133530100103093,MFG HOME PARK,COMMERCIAL,0,0,0,0,7122,7122
133530100103094,MFG HOME PARK,COMMERCIAL,0,0,0,0,6313,6313
133530100103095,MFG HOME PARK,COMMERCIAL,0,0,0,0,4224,4224
133530100103096,MFG HOME PARK,COMMERCIAL,0,0,0,0,8417,8417
133530100103097,MFG HOME PARK,COMMERCIAL,0,0,0,0,8438,8438
133530100103098,MFG HOME PARK,COMMERCIAL,0,0,0,0,7880,7880
133530100103099,MFG HOME PARK,COMMERCIAL,0,0,0,0,7935,7935
133530100103100,MFG HOME PARK,COMMERCIAL,0,0,0,0,7935,7935
133530100103101,MFG HOME PARK,COMMERCIAL,0,0,0,0,7426,7426
133532600100000,MFG HOME PARK,COMMERCIAL,0,728270,728270,0,255669,983939
133532600103000,MFG HOME PARK,COMMERCIAL,0,0,0,0,6985,6985
133532600103001,MFG HOME PARK,COMMERCIAL,0,0,0,0,4836,4836
133532600103002,MFG HOME PARK,COMMERCIAL,0,0,0,0,6888,6888
133532600103003,MFG HOME PARK,COMMERCIAL,0,0,0,0,6590,6590
133532600103004,MFG HOME PARK,COMMERCIAL,0,0,0,0,5889,5889
133532600103005,MFG HOME PARK,COMMERCIAL,0,0,0,0,7387,7387
133532600103006,MFG HOME PARK,COMMERCIAL,0,0,0,0,6716,6716
133532600103007,MFG HOME PARK,COMMERCIAL,0,0,0,0,5166,5166
133532600103008,MFG HOME PARK,COMMERCIAL,0,0,0,0,8238,8238
133532600103009,MFG HOME PARK,COMMERCIAL,0,0,0,0,8238,8238
133532600103010,MFG HOME PARK,COMMERCIAL,0,0,0,0,10580,10580
133532600103011,MFG HOME PARK,COMMERCIAL,0,0,0,0,6117,6117
133532600103012,MFG HOME PARK,COMMERCIAL,0,0,0,0,7274,7274
133532600103013,MFG HOME PARK,COMMERCIAL,0,0,0,0,9092,9092
133532600103014,MFG HOME PARK,COMMERCIAL,0,0,0,0,8662,8662
133532600103022,MFG HOME PARK,COMMERCIAL,0,0,0,0,5455,5455
133532600103068,MFG HOME PARK,COMMERCIAL,0,0,0,0,6418,6418
133532600300000,SW 454,RESIDENTIAL,122550,0,122550,0,0,122550
133535100200000,SW 454,RESIDENTIAL,29750,0,29750,130828,0,160578
133535100300000,SW 454,RESIDENTIAL,29750,0,29750,131568,0,161318
133535100400000,SW 454,RESIDENTIAL,29750,0,29750,161535,0,191285
133535100500000,SW 454,RESIDENTIAL,29750,0,29750,130495,0,160245
133535100600000,SW 454,RESIDENTIAL,29750,0,29750,116363,0,146113
133535100700000,SW 454,RESIDENTIAL,29750,0,29750,117241,0,146991
133535100800000,SW 454,RESIDENTIAL,29750,0,29750,118010,0,147760
133535100900000,SW 454,RESIDENTIAL,30299,0,30299,115509,0,145808
133535101000000,SW 454,RESIDENTIAL,33112,0,33112,0,0,33112
133535101100000,SW 454,RESIDENTIAL,46842,0,46842,119690,0,166532
133535200100000,SW 454,RESIDENTIAL,30706,0,30706,219237,0,249943
133535200200000,SW 454,RESIDENTIAL,30706,0,30706,109506,0,140212
133535200300000,SW 454,RESIDENTIAL,32310,0,32310,172056,0,204366
133535200400000,SW 407,RESIDENTIAL,92840,0,92840,0,0,92840
133535200500000,SW 454,RESIDENTIAL,28152,0,28152,0,0,28152
133535200600000,SW 454,RESIDENTIAL,45747,0,45747,169687,0,215434
133535200700000,SW 454,RESIDENTIAL,29750,0,29750,0,0,29750
133535200800000,SW 454,RESIDENTIAL,29750,0,29750,135497,0,165247
133535200900000,SW 454,RESIDENTIAL,29750,0,29750,156462,0,186212
133535201000000,SW 454,RESIDENTIAL,29750,0,29750,168097,0,197847
133535201100000,SW 454,RESIDENTIAL,29750,0,29750,181569,0,211319
133535300100000,SW 454,RESIDENTIAL,29750,0,29750,122099,0,151849
133535300200000,SW 454,RESIDENTIAL,29750,0,29750,132701,0,162451
133535300300000,SW 454,RESIDENTIAL,31784,0,31784,116675,0,148459
133535400100000,SW 454,RESIDENTIAL,29750,0,29750,147392,0,177142
133535400200000,SW 454,RESIDENTIAL,29750,0,29750,136362,0,166112
133535400300000,SW 454,RESIDENTIAL,29750,0,29750,139768,0,169518
133535400400000,SW 454,RESIDENTIAL,29750,0,29750,125571,0,155321
133535400500000,SW 454,RESIDENTIAL,26775,0,26775,0,0,26775
133535400600000,SW 454,RESIDENTIAL,33021,0,33021,136811,0,169832
133535400700000,SW 454,RESIDENTIAL,36855,0,36855,116325,0,153180
133535400800000,SW 454,RESIDENTIAL,37237,0,37237,130072,0,167309
133535400900000,SW 454,RESIDENTIAL,32130,0,32130,0,0,32130
133535401000000,SW 454,RESIDENTIAL,29750,0,29750,151585,0,181335
133535401100000,SW 454,RESIDENTIAL,29750,0,29750,149768,0,179518
133535401200000,SW 454,RESIDENTIAL,29750,0,29750,133913,0,163663
133535401300000,SW 454,RESIDENTIAL,26775,0,26775,0,0,26775
133535500100000,SW 454,RESIDENTIAL,29750,0,29750,157964,0,187714
133535500200000,SW 454,RESIDENTIAL,29750,0,29750,143545,0,173295
133535500300000,SW 454,RESIDENTIAL,26775,0,26775,0,0,26775
133535500400000,SW 454,RESIDENTIAL,26775,0,26775,0,0,26775
133535500500000,SW 454,RESIDENTIAL,26775,0,26775,0,0,26775
133535500600000,SW 454,RESIDENTIAL,31592,0,31592,0,0,31592
133535500700000,SW 454,RESIDENTIAL,30047,0,30047,127847,0,157894
133535500800000,SW 454,RESIDENTIAL,39667,0,39667,116811,0,156478
133535500900000,SW 454,RESIDENTIAL,50122,0,50122,162271,0,212393
133535501000000,SW 454,RESIDENTIAL,48896,0,48896,165499,0,214395
133535501100000,SW 454,RESIDENTIAL,44217,0,44217,124097,0,168314
133537600100000,SW 407,AG LAND,106821,0,106821,0,0,106821
133540100100000,SW 407,AG LAND,93072,0,93072,0,3753,96825
133540100102000,SW 407,RESIDENTIAL,0,0,0,12192,0,12192
133545100100000,SW 407,AG LAND,95677,0,95677,0,2670,98347
133545100200000,SW 407,RESIDENTIAL,74400,0,74400,164178,0,238578
133547600100000,SW 407,AG LAND,91021,0,91021,0,0,91021
133610100300000,FLAT PARKING,EXEMPT,0,122715,122715,0,19872,142587
133610100302000,BILLBOARD(BLL),COMMERCIAL,0,0,0,0,14098,14098
133610100400000,OFFICE,EXEMPT,0,296568,296568,0,1269168,1565736
133610100500000,MFG HOME PARK,COMMERCIAL,0,281500,281500,0,405054,686554
133610100600000,VACANT LAND,COMMERCIAL,0,9527,9527,0,0,9527
133610100700000,MFG HOME PARK,COMMERCIAL,0,9495,9495,0,0,9495
133610100800000,OFFICE,EXEMPT,0,67003,67003,0,296712,363715
133610100900000,WAREHOUSE,COMMERCIAL,0,77250,77250,0,175510,252760
133610101000000,SMALL RETAIL,COMMERCIAL,0,268800,268800,0,230369,499169
133610101100000,RESTAURANT,COMMERCIAL,0,279200,279200,0,96902,376102
133610101200000,LG DISCOUNT/RETAIL,COMMERCIAL,0,825000,825000,0,1138085,1963085
133610101300000,VACANT LAND,COMMERCIAL,0,505000,505000,0,19110,524110
133610200100000,FITNESS CENTER,COMMERCIAL,0,222000,222000,0,19121,241121
133610200300000,SW 407,AG LAND,19432,0,19432,0,0,19432
133610200400000,GROCERY STORE,COMMERCIAL,0,936000,936000,0,959712,1895712
133610200500000,WAREHOUSE,COMMERCIAL,0,201000,201000,0,55285,256285
133610200600000,AUTO REPAIR/SALES,COMMERCIAL,0,64125,64125,0,51183,115308
133610200700000,FITNESS CENTER,COMMERCIAL,0,336000,336000,0,577319,913319
133610200800000,VACANT LAND,COMMERCIAL,0,19200,19200,0,0,19200
133612600100000,AUTO REPAIR/SALES,COMMERCIAL,0,278000,278000,0,232208,510208
133612600200000,PRINTING,INDUSTRIAL,0,156600,156600,0,570059,726659
133612600300000,HOTEL,COMMERCIAL,0,274000,274000,0,672140,946140
133612600400000,MFG HOME PARK,COMMERCIAL,0,366000,366000,0,291200,657200
133612600500000,WAREHOUSE,COMMERCIAL,0,265000,265000,0,307252,572252
133612600502000,BILLBOARD(BLL),COMMERCIAL,0,0,0,0,46479,46479
133612600600000,SW 407,RESIDENTIAL,50750,0,50750,63965,0,114715
133612700100000,SW 407,AG LAND,40647,0,40647,0,0,40647
133615100200000,OFFICE,COMMERCIAL,0,129109,129109,0,340883,469992
133615100400000,APARTMENT,COMMERCIAL,0,19695,19695,0,126902,146597
133615100500000,APARTMENT,COMMERCIAL,0,19630,19630,0,140081,159711
133615100600000,APARTMENT,COMMERCIAL,0,19630,19630,0,141474,161104
133615100700000,APARTMENT,COMMERCIAL,0,19630,19630,0,97126,116756
133615100800000,APARTMENT,COMMERCIAL,0,19565,19565,0,97126,116691
133615100900000,APARTMENT,COMMERCIAL,0,19500,19500,0,104664,124164
133615101000000,APARTMENT,COMMERCIAL,0,19500,19500,0,103011,122511
133615101800000,APARTMENT,COMMERCIAL,0,19008,19008,0,127396,146404
133615102100000,APARTMENT,COMMERCIAL,0,19008,19008,0,119806,138814
133615102200000,APARTMENT,COMMERCIAL,0,19008,19008,0,127396,146404
133615102300000,APARTMENT,COMMERCIAL,0,19008,19008,0,127239,146247
133615102400000,APARTMENT,COMMERCIAL,0,19008,19008,0,118524,137532
133615102700000,OFFICE; MEDICAL,COMMERCIAL,0,286500,286500,0,230482,516982
133615102800000,FITNESS CENTER,COMMERCIAL,0,180000,180000,0,701657,881657
133615200200000,CHURCH,EXEMPT,0,121770,121770,0,398764,520534
133615200300000,CHURCH,EXEMPT,0,121770,121770,0,376716,498486
133615200401000,OFFICE,COMMERCIAL,0,22882,22882,0,38943,61825
133615200401001,OFFICE,COMMERCIAL,0,22882,22882,0,38943,61825
133615200401002,OFFICE,COMMERCIAL,0,22882,22882,0,38943,61825
133615200401003,OFFICE,COMMERCIAL,0,22882,22882,0,38943,61825
133615200401004,OFFICE,COMMERCIAL,0,21813,21813,0,49501,71314
133615200401005,OFFICE,COMMERCIAL,0,21813,21813,0,49501,71314
133615200401006,OFFICE,COMMERCIAL,0,21813,21813,0,49501,71314
133615200401007,OFFICE,COMMERCIAL,0,21813,21813,0,49501,71314
133615200500000,NBHD SHOPPING CENTER,COMMERCIAL,0,170800,170800,0,452019,622819
133615200600000,OFFICE,EXEMPT,0,243540,243540,0,692629,936169
133615200800000,OFFICE; MEDICAL,COMMERCIAL,0,83160,83160,0,247917,331077
133617600200000,GROCERY STORE,COMMERCIAL,0,2186000,2186000,0,9502176,11688176
133617600400000,RESTAURANT,COMMERCIAL,0,254100,254100,0,484459,738559
133617600700000,FAST FOOD,COMMERCIAL,0,368800,368800,0,604731,973531
133617600800000,VACANT LAND,COMMERCIAL,0,1610,1610,0,0,1610
133617600900000,AUTO REPAIR/SALES,COMMERCIAL,0,325200,325200,0,395983,721183
133617601100000,BRANCH BANK/CU,COMMERCIAL,0,648858,648858,0,1012952,1661810
133617700200000,SMALL RETAIL,EXEMPT,0,275832,275832,0,675820,951652
133617700300000,BOWLING ALLEY,COMMERCIAL,0,386550,386550,0,765767,1152317
133617700400000,WAREHOUSE;MINI STORG,COMMERCIAL,0,298500,298500,0,611122,909622
133617700500000,OFFICE,COMMERCIAL,0,136200,136200,0,266514,402714
133620100100000,SHOP,COMMERCIAL,0,422400,422400,0,1461283,1883683
133620100200000,FLAT PARKING,COMMERCIAL,0,205800,205800,0,64837,270637
133620200100000,CARWASH,COMMERCIAL,0,266000,266000,0,285615,551615
133620200200000,WAREHOUSE;MINI STORG,COMMERCIAL,0,96400,96400,0,286738,383138
133620200300000,WAREHOUSE,COMMERCIAL,0,329130,329130,0,5770870,6100000
133620200400000,FEDERAL PROPERTY,EXEMPT,0,0,0,0,0,0
133622600100000,VACANT LAND,COMMERCIAL,0,744600,744600,0,0,744600
133622600200000,WAREHOUSE;MINI STORG,COMMERCIAL,0,163200,163200,0,49640,212840
133622700200000,WAREHOUSE,COMMERCIAL,0,803000,803000,0,4322250,5125250
133622700300000,VACANT LAND,COMMERCIAL,0,482600,482600,0,0,482600
133625100200000,FLAT PARKING,COMMERCIAL,0,816750,816750,0,149750,966500
133625100300000,VACANT LAND,COMMERCIAL,0,879150,879150,0,0,879150
133627600200000,WAREHOUSE,COMMERCIAL,0,483000,483000,0,4599213,5082213
133627600301000,WAREHOUSE,COMMERCIAL,0,23605,23605,0,118497,142102
133627600301001,WAREHOUSE,COMMERCIAL,0,23605,23605,0,118497,142102
133627600301002,WAREHOUSE,COMMERCIAL,0,23605,23605,0,121016,144621
133627600301003,WAREHOUSE,COMMERCIAL,0,23605,23605,0,123077,146682
133627600301004,WAREHOUSE,COMMERCIAL,0,23605,23605,0,123077,146682
133627600301005,WAREHOUSE,COMMERCIAL,0,23605,23605,0,123077,146682
133627600301006,WAREHOUSE,COMMERCIAL,0,23605,23605,0,123077,146682
133627600301007,WAREHOUSE,COMMERCIAL,0,23605,23605,0,123077,146682
133627600301008,WAREHOUSE,COMMERCIAL,0,23605,23605,0,117748,141353
133627600301009,WAREHOUSE,COMMERCIAL,0,23605,23605,0,123077,146682
133627600301010,WAREHOUSE,COMMERCIAL,0,23605,23605,0,123077,146682
133627600301011,WAREHOUSE,COMMERCIAL,0,23605,23605,0,123077,146682
133627600400000,MATERIALS MFG;INDUST,INDUSTRIAL,0,262872,262872,0,2240642,2503514
133627600500000,OFFICE; MEDICAL,COMMERCIAL,0,296000,296000,0,952414,1248414
133627600600000,VACANT LAND,COMMERCIAL,0,332600,332600,0,0,332600
133627600700000,VACANT LAND,COMMERCIAL,0,636000,636000,0,0,636000
133627600800000,NBHD SHOPPING CENTER,COMMERCIAL,0,533000,533000,0,450875,983875
133627600900000,OFFICE,COMMERCIAL,0,444000,444000,0,2690883,3134883
133630100100000,CONVENIENCE STORE,COMMERCIAL,0,188600,188600,0,304092,492692
133630100200000,SW 407,AG LAND,69714,0,69714,0,0,69714
133632600100000,MFG HOME PARK,COMMERCIAL,0,4524500,4524500,0,2902075,7426575
133632600103000,MFG HOME PARK,COMMERCIAL,0,0,0,0,5455,5455
133632600103001,MFG HOME PARK,COMMERCIAL,0,0,0,0,4567,4567
133632600103002,MFG HOME PARK,COMMERCIAL,0,0,0,0,4294,4294
133632600103003,MFG HOME PARK,COMMERCIAL,0,0,0,0,5786,5786
133632600103005,MFG HOME PARK,COMMERCIAL,0,0,0,0,5372,5372
133632600103006,MFG HOME PARK,COMMERCIAL,0,0,0,0,6819,6819
133632600103007,MFG HOME PARK,COMMERCIAL,0,0,0,0,5372,5372
133632600103008,MFG HOME PARK,COMMERCIAL,0,0,0,0,7008,7008
133632600103009,MFG HOME PARK,COMMERCIAL,0,0,0,0,5372,5372
133632600103010,MFG HOME PARK,COMMERCIAL,0,0,0,0,5372,5372
133632600103011,MFG HOME PARK,COMMERCIAL,0,0,0,0,4298,4298
133632600103012,MFG HOME PARK,COMMERCIAL,0,0,0,0,6985,6985
133632600103013,MFG HOME PARK,COMMERCIAL,0,0,0,0,5372,5372
133632600103014,MFG HOME PARK,COMMERCIAL,0,0,0,0,4041,4041
133632600103015,MFG HOME PARK,COMMERCIAL,0,0,0,0,4409,4409
133632600103016,MFG HOME PARK,COMMERCIAL,0,0,0,0,5430,5430
133632600103017,MFG HOME PARK,COMMERCIAL,0,0,0,0,3455,3455
133632600103018,MFG HOME PARK,COMMERCIAL,0,0,0,0,8984,8984
133632600103019,MFG HOME PARK,COMMERCIAL,0,0,0,0,7405,7405
133632600103020,MFG HOME PARK,COMMERCIAL,0,0,0,0,6960,6960
133632600103021,MFG HOME PARK,COMMERCIAL,0,0,0,0,8688,8688
133632600103022,MFG HOME PARK,COMMERCIAL,0,0,0,0,7439,7439
133632600103023,MFG HOME PARK,COMMERCIAL,0,0,0,0,6819,6819
133632600103024,MFG HOME PARK,COMMERCIAL,0,0,0,0,10797,10797
133632600103025,MFG HOME PARK,COMMERCIAL,0,0,0,0,6328,6328
133632600103026,MFG HOME PARK,COMMERCIAL,0,0,0,0,4224,4224
133632600103027,MFG HOME PARK,RESIDENTIAL,0,0,0,13500,0,13500
133637600100000,LG DISCOUNT/RETAIL,COMMERCIAL,0,672300,672300,0,826592,1498892
133637600200000,VACANT LAND,COMMERCIAL,0,25500,25500,0,0,25500
133637700200000,SW 407,AG LAND,11762,0,11762,0,0,11762
133640100500000,FLAT PARKING,COMMERCIAL,0,552758,552758,0,0,552758
133640100600000,DEPT/ANCHOR STORE,COMMERCIAL,0,272430,272430,0,506456,778886
133640100700000,BRANCH BANK/CU,COMMERCIAL,0,64367,64367,0,385260,449627
133640101001000,BRANCH BANK/CU,COMMERCIAL,0,615215,615215,0,1339188,1954403
133640101001004,NBHD SHOPPING CENTER,COMMERCIAL,0,869978,869978,0,1127165,1997143
133640101001005,VACANT LAND,COMMERCIAL,0,247819,247819,0,0,247819
133640101002000,BILLBOARD(BLL),COMMERCIAL,0,0,0,0,16143,16143
133640200400000,SW 420,RESIDENTIAL,30240,0,30240,89535,0,119775
133640200500000,SW 420,RESIDENTIAL,30240,0,30240,85935,0,116175
133640200600000,SW 420,RESIDENTIAL,30422,0,30422,83555,0,113977
133642600100000,LG DISCOUNT/RETAIL,COMMERCIAL,0,310500,310500,0,1234325,1544825
133642600200000,OFFICE,COMMERCIAL,0,87038,87038,0,236752,323790
133642600300000,BRANCH BANK/CU,COMMERCIAL,0,438750,438750,0,856536,1295286
133642700200000,OFFICE,COMMERCIAL,0,70656,70656,0,248765,319421
133642700300000,CARWASH,COMMERCIAL,0,243000,243000,0,300419,543419
133642700400000,OFFICE; MEDICAL,COMMERCIAL,0,88520,88520,0,511310,599830
133642700500000,FLAT PARKING,COMMERCIAL,0,238200,238200,0,3600,241800
133642700600000,LG DISCOUNT/RETAIL,COMMERCIAL,0,1128600,1128600,0,2832577,3961177
133642700700000,AUTO REPAIR/SALES,COMMERCIAL,0,184020,184020,0,247809,431829
133642700800000,RESTAURANT,COMMERCIAL,0,354000,354000,0,38430,392430
133642700900000,LG DISCOUNT/RETAIL,COMMERCIAL,0,1139250,1139250,0,1687169,2826419
133642700902000,BILLBOARD(BLL),COMMERCIAL,0,0,0,0,63922,63922
133645100200000,THEATER,COMMERCIAL,0,28958,28958,0,61042,90000
133645100300000,RESTAURANT,COMMERCIAL,0,333600,333600,0,220824,554424
133645100400000,NBHD SHOPPING CENTER,COMMERCIAL,0,559200,559200,0,431320,990520
133645200100000,NBHD SHOPPING CENTER,COMMERCIAL,0,280800,280800,0,622741,903541
133645200102000,BILLBOARD(BLL),COMMERCIAL,0,0,0,0,45172,45172
133645300100000,LG DISCOUNT/RETAIL,COMMERCIAL,0,3001675,3001675,0,7433420,10435095
133647600200000,REG SHOPPING CENTER,COMMERCIAL,0,347832,347832,0,407706,755538
133647600300000,DEPT/ANCHOR STORE,COMMERCIAL,0,175377,175377,0,119511,294888
133647600400000,DEPT/ANCHOR STORE,COMMERCIAL,0,410623,410623,0,485475,896098
133647600500000,FLAT PARKING,COMMERCIAL,0,187840,187840,0,0,187840
133647600600000,FLAT PARKING,COMMERCIAL,0,15619,15619,0,0,15619
133647600700000,DEPT/ANCHOR STORE,COMMERCIAL,0,922404,922404,0,95969,1018373
133647600800000,BRANCH BANK/CU,COMMERCIAL,0,716000,716000,0,1308498,2024498
140132600200000,LG DISCOUNT/RETAIL,COMMERCIAL,0,522800,522800,0,780780,1303580
140132600300000,APARTMENT,COMMERCIAL,0,18589,18589,0,160426,179015
140132600400000,APARTMENT,COMMERCIAL,0,21978,21978,0,157924,179902
140132600600000,APARTMENT,COMMERCIAL,0,19229,19229,0,152076,171305
140132600700000,APARTMENT,COMMERCIAL,0,22604,22604,0,189144,211748
140132600800000,APARTMENT,COMMERCIAL,0,20196,20196,0,161501,181697
140132600900000,APARTMENT,COMMERCIAL,0,17544,17544,0,160407,177951
140132601100000,NE 115,RESIDENTIAL,8800,0,8800,0,0,8800
140132700300000,NBHD SHOPPING CENTER,COMMERCIAL,0,580000,580000,0,1239181,1819181
140132700401009,LG DISCOUNT/RETAIL,COMMERCIAL,0,116126,116126,0,628788,744914
140132700401010,SMALL RETAIL,COMMERCIAL,0,54610,54610,0,328159,382769
140132700401011,OFFICE,COMMERCIAL,0,153088,153088,0,1062276,1215364
140132700401012,SMALL RETAIL,COMMERCIAL,0,65234,65234,0,331981,397215
140132700401013,FITNESS CENTER,COMMERCIAL,0,484360,484360,0,3119840,3604200
140132700401014,LG DISCOUNT/RETAIL,COMMERCIAL,0,120850,120850,0,535825,656675
140132700900000,VACANT LAND,COMMERCIAL,0,20,20,0,0,20
140132701300000,FLAT PARKING,COMMERCIAL,0,50020,50020,0,12127,62147
140215100700000,OFFICE,COMMERCIAL,0,322500,322500,0,359375,681875
140215100800000,FLAT PARKING,COMMERCIAL,0,20,20,0,0,20
140215200200000,LG DISCOUNT/RETAIL,COMMERCIAL,0,2620020,2620020,0,1879980,4500000
140215200300000,SMALL RETAIL,COMMERCIAL,0,252000,252000,0,446946,698946
140215200400000,RESTAURANT,COMMERCIAL,0,410500,410500,0,378478,788978
140220100100000,CENTRALLY ASSESSED,OTHER,0,0,0,0,0,0
140220100200000,NE 115,RESIDENTIAL,6340,0,6340,8366,0,14706
140220100300000,NE 115,RESIDENTIAL,2440,0,2440,0,0,2440
140220100400000,NE 115,RESIDENTIAL,8980,0,8980,0,0,8980
140220200100000,FITNESS CENTER,COMMERCIAL,0,252050,252050,0,762020,1014070
140220200200000,AUTO REPAIR/SALES,COMMERCIAL,0,63000,63000,0,51224,114224
140220200300000,NE 115,RESIDENTIAL,41875,0,41875,110118,0,151993
140220200400000,LG DISCOUNT/RETAIL,COMMERCIAL,0,833000,833000,0,880346,1713346
140220200500000,SMALL RETAIL,COMMERCIAL,0,180600,180600,0,190498,371098
140220200600000,NBHD SHOPPING CENTER,COMMERCIAL,0,401050,401050,0,838998,1240048
140220200700000,SHOP,COMMERCIAL,0,94815,94815,0,80454,175269
140220200702000,BILLBOARD(BLL),COMMERCIAL,0,0,0,0,12251,12251
140220200800000,AUTO REPAIR/SALES,COMMERCIAL,0,175500,175500,0,217301,392801
140220200900000,FLAT PARKING,COMMERCIAL,0,29000,29000,0,5712,34712
140220201000000,OFFICE,COMMERCIAL,0,178750,178750,0,452482,631232
140220201100000,CITY PROPERTY,EXEMPT,0,0,0,0,0,0
140220300600000,OFFICE,COMMERCIAL,0,73097,73097,0,175463,248560
140220300700000,OFFICE; MEDICAL,COMMERCIAL,0,47276,47276,0,274861,322137
140220300800000,OFFICE,COMMERCIAL,0,63615,63615,0,140957,204572
140220300900000,OFFICE,COMMERCIAL,0,35648,35648,0,164794,200442
140220301000000,OFFICE,COMMERCIAL,0,124370,124370,0,469325,593695
140220301100000,LAUNDROMAT/CLEANERS,COMMERCIAL,0,76387,76387,0,196373,272760
140220301200000,DAY CARE CENTER,COMMERCIAL,0,71910,71910,0,207240,279150
140220301300000,FITNESS CENTER,COMMERCIAL,0,60982,60982,0,165380,226362
140220400300000,APARTMENT,COMMERCIAL,0,175840,175840,0,1737934,1913774
140220400400000,APARTMENT,COMMERCIAL,0,136240,136240,0,1468639,1604879
140220400500000,APARTMENT,COMMERCIAL,0,112480,112480,0,1445790,1558270
140222600200000,NE 164,RESIDENTIAL,28000,0,28000,216584,0,244584
140222600300000,NE 164,RESIDENTIAL,28000,0,28000,166067,0,194067
140222600400000,NE 164,RESIDENTIAL,30154,0,30154,199356,0,229510
140222600500000,NE 164,RESIDENTIAL,31540,0,31540,190775,0,222315
140222600600000,NE 164,RESIDENTIAL,57098,0,57098,337753,0,394851
140222700100000,NE 164,RESIDENTIAL,28280,0,28280,177645,0,205925
140222700200000,NE 164,RESIDENTIAL,28280,0,28280,158962,0,187242
140222700300000,NE 164,RESIDENTIAL,28560,0,28560,137550,0,166110
140222700400000,NE 164,RESIDENTIAL,31616,0,31616,202675,0,234291
140222701300000,NE 164,RESIDENTIAL,52692,0,52692,272067,0,324759
140222701400000,NE 164,RESIDENTIAL,45900,0,45900,225523,0,271423
140222701500000,NE 164,RESIDENTIAL,45450,0,45450,164621,0,210071
140222703000000,LG DISCOUNT/RETAIL,COMMERCIAL,0,480520,480520,0,1282792,1763312
140222703100000,OFFICE,COMMERCIAL,0,112520,112520,0,442180,554700
140222703200000,NE 164,RESIDENTIAL,30953,0,30953,162540,0,193493
140222703300000,NE 164,RESIDENTIAL,28188,0,28188,233746,0,261934
140222703400000,NE 164,RESIDENTIAL,28253,0,28253,176260,0,204513
140222703500000,NE 164,RESIDENTIAL,28419,0,28419,175832,0,204251
140222703600000,NE 164,RESIDENTIAL,28351,0,28351,178666,0,207017
140222703700000,NE 164,RESIDENTIAL,30164,0,30164,161100,0,191264
140222800100000,WAREHOUSE,COMMERCIAL,0,251875,251875,0,1048512,1300387
140222800200000,WAREHOUSE;MINI STORG,COMMERCIAL,0,581250,581250,0,579427,1160677
140222800202000,BILLBOARD(BLL),COMMERCIAL,0,0,0,0,54065,54065
140222800300000,NBHD SHOPPING CENTER,COMMERCIAL,0,239000,239000,0,852087,1091087
140222800400000,OFFICE,COMMERCIAL,0,411000,411000,0,1192639,1603639
140222800600000,CONVENIENCE STORE,COMMERCIAL,0,252000,252000,0,299640,551640
140222800700000,FLAT PARKING,COMMERCIAL,0,132000,132000,0,7013,139013
140222800900000,VACANT LAND,COMMERCIAL,0,220600,220600,0,0,220600
140222900100000,CENTRALLY ASSESSED,OTHER,0,0,0,0,0,0
140223000100000,NE 164,RESIDENTIAL,55932,0,55932,315056,0,370988
140225100100000,HIGH TECH/RESEARCH,INDUSTRIAL,0,1278983,1278983,0,15857273,17136256
140225100200000,HIGH TECH/RESEARCH,INDUSTRIAL,0,17122,17122,0,461205,478327
140225100300000,RESTAURANT,COMMERCIAL,0,783000,783000,0,1182246,1965246
140227600100000,NBHD SHOPPING CENTER,COMMERCIAL,0,126313,126313,0,476663,602976
140227600200000,OFFICE,COMMERCIAL,0,123920,123920,0,367657,491577
140227600400000,SMALL RETAIL,COMMERCIAL,0,165200,165200,0,531411,696611
140227600500000,OFFICE,COMMERCIAL,0,95850,95850,0,217507,313357
140227600700000,SMALL RETAIL,COMMERCIAL,0,366000,366000,0,502193,868193
140227600800000,CARWASH,COMMERCIAL,0,483600,483600,0,363920,847520
140227600900000,RESTAURANT,COMMERCIAL,0,1000020,1000020,0,897694,1897714
140227601000000,SMALL RETAIL,COMMERCIAL,0,160020,160020,0,425062,585082
140227601100000,FAST FOOD,COMMERCIAL,0,630020,630020,0,522149,1152169
140227601200000,OFFICE,COMMERCIAL,0,101930,101930,0,199481,301411
140227601300000,OFFICE,COMMERCIAL,0,99547,99547,0,200831,300378
140227601400000,OFFICE,COMMERCIAL,0,99346,99346,0,197231,296577
140227601500000,SMALL RETAIL,COMMERCIAL,0,343175,343175,0,338453,681628
140227601600000,OFFICE,COMMERCIAL,0,126170,126170,0,666246,792416
140227601700000,OFFICE,COMMERCIAL,0,123920,123920,0,364142,488062
140227601900000,OFFICE,COMMERCIAL,0,191075,191075,0,408925,600000
140227602100000,FLAT PARKING,COMMERCIAL,0,145000,145000,0,18112,163112
140227602200000,DAY CARE CENTER,COMMERCIAL,0,490000,490000,0,2465724,2955724
140227602300000,VACANT LAND,COMMERCIAL,0,1800,1800,0,0,1800
140227700100000,VACANT LAND,COMMERCIAL,0,15,15,0,0,15
140227700200000,WAREHOUSE;MINI STORG,COMMERCIAL,0,134400,134400,0,82745,217145
140227700300000,CHURCH,EXEMPT,0,381294,381294,0,4209209,4590503
140227700400000,WAREHOUSE,COMMERCIAL,0,244350,244350,0,4495,248845
140227700500000,SKATING RINK,COMMERCIAL,0,244350,244350,0,397259,641609
140227700600000,OFFICE,COMMERCIAL,0,622020,622020,0,715667,1337687
140227700800000,CONVENIENCE STORE,COMMERCIAL,0,600020,600020,0,441227,1041247
140227700900000,FLAT PARKING,COMMERCIAL,0,14000,14000,0,1998,15998
140227701800000,FLAT PARKING,COMMERCIAL,0,20,20,0,0,20
140230100100000,RESTAURANT,COMMERCIAL,0,810000,810000,0,813643,1623643
140230100200000,FAST FOOD,COMMERCIAL,0,825000,825000,0,1011358,1836358
140230100300000,RESTAURANT,COMMERCIAL,0,498000,498000,0,309043,807043
140230100400000,RESTAURANT,COMMERCIAL,0,432000,432000,0,412937,844937
140230100500000,FAST FOOD,COMMERCIAL,0,637800,637800,0,490716,1128516
140230100600000,FLAT PARKING,COMMERCIAL,0,20,20,0,0,20
140230100700000,RESTAURANT,COMMERCIAL,0,580200,580200,0,610928,1191128
140230100800000,RESTAURANT,COMMERCIAL,0,590000,590000,0,632550,1222550
140230100900000,LG DISCOUNT/RETAIL,COMMERCIAL,0,1233770,1233770,0,5010213,6243983
140230101100000,FLAT PARKING,COMMERCIAL,0,877507,877507,0,345104,1222611
140230101200000,GROCERY STORE,COMMERCIAL,0,331200,331200,0,2246189,2577389
140230101300000,VACANT LAND,COMMERCIAL,0,20,20,0,0,20
140230101400000,LG DISCOUNT/RETAIL,COMMERCIAL,0,242700,242700,0,877438,1120138
140232600100000,RESTAURANT,COMMERCIAL,0,990000,990000,0,795916,1785916
140232600200000,OFFICE,COMMERCIAL,0,500580,500580,0,647439,1148019
140232600300000,OFFICE,COMMERCIAL,0,362880,362880,0,565508,928388
140232600400000,NE 117,RESIDENTIAL,33000,0,33000,76378,0,109378
140232600500000,NE 117,RESIDENTIAL,33000,0,33000,74916,0,107916
140232600600000,CITY PROPERTY,EXEMPT,0,0,0,0,0,0
140232600700000,CITY PROPERTY,EXEMPT,0,0,0,0,0,0
140232600800000,NE 117,RESIDENTIAL,33000,0,33000,58814,0,91814
140232600900000,NE 117,RESIDENTIAL,36040,0,36040,81671,0,117711
140232601000000,NE 117,RESIDENTIAL,36000,0,36000,53369,0,89369
140232601100000,NE 117,RESIDENTIAL,36000,0,36000,138071,0,174071
140232601200000,NE 117,RESIDENTIAL,36000,0,36000,79617,0,115617
140232601300000,NE 117,RESIDENTIAL,35000,0,35000,74980,0,109980
140232601400000,NE 117,RESIDENTIAL,47500,0,47500,93997,0,141497
140232601500000,NE 117,RESIDENTIAL,46250,0,46250,85093,0,131343
140232601600000,NE 117,RESIDENTIAL,46755,0,46755,110479,0,157234
140232601700000,FUNERAL HOME,COMMERCIAL,0,704965,704965,0,336865,1041830
140232601800000,OFFICE,COMMERCIAL,0,76200,76200,0,928607,1004807
140232601900000,OFFICE,COMMERCIAL,0,86880,86880,0,815600,902480
140232602000000,DEPT/ANCHOR STORE,COMMERCIAL,0,1161000,1161000,0,3436460,4597460
140232602100000,VACANT LAND,COMMERCIAL,0,697,697,0,0,697
140235100100000,FUNERAL HOME,EXEMPT,0,3121000,3121000,0,2155583,5276583
140237600100000,VACANT LAND,COMMERCIAL,0,840,840,0,0,840
140237600200000,FUNERAL HOME,COMMERCIAL,0,145200,145200,0,235156,380356
140237600300000,FUNERAL HOME,COMMERCIAL,0,413100,413100,0,905521,1318621
140237600400000,LG DISCOUNT/RETAIL,COMMERCIAL,0,318300,318300,0,304733,623033
140237600500000,CITY PROPERTY,EXEMPT,0,0,0,0,0,0
140237700100000,OFFICE,COMMERCIAL,0,121238,121238,0,139749,260987
140237700200000,FLAT PARKING,COMMERCIAL,0,76291,76291,0,5886,82177
140237700300000,OFFICE; MEDICAL,COMMERCIAL,0,393300,393300,0,258746,652046
140237700400000,OFFICE; MEDICAL,COMMERCIAL,0,385050,385050,0,240550,625600
140237700500000,OFFICE,COMMERCIAL,0,130900,130900,0,155167,286067
140237700600000,OFFICE; MEDICAL,COMMERCIAL,0,164609,164609,0,186515,351124
140237700700000,NE 115,RESIDENTIAL,17727,0,17727,87563,0,105290
140237700800000,NE 115,RESIDENTIAL,20248,0,20248,52806,0,73054
140237700901000,OFFICE,COMMERCIAL,0,2484,2484,0,44346,46830
140237700901001,OFFICE,COMMERCIAL,0,1538,1538,0,27558,29096
140237700901002,OFFICE,COMMERCIAL,0,3076,3076,0,46439,49515
140237700901003,OFFICE,COMMERCIAL,0,1538,1538,0,27558,29096
140237700901004,OFFICE,COMMERCIAL,0,1538,1538,0,27558,29096
140237700901005,OFFICE,COMMERCIAL,0,592,592,0,10769,11361
140237700901006,OFFICE,COMMERCIAL,0,1538,1538,0,27558,29096
140237700901007,OFFICE,COMMERCIAL,0,1538,1538,0,27558,29096
140237700901052,OFFICE,COMMERCIAL,0,710,710,0,13544,14254
140237700901053,OFFICE,COMMERCIAL,0,592,592,0,19669,20261
140237701200000,NE 115,RESIDENTIAL,2064,0,2064,0,0,2064
140240100300000,LG DISCOUNT/RETAIL,COMMERCIAL,0,1090000,1090000,0,1656162,2746162
140240100400000,AUTO REPAIR/SALES,COMMERCIAL,0,355000,355000,0,281918,636918
140240100500000,AUTO REPAIR/SALES,COMMERCIAL,0,253967,253967,0,212571,466538
140240100502000,BILLBOARD(BLL),COMMERCIAL,0,0,0,0,45172,45172
140240100600000,NBHD SHOPPING CENTER,COMMERCIAL,0,218512,218512,0,413038,631550
140240100700000,FLAT PARKING,COMMERCIAL,0,33634,33634,0,3780,37414
140240100800000,FLAT PARKING,COMMERCIAL,0,5000,5000,0,71,5071
140240101200000,SMALL RETAIL,COMMERCIAL,0,830000,830000,0,793646,1623646
140240101300000,LG DISCOUNT/RETAIL,COMMERCIAL,0,1092000,1092000,0,2834808,3926808
140240200100000,NBHD SHOPPING CENTER,COMMERCIAL,0,720000,720000,0,1116247,1836247
140240200200000,LG DISCOUNT/RETAIL,COMMERCIAL,0,2623500,2623500,0,2116366,4739866
140240200300000,SMALL RETAIL,COMMERCIAL,0,290000,290000,0,486329,776329
140240200400000,SMALL RETAIL,COMMERCIAL,0,228506,228506,0,187722,416228
140240200402000,BILLBOARD(BLL),COMMERCIAL,0,0,0,0,12762,12762
140240200500000,CITY PROPERTY,EXEMPT,0,0,0,0,0,0
140240300400000,RESTAURANT,COMMERCIAL,0,366000,366000,0,196426,562426
140240301600000,OFFICE,COMMERCIAL,0,408000,408000,0,1208111,1616111
140240301700000,AUTO REPAIR/SALES,COMMERCIAL,0,278400,278400,0,258197,536597
140240400200000,NBHD SHOPPING CENTER,COMMERCIAL,0,730000,730000,0,2005373,2735373
140240400400000,RESTAURANT,COMMERCIAL,0,1620000,1620000,0,1265938,2885938
140240400500000,HOTEL,COMMERCIAL,0,333000,333000,0,514243,847243
140242600100000,DEPT/ANCHOR STORE,COMMERCIAL,0,2488750,2488750,0,2511250,5000000
140242600200000,FAST FOOD,COMMERCIAL,0,474000,474000,0,771519,1245519
140242600300000,REG SHOPPING CENTER,COMMERCIAL,0,5116250,5116250,0,27566808,32683058
140245100100000,RESTAURANT,COMMERCIAL,0,375020,375020,0,755973,1130993
140245100200000,SMALL RETAIL,COMMERCIAL,0,156629,156629,0,315559,472188
140245100300000,LG DISCOUNT/RETAIL,COMMERCIAL,0,2373968,2373968,0,4876032,7250000
140245100500000,OFFICE,COMMERCIAL,0,792750,792750,0,838243,1630993
140245100600000,FAST FOOD,COMMERCIAL,0,244000,244000,0,338596,582596
140245100700000,SMALL RETAIL,COMMERCIAL,0,195200,195200,0,278856,474056
140245100800000,BARS/LOUNGE,COMMERCIAL,0,97350,97350,0,183820,281170
140245100900000,WAREHOUSE;MINI STORG,COMMERCIAL,0,118737,118737,0,86811,205548
140245101000000,NE 115,RESIDENTIAL,10420,0,10420,0,0,10420
140245101100000,NE 115,RESIDENTIAL,10000,0,10000,0,0,10000
140245101200000,WAREHOUSE;MINI STORG,COMMERCIAL,0,43000,43000,0,34888,77888
140245200100000,BRANCH BANK/CU,COMMERCIAL,0,120000,120000,0,357765,477765
140245200200000,BRANCH BANK/CU,COMMERCIAL,0,350020,350020,0,370923,720943
140245200300000,AUTO REPAIR/SALES,COMMERCIAL,0,181500,181500,0,418962,600462
140245200400000,SHOP,EXEMPT,0,21168,21168,0,176647,197815
140245300401001,OFFICE,COMMERCIAL,0,3904,3904,0,48779,52683
140245300500000,NE 115,RESIDENTIAL,30912,0,30912,167019,0,197931
140245300600000,NE 115,RESIDENTIAL,15572,0,15572,74509,0,90081
140245300700000,NE 115,RESIDENTIAL,2986,0,2986,0,0,2986
140245300800000,NE 115,RESIDENTIAL,111,0,111,0,0,111
140245300900000,NE 115,RESIDENTIAL,3993,0,3993,0,0,3993
140247600900000,VACANT LAND,EXEMPT,0,237800,237800,0,0,237800
140247601000000,LG DISCOUNT/RETAIL,COMMERCIAL,0,1352520,1352520,0,2455690,3808210
140247601300000,LG DISCOUNT/RETAIL,COMMERCIAL,0,2041270,2041270,0,5477946,7519216
140247601400000,LG DISCOUNT/RETAIL,COMMERCIAL,0,1097250,1097250,0,5468827,6566077
140310100100000,NE 110,RESIDENTIAL,19708,0,19708,82785,0,102493
140310100200000,NE 110,RESIDENTIAL,19176,0,19176,112861,0,132037
140310100300000,NE 110,RESIDENTIAL,19176,0,19176,130087,0,149263
140310100400000,NE 110,RESIDENTIAL,19176,0,19176,145679,0,164855
140310100500000,NE 110,RESIDENTIAL,19176,0,19176,108218,0,127394
140310100600000,NE 110,RESIDENTIAL,19176,0,19176,147857,0,167033
140310100700000,NE 110,RESIDENTIAL,22997,0,22997,127355,0,150352
140310100800000,NE 110,RESIDENTIAL,24190,0,24190,127145,0,151335
140310200100000,NE 110,RESIDENTIAL,18430,0,18430,127276,0,145706
140310200200000,NE 110,RESIDENTIAL,21257,0,21257,138649,0,159906
140310300300000,APARTMENT,RESIDENTIAL,16500,0,16500,100260,0,116760
140310300600000,APARTMENT,RESIDENTIAL,24844,0,24844,142639,0,167483
140310300900000,CHURCH,EXEMPT,0,691200,691200,0,1158057,1849257
140310400400000,NBHD SHOPPING CENTER,COMMERCIAL,0,220000,220000,0,790233,1010233
140310400500000,NBHD SHOPPING CENTER,COMMERCIAL,0,317500,317500,0,735034,1052534
140310400600000,VACANT LAND,COMMERCIAL,0,302,302,0,0,302
140310400700000,BRANCH BANK/CU,COMMERCIAL,0,332000,332000,0,1150606,1482606
140312600100000,NE 110,RESIDENTIAL,23901,0,23901,125643,0,149544
140312600200000,NE 110,RESIDENTIAL,21632,0,21632,103728,0,125360
140312600300000,NE 110,RESIDENTIAL,21632,0,21632,113745,0,135377
140312600400000,NE 110,RESIDENTIAL,21632,0,21632,121295,0,142927
140312600500000,NE 110,RESIDENTIAL,21632,0,21632,109150,0,130782
140312600600000,NE 110,RESIDENTIAL,21777,0,21777,126289,0,148066
140312600700000,NE 110,RESIDENTIAL,23478,0,23478,102727,0,126205
140312700100000,NE 110,RESIDENTIAL,23296,0,23296,94685,0,117981
140312700200000,NE 110,RESIDENTIAL,20800,0,20800,102813,0,123613
140312800100000,NE 110,RESIDENTIAL,26141,0,26141,94866,0,121007
140312800200000,NE 110,RESIDENTIAL,22057,0,22057,116195,0,138252
140312800300000,NE 110,RESIDENTIAL,21168,0,21168,96805,0,117973
140312800400000,NE 110,RESIDENTIAL,21168,0,21168,112314,0,133482
140312800500000,NE 110,RESIDENTIAL,21168,0,21168,123784,0,144952
140312800600000,NE 110,RESIDENTIAL,21509,0,21509,119151,0,140660
140312800700000,NE 110,RESIDENTIAL,22661,0,22661,98580,0,121241
140312800800000,NE 110,RESIDENTIAL,22661,0,22661,85262,0,107923
140312800900000,NE 110,RESIDENTIAL,22482,0,22482,105435,0,127917
140312801000000,NE 110,RESIDENTIAL,22251,0,22251,85055,0,107306
140312801100000,NE 110,RESIDENTIAL,21470,0,21470,105019,0,126489
140312801200000,NE 110,RESIDENTIAL,21470,0,21470,107113,0,128583
140312801300000,NE 110,RESIDENTIAL,21660,0,21660,93790,0,115450
140312801400000,NE 110,RESIDENTIAL,22156,0,22156,105021,0,127177
140312801500000,NE 110,RESIDENTIAL,22321,0,22321,96987,0,119308
140312801600000,NE 110,RESIDENTIAL,25200,0,25200,131307,0,156507
140312900100000,NE 110,RESIDENTIAL,22440,0,22440,93463,0,115903
140312900200000,NE 110,RESIDENTIAL,20800,0,20800,93595,0,114395
140312900300000,NE 110,RESIDENTIAL,22348,0,22348,92167,0,114515
140312900400000,NE 110,RESIDENTIAL,22176,0,22176,117165,0,139341
140312900500000,NE 110,RESIDENTIAL,22440,0,22440,97756,0,120196
140313000100000,AUTO REPAIR/SALES,COMMERCIAL,0,102581,102581,0,193105,295686
140313000200000,SHOP,COMMERCIAL,0,208250,208250,0,280977,489227
140313000202000,BILLBOARD(BLL),COMMERCIAL,0,0,0,0,54065,54065
140313000300000,WAREHOUSE,COMMERCIAL,0,463125,463125,0,865296,1328421
140313000400000,VACANT LAND,COMMERCIAL,0,142100,142100,0,0,142100
140315100100000,HIGH TECH/RESEARCH,INDUSTRIAL,0,2513802,2513802,0,16590907,19104709
140317600100000,ANTENNAS/TOWERS(BLL),COMMERCIAL,0,152100,152100,0,1119,153219
140320100100000,NE 111,RESIDENTIAL,20000,0,20000,95757,0,115757
140320200200000,LG DISCOUNT/RETAIL,COMMERCIAL,0,1437000,1437000,0,6982751,8419751
140320200300000,NBHD SHOPPING CENTER,COMMERCIAL,0,677500,677500,0,2822164,3499664
140320200400000,BRANCH BANK/CU,COMMERCIAL,0,510000,510000,0,801791,1311791
140320300100000,NE 111,RESIDENTIAL,20000,0,20000,104257,0,124257
140320300200000,NE 111,RESIDENTIAL,440,0,440,0,0,440
140320300300000,NE 111,RESIDENTIAL,21400,0,21400,95259,0,116659
140320400100000,CITY PROPERTY,EXEMPT,0,0,0,0,0,0
140320400200000,CONC/ASPH;INDUSTRIAL,COMMERCIAL,0,382375,382375,0,274219,656594
140320400300000,CONC/ASPH;INDUSTRIAL,COMMERCIAL,0,558600,558600,0,326567,885167
140320400302000,BILLBOARD(BLL),COMMERCIAL,0,0,0,0,44204,44204
140320500100000,WAREHOUSE,COMMERCIAL,0,339000,339000,0,3326969,3665969
140320500200000,FLAT PARKING,COMMERCIAL,0,103600,103600,0,40729,144329
140320500300000,SHOP,COMMERCIAL,0,424000,424000,0,1214081,1638081
140320500400000,VACANT LAND,COMMERCIAL,0,34900,34900,0,0,34900
140322600100000,SHOP,COMMERCIAL,0,83265,83265,0,157469,240734
140322600200000,VACANT LAND,COMMERCIAL,0,33710,33710,0,0,33710
140322600300000,VACANT LAND,COMMERCIAL,0,134881,134881,0,0,134881
140322600400000,OFFICE,COMMERCIAL,0,148800,148800,0,394158,542958
140322600500000,FLAT PARKING,COMMERCIAL,0,202000,202000,0,8311,210311
140322600600000,SMALL RETAIL,COMMERCIAL,0,212000,212000,0,593150,805150
140322600701000,VETERINARY CLINIC,COMMERCIAL,0,81259,81259,0,377876,459135
140322600701001,SMALL RETAIL,COMMERCIAL,0,24379,24379,0,105282,129661
140322600701002,SMALL RETAIL,COMMERCIAL,0,24379,24379,0,105282,129661
140322600701003,SMALL RETAIL,COMMERCIAL,0,24379,24379,0,105282,129661
140322600701004,SMALL RETAIL,COMMERCIAL,0,24379,24379,0,105282,129661
140322600800000,RESTAURANT,COMMERCIAL,0,280000,280000,0,677829,957829
140322700100000,OFFICE,COMMERCIAL,0,333750,333750,0,731135,1064885
140322700200000,OFFICE,COMMERCIAL,0,498000,498000,0,863719,1361719
140322700300000,FRATERNAL,COMMERCIAL,0,691740,691740,0,1076647,1768387
140322700400000,DAY CARE CENTER,COMMERCIAL,0,217500,217500,0,387010,604510
140322700500000,FAST FOOD,COMMERCIAL,0,275000,275000,0,897261,1172261
140322800200000,WAREHOUSE,EXEMPT,0,836730,836730,0,1643689,2480419
140322800300000,CONVENIENCE STORE,COMMERCIAL,0,303620,303620,0,321414,625034
140322800500000,WAREHOUSE,COMMERCIAL,0,1222000,1222000,0,4582628,5804628
140322800600000,BRANCH BANK/CU,COMMERCIAL,0,300000,300000,0,1293385,1593385
140322800700000,CENTRALLY ASSESSED,OTHER,0,0,0,0,0,0
140325100100000,OFFICE,COMMERCIAL,0,431000,431000,0,3165482,3596482
140325100300000,HOTEL,COMMERCIAL,0,420000,420000,0,1682069,2102069
140325100400000,THEATER,COMMERCIAL,0,1274250,1274250,0,7117300,8391550
140325100500000,NBHD SHOPPING CENTER,COMMERCIAL,0,616500,616500,0,1317770,1934270
140325100600000,FLAT PARKING,COMMERCIAL,0,138750,138750,0,50225,188975
140325100700000,OFFICE; MEDICAL,COMMERCIAL,0,644490,644490,0,4803345,5447835
140325100800000,BRANCH BANK/CU,COMMERCIAL,0,300000,300000,0,824058,1124058
140325200100000,OFFICE,COMMERCIAL,0,132750,132750,0,568986,701736
140325200200000,OFFICE,COMMERCIAL,0,207000,207000,0,624706,831706
140325200300000,OFFICE,COMMERCIAL,0,214500,214500,0,616443,830943
140325200400000,RESTAURANT,COMMERCIAL,0,648000,648000,0,760012,1408012
140325200500000,HOTEL,COMMERCIAL,0,541120,541120,0,2570885,3112005
140325300100000,AUTO REPAIR/SALES,COMMERCIAL,0,444000,444000,0,305322,749322
140325300200000,OFFICE,COMMERCIAL,0,86632,86632,0,259791,346423
140325300300000,RESTAURANT,COMMERCIAL,0,400950,400950,0,449488,850438
140325300400000,FLAT PARKING,COMMERCIAL,0,117994,117994,0,40280,158274
140325300402000,BILLBOARD(BLL),COMMERCIAL,0,0,0,0,43915,43915
140325300500000,OFFICE,COMMERCIAL,0,99300,99300,0,542008,641308
140327600100000,WAREHOUSE,COMMERCIAL,0,423000,423000,0,1291092,1714092
140327600200000,MATERIALS MFG;INDUST,INDUSTRIAL,0,371088,371088,0,1190771,1561859
140327600300000,FLAT PARKING,COMMERCIAL,0,694500,694500,0,117362,811862
140327600400000,HOTEL,COMMERCIAL,0,672000,672000,0,4381912,5053912
140327600500000,HOTEL,COMMERCIAL,0,636000,636000,0,4544228,5180228
140327600700000,HOTEL,COMMERCIAL,0,470400,470400,0,2179600,2650000
140327600800000,FLAT PARKING,COMMERCIAL,0,321000,321000,0,69976,390976
140327700100000,HOTEL,COMMERCIAL,0,187500,187500,0,1110439,1297939
140327700200000,HIGH TECH/RESEARCH,INDUSTRIAL,0,1013094,1013094,0,4245363,5258457
140327700300000,HOTEL,COMMERCIAL,0,1312000,1312000,0,7789367,9101367
140327700400000,FLAT PARKING,COMMERCIAL,0,106500,106500,0,8872,115372
140327700500000,OFFICE,COMMERCIAL,0,90476,90476,0,281967,372443
140327700502000,BILLBOARD(BLL),COMMERCIAL,0,0,0,0,49150,49150
140330100100000,SCHOOL,EXEMPT,0,0,0,0,0,0
140330100200000,CITY PROPERTY,EXEMPT,0,0,0,0,0,0
140332600100000,CITY PROPERTY,EXEMPT,0,0,0,0,0,0
140337600100000,SCHOOL,EXEMPT,0,149310,149310,0,203825,353135
140337600200000,NE 117,RESIDENTIAL,33739,0,33739,72829,0,106568
140337600300000,NE 117,RESIDENTIAL,32010,0,32010,80061,0,112071
140337600400000,NE 117,RESIDENTIAL,32010,0,32010,69477,0,101487
140337600500000,NE 117,RESIDENTIAL,32010,0,32010,67800,0,99810
140337600600000,NE 117,RESIDENTIAL,32010,0,32010,76306,0,108316
140337600700000,NE 117,RESIDENTIAL,32010,0,32010,75575,0,107585
140337600800000,NE 117,RESIDENTIAL,32010,0,32010,89402,0,121412
140337600900000,NE 117,RESIDENTIAL,32010,0,32010,80095,0,112105
140337601000000,NE 117,RESIDENTIAL,36596,0,36596,83391,0,119987
140337700100000,NE 117,RESIDENTIAL,34629,0,34629,61801,0,96430
140337700200000,NE 117,RESIDENTIAL,33756,0,33756,71276,0,105032
140337700300000,NE 117,RESIDENTIAL,33756,0,33756,74358,0,108114
140337700400000,NE 117,RESIDENTIAL,33756,0,33756,73772,0,107528
140337700500000,NE 117,RESIDENTIAL,33756,0,33756,77991,0,111747
140337700600000,NE 117,RESIDENTIAL,33756,0,33756,83518,0,117274
140337700700000,NE 117,RESIDENTIAL,32010,0,32010,77026,0,109036
140337700800000,NE 117,RESIDENTIAL,32010,0,32010,75511,0,107521
140337700900000,NE 117,RESIDENTIAL,32010,0,32010,73623,0,105633
140337701000000,NE 117,RESIDENTIAL,38070,0,38070,86033,0,124103
140337800100000,NE 117,RESIDENTIAL,36434,0,36434,97146,0,133580
140337800200000,NE 117,RESIDENTIAL,35264,0,35264,88346,0,123610
140337800300000,NE 117,RESIDENTIAL,33456,0,33456,58218,0,91674
140337800400000,NE 117,RESIDENTIAL,32100,0,32100,57827,0,89927
140337800500000,NE 117,RESIDENTIAL,32700,0,32700,57335,0,90035
140337800600000,NE 117,RESIDENTIAL,32100,0,32100,54242,0,86342
140337800700000,NE 117,RESIDENTIAL,31200,0,31200,62121,0,93321
140337800800000,NE 117,RESIDENTIAL,30888,0,30888,60359,0,91247
140337800900000,NE 117,RESIDENTIAL,32010,0,32010,71111,0,103121
140337801000000,NE 117,RESIDENTIAL,33174,0,33174,56530,0,89704
140337801100000,NE 117,RESIDENTIAL,32126,0,32126,76102,0,108228
140337801200000,NE 117,RESIDENTIAL,33756,0,33756,66081,0,99837
140337801300000,NE 117,RESIDENTIAL,32010,0,32010,84445,0,116455
140337801400000,NE 117,RESIDENTIAL,32010,0,32010,65561,0,97571
140337801500000,NE 117,RESIDENTIAL,32010,0,32010,69420,0,101430
140337801600000,NE 117,RESIDENTIAL,32010,0,32010,84671,0,116681
140337801700000,NE 117,RESIDENTIAL,32010,0,32010,71597,0,103607
140337801800000,NE 117,RESIDENTIAL,32708,0,32708,80778,0,113486
140337801900000,NE 117,RESIDENTIAL,33756,0,33756,75707,0,109463
140337802000000,NE 117,RESIDENTIAL,33756,0,33756,70983,0,104739
140337802100000,NE 117,RESIDENTIAL,33756,0,33756,77500,0,111256
140337802200000,NE 117,RESIDENTIAL,36289,0,36289,83563,0,119852
140337802300000,NE 117,RESIDENTIAL,34066,0,34066,76239,0,110305
140337802400000,NE 117,RESIDENTIAL,37810,0,37810,79498,0,117308
140337802500000,NE 117,RESIDENTIAL,33756,0,33756,78326,0,112082
140337802600000,NE 117,RESIDENTIAL,33756,0,33756,88370,0,122126
140337802700000,NE 117,RESIDENTIAL,33756,0,33756,88301,0,122057
140337802800000,NE 117,RESIDENTIAL,32708,0,32708,74792,0,107500
140337802900000,NE 117,RESIDENTIAL,32010,0,32010,80578,0,112588
140337803000000,NE 117,RESIDENTIAL,32010,0,32010,82132,0,114142
140337803100000,NE 117,RESIDENTIAL,32010,0,32010,56981,0,88991
140337803200000,NE 117,RESIDENTIAL,32010,0,32010,60265,0,92275
140337803300000,NE 117,RESIDENTIAL,32010,0,32010,74193,0,106203
140337803400000,NE 117,RESIDENTIAL,32534,0,32534,79032,0,111566
140337803500000,NE 117,RESIDENTIAL,32010,0,32010,73378,0,105388
140337803600000,NE 117,RESIDENTIAL,32010,0,32010,75332,0,107342
140337803700000,NE 117,RESIDENTIAL,33908,0,33908,79117,0,113025
140337803800000,NE 117,RESIDENTIAL,34094,0,34094,53889,0,87983
140337803900000,NE 117,RESIDENTIAL,35853,0,35853,70477,0,106330
140337804000000,NE 117,RESIDENTIAL,35937,0,35937,87230,0,123167
140337804100000,NE 117,RESIDENTIAL,34382,0,34382,88756,0,123138
140337804200000,NE 117,RESIDENTIAL,34382,0,34382,74651,0,109033
140337804300000,NE 117,RESIDENTIAL,33060,0,33060,86971,0,120031
140337804400000,NE 117,RESIDENTIAL,33408,0,33408,78133,0,111541
140337900100000,NE 117,RESIDENTIAL,34642,0,34642,75529,0,110171
140337900200000,NE 117,RESIDENTIAL,34920,0,34920,67154,0,102074
140337900300000,NE 117,RESIDENTIAL,34920,0,34920,73329,0,108249
140337900400000,NE 117,RESIDENTIAL,34920,0,34920,71509,0,106429
140337900500000,NE 117,RESIDENTIAL,34920,0,34920,90307,0,125227
140337900600000,NE 117,RESIDENTIAL,33756,0,33756,81784,0,115540
140337900700000,NE 117,RESIDENTIAL,33756,0,33756,82844,0,116600
140337900800000,NE 117,RESIDENTIAL,33756,0,33756,61489,0,95245
140337900900000,NE 117,RESIDENTIAL,36064,0,36064,79461,0,115525
140337901000000,NE 117,RESIDENTIAL,34400,0,34400,80389,0,114789
140337901100000,NE 117,RESIDENTIAL,36960,0,36960,57598,0,94558
140337901200000,NE 117,RESIDENTIAL,34832,0,34832,57973,0,92805
140337901300000,NE 117,RESIDENTIAL,33199,0,33199,61211,0,94410
140337901400000,NE 117,RESIDENTIAL,38160,0,38160,64308,0,102468
140337901500000,NE 117,RESIDENTIAL,38160,0,38160,69240,0,107400
140337901600000,NE 117,RESIDENTIAL,38160,0,38160,78895,0,117055
140337901700000,NE 117,RESIDENTIAL,38160,0,38160,70632,0,108792
140337901800000,NE 117,RESIDENTIAL,38160,0,38160,89313,0,127473
140337901900000,NE 117,RESIDENTIAL,38160,0,38160,73891,0,112051
140337902000000,CHURCH,COMMERCIAL,0,97065,97065,0,152133,249198
140337902100000,BRANCH BANK/CU,COMMERCIAL,0,642000,642000,0,3080829,3722829
140337902300000,FAST FOOD,COMMERCIAL,0,33250,33250,0,81653,114903
140337902400000,AUTO REPAIR/SALES,COMMERCIAL,0,182400,182400,0,154006,336406
140337902500000,SMALL RETAIL,COMMERCIAL,0,200300,200300,0,426358,626658
140337902600000,OFFICE,COMMERCIAL,0,466000,466000,0,293313,759313
140337902700000,NBHD SHOPPING CENTER,COMMERCIAL,0,269747,269747,0,710253,980000
140338000100000,NE 117,RESIDENTIAL,35455,0,35455,83395,0,118850
140338000200000,NE 117,RESIDENTIAL,34150,0,34150,67037,0,101187
140338000300000,NE 117,RESIDENTIAL,32832,0,32832,73460,0,106292
140338000400000,NE 117,RESIDENTIAL,32010,0,32010,79193,0,111203
140338000500000,NE 117,RESIDENTIAL,32010,0,32010,73804,0,105814
140338000600000,NE 117,RESIDENTIAL,31777,0,31777,77160,0,108937
140338000700000,NE 117,RESIDENTIAL,31777,0,31777,71475,0,103252
140338000800000,NE 117,RESIDENTIAL,31777,0,31777,66709,0,98486
140338000900000,NE 117,RESIDENTIAL,31777,0,31777,69076,0,100853
140338001000000,NE 117,RESIDENTIAL,31777,0,31777,68326,0,100103
140338001100000,NE 117,RESIDENTIAL,31777,0,31777,53317,0,85094
140338001200000,NE 117,RESIDENTIAL,31777,0,31777,73135,0,104912
140338001300000,NE 117,RESIDENTIAL,31777,0,31777,78002,0,109779
140338001400000,NE 117,RESIDENTIAL,31777,0,31777,81308,0,113085
140338001500000,NE 117,RESIDENTIAL,36289,0,36289,70554,0,106843
140338001600000,NE 117,RESIDENTIAL,34066,0,34066,69891,0,103957
140338001700000,NE 117,RESIDENTIAL,37810,0,37810,72441,0,110251
140338001800000,NE 117,RESIDENTIAL,31777,0,31777,72345,0,104122
140338001900000,NE 117,RESIDENTIAL,31777,0,31777,76034,0,107811
140338002000000,NE 117,RESIDENTIAL,31777,0,31777,75516,0,107293
140338002100000,NE 117,RESIDENTIAL,31777,0,31777,86833,0,118610
140338002200000,NE 117,RESIDENTIAL,31777,0,31777,66994,0,98771
140338002300000,NE 117,RESIDENTIAL,31777,0,31777,83856,0,115633
140338002400000,NE 117,RESIDENTIAL,31777,0,31777,68015,0,99792
140338002500000,NE 117,RESIDENTIAL,31777,0,31777,68143,0,99920
140338002600000,NE 117,RESIDENTIAL,31777,0,31777,85703,0,117480
140338002700000,NE 117,RESIDENTIAL,32010,0,32010,91702,0,123712
140338002800000,NE 117,RESIDENTIAL,32010,0,32010,72356,0,104366
140338002900000,NE 117,RESIDENTIAL,32623,0,32623,75311,0,107934
140338003000000,NE 117,RESIDENTIAL,32771,0,32771,69456,0,102227
140338100200000,AUTO REPAIR/SALES,COMMERCIAL,0,3375,3375,0,139391,142766
140338100500000,OFFICE,EXEMPT,0,232500,232500,0,1033039,1265539
140338100700000,OFFICE,COMMERCIAL,0,40347,40347,0,130592,170939
140340100100000,OFFICE,COMMERCIAL,0,1009125,1009125,0,1233446,2242571
140340200100000,NE 117,RESIDENTIAL,35316,0,35316,76719,0,112035
140340200200000,NE 117,RESIDENTIAL,36660,0,36660,102169,0,138829
140340200300000,NE 117,RESIDENTIAL,28200,0,28200,86038,0,114238
140340200400000,NE 117,RESIDENTIAL,28200,0,28200,82153,0,110353
140340200500000,NE 117,RESIDENTIAL,28200,0,28200,72161,0,100361
140340200600000,NE 117,RESIDENTIAL,28200,0,28200,70222,0,98422
140340200700000,NE 117,RESIDENTIAL,28200,0,28200,77902,0,106102
140340200800000,NE 117,RESIDENTIAL,28200,0,28200,80605,0,108805
140340200900000,NE 117,RESIDENTIAL,28200,0,28200,86129,0,114329
140340201000000,NE 117,RESIDENTIAL,33109,0,33109,85437,0,118546
140340201100000,NE 117,RESIDENTIAL,33691,0,33691,80134,0,113825
140340201200000,NE 117,RESIDENTIAL,28592,0,28592,100915,0,129507
140340201300000,NE 117,RESIDENTIAL,28500,0,28500,80641,0,109141
140340201400000,NE 117,RESIDENTIAL,33014,0,33014,75550,0,108564
140340201500000,NE 117,RESIDENTIAL,33250,0,33250,104994,0,138244
140340201600000,NE 117,RESIDENTIAL,26675,0,26675,74357,0,101032
140340201700000,NE 117,RESIDENTIAL,26675,0,26675,74876,0,101551
140340201800000,NE 117,RESIDENTIAL,28251,0,28251,77858,0,106109
140340201900000,NE 117,RESIDENTIAL,25200,0,25200,68743,0,93943
140340202000000,NE 117,RESIDENTIAL,26149,0,26149,87646,0,113795
140340202100000,NE 117,RESIDENTIAL,27160,0,27160,75351,0,102511
140340202200000,NE 117,RESIDENTIAL,27160,0,27160,67208,0,94368
140340202300000,NE 117,RESIDENTIAL,27160,0,27160,78462,0,105622
140340202400000,NE 117,RESIDENTIAL,27160,0,27160,82963,0,110123
140340202500000,NE 117,RESIDENTIAL,18634,0,18634,0,0,18634
140340202600000,NE 117,RESIDENTIAL,23674,0,23674,99417,0,123091
140340202700000,NE 117,RESIDENTIAL,29414,0,29414,78266,0,107680
140340202800000,NE 117,RESIDENTIAL,30720,0,30720,72289,0,103009
140340202900000,NE 117,RESIDENTIAL,31680,0,31680,76738,0,108418
140340203000000,NE 117,RESIDENTIAL,31680,0,31680,75722,0,107402
140340203100000,NE 117,RESIDENTIAL,31680,0,31680,75284,0,106964
140340203200000,NE 117,RESIDENTIAL,31680,0,31680,81035,0,112715
140340300100000,NE 117,RESIDENTIAL,35079,0,35079,81755,0,116834
140340300200000,NE 117,RESIDENTIAL,36425,0,36425,63101,0,99526
140340300300000,NE 117,RESIDENTIAL,28200,0,28200,78912,0,107112
140340300400000,NE 117,RESIDENTIAL,28200,0,28200,74239,0,102439
140340300500000,NE 117,RESIDENTIAL,28200,0,28200,83045,0,111245
140340300600000,NE 117,RESIDENTIAL,28200,0,28200,78672,0,106872
140340300700000,NE 117,RESIDENTIAL,28200,0,28200,74132,0,102332
140340300800000,NE 117,RESIDENTIAL,28200,0,28200,71202,0,99402
140340300900000,NE 117,RESIDENTIAL,28200,0,28200,72146,0,100346
140340301000000,NE 117,RESIDENTIAL,30300,0,30300,85533,0,115833
140340301100000,NE 117,RESIDENTIAL,33950,0,33950,82851,0,116801
140340301200000,NE 117,RESIDENTIAL,33777,0,33777,85686,0,119463
140340301300000,NE 117,RESIDENTIAL,34083,0,34083,83668,0,117751
140340301400000,NE 117,RESIDENTIAL,31680,0,31680,81533,0,113213
140340301500000,NE 117,RESIDENTIAL,31680,0,31680,74806,0,106486
140340301600000,NE 117,RESIDENTIAL,31680,0,31680,82125,0,113805
140340301700000,NE 117,RESIDENTIAL,31680,0,31680,71506,0,103186
140340301800000,NE 117,RESIDENTIAL,31680,0,31680,79511,0,111191
140340301900000,NE 117,RESIDENTIAL,31680,0,31680,75945,0,107625
140340302000000,NE 117,RESIDENTIAL,31680,0,31680,80017,0,111697
140340400100000,OFFICE,COMMERCIAL,0,137000,137000,0,233016,370016
140340400200000,NE 116,RESIDENTIAL,43600,0,43600,126907,0,170507
140340400300000,NE 116,RESIDENTIAL,43600,0,43600,80246,0,123846
140340400400000,NE 116,RESIDENTIAL,43600,0,43600,100907,0,144507
140340400500000,NE 116,RESIDENTIAL,43600,0,43600,85816,0,129416
140340400600000,NE 116,RESIDENTIAL,25712,0,25712,125782,0,151494
140340400700000,NE 116,RESIDENTIAL,27867,0,27867,129184,0,157051
140340400800000,NE 116,EXEMPT,0,54267,54267,0,98368,152635
140340400900000,NE 116,RESIDENTIAL,27967,0,27967,119330,0,147297
140340401000000,NE 116,RESIDENTIAL,29601,0,29601,137232,0,166833
140340401100000,NE 116,RESIDENTIAL,25749,0,25749,117563,0,143312
140340401200000,NE 116,RESIDENTIAL,26125,0,26125,120108,0,146233
140340401300000,CITY PROPERTY,EXEMPT,0,0,0,0,0,0
140340401400000,CITY PROPERTY,EXEMPT,0,0,0,0,0,0
140340500100000,CHURCH,EXEMPT,0,64800,64800,0,181283,246083
140340500200000,NE 116,RESIDENTIAL,43600,0,43600,114722,0,158322
140340500300000,NE 116,RESIDENTIAL,43600,0,43600,94350,0,137950
140340500400000,NE 116,RESIDENTIAL,43600,0,43600,112854,0,156454
140340500500000,NE 116,RESIDENTIAL,43600,0,43600,86179,0,129779
140340500600000,NE 116,RESIDENTIAL,43600,0,43600,98225,0,141825
140340500700000,NE 116,RESIDENTIAL,31179,0,31179,144833,0,176012
140340500800000,NE 116,RESIDENTIAL,29975,0,29975,155379,0,185354
140340500900000,NE 116,RESIDENTIAL,29975,0,29975,143383,0,173358
140340501000000,NE 116,RESIDENTIAL,29975,0,29975,146410,0,176385
140340501100000,NE 116,RESIDENTIAL,29975,0,29975,117176,0,147151
140340501200000,NE 116,RESIDENTIAL,29975,0,29975,159278,0,189253
140340600100000,NE 116,RESIDENTIAL,34574,0,34574,100568,0,135142
140340600200000,NE 116,RESIDENTIAL,35915,0,35915,148416,0,184331
140340600300000,NE 116,RESIDENTIAL,29425,0,29425,194128,0,223553
140340600400000,NE 116,RESIDENTIAL,38252,0,38252,140002,0,178254
140342600100000,NE 117,RESIDENTIAL,39592,0,39592,86575,0,126167
140342600200000,NE 117,RESIDENTIAL,25872,0,25872,59417,0,85289
140342600300000,NE 117,RESIDENTIAL,23760,0,23760,83341,0,107101
140342600400000,NE 117,RESIDENTIAL,36660,0,36660,66496,0,103156
140342600500000,NE 117,RESIDENTIAL,32902,0,32902,77588,0,110490
140342600600000,NE 117,RESIDENTIAL,35568,0,35568,61573,0,97141
140342600700000,NE 117,RESIDENTIAL,37624,0,37624,93680,0,131304
140342600800000,NE 117,RESIDENTIAL,32495,0,32495,73874,0,106369
140342600900000,NE 117,RESIDENTIAL,34000,0,34000,82732,0,116732
140342601000000,NE 117,RESIDENTIAL,33000,0,33000,74489,0,107489
140342601100000,NE 117,RESIDENTIAL,35705,0,35705,75371,0,111076
140342601200000,NE 117,RESIDENTIAL,30500,0,30500,76150,0,106650
140342601300000,NE 117,RESIDENTIAL,31763,0,31763,73977,0,105740
140342601400000,NE 117,RESIDENTIAL,31110,0,31110,87606,0,118716
140342601500000,NE 117,RESIDENTIAL,30195,0,30195,80740,0,110935
140342700100000,CHURCH,EXEMPT,0,703080,703080,0,323999,1027079
140342700200000,NE 117,RESIDENTIAL,38880,0,38880,94556,0,133436
140342700300000,NE 117,RESIDENTIAL,34560,0,34560,73888,0,108448
140342700400000,NE 117,RESIDENTIAL,39168,0,39168,72782,0,111950
140342700500000,NE 117,RESIDENTIAL,30333,0,30333,73117,0,103450
140342700600000,NE 117,RESIDENTIAL,29890,0,29890,69216,0,99106
140342700700000,NE 117,RESIDENTIAL,29617,0,29617,73264,0,102881
140342700800000,NE 117,RESIDENTIAL,29585,0,29585,84448,0,114033
140342700900000,NE 117,RESIDENTIAL,30195,0,30195,78090,0,108285
140342701000000,NE 117,RESIDENTIAL,31142,0,31142,75676,0,106818
140342701100000,NE 117,RESIDENTIAL,29813,0,29813,73389,0,103202
140342701200000,NE 117,RESIDENTIAL,31565,0,31565,68584,0,100149
140342701300000,NE 117,RESIDENTIAL,30625,0,30625,100223,0,130848
140342701400000,NE 117,RESIDENTIAL,36975,0,36975,81798,0,118773
140342701500000,NE 117,RESIDENTIAL,32177,0,32177,63285,0,95462
140342701600000,NE 117,RESIDENTIAL,33453,0,33453,59855,0,93308
140342701700000,NE 117,RESIDENTIAL,36416,0,36416,69965,0,106381
140342800100000,NE 117,RESIDENTIAL,36978,0,36978,78918,0,115896
140342800200000,NE 117,RESIDENTIAL,34920,0,34920,72507,0,107427
140342800300000,NE 117,RESIDENTIAL,34920,0,34920,69530,0,104450
140342800400000,NE 117,RESIDENTIAL,34920,0,34920,69923,0,104843
140342800500000,NE 117,RESIDENTIAL,34920,0,34920,86057,0,120977
140342800600000,NE 117,RESIDENTIAL,34920,0,34920,79390,0,114310
140342800700000,NE 117,RESIDENTIAL,34920,0,34920,78267,0,113187
140342800800000,NE 117,RESIDENTIAL,37248,0,37248,84637,0,121885
140342900100000,NE 117,RESIDENTIAL,35720,0,35720,79316,0,115036
140342900200000,NE 117,RESIDENTIAL,33170,0,33170,87563,0,120733
140342900300000,NE 117,RESIDENTIAL,33790,0,33790,75747,0,109537
140342900400000,NE 117,RESIDENTIAL,34467,0,34467,70934,0,105401
140342900500000,NE 117,RESIDENTIAL,33170,0,33170,65857,0,99027
140342900600000,NE 117,RESIDENTIAL,32067,0,32067,71591,0,103658
140342900700000,NE 117,RESIDENTIAL,30667,0,30667,68051,0,98718
140342900800000,NE 117,RESIDENTIAL,30360,0,30360,63597,0,93957
140342900900000,NE 117,RESIDENTIAL,29585,0,29585,55091,0,84676
140342901000000,NE 117,RESIDENTIAL,29520,0,29520,63612,0,93132
140342901100000,NE 117,RESIDENTIAL,29407,0,29407,71346,0,100753
140342901200000,NE 117,RESIDENTIAL,29423,0,29423,69493,0,98916
140342901300000,NE 117,RESIDENTIAL,29423,0,29423,65090,0,94513
140342901400000,NE 117,RESIDENTIAL,29423,0,29423,69161,0,98584
140342901500000,NE 117,RESIDENTIAL,29423,0,29423,65142,0,94565
140342901600000,NE 117,RESIDENTIAL,29423,0,29423,65344,0,94767
140342901700000,NE 117,RESIDENTIAL,29682,0,29682,66167,0,95849
140342901800000,NE 117,RESIDENTIAL,39168,0,39168,83343,0,122511
140342901900000,NE 117,RESIDENTIAL,34560,0,34560,84155,0,118715
140342902000000,NE 117,RESIDENTIAL,39168,0,39168,93154,0,132322
140342902100000,NE 117,RESIDENTIAL,27095,0,27095,67134,0,94229
140342902200000,NE 117,RESIDENTIAL,29585,0,29585,66526,0,96111
140342902300000,NE 117,RESIDENTIAL,30070,0,30070,75149,0,105219
140342902400000,NE 117,RESIDENTIAL,30070,0,30070,80075,0,110145
140342902500000,NE 117,RESIDENTIAL,30070,0,30070,77030,0,107100
140342902600000,NE 117,RESIDENTIAL,29908,0,29908,56651,0,86559
140342902700000,NE 117,RESIDENTIAL,29908,0,29908,69863,0,99771
140342902800000,NE 117,RESIDENTIAL,30543,0,30543,73088,0,103631
140342902900000,NE 117,RESIDENTIAL,30855,0,30855,103762,0,134617
140342903000000,NE 117,RESIDENTIAL,31815,0,31815,75715,0,107530
140342903100000,NE 117,RESIDENTIAL,33567,0,33567,71402,0,104969
140342903200000,NE 117,RESIDENTIAL,34517,0,34517,121494,0,156011
140342903300000,NE 117,RESIDENTIAL,34418,0,34418,95117,0,129535
140342903400000,NE 117,RESIDENTIAL,35720,0,35720,79438,0,115158
140342903500000,NE 117,RESIDENTIAL,26950,0,26950,74058,0,101008
140342903600000,NE 117,RESIDENTIAL,28875,0,28875,13947,0,42822
140342903700000,NE 117,RESIDENTIAL,28875,0,28875,66994,0,95869
140342903800000,NE 117,RESIDENTIAL,31033,0,31033,53782,0,84815
140342903900000,NE 117,RESIDENTIAL,35530,0,35530,73777,0,109307
140342904000000,NE 117,RESIDENTIAL,28500,0,28500,77085,0,105585
140343000100000,NE 117,RESIDENTIAL,31768,0,31768,62635,0,94403
140343000200000,NE 117,RESIDENTIAL,26675,0,26675,72690,0,99365
140343000300000,NE 117,RESIDENTIAL,26675,0,26675,74710,0,101385
140343000400000,NE 117,RESIDENTIAL,26675,0,26675,72028,0,98703
140343000500000,NE 117,RESIDENTIAL,29100,0,29100,75303,0,104403
140343000600000,NE 117,RESIDENTIAL,29100,0,29100,71153,0,100253
140343000700000,NE 117,RESIDENTIAL,29100,0,29100,90913,0,120013
140343000800000,NE 117,RESIDENTIAL,29100,0,29100,81760,0,110860
140343000900000,NE 117,RESIDENTIAL,29100,0,29100,71805,0,100905
140343001000000,NE 117,RESIDENTIAL,29100,0,29100,67793,0,96893
140343001100000,NE 117,RESIDENTIAL,29100,0,29100,70803,0,99903
140343001200000,NE 117,RESIDENTIAL,29100,0,29100,79859,0,108959
140343001300000,NE 117,RESIDENTIAL,29100,0,29100,70069,0,99169
140343001400000,NE 117,RESIDENTIAL,47580,0,47580,58674,0,106254
140343001500000,NE 117,RESIDENTIAL,27691,0,27691,68153,0,95844
140343001600000,NE 117,RESIDENTIAL,33479,0,33479,72241,0,105720
140343001700000,NE 117,RESIDENTIAL,28258,0,28258,64820,0,93078
140343001800000,NE 117,RESIDENTIAL,15750,0,15750,0,0,15750
140343001900000,NE 117,RESIDENTIAL,34106,0,34106,94467,0,128573
140343100100000,NE 117,RESIDENTIAL,35720,0,35720,66059,0,101779
140343100200000,NE 117,RESIDENTIAL,30393,0,30393,73403,0,103796
140343100300000,NE 117,RESIDENTIAL,29423,0,29423,76339,0,105762
140343100400000,NE 117,RESIDENTIAL,30393,0,30393,78173,0,108566
140343100500000,NE 117,RESIDENTIAL,30393,0,30393,81290,0,111683
140343100600000,NE 117,RESIDENTIAL,30393,0,30393,69869,0,100262
140343100700000,NE 117,RESIDENTIAL,30393,0,30393,78222,0,108615
140343100800000,NE 117,RESIDENTIAL,30393,0,30393,85363,0,115756
140343100900000,NE 117,RESIDENTIAL,30393,0,30393,85902,0,116295
140343101000000,NE 117,RESIDENTIAL,30393,0,30393,66426,0,96819
140343101100000,NE 117,RESIDENTIAL,30393,0,30393,85055,0,115448
140343101200000,NE 117,RESIDENTIAL,31881,0,31881,80362,0,112243
140343101300000,NE 117,RESIDENTIAL,39168,0,39168,74306,0,113474
140343101400000,NE 117,RESIDENTIAL,34560,0,34560,71837,0,106397
140343101500000,NE 117,RESIDENTIAL,39168,0,39168,88720,0,127888
140343101600000,NE 117,RESIDENTIAL,27742,0,27742,72495,0,100237
140343101700000,NE 117,RESIDENTIAL,31033,0,31033,68635,0,99668
140343101800000,NE 117,RESIDENTIAL,27930,0,27930,62770,0,90700
140343101900000,NE 117,RESIDENTIAL,28583,0,28583,83830,0,112413
140343102000000,NE 117,RESIDENTIAL,27930,0,27930,87437,0,115367
140343102100000,NE 117,RESIDENTIAL,28583,0,28583,93311,0,121894
140343102200000,NE 117,RESIDENTIAL,27930,0,27930,76360,0,104290
140343102300000,NE 117,RESIDENTIAL,31033,0,31033,84382,0,115415
140343102400000,NE 117,RESIDENTIAL,29400,0,29400,75344,0,104744
140343102500000,NE 117,RESIDENTIAL,35794,0,35794,89706,0,125500
140343102600000,NE 117,RESIDENTIAL,28200,0,28200,79020,0,107220
140343200100000,NE 117,RESIDENTIAL,37248,0,37248,78721,0,115969
140343200200000,NE 117,RESIDENTIAL,34338,0,34338,87897,0,122235
140343200300000,NE 117,RESIDENTIAL,34338,0,34338,81228,0,115566
140343200400000,NE 117,RESIDENTIAL,34338,0,34338,88102,0,122440
140343200500000,NE 117,RESIDENTIAL,34338,0,34338,80046,0,114384
140343200600000,NE 117,RESIDENTIAL,34338,0,34338,77100,0,111438
140343200700000,NE 117,RESIDENTIAL,34338,0,34338,91444,0,125782
140343200800000,NE 117,RESIDENTIAL,34338,0,34338,71784,0,106122
140343200900000,NE 117,RESIDENTIAL,34804,0,34804,94983,0,129787
140343201000000,NE 117,RESIDENTIAL,33745,0,33745,79167,0,112912
140343300100000,NE 117,RESIDENTIAL,31906,0,31906,76914,0,108820
140343300200000,NE 117,RESIDENTIAL,28453,0,28453,73125,0,101578
140343300300000,NE 117,RESIDENTIAL,28130,0,28130,80735,0,108865
140343300400000,NE 117,RESIDENTIAL,27968,0,27968,86491,0,114459
140343300500000,NE 117,RESIDENTIAL,27968,0,27968,73613,0,101581
140343300600000,NE 117,RESIDENTIAL,27968,0,27968,77034,0,105002
140343300700000,NE 117,RESIDENTIAL,27968,0,27968,76106,0,104074
140343300800000,NE 117,RESIDENTIAL,27322,0,27322,73055,0,100377
140343300900000,NE 117,RESIDENTIAL,36864,0,36864,82159,0,119023
140343301000000,NE 117,RESIDENTIAL,34560,0,34560,104639,0,139199
140343301100000,NE 117,RESIDENTIAL,36864,0,36864,79255,0,116119
140343301200000,NE 117,RESIDENTIAL,35114,0,35114,70547,0,105661
140343301300000,NE 117,RESIDENTIAL,36860,0,36860,82256,0,119116
140343301400000,NE 117,RESIDENTIAL,37597,0,37597,62123,0,99720
140343301500000,NE 117,RESIDENTIAL,37781,0,37781,74111,0,111892
140343301600000,NE 117,RESIDENTIAL,37631,0,37631,64037,0,101668
140343301700000,NE 117,RESIDENTIAL,28200,0,28200,75868,0,104068
140343400100000,NE 117,RESIDENTIAL,36230,0,36230,82606,0,118836
140343400200000,NE 117,RESIDENTIAL,38080,0,38080,81018,0,119098
140343400300000,NE 117,RESIDENTIAL,37300,0,37300,97489,0,134789
140343400400000,NE 117,RESIDENTIAL,37149,0,37149,87996,0,125145
140345100100000,NE 117,RESIDENTIAL,32939,0,32939,73464,0,106403
140345100200000,NE 117,RESIDENTIAL,31837,0,31837,55955,0,87792
140345100300000,NE 117,RESIDENTIAL,38220,0,38220,63402,0,101622
140345100400000,NE 117,RESIDENTIAL,35362,0,35362,73058,0,108420
140345100500000,NE 117,RESIDENTIAL,37653,0,37653,76944,0,114597
140345100600000,NE 117,RESIDENTIAL,31040,0,31040,80834,0,111874
140345200100000,NE 117,RESIDENTIAL,30080,0,30080,94043,0,124123
140345200200000,NE 117,RESIDENTIAL,34920,0,34920,73505,0,108425
140345200300000,NE 117,RESIDENTIAL,34920,0,34920,73076,0,107996
140345200400000,NE 117,RESIDENTIAL,34920,0,34920,69761,0,104681
140345200500000,NE 117,RESIDENTIAL,34920,0,34920,83521,0,118441
140345200600000,NE 117,RESIDENTIAL,34920,0,34920,83393,0,118313
140345200700000,NE 117,RESIDENTIAL,34920,0,34920,64437,0,99357
140345200800000,NE 117,RESIDENTIAL,34920,0,34920,79995,0,114915
140345200900000,NE 117,RESIDENTIAL,34920,0,34920,76652,0,111572
140345201000000,NE 117,RESIDENTIAL,34920,0,34920,81803,0,116723
140345201100000,NE 117,RESIDENTIAL,34920,0,34920,75600,0,110520
140345201200000,NE 117,RESIDENTIAL,34920,0,34920,82929,0,117849
140345201300000,NE 117,RESIDENTIAL,34920,0,34920,92399,0,127319
140345201400000,NE 117,RESIDENTIAL,34920,0,34920,88789,0,123709
140345201500000,NE 117,RESIDENTIAL,30080,0,30080,80486,0,110566
140345201600000,NE 117,RESIDENTIAL,22560,0,22560,75486,0,98046
140345300100000,NE 117,RESIDENTIAL,24064,0,24064,75032,0,99096
140345300200000,NE 117,RESIDENTIAL,32010,0,32010,71628,0,103638
140345300300000,NE 117,RESIDENTIAL,32010,0,32010,67386,0,99396
140345300400000,NE 117,RESIDENTIAL,32010,0,32010,68153,0,100163
140345300500000,NE 117,RESIDENTIAL,32010,0,32010,69932,0,101942
140345300600000,NE 117,RESIDENTIAL,32010,0,32010,76756,0,108766
140345300700000,NE 117,RESIDENTIAL,32010,0,32010,72532,0,104542
140345300800000,NE 117,RESIDENTIAL,32010,0,32010,95764,0,127774
140345300900000,NE 117,RESIDENTIAL,32010,0,32010,75212,0,107222
140345301000000,NE 117,RESIDENTIAL,32010,0,32010,69342,0,101352
140345301100000,NE 117,RESIDENTIAL,32010,0,32010,80647,0,112657
140345301200000,NE 117,RESIDENTIAL,32010,0,32010,77533,0,109543
140345301300000,NE 117,RESIDENTIAL,32010,0,32010,80535,0,112545
140345301400000,NE 117,RESIDENTIAL,32010,0,32010,67421,0,99431
140345301500000,NE 117,RESIDENTIAL,32010,0,32010,70380,0,102390
140345301600000,NE 117,RESIDENTIAL,32010,0,32010,72467,0,104477
140345301700000,NE 117,RESIDENTIAL,32010,0,32010,74199,0,106209
140345301800000,NE 117,RESIDENTIAL,24064,0,24064,60943,0,85007
140345301900000,NE 117,RESIDENTIAL,22560,0,22560,69109,0,91669
140345400100000,NE 117,RESIDENTIAL,37440,0,37440,72721,0,110161
140345400200000,NE 117,RESIDENTIAL,32100,0,32100,55118,0,87218
140345400300000,NE 117,RESIDENTIAL,32400,0,32400,52504,0,84904
140345400400000,NE 117,RESIDENTIAL,32400,0,32400,70414,0,102814
140345400500000,NE 117,RESIDENTIAL,32123,0,32123,54124,0,86247
140345400600000,NE 117,RESIDENTIAL,36622,0,36622,71109,0,107731
140345400700000,NE 117,RESIDENTIAL,34160,0,34160,63063,0,97223
140345500100000,NE 117,RESIDENTIAL,44070,0,44070,76946,0,121016
140345500200000,NE 117,EXEMPT,0,47514,47514,0,91098,138612
140345500300000,CHURCH,EXEMPT,0,172800,172800,0,85306,258106
140345500400000,NE 117,RESIDENTIAL,44840,0,44840,124243,0,169083
140345500500000,NE 117,RESIDENTIAL,23185,0,23185,71787,0,94972
140345500600000,NE 117,RESIDENTIAL,25355,0,25355,29628,0,54983
140345500700000,NE 117,RESIDENTIAL,32906,0,32906,92717,0,125623
140345500800000,NE 117,RESIDENTIAL,34425,0,34425,73885,0,108310
140345500900000,NE 117,RESIDENTIAL,31945,0,31945,81832,0,113777
140345501000000,NE 117,RESIDENTIAL,31200,0,31200,72204,0,103404
140345501100000,NE 117,RESIDENTIAL,31200,0,31200,103627,0,134827
140345501200000,NE 117,RESIDENTIAL,31320,0,31320,86709,0,118029
140345501300000,NE 117,RESIDENTIAL,31200,0,31200,77172,0,108372
140345501400000,NE 117,RESIDENTIAL,31200,0,31200,80883,0,112083
140345501500000,NE 117,RESIDENTIAL,31200,0,31200,96447,0,127647
140345501600000,NE 117,RESIDENTIAL,31200,0,31200,103265,0,134465
140345501700000,NE 117,RESIDENTIAL,31200,0,31200,50985,0,82185
140345501800000,NE 117,RESIDENTIAL,30368,0,30368,60252,0,90620
140345501900000,NE 117,RESIDENTIAL,42700,0,42700,81048,0,123748
140345502000000,NE 117,RESIDENTIAL,6092,0,6092,962,0,7054
140345502100000,NE 117,RESIDENTIAL,36400,0,36400,67654,0,104054
140345502200000,NE 117,RESIDENTIAL,6234,0,6234,0,0,6234
140345502300000,NE 117,RESIDENTIAL,36811,0,36811,75563,0,112374
140345502400000,NE 117,RESIDENTIAL,42253,0,42253,83346,0,125599
140345502500000,NE 117,RESIDENTIAL,5450,0,5450,0,0,5450
140345502600000,NE 117,RESIDENTIAL,36400,0,36400,117476,0,153876
140345502700000,NE 117,RESIDENTIAL,36400,0,36400,87475,0,123875
140345502800000,NE 117,RESIDENTIAL,36400,0,36400,128068,0,164468
140345502900000,NE 117,RESIDENTIAL,36052,0,36052,120401,0,156453
140345600100000,NE 117,RESIDENTIAL,35109,0,35109,48585,0,83694
140345600200000,NE 117,RESIDENTIAL,33300,0,33300,77700,0,111000
140345600300000,NE 117,RESIDENTIAL,31280,0,31280,64085,0,95365
140345600400000,NE 117,RESIDENTIAL,38562,0,38562,141621,0,180183
140345600500000,NE 117,RESIDENTIAL,36604,0,36604,76611,0,113215
140345600600000,APARTMENT,COMMERCIAL,0,336000,336000,0,2069171,2405171
140345600700000,NE 117,RESIDENTIAL,45900,0,45900,97546,0,143446
140345600800000,NE 117,RESIDENTIAL,41111,0,41111,110046,0,151157
140345600900000,NE 117,RESIDENTIAL,42281,0,42281,107985,0,150266
140345601000000,NE 117,RESIDENTIAL,42281,0,42281,60508,0,102789
140345601100000,NE 117,RESIDENTIAL,42179,0,42179,84249,0,126428
140345601200000,NE 117,RESIDENTIAL,38360,0,38360,99057,0,137417
140345601300000,NE 117,RESIDENTIAL,44240,0,44240,89676,0,133916
140345601400000,NE 117,RESIDENTIAL,38164,0,38164,85656,0,123820
140345700100000,NE 117,RESIDENTIAL,48589,0,48589,70529,0,119118
140345700200000,NE 117,RESIDENTIAL,31200,0,31200,82392,0,113592
140345700300000,NE 117,RESIDENTIAL,31200,0,31200,80531,0,111731
140345700400000,NE 117,RESIDENTIAL,31200,0,31200,61225,0,92425
140345700500000,NE 117,RESIDENTIAL,31200,0,31200,61189,0,92389
140345700600000,NE 117,RESIDENTIAL,31200,0,31200,69139,0,100339
140345700700000,NE 117,RESIDENTIAL,31200,0,31200,89246,0,120446
140345700800000,NE 117,RESIDENTIAL,31200,0,31200,77986,0,109186
140345700900000,NE 117,RESIDENTIAL,31200,0,31200,99962,0,131162
140345701000000,NE 117,RESIDENTIAL,30403,0,30403,71228,0,101631
140345701100000,NE 116,RESIDENTIAL,13338,0,13338,61334,0,74672
140345701200000,NE 116,RESIDENTIAL,18691,0,18691,111402,0,130093
140345701300000,NE 116,RESIDENTIAL,25575,0,25575,108766,0,134341
140345701400000,NE 116,RESIDENTIAL,25575,0,25575,98272,0,123847
140345701500000,NE 116,RESIDENTIAL,25575,0,25575,128091,0,153666
140345701600000,NE 116,RESIDENTIAL,28688,0,28688,135036,0,163724
140345701700000,NE 116,RESIDENTIAL,27500,0,27500,136471,0,163971
140345701800000,NE 116,RESIDENTIAL,27500,0,27500,87729,0,115229
140345800100000,NE 116,RESIDENTIAL,25300,0,25300,112424,0,137724
140345800200000,NE 116,RESIDENTIAL,25300,0,25300,101974,0,127274
140345800300000,NE 116,RESIDENTIAL,25300,0,25300,111054,0,136354
140345800400000,NE 116,RESIDENTIAL,22897,0,22897,106961,0,129858
140347600100000,NE 116,RESIDENTIAL,29425,0,29425,124433,0,153858
140347600200000,NE 116,RESIDENTIAL,29425,0,29425,178902,0,208327
140347600300000,NE 116,RESIDENTIAL,29425,0,29425,147184,0,176609
140347600400000,NE 116,RESIDENTIAL,29425,0,29425,130390,0,159815
140347700100000,NE 116,RESIDENTIAL,40942,0,40942,234651,0,275593
140347700200000,NE 116,RESIDENTIAL,36488,0,36488,196373,0,232861
140347700300000,NE 116,RESIDENTIAL,29425,0,29425,176485,0,205910
140347700400000,NE 116,RESIDENTIAL,29425,0,29425,164530,0,193955
140347700500000,NE 116,RESIDENTIAL,29425,0,29425,120402,0,149827
140347700600000,NE 116,RESIDENTIAL,29750,0,29750,112862,0,142612
140347700700000,NE 116,RESIDENTIAL,30316,0,30316,172400,0,202716
140347700800000,NE 116,RESIDENTIAL,29425,0,29425,126804,0,156229
140347700900000,NE 116,RESIDENTIAL,29425,0,29425,103991,0,133416
140347701000000,NE 116,RESIDENTIAL,29425,0,29425,101543,0,130968
140347701100000,NE 116,RESIDENTIAL,29425,0,29425,98368,0,127793
140347800100000,NE 116,RESIDENTIAL,29975,0,29975,133688,0,163663
140347800200000,NE 116,RESIDENTIAL,32362,0,32362,120273,0,152635
140347800300000,NE 116,RESIDENTIAL,31774,0,31774,167479,0,199253
140347800400000,NE 116,RESIDENTIAL,31924,0,31924,112821,0,144745
140347900100000,NE 116,RESIDENTIAL,29425,0,29425,117250,0,146675
140347900200000,NE 116,RESIDENTIAL,29425,0,29425,186121,0,215546
140347900300000,NE 116,RESIDENTIAL,29425,0,29425,126136,0,155561
140347900400000,NE 116,RESIDENTIAL,26769,0,26769,158727,0,185496
140347900500000,NE 116,RESIDENTIAL,27879,0,27879,145867,0,173746
140347900600000,NE 116,RESIDENTIAL,30974,0,30974,235502,0,266476
140347900700000,NE 116,RESIDENTIAL,27326,0,27326,141381,0,168707
140347900800000,NE 116,RESIDENTIAL,30918,0,30918,108038,0,138956
140347900900000,NE 116,RESIDENTIAL,27864,0,27864,129636,0,157500
140347901000000,NE 116,RESIDENTIAL,29425,0,29425,89017,0,118442
140347901100000,NE 116,RESIDENTIAL,29425,0,29425,112636,0,142061
140347901200000,NE 116,RESIDENTIAL,29425,0,29425,142276,0,171701
140347901300000,NE 116,RESIDENTIAL,29425,0,29425,139954,0,169379
140347901400000,NE 116,RESIDENTIAL,30639,0,30639,102197,0,132836
140347901500000,NE 116,RESIDENTIAL,28811,0,28811,124724,0,153535
140347901600000,NE 116,RESIDENTIAL,29425,0,29425,95682,0,125107
140347901700000,NE 116,RESIDENTIAL,29425,0,29425,105791,0,135216
140347901800000,NE 116,RESIDENTIAL,29425,0,29425,83675,0,113100
140347901900000,NE 116,RESIDENTIAL,42800,0,42800,78006,0,120806
140348000100000,NE 116,RESIDENTIAL,32956,0,32956,129798,0,162754
140348000200000,NE 116,RESIDENTIAL,24260,0,24260,144342,0,168602
140348000300000,NE 116,RESIDENTIAL,29700,0,29700,124667,0,154367
140348000400000,NE 116,RESIDENTIAL,29700,0,29700,90163,0,119863
140348000500000,NE 116,RESIDENTIAL,29700,0,29700,147286,0,176986
140348000600000,NE 116,RESIDENTIAL,30391,0,30391,110043,0,140434
140348000700000,NE 116,RESIDENTIAL,31058,0,31058,194775,0,225833
140348000800000,NE 116,RESIDENTIAL,29425,0,29425,115083,0,144508
140348000900000,NE 116,RESIDENTIAL,29425,0,29425,115475,0,144900
140348001000000,NE 116,RESIDENTIAL,29425,0,29425,174785,0,204210
140348001100000,NE 116,RESIDENTIAL,29425,0,29425,82779,0,112204
140348001200000,NE 116,RESIDENTIAL,30639,0,30639,110391,0,141030
140348001300000,NE 116,RESIDENTIAL,30875,0,30875,115037,0,145912
140348001400000,NE 116,RESIDENTIAL,27777,0,27777,117950,0,145727
140348001500000,NE 116,RESIDENTIAL,31585,0,31585,126575,0,158160
140348001600000,NE 116,RESIDENTIAL,28999,0,28999,128626,0,157625
140348001700000,NE 116,RESIDENTIAL,28884,0,28884,178511,0,207395
140348001800000,NE 116,RESIDENTIAL,29700,0,29700,116042,0,145742
140348100100000,NE 116,RESIDENTIAL,30032,0,30032,101006,0,131038
140348100200000,NE 116,RESIDENTIAL,29425,0,29425,89500,0,118925
140348100300000,NE 116,RESIDENTIAL,29425,0,29425,126921,0,156346
140348100400000,NE 116,RESIDENTIAL,29425,0,29425,116632,0,146057
140348100500000,NE 116,RESIDENTIAL,29425,0,29425,92910,0,122335
140348100600000,NE 116,RESIDENTIAL,28471,0,28471,92993,0,121464
140348200100000,NE 116,RESIDENTIAL,30032,0,30032,107512,0,137544
140348200200000,NE 116,RESIDENTIAL,29425,0,29425,73533,0,102958
140348200300000,NE 116,RESIDENTIAL,29425,0,29425,124459,0,153884
140348200400000,NE 116,RESIDENTIAL,29425,0,29425,118390,0,147815
140348200500000,NE 116,RESIDENTIAL,29425,0,29425,81695,0,111120
140348200600000,NE 116,RESIDENTIAL,31509,0,31509,129234,0,160743
140410100200000,WAREHOUSE,COMMERCIAL,0,444500,444500,0,417023,861523
140410100300000,CENTRALLY ASSESSED,OTHER,0,0,0,0,0,0
140410100400000,WAREHOUSE,COMMERCIAL,0,348750,348750,0,352841,701591
140410100500000,EQUIPMENT MFG;INDUST,INDUSTRIAL,0,310176,310176,0,1638332,1948508
140410100600000,OFFICE,COMMERCIAL,0,420000,420000,0,464379,884379
140410100800000,OFFICE,COMMERCIAL,0,407000,407000,0,1874526,2281526
140410200100000,WAREHOUSE,COMMERCIAL,0,784460,784460,0,3258402,4042862
140410200200000,PAPER; INDUSTRIAL,INDUSTRIAL,0,616226,616226,0,4089840,4706066
140410200300000,VACANT LAND,COMMERCIAL,0,1408,1408,0,0,1408
140412600100000,CENTRALLY ASSESSED,OTHER,0,0,0,0,0,0
140412600200000,SMALL RETAIL,COMMERCIAL,0,134730,134730,0,250192,384922
140412600300000,VETERINARY CLINIC,COMMERCIAL,0,95940,95940,0,184131,280071
140412600400000,SMALL RETAIL,COMMERCIAL,0,118728,118728,0,137058,255786
140412600500000,SMALL RETAIL,COMMERCIAL,0,167500,167500,0,153092,320592
140412600502000,BILLBOARD(BLL),COMMERCIAL,0,0,0,0,58868,58868
140412600600000,FLAT PARKING,COMMERCIAL,0,20,20,0,8800,8820
140412600700000,AUTO REPAIR/SALES,COMMERCIAL,0,90000,90000,0,224835,314835
140412600800000,FLAT PARKING,COMMERCIAL,0,71775,71775,0,6832,78607
140412600900000,SHOP,COMMERCIAL,0,92956,92956,0,146890,239846
140412601000000,FLAT PARKING,COMMERCIAL,0,2395,2395,0,15519,17914
140412601100000,OFFICE,COMMERCIAL,0,151900,151900,0,281560,433460
140412601200000,OFFICE,COMMERCIAL,0,140400,140400,0,501987,642387
140412601300000,VACANT LAND,COMMERCIAL,0,60000,60000,0,0,60000
140412601400000,RESTAURANT,COMMERCIAL,0,267500,267500,0,193133,460633
140412602500000,FLAT PARKING,COMMERCIAL,0,3900,3900,0,0,3900
140412900100000,SHOP,COMMERCIAL,0,356250,356250,0,682419,1038669
140412900200000,FLAT PARKING,COMMERCIAL,0,266340,266340,0,0,266340
140412900300000,VACANT LAND,COMMERCIAL,0,20,20,0,0,20
140413000100000,SMALL RETAIL,COMMERCIAL,0,260000,260000,0,108101,368101
140413000300000,SMALL RETAIL,COMMERCIAL,0,174562,174562,0,414168,588730
140413000400000,OFFICE,COMMERCIAL,0,105875,105875,0,166471,272346
140413000500000,SMALL RETAIL,COMMERCIAL,0,111375,111375,0,413957,525332
140413000600000,VACANT LAND,COMMERCIAL,0,20,20,0,0,20
140413000700000,VACANT LAND,COMMERCIAL,0,20,20,0,0,20
140413000900000,LG DISCOUNT/RETAIL,COMMERCIAL,0,915600,915600,0,2074020,2989620
140413100100000,LG DISCOUNT/RETAIL,COMMERCIAL,0,292500,292500,0,503430,795930
140413100200000,WAREHOUSE;MINI STORG,COMMERCIAL,0,91250,91250,0,124092,215342
140413100300000,FAST FOOD,COMMERCIAL,0,500000,500000,0,573423,1073423
140413100400000,SMALL RETAIL,COMMERCIAL,0,235000,235000,0,309121,544121
140413100402000,BILLBOARD(BLL),COMMERCIAL,0,0,0,0,55552,55552
140413100500000,LG DISCOUNT/RETAIL,COMMERCIAL,0,210000,210000,0,398941,608941
140413100600000,SMALL RETAIL,COMMERCIAL,0,100188,100188,0,160098,260286
140413100602000,BILLBOARD(BLL),COMMERCIAL,0,0,0,0,14079,14079
140413101100000,OFFICE,COMMERCIAL,0,222500,222500,0,1011499,1233999
140413101200000,VACANT LAND,COMMERCIAL,0,20,20,0,0,20
140413101300000,WAREHOUSE,COMMERCIAL,0,108288,108288,0,174294,282582
140415100100000,VACANT LAND,COMMERCIAL,0,64500,64500,0,0,64500
140415100400000,LG DISCOUNT/RETAIL,COMMERCIAL,0,281400,281400,0,345088,626488
140415100600000,CENTRALLY ASSESSED,OTHER,0,0,0,0,0,0
140415100602000,BILLBOARD(BLL),COMMERCIAL,0,0,0,0,42072,42072
140415200100000,LG DISCOUNT/RETAIL,COMMERCIAL,0,1086660,1086660,0,3755333,4841993
140415200200000,AUTO REPAIR/SALES,COMMERCIAL,0,466030,466030,0,537252,1003282
140415200301000,WAREHOUSE,COMMERCIAL,0,69127,69127,0,213509,282636
140415200301001,WAREHOUSE,COMMERCIAL,0,68745,68745,0,233341,302086
140415200301002,SHOP,COMMERCIAL,0,135250,135250,0,279345,414595
140415200400000,AUTO REPAIR/SALES,COMMERCIAL,0,300000,300000,0,360295,660295
140415300100000,NE 111,RESIDENTIAL,47875,0,47875,194207,0,242082
140415300200000,OFFICE; MEDICAL,COMMERCIAL,0,831000,831000,0,3437792,4268792
140415300300000,OFFICE; MEDICAL,COMMERCIAL,0,170000,170000,0,604616,774616
140417600100000,OFFICE,COMMERCIAL,0,114770,114770,0,333832,448602
140417600200000,OFFICE,COMMERCIAL,0,62856,62856,0,381033,443889
140417600400000,AUTO REPAIR/SALES,COMMERCIAL,0,1137200,1137200,0,3026948,4164148
140417600500000,FLAT PARKING,COMMERCIAL,0,629100,629100,0,10362,639462
140417600600000,AUTO REPAIR/SALES,COMMERCIAL,0,450825,450825,0,428248,879073
140417600700000,SHOP,COMMERCIAL,0,147021,147021,0,98689,245710
140417600800000,BRANCH BANK/CU,COMMERCIAL,0,558000,558000,0,435839,993839
140417601000000,FLAT PARKING,COMMERCIAL,0,25200,25200,0,14640,39840
140417601100000,VACANT LAND,COMMERCIAL,0,1360,1360,0,0,1360
140417700100000,AUTO REPAIR/SALES,COMMERCIAL,0,1182500,1182500,0,802112,1984612
140417700200000,SHOP,COMMERCIAL,0,265500,265500,0,316050,581550
140417700300000,FLAT PARKING,COMMERCIAL,0,54900,54900,0,0,54900
140417700400000,AUTO REPAIR/SALES,COMMERCIAL,0,244200,244200,0,345377,589577
140417800100000,HIGH TECH/RESEARCH,INDUSTRIAL,0,619650,619650,0,1577351,2197001
140417800200000,NE 111,RESIDENTIAL,47550,0,47550,167036,0,214586
140420500100000,LG DISCOUNT/RETAIL,COMMERCIAL,0,795000,795000,0,951305,1746305
140420500200000,FLAT PARKING,COMMERCIAL,0,20,20,0,18277,18297
140420500300000,APARTMENT,RESIDENTIAL,26880,0,26880,299071,0,325951
140420500400000,APARTMENT,RESIDENTIAL,26800,0,26800,299071,0,325871
140420500500000,APARTMENT,RESIDENTIAL,35910,0,35910,55090,0,91000
140420500700000,APARTMENT,RESIDENTIAL,29700,0,29700,299729,0,329429
140420500800000,APARTMENT,COMMERCIAL,0,27280,27280,0,287063,314343
140420500900000,APARTMENT,COMMERCIAL,0,598400,598400,0,3946047,4544447
140420501000000,SHOP,COMMERCIAL,0,37225,37225,0,73426,110651
140420501100000,RESTAURANT,COMMERCIAL,0,48700,48700,0,125622,174322
140420501200000,RESTAURANT,COMMERCIAL,0,103800,103800,0,155087,258887
140420501300000,SMALL RETAIL,COMMERCIAL,0,112985,112985,0,164891,277876
140420501400000,RESTAURANT,COMMERCIAL,0,183000,183000,0,243791,426791
140420501500000,BARS/LOUNGE,COMMERCIAL,0,115560,115560,0,169296,284856
140420600100000,APARTMENT,RESIDENTIAL,42302,0,42302,378347,0,420649
140420600200000,SMALL RETAIL,COMMERCIAL,0,48600,48600,0,198321,246921
140423100100000,HOTEL,COMMERCIAL,0,546000,546000,0,1453689,1999689
140423100200000,RESTAURANT,COMMERCIAL,0,250500,250500,0,423459,673959
140423100300000,SHOP,COMMERCIAL,0,170000,170000,0,482642,652642
140423100400000,EQUIPMENT MFG;INDUST,INDUSTRIAL,0,337392,337392,0,1340829,1678221
140423100500000,SHOP,COMMERCIAL,0,87200,87200,0,690608,777808
140423100600000,CENTRALLY ASSESSED,OTHER,0,0,0,0,0,0
140423200100000,OFFICE,COMMERCIAL,0,146239,146239,0,273739,419978
140423200200000,SMALL RETAIL,COMMERCIAL,0,157800,157800,0,90384,248184
140423200300000,NBHD SHOPPING CENTER,COMMERCIAL,0,416000,416000,0,946304,1362304
140425100100000,CITY PROPERTY,EXEMPT,0,0,0,0,0,0
140425200100000,CITY PROPERTY,EXEMPT,0,0,0,0,0,0
140427600300000,WAREHOUSE,COMMERCIAL,0,188700,188700,0,284811,473511
140427600400000,WAREHOUSE,COMMERCIAL,0,271000,271000,0,788849,1059849
140427600500000,WAREHOUSE,COMMERCIAL,0,222750,222750,0,529132,751882
140427600600000,WAREHOUSE,COMMERCIAL,0,205200,205200,0,1130223,1335423
140427600700000,WAREHOUSE,COMMERCIAL,0,124800,124800,0,737527,862327
140427600800000,WAREHOUSE,COMMERCIAL,0,94400,94400,0,160849,255249
140427600900000,SHOP,COMMERCIAL,0,106400,106400,0,365167,471567
140427601000000,FLAT PARKING,COMMERCIAL,0,400,400,0,576,976
140427601200000,CENTRALLY ASSESSED,OTHER,0,0,0,0,0,0
140427601300000,SHOP,COMMERCIAL,0,105100,105100,0,269294,374394
140427601400000,AUTO REPAIR/SALES,COMMERCIAL,0,251400,251400,0,392951,644351
140427700100000,NBHD SHOPPING CENTER,COMMERCIAL,0,332500,332500,0,713450,1045950
140427700200000,OFFICE,COMMERCIAL,0,42000,42000,0,199188,241188
140427700300000,NE 112,RESIDENTIAL,24300,0,24300,67372,0,91672
140427700400000,NE 112,RESIDENTIAL,10000,0,10000,42471,0,52471
140427700500000,NE 112,RESIDENTIAL,24525,0,24525,79343,0,103868
140427700600000,NE 112,RESIDENTIAL,30150,0,30150,66851,0,97001
140427700700000,NE 112,RESIDENTIAL,18057,0,18057,77705,0,95762
140427700800000,NE 112,RESIDENTIAL,18300,0,18300,63914,0,82214
140427700900000,NE 112,RESIDENTIAL,31350,0,31350,74903,0,106253
140427701000000,NE 112,RESIDENTIAL,19680,0,19680,101051,0,120731
140427701100000,CENTRALLY ASSESSED,OTHER,0,0,0,0,0,0
140427800100000,CHURCH,EXEMPT,0,91109,91109,0,113669,204778
140427800200000,NE 112,RESIDENTIAL,20750,0,20750,0,0,20750
140427800300000,NE 112,RESIDENTIAL,19920,0,19920,57074,0,76994
140427800400000,NE 112,RESIDENTIAL,20140,0,20140,72486,0,92626
140427800500000,NE 112,RESIDENTIAL,18880,0,18880,39448,0,58328
140427800600000,NE 112,RESIDENTIAL,18880,0,18880,29427,0,48307
140427800700000,VACANT LAND,COMMERCIAL,0,713780,713780,0,0,713780
140430100300000,SMALL RETAIL,COMMERCIAL,0,86125,86125,0,183467,269592
140430100400000,SHOP,COMMERCIAL,0,45900,45900,0,66299,112199
140430100500000,HOTEL,COMMERCIAL,0,178750,178750,0,771720,950470
140430100600000,SMALL RETAIL,COMMERCIAL,0,76160,76160,0,233563,309723
140430100700000,WAREHOUSE;MINI STORG,COMMERCIAL,0,161250,161250,0,91804,253054
140430100800000,AUTO REPAIR/SALES,COMMERCIAL,0,437500,437500,0,1399658,1837158
140430100900000,SMALL RETAIL,COMMERCIAL,0,185500,185500,0,248393,433893
140430101000000,AUTO REPAIR/SALES,COMMERCIAL,0,473625,473625,0,790565,1264190
140430101100000,SHOP,COMMERCIAL,0,46500,46500,0,182143,228643
140430101200000,CITY PROPERTY,EXEMPT,0,0,0,0,0,0
140430101300000,CENTRALLY ASSESSED,OTHER,0,0,0,0,0,0
140430101400000,CITY PROPERTY,EXEMPT,0,0,0,0,0,0
140430200100000,NE 120,RESIDENTIAL,30252,0,30252,134392,0,164644
140430200200000,NE 120,RESIDENTIAL,28000,0,28000,148589,0,176589
140430300100000,NE 120,RESIDENTIAL,32340,0,32340,159496,0,191836
140430300200000,NE 120,RESIDENTIAL,33280,0,33280,152485,0,185765
140432600100000,NE 120,RESIDENTIAL,30219,0,30219,142296,0,172515
140432600200000,NE 120,RESIDENTIAL,28785,0,28785,124986,0,153771
140432600300000,NE 120,RESIDENTIAL,29169,0,29169,132649,0,161818
140432600400000,NE 120,RESIDENTIAL,32435,0,32435,114509,0,146944
140432600500000,NE 120,RESIDENTIAL,33602,0,33602,108268,0,141870
140432600600000,NE 120,RESIDENTIAL,32311,0,32311,160597,0,192908
140432600700000,NE 120,RESIDENTIAL,32689,0,32689,161095,0,193784
140432601000000,NE 120,RESIDENTIAL,30600,0,30600,171618,0,202218
140432601100000,NE 120,RESIDENTIAL,2106,0,2106,0,0,2106
140432601200000,NE 120,RESIDENTIAL,29700,0,29700,139074,0,168774
140432601300000,NE 120,RESIDENTIAL,30528,0,30528,132431,0,162959
140432601400000,NE 120,RESIDENTIAL,33048,0,33048,176229,0,209277
140432601500000,NE 120,RESIDENTIAL,32000,0,32000,203597,0,235597
140432601600000,NE 120,RESIDENTIAL,30000,0,30000,172950,0,202950
140432601700000,NE 120,RESIDENTIAL,30000,0,30000,156322,0,186322
140432601800000,NE 120,RESIDENTIAL,30607,0,30607,125715,0,156322
140432601900000,NE 120,RESIDENTIAL,33507,0,33507,154438,0,187945
140432602000000,NE 120,RESIDENTIAL,33566,0,33566,145654,0,179220
140432602100000,NE 120,RESIDENTIAL,33152,0,33152,147350,0,180502
140432602200000,NE 120,RESIDENTIAL,32000,0,32000,175311,0,207311
140432700100000,NE 120,RESIDENTIAL,30756,0,30756,160825,0,191581
140432700200000,NE 120,RESIDENTIAL,32000,0,32000,154841,0,186841
140432700300000,NE 120,RESIDENTIAL,30000,0,30000,165127,0,195127
140432700400000,NE 120,RESIDENTIAL,28000,0,28000,151419,0,179419
140432700500000,NE 120,RESIDENTIAL,32000,0,32000,189821,0,221821
140432700600000,NE 120,RESIDENTIAL,34469,0,34469,179092,0,213561
140432700700000,NE 120,RESIDENTIAL,34800,0,34800,140398,0,175198
140432700800000,NE 120,RESIDENTIAL,33213,0,33213,123951,0,157164
140432700900000,NE 120,RESIDENTIAL,37332,0,37332,202356,0,239688
140432701000000,NE 120,RESIDENTIAL,32420,0,32420,158828,0,191248
140432701100000,NE 120,RESIDENTIAL,31820,0,31820,133180,0,165000
140432701200000,NE 120,RESIDENTIAL,31220,0,31220,153843,0,185063
140432701300000,NE 120,RESIDENTIAL,32340,0,32340,141984,0,174324
140432701400000,NE 120,RESIDENTIAL,31700,0,31700,145359,0,177059
140432701500000,NE 120,RESIDENTIAL,705,0,705,0,0,705
140432701600000,NE 120,RESIDENTIAL,33545,0,33545,215404,0,248949
140432701700000,NE 120,RESIDENTIAL,38907,0,38907,175178,0,214085
140432701800000,NE 120,RESIDENTIAL,28712,0,28712,139919,0,168631
140432701900000,NE 120,RESIDENTIAL,32340,0,32340,131519,0,163859
140432702000000,NE 120,RESIDENTIAL,26800,0,26800,145003,0,171803
140432702100000,NE 120,RESIDENTIAL,28916,0,28916,189188,0,218104
140432702200000,NE 120,RESIDENTIAL,26520,0,26520,130095,0,156615
140432702300000,NE 120,RESIDENTIAL,26395,0,26395,140974,0,167369
140432702400000,NE 120,RESIDENTIAL,28119,0,28119,128781,0,156900
140432702500000,NE 120,RESIDENTIAL,33512,0,33512,148524,0,182036
140432702600000,NE 120,RESIDENTIAL,27318,0,27318,152794,0,180112
140432702700000,NE 120,RESIDENTIAL,28560,0,28560,141418,0,169978
140432702800000,NE 120,RESIDENTIAL,28560,0,28560,163379,0,191939
140432702900000,NE 120,RESIDENTIAL,29620,0,29620,157909,0,187529
140432703000000,NE 120,RESIDENTIAL,33454,0,33454,143255,0,176709
140432703100000,NE 120,RESIDENTIAL,35148,0,35148,139467,0,174615
140432703200000,NE 120,RESIDENTIAL,34854,0,34854,145603,0,180457
140432703300000,NE 120,RESIDENTIAL,31902,0,31902,129911,0,161813
140432703400000,NE 120,RESIDENTIAL,28560,0,28560,128726,0,157286
140432703500000,NE 120,RESIDENTIAL,28560,0,28560,132684,0,161244
140432703600000,NE 120,RESIDENTIAL,26928,0,26928,141751,0,168679
140432703700000,NE 120,RESIDENTIAL,28215,0,28215,122317,0,150532
140432703800000,NE 120,RESIDENTIAL,30241,0,30241,141399,0,171640
140432703900000,NE 120,RESIDENTIAL,27160,0,27160,103018,0,130178
140432704000000,NE 120,RESIDENTIAL,27160,0,27160,116185,0,143345
140432704100000,NE 120,RESIDENTIAL,27160,0,27160,127989,0,155149
140432704200000,NE 120,RESIDENTIAL,27611,0,27611,103730,0,131341
140432800100000,NE 120,RESIDENTIAL,30492,0,30492,134897,0,165389
140432800200000,NE 120,RESIDENTIAL,29333,0,29333,124480,0,153813
140432800300000,NE 120,RESIDENTIAL,29851,0,29851,133441,0,163292
140432800400000,NE 120,RESIDENTIAL,26000,0,26000,98062,0,124062
140432800500000,NE 120,RESIDENTIAL,26000,0,26000,110052,0,136052
140432800600000,NE 120,RESIDENTIAL,26000,0,26000,107337,0,133337
140432800700000,NE 120,RESIDENTIAL,26000,0,26000,125947,0,151947
140432800800000,NE 120,RESIDENTIAL,26252,0,26252,113129,0,139381
140432900100000,NE 120,RESIDENTIAL,33048,0,33048,145751,0,178799
140432900200000,NE 120,RESIDENTIAL,32640,0,32640,157805,0,190445
140432900300000,NE 120,RESIDENTIAL,30300,0,30300,182483,0,212783
140432900400000,NE 120,RESIDENTIAL,32320,0,32320,135073,0,167393
140432900500000,NE 120,RESIDENTIAL,28000,0,28000,120674,0,148674
140432900600000,NE 120,RESIDENTIAL,32667,0,32667,0,0,32667
140432900800000,NE 120,RESIDENTIAL,28274,0,28274,179263,0,207537
140432900900000,NE 120,RESIDENTIAL,30138,0,30138,132274,0,162412
140435100100000,NE 121,RESIDENTIAL,25751,0,25751,101198,0,126949
140435100200000,NE 121,RESIDENTIAL,26775,0,26775,95977,0,122752
140435100300000,NE 121,RESIDENTIAL,27071,0,27071,90903,0,117974
140435100400000,NE 121,RESIDENTIAL,26928,0,26928,112369,0,139297
140435100500000,NE 121,RESIDENTIAL,26014,0,26014,126871,0,152885
140435100600000,NE 121,RESIDENTIAL,29006,0,29006,92086,0,121092
140435100700000,NE 121,RESIDENTIAL,27094,0,27094,94810,0,121904
140435100800000,NE 121,RESIDENTIAL,26864,0,26864,94064,0,120928
140435100900000,NE 121,RESIDENTIAL,26950,0,26950,112167,0,139117
140435101000000,NE 121,RESIDENTIAL,25904,0,25904,95115,0,121019
140435101100000,NE 121,RESIDENTIAL,25155,0,25155,96146,0,121301
140435101200000,NE 121,RESIDENTIAL,24823,0,24823,125628,0,150451
140435101300000,NE 121,RESIDENTIAL,25194,0,25194,100145,0,125339
140435200100000,NE 121,RESIDENTIAL,29511,0,29511,96119,0,125630
140435200200000,NE 121,RESIDENTIAL,30000,0,30000,147551,0,177551
140435200300000,NE 121,RESIDENTIAL,28125,0,28125,125549,0,153674
140435200400000,NE 121,RESIDENTIAL,30000,0,30000,118125,0,148125
140435200500000,NE 121,RESIDENTIAL,29860,0,29860,165227,0,195087
140435200600000,NE 121,RESIDENTIAL,28125,0,28125,134166,0,162291
140435200700000,NE 121,RESIDENTIAL,28649,0,28649,140953,0,169602
140435300100000,NE 121,RESIDENTIAL,28596,0,28596,131239,0,159835
140435300200000,NE 121,RESIDENTIAL,28125,0,28125,139016,0,167141
140435300300000,NE 121,RESIDENTIAL,29726,0,29726,126619,0,156345
140435300400000,NE 121,RESIDENTIAL,30727,0,30727,124457,0,155184
140435300500000,NE 121,RESIDENTIAL,31460,0,31460,127786,0,159246
140435300600000,NE 121,RESIDENTIAL,29919,0,29919,101745,0,131664
140435300700000,NE 121,RESIDENTIAL,30300,0,30300,98147,0,128447
140435300800000,NE 121,RESIDENTIAL,29929,0,29929,137599,0,167528
140435300900000,NE 121,RESIDENTIAL,28250,0,28250,107250,0,135500
140435301000000,NE 121,RESIDENTIAL,30652,0,30652,110634,0,141286
140435301100000,SCHOOL,EXEMPT,0,0,0,0,0,0
140435400100000,NE 121,RESIDENTIAL,27000,0,27000,111218,0,138218
140435400200000,NE 121,RESIDENTIAL,30687,0,30687,115306,0,145993
140435400300000,NE 121,RESIDENTIAL,33959,0,33959,143853,0,177812
140435400400000,NE 121,RESIDENTIAL,32469,0,32469,132796,0,165265
140435400500000,NE 121,RESIDENTIAL,35490,0,35490,162750,0,198240
140435400600000,NE 121,RESIDENTIAL,31704,0,31704,115421,0,147125
140435400700000,NE 121,RESIDENTIAL,33150,0,33150,154651,0,187801
140435400800000,NE 121,RESIDENTIAL,27245,0,27245,115722,0,142967
140435400900000,NE 121,RESIDENTIAL,24490,0,24490,93591,0,118081
140435401000000,NE 121,RESIDENTIAL,25350,0,25350,78525,0,103875
140435401100000,NE 121,RESIDENTIAL,24570,0,24570,93119,0,117689
140435401200000,NE 121,RESIDENTIAL,25350,0,25350,100848,0,126198
140435401300000,NE 121,RESIDENTIAL,24180,0,24180,95499,0,119679
140435401400000,NE 121,RESIDENTIAL,25155,0,25155,125315,0,150470
140435401500000,NE 121,RESIDENTIAL,26355,0,26355,93386,0,119741
140435401600000,NE 121,RESIDENTIAL,26950,0,26950,106940,0,133890
140435401700000,NE 121,RESIDENTIAL,26106,0,26106,88923,0,115029
140435401800000,NE 121,RESIDENTIAL,26613,0,26613,106320,0,132933
140435401900000,NE 121,RESIDENTIAL,26730,0,26730,120970,0,147700
140435500100000,NE 121,RESIDENTIAL,27373,0,27373,119014,0,146387
140435500200000,NE 121,RESIDENTIAL,28350,0,28350,104333,0,132683
140435500300000,NE 121,RESIDENTIAL,28688,0,28688,107761,0,136449
140435500400000,NE 121,RESIDENTIAL,28406,0,28406,101110,0,129516
140435500500000,NE 121,RESIDENTIAL,28450,0,28450,0,0,28450
140435500600000,NE 121,RESIDENTIAL,36508,0,36508,175553,0,212061
140435500700000,NE 121,RESIDENTIAL,26418,0,26418,102442,0,128860
140435500800000,NE 121,RESIDENTIAL,29278,0,29278,138208,0,167486
140435500900000,NE 121,RESIDENTIAL,30047,0,30047,117958,0,148005
140435501000000,NE 121,RESIDENTIAL,30122,0,30122,141819,0,171941
140435501100000,NE 121,RESIDENTIAL,30960,0,30960,145045,0,176005
140435501200000,NE 121,RESIDENTIAL,32099,0,32099,136922,0,169021
140435501300000,NE 121,RESIDENTIAL,28687,0,28687,113163,0,141850
140435501400000,NE 121,RESIDENTIAL,28659,0,28659,109328,0,137987
140435600100000,NE 121,RESIDENTIAL,30494,0,30494,113289,0,143783
140435600200000,NE 121,RESIDENTIAL,29925,0,29925,122469,0,152394
140435600300000,NE 121,RESIDENTIAL,27653,0,27653,145526,0,173179
140435600400000,NE 121,RESIDENTIAL,30300,0,30300,120010,0,150310
140435600500000,NE 121,RESIDENTIAL,30300,0,30300,133196,0,163496
140435600600000,NE 121,RESIDENTIAL,30300,0,30300,121289,0,151589
140435600700000,NE 121,RESIDENTIAL,30300,0,30300,158809,0,189109
140435600800000,NE 121,RESIDENTIAL,28937,0,28937,129321,0,158258
140435600900000,NE 121,RESIDENTIAL,30300,0,30300,136777,0,167077
140435601000000,NE 121,RESIDENTIAL,29412,0,29412,144834,0,174246
140435601100000,NE 121,RESIDENTIAL,30213,0,30213,151827,0,182040
140435601200000,NE 121,RESIDENTIAL,30000,0,30000,92465,0,122465
140435601300000,NE 121,RESIDENTIAL,29550,0,29550,123560,0,153110
140435601400000,NE 121,RESIDENTIAL,30300,0,30300,112052,0,142352
140435601500000,NE 121,RESIDENTIAL,30338,0,30338,116333,0,146671
140435601600000,NE 121,RESIDENTIAL,30679,0,30679,111380,0,142059
140435601700000,NE 121,RESIDENTIAL,31872,0,31872,126884,0,158756
140435700100000,NE 121,RESIDENTIAL,27000,0,27000,117946,0,144946
140435700200000,NE 121,RESIDENTIAL,26322,0,26322,109176,0,135498
140435700300000,NE 121,RESIDENTIAL,24863,0,24863,92381,0,117244
140435700400000,NE 121,RESIDENTIAL,26775,0,26775,85878,0,112653
140435700500000,NE 121,RESIDENTIAL,27504,0,27504,92853,0,120357
140435700600000,NE 121,RESIDENTIAL,29160,0,29160,89186,0,118346
140435700700000,NE 121,RESIDENTIAL,30589,0,30589,117120,0,147709
140435700800000,NE 121,RESIDENTIAL,21420,0,21420,87052,0,108472
140435700900000,NE 121,RESIDENTIAL,21420,0,21420,81055,0,102475
140435701000000,NE 121,RESIDENTIAL,21042,0,21042,86075,0,107117
140435701100000,NE 121,RESIDENTIAL,22680,0,22680,118836,0,141516
140437600100000,HOTEL,COMMERCIAL,0,500720,500720,0,2590168,3090888
140437600300000,FLAT PARKING,COMMERCIAL,0,30789,30789,0,7159,37948
140437600400000,CENTRALLY ASSESSED,OTHER,0,0,0,0,0,0
140437600500000,CITY PROPERTY,EXEMPT,0,0,0,0,0,0
140437601000000,APARTMENT,COMMERCIAL,0,24481,24481,0,167487,191968
140437700100000,NE 121,RESIDENTIAL,33257,0,33257,141287,0,174544
140437700200000,NE 121,RESIDENTIAL,28350,0,28350,166210,0,194560
140437700300000,NE 121,RESIDENTIAL,16043,0,16043,106425,0,122468
140437700400000,NE 121,RESIDENTIAL,10350,0,10350,90909,0,101259
140437700500000,NE 121,RESIDENTIAL,10170,0,10170,106772,0,116942
140437700600000,NE 121,RESIDENTIAL,15204,0,15204,108051,0,123255
140437701200000,NE 121,RESIDENTIAL,40600,0,40600,245213,0,285813
140437701300000,NE 121,RESIDENTIAL,36720,0,36720,221098,0,257818
140437701400000,NE 121,RESIDENTIAL,30000,0,30000,161445,0,191445
140437701500000,NE 121,RESIDENTIAL,28125,0,28125,163169,0,191294
140437701600000,NE 121,RESIDENTIAL,30000,0,30000,179671,0,209671
140437701700000,NE 121,RESIDENTIAL,19529,0,19529,153705,0,173234
140437701800000,NE 121,RESIDENTIAL,28125,0,28125,161851,0,189976
140437701900000,NE 121,RESIDENTIAL,30855,0,30855,212415,0,243270
140437702000000,NE 121,RESIDENTIAL,26775,0,26775,71215,0,97990
140437702100000,NE 121,RESIDENTIAL,21600,0,21600,68627,0,90227
140437702200000,NE 121,RESIDENTIAL,21346,0,21346,92252,0,113598
140437702300000,NE 121,RESIDENTIAL,22444,0,22444,101736,0,124180
140437702400000,NE 121,RESIDENTIAL,22759,0,22759,123830,0,146589
140437702500000,NE 121,RESIDENTIAL,23625,0,23625,122773,0,146398
140437702600000,NE 121,RESIDENTIAL,23940,0,23940,114435,0,138375
140437702700000,NE 121,RESIDENTIAL,22680,0,22680,115447,0,138127
140437702800000,NE 121,RESIDENTIAL,22680,0,22680,116320,0,139000
140437702900000,NE 121,RESIDENTIAL,22444,0,22444,120003,0,142447
140437703000000,NE 121,RESIDENTIAL,22444,0,22444,95616,0,118060
140437703100000,NE 121,RESIDENTIAL,21802,0,21802,83661,0,105463
140437800100000,NE 121,RESIDENTIAL,29524,0,29524,133478,0,163002
140437800200000,NE 121,RESIDENTIAL,30600,0,30600,158625,0,189225
140437800300000,NE 121,RESIDENTIAL,30600,0,30600,160239,0,190839
140437800400000,NE 121,RESIDENTIAL,32513,0,32513,162841,0,195354
140437800500000,NE 121,RESIDENTIAL,30600,0,30600,153265,0,183865
140437800600000,NE 121,RESIDENTIAL,28688,0,28688,145094,0,173782
140437800700000,NE 121,RESIDENTIAL,29197,0,29197,179523,0,208720
140437800800000,NE 121,RESIDENTIAL,31957,0,31957,191955,0,223912
140437800900000,NE 121,RESIDENTIAL,25935,0,25935,124658,0,150593
140437801000000,NE 121,RESIDENTIAL,25350,0,25350,106378,0,131728
140437801100000,NE 121,RESIDENTIAL,25194,0,25194,120025,0,145219
140437801200000,NE 121,RESIDENTIAL,25194,0,25194,93047,0,118241
140437801300000,NE 121,RESIDENTIAL,26046,0,26046,97269,0,123315
140437801400000,NE 121,RESIDENTIAL,38200,0,38200,185573,0,223773
140437801500000,NE 121,RESIDENTIAL,28125,0,28125,149830,0,177955
140437801600000,NE 121,RESIDENTIAL,32062,0,32062,205434,0,237496
140437801700000,NE 121,RESIDENTIAL,30671,0,30671,164587,0,195258
140437801800000,NE 121,RESIDENTIAL,31270,0,31270,169668,0,200938
140437801900000,NE 121,RESIDENTIAL,32147,0,32147,172329,0,204476
140440100100000,SCHOOL,EXEMPT,0,1042200,1042200,0,5992277,7034477
140440100400000,NE 118,RESIDENTIAL,26160,0,26160,149790,0,175950
140440100500000,NE 118,RESIDENTIAL,24321,0,24321,84358,0,108679
140440100700000,NE 118,RESIDENTIAL,22871,0,22871,58296,0,81167
140440100800000,NE 118,RESIDENTIAL,24897,0,24897,90192,0,115089
140440100900000,NE 118,RESIDENTIAL,23400,0,23400,89265,0,112665
140440101000000,NE 118,RESIDENTIAL,23400,0,23400,102397,0,125797
140440101100000,NE 118,RESIDENTIAL,23400,0,23400,99675,0,123075
140440101200000,NE 118,RESIDENTIAL,23400,0,23400,97398,0,120798
140440101300000,NE 118,RESIDENTIAL,24154,0,24154,120366,0,144520
140440101400000,NE 118,RESIDENTIAL,23400,0,23400,95084,0,118484
140440101500000,NE 118,RESIDENTIAL,23400,0,23400,113015,0,136415
140440101600000,NE 118,RESIDENTIAL,23400,0,23400,113693,0,137093
140440101700000,NE 118,RESIDENTIAL,23400,0,23400,94871,0,118271
140440101800000,NE 118,RESIDENTIAL,23400,0,23400,90950,0,114350
140440101900000,NE 118,RESIDENTIAL,23400,0,23400,101572,0,124972
140440102000000,NE 118,RESIDENTIAL,23400,0,23400,94321,0,117721
140440102100000,NE 118,RESIDENTIAL,23400,0,23400,92816,0,116216
140440102200000,NE 118,RESIDENTIAL,23400,0,23400,115129,0,138529
140440102300000,NE 118,RESIDENTIAL,23400,0,23400,117834,0,141234
140440102400000,NE 118,RESIDENTIAL,23400,0,23400,102673,0,126073
140440102500000,NE 118,RESIDENTIAL,23400,0,23400,102850,0,126250
140440102600000,NE 118,EXEMPT,0,25818,25818,0,128330,154148
140440102700000,NE 118,RESIDENTIAL,23430,0,23430,72630,0,96060
140440102800000,NE 118,RESIDENTIAL,39723,0,39723,167148,0,206871
140440200100000,NE 118,RESIDENTIAL,25113,0,25113,108621,0,133734
140440200200000,NE 118,RESIDENTIAL,23400,0,23400,86069,0,109469
140440200300000,NE 118,RESIDENTIAL,23400,0,23400,83835,0,107235
140440200400000,NE 118,RESIDENTIAL,23400,0,23400,79147,0,102547
140440200500000,NE 118,RESIDENTIAL,23400,0,23400,85398,0,108798
140440200600000,NE 118,RESIDENTIAL,23400,0,23400,78819,0,102219
140440200700000,NE 118,RESIDENTIAL,23400,0,23400,115403,0,138803
140440200800000,NE 118,RESIDENTIAL,23400,0,23400,96751,0,120151
140440200900000,NE 118,RESIDENTIAL,23400,0,23400,82180,0,105580
140440201000000,NE 118,RESIDENTIAL,23400,0,23400,92816,0,116216
140440201100000,NE 118,RESIDENTIAL,23400,0,23400,93047,0,116447
140440201200000,NE 118,RESIDENTIAL,23400,0,23400,95332,0,118732
140440201300000,NE 118,RESIDENTIAL,23400,0,23400,108192,0,131592
140440201400000,NE 118,RESIDENTIAL,23400,0,23400,93011,0,116411
140440201500000,NE 118,RESIDENTIAL,23400,0,23400,98022,0,121422
140440201600000,NE 118,RESIDENTIAL,23695,0,23695,80915,0,104610
140440201700000,NE 118,RESIDENTIAL,23400,0,23400,81165,0,104565
140440201800000,NE 118,RESIDENTIAL,23400,0,23400,88129,0,111529
140440201900000,NE 118,RESIDENTIAL,20063,0,20063,80742,0,100805
140440202000000,NE 118,RESIDENTIAL,25881,0,25881,115371,0,141252
140440202100000,NE 118,RESIDENTIAL,24890,0,24890,114422,0,139312
140440202200000,NE 118,RESIDENTIAL,24345,0,24345,109559,0,133904
140440202300000,NE 118,RESIDENTIAL,24030,0,24030,94146,0,118176
140440202400000,NE 118,RESIDENTIAL,23250,0,23250,99572,0,122822
140440202500000,NE 118,RESIDENTIAL,24300,0,24300,107600,0,131900
140440202600000,NE 118,RESIDENTIAL,22500,0,22500,97645,0,120145
140440202700000,NE 118,RESIDENTIAL,24225,0,24225,84094,0,108319
140440202800000,NE 118,RESIDENTIAL,23250,0,23250,71133,0,94383
140440202900000,NE 118,RESIDENTIAL,22500,0,22500,98376,0,120876
140440203000000,NE 118,RESIDENTIAL,23250,0,23250,91276,0,114526
140440203100000,NE 118,RESIDENTIAL,25393,0,25393,82461,0,107854
140440203200000,NE 118,RESIDENTIAL,26031,0,26031,85273,0,111304
140440203300000,NE 118,RESIDENTIAL,26296,0,26296,110538,0,136834
140440203400000,NE 118,RESIDENTIAL,22560,0,22560,96185,0,118745
140440203500000,NE 118,RESIDENTIAL,22302,0,22302,77687,0,99989
140440203600000,NE 118,RESIDENTIAL,25877,0,25877,130705,0,156582
140440203700000,NE 118,RESIDENTIAL,50500,0,50500,119204,0,169704
140440203900000,NE 118,RESIDENTIAL,22613,0,22613,87864,0,110477
140440204000000,NE 118,RESIDENTIAL,21178,0,21178,100942,0,122120
140440204100000,NE 118,RESIDENTIAL,19890,0,19890,103486,0,123376
140440204200000,NE 118,RESIDENTIAL,19890,0,19890,102207,0,122097
140440204300000,NE 118,RESIDENTIAL,19890,0,19890,100008,0,119898
140440204400000,NE 118,RESIDENTIAL,18228,0,18228,103902,0,122130
140440300100000,NE 118,RESIDENTIAL,19915,0,19915,114956,0,134871
140440300200000,NE 118,RESIDENTIAL,20332,0,20332,96042,0,116374
140440300300000,NE 118,RESIDENTIAL,25748,0,25748,117260,0,143008
140440300400000,NE 118,RESIDENTIAL,24075,0,24075,94748,0,118823
140440400100000,NE 118,RESIDENTIAL,25520,0,25520,110609,0,136129
140440400200000,NE 118,RESIDENTIAL,24476,0,24476,113191,0,137667
140440400300000,NE 118,RESIDENTIAL,24075,0,24075,76322,0,100397
140440400400000,NE 118,RESIDENTIAL,25680,0,25680,91174,0,116854
140440400500000,NE 118,RESIDENTIAL,22470,0,22470,104512,0,126982
140440400600000,NE 118,RESIDENTIAL,23850,0,23850,98768,0,122618
140440400700000,NE 118,RESIDENTIAL,22899,0,22899,95695,0,118594
140440600100000,AUTO REPAIR/SALES,COMMERCIAL,0,360000,360000,0,430477,790477
140440600200000,HOTEL,COMMERCIAL,0,501250,501250,0,2842492,3343742
140440600300000,NBHD SHOPPING CENTER,COMMERCIAL,0,684000,684000,0,889369,1573369
140442700100000,NE 118,RESIDENTIAL,29239,0,29239,0,0,29239
140442700300000,AUTO REPAIR/SALES,COMMERCIAL,0,804000,804000,0,1385229,2189229
140442700400000,CHURCH,EXEMPT,0,171396,171396,0,4853561,5024957
140442700600000,NE 118,RESIDENTIAL,30780,0,30780,90105,0,120885
140442700700000,NE 118,RESIDENTIAL,38002,0,38002,83946,0,121948
140442700800000,NE 118,RESIDENTIAL,27167,0,27167,96836,0,124003
140442700900000,NE 118,RESIDENTIAL,50535,0,50535,106303,0,156838
140442701000000,FLAT PARKING,COMMERCIAL,0,85500,85500,0,0,85500
140442701100000,WAREHOUSE,COMMERCIAL,0,438750,438750,0,1194741,1633491
140445100100000,NE 118,RESIDENTIAL,23800,0,23800,92444,0,116244
140445100200000,NE 118,RESIDENTIAL,23265,0,23265,88304,0,111569
140445100300000,NE 118,RESIDENTIAL,23265,0,23265,84160,0,107425
140445100400000,NE 118,RESIDENTIAL,21150,0,21150,95061,0,116211
140445100500000,NE 118,RESIDENTIAL,21150,0,21150,91721,0,112871
140445100600000,NE 118,RESIDENTIAL,21150,0,21150,83099,0,104249
140445100700000,NE 118,RESIDENTIAL,21150,0,21150,101621,0,122771
140445100800000,NE 118,RESIDENTIAL,21150,0,21150,87172,0,108322
140445100900000,NE 118,RESIDENTIAL,21150,0,21150,83774,0,104924
140445101000000,NE 118,RESIDENTIAL,21150,0,21150,79578,0,100728
140445101100000,NE 118,RESIDENTIAL,21150,0,21150,80701,0,101851
140445101200000,NE 118,RESIDENTIAL,21150,0,21150,89306,0,110456
140445101300000,NE 118,RESIDENTIAL,21150,0,21150,91045,0,112195
140445101400000,NE 118,RESIDENTIAL,21150,0,21150,93159,0,114309
140445101500000,NE 118,RESIDENTIAL,24989,0,24989,98279,0,123268
140445101600000,NE 118,RESIDENTIAL,24709,0,24709,96475,0,121184
140445101700000,NE 118,RESIDENTIAL,25172,0,25172,115523,0,140695
140445101800000,NE 118,RESIDENTIAL,24581,0,24581,91997,0,116578
140445101900000,NE 118,RESIDENTIAL,28350,0,28350,116616,0,144966
140445200100000,NE 118,RESIDENTIAL,23760,0,23760,107726,0,131486
140445200200000,NE 118,RESIDENTIAL,23270,0,23270,102991,0,126261
140445200300000,NE 118,RESIDENTIAL,23366,0,23366,117348,0,140714
140445200400000,NE 118,RESIDENTIAL,23366,0,23366,113891,0,137257
140445200500000,NE 118,RESIDENTIAL,23947,0,23947,103212,0,127159
140445200600000,NE 118,RESIDENTIAL,25262,0,25262,94370,0,119632
140445200700000,NE 118,RESIDENTIAL,24255,0,24255,99452,0,123707
140445200800000,NE 118,RESIDENTIAL,22725,0,22725,89189,0,111914
140445200900000,NE 118,RESIDENTIAL,22691,0,22691,93394,0,116085
140445201000000,NE 118,RESIDENTIAL,22950,0,22950,86003,0,108953
140445201100000,NE 118,RESIDENTIAL,22950,0,22950,71828,0,94778
140445201200000,NE 118,RESIDENTIAL,22950,0,22950,95901,0,118851
140445201300000,NE 118,RESIDENTIAL,22950,0,22950,91005,0,113955
140445201400000,NE 118,RESIDENTIAL,22950,0,22950,80703,0,103653
140445201500000,NE 118,RESIDENTIAL,21685,0,21685,89080,0,110765
140445201600000,NE 118,RESIDENTIAL,21600,0,21600,86224,0,107824
140445201700000,NE 118,RESIDENTIAL,24628,0,24628,83733,0,108361
140445201800000,NE 118,RESIDENTIAL,24336,0,24336,85621,0,109957
140445201900000,NE 118,RESIDENTIAL,22950,0,22950,83085,0,106035
140445202000000,NE 118,RESIDENTIAL,22950,0,22950,83216,0,106166
140445202100000,NE 118,RESIDENTIAL,22950,0,22950,79837,0,102787
140445202200000,NE 118,RESIDENTIAL,22950,0,22950,98432,0,121382
140445202300000,NE 118,RESIDENTIAL,22950,0,22950,130663,0,153613
140445202400000,NE 118,RESIDENTIAL,22500,0,22500,109663,0,132163
140445202500000,NE 118,RESIDENTIAL,21600,0,21600,82379,0,103979
140445202600000,NE 118,RESIDENTIAL,22560,0,22560,93072,0,115632
140445202700000,NE 118,RESIDENTIAL,22546,0,22546,80343,0,102889
140445202800000,NE 118,RESIDENTIAL,21150,0,21150,80648,0,101798
140445202900000,NE 118,RESIDENTIAL,23618,0,23618,91157,0,114775
140445203000000,NE 118,RESIDENTIAL,23618,0,23618,91099,0,114717
140445300100000,NE 118,RESIDENTIAL,23729,0,23729,91707,0,115436
140445300200000,NE 118,RESIDENTIAL,23970,0,23970,108910,0,132880
140445300300000,NE 118,RESIDENTIAL,23970,0,23970,77453,0,101423
140445300400000,NE 118,RESIDENTIAL,23371,0,23371,116942,0,140313
140445400100000,NE 118,RESIDENTIAL,28618,0,28618,83476,0,112094
140445400200000,NE 118,RESIDENTIAL,31050,0,31050,73968,0,105018
140445400400000,SMALL RETAIL,COMMERCIAL,0,270900,270900,0,542349,813249
140445400500000,NE 118,RESIDENTIAL,25425,0,25425,107963,0,133388
140445400700000,NE 118,RESIDENTIAL,31675,0,31675,123941,0,155616
140445400800000,CHURCH,EXEMPT,0,648000,648000,0,490284,1138284
140445401100000,OFFICE; MEDICAL,COMMERCIAL,0,60048,60048,0,63680,123728
140445401200000,SMALL RETAIL,COMMERCIAL,0,57600,57600,0,47480,105080
140445401300000,NE 118,RESIDENTIAL,22950,0,22950,0,0,22950
140445401400000,NE 118,RESIDENTIAL,21150,0,21150,99328,0,120478
140445401500000,NE 118,RESIDENTIAL,22163,0,22163,86752,0,108915
140445401600000,NE 118,RESIDENTIAL,20074,0,20074,115172,0,135246
140445401700000,NE 118,RESIDENTIAL,21038,0,21038,80006,0,101044
140445401800000,NE 118,RESIDENTIAL,20831,0,20831,87489,0,108320
140445401900000,NE 118,RESIDENTIAL,20831,0,20831,81725,0,102556
140445402000000,NE 118,RESIDENTIAL,23062,0,23062,56315,0,79377
140445402100000,OFFICE; MEDICAL,COMMERCIAL,0,235874,235874,0,618965,854839
140445500100000,FLAT PARKING,COMMERCIAL,0,22520,22520,0,9582,32102
140445500200000,FLAT PARKING,COMMERCIAL,0,70000,70000,0,9840,79840
140445500300000,AUTO REPAIR/SALES,COMMERCIAL,0,445000,445000,0,532065,977065
140445500400000,NBHD SHOPPING CENTER,COMMERCIAL,0,245750,245750,0,877052,1122802
140445600100000,OFFICE,COMMERCIAL,0,60987,60987,0,201782,262769
140445600200000,NE 118,RESIDENTIAL,29974,0,29974,63128,0,93102
140445700100000,NE 118,RESIDENTIAL,25912,0,25912,88601,0,114513
140445700200000,NE 118,RESIDENTIAL,21436,0,21436,75607,0,97043
140445700300000,RESTAURANT,COMMERCIAL,0,154170,154170,0,74277,228447
140445700400000,FAST FOOD,COMMERCIAL,0,324000,324000,0,431470,755470
140445700500000,NE 118,RESIDENTIAL,20006,0,20006,82766,0,102772
140445700600000,NE 118,RESIDENTIAL,20006,0,20006,84644,0,104650
140445800100000,NBHD SHOPPING CENTER,COMMERCIAL,0,451125,451125,0,1502157,1953282
140445800200000,FLAT PARKING,COMMERCIAL,0,40960,40960,0,7125,48085
140445800400000,FAST FOOD,COMMERCIAL,0,127900,127900,0,73979,201879
140445800500000,CONVENIENCE STORE,COMMERCIAL,0,162600,162600,0,208252,370852
140445800600000,FLAT PARKING,COMMERCIAL,0,54075,54075,0,2460,56535
140445800700000,RESTAURANT,COMMERCIAL,0,131473,131473,0,88918,220391
140445800800000,RESTAURANT,COMMERCIAL,0,153513,153513,0,81430,234943
140445800900000,CITY PROPERTY,EXEMPT,0,0,0,0,0,0
140445801000000,SMALL RETAIL,COMMERCIAL,0,132500,132500,0,313185,445685
140447600100000,NE 118,RESIDENTIAL,18114,0,18114,59240,0,77354
140447600200000,NE 118,RESIDENTIAL,19082,0,19082,77183,0,96265
140447600300000,NE 118,RESIDENTIAL,18330,0,18330,66435,0,84765
140447600400000,NE 118,RESIDENTIAL,18330,0,18330,60525,0,78855
140447600500000,NE 118,RESIDENTIAL,18330,0,18330,65402,0,83732
140447600600000,NE 118,RESIDENTIAL,18330,0,18330,64670,0,83000
140447600700000,NE 118,RESIDENTIAL,18330,0,18330,67605,0,85935
140447600800000,NE 118,RESIDENTIAL,18330,0,18330,68723,0,87053
140447600900000,NE 118,RESIDENTIAL,18330,0,18330,65556,0,83886
140447601000000,NE 118,RESIDENTIAL,18330,0,18330,63828,0,82158
140447601100000,NE 118,RESIDENTIAL,18330,0,18330,76024,0,94354
140447601200000,NE 118,RESIDENTIAL,18330,0,18330,68331,0,86661
140447601300000,NE 118,RESIDENTIAL,18330,0,18330,61554,0,79884
140447601400000,NE 118,RESIDENTIAL,18330,0,18330,64442,0,82772
140447601500000,NE 118,RESIDENTIAL,18330,0,18330,61118,0,79448
140447601600000,NE 118,RESIDENTIAL,18330,0,18330,69549,0,87879
140447601700000,NE 118,RESIDENTIAL,18330,0,18330,64348,0,82678
140447601800000,NE 118,RESIDENTIAL,18330,0,18330,65199,0,83529
140447601900000,NE 118,RESIDENTIAL,18330,0,18330,63015,0,81345
140447602000000,NE 118,RESIDENTIAL,18330,0,18330,79267,0,97597
140447602100000,NE 118,RESIDENTIAL,20478,0,20478,64872,0,85350
140447602200000,NE 118,RESIDENTIAL,20548,0,20548,93471,0,114019
140447602300000,NE 118,RESIDENTIAL,18330,0,18330,61730,0,80060
140447602400000,NE 118,RESIDENTIAL,18330,0,18330,68189,0,86519
140447602500000,NE 118,RESIDENTIAL,18330,0,18330,68870,0,87200
140447602600000,NE 118,RESIDENTIAL,18330,0,18330,60066,0,78396
140447602700000,NE 118,RESIDENTIAL,18330,0,18330,80312,0,98642
140447602800000,NE 118,RESIDENTIAL,18330,0,18330,63530,0,81860
140447602900000,NE 118,RESIDENTIAL,18330,0,18330,56164,0,74494
140447603000000,NE 118,RESIDENTIAL,18330,0,18330,68430,0,86760
140447603100000,NE 118,RESIDENTIAL,18330,0,18330,66864,0,85194
140447603200000,NE 118,RESIDENTIAL,18330,0,18330,64691,0,83021
140447603300000,NE 118,RESIDENTIAL,18330,0,18330,60033,0,78363
140447603400000,NE 118,RESIDENTIAL,18330,0,18330,64423,0,82753
140447603500000,NE 118,RESIDENTIAL,18330,0,18330,82377,0,100707
140447603600000,NE 118,RESIDENTIAL,18330,0,18330,67790,0,86120
140447603700000,NE 118,RESIDENTIAL,18330,0,18330,69249,0,87579
140447603800000,NE 118,RESIDENTIAL,18330,0,18330,72958,0,91288
140447603900000,NE 118,RESIDENTIAL,18330,0,18330,72023,0,90353
140447604000000,NE 118,RESIDENTIAL,18330,0,18330,77274,0,95604
140447700100000,NE 118,RESIDENTIAL,19550,0,19550,69589,0,89139
140447700200000,NE 118,RESIDENTIAL,18910,0,18910,89156,0,108066
140447700300000,NE 118,RESIDENTIAL,18525,0,18525,67793,0,86318
140447700400000,NE 118,RESIDENTIAL,18525,0,18525,59631,0,78156
140447700500000,NE 118,RESIDENTIAL,22395,0,22395,82126,0,104521
140447700600000,NE 118,RESIDENTIAL,18525,0,18525,91163,0,109688
140447700700000,NE 118,RESIDENTIAL,18525,0,18525,66193,0,84718
140447700800000,NE 118,RESIDENTIAL,18525,0,18525,61212,0,79737
140447700900000,NE 118,RESIDENTIAL,18525,0,18525,67224,0,85749
140447701000000,NE 118,RESIDENTIAL,18525,0,18525,76762,0,95287
140447701100000,NE 118,RESIDENTIAL,18525,0,18525,66383,0,84908
140447701200000,NE 118,RESIDENTIAL,18525,0,18525,65174,0,83699
140447701300000,NE 118,RESIDENTIAL,18525,0,18525,69088,0,87613
140447701400000,NE 118,RESIDENTIAL,18525,0,18525,105517,0,124042
140447701500000,NE 118,RESIDENTIAL,18525,0,18525,68330,0,86855
140447701600000,NE 118,RESIDENTIAL,18525,0,18525,64160,0,82685
140447701700000,NE 118,RESIDENTIAL,18525,0,18525,72910,0,91435
140447701800000,NE 118,RESIDENTIAL,18525,0,18525,64389,0,82914
140447701900000,NE 118,RESIDENTIAL,18525,0,18525,73132,0,91657
140447702000000,NE 118,RESIDENTIAL,18525,0,18525,71118,0,89643
140447702100000,NE 118,RESIDENTIAL,19316,0,19316,89592,0,108908
140447702200000,NE 118,RESIDENTIAL,19982,0,19982,64714,0,84696
140447702300000,NE 118,RESIDENTIAL,18525,0,18525,65342,0,83867
140447702400000,NE 118,RESIDENTIAL,18525,0,18525,61082,0,79607
140447702500000,NE 118,RESIDENTIAL,18525,0,18525,64642,0,83167
140447702600000,NE 118,RESIDENTIAL,18525,0,18525,63129,0,81654
140447702700000,NE 118,RESIDENTIAL,18525,0,18525,62706,0,81231
140447702800000,NE 118,RESIDENTIAL,18525,0,18525,67099,0,85624
140447702900000,NE 118,RESIDENTIAL,18525,0,18525,69634,0,88159
140447703000000,NE 118,RESIDENTIAL,18525,0,18525,52145,0,70670
140447703100000,NE 118,RESIDENTIAL,18525,0,18525,59012,0,77537
140447703200000,NE 118,RESIDENTIAL,18525,0,18525,69402,0,87927
140447703300000,NE 118,RESIDENTIAL,18525,0,18525,59466,0,77991
140447703400000,NE 118,RESIDENTIAL,18525,0,18525,67612,0,86137
140447703500000,NE 118,RESIDENTIAL,18525,0,18525,72713,0,91238
140447703600000,NE 118,RESIDENTIAL,18525,0,18525,62487,0,81012
140447703700000,NE 118,RESIDENTIAL,18525,0,18525,71073,0,89598
140447703800000,NE 118,RESIDENTIAL,18525,0,18525,63574,0,82099
140447703900000,NE 118,RESIDENTIAL,19451,0,19451,63847,0,83298
140447704000000,NE 118,RESIDENTIAL,19143,0,19143,72227,0,91370
140447800100000,NE 118,RESIDENTIAL,18825,0,18825,92800,0,111625
140447800200000,NE 118,RESIDENTIAL,25646,0,25646,92419,0,118065
140447800300000,NE 118,RESIDENTIAL,24823,0,24823,100747,0,125570
140447800400000,NE 118,RESIDENTIAL,23790,0,23790,68286,0,92076
140447800500000,NE 118,RESIDENTIAL,23400,0,23400,80752,0,104152
140447800600000,NE 118,RESIDENTIAL,23543,0,23543,92319,0,115862
140447800700000,NE 118,RESIDENTIAL,21825,0,21825,96564,0,118389
140447800800000,CITY PROPERTY,EXEMPT,0,0,0,0,0,0
140447800900000,NE 118,RESIDENTIAL,23400,0,23400,93735,0,117135
140447801000000,CITY PROPERTY,EXEMPT,0,0,0,0,0,0
140447801200000,NE 118,RESIDENTIAL,25000,0,25000,0,0,25000
140447801300000,OFFICE,COMMERCIAL,0,176000,176000,0,622800,798800
140447801400000,NE 118,RESIDENTIAL,19308,0,19308,97177,0,116485
140447801500000,NE 118,RESIDENTIAL,18330,0,18330,52783,0,71113
140447801600000,NE 118,RESIDENTIAL,18330,0,18330,72766,0,91096
140447801700000,NE 118,RESIDENTIAL,18330,0,18330,71551,0,89881
140447801800000,NE 118,RESIDENTIAL,18330,0,18330,87443,0,105773
140447801900000,NE 118,RESIDENTIAL,18330,0,18330,77769,0,96099
140447802000000,NE 118,RESIDENTIAL,18330,0,18330,71697,0,90027
140447802100000,NE 118,RESIDENTIAL,18330,0,18330,72117,0,90447
140447802200000,NE 118,RESIDENTIAL,18330,0,18330,68559,0,86889
140447802300000,NE 118,RESIDENTIAL,18330,0,18330,66987,0,85317
140447802400000,NE 118,RESIDENTIAL,18330,0,18330,63132,0,81462
140447802500000,NE 118,RESIDENTIAL,18330,0,18330,58949,0,77279
140447802600000,NE 118,RESIDENTIAL,18330,0,18330,67625,0,85955
140447802700000,NE 118,RESIDENTIAL,18330,0,18330,74088,0,92418
140447802800000,CITY PROPERTY,EXEMPT,0,0,0,0,0,0
140447802900000,NE 118,RESIDENTIAL,19298,0,19298,89598,0,108896
140447803000000,NE 118,RESIDENTIAL,18330,0,18330,63503,0,81833
140447803100000,NE 118,RESIDENTIAL,18330,0,18330,89593,0,107923
140447803200000,NE 118,RESIDENTIAL,18330,0,18330,79120,0,97450
140447900100000,NE 118,RESIDENTIAL,19500,0,19500,104882,0,124382
140447900200000,NE 118,RESIDENTIAL,25805,0,25805,86385,0,112190
140447900300000,NE 118,RESIDENTIAL,23790,0,23790,90339,0,114129
140447900400000,NE 118,RESIDENTIAL,23790,0,23790,93578,0,117368
140447900500000,NE 118,RESIDENTIAL,23790,0,23790,88645,0,112435
140447900600000,NE 118,RESIDENTIAL,23790,0,23790,145517,0,169307
140447900700000,NE 118,RESIDENTIAL,23790,0,23790,82550,0,106340
140447900800000,NE 118,RESIDENTIAL,23790,0,23790,82384,0,106174
140447900900000,NE 118,RESIDENTIAL,23790,0,23790,88513,0,112303
140447901000000,NE 118,RESIDENTIAL,23790,0,23790,98926,0,122716
140447901100000,NE 118,RESIDENTIAL,23790,0,23790,93743,0,117533
140447901201000,OFFICE,COMMERCIAL,0,27846,27846,0,89552,117398
140447901201001,OFFICE,COMMERCIAL,0,27846,27846,0,89552,117398
140447901201002,OFFICE,COMMERCIAL,0,27846,27846,0,89552,117398
140447901201003,OFFICE,COMMERCIAL,0,27846,27846,0,90295,118141
140447901201004,OFFICE,COMMERCIAL,0,34970,34970,0,109867,144837
140447901201005,OFFICE,COMMERCIAL,0,34970,34970,0,109867,144837
140447901201006,OFFICE,COMMERCIAL,0,139766,139766,0,314525,454291
140447901301000,OFFICE,COMMERCIAL,0,27846,27846,0,89106,116952
140447901301001,OFFICE,COMMERCIAL,0,27846,27846,0,88373,116219
140447901301002,OFFICE,COMMERCIAL,0,27846,27846,0,89552,117398
140447901301003,OFFICE,COMMERCIAL,0,27846,27846,0,89552,117398
140447901400000,CHURCH,EXEMPT,0,369360,369360,0,227437,596797
140447901401000,OFFICE,COMMERCIAL,0,27846,27846,0,85663,113509
140447901401001,OFFICE,COMMERCIAL,0,27846,27846,0,84838,112684
140447901401002,OFFICE,COMMERCIAL,0,27846,27846,0,85663,113509
140447901401003,OFFICE,COMMERCIAL,0,27846,27846,0,86367,114213
140447901500000,APARTMENT,COMMERCIAL,0,37360,37360,0,132800,170160
140447901600000,APARTMENT,RESIDENTIAL,19454,0,19454,188446,0,207900
140447902000000,APARTMENT,RESIDENTIAL,64800,0,64800,687035,0,751835
140447902100000,APARTMENT,COMMERCIAL,0,16200,16200,0,110091,126291
140447902200000,APARTMENT,COMMERCIAL,0,28607,28607,0,159370,187977
140448000100000,NE 118,RESIDENTIAL,25555,0,25555,86906,0,112461
140448000200000,NE 118,RESIDENTIAL,23790,0,23790,84453,0,108243
140448000300000,NE 118,RESIDENTIAL,23790,0,23790,99068,0,122858
140448000400000,NE 118,RESIDENTIAL,23790,0,23790,90541,0,114331
140448000500000,NE 118,RESIDENTIAL,24570,0,24570,96486,0,121056
140448000600000,NE 118,RESIDENTIAL,23010,0,23010,96142,0,119152
140448000700000,NE 118,RESIDENTIAL,23790,0,23790,92926,0,116716
140448000800000,NE 118,RESIDENTIAL,23400,0,23400,101082,0,124482
140448000900000,NE 118,RESIDENTIAL,19890,0,19890,72529,0,92419
140448001000000,NE 118,RESIDENTIAL,24211,0,24211,98534,0,122745
140448001100000,NE 118,RESIDENTIAL,19800,0,19800,0,0,19800
140510600100000,CONVENIENCE STORE,COMMERCIAL,0,207000,207000,0,262282,469282
140510600200000,FLAT PARKING,COMMERCIAL,0,168000,168000,0,12177,180177
140510600300000,NBHD SHOPPING CENTER,COMMERCIAL,0,91476,91476,0,312499,403975
140510600400000,WAREHOUSE,COMMERCIAL,0,236000,236000,0,311155,547155
140510600501000,NBHD SHOPPING CENTER,COMMERCIAL,0,34466,34466,0,112120,146586
140510600501001,NBHD SHOPPING CENTER,COMMERCIAL,0,23697,23697,0,77301,100998
140510600501002,NBHD SHOPPING CENTER,COMMERCIAL,0,28002,28002,0,91074,119076
140510600501003,NBHD SHOPPING CENTER,COMMERCIAL,0,21542,21542,0,70415,91957
140510600501004,NBHD SHOPPING CENTER,COMMERCIAL,0,28002,28002,0,91074,119076
140510600501005,NBHD SHOPPING CENTER,COMMERCIAL,0,23697,23697,0,77301,100998
140510600501006,NBHD SHOPPING CENTER,COMMERCIAL,0,28002,28002,0,91074,119076
140510600501007,NBHD SHOPPING CENTER,COMMERCIAL,0,23697,23697,0,77301,100998
140510600501008,NBHD SHOPPING CENTER,COMMERCIAL,0,28002,28002,0,91074,119076
140510600501009,NBHD SHOPPING CENTER,COMMERCIAL,0,23697,23697,0,77301,100998
140510600501010,NBHD SHOPPING CENTER,COMMERCIAL,0,28002,28002,0,91074,119076
140510600501011,NBHD SHOPPING CENTER,COMMERCIAL,0,25847,25847,0,84187,110034
140510600501012,NBHD SHOPPING CENTER,COMMERCIAL,0,28002,28002,0,91074,119076
140510600501013,NBHD SHOPPING CENTER,COMMERCIAL,0,23697,23697,0,77301,100998
140510600501014,NBHD SHOPPING CENTER,COMMERCIAL,0,28002,28002,0,94657,122659
140510600501015,NBHD SHOPPING CENTER,COMMERCIAL,0,23697,23697,0,78013,101710
140510600501016,NBHD SHOPPING CENTER,COMMERCIAL,0,28002,28002,0,91915,119917
140510600501017,NBHD SHOPPING CENTER,COMMERCIAL,0,23697,23697,0,77301,100998
140510600501018,NBHD SHOPPING CENTER,COMMERCIAL,0,28002,28002,0,96018,124020
140510600501019,NBHD SHOPPING CENTER,COMMERCIAL,0,23697,23697,0,77301,100998
140510600501020,NBHD SHOPPING CENTER,COMMERCIAL,0,29504,29504,0,93498,123002
140510600501021,NBHD SHOPPING CENTER,COMMERCIAL,0,22259,22259,0,72619,94878
140510600501022,NBHD SHOPPING CENTER,COMMERCIAL,0,25847,25847,0,84187,110034
140510600501023,NBHD SHOPPING CENTER,COMMERCIAL,0,22453,22453,0,73199,95652
140510600501024,NBHD SHOPPING CENTER,COMMERCIAL,0,29245,29245,0,101355,130600
140510600600000,FAST FOOD,COMMERCIAL,0,546820,546820,0,671128,1217948
140510600700000,FLAT PARKING,COMMERCIAL,0,207857,207857,0,84521,292378
140510600900000,FAST FOOD,COMMERCIAL,0,535620,535620,0,729681,1265301
140510601000000,FLAT PARKING,COMMERCIAL,0,140720,140720,0,63202,203922
140510601100000,RESTAURANT,COMMERCIAL,0,622420,622420,0,511749,1134169
140510601200000,FAST FOOD,COMMERCIAL,0,248020,248020,0,570937,818957
140510601300000,FAST FOOD,COMMERCIAL,0,225220,225220,0,441084,666304
140512900100000,NBHD SHOPPING CENTER,COMMERCIAL,0,276420,276420,0,522710,799130
140512900200000,RESTAURANT,COMMERCIAL,0,216902,216902,0,309225,526127
140512900300000,FAST FOOD,COMMERCIAL,0,299220,299220,0,351596,650816
140512900400000,SMALL RETAIL,COMMERCIAL,0,322420,322420,0,495494,817914
140512900500000,BRANCH BANK/CU,COMMERCIAL,0,816620,816620,0,2054614,2871234
140512900900000,GROCERY STORE,COMMERCIAL,0,507520,507520,0,1085188,1592708
140512901200000,LG DISCOUNT/RETAIL,COMMERCIAL,0,1339004,1339004,0,7684093,9023097
140512901300000,VACANT LAND,COMMERCIAL,0,2000,2000,0,0,2000
140515100300000,VACANT LAND,COMMERCIAL,0,31275,31275,0,0,31275
140515100400000,CHURCH,EXEMPT,0,997002,997002,0,6946905,7943907
140517600300000,WAREHOUSE,COMMERCIAL,0,209895,209895,0,825473,1035368
140517600400000,WAREHOUSE,COMMERCIAL,0,239020,239020,0,596360,835380
140517600500000,WAREHOUSE,COMMERCIAL,0,200520,200520,0,780194,980714
140517600600000,VACANT LAND,COMMERCIAL,0,104155,104155,0,0,104155
140517600700000,DAY CARE CENTER,COMMERCIAL,0,93645,93645,0,389614,483259
140517600800000,FLAT PARKING,COMMERCIAL,0,108048,108048,0,0,108048
140517600900000,LG DISCOUNT/RETAIL,COMMERCIAL,0,1165040,1165040,0,5378791,6543831
140517601000000,LG DISCOUNT/RETAIL,COMMERCIAL,0,1495100,1495100,0,7251466,8746566
140517601100000,WAREHOUSE,COMMERCIAL,0,254145,254145,0,1108755,1362900
140517601200000,VACANT LAND,COMMERCIAL,0,203526,203526,0,0,203526
140520800100000,NE 111,RESIDENTIAL,740,0,740,0,0,740
140520800200000,SECTION 42,COMMERCIAL,0,128020,128020,0,104329,232349
140520800300000,NE 168,RESIDENTIAL,60000,0,60000,163981,0,223981
140520800400000,APARTMENT,EXEMPT,0,73440,73440,0,679925,753365
140520800500000,APARTMENT,EXEMPT,0,29527,29527,0,247318,276845
140522700100000,CHURCH,EXEMPT,0,465264,465264,0,768960,1234224
140522700200000,NE 113,RESIDENTIAL,22563,0,22563,101205,0,123768
140522700300000,NE 113,RESIDENTIAL,22560,0,22560,117081,0,139641
140522700400000,NE 113,RESIDENTIAL,22800,0,22800,114124,0,136924
140522700500000,NE 113,RESIDENTIAL,22800,0,22800,106150,0,128950
140522700600000,NE 113,RESIDENTIAL,23040,0,23040,131964,0,155004
140522700700000,NE 113,RESIDENTIAL,22272,0,22272,102297,0,124569
140522700800000,NE 113,RESIDENTIAL,26214,0,26214,99833,0,126047
140522700900000,NE 113,RESIDENTIAL,26216,0,26216,98453,0,124669
140522701000000,NE 113,RESIDENTIAL,22560,0,22560,93778,0,116338
140522701100000,NE 113,RESIDENTIAL,22560,0,22560,92164,0,114724
140522701200000,NE 113,RESIDENTIAL,22560,0,22560,91957,0,114517
140522701300000,NE 113,RESIDENTIAL,24741,0,24741,93827,0,118568
140522800100000,CHURCH,EXEMPT,0,494640,494640,0,1920395,2415035
140522800200000,NE 113,RESIDENTIAL,24696,0,24696,122101,0,146797
140522800300000,NE 113,RESIDENTIAL,24020,0,24020,111729,0,135749
140522800400000,NE 113,RESIDENTIAL,23775,0,23775,107812,0,131587
140522800500000,NE 113,RESIDENTIAL,23775,0,23775,96420,0,120195
140522800600000,NE 113,RESIDENTIAL,23530,0,23530,116669,0,140199
140522800700000,NE 113,RESIDENTIAL,23530,0,23530,111502,0,135032
140522800800000,NE 113,RESIDENTIAL,23530,0,23530,108873,0,132403
140522800900000,NE 113,RESIDENTIAL,24530,0,24530,130712,0,155242
140522801000000,NE 113,RESIDENTIAL,25868,0,25868,124174,0,150042
140522801100000,NE 113,RESIDENTIAL,25536,0,25536,116681,0,142217
140522801200000,NE 113,RESIDENTIAL,23703,0,23703,100145,0,123848
140522801300000,NE 113,RESIDENTIAL,23530,0,23530,109194,0,132724
140522801400000,NE 113,RESIDENTIAL,23530,0,23530,93488,0,117018
140522900100000,NE 113,RESIDENTIAL,23436,0,23436,110375,0,133811
140522900200000,NE 113,RESIDENTIAL,25380,0,25380,107632,0,133012
140522900300000,NE 113,RESIDENTIAL,25380,0,25380,108825,0,134205
140522900400000,NE 113,RESIDENTIAL,22560,0,22560,92895,0,115455
140522900500000,NE 113,RESIDENTIAL,21933,0,21933,105389,0,127322
140522900600000,NE 113,RESIDENTIAL,23218,0,23218,112887,0,136105
140522900700000,NE 113,RESIDENTIAL,22560,0,22560,103241,0,125801
140522900800000,NE 113,RESIDENTIAL,22560,0,22560,102619,0,125179
140522900900000,NE 113,RESIDENTIAL,22560,0,22560,108284,0,130844
140522901000000,NE 113,RESIDENTIAL,22560,0,22560,104064,0,126624
140522901100000,NE 113,RESIDENTIAL,23436,0,23436,103673,0,127109
140523000100000,NE 113,RESIDENTIAL,25273,0,25273,112316,0,137589
140523000200000,NE 113,RESIDENTIAL,24510,0,24510,112737,0,137247
140523000300000,NE 113,RESIDENTIAL,24510,0,24510,104406,0,128916
140523000400000,NE 113,RESIDENTIAL,24510,0,24510,112763,0,137273
140523000500000,NE 113,RESIDENTIAL,24510,0,24510,103175,0,127685
140523000600000,NE 113,RESIDENTIAL,24510,0,24510,109106,0,133616
140523000700000,NE 113,RESIDENTIAL,24510,0,24510,111865,0,136375
140523000800000,NE 113,RESIDENTIAL,26784,0,26784,108379,0,135163
140523000900000,NE 113,RESIDENTIAL,24735,0,24735,109018,0,133753
140523001000000,NE 113,RESIDENTIAL,24735,0,24735,151544,0,176279
140523001100000,NE 113,RESIDENTIAL,27962,0,27962,100558,0,128520
140523001200000,NE 113,RESIDENTIAL,27789,0,27789,118694,0,146483
140523001300000,NE 113,RESIDENTIAL,25500,0,25500,116487,0,141987
140523001400000,NE 113,RESIDENTIAL,25500,0,25500,117055,0,142555
140523001500000,NE 113,RESIDENTIAL,25500,0,25500,110295,0,135795
140525100100000,NE 113,RESIDENTIAL,24785,0,24785,102674,0,127459
140525100200000,NE 113,RESIDENTIAL,22560,0,22560,98920,0,121480
140525100300000,NE 113,RESIDENTIAL,22560,0,22560,105925,0,128485
140525100400000,NE 113,RESIDENTIAL,22560,0,22560,88100,0,110660
140525100500000,NE 113,RESIDENTIAL,22560,0,22560,106356,0,128916
140525100600000,NE 113,RESIDENTIAL,22560,0,22560,105450,0,128010
140525100700000,NE 113,RESIDENTIAL,24252,0,24252,101520,0,125772
140525100800000,NE 113,RESIDENTIAL,24252,0,24252,100090,0,124342
140525100900000,NE 113,RESIDENTIAL,22560,0,22560,101335,0,123895
140525101000000,NE 113,RESIDENTIAL,22560,0,22560,102814,0,125374
140525101100000,NE 113,RESIDENTIAL,22560,0,22560,116614,0,139174
140525101200000,NE 113,RESIDENTIAL,22560,0,22560,93744,0,116304
140525101300000,NE 113,RESIDENTIAL,22560,0,22560,105097,0,127657
140525101400000,NE 113,RESIDENTIAL,24785,0,24785,109875,0,134660
140525101500000,NE 113,RESIDENTIAL,24741,0,24741,107394,0,132135
140525101600000,NE 113,RESIDENTIAL,22560,0,22560,103814,0,126374
140525101700000,NE 113,RESIDENTIAL,22560,0,22560,109218,0,131778
140525101800000,NE 113,RESIDENTIAL,22560,0,22560,105360,0,127920
140525101900000,NE 113,RESIDENTIAL,24741,0,24741,115888,0,140629
140525102000000,NE 113,RESIDENTIAL,24785,0,24785,124846,0,149631
140525102100000,NE 113,RESIDENTIAL,22560,0,22560,92888,0,115448
140525102200000,NE 113,RESIDENTIAL,22560,0,22560,111906,0,134466
140525102300000,NE 113,RESIDENTIAL,22560,0,22560,98971,0,121531
140525102400000,NE 113,RESIDENTIAL,22560,0,22560,105927,0,128487
140525102500000,NE 113,RESIDENTIAL,22560,0,22560,101777,0,124337
140525102600000,NE 113,RESIDENTIAL,24252,0,24252,109942,0,134194
140525102700000,NE 113,RESIDENTIAL,24252,0,24252,110837,0,135089
140525102800000,NE 113,RESIDENTIAL,24252,0,24252,89125,0,113377
140525102900000,NE 113,RESIDENTIAL,24252,0,24252,97964,0,122216
140525103000000,NE 113,RESIDENTIAL,24252,0,24252,109339,0,133591
140525103100000,NE 113,RESIDENTIAL,24252,0,24252,111012,0,135264
140525103200000,NE 113,RESIDENTIAL,23823,0,23823,118308,0,142131
140525103300000,NE 113,RESIDENTIAL,25305,0,25305,97963,0,123268
140525103400000,NE 113,RESIDENTIAL,23834,0,23834,121975,0,145809
140525103500000,NE 113,RESIDENTIAL,24252,0,24252,100523,0,124775
140525103600000,NE 113,RESIDENTIAL,23562,0,23562,99828,0,123390
140525200100000,NE 113,RESIDENTIAL,23603,0,23603,84881,0,108484
140525200200000,NE 113,RESIDENTIAL,22560,0,22560,106716,0,129276
140525200300000,NE 113,RESIDENTIAL,22560,0,22560,107139,0,129699
140525200400000,NE 113,RESIDENTIAL,22560,0,22560,106941,0,129501
140525200500000,NE 113,RESIDENTIAL,22560,0,22560,105195,0,127755
140525200600000,NE 113,RESIDENTIAL,23039,0,23039,127733,0,150772
140525200700000,NE 113,RESIDENTIAL,23039,0,23039,96111,0,119150
140525200800000,NE 113,RESIDENTIAL,22560,0,22560,106227,0,128787
140525200900000,NE 113,RESIDENTIAL,22560,0,22560,107776,0,130336
140525201000000,NE 113,RESIDENTIAL,22560,0,22560,113752,0,136312
140525201100000,NE 113,RESIDENTIAL,22560,0,22560,110381,0,132941
140525201200000,NE 113,RESIDENTIAL,23603,0,23603,102778,0,126381
140525300100000,NE 113,RESIDENTIAL,25500,0,25500,114342,0,139842
140525300200000,NE 113,RESIDENTIAL,25500,0,25500,96109,0,121609
140525300300000,NE 113,RESIDENTIAL,25500,0,25500,110134,0,135634
140525300400000,NE 113,RESIDENTIAL,27789,0,27789,103571,0,131360
140525300500000,NE 113,RESIDENTIAL,27744,0,27744,118352,0,146096
140525300600000,NE 113,RESIDENTIAL,27393,0,27393,120326,0,147719
140525300700000,NE 113,RESIDENTIAL,24735,0,24735,106825,0,131560
140525300800000,NE 113,RESIDENTIAL,24735,0,24735,97065,0,121800
140525300900000,NE 113,RESIDENTIAL,23280,0,23280,113459,0,136739
140525301000000,NE 113,RESIDENTIAL,23280,0,23280,107607,0,130887
140525301100000,NE 113,RESIDENTIAL,23280,0,23280,109315,0,132595
140525301200000,NE 113,RESIDENTIAL,23346,0,23346,96401,0,119747
140525301300000,NE 113,RESIDENTIAL,23214,0,23214,115148,0,138362
140525301400000,NE 113,RESIDENTIAL,25200,0,25200,120265,0,145465
140525301500000,NE 113,RESIDENTIAL,24000,0,24000,91381,0,115381
140525301600000,NE 113,RESIDENTIAL,24000,0,24000,101396,0,125396
140525301700000,NE 113,RESIDENTIAL,24000,0,24000,92821,0,116821
140525301800000,NE 113,RESIDENTIAL,24000,0,24000,85689,0,109689
140525301900000,NE 113,RESIDENTIAL,24000,0,24000,90139,0,114139
140525302000000,NE 113,RESIDENTIAL,24000,0,24000,93175,0,117175
140525302100000,NE 113,RESIDENTIAL,24000,0,24000,104883,0,128883
140525302200000,NE 113,RESIDENTIAL,25200,0,25200,105833,0,131033
140525302300000,NE 113,RESIDENTIAL,24000,0,24000,104674,0,128674
140525302400000,NE 113,RESIDENTIAL,24600,0,24600,102931,0,127531
140525302500000,NE 113,RESIDENTIAL,23400,0,23400,99744,0,123144
140525302600000,NE 113,RESIDENTIAL,24000,0,24000,76187,0,100187
140525302700000,NE 113,RESIDENTIAL,25862,0,25862,97772,0,123634
140525302800000,NE 113,RESIDENTIAL,27257,0,27257,99105,0,126362
140525302900000,NE 113,RESIDENTIAL,27393,0,27393,104492,0,131885
140525303000000,NE 113,RESIDENTIAL,27853,0,27853,109168,0,137021
140525303100000,NE 113,RESIDENTIAL,25862,0,25862,120677,0,146539
140525303200000,NE 113,RESIDENTIAL,24000,0,24000,108313,0,132313
140525303300000,NE 113,RESIDENTIAL,24000,0,24000,106515,0,130515
140525303400000,NE 113,RESIDENTIAL,24000,0,24000,90625,0,114625
140525303500000,NE 113,RESIDENTIAL,24000,0,24000,118499,0,142499
140525400100000,NE 113,RESIDENTIAL,23530,0,23530,123936,0,147466
140525400200000,NE 113,RESIDENTIAL,23530,0,23530,118074,0,141604
140525400300000,NE 113,RESIDENTIAL,23040,0,23040,109078,0,132118
140525400400000,NE 113,RESIDENTIAL,23309,0,23309,111482,0,134791
140525400500000,NE 113,RESIDENTIAL,22771,0,22771,88736,0,111507
140525400600000,NE 113,RESIDENTIAL,23040,0,23040,125908,0,148948
140525400700000,NE 113,RESIDENTIAL,23040,0,23040,86213,0,109253
140525400800000,NE 113,RESIDENTIAL,23280,0,23280,114101,0,137381
140525400900000,NE 113,RESIDENTIAL,23280,0,23280,110374,0,133654
140525401000000,NE 113,RESIDENTIAL,23280,0,23280,95183,0,118463
140525500100000,NE 113,RESIDENTIAL,22801,0,22801,101818,0,124619
140525500200000,NE 113,RESIDENTIAL,23039,0,23039,109854,0,132893
140525500300000,NE 113,RESIDENTIAL,22861,0,22861,111264,0,134125
140525500400000,NE 113,RESIDENTIAL,22861,0,22861,100099,0,122960
140525500500000,NE 113,RESIDENTIAL,23116,0,23116,108988,0,132104
140525500600000,NE 113,RESIDENTIAL,27141,0,27141,101474,0,128615
140525500700000,NE 113,RESIDENTIAL,22639,0,22639,99415,0,122054
140525500800000,NE 113,RESIDENTIAL,23354,0,23354,118581,0,141935
140525500900000,NE 113,RESIDENTIAL,22800,0,22800,102247,0,125047
140525600100000,NE 113,RESIDENTIAL,23925,0,23925,131632,0,155557
140525600200000,NE 113,RESIDENTIAL,24132,0,24132,125431,0,149563
140525600300000,NE 113,RESIDENTIAL,23206,0,23206,121727,0,144933
140525600400000,NE 113,RESIDENTIAL,23232,0,23232,111869,0,135101
140525600500000,NE 113,RESIDENTIAL,24276,0,24276,127206,0,151482
140525600600000,NE 113,RESIDENTIAL,28187,0,28187,117471,0,145658
140525600700000,NE 113,RESIDENTIAL,22988,0,22988,103618,0,126606
140525600800000,NE 113,RESIDENTIAL,22988,0,22988,116100,0,139088
140525600900000,NE 113,RESIDENTIAL,22988,0,22988,112560,0,135548
140525601000000,NE 113,RESIDENTIAL,22988,0,22988,111767,0,134755
140525601100000,NE 113,RESIDENTIAL,22988,0,22988,110639,0,133627
140525601200000,NE 113,RESIDENTIAL,22988,0,22988,118231,0,141219
140525601300000,NE 113,RESIDENTIAL,22988,0,22988,114525,0,137513
140525601400000,NE 113,RESIDENTIAL,23530,0,23530,110956,0,134486
140525601500000,NE 113,RESIDENTIAL,22988,0,22988,108639,0,131627
140525601600000,NE 113,RESIDENTIAL,22988,0,22988,109228,0,132216
140525601700000,NE 113,RESIDENTIAL,22988,0,22988,126223,0,149211
140525601800000,NE 113,RESIDENTIAL,22988,0,22988,112105,0,135093
140525601900000,NE 113,RESIDENTIAL,22885,0,22885,105497,0,128382
140525602000000,NE 113,RESIDENTIAL,24840,0,24840,113339,0,138179
140525602100000,NE 113,RESIDENTIAL,25222,0,25222,122932,0,148154
140525602200000,NE 113,RESIDENTIAL,24781,0,24781,113172,0,137953
140525602300000,NE 113,RESIDENTIAL,24149,0,24149,102060,0,126209
140525602400000,NE 113,RESIDENTIAL,24411,0,24411,112235,0,136646
140525602500000,NE 113,RESIDENTIAL,24265,0,24265,102223,0,126488
140525602600000,NE 113,RESIDENTIAL,24265,0,24265,127692,0,151957
140525602700000,NE 113,RESIDENTIAL,24265,0,24265,118245,0,142510
140525602800000,NE 113,RESIDENTIAL,24577,0,24577,99632,0,124209
140525602900000,NE 113,RESIDENTIAL,24444,0,24444,97633,0,122077
140525603000000,NE 113,RESIDENTIAL,23775,0,23775,112630,0,136405
140525603100000,NE 113,RESIDENTIAL,23775,0,23775,107352,0,131127
140525700100000,NE 113,RESIDENTIAL,24145,0,24145,168004,0,192149
140525700200000,NE 113,RESIDENTIAL,22560,0,22560,105387,0,127947
140525700300000,NE 113,RESIDENTIAL,22560,0,22560,89401,0,111961
140525700400000,NE 113,RESIDENTIAL,22560,0,22560,110903,0,133463
140525700500000,NE 113,RESIDENTIAL,22560,0,22560,94940,0,117500
140525700600000,NE 113,RESIDENTIAL,22560,0,22560,106106,0,128666
140525700700000,NE 113,RESIDENTIAL,22560,0,22560,109868,0,132428
140525700800000,NE 113,RESIDENTIAL,22560,0,22560,104220,0,126780
140525700900000,NE 113,RESIDENTIAL,22560,0,22560,104319,0,126879
140525701000000,NE 113,RESIDENTIAL,22560,0,22560,102643,0,125203
140525701100000,NE 113,RESIDENTIAL,22560,0,22560,108496,0,131056
140525701200000,NE 113,RESIDENTIAL,24252,0,24252,98820,0,123072
140525701300000,NE 113,RESIDENTIAL,23718,0,23718,107432,0,131150
140525701400000,NE 113,RESIDENTIAL,23775,0,23775,109478,0,133253
140525701500000,NE 113,RESIDENTIAL,23775,0,23775,123402,0,147177
140525701600000,NE 113,RESIDENTIAL,24512,0,24512,112670,0,137182
140525701700000,NE 113,RESIDENTIAL,24250,0,24250,117642,0,141892
140525701800000,NE 113,RESIDENTIAL,23775,0,23775,108072,0,131847
140525701900000,NE 113,RESIDENTIAL,23775,0,23775,118090,0,141865
140525702000000,NE 113,RESIDENTIAL,23775,0,23775,120857,0,144632
140525702100000,NE 113,RESIDENTIAL,24796,0,24796,99437,0,124233
140525702200000,NE 113,RESIDENTIAL,27972,0,27972,100154,0,128126
140525702300000,NE 113,RESIDENTIAL,25600,0,25600,118144,0,143744
140525702400000,NE 113,RESIDENTIAL,23530,0,23530,119740,0,143270
140525702500000,NE 113,RESIDENTIAL,23775,0,23775,110345,0,134120
140525702600000,NE 113,RESIDENTIAL,23775,0,23775,115989,0,139764
140525702700000,NE 113,RESIDENTIAL,24020,0,24020,113997,0,138017
140525702800000,NE 113,RESIDENTIAL,24020,0,24020,143082,0,167102
140525800100000,NE 113,RESIDENTIAL,25250,0,25250,124818,0,150068
140525800200000,NE 113,RESIDENTIAL,22560,0,22560,98333,0,120893
140525800300000,NE 113,RESIDENTIAL,22560,0,22560,96748,0,119308
140525800400000,NE 113,RESIDENTIAL,24064,0,24064,101905,0,125969
140525800500000,NE 113,RESIDENTIAL,24252,0,24252,103270,0,127522
140525900200000,NE 113,RESIDENTIAL,24095,0,24095,106372,0,130467
140525900300000,NE 113,RESIDENTIAL,24016,0,24016,106482,0,130498
140525900400000,NE 113,RESIDENTIAL,24265,0,24265,101601,0,125866
140525900500000,NE 113,RESIDENTIAL,24265,0,24265,101891,0,126156
140525900600000,NE 113,RESIDENTIAL,24265,0,24265,108375,0,132640
140525900700000,NE 113,RESIDENTIAL,24265,0,24265,113749,0,138014
140527600100000,MFG HOME PARK,COMMERCIAL,0,3114500,3114500,0,2195123,5309623
140530100100000,NE 123,RESIDENTIAL,16150,0,16150,7151,0,23301
140530100200000,NE 123,RESIDENTIAL,25835,0,25835,99915,0,125750
140530100300000,NE 123,RESIDENTIAL,25542,0,25542,115001,0,140543
140530100400000,NE 123,RESIDENTIAL,25542,0,25542,96946,0,122488
140530100500000,NE 123,RESIDENTIAL,25542,0,25542,100319,0,125861
140530100600000,NE 123,RESIDENTIAL,26390,0,26390,101895,0,128285
140530100700000,NE 123,RESIDENTIAL,26730,0,26730,101220,0,127950
140530100800000,NE 123,RESIDENTIAL,26730,0,26730,109830,0,136560
140530100900000,NE 123,RESIDENTIAL,27263,0,27263,93596,0,120859
140530101000000,NE 123,RESIDENTIAL,25542,0,25542,104446,0,129988
140530101100000,NE 123,RESIDENTIAL,25542,0,25542,112240,0,137782
140530101200000,NE 123,RESIDENTIAL,25542,0,25542,91278,0,116820
140530101300000,NE 123,RESIDENTIAL,27431,0,27431,93404,0,120835
140530101400000,NE 123,RESIDENTIAL,36204,0,36204,107160,0,143364
140530101500000,NE 123,RESIDENTIAL,32783,0,32783,112517,0,145300
140530101600000,NE 123,RESIDENTIAL,31928,0,31928,120453,0,152381
140530101700000,NE 123,RESIDENTIAL,31928,0,31928,102931,0,134859
140530101800000,NE 123,RESIDENTIAL,31928,0,31928,98187,0,130115
140530101900000,NE 123,RESIDENTIAL,31928,0,31928,133648,0,165576
140530102000000,NE 123,RESIDENTIAL,31928,0,31928,102573,0,134501
140530102100000,NE 123,RESIDENTIAL,31928,0,31928,110117,0,142045
140530102200000,NE 123,RESIDENTIAL,31928,0,31928,112842,0,144770
140530200100000,NE 123,RESIDENTIAL,26569,0,26569,97548,0,124117
140530200200000,NE 123,RESIDENTIAL,25800,0,25800,101248,0,127048
140530200300000,NE 123,RESIDENTIAL,25800,0,25800,94228,0,120028
140530200400000,NE 123,RESIDENTIAL,25800,0,25800,100717,0,126517
140530200500000,NE 123,RESIDENTIAL,25800,0,25800,115371,0,141171
140530200600000,NE 123,RESIDENTIAL,25800,0,25800,96649,0,122449
140530200700000,NE 123,RESIDENTIAL,25800,0,25800,103803,0,129603
140530200800000,NE 123,RESIDENTIAL,25800,0,25800,115505,0,141305
140530200900000,NE 123,RESIDENTIAL,25800,0,25800,120532,0,146332
140530300100000,NE 123,RESIDENTIAL,26316,0,26316,85210,0,111526
140530300200000,NE 123,RESIDENTIAL,26790,0,26790,108786,0,135576
140530300300000,NE 123,RESIDENTIAL,25284,0,25284,89303,0,114587
140530300400000,NE 123,RESIDENTIAL,26790,0,26790,125415,0,152205
140530300500000,NE 123,RESIDENTIAL,25490,0,25490,99038,0,124528
140530300600000,NE 123,RESIDENTIAL,26832,0,26832,85450,0,112282
140530300700000,NE 123,RESIDENTIAL,25490,0,25490,99192,0,124682
140530300800000,NE 123,RESIDENTIAL,24544,0,24544,92566,0,117110
140530300900000,NE 123,RESIDENTIAL,27664,0,27664,145477,0,173141
140530301000000,NE 123,RESIDENTIAL,25376,0,25376,130856,0,156232
140530301100000,NE 123,RESIDENTIAL,26874,0,26874,120971,0,147845
140530301200000,NE 123,RESIDENTIAL,24544,0,24544,108271,0,132815
140530301300000,NE 123,RESIDENTIAL,28080,0,28080,111562,0,139642
140530301400000,NE 123,RESIDENTIAL,24752,0,24752,99844,0,124596
140530301500000,NE 123,RESIDENTIAL,26832,0,26832,98770,0,125602
140530301600000,NE 123,RESIDENTIAL,26832,0,26832,122175,0,149007
140530301700000,NE 123,RESIDENTIAL,26832,0,26832,118368,0,145200
140530301800000,NE 123,RESIDENTIAL,26832,0,26832,101652,0,128484
140530400100000,NE 123,RESIDENTIAL,27603,0,27603,103434,0,131037
140530400200000,NE 123,RESIDENTIAL,26574,0,26574,112528,0,139102
140530400300000,NE 123,RESIDENTIAL,26866,0,26866,127622,0,154488
140530400400000,NE 123,RESIDENTIAL,26866,0,26866,116045,0,142911
140530400500000,NE 123,RESIDENTIAL,26866,0,26866,112222,0,139088
140530400600000,NE 123,RESIDENTIAL,26866,0,26866,108195,0,135061
140530400700000,NE 123,RESIDENTIAL,26906,0,26906,121238,0,148144
140530400800000,NE 123,RESIDENTIAL,26664,0,26664,91366,0,118030
140530400900000,NE 123,RESIDENTIAL,26058,0,26058,107456,0,133514
140530401000000,NE 123,RESIDENTIAL,26058,0,26058,112914,0,138972
140530401100000,NE 123,RESIDENTIAL,26058,0,26058,107615,0,133673
140530401200000,NE 123,RESIDENTIAL,26058,0,26058,96474,0,122532
140530401300000,NE 123,RESIDENTIAL,26058,0,26058,108179,0,134237
140530401400000,NE 123,RESIDENTIAL,26058,0,26058,93101,0,119159
140530401500000,NE 123,RESIDENTIAL,26058,0,26058,113715,0,139773
140532600100000,NE 113,RESIDENTIAL,24252,0,24252,127014,0,151266
140532600200000,NE 113,RESIDENTIAL,30723,0,30723,128224,0,158947
140532600300000,NE 113,RESIDENTIAL,32873,0,32873,122694,0,155567
140532600400000,NE 113,RESIDENTIAL,25026,0,25026,124728,0,149754
140532600500000,NE 113,RESIDENTIAL,24820,0,24820,104502,0,129322
140532600600000,NE 113,RESIDENTIAL,24265,0,24265,125347,0,149612
140532600700000,NE 113,RESIDENTIAL,27252,0,27252,131083,0,158335
140532600800000,NE 113,RESIDENTIAL,25407,0,25407,117455,0,142862
140532600900000,NE 113,RESIDENTIAL,24020,0,24020,88635,0,112655
140532601000000,NE 113,RESIDENTIAL,23775,0,23775,106141,0,129916
140532601100000,NE 113,RESIDENTIAL,23530,0,23530,90177,0,113707
140532601300000,NE 113,RESIDENTIAL,24020,0,24020,145882,0,169902
140532601400000,NE 113,RESIDENTIAL,36992,0,36992,184478,0,221470
140532601500000,NE 113,RESIDENTIAL,33399,0,33399,0,0,33399
140532601600000,NE 113,RESIDENTIAL,25740,0,25740,0,0,25740
140532601700000,NE 113,RESIDENTIAL,26520,0,26520,174804,0,201324
140532601800000,NE 113,RESIDENTIAL,27560,0,27560,150599,0,178159
140532601900000,NE 113,RESIDENTIAL,28340,0,28340,159689,0,188029
140532602000000,NE 123,RESIDENTIAL,28860,0,28860,138144,0,167004
140532602100000,NE 123,RESIDENTIAL,29491,0,29491,158402,0,187893
140532602200000,NE 123,RESIDENTIAL,33253,0,33253,140060,0,173313
140532602300000,NE 123,RESIDENTIAL,28653,0,28653,155726,0,184379
140535100100000,CITY PROPERTY,EXEMPT,0,0,0,0,0,0
140535900100000,NE 113,RESIDENTIAL,23530,0,23530,98944,0,122474
140537600100000,NE 123,RESIDENTIAL,25800,0,25800,105864,0,131664
140537600200000,NE 123,RESIDENTIAL,24020,0,24020,98946,0,122966
140537600300000,NE 123,RESIDENTIAL,26030,0,26030,104960,0,130990
140537600400000,NE 123,RESIDENTIAL,25800,0,25800,101257,0,127057
140537600500000,NE 123,RESIDENTIAL,26337,0,26337,87471,0,113808
140537600600000,NE 123,RESIDENTIAL,27904,0,27904,113034,0,140938
140537600700000,NE 123,RESIDENTIAL,27904,0,27904,101393,0,129297
140537600800000,NE 123,RESIDENTIAL,26015,0,26015,96731,0,122746
140537600900000,NE 123,RESIDENTIAL,25744,0,25744,105687,0,131431
140537601000000,NE 123,RESIDENTIAL,24956,0,24956,111310,0,136266
140537601100000,NE 123,RESIDENTIAL,26000,0,26000,105654,0,131654
140537601200000,NE 123,RESIDENTIAL,25836,0,25836,89539,0,115375
140537601300000,NE 123,RESIDENTIAL,26154,0,26154,123792,0,149946
140537601400000,NE 123,RESIDENTIAL,23040,0,23040,99425,0,122465
140537601500000,NE 123,RESIDENTIAL,23040,0,23040,117000,0,140040
140537601600000,NE 123,RESIDENTIAL,24576,0,24576,116245,0,140821
140537601700000,NE 123,RESIDENTIAL,24576,0,24576,110709,0,135285
140537601800000,NE 123,RESIDENTIAL,24576,0,24576,101844,0,126420
140537601900000,NE 123,RESIDENTIAL,24576,0,24576,95152,0,119728
140537602000000,NE 123,RESIDENTIAL,23922,0,23922,92948,0,116870
140537602100000,NE 123,RESIDENTIAL,10,0,10,0,0,10
140537700100000,NE 123,RESIDENTIAL,25168,0,25168,96558,0,121726
140537700200000,NE 123,RESIDENTIAL,26832,0,26832,100190,0,127022
140537700300000,NE 123,RESIDENTIAL,26696,0,26696,97715,0,124411
140537700400000,NE 123,RESIDENTIAL,27090,0,27090,104406,0,131496
140537700500000,NE 123,RESIDENTIAL,30949,0,30949,121011,0,151960
140537700600000,NE 123,RESIDENTIAL,28500,0,28500,124455,0,152955
140537700700000,NE 123,RESIDENTIAL,25800,0,25800,93634,0,119434
140537700800000,NE 123,RESIDENTIAL,25986,0,25986,95492,0,121478
140537700900000,NE 123,RESIDENTIAL,25168,0,25168,124260,0,149428
140537701000000,NE 123,RESIDENTIAL,28652,0,28652,121339,0,149991
140537800100000,NE 123,RESIDENTIAL,26914,0,26914,96806,0,123720
140537800200000,NE 123,RESIDENTIAL,26866,0,26866,111918,0,138784
140537800300000,NE 123,RESIDENTIAL,26600,0,26600,118695,0,145295
140537800400000,NE 123,RESIDENTIAL,26266,0,26266,115457,0,141723
140537800500000,NE 123,RESIDENTIAL,26118,0,26118,101348,0,127466
140537800600000,NE 123,RESIDENTIAL,25992,0,25992,121111,0,147103
140537800700000,NE 123,RESIDENTIAL,25650,0,25650,91898,0,117548
140537800800000,NE 123,RESIDENTIAL,24510,0,24510,120019,0,144529
140537800900000,NE 123,RESIDENTIAL,25591,0,25591,119302,0,144893
140537801000000,NE 123,RESIDENTIAL,26220,0,26220,127023,0,153243
140537801100000,NE 123,RESIDENTIAL,26600,0,26600,107812,0,134412
140537801200000,NE 123,RESIDENTIAL,26600,0,26600,108413,0,135013
140537801300000,NE 123,RESIDENTIAL,26600,0,26600,100020,0,126620
140537801400000,NE 123,RESIDENTIAL,26600,0,26600,105983,0,132583
140537801500000,NE 123,RESIDENTIAL,26600,0,26600,99466,0,126066
140537801600000,NE 123,RESIDENTIAL,26600,0,26600,85632,0,112232
140537801700000,NE 123,RESIDENTIAL,26600,0,26600,115537,0,142137
140537801800000,NE 123,RESIDENTIAL,26600,0,26600,104528,0,131128
140537801900000,NE 123,RESIDENTIAL,26642,0,26642,114473,0,141115
140537802000000,NE 123,RESIDENTIAL,24468,0,24468,82610,0,107078
140537802100000,NE 123,RESIDENTIAL,24510,0,24510,107930,0,132440
140537802200000,NE 123,RESIDENTIAL,24510,0,24510,102567,0,127077
140537802300000,NE 123,RESIDENTIAL,24510,0,24510,96000,0,120510
140537802400000,NE 123,RESIDENTIAL,24510,0,24510,97276,0,121786
140537802500000,NE 123,RESIDENTIAL,24510,0,24510,115167,0,139677
140537802600000,NE 123,RESIDENTIAL,24510,0,24510,85434,0,109944
140537802700000,NE 123,RESIDENTIAL,24510,0,24510,87056,0,111566
140537802800000,NE 123,RESIDENTIAL,24130,0,24130,136880,0,161010
140537802900000,NE 123,RESIDENTIAL,24130,0,24130,95972,0,120102
140537803000000,NE 123,RESIDENTIAL,24130,0,24130,92158,0,116288
140537803100000,NE 123,RESIDENTIAL,24172,0,24172,111434,0,135606
140537803200000,NE 123,RESIDENTIAL,24510,0,24510,109052,0,133562
140537803300000,NE 123,RESIDENTIAL,25650,0,25650,110050,0,135700
140537803400000,NE 123,RESIDENTIAL,25067,0,25067,103279,0,128346
140537803500000,NE 123,RESIDENTIAL,26582,0,26582,120520,0,147102
140537803600000,NE 123,RESIDENTIAL,26599,0,26599,99994,0,126593
140537803700000,NE 123,RESIDENTIAL,28225,0,28225,105170,0,133395
140537900100000,NE 123,RESIDENTIAL,31928,0,31928,120375,0,152303
140537900200000,NE 123,RESIDENTIAL,31928,0,31928,86574,0,118502
140537900300000,NE 123,RESIDENTIAL,33792,0,33792,125792,0,159584
140537900400000,NE 123,RESIDENTIAL,33120,0,33120,101759,0,134879
140537900500000,NE 123,RESIDENTIAL,32063,0,32063,123199,0,155262
140537900600000,NE 123,RESIDENTIAL,32952,0,32952,93809,0,126761
140537900700000,NE 123,RESIDENTIAL,32900,0,32900,84102,0,117002
140537900800000,NE 123,RESIDENTIAL,32848,0,32848,119873,0,152721
140537900900000,NE 123,RESIDENTIAL,32900,0,32900,93404,0,126304
140537901000000,NE 123,RESIDENTIAL,32900,0,32900,121788,0,154688
140537901100000,NE 123,RESIDENTIAL,32900,0,32900,94621,0,127521
140537901200000,NE 123,RESIDENTIAL,32900,0,32900,92446,0,125346
140537901300000,NE 123,RESIDENTIAL,32900,0,32900,120696,0,153596
140537901400000,NE 123,RESIDENTIAL,32900,0,32900,108976,0,141876
140537901500000,NE 123,RESIDENTIAL,32900,0,32900,118604,0,151504
140537901600000,NE 123,RESIDENTIAL,32900,0,32900,117110,0,150010
140537901700000,NE 123,RESIDENTIAL,30080,0,30080,112467,0,142547
140537901800000,NE 123,RESIDENTIAL,33983,0,33983,103024,0,137007
140538000100000,NE 123,RESIDENTIAL,5,0,5,0,0,5
140538000200000,NE 123,RESIDENTIAL,25737,0,25737,98728,0,124465
140538000300000,NE 123,RESIDENTIAL,25568,0,25568,142274,0,167842
140538000400000,NE 123,RESIDENTIAL,24440,0,24440,119917,0,144357
140538000500000,NE 123,RESIDENTIAL,26696,0,26696,114362,0,141058
140538000600000,NE 123,RESIDENTIAL,25568,0,25568,109979,0,135547
140538000700000,NE 123,RESIDENTIAL,25651,0,25651,116976,0,142627
140538000800000,NE 123,RESIDENTIAL,26655,0,26655,106810,0,133465
140538000900000,NE 123,RESIDENTIAL,24252,0,24252,104537,0,128789
140538001000000,NE 123,RESIDENTIAL,24252,0,24252,112519,0,136771
140538001100000,NE 123,RESIDENTIAL,24252,0,24252,108003,0,132255
140538001200000,NE 123,RESIDENTIAL,24252,0,24252,88816,0,113068
140538001300000,NE 123,RESIDENTIAL,24252,0,24252,101567,0,125819
140538001400000,NE 123,RESIDENTIAL,24252,0,24252,107892,0,132144
140538001500000,NE 123,RESIDENTIAL,24252,0,24252,109701,0,133953
140538001600000,NE 123,RESIDENTIAL,24293,0,24293,98563,0,122856
140538001700000,NE 123,EXEMPT,0,26235,26235,0,121114,147349
140538001800000,CHURCH,EXEMPT,0,480600,480600,0,212223,692823
140540100100000,NE 123,RESIDENTIAL,29029,0,29029,87351,0,116380
140540100200000,NE 123,RESIDENTIAL,19866,0,19866,82209,0,102075
140540100300000,NE 123,RESIDENTIAL,26488,0,26488,97768,0,124256
140540100400000,NE 123,RESIDENTIAL,28195,0,28195,116101,0,144296
140540100500000,NE 123,RESIDENTIAL,24151,0,24151,96035,0,120186
140540100600000,NE 123,RESIDENTIAL,27300,0,27300,101207,0,128507
140540200100000,CITY PROPERTY,EXEMPT,0,0,0,0,0,0
140540200200000,NE 123,RESIDENTIAL,26585,0,26585,110590,0,137175
140540200300000,NE 123,RESIDENTIAL,25370,0,25370,108219,0,133589
140540200400000,NE 123,EXEMPT,0,25542,25542,0,110996,136538
140540200500000,NE 123,RESIDENTIAL,25542,0,25542,127781,0,153323
140540200600000,NE 123,RESIDENTIAL,25542,0,25542,115273,0,140815
140540200700000,NE 123,RESIDENTIAL,25542,0,25542,115175,0,140717
140540200800000,NE 123,RESIDENTIAL,25542,0,25542,115423,0,140965
140540200900000,NE 123,RESIDENTIAL,25542,0,25542,109450,0,134992
140540201000000,NE 123,RESIDENTIAL,25542,0,25542,106982,0,132524
140540201100000,NE 123,RESIDENTIAL,25542,0,25542,100119,0,125661
140540201200000,NE 123,RESIDENTIAL,23562,0,23562,114283,0,137845
140540201300000,NE 123,RESIDENTIAL,26146,0,26146,125711,0,151857
140540201400000,NE 123,RESIDENTIAL,25202,0,25202,127997,0,153199
140540300100000,NE 123,RESIDENTIAL,28160,0,28160,127316,0,155476
140540300200000,NE 123,RESIDENTIAL,29376,0,29376,106910,0,136286
140540300300000,NE 123,RESIDENTIAL,28560,0,28560,124507,0,153067
140540300400000,NE 123,RESIDENTIAL,28560,0,28560,76989,0,105549
140540300500000,NE 123,RESIDENTIAL,28560,0,28560,115270,0,143830
140540300600000,NE 123,RESIDENTIAL,27948,0,27948,104416,0,132364
140540300700000,NE 123,RESIDENTIAL,26316,0,26316,100597,0,126913
140540300800000,NE 123,RESIDENTIAL,26316,0,26316,131166,0,157482
140540400100000,NE 123,RESIDENTIAL,26389,0,26389,107797,0,134186
140540400200000,NE 123,RESIDENTIAL,19305,0,19305,99612,0,118917
140540400300000,NE 123,RESIDENTIAL,19305,0,19305,103521,0,122826
140540400400000,NE 123,RESIDENTIAL,19305,0,19305,113403,0,132708
140540400500000,NE 123,RESIDENTIAL,19305,0,19305,92656,0,111961
140540400600000,NE 123,RESIDENTIAL,19305,0,19305,85532,0,104837
140540400700000,NE 123,RESIDENTIAL,19305,0,19305,109129,0,128434
140540400800000,NE 123,RESIDENTIAL,19305,0,19305,90653,0,109958
140540400900000,NE 123,RESIDENTIAL,19305,0,19305,101298,0,120603
140540401000000,NE 123,RESIDENTIAL,19305,0,19305,97385,0,116690
140540401100000,NE 123,RESIDENTIAL,25542,0,25542,103584,0,129126
140540401200000,NE 123,RESIDENTIAL,25542,0,25542,122859,0,148401
140540401300000,NE 123,RESIDENTIAL,27086,0,27086,105856,0,132942
140540401400000,NE 123,RESIDENTIAL,27086,0,27086,98049,0,125135
140540401500000,NE 123,RESIDENTIAL,27086,0,27086,109728,0,136814
140540401600000,NE 123,RESIDENTIAL,27086,0,27086,110399,0,137485
140540401700000,NE 123,RESIDENTIAL,26334,0,26334,98924,0,125258
140540500100000,NE 123,RESIDENTIAL,26792,0,26792,113077,0,139869
140540500200000,NE 123,RESIDENTIAL,26023,0,26023,93513,0,119536
140540500300000,NE 123,RESIDENTIAL,25800,0,25800,103809,0,129609
140540500400000,NE 123,RESIDENTIAL,25800,0,25800,108421,0,134221
140540500500000,NE 123,RESIDENTIAL,25800,0,25800,104118,0,129918
140540500600000,NE 123,RESIDENTIAL,25800,0,25800,88421,0,114221
140540500700000,NE 123,RESIDENTIAL,25800,0,25800,122729,0,148529
140540500800000,NE 123,RESIDENTIAL,25800,0,25800,107353,0,133153
140540500900000,NE 123,RESIDENTIAL,25800,0,25800,90762,0,116562
140540501000000,NE 123,RESIDENTIAL,25800,0,25800,107043,0,132843
140540501100000,NE 123,RESIDENTIAL,25800,0,25800,103979,0,129779
140540501200000,NE 123,RESIDENTIAL,25800,0,25800,120216,0,146016
140540501300000,NE 123,RESIDENTIAL,25556,0,25556,117460,0,143016
140542800200000,NE 125,RESIDENTIAL,29664,0,29664,198920,0,228584
140542800300000,NE 125,RESIDENTIAL,25298,0,25298,183056,0,208354
140542800400000,NE 125,RESIDENTIAL,24174,0,24174,218463,0,242637
140542800500000,NE 125,RESIDENTIAL,23256,0,23256,169823,0,193079
140542800600000,NE 125,RESIDENTIAL,22950,0,22950,185688,0,208638
140542800700000,NE 125,RESIDENTIAL,23256,0,23256,180896,0,204152
140542800800000,NE 125,RESIDENTIAL,22950,0,22950,215757,0,238707
140542800900000,NE 125,RESIDENTIAL,22950,0,22950,178515,0,201465
140542801000000,NE 125,RESIDENTIAL,23256,0,23256,205544,0,228800
140542900100000,NE 125,RESIDENTIAL,25075,0,25075,206016,0,231091
140542900200000,NE 125,RESIDENTIAL,23280,0,23280,190898,0,214178
140542900300000,NE 125,RESIDENTIAL,25143,0,25143,191164,0,216307
140542900400000,NE 125,RESIDENTIAL,22758,0,22758,161508,0,184266
140542900500000,NE 125,RESIDENTIAL,21600,0,21600,134275,0,155875
140542900600000,NE 125,RESIDENTIAL,23700,0,23700,175528,0,199228
140542900700000,NE 125,RESIDENTIAL,22200,0,22200,165294,0,187494
140542900800000,NE 125,RESIDENTIAL,21600,0,21600,155194,0,176794
140542900900000,NE 125,RESIDENTIAL,23700,0,23700,200884,0,224584
140542901000000,NE 125,RESIDENTIAL,22200,0,22200,171428,0,193628
140542901100000,NE 125,RESIDENTIAL,24000,0,24000,181577,0,205577
140542901200000,NE 125,RESIDENTIAL,24000,0,24000,176088,0,200088
140542901300000,NE 125,RESIDENTIAL,22800,0,22800,176667,0,199467
140542901400000,NE 125,RESIDENTIAL,22800,0,22800,197510,0,220310
140542901500000,NE 125,RESIDENTIAL,24000,0,24000,186751,0,210751
140542901600000,NE 125,RESIDENTIAL,22800,0,22800,184190,0,206990
140542901700000,NE 125,RESIDENTIAL,23632,0,23632,254982,0,278614
140543000100000,NE 125,RESIDENTIAL,27173,0,27173,184618,0,211791
140543000200000,NE 125,RESIDENTIAL,24385,0,24385,178868,0,203253
140543000300000,NE 125,RESIDENTIAL,24480,0,24480,164573,0,189053
140543000400000,NE 125,RESIDENTIAL,24480,0,24480,176300,0,200780
140543000500000,NE 125,RESIDENTIAL,24480,0,24480,157806,0,182286
140543000600000,NE 125,RESIDENTIAL,24480,0,24480,138568,0,163048
140543000700000,NE 125,RESIDENTIAL,24480,0,24480,180815,0,205295
140545100300000,CHURCH,EXEMPT,0,461376,461376,0,1396792,1858168
140545200200000,NE 125,RESIDENTIAL,23939,0,23939,179790,0,203729
140545200300000,NE 125,RESIDENTIAL,26006,0,26006,195848,0,221854
140545200400000,NE 125,RESIDENTIAL,25793,0,25793,194919,0,220712
140545200500000,NE 125,RESIDENTIAL,24371,0,24371,170239,0,194610
140545200600000,NE 125,RESIDENTIAL,22800,0,22800,177028,0,199828
140545200700000,NE 125,RESIDENTIAL,26350,0,26350,135230,0,161580
140545300100000,NE 125,RESIDENTIAL,25650,0,25650,215691,0,241341
140545300200000,NE 125,RESIDENTIAL,25650,0,25650,173153,0,198803
140545400100000,NE 125,RESIDENTIAL,24480,0,24480,166033,0,190513
140545400200000,NE 125,RESIDENTIAL,24480,0,24480,138433,0,162913
140545400300000,NE 125,RESIDENTIAL,23856,0,23856,163378,0,187234
140545400400000,NE 125,RESIDENTIAL,25725,0,25725,178954,0,204679
140545400500000,NE 125,RESIDENTIAL,26468,0,26468,171912,0,198380
140545400600000,NE 125,RESIDENTIAL,25288,0,25288,159533,0,184821
140545400700000,NE 125,RESIDENTIAL,23837,0,23837,144483,0,168320
140545400800000,NE 125,RESIDENTIAL,26177,0,26177,216729,0,242906
140545400900000,NE 125,RESIDENTIAL,25913,0,25913,199704,0,225617
140545500200000,CHURCH,EXEMPT,0,572400,572400,0,1921540,2493940
140547600100000,NE 123,RESIDENTIAL,26316,0,26316,115123,0,141439
140547600200000,NE 123,RESIDENTIAL,26316,0,26316,95250,0,121566
140547600300000,NE 123,RESIDENTIAL,26316,0,26316,118235,0,144551
140547600400000,NE 123,RESIDENTIAL,26316,0,26316,117283,0,143599
140547600500000,NE 123,RESIDENTIAL,26316,0,26316,116159,0,142475
140547600600000,NE 123,RESIDENTIAL,26316,0,26316,107949,0,134265
140547600700000,NE 123,RESIDENTIAL,26316,0,26316,110085,0,136401
140547600800000,NE 123,RESIDENTIAL,29249,0,29249,95746,0,124995
140547600900000,NE 123,RESIDENTIAL,29718,0,29718,105567,0,135285
140547601000000,NE 123,RESIDENTIAL,28682,0,28682,104607,0,133289
140547601100000,NE 123,RESIDENTIAL,25628,0,25628,104699,0,130327
140547601200000,NE 123,EXEMPT,0,26880,26880,0,109523,136403
140547601300000,NE 123,RESIDENTIAL,26880,0,26880,99367,0,126247
140547601400000,CITY PROPERTY,EXEMPT,0,0,0,0,0,0
140547601500000,CHURCH,EXEMPT,0,473472,473472,0,1474881,1948353
140547601600000,SCHOOL,EXEMPT,0,0,0,0,0,0
140547700100000,NE 123,RESIDENTIAL,25740,0,25740,112466,0,138206
140547700200000,NE 123,RESIDENTIAL,19305,0,19305,122163,0,141468
140547700300000,NE 123,RESIDENTIAL,19157,0,19157,99130,0,118287
140547700400000,NE 123,RESIDENTIAL,19157,0,19157,116924,0,136081
140547700500000,NE 123,RESIDENTIAL,19157,0,19157,91178,0,110335
140547700600000,NE 123,RESIDENTIAL,19157,0,19157,94393,0,113550
140547700700000,NE 123,RESIDENTIAL,19157,0,19157,91815,0,110972
140547700800000,NE 123,RESIDENTIAL,19157,0,19157,96180,0,115337
140547700900000,NE 123,RESIDENTIAL,20196,0,20196,93577,0,113773
140547701000000,NE 123,RESIDENTIAL,26384,0,26384,90414,0,116798
140547701100000,NE 123,RESIDENTIAL,25542,0,25542,100376,0,125918
140547701200000,NE 123,RESIDENTIAL,25542,0,25542,81477,0,107019
140547701300000,NE 123,RESIDENTIAL,25542,0,25542,85666,0,111208
140547701400000,NE 123,RESIDENTIAL,25542,0,25542,95266,0,120808
140547701500000,NE 123,RESIDENTIAL,25542,0,25542,88739,0,114281
140547701600000,NE 123,RESIDENTIAL,25542,0,25542,91787,0,117329
140547800100000,SCHOOL,EXEMPT,0,0,0,0,0,0
140610200100000,BRANCH BANK/CU,COMMERCIAL,0,485000,485000,0,1810723,2295723
140610200200000,FAST FOOD,COMMERCIAL,0,485000,485000,0,1179308,1664308
140610300100000,CONVENIENCE STORE,COMMERCIAL,0,550900,550900,0,536861,1087761
140610300200000,NE 168,RESIDENTIAL,33740,0,33740,63189,0,96929
140612800100000,CHURCH,EXEMPT,0,69806,69806,0,39935,109741
140612800200000,NE 168,RESIDENTIAL,51800,0,51800,0,0,51800
140612800300000,NE 168,RESIDENTIAL,52350,0,52350,0,0,52350
140612900100000,NE 168,AG LAND,35111,0,35111,0,0,35111
140612900300000,SHOP,COMMERCIAL,0,117000,117000,0,205197,322197
140612900400000,NE 168,RESIDENTIAL,53300,0,53300,195616,0,248916
140612900500000,NE 168,RESIDENTIAL,5825,0,5825,0,0,5825
140615100100000,NE 168,AG LAND,18119,0,18119,0,0,18119
140615200200000,NE 168,AG LAND,30353,0,30353,0,1417,31770
140615200400000,STATE PROPERTY,EXEMPT,0,0,0,0,0,0
140617600100000,NE 168,AG LAND,29296,0,29296,0,0,29296
140617600300000,FAST FOOD,COMMERCIAL,0,468000,468000,0,693144,1161144
140617600400000,BRANCH BANK/CU,COMMERCIAL,0,728020,728020,0,592312,1320332
140617600500000,GROCERY STORE,COMMERCIAL,0,1135620,1135620,0,5464380,6600000
140617600800000,NBHD SHOPPING CENTER,COMMERCIAL,0,400020,400020,0,949834,1349854
140617600900000,NBHD SHOPPING CENTER,COMMERCIAL,0,800020,800020,0,1454893,2254913
140617601000000,VACANT LAND,COMMERCIAL,0,20,20,0,0,20
140617601100000,FLAT PARKING,COMMERCIAL,0,102020,102020,0,35259,137279
140617601400000,VACANT LAND,COMMERCIAL,0,783900,783900,0,0,783900
140617601500000,RESTAURANT,COMMERCIAL,0,560020,560020,0,639980,1200000
140620100200000,NE 168,AG DWELLING,25695,0,25695,213143,1470,240308
140620100300000,NE 168,RESIDENTIAL,62150,0,62150,117702,0,179852
140620100400000,NE 168,RESIDENTIAL,55625,0,55625,124015,0,179640
140620100500000,NE 168,RESIDENTIAL,40320,0,40320,112094,0,152414
140620100600000,NE 168,RESIDENTIAL,32549,0,32549,126137,0,158686
140620100700000,NE 168,RESIDENTIAL,32175,0,32175,115616,0,147791
140620200100000,NE 168,RESIDENTIAL,45319,0,45319,102595,0,147914
140620200200000,NE 168,AG DWELLING,2687,0,2687,122830,8161,133678
140620200300000,NE 168,AG LAND,5112,0,5112,0,0,5112
140620200400000,NE 168,RESIDENTIAL,45544,0,45544,0,0,45544
140620200500000,NE 168,RESIDENTIAL,45544,0,45544,183575,0,229119
140620200600000,NE 168,RESIDENTIAL,56525,0,56525,59310,0,115835
140620200700000,NE 168,RESIDENTIAL,45675,0,45675,152878,0,198553
140620200800000,NE 168,RESIDENTIAL,45675,0,45675,132398,0,178073
140620300200000,NE 168,RESIDENTIAL,50975,0,50975,79981,0,130956
140620300300000,NE 168,RESIDENTIAL,54850,0,54850,254747,0,309597
140620300500000,NE 168,RESIDENTIAL,67450,0,67450,171798,0,239248
140622600300000,NE 168,RESIDENTIAL,10350,0,10350,0,0,10350
140622600400000,NE 172,RESIDENTIAL,2800,0,2800,0,0,2800
140622600500000,NE 172,RESIDENTIAL,56100,0,56100,16237,0,72337
140623000100000,NE 172,RESIDENTIAL,44031,0,44031,157385,0,201416
140623000200000,NE 172,RESIDENTIAL,44319,0,44319,191919,0,236238
140623100100000,NE 172,RESIDENTIAL,39756,0,39756,130859,0,170615
140623100200000,NE 172,RESIDENTIAL,39015,0,39015,131903,0,170918
140623100300000,NE 172,RESIDENTIAL,39015,0,39015,130577,0,169592
140623100400000,NE 172,RESIDENTIAL,39015,0,39015,129453,0,168468
140623100500000,NE 172,RESIDENTIAL,39039,0,39039,128012,0,167051
140623100600000,NE 172,RESIDENTIAL,41367,0,41367,192397,0,233764
140623100700000,NE 172,RESIDENTIAL,41488,0,41488,163359,0,204847
140625100100000,NE 168,AG LAND,4126,0,4126,0,0,4126
140625100700000,NE 168,AG LAND,3035,0,3035,0,0,3035
140625200100000,OFFICE,COMMERCIAL,0,540840,540840,0,2276491,2817331
140627600100000,NE 168,AG LAND,33132,0,33132,0,0,33132
140627600200000,NE 168,RESIDENTIAL,30375,0,30375,69783,0,100158
140627600300000,CITY PROPERTY,EXEMPT,0,0,0,0,0,0
140627600400000,OFFICE,COMMERCIAL,0,523000,523000,0,3834416,4357416
140627600500000,OFFICE,COMMERCIAL,0,312000,312000,0,1206950,1518950
140627600600000,OFFICE; MEDICAL,COMMERCIAL,0,185000,185000,0,687240,872240
140630100100000,OFFICE,COMMERCIAL,0,280000,280000,0,904088,1184088
140630200100000,FLAT PARKING,COMMERCIAL,0,142500,142500,0,101936,244436
140630200200000,OFFICE,COMMERCIAL,0,826040,826040,0,12650075,13476115
140630200300000,NE 168,AG LAND,10915,0,10915,0,0,10915
140630200500000,NE 127,RESIDENTIAL,79100,0,79100,308788,0,387888
140630200600000,NE 127,RESIDENTIAL,85124,0,85124,331885,0,417009
140630200700000,NE 127,RESIDENTIAL,87552,0,87552,312448,0,400000
140630200800000,NE 127,RESIDENTIAL,96075,0,96075,316517,0,412592
140630200900000,NE 127,RESIDENTIAL,79411,0,79411,324601,0,404012
140630201000000,NE 127,RESIDENTIAL,81270,0,81270,285785,0,367055
140630201100000,NE 127,RESIDENTIAL,78240,0,78240,331361,0,409601
140630201200000,NE 127,RESIDENTIAL,81573,0,81573,326394,0,407967
140630201400000,NE 127,RESIDENTIAL,67369,0,67369,306701,0,374070
140630201500000,NE 127,RESIDENTIAL,67461,0,67461,296376,0,363837
140630201600000,NE 127,RESIDENTIAL,71035,0,71035,308347,0,379382
140630201700000,NE 127,RESIDENTIAL,69508,0,69508,370099,0,439607
140630201800000,NE 127,RESIDENTIAL,67124,0,67124,325434,0,392558
140630201900000,NE 127,RESIDENTIAL,67238,0,67238,352556,0,419794
140630202000000,NE 127,RESIDENTIAL,87926,0,87926,373768,0,461694
140630202100000,NE 127,RESIDENTIAL,67660,0,67660,413464,0,481124
140630202200000,NE 127,RESIDENTIAL,69536,0,69536,330451,0,399987
140630202300000,NE 127,RESIDENTIAL,71324,0,71324,342511,0,413835
140630202400000,NE 127,RESIDENTIAL,57500,0,57500,0,0,57500
140630202500000,NE 127,RESIDENTIAL,64802,0,64802,371363,0,436165
140630202600000,NE 127,RESIDENTIAL,95285,0,95285,408213,0,503498
140630202700000,NE 127,RESIDENTIAL,91825,0,91825,228175,0,320000
140630300100000,NE 127,RESIDENTIAL,81605,0,81605,326754,0,408359
140630300200000,NE 127,RESIDENTIAL,91741,0,91741,296242,0,387983
140630300300000,NE 127,RESIDENTIAL,86205,0,86205,363574,0,449779
140630300400000,NE 127,RESIDENTIAL,88000,0,88000,291498,0,379498
140630300500000,NE 127,RESIDENTIAL,96507,0,96507,347478,0,443985
140630300600000,NE 127,RESIDENTIAL,92215,0,92215,271161,0,363376
140630300700000,NE 127,RESIDENTIAL,90862,0,90862,369710,0,460572
140630300800000,NE 127,RESIDENTIAL,109386,0,109386,398424,0,507810
140630300900000,NE 127,RESIDENTIAL,76868,0,76868,302874,0,379742
140630301000000,NE 127,RESIDENTIAL,74038,0,74038,0,0,74038
140632800100000,NE 161,RESIDENTIAL,1824,0,1824,0,0,1824
140632800200000,NE 161,RESIDENTIAL,45870,0,45870,203617,0,249487
140632800300000,NE 161,RESIDENTIAL,42500,0,42500,251032,0,293532
140633000100000,NE 161,RESIDENTIAL,948,0,948,0,0,948
140633000200000,NE 161,RESIDENTIAL,47798,0,47798,220840,0,268638
140635100100000,NE 128,RESIDENTIAL,73987,0,73987,466829,0,540816
140635100200000,NE 128,RESIDENTIAL,102696,0,102696,514931,0,617627
140635100300000,NE 128,RESIDENTIAL,102800,0,102800,671541,0,774341
140635100400000,NE 128,RESIDENTIAL,85564,0,85564,249889,0,335453
140635100500000,NE 128,RESIDENTIAL,103700,0,103700,385000,0,488700
140635100600000,NE 128,RESIDENTIAL,101700,0,101700,339107,0,440807
140635100700000,NE 128,RESIDENTIAL,94513,0,94513,285586,0,380099
140635100800000,NE 128,RESIDENTIAL,108500,0,108500,767620,0,876120
140635100900000,NE 128,RESIDENTIAL,99006,0,99006,388177,0,487183
140635101000000,NE 128,RESIDENTIAL,75621,0,75621,337843,0,413464
140635101100000,NE 128,RESIDENTIAL,102900,0,102900,536753,0,639653
140635101200000,NE 128,RESIDENTIAL,3200,0,3200,0,0,3200
140635101300000,NE 128,RESIDENTIAL,103200,0,103200,625000,0,728200
140635101400000,NE 128,RESIDENTIAL,100800,0,100800,474065,0,574865
140635101500000,NE 128,RESIDENTIAL,75822,0,75822,487012,0,562834
140635101600000,NE 128,RESIDENTIAL,78480,0,78480,325858,0,404338
140635101700000,NE 128,RESIDENTIAL,80501,0,80501,303308,0,383809
140635101800000,NE 128,RESIDENTIAL,103900,0,103900,450781,0,554681
140635101900000,NE 128,RESIDENTIAL,104600,0,104600,504995,0,609595
140635102000000,NE 128,RESIDENTIAL,96000,0,96000,387622,0,483622
140635102100000,NE 128,RESIDENTIAL,104261,0,104261,375366,0,479627
140635102200000,NE 128,RESIDENTIAL,82678,0,82678,399162,0,481840
140635102300000,NE 128,RESIDENTIAL,38792,0,38792,167950,0,206742
140635102400000,NE 128,RESIDENTIAL,39046,0,39046,127573,0,166619
140635102500000,NE 128,RESIDENTIAL,33660,0,33660,206292,0,239952
140635102600000,NE 128,RESIDENTIAL,38750,0,38750,80120,0,118870
140635200100000,NE 128,RESIDENTIAL,91317,0,91317,318258,0,409575
140635200200000,NE 128,RESIDENTIAL,95962,0,95962,722655,0,818617
140635200400000,NE 128,RESIDENTIAL,21723,0,21723,6621,0,28344
140635200500000,NE 128,RESIDENTIAL,21723,0,21723,79032,0,100755
140635200600000,NE 128,RESIDENTIAL,54332,0,54332,0,0,54332
140635200700000,NE 128,RESIDENTIAL,80325,0,80325,282881,0,363206
140637600100000,NE 127,RESIDENTIAL,57570,0,57570,277237,0,334807
140637600200000,NE 127,RESIDENTIAL,57570,0,57570,250739,0,308309
140637600300000,NE 127,RESIDENTIAL,57570,0,57570,281177,0,338747
140637600400000,NE 127,RESIDENTIAL,57570,0,57570,249851,0,307421
140637600500000,NE 127,RESIDENTIAL,72720,0,72720,306786,0,379506
140637600600000,NE 127,RESIDENTIAL,64387,0,64387,223067,0,287454
140637600700000,NE 127,RESIDENTIAL,60600,0,60600,267844,0,328444
140637600800000,NE 127,RESIDENTIAL,58387,0,58387,268331,0,326718
140637600900000,NE 127,RESIDENTIAL,65426,0,65426,235014,0,300440
140637601000000,NE 127,RESIDENTIAL,65484,0,65484,258326,0,323810
140637601100000,NE 127,RESIDENTIAL,71162,0,71162,292971,0,364133
140637601200000,NE 127,RESIDENTIAL,65510,0,65510,234550,0,300060
140637601300000,NE 127,RESIDENTIAL,59500,0,59500,216179,0,275679
140637601400000,NE 127,RESIDENTIAL,62849,0,62849,278536,0,341385
140637601500000,NE 127,RESIDENTIAL,66553,0,66553,290101,0,356654
140637601600000,NE 127,RESIDENTIAL,65313,0,65313,314352,0,379665
140637601700000,NE 127,RESIDENTIAL,71000,0,71000,321744,0,392744
140637601800000,NE 127,RESIDENTIAL,95918,0,95918,278759,0,374677
140637601900000,NE 127,RESIDENTIAL,88873,0,88873,206639,0,295512
140637602000000,NE 127,RESIDENTIAL,115700,0,115700,164586,0,280286
140637602100000,NE 127,RESIDENTIAL,110500,0,110500,151711,0,262211
140637602200000,NE 127,RESIDENTIAL,100600,0,100600,207770,0,308370
140637602300000,NE 127,RESIDENTIAL,74800,0,74800,102542,0,177342
140637602400000,NE 127,RESIDENTIAL,60250,0,60250,114798,0,175048
140637602500000,DAY CARE CENTER,COMMERCIAL,0,217000,217000,0,397072,614072
140637602600000,NE 127,RESIDENTIAL,66680,0,66680,386289,0,452969
140637602700000,NE 127,RESIDENTIAL,85,0,85,0,0,85
140637700100000,NE 127,RESIDENTIAL,76304,0,76304,227368,0,303672
140637700300000,NE 127,RESIDENTIAL,81764,0,81764,251907,0,333671
140637800100000,NE 127,RESIDENTIAL,79683,0,79683,282849,0,362532
140637800200000,NE 127,RESIDENTIAL,80109,0,80109,343905,0,424014
140637800300000,NE 127,RESIDENTIAL,79490,0,79490,222688,0,302178
140637800400000,NE 127,RESIDENTIAL,78540,0,78540,346699,0,425239
140637800500000,NE 127,RESIDENTIAL,78540,0,78540,336521,0,415061
140637800600000,NE 127,RESIDENTIAL,101795,0,101795,244035,0,345830
140637800700000,NE 127,RESIDENTIAL,73920,0,73920,166080,0,240000
140637800800000,NE 127,RESIDENTIAL,69942,0,69942,270136,0,340078
140637800900000,NE 127,RESIDENTIAL,71832,0,71832,274860,0,346692
140637801000000,NE 127,RESIDENTIAL,73092,0,73092,180734,0,253826
140637801100000,NE 127,RESIDENTIAL,68363,0,68363,254535,0,322898
140637801200000,NE 127,RESIDENTIAL,72832,0,72832,282897,0,355729
140637801300000,NE 127,RESIDENTIAL,74060,0,74060,173070,0,247130
140637801400000,NE 127,RESIDENTIAL,69724,0,69724,259476,0,329200
140637801500000,NE 127,RESIDENTIAL,68782,0,68782,263281,0,332063
140637801600000,NE 127,RESIDENTIAL,68340,0,68340,257715,0,326055
140637801700000,NE 127,RESIDENTIAL,70928,0,70928,280545,0,351473
140637801800000,NE 127,RESIDENTIAL,67575,0,67575,243235,0,310810
140637801900000,NE 127,RESIDENTIAL,70676,0,70676,343369,0,414045
140637802000000,NE 127,RESIDENTIAL,72733,0,72733,403934,0,476667
140642600100000,NE 127,AG LAND,26290,0,26290,0,0,26290
140642600200000,OFFICE,COMMERCIAL,0,410000,410000,0,1171436,1581436
140642700100000,OFFICE,COMMERCIAL,0,747900,747900,0,16752100,17500000
140645100100000,OFFICE,COMMERCIAL,0,1685440,1685440,0,10332436,12017876
140645100200000,FLAT PARKING,COMMERCIAL,0,196500,196500,0,130173,326673
140645100300000,OFFICE,COMMERCIAL,0,49500,49500,0,4790472,4839972
140710100100000,BRANCH BANK/CU,COMMERCIAL,0,338000,338000,0,623893,961893
140710100200000,RESTAURANT,COMMERCIAL,0,310000,310000,0,417446,727446
140710100300000,OFFICE,COMMERCIAL,0,285000,285000,0,803121,1088121
140710100400000,OFFICE,COMMERCIAL,0,177000,177000,0,955397,1132397
140710100500000,OFFICE,COMMERCIAL,0,326280,326280,0,1502431,1828711
140710100600000,FLAT PARKING,COMMERCIAL,0,123525,123525,0,28361,151886
140710100700000,OFFICE,COMMERCIAL,0,159000,159000,0,623621,782621
140710100800000,OFFICE; MEDICAL,COMMERCIAL,0,78400,78400,0,335756,414156
140710100900000,OFFICE,COMMERCIAL,0,70933,70933,0,210648,281581
140710101000000,OFFICE,COMMERCIAL,0,333200,333200,0,634749,967949
140710101001000,OFFICE; MEDICAL,COMMERCIAL,0,165235,165235,0,585291,750526
140710101001001,OFFICE,COMMERCIAL,0,165235,165235,0,553640,718875
140710200100000,VACANT LAND,COMMERCIAL,0,1630950,1630950,0,0,1630950
140710200200000,OFFICE,COMMERCIAL,0,318000,318000,0,921828,1239828
140710200300000,OFFICE,COMMERCIAL,0,108450,108450,0,375331,483781
140710200400000,OFFICE; MEDICAL,COMMERCIAL,0,118350,118350,0,353873,472223
140710300100000,OFFICE,COMMERCIAL,0,286500,286500,0,1211168,1497668
140710300200000,OFFICE,EXEMPT,0,170381,170381,0,731096,901477
140710300300000,OFFICE,COMMERCIAL,0,617000,617000,0,2069384,2686384
140712600100000,CHURCH,EXEMPT,0,683640,683640,0,396962,1080602
140712600200000,NE 140,RESIDENTIAL,48377,0,48377,98972,0,147349
140712700400000,NE 140,RESIDENTIAL,50150,0,50150,179757,0,229907
140712700500000,NE 140,RESIDENTIAL,50015,0,50015,176303,0,226318
140712700700000,NE 140,RESIDENTIAL,50150,0,50150,117407,0,167557
140712800700000,NE 140,RESIDENTIAL,44550,0,44550,133067,0,177617
140712800800000,NE 140,RESIDENTIAL,45450,0,45450,86424,0,131874
140712800900000,NE 140,RESIDENTIAL,44175,0,44175,105124,0,149299
140712900100000,NE 140,RESIDENTIAL,2900,0,2900,0,0,2900
140715100100000,NE 140,RESIDENTIAL,50250,0,50250,167396,0,217646
140715100700000,NE 140,RESIDENTIAL,45500,0,45500,183951,0,229451
140715100800000,NE 140,RESIDENTIAL,45500,0,45500,159199,0,204699
140715300200000,NE 140,RESIDENTIAL,45150,0,45150,148003,0,193153
140715400100000,VACANT LAND,COMMERCIAL,0,245400,245400,0,0,245400
140717600100000,OFFICE,COMMERCIAL,0,119586,119586,0,355004,474590
140717600200000,OFFICE,COMMERCIAL,0,130680,130680,0,356346,487026
140717600300000,OFFICE,COMMERCIAL,0,102177,102177,0,361721,463898
140717600600000,OFFICE; MEDICAL,COMMERCIAL,0,230000,230000,0,733263,963263
140717600800000,OFFICE,COMMERCIAL,0,82335,82335,0,307707,390042
140717600900000,FLAT PARKING,COMMERCIAL,0,86650,86650,0,3847,90497
140717700100000,OFFICE,COMMERCIAL,0,230000,230000,0,493523,723523
140717800100000,OFFICE,COMMERCIAL,0,153200,153200,0,549434,702634
140717800200000,OFFICE,COMMERCIAL,0,419000,419000,0,364601,783601
140717900900000,NE 138,RESIDENTIAL,73614,0,73614,0,0,73614
140717901000000,NE 138,RESIDENTIAL,55982,0,55982,343820,0,399802
140717901100000,NE 138,RESIDENTIAL,77163,0,77163,279677,0,356840
140717901200000,NE 138,RESIDENTIAL,68508,0,68508,290529,0,359037
140717901300000,NE 138,RESIDENTIAL,70632,0,70632,311781,0,382413
140717901400000,NE 138,RESIDENTIAL,80039,0,80039,291400,0,371439
140718000100000,OFFICE; MEDICAL,COMMERCIAL,0,125500,125500,0,592287,717787
140718000400000,OFFICE; MEDICAL,COMMERCIAL,0,174000,174000,0,218017,392017
140718000700000,NE 138,RESIDENTIAL,57570,0,57570,276904,0,334474
140718000800000,NE 138,RESIDENTIAL,51859,0,51859,0,0,51859
140718000900000,NE 138,RESIDENTIAL,54605,0,54605,255395,0,310000
140718001000000,OFFICE; MEDICAL,COMMERCIAL,0,174000,174000,0,712953,886953
140718001100000,OFFICE,COMMERCIAL,0,318060,318060,0,1178414,1496474
140718001400000,OFFICE; MEDICAL,COMMERCIAL,0,138700,138700,0,644806,783506
140718001500000,NE 138,RESIDENTIAL,55000,0,55000,0,0,55000
140718001600000,NE 138,RESIDENTIAL,74112,0,74112,261523,0,335635
140720100100000,NE 140,RESIDENTIAL,28950,0,28950,142208,0,171158
140720100200000,NE 140,RESIDENTIAL,28980,0,28980,171023,0,200003
140720100300000,NE 140,RESIDENTIAL,29389,0,29389,151840,0,181229
140720100400000,NE 140,RESIDENTIAL,26780,0,26780,158837,0,185617
140720100500000,NE 140,RESIDENTIAL,26780,0,26780,131692,0,158472
140720100600000,NE 140,RESIDENTIAL,26520,0,26520,146203,0,172723
140720100700000,NE 140,RESIDENTIAL,27200,0,27200,156215,0,183415
140720100800000,NE 140,RESIDENTIAL,28156,0,28156,159495,0,187651
140720100900000,NE 140,RESIDENTIAL,28154,0,28154,150530,0,178684
140720101000000,NE 140,RESIDENTIAL,27820,0,27820,133282,0,161102
140720101100000,NE 140,RESIDENTIAL,27560,0,27560,164063,0,191623
140720101200000,NE 140,RESIDENTIAL,32136,0,32136,197171,0,229307
140720101300000,NE 140,RESIDENTIAL,30272,0,30272,169702,0,199974
140720101400000,NE 140,RESIDENTIAL,30223,0,30223,173227,0,203450
140720101500000,NE 140,RESIDENTIAL,30106,0,30106,166075,0,196181
140720101600000,NE 140,RESIDENTIAL,20929,0,20929,145958,0,166887
140720101700000,NE 140,RESIDENTIAL,22266,0,22266,165352,0,187618
140720101800000,NE 140,RESIDENTIAL,19344,0,19344,148741,0,168085
140720101900000,NE 140,RESIDENTIAL,24779,0,24779,163931,0,188710
140720102000000,NE 140,RESIDENTIAL,23888,0,23888,183464,0,207352
140720102100000,NE 140,RESIDENTIAL,2355,0,2355,0,0,2355
140720102200000,NE 140,RESIDENTIAL,27596,0,27596,147933,0,175529
140720102300000,NE 140,RESIDENTIAL,22660,0,22660,171600,0,194260
140720102400000,NE 140,RESIDENTIAL,23540,0,23540,153881,0,177421
140720102500000,NE 140,RESIDENTIAL,23760,0,23760,155571,0,179331
140720102600000,NE 140,RESIDENTIAL,23540,0,23540,175750,0,199290
140720102700000,NE 140,RESIDENTIAL,25060,0,25060,159608,0,184668
140720102800000,NE 140,RESIDENTIAL,28347,0,28347,163169,0,191516
140720102900000,NE 140,RESIDENTIAL,28401,0,28401,182075,0,210476
140720103000000,NE 140,RESIDENTIAL,25900,0,25900,168947,0,194847
140720103100000,NE 158,RESIDENTIAL,36214,0,36214,233126,0,269340
140720103200000,NE 158,RESIDENTIAL,34096,0,34096,243297,0,277393
140720103300000,NE 158,RESIDENTIAL,32640,0,32640,240547,0,273187
140720103400000,NE 158,RESIDENTIAL,30608,0,30608,207259,0,237867
140720103500000,NE 158,RESIDENTIAL,31624,0,31624,226306,0,257930
140720103600000,NE 158,RESIDENTIAL,31624,0,31624,213517,0,245141
140720103700000,NE 158,RESIDENTIAL,31624,0,31624,191118,0,222742
140720103800000,NE 158,RESIDENTIAL,31624,0,31624,198045,0,229669
140720103900000,NE 158,RESIDENTIAL,33136,0,33136,206598,0,239734
140720104000000,NE 140,RESIDENTIAL,3500,0,3500,0,0,3500
140720104100000,NE 152,RESIDENTIAL,26962,0,26962,195604,0,222566
140720104200000,NE 152,RESIDENTIAL,28166,0,28166,250243,0,278409
140720104300000,NE 152,RESIDENTIAL,26906,0,26906,247765,0,274671
140720200200000,NE 140,RESIDENTIAL,4400,0,4400,0,0,4400
140720200300000,NE 140,RESIDENTIAL,16200,0,16200,140661,0,156861
140720200400000,NE 140,RESIDENTIAL,6720,0,6720,113410,0,120130
140720200500000,NE 140,RESIDENTIAL,7216,0,7216,117412,0,124628
140720200600000,NE 140,RESIDENTIAL,7488,0,7488,131123,0,138611
140720200700000,NE 140,RESIDENTIAL,7296,0,7296,134158,0,141454
140720200800000,NE 140,RESIDENTIAL,12827,0,12827,136325,0,149152
140720200900000,NE 140,RESIDENTIAL,4000,0,4000,0,0,4000
140720201000000,NE 140,RESIDENTIAL,13500,0,13500,143055,0,156555
140720201100000,NE 140,RESIDENTIAL,6240,0,6240,107402,0,113642
140720201200000,NE 140,RESIDENTIAL,6952,0,6952,115468,0,122420
140720201300000,NE 140,RESIDENTIAL,7488,0,7488,126775,0,134263
140720201400000,NE 140,RESIDENTIAL,7392,0,7392,132367,0,139759
140720201500000,NE 140,RESIDENTIAL,14040,0,14040,134781,0,148821
140720201600000,NE 140,RESIDENTIAL,27648,0,27648,164796,0,192444
140720201700000,NE 140,RESIDENTIAL,27548,0,27548,160343,0,187891
140720201800000,NE 140,RESIDENTIAL,21120,0,21120,141976,0,163096
140720201900000,NE 140,RESIDENTIAL,25161,0,25161,167924,0,193085
140720202000000,NE 140,RESIDENTIAL,21763,0,21763,147261,0,169024
140720202100000,NE 140,RESIDENTIAL,20253,0,20253,150943,0,171196
140720202200000,NE 140,RESIDENTIAL,25207,0,25207,145364,0,170571
140720202300000,NE 140,RESIDENTIAL,23796,0,23796,154727,0,178523
140720202400000,NE 140,RESIDENTIAL,27412,0,27412,142028,0,169440
140720202500000,NE 140,RESIDENTIAL,21460,0,21460,142745,0,164205
140720202600000,NE 140,RESIDENTIAL,25931,0,25931,150647,0,176578
140720202700000,NE 140,RESIDENTIAL,17712,0,17712,152252,0,169964
140720202800000,NE 140,RESIDENTIAL,25476,0,25476,137395,0,162871
140720202900000,NE 140,RESIDENTIAL,25595,0,25595,169544,0,195139
140720203000000,NE 140,RESIDENTIAL,28043,0,28043,156849,0,184892
140720203100000,NE 140,RESIDENTIAL,24600,0,24600,148086,0,172686
140720203200000,NE 140,RESIDENTIAL,27360,0,27360,161709,0,189069
140720203300000,NE 140,RESIDENTIAL,23040,0,23040,149696,0,172736
140720203400000,NE 140,RESIDENTIAL,20736,0,20736,136411,0,157147
140720203500000,NE 140,RESIDENTIAL,22079,0,22079,150171,0,172250
140720203600000,NE 140,RESIDENTIAL,27309,0,27309,141689,0,168998
140720203700000,NE 140,RESIDENTIAL,23781,0,23781,144438,0,168219
140720203800000,NE 140,RESIDENTIAL,23296,0,23296,131296,0,154592
140720203900000,NE 140,RESIDENTIAL,23040,0,23040,149355,0,172395
140720204000000,NE 140,RESIDENTIAL,24444,0,24444,145476,0,169920
140720204100000,NE 140,RESIDENTIAL,22666,0,22666,137897,0,160563
140720204200000,NE 140,RESIDENTIAL,27904,0,27904,165745,0,193649
140720204300000,NE 140,RESIDENTIAL,25024,0,25024,161219,0,186243
140720204400000,NE 152,RESIDENTIAL,21739,0,21739,214049,0,235788
140720204500000,NE 152,RESIDENTIAL,20564,0,20564,201805,0,222369
140720204700000,NE 152,RESIDENTIAL,20564,0,20564,237349,0,257913
140720204800000,NE 152,RESIDENTIAL,20564,0,20564,218165,0,238729
140720204900000,NE 152,RESIDENTIAL,21747,0,21747,231327,0,253074
140720205000000,NE 152,RESIDENTIAL,21762,0,21762,237011,0,258773
140720205100000,NE 152,RESIDENTIAL,20564,0,20564,203576,0,224140
140720205200000,NE 152,RESIDENTIAL,20564,0,20564,243322,0,263886
140720205300000,NE 152,RESIDENTIAL,20564,0,20564,250241,0,270805
140720205400000,NE 152,RESIDENTIAL,20564,0,20564,224336,0,244900
140720205500000,NE 152,RESIDENTIAL,21777,0,21777,255254,0,277031
140720205600000,NE 152,RESIDENTIAL,29642,0,29642,256751,0,286393
140720205700000,NE 152,RESIDENTIAL,20564,0,20564,239782,0,260346
140720205800000,NE 152,RESIDENTIAL,20564,0,20564,239071,0,259635
140720205900000,NE 152,RESIDENTIAL,29652,0,29652,244671,0,274323
140720206000000,NE 152,RESIDENTIAL,26630,0,26630,250252,0,276882
140720206100000,NE 152,RESIDENTIAL,22176,0,22176,246233,0,268409
140720206200000,NE 152,RESIDENTIAL,26400,0,26400,211733,0,238133
140720206300000,NE 152,RESIDENTIAL,27238,0,27238,245195,0,272433
140722600300000,NE 158,RESIDENTIAL,38640,0,38640,184757,0,223397
140722600400000,NE 158,RESIDENTIAL,39200,0,39200,154834,0,194034
140722600500000,NE 158,RESIDENTIAL,37620,0,37620,222752,0,260372
140722600600000,NE 158,RESIDENTIAL,37620,0,37620,204787,0,242407
140722600700000,NE 158,RESIDENTIAL,37620,0,37620,196431,0,234051
140722600800000,NE 158,RESIDENTIAL,39600,0,39600,216160,0,255760
140722600900000,NE 158,RESIDENTIAL,39600,0,39600,188407,0,228007
140722601000000,NE 158,RESIDENTIAL,39600,0,39600,213131,0,252731
140722601100000,NE 158,RESIDENTIAL,40392,0,40392,222074,0,262466
140722601200000,NE 158,RESIDENTIAL,40392,0,40392,216538,0,256930
140722601300000,NE 158,RESIDENTIAL,40005,0,40005,203739,0,243744
140722601400000,NE 158,RESIDENTIAL,44512,0,44512,210663,0,255175
140722601500000,NE 158,RESIDENTIAL,38780,0,38780,197270,0,236050
140722601600000,NE 158,RESIDENTIAL,31232,0,31232,196577,0,227809
140722601700000,NE 158,RESIDENTIAL,39118,0,39118,226008,0,265126
140722601800000,NE 158,RESIDENTIAL,37620,0,37620,206316,0,243936
140722601900000,NE 158,RESIDENTIAL,37620,0,37620,250568,0,288188
140722602000000,NE 158,RESIDENTIAL,37620,0,37620,209938,0,247558
140722602100000,NE 158,RESIDENTIAL,37620,0,37620,218908,0,256528
140722602200000,NE 158,RESIDENTIAL,37620,0,37620,223511,0,261131
140722602300000,NE 158,RESIDENTIAL,39320,0,39320,223884,0,263204
140722602400000,NE 158,RESIDENTIAL,33482,0,33482,188635,0,222117
140722602500000,NE 158,RESIDENTIAL,33482,0,33482,211210,0,244692
140722602600000,NE 158,RESIDENTIAL,35640,0,35640,222072,0,257712
140722602700000,NE 158,RESIDENTIAL,32579,0,32579,162662,0,195241
140722602800000,NE 158,RESIDENTIAL,30454,0,30454,83879,0,114333
140722602900000,NE 158,RESIDENTIAL,1650,0,1650,0,0,1650
140722603000000,NE 158,RESIDENTIAL,5,0,5,0,0,5
140722603100000,NE 158,RESIDENTIAL,34240,0,34240,146672,0,180912
140722603200000,NE 158,RESIDENTIAL,33863,0,33863,169118,0,202981
140722603300000,NE 158,RESIDENTIAL,34008,0,34008,162657,0,196665
140722603400000,NE 158,RESIDENTIAL,34240,0,34240,178155,0,212395
140722603500000,NE 158,RESIDENTIAL,30940,0,30940,186153,0,217093
140722603600000,NE 158,RESIDENTIAL,32421,0,32421,166615,0,199036
140722603700000,NE 158,RESIDENTIAL,1900,0,1900,0,0,1900
140722603800000,NE 152,RESIDENTIAL,23924,0,23924,220370,0,244294
140722603900000,NE 152,RESIDENTIAL,24552,0,24552,201448,0,226000
140722604000000,NE 152,RESIDENTIAL,24552,0,24552,212706,0,237258
140722604100000,NE 152,RESIDENTIAL,24552,0,24552,204326,0,228878
140722604200000,NE 152,RESIDENTIAL,24552,0,24552,229767,0,254319
140722604300000,NE 152,RESIDENTIAL,24552,0,24552,239954,0,264506
140722604400000,NE 152,RESIDENTIAL,24552,0,24552,226463,0,251015
140722604500000,NE 152,RESIDENTIAL,24552,0,24552,252532,0,277084
140722604600000,NE 152,RESIDENTIAL,24552,0,24552,229194,0,253746
140722604700000,NE 152,RESIDENTIAL,24552,0,24552,232144,0,256696
140722604800000,NE 152,RESIDENTIAL,24552,0,24552,230881,0,255433
140722604900000,NE 152,RESIDENTIAL,24552,0,24552,244668,0,269220
140722605000000,NE 152,RESIDENTIAL,24552,0,24552,228572,0,253124
140722605100000,NE 152,RESIDENTIAL,23760,0,23760,225184,0,248944
140722605200000,NE 152,RESIDENTIAL,22933,0,22933,207194,0,230127
140722605300000,NE 152,RESIDENTIAL,23397,0,23397,206876,0,230273
140722605400000,NE 152,RESIDENTIAL,26460,0,26460,225800,0,252260
140722605500000,NE 152,RESIDENTIAL,26901,0,26901,240471,0,267372
140722605600000,NE 152,RESIDENTIAL,26350,0,26350,193378,0,219728
140722605700000,NE 152,RESIDENTIAL,26160,0,26160,234551,0,260711
140722605800000,NE 152,RESIDENTIAL,25611,0,25611,229913,0,255524
140722700100000,NE 158,RESIDENTIAL,28672,0,28672,138022,0,166694
140722700200000,NE 158,RESIDENTIAL,33981,0,33981,187932,0,221913
140722700300000,NE 158,RESIDENTIAL,32400,0,32400,203580,0,235980
140722700400000,NE 158,RESIDENTIAL,32700,0,32700,177059,0,209759
140722700500000,NE 158,RESIDENTIAL,32700,0,32700,206746,0,239446
140722700600000,NE 158,RESIDENTIAL,32700,0,32700,233062,0,265762
140722700700000,NE 158,RESIDENTIAL,32700,0,32700,182145,0,214845
140722700800000,NE 158,RESIDENTIAL,37060,0,37060,173687,0,210747
140722700900000,NE 158,RESIDENTIAL,32400,0,32400,227311,0,259711
140722701000000,NE 158,RESIDENTIAL,38407,0,38407,221546,0,259953
140722701100000,NE 158,RESIDENTIAL,39974,0,39974,232742,0,272716
140722701200000,NE 158,RESIDENTIAL,40320,0,40320,235234,0,275554
140722701300000,NE 158,RESIDENTIAL,36252,0,36252,204501,0,240753
140722701400000,NE 158,RESIDENTIAL,34240,0,34240,190849,0,225089
140722701500000,NE 158,RESIDENTIAL,34560,0,34560,210138,0,244698
140722701600000,NE 158,RESIDENTIAL,34560,0,34560,218643,0,253203
140722701700000,NE 158,RESIDENTIAL,34560,0,34560,223887,0,258447
140722701800000,NE 158,RESIDENTIAL,34560,0,34560,214498,0,249058
140722701900000,NE 158,RESIDENTIAL,34560,0,34560,199633,0,234193
140722702000000,NE 158,RESIDENTIAL,35415,0,35415,200655,0,236070
140722702100000,NE 158,RESIDENTIAL,35418,0,35418,230109,0,265527
140722702200000,NE 158,RESIDENTIAL,32151,0,32151,191018,0,223169
140722702300000,NE 158,RESIDENTIAL,32670,0,32670,216213,0,248883
140722702400000,NE 158,RESIDENTIAL,33796,0,33796,204346,0,238142
140722702500000,NE 158,RESIDENTIAL,33117,0,33117,204465,0,237582
140722702600000,NE 158,RESIDENTIAL,34445,0,34445,179836,0,214281
140722702700000,NE 158,RESIDENTIAL,30796,0,30796,148806,0,179602
140722702800000,NE 158,RESIDENTIAL,29120,0,29120,150097,0,179217
140722702900000,NE 158,RESIDENTIAL,29120,0,29120,148512,0,177632
140722703000000,NE 158,RESIDENTIAL,29120,0,29120,146873,0,175993
140722703100000,NE 158,RESIDENTIAL,29120,0,29120,145159,0,174279
140722703200000,NE 158,RESIDENTIAL,29120,0,29120,138234,0,167354
140722703300000,NE 158,RESIDENTIAL,29120,0,29120,134864,0,163984
140722703400000,NE 158,RESIDENTIAL,29120,0,29120,146240,0,175360
140722703500000,NE 158,RESIDENTIAL,29120,0,29120,117902,0,147022
140722703600000,NE 158,RESIDENTIAL,29120,0,29120,137409,0,166529
140722800200000,NE 152,RESIDENTIAL,21912,0,21912,243339,0,265251
140722800300000,NE 152,RESIDENTIAL,21912,0,21912,194596,0,216508
140722800400000,NE 152,RESIDENTIAL,21912,0,21912,244560,0,266472
140722800500000,NE 152,RESIDENTIAL,21912,0,21912,209996,0,231908
140722800600000,NE 152,RESIDENTIAL,21912,0,21912,244782,0,266694
140722800700000,NE 152,RESIDENTIAL,29569,0,29569,225567,0,255136
140725100100000,NE 158,RESIDENTIAL,27973,0,27973,161073,0,189046
140725100200000,NE 158,RESIDENTIAL,32400,0,32400,176354,0,208754
140725100300000,NE 158,RESIDENTIAL,32400,0,32400,162478,0,194878
140725100400000,NE 158,RESIDENTIAL,32400,0,32400,181655,0,214055
140725100500000,NE 158,RESIDENTIAL,32400,0,32400,156095,0,188495
140725100600000,NE 158,RESIDENTIAL,36562,0,36562,174519,0,211081
140725100700000,NE 158,RESIDENTIAL,34272,0,34272,165317,0,199589
140725100800000,NE 158,RESIDENTIAL,36687,0,36687,171241,0,207928
140725100900000,NE 158,RESIDENTIAL,35802,0,35802,187488,0,223290
140725101000000,NE 158,RESIDENTIAL,39780,0,39780,169937,0,209717
140725101100000,NE 158,RESIDENTIAL,35802,0,35802,241357,0,277159
140725101200000,NE 158,RESIDENTIAL,35661,0,35661,218098,0,253759
140725101300000,NE 158,RESIDENTIAL,32860,0,32860,205984,0,238844
140725101400000,NE 158,RESIDENTIAL,32855,0,32855,172606,0,205461
140725101500000,NE 158,RESIDENTIAL,37368,0,37368,218919,0,256287
140725101600000,NE 158,RESIDENTIAL,37260,0,37260,197660,0,234920
140725200100000,NE 158,RESIDENTIAL,32284,0,32284,169065,0,201349
140725200200000,NE 158,RESIDENTIAL,30200,0,30200,0,0,30200
140725200300000,NE 158,RESIDENTIAL,21950,0,21950,0,0,21950
140725200400000,NE 158,RESIDENTIAL,34660,0,34660,204810,0,239470
140725200500000,NE 158,RESIDENTIAL,32929,0,32929,177011,0,209940
140725200600000,NE 140,RESIDENTIAL,350,0,350,0,0,350
140725200700000,NE 158,RESIDENTIAL,35360,0,35360,213153,0,248513
140725200800000,NE 158,RESIDENTIAL,35031,0,35031,224830,0,259861
140725200900000,NE 158,RESIDENTIAL,32548,0,32548,222907,0,255455
140725201000000,NE 158,RESIDENTIAL,32548,0,32548,196009,0,228557
140725201100000,NE 158,RESIDENTIAL,32471,0,32471,220428,0,252899
140725201200000,NE 158,RESIDENTIAL,34745,0,34745,245467,0,280212
140725201300000,NE 158,RESIDENTIAL,35083,0,35083,234606,0,269689
140725201400000,NE 158,RESIDENTIAL,39923,0,39923,238092,0,278015
140725201500000,NE 158,RESIDENTIAL,32056,0,32056,0,0,32056
140725201600000,NE 158,RESIDENTIAL,31210,0,31210,186008,0,217218
140725201700000,NE 158,RESIDENTIAL,29713,0,29713,199292,0,229005
140725201800000,NE 158,RESIDENTIAL,29304,0,29304,170493,0,199797
140725201900000,NE 158,RESIDENTIAL,29240,0,29240,156524,0,185764
140725202000000,NE 158,RESIDENTIAL,29397,0,29397,169866,0,199263
140725202100000,NE 158,RESIDENTIAL,30387,0,30387,182486,0,212873
140725202200000,NE 158,RESIDENTIAL,30240,0,30240,142441,0,172681
140725202300000,NE 158,RESIDENTIAL,30240,0,30240,171520,0,201760
140725202400000,NE 158,RESIDENTIAL,30240,0,30240,166643,0,196883
140725202500000,NE 158,RESIDENTIAL,31200,0,31200,171830,0,203030
140725202600000,NE 158,RESIDENTIAL,29952,0,29952,207387,0,237339
140725202700000,NE 158,RESIDENTIAL,30240,0,30240,186014,0,216254
140725202800000,NE 158,RESIDENTIAL,30240,0,30240,210150,0,240390
140725202900000,NE 158,RESIDENTIAL,30240,0,30240,204961,0,235201
140725203000000,NE 158,RESIDENTIAL,34073,0,34073,221461,0,255534
140725203100000,NE 158,RESIDENTIAL,35475,0,35475,205558,0,241033
140725203200000,NE 158,RESIDENTIAL,33320,0,33320,180096,0,213416
140725203300000,NE 158,RESIDENTIAL,28512,0,28512,190959,0,219471
140725203400000,NE 158,RESIDENTIAL,30823,0,30823,184586,0,215409
140725203500000,NE 158,RESIDENTIAL,30031,0,30031,172683,0,202714
140725203600000,NE 158,RESIDENTIAL,32170,0,32170,164306,0,196476
140725203700000,NE 158,RESIDENTIAL,31200,0,31200,212521,0,243721
140725203800000,NE 158,RESIDENTIAL,31200,0,31200,176061,0,207261
140725203900000,NE 158,RESIDENTIAL,31200,0,31200,177678,0,208878
140725204000000,NE 158,RESIDENTIAL,31200,0,31200,195275,0,226475
140725204100000,NE 158,RESIDENTIAL,31200,0,31200,179842,0,211042
140725204200000,NE 158,RESIDENTIAL,31575,0,31575,164538,0,196113
140727600100000,NE 158,RESIDENTIAL,35749,0,35749,206359,0,242108
140727600200000,NE 158,RESIDENTIAL,32265,0,32265,208389,0,240654
140727600300000,NE 158,RESIDENTIAL,32265,0,32265,216366,0,248631
140727600400000,NE 158,RESIDENTIAL,32265,0,32265,189024,0,221289
140727600500000,NE 158,RESIDENTIAL,32265,0,32265,234397,0,266662
140727600600000,NE 158,RESIDENTIAL,32538,0,32538,238171,0,270709
140727600700000,NE 158,RESIDENTIAL,32960,0,32960,201729,0,234689
140727600800000,NE 158,RESIDENTIAL,34629,0,34629,193106,0,227735
140727600900000,NE 158,RESIDENTIAL,35129,0,35129,227391,0,262520
140727601000000,NE 158,RESIDENTIAL,39326,0,39326,290135,0,329461
140727601100000,NE 158,RESIDENTIAL,39400,0,39400,0,0,39400
140727601200000,NE 158,RESIDENTIAL,65300,0,65300,0,0,65300
140727601300000,NE 158,RESIDENTIAL,32688,0,32688,183896,0,216584
140727601400000,NE 158,RESIDENTIAL,34240,0,34240,238048,0,272288
140727601500000,NE 158,RESIDENTIAL,34240,0,34240,190832,0,225072
140727601600000,NE 158,RESIDENTIAL,34240,0,34240,179833,0,214073
140727601700000,NE 158,RESIDENTIAL,35020,0,35020,180362,0,215382
140727601800000,NE 158,RESIDENTIAL,35020,0,35020,194190,0,229210
140727601900000,NE 158,RESIDENTIAL,35020,0,35020,193387,0,228407
140727602000000,NE 158,RESIDENTIAL,35020,0,35020,194603,0,229623
140727602100000,NE 158,RESIDENTIAL,38629,0,38629,172205,0,210834
140727602200000,NE 158,RESIDENTIAL,40460,0,40460,217501,0,257961
140727602300000,NE 158,RESIDENTIAL,41600,0,41600,224802,0,266402
140727602400000,NE 158,RESIDENTIAL,43333,0,43333,186400,0,229733
140727602500000,NE 158,RESIDENTIAL,44200,0,44200,186916,0,231116
140727602600000,NE 158,RESIDENTIAL,44200,0,44200,232901,0,277101
140727602700000,NE 158,RESIDENTIAL,44893,0,44893,249233,0,294126
140727602800000,NE 158,RESIDENTIAL,47668,0,47668,193929,0,241597
140727602900000,NE 158,RESIDENTIAL,44428,0,44428,0,0,44428
140727603000000,NE 158,RESIDENTIAL,44836,0,44836,198778,0,243614
140727603100000,NE 158,RESIDENTIAL,44081,0,44081,229801,0,273882
140727603200000,NE 158,RESIDENTIAL,45125,0,45125,258822,0,303947
140727603300000,NE 158,RESIDENTIAL,38500,0,38500,225440,0,263940
140727603400000,NE 158,RESIDENTIAL,39220,0,39220,193124,0,232344
140727603500000,NE 158,RESIDENTIAL,42293,0,42293,208493,0,250786
140727603600000,NE 158,RESIDENTIAL,39000,0,39000,189640,0,228640
140727603700000,NE 158,RESIDENTIAL,39000,0,39000,179011,0,218011
140727603800000,NE 158,RESIDENTIAL,38454,0,38454,186347,0,224801
140727603900000,NE 158,RESIDENTIAL,36528,0,36528,176321,0,212849
140727604000000,NE 158,RESIDENTIAL,35333,0,35333,168484,0,203817
140727604100000,NE 158,RESIDENTIAL,38023,0,38023,189871,0,227894
140727604200000,NE 158,RESIDENTIAL,30218,0,30218,166445,0,196663
140727604300000,NE 158,RESIDENTIAL,30900,0,30900,177937,0,208837
140727604400000,NE 158,RESIDENTIAL,30900,0,30900,206075,0,236975
140727604500000,NE 158,RESIDENTIAL,30900,0,30900,195783,0,226683
140727604600000,NE 158,RESIDENTIAL,30900,0,30900,179715,0,210615
140727604700000,NE 158,RESIDENTIAL,36055,0,36055,208979,0,245034
140730100100000,NE 158,RESIDENTIAL,35020,0,35020,165739,0,200759
140730100200000,NE 140,RESIDENTIAL,54600,0,54600,0,0,54600
140730100300000,NE 158,RESIDENTIAL,34240,0,34240,203492,0,237732
140730100400000,NE 158,RESIDENTIAL,37078,0,37078,177469,0,214547
140730100500000,NE 158,RESIDENTIAL,35855,0,35855,192016,0,227871
140730100600000,NE 158,RESIDENTIAL,36196,0,36196,259414,0,295610
140730100700000,NE 158,RESIDENTIAL,34768,0,34768,172483,0,207251
140730100800000,NE 158,RESIDENTIAL,33921,0,33921,186435,0,220356
140730100900000,NE 158,RESIDENTIAL,32832,0,32832,170754,0,203586
140730101000000,NE 158,RESIDENTIAL,29242,0,29242,184586,0,213828
140730101100000,NE 158,RESIDENTIAL,29664,0,29664,185972,0,215636
140730101200000,NE 158,RESIDENTIAL,33502,0,33502,192997,0,226499
140730101300000,NE 158,RESIDENTIAL,37667,0,37667,210778,0,248445
140730101400000,NE 158,RESIDENTIAL,38626,0,38626,177803,0,216429
140730101500000,NE 158,RESIDENTIAL,34259,0,34259,178337,0,212596
140730101600000,NE 158,RESIDENTIAL,36630,0,36630,178844,0,215474
140730101700000,NE 158,RESIDENTIAL,34564,0,34564,170151,0,204715
140730200100000,NE 158,RESIDENTIAL,30600,0,30600,185548,0,216148
140730200200000,NE 158,RESIDENTIAL,37139,0,37139,237222,0,274361
140730200300000,NE 158,RESIDENTIAL,38923,0,38923,271271,0,310194
140730200400000,NE 158,RESIDENTIAL,37080,0,37080,236315,0,273395
140730200500000,NE 158,RESIDENTIAL,38000,0,38000,245841,0,283841
140730200600000,NE 158,RESIDENTIAL,30096,0,30096,173863,0,203959
140730200700000,NE 158,RESIDENTIAL,30600,0,30600,223114,0,253714
140730200800000,NE 158,RESIDENTIAL,30076,0,30076,241132,0,271208
140730200900000,NE 158,RESIDENTIAL,29252,0,29252,193090,0,222342
140730201000000,NE 158,RESIDENTIAL,29376,0,29376,243546,0,272922
140730201100000,NE 158,RESIDENTIAL,31909,0,31909,245175,0,277084
140730201200000,NE 158,RESIDENTIAL,30600,0,30600,192246,0,222846
140730300100000,NE 158,RESIDENTIAL,34641,0,34641,207258,0,241899
140730300200000,NE 158,RESIDENTIAL,36084,0,36084,174294,0,210378
140730300300000,NE 158,RESIDENTIAL,34627,0,34627,188418,0,223045
140730300400000,NE 158,RESIDENTIAL,49530,0,49530,220716,0,270246
140730400100000,NE 158,RESIDENTIAL,49088,0,49088,137743,0,186831
140730400200000,NE 158,RESIDENTIAL,47730,0,47730,210299,0,258029
140730400300000,NE 158,RESIDENTIAL,42527,0,42527,247952,0,290479
140730400400000,NE 158,RESIDENTIAL,41348,0,41348,280946,0,322294
140730400500000,NE 140,RESIDENTIAL,18800,0,18800,0,0,18800
140730400600000,NE 158,RESIDENTIAL,49046,0,49046,225798,0,274844
140730400700000,NE 158,RESIDENTIAL,49046,0,49046,200632,0,249678
140730400800000,NE 158,RESIDENTIAL,37547,0,37547,200911,0,238458
140730400900000,NE 158,RESIDENTIAL,29100,0,29100,0,0,29100
140730401000000,NE 158,RESIDENTIAL,55531,0,55531,307374,0,362905
140730401100000,NE 153,RESIDENTIAL,6150,0,6150,0,0,6150
140730401200000,NE 153,RESIDENTIAL,18595,0,18595,201057,0,219652
140730401300000,NE 153,RESIDENTIAL,12983,0,12983,131419,0,144402
140730401400000,NE 153,RESIDENTIAL,15628,0,15628,135879,0,151507
140730401500000,NE 153,RESIDENTIAL,19077,0,19077,146117,0,165194
140730401600000,NE 153,RESIDENTIAL,19050,0,19050,181896,0,200946
140730401800000,NE 158,RESIDENTIAL,8000,0,8000,0,0,8000
140730500100000,NE 158,RESIDENTIAL,36036,0,36036,211950,0,247986
140732600100000,NE 158,RESIDENTIAL,30600,0,30600,194691,0,225291
140732600200000,NE 158,RESIDENTIAL,31240,0,31240,245279,0,276519
140732600300000,NE 158,RESIDENTIAL,35809,0,35809,244144,0,279953
140732600400000,NE 158,RESIDENTIAL,37168,0,37168,304929,0,342097
140732600500000,NE 158,RESIDENTIAL,38362,0,38362,219482,0,257844
140732600600000,NE 158,RESIDENTIAL,38375,0,38375,223493,0,261868
140732700100000,NE 158,RESIDENTIAL,40186,0,40186,222698,0,262884
140732700200000,NE 158,RESIDENTIAL,102650,0,102650,0,0,102650
140732700300000,NE 158,RESIDENTIAL,34849,0,34849,185997,0,220846
140732700400000,NE 158,RESIDENTIAL,35613,0,35613,224415,0,260028
140732700500000,NE 153,RESIDENTIAL,17442,0,17442,174563,0,192005
140732700600000,NE 153,RESIDENTIAL,13248,0,13248,124207,0,137455
140732700700000,NE 153,RESIDENTIAL,15621,0,15621,144122,0,159743
140732700800000,NE 153,RESIDENTIAL,18915,0,18915,159707,0,178622
140732700900000,NE 153,RESIDENTIAL,19695,0,19695,178142,0,197837
140732701000000,NE 153,RESIDENTIAL,14900,0,14900,0,0,14900
140732701100000,NE 153,RESIDENTIAL,18330,0,18330,165970,0,184300
140732701200000,NE 153,RESIDENTIAL,13440,0,13440,137462,0,150902
140732701300000,NE 153,RESIDENTIAL,16170,0,16170,145380,0,161550
140732701400000,NE 153,RESIDENTIAL,19319,0,19319,143194,0,162513
140732701500000,NE 153,RESIDENTIAL,21058,0,21058,179625,0,200683
140732701600000,NE 153,RESIDENTIAL,18525,0,18525,183361,0,201886
140732701700000,NE 153,RESIDENTIAL,13160,0,13160,128076,0,141236
140732701800000,NE 153,RESIDENTIAL,15015,0,15015,148506,0,163521
140732701900000,NE 153,RESIDENTIAL,18170,0,18170,149244,0,167414
140732702000000,NE 153,RESIDENTIAL,18347,0,18347,168802,0,187149
140732702100000,NE 153,RESIDENTIAL,19375,0,19375,187799,0,207174
140732702200000,NE 153,RESIDENTIAL,18565,0,18565,146100,0,164665
140732702300000,NE 153,RESIDENTIAL,15015,0,15015,143225,0,158240
140732702400000,NE 153,RESIDENTIAL,13160,0,13160,136420,0,149580
140732702500000,NE 153,RESIDENTIAL,19650,0,19650,168802,0,188452
140732702600000,NE 153,RESIDENTIAL,20547,0,20547,195624,0,216171
140732702700000,NE 153,RESIDENTIAL,17440,0,17440,144898,0,162338
140732702800000,NE 153,RESIDENTIAL,15180,0,15180,154826,0,170006
140732702900000,NE 153,RESIDENTIAL,13020,0,13020,134096,0,147116
140732703000000,NE 153,RESIDENTIAL,20240,0,20240,206080,0,226320
140732703100000,NE 158,RESIDENTIAL,38170,0,38170,215185,0,253355
140732703200000,NE 158,RESIDENTIAL,38439,0,38439,213535,0,251974
140732703300000,NE 158,RESIDENTIAL,36720,0,36720,225060,0,261780
140732800100000,NE 158,RESIDENTIAL,38624,0,38624,222298,0,260922
140732800200000,NE 153,RESIDENTIAL,7950,0,7950,0,0,7950
140732800300000,NE 158,RESIDENTIAL,37092,0,37092,257253,0,294345
140732800400000,NE 158,RESIDENTIAL,34690,0,34690,238055,0,272745
140732800500000,NE 158,RESIDENTIAL,36432,0,36432,240418,0,276850
140732800600000,NE 153,RESIDENTIAL,1900,0,1900,0,0,1900
140732800700000,NE 140,RESIDENTIAL,850,0,850,0,0,850
140735100100000,NE 151,RESIDENTIAL,333000,0,333000,0,0,333000
140735100200000,NE 151,RESIDENTIAL,7000,0,7000,0,0,7000
140737600100000,CITY PROPERTY,EXEMPT,0,0,0,0,0,0
140740100100000,NE 138,RESIDENTIAL,70123,0,70123,235423,0,305546
140740100200000,NE 138,RESIDENTIAL,63650,0,63650,264091,0,327741
140740100300000,NE 138,RESIDENTIAL,78390,0,78390,271848,0,350238
140740100400000,NE 138,RESIDENTIAL,80852,0,80852,296547,0,377399
140740100500000,NE 138,RESIDENTIAL,97170,0,97170,349577,0,446747
140740100600000,NE 138,RESIDENTIAL,75600,0,75600,287344,0,362944
140740100700000,NE 138,RESIDENTIAL,103600,0,103600,335510,0,439110
140740100800000,NE 138,RESIDENTIAL,114700,0,114700,343652,0,458352
140740100900000,NE 157,RESIDENTIAL,70800,0,70800,222812,0,293612
140740101000000,NE 157,RESIDENTIAL,71020,0,71020,284091,0,355111
140740101100000,NE 157,RESIDENTIAL,64516,0,64516,195359,0,259875
140740101200000,NE 157,RESIDENTIAL,125000,0,125000,266460,0,391460
140740101300000,NE 157,RESIDENTIAL,103530,0,103530,193585,0,297115
140740101400000,NE 157,RESIDENTIAL,109610,0,109610,297569,0,407179
140740101500000,NE 157,RESIDENTIAL,114480,0,114480,294793,0,409273
140740101600000,NE 157,RESIDENTIAL,111860,0,111860,264631,0,376491
140740101700000,NE 157,RESIDENTIAL,108290,0,108290,0,0,108290
140740101900000,NE 157,RESIDENTIAL,73220,0,73220,224829,0,298049
140740102000000,NE 157,RESIDENTIAL,53234,0,53234,0,0,53234
140740102100000,NE 157,RESIDENTIAL,72458,0,72458,342315,0,414773
140740102200000,NE 157,RESIDENTIAL,75600,0,75600,412956,0,488556
140740102300000,NE 157,RESIDENTIAL,100500,0,100500,306056,0,406556
140740102400000,NE 157,RESIDENTIAL,100200,0,100200,314698,0,414898
140740102500000,NE 138,RESIDENTIAL,65325,0,65325,288836,0,354161
140740102600000,NE 138,RESIDENTIAL,56227,0,56227,413319,0,469546
140740102700000,NE 138,RESIDENTIAL,53104,0,53104,0,0,53104
140740102800000,NE 157,RESIDENTIAL,67320,0,67320,284927,0,352247
140740102900000,NE 157,RESIDENTIAL,66482,0,66482,206013,0,272495
140740103000000,NE 157,RESIDENTIAL,76028,0,76028,219554,0,295582
140740103100000,NE 157,RESIDENTIAL,65450,0,65450,235820,0,301270
140740103200000,NE 157,RESIDENTIAL,64900,0,64900,316354,0,381254
140740103300000,NE 157,RESIDENTIAL,58580,0,58580,289878,0,348458
140740103400000,NE 138,RESIDENTIAL,67667,0,67667,257486,0,325153
140740103500000,NE 138,RESIDENTIAL,59547,0,59547,287751,0,347298
140740103600000,CENTRALLY ASSESSED,OTHER,0,0,0,0,0,0
140742600200000,NE 157,RESIDENTIAL,50250,0,50250,0,0,50250
140742600300000,NE 157,RESIDENTIAL,28491,0,28491,0,0,28491
140742600400000,NE 157,RESIDENTIAL,45100,0,45100,0,0,45100
140742600500000,NE 157,RESIDENTIAL,55050,0,55050,0,0,55050
140742700100000,NE 158,RESIDENTIAL,74360,0,74360,248671,0,323031
140742700200000,NE 158,RESIDENTIAL,35711,0,35711,167857,0,203568
140742700300000,NE 158,RESIDENTIAL,37400,0,37400,206161,0,243561
140742700400000,NE 158,RESIDENTIAL,35374,0,35374,241431,0,276805
140742700500000,NE 158,RESIDENTIAL,27574,0,27574,207269,0,234843
140742700600000,NE 158,RESIDENTIAL,54608,0,54608,190237,0,244845
140742700700000,NE 158,RESIDENTIAL,65380,0,65380,199864,0,265244
140742700800000,NE 158,RESIDENTIAL,106735,0,106735,202321,0,309056
140742700900000,NE 158,RESIDENTIAL,49905,0,49905,215431,0,265336
140742701000000,NE 158,RESIDENTIAL,49884,0,49884,246650,0,296534
140742701100000,NE 158,RESIDENTIAL,49376,0,49376,240714,0,290090
140745100100000,CITY PROPERTY,EXEMPT,0,0,0,0,0,0
140810100100000,NE 134,RESIDENTIAL,29236,0,29236,127927,0,157163
140810100200000,NE 134,RESIDENTIAL,25830,0,25830,123066,0,148896
140810100300000,NE 134,RESIDENTIAL,23765,0,23765,142024,0,165789
140810100400000,NE 134,RESIDENTIAL,23765,0,23765,111832,0,135597
140810100500000,NE 134,RESIDENTIAL,27352,0,27352,125985,0,153337
140810100600000,NE 134,RESIDENTIAL,34047,0,34047,115557,0,149604
140810100700000,NE 134,RESIDENTIAL,30870,0,30870,102759,0,133629
140810100800000,NE 134,RESIDENTIAL,34342,0,34342,125780,0,160122
140810100900000,NE 134,RESIDENTIAL,33708,0,33708,107228,0,140936
140810101000000,NE 134,RESIDENTIAL,36112,0,36112,132294,0,168406
140810101100000,NE 134,RESIDENTIAL,34884,0,34884,122007,0,156891
140810101200000,NE 134,RESIDENTIAL,34884,0,34884,136203,0,171087
140810101300000,NE 134,RESIDENTIAL,34884,0,34884,114033,0,148917
140810101400000,NE 134,RESIDENTIAL,33836,0,33836,125319,0,159155
140810101500000,NE 134,RESIDENTIAL,31482,0,31482,109552,0,141034
140810101600000,NE 134,RESIDENTIAL,31137,0,31137,90344,0,121481
140810101700000,NE 134,RESIDENTIAL,32602,0,32602,81957,0,114559
140810200100000,NE 134,RESIDENTIAL,26082,0,26082,113975,0,140057
140810200200000,NE 134,RESIDENTIAL,24784,0,24784,127497,0,152281
140810200300000,NE 134,RESIDENTIAL,24784,0,24784,92074,0,116858
140810200400000,NE 134,RESIDENTIAL,25463,0,25463,103061,0,128524
140810200500000,CHURCH,EXEMPT,0,99187,99187,0,351000,450187
140810200600000,CHURCH,EXEMPT,0,108518,108518,0,15173,123691
140810200700000,NE 134,RESIDENTIAL,25725,0,25725,116384,0,142109
140810200800000,NE 134,RESIDENTIAL,27930,0,27930,123844,0,151774
140810200900000,NE 134,RESIDENTIAL,27930,0,27930,114789,0,142719
140810201000000,NE 134,RESIDENTIAL,27645,0,27645,104457,0,132102
140810201100000,NE 134,RESIDENTIAL,31101,0,31101,108709,0,139810
140810201200000,CHURCH,EXEMPT,0,100397,100397,0,12420,112817
140810201300000,NE 134,RESIDENTIAL,27160,0,27160,99500,0,126660
140810201400000,NE 134,RESIDENTIAL,27160,0,27160,105232,0,132392
140810201500000,NE 134,RESIDENTIAL,27160,0,27160,97701,0,124861
140810201600000,NE 134,RESIDENTIAL,27822,0,27822,96241,0,124063
140810300100000,NE 134,RESIDENTIAL,36130,0,36130,118928,0,155058
140810300200000,NE 134,RESIDENTIAL,34959,0,34959,120478,0,155437
140810300300000,NE 134,RESIDENTIAL,26933,0,26933,101818,0,128751
140810300400000,NE 134,RESIDENTIAL,27607,0,27607,119566,0,147173
140810300500000,NE 134,RESIDENTIAL,27607,0,27607,109844,0,137451
140810300600000,NE 134,RESIDENTIAL,28280,0,28280,92062,0,120342
140810300700000,NE 134,RESIDENTIAL,27720,0,27720,109448,0,137168
140810300800000,NE 134,RESIDENTIAL,27440,0,27440,91056,0,118496
140810300900000,NE 134,RESIDENTIAL,28160,0,28160,103220,0,131380
140810301000000,NE 134,RESIDENTIAL,28302,0,28302,120466,0,148768
140810301100000,NE 134,RESIDENTIAL,29302,0,29302,107968,0,137270
140810301200000,NE 134,RESIDENTIAL,36215,0,36215,144581,0,180796
140810301300000,NE 134,RESIDENTIAL,33709,0,33709,106514,0,140223
140810301400000,NE 134,RESIDENTIAL,33576,0,33576,120347,0,153923
140810301500000,NE 134,RESIDENTIAL,32275,0,32275,124911,0,157186
140810301600000,NE 134,RESIDENTIAL,33699,0,33699,94489,0,128188
140810301700000,NE 134,RESIDENTIAL,32943,0,32943,114102,0,147045
140810301800000,NE 134,RESIDENTIAL,32149,0,32149,130655,0,162804
140810301900000,NE 134,RESIDENTIAL,33523,0,33523,134385,0,167908
140810400100000,NE 134,RESIDENTIAL,31346,0,31346,143543,0,174889
140810400200000,NE 134,RESIDENTIAL,28785,0,28785,97303,0,126088
140810400300000,NE 134,RESIDENTIAL,28500,0,28500,140558,0,169058
140810400400000,NE 134,RESIDENTIAL,28215,0,28215,115785,0,144000
140810400500000,NE 134,RESIDENTIAL,27930,0,27930,114035,0,141965
140810400600000,NE 134,RESIDENTIAL,29988,0,29988,97448,0,127436
140810400700000,NE 134,RESIDENTIAL,27645,0,27645,107809,0,135454
140810400800000,NE 134,RESIDENTIAL,27645,0,27645,122634,0,150279
140810400900000,NE 134,RESIDENTIAL,27645,0,27645,109794,0,137439
140810401000000,NE 134,RESIDENTIAL,27298,0,27298,111610,0,138908
140810401100000,NE 134,RESIDENTIAL,32327,0,32327,127535,0,159862
140810401200000,NE 134,RESIDENTIAL,32063,0,32063,139910,0,171973
140810401300000,NE 134,RESIDENTIAL,31725,0,31725,136965,0,168690
140810401400000,NE 134,RESIDENTIAL,32063,0,32063,140621,0,172684
140810401500000,NE 134,RESIDENTIAL,33048,0,33048,118977,0,152025
140810401600000,NE 134,RESIDENTIAL,32738,0,32738,119344,0,152082
140810401700000,NE 134,RESIDENTIAL,33075,0,33075,120695,0,153770
140810401800000,NE 134,RESIDENTIAL,33075,0,33075,105142,0,138217
140810401900000,NE 134,RESIDENTIAL,31742,0,31742,127463,0,159205
140810402000000,NE 134,RESIDENTIAL,32915,0,32915,143829,0,176744
140810500100000,NE 134,RESIDENTIAL,29988,0,29988,132794,0,162782
140810500200000,NE 134,RESIDENTIAL,31742,0,31742,105073,0,136815
140810500300000,NE 134,RESIDENTIAL,31742,0,31742,133891,0,165633
140810500400000,NE 134,RESIDENTIAL,32062,0,32062,100946,0,133008
140810500500000,NE 134,RESIDENTIAL,32384,0,32384,118129,0,150513
140810500600000,NE 134,RESIDENTIAL,32837,0,32837,139105,0,171942
140810500700000,NE 134,RESIDENTIAL,32773,0,32773,139792,0,172565
140810500800000,NE 134,RESIDENTIAL,33542,0,33542,94576,0,128118
140810500900000,NE 134,RESIDENTIAL,31365,0,31365,149516,0,180881
140810501000000,NE 134,RESIDENTIAL,32746,0,32746,113487,0,146233
140810501100000,NE 134,RESIDENTIAL,34379,0,34379,140161,0,174540
140810501200000,NE 134,RESIDENTIAL,32438,0,32438,122426,0,154864
140810501300000,NE 134,RESIDENTIAL,34812,0,34812,129622,0,164434
140810501400000,NE 134,RESIDENTIAL,34007,0,34007,127390,0,161397
140810501500000,NE 134,RESIDENTIAL,31634,0,31634,131858,0,163492
140810501600000,NE 134,RESIDENTIAL,32506,0,32506,119670,0,152176
140810501700000,NE 134,RESIDENTIAL,32738,0,32738,116346,0,149084
140810501800000,NE 134,RESIDENTIAL,30919,0,30919,89667,0,120586
140810501900000,NE 134,RESIDENTIAL,32738,0,32738,109531,0,142269
140810502000000,NE 134,RESIDENTIAL,33393,0,33393,91038,0,124431
140810600100000,NE 134,RESIDENTIAL,33345,0,33345,117213,0,150558
140810600200000,NE 134,RESIDENTIAL,35568,0,35568,97680,0,133248
140810600300000,NE 134,RESIDENTIAL,34827,0,34827,103745,0,138572
140810600400000,NE 134,RESIDENTIAL,35611,0,35611,90458,0,126069
140810600500000,NE 134,RESIDENTIAL,34425,0,34425,102888,0,137313
140810600600000,NE 134,RESIDENTIAL,33611,0,33611,123984,0,157595
140810600700000,NE 134,RESIDENTIAL,34474,0,34474,97212,0,131686
140810600800000,NE 134,RESIDENTIAL,34003,0,34003,121409,0,155412
140810600900000,NE 134,RESIDENTIAL,34354,0,34354,106875,0,141229
140810601000000,NE 134,RESIDENTIAL,34616,0,34616,137142,0,171758
140810601100000,NE 134,RESIDENTIAL,34561,0,34561,123623,0,158184
140810601200000,NE 134,RESIDENTIAL,34140,0,34140,129499,0,163639
140810601300000,NE 134,RESIDENTIAL,34132,0,34132,162184,0,196316
140810601400000,NE 134,RESIDENTIAL,33997,0,33997,134006,0,168003
140810601500000,NE 134,RESIDENTIAL,34769,0,34769,122279,0,157048
140810601600000,NE 134,RESIDENTIAL,33787,0,33787,112563,0,146350
140810601700000,NE 134,RESIDENTIAL,36057,0,36057,105241,0,141298
140810601800000,NE 134,RESIDENTIAL,36932,0,36932,126071,0,163003
140810601900000,NE 134,RESIDENTIAL,34399,0,34399,86546,0,120945
140810602000000,NE 134,RESIDENTIAL,35494,0,35494,112352,0,147846
140810602100000,NE 134,RESIDENTIAL,33589,0,33589,113210,0,146799
140810602200000,NE 134,RESIDENTIAL,30645,0,30645,124302,0,154947
140810700100000,NE 134,RESIDENTIAL,35703,0,35703,121056,0,156759
140810700200000,NE 134,RESIDENTIAL,33801,0,33801,119749,0,153550
140810700300000,NE 134,RESIDENTIAL,33345,0,33345,112839,0,146184
140810700400000,NE 134,RESIDENTIAL,33885,0,33885,126810,0,160695
140810700500000,NE 134,RESIDENTIAL,32751,0,32751,140425,0,173176
140812600100000,NE 134,RESIDENTIAL,25994,0,25994,124092,0,150086
140812600200000,NE 134,RESIDENTIAL,28800,0,28800,142646,0,171446
140812600300000,NE 134,RESIDENTIAL,28500,0,28500,144878,0,173378
140812600400000,NE 134,RESIDENTIAL,30438,0,30438,127872,0,158310
140812600500000,NE 134,RESIDENTIAL,29408,0,29408,147060,0,176468
140812700100000,NE 134,RESIDENTIAL,28512,0,28512,144240,0,172752
140812700200000,NE 134,RESIDENTIAL,33372,0,33372,146229,0,179601
140812700300000,NE 134,RESIDENTIAL,33048,0,33048,117811,0,150859
140812700400000,NE 134,RESIDENTIAL,33247,0,33247,156156,0,189403
140812700500000,NE 134,RESIDENTIAL,29424,0,29424,130636,0,160060
140812700600000,NE 134,RESIDENTIAL,32307,0,32307,138890,0,171197
140812700700000,NE 134,RESIDENTIAL,30417,0,30417,142365,0,172782
140812700800000,NE 134,RESIDENTIAL,31188,0,31188,122987,0,154175
140812700900000,NE 134,RESIDENTIAL,31595,0,31595,145409,0,177004
140812701000000,NE 134,RESIDENTIAL,31464,0,31464,134144,0,165608
140812701100000,NE 134,RESIDENTIAL,30315,0,30315,146943,0,177258
140812701200000,NE 134,RESIDENTIAL,32400,0,32400,125157,0,157557
140812701300000,NE 134,RESIDENTIAL,27398,0,27398,114652,0,142050
140812701400000,NE 134,RESIDENTIAL,28699,0,28699,128722,0,157421
140812701500000,NE 134,RESIDENTIAL,30615,0,30615,127513,0,158128
140812701600000,NE 134,RESIDENTIAL,30703,0,30703,139644,0,170347
140812701700000,NE 134,RESIDENTIAL,29243,0,29243,139322,0,168565
140812701800000,NE 134,RESIDENTIAL,27779,0,27779,124681,0,152460
140812800100000,NE 134,RESIDENTIAL,32062,0,32062,148521,0,180583
140812800200000,NE 134,RESIDENTIAL,35373,0,35373,136573,0,171946
140812800300000,NE 134,RESIDENTIAL,31742,0,31742,170002,0,201744
140812800400000,NE 134,RESIDENTIAL,34140,0,34140,146554,0,180694
140812800500000,NE 134,RESIDENTIAL,33372,0,33372,136138,0,169510
140812800600000,NE 134,RESIDENTIAL,34344,0,34344,127955,0,162299
140812800700000,NE 134,RESIDENTIAL,34155,0,34155,127875,0,162030
140812800800000,NE 134,RESIDENTIAL,39154,0,39154,199771,0,238925
140812800900000,NE 134,RESIDENTIAL,36085,0,36085,200999,0,237084
140812801000000,NE 134,RESIDENTIAL,36360,0,36360,169372,0,205732
140812801100000,NE 134,RESIDENTIAL,37723,0,37723,173090,0,210813
140812801200000,NE 134,RESIDENTIAL,37296,0,37296,139601,0,176897
140812801300000,NE 134,RESIDENTIAL,36720,0,36720,158270,0,194990
140812801400000,NE 134,RESIDENTIAL,35027,0,35027,144399,0,179426
140812801500000,NE 134,RESIDENTIAL,32671,0,32671,124987,0,157658
140812900100000,NE 134,RESIDENTIAL,35613,0,35613,173246,0,208859
140812900200000,NE 134,RESIDENTIAL,32492,0,32492,165506,0,197998
140812900300000,NE 134,RESIDENTIAL,34200,0,34200,144560,0,178760
140812900400000,NE 134,RESIDENTIAL,34200,0,34200,160122,0,194322
140812900500000,NE 134,RESIDENTIAL,34200,0,34200,175860,0,210060
140812900600000,NE 134,RESIDENTIAL,34545,0,34545,175538,0,210083
140812900700000,NE 134,RESIDENTIAL,35754,0,35754,150263,0,186017
140812900800000,NE 134,RESIDENTIAL,36905,0,36905,182698,0,219603
140812900900000,NE 134,RESIDENTIAL,32763,0,32763,160606,0,193369
140812901000000,NE 134,RESIDENTIAL,32850,0,32850,162151,0,195001
140812901100000,NE 134,RESIDENTIAL,32850,0,32850,163866,0,196716
140812901200000,NE 134,RESIDENTIAL,32850,0,32850,147310,0,180160
140812901300000,NE 134,RESIDENTIAL,32850,0,32850,150192,0,183042
140813000100000,NE 134,RESIDENTIAL,33698,0,33698,118498,0,152196
140813000200000,NE 134,RESIDENTIAL,36360,0,36360,145117,0,181477
140813000300000,NE 134,RESIDENTIAL,36360,0,36360,171403,0,207763
140813000400000,NE 134,RESIDENTIAL,36360,0,36360,185097,0,221457
140813000500000,NE 134,RESIDENTIAL,35198,0,35198,175293,0,210491
140813000600000,NE 134,RESIDENTIAL,39907,0,39907,186477,0,226384
140813000700000,NE 134,RESIDENTIAL,42768,0,42768,216102,0,258870
140813000800000,NE 135,RESIDENTIAL,47143,0,47143,288215,0,335358
140813000900000,NE 135,RESIDENTIAL,45818,0,45818,223164,0,268982
140813001000000,NE 135,RESIDENTIAL,45315,0,45315,325782,0,371097
140813001100000,NE 135,RESIDENTIAL,45552,0,45552,345118,0,390670
140813001200000,NE 135,RESIDENTIAL,42573,0,42573,276724,0,319297
140813001300000,NE 135,RESIDENTIAL,43935,0,43935,200126,0,244061
140813001400000,NE 135,RESIDENTIAL,38833,0,38833,205781,0,244614
140813001500000,NE 135,RESIDENTIAL,39440,0,39440,230921,0,270361
140813001600000,NE 135,RESIDENTIAL,39558,0,39558,239267,0,278825
140813001700000,NE 135,RESIDENTIAL,39888,0,39888,208436,0,248324
140813001800000,NE 134,RESIDENTIAL,35975,0,35975,145375,0,181350
140813001900000,NE 134,RESIDENTIAL,34104,0,34104,137746,0,171850
140813002000000,NE 134,RESIDENTIAL,33027,0,33027,135193,0,168220
140813002100000,NE 134,RESIDENTIAL,37440,0,37440,187235,0,224675
140813002200000,NE 134,RESIDENTIAL,37179,0,37179,139804,0,176983
140813002300000,NE 134,RESIDENTIAL,33920,0,33920,183391,0,217311
140813002400000,NE 134,RESIDENTIAL,35226,0,35226,177858,0,213084
140813002500000,NE 134,RESIDENTIAL,36360,0,36360,202852,0,239212
140813002600000,NE 134,RESIDENTIAL,39244,0,39244,141270,0,180514
140813002700000,NE 134,RESIDENTIAL,39936,0,39936,178085,0,218021
140813100100000,NE 134,RESIDENTIAL,32482,0,32482,138938,0,171420
140813100200000,NE 134,RESIDENTIAL,32818,0,32818,135598,0,168416
140813100300000,NE 134,RESIDENTIAL,31256,0,31256,121737,0,152993
140813100400000,NE 134,RESIDENTIAL,33197,0,33197,150416,0,183613
140813100500000,NE 134,RESIDENTIAL,32705,0,32705,137342,0,170047
140813100600000,NE 134,RESIDENTIAL,38803,0,38803,157709,0,196512
140813100700000,NE 134,RESIDENTIAL,35113,0,35113,160300,0,195413
140813100800000,NE 134,RESIDENTIAL,36474,0,36474,168037,0,204511
140813100900000,NE 134,RESIDENTIAL,31977,0,31977,153889,0,185866
140813101000000,NE 134,RESIDENTIAL,34552,0,34552,183670,0,218222
140813101100000,NE 134,RESIDENTIAL,32636,0,32636,141911,0,174547
140813200100000,NE 134,RESIDENTIAL,31752,0,31752,133441,0,165193
140813200200000,NE 134,RESIDENTIAL,33858,0,33858,118390,0,152248
140813200300000,NE 134,RESIDENTIAL,32119,0,32119,123850,0,155969
140813200400000,NE 134,RESIDENTIAL,32589,0,32589,132414,0,165003
140813200500000,NE 134,RESIDENTIAL,31050,0,31050,129415,0,160465
140813200600000,NE 134,RESIDENTIAL,31742,0,31742,138944,0,170686
140813200700000,NE 135,RESIDENTIAL,39218,0,39218,201779,0,240997
140813200800000,NE 135,RESIDENTIAL,43757,0,43757,223334,0,267091
140813200900000,NE 135,RESIDENTIAL,39583,0,39583,247482,0,287065
140813201000000,NE 135,RESIDENTIAL,41487,0,41487,246702,0,288189
140813201100000,NE 135,RESIDENTIAL,45897,0,45897,266770,0,312667
140813201200000,NE 135,RESIDENTIAL,43541,0,43541,260163,0,303704
140813201300000,NE 135,RESIDENTIAL,45621,0,45621,197379,0,243000
140813201400000,NE 135,RESIDENTIAL,43120,0,43120,220237,0,263357
140813201500000,NE 135,RESIDENTIAL,43925,0,43925,278796,0,322721
140813201600000,NE 135,RESIDENTIAL,46876,0,46876,223124,0,270000
140813201700000,NE 135,RESIDENTIAL,42613,0,42613,331033,0,373646
140813201800000,NE 135,RESIDENTIAL,34650,0,34650,283239,0,317889
140813201900000,NE 135,RESIDENTIAL,41629,0,41629,325111,0,366740
140813202000000,NE 135,RESIDENTIAL,47522,0,47522,265268,0,312790
140813202100000,NE 135,RESIDENTIAL,46425,0,46425,320022,0,366447
140813202200000,NE 134,RESIDENTIAL,42793,0,42793,204681,0,247474
140813202300000,NE 134,RESIDENTIAL,44922,0,44922,225774,0,270696
140813202400000,NE 134,RESIDENTIAL,40850,0,40850,201537,0,242387
140813202500000,NE 134,RESIDENTIAL,37203,0,37203,198087,0,235290
140813202600000,NE 134,RESIDENTIAL,35350,0,35350,185398,0,220748
140813202700000,NE 134,RESIDENTIAL,34875,0,34875,150298,0,185173
140815100100000,NE 134,RESIDENTIAL,39643,0,39643,211237,0,250880
140815100200000,NE 134,RESIDENTIAL,39643,0,39643,209714,0,249357
140815100300000,NE 134,RESIDENTIAL,42753,0,42753,194916,0,237669
140815100400000,NE 135,RESIDENTIAL,61631,0,61631,362817,0,424448
140815100500000,NE 135,RESIDENTIAL,48675,0,48675,306425,0,355100
140815100600000,NE 135,RESIDENTIAL,48905,0,48905,256451,0,305356
140815100700000,NE 135,RESIDENTIAL,51984,0,51984,283995,0,335979
140815100800000,NE 135,RESIDENTIAL,53083,0,53083,354304,0,407387
140815200100000,NE 135,RESIDENTIAL,85050,0,85050,249227,0,334277
140815200200000,NE 135,RESIDENTIAL,48841,0,48841,247034,0,295875
140815200300000,NE 135,RESIDENTIAL,46885,0,46885,249780,0,296665
140815200400000,NE 135,RESIDENTIAL,44092,0,44092,271624,0,315716
140815200500000,NE 135,RESIDENTIAL,44415,0,44415,227321,0,271736
140815200600000,NE 135,RESIDENTIAL,50613,0,50613,267712,0,318325
140815200700000,NE 135,RESIDENTIAL,48790,0,48790,262038,0,310828
140815200800000,NE 135,RESIDENTIAL,48150,0,48150,223456,0,271606
140815200900000,NE 135,RESIDENTIAL,51604,0,51604,183549,0,235153
140815201000000,NE 135,RESIDENTIAL,52873,0,52873,237584,0,290457
140815201100000,NE 135,RESIDENTIAL,58603,0,58603,325410,0,384013
140815201200000,NE 135,RESIDENTIAL,53148,0,53148,272760,0,325908
140815201300000,NE 135,RESIDENTIAL,54320,0,54320,267754,0,322074
140815201400000,NE 135,RESIDENTIAL,49600,0,49600,267187,0,316787
140815201500000,NE 135,RESIDENTIAL,49200,0,49200,256312,0,305512
140815201600000,NE 135,RESIDENTIAL,52885,0,52885,269154,0,322039
140815201700000,NE 135,RESIDENTIAL,45780,0,45780,266308,0,312088
140815201800000,NE 135,RESIDENTIAL,47769,0,47769,258048,0,305817
140815201900000,NE 135,RESIDENTIAL,48828,0,48828,288826,0,337654
140815202000000,NE 135,RESIDENTIAL,49774,0,49774,248222,0,297996
140815202100000,NE 135,RESIDENTIAL,47401,0,47401,225870,0,273271
140815202200000,NE 136,RESIDENTIAL,65135,0,65135,292977,0,358112
140815202300000,NE 136,RESIDENTIAL,60420,0,60420,338909,0,399329
140815202400000,NE 136,RESIDENTIAL,58144,0,58144,291375,0,349519
140815202500000,NE 136,RESIDENTIAL,64418,0,64418,285691,0,350109
140815202600000,NE 136,RESIDENTIAL,65911,0,65911,322323,0,388234
140815202700000,NE 136,RESIDENTIAL,92350,0,92350,332721,0,425071
140815202800000,NE 136,RESIDENTIAL,74240,0,74240,319403,0,393643
140815202900000,NE 136,RESIDENTIAL,67800,0,67800,327541,0,395341
140815203000000,NE 136,RESIDENTIAL,65400,0,65400,303429,0,368829
140815203100000,NE 136,RESIDENTIAL,59875,0,59875,230125,0,290000
140815203200000,NE 136,RESIDENTIAL,48417,0,48417,222145,0,270562
140815203300000,NE 136,RESIDENTIAL,49272,0,49272,254790,0,304062
140815203400000,NE 136,RESIDENTIAL,50818,0,50818,249527,0,300345
140815203500000,NE 136,RESIDENTIAL,76500,0,76500,265061,0,341561
140815203600000,NE 136,RESIDENTIAL,85000,0,85000,264780,0,349780
140815203700000,NE 136,RESIDENTIAL,52929,0,52929,302045,0,354974
140815203800000,NE 136,RESIDENTIAL,44439,0,44439,295990,0,340429
140817600100000,NE 134,RESIDENTIAL,32483,0,32483,166916,0,199399
140817600200000,NE 134,RESIDENTIAL,32942,0,32942,133148,0,166090
140817600300000,NE 134,RESIDENTIAL,31699,0,31699,134975,0,166674
140817600400000,NE 134,RESIDENTIAL,30654,0,30654,158171,0,188825
140817600500000,NE 134,RESIDENTIAL,30234,0,30234,137078,0,167312
140817600600000,NE 134,RESIDENTIAL,30060,0,30060,138685,0,168745
140817600700000,NE 134,RESIDENTIAL,33817,0,33817,142005,0,175822
140817600800000,NE 134,RESIDENTIAL,30060,0,30060,141985,0,172045
140817600900000,NE 134,RESIDENTIAL,30060,0,30060,158219,0,188279
140817601000000,NE 134,RESIDENTIAL,30060,0,30060,163316,0,193376
140817601100000,NE 134,RESIDENTIAL,30182,0,30182,149368,0,179550
140817700100000,NE 134,RESIDENTIAL,29916,0,29916,109109,0,139025
140817700200000,NE 134,RESIDENTIAL,36644,0,36644,109009,0,145653
140817700300000,NE 134,RESIDENTIAL,37166,0,37166,117665,0,154831
140817700400000,NE 134,RESIDENTIAL,33354,0,33354,126096,0,159450
140817700500000,NE 134,RESIDENTIAL,36960,0,36960,157923,0,194883
140817700600000,NE 134,RESIDENTIAL,35269,0,35269,105067,0,140336
140817700700000,NE 134,RESIDENTIAL,36540,0,36540,145314,0,181854
140817700800000,NE 134,RESIDENTIAL,33068,0,33068,126113,0,159181
140817700900000,NE 134,RESIDENTIAL,32604,0,32604,155934,0,188538
140817701000000,NE 134,RESIDENTIAL,34398,0,34398,153714,0,188112
140817701100000,NE 134,RESIDENTIAL,40709,0,40709,134554,0,175263
140817701200000,NE 134,RESIDENTIAL,39724,0,39724,153368,0,193092
140817701300000,NE 134,RESIDENTIAL,32484,0,32484,108930,0,141414
140817701400000,NE 134,RESIDENTIAL,32393,0,32393,119386,0,151779
140817701500000,NE 134,RESIDENTIAL,30195,0,30195,107024,0,137219
140817701600000,NE 134,RESIDENTIAL,28598,0,28598,109412,0,138010
140817701700000,NE 134,RESIDENTIAL,29258,0,29258,138004,0,167262
140817800100000,NE 134,RESIDENTIAL,34992,0,34992,103760,0,138752
140817800200000,NE 134,RESIDENTIAL,34194,0,34194,124061,0,158255
140817800300000,NE 134,RESIDENTIAL,37968,0,37968,126296,0,164264
140817800400000,NE 134,RESIDENTIAL,34749,0,34749,131436,0,166185
140817800500000,NE 134,RESIDENTIAL,33372,0,33372,174582,0,207954
140817800600000,NE 134,RESIDENTIAL,34542,0,34542,108366,0,142908
140817800700000,NE 135,RESIDENTIAL,64050,0,64050,307837,0,371887
140817800800000,NE 135,RESIDENTIAL,75250,0,75250,289943,0,365193
140817800900000,NE 134,RESIDENTIAL,46962,0,46962,221481,0,268443
140817801000000,NE 134,RESIDENTIAL,32960,0,32960,136321,0,169281
140817801100000,NE 134,RESIDENTIAL,32640,0,32640,190453,0,223093
140817801200000,NE 134,RESIDENTIAL,43231,0,43231,197118,0,240349
140817801300000,NE 134,RESIDENTIAL,39830,0,39830,163520,0,203350
140817801400000,NE 134,RESIDENTIAL,34749,0,34749,115456,0,150205
140817801500000,NE 134,RESIDENTIAL,34898,0,34898,114767,0,149665
140817801600000,NE 134,RESIDENTIAL,37064,0,37064,162864,0,199928
140817801700000,NE 134,RESIDENTIAL,34157,0,34157,99995,0,134152
140817801800000,NE 134,RESIDENTIAL,36146,0,36146,122584,0,158730
140817900100000,NE 134,RESIDENTIAL,45423,0,45423,163958,0,209381
140817900200000,NE 134,RESIDENTIAL,39089,0,39089,151007,0,190096
140817900300000,NE 134,RESIDENTIAL,38375,0,38375,163888,0,202263
140817900400000,NE 134,RESIDENTIAL,37853,0,37853,126917,0,164770
140817900700000,NE 134,RESIDENTIAL,38587,0,38587,179739,0,218326
140818000100000,NE 134,RESIDENTIAL,38784,0,38784,159713,0,198497
140818000200000,NE 134,RESIDENTIAL,38343,0,38343,168457,0,206800
140818000300000,NE 134,RESIDENTIAL,53106,0,53106,140158,0,193264
140818000400000,NE 134,RESIDENTIAL,39217,0,39217,139146,0,178363
140818000500000,NE 134,RESIDENTIAL,36403,0,36403,161713,0,198116
140818000600000,NE 134,RESIDENTIAL,35910,0,35910,106701,0,142611
140818000700000,NE 134,RESIDENTIAL,43398,0,43398,229915,0,273313
140818000800000,NE 134,RESIDENTIAL,31680,0,31680,183477,0,215157
140818000900000,NE 134,RESIDENTIAL,31807,0,31807,0,0,31807
140818001200000,CENTRALLY ASSESSED,OTHER,0,0,0,0,0,0
140818001300000,CITY PROPERTY,EXEMPT,0,0,0,0,0,0
140818100100000,NE 135,RESIDENTIAL,48208,0,48208,167881,0,216089
140818100200000,NE 135,RESIDENTIAL,44408,0,44408,195144,0,239552
140818100300000,NE 135,RESIDENTIAL,44167,0,44167,177137,0,221304
140818100400000,NE 135,RESIDENTIAL,52148,0,52148,198339,0,250487
140818100500000,NE 135,RESIDENTIAL,77000,0,77000,254358,0,331358
140818100600000,NE 135,RESIDENTIAL,64743,0,64743,260298,0,325041
140818100700000,NE 135,RESIDENTIAL,51520,0,51520,229927,0,281447
140818100800000,NE 135,RESIDENTIAL,73905,0,73905,344667,0,418572
140818100900000,NE 135,RESIDENTIAL,64424,0,64424,210644,0,275068
140818101000000,NE 135,RESIDENTIAL,64565,0,64565,228212,0,292777
140818101100000,NE 135,RESIDENTIAL,57306,0,57306,230735,0,288041
140818101200000,NE 135,RESIDENTIAL,63220,0,63220,220036,0,283256
140818200500000,NE 134,RESIDENTIAL,34729,0,34729,151474,0,186203
140818200600000,NE 134,RESIDENTIAL,34884,0,34884,160132,0,195016
140820100100000,NE 139,RESIDENTIAL,22450,0,22450,0,0,22450
140820100200000,NE 139,RESIDENTIAL,29030,0,29030,136102,0,165132
140820100300000,NE 139,RESIDENTIAL,27471,0,27471,122904,0,150375
140820100400000,NE 139,RESIDENTIAL,27677,0,27677,139285,0,166962
140820100500000,NE 139,RESIDENTIAL,29016,0,29016,120969,0,149985
140820100600000,NE 139,RESIDENTIAL,26412,0,26412,120085,0,146497
140820100700000,NE 139,RESIDENTIAL,25296,0,25296,125219,0,150515
140820100800000,NE 139,RESIDENTIAL,24056,0,24056,134555,0,158611
140820100900000,NE 139,RESIDENTIAL,24056,0,24056,145493,0,169549
140820101000000,NE 139,RESIDENTIAL,23312,0,23312,130945,0,154257
140820101100000,NE 139,RESIDENTIAL,26320,0,26320,112546,0,138866
140820101400000,NE 139,RESIDENTIAL,15166,0,15166,164603,0,179769
140820101500000,NE 139,RESIDENTIAL,10318,0,10318,178671,0,188989
140820101600000,NE 139,RESIDENTIAL,21016,0,21016,148715,0,169731
140820101700000,NE 139,RESIDENTIAL,9387,0,9387,117275,0,126662
140820101800000,NE 139,RESIDENTIAL,15750,0,15750,116087,0,131837
140820101900000,NE 139,RESIDENTIAL,16302,0,16302,126795,0,143097
140820102000000,NE 139,RESIDENTIAL,9387,0,9387,115745,0,125132
140820102300000,NE 139,RESIDENTIAL,13728,0,13728,153720,0,167448
140820102400000,NE 139,RESIDENTIAL,12348,0,12348,166337,0,178685
140820102600000,NE 139,RESIDENTIAL,28500,0,28500,156382,0,184882
140820103900000,NE 139,RESIDENTIAL,16647,0,16647,149937,0,166584
140820104000000,NE 139,RESIDENTIAL,10317,0,10317,145542,0,155859
140820104100000,NE 139,RESIDENTIAL,26320,0,26320,114079,0,140399
140820104200000,NE 139,RESIDENTIAL,29030,0,29030,131615,0,160645
140820104300000,NE 139,RESIDENTIAL,25269,0,25269,160434,0,185703
140820104400000,NE 139,RESIDENTIAL,25192,0,25192,144414,0,169606
140820104500000,NE 139,RESIDENTIAL,27776,0,27776,160479,0,188255
140820104600000,NE 139,RESIDENTIAL,27776,0,27776,161080,0,188856
140820104700000,NE 139,RESIDENTIAL,27776,0,27776,164671,0,192447
140820104800000,NE 139,RESIDENTIAL,25792,0,25792,145215,0,171007
140820104900000,NE 139,RESIDENTIAL,26598,0,26598,163175,0,189773
140820105000000,NE 139,RESIDENTIAL,26320,0,26320,138780,0,165100
140820105100000,NE 139,RESIDENTIAL,26320,0,26320,132357,0,158677
140820105200000,NE 139,RESIDENTIAL,29400,0,29400,184576,0,213976
140820105300000,NE 139,RESIDENTIAL,29513,0,29513,136733,0,166246
140820105400000,NE 139,RESIDENTIAL,28667,0,28667,132345,0,161012
140820105500000,NE 139,RESIDENTIAL,28248,0,28248,144737,0,172985
140820105600000,NE 139,RESIDENTIAL,27323,0,27323,136270,0,163593
140820105700000,NE 139,RESIDENTIAL,28373,0,28373,152164,0,180537
140820105800000,NE 139,RESIDENTIAL,28971,0,28971,154434,0,183405
140820105900000,NE 139,RESIDENTIAL,27136,0,27136,162914,0,190050
140820106000000,NE 139,RESIDENTIAL,28036,0,28036,133645,0,161681
140820106100000,NE 139,RESIDENTIAL,22100,0,22100,115142,0,137242
140820106200000,NE 139,RESIDENTIAL,29914,0,29914,165096,0,195010
140820106300000,NE 139,RESIDENTIAL,27611,0,27611,161917,0,189528
140820106400000,NE 139,RESIDENTIAL,30189,0,30189,157720,0,187909
140820106500000,NE 139,RESIDENTIAL,29433,0,29433,130125,0,159558
140820106600000,NE 139,RESIDENTIAL,28776,0,28776,122930,0,151706
140820106700000,NE 139,RESIDENTIAL,30174,0,30174,128891,0,159065
140820106800000,NE 139,RESIDENTIAL,28764,0,28764,118334,0,147098
140820106900000,NE 139,RESIDENTIAL,28262,0,28262,144760,0,173022
140820107000000,NE 139,RESIDENTIAL,28280,0,28280,155630,0,183910
140820107100000,NE 139,RESIDENTIAL,28621,0,28621,130892,0,159513
140820107200000,NE 139,RESIDENTIAL,50438,0,50438,0,0,50438
140820107300000,NE 139,RESIDENTIAL,41817,0,41817,229979,0,271796
140820107400000,NE 139,RESIDENTIAL,39220,0,39220,220074,0,259294
140820107500000,NE 139,RESIDENTIAL,40838,0,40838,202218,0,243056
140820107600000,NE 139,RESIDENTIAL,36537,0,36537,201820,0,238357
140820107700000,NE 139,RESIDENTIAL,36320,0,36320,188119,0,224439
140820107800000,NE 139,RESIDENTIAL,36719,0,36719,195581,0,232300
140820107900000,NE 139,RESIDENTIAL,37893,0,37893,204155,0,242048
140820108000000,NE 139,RESIDENTIAL,35520,0,35520,199505,0,235025
140820108100000,NE 139,RESIDENTIAL,38220,0,38220,227173,0,265393
140820108200000,NE 139,RESIDENTIAL,39215,0,39215,207595,0,246810
140820108300000,NE 139,RESIDENTIAL,41807,0,41807,200189,0,241996
140820108400000,NE 139,RESIDENTIAL,42244,0,42244,203490,0,245734
140820108500000,NE 139,RESIDENTIAL,39990,0,39990,213031,0,253021
140820108600000,NE 139,RESIDENTIAL,39835,0,39835,203532,0,243367
140820108700000,NE 139,RESIDENTIAL,40058,0,40058,223531,0,263589
140820108800000,NE 139,RESIDENTIAL,39480,0,39480,183843,0,223323
140820108900000,NE 139,RESIDENTIAL,39480,0,39480,233640,0,273120
140820109000000,NE 139,RESIDENTIAL,39480,0,39480,183904,0,223384
140820109100000,NE 139,RESIDENTIAL,43986,0,43986,208386,0,252372
140820109200000,NE 135,RESIDENTIAL,135,0,135,0,0,135
140820109300000,NE 139,RESIDENTIAL,42778,0,42778,180459,0,223237
140820109400000,NE 139,RESIDENTIAL,42300,0,42300,212466,0,254766
140820109500000,NE 139,RESIDENTIAL,42075,0,42075,189499,0,231574
140820109600000,NE 139,RESIDENTIAL,41904,0,41904,218785,0,260689
140820109700000,NE 139,RESIDENTIAL,41807,0,41807,179463,0,221270
140820109800000,NE 139,RESIDENTIAL,42770,0,42770,192230,0,235000
140820109900000,NE 139,RESIDENTIAL,41681,0,41681,249833,0,291514
140820110000000,NE 139,RESIDENTIAL,42864,0,42864,147136,0,190000
140820110100000,NE 139,RESIDENTIAL,42864,0,42864,179662,0,222526
140820110200000,NE 139,RESIDENTIAL,43005,0,43005,163748,0,206753
140820110400000,CHURCH,EXEMPT,0,389016,389016,0,3549303,3938319
140820200100000,NE 135,RESIDENTIAL,44042,0,44042,316967,0,361009
140820200200000,NE 135,RESIDENTIAL,41876,0,41876,303337,0,345213
140820200300000,NE 135,RESIDENTIAL,44585,0,44585,302192,0,346777
140820200400000,NE 135,RESIDENTIAL,43614,0,43614,202569,0,246183
140820200500000,NE 135,RESIDENTIAL,40480,0,40480,255494,0,295974
140820300100000,NE 136,RESIDENTIAL,38882,0,38882,131896,0,170778
140820300200000,NE 136,RESIDENTIAL,37331,0,37331,154068,0,191399
140822602400000,CITY PROPERTY,EXEMPT,0,0,0,0,0,0
140822801000000,NE 140,RESIDENTIAL,11100,0,11100,0,0,11100
140825100100000,NE 138,RESIDENTIAL,10944,0,10944,0,0,10944
140825100200000,NE 138,RESIDENTIAL,61850,0,61850,133358,0,195208
140825100300000,NE 138,RESIDENTIAL,50530,0,50530,154470,0,205000
140825100400000,NE 138,RESIDENTIAL,48750,0,48750,137919,0,186669
140825100500000,NE 138,RESIDENTIAL,55250,0,55250,198470,0,253720
140825100600000,NE 138,RESIDENTIAL,43700,0,43700,210989,0,254689
140825100700000,NE 138,RESIDENTIAL,51733,0,51733,223330,0,275063
140825100800000,NE 138,RESIDENTIAL,44640,0,44640,275919,0,320559
140825100900000,NE 138,RESIDENTIAL,48180,0,48180,200295,0,248475
140825101000000,NE 138,RESIDENTIAL,49434,0,49434,127002,0,176436
140825101100000,NE 138,RESIDENTIAL,45125,0,45125,214102,0,259227
140825101200000,NE 138,RESIDENTIAL,46550,0,46550,175043,0,221593
140825101300000,NE 138,RESIDENTIAL,46550,0,46550,230779,0,277329
140825101400000,NE 138,RESIDENTIAL,49000,0,49000,180863,0,229863
140825101500000,NE 138,RESIDENTIAL,51649,0,51649,213593,0,265242
140825101600000,NE 138,RESIDENTIAL,48672,0,48672,172076,0,220748
140825101700000,NE 138,RESIDENTIAL,124297,0,124297,255380,0,379677
140825101800000,NE 138,RESIDENTIAL,63469,0,63469,223492,0,286961
140825101900000,NE 138,RESIDENTIAL,76550,0,76550,258011,0,334561
140825102000000,NE 138,RESIDENTIAL,76600,0,76600,288143,0,364743
140825102100000,NE 138,RESIDENTIAL,53309,0,53309,262153,0,315462
140825102200000,NE 138,RESIDENTIAL,52635,0,52635,203121,0,255756
140825102300000,NE 138,RESIDENTIAL,75400,0,75400,253212,0,328612
140825102400000,NE 138,RESIDENTIAL,54589,0,54589,185195,0,239784
140825102500000,NE 138,RESIDENTIAL,49908,0,49908,193744,0,243652
140825102600000,NE 138,RESIDENTIAL,46550,0,46550,180131,0,226681
140825102700000,NE 138,RESIDENTIAL,46550,0,46550,189148,0,235698
140825102800000,NE 138,RESIDENTIAL,51943,0,51943,196594,0,248537
140825102900000,NE 138,RESIDENTIAL,44820,0,44820,164912,0,209732
140825103000000,NE 138,RESIDENTIAL,52552,0,52552,138710,0,191262
140825103100000,NE 138,RESIDENTIAL,56437,0,56437,233053,0,289490
140825103200000,NE 138,RESIDENTIAL,50400,0,50400,274386,0,324786
140825103300000,NE 138,RESIDENTIAL,75500,0,75500,213757,0,289257
140825103400000,NE 138,RESIDENTIAL,48577,0,48577,251362,0,299939
140825103500000,NE 138,RESIDENTIAL,48195,0,48195,273314,0,321509
140825103600000,NE 138,RESIDENTIAL,51276,0,51276,225239,0,276515
140825103700000,NE 138,RESIDENTIAL,56962,0,56962,199787,0,256749
140825103800000,NE 138,RESIDENTIAL,56850,0,56850,214827,0,271677
140825103900000,NE 138,RESIDENTIAL,61785,0,61785,284980,0,346765
140825104000000,NE 138,RESIDENTIAL,20,0,20,0,0,20
140825104100000,NE 138,RESIDENTIAL,20,0,20,0,0,20
140825104200000,NE 138,RESIDENTIAL,20,0,20,0,0,20
140825200100000,NE 138,RESIDENTIAL,47923,0,47923,186974,0,234897
140825200300000,NE 138,RESIDENTIAL,47500,0,47500,150588,0,198088
140825200400000,NE 138,RESIDENTIAL,47500,0,47500,158306,0,205806
140825200500000,NE 138,RESIDENTIAL,47500,0,47500,128329,0,175829
140825300700000,NE 138,RESIDENTIAL,78,0,78,0,0,78
140825400100000,NE 138,RESIDENTIAL,51500,0,51500,290930,0,342430
140825400200000,NE 138,RESIDENTIAL,51300,0,51300,262727,0,314027
140825400300000,NE 138,RESIDENTIAL,50850,0,50850,283151,0,334001
140825400400000,NE 138,RESIDENTIAL,52200,0,52200,287035,0,339235
140825400500000,NE 138,RESIDENTIAL,56952,0,56952,268419,0,325371
140825400600000,NE 138,RESIDENTIAL,55781,0,55781,292427,0,348208
140825400700000,NE 138,RESIDENTIAL,47500,0,47500,236082,0,283582
140827600100000,NE 136,RESIDENTIAL,38467,0,38467,146655,0,185122
140827600200000,NE 136,RESIDENTIAL,37629,0,37629,131626,0,169255
140827600300000,NE 136,RESIDENTIAL,38326,0,38326,129444,0,167770
140827600400000,NE 136,RESIDENTIAL,39064,0,39064,137987,0,177051
140827600500000,NE 136,RESIDENTIAL,39108,0,39108,146828,0,185936
140827600600000,NE 136,RESIDENTIAL,37843,0,37843,135049,0,172892
140827600700000,NE 136,RESIDENTIAL,38610,0,38610,137243,0,175853
140827600800000,NE 136,RESIDENTIAL,38873,0,38873,144771,0,183644
140827600900000,NE 136,RESIDENTIAL,37660,0,37660,152988,0,190648
140827601000000,NE 136,RESIDENTIAL,37500,0,37500,141886,0,179386
140827601100000,NE 136,RESIDENTIAL,39312,0,39312,139513,0,178825
140827601200000,NE 136,RESIDENTIAL,38313,0,38313,122927,0,161240
140827601300000,NE 136,RESIDENTIAL,37406,0,37406,148798,0,186204
140827601400000,NE 136,RESIDENTIAL,40893,0,40893,131596,0,172489
140827601500000,NE 136,RESIDENTIAL,34508,0,34508,126822,0,161330
140827601600000,NE 136,RESIDENTIAL,35167,0,35167,134778,0,169945
140827601700000,NE 136,RESIDENTIAL,36167,0,36167,155639,0,191806
140827601800000,NE 136,RESIDENTIAL,35855,0,35855,152157,0,188012
140827601900000,NE 136,RESIDENTIAL,36550,0,36550,138398,0,174948
140827602000000,NE 136,RESIDENTIAL,35687,0,35687,135947,0,171634
140827602100000,NE 136,RESIDENTIAL,36966,0,36966,132288,0,169254
140827602200000,NE 136,RESIDENTIAL,36880,0,36880,136155,0,173035
140827602300000,NE 136,RESIDENTIAL,37125,0,37125,158143,0,195268
140827602400000,NE 136,RESIDENTIAL,38800,0,38800,151401,0,190201
140827602500000,NE 136,RESIDENTIAL,39162,0,39162,165761,0,204923
140827602600000,NE 136,RESIDENTIAL,37561,0,37561,145975,0,183536
140827602700000,NE 136,RESIDENTIAL,38874,0,38874,147676,0,186550
140827602800000,NE 136,RESIDENTIAL,34880,0,34880,128657,0,163537
140827602900000,NE 136,RESIDENTIAL,35243,0,35243,145799,0,181042
140827603000000,NE 136,RESIDENTIAL,38475,0,38475,157774,0,196249
140827603100000,NE 136,RESIDENTIAL,38430,0,38430,152877,0,191307
140827603200000,NE 136,RESIDENTIAL,36400,0,36400,142494,0,178894
140827603300000,NE 136,RESIDENTIAL,35182,0,35182,156270,0,191452
140827700100000,NE 136,RESIDENTIAL,37998,0,37998,140405,0,178403
140827700200000,NE 136,RESIDENTIAL,37998,0,37998,160286,0,198284
140827700300000,NE 136,RESIDENTIAL,37500,0,37500,134567,0,172067
140827700400000,NE 136,RESIDENTIAL,37516,0,37516,122045,0,159561
140827700500000,NE 136,RESIDENTIAL,37842,0,37842,132311,0,170153
140827700600000,NE 136,RESIDENTIAL,40185,0,40185,135977,0,176162
140827700700000,NE 136,RESIDENTIAL,37500,0,37500,146243,0,183743
140827800100000,NE 136,RESIDENTIAL,40196,0,40196,144525,0,184721
140827800200000,NE 136,RESIDENTIAL,40168,0,40168,131251,0,171419
140827800300000,NE 136,RESIDENTIAL,40712,0,40712,159277,0,199989
140827800400000,NE 136,RESIDENTIAL,41412,0,41412,139966,0,181378
140827800500000,NE 136,RESIDENTIAL,40097,0,40097,125630,0,165727
140827800600000,NE 136,RESIDENTIAL,41959,0,41959,134520,0,176479
140827800700000,NE 136,RESIDENTIAL,39105,0,39105,124685,0,163790
140827800800000,NE 136,RESIDENTIAL,39610,0,39610,123357,0,162967
140827800900000,NE 136,RESIDENTIAL,39558,0,39558,177670,0,217228
140827801000000,NE 136,RESIDENTIAL,41648,0,41648,158794,0,200442
140827801100000,NE 136,RESIDENTIAL,41819,0,41819,164058,0,205877
140827801200000,NE 136,RESIDENTIAL,44471,0,44471,163335,0,207806
140827801300000,NE 136,RESIDENTIAL,46410,0,46410,178787,0,225197
140827801400000,NE 136,RESIDENTIAL,41809,0,41809,148002,0,189811
140827801500000,NE 136,RESIDENTIAL,42997,0,42997,154953,0,197950
140827801600000,NE 136,RESIDENTIAL,43173,0,43173,141350,0,184523
140827801700000,NE 136,RESIDENTIAL,40422,0,40422,162407,0,202829
140827801800000,NE 136,RESIDENTIAL,40779,0,40779,142642,0,183421
140827801900000,NE 136,RESIDENTIAL,36600,0,36600,131758,0,168358
140827802000000,NE 136,RESIDENTIAL,39487,0,39487,137292,0,176779
140827802100000,NE 136,RESIDENTIAL,40664,0,40664,150822,0,191486
140827802200000,NE 136,RESIDENTIAL,40978,0,40978,133206,0,174184
140827802300000,NE 136,RESIDENTIAL,41960,0,41960,195098,0,237058
140827802400000,NE 136,RESIDENTIAL,37718,0,37718,139387,0,177105
140827802500000,NE 136,RESIDENTIAL,39238,0,39238,145781,0,185019
140827802600000,NE 136,RESIDENTIAL,42067,0,42067,155150,0,197217
140827802700000,NE 136,RESIDENTIAL,45120,0,45120,142299,0,187419
140827802800000,NE 136,RESIDENTIAL,45570,0,45570,158359,0,203929
140827802900000,NE 136,RESIDENTIAL,46050,0,46050,152730,0,198780
140827803000000,NE 136,RESIDENTIAL,45690,0,45690,138942,0,184632
140827803100000,NE 136,RESIDENTIAL,1200,0,1200,0,0,1200
140827900100000,NE 136,RESIDENTIAL,51370,0,51370,291214,0,342584
140828000100000,NE 136,RESIDENTIAL,47320,0,47320,199591,0,246911
140828000200000,NE 136,RESIDENTIAL,46611,0,46611,226384,0,272995
140828000300000,NE 136,RESIDENTIAL,48357,0,48357,259896,0,308253
140828000400000,NE 136,RESIDENTIAL,37206,0,37206,157525,0,194731
140828000500000,NE 136,RESIDENTIAL,36813,0,36813,136212,0,173025
140828000600000,NE 136,RESIDENTIAL,41007,0,41007,150336,0,191343
140828000700000,NE 136,RESIDENTIAL,39346,0,39346,148448,0,187794
140828000800000,NE 136,RESIDENTIAL,42997,0,42997,171544,0,214541
140828000900000,NE 136,RESIDENTIAL,43125,0,43125,173450,0,216575
140828001000000,NE 136,RESIDENTIAL,40116,0,40116,179660,0,219776
140828001100000,NE 136,RESIDENTIAL,40836,0,40836,145202,0,186038
140828001200000,NE 136,RESIDENTIAL,39924,0,39924,126089,0,166013
140828001300000,NE 136,RESIDENTIAL,41850,0,41850,159003,0,200853
140828001400000,NE 136,RESIDENTIAL,42187,0,42187,157769,0,199956
140830100100000,NE 137,RESIDENTIAL,61820,0,61820,213977,0,275797
140830100200000,NE 136,RESIDENTIAL,52741,0,52741,186014,0,238755
140830100300000,NE 137,RESIDENTIAL,54981,0,54981,225976,0,280957
140830100400000,NE 137,RESIDENTIAL,32520,0,32520,173328,0,205848
140830100700000,NE 137,RESIDENTIAL,64020,0,64020,299662,0,363682
140830100900000,NE 167,RESIDENTIAL,76454,0,76454,324225,0,400679
140830101000000,NE 167,RESIDENTIAL,69041,0,69041,304589,0,373630
140830101100000,NE 167,RESIDENTIAL,68322,0,68322,396953,0,465275
140830101200000,NE 167,RESIDENTIAL,71229,0,71229,367441,0,438670
140830101300000,NE 167,RESIDENTIAL,73401,0,73401,382836,0,456237
140830101400000,NE 167,RESIDENTIAL,72069,0,72069,363300,0,435369
140830101500000,NE 167,RESIDENTIAL,86402,0,86402,305390,0,391792
140830101600000,NE 167,RESIDENTIAL,73442,0,73442,363161,0,436603
140830101700000,NE 167,RESIDENTIAL,88061,0,88061,385428,0,473489
140830101800000,NE 167,RESIDENTIAL,5138,0,5138,0,0,5138
140830101900000,NE 167,RESIDENTIAL,5004,0,5004,0,0,5004
140830102000000,NE 167,RESIDENTIAL,5004,0,5004,0,0,5004
140830102100000,NE 167,RESIDENTIAL,4253,0,4253,0,0,4253
140830102200000,NE 167,RESIDENTIAL,3628,0,3628,0,0,3628
140830102300000,NE 167,RESIDENTIAL,3252,0,3252,0,0,3252
140830102400000,NE 167,RESIDENTIAL,3628,0,3628,0,0,3628
140830102600000,NE 167,RESIDENTIAL,6129,0,6129,0,0,6129
140830102700000,NE 167,RESIDENTIAL,5004,0,5004,0,0,5004
140830102800000,NE 167,RESIDENTIAL,4754,0,4754,0,0,4754
140830102900000,NE 167,RESIDENTIAL,100980,0,100980,311490,0,412470
140830103000000,NE 167,RESIDENTIAL,4503,0,4503,0,0,4503
140830103100000,NE 167,RESIDENTIAL,97970,0,97970,338712,0,436682
140830103200000,NE 149,RESIDENTIAL,3850,0,3850,0,0,3850
140830103300000,NE 149,RESIDENTIAL,25200,0,25200,0,0,25200
140830103400000,NE 167,RESIDENTIAL,84525,0,84525,327882,0,412407
140830200100000,NE 137,RESIDENTIAL,49511,0,49511,199389,0,248900
140830200200000,NE 137,RESIDENTIAL,55685,0,55685,189370,0,245055
140830200300000,NE 137,RESIDENTIAL,58352,0,58352,313356,0,371708
140830200400000,NE 137,RESIDENTIAL,70276,0,70276,331680,0,401956
140830200500000,NE 137,RESIDENTIAL,57288,0,57288,279130,0,336418
140830200600000,NE 137,RESIDENTIAL,60366,0,60366,192299,0,252665
140830200700000,NE 137,RESIDENTIAL,62016,0,62016,218335,0,280351
140830200800000,NE 137,RESIDENTIAL,60336,0,60336,276218,0,336554
140830200900000,NE 137,RESIDENTIAL,49895,0,49895,175950,0,225845
140830201000000,NE 137,RESIDENTIAL,55105,0,55105,196393,0,251498
140830201100000,NE 137,RESIDENTIAL,54388,0,54388,184743,0,239131
140830201200000,NE 137,RESIDENTIAL,54945,0,54945,198191,0,253136
140830300100000,NE 137,RESIDENTIAL,61123,0,61123,238200,0,299323
140830300200000,NE 137,RESIDENTIAL,60900,0,60900,256154,0,317054
140830300300000,NE 137,RESIDENTIAL,63825,0,63825,256650,0,320475
140830300400000,NE 137,RESIDENTIAL,65151,0,65151,304009,0,369160
140830300500000,NE 137,RESIDENTIAL,63990,0,63990,243789,0,307779
140830300600000,NE 137,RESIDENTIAL,60833,0,60833,226666,0,287499
140830300700000,NE 167,RESIDENTIAL,104558,0,104558,534446,0,639004
140830300800000,NE 167,RESIDENTIAL,92800,0,92800,338907,0,431707
140830300900000,NE 167,RESIDENTIAL,75582,0,75582,352285,0,427867
140830301000000,NE 167,RESIDENTIAL,98325,0,98325,345357,0,443682
140830301100000,NE 167,RESIDENTIAL,89390,0,89390,372517,0,461907
140830301200000,NE 167,RESIDENTIAL,83448,0,83448,382522,0,465970
140830301300000,NE 167,RESIDENTIAL,83362,0,83362,363501,0,446863
140830301400000,NE 167,RESIDENTIAL,86402,0,86402,366753,0,453155
140832600100000,NE 137,RESIDENTIAL,68995,0,68995,403031,0,472026
140832600200000,NE 137,RESIDENTIAL,68818,0,68818,359946,0,428764
140832600300000,NE 137,RESIDENTIAL,78150,0,78150,274661,0,352811
140832600400000,NE 138,RESIDENTIAL,65875,0,65875,232704,0,298579
140832600500000,NE 138,RESIDENTIAL,64062,0,64062,239325,0,303387
140832600600000,NE 138,RESIDENTIAL,60560,0,60560,201233,0,261793
140832600700000,NE 138,RESIDENTIAL,64260,0,64260,337332,0,401592
140832600800000,NE 138,RESIDENTIAL,61680,0,61680,317740,0,379420
140832600900000,NE 138,RESIDENTIAL,67680,0,67680,277096,0,344776
140832601000000,NE 138,RESIDENTIAL,62320,0,62320,254732,0,317052
140832601100000,NE 138,RESIDENTIAL,54702,0,54702,333371,0,388073
140832601200000,NE 138,RESIDENTIAL,58032,0,58032,280716,0,338748
140832601300000,NE 138,RESIDENTIAL,51012,0,51012,182841,0,233853
140832601400000,NE 138,RESIDENTIAL,56407,0,56407,261442,0,317849
140832601500000,NE 138,RESIDENTIAL,55526,0,55526,291808,0,347334
140832601600000,NE 138,RESIDENTIAL,100600,0,100600,255710,0,356310
140832601800000,NE 137,RESIDENTIAL,77200,0,77200,239800,0,317000
140832601900000,NE 137,RESIDENTIAL,30380,0,30380,0,0,30380
140832602000000,NE 137,RESIDENTIAL,78250,0,78250,230481,0,308731
140832602100000,NE 137,RESIDENTIAL,77200,0,77200,227800,0,305000
140832602300000,NE 167,RESIDENTIAL,91123,0,91123,465955,0,557078
140832602400000,NE 167,RESIDENTIAL,78826,0,78826,479127,0,557953
140832602500000,NE 167,RESIDENTIAL,99450,0,99450,345140,0,444590
140832602600000,NE 167,RESIDENTIAL,86895,0,86895,0,0,86895
140832602700000,CITY PROPERTY,EXEMPT,0,0,0,0,0,0
140832602800000,NE 167,RESIDENTIAL,74814,0,74814,355390,0,430204
140832700100000,NE 138,RESIDENTIAL,62152,0,62152,333800,0,395952
140835100100000,NE 167,RESIDENTIAL,71504,0,71504,0,0,71504
140835100200000,NE 167,RESIDENTIAL,81081,0,81081,426635,0,507716
140835100300000,NE 167,RESIDENTIAL,88036,0,88036,447817,0,535853
140835100400000,NE 167,RESIDENTIAL,73400,0,73400,442807,0,516207
140835200200000,NE 167,RESIDENTIAL,154100,0,154100,962295,0,1116395
140835200300000,NE 167,RESIDENTIAL,71198,0,71198,564868,0,636066
140835200400000,NE 167,RESIDENTIAL,92988,0,92988,394040,0,487028
140835200500000,NE 167,RESIDENTIAL,88919,0,88919,436426,0,525345
140835200600000,NE 167,RESIDENTIAL,102240,0,102240,398778,0,501018
140835200700000,NE 167,RESIDENTIAL,90293,0,90293,342433,0,432726
140835200800000,NE 167,RESIDENTIAL,53409,0,53409,0,0,53409
140835200900000,NE 167,RESIDENTIAL,59129,0,59129,364021,0,423150
140835201000000,NE 167,RESIDENTIAL,88585,0,88585,294122,0,382707
140835201100000,NE 167,RESIDENTIAL,87675,0,87675,276508,0,364183
140835201200000,CENTRALLY ASSESSED,OTHER,0,0,0,0,0,0
140835201300000,NE 167,RESIDENTIAL,77616,0,77616,410743,0,488359
140835201400000,NE 167,RESIDENTIAL,82971,0,82971,474165,0,557136
140835201500000,NE 167,RESIDENTIAL,129363,0,129363,412336,0,541699
140835201600000,NE 167,RESIDENTIAL,131000,0,131000,469216,0,600216
140835201700000,NE 167,RESIDENTIAL,206350,0,206350,560279,0,766629
140835201800000,NE 167,RESIDENTIAL,122944,0,122944,507699,0,630643
140835201900000,NE 167,RESIDENTIAL,98428,0,98428,514512,0,612940
140835202000000,NE 167,RESIDENTIAL,95558,0,95558,434442,0,530000
140837600100000,CITY PROPERTY,EXEMPT,0,0,0,0,0,0
140837600500000,NE 167,RESIDENTIAL,113227,0,113227,363028,0,476255
140837600600000,NE 167,RESIDENTIAL,81354,0,81354,337821,0,419175
140837600700000,NE 167,RESIDENTIAL,80535,0,80535,370542,0,451077
140837600800000,NE 167,RESIDENTIAL,71938,0,71938,0,0,71938
140837600900000,NE 167,RESIDENTIAL,82000,0,82000,323053,0,405053
140837601000000,NE 167,RESIDENTIAL,74631,0,74631,362714,0,437345
140837601100000,NE 167,RESIDENTIAL,75717,0,75717,325369,0,401086
140837601200000,NE 167,RESIDENTIAL,64855,0,64855,0,0,64855
140837601300000,NE 167,RESIDENTIAL,134080,0,134080,264810,0,398890
140837601400000,NE 167,RESIDENTIAL,133289,0,133289,401154,0,534443
140837601500000,NE 167,RESIDENTIAL,7532,0,7532,0,0,7532
140837601600000,NE 167,RESIDENTIAL,8070,0,8070,0,0,8070
140837601700000,NE 167,RESIDENTIAL,9049,0,9049,0,0,9049
140837700100000,NE 167,RESIDENTIAL,60775,0,60775,361726,0,422501
140837700200000,NE 167,RESIDENTIAL,73173,0,73173,348165,0,421338
140837700300000,NE 167,RESIDENTIAL,74725,0,74725,373594,0,448319
140837700600000,NE 167,RESIDENTIAL,54000,0,54000,383795,0,437795
140837700900000,NE 167,RESIDENTIAL,57420,0,57420,333866,0,391286
140837701000000,NE 167,RESIDENTIAL,68580,0,68580,339638,0,408218
140837701300000,NE 167,RESIDENTIAL,58608,0,58608,374249,0,432857
140837701600000,NE 167,RESIDENTIAL,37248,0,37248,0,0,37248
140840100100000,NE 135,RESIDENTIAL,22194,0,22194,164493,0,186687
140840100200000,NE 135,RESIDENTIAL,24150,0,24150,135085,0,159235
140840100300000,NE 135,RESIDENTIAL,24150,0,24150,107794,0,131944
140840100400000,NE 135,RESIDENTIAL,24150,0,24150,137015,0,161165
140840100500000,NE 135,RESIDENTIAL,25760,0,25760,131276,0,157036
140840100600000,NE 135,RESIDENTIAL,25760,0,25760,134393,0,160153
140840100700000,NE 135,RESIDENTIAL,27600,0,27600,121782,0,149382
140840100800000,NE 135,RESIDENTIAL,25507,0,25507,120657,0,146164
140840100900000,NE 135,RESIDENTIAL,24782,0,24782,139187,0,163969
140840101000000,NE 135,RESIDENTIAL,24150,0,24150,137389,0,161539
140840101100000,NE 135,RESIDENTIAL,25760,0,25760,109903,0,135663
140840101200000,NE 135,RESIDENTIAL,24150,0,24150,117511,0,141661
140840101300000,NE 135,RESIDENTIAL,24150,0,24150,142517,0,166667
140840101400000,NE 135,RESIDENTIAL,24150,0,24150,124104,0,148254
140840101500000,NE 135,RESIDENTIAL,25105,0,25105,118967,0,144072
140840200100000,NE 135,RESIDENTIAL,28679,0,28679,124506,0,153185
140840200200000,NE 135,RESIDENTIAL,28697,0,28697,137076,0,165773
140840200300000,NE 135,RESIDENTIAL,61950,0,61950,0,0,61950
140840200400000,NE 135,RESIDENTIAL,32908,0,32908,160489,0,193397
140840200500000,NE 135,RESIDENTIAL,31617,0,31617,153829,0,185446
140840200600000,NE 135,RESIDENTIAL,30683,0,30683,134347,0,165030
140840200700000,NE 135,RESIDENTIAL,32083,0,32083,124975,0,157058
140840200800000,NE 135,RESIDENTIAL,32480,0,32480,183496,0,215976
140840200900000,NE 135,RESIDENTIAL,29211,0,29211,157938,0,187149
140840201000000,NE 135,RESIDENTIAL,30428,0,30428,154240,0,184668
140840201100000,NE 135,RESIDENTIAL,30013,0,30013,169150,0,199163
140840201200000,NE 135,RESIDENTIAL,29750,0,29750,133905,0,163655
140840201300000,NE 135,RESIDENTIAL,29353,0,29353,132552,0,161905
140840201400000,NE 135,RESIDENTIAL,29393,0,29393,120048,0,149441
140840201500000,NE 135,RESIDENTIAL,27014,0,27014,145460,0,172474
140840201600000,NE 135,RESIDENTIAL,28600,0,28600,159287,0,187887
140840201700000,NE 135,RESIDENTIAL,26096,0,26096,144309,0,170405
140840201800000,NE 135,RESIDENTIAL,28359,0,28359,153195,0,181554
140840300100000,NE 135,RESIDENTIAL,24878,0,24878,110128,0,135006
140840300200000,NE 135,RESIDENTIAL,24675,0,24675,120568,0,145243
140840300300000,NE 135,RESIDENTIAL,27038,0,27038,133000,0,160038
140840300400000,NE 135,RESIDENTIAL,27212,0,27212,160059,0,187271
140840300500000,NE 135,RESIDENTIAL,29452,0,29452,157675,0,187127
140840300600000,NE 135,RESIDENTIAL,29717,0,29717,122615,0,152332
140840300700000,NE 135,RESIDENTIAL,29592,0,29592,144376,0,173968
140840300800000,NE 135,RESIDENTIAL,27515,0,27515,127501,0,155016
140840300900000,NE 135,RESIDENTIAL,28102,0,28102,140501,0,168603
140840301000000,NE 135,RESIDENTIAL,27189,0,27189,137940,0,165129
140840301100000,NE 135,RESIDENTIAL,25561,0,25561,125847,0,151408
140840301200000,NE 135,RESIDENTIAL,31841,0,31841,124343,0,156184
140840301300000,NE 135,RESIDENTIAL,32116,0,32116,139642,0,171758
140840301400000,NE 135,RESIDENTIAL,32116,0,32116,150029,0,182145
140840301500000,NE 135,RESIDENTIAL,31862,0,31862,149752,0,181614
140840301600000,NE 135,RESIDENTIAL,31862,0,31862,147811,0,179673
140840301700000,NE 135,RESIDENTIAL,31865,0,31865,150796,0,182661
140840301800000,NE 135,RESIDENTIAL,26034,0,26034,161722,0,187756
140840301900000,NE 135,RESIDENTIAL,29699,0,29699,158870,0,188569
140840302000000,NE 135,RESIDENTIAL,31108,0,31108,144467,0,175575
140840302200000,NE 135,RESIDENTIAL,27927,0,27927,147609,0,175536
140840302300000,NE 135,RESIDENTIAL,26160,0,26160,117022,0,143182
140840302400000,NE 135,RESIDENTIAL,24750,0,24750,112997,0,137747
140840302500000,NE 135,RESIDENTIAL,19813,0,19813,128850,0,148663
140840302600000,NE 135,RESIDENTIAL,24355,0,24355,129511,0,153866
140840302800000,NE 135,RESIDENTIAL,29952,0,29952,149751,0,179703
140840400100000,NE 135,RESIDENTIAL,30692,0,30692,111035,0,141727
140840400200000,NE 135,RESIDENTIAL,27370,0,27370,126741,0,154111
140840400300000,NE 135,RESIDENTIAL,31267,0,31267,136941,0,168208
140840400400000,NE 135,RESIDENTIAL,32585,0,32585,182219,0,214804
140840400500000,NE 135,RESIDENTIAL,31609,0,31609,139266,0,170875
140840400600000,NE 135,RESIDENTIAL,31235,0,31235,158947,0,190182
140840400700000,NE 135,RESIDENTIAL,32862,0,32862,160007,0,192869
140840400800000,NE 135,RESIDENTIAL,34257,0,34257,163031,0,197288
140840400900000,NE 135,RESIDENTIAL,30801,0,30801,128545,0,159346
140840401000000,NE 135,RESIDENTIAL,32820,0,32820,180078,0,212898
140840401100000,NE 135,RESIDENTIAL,32504,0,32504,153462,0,185966
140840401200000,NE 135,RESIDENTIAL,31331,0,31331,119743,0,151074
140840401300000,NE 135,RESIDENTIAL,36750,0,36750,241229,0,277979
140842600100000,NE 135,RESIDENTIAL,93300,0,93300,0,0,93300
140842600200000,NE 135,RESIDENTIAL,176950,0,176950,0,0,176950
140842600300000,NE 135,RESIDENTIAL,34510,0,34510,160373,0,194883
140842600400000,NE 135,RESIDENTIAL,31145,0,31145,185607,0,216752
140842600500000,NE 135,RESIDENTIAL,33220,0,33220,159574,0,192794
140842600600000,NE 135,RESIDENTIAL,35094,0,35094,165434,0,200528
140842600700000,NE 135,RESIDENTIAL,33220,0,33220,148705,0,181925
140842600800000,NE 135,RESIDENTIAL,34857,0,34857,202148,0,237005
140842600900000,NE 135,RESIDENTIAL,32050,0,32050,177508,0,209558
140845100100000,NE 135,RESIDENTIAL,26142,0,26142,158284,0,184426
140845100200000,NE 135,RESIDENTIAL,29050,0,29050,149818,0,178868
140845100300000,NE 135,RESIDENTIAL,27720,0,27720,161219,0,188939
140845200100000,NE 135,RESIDENTIAL,36109,0,36109,138547,0,174656
140845200200000,NE 135,RESIDENTIAL,34252,0,34252,236268,0,270520
140845200300000,NE 135,RESIDENTIAL,29155,0,29155,180980,0,210135
140845200400000,NE 135,RESIDENTIAL,31150,0,31150,166268,0,197418
140845200500000,NE 135,RESIDENTIAL,30210,0,30210,150881,0,181091
140845200600000,NE 135,RESIDENTIAL,32035,0,32035,143949,0,175984
140845200700000,NE 135,RESIDENTIAL,33453,0,33453,161394,0,194847
140845200800000,NE 135,RESIDENTIAL,30940,0,30940,208997,0,239937
140845200900000,NE 135,RESIDENTIAL,30702,0,30702,170173,0,200875
140845201000000,NE 135,RESIDENTIAL,32427,0,32427,178483,0,210910
140845201100000,NE 135,RESIDENTIAL,34791,0,34791,179223,0,214014
140845201200000,NE 135,RESIDENTIAL,32760,0,32760,183607,0,216367
140845201300000,NE 135,RESIDENTIAL,32664,0,32664,176350,0,209014
140845201400000,NE 135,RESIDENTIAL,31487,0,31487,160855,0,192342
140845201500000,NE 135,RESIDENTIAL,47650,0,47650,195631,0,243281
140845201600000,NE 149,RESIDENTIAL,37468,0,37468,161009,0,198477
140845201700000,NE 149,RESIDENTIAL,29211,0,29211,182246,0,211457
140845201800000,NE 149,RESIDENTIAL,29211,0,29211,180783,0,209994
140845201900000,NE 135,RESIDENTIAL,38114,0,38114,185540,0,223654
140845202000000,NE 135,RESIDENTIAL,32505,0,32505,185148,0,217653
140845202100000,NE 135,RESIDENTIAL,32725,0,32725,209175,0,241900
140845202200000,NE 135,RESIDENTIAL,32907,0,32907,175194,0,208101
140845202300000,NE 135,RESIDENTIAL,45350,0,45350,190391,0,235741
140845202400000,NE 135,RESIDENTIAL,32997,0,32997,167244,0,200241
140845202500000,NE 135,RESIDENTIAL,31327,0,31327,166896,0,198223
140845202600000,NE 135,RESIDENTIAL,31059,0,31059,131082,0,162141
140845202700000,NE 135,RESIDENTIAL,32319,0,32319,145409,0,177728
140845202800000,NE 135,RESIDENTIAL,33165,0,33165,171141,0,204306
140845202900000,NE 135,RESIDENTIAL,30527,0,30527,172036,0,202563
140845300100000,NE 135,RESIDENTIAL,33495,0,33495,167139,0,200634
140845300200000,NE 135,RESIDENTIAL,88550,0,88550,0,0,88550
140845300300000,NE 135,RESIDENTIAL,47275,0,47275,174353,0,221628
140845300400000,NE 135,RESIDENTIAL,46550,0,46550,204007,0,250557
140845300500000,NE 135,RESIDENTIAL,47000,0,47000,149418,0,196418
140845300600000,NE 149,RESIDENTIAL,49823,0,49823,202876,0,252699
140845300700000,NE 149,RESIDENTIAL,27543,0,27543,195574,0,223117
140845300800000,NE 135,RESIDENTIAL,30048,0,30048,179028,0,209076
140845300900000,NE 135,RESIDENTIAL,34650,0,34650,172807,0,207457
140845301000000,NE 135,RESIDENTIAL,34587,0,34587,173939,0,208526
140845301100000,NE 135,RESIDENTIAL,34486,0,34486,208060,0,242546
140845301200000,NE 135,RESIDENTIAL,28558,0,28558,171105,0,199663
140845301300000,NE 135,RESIDENTIAL,35700,0,35700,185750,0,221450
140845301400000,NE 135,RESIDENTIAL,45475,0,45475,175475,0,220950
140845301500000,NE 135,RESIDENTIAL,35224,0,35224,168752,0,203976
140845301600000,NE 135,RESIDENTIAL,32830,0,32830,157643,0,190473
140845301700000,NE 135,RESIDENTIAL,32205,0,32205,165817,0,198022
140845301800000,NE 135,RESIDENTIAL,30940,0,30940,173965,0,204905
140845301900000,NE 135,RESIDENTIAL,31535,0,31535,176956,0,208491
140845302000000,NE 135,RESIDENTIAL,31833,0,31833,180536,0,212369
140845302100000,NE 135,RESIDENTIAL,32428,0,32428,147372,0,179800
140845302200000,NE 135,RESIDENTIAL,33023,0,33023,164881,0,197904
140845302300000,NE 135,RESIDENTIAL,33618,0,33618,166763,0,200381
140847600200000,NE 135,RESIDENTIAL,29162,0,29162,137080,0,166242
140847600400000,NE 135,RESIDENTIAL,30048,0,30048,141784,0,171832
140847600500000,NE 135,RESIDENTIAL,31462,0,31462,132069,0,163531
140847600600000,NE 135,RESIDENTIAL,33226,0,33226,136349,0,169575
140847600700000,NE 135,RESIDENTIAL,34335,0,34335,147285,0,181620
140847600800000,NE 135,RESIDENTIAL,28167,0,28167,0,0,28167
140847600900000,NE 135,RESIDENTIAL,31582,0,31582,128995,0,160577
140847601000000,NE 135,RESIDENTIAL,32246,0,32246,125344,0,157590
140847601100000,NE 135,RESIDENTIAL,31640,0,31640,114007,0,145647
140847601200000,NE 135,RESIDENTIAL,31261,0,31261,161276,0,192537
140847601300000,NE 135,RESIDENTIAL,31533,0,31533,132847,0,164380
140847601400000,NE 135,RESIDENTIAL,31809,0,31809,151671,0,183480
140847601500000,NE 135,RESIDENTIAL,31659,0,31659,163365,0,195024
140847601600000,NE 135,RESIDENTIAL,32787,0,32787,188389,0,221176
140847601700000,NE 135,RESIDENTIAL,33278,0,33278,136940,0,170218
140847601800000,NE 135,RESIDENTIAL,31594,0,31594,167172,0,198766
140847601900000,NE 135,RESIDENTIAL,31327,0,31327,156380,0,187707
140847602000000,NE 135,RESIDENTIAL,31327,0,31327,132754,0,164081
140847602100000,NE 135,RESIDENTIAL,31424,0,31424,152312,0,183736
140847602200000,NE 135,RESIDENTIAL,32103,0,32103,161273,0,193376
140847602300000,NE 135,RESIDENTIAL,31832,0,31832,142605,0,174437
140847602400000,NE 135,RESIDENTIAL,32694,0,32694,179070,0,211764
140847602500000,NE 135,RESIDENTIAL,32012,0,32012,160989,0,193001
140847602600000,NE 135,RESIDENTIAL,31594,0,31594,175538,0,207132
140847602700000,NE 135,RESIDENTIAL,31785,0,31785,157965,0,189750
140847602800000,NE 135,RESIDENTIAL,29155,0,29155,126376,0,155531
140847602900000,NE 135,RESIDENTIAL,29155,0,29155,150969,0,180124
140847603000000,NE 135,RESIDENTIAL,24908,0,24908,153103,0,178011
140847603100000,NE 135,RESIDENTIAL,3525,0,3525,0,0,3525
140847603300000,NE 135,RESIDENTIAL,94762,0,94762,145907,0,240669
140847603400000,NE 135,RESIDENTIAL,50,0,50,0,0,50
140847603500000,NE 135,RESIDENTIAL,29453,0,29453,152314,0,181767
140847700100000,NE 135,RESIDENTIAL,29654,0,29654,154015,0,183669
140847700200000,NE 135,RESIDENTIAL,27160,0,27160,161213,0,188373
140847700300000,NE 135,RESIDENTIAL,28905,0,28905,147726,0,176631
140847700400000,NE 135,RESIDENTIAL,31546,0,31546,158505,0,190051
140847700500000,NE 135,RESIDENTIAL,46125,0,46125,135356,0,181481
140847700600000,NE 135,RESIDENTIAL,45225,0,45225,219250,0,264475
140847700700000,NE 135,RESIDENTIAL,34650,0,34650,155480,0,190130
140847700800000,NE 135,RESIDENTIAL,32725,0,32725,127947,0,160672
140847700900000,NE 135,RESIDENTIAL,31135,0,31135,137209,0,168344
140847701000000,NE 135,RESIDENTIAL,29248,0,29248,151236,0,180484
140847701100000,NE 135,RESIDENTIAL,27189,0,27189,152029,0,179218
140847701200000,NE 135,RESIDENTIAL,35897,0,35897,161618,0,197515
140847701300000,NE 135,RESIDENTIAL,37775,0,37775,167083,0,204858
140847701400000,NE 135,RESIDENTIAL,35593,0,35593,159333,0,194926
140847701500000,NE 135,RESIDENTIAL,29453,0,29453,155209,0,184662
140847701600000,NE 135,RESIDENTIAL,26775,0,26775,170113,0,196888
140910100100000,NE 132,RESIDENTIAL,30120,0,30120,77671,0,107791
140910100200000,NE 132,RESIDENTIAL,24240,0,24240,79546,0,103786
140910100300000,NE 132,RESIDENTIAL,23432,0,23432,65218,0,88650
140910100400000,OFFICE; MEDICAL,COMMERCIAL,0,75000,75000,0,205304,280304
140910100500000,OFFICE,COMMERCIAL,0,149600,149600,0,358325,507925
140910100600000,APARTMENT,EXEMPT,0,61560,61560,0,978949,1040509
140910100800000,APARTMENT,COMMERCIAL,0,103200,103200,0,1419925,1523125
140910101100000,SCHOOL,EXEMPT,0,0,0,0,0,0
140910101200000,NE 132,RESIDENTIAL,29510,0,29510,87128,0,116638
140910101300000,NE 132,RESIDENTIAL,31050,0,31050,99230,0,130280
140910101400000,NE 132,RESIDENTIAL,31050,0,31050,91487,0,122537
140910101500000,NE 132,RESIDENTIAL,31050,0,31050,86894,0,117944
140910101600000,NE 132,RESIDENTIAL,31050,0,31050,97175,0,128225
140910101700000,NE 132,RESIDENTIAL,31050,0,31050,87205,0,118255
140910101800000,NE 132,RESIDENTIAL,31050,0,31050,94319,0,125369
140910101900000,NE 132,RESIDENTIAL,31050,0,31050,114379,0,145429
140910102000000,NE 132,RESIDENTIAL,31050,0,31050,85653,0,116703
140910102100000,NE 132,RESIDENTIAL,31050,0,31050,120890,0,151940
140910102200000,NE 132,RESIDENTIAL,31050,0,31050,119606,0,150656
140910102300000,NE 132,RESIDENTIAL,31050,0,31050,107957,0,139007
140910102400000,NE 132,RESIDENTIAL,31050,0,31050,119022,0,150072
140910102500000,APARTMENT,COMMERCIAL,0,154240,154240,0,1550390,1704630
140910200100000,APARTMENT,COMMERCIAL,0,719800,719800,0,15964613,16684413
140910200200000,NE 132,RESIDENTIAL,33000,0,33000,95148,0,128148
140910200300000,NE 132,RESIDENTIAL,30000,0,30000,109092,0,139092
140910200400000,NE 132,RESIDENTIAL,33000,0,33000,105236,0,138236
140910200500000,NE 132,RESIDENTIAL,33000,0,33000,86776,0,119776
140910200600000,NE 132,RESIDENTIAL,33000,0,33000,88496,0,121496
140910200700000,NE 132,RESIDENTIAL,33000,0,33000,74067,0,107067
140910200800000,NE 132,RESIDENTIAL,33000,0,33000,78121,0,111121
140910200900000,NE 132,RESIDENTIAL,33000,0,33000,90262,0,123262
140910201000000,NE 132,RESIDENTIAL,33000,0,33000,84456,0,117456
140910201100000,NE 132,RESIDENTIAL,33000,0,33000,88882,0,121882
140910201200000,NE 132,RESIDENTIAL,36795,0,36795,103743,0,140538
140910300100000,NE 132,RESIDENTIAL,33972,0,33972,84651,0,118623
140910300200000,NE 132,RESIDENTIAL,33000,0,33000,83469,0,116469
140910300300000,NE 132,RESIDENTIAL,33000,0,33000,77291,0,110291
140910300400000,NE 132,RESIDENTIAL,33000,0,33000,76234,0,109234
140910300500000,NE 132,RESIDENTIAL,33000,0,33000,95437,0,128437
140910300600000,NE 132,RESIDENTIAL,33000,0,33000,91567,0,124567
140910300700000,NE 132,RESIDENTIAL,33000,0,33000,127258,0,160258
140910300800000,NE 132,RESIDENTIAL,33000,0,33000,79265,0,112265
140910300900000,NE 132,RESIDENTIAL,33000,0,33000,109307,0,142307
140910301000000,NE 132,RESIDENTIAL,33000,0,33000,96147,0,129147
140910301100000,NE 132,RESIDENTIAL,33000,0,33000,77679,0,110679
140910301200000,NE 132,RESIDENTIAL,33000,0,33000,86480,0,119480
140910301300000,NE 132,RESIDENTIAL,31900,0,31900,79940,0,111840
140910301400000,NE 132,RESIDENTIAL,33000,0,33000,86410,0,119410
140910301500000,NE 132,RESIDENTIAL,33000,0,33000,83991,0,116991
140910301600000,NE 132,RESIDENTIAL,33000,0,33000,80723,0,113723
140910301700000,NE 132,RESIDENTIAL,33000,0,33000,98118,0,131118
140910301800000,NE 132,RESIDENTIAL,33000,0,33000,115964,0,148964
140910301900000,NE 132,RESIDENTIAL,30000,0,30000,79449,0,109449
140910302000000,NE 132,RESIDENTIAL,33000,0,33000,99604,0,132604
140910302100000,NE 132,RESIDENTIAL,33000,0,33000,78570,0,111570
140910302200000,NE 132,RESIDENTIAL,32028,0,32028,79961,0,111989
140912600100000,BRANCH BANK/CU,COMMERCIAL,0,214000,214000,0,389677,603677
140912600200000,LG DISCOUNT/RETAIL,COMMERCIAL,0,694520,694520,0,1459383,2153903
140912600300000,RESTAURANT,COMMERCIAL,0,292520,292520,0,242443,534963
140912600400000,NBHD SHOPPING CENTER,COMMERCIAL,0,116420,116420,0,425337,541757
140912600500000,SMALL RETAIL,COMMERCIAL,0,305020,305020,0,478281,783301
140912600600000,NE 132,RESIDENTIAL,40314,0,40314,115995,0,156309
140912600700000,NE 132,RESIDENTIAL,35530,0,35530,91748,0,127278
140912600800000,NE 132,RESIDENTIAL,33000,0,33000,104885,0,137885
140912600900000,NE 132,RESIDENTIAL,33000,0,33000,73400,0,106400
140912601000000,NE 132,RESIDENTIAL,33000,0,33000,92165,0,125165
140912601100000,SMALL RETAIL,COMMERCIAL,0,28748,28748,0,123066,151814
140912601200000,OFFICE,COMMERCIAL,0,40067,40067,0,120633,160700
140912601300000,OFFICE,COMMERCIAL,0,29529,29529,0,144146,173675
140912601400000,VETERINARY CLINIC,COMMERCIAL,0,38345,38345,0,208226,246571
140912601500000,FITNESS CENTER,COMMERCIAL,0,246020,246020,0,374265,620285
140912700100000,CONVENIENCE STORE,COMMERCIAL,0,227000,227000,0,290615,517615
140912700200000,AUTO REPAIR/SALES,COMMERCIAL,0,159200,159200,0,87399,246599
140912700300000,SMALL RETAIL,COMMERCIAL,0,100400,100400,0,135550,235950
140912700400000,SMALL RETAIL,COMMERCIAL,0,97400,97400,0,133644,231044
140912700700000,CENTRALLY ASSESSED,OTHER,0,0,0,0,0,0
140912700800000,SMALL RETAIL,COMMERCIAL,0,98206,98206,0,95347,193553
140912700900000,BARS/LOUNGE,COMMERCIAL,0,70320,70320,0,104080,174400
140912701000000,RESTAURANT,COMMERCIAL,0,261425,261425,0,235017,496442
140912701100000,RESTAURANT,COMMERCIAL,0,175190,175190,0,214416,389606
140912701200000,LAUNDROMAT/CLEANERS,COMMERCIAL,0,83179,83179,0,221192,304371
140912701300000,FAST FOOD,COMMERCIAL,0,170095,170095,0,429298,599393
140912701400000,NBHD SHOPPING CENTER,COMMERCIAL,0,312725,312725,0,496716,809441
140912701500000,LAUNDROMAT/CLEANERS,COMMERCIAL,0,96376,96376,0,69471,165847
140912701600000,LG DISCOUNT/RETAIL,COMMERCIAL,0,325375,325375,0,262411,587786
140912800100000,NE 132,RESIDENTIAL,33000,0,33000,85019,0,118019
140912800200000,NE 132,RESIDENTIAL,33000,0,33000,95422,0,128422
140912800300000,NE 132,RESIDENTIAL,33000,0,33000,81715,0,114715
140912800400000,NE 132,RESIDENTIAL,33000,0,33000,74967,0,107967
140912800500000,NE 132,RESIDENTIAL,35653,0,35653,91499,0,127152
140912800600000,NE 132,RESIDENTIAL,33642,0,33642,72899,0,106541
140912800700000,NE 132,RESIDENTIAL,33000,0,33000,75329,0,108329
140912800800000,NE 132,RESIDENTIAL,31900,0,31900,79589,0,111489
140912800900000,NE 132,RESIDENTIAL,33000,0,33000,80064,0,113064
140912801000000,NE 132,RESIDENTIAL,31900,0,31900,88703,0,120603
140912900100000,NE 133,RESIDENTIAL,146,0,146,0,0,146
140915100100000,NE 132,RESIDENTIAL,33000,0,33000,94933,0,127933
140915100200000,NE 132,RESIDENTIAL,33000,0,33000,82271,0,115271
140915100300000,NE 132,RESIDENTIAL,29333,0,29333,110683,0,140016
140915100400000,NE 132,RESIDENTIAL,17271,0,17271,83579,0,100850
140915100500000,NE 132,RESIDENTIAL,16920,0,16920,90681,0,107601
140915100600000,NE 132,RESIDENTIAL,16920,0,16920,81938,0,98858
140915100700000,NE 132,RESIDENTIAL,16826,0,16826,82583,0,99409
140915100800000,NE 132,RESIDENTIAL,32450,0,32450,91132,0,123582
140915100900000,NE 132,RESIDENTIAL,31900,0,31900,78871,0,110771
140915101000000,NE 132,RESIDENTIAL,31900,0,31900,80746,0,112646
140915102000000,CENTRALLY ASSESSED,OTHER,0,0,0,0,0,0
140915200100000,OFFICE,COMMERCIAL,0,140418,140418,0,337587,478005
140915200200000,OFFICE,COMMERCIAL,0,80240,80240,0,42338,122578
140915200300000,OFFICE,COMMERCIAL,0,98803,98803,0,350748,449551
140915200500000,NE 132,RESIDENTIAL,20007,0,20007,47371,0,67378
140915200600000,NE 132,RESIDENTIAL,20880,0,20880,67738,0,88618
140915200700000,APARTMENT,COMMERCIAL,0,31200,31200,0,215481,246681
140915200800000,OFFICE,COMMERCIAL,0,42000,42000,0,63299,105299
140915200900000,OFFICE; MEDICAL,COMMERCIAL,0,139200,139200,0,580650,719850
140915201000000,NE 132,RESIDENTIAL,21895,0,21895,72195,0,94090
140915201100000,BRANCH BANK/CU,COMMERCIAL,0,93500,93500,0,239192,332692
140915201200000,OFFICE,COMMERCIAL,0,91500,91500,0,236102,327602
140915201300000,OFFICE,COMMERCIAL,0,88500,88500,0,310527,399027
140915201400000,NE 132,RESIDENTIAL,18550,0,18550,57105,0,75655
140915300100000,NE 132,RESIDENTIAL,32670,0,32670,77832,0,110502
140915300200000,NE 132,RESIDENTIAL,32670,0,32670,103319,0,135989
140915300300000,NE 132,RESIDENTIAL,31944,0,31944,91724,0,123668
140915300400000,NE 132,RESIDENTIAL,36655,0,36655,77438,0,114093
140915300500000,NE 132,RESIDENTIAL,24000,0,24000,58137,0,82137
140915300600000,NE 132,RESIDENTIAL,23100,0,23100,109608,0,132708
140915300700000,NE 132,RESIDENTIAL,33550,0,33550,84375,0,117925
140915300800000,NE 132,RESIDENTIAL,33000,0,33000,72574,0,105574
140915300900000,NE 132,RESIDENTIAL,33000,0,33000,103103,0,136103
140915400100000,NE 132,RESIDENTIAL,33000,0,33000,96060,0,129060
140915400200000,NE 132,RESIDENTIAL,33000,0,33000,83699,0,116699
140915400300000,NE 132,RESIDENTIAL,33000,0,33000,80986,0,113986
140915400400000,NE 132,RESIDENTIAL,33000,0,33000,76598,0,109598
140915400500000,NE 132,RESIDENTIAL,32120,0,32120,72500,0,104620
140915400600000,NE 132,RESIDENTIAL,26191,0,26191,51364,0,77555
140915400700000,NE 132,RESIDENTIAL,25650,0,25650,63165,0,88815
140915400800000,NE 132,RESIDENTIAL,25650,0,25650,55044,0,80694
140915400900000,NE 132,RESIDENTIAL,25650,0,25650,99061,0,124711
140915401000000,NE 132,RESIDENTIAL,25650,0,25650,66197,0,91847
140915500100000,NE 132,RESIDENTIAL,27000,0,27000,90431,0,117431
140915500200000,NE 132,RESIDENTIAL,27000,0,27000,79623,0,106623
140915500300000,NE 132,RESIDENTIAL,27000,0,27000,54637,0,81637
140915500400000,NE 132,RESIDENTIAL,26235,0,26235,62758,0,88993
140915500500000,NE 132,RESIDENTIAL,16088,0,16088,61175,0,77263
140915500600000,OFFICE,EXEMPT,0,71780,71780,0,73211,144991
140915500700000,NE 132,RESIDENTIAL,29424,0,29424,64962,0,94386
140915600100000,WAREHOUSE,COMMERCIAL,0,240809,240809,0,318359,559168
140915600102000,ANTENNAS/TOWERS(BLL),COMMERCIAL,0,0,0,0,144767,144767
140915600200000,SMALL RETAIL,COMMERCIAL,0,65395,65395,0,197229,262624
140915700100000,NE 132,RESIDENTIAL,25380,0,25380,60125,0,85505
140915700200000,NE 132,RESIDENTIAL,25648,0,25648,56335,0,81983
140915700300000,OFFICE,COMMERCIAL,0,115435,115435,0,241306,356741
140917600100000,NE 132,RESIDENTIAL,32899,0,32899,94012,0,126911
140917600200000,NE 132,RESIDENTIAL,32670,0,32670,92937,0,125607
140917600300000,NE 132,RESIDENTIAL,33000,0,33000,86512,0,119512
140917600400000,NE 132,RESIDENTIAL,33000,0,33000,114475,0,147475
140917600500000,NE 132,RESIDENTIAL,33000,0,33000,123940,0,156940
140917600600000,NE 132,RESIDENTIAL,33000,0,33000,84687,0,117687
140917600700000,NE 132,RESIDENTIAL,33000,0,33000,82470,0,115470
140917600800000,NE 132,RESIDENTIAL,33000,0,33000,77428,0,110428
140917600900000,NE 132,RESIDENTIAL,33000,0,33000,71139,0,104139
140917601000000,NE 132,RESIDENTIAL,33000,0,33000,96279,0,129279
140917601100000,NE 132,RESIDENTIAL,33000,0,33000,80209,0,113209
140917601200000,NE 132,RESIDENTIAL,31900,0,31900,94838,0,126738
140917601300000,NE 132,RESIDENTIAL,32285,0,32285,99096,0,131381
140917601400000,NE 132,RESIDENTIAL,33000,0,33000,84698,0,117698
140917601500000,NE 132,RESIDENTIAL,33000,0,33000,85551,0,118551
140917601600000,NE 132,RESIDENTIAL,33000,0,33000,90362,0,123362
140917601700000,NE 132,RESIDENTIAL,33000,0,33000,88460,0,121460
140917601800000,NE 132,RESIDENTIAL,33000,0,33000,81467,0,114467
140917601900000,NE 132,RESIDENTIAL,33000,0,33000,91101,0,124101
140917602000000,NE 132,RESIDENTIAL,32670,0,32670,80248,0,112918
140917602100000,NE 132,RESIDENTIAL,32670,0,32670,110584,0,143254
140917602200000,NE 132,RESIDENTIAL,35140,0,35140,91383,0,126523
140917700100000,CHURCH,EXEMPT,0,196560,196560,0,153453,350013
140917700200000,NE 132,RESIDENTIAL,36944,0,36944,103086,0,140030
140917700300000,NE 132,RESIDENTIAL,34496,0,34496,110448,0,144944
140917700400000,NE 132,RESIDENTIAL,35200,0,35200,86616,0,121816
140917700500000,NE 132,RESIDENTIAL,35200,0,35200,118155,0,153355
140917700600000,NE 132,RESIDENTIAL,59657,0,59657,99741,0,159398
140917700700000,NE 132,RESIDENTIAL,21375,0,21375,63278,0,84653
140917700800000,NE 132,RESIDENTIAL,23085,0,23085,58791,0,81876
140917700900000,NE 132,RESIDENTIAL,23085,0,23085,53733,0,76818
140917701000000,NE 132,RESIDENTIAL,23085,0,23085,51007,0,74092
140917701100000,NE 132,RESIDENTIAL,23085,0,23085,56009,0,79094
140917701200000,NE 132,RESIDENTIAL,23085,0,23085,65299,0,88384
140917701300000,NE 132,RESIDENTIAL,22804,0,22804,52328,0,75132
140917800100000,NE 132,RESIDENTIAL,37897,0,37897,76068,0,113965
140917800200000,NE 132,RESIDENTIAL,36432,0,36432,96091,0,132523
140917800300000,NE 132,RESIDENTIAL,35228,0,35228,98666,0,133894
140917800400000,NE 132,RESIDENTIAL,33772,0,33772,102263,0,136035
140917800500000,NE 132,RESIDENTIAL,33862,0,33862,89021,0,122883
140917800600000,NE 132,RESIDENTIAL,33396,0,33396,89106,0,122502
140917800700000,NE 132,RESIDENTIAL,32670,0,32670,108376,0,141046
140917800800000,NE 132,RESIDENTIAL,32670,0,32670,100583,0,133253
140917800900000,NE 132,RESIDENTIAL,32670,0,32670,80104,0,112774
140917801000000,NE 132,RESIDENTIAL,32670,0,32670,94100,0,126770
140917801100000,NE 132,RESIDENTIAL,32670,0,32670,76364,0,109034
140917801200000,NE 132,RESIDENTIAL,32670,0,32670,78541,0,111211
140917801300000,NE 132,RESIDENTIAL,32670,0,32670,93276,0,125946
140917801400000,NE 132,RESIDENTIAL,32670,0,32670,86107,0,118777
140917801500000,NE 132,RESIDENTIAL,33000,0,33000,87578,0,120578
140917801600000,NE 132,RESIDENTIAL,33000,0,33000,106777,0,139777
140917801700000,NE 132,RESIDENTIAL,33000,0,33000,89037,0,122037
140917801800000,NE 132,RESIDENTIAL,33000,0,33000,102060,0,135060
140917801900000,NE 132,RESIDENTIAL,33000,0,33000,88314,0,121314
140917802000000,NE 132,RESIDENTIAL,33000,0,33000,77708,0,110708
140917802100000,NE 132,RESIDENTIAL,33000,0,33000,70305,0,103305
140917802200000,NE 132,RESIDENTIAL,33000,0,33000,79391,0,112391
140917802300000,NE 132,RESIDENTIAL,33000,0,33000,74576,0,107576
140917802400000,NE 132,RESIDENTIAL,33660,0,33660,71706,0,105366
140917802500000,NE 132,RESIDENTIAL,34320,0,34320,96927,0,131247
140917802600000,NE 132,RESIDENTIAL,34650,0,34650,74493,0,109143
140917802700000,NE 132,RESIDENTIAL,34980,0,34980,95577,0,130557
140917802800000,NE 132,RESIDENTIAL,34376,0,34376,78091,0,112467
140917802900000,NE 132,RESIDENTIAL,32670,0,32670,70928,0,103598
140917803000000,NE 132,RESIDENTIAL,32340,0,32340,86532,0,118872
140917803100000,NE 132,RESIDENTIAL,32670,0,32670,89901,0,122571
140917900100000,NE 132,RESIDENTIAL,33532,0,33532,89319,0,122851
140917900200000,NE 132,RESIDENTIAL,33000,0,33000,83710,0,116710
140917900300000,NE 132,RESIDENTIAL,33000,0,33000,73613,0,106613
140917900400000,NE 132,RESIDENTIAL,33000,0,33000,92039,0,125039
140917900500000,NE 132,RESIDENTIAL,33000,0,33000,86661,0,119661
140917900600000,NE 132,RESIDENTIAL,33000,0,33000,81594,0,114594
140917900700000,NE 132,RESIDENTIAL,33000,0,33000,83424,0,116424
140917900800000,NE 132,RESIDENTIAL,33000,0,33000,87332,0,120332
140917900900000,NE 132,RESIDENTIAL,33000,0,33000,78484,0,111484
140917901000000,NE 132,RESIDENTIAL,33000,0,33000,82297,0,115297
140917901100000,NE 132,RESIDENTIAL,33000,0,33000,85511,0,118511
140917901200000,NE 132,RESIDENTIAL,33000,0,33000,80136,0,113136
140917901300000,NE 132,RESIDENTIAL,33000,0,33000,95458,0,128458
140917901400000,NE 132,RESIDENTIAL,33000,0,33000,82921,0,115921
140917901500000,NE 132,RESIDENTIAL,33000,0,33000,91500,0,124500
140917901600000,NE 132,RESIDENTIAL,25736,0,25736,63510,0,89246
140917901700000,NE 132,RESIDENTIAL,25650,0,25650,60903,0,86553
140917901800000,NE 132,RESIDENTIAL,25650,0,25650,58514,0,84164
140917901900000,NE 132,RESIDENTIAL,25650,0,25650,58911,0,84561
140917902000000,NE 132,RESIDENTIAL,21375,0,21375,97208,0,118583
140917902100000,NE 132,RESIDENTIAL,23513,0,23513,86187,0,109700
140917902200000,NE 132,RESIDENTIAL,34628,0,34628,72323,0,106951
140917902300000,NE 132,RESIDENTIAL,25650,0,25650,87119,0,112769
140917902400000,NE 132,RESIDENTIAL,25650,0,25650,71441,0,97091
140917902500000,NE 132,RESIDENTIAL,25650,0,25650,61590,0,87240
140917902600000,NE 132,RESIDENTIAL,25650,0,25650,62659,0,88309
140917902700000,NE 132,RESIDENTIAL,25650,0,25650,53088,0,78738
140917902800000,NE 132,RESIDENTIAL,25650,0,25650,58979,0,84629
140917902900000,NE 132,RESIDENTIAL,24239,0,24239,62967,0,87206
140918000100000,NE 132,RESIDENTIAL,26043,0,26043,60161,0,86204
140918000200000,NE 132,RESIDENTIAL,25380,0,25380,56920,0,82300
140918000300000,NE 132,RESIDENTIAL,25944,0,25944,77185,0,103129
140918000400000,NE 132,RESIDENTIAL,28130,0,28130,61660,0,89790
140918100100000,NE 132,RESIDENTIAL,25380,0,25380,58989,0,84369
140918100200000,NE 132,RESIDENTIAL,25380,0,25380,67731,0,93111
140918100300000,NE 132,RESIDENTIAL,25380,0,25380,62683,0,88063
140918100400000,NE 132,RESIDENTIAL,25380,0,25380,66663,0,92043
140918100500000,NE 132,RESIDENTIAL,25380,0,25380,68315,0,93695
140918100600000,NE 132,RESIDENTIAL,25380,0,25380,59777,0,85157
140918100700000,NE 132,RESIDENTIAL,25380,0,25380,56335,0,81715
140918100800000,NE 132,RESIDENTIAL,25380,0,25380,66527,0,91907
140918100900000,NE 132,RESIDENTIAL,25380,0,25380,51122,0,76502
140918101000000,NE 132,RESIDENTIAL,25380,0,25380,62696,0,88076
140918101100000,NE 132,RESIDENTIAL,25380,0,25380,63617,0,88997
140918101200000,NE 132,RESIDENTIAL,25380,0,25380,61570,0,86950
140918101300000,NE 132,RESIDENTIAL,25380,0,25380,56668,0,82048
140918101400000,NE 132,RESIDENTIAL,25380,0,25380,64009,0,89389
140918101500000,NE 132,RESIDENTIAL,25380,0,25380,53788,0,79168
140918101600000,NE 132,RESIDENTIAL,25380,0,25380,63175,0,88555
140918101700000,NE 132,RESIDENTIAL,25380,0,25380,48600,0,73980
140918101800000,NE 132,RESIDENTIAL,25621,0,25621,60343,0,85964
140918101900000,NE 132,RESIDENTIAL,25659,0,25659,56869,0,82528
140918102000000,NE 132,RESIDENTIAL,25659,0,25659,96311,0,121970
140918102100000,NE 132,RESIDENTIAL,25621,0,25621,60819,0,86440
140918102200000,NE 132,RESIDENTIAL,25380,0,25380,47763,0,73143
140918102300000,NE 132,RESIDENTIAL,25380,0,25380,64406,0,89786
140918102400000,NE 132,RESIDENTIAL,25380,0,25380,63394,0,88774
140918102500000,NE 132,RESIDENTIAL,25380,0,25380,60608,0,85988
140918102600000,NE 132,RESIDENTIAL,25380,0,25380,62978,0,88358
140918102700000,NE 132,RESIDENTIAL,25380,0,25380,61896,0,87276
140918102800000,NE 132,RESIDENTIAL,25380,0,25380,69958,0,95338
140918102900000,NE 132,RESIDENTIAL,25380,0,25380,68989,0,94369
140918103000000,NE 132,RESIDENTIAL,25380,0,25380,54230,0,79610
140918103100000,NE 132,RESIDENTIAL,25380,0,25380,61080,0,86460
140918103200000,NE 132,RESIDENTIAL,25380,0,25380,55478,0,80858
140918103300000,NE 132,RESIDENTIAL,25380,0,25380,54769,0,80149
140918103400000,NE 132,RESIDENTIAL,25380,0,25380,67055,0,92435
140918103500000,NE 132,RESIDENTIAL,25380,0,25380,51309,0,76689
140918103600000,NE 132,RESIDENTIAL,25380,0,25380,59759,0,85139
140918103700000,NE 132,RESIDENTIAL,25380,0,25380,70892,0,96272
140918103800000,NE 132,RESIDENTIAL,25380,0,25380,90814,0,116194
140918200100000,NE 132,RESIDENTIAL,26043,0,26043,60331,0,86374
140918200200000,NE 132,RESIDENTIAL,25380,0,25380,64330,0,89710
140918200300000,NE 132,RESIDENTIAL,25380,0,25380,61631,0,87011
140918200400000,NE 132,RESIDENTIAL,25380,0,25380,57193,0,82573
140918200500000,NE 132,RESIDENTIAL,25380,0,25380,61110,0,86490
140918200600000,NE 132,RESIDENTIAL,25380,0,25380,62250,0,87630
140918200700000,NE 132,RESIDENTIAL,25380,0,25380,60515,0,85895
140918200800000,NE 132,RESIDENTIAL,25380,0,25380,60866,0,86246
140918200900000,NE 132,RESIDENTIAL,25380,0,25380,60097,0,85477
140918201000000,NE 132,RESIDENTIAL,25380,0,25380,52264,0,77644
140918201100000,NE 132,RESIDENTIAL,25380,0,25380,66623,0,92003
140918201200000,NE 132,RESIDENTIAL,25380,0,25380,58932,0,84312
140918201300000,NE 132,RESIDENTIAL,25380,0,25380,52785,0,78165
140918201400000,NE 132,RESIDENTIAL,25380,0,25380,66564,0,91944
140918201500000,NE 132,RESIDENTIAL,25380,0,25380,82921,0,108301
140918201600000,NE 132,RESIDENTIAL,25380,0,25380,67071,0,92451
140918201700000,NE 132,RESIDENTIAL,25380,0,25380,69209,0,94589
140918201800000,NE 132,RESIDENTIAL,25380,0,25380,63478,0,88858
140918201900000,NE 132,RESIDENTIAL,25380,0,25380,54750,0,80130
140918202000000,NE 132,RESIDENTIAL,25380,0,25380,55727,0,81107
140918202100000,NE 132,RESIDENTIAL,25380,0,25380,60066,0,85446
140918202200000,NE 132,RESIDENTIAL,25380,0,25380,55936,0,81316
140920100100000,NE 133,RESIDENTIAL,25617,0,25617,107231,0,132848
140920100200000,NE 133,RESIDENTIAL,24419,0,24419,85541,0,109960
140920100300000,NE 133,RESIDENTIAL,24419,0,24419,85069,0,109488
140920100400000,NE 133,RESIDENTIAL,25704,0,25704,101089,0,126793
140920100500000,NE 133,RESIDENTIAL,27310,0,27310,103351,0,130661
140920100600000,NE 133,RESIDENTIAL,27132,0,27132,98148,0,125280
140920100700000,NE 133,RESIDENTIAL,26561,0,26561,113458,0,140019
140920100800000,NE 133,RESIDENTIAL,27310,0,27310,102960,0,130270
140920100900000,NE 133,RESIDENTIAL,25436,0,25436,94329,0,119765
140920101000000,NE 133,RESIDENTIAL,24414,0,24414,107168,0,131582
140920101100000,NE 133,RESIDENTIAL,31676,0,31676,105064,0,136740
140920101200000,NE 133,RESIDENTIAL,32738,0,32738,112100,0,144838
140920101300000,NE 133,RESIDENTIAL,32738,0,32738,105893,0,138631
140920101400000,NE 133,RESIDENTIAL,32738,0,32738,98267,0,131005
140920101500000,NE 133,RESIDENTIAL,33174,0,33174,110802,0,143976
140920101600000,NE 133,RESIDENTIAL,33174,0,33174,109303,0,142477
140920101700000,NE 133,RESIDENTIAL,32738,0,32738,119199,0,151937
140920101800000,NE 133,RESIDENTIAL,30555,0,30555,114477,0,145032
140920101900000,NE 133,RESIDENTIAL,30555,0,30555,115644,0,146199
140920102000000,NE 133,RESIDENTIAL,30555,0,30555,103350,0,133905
140920102100000,NE 133,RESIDENTIAL,30555,0,30555,104987,0,135542
140920102200000,NE 133,RESIDENTIAL,31541,0,31541,105560,0,137101
140920102300000,NE 133,RESIDENTIAL,31907,0,31907,110254,0,142161
140920102400000,NE 133,RESIDENTIAL,33860,0,33860,117478,0,151338
140920102500000,NE 133,RESIDENTIAL,29750,0,29750,92637,0,122387
140920102600000,NE 133,RESIDENTIAL,31185,0,31185,105573,0,136758
140920102700000,NE 133,RESIDENTIAL,31185,0,31185,103285,0,134470
140920102800000,NE 133,RESIDENTIAL,31185,0,31185,112275,0,143460
140920102900000,NE 133,RESIDENTIAL,32447,0,32447,100733,0,133180
140920103000000,NE 133,RESIDENTIAL,31815,0,31815,91616,0,123431
140920103100000,NE 133,RESIDENTIAL,30128,0,30128,101985,0,132113
140920103200000,NE 133,RESIDENTIAL,30713,0,30713,90783,0,121496
140920103300000,NE 133,RESIDENTIAL,31590,0,31590,98729,0,130319
140920103400000,NE 133,RESIDENTIAL,31883,0,31883,90770,0,122653
140920103500000,NE 133,RESIDENTIAL,34155,0,34155,100083,0,134238
140920103600000,NE 133,RESIDENTIAL,28958,0,28958,100217,0,129175
140920103700000,NE 133,RESIDENTIAL,31356,0,31356,119818,0,151174
140920103800000,NE 133,RESIDENTIAL,30732,0,30732,89249,0,119981
140920103900000,NE 133,RESIDENTIAL,30136,0,30136,101876,0,132012
140920200100000,NE 133,RESIDENTIAL,35647,0,35647,106193,0,141840
140920200200000,NE 133,RESIDENTIAL,31540,0,31540,99903,0,131443
140920200300000,NE 133,RESIDENTIAL,31725,0,31725,92576,0,124301
140920200400000,NE 133,RESIDENTIAL,33068,0,33068,144949,0,178017
140920200500000,NE 133,RESIDENTIAL,31725,0,31725,121734,0,153459
140920200600000,NE 133,RESIDENTIAL,35013,0,35013,113145,0,148158
140920200700000,NE 133,RESIDENTIAL,32168,0,32168,94189,0,126357
140920200800000,NE 133,RESIDENTIAL,33180,0,33180,128874,0,162054
140920200900000,NE 133,RESIDENTIAL,34254,0,34254,118204,0,152458
140920201000000,NE 133,RESIDENTIAL,32592,0,32592,99729,0,132321
140920201100000,NE 133,RESIDENTIAL,29928,0,29928,100634,0,130562
140920201200000,NE 133,RESIDENTIAL,31380,0,31380,95489,0,126869
140920201300000,NE 133,RESIDENTIAL,30555,0,30555,114086,0,144641
140920201400000,NE 133,RESIDENTIAL,30555,0,30555,97497,0,128052
140920201500000,NE 133,RESIDENTIAL,30555,0,30555,98795,0,129350
140920201600000,NE 133,RESIDENTIAL,31635,0,31635,99255,0,130890
140920201700000,NE 133,RESIDENTIAL,32018,0,32018,124634,0,156652
140920201800000,NE 133,RESIDENTIAL,31667,0,31667,112292,0,143959
140920201900000,NE 133,RESIDENTIAL,32818,0,32818,98849,0,131667
140920202000000,NE 133,RESIDENTIAL,30294,0,30294,111600,0,141894
140920202100000,NE 133,RESIDENTIAL,30294,0,30294,102647,0,132941
140920202200000,NE 133,RESIDENTIAL,30294,0,30294,111289,0,141583
140920202300000,NE 133,RESIDENTIAL,30870,0,30870,108533,0,139403
140920202400000,NE 133,RESIDENTIAL,30870,0,30870,105300,0,136170
140920202500000,NE 133,RESIDENTIAL,31239,0,31239,112183,0,143422
140920202600000,NE 133,RESIDENTIAL,29610,0,29610,110318,0,139928
140920202700000,NE 133,RESIDENTIAL,27965,0,27965,90855,0,118820
140920300100000,NE 133,RESIDENTIAL,30878,0,30878,127132,0,158010
140920300200000,NE 133,RESIDENTIAL,32128,0,32128,89286,0,121414
140920300300000,NE 133,RESIDENTIAL,30555,0,30555,93319,0,123874
140920300400000,NE 133,RESIDENTIAL,30555,0,30555,106422,0,136977
140920300500000,NE 133,RESIDENTIAL,32400,0,32400,87587,0,119987
140920300600000,NE 133,RESIDENTIAL,33886,0,33886,95199,0,129085
140920300700000,NE 133,RESIDENTIAL,32401,0,32401,99815,0,132216
140920300800000,NE 133,RESIDENTIAL,33244,0,33244,115387,0,148631
140920300900000,NE 133,RESIDENTIAL,32490,0,32490,119599,0,152089
140920301000000,NE 133,RESIDENTIAL,32994,0,32994,114201,0,147195
140920301100000,NE 133,RESIDENTIAL,33037,0,33037,113518,0,146555
140920301200000,NE 133,RESIDENTIAL,32913,0,32913,80454,0,113367
140920301300000,NE 133,RESIDENTIAL,32582,0,32582,110365,0,142947
140920301400000,NE 133,RESIDENTIAL,32015,0,32015,102614,0,134629
140920301500000,NE 133,RESIDENTIAL,31210,0,31210,122504,0,153714
140920301600000,NE 133,RESIDENTIAL,33546,0,33546,120036,0,153582
140920301700000,NE 133,RESIDENTIAL,36067,0,36067,102325,0,138392
140920301800000,NE 133,RESIDENTIAL,33392,0,33392,100924,0,134316
140920400100000,NE 133,RESIDENTIAL,31160,0,31160,110038,0,141198
140920400200000,NE 133,RESIDENTIAL,29246,0,29246,107861,0,137107
140920400300000,NE 133,RESIDENTIAL,29246,0,29246,89950,0,119196
140920400400000,NE 133,RESIDENTIAL,29246,0,29246,93142,0,122388
140920400500000,NE 133,RESIDENTIAL,30770,0,30770,86272,0,117042
140920400600000,NE 133,EXEMPT,0,31952,31952,0,109490,141442
140920400700000,NE 133,RESIDENTIAL,32251,0,32251,111075,0,143326
140920400800000,NE 133,RESIDENTIAL,31059,0,31059,92888,0,123947
140920400900000,NE 133,RESIDENTIAL,30750,0,30750,90492,0,121242
140920401000000,NE 133,RESIDENTIAL,31865,0,31865,105749,0,137614
140920401100000,NE 133,RESIDENTIAL,31536,0,31536,101567,0,133103
140920401200000,NE 133,RESIDENTIAL,29682,0,29682,108705,0,138387
140920401300000,NE 133,RESIDENTIAL,29391,0,29391,71834,0,101225
140920401400000,NE 133,RESIDENTIAL,30826,0,30826,93686,0,124512
140920401500000,NE 133,RESIDENTIAL,31579,0,31579,103766,0,135345
140920401600000,NE 133,RESIDENTIAL,29682,0,29682,84197,0,113879
140920401700000,NE 133,RESIDENTIAL,33157,0,33157,108335,0,141492
140920401800000,NE 133,RESIDENTIAL,31812,0,31812,124560,0,156372
140920401900000,NE 133,RESIDENTIAL,30798,0,30798,84899,0,115697
140920402000000,NE 133,RESIDENTIAL,27323,0,27323,82089,0,109412
140920402100000,NE 133,RESIDENTIAL,29529,0,29529,102978,0,132507
140920402200000,NE 133,RESIDENTIAL,28958,0,28958,100349,0,129307
140920402300000,NE 133,RESIDENTIAL,28665,0,28665,109156,0,137821
140920402400000,NE 133,RESIDENTIAL,29397,0,29397,90356,0,119753
140920402500000,NE 133,RESIDENTIAL,30870,0,30870,86903,0,117773
140920402600000,NE 133,RESIDENTIAL,30240,0,30240,103220,0,133460
140920402700000,NE 133,RESIDENTIAL,31410,0,31410,91472,0,122882
140920402800000,NE 133,RESIDENTIAL,30863,0,30863,76395,0,107258
140920500100000,NE 133,RESIDENTIAL,30816,0,30816,95827,0,126643
140920500200000,NE 133,RESIDENTIAL,31085,0,31085,122069,0,153154
140920500300000,NE 133,RESIDENTIAL,29682,0,29682,109430,0,139112
140920500400000,NE 133,RESIDENTIAL,28373,0,28373,104234,0,132607
140920500500000,NE 133,RESIDENTIAL,29512,0,29512,83035,0,112547
140920500600000,NE 133,RESIDENTIAL,29682,0,29682,96882,0,126564
140920500700000,NE 133,RESIDENTIAL,28373,0,28373,88441,0,116814
140920500800000,NE 133,RESIDENTIAL,28373,0,28373,106060,0,134433
140920500900000,NE 133,RESIDENTIAL,30034,0,30034,135133,0,165167
140920501000000,NE 133,RESIDENTIAL,32701,0,32701,105158,0,137859
140920501100000,NE 133,RESIDENTIAL,32724,0,32724,84803,0,117527
140920501200000,NE 133,RESIDENTIAL,31541,0,31541,97926,0,129467
140920501300000,NE 133,RESIDENTIAL,31906,0,31906,111548,0,143454
140920501400000,NE 133,RESIDENTIAL,32112,0,32112,103328,0,135440
140920600100000,NE 133,RESIDENTIAL,32340,0,32340,105884,0,138224
140920600200000,NE 133,RESIDENTIAL,33285,0,33285,93195,0,126480
140920600300000,NE 133,RESIDENTIAL,30900,0,30900,89618,0,120518
140922600100000,NE 133,RESIDENTIAL,23961,0,23961,85117,0,109078
140922600200000,NE 133,RESIDENTIAL,24990,0,24990,98513,0,123503
140922600300000,NE 133,RESIDENTIAL,24990,0,24990,91821,0,116811
140922600400000,NE 133,RESIDENTIAL,24990,0,24990,97454,0,122444
140922600500000,NE 133,RESIDENTIAL,24990,0,24990,85108,0,110098
140922600600000,NE 133,RESIDENTIAL,34769,0,34769,107724,0,142493
140922600700000,NE 133,RESIDENTIAL,33915,0,33915,83055,0,116970
140922600800000,NE 133,RESIDENTIAL,35329,0,35329,117848,0,153177
140922600900000,NE 133,RESIDENTIAL,30555,0,30555,92725,0,123280
140922601000000,NE 133,RESIDENTIAL,29900,0,29900,92600,0,122500
140922601100000,NE 133,RESIDENTIAL,31210,0,31210,100820,0,132030
140922601200000,NE 133,RESIDENTIAL,30555,0,30555,111138,0,141693
140922601300000,NE 133,RESIDENTIAL,31915,0,31915,93893,0,125808
140922700100000,NE 133,RESIDENTIAL,34425,0,34425,93487,0,127912
140922700200000,NE 133,RESIDENTIAL,27039,0,27039,122598,0,149637
140922700300000,NE 133,RESIDENTIAL,25480,0,25480,116143,0,141623
140922700400000,NE 133,RESIDENTIAL,24998,0,24998,121493,0,146491
140922700500000,NE 133,RESIDENTIAL,25712,0,25712,141456,0,167168
140922700600000,NE 133,RESIDENTIAL,34761,0,34761,106614,0,141375
140922700700000,NE 133,RESIDENTIAL,36982,0,36982,117308,0,154290
140922700800000,NE 133,RESIDENTIAL,35113,0,35113,135618,0,170731
140922700900000,NE 133,RESIDENTIAL,36490,0,36490,135313,0,171803
140922701000000,NE 133,RESIDENTIAL,33416,0,33416,133099,0,166515
140922701100000,NE 133,RESIDENTIAL,32089,0,32089,108999,0,141088
140922701200000,NE 133,RESIDENTIAL,32471,0,32471,96334,0,128805
140922701300000,NE 133,RESIDENTIAL,28925,0,28925,101617,0,130542
140922701400000,NE 133,RESIDENTIAL,35806,0,35806,110750,0,146556
140922701500000,NE 133,RESIDENTIAL,31765,0,31765,114218,0,145983
140922800100000,NE 133,RESIDENTIAL,32728,0,32728,94657,0,127385
140922800200000,NE 133,RESIDENTIAL,26472,0,26472,117826,0,144298
140922800300000,NE 133,RESIDENTIAL,35133,0,35133,140217,0,175350
140922800400000,NE 133,RESIDENTIAL,35589,0,35589,135840,0,171429
140922800500000,NE 133,RESIDENTIAL,34509,0,34509,119141,0,153650
140922800600000,NE 133,RESIDENTIAL,34425,0,34425,104947,0,139372
140922800700000,NE 133,RESIDENTIAL,35100,0,35100,120173,0,155273
140922800800000,NE 133,RESIDENTIAL,33412,0,33412,111422,0,144834
140922800900000,NE 133,RESIDENTIAL,35317,0,35317,136954,0,172271
140922801000000,NE 133,RESIDENTIAL,37066,0,37066,119121,0,156187
140922801100000,NE 133,RESIDENTIAL,29482,0,29482,106040,0,135522
140922801200000,NE 133,RESIDENTIAL,28958,0,28958,78640,0,107598
140922801300000,NE 133,RESIDENTIAL,34116,0,34116,117862,0,151978
140922801400000,NE 133,RESIDENTIAL,30936,0,30936,98168,0,129104
140922801500000,NE 133,RESIDENTIAL,29917,0,29917,112356,0,142273
140922801600000,NE 133,RESIDENTIAL,32957,0,32957,116692,0,149649
140922801700000,NE 133,RESIDENTIAL,35089,0,35089,104653,0,139742
140922801800000,NE 133,RESIDENTIAL,35509,0,35509,111838,0,147347
140922801900000,NE 133,RESIDENTIAL,35036,0,35036,117677,0,152713
140922802000000,NE 133,RESIDENTIAL,34580,0,34580,136284,0,170864
140922802100000,NE 133,RESIDENTIAL,33392,0,33392,105132,0,138524
140922802200000,NE 133,RESIDENTIAL,32760,0,32760,108914,0,141674
140922802300000,NE 133,RESIDENTIAL,34425,0,34425,119682,0,154107
140922802400000,NE 133,RESIDENTIAL,37323,0,37323,131573,0,168896
140922802500000,NE 133,RESIDENTIAL,35662,0,35662,131836,0,167498
140922802600000,NE 133,RESIDENTIAL,33680,0,33680,104170,0,137850
140922802700000,NE 133,RESIDENTIAL,31815,0,31815,144113,0,175928
140922802800000,NE 133,RESIDENTIAL,36949,0,36949,121601,0,158550
140922802900000,NE 133,RESIDENTIAL,34838,0,34838,102275,0,137113
140922803000000,NE 133,RESIDENTIAL,30555,0,30555,116164,0,146719
140922803100000,NE 133,RESIDENTIAL,33174,0,33174,118530,0,151704
140922803200000,NE 133,RESIDENTIAL,33174,0,33174,135934,0,169108
140922900100000,NE 133,RESIDENTIAL,28315,0,28315,96375,0,124690
140922900200000,NE 133,RESIDENTIAL,28958,0,28958,78904,0,107862
140922900300000,NE 133,RESIDENTIAL,28958,0,28958,82422,0,111380
140922900400000,NE 133,RESIDENTIAL,28958,0,28958,92186,0,121144
140922900500000,NE 133,RESIDENTIAL,28958,0,28958,94590,0,123548
140922900600000,NE 133,RESIDENTIAL,30054,0,30054,97783,0,127837
140922900700000,NE 133,RESIDENTIAL,30054,0,30054,83132,0,113186
140922900800000,NE 133,RESIDENTIAL,30054,0,30054,97309,0,127363
140922900900000,NE 133,RESIDENTIAL,30685,0,30685,118783,0,149468
140923000100000,NE 133,RESIDENTIAL,29932,0,29932,77978,0,107910
140923000200000,NE 133,RESIDENTIAL,30555,0,30555,90815,0,121370
140923000300000,NE 133,RESIDENTIAL,30870,0,30870,92452,0,123322
140923000400000,NE 133,RESIDENTIAL,31656,0,31656,117407,0,149063
140923000500000,NE 133,RESIDENTIAL,32445,0,32445,105486,0,137931
140923000600000,NE 133,RESIDENTIAL,32445,0,32445,130167,0,162612
140923000700000,NE 133,RESIDENTIAL,31668,0,31668,84974,0,116642
140923000800000,NE 133,RESIDENTIAL,29183,0,29183,106203,0,135386
140923000900000,NE 133,RESIDENTIAL,31020,0,31020,104613,0,135633
140923001000000,NE 133,RESIDENTIAL,30906,0,30906,107921,0,138827
140923001100000,NE 133,RESIDENTIAL,33025,0,33025,127699,0,160724
140923001200000,NE 133,RESIDENTIAL,32729,0,32729,101843,0,134572
140923001300000,NE 133,RESIDENTIAL,29988,0,29988,107809,0,137797
140923001400000,NE 133,RESIDENTIAL,31360,0,31360,118539,0,149899
140923001500000,NE 133,RESIDENTIAL,32130,0,32130,84337,0,116467
140923001600000,NE 133,RESIDENTIAL,32130,0,32130,99384,0,131514
140923100100000,NE 133,RESIDENTIAL,32878,0,32878,92985,0,125863
140923100200000,NE 133,RESIDENTIAL,28958,0,28958,95984,0,124942
140923100300000,NE 133,RESIDENTIAL,28958,0,28958,95830,0,124788
140923100400000,NE 133,RESIDENTIAL,32188,0,32188,103317,0,135505
140923200100000,NE 133,RESIDENTIAL,34366,0,34366,90671,0,125037
140923200200000,NE 133,RESIDENTIAL,31500,0,31500,106294,0,137794
140923200300000,NE 133,RESIDENTIAL,29155,0,29155,105422,0,134577
140923200400000,NE 133,RESIDENTIAL,34633,0,34633,90398,0,125031
140923200500000,NE 133,RESIDENTIAL,31800,0,31800,99816,0,131616
140923200600000,NE 133,RESIDENTIAL,31298,0,31298,78876,0,110174
140923200700000,NE 133,RESIDENTIAL,31590,0,31590,87996,0,119586
140923200800000,NE 133,RESIDENTIAL,33345,0,33345,84099,0,117444
140923200900000,NE 133,RESIDENTIAL,30420,0,30420,129308,0,159728
140923201000000,NE 133,RESIDENTIAL,30420,0,30420,88781,0,119201
140923300100000,NE 133,RESIDENTIAL,31528,0,31528,96410,0,127938
140923300200000,NE 133,RESIDENTIAL,35923,0,35923,107723,0,143646
140923300300000,NE 133,RESIDENTIAL,34884,0,34884,127828,0,162712
140923300400000,NE 133,RESIDENTIAL,34504,0,34504,106439,0,140943
140923300500000,NE 133,RESIDENTIAL,33907,0,33907,107773,0,141680
140923300600000,NE 133,RESIDENTIAL,35431,0,35431,126634,0,162065
140923300700000,NE 133,RESIDENTIAL,34559,0,34559,102831,0,137390
140923300800000,NE 133,RESIDENTIAL,33442,0,33442,109092,0,142534
140923300900000,NE 133,RESIDENTIAL,33393,0,33393,121226,0,154619
140923301000000,NE 133,RESIDENTIAL,34155,0,34155,112846,0,147001
140923301100000,NE 133,RESIDENTIAL,32148,0,32148,112971,0,145119
140923301200000,NE 133,RESIDENTIAL,30118,0,30118,92822,0,122940
140923301300000,NE 133,RESIDENTIAL,34483,0,34483,104034,0,138517
140923301400000,NE 133,RESIDENTIAL,30555,0,30555,104701,0,135256
140923301500000,NE 133,RESIDENTIAL,30555,0,30555,106581,0,137136
140923301600000,NE 133,RESIDENTIAL,30555,0,30555,113934,0,144489
140923301700000,NE 133,RESIDENTIAL,32225,0,32225,119112,0,151337
140923301800000,NE 133,RESIDENTIAL,31185,0,31185,94909,0,126094
140923301900000,NE 133,RESIDENTIAL,28958,0,28958,98110,0,127068
140923302000000,NE 133,RESIDENTIAL,28958,0,28958,106505,0,135463
140923302100000,NE 133,RESIDENTIAL,28958,0,28958,110336,0,139294
140923400100000,NE 133,RESIDENTIAL,30600,0,30600,104877,0,135477
140923400200000,NE 133,RESIDENTIAL,32400,0,32400,117930,0,150330
140923400300000,NE 133,RESIDENTIAL,31500,0,31500,97761,0,129261
140923400400000,NE 133,RESIDENTIAL,27000,0,27000,93353,0,120353
140923400500000,NE 133,RESIDENTIAL,32300,0,32300,121413,0,153713
140925100100000,NE 133,RESIDENTIAL,34081,0,34081,102978,0,137059
140925200100000,NE 133,RESIDENTIAL,33345,0,33345,90939,0,124284
140925200200000,NE 133,RESIDENTIAL,34320,0,34320,109430,0,143750
140925200300000,NE 133,RESIDENTIAL,32917,0,32917,100472,0,133389
140925200400000,NE 133,RESIDENTIAL,33791,0,33791,99097,0,132888
140925200500000,NE 133,RESIDENTIAL,31258,0,31258,86871,0,118129
140925200600000,NE 133,RESIDENTIAL,34234,0,34234,111408,0,145642
140925200700000,NE 133,RESIDENTIAL,35894,0,35894,111006,0,146900
140925200800000,NE 133,RESIDENTIAL,37908,0,37908,107897,0,145805
140925200900000,NE 133,RESIDENTIAL,39621,0,39621,117045,0,156666
140925201000000,NE 133,RESIDENTIAL,36598,0,36598,110276,0,146874
140925201100000,NE 133,RESIDENTIAL,34571,0,34571,94301,0,128872
140925201200000,NE 133,RESIDENTIAL,34150,0,34150,120161,0,154311
140925201300000,NE 133,RESIDENTIAL,34876,0,34876,112279,0,147155
140925201400000,NE 133,RESIDENTIAL,34288,0,34288,102114,0,136402
140925201500000,NE 133,RESIDENTIAL,37125,0,37125,109080,0,146205
140925201600000,NE 133,RESIDENTIAL,41040,0,41040,113327,0,154367
140925201700000,NE 133,RESIDENTIAL,41876,0,41876,113758,0,155634
140925201800000,NE 133,RESIDENTIAL,44839,0,44839,153100,0,197939
140925201900000,NE 133,RESIDENTIAL,44348,0,44348,122544,0,166892
140925202000000,NE 133,RESIDENTIAL,45441,0,45441,119039,0,164480
140925202100000,NE 133,RESIDENTIAL,45562,0,45562,191774,0,237336
140925202200000,NE 133,RESIDENTIAL,35193,0,35193,172765,0,207958
140925202300000,NE 133,RESIDENTIAL,38913,0,38913,132724,0,171637
140925202400000,NE 133,RESIDENTIAL,36433,0,36433,119337,0,155770
140925202500000,NE 133,RESIDENTIAL,40014,0,40014,139079,0,179093
140925202600000,NE 133,RESIDENTIAL,39672,0,39672,153410,0,193082
140925202700000,NE 133,RESIDENTIAL,40365,0,40365,145928,0,186293
140925202800000,NE 133,RESIDENTIAL,35946,0,35946,129363,0,165309
140925202900000,NE 133,RESIDENTIAL,32062,0,32062,128413,0,160475
140925203000000,NE 133,RESIDENTIAL,31881,0,31881,127400,0,159281
140925203100000,NE 133,RESIDENTIAL,30353,0,30353,120790,0,151143
140925203200000,NE 133,RESIDENTIAL,33846,0,33846,110793,0,144639
140925203300000,NE 133,RESIDENTIAL,32119,0,32119,126542,0,158661
140925203400000,NE 133,RESIDENTIAL,33813,0,33813,110445,0,144258
140925300100000,NE 133,RESIDENTIAL,34920,0,34920,103175,0,138095
140925300200000,NE 133,RESIDENTIAL,32445,0,32445,99431,0,131876
140925300300000,NE 133,RESIDENTIAL,32174,0,32174,109092,0,141266
140925300400000,NE 133,RESIDENTIAL,36674,0,36674,145591,0,182265
140925300500000,NE 133,RESIDENTIAL,33700,0,33700,123684,0,157384
140925300600000,NE 133,RESIDENTIAL,34020,0,34020,110828,0,144848
140925300700000,NE 133,RESIDENTIAL,33453,0,33453,116938,0,150391
140925300800000,NE 133,RESIDENTIAL,33815,0,33815,110941,0,144756
140925300900000,NE 133,RESIDENTIAL,33815,0,33815,101187,0,135002
140925301000000,NE 133,RESIDENTIAL,41059,0,41059,266075,0,307134
140925301100000,NE 133,RESIDENTIAL,36701,0,36701,95156,0,131857
140925301200000,NE 133,RESIDENTIAL,34700,0,34700,104208,0,138908
140925301300000,NE 133,RESIDENTIAL,36555,0,36555,107309,0,143864
140925301400000,NE 133,RESIDENTIAL,35016,0,35016,117770,0,152786
140925301500000,NE 133,RESIDENTIAL,33882,0,33882,114906,0,148788
140925301600000,NE 133,RESIDENTIAL,34330,0,34330,108596,0,142926
140925400100000,NE 133,RESIDENTIAL,34425,0,34425,111070,0,145495
140925400200000,NE 133,RESIDENTIAL,44550,0,44550,166062,0,210612
140925400300000,NE 133,RESIDENTIAL,34425,0,34425,135928,0,170353
140925400400000,NE 133,RESIDENTIAL,34200,0,34200,96845,0,131045
140925400500000,NE 133,RESIDENTIAL,33210,0,33210,116464,0,149674
140925400600000,NE 133,RESIDENTIAL,35802,0,35802,129889,0,165691
140925400700000,NE 133,RESIDENTIAL,37950,0,37950,123051,0,161001
140925400800000,NE 133,RESIDENTIAL,37915,0,37915,119162,0,157077
140925400900000,NE 133,RESIDENTIAL,35829,0,35829,111855,0,147684
140925401000000,NE 133,RESIDENTIAL,38070,0,38070,121083,0,159153
140925401100000,NE 133,RESIDENTIAL,37167,0,37167,124688,0,161855
140925401200000,NE 133,RESIDENTIAL,41313,0,41313,118687,0,160000
140925401300000,NE 133,RESIDENTIAL,66150,0,66150,224072,0,290222
140925401400000,NE 133,RESIDENTIAL,38137,0,38137,106989,0,145126
140925401500000,NE 133,RESIDENTIAL,38316,0,38316,105991,0,144307
140925401600000,NE 133,RESIDENTIAL,31188,0,31188,122256,0,153444
140925401700000,NE 133,RESIDENTIAL,38652,0,38652,128080,0,166732
140925401800000,NE 133,RESIDENTIAL,39780,0,39780,124330,0,164110
140925401900000,NE 133,RESIDENTIAL,35038,0,35038,108888,0,143926
140925402000000,NE 133,RESIDENTIAL,40095,0,40095,121065,0,161160
140925402100000,NE 133,RESIDENTIAL,42294,0,42294,134832,0,177126
140925402200000,NE 133,RESIDENTIAL,43092,0,43092,96476,0,139568
140925402300000,NE 133,RESIDENTIAL,41850,0,41850,138678,0,180528
140925402400000,NE 133,RESIDENTIAL,42300,0,42300,127922,0,170222
140925402500000,NE 133,RESIDENTIAL,43680,0,43680,155163,0,198843
140925500100000,NE 133,RESIDENTIAL,33075,0,33075,121249,0,154324
140925500200000,NE 133,RESIDENTIAL,32351,0,32351,120625,0,152976
140925500300000,NE 133,RESIDENTIAL,35226,0,35226,120188,0,155414
140925500400000,NE 133,RESIDENTIAL,32516,0,32516,152866,0,185382
140925500500000,NE 133,RESIDENTIAL,34884,0,34884,116880,0,151764
140925500600000,NE 133,RESIDENTIAL,34425,0,34425,132817,0,167242
140925500700000,NE 133,RESIDENTIAL,34884,0,34884,142464,0,177348
140925500800000,NE 133,RESIDENTIAL,34884,0,34884,103366,0,138250
140925500900000,NE 133,RESIDENTIAL,34884,0,34884,135759,0,170643
140925501000000,NE 133,RESIDENTIAL,34783,0,34783,126199,0,160982
140925600100000,NE 133,RESIDENTIAL,40832,0,40832,116249,0,157081
140925600200000,NE 133,RESIDENTIAL,37936,0,37936,151339,0,189275
140925600300000,NE 133,RESIDENTIAL,37898,0,37898,105806,0,143704
140925600400000,NE 133,RESIDENTIAL,37705,0,37705,113498,0,151203
140925600500000,NE 133,RESIDENTIAL,32130,0,32130,103213,0,135343
140925600600000,NE 133,RESIDENTIAL,39792,0,39792,125149,0,164941
140925600700000,NE 133,RESIDENTIAL,39895,0,39895,167614,0,207509
140927600100000,NE 133,RESIDENTIAL,31273,0,31273,92778,0,124051
140927600200000,NE 133,RESIDENTIAL,29680,0,29680,86731,0,116411
140927600300000,NE 133,RESIDENTIAL,30573,0,30573,98960,0,129533
140927600400000,NE 133,RESIDENTIAL,31005,0,31005,98633,0,129638
140927600500000,NE 133,RESIDENTIAL,31005,0,31005,92669,0,123674
140927600600000,NE 133,RESIDENTIAL,31005,0,31005,96498,0,127503
140927600700000,NE 133,RESIDENTIAL,31005,0,31005,109232,0,140237
140927600800000,NE 133,RESIDENTIAL,31005,0,31005,91600,0,122605
140927600900000,NE 133,RESIDENTIAL,31005,0,31005,98658,0,129663
140927601000000,NE 133,RESIDENTIAL,382,0,382,0,0,382
140927700100000,NE 133,RESIDENTIAL,32999,0,32999,96488,0,129487
140927700200000,NE 133,RESIDENTIAL,31269,0,31269,99022,0,130291
140927700300000,NE 133,RESIDENTIAL,32400,0,32400,106922,0,139322
140927700400000,NE 133,RESIDENTIAL,30991,0,30991,96922,0,127913
140927700500000,NE 133,RESIDENTIAL,30328,0,30328,111642,0,141970
140927700600000,NE 133,RESIDENTIAL,30240,0,30240,95879,0,126119
140927700700000,NE 133,RESIDENTIAL,30240,0,30240,91634,0,121874
140927700800000,NE 133,RESIDENTIAL,30240,0,30240,94833,0,125073
140927700900000,NE 133,RESIDENTIAL,28958,0,28958,106355,0,135313
140927701000000,NE 133,RESIDENTIAL,28958,0,28958,97071,0,126029
140927701100000,NE 133,RESIDENTIAL,28958,0,28958,119918,0,148876
140927701200000,NE 133,RESIDENTIAL,28958,0,28958,102944,0,131902
140927701300000,NE 133,RESIDENTIAL,28958,0,28958,83363,0,112321
140927701400000,NE 133,RESIDENTIAL,28614,0,28614,105252,0,133866
140927800100000,NE 133,RESIDENTIAL,29301,0,29301,116408,0,145709
140927800200000,NE 133,RESIDENTIAL,27063,0,27063,88713,0,115776
140927900100000,NE 133,RESIDENTIAL,34611,0,34611,113017,0,147628
140927900200000,NE 133,RESIDENTIAL,29232,0,29232,135795,0,165027
140927900300000,NE 133,RESIDENTIAL,31597,0,31597,92904,0,124501
140927900400000,NE 133,RESIDENTIAL,32054,0,32054,90076,0,122130
140927900500000,NE 133,RESIDENTIAL,32182,0,32182,91017,0,123199
140927900600000,NE 133,RESIDENTIAL,28958,0,28958,87036,0,115994
140927900700000,NE 133,RESIDENTIAL,27349,0,27349,80974,0,108323
140927900800000,NE 133,RESIDENTIAL,28958,0,28958,81050,0,110008
140927900900000,NE 133,RESIDENTIAL,28958,0,28958,88381,0,117339
140927901000000,NE 133,RESIDENTIAL,28958,0,28958,94340,0,123298
140927901100000,NE 133,RESIDENTIAL,28958,0,28958,119697,0,148655
140927901200000,NE 133,RESIDENTIAL,27349,0,27349,107234,0,134583
140927901300000,NE 133,RESIDENTIAL,28958,0,28958,98082,0,127040
140927901400000,NE 133,RESIDENTIAL,29301,0,29301,95820,0,125121
140927901500000,NE 133,RESIDENTIAL,29973,0,29973,85314,0,115287
140927901600000,NE 133,RESIDENTIAL,28858,0,28858,91284,0,120142
140927901700000,NE 133,RESIDENTIAL,30555,0,30555,98371,0,128926
140927901800000,NE 133,RESIDENTIAL,30555,0,30555,95751,0,126306
140927901900000,NE 133,RESIDENTIAL,30555,0,30555,98908,0,129463
140927902000000,NE 133,RESIDENTIAL,30555,0,30555,89829,0,120384
140927902100000,NE 133,RESIDENTIAL,30555,0,30555,95992,0,126547
140927902200000,NE 133,RESIDENTIAL,30682,0,30682,102096,0,132778
140927902300000,NE 133,RESIDENTIAL,33097,0,33097,104066,0,137163
140927902400000,NE 133,RESIDENTIAL,32265,0,32265,118961,0,151226
140927902500000,NE 133,RESIDENTIAL,31876,0,31876,108360,0,140236
140927902600000,NE 133,RESIDENTIAL,31185,0,31185,95223,0,126408
140927902700000,NE 133,RESIDENTIAL,34593,0,34593,114746,0,149339
140928000100000,NE 133,RESIDENTIAL,28614,0,28614,91162,0,119776
140928000200000,NE 133,RESIDENTIAL,29341,0,29341,129502,0,158843
140928000300000,NE 133,RESIDENTIAL,31864,0,31864,103792,0,135656
140928000400000,NE 133,RESIDENTIAL,33232,0,33232,101610,0,134842
140928000500000,NE 133,RESIDENTIAL,34702,0,34702,119726,0,154428
140928000600000,NE 133,RESIDENTIAL,30555,0,30555,106750,0,137305
140928000700000,NE 133,RESIDENTIAL,32738,0,32738,102642,0,135380
140928000800000,NE 133,RESIDENTIAL,30919,0,30919,103137,0,134056
140928000900000,NE 133,RESIDENTIAL,32738,0,32738,106298,0,139036
140928001000000,NE 133,RESIDENTIAL,32738,0,32738,112154,0,144892
140928001100000,NE 133,RESIDENTIAL,34556,0,34556,125070,0,159626
140928100100000,NE 133,RESIDENTIAL,32815,0,32815,94728,0,127543
140928100200000,NE 133,RESIDENTIAL,31185,0,31185,85825,0,117010
140928100300000,NE 133,RESIDENTIAL,30870,0,30870,103770,0,134640
140928100400000,NE 133,RESIDENTIAL,32544,0,32544,97306,0,129850
140928100500000,NE 133,RESIDENTIAL,31464,0,31464,100678,0,132142
140928100600000,NE 133,RESIDENTIAL,30132,0,30132,101290,0,131422
140928100700000,NE 133,RESIDENTIAL,32422,0,32422,95565,0,127987
140928100800000,NE 133,RESIDENTIAL,31355,0,31355,101205,0,132560
140928100900000,NE 133,RESIDENTIAL,31742,0,31742,83741,0,115483
140928101000000,NE 133,RESIDENTIAL,31742,0,31742,99968,0,131710
140928101100000,NE 133,RESIDENTIAL,32980,0,32980,112560,0,145540
140928101200000,NE 133,RESIDENTIAL,30870,0,30870,100630,0,131500
140928101300000,NE 133,RESIDENTIAL,31421,0,31421,91776,0,123197
140928101400000,NE 133,RESIDENTIAL,33075,0,33075,123054,0,156129
140928101500000,NE 133,RESIDENTIAL,34992,0,34992,108900,0,143892
140928101600000,NE 133,RESIDENTIAL,34668,0,34668,116081,0,150749
140928101700000,NE 133,RESIDENTIAL,35274,0,35274,125061,0,160335
140928101800000,NE 133,RESIDENTIAL,32730,0,32730,102525,0,135255
140928101900000,NE 133,RESIDENTIAL,31703,0,31703,100078,0,131781
140928102000000,NE 133,RESIDENTIAL,31519,0,31519,108015,0,139534
140928102100000,NE 133,RESIDENTIAL,31500,0,31500,107726,0,139226
140928102200000,NE 133,RESIDENTIAL,30433,0,30433,112988,0,143421
140928102300000,NE 133,RESIDENTIAL,33248,0,33248,105897,0,139145
140928102400000,NE 133,RESIDENTIAL,33482,0,33482,107385,0,140867
140928102500000,NE 133,RESIDENTIAL,32384,0,32384,79153,0,111537
140928200100000,NE 133,RESIDENTIAL,33041,0,33041,103590,0,136631
140928200200000,NE 133,RESIDENTIAL,31005,0,31005,77169,0,108174
140928200300000,NE 133,RESIDENTIAL,32020,0,32020,89276,0,121296
140928200400000,NE 133,RESIDENTIAL,32020,0,32020,88157,0,120177
140928200500000,NE 133,RESIDENTIAL,34303,0,34303,92526,0,126829
140928200600000,NE 133,RESIDENTIAL,33432,0,33432,102192,0,135624
140928200900000,NE 133,RESIDENTIAL,45696,0,45696,110464,0,156160
140928300100000,NE 133,RESIDENTIAL,32400,0,32400,86370,0,118770
140928300200000,NE 133,RESIDENTIAL,32135,0,32135,113787,0,145922
140928300300000,NE 133,RESIDENTIAL,31864,0,31864,105072,0,136936
140928300400000,NE 133,RESIDENTIAL,31500,0,31500,109060,0,140560
140928300500000,NE 133,RESIDENTIAL,34884,0,34884,109323,0,144207
140928300600000,NE 133,RESIDENTIAL,33721,0,33721,110824,0,144545
140928300700000,NE 133,RESIDENTIAL,31686,0,31686,104816,0,136502
140928300800000,NE 133,RESIDENTIAL,33915,0,33915,104852,0,138767
140928300900000,NE 133,RESIDENTIAL,33385,0,33385,102850,0,136235
140928301000000,NE 133,RESIDENTIAL,34200,0,34200,139781,0,173981
140928301100000,NE 133,RESIDENTIAL,35611,0,35611,113725,0,149336
140928301200000,NE 133,RESIDENTIAL,37278,0,37278,102064,0,139342
140928301300000,NE 133,RESIDENTIAL,35568,0,35568,118674,0,154242
140928301400000,NE 133,RESIDENTIAL,35234,0,35234,109574,0,144808
140928301500000,NE 133,RESIDENTIAL,34200,0,34200,126718,0,160918
140928301600000,NE 133,RESIDENTIAL,33025,0,33025,112151,0,145176
140928301700000,NE 133,RESIDENTIAL,33666,0,33666,114022,0,147688
140928301800000,NE 133,RESIDENTIAL,33666,0,33666,101312,0,134978
140928301900000,NE 133,RESIDENTIAL,32704,0,32704,113822,0,146526
140928302000000,NE 133,RESIDENTIAL,33772,0,33772,109810,0,143582
140928302100000,NE 133,RESIDENTIAL,32323,0,32323,100755,0,133078
140928302200000,NE 133,RESIDENTIAL,33382,0,33382,111470,0,144852
140928302300000,NE 133,RESIDENTIAL,33174,0,33174,87352,0,120526
140928400100000,NE 133,RESIDENTIAL,35694,0,35694,112145,0,147839
140928400200000,NE 133,RESIDENTIAL,36450,0,36450,102217,0,138667
140928400300000,NE 133,RESIDENTIAL,34627,0,34627,97516,0,132143
140928400400000,NE 133,RESIDENTIAL,34627,0,34627,135763,0,170390
140928400500000,NE 133,RESIDENTIAL,34627,0,34627,104085,0,138712
140928400600000,NE 133,RESIDENTIAL,34627,0,34627,123942,0,158569
140928400700000,NE 133,RESIDENTIAL,33874,0,33874,106257,0,140131
140928400800000,NE 133,RESIDENTIAL,33048,0,33048,117805,0,150853
140928400900000,NE 133,RESIDENTIAL,34627,0,34627,118397,0,153024
140928401000000,NE 133,RESIDENTIAL,40540,0,40540,117792,0,158332
140928401100000,NE 133,RESIDENTIAL,39996,0,39996,125572,0,165568
140928401200000,NE 133,RESIDENTIAL,41400,0,41400,113150,0,154550
140928401300000,NE 133,RESIDENTIAL,37834,0,37834,119135,0,156969
140928401400000,NE 133,RESIDENTIAL,39502,0,39502,111645,0,151147
140928401500000,NE 133,RESIDENTIAL,40969,0,40969,123912,0,164881
140930100100000,SECTION 42,COMMERCIAL,0,561600,561600,0,4062224,4623824
140930100200000,NE 147,RESIDENTIAL,24939,0,24939,0,0,24939
140930100300000,NE 147,RESIDENTIAL,38400,0,38400,107072,0,145472
140930100400000,NE 147,RESIDENTIAL,40200,0,40200,146923,0,187123
140930100500000,NE 147,RESIDENTIAL,25392,0,25392,0,0,25392
140930100600000,NE 147,RESIDENTIAL,39600,0,39600,147793,0,187393
140930100700000,NE 147,RESIDENTIAL,19788,0,19788,0,0,19788
140930200100000,NE 147,RESIDENTIAL,42075,0,42075,103211,0,145286
140930200200000,NE 147,RESIDENTIAL,30398,0,30398,102404,0,132802
140930200300000,NE 147,RESIDENTIAL,32665,0,32665,103332,0,135997
140930200400000,NE 147,RESIDENTIAL,38376,0,38376,103200,0,141576
140930200500000,NE 147,RESIDENTIAL,39577,0,39577,125457,0,165034
140930200600000,NE 147,RESIDENTIAL,26153,0,26153,66861,0,93014
140930200700000,NE 147,RESIDENTIAL,27936,0,27936,106419,0,134355
140930200800000,NE 147,RESIDENTIAL,34422,0,34422,119859,0,154281
140930200900000,NE 147,RESIDENTIAL,16422,0,16422,119587,0,136009
140930201000000,NE 147,RESIDENTIAL,35770,0,35770,90409,0,126179
140930201100000,NE 147,RESIDENTIAL,36096,0,36096,85251,0,121347
140930201200000,NE 147,RESIDENTIAL,31815,0,31815,104289,0,136104
140930201300000,NE 147,RESIDENTIAL,30420,0,30420,80652,0,111072
140930201400000,NE 147,RESIDENTIAL,29925,0,29925,82458,0,112383
140930201500000,NE 147,RESIDENTIAL,32020,0,32020,69494,0,101514
140930201600000,CITY PROPERTY,EXEMPT,0,0,0,0,0,0
140930201700000,NE 147,RESIDENTIAL,36923,0,36923,161951,0,198874
140930201800000,NE 147,RESIDENTIAL,36360,0,36360,156778,0,193138
140930201900000,NE 147,RESIDENTIAL,36360,0,36360,137545,0,173905
140930202000000,NE 147,RESIDENTIAL,36360,0,36360,135451,0,171811
140930202100000,NE 147,RESIDENTIAL,36360,0,36360,143294,0,179654
140930202200000,NE 147,RESIDENTIAL,36112,0,36112,131470,0,167582
140930202300000,NE 147,RESIDENTIAL,38750,0,38750,183838,0,222588
140930202400000,NE 147,RESIDENTIAL,37791,0,37791,127415,0,165206
140930202500000,NE 147,RESIDENTIAL,38454,0,38454,154441,0,192895
140930202600000,NE 147,RESIDENTIAL,36978,0,36978,122287,0,159265
140930202700000,NE 147,RESIDENTIAL,37133,0,37133,157312,0,194445
140930202800000,NE 147,RESIDENTIAL,36765,0,36765,162475,0,199240
140930202900000,NE 147,RESIDENTIAL,36765,0,36765,132716,0,169481
140930203000000,NE 147,RESIDENTIAL,38090,0,38090,136259,0,174349
140930203100000,NE 147,RESIDENTIAL,35802,0,35802,133965,0,169767
140930203200000,NE 147,RESIDENTIAL,43850,0,43850,55283,0,99133
140930203300000,NE 147,RESIDENTIAL,55803,0,55803,295727,0,351530
140930203400000,NE 147,RESIDENTIAL,60333,0,60333,254131,0,314464
140930203500000,NE 147,RESIDENTIAL,41175,0,41175,60778,0,101953
140930203600000,NE 147,RESIDENTIAL,20400,0,20400,80250,0,100650
140930203700000,NE 147,RESIDENTIAL,25070,0,25070,164077,0,189147
140930203800000,NE 147,RESIDENTIAL,25200,0,25200,148419,0,173619
140930203900000,NE 147,RESIDENTIAL,24960,0,24960,116731,0,141691
140930204000000,NE 147,RESIDENTIAL,24240,0,24240,168415,0,192655
140930204100000,NE 147,RESIDENTIAL,21275,0,21275,94872,0,116147
140930204200000,NE 147,RESIDENTIAL,21691,0,21691,129899,0,151590
140932600100000,NE 147,RESIDENTIAL,40545,0,40545,94043,0,134588
140932600200000,NE 147,RESIDENTIAL,39109,0,39109,131889,0,170998
140932700100000,NE 147,RESIDENTIAL,58032,0,58032,159793,0,217825
140932700200000,NE 147,RESIDENTIAL,57406,0,57406,168845,0,226251
140932700300000,NE 147,RESIDENTIAL,32368,0,32368,101300,0,133668
140932700400000,NE 147,RESIDENTIAL,31173,0,31173,139859,0,171032
140932700500000,NE 147,RESIDENTIAL,29235,0,29235,0,0,29235
140932700600000,NE 147,RESIDENTIAL,31036,0,31036,110558,0,141594
140932701000000,NE 147,RESIDENTIAL,19100,0,19100,97352,0,116452
140932701100000,NE 147,RESIDENTIAL,27060,0,27060,123248,0,150308
140932701200000,NE 147,RESIDENTIAL,17762,0,17762,85794,0,103556
140932701300000,NE 147,RESIDENTIAL,20160,0,20160,78407,0,98567
140932701400000,NE 147,RESIDENTIAL,23380,0,23380,139106,0,162486
140932701500000,NE 147,RESIDENTIAL,21141,0,21141,75170,0,96311
140932701600000,NE 147,RESIDENTIAL,38347,0,38347,132587,0,170934
140932701700000,NE 147,RESIDENTIAL,27964,0,27964,67807,0,95771
140932701800000,NE 147,RESIDENTIAL,24705,0,24705,193124,0,217829
140932701900000,NE 147,RESIDENTIAL,24589,0,24589,124882,0,149471
140932702000000,NE 147,RESIDENTIAL,38547,0,38547,59835,0,98382
140932702100000,NE 145,RESIDENTIAL,35880,0,35880,216689,0,252569
140932702300000,NE 147,RESIDENTIAL,27979,0,27979,122918,0,150897
140932800100000,NE 147,RESIDENTIAL,24266,0,24266,100714,0,124980
140932800200000,NE 147,RESIDENTIAL,26160,0,26160,35254,0,61414
140932800300000,NE 147,RESIDENTIAL,37178,0,37178,71696,0,108874
140932800400000,NE 147,RESIDENTIAL,30317,0,30317,139275,0,169592
140932800500000,NE 147,RESIDENTIAL,31620,0,31620,166732,0,198352
140932800600000,NE 147,RESIDENTIAL,24180,0,24180,109151,0,133331
140932800700000,NE 147,RESIDENTIAL,30480,0,30480,124809,0,155289
140932800800000,NE 147,RESIDENTIAL,30960,0,30960,111040,0,142000
140932800900000,NE 147,RESIDENTIAL,40425,0,40425,59068,0,99493
140932801000000,NE 147,RESIDENTIAL,40500,0,40500,121284,0,161784
140932801100000,NE 147,RESIDENTIAL,42275,0,42275,118894,0,161169
140932801200000,NE 147,RESIDENTIAL,27885,0,27885,120753,0,148638
140932801300000,NE 147,RESIDENTIAL,26250,0,26250,107289,0,133539
140932801400000,NE 147,RESIDENTIAL,24747,0,24747,150215,0,174962
140932801500000,NE 147,RESIDENTIAL,21421,0,21421,152228,0,173649
140932801600000,NE 147,RESIDENTIAL,23031,0,23031,116139,0,139170
140932801700000,NE 147,RESIDENTIAL,22800,0,22800,116854,0,139654
140932801800000,NE 147,RESIDENTIAL,26353,0,26353,130846,0,157199
140932801900000,NE 147,RESIDENTIAL,22374,0,22374,127259,0,149633
140932802000000,NE 147,RESIDENTIAL,26220,0,26220,223225,0,249445
140932802100000,NE 147,RESIDENTIAL,28017,0,28017,183343,0,211360
140932802200000,NE 147,RESIDENTIAL,37442,0,37442,47171,0,84613
140932802300000,NE 147,RESIDENTIAL,28381,0,28381,167592,0,195973
140932802400000,NE 147,RESIDENTIAL,40525,0,40525,88268,0,128793
140932802500000,NE 147,RESIDENTIAL,34744,0,34744,48934,0,83678
140932802600000,NE 147,RESIDENTIAL,40100,0,40100,240091,0,280191
140932802700000,NE 147,RESIDENTIAL,40075,0,40075,261136,0,301211
140932802800000,NE 147,RESIDENTIAL,35670,0,35670,109056,0,144726
140932802900000,NE 147,RESIDENTIAL,39600,0,39600,123745,0,163345
140932803000000,NE 147,RESIDENTIAL,39000,0,39000,49789,0,88789
140932803100000,NE 147,RESIDENTIAL,23985,0,23985,95484,0,119469
140932803400000,NE 147,RESIDENTIAL,1131,0,1131,0,0,1131
140935100100000,NE 147,RESIDENTIAL,20706,0,20706,101287,0,121993
140935100200000,NE 147,RESIDENTIAL,35910,0,35910,106938,0,142848
140935100300000,NE 147,RESIDENTIAL,39906,0,39906,130465,0,170371
140935100400000,NE 147,RESIDENTIAL,23085,0,23085,98198,0,121283
140935100500000,NE 147,RESIDENTIAL,22572,0,22572,132387,0,154959
140935100600000,NE 147,RESIDENTIAL,22800,0,22800,143882,0,166682
140935100700000,NE 147,RESIDENTIAL,22800,0,22800,113848,0,136648
140935100800000,NE 147,RESIDENTIAL,22572,0,22572,129848,0,152420
140935100900000,NE 147,RESIDENTIAL,22116,0,22116,108175,0,130291
140935101000000,NE 147,RESIDENTIAL,20766,0,20766,129304,0,150070
140935101100000,NE 147,RESIDENTIAL,41075,0,41075,44186,0,85261
140935101400000,NE 147,RESIDENTIAL,21517,0,21517,0,0,21517
140935101500000,NE 147,RESIDENTIAL,15300,0,15300,37165,0,52465
140935101600000,NE 147,RESIDENTIAL,16950,0,16950,0,0,16950
140935101700000,NE 147,RESIDENTIAL,20340,0,20340,79361,0,99701
140935101800000,NE 147,RESIDENTIAL,18656,0,18656,71819,0,90475
140935101900000,NE 147,RESIDENTIAL,15300,0,15300,92183,0,107483
140935102000000,NE 147,RESIDENTIAL,15300,0,15300,105030,0,120330
140935102100000,NE 147,RESIDENTIAL,4200,0,4200,0,0,4200
140935102200000,NE 147,RESIDENTIAL,42475,0,42475,185503,0,227978
140935102300000,NE 147,RESIDENTIAL,42725,0,42725,62826,0,105551
140935102400000,NE 147,RESIDENTIAL,43300,0,43300,105695,0,148995
140935102500000,NE 147,RESIDENTIAL,30000,0,30000,112359,0,142359
140935102600000,NE 147,RESIDENTIAL,30094,0,30094,77388,0,107482
140935102700000,NE 147,RESIDENTIAL,42175,0,42175,79910,0,122085
140935102800000,NE 147,RESIDENTIAL,42380,0,42380,0,0,42380
140935102900000,NE 147,RESIDENTIAL,33789,0,33789,0,0,33789
140935103000000,NE 147,RESIDENTIAL,25025,0,25025,0,0,25025
140935103100000,NE 147,RESIDENTIAL,41400,0,41400,397506,0,438906
140935200100000,NE 147,RESIDENTIAL,29971,0,29971,133974,0,163945
140935200200000,NE 147,RESIDENTIAL,24184,0,24184,83951,0,108135
140935200300000,NE 147,RESIDENTIAL,41328,0,41328,230170,0,271498
140935200400000,NE 147,RESIDENTIAL,26451,0,26451,98756,0,125207
140935200500000,NE 147,RESIDENTIAL,25800,0,25800,131433,0,157233
140935200600000,NE 147,RESIDENTIAL,25800,0,25800,114597,0,140397
140935200700000,NE 147,RESIDENTIAL,27997,0,27997,96043,0,124040
140935300100000,NE 147,RESIDENTIAL,23184,0,23184,193668,0,216852
140935300200000,NE 147,RESIDENTIAL,38250,0,38250,111690,0,149940
140935300300000,NE 147,RESIDENTIAL,21120,0,21120,0,0,21120
140935300500000,NE 147,RESIDENTIAL,21615,0,21615,91894,0,113509
140935300600000,NE 147,RESIDENTIAL,29925,0,29925,50290,0,80215
140935301000000,NE 147,RESIDENTIAL,16538,0,16538,55920,0,72458
140935301100000,NE 147,RESIDENTIAL,24883,0,24883,98832,0,123715
140935301200000,NE 147,RESIDENTIAL,29606,0,29606,62502,0,92108
140935301400000,NE 147,RESIDENTIAL,26670,0,26670,111047,0,137717
140935301500000,NE 147,RESIDENTIAL,26880,0,26880,103625,0,130505
140935301600000,NE 147,RESIDENTIAL,27648,0,27648,103700,0,131348
140935301700000,NE 147,RESIDENTIAL,17415,0,17415,36762,0,54177
140935301800000,NE 147,RESIDENTIAL,25880,0,25880,107020,0,132900
140935301900000,NE 147,RESIDENTIAL,26865,0,26865,99376,0,126241
140935302000000,NE 147,RESIDENTIAL,26585,0,26585,106022,0,132607
140935302100000,NE 147,RESIDENTIAL,25549,0,25549,587,0,26136
140935302200000,NE 147,RESIDENTIAL,32562,0,32562,122295,0,154857
140937600100000,NE 147,RESIDENTIAL,40575,0,40575,108305,0,148880
140937600200000,NE 147,RESIDENTIAL,33800,0,33800,87861,0,121661
140937600300000,NE 147,RESIDENTIAL,31360,0,31360,63463,0,94823
140937600400000,NE 147,RESIDENTIAL,30480,0,30480,144702,0,175182
140937600500000,NE 147,RESIDENTIAL,22860,0,22860,79471,0,102331
140937600600000,NE 147,RESIDENTIAL,36195,0,36195,47408,0,83603
140937600700000,NE 147,RESIDENTIAL,19500,0,19500,43861,0,63361
140937600800000,NE 147,RESIDENTIAL,24060,0,24060,87553,0,111613
140937600900000,NE 147,RESIDENTIAL,28560,0,28560,81473,0,110033
140937601000000,NE 147,RESIDENTIAL,22995,0,22995,92200,0,115195
140937601100000,NE 147,RESIDENTIAL,20280,0,20280,77774,0,98054
140937601200000,NE 147,RESIDENTIAL,19790,0,19790,90212,0,110002
140937601300000,NE 147,RESIDENTIAL,18720,0,18720,86811,0,105531
140937601400000,NE 147,RESIDENTIAL,19305,0,19305,97695,0,117000
140937601500000,NE 147,RESIDENTIAL,18000,0,18000,86118,0,104118
140937601600000,NE 147,RESIDENTIAL,18000,0,18000,90862,0,108862
140937601700000,NE 147,RESIDENTIAL,18900,0,18900,84754,0,103654
140937601800000,NE 147,RESIDENTIAL,18850,0,18850,107324,0,126174
140937601900000,NE 147,RESIDENTIAL,5265,0,5265,0,0,5265
140937700100000,NE 147,RESIDENTIAL,20490,0,20490,140062,0,160552
140937700200000,NE 147,RESIDENTIAL,20827,0,20827,122545,0,143372
140937700300000,NE 147,RESIDENTIAL,17919,0,17919,113491,0,131410
140937700400000,NE 147,RESIDENTIAL,19157,0,19157,92991,0,112148
140937700500000,NE 147,RESIDENTIAL,20927,0,20927,116219,0,137146
140937700600000,NE 147,RESIDENTIAL,20790,0,20790,119146,0,139936
140937700700000,NE 147,RESIDENTIAL,20790,0,20790,123919,0,144709
140937700800000,NE 147,RESIDENTIAL,21261,0,21261,119977,0,141238
140937700900000,NE 147,RESIDENTIAL,21885,0,21885,102102,0,123987
140937701000000,NE 147,RESIDENTIAL,20265,0,20265,94735,0,115000
140937701100000,NE 147,RESIDENTIAL,19157,0,19157,105140,0,124297
140937701200000,NE 147,RESIDENTIAL,19157,0,19157,107310,0,126467
140937701300000,NE 147,RESIDENTIAL,23851,0,23851,129056,0,152907
140937701400000,NE 147,RESIDENTIAL,22626,0,22626,116503,0,139129
140937701500000,NE 147,RESIDENTIAL,19355,0,19355,140270,0,159625
140937701600000,NE 147,RESIDENTIAL,17087,0,17087,135264,0,152351
140937701700000,NE 147,RESIDENTIAL,27056,0,27056,109851,0,136907
140937701800000,NE 147,RESIDENTIAL,45500,0,45500,114070,0,159570
140937701900000,NE 147,RESIDENTIAL,43275,0,43275,51693,0,94968
140937702000000,NE 147,RESIDENTIAL,20116,0,20116,63741,0,83857
140937702100000,NE 147,RESIDENTIAL,21293,0,21293,104264,0,125557
140937702200000,NE 147,RESIDENTIAL,38749,0,38749,134709,0,173458
140937702300000,NE 147,RESIDENTIAL,31446,0,31446,119882,0,151328
140937702400000,NE 147,RESIDENTIAL,22863,0,22863,76293,0,99156
140937702500000,NE 147,RESIDENTIAL,14974,0,14974,72459,0,87433
140937702600000,NE 147,RESIDENTIAL,14985,0,14985,58464,0,73449
140937702700000,NE 147,RESIDENTIAL,18315,0,18315,58193,0,76508
140937702800000,NE 147,RESIDENTIAL,18315,0,18315,65610,0,83925
140937702900000,NE 147,RESIDENTIAL,25704,0,25704,149185,0,174889
140937703000000,NE 147,RESIDENTIAL,23617,0,23617,78510,0,102127
140937703100000,NE 147,RESIDENTIAL,36695,0,36695,193063,0,229758
140937703200000,NE 147,RESIDENTIAL,21797,0,21797,124656,0,146453
140937703300000,NE 147,RESIDENTIAL,22950,0,22950,122076,0,145026
140937703400000,NE 147,RESIDENTIAL,22950,0,22950,144894,0,167844
140937703500000,NE 147,RESIDENTIAL,22950,0,22950,130780,0,153730
140937703600000,NE 147,RESIDENTIAL,22950,0,22950,121175,0,144125
140937703700000,NE 147,RESIDENTIAL,22950,0,22950,132822,0,155772
140937703800000,NE 147,RESIDENTIAL,23720,0,23720,128439,0,152159
140937703900000,NE 147,RESIDENTIAL,23940,0,23940,122263,0,146203
140937704000000,NE 147,RESIDENTIAL,4700,0,4700,0,0,4700
140937704100000,NE 147,RESIDENTIAL,24885,0,24885,184614,0,209499
140937704200000,NE 147,RESIDENTIAL,24210,0,24210,144047,0,168257
140937704300000,NE 147,RESIDENTIAL,26481,0,26481,156510,0,182991
140937704400000,NE 147,RESIDENTIAL,22711,0,22711,131430,0,154141
140937704500000,NE 147,RESIDENTIAL,23072,0,23072,145783,0,168855
140937704600000,NE 147,RESIDENTIAL,23072,0,23072,139661,0,162733
140937704700000,NE 147,RESIDENTIAL,22873,0,22873,137081,0,159954
140937704800000,NE 147,RESIDENTIAL,22476,0,22476,138373,0,160849
140937704900000,NE 147,RESIDENTIAL,22497,0,22497,124857,0,147354
140937800100000,NE 147,RESIDENTIAL,14553,0,14553,13003,0,27556
140937800200000,NE 147,RESIDENTIAL,12615,0,12615,101726,0,114341
140937800300000,NE 147,RESIDENTIAL,18300,0,18300,90277,0,108577
140937800400000,NE 147,RESIDENTIAL,18300,0,18300,88340,0,106640
140937800500000,NE 147,RESIDENTIAL,18300,0,18300,99131,0,117431
140937800600000,NE 147,RESIDENTIAL,18300,0,18300,81841,0,100141
140937800700000,NE 147,RESIDENTIAL,18300,0,18300,126805,0,145105
140937800800000,NE 147,RESIDENTIAL,18000,0,18000,90788,0,108788
140937800900000,NE 147,RESIDENTIAL,18000,0,18000,88368,0,106368
140937801000000,NE 147,RESIDENTIAL,18000,0,18000,112655,0,130655
140937803200000,NE 147,RESIDENTIAL,31487,0,31487,174713,0,206200
140937803300000,NE 147,RESIDENTIAL,31944,0,31944,85430,0,117374
140937803500000,NE 147,RESIDENTIAL,21465,0,21465,68665,0,90130
140937900100000,NE 147,RESIDENTIAL,19500,0,19500,98996,0,118496
140937900200000,NE 147,RESIDENTIAL,18000,0,18000,78485,0,96485
140937900300000,NE 147,RESIDENTIAL,19500,0,19500,75190,0,94690
140937900400000,NE 147,RESIDENTIAL,18000,0,18000,91163,0,109163
140937900500000,NE 147,RESIDENTIAL,20800,0,20800,79307,0,100107
140937900600000,NE 147,RESIDENTIAL,18772,0,18772,94955,0,113727
140937900700000,NE 147,RESIDENTIAL,18000,0,18000,97294,0,115294
140937900800000,NE 147,RESIDENTIAL,18525,0,18525,101380,0,119905
140937900900000,NE 147,RESIDENTIAL,18000,0,18000,81454,0,99454
140937901000000,NE 147,RESIDENTIAL,18525,0,18525,101515,0,120040
140938000100000,NE 147,RESIDENTIAL,22890,0,22890,55578,0,78468
140938000200000,NE 147,RESIDENTIAL,28554,0,28554,135767,0,164321
140938000300000,NE 147,RESIDENTIAL,35422,0,35422,163402,0,198824
140938000400000,NE 147,RESIDENTIAL,25294,0,25294,59158,0,84452
140938000500000,NE 147,RESIDENTIAL,23408,0,23408,107618,0,131026
140938000600000,NE 147,RESIDENTIAL,16120,0,16120,42322,0,58442
140940100100000,NE 131,RESIDENTIAL,12870,0,12870,107411,0,120281
140940100200000,NE 131,RESIDENTIAL,19012,0,19012,100814,0,119826
140940100300000,NE 131,RESIDENTIAL,14625,0,14625,32281,0,46906
140940100400000,NE 131,RESIDENTIAL,14625,0,14625,118254,0,132879
140940100500000,NE 131,RESIDENTIAL,16088,0,16088,72359,0,88447
140940100600000,NE 131,RESIDENTIAL,13163,0,13163,99353,0,112516
140940100700000,NE 131,RESIDENTIAL,14625,0,14625,114367,0,128992
140940100800000,NE 131,RESIDENTIAL,14625,0,14625,96996,0,111621
140940100900000,NE 131,RESIDENTIAL,29000,0,29000,132036,0,161036
140940101000000,NE 131,RESIDENTIAL,16530,0,16530,80470,0,97000
140940101100000,NE 131,RESIDENTIAL,12180,0,12180,64071,0,76251
140940101200000,NE 131,RESIDENTIAL,12180,0,12180,57707,0,69887
140940101300000,NE 131,RESIDENTIAL,16240,0,16240,70681,0,86921
140940101400000,NE 131,RESIDENTIAL,14500,0,14500,73017,0,87517
140940101500000,NE 131,RESIDENTIAL,14500,0,14500,87755,0,102255
140940101600000,NE 131,RESIDENTIAL,17400,0,17400,117490,0,134890
140940101700000,NE 131,RESIDENTIAL,17400,0,17400,51808,0,69208
140940101800000,NE 131,RESIDENTIAL,14500,0,14500,48396,0,62896
140940101900000,NE 131,RESIDENTIAL,14500,0,14500,78930,0,93430
140940102000000,NE 131,RESIDENTIAL,14500,0,14500,77442,0,91942
140940102100000,NE 131,RESIDENTIAL,12125,0,12125,34471,0,46596
140940102200000,NE 131,RESIDENTIAL,16875,0,16875,108239,0,125114
140940102300000,NE 131,RESIDENTIAL,19597,0,19597,47372,0,66969
140940200100000,NE 131,RESIDENTIAL,9326,0,9326,38437,0,47763
140940200200000,NE 131,RESIDENTIAL,14375,0,14375,62955,0,77330
140940200300000,NE 131,RESIDENTIAL,14375,0,14375,91876,0,106251
140940200400000,NE 131,RESIDENTIAL,14375,0,14375,38797,0,53172
140940200500000,NE 131,RESIDENTIAL,14375,0,14375,56369,0,70744
140940200600000,NE 131,RESIDENTIAL,14375,0,14375,55306,0,69681
140940200700000,NE 131,RESIDENTIAL,14375,0,14375,93002,0,107377
140940200800000,NE 131,RESIDENTIAL,14375,0,14375,64383,0,78758
140940200900000,NE 131,RESIDENTIAL,14375,0,14375,33965,0,48340
140940201000000,NE 131,RESIDENTIAL,14375,0,14375,55047,0,69422
140940201100000,NE 131,RESIDENTIAL,14375,0,14375,29102,0,43477
140940201200000,NE 131,RESIDENTIAL,18687,0,18687,92199,0,110886
140940201300000,NE 131,RESIDENTIAL,18687,0,18687,100591,0,119278
140940201400000,NE 131,RESIDENTIAL,14375,0,14375,99958,0,114333
140940201500000,NE 131,RESIDENTIAL,14375,0,14375,113502,0,127877
140940201600000,NE 131,RESIDENTIAL,14375,0,14375,69273,0,83648
140940201700000,NE 131,RESIDENTIAL,14375,0,14375,64308,0,78683
140940201800000,NE 131,RESIDENTIAL,18550,0,18550,118697,0,137247
140940201900000,NE 131,RESIDENTIAL,15400,0,15400,90957,0,106357
140940300100000,NE 131,RESIDENTIAL,18000,0,18000,76296,0,94296
140940300200000,NE 131,RESIDENTIAL,16359,0,16359,112116,0,128475
140940300300000,NE 131,RESIDENTIAL,16359,0,16359,95749,0,112108
140940300400000,NE 131,RESIDENTIAL,17280,0,17280,99826,0,117106
140940300500000,NE 131,RESIDENTIAL,26937,0,26937,122813,0,149750
140940300600000,NE 131,RESIDENTIAL,14250,0,14250,52460,0,66710
140940300700000,NE 131,RESIDENTIAL,14125,0,14125,99738,0,113863
140940300800000,NE 131,RESIDENTIAL,21187,0,21187,56666,0,77853
140940300900000,NE 131,RESIDENTIAL,16809,0,16809,51117,0,67926
140940301000000,NE 131,RESIDENTIAL,17920,0,17920,96815,0,114735
140940301200000,NE 131,RESIDENTIAL,14000,0,14000,0,0,14000
140940301300000,FLAT PARKING,COMMERCIAL,0,67920,67920,0,6405,74325
140940301400000,NE 131,RESIDENTIAL,14125,0,14125,0,0,14125
140940301500000,NE 131,RESIDENTIAL,16830,0,16830,96059,0,112889
140940301600000,NE 131,RESIDENTIAL,16500,0,16500,121651,0,138151
140940301700000,NE 131,RESIDENTIAL,16500,0,16500,99456,0,115956
140940302000000,NE 131,RESIDENTIAL,21562,0,21562,78412,0,99974
140940302100000,NE 131,RESIDENTIAL,14375,0,14375,131954,0,146329
140940302200000,NE 131,RESIDENTIAL,14375,0,14375,95108,0,109483
140940302300000,NE 131,RESIDENTIAL,14375,0,14375,72140,0,86515
140940302400000,NE 131,RESIDENTIAL,18687,0,18687,97309,0,115996
140940302500000,NE 131,RESIDENTIAL,14375,0,14375,49202,0,63577
140940302600000,NE 131,RESIDENTIAL,14375,0,14375,92859,0,107234
140940302700000,NE 131,RESIDENTIAL,14375,0,14375,31590,0,45965
140940302800000,NE 131,RESIDENTIAL,18687,0,18687,74776,0,93463
140940302900000,NE 131,RESIDENTIAL,18687,0,18687,91976,0,110663
140940303000000,NE 131,RESIDENTIAL,18687,0,18687,67156,0,85843
140940303100000,NE 131,RESIDENTIAL,18687,0,18687,68964,0,87651
140940303200000,NE 131,RESIDENTIAL,16129,0,16129,41884,0,58013
140940400200000,NE 131,RESIDENTIAL,12650,0,12650,52790,0,65440
140940400300000,NE 131,RESIDENTIAL,16100,0,16100,73398,0,89498
140940400400000,NE 131,RESIDENTIAL,17812,0,17812,57188,0,75000
140940400500000,NE 131,RESIDENTIAL,16625,0,16625,116075,0,132700
140940400600000,NE 131,RESIDENTIAL,16650,0,16650,0,0,16650
140940400700000,NE 131,RESIDENTIAL,16650,0,16650,73965,0,90615
140940400800000,NE 131,RESIDENTIAL,13200,0,13200,76095,0,89295
140940400900000,NE 131,RESIDENTIAL,14375,0,14375,62532,0,76907
140940401000000,NE 131,RESIDENTIAL,11875,0,11875,74219,0,86094
140940401100000,NE 131,RESIDENTIAL,14000,0,14000,73041,0,87041
140940401200000,NE 131,RESIDENTIAL,14000,0,14000,74945,0,88945
140940401400000,OFFICE; MEDICAL,COMMERCIAL,0,192000,192000,0,487089,679089
140940402000000,GROCERY STORE,COMMERCIAL,0,1083460,1083460,0,4790940,5874400
140942600100000,FLAT PARKING,COMMERCIAL,0,109768,109768,0,10840,120608
140942600200000,OFFICE,COMMERCIAL,0,116110,116110,0,279372,395482
140942600300000,NE 132,RESIDENTIAL,18600,0,18600,115005,0,133605
140942600400000,NE 131,RESIDENTIAL,16815,0,16815,93149,0,109964
140942600500000,NE 132,RESIDENTIAL,17325,0,17325,73517,0,90842
140942600600000,RESTAURANT,COMMERCIAL,0,114528,114528,0,98042,212570
140942600700000,SMALL RETAIL,COMMERCIAL,0,17402,17402,0,45769,63171
140942600800000,LG DISCOUNT/RETAIL,COMMERCIAL,0,487500,487500,0,627697,1115197
140942600900000,OFFICE,COMMERCIAL,0,25622,25622,0,87788,113410
140942601000000,AUTO REPAIR/SALES,COMMERCIAL,0,168750,168750,0,143709,312459
140942601100000,LAUNDROMAT/CLEANERS,COMMERCIAL,0,97440,97440,0,201295,298735
140942601200000,OFFICE,COMMERCIAL,0,191040,191040,0,427083,618123
140942700100000,NE 132,RESIDENTIAL,16537,0,16537,101678,0,118215
140942700200000,NE 132,RESIDENTIAL,16950,0,16950,64814,0,81764
140942700300000,NE 132,RESIDENTIAL,18058,0,18058,62439,0,80497
140942700400000,NE 132,RESIDENTIAL,13000,0,13000,44830,0,57830
140942700500000,NE 132,RESIDENTIAL,12750,0,12750,0,0,12750
140942700600000,OFFICE; MEDICAL,COMMERCIAL,0,99603,99603,0,153717,253320
140942800100000,WAREHOUSE,COMMERCIAL,0,212970,212970,0,422644,635614
140942900100000,AUTO REPAIR/SALES,COMMERCIAL,0,77040,77040,0,35954,112994
140942900200000,RESTAURANT,COMMERCIAL,0,136214,136214,0,237671,373885
140942900300000,RESTAURANT,COMMERCIAL,0,138425,138425,0,117490,255915
140942900400000,AUTO REPAIR/SALES,COMMERCIAL,0,240000,240000,0,149918,389918
140943000100000,VACANT LAND,COMMERCIAL,0,8257,8257,0,0,8257
140945100100000,OFFICE,COMMERCIAL,0,128542,128542,0,471881,600423
140945100200000,OFFICE,COMMERCIAL,0,86367,86367,0,356129,442496
140945100300000,OFFICE; MEDICAL,COMMERCIAL,0,78888,78888,0,107658,186546
140945100401000,OFFICE; MEDICAL,COMMERCIAL,0,74052,74052,0,290439,364491
140945100401001,OFFICE,COMMERCIAL,0,74052,74052,0,366010,440062
140945100500000,NE 146,RESIDENTIAL,16928,0,16928,36118,0,53046
140945100600000,NE 146,RESIDENTIAL,22448,0,22448,24653,0,47101
140945100700000,SMALL RETAIL,COMMERCIAL,0,196200,196200,0,362197,558397
140945100800000,DAY CARE CENTER,COMMERCIAL,0,205700,205700,0,239591,445291
140945100900000,NE 146,RESIDENTIAL,19775,0,19775,57749,0,77524
140945101000000,NE 146,RESIDENTIAL,16120,0,16120,45166,0,61286
140945101100000,NE 146,RESIDENTIAL,27363,0,27363,67055,0,94418
140945101200000,NE 146,RESIDENTIAL,19988,0,19988,71397,0,91385
140945101400000,CENTRALLY ASSESSED,OTHER,0,0,0,0,0,0
140945200100000,CITY PROPERTY,EXEMPT,0,0,0,0,0,0
140945200200000,NE 146,RESIDENTIAL,8779,0,8779,0,0,8779
140945200300000,NE 147,RESIDENTIAL,10632,0,10632,92865,0,103497
140945200400000,NE 147,RESIDENTIAL,15250,0,15250,89283,0,104533
140945200500000,NE 147,RESIDENTIAL,15250,0,15250,91867,0,107117
140945200600000,NE 147,RESIDENTIAL,15250,0,15250,79990,0,95240
140945200700000,NE 147,RESIDENTIAL,15250,0,15250,83595,0,98845
140945200800000,NE 147,RESIDENTIAL,15250,0,15250,97479,0,112729
140945200900000,NE 147,RESIDENTIAL,15000,0,15000,109174,0,124174
140945201100000,NE 147,RESIDENTIAL,25200,0,25200,83048,0,108248
140947600100000,OFFICE,COMMERCIAL,0,415200,415200,0,610753,1025953
140947700200000,SMALL RETAIL,COMMERCIAL,0,377060,377060,0,637670,1014730
140947700500000,NE 146,RESIDENTIAL,10688,0,10688,28942,0,39630
140947700600000,NE 146,RESIDENTIAL,9500,0,9500,61006,0,70506
140947700700000,NE 146,RESIDENTIAL,10450,0,10450,0,0,10450
140947700800000,NE 146,RESIDENTIAL,13063,0,13063,17498,0,30561
140947700900000,OFFICE; MEDICAL,COMMERCIAL,0,272000,272000,0,1385509,1657509
140947701100000,NE 146,RESIDENTIAL,15750,0,15750,27848,0,43598
140947701200000,NE 146,RESIDENTIAL,15625,0,15625,0,0,15625
140947701300000,NE 146,RESIDENTIAL,38579,0,38579,126467,0,165046
140947701400000,NE 146,RESIDENTIAL,25286,0,25286,153929,0,179215
140947701500000,NE 146,RESIDENTIAL,18039,0,18039,85515,0,103554
140947701600000,NE 146,RESIDENTIAL,17955,0,17955,69851,0,87806
140947701700000,NE 146,RESIDENTIAL,17955,0,17955,73682,0,91637
140947701800000,NE 146,RESIDENTIAL,17955,0,17955,77480,0,95435
140947701900000,NE 146,RESIDENTIAL,17955,0,17955,80443,0,98398
140947702000000,NE 146,RESIDENTIAL,17955,0,17955,81324,0,99279
140947702100000,NE 146,RESIDENTIAL,10912,0,10912,69874,0,80786
140947702200000,APARTMENT,COMMERCIAL,0,21844,21844,0,142954,164798
140947702300000,NE 146,RESIDENTIAL,13426,0,13426,99306,0,112732
140947702400000,NE 146,RESIDENTIAL,12375,0,12375,69099,0,81474
140947702500000,NE 146,RESIDENTIAL,12625,0,12625,69767,0,82392
140947702600000,NE 146,RESIDENTIAL,14794,0,14794,66300,0,81094
140947702700000,NE 146,RESIDENTIAL,21187,0,21187,57367,0,78554
140947702800000,NE 146,RESIDENTIAL,17500,0,17500,92058,0,109558
140947702900000,NE 146,RESIDENTIAL,12875,0,12875,72213,0,85088
140947703000000,NE 146,RESIDENTIAL,12750,0,12750,59748,0,72498
140947703100000,NE 146,RESIDENTIAL,12750,0,12750,6251,0,19001
140947703200000,NE 146,RESIDENTIAL,20825,0,20825,102784,0,123609
140947703300000,NE 146,RESIDENTIAL,18000,0,18000,71133,0,89133
140947703400000,NE 146,RESIDENTIAL,21175,0,21175,68113,0,89288
140947800200000,NE 146,RESIDENTIAL,13388,0,13388,56761,0,70149
140947800300000,NE 146,RESIDENTIAL,13655,0,13655,68335,0,81990
140947800400000,NE 146,RESIDENTIAL,11875,0,11875,42996,0,54871
140947800500000,NE 146,RESIDENTIAL,11875,0,11875,58499,0,70374
140947800600000,NE 146,RESIDENTIAL,11875,0,11875,32876,0,44751
140947800700000,CONVENIENCE STORE,COMMERCIAL,0,369700,369700,0,656100,1025800
140947801300000,NE 146,RESIDENTIAL,17010,0,17010,0,0,17010
140947801500000,NE 146,RESIDENTIAL,18900,0,18900,63104,0,82004
140947801600000,NE 146,RESIDENTIAL,22437,0,22437,5035,0,27472
140947801700000,NE 146,RESIDENTIAL,22035,0,22035,53444,0,75479
140947801800000,NE 146,RESIDENTIAL,22035,0,22035,49518,0,71553
140947801900000,NE 146,RESIDENTIAL,20638,0,20638,122101,0,142739
140947802000000,NE 146,RESIDENTIAL,20638,0,20638,64974,0,85612
140947802100000,NE 146,RESIDENTIAL,22225,0,22225,86776,0,109001
140947802200000,NE 146,RESIDENTIAL,25400,0,25400,57727,0,83127
140947802300000,NE 146,RESIDENTIAL,16828,0,16828,54034,0,70862
140947802400000,NE 146,RESIDENTIAL,14335,0,14335,0,0,14335
140947802500000,CONVENIENCE STORE,COMMERCIAL,0,135233,135233,0,207766,342999
140947802600000,NE 146,RESIDENTIAL,19089,0,19089,62690,0,81779
140947802700000,NE 146,RESIDENTIAL,15907,0,15907,51460,0,67367
140947802800000,NE 146,RESIDENTIAL,25452,0,25452,72783,0,98235
140947802900000,NE 146,RESIDENTIAL,22270,0,22270,51177,0,73447
140947803000000,NE 146,RESIDENTIAL,16519,0,16519,70009,0,86528
140947803100000,NE 146,RESIDENTIAL,18554,0,18554,94633,0,113187
140947803200000,NE 146,RESIDENTIAL,18753,0,18753,74847,0,93600
140947803300000,NE 146,RESIDENTIAL,21121,0,21121,126569,0,147690
140947803400000,NE 146,RESIDENTIAL,18953,0,18953,78406,0,97359
140947803500000,NE 146,RESIDENTIAL,19286,0,19286,78264,0,97550
140947803600000,NE 146,RESIDENTIAL,19691,0,19691,90445,0,110136
140947803700000,NE 146,RESIDENTIAL,23765,0,23765,90690,0,114455
140947803800000,NE 146,RESIDENTIAL,24723,0,24723,93749,0,118472
140947900200000,NE 143,RESIDENTIAL,21152,0,21152,60542,0,81694
140947900300000,NE 143,RESIDENTIAL,21420,0,21420,62716,0,84136
140947900400000,NE 143,RESIDENTIAL,19264,0,19264,66759,0,86023
140947900500000,NE 143,RESIDENTIAL,20954,0,20954,88404,0,109358
140947900600000,NE 143,RESIDENTIAL,17280,0,17280,78992,0,96272
140947900700000,NE 143,RESIDENTIAL,15595,0,15595,68404,0,83999
140947900800000,NE 143,RESIDENTIAL,20400,0,20400,40087,0,60487
140947900900000,NE 143,RESIDENTIAL,24240,0,24240,68077,0,92317
140948000100000,NE 143,RESIDENTIAL,25926,0,25926,76485,0,102411
140948000200000,NE 143,RESIDENTIAL,24948,0,24948,106126,0,131074
140948000300000,NE 143,RESIDENTIAL,24998,0,24998,79614,0,104612
140948000400000,NE 143,RESIDENTIAL,34335,0,34335,61029,0,95364
140948000500000,NE 143,RESIDENTIAL,37346,0,37346,109626,0,146972
140948000600000,NE 143,RESIDENTIAL,28665,0,28665,99939,0,128604
140948000700000,NE 143,RESIDENTIAL,19159,0,19159,78698,0,97857
140948000800000,NE 143,RESIDENTIAL,21000,0,21000,75027,0,96027
140948000900000,NE 143,RESIDENTIAL,34801,0,34801,76677,0,111478
140948001000000,NE 143,RESIDENTIAL,13702,0,13702,60430,0,74132
140948001100000,NE 143,RESIDENTIAL,18720,0,18720,81965,0,100685
140948001200000,CHURCH,EXEMPT,0,16034,16034,0,7080,23114
140948001300000,NE 143,RESIDENTIAL,29998,0,29998,132099,0,162097
140948001400000,NE 143,RESIDENTIAL,20400,0,20400,95117,0,115517
140948001500000,NE 143,RESIDENTIAL,18768,0,18768,85226,0,103994
140948001600000,NE 143,RESIDENTIAL,26112,0,26112,99564,0,125676
140948001700000,NE 143,RESIDENTIAL,27669,0,27669,76913,0,104582
140948001800000,NE 143,RESIDENTIAL,28560,0,28560,88939,0,117499
140948001900000,NE 143,RESIDENTIAL,29451,0,29451,123694,0,153145
141010100100000,NE 130,RESIDENTIAL,19672,0,19672,87308,0,106980
141010100200000,NE 130,RESIDENTIAL,20176,0,20176,94825,0,115001
141010100300000,NE 130,RESIDENTIAL,18042,0,18042,62326,0,80368
141010100400000,NE 130,RESIDENTIAL,17460,0,17460,79564,0,97024
141010100500000,NE 130,RESIDENTIAL,15520,0,15520,95895,0,111415
141010100600000,NE 130,RESIDENTIAL,15520,0,15520,83572,0,99092
141010100700000,NE 130,RESIDENTIAL,15520,0,15520,103857,0,119377
141010100800000,NE 130,RESIDENTIAL,15520,0,15520,69408,0,84928
141010100900000,NE 130,RESIDENTIAL,15520,0,15520,77053,0,92573
141010101000000,NE 130,RESIDENTIAL,15520,0,15520,79327,0,94847
141010101100000,NE 130,RESIDENTIAL,15520,0,15520,82376,0,97896
141010101200000,NE 130,RESIDENTIAL,16587,0,16587,81168,0,97755
141010200100000,NE 130,RESIDENTIAL,17460,0,17460,69236,0,86696
141010200200000,NE 130,RESIDENTIAL,18915,0,18915,101489,0,120404
141010200300000,NE 130,RESIDENTIAL,15520,0,15520,72534,0,88054
141010200400000,NE 130,RESIDENTIAL,15520,0,15520,77451,0,92971
141010200500000,NE 130,RESIDENTIAL,15520,0,15520,81708,0,97228
141010200600000,NE 130,RESIDENTIAL,15520,0,15520,77254,0,92774
141010300100000,NE 130,RESIDENTIAL,17314,0,17314,94551,0,111865
141010300200000,NE 130,RESIDENTIAL,17314,0,17314,75734,0,93048
141010300300000,NE 130,RESIDENTIAL,17460,0,17460,97574,0,115034
141010300400000,NE 130,RESIDENTIAL,17460,0,17460,74153,0,91613
141010300500000,NE 130,RESIDENTIAL,17460,0,17460,65618,0,83078
141010400100000,NE 130,RESIDENTIAL,19012,0,19012,105972,0,124984
141010400200000,NE 130,RESIDENTIAL,17460,0,17460,70714,0,88174
141010400300000,NE 130,RESIDENTIAL,17460,0,17460,90435,0,107895
141010400400000,NE 130,RESIDENTIAL,15520,0,15520,106553,0,122073
141010400500000,NE 130,RESIDENTIAL,15520,0,15520,99325,0,114845
141010400600000,NE 130,RESIDENTIAL,17460,0,17460,73427,0,90887
141010400700000,NE 130,RESIDENTIAL,15520,0,15520,78629,0,94149
141010400800000,NE 130,RESIDENTIAL,15520,0,15520,77929,0,93449
141010400900000,NE 130,RESIDENTIAL,15520,0,15520,62501,0,78021
141010401000000,NE 130,RESIDENTIAL,15520,0,15520,98061,0,113581
141010401100000,NE 130,RESIDENTIAL,15520,0,15520,66062,0,81582
141010401200000,NE 130,RESIDENTIAL,15520,0,15520,75077,0,90597
141010401300000,NE 130,RESIDENTIAL,16587,0,16587,69112,0,85699
141010401400000,NE 130,RESIDENTIAL,19529,0,19529,65245,0,84774
141010401500000,NE 130,RESIDENTIAL,19529,0,19529,46503,0,66032
141010401600000,NE 130,RESIDENTIAL,19400,0,19400,55253,0,74653
141010401700000,NE 130,RESIDENTIAL,19788,0,19788,60809,0,80597
141010401800000,NE 130,RESIDENTIAL,19788,0,19788,62766,0,82554
141010401900000,NE 130,RESIDENTIAL,19400,0,19400,88617,0,108017
141010402000000,NE 130,RESIDENTIAL,19788,0,19788,78104,0,97892
141010402100000,NE 130,RESIDENTIAL,19400,0,19400,51916,0,71316
141010402200000,NE 130,RESIDENTIAL,19693,0,19693,96906,0,116599
141010402300000,NE 130,RESIDENTIAL,19200,0,19200,78171,0,97371
141010402400000,NE 130,RESIDENTIAL,16128,0,16128,55791,0,71919
141010402500000,NE 130,RESIDENTIAL,22912,0,22912,84590,0,107502
141010500100000,NE 130,RESIDENTIAL,16587,0,16587,92081,0,108668
141010500200000,NE 130,RESIDENTIAL,15520,0,15520,103224,0,118744
141010500300000,NE 130,RESIDENTIAL,15520,0,15520,83859,0,99379
141010500400000,NE 130,RESIDENTIAL,15520,0,15520,87314,0,102834
141010500500000,NE 130,RESIDENTIAL,15520,0,15520,98139,0,113659
141010500600000,NE 130,RESIDENTIAL,17280,0,17280,68052,0,85332
141010500700000,NE 130,RESIDENTIAL,17280,0,17280,62366,0,79646
141010500800000,NE 130,RESIDENTIAL,15520,0,15520,106344,0,121864
141010500900000,NE 130,RESIDENTIAL,15520,0,15520,84684,0,100204
141010501000000,NE 130,RESIDENTIAL,15520,0,15520,103887,0,119407
141010501100000,NE 130,RESIDENTIAL,15520,0,15520,88980,0,104500
141010501200000,NE 130,RESIDENTIAL,15520,0,15520,93612,0,109132
141010501300000,NE 130,RESIDENTIAL,15520,0,15520,71967,0,87487
141010501400000,NE 130,RESIDENTIAL,17460,0,17460,81509,0,98969
141010600100000,NE 130,RESIDENTIAL,20176,0,20176,82080,0,102256
141010600200000,NE 130,RESIDENTIAL,18914,0,18914,87585,0,106499
141010600300000,NE 130,RESIDENTIAL,18508,0,18508,75452,0,93960
141010600400000,NE 130,RESIDENTIAL,19186,0,19186,65069,0,84255
141010600500000,NE 130,RESIDENTIAL,21622,0,21622,109023,0,130645
141010600600000,NE 130,RESIDENTIAL,25245,0,25245,76272,0,101517
141010600700000,NE 130,RESIDENTIAL,23280,0,23280,58786,0,82066
141010600800000,NE 130,RESIDENTIAL,23280,0,23280,33075,0,56355
141010600900000,NE 130,RESIDENTIAL,23280,0,23280,88079,0,111359
141010601000000,NE 130,RESIDENTIAL,17460,0,17460,61316,0,78776
141010700100000,NE 130,RESIDENTIAL,21560,0,21560,131636,0,153196
141010700200000,NE 130,RESIDENTIAL,23100,0,23100,106796,0,129896
141010700300000,NE 130,RESIDENTIAL,23842,0,23842,66901,0,90743
141010700400000,NE 130,RESIDENTIAL,23940,0,23940,83467,0,107407
141010700500000,NE 130,RESIDENTIAL,22680,0,22680,80529,0,103209
141010700600000,NE 130,RESIDENTIAL,22680,0,22680,67383,0,90063
141010700700000,NE 130,RESIDENTIAL,23940,0,23940,94880,0,118820
141010700800000,NE 130,RESIDENTIAL,22680,0,22680,55494,0,78174
141010700900000,NE 130,RESIDENTIAL,22680,0,22680,58380,0,81060
141010701000000,NE 130,RESIDENTIAL,23712,0,23712,59659,0,83371
141010701100000,NE 130,RESIDENTIAL,23650,0,23650,75836,0,99486
141010701200000,NE 130,RESIDENTIAL,16038,0,16038,79417,0,95455
141010701300000,NE 130,RESIDENTIAL,15840,0,15840,78873,0,94713
141010701400000,NE 130,RESIDENTIAL,15840,0,15840,56034,0,71874
141010701500000,NE 130,RESIDENTIAL,15840,0,15840,91543,0,107383
141010701600000,NE 130,RESIDENTIAL,15840,0,15840,51799,0,67639
141010701700000,NE 130,RESIDENTIAL,15840,0,15840,38966,0,54806
141010701800000,NE 130,RESIDENTIAL,15840,0,15840,75885,0,91725
141010701900000,NE 130,RESIDENTIAL,16830,0,16830,98266,0,115096
141010702000000,NE 130,RESIDENTIAL,15840,0,15840,66798,0,82638
141010702100000,NE 130,RESIDENTIAL,15840,0,15840,43813,0,59653
141010702200000,NE 130,RESIDENTIAL,15840,0,15840,77123,0,92963
141010702300000,NE 130,RESIDENTIAL,15840,0,15840,89824,0,105664
141010702400000,NE 130,RESIDENTIAL,19008,0,19008,99054,0,118062
141010702500000,NE 130,RESIDENTIAL,16038,0,16038,64685,0,80723
141010800100000,NE 130,RESIDENTIAL,24752,0,24752,60321,0,85073
141010800200000,NE 130,RESIDENTIAL,19660,0,19660,83598,0,103258
141010800300000,NE 130,RESIDENTIAL,18540,0,18540,96547,0,115087
141010800400000,NE 130,RESIDENTIAL,18540,0,18540,93192,0,111732
141010800500000,NE 130,RESIDENTIAL,18540,0,18540,105354,0,123894
141010800600000,NE 130,RESIDENTIAL,16160,0,16160,63501,0,79661
141010800700000,NE 130,RESIDENTIAL,16160,0,16160,61085,0,77245
141010800800000,NE 130,RESIDENTIAL,16160,0,16160,65304,0,81464
141010800900000,NE 130,RESIDENTIAL,16160,0,16160,66220,0,82380
141010801000000,NE 130,RESIDENTIAL,20400,0,20400,101336,0,121736
141010801100000,NE 130,RESIDENTIAL,20944,0,20944,97682,0,118626
141010801200000,NE 130,RESIDENTIAL,22624,0,22624,73690,0,96314
141010801300000,NE 130,RESIDENTIAL,17544,0,17544,90092,0,107636
141010900100000,NE 130,RESIDENTIAL,20365,0,20365,94926,0,115291
141010900200000,NE 130,RESIDENTIAL,18540,0,18540,50023,0,68563
141010900300000,NE 130,RESIDENTIAL,18180,0,18180,64671,0,82851
141010900400000,NE 130,RESIDENTIAL,18180,0,18180,53352,0,71532
141010900500000,NE 130,RESIDENTIAL,18180,0,18180,63873,0,82053
141010900600000,NE 130,RESIDENTIAL,4400,0,4400,0,0,4400
141010900700000,NE 130,RESIDENTIAL,17460,0,17460,55791,0,73251
141010900800000,NE 130,RESIDENTIAL,18236,0,18236,52808,0,71044
141010900900000,NE 130,RESIDENTIAL,16684,0,16684,68208,0,84892
141010901000000,NE 130,RESIDENTIAL,16160,0,16160,112038,0,128198
141010901100000,NE 130,RESIDENTIAL,16160,0,16160,83951,0,100111
141010901200000,NE 130,RESIDENTIAL,16160,0,16160,74456,0,90616
141010901300000,NE 130,RESIDENTIAL,16160,0,16160,100436,0,116596
141010901400000,NE 130,RESIDENTIAL,19539,0,19539,66601,0,86140
141011000100000,NE 130,RESIDENTIAL,25856,0,25856,74828,0,100684
141011000200000,NE 130,RESIDENTIAL,23280,0,23280,81491,0,104771
141011000300000,NE 130,RESIDENTIAL,24735,0,24735,79088,0,103823
141011000400000,NE 130,RESIDENTIAL,16160,0,16160,65605,0,81765
141011000500000,NE 130,RESIDENTIAL,16160,0,16160,92077,0,108237
141011000600000,NE 130,RESIDENTIAL,16160,0,16160,72765,0,88925
141011000700000,NE 130,RESIDENTIAL,16160,0,16160,93768,0,109928
141011000800000,NE 130,RESIDENTIAL,16160,0,16160,114615,0,130775
141011000900000,NE 130,RESIDENTIAL,24444,0,24444,71906,0,96350
141011001000000,NE 130,RESIDENTIAL,25142,0,25142,66069,0,91211
141011001100000,NE 130,RESIDENTIAL,16160,0,16160,99545,0,115705
141011001200000,NE 130,RESIDENTIAL,16160,0,16160,68714,0,84874
141011001300000,NE 130,RESIDENTIAL,25856,0,25856,104362,0,130218
141011001400000,NE 130,RESIDENTIAL,24240,0,24240,75480,0,99720
141011001500000,NE 130,RESIDENTIAL,24240,0,24240,86637,0,110877
141011001600000,NE 130,RESIDENTIAL,25856,0,25856,54503,0,80359
141011100100000,NE 130,RESIDENTIAL,24570,0,24570,71506,0,96076
141011100200000,NE 130,RESIDENTIAL,24570,0,24570,75747,0,100317
141011100300000,NE 130,RESIDENTIAL,22624,0,22624,82287,0,104911
141011100400000,NE 130,RESIDENTIAL,28280,0,28280,65263,0,93543
141011100500000,NE 130,RESIDENTIAL,28280,0,28280,75137,0,103417
141011100700000,NE 130,RESIDENTIAL,16160,0,16160,53028,0,69188
141011100800000,NE 130,RESIDENTIAL,16160,0,16160,60639,0,76799
141011100900000,NE 130,RESIDENTIAL,16160,0,16160,68082,0,84242
141011101000000,NE 130,RESIDENTIAL,16160,0,16160,75885,0,92045
141011101100000,NE 130,RESIDENTIAL,25856,0,25856,73024,0,98880
141011101200000,NE 130,RESIDENTIAL,16160,0,16160,63972,0,80132
141011101300000,NE 130,RESIDENTIAL,24240,0,24240,94802,0,119042
141011101400000,NE 130,RESIDENTIAL,24240,0,24240,99209,0,123449
141011101500000,NE 130,RESIDENTIAL,16160,0,16160,51484,0,67644
141011101600000,NE 130,RESIDENTIAL,24240,0,24240,80927,0,105167
141011200100000,NE 130,RESIDENTIAL,16160,0,16160,91748,0,107908
141011200200000,NE 130,RESIDENTIAL,21600,0,21600,77207,0,98807
141011200300000,NE 130,RESIDENTIAL,21600,0,21600,85941,0,107541
141011200400000,NE 130,RESIDENTIAL,16160,0,16160,78198,0,94358
141011200500000,NE 130,RESIDENTIAL,16160,0,16160,43485,0,59645
141011200600000,NE 130,RESIDENTIAL,21816,0,21816,60977,0,82793
141011200700000,NE 130,RESIDENTIAL,18584,0,18584,55464,0,74048
141011200800000,NE 130,RESIDENTIAL,21816,0,21816,63515,0,85331
141011200900000,NE 130,RESIDENTIAL,18584,0,18584,53003,0,71587
141011201000000,NE 130,RESIDENTIAL,21600,0,21600,59317,0,80917
141011201100000,NE 130,RESIDENTIAL,21600,0,21600,64411,0,86011
141011201200000,NE 130,RESIDENTIAL,16160,0,16160,57422,0,73582
141011201300000,NE 130,RESIDENTIAL,16160,0,16160,99756,0,115916
141011201400000,NE 130,RESIDENTIAL,24240,0,24240,63286,0,87526
141011201500000,NE 130,RESIDENTIAL,24240,0,24240,91397,0,115637
141011201600000,NE 130,RESIDENTIAL,25856,0,25856,84357,0,110213
141011201900000,NE 130,RESIDENTIAL,33936,0,33936,88489,0,122425
141011300100000,NE 130,RESIDENTIAL,25856,0,25856,80858,0,106714
141011300200000,NE 130,RESIDENTIAL,25025,0,25025,80969,0,105994
141011300300000,NE 130,RESIDENTIAL,24127,0,24127,83654,0,107781
141011300400000,NE 130,RESIDENTIAL,24240,0,24240,97021,0,121261
141011300500000,NE 130,RESIDENTIAL,24240,0,24240,94953,0,119193
141011300600000,NE 130,RESIDENTIAL,24240,0,24240,106116,0,130356
141011300700000,NE 130,RESIDENTIAL,22220,0,22220,84313,0,106533
141011300900000,NE 130,RESIDENTIAL,25780,0,25780,84706,0,110486
141011301000000,NE 130,RESIDENTIAL,21576,0,21576,88237,0,109813
141011301100000,NE 130,RESIDENTIAL,25856,0,25856,84817,0,110673
141011301200000,NE 130,RESIDENTIAL,25856,0,25856,118102,0,143958
141011301300000,NE 130,RESIDENTIAL,21816,0,21816,59618,0,81434
141011301400000,NE 130,RESIDENTIAL,18584,0,18584,82049,0,100633
141011301500000,NE 130,RESIDENTIAL,21816,0,21816,66461,0,88277
141011301600000,NE 130,RESIDENTIAL,18584,0,18584,48019,0,66603
141012600100000,GOLF COURSE,COMMERCIAL,0,200000,200000,0,413301,613301
141015100100000,NE 131,RESIDENTIAL,16180,0,16180,42720,0,58900
141015100200000,NE 131,RESIDENTIAL,16282,0,16282,39129,0,55411
141015100300000,NE 131,RESIDENTIAL,15423,0,15423,61472,0,76895
141015100400000,NE 131,RESIDENTIAL,15714,0,15714,47460,0,63174
141015100500000,NE 131,RESIDENTIAL,14259,0,14259,45637,0,59896
141015100600000,NE 131,RESIDENTIAL,15714,0,15714,51395,0,67109
141015100700000,NE 131,RESIDENTIAL,15423,0,15423,57715,0,73138
141015100800000,NE 131,RESIDENTIAL,15714,0,15714,66995,0,82709
141015100900000,NE 131,RESIDENTIAL,14259,0,14259,63135,0,77394
141015101000000,NE 131,RESIDENTIAL,15714,0,15714,65262,0,80976
141015101100000,NE 131,RESIDENTIAL,15423,0,15423,56116,0,71539
141015101200000,NE 131,RESIDENTIAL,16587,0,16587,71980,0,88567
141015101300000,NE 131,RESIDENTIAL,17784,0,17784,70383,0,88167
141015101400000,NE 131,RESIDENTIAL,16377,0,16377,59331,0,75708
141015101500000,NE 131,RESIDENTIAL,16524,0,16524,59474,0,75998
141015101600000,NE 131,RESIDENTIAL,14994,0,14994,57254,0,72248
141015101700000,NE 131,RESIDENTIAL,16362,0,16362,53256,0,69618
141015101800000,NE 131,RESIDENTIAL,15900,0,15900,81707,0,97607
141015101900000,NE 131,RESIDENTIAL,16038,0,16038,68411,0,84449
141015102000000,NE 131,RESIDENTIAL,14553,0,14553,54649,0,69202
141015102100000,NE 131,RESIDENTIAL,15876,0,15876,62028,0,77904
141015102200000,NE 131,RESIDENTIAL,15423,0,15423,66000,0,81423
141015200100000,NE 131,RESIDENTIAL,16663,0,16663,63763,0,80426
141015200200000,NE 131,RESIDENTIAL,17700,0,17700,69812,0,87512
141015200300000,NE 131,RESIDENTIAL,18000,0,18000,58808,0,76808
141015200400000,NE 131,RESIDENTIAL,16800,0,16800,54360,0,71160
141015200500000,NE 131,RESIDENTIAL,18000,0,18000,77394,0,95394
141015200600000,NE 131,RESIDENTIAL,16800,0,16800,50224,0,67024
141015200700000,NE 131,RESIDENTIAL,18000,0,18000,93900,0,111900
141015200800000,NE 131,RESIDENTIAL,16800,0,16800,54120,0,70920
141015200900000,NE 131,RESIDENTIAL,18000,0,18000,72281,0,90281
141015201000000,NE 131,RESIDENTIAL,18000,0,18000,78550,0,96550
141015201100000,NE 131,RESIDENTIAL,17373,0,17373,70586,0,87959
141015201200000,NE 131,RESIDENTIAL,17100,0,17100,52930,0,70030
141015201300000,NE 131,RESIDENTIAL,15900,0,15900,55446,0,71346
141015201400000,NE 131,RESIDENTIAL,16200,0,16200,56426,0,72626
141015201500000,NE 131,RESIDENTIAL,14700,0,14700,46374,0,61074
141015201600000,NE 131,RESIDENTIAL,16200,0,16200,42714,0,58914
141015201700000,NE 131,RESIDENTIAL,15900,0,15900,66773,0,82673
141015201800000,NE 131,RESIDENTIAL,16200,0,16200,54447,0,70647
141015201900000,NE 131,RESIDENTIAL,14700,0,14700,53656,0,68356
141015202000000,NE 131,RESIDENTIAL,16200,0,16200,57696,0,73896
141015202100000,NE 131,RESIDENTIAL,15900,0,15900,55888,0,71788
141015300100000,NE 131,RESIDENTIAL,17122,0,17122,66867,0,83989
141015300200000,NE 131,RESIDENTIAL,16116,0,16116,88533,0,104649
141015300300000,NE 131,RESIDENTIAL,16038,0,16038,63898,0,79936
141015300400000,NE 131,RESIDENTIAL,16038,0,16038,64003,0,80041
141015300500000,NE 131,RESIDENTIAL,15444,0,15444,57027,0,72471
141015300600000,NE 131,RESIDENTIAL,15741,0,15741,77171,0,92912
141015300700000,NE 131,RESIDENTIAL,14850,0,14850,55043,0,69893
141015300800000,NE 131,RESIDENTIAL,16038,0,16038,69320,0,85358
141015300900000,NE 131,RESIDENTIAL,15741,0,15741,59978,0,75719
141015301000000,NE 131,RESIDENTIAL,14850,0,14850,42877,0,57727
141015301100000,NE 131,RESIDENTIAL,15741,0,15741,63717,0,79458
141015301200000,NE 131,RESIDENTIAL,16929,0,16929,61678,0,78607
141015301300000,NE 131,RESIDENTIAL,17523,0,17523,61092,0,78615
141015301400000,NE 131,RESIDENTIAL,16632,0,16632,53666,0,70298
141015301500000,NE 131,RESIDENTIAL,17820,0,17820,61828,0,79648
141015301600000,NE 131,RESIDENTIAL,17820,0,17820,61862,0,79682
141015301700000,NE 131,RESIDENTIAL,16632,0,16632,57730,0,74362
141015301800000,NE 131,RESIDENTIAL,17820,0,17820,79118,0,96938
141015301900000,NE 131,RESIDENTIAL,17820,0,17820,86752,0,104572
141015302000000,NE 131,RESIDENTIAL,17820,0,17820,67333,0,85153
141015302100000,NE 131,RESIDENTIAL,16632,0,16632,67014,0,83646
141015400100000,NE 131,RESIDENTIAL,15949,0,15949,62353,0,78302
141015400200000,NE 131,RESIDENTIAL,21869,0,21869,110320,0,132189
141015400300000,NE 131,RESIDENTIAL,22338,0,22338,98458,0,120796
141015400400000,NE 131,RESIDENTIAL,22338,0,22338,113094,0,135432
141015400500000,NE 131,RESIDENTIAL,22119,0,22119,107778,0,129897
141015400600000,NE 131,RESIDENTIAL,21900,0,21900,123986,0,145886
141015400700000,NE 131,RESIDENTIAL,21900,0,21900,99036,0,120936
141015400800000,NE 131,RESIDENTIAL,21681,0,21681,110573,0,132254
141015400900000,NE 131,RESIDENTIAL,22050,0,22050,121093,0,143143
141015401000000,NE 131,RESIDENTIAL,15390,0,15390,58223,0,73613
141015401100000,NE 131,RESIDENTIAL,15105,0,15105,52521,0,67626
141015401200000,NE 131,RESIDENTIAL,15390,0,15390,52520,0,67910
141015401300000,NE 131,RESIDENTIAL,15390,0,15390,70590,0,85980
141015401400000,NE 131,RESIDENTIAL,14250,0,14250,63134,0,77384
141015401500000,NE 131,RESIDENTIAL,15390,0,15390,59566,0,74956
141015401600000,NE 131,RESIDENTIAL,15105,0,15105,79203,0,94308
141015401700000,NE 131,RESIDENTIAL,14250,0,14250,54751,0,69001
141015401800000,NE 131,RESIDENTIAL,15390,0,15390,69486,0,84876
141015401900000,NE 131,EXEMPT,0,14820,14820,0,58696,73516
141015500100000,NE 131,RESIDENTIAL,22750,0,22750,75798,0,98548
141015500200000,NE 131,RESIDENTIAL,22750,0,22750,86784,0,109534
141015500300000,NE 131,RESIDENTIAL,22750,0,22750,117085,0,139835
141015500400000,NE 131,RESIDENTIAL,22750,0,22750,110183,0,132933
141015500500000,NE 131,RESIDENTIAL,22750,0,22750,69998,0,92748
141015500600000,NE 131,RESIDENTIAL,14983,0,14983,56051,0,71034
141015500700000,NE 131,RESIDENTIAL,15243,0,15243,50050,0,65293
141015500800000,NE 131,RESIDENTIAL,15275,0,15275,52428,0,67703
141015500900000,NE 131,RESIDENTIAL,22750,0,22750,48794,0,71544
141015501000000,NE 131,RESIDENTIAL,22750,0,22750,113786,0,136536
141015501100000,NE 131,RESIDENTIAL,22750,0,22750,108267,0,131017
141015501200000,NE 131,RESIDENTIAL,22750,0,22750,58456,0,81206
141015501300000,NE 131,RESIDENTIAL,22750,0,22750,17719,0,40469
141015501400000,NE 131,RESIDENTIAL,22750,0,22750,83100,0,105850
141015501500000,NE 131,RESIDENTIAL,22750,0,22750,68986,0,91736
141015600100000,NE 131,RESIDENTIAL,22750,0,22750,84635,0,107385
141015600200000,NE 131,RESIDENTIAL,22750,0,22750,79988,0,102738
141015600300000,NE 131,RESIDENTIAL,22750,0,22750,69989,0,92739
141015600400000,NE 131,RESIDENTIAL,22750,0,22750,103419,0,126169
141015600500000,NE 131,RESIDENTIAL,22750,0,22750,99020,0,121770
141015600600000,NE 131,RESIDENTIAL,22750,0,22750,67766,0,90516
141015600700000,NE 131,RESIDENTIAL,22750,0,22750,115209,0,137959
141015600800000,NE 131,RESIDENTIAL,21125,0,21125,87617,0,108742
141015600900000,NE 131,RESIDENTIAL,24375,0,24375,103569,0,127944
141015601000000,NE 131,RESIDENTIAL,22750,0,22750,83329,0,106079
141015601100000,NE 131,RESIDENTIAL,22750,0,22750,72448,0,95198
141015601200000,NE 131,RESIDENTIAL,11375,0,11375,43406,0,54781
141015601300000,NE 131,RESIDENTIAL,11375,0,11375,42013,0,53388
141015700100000,NE 131,RESIDENTIAL,15600,0,15600,89726,0,105326
141015700200000,NE 131,RESIDENTIAL,26325,0,26325,104516,0,130841
141015700400000,NE 131,RESIDENTIAL,14625,0,14625,0,0,14625
141015700500000,NE 131,RESIDENTIAL,14625,0,14625,93340,0,107965
141015700600000,NE 131,RESIDENTIAL,25215,0,25215,114979,0,140194
141015700700000,NE 131,RESIDENTIAL,24619,0,24619,121231,0,145850
141015700800000,NE 131,RESIDENTIAL,24700,0,24700,111549,0,136249
141015700900000,NE 131,RESIDENTIAL,24700,0,24700,69858,0,94558
141015701000000,NE 131,RESIDENTIAL,24700,0,24700,71363,0,96063
141015800100000,NE 131,RESIDENTIAL,17063,0,17063,66065,0,83128
141015800200000,NE 131,RESIDENTIAL,17063,0,17063,79565,0,96628
141015800300000,NE 131,RESIDENTIAL,11375,0,11375,35141,0,46516
141015800400000,NE 131,RESIDENTIAL,22750,0,22750,62885,0,85635
141015800500000,NE 131,RESIDENTIAL,22750,0,22750,68845,0,91595
141015800600000,NE 131,RESIDENTIAL,22750,0,22750,71877,0,94627
141015800700000,NE 131,RESIDENTIAL,14625,0,14625,57878,0,72503
141015800800000,NE 131,RESIDENTIAL,16250,0,16250,39474,0,55724
141015800900000,NE 131,RESIDENTIAL,14625,0,14625,52425,0,67050
141015801000000,NE 131,RESIDENTIAL,22750,0,22750,66111,0,88861
141015801100000,NE 131,RESIDENTIAL,22750,0,22750,77492,0,100242
141015801200000,NE 131,RESIDENTIAL,22750,0,22750,66262,0,89012
141015801300000,NE 131,RESIDENTIAL,22750,0,22750,58166,0,80916
141015801400000,NE 131,RESIDENTIAL,22750,0,22750,91252,0,114002
141015801500000,NE 131,RESIDENTIAL,22750,0,22750,89260,0,112010
141015801600000,NE 131,RESIDENTIAL,22750,0,22750,71509,0,94259
141015900100000,NE 131,RESIDENTIAL,22750,0,22750,61107,0,83857
141015900200000,NE 131,RESIDENTIAL,22750,0,22750,85038,0,107788
141015900300000,NE 131,RESIDENTIAL,22750,0,22750,77825,0,100575
141015900400000,NE 131,RESIDENTIAL,23481,0,23481,35019,0,58500
141015900500000,NE 131,RESIDENTIAL,13000,0,13000,48232,0,61232
141015900600000,NE 131,RESIDENTIAL,16250,0,16250,80111,0,96361
141015900700000,NE 131,RESIDENTIAL,11375,0,11375,38318,0,49693
141015900800000,CITY PROPERTY,EXEMPT,0,0,0,0,0,0
141015900900000,NE 131,RESIDENTIAL,14788,0,14788,32178,0,46966
141015901000000,NE 131,RESIDENTIAL,14788,0,14788,43043,0,57831
141015901100000,NE 131,RESIDENTIAL,23660,0,23660,97808,0,121468
141015901200000,NE 131,RESIDENTIAL,24772,0,24772,112385,0,137157
141015901300000,NE 131,RESIDENTIAL,22750,0,22750,104264,0,127014
141015901400000,NE 131,RESIDENTIAL,22750,0,22750,81771,0,104521
141015901500000,NE 131,RESIDENTIAL,22750,0,22750,75923,0,98673
141015901600000,NE 131,RESIDENTIAL,22750,0,22750,56929,0,79679
141015901700000,NE 131,RESIDENTIAL,22750,0,22750,48367,0,71117
141015901800000,NE 131,RESIDENTIAL,22750,0,22750,73238,0,95988
141017600100000,NE 129,RESIDENTIAL,24030,0,24030,74206,0,98236
141017600200000,NE 129,RESIDENTIAL,31500,0,31500,33466,0,64966
141017600300000,NE 129,RESIDENTIAL,32130,0,32130,104879,0,137009
141017600400000,NE 129,RESIDENTIAL,34650,0,34650,90496,0,125146
141017600500000,NE 129,RESIDENTIAL,43092,0,43092,115436,0,158528
141017600600000,NE 129,RESIDENTIAL,40950,0,40950,103685,0,144635
141017600700000,NE 129,RESIDENTIAL,35910,0,35910,70021,0,105931
141017600800000,NE 129,RESIDENTIAL,33390,0,33390,83851,0,117241
141017600900000,NE 129,RESIDENTIAL,31500,0,31500,52068,0,83568
141017601000000,NE 129,RESIDENTIAL,28050,0,28050,86887,0,114937
141017601100000,NE 129,RESIDENTIAL,27600,0,27600,69856,0,97456
141017601200000,NE 129,RESIDENTIAL,23000,0,23000,71719,0,94719
141017601300000,NE 129,RESIDENTIAL,23000,0,23000,101852,0,124852
141017601400000,NE 129,RESIDENTIAL,33600,0,33600,68465,0,102065
141017601500000,NE 129,RESIDENTIAL,33600,0,33600,79015,0,112615
141017601600000,NE 129,RESIDENTIAL,35700,0,35700,97796,0,133496
141017601700000,NE 129,RESIDENTIAL,31500,0,31500,86863,0,118363
141017601800000,NE 129,RESIDENTIAL,33600,0,33600,113372,0,146972
141017601900000,NE 129,RESIDENTIAL,27200,0,27200,83057,0,110257
141017602000000,NE 129,RESIDENTIAL,24638,0,24638,73339,0,97977
141017602100000,NE 129,RESIDENTIAL,22028,0,22028,66435,0,88463
141017602200000,NE 129,RESIDENTIAL,23955,0,23955,56585,0,80540
141017700100000,SCHOOL,EXEMPT,0,0,0,0,0,0
141017800100000,NE 129,RESIDENTIAL,31918,0,31918,116747,0,148665
141017800200000,NE 129,RESIDENTIAL,31280,0,31280,66761,0,98041
141017800300000,NE 129,RESIDENTIAL,31500,0,31500,109832,0,141332
141017800400000,NE 129,RESIDENTIAL,31500,0,31500,101664,0,133164
141017800500000,NE 129,RESIDENTIAL,31500,0,31500,79760,0,111260
141017800600000,NE 129,RESIDENTIAL,31500,0,31500,110225,0,141725
141017800700000,NE 129,RESIDENTIAL,31500,0,31500,106114,0,137614
141017800800000,NE 129,RESIDENTIAL,31500,0,31500,60993,0,92493
141017800900000,NE 129,RESIDENTIAL,31500,0,31500,66562,0,98062
141017801000000,NE 129,RESIDENTIAL,30258,0,30258,87292,0,117550
141017801100000,NE 129,RESIDENTIAL,32742,0,32742,129810,0,162552
141017801200000,NE 129,RESIDENTIAL,31500,0,31500,75320,0,106820
141017801300000,NE 129,RESIDENTIAL,31500,0,31500,99938,0,131438
141017801400000,NE 129,RESIDENTIAL,31500,0,31500,71931,0,103431
141017801500000,NE 129,RESIDENTIAL,31500,0,31500,79281,0,110781
141017801600000,NE 129,RESIDENTIAL,31500,0,31500,113405,0,144905
141017801700000,NE 129,RESIDENTIAL,31500,0,31500,80023,0,111523
141017801800000,NE 129,RESIDENTIAL,31500,0,31500,62149,0,93649
141017801900000,NE 129,RESIDENTIAL,23000,0,23000,74703,0,97703
141017802000000,NE 129,RESIDENTIAL,34883,0,34883,101412,0,136295
141017802100000,NE 129,RESIDENTIAL,25088,0,25088,113514,0,138602
141017802200000,NE 129,RESIDENTIAL,25585,0,25585,87501,0,113086
141017900100000,NE 131,RESIDENTIAL,22750,0,22750,102052,0,124802
141017900200000,NE 131,RESIDENTIAL,22750,0,22750,77993,0,100743
141017900300000,NE 131,RESIDENTIAL,22750,0,22750,83907,0,106657
141017900400000,NE 131,RESIDENTIAL,17063,0,17063,75617,0,92680
141017900500000,NE 131,RESIDENTIAL,17063,0,17063,81064,0,98127
141017900600000,NE 131,RESIDENTIAL,22750,0,22750,84618,0,107368
141017900700000,NE 131,RESIDENTIAL,11375,0,11375,60218,0,71593
141017900800000,NE 131,RESIDENTIAL,11375,0,11375,72792,0,84167
141017900900000,NE 131,RESIDENTIAL,22750,0,22750,71710,0,94460
141017901000000,NE 131,RESIDENTIAL,11375,0,11375,67955,0,79330
141017901100000,NE 131,RESIDENTIAL,27300,0,27300,110840,0,138140
141017901200000,NE 131,RESIDENTIAL,22750,0,22750,92645,0,115395
141017901300000,NE 131,RESIDENTIAL,11375,0,11375,59890,0,71265
141017901400000,NE 131,RESIDENTIAL,17063,0,17063,50790,0,67853
141017901500000,NE 131,RESIDENTIAL,17063,0,17063,76298,0,93361
141017901600000,NE 131,RESIDENTIAL,11375,0,11375,51425,0,62800
141017901700000,NE 131,RESIDENTIAL,21125,0,21125,50790,0,71915
141017901800000,NE 131,RESIDENTIAL,13000,0,13000,43258,0,56258
141017901900000,NE 131,RESIDENTIAL,22750,0,22750,71882,0,94632
141018000100000,NE 129,RESIDENTIAL,21000,0,21000,49228,0,70228
141018000200000,NE 129,RESIDENTIAL,22050,0,22050,70320,0,92370
141018000300000,NE 129,RESIDENTIAL,32760,0,32760,71122,0,103882
141018000400000,NE 129,RESIDENTIAL,21000,0,21000,40184,0,61184
141018000500000,NE 129,RESIDENTIAL,21000,0,21000,103341,0,124341
141018000600000,NE 129,RESIDENTIAL,26250,0,26250,76165,0,102415
141018000700000,NE 129,RESIDENTIAL,26250,0,26250,49046,0,75296
141018000800000,NE 129,RESIDENTIAL,26250,0,26250,73459,0,99709
141018000900000,NE 129,RESIDENTIAL,26250,0,26250,89155,0,115405
141018001000000,NE 129,RESIDENTIAL,21000,0,21000,81103,0,102103
141018001100000,NE 129,RESIDENTIAL,21000,0,21000,95854,0,116854
141018001200000,NE 129,RESIDENTIAL,31500,0,31500,86254,0,117754
141018001300000,NE 129,RESIDENTIAL,31500,0,31500,96978,0,128478
141018001400000,NE 129,RESIDENTIAL,21000,0,21000,50594,0,71594
141018001500000,NE 129,RESIDENTIAL,21000,0,21000,56530,0,77530
141018001600000,NE 129,RESIDENTIAL,21000,0,21000,51781,0,72781
141018001700000,NE 129,RESIDENTIAL,21000,0,21000,69151,0,90151
141018001800000,NE 129,RESIDENTIAL,21000,0,21000,66847,0,87847
141018001900000,NE 129,RESIDENTIAL,23625,0,23625,57170,0,80795
141018002000000,NE 129,RESIDENTIAL,33469,0,33469,69134,0,102603
141018002100000,NE 129,RESIDENTIAL,26250,0,26250,59931,0,86181
141018002200000,NE 129,RESIDENTIAL,26250,0,26250,91467,0,117717
141018002300000,NE 129,RESIDENTIAL,31500,0,31500,79548,0,111048
141018002400000,NE 129,RESIDENTIAL,23625,0,23625,90488,0,114113
141018002500000,NE 129,RESIDENTIAL,23625,0,23625,67380,0,91005
141018002600000,NE 129,RESIDENTIAL,36750,0,36750,74423,0,111173
141018100100000,NE 131,RESIDENTIAL,22750,0,22750,72890,0,95640
141018100200000,NE 131,RESIDENTIAL,22750,0,22750,133157,0,155907
141018100300000,NE 131,RESIDENTIAL,15817,0,15817,94045,0,109862
141018100400000,NE 131,RESIDENTIAL,14408,0,14408,71132,0,85540
141018100500000,NE 131,RESIDENTIAL,15275,0,15275,71261,0,86536
141018100600000,NE 131,RESIDENTIAL,22750,0,22750,76399,0,99149
141018100700000,NE 131,RESIDENTIAL,22750,0,22750,108654,0,131404
141018100800000,NE 131,RESIDENTIAL,22750,0,22750,81091,0,103841
141018100900000,NE 131,RESIDENTIAL,22750,0,22750,48362,0,71112
141018101000000,NE 131,RESIDENTIAL,15165,0,15165,70348,0,85513
141018101100000,NE 131,RESIDENTIAL,15165,0,15165,64009,0,79174
141018101200000,NE 131,RESIDENTIAL,18415,0,18415,60339,0,78754
141018101300000,NE 131,RESIDENTIAL,19500,0,19500,86918,0,106418
141018101400000,NE 131,RESIDENTIAL,22750,0,22750,75440,0,98190
141018101500000,NE 131,RESIDENTIAL,18957,0,18957,61432,0,80389
141018101600000,NE 131,RESIDENTIAL,18957,0,18957,71845,0,90802
141018101700000,NE 131,RESIDENTIAL,18957,0,18957,54209,0,73166
141018101800000,NE 131,RESIDENTIAL,22750,0,22750,64956,0,87706
141018101900000,NE 131,RESIDENTIAL,11375,0,11375,52876,0,64251
141020100100000,GOLF COURSE,COMMERCIAL,0,179600,179600,0,445927,625527
141020200100000,CONVENIENCE STORE,COMMERCIAL,0,111900,111900,0,227421,339321
141020200200000,SMALL RETAIL,COMMERCIAL,0,77000,77000,0,192887,269887
141020200300000,OFFICE,COMMERCIAL,0,136000,136000,0,456835,592835
141022600100000,OFFICE; MEDICAL,COMMERCIAL,0,69000,69000,0,205602,274602
141022600200000,NE 132,RESIDENTIAL,40838,0,40838,82977,0,123815
141022600300000,NE 132,RESIDENTIAL,35640,0,35640,84417,0,120057
141022600400000,NE 132,RESIDENTIAL,16830,0,16830,80429,0,97259
141022600500000,NE 132,RESIDENTIAL,36900,0,36900,57246,0,94146
141022600600000,NE 132,RESIDENTIAL,33840,0,33840,103815,0,137655
141022600700000,NE 132,RESIDENTIAL,36981,0,36981,109658,0,146639
141022600800000,NE 132,RESIDENTIAL,42075,0,42075,94587,0,136662
141022600900000,NE 132,RESIDENTIAL,37622,0,37622,106934,0,144556
141022601000000,NE 132,RESIDENTIAL,30410,0,30410,89998,0,120408
141022601100000,NE 132,RESIDENTIAL,33580,0,33580,92026,0,125606
141022601200000,NE 132,RESIDENTIAL,37345,0,37345,87166,0,124511
141022601300000,NE 132,RESIDENTIAL,34411,0,34411,114722,0,149133
141022601400000,APARTMENT,COMMERCIAL,0,37200,37200,0,365863,403063
141022601500000,FLAT PARKING,COMMERCIAL,0,91500,91500,0,29134,120634
141022700100000,NE 132,RESIDENTIAL,32928,0,32928,87667,0,120595
141022700200000,NE 132,RESIDENTIAL,32670,0,32670,95270,0,127940
141022700300000,NE 132,RESIDENTIAL,28840,0,28840,111849,0,140689
141022700400000,NE 132,RESIDENTIAL,43715,0,43715,145079,0,188794
141022700500000,NE 132,RESIDENTIAL,45357,0,45357,83981,0,129338
141022700600000,NE 132,RESIDENTIAL,32670,0,32670,102645,0,135315
141022700700000,NE 132,RESIDENTIAL,28350,0,28350,74817,0,103167
141022701000000,NE 132,RESIDENTIAL,26730,0,26730,99042,0,125772
141022701100000,NE 132,RESIDENTIAL,26957,0,26957,99768,0,126725
141022701200000,NE 132,RESIDENTIAL,30240,0,30240,105140,0,135380
141022701300000,NE 132,RESIDENTIAL,28343,0,28343,102900,0,131243
141022701400000,NE 132,RESIDENTIAL,39847,0,39847,126970,0,166817
141022701500000,NE 132,RESIDENTIAL,37950,0,37950,161572,0,199522
141022701600000,NE 132,RESIDENTIAL,37950,0,37950,89933,0,127883
141022701700000,NE 132,RESIDENTIAL,37950,0,37950,110779,0,148729
141022701800000,NE 132,RESIDENTIAL,38280,0,38280,104510,0,142790
141022701900000,NE 132,RESIDENTIAL,38940,0,38940,91798,0,130738
141022702000000,NE 132,RESIDENTIAL,33557,0,33557,93807,0,127364
141022702100000,NE 132,RESIDENTIAL,34320,0,34320,81297,0,115617
141022702200000,NE 132,RESIDENTIAL,34320,0,34320,113681,0,148001
141022702300000,NE 132,RESIDENTIAL,34320,0,34320,84525,0,118845
141022702400000,NE 132,RESIDENTIAL,38324,0,38324,90642,0,128966
141022702500000,NE 132,RESIDENTIAL,37180,0,37180,101980,0,139160
141022702600000,NE 132,RESIDENTIAL,32604,0,32604,93790,0,126394
141022702700000,NE 132,RESIDENTIAL,49252,0,49252,92609,0,141861
141022800100000,NE 132,RESIDENTIAL,60950,0,60950,91196,0,152146
141022800200000,NE 132,RESIDENTIAL,28759,0,28759,80629,0,109388
141022800300000,NE 132,RESIDENTIAL,31680,0,31680,78835,0,110515
141022800400000,NE 132,RESIDENTIAL,31680,0,31680,89302,0,120982
141022800500000,NE 132,RESIDENTIAL,30624,0,30624,93216,0,123840
141022800600000,NE 132,RESIDENTIAL,30624,0,30624,71967,0,102591
141022800700000,NE 132,RESIDENTIAL,27701,0,27701,86468,0,114169
141022800800000,NE 132,RESIDENTIAL,22141,0,22141,84764,0,106905
141022900100000,NE 132,RESIDENTIAL,33110,0,33110,102648,0,135758
141022900200000,NE 132,RESIDENTIAL,33330,0,33330,99651,0,132981
141022900300000,NE 132,RESIDENTIAL,31123,0,31123,87247,0,118370
141022900400000,NE 132,RESIDENTIAL,34011,0,34011,108586,0,142597
141022900500000,NE 132,RESIDENTIAL,33941,0,33941,97681,0,131622
141022900600000,NE 132,RESIDENTIAL,34202,0,34202,101653,0,135855
141022900700000,NE 132,RESIDENTIAL,34277,0,34277,99461,0,133738
141022900800000,NE 132,RESIDENTIAL,34277,0,34277,76874,0,111151
141022900900000,NE 132,RESIDENTIAL,34277,0,34277,90097,0,124374
141022901000000,NE 132,RESIDENTIAL,34558,0,34558,101857,0,136415
141022901100000,NE 132,RESIDENTIAL,34950,0,34950,101669,0,136619
141022901200000,NE 132,RESIDENTIAL,34782,0,34782,79329,0,114111
141022901300000,NE 132,RESIDENTIAL,34782,0,34782,94614,0,129396
141022901400000,NE 132,RESIDENTIAL,34782,0,34782,90629,0,125411
141022901500000,NE 132,RESIDENTIAL,34782,0,34782,93574,0,128356
141022901600000,NE 132,RESIDENTIAL,34782,0,34782,87106,0,121888
141022901700000,NE 132,RESIDENTIAL,35567,0,35567,82231,0,117798
141022901800000,NE 132,RESIDENTIAL,34631,0,34631,80997,0,115628
141022901900000,NE 132,RESIDENTIAL,35306,0,35306,96286,0,131592
141022902000000,NE 132,RESIDENTIAL,34320,0,34320,71680,0,106000
141022902100000,NE 132,RESIDENTIAL,36960,0,36960,56692,0,93652
141022902200000,NE 132,RESIDENTIAL,38204,0,38204,92428,0,130632
141023000100000,NE 132,RESIDENTIAL,40966,0,40966,110150,0,151116
141023000200000,NE 132,RESIDENTIAL,31715,0,31715,101551,0,133266
141023000300000,NE 132,RESIDENTIAL,38662,0,38662,79844,0,118506
141023000400000,NE 132,RESIDENTIAL,28093,0,28093,86998,0,115091
141023000500000,NE 132,RESIDENTIAL,28440,0,28440,85287,0,113727
141023000600000,NE 132,RESIDENTIAL,28704,0,28704,84517,0,113221
141023000700000,NE 132,RESIDENTIAL,28915,0,28915,99699,0,128614
141023000800000,NE 132,RESIDENTIAL,32480,0,32480,97114,0,129594
141023000900000,NE 132,RESIDENTIAL,25203,0,25203,76797,0,102000
141023001000000,NE 132,RESIDENTIAL,22387,0,22387,100218,0,122605
141023001100000,NE 132,RESIDENTIAL,22046,0,22046,76591,0,98637
141023100100000,NE 132,RESIDENTIAL,31372,0,31372,72609,0,103981
141023100200000,NE 132,RESIDENTIAL,31680,0,31680,66980,0,98660
141023100300000,NE 132,RESIDENTIAL,31680,0,31680,74906,0,106586
141023100400000,NE 132,RESIDENTIAL,31680,0,31680,80531,0,112211
141023100500000,NE 132,RESIDENTIAL,31680,0,31680,111331,0,143011
141023100600000,NE 132,RESIDENTIAL,33247,0,33247,86945,0,120192
141023100700000,NE 132,RESIDENTIAL,32616,0,32616,58279,0,90895
141023100800000,NE 132,RESIDENTIAL,32933,0,32933,95730,0,128663
141023100900000,NE 132,RESIDENTIAL,22560,0,22560,74992,0,97552
141023101000000,NE 132,RESIDENTIAL,22560,0,22560,53865,0,76425
141023101100000,NE 132,RESIDENTIAL,24750,0,24750,46139,0,70889
141023200100000,NE 132,RESIDENTIAL,34320,0,34320,82399,0,116719
141023200200000,NE 132,RESIDENTIAL,34320,0,34320,74816,0,109136
141023200300000,NE 132,RESIDENTIAL,34267,0,34267,85331,0,119598
141023200400000,NE 132,RESIDENTIAL,32683,0,32683,97563,0,130246
141023200500000,NE 132,RESIDENTIAL,33792,0,33792,114417,0,148209
141023200600000,NE 132,RESIDENTIAL,31680,0,31680,83667,0,115347
141023200700000,NE 132,RESIDENTIAL,33792,0,33792,89004,0,122796
141023200800000,NE 132,RESIDENTIAL,32736,0,32736,99015,0,131751
141023200900000,NE 132,RESIDENTIAL,32736,0,32736,76716,0,109452
141023201000000,NE 132,RESIDENTIAL,32736,0,32736,98946,0,131682
141023201100000,NE 132,RESIDENTIAL,32472,0,32472,85348,0,117820
141023201200000,NE 132,RESIDENTIAL,33052,0,33052,106936,0,139988
141023201300000,NE 132,RESIDENTIAL,29343,0,29343,99586,0,128929
141023201400000,NE 132,RESIDENTIAL,29343,0,29343,95922,0,125265
141023201500000,NE 132,RESIDENTIAL,29343,0,29343,92015,0,121358
141023201600000,NE 132,RESIDENTIAL,29343,0,29343,90563,0,119906
141023201700000,NE 132,RESIDENTIAL,29343,0,29343,104602,0,133945
141023201800000,NE 132,RESIDENTIAL,29343,0,29343,69171,0,98514
141023201900000,NE 132,RESIDENTIAL,29343,0,29343,86361,0,115704
141023202000000,NE 132,RESIDENTIAL,29343,0,29343,81112,0,110455
141023202100000,NE 132,RESIDENTIAL,29343,0,29343,85825,0,115168
141023202200000,NE 132,RESIDENTIAL,29343,0,29343,73002,0,102345
141023202300000,NE 132,EXEMPT,0,33013,33013,0,118637,151650
141023300100000,NE 132,RESIDENTIAL,30456,0,30456,67089,0,97545
141023300200000,NE 132,RESIDENTIAL,29610,0,29610,57542,0,87152
141023300300000,NE 132,RESIDENTIAL,32359,0,32359,74339,0,106698
141023300400000,NE 132,RESIDENTIAL,26100,0,26100,48698,0,74798
141023400100000,NE 132,RESIDENTIAL,29695,0,29695,57862,0,87557
141023400200000,NE 132,RESIDENTIAL,38525,0,38525,72167,0,110692
141023400300000,NE 132,RESIDENTIAL,30690,0,30690,73997,0,104687
141023400400000,NE 132,RESIDENTIAL,40755,0,40755,87146,0,127901
141023400500000,NE 132,RESIDENTIAL,32010,0,32010,71335,0,103345
141023400600000,NE 132,RESIDENTIAL,31882,0,31882,134267,0,166149
141023400700000,NE 132,RESIDENTIAL,34612,0,34612,79677,0,114289
141023400800000,NE 132,RESIDENTIAL,31020,0,31020,82814,0,113834
141023400900000,NE 132,RESIDENTIAL,31020,0,31020,92122,0,123142
141023401000000,NE 132,RESIDENTIAL,31020,0,31020,73956,0,104976
141023401100000,NE 132,RESIDENTIAL,34496,0,34496,98713,0,133209
141023401200000,NE 132,RESIDENTIAL,32724,0,32724,88986,0,121710
141025100100000,GOLF COURSE,COMMERCIAL,0,25500,25500,0,39884,65384
141025100200000,NE 132,RESIDENTIAL,33516,0,33516,72182,0,105698
141025100300000,NE 132,RESIDENTIAL,27440,0,27440,63707,0,91147
141025100400000,NE 132,RESIDENTIAL,33264,0,33264,61566,0,94830
141025100500000,NE 132,RESIDENTIAL,34650,0,34650,63639,0,98289
141025100600000,NE 132,RESIDENTIAL,30600,0,30600,66177,0,96777
141025100700000,NE 132,RESIDENTIAL,30282,0,30282,64601,0,94883
141025100800000,NE 132,RESIDENTIAL,32738,0,32738,71823,0,104561
141025100900000,NE 132,RESIDENTIAL,32738,0,32738,66238,0,98976
141025101000000,NE 132,EXEMPT,0,32738,32738,0,52104,84842
141025101100000,NE 132,RESIDENTIAL,32738,0,32738,74134,0,106872
141025101200000,NE 132,RESIDENTIAL,33369,0,33369,66090,0,99459
141025101300000,NE 132,RESIDENTIAL,32760,0,32760,83795,0,116555
141025101400000,NE 132,RESIDENTIAL,33264,0,33264,65960,0,99224
141025101500000,NE 132,RESIDENTIAL,31590,0,31590,52451,0,84041
141025101600000,NE 131,RESIDENTIAL,19305,0,19305,71991,0,91296
141025101700000,NE 131,RESIDENTIAL,19305,0,19305,73564,0,92869
141025101800000,NE 131,RESIDENTIAL,21879,0,21879,78822,0,100701
141025200100000,NE 132,RESIDENTIAL,24000,0,24000,63013,0,87013
141025200200000,NE 132,RESIDENTIAL,24750,0,24750,46742,0,71492
141025200300000,NE 132,RESIDENTIAL,24750,0,24750,46702,0,71452
141025200400000,NE 132,RESIDENTIAL,24750,0,24750,48310,0,73060
141025200500000,NE 132,RESIDENTIAL,24750,0,24750,56912,0,81662
141025200600000,NE 132,RESIDENTIAL,24750,0,24750,51961,0,76711
141025200700000,NE 132,RESIDENTIAL,24750,0,24750,48559,0,73309
141025200800000,NE 132,RESIDENTIAL,24750,0,24750,50632,0,75382
141025200900000,NE 132,RESIDENTIAL,24750,0,24750,46604,0,71354
141025201000000,NE 132,RESIDENTIAL,24750,0,24750,41081,0,65831
141025201100000,NE 132,RESIDENTIAL,24750,0,24750,50206,0,74956
141025201200000,NE 132,RESIDENTIAL,25650,0,25650,69919,0,95569
141025201300000,NE 132,RESIDENTIAL,32359,0,32359,69282,0,101641
141025201400000,NE 132,RESIDENTIAL,29610,0,29610,57345,0,86955
141025201500000,NE 132,RESIDENTIAL,30456,0,30456,69924,0,100380
141025201600000,NE 132,RESIDENTIAL,24000,0,24000,43052,0,67052
141025201700000,NE 132,RESIDENTIAL,24000,0,24000,48603,0,72603
141025201800000,NE 132,RESIDENTIAL,24000,0,24000,77880,0,101880
141025201900000,NE 132,RESIDENTIAL,24000,0,24000,86949,0,110949
141025202000000,NE 132,RESIDENTIAL,24000,0,24000,69732,0,93732
141025202100000,NE 132,RESIDENTIAL,26000,0,26000,49891,0,75891
141025202200000,NE 132,RESIDENTIAL,24000,0,24000,68015,0,92015
141025202300000,NE 132,RESIDENTIAL,24000,0,24000,53623,0,77623
141025202400000,NE 132,RESIDENTIAL,24000,0,24000,54379,0,78379
141025202500000,NE 132,RESIDENTIAL,24000,0,24000,63241,0,87241
141025300100000,NE 132,RESIDENTIAL,25380,0,25380,55814,0,81194
141025300200000,NE 132,RESIDENTIAL,37218,0,37218,77174,0,114392
141025300300000,NE 132,RESIDENTIAL,32912,0,32912,96457,0,129369
141025300400000,NE 132,RESIDENTIAL,27495,0,27495,55215,0,82710
141025300500000,NE 132,RESIDENTIAL,27495,0,27495,66852,0,94347
141025300600000,NE 132,RESIDENTIAL,25380,0,25380,46172,0,71552
141025300700000,NE 132,RESIDENTIAL,30679,0,30679,61869,0,92548
141025300800000,NE 132,RESIDENTIAL,29295,0,29295,47671,0,76966
141025300900000,NE 132,RESIDENTIAL,31697,0,31697,66339,0,98036
141025301000000,NE 132,RESIDENTIAL,27788,0,27788,61688,0,89476
141025301100000,NE 132,RESIDENTIAL,25245,0,25245,46130,0,71375
141025301200000,NE 132,RESIDENTIAL,25380,0,25380,51282,0,76662
141025400100000,NE 132,RESIDENTIAL,24840,0,24840,59930,0,84770
141025400200000,NE 132,RESIDENTIAL,28518,0,28518,50715,0,79233
141025400300000,NE 132,RESIDENTIAL,24008,0,24008,43980,0,67988
141025400400000,NE 132,RESIDENTIAL,26190,0,26190,42828,0,69018
141025400500000,NE 132,RESIDENTIAL,26190,0,26190,46204,0,72394
141025400600000,NE 132,RESIDENTIAL,26190,0,26190,67687,0,93877
141025400700000,NE 132,RESIDENTIAL,26190,0,26190,47702,0,73892
141025400800000,NE 132,RESIDENTIAL,26190,0,26190,46795,0,72985
141025400900000,NE 132,RESIDENTIAL,28000,0,28000,105484,0,133484
141025401000000,NE 132,RESIDENTIAL,34178,0,34178,103472,0,137650
141025401100000,NE 132,RESIDENTIAL,26190,0,26190,110674,0,136864
141025401200000,NE 132,RESIDENTIAL,24008,0,24008,130755,0,154763
141025401300000,NE 132,RESIDENTIAL,26190,0,26190,80675,0,106865
141025401400000,NE 132,RESIDENTIAL,26190,0,26190,106070,0,132260
141025401500000,NE 132,RESIDENTIAL,27495,0,27495,81899,0,109394
141025401600000,NE 132,RESIDENTIAL,26313,0,26313,70966,0,97279
141025401700000,NE 132,RESIDENTIAL,25380,0,25380,74624,0,100004
141025500100000,NE 132,RESIDENTIAL,36045,0,36045,81339,0,117384
141025500200000,NE 132,RESIDENTIAL,36000,0,36000,57269,0,93269
141025500300000,NE 132,RESIDENTIAL,33075,0,33075,74124,0,107199
141025500400000,NE 132,RESIDENTIAL,34155,0,34155,63156,0,97311
141025500500000,NE 132,RESIDENTIAL,36450,0,36450,63422,0,99872
141025500600000,NE 132,RESIDENTIAL,23280,0,23280,47461,0,70741
141025500700000,NE 132,RESIDENTIAL,25200,0,25200,62894,0,88094
141025500800000,NE 132,RESIDENTIAL,24240,0,24240,53481,0,77721
141025500900000,NE 132,RESIDENTIAL,24159,0,24159,83457,0,107616
141025501000000,NE 132,RESIDENTIAL,23280,0,23280,48046,0,71326
141025501100000,NE 132,RESIDENTIAL,23280,0,23280,94679,0,117959
141025501200000,NE 132,RESIDENTIAL,24240,0,24240,45489,0,69729
141025501300000,NE 132,RESIDENTIAL,27071,0,27071,62553,0,89624
141025501400000,NE 131,RESIDENTIAL,23089,0,23089,91081,0,114170
141025501500000,NE 131,RESIDENTIAL,19305,0,19305,89305,0,108610
141025501600000,NE 131,RESIDENTIAL,19305,0,19305,71309,0,90614
141025501700000,NE 131,RESIDENTIAL,19305,0,19305,80964,0,100269
141025501800000,NE 131,RESIDENTIAL,19305,0,19305,74335,0,93640
141025501900000,NE 131,RESIDENTIAL,19305,0,19305,65317,0,84622
141025502000000,NE 131,RESIDENTIAL,19305,0,19305,69407,0,88712
141025502100000,NE 131,RESIDENTIAL,19305,0,19305,75840,0,95145
141025502200000,NE 131,RESIDENTIAL,19305,0,19305,90392,0,109697
141025502300000,NE 131,RESIDENTIAL,19305,0,19305,92642,0,111947
141025502400000,NE 132,RESIDENTIAL,27540,0,27540,47890,0,75430
141025502500000,NE 132,RESIDENTIAL,29952,0,29952,85247,0,115199
141025502600000,NE 132,RESIDENTIAL,36115,0,36115,60308,0,96423
141025502700000,NE 132,RESIDENTIAL,29970,0,29970,57995,0,87965
141025502800000,NE 132,RESIDENTIAL,28936,0,28936,46275,0,75211
141025502900000,NE 132,RESIDENTIAL,27027,0,27027,51975,0,79002
141025503000000,NE 132,RESIDENTIAL,30450,0,30450,51325,0,81775
141025503100000,NE 132,RESIDENTIAL,33784,0,33784,52384,0,86168
141025503200000,NE 132,RESIDENTIAL,29187,0,29187,50814,0,80001
141025503300000,NE 132,RESIDENTIAL,29952,0,29952,63716,0,93668
141025503400000,NE 132,RESIDENTIAL,37395,0,37395,49504,0,86899
141025600100000,NE 132,RESIDENTIAL,30070,0,30070,99846,0,129916
141025600200000,NE 132,RESIDENTIAL,28665,0,28665,50804,0,79469
141025600300000,NE 132,RESIDENTIAL,29581,0,29581,62880,0,92461
141025600400000,NE 132,RESIDENTIAL,25110,0,25110,48320,0,73430
141025600500000,NE 132,RESIDENTIAL,26064,0,26064,57817,0,83881
141025600600000,NE 132,RESIDENTIAL,27846,0,27846,71194,0,99040
141025600700000,NE 132,RESIDENTIAL,28704,0,28704,43163,0,71867
141025600800000,NE 132,RESIDENTIAL,26730,0,26730,66673,0,93403
141025600900000,NE 132,RESIDENTIAL,25920,0,25920,48090,0,74010
141025601000000,NE 132,RESIDENTIAL,29952,0,29952,58920,0,88872
141025601100000,NE 132,RESIDENTIAL,25389,0,25389,108777,0,134166
141025601200000,NE 132,RESIDENTIAL,27437,0,27437,94277,0,121714
141025601300000,NE 132,RESIDENTIAL,27852,0,27852,80368,0,108220
141025601400000,NE 132,RESIDENTIAL,31661,0,31661,115595,0,147256
141025601500000,NE 132,RESIDENTIAL,24703,0,24703,81831,0,106534
141025601600000,NE 132,RESIDENTIAL,27241,0,27241,80491,0,107732
141025601700000,NE 132,RESIDENTIAL,31304,0,31304,114707,0,146011
141025601800000,DAY CARE CENTER,COMMERCIAL,0,33755,33755,0,118578,152333
141025601900000,NE 132,RESIDENTIAL,29329,0,29329,88378,0,117707
141025602000000,NE 132,RESIDENTIAL,27550,0,27550,103457,0,131007
141025602100000,NE 132,RESIDENTIAL,27151,0,27151,70289,0,97440
141025602200000,NE 132,RESIDENTIAL,28186,0,28186,69217,0,97403
141025602300000,NE 132,RESIDENTIAL,27533,0,27533,65533,0,93066
141025700100000,NE 132,RESIDENTIAL,29610,0,29610,63202,0,92812
141025700200000,NE 132,RESIDENTIAL,27918,0,27918,56203,0,84121
141025700300000,NE 132,RESIDENTIAL,32371,0,32371,102016,0,134387
141025700400000,NE 132,RESIDENTIAL,30467,0,30467,128253,0,158720
141025700500000,NE 132,RESIDENTIAL,34112,0,34112,84313,0,118425
141025700600000,NE 132,RESIDENTIAL,39824,0,39824,205483,0,245307
141025700700000,NE 132,RESIDENTIAL,36353,0,36353,129483,0,165836
141025700800000,NE 132,RESIDENTIAL,30740,0,30740,48727,0,79467
141025700900000,NE 132,RESIDENTIAL,26010,0,26010,67121,0,93131
141025701000000,NE 132,RESIDENTIAL,27693,0,27693,82909,0,110602
141025701100000,NE 132,RESIDENTIAL,30210,0,30210,66331,0,96541
141027600100000,GOLF COURSE,COMMERCIAL,0,463300,463300,0,2830761,3294061
141027600200000,NE 131,RESIDENTIAL,16088,0,16088,65732,0,81820
141027600300000,NE 131,RESIDENTIAL,16088,0,16088,93250,0,109338
141027600400000,NE 131,RESIDENTIAL,20914,0,20914,104964,0,125878
141027600500000,NE 131,RESIDENTIAL,20914,0,20914,93379,0,114293
141027600600000,NE 131,RESIDENTIAL,20914,0,20914,124729,0,145643
141027600700000,NE 131,RESIDENTIAL,20608,0,20608,101976,0,122584
141027600800000,NE 131,RESIDENTIAL,19305,0,19305,113897,0,133202
141027600900000,NE 131,RESIDENTIAL,19305,0,19305,93290,0,112595
141027601000000,NE 131,RESIDENTIAL,25096,0,25096,127186,0,152282
141027601100000,NE 131,RESIDENTIAL,21879,0,21879,84554,0,106433
141027601200000,NE 131,RESIDENTIAL,24131,0,24131,122713,0,146844
141027601300000,NE 131,RESIDENTIAL,19305,0,19305,80824,0,100129
141027601400000,NE 131,RESIDENTIAL,19305,0,19305,83863,0,103168
141027601500000,NE 131,RESIDENTIAL,19305,0,19305,86808,0,106113
141027601600000,NE 131,RESIDENTIAL,19305,0,19305,65752,0,85057
141027601700000,NE 131,RESIDENTIAL,19305,0,19305,57918,0,77223
141027601800000,NE 131,RESIDENTIAL,19305,0,19305,76051,0,95356
141027601900000,NE 131,RESIDENTIAL,19888,0,19888,65137,0,85025
141030100100000,NE 131,RESIDENTIAL,13733,0,13733,54526,0,68259
141030100200000,NE 131,RESIDENTIAL,14771,0,14771,69055,0,83826
141030100300000,NE 131,RESIDENTIAL,22880,0,22880,70604,0,93484
141030100400000,NE 131,RESIDENTIAL,17397,0,17397,56514,0,73911
141030100500000,NE 131,RESIDENTIAL,17726,0,17726,64864,0,82590
141030100600000,NE 131,RESIDENTIAL,18382,0,18382,91528,0,109910
141030100700000,NE 131,RESIDENTIAL,25275,0,25275,63890,0,89165
141030100800000,NE 131,RESIDENTIAL,26260,0,26260,83200,0,109460
141030100900000,NE 131,RESIDENTIAL,24240,0,24240,65645,0,89885
141030101000000,NE 131,RESIDENTIAL,24240,0,24240,38432,0,62672
141030101100000,NE 131,RESIDENTIAL,25740,0,25740,82268,0,108008
141030101200000,NE 131,RESIDENTIAL,26260,0,26260,79326,0,105586
141030101300000,NE 131,RESIDENTIAL,26260,0,26260,112110,0,138370
141030101400000,NE 131,RESIDENTIAL,26260,0,26260,106941,0,133201
141030101500000,NE 131,RESIDENTIAL,24240,0,24240,163667,0,187907
141030101600000,NE 131,RESIDENTIAL,26000,0,26000,103348,0,129348
141030101700000,NE 131,RESIDENTIAL,24240,0,24240,52034,0,76274
141030101800000,NE 131,RESIDENTIAL,24240,0,24240,70380,0,94620
141030101900000,NE 131,RESIDENTIAL,24240,0,24240,56227,0,80467
141030102000000,NE 131,RESIDENTIAL,24720,0,24720,33790,0,58510
141030102100000,NE 131,RESIDENTIAL,26000,0,26000,77582,0,103582
141030102200000,NE 131,RESIDENTIAL,26000,0,26000,99196,0,125196
141030102300000,NE 131,RESIDENTIAL,25818,0,25818,108264,0,134082
141030102400000,NE 131,RESIDENTIAL,24543,0,24543,84357,0,108900
141030102500000,NE 131,RESIDENTIAL,13938,0,13938,76143,0,90081
141030102600000,NE 131,RESIDENTIAL,16362,0,16362,91534,0,107896
141030102700000,NE 131,RESIDENTIAL,16059,0,16059,73700,0,89759
141030102800000,NE 131,RESIDENTIAL,25920,0,25920,114131,0,140051
141030102900000,NE 131,RESIDENTIAL,15790,0,15790,91380,0,107170
141030103000000,NE 131,RESIDENTIAL,14510,0,14510,103198,0,117708
141030103100000,NE 131,RESIDENTIAL,18180,0,18180,79093,0,97273
141030103200000,NE 131,RESIDENTIAL,13254,0,13254,37275,0,50529
141030103300000,NE 131,RESIDENTIAL,13254,0,13254,47139,0,60393
141030200100000,NE 131,RESIDENTIAL,26260,0,26260,119785,0,146045
141030200200000,NE 131,RESIDENTIAL,26260,0,26260,87292,0,113552
141030200300000,NE 131,RESIDENTIAL,16362,0,16362,85823,0,102185
141030200400000,NE 131,RESIDENTIAL,24240,0,24240,81798,0,106038
141030300100000,CENTRALLY ASSESSED,OTHER,0,0,0,0,0,0
141030300200000,NE 131,RESIDENTIAL,12000,0,12000,45106,0,57106
141030300300000,NE 131,RESIDENTIAL,18000,0,18000,82731,0,100731
141030300400000,NE 131,RESIDENTIAL,24000,0,24000,46321,0,70321
141030300500000,NE 131,RESIDENTIAL,24000,0,24000,102660,0,126660
141030300600000,NE 131,RESIDENTIAL,24000,0,24000,115263,0,139263
141030300700000,NE 131,RESIDENTIAL,24000,0,24000,82203,0,106203
141030300800000,NE 131,RESIDENTIAL,24000,0,24000,59908,0,83908
141030300900000,NE 131,RESIDENTIAL,24000,0,24000,88637,0,112637
141030301000000,NE 131,RESIDENTIAL,24960,0,24960,71595,0,96555
141030301200000,NE 131,RESIDENTIAL,21420,0,21420,58366,0,79786
141030301300000,NE 131,RESIDENTIAL,24480,0,24480,92773,0,117253
141030301400000,NE 131,RESIDENTIAL,24000,0,24000,146000,0,170000
141030301500000,DAY CARE CENTER,COMMERCIAL,0,44800,44800,0,136137,180937
141030301600000,NE 131,RESIDENTIAL,24000,0,24000,101168,0,125168
141030301700000,NE 131,RESIDENTIAL,23520,0,23520,96990,0,120510
141030301800000,NE 131,RESIDENTIAL,22800,0,22800,112499,0,135299
141030301900000,NE 131,RESIDENTIAL,24000,0,24000,102657,0,126657
141030302000000,NE 131,RESIDENTIAL,24000,0,24000,100432,0,124432
141030302100000,NE 131,RESIDENTIAL,24000,0,24000,108442,0,132442
141030302200000,NE 131,RESIDENTIAL,24000,0,24000,92661,0,116661
141030302300000,NE 131,RESIDENTIAL,18000,0,18000,95442,0,113442
141030302400000,NE 131,RESIDENTIAL,18000,0,18000,84164,0,102164
141030302500000,NE 131,RESIDENTIAL,12000,0,12000,48646,0,60646
141030302600000,NE 131,RESIDENTIAL,18000,0,18000,79352,0,97352
141030302700000,NE 131,RESIDENTIAL,26730,0,26730,81167,0,107897
141030302800000,NE 131,RESIDENTIAL,14709,0,14709,135798,0,150507
141030302900000,NE 131,RESIDENTIAL,14706,0,14706,142448,0,157154
141030400100000,NE 131,RESIDENTIAL,15960,0,15960,56799,0,72759
141030400200000,NE 131,RESIDENTIAL,24480,0,24480,93854,0,118334
141030400300000,NE 131,RESIDENTIAL,23520,0,23520,92334,0,115854
141030400400000,NE 131,RESIDENTIAL,15960,0,15960,37947,0,53907
141030400500000,NE 131,RESIDENTIAL,15960,0,15960,49443,0,65403
141030400600000,NE 131,RESIDENTIAL,15960,0,15960,45287,0,61247
141030500100000,NE 131,RESIDENTIAL,15960,0,15960,39655,0,55615
141030500200000,NE 131,RESIDENTIAL,21000,0,21000,230800,0,251800
141030500300000,NE 131,RESIDENTIAL,15000,0,15000,64033,0,79033
141030500400000,NE 131,RESIDENTIAL,12000,0,12000,80521,0,92521
141030500500000,NE 131,RESIDENTIAL,15510,0,15510,85820,0,101330
141030500600000,NE 131,RESIDENTIAL,15510,0,15510,91770,0,107280
141030500700000,NE 131,RESIDENTIAL,15000,0,15000,105293,0,120293
141030500800000,NE 131,EXEMPT,0,23520,23520,0,117617,141137
141030500900000,NE 131,RESIDENTIAL,17640,0,17640,99507,0,117147
141030501000000,NE 131,RESIDENTIAL,17640,0,17640,98233,0,115873
141030501100000,NE 131,RESIDENTIAL,17640,0,17640,88658,0,106298
141030501200000,NE 131,RESIDENTIAL,17640,0,17640,80857,0,98497
141030501300000,NE 131,RESIDENTIAL,18000,0,18000,115378,0,133378
141030501400000,NE 131,RESIDENTIAL,14820,0,14820,80565,0,95385
141030501500000,NE 131,RESIDENTIAL,14700,0,14700,74431,0,89131
141030501600000,NE 131,RESIDENTIAL,21120,0,21120,95509,0,116629
141030501700000,NE 131,RESIDENTIAL,24000,0,24000,81425,0,105425
141030501800000,NE 131,RESIDENTIAL,25920,0,25920,56912,0,82832
141030501900000,NE 131,RESIDENTIAL,21120,0,21120,59979,0,81099
141030502000000,NE 131,RESIDENTIAL,24000,0,24000,61044,0,85044
141030502100000,NE 131,RESIDENTIAL,12960,0,12960,55636,0,68596
141030502200000,NE 131,RESIDENTIAL,12960,0,12960,41751,0,54711
141030502300000,NE 131,RESIDENTIAL,24480,0,24480,82113,0,106593
141030502400000,NE 131,RESIDENTIAL,24000,0,24000,65674,0,89674
141030502500000,NE 131,RESIDENTIAL,24480,0,24480,127959,0,152439
141030502600000,NE 131,RESIDENTIAL,24480,0,24480,100256,0,124736
141030502700000,NE 131,RESIDENTIAL,12240,0,12240,56919,0,69159
141030502800000,NE 131,RESIDENTIAL,12240,0,12240,47185,0,59425
141030502900000,NE 131,RESIDENTIAL,24480,0,24480,98793,0,123273
141030503000000,NE 131,RESIDENTIAL,15000,0,15000,98929,0,113929
141030503100000,NE 131,RESIDENTIAL,27720,0,27720,88007,0,115727
141030503200000,NE 131,RESIDENTIAL,12000,0,12000,37784,0,49784
141030503300000,NE 131,RESIDENTIAL,12000,0,12000,49865,0,61865
141030503400000,NE 131,RESIDENTIAL,24000,0,24000,71119,0,95119
141030503500000,NE 131,RESIDENTIAL,15960,0,15960,61363,0,77323
141030503600000,NE 131,RESIDENTIAL,15960,0,15960,37787,0,53747
141030503700000,NE 131,RESIDENTIAL,15960,0,15960,35751,0,51711
141030600100000,NE 131,RESIDENTIAL,22800,0,22800,100790,0,123590
141030600200000,NE 131,RESIDENTIAL,15600,0,15600,84118,0,99718
141030600300000,NE 131,RESIDENTIAL,14400,0,14400,32295,0,46695
141030600400000,NE 131,RESIDENTIAL,24000,0,24000,45168,0,69168
141030700100000,NE 131,RESIDENTIAL,17020,0,17020,71964,0,88984
141030700200000,NE 131,RESIDENTIAL,15300,0,15300,99941,0,115241
141030700300000,NE 131,RESIDENTIAL,24480,0,24480,121590,0,146070
141030700400000,NE 131,RESIDENTIAL,24480,0,24480,88207,0,112687
141030700500000,NE 131,RESIDENTIAL,24480,0,24480,124010,0,148490
141030700600000,NE 131,RESIDENTIAL,18360,0,18360,59486,0,77846
141030700700000,NE 131,RESIDENTIAL,18360,0,18360,58025,0,76385
141030700800000,NE 131,RESIDENTIAL,25203,0,25203,104211,0,129414
141030700900000,NE 131,RESIDENTIAL,16672,0,16672,45309,0,61981
141030701000000,NE 131,RESIDENTIAL,14280,0,14280,20708,0,34988
141030701100000,NE 131,RESIDENTIAL,14280,0,14280,67727,0,82007
141030701200000,NE 131,RESIDENTIAL,28560,0,28560,54909,0,83469
141030701300000,NE 131,RESIDENTIAL,28560,0,28560,55505,0,84065
141030701400000,NE 131,RESIDENTIAL,28560,0,28560,85978,0,114538
141030701500000,NE 131,RESIDENTIAL,28560,0,28560,68498,0,97058
141030701600000,NE 131,RESIDENTIAL,17850,0,17850,136922,0,154772
141030701700000,NE 131,RESIDENTIAL,16100,0,16100,99659,0,115759
141030701800000,NE 131,RESIDENTIAL,16560,0,16560,92582,0,109142
141030701900000,NE 131,RESIDENTIAL,16560,0,16560,96299,0,112859
141030702000000,NE 131,RESIDENTIAL,16560,0,16560,94184,0,110744
141030800100000,NE 131,RESIDENTIAL,24480,0,24480,86277,0,110757
141030800200000,NE 131,RESIDENTIAL,16310,0,16310,46366,0,62676
141030800300000,NE 131,RESIDENTIAL,12240,0,12240,47393,0,59633
141030800400000,NE 131,RESIDENTIAL,24480,0,24480,56854,0,81334
141030800500000,NE 131,RESIDENTIAL,24480,0,24480,75740,0,100220
141030800600000,NE 131,RESIDENTIAL,12240,0,12240,52522,0,64762
141030800700000,NE 131,RESIDENTIAL,12240,0,12240,26631,0,38871
141030800800000,NE 131,RESIDENTIAL,12240,0,12240,21404,0,33644
141030800900000,NE 131,RESIDENTIAL,14280,0,14280,61001,0,75281
141030801000000,NE 131,RESIDENTIAL,14280,0,14280,82050,0,96330
141030801100000,NE 131,RESIDENTIAL,14280,0,14280,40277,0,54557
141030801200000,NE 131,RESIDENTIAL,14280,0,14280,49441,0,63721
141030801300000,NE 131,RESIDENTIAL,14280,0,14280,52663,0,66943
141030801400000,NE 131,RESIDENTIAL,14280,0,14280,39973,0,54253
141030801500000,NE 131,RESIDENTIAL,14280,0,14280,60908,0,75188
141030801600000,NE 131,RESIDENTIAL,14280,0,14280,48286,0,62566
141030801700000,NE 131,RESIDENTIAL,19028,0,19028,62429,0,81457
141030801800000,NE 131,RESIDENTIAL,28560,0,28560,84720,0,113280
141030900100000,NE 131,RESIDENTIAL,12240,0,12240,49242,0,61482
141030900200000,NE 131,RESIDENTIAL,12240,0,12240,53030,0,65270
141030900300000,NE 131,RESIDENTIAL,22800,0,22800,118043,0,140843
141030900400000,NE 131,RESIDENTIAL,30240,0,30240,53002,0,83242
141030900500000,NE 131,RESIDENTIAL,14280,0,14280,76035,0,90315
141030900600000,NE 131,RESIDENTIAL,14280,0,14280,66427,0,80707
141032600100000,NE 131,RESIDENTIAL,26260,0,26260,57338,0,83598
141032600200000,NE 131,RESIDENTIAL,26000,0,26000,103747,0,129747
141032600300000,NE 131,RESIDENTIAL,26260,0,26260,103046,0,129306
141032600400000,NE 131,RESIDENTIAL,26000,0,26000,90122,0,116122
141032600500000,NE 131,RESIDENTIAL,25740,0,25740,99853,0,125593
141032600600000,NE 131,RESIDENTIAL,26520,0,26520,85499,0,112019
141032600700000,NE 131,RESIDENTIAL,26520,0,26520,93195,0,119715
141032600800000,NE 131,RESIDENTIAL,26520,0,26520,86155,0,112675
141032600900000,NE 131,RESIDENTIAL,24440,0,24440,61756,0,86196
141032601000000,NE 131,RESIDENTIAL,19760,0,19760,57846,0,77606
141032601100000,NE 131,RESIDENTIAL,18459,0,18459,51482,0,69941
141032601200000,CHURCH,EXEMPT,0,71366,71366,0,0,71366
141032601300000,CHURCH,EXEMPT,0,31752,31752,0,60534,92286
141032601400000,NE 131,RESIDENTIAL,17675,0,17675,71244,0,88919
141032601500000,NE 131,RESIDENTIAL,24000,0,24000,100880,0,124880
141032601600000,NE 131,RESIDENTIAL,24600,0,24600,55911,0,80511
141032601700000,NE 131,RESIDENTIAL,13200,0,13200,78371,0,91571
141032601800000,NE 131,RESIDENTIAL,13200,0,13200,75696,0,88896
141032601900000,NE 131,RESIDENTIAL,24000,0,24000,73626,0,97626
141032602000000,NE 131,RESIDENTIAL,24000,0,24000,73589,0,97589
141032602100000,NE 131,RESIDENTIAL,24000,0,24000,104666,0,128666
141032602200000,NE 131,RESIDENTIAL,24720,0,24720,102034,0,126754
141032602300000,NE 131,RESIDENTIAL,15150,0,15150,64030,0,79180
141032602400000,NE 131,RESIDENTIAL,18180,0,18180,128345,0,146525
141032602500000,NE 131,RESIDENTIAL,15150,0,15150,57825,0,72975
141032602600000,NE 131,RESIDENTIAL,24480,0,24480,63823,0,88303
141032602700000,NE 131,RESIDENTIAL,16059,0,16059,68697,0,84756
141032602800000,NE 131,RESIDENTIAL,16059,0,16059,82698,0,98757
141032700100000,NE 131,RESIDENTIAL,14409,0,14409,91658,0,106067
141032700200000,NE 132,RESIDENTIAL,31652,0,31652,110886,0,142538
141032700300000,NE 131,RESIDENTIAL,14850,0,14850,62426,0,77276
141032700400000,NE 131,RESIDENTIAL,13500,0,13500,104558,0,118058
141032700500000,NE 131,RESIDENTIAL,13500,0,13500,64338,0,77838
141032700600000,NE 131,RESIDENTIAL,14799,0,14799,46341,0,61140
141032700700000,NE 131,RESIDENTIAL,13187,0,13187,89667,0,102854
141032700800000,NE 131,RESIDENTIAL,14292,0,14292,87136,0,101428
141032800100000,NE 131,RESIDENTIAL,24000,0,24000,97815,0,121815
141032800200000,NE 131,RESIDENTIAL,25500,0,25500,66986,0,92486
141032800300000,NE 131,RESIDENTIAL,22500,0,22500,47099,0,69599
141032800400000,NE 131,RESIDENTIAL,15900,0,15900,87709,0,103609
141032800500000,NE 131,RESIDENTIAL,15900,0,15900,86071,0,101971
141032800600000,NE 131,RESIDENTIAL,16200,0,16200,69300,0,85500
141032800700000,NE 131,RESIDENTIAL,24000,0,24000,78681,0,102681
141032800800000,NE 131,RESIDENTIAL,24000,0,24000,91913,0,115913
141032800900000,NE 131,RESIDENTIAL,24000,0,24000,85359,0,109359
141032801000000,NE 131,RESIDENTIAL,24000,0,24000,113654,0,137654
141032801100000,NE 131,RESIDENTIAL,12240,0,12240,53069,0,65309
141032801200000,NE 131,RESIDENTIAL,12240,0,12240,75542,0,87782
141032801300000,NE 131,RESIDENTIAL,24960,0,24960,85758,0,110718
141032801400000,NE 131,RESIDENTIAL,18480,0,18480,0,0,18480
141032801500000,NE 131,RESIDENTIAL,16100,0,16100,81309,0,97409
141032801600000,NE 131,RESIDENTIAL,21188,0,21188,87418,0,108606
141032801700000,NE 131,RESIDENTIAL,18850,0,18850,103260,0,122110
141032801800000,NE 131,RESIDENTIAL,20650,0,20650,71580,0,92230
141032801900000,NE 131,RESIDENTIAL,23040,0,23040,114225,0,137265
141032802000000,NE 131,RESIDENTIAL,23520,0,23520,114341,0,137861
141032802100000,NE 131,RESIDENTIAL,12000,0,12000,87728,0,99728
141032802200000,NE 131,RESIDENTIAL,18000,0,18000,70843,0,88843
141032802300000,NE 131,RESIDENTIAL,18000,0,18000,64537,0,82537
141032802400000,NE 131,RESIDENTIAL,24000,0,24000,64805,0,88805
141032802500000,NE 131,RESIDENTIAL,24000,0,24000,88231,0,112231
141032802600000,NE 131,RESIDENTIAL,16200,0,16200,110843,0,127043
141032802700000,NE 131,RESIDENTIAL,15900,0,15900,97502,0,113402
141032802800000,NE 131,RESIDENTIAL,15900,0,15900,78152,0,94052
141032802900000,NE 131,RESIDENTIAL,18000,0,18000,95777,0,113777
141032803000000,NE 131,RESIDENTIAL,18000,0,18000,101007,0,119007
141032803100000,NE 131,RESIDENTIAL,18000,0,18000,112290,0,130290
141032803200000,NE 131,RESIDENTIAL,18000,0,18000,81102,0,99102
141032900100000,NE 131,RESIDENTIAL,13200,0,13200,67599,0,80799
141032900200000,NE 131,RESIDENTIAL,12720,0,12720,96858,0,109578
141032900300000,NE 131,RESIDENTIAL,12240,0,12240,90496,0,102736
141032900400000,NE 131,RESIDENTIAL,12960,0,12960,58429,0,71389
141032900500000,NE 131,RESIDENTIAL,9450,0,9450,0,0,9450
141032900600000,OFFICE,COMMERCIAL,0,147000,147000,0,590360,737360
141033000100000,NE 131,RESIDENTIAL,15600,0,15600,109303,0,124903
141033000200000,NE 131,RESIDENTIAL,18000,0,18000,119651,0,137651
141033000300000,NE 131,RESIDENTIAL,18000,0,18000,112888,0,130888
141033000400000,NE 131,RESIDENTIAL,14730,0,14730,88564,0,103294
141033000500000,NE 131,RESIDENTIAL,14550,0,14550,61601,0,76151
141033000600000,NE 131,RESIDENTIAL,19740,0,19740,74969,0,94709
141033000700000,NE 131,RESIDENTIAL,18900,0,18900,73076,0,91976
141033000800000,NE 131,RESIDENTIAL,14250,0,14250,74804,0,89054
141033000900000,NE 131,RESIDENTIAL,18000,0,18000,82471,0,100471
141033001000000,NE 131,RESIDENTIAL,24000,0,24000,82665,0,106665
141033001100000,NE 131,RESIDENTIAL,24000,0,24000,102350,0,126350
141033001200000,NE 131,RESIDENTIAL,23520,0,23520,112793,0,136313
141033001300000,NE 131,RESIDENTIAL,24000,0,24000,109252,0,133252
141033001400000,NE 131,RESIDENTIAL,24000,0,24000,85755,0,109755
141033001500000,NE 131,RESIDENTIAL,22531,0,22531,22127,0,44658
141033001600000,NE 131,RESIDENTIAL,18025,0,18025,55210,0,73235
141033001700000,NE 131,RESIDENTIAL,21350,0,21350,52776,0,74126
141033001800000,APARTMENT,RESIDENTIAL,25680,0,25680,387954,0,413634
141033001900000,APARTMENT,RESIDENTIAL,19520,0,19520,184487,0,204007
141033002000000,APARTMENT,RESIDENTIAL,15120,0,15120,171108,0,186228
141033002100000,NE 131,RESIDENTIAL,10500,0,10500,27908,0,38408
141033002300000,NE 131,RESIDENTIAL,22050,0,22050,66914,0,88964
141033002500000,NE 131,RESIDENTIAL,10500,0,10500,27311,0,37811
141033002600000,NE 131,RESIDENTIAL,28200,0,28200,124884,0,153084
141033002700000,NE 131,RESIDENTIAL,19800,0,19800,38119,0,57919
141033002800000,NE 131,RESIDENTIAL,24480,0,24480,38295,0,62775
141033002900000,NE 131,RESIDENTIAL,24000,0,24000,61243,0,85243
141033003000000,NE 131,RESIDENTIAL,24000,0,24000,43330,0,67330
141033003100000,NE 131,RESIDENTIAL,18000,0,18000,68565,0,86565
141033003200000,NE 131,RESIDENTIAL,15600,0,15600,53872,0,69472
141033003300000,NE 131,RESIDENTIAL,16920,0,16920,90494,0,107414
141033003400000,NE 131,RESIDENTIAL,22050,0,22050,50997,0,73047
141033003500000,NE 131,RESIDENTIAL,24720,0,24720,88288,0,113008
141033003600000,NE 131,RESIDENTIAL,24000,0,24000,96552,0,120552
141033003700000,NE 131,RESIDENTIAL,24000,0,24000,84183,0,108183
141033003800000,NE 131,RESIDENTIAL,9600,0,9600,58659,0,68259
141033100100000,NE 131,RESIDENTIAL,22800,0,22800,78542,0,101342
141033100200000,NE 131,RESIDENTIAL,12240,0,12240,77146,0,89386
141033100300000,NE 131,RESIDENTIAL,12240,0,12240,69695,0,81935
141033100400000,NE 131,RESIDENTIAL,22557,0,22557,116118,0,138675
141033100500000,NE 131,RESIDENTIAL,12240,0,12240,67514,0,79754
141033100600000,NE 131,RESIDENTIAL,12240,0,12240,64445,0,76685
141033100700000,NE 131,RESIDENTIAL,33600,0,33600,99500,0,133100
141033100800000,NE 131,RESIDENTIAL,16800,0,16800,45269,0,62069
141033100900000,NE 131,RESIDENTIAL,12240,0,12240,56509,0,68749
141033101000000,NE 131,RESIDENTIAL,24000,0,24000,131527,0,155527
141033101100000,NE 131,RESIDENTIAL,25193,0,25193,153936,0,179129
141033101200000,NE 131,RESIDENTIAL,24480,0,24480,119056,0,143536
141033101300000,NE 131,RESIDENTIAL,24480,0,24480,86185,0,110665
141033101400000,NE 131,RESIDENTIAL,21120,0,21120,91992,0,113112
141033101600000,NE 131,RESIDENTIAL,18240,0,18240,45998,0,64238
141033101700000,CONVENIENCE STORE,COMMERCIAL,0,435000,435000,0,796541,1231541
141033101800000,NE 131,RESIDENTIAL,30800,0,30800,66597,0,97397
141033102000000,NE 131,RESIDENTIAL,31080,0,31080,51794,0,82874
141033102100000,NE 131,RESIDENTIAL,28560,0,28560,94759,0,123319
141033102200000,NE 131,RESIDENTIAL,28560,0,28560,76122,0,104682
141033102300000,NE 131,RESIDENTIAL,25199,0,25199,51543,0,76742
141033102400000,NE 131,RESIDENTIAL,29120,0,29120,41085,0,70205
141033102500000,NE 131,RESIDENTIAL,14280,0,14280,61541,0,75821
141033102600000,NE 131,RESIDENTIAL,28560,0,28560,61668,0,90228
141033102700000,NE 131,RESIDENTIAL,29382,0,29382,70397,0,99779
141033102800000,NE 131,RESIDENTIAL,28560,0,28560,78206,0,106766
141033102900000,NE 131,RESIDENTIAL,30240,0,30240,68538,0,98778
141035100100000,NE 143,RESIDENTIAL,26664,0,26664,113610,0,140274
141035100200000,NE 143,RESIDENTIAL,17952,0,17952,89149,0,107101
141035100300000,NE 143,RESIDENTIAL,17952,0,17952,68942,0,86894
141035100400000,NE 143,RESIDENTIAL,17952,0,17952,65005,0,82957
141035100500000,NE 143,RESIDENTIAL,31680,0,31680,107953,0,139633
141035100600000,NE 143,RESIDENTIAL,32208,0,32208,71712,0,103920
141035100700000,NE 143,RESIDENTIAL,40260,0,40260,88172,0,128432
141035100800000,NE 143,RESIDENTIAL,33330,0,33330,103106,0,136436
141035100900000,NE 143,RESIDENTIAL,33330,0,33330,107234,0,140564
141035101000000,NE 143,RESIDENTIAL,40260,0,40260,80319,0,120579
141035101100000,NE 143,RESIDENTIAL,32208,0,32208,86596,0,118804
141035101200000,NE 143,RESIDENTIAL,32208,0,32208,104149,0,136357
141035101300000,NE 143,RESIDENTIAL,28248,0,28248,57014,0,85262
141035101400000,NE 143,RESIDENTIAL,26928,0,26928,42530,0,69458
141035101500000,NE 143,RESIDENTIAL,26664,0,26664,65825,0,92489
141035101600000,NE 143,RESIDENTIAL,31680,0,31680,72628,0,104308
141035101700000,NE 143,RESIDENTIAL,32208,0,32208,65938,0,98146
141035101800000,NE 143,RESIDENTIAL,35136,0,35136,92967,0,128103
141035101900000,NE 143,RESIDENTIAL,5016,0,5016,0,0,5016
141035102000000,NE 143,RESIDENTIAL,5280,0,5280,0,0,5280
141035102100000,NE 143,RESIDENTIAL,3960,0,3960,0,0,3960
141035102200000,NE 143,RESIDENTIAL,6930,0,6930,0,0,6930
141035102300000,NE 143,RESIDENTIAL,6930,0,6930,0,0,6930
141035102400000,NE 143,RESIDENTIAL,28000,0,28000,184955,0,212955
141035102500000,NE 143,RESIDENTIAL,24800,0,24800,89057,0,113857
141035102600000,NE 143,RESIDENTIAL,26664,0,26664,121993,0,148657
141035200100000,NE 143,RESIDENTIAL,27428,0,27428,107222,0,134650
141035200200000,NE 143,RESIDENTIAL,32208,0,32208,75274,0,107482
141035200400000,NE 143,RESIDENTIAL,32208,0,32208,137516,0,169724
141035200500000,NE 143,RESIDENTIAL,3300,0,3300,0,0,3300
141035200600000,NE 143,RESIDENTIAL,3300,0,3300,0,0,3300
141035200700000,NE 143,RESIDENTIAL,26840,0,26840,91267,0,118107
141035200800000,NE 143,RESIDENTIAL,26840,0,26840,98599,0,125439
141035200900000,NE 143,RESIDENTIAL,4620,0,4620,0,0,4620
141035201000000,NE 143,RESIDENTIAL,6930,0,6930,0,0,6930
141035201100000,NE 143,RESIDENTIAL,31424,0,31424,82822,0,114246
141035201200000,NE 143,RESIDENTIAL,34560,0,34560,69044,0,103604
141035201300000,NE 143,RESIDENTIAL,4560,0,4560,0,0,4560
141035201400000,NE 143,RESIDENTIAL,28800,0,28800,95131,0,123931
141035201500000,NE 143,RESIDENTIAL,30976,0,30976,74770,0,105746
141035201600000,NE 143,RESIDENTIAL,29280,0,29280,84322,0,113602
141035201700000,NE 143,RESIDENTIAL,29280,0,29280,91365,0,120645
141035201800000,NE 143,RESIDENTIAL,29280,0,29280,83550,0,112830
141035201900000,NE 143,RESIDENTIAL,28800,0,28800,95538,0,124338
141035202000000,OFFICE,COMMERCIAL,0,85397,85397,0,355565,440962
141035202100000,NE 143,RESIDENTIAL,24240,0,24240,51435,0,75675
141035202200000,NE 143,RESIDENTIAL,24240,0,24240,116393,0,140633
141035202300000,NE 143,RESIDENTIAL,24240,0,24240,87604,0,111844
141035202400000,NE 143,RESIDENTIAL,33330,0,33330,73996,0,107326
141035202500000,NE 143,RESIDENTIAL,22220,0,22220,77532,0,99752
141035202600000,NE 143,RESIDENTIAL,16830,0,16830,61968,0,78798
141035202700000,NE 143,RESIDENTIAL,16830,0,16830,32776,0,49606
141035202800000,NE 143,RESIDENTIAL,34297,0,34297,120502,0,154799
141035202900000,NE 143,RESIDENTIAL,27600,0,27600,112925,0,140525
141035203000000,NE 143,RESIDENTIAL,18622,0,18622,0,0,18622
141035203100000,NE 143,RESIDENTIAL,26866,0,26866,61738,0,88604
141035300100000,NE 143,RESIDENTIAL,21223,0,21223,102741,0,123964
141035300200000,NE 143,RESIDENTIAL,19920,0,19920,106903,0,126823
141035300300000,NE 143,RESIDENTIAL,29293,0,29293,109498,0,138791
141035300400000,NE 143,RESIDENTIAL,25086,0,25086,109371,0,134457
141035300500000,NE 143,RESIDENTIAL,25931,0,25931,102715,0,128646
141035300600000,NE 143,RESIDENTIAL,24240,0,24240,75470,0,99710
141035300700000,NE 143,RESIDENTIAL,24240,0,24240,95133,0,119373
141035300800000,NE 143,RESIDENTIAL,29088,0,29088,82673,0,111761
141035300900000,NE 143,RESIDENTIAL,36026,0,36026,113679,0,149705
141035301000000,NE 143,RESIDENTIAL,27002,0,27002,120031,0,147033
141035301100000,NE 143,RESIDENTIAL,28980,0,28980,146841,0,175821
141035301200000,NE 143,RESIDENTIAL,28280,0,28280,125596,0,153876
141035301300000,NE 143,RESIDENTIAL,28280,0,28280,93620,0,121900
141035301400000,NE 143,RESIDENTIAL,28318,0,28318,95637,0,123955
141035301500000,NE 143,RESIDENTIAL,28280,0,28280,116735,0,145015
141035301600000,NE 143,RESIDENTIAL,26086,0,26086,143295,0,169381
141035301700000,NE 143,RESIDENTIAL,28230,0,28230,110202,0,138432
141035301800000,NE 143,RESIDENTIAL,22967,0,22967,106190,0,129157
141035400100000,NE 143,RESIDENTIAL,24981,0,24981,80182,0,105163
141035400200000,NE 143,RESIDENTIAL,24240,0,24240,121325,0,145565
141035400300000,NE 143,RESIDENTIAL,30704,0,30704,123962,0,154666
141035400400000,NE 143,RESIDENTIAL,29189,0,29189,87891,0,117080
141035400500000,NE 143,RESIDENTIAL,24240,0,24240,96775,0,121015
141035400600000,NE 143,RESIDENTIAL,24240,0,24240,73846,0,98086
141035400700000,NE 143,RESIDENTIAL,24240,0,24240,87212,0,111452
141035400800000,NE 143,RESIDENTIAL,34728,0,34728,116690,0,151418
141035400900000,NE 143,RESIDENTIAL,26847,0,26847,68521,0,95368
141035401000000,NE 143,RESIDENTIAL,24240,0,24240,60144,0,84384
141035401100000,NE 143,RESIDENTIAL,24240,0,24240,101695,0,125935
141035401200000,NE 143,RESIDENTIAL,21008,0,21008,60312,0,81320
141035401300000,NE 143,RESIDENTIAL,21008,0,21008,83058,0,104066
141035401400000,NE 143,RESIDENTIAL,21008,0,21008,48322,0,69330
141035401500000,NE 143,RESIDENTIAL,21412,0,21412,56260,0,77672
141035401600000,NE 143,RESIDENTIAL,21008,0,21008,60222,0,81230
141035401700000,NE 143,RESIDENTIAL,21412,0,21412,77525,0,98937
141035401800000,NE 143,RESIDENTIAL,21008,0,21008,64823,0,85831
141035401900000,NE 143,RESIDENTIAL,20954,0,20954,76107,0,97061
141035500100000,NE 143,RESIDENTIAL,25048,0,25048,95328,0,120376
141035500200000,NE 143,RESIDENTIAL,26260,0,26260,123694,0,149954
141035500300000,NE 143,RESIDENTIAL,28785,0,28785,99736,0,128521
141035500400000,NE 143,RESIDENTIAL,28785,0,28785,85106,0,113891
141035500500000,NE 143,RESIDENTIAL,28987,0,28987,107872,0,136859
141035500600000,NE 143,RESIDENTIAL,28785,0,28785,149210,0,177995
141035500700000,NE 143,RESIDENTIAL,28785,0,28785,118566,0,147351
141035500800000,NE 143,RESIDENTIAL,26664,0,26664,104776,0,131440
141035500900000,NE 143,RESIDENTIAL,29637,0,29637,129541,0,159178
141035501000000,NE 143,RESIDENTIAL,28070,0,28070,100566,0,128636
141035501100000,NE 143,RESIDENTIAL,21816,0,21816,90073,0,111889
141035501200000,NE 143,RESIDENTIAL,21816,0,21816,93609,0,115425
141035501300000,NE 143,RESIDENTIAL,19392,0,19392,50357,0,69749
141035501400000,NE 143,RESIDENTIAL,19392,0,19392,52730,0,72122
141035501500000,NE 143,RESIDENTIAL,21816,0,21816,77101,0,98917
141035501600000,NE 143,RESIDENTIAL,19392,0,19392,62519,0,81911
141035501700000,NE 143,RESIDENTIAL,21816,0,21816,65702,0,87518
141035501800000,NE 143,RESIDENTIAL,24240,0,24240,72716,0,96956
141035501900000,NE 143,RESIDENTIAL,24240,0,24240,61168,0,85408
141035502000000,NE 143,RESIDENTIAL,24981,0,24981,94258,0,119239
141035502100000,NE 143,RESIDENTIAL,23859,0,23859,90832,0,114691
141035502200000,NE 143,RESIDENTIAL,21816,0,21816,73610,0,95426
141035502300000,NE 143,RESIDENTIAL,21816,0,21816,93811,0,115627
141035502400000,NE 143,RESIDENTIAL,21816,0,21816,75712,0,97528
141035502500000,NE 143,RESIDENTIAL,21816,0,21816,71414,0,93230
141035502600000,NE 143,RESIDENTIAL,21816,0,21816,112624,0,134440
141035502700000,NE 143,RESIDENTIAL,21816,0,21816,75387,0,97203
141035502800000,NE 143,RESIDENTIAL,21816,0,21816,78092,0,99908
141035502900000,NE 143,RESIDENTIAL,21816,0,21816,81237,0,103053
141035503000000,NE 143,RESIDENTIAL,26579,0,26579,102099,0,128678
141035503100000,NE 143,RESIDENTIAL,26743,0,26743,89302,0,116045
141035503200000,NE 143,RESIDENTIAL,25452,0,25452,80399,0,105851
141035503300000,NE 143,RESIDENTIAL,27270,0,27270,138651,0,165921
141035503400000,NE 143,RESIDENTIAL,27270,0,27270,64455,0,91725
141035503500000,NE 143,RESIDENTIAL,27270,0,27270,101184,0,128454
141035503600000,NE 143,RESIDENTIAL,18180,0,18180,71618,0,89798
141035503700000,NE 143,RESIDENTIAL,18180,0,18180,55728,0,73908
141035503800000,NE 143,RESIDENTIAL,27961,0,27961,97693,0,125654
141037600300000,NE 143,RESIDENTIAL,7280,0,7280,0,0,7280
141037600400000,NE 143,RESIDENTIAL,7920,0,7920,0,0,7920
141037600500000,NE 142,RESIDENTIAL,23285,0,23285,116978,0,140263
141037700100000,NE 143,RESIDENTIAL,25819,0,25819,57217,0,83036
141037700200000,NE 143,RESIDENTIAL,24240,0,24240,130499,0,154739
141037700300000,NE 143,RESIDENTIAL,23163,0,23163,97484,0,120647
141037700400000,NE 143,RESIDENTIAL,32452,0,32452,122288,0,154740
141037700500000,NE 143,RESIDENTIAL,25088,0,25088,102300,0,127388
141037700600000,NE 143,RESIDENTIAL,24240,0,24240,83395,0,107635
141037700700000,NE 143,RESIDENTIAL,24761,0,24761,88600,0,113361
141037700800000,NE 143,RESIDENTIAL,25121,0,25121,78944,0,104065
141037700900000,NE 143,RESIDENTIAL,24240,0,24240,80819,0,105059
141037701000000,NE 143,RESIDENTIAL,24664,0,24664,136190,0,160854
141037701100000,NE 143,RESIDENTIAL,33238,0,33238,508,0,33746
141037701200000,NE 143,RESIDENTIAL,16100,0,16100,44796,0,60896
141037701300000,NE 143,RESIDENTIAL,3120,0,3120,36155,0,39275
141037701400000,NE 143,RESIDENTIAL,24480,0,24480,46760,0,71240
141037701500000,NE 143,RESIDENTIAL,22811,0,22811,91708,0,114519
141037800100000,NE 143,RESIDENTIAL,22417,0,22417,54067,0,76484
141037800200000,NE 143,RESIDENTIAL,18180,0,18180,60729,0,78909
141037800300000,NE 143,RESIDENTIAL,20200,0,20200,50020,0,70220
141037800400000,NE 143,RESIDENTIAL,18180,0,18180,56458,0,74638
141037800500000,NE 143,RESIDENTIAL,20200,0,20200,54892,0,75092
141037800600000,NE 143,RESIDENTIAL,23316,0,23316,54542,0,77858
141037800700000,NE 143,RESIDENTIAL,27260,0,27260,62894,0,90154
141037800800000,NE 143,RESIDENTIAL,27323,0,27323,86289,0,113612
141037800900000,NE 143,RESIDENTIAL,24960,0,24960,89549,0,114509
141037801000000,NE 143,RESIDENTIAL,26545,0,26545,63647,0,90192
141037801100000,NE 143,RESIDENTIAL,21712,0,21712,71038,0,92750
141037801200000,NE 143,RESIDENTIAL,22215,0,22215,70518,0,92733
141037801300000,NE 143,RESIDENTIAL,22368,0,22368,57205,0,79573
141037801400000,NE 143,RESIDENTIAL,20200,0,20200,49260,0,69460
141037801500000,NE 143,RESIDENTIAL,18180,0,18180,53208,0,71388
141037801600000,NE 143,RESIDENTIAL,20200,0,20200,67349,0,87549
141037801700000,NE 143,RESIDENTIAL,18180,0,18180,67814,0,85994
141037801800000,NE 143,RESIDENTIAL,23316,0,23316,60926,0,84242
141037900100000,NE 143,RESIDENTIAL,22535,0,22535,72907,0,95442
141037900200000,NE 143,RESIDENTIAL,27440,0,27440,60317,0,87757
141037900300000,NE 143,RESIDENTIAL,19400,0,19400,119454,0,138854
141037900400000,NE 143,RESIDENTIAL,31817,0,31817,72706,0,104523
141038000200000,NE 143,RESIDENTIAL,35075,0,35075,56352,0,91427
141038000300000,NE 143,RESIDENTIAL,21052,0,21052,110820,0,131872
141038000400000,NE 143,RESIDENTIAL,20200,0,20200,98625,0,118825
141038000500000,NE 143,RESIDENTIAL,19348,0,19348,100948,0,120296
141038000600000,NE 143,RESIDENTIAL,21052,0,21052,85185,0,106237
141038000700000,NE 143,RESIDENTIAL,20200,0,20200,73872,0,94072
141038000800000,NE 143,RESIDENTIAL,19348,0,19348,104366,0,123714
141038001000000,NE 143,RESIDENTIAL,29952,0,29952,79070,0,109022
141038001100000,CHURCH,EXEMPT,0,92880,92880,0,177501,270381
141038100100000,NE 143,RESIDENTIAL,22357,0,22357,81722,0,104079
141038100200000,NE 143,RESIDENTIAL,18180,0,18180,53740,0,71920
141038100300000,NE 143,RESIDENTIAL,20200,0,20200,50398,0,70598
141038100400000,NE 143,RESIDENTIAL,18180,0,18180,54354,0,72534
141038100500000,NE 143,RESIDENTIAL,20200,0,20200,52129,0,72329
141038100600000,NE 143,RESIDENTIAL,23287,0,23287,57609,0,80896
141038100700000,NE 143,RESIDENTIAL,22666,0,22666,56110,0,78776
141038100800000,NE 143,RESIDENTIAL,23200,0,23200,48520,0,71720
141038100900000,NE 143,RESIDENTIAL,19333,0,19333,51662,0,70995
141038101000000,NE 143,RESIDENTIAL,18382,0,18382,45669,0,64051
141038101100000,NE 143,RESIDENTIAL,22355,0,22355,56342,0,78697
141038101200000,NE 143,RESIDENTIAL,21856,0,21856,70936,0,92792
141038101300000,NE 143,RESIDENTIAL,21856,0,21856,75693,0,97549
141038101400000,NE 143,RESIDENTIAL,21856,0,21856,75377,0,97233
141038101500000,NE 143,RESIDENTIAL,25566,0,25566,157150,0,182716
141038101600000,NE 143,RESIDENTIAL,26506,0,26506,100672,0,127178
141038101700000,NE 143,RESIDENTIAL,22309,0,22309,60196,0,82505
141038101800000,NE 143,RESIDENTIAL,20200,0,20200,54733,0,74933
141038101900000,NE 143,RESIDENTIAL,18180,0,18180,48556,0,66736
141038102000000,NE 143,RESIDENTIAL,20200,0,20200,54599,0,74799
141038102100000,NE 143,RESIDENTIAL,18180,0,18180,49602,0,67782
141038102200000,NE 143,RESIDENTIAL,23287,0,23287,76002,0,99289
141038200100000,NE 143,RESIDENTIAL,25088,0,25088,156573,0,181661
141038200200000,NE 143,RESIDENTIAL,24240,0,24240,72369,0,96609
141038200300000,NE 143,RESIDENTIAL,24240,0,24240,106339,0,130579
141038200400000,NE 143,RESIDENTIAL,24240,0,24240,121575,0,145815
141038200500000,NE 143,RESIDENTIAL,24590,0,24590,71658,0,96248
141038200600000,NE 143,RESIDENTIAL,25088,0,25088,73865,0,98953
141038200700000,NE 143,RESIDENTIAL,24240,0,24240,73419,0,97659
141038200800000,NE 143,RESIDENTIAL,24240,0,24240,69667,0,93907
141038200900000,NE 143,RESIDENTIAL,24240,0,24240,75338,0,99578
141038201000000,NE 143,RESIDENTIAL,24590,0,24590,102995,0,127585
141038201100000,NE 143,RESIDENTIAL,26193,0,26193,72915,0,99108
141038201200000,NE 143,RESIDENTIAL,24240,0,24240,124053,0,148293
141038201300000,NE 143,RESIDENTIAL,24240,0,24240,83395,0,107635
141038201400000,NE 143,RESIDENTIAL,24240,0,24240,90781,0,115021
141038201500000,NE 143,RESIDENTIAL,23432,0,23432,119734,0,143166
141038201600000,NE 143,RESIDENTIAL,26193,0,26193,98742,0,124935
141038201700000,NE 143,RESIDENTIAL,24240,0,24240,90072,0,114312
141038201800000,NE 143,RESIDENTIAL,24240,0,24240,121287,0,145527
141038201900000,NE 143,RESIDENTIAL,24240,0,24240,86040,0,110280
141038202000000,NE 143,RESIDENTIAL,23432,0,23432,92134,0,115566
141038300100000,NE 143,RESIDENTIAL,27196,0,27196,71772,0,98968
141038300200000,NE 143,RESIDENTIAL,25048,0,25048,102299,0,127347
141038300300000,NE 143,RESIDENTIAL,25048,0,25048,83688,0,108736
141038300400000,NE 143,RESIDENTIAL,24240,0,24240,74023,0,98263
141038300500000,NE 143,RESIDENTIAL,21008,0,21008,82537,0,103545
141038300600000,NE 143,RESIDENTIAL,25086,0,25086,74666,0,99752
141038300700000,NE 143,RESIDENTIAL,24240,0,24240,76606,0,100846
141038300800000,NE 143,RESIDENTIAL,24240,0,24240,89101,0,113341
141038300900000,NE 143,RESIDENTIAL,24240,0,24240,64153,0,88393
141038301000000,NE 143,RESIDENTIAL,24542,0,24542,82642,0,107184
141038301100000,NE 143,RESIDENTIAL,25086,0,25086,115109,0,140195
141038301200000,NE 143,RESIDENTIAL,28280,0,28280,122788,0,151068
141038301300000,NE 143,RESIDENTIAL,24240,0,24240,97351,0,121591
141038301400000,NE 143,RESIDENTIAL,28785,0,28785,123417,0,152202
141038301500000,NE 143,RESIDENTIAL,30046,0,30046,100642,0,130688
141038301600000,NE 143,RESIDENTIAL,26260,0,26260,128465,0,154725
141038301700000,NE 143,RESIDENTIAL,28280,0,28280,116591,0,144871
141038301800000,NE 143,RESIDENTIAL,24240,0,24240,110674,0,134914
141038301900000,NE 143,RESIDENTIAL,24799,0,24799,93499,0,118298
141038400100000,NE 143,RESIDENTIAL,25048,0,25048,114764,0,139812
141038400200000,NE 143,RESIDENTIAL,24240,0,24240,116868,0,141108
141038400300000,NE 143,RESIDENTIAL,24240,0,24240,107812,0,132052
141038400400000,NE 143,RESIDENTIAL,24240,0,24240,84791,0,109031
141038400500000,NE 143,RESIDENTIAL,24509,0,24509,86055,0,110564
141038400600000,NE 143,RESIDENTIAL,25048,0,25048,83256,0,108304
141038400700000,NE 143,RESIDENTIAL,24240,0,24240,69467,0,93707
141038400800000,NE 143,RESIDENTIAL,24240,0,24240,114746,0,138986
141038400900000,NE 143,RESIDENTIAL,24240,0,24240,82616,0,106856
141038401000000,NE 143,RESIDENTIAL,24509,0,24509,79946,0,104455
141038401100000,NE 143,RESIDENTIAL,23488,0,23488,89557,0,113045
141038401200000,NE 143,RESIDENTIAL,21816,0,21816,102768,0,124584
141038401300000,NE 143,RESIDENTIAL,21816,0,21816,100613,0,122429
141038401400000,NE 143,RESIDENTIAL,21816,0,21816,93468,0,115284
141038401500000,NE 143,RESIDENTIAL,21064,0,21064,109272,0,130336
141038401600000,NE 143,RESIDENTIAL,23488,0,23488,98702,0,122190
141038401700000,NE 143,RESIDENTIAL,21816,0,21816,117753,0,139569
141038401800000,NE 143,RESIDENTIAL,21816,0,21816,145499,0,167315
141038401900000,NE 143,RESIDENTIAL,21816,0,21816,133538,0,155354
141038402000000,NE 143,RESIDENTIAL,21064,0,21064,132843,0,153907
141038500100000,NE 143,RESIDENTIAL,25048,0,25048,87181,0,112229
141038500200000,NE 143,RESIDENTIAL,24240,0,24240,109815,0,134055
141038500300000,NE 143,RESIDENTIAL,27472,0,27472,115328,0,142800
141038500400000,NE 143,RESIDENTIAL,28280,0,28280,108718,0,136998
141038500500000,NE 143,RESIDENTIAL,28970,0,28970,147371,0,176341
141038500600000,NE 143,RESIDENTIAL,28280,0,28280,98823,0,127103
141038500700000,NE 143,RESIDENTIAL,24240,0,24240,94983,0,119223
141038500800000,NE 143,RESIDENTIAL,29088,0,29088,113471,0,142559
141038500900000,NE 143,RESIDENTIAL,24469,0,24469,116263,0,140732
141038501000000,NE 143,RESIDENTIAL,22567,0,22567,84117,0,106684
141038501100000,NE 143,RESIDENTIAL,21816,0,21816,74981,0,96797
141038501200000,NE 143,RESIDENTIAL,21816,0,21816,94313,0,116129
141038501300000,NE 143,RESIDENTIAL,21816,0,21816,88479,0,110295
141038501400000,NE 143,RESIDENTIAL,21983,0,21983,85670,0,107653
141038501500000,NE 143,RESIDENTIAL,22543,0,22543,81984,0,104527
141038501600000,NE 143,RESIDENTIAL,21816,0,21816,73907,0,95723
141038501700000,NE 143,RESIDENTIAL,21816,0,21816,80428,0,102244
141038501800000,NE 143,RESIDENTIAL,21816,0,21816,115734,0,137550
141038501900000,NE 143,RESIDENTIAL,22355,0,22355,83011,0,105366
141040100100000,NE 129,RESIDENTIAL,21353,0,21353,86846,0,108199
141040100200000,NE 129,RESIDENTIAL,40660,0,40660,76963,0,117623
141040100300000,NE 129,RESIDENTIAL,40660,0,40660,36027,0,76687
141040100400000,NE 129,RESIDENTIAL,21400,0,21400,48732,0,70132
141040100500000,NE 129,RESIDENTIAL,21400,0,21400,45092,0,66492
141040100600000,NE 129,RESIDENTIAL,21400,0,21400,56417,0,77817
141040100700000,NE 129,RESIDENTIAL,21400,0,21400,86536,0,107936
141040100800000,NE 129,RESIDENTIAL,23005,0,23005,56786,0,79791
141040100900000,NE 129,RESIDENTIAL,19795,0,19795,47725,0,67520
141040101000000,NE 129,RESIDENTIAL,21400,0,21400,72932,0,94332
141040101100000,NE 129,RESIDENTIAL,21400,0,21400,74099,0,95499
141040101200000,NE 129,RESIDENTIAL,32800,0,32800,56777,0,89577
141040101300000,NE 129,RESIDENTIAL,33763,0,33763,71055,0,104818
141040101400000,NE 129,RESIDENTIAL,32100,0,32100,49867,0,81967
141040101500000,NE 129,RESIDENTIAL,26750,0,26750,65522,0,92272
141040101600000,NE 129,RESIDENTIAL,26750,0,26750,87658,0,114408
141040101700000,NE 129,RESIDENTIAL,40660,0,40660,100491,0,141151
141040101800000,NE 129,RESIDENTIAL,21400,0,21400,60841,0,82241
141040101900000,NE 129,RESIDENTIAL,21400,0,21400,67113,0,88513
141040102000000,NE 129,RESIDENTIAL,21400,0,21400,63716,0,85116
141040102100000,NE 129,RESIDENTIAL,21400,0,21400,57503,0,78903
141040102200000,NE 129,RESIDENTIAL,22470,0,22470,67867,0,90337
141040102300000,NE 129,RESIDENTIAL,20330,0,20330,71961,0,92291
141040102400000,NE 129,RESIDENTIAL,32100,0,32100,71501,0,103601
141040102500000,CONVERSION,COMMERCIAL,0,11826,11826,0,56614,68440
141040102600000,NE 129,RESIDENTIAL,23715,0,23715,101176,0,124891
141040102700000,NE 129,RESIDENTIAL,19125,0,19125,85216,0,104341
141040102800000,NE 129,RESIDENTIAL,19710,0,19710,79845,0,99555
141040102900000,NE 129,RESIDENTIAL,19710,0,19710,50925,0,70635
141040200100000,NE 129,RESIDENTIAL,22950,0,22950,62885,0,85835
141040200200000,NE 129,RESIDENTIAL,21400,0,21400,71371,0,92771
141040200300000,NE 129,RESIDENTIAL,21400,0,21400,81069,0,102469
141040200400000,NE 129,RESIDENTIAL,32100,0,32100,81299,0,113399
141040200500000,NE 129,RESIDENTIAL,42800,0,42800,58197,0,100997
141040200600000,NE 129,RESIDENTIAL,32100,0,32100,109164,0,141264
141040200700000,NE 129,RESIDENTIAL,24250,0,24250,52219,0,76469
141040200800000,NE 129,RESIDENTIAL,24250,0,24250,54216,0,78466
141040200900000,NE 129,RESIDENTIAL,21250,0,21250,82307,0,103557
141040201000000,NE 129,RESIDENTIAL,21400,0,21400,53289,0,74689
141040201100000,NE 129,RESIDENTIAL,21400,0,21400,83307,0,104707
141040201200000,NE 129,RESIDENTIAL,40660,0,40660,75041,0,115701
141040201300000,NE 129,RESIDENTIAL,37450,0,37450,64519,0,101969
141040201400000,NE 129,RESIDENTIAL,43335,0,43335,111581,0,154916
141040201500000,NE 129,RESIDENTIAL,40660,0,40660,97407,0,138067
141040201600000,NE 129,RESIDENTIAL,40660,0,40660,102750,0,143410
141040201700000,NE 129,RESIDENTIAL,35600,0,35600,87163,0,122763
141040201800000,NE 129,RESIDENTIAL,27375,0,27375,78696,0,106071
141040201900000,NE 129,RESIDENTIAL,22950,0,22950,54220,0,77170
141040202000000,NE 129,RESIDENTIAL,22950,0,22950,56931,0,79881
141040202100000,NE 129,RESIDENTIAL,25500,0,25500,87460,0,112960
141040300100000,NE 129,RESIDENTIAL,30386,0,30386,90863,0,121249
141040300200000,NE 129,RESIDENTIAL,21400,0,21400,108390,0,129790
141040300300000,NE 129,RESIDENTIAL,21400,0,21400,104827,0,126227
141040300400000,NE 129,RESIDENTIAL,21400,0,21400,86355,0,107755
141040300500000,NE 129,RESIDENTIAL,21400,0,21400,76550,0,97950
141040300600000,NE 129,RESIDENTIAL,21400,0,21400,62626,0,84026
141040300700000,NE 129,RESIDENTIAL,21400,0,21400,59105,0,80505
141040300800000,NE 129,RESIDENTIAL,32100,0,32100,77270,0,109370
141040300900000,NE 129,RESIDENTIAL,26750,0,26750,55419,0,82169
141040301000000,NE 129,RESIDENTIAL,26750,0,26750,61426,0,88176
141040301100000,NE 129,RESIDENTIAL,26750,0,26750,86031,0,112781
141040301200000,NE 129,RESIDENTIAL,23500,0,23500,69344,0,92844
141040301300000,NE 129,RESIDENTIAL,28200,0,28200,69005,0,97205
141040301500000,NE 129,RESIDENTIAL,33200,0,33200,76120,0,109320
141040301600000,NE 129,RESIDENTIAL,28355,0,28355,79911,0,108266
141040301700000,NE 129,RESIDENTIAL,28890,0,28890,71710,0,100600
141040301800000,NE 129,RESIDENTIAL,28355,0,28355,66855,0,95210
141040301900000,NE 129,RESIDENTIAL,21400,0,21400,77067,0,98467
141040302000000,NE 129,RESIDENTIAL,21400,0,21400,82532,0,103932
141040302100000,NE 129,RESIDENTIAL,40660,0,40660,104364,0,145024
141040302200000,NE 129,RESIDENTIAL,21400,0,21400,67112,0,88512
141040302300000,NE 129,RESIDENTIAL,21400,0,21400,66045,0,87445
141040302400000,NE 129,RESIDENTIAL,40660,0,40660,92383,0,133043
141040302500000,NE 129,RESIDENTIAL,24638,0,24638,76348,0,100986
141040302600000,NE 129,RESIDENTIAL,36135,0,36135,87370,0,123505
141040302700000,NE 129,RESIDENTIAL,30386,0,30386,75252,0,105638
141040302900000,NE 129,RESIDENTIAL,50967,0,50967,74197,0,125164
141040400100000,NE 129,RESIDENTIAL,35600,0,35600,106615,0,142215
141040400200000,NE 129,RESIDENTIAL,21400,0,21400,52707,0,74107
141040400300000,NE 129,RESIDENTIAL,21400,0,21400,111930,0,133330
141040400400000,NE 129,RESIDENTIAL,22738,0,22738,66238,0,88976
141040400500000,NE 129,RESIDENTIAL,20063,0,20063,102092,0,122155
141040400600000,NE 129,RESIDENTIAL,40660,0,40660,81252,0,121912
141040400700000,NE 129,RESIDENTIAL,21400,0,21400,59342,0,80742
141040401000000,NE 129,RESIDENTIAL,21400,0,21400,44591,0,65991
141040401100000,NE 129,RESIDENTIAL,21400,0,21400,54773,0,76173
141040401200000,NE 129,RESIDENTIAL,21400,0,21400,67221,0,88621
141040401300000,NE 129,RESIDENTIAL,31025,0,31025,82589,0,113614
141040401400000,NE 129,RESIDENTIAL,34000,0,34000,76648,0,110648
141040401500000,NE 129,RESIDENTIAL,26750,0,26750,57195,0,83945
141040401600000,NE 129,RESIDENTIAL,26750,0,26750,64631,0,91381
141040401700000,NE 129,RESIDENTIAL,32100,0,32100,61768,0,93868
141040401800000,NE 129,RESIDENTIAL,21400,0,21400,86192,0,107592
141040401900000,NE 129,RESIDENTIAL,21400,0,21400,58337,0,79737
141040402000000,NE 129,RESIDENTIAL,21400,0,21400,63285,0,84685
141040402100000,NE 129,RESIDENTIAL,21400,0,21400,64982,0,86382
141040402200000,NE 129,RESIDENTIAL,40660,0,40660,79143,0,119803
141040402300000,NE 129,RESIDENTIAL,34000,0,34000,68645,0,102645
141040402500000,NE 129,RESIDENTIAL,32704,0,32704,103181,0,135885
141040402600000,NE 129,RESIDENTIAL,40660,0,40660,93238,0,133898
141040500100000,NE 129,RESIDENTIAL,34000,0,34000,67799,0,101799
141040500200000,NE 129,RESIDENTIAL,23850,0,23850,107751,0,131601
141040500300000,NE 129,RESIDENTIAL,18550,0,18550,83866,0,102416
141040500400000,NE 129,RESIDENTIAL,21200,0,21200,76631,0,97831
141040500500000,NE 129,RESIDENTIAL,21200,0,21200,76471,0,97671
141040500600000,NE 129,RESIDENTIAL,31800,0,31800,83576,0,115376
141040500700000,NE 129,RESIDENTIAL,42400,0,42400,78927,0,121327
141040500800000,NE 129,RESIDENTIAL,21200,0,21200,103789,0,124989
141040500900000,NE 129,RESIDENTIAL,31800,0,31800,80148,0,111948
141040501000000,NE 129,RESIDENTIAL,31800,0,31800,35794,0,67594
141040501100000,NE 129,RESIDENTIAL,40280,0,40280,86087,0,126367
141040501200000,NE 129,RESIDENTIAL,25440,0,25440,73486,0,98926
141040501300000,NE 129,RESIDENTIAL,25440,0,25440,69805,0,95245
141040501400000,NE 129,RESIDENTIAL,16960,0,16960,65840,0,82800
141040501500000,NE 129,RESIDENTIAL,16960,0,16960,64725,0,81685
141040501600000,NE 129,RESIDENTIAL,20352,0,20352,72121,0,92473
141040501700000,NE 129,RESIDENTIAL,30528,0,30528,103922,0,134450
141040501800000,NE 129,RESIDENTIAL,29680,0,29680,66370,0,96050
141040501900000,NE 129,RESIDENTIAL,21200,0,21200,80492,0,101692
141040502000000,NE 129,RESIDENTIAL,16960,0,16960,96971,0,113931
141040502100000,NE 129,RESIDENTIAL,33920,0,33920,105221,0,139141
141040502200000,NE 129,RESIDENTIAL,15680,0,15680,61106,0,76786
141040502300000,NE 129,RESIDENTIAL,15680,0,15680,79548,0,95228
141040502400000,NE 129,RESIDENTIAL,13140,0,13140,50898,0,64038
141040502500000,NE 129,RESIDENTIAL,26280,0,26280,69906,0,96186
141040600100000,NE 129,RESIDENTIAL,18600,0,18600,66588,0,85188
141040600200000,NE 129,RESIDENTIAL,18600,0,18600,65563,0,84163
141040600300000,NE 129,RESIDENTIAL,21200,0,21200,66249,0,87449
141040600400000,NE 129,RESIDENTIAL,21200,0,21200,67029,0,88229
141040600500000,NE 129,RESIDENTIAL,29150,0,29150,66200,0,95350
141040600600000,NE 129,RESIDENTIAL,23850,0,23850,9530,0,33380
141040600700000,NE 129,RESIDENTIAL,31800,0,31800,47573,0,79373
141040600800000,NE 129,RESIDENTIAL,40280,0,40280,108946,0,149226
141040600900000,NE 129,RESIDENTIAL,29150,0,29150,71252,0,100402
141040601000000,NE 129,RESIDENTIAL,27560,0,27560,79764,0,107324
141040601100000,NE 129,RESIDENTIAL,28090,0,28090,100423,0,128513
141040601200000,NE 129,RESIDENTIAL,33920,0,33920,42202,0,76122
141040601300000,NE 129,RESIDENTIAL,33920,0,33920,63442,0,97362
141040601400000,NE 129,RESIDENTIAL,33920,0,33920,95262,0,129182
141040601500000,NE 129,RESIDENTIAL,33920,0,33920,82062,0,115982
141040601600000,NE 129,RESIDENTIAL,33920,0,33920,93669,0,127589
141040601700000,NE 129,RESIDENTIAL,33920,0,33920,101515,0,135435
141040601800000,NE 129,RESIDENTIAL,25280,0,25280,69300,0,94580
141040601900000,NE 129,RESIDENTIAL,32850,0,32850,77081,0,109931
141040602000000,NE 129,RESIDENTIAL,21535,0,21535,53109,0,74644
141042600100000,NE 129,RESIDENTIAL,29200,0,29200,56776,0,85976
141042600200000,NE 129,RESIDENTIAL,40660,0,40660,95499,0,136159
141042600300000,NE 129,RESIDENTIAL,40660,0,40660,62099,0,102759
141042600400000,NE 129,RESIDENTIAL,28355,0,28355,114912,0,143267
141042600500000,NE 129,RESIDENTIAL,28355,0,28355,93967,0,122322
141042600600000,NE 129,RESIDENTIAL,28890,0,28890,62491,0,91381
141042600700000,NE 129,RESIDENTIAL,40660,0,40660,66145,0,106805
141042600800000,NE 129,RESIDENTIAL,40660,0,40660,70889,0,111549
141042600900000,NE 129,RESIDENTIAL,26750,0,26750,73048,0,99798
141042601000000,NE 129,RESIDENTIAL,29425,0,29425,64233,0,93658
141042601100000,NE 129,RESIDENTIAL,29425,0,29425,64118,0,93543
141042601200000,NE 129,RESIDENTIAL,34800,0,34800,57796,0,92596
141042601300000,NE 129,RESIDENTIAL,29200,0,29200,88611,0,117811
141042601400000,NE 129,RESIDENTIAL,38325,0,38325,53581,0,91906
141042700100000,NE 129,RESIDENTIAL,34000,0,34000,72894,0,106894
141042700200000,NE 129,RESIDENTIAL,40660,0,40660,42671,0,83331
141042700300000,NE 129,RESIDENTIAL,21400,0,21400,60414,0,81814
141042700400000,NE 129,RESIDENTIAL,21400,0,21400,58387,0,79787
141042700500000,NE 129,RESIDENTIAL,40660,0,40660,65837,0,106497
141042700600000,NE 129,RESIDENTIAL,40660,0,40660,82952,0,123612
141042700700000,HIGH TECH/RESEARCH,INDUSTRIAL,0,692300,692300,0,3434650,4126950
141042700800000,NE 129,RESIDENTIAL,21400,0,21400,31809,0,53209
141042700900000,NE 129,RESIDENTIAL,24075,0,24075,59408,0,83483
141042701000000,NE 129,RESIDENTIAL,40125,0,40125,96774,0,136899
141042701100000,NE 129,RESIDENTIAL,40660,0,40660,52672,0,93332
141042701200000,NE 129,RESIDENTIAL,34800,0,34800,86203,0,121003
141042701300000,NE 129,RESIDENTIAL,34800,0,34800,44842,0,79642
141042701400000,NE 129,RESIDENTIAL,40800,0,40800,77734,0,118534
141042701500000,NE 129,RESIDENTIAL,31025,0,31025,65593,0,96618
141042800100000,NE 129,RESIDENTIAL,34800,0,34800,78617,0,113417
141042800200000,NE 129,RESIDENTIAL,21200,0,21200,65657,0,86857
141042800300000,NE 129,RESIDENTIAL,21200,0,21200,60593,0,81793
141042800400000,NE 129,RESIDENTIAL,20140,0,20140,72993,0,93133
141042800500000,NE 129,RESIDENTIAL,22260,0,22260,94570,0,116830
141042800600000,NE 129,RESIDENTIAL,34450,0,34450,102777,0,137227
141042800700000,NE 129,RESIDENTIAL,37762,0,37762,86049,0,123811
141042800800000,NE 129,RESIDENTIAL,33920,0,33920,106648,0,140568
141042800900000,NE 129,RESIDENTIAL,33920,0,33920,72865,0,106785
141042801000000,NE 129,RESIDENTIAL,33920,0,33920,49340,0,83260
141042801100000,NE 129,RESIDENTIAL,16960,0,16960,57433,0,74393
141042801200000,NE 129,RESIDENTIAL,16960,0,16960,61604,0,78564
141042801300000,NE 129,RESIDENTIAL,27840,0,27840,75817,0,103657
141042801400000,NE 129,RESIDENTIAL,27375,0,27375,115008,0,142383
141042801500000,NE 129,RESIDENTIAL,27375,0,27375,79717,0,107092
141045100800000,NE 142,RESIDENTIAL,35628,0,35628,127647,0,163275
141045100900000,NE 142,RESIDENTIAL,30804,0,30804,126967,0,157771
141045101000000,NE 142,RESIDENTIAL,33413,0,33413,137857,0,171270
141045101100000,NE 142,RESIDENTIAL,33413,0,33413,135800,0,169213
141045101200000,NE 142,RESIDENTIAL,40095,0,40095,168101,0,208196
141045200100000,NE 142,RESIDENTIAL,19282,0,19282,107074,0,126356
141045200200000,NE 142,RESIDENTIAL,19824,0,19824,110089,0,129913
141045200300000,NE 142,RESIDENTIAL,29239,0,29239,112520,0,141759
141045200400000,NE 142,RESIDENTIAL,28200,0,28200,83506,0,111706
141045200500000,NE 142,RESIDENTIAL,28200,0,28200,103984,0,132184
141045200600000,NE 142,RESIDENTIAL,28500,0,28500,112823,0,141323
141045200700000,NE 142,RESIDENTIAL,28500,0,28500,94382,0,122882
141045200800000,NE 142,RESIDENTIAL,28800,0,28800,102362,0,131162
141045200900000,NE 142,RESIDENTIAL,28800,0,28800,92950,0,121750
141045201000000,NE 142,RESIDENTIAL,28800,0,28800,111311,0,140111
141045201100000,NE 142,RESIDENTIAL,33410,0,33410,143549,0,176959
141045201200000,NE 142,RESIDENTIAL,33060,0,33060,133171,0,166231
141045201300000,NE 142,RESIDENTIAL,30095,0,30095,131200,0,161295
141045201400000,NE 142,RESIDENTIAL,30869,0,30869,79939,0,110808
141045201500000,NE 142,RESIDENTIAL,28800,0,28800,87412,0,116212
141045201600000,NE 142,RESIDENTIAL,28800,0,28800,95112,0,123912
141045201700000,NE 142,RESIDENTIAL,28800,0,28800,88658,0,117458
141045201800000,NE 142,RESIDENTIAL,28500,0,28500,94586,0,123086
141045201900000,NE 142,RESIDENTIAL,27867,0,27867,106783,0,134650
141045300100000,NE 142,RESIDENTIAL,29824,0,29824,110460,0,140284
141045300200000,NE 142,RESIDENTIAL,29767,0,29767,108846,0,138613
141045300300000,NE 142,RESIDENTIAL,28500,0,28500,110430,0,138930
141045300400000,NE 142,RESIDENTIAL,28500,0,28500,121476,0,149976
141045300500000,NE 142,RESIDENTIAL,28500,0,28500,101548,0,130048
141045300600000,NE 142,RESIDENTIAL,28500,0,28500,115971,0,144471
141045300700000,NE 142,RESIDENTIAL,28500,0,28500,105994,0,134494
141045300800000,NE 142,RESIDENTIAL,26125,0,26125,126162,0,152287
141045300900000,NE 142,RESIDENTIAL,30875,0,30875,109208,0,140083
141045301000000,NE 142,RESIDENTIAL,22800,0,22800,84856,0,107656
141045301100000,NE 142,RESIDENTIAL,22800,0,22800,99927,0,122727
141045301200000,NE 142,RESIDENTIAL,22800,0,22800,99720,0,122520
141045301300000,NE 142,RESIDENTIAL,22800,0,22800,85097,0,107897
141045301400000,NE 142,RESIDENTIAL,28500,0,28500,112233,0,140733
141045301500000,NE 142,RESIDENTIAL,28500,0,28500,97378,0,125878
141045301600000,NE 142,RESIDENTIAL,28500,0,28500,76706,0,105206
141045301700000,NE 142,RESIDENTIAL,28500,0,28500,111691,0,140191
141045301800000,NE 142,RESIDENTIAL,28500,0,28500,108843,0,137343
141045301900000,NE 142,RESIDENTIAL,28500,0,28500,82633,0,111133
141045302000000,NE 142,RESIDENTIAL,28500,0,28500,97245,0,125745
141045400100000,NE 142,RESIDENTIAL,29718,0,29718,109768,0,139486
141045400200000,NE 142,RESIDENTIAL,33970,0,33970,115938,0,149908
141045400300000,NE 142,RESIDENTIAL,30300,0,30300,105263,0,135563
141045400400000,NE 142,RESIDENTIAL,30000,0,30000,118317,0,148317
141045400500000,NE 142,RESIDENTIAL,30000,0,30000,93581,0,123581
141045400600000,NE 142,RESIDENTIAL,29700,0,29700,85550,0,115250
141045400700000,NE 142,RESIDENTIAL,29700,0,29700,110593,0,140293
141045400800000,NE 142,RESIDENTIAL,29400,0,29400,78377,0,107777
141045400900000,NE 142,RESIDENTIAL,27053,0,27053,99054,0,126107
141045401000000,NE 142,RESIDENTIAL,23547,0,23547,109335,0,132882
141045401100000,NE 142,RESIDENTIAL,22800,0,22800,74530,0,97330
141045401200000,NE 142,RESIDENTIAL,22800,0,22800,77058,0,99858
141045401300000,NE 142,RESIDENTIAL,22800,0,22800,90236,0,113036
141045401400000,NE 142,RESIDENTIAL,28500,0,28500,84694,0,113194
141045401500000,NE 142,RESIDENTIAL,28500,0,28500,76132,0,104632
141045401600000,NE 142,RESIDENTIAL,28500,0,28500,80654,0,109154
141045401700000,NE 142,RESIDENTIAL,28500,0,28500,100657,0,129157
141045401800000,NE 142,RESIDENTIAL,28500,0,28500,91207,0,119707
141045401900000,NE 142,RESIDENTIAL,28500,0,28500,77367,0,105867
141045402000000,NE 142,RESIDENTIAL,28500,0,28500,118612,0,147112
141045500100000,NE 142,RESIDENTIAL,29816,0,29816,156160,0,185976
141045500200000,NE 142,RESIDENTIAL,30294,0,30294,168994,0,199288
141045500300000,NE 142,RESIDENTIAL,23760,0,23760,85831,0,109591
141045500400000,NE 142,RESIDENTIAL,27720,0,27720,123994,0,151714
141045500500000,NE 142,RESIDENTIAL,27720,0,27720,106037,0,133757
141045500600000,NE 142,RESIDENTIAL,27720,0,27720,108413,0,136133
141045500700000,NE 142,RESIDENTIAL,27720,0,27720,106036,0,133756
141045500800000,NE 142,RESIDENTIAL,23760,0,23760,113639,0,137399
141045500900000,NE 142,RESIDENTIAL,23760,0,23760,93039,0,116799
141045501000000,NE 142,RESIDENTIAL,23760,0,23760,85199,0,108959
141045501100000,NE 142,RESIDENTIAL,23760,0,23760,94058,0,117818
141045501200000,NE 142,RESIDENTIAL,28182,0,28182,105965,0,134147
141045501300000,NE 142,RESIDENTIAL,30805,0,30805,92946,0,123751
141045501400000,NE 142,RESIDENTIAL,29700,0,29700,81872,0,111572
141045501500000,NE 142,RESIDENTIAL,29700,0,29700,83370,0,113070
141045501600000,NE 142,RESIDENTIAL,29700,0,29700,108098,0,137798
141045501700000,NE 142,RESIDENTIAL,29700,0,29700,84616,0,114316
141045501800000,NE 142,RESIDENTIAL,34650,0,34650,94073,0,128723
141045501900000,NE 142,RESIDENTIAL,34650,0,34650,122237,0,156887
141045502000000,NE 142,RESIDENTIAL,34650,0,34650,91306,0,125956
141045502100000,NE 142,RESIDENTIAL,34650,0,34650,128396,0,163046
141045502200000,NE 142,RESIDENTIAL,29700,0,29700,96930,0,126630
141045502300000,NE 142,RESIDENTIAL,35640,0,35640,106006,0,141646
141045502400000,NE 142,RESIDENTIAL,38828,0,38828,161167,0,199995
141045600600000,NE 142,RESIDENTIAL,23640,0,23640,131003,0,154643
141045600700000,NE 142,RESIDENTIAL,28066,0,28066,116598,0,144664
141045600800000,NE 142,RESIDENTIAL,28066,0,28066,118076,0,146142
141045600900000,NE 142,RESIDENTIAL,26463,0,26463,108813,0,135276
141045601000000,NE 142,RESIDENTIAL,28868,0,28868,115868,0,144736
141045700100000,NE 142,RESIDENTIAL,38355,0,38355,190159,0,228514
141045700200000,NE 142,RESIDENTIAL,34650,0,34650,125005,0,159655
141045700300000,NE 142,RESIDENTIAL,35269,0,35269,152411,0,187680
141045700400000,NE 142,RESIDENTIAL,34650,0,34650,125773,0,160423
141045700500000,NE 142,RESIDENTIAL,29700,0,29700,94586,0,124286
141045700600000,NE 142,RESIDENTIAL,34650,0,34650,100973,0,135623
141045700700000,NE 142,RESIDENTIAL,34650,0,34650,105759,0,140409
141045700800000,NE 142,RESIDENTIAL,34650,0,34650,117387,0,152037
141045700900000,NE 142,RESIDENTIAL,29700,0,29700,107205,0,136905
141045701000000,NE 142,RESIDENTIAL,29700,0,29700,93677,0,123377
141045701100000,NE 142,RESIDENTIAL,26730,0,26730,82750,0,109480
141045701200000,NE 142,RESIDENTIAL,31565,0,31565,91678,0,123243
141045701300000,NE 142,RESIDENTIAL,32053,0,32053,111090,0,143143
141045701400000,NE 142,RESIDENTIAL,28868,0,28868,161606,0,190474
141045701500000,NE 142,RESIDENTIAL,26062,0,26062,87663,0,113725
141045701600000,NE 142,RESIDENTIAL,28066,0,28066,107069,0,135135
141045701700000,NE 142,RESIDENTIAL,28066,0,28066,89385,0,117451
141045701800000,NE 142,RESIDENTIAL,28066,0,28066,95355,0,123421
141045701900000,NE 142,RESIDENTIAL,28066,0,28066,96181,0,124247
141045702000000,NE 142,RESIDENTIAL,28568,0,28568,127928,0,156496
141045702100000,NE 142,RESIDENTIAL,30472,0,30472,117787,0,148259
141045702200000,NE 142,RESIDENTIAL,30673,0,30673,118845,0,149518
141045702300000,NE 142,RESIDENTIAL,30237,0,30237,107196,0,137433
141045800100000,NE 142,RESIDENTIAL,33413,0,33413,125391,0,158804
141045800200000,NE 142,RESIDENTIAL,33413,0,33413,112787,0,146200
141045800300000,NE 142,RESIDENTIAL,33413,0,33413,129742,0,163155
141045800400000,NE 142,RESIDENTIAL,33249,0,33249,121967,0,155216
141045800500000,NE 142,RESIDENTIAL,31197,0,31197,120106,0,151303
141047600100000,NE 141,RESIDENTIAL,15520,0,15520,52540,0,68060
141047600200000,NE 141,RESIDENTIAL,21600,0,21600,79073,0,100673
141047600300000,NE 141,RESIDENTIAL,21600,0,21600,107226,0,128826
141047600400000,NE 141,RESIDENTIAL,26190,0,26190,113463,0,139653
141047600500000,NE 141,RESIDENTIAL,26190,0,26190,89256,0,115446
141047600600000,NE 141,RESIDENTIAL,27511,0,27511,114766,0,142277
141047600700000,NE 141,RESIDENTIAL,24869,0,24869,55124,0,79993
141047700100000,NE 141,RESIDENTIAL,26190,0,26190,60283,0,86473
141047700200000,NE 141,RESIDENTIAL,15520,0,15520,62700,0,78220
141047700300000,NE 141,RESIDENTIAL,23400,0,23400,70564,0,93964
141047700400000,NE 141,RESIDENTIAL,19800,0,19800,93657,0,113457
141047700500000,NE 141,RESIDENTIAL,17460,0,17460,55317,0,72777
141047700600000,NE 141,RESIDENTIAL,17460,0,17460,43857,0,61317
141047700700000,NE 141,RESIDENTIAL,17460,0,17460,56527,0,73987
141047700800000,NE 141,RESIDENTIAL,26190,0,26190,69267,0,95457
141047700900000,NE 141,RESIDENTIAL,26190,0,26190,68493,0,94683
141047701000000,NE 141,RESIDENTIAL,17460,0,17460,59022,0,76482
141047701100000,NE 141,RESIDENTIAL,17460,0,17460,51777,0,69237
141047701200000,NE 141,RESIDENTIAL,17460,0,17460,58172,0,75632
141047701300000,NE 141,RESIDENTIAL,26190,0,26190,75354,0,101544
141047701400000,NE 141,RESIDENTIAL,26190,0,26190,71946,0,98136
141047701500000,NE 141,RESIDENTIAL,26190,0,26190,70728,0,96918
141047800100000,NE 141,RESIDENTIAL,24000,0,24000,98843,0,122843
141047800200000,NE 141,RESIDENTIAL,24000,0,24000,89846,0,113846
141047800300000,NE 141,RESIDENTIAL,28238,0,28238,90507,0,118745
141047800400000,NE 141,RESIDENTIAL,18987,0,18987,71062,0,90049
141047800500000,NE 141,RESIDENTIAL,22725,0,22725,46126,0,68851
141047800600000,NE 141,RESIDENTIAL,22725,0,22725,84099,0,106824
141047800700000,NE 141,RESIDENTIAL,22725,0,22725,81411,0,104136
141047800800000,NE 141,RESIDENTIAL,23407,0,23407,63984,0,87391
141047800900000,NE 141,RESIDENTIAL,26190,0,26190,54475,0,80665
141047801000000,NE 141,RESIDENTIAL,26190,0,26190,81265,0,107455
141047801100000,NE 141,RESIDENTIAL,26190,0,26190,98484,0,124674
141047801200000,NE 141,RESIDENTIAL,21825,0,21825,106998,0,128823
141047900100000,NE 141,RESIDENTIAL,22560,0,22560,82476,0,105036
141047900200000,NE 141,RESIDENTIAL,20680,0,20680,85953,0,106633
141047900300000,NE 141,RESIDENTIAL,21600,0,21600,57559,0,79159
141047900400000,NE 141,RESIDENTIAL,21600,0,21600,80538,0,102138
141047900500000,NE 141,RESIDENTIAL,21600,0,21600,78284,0,99884
141047900600000,NE 141,RESIDENTIAL,18630,0,18630,78433,0,97063
141047900700000,NE 141,RESIDENTIAL,17050,0,17050,74859,0,91909
141047900800000,NE 141,RESIDENTIAL,16650,0,16650,61014,0,77664
141048000700000,NE 142,RESIDENTIAL,37125,0,37125,173017,0,210142
141048000800000,NE 142,RESIDENTIAL,37125,0,37125,141493,0,178618
141048000900000,NE 142,RESIDENTIAL,33660,0,33660,155803,0,189463
141048001000000,NE 142,RESIDENTIAL,37531,0,37531,165350,0,202881
141048100100000,NE 141,RESIDENTIAL,16151,0,16151,56980,0,73131
141048100200000,NE 141,RESIDENTIAL,28984,0,28984,64648,0,93632
141048100300000,NE 141,RESIDENTIAL,22087,0,22087,83380,0,105467
141048100400000,NE 141,RESIDENTIAL,26190,0,26190,86170,0,112360
141048100500000,NE 141,RESIDENTIAL,26190,0,26190,77919,0,104109
141048100600000,NE 141,RESIDENTIAL,26190,0,26190,125871,0,152061
141048100700000,NE 141,RESIDENTIAL,26190,0,26190,75867,0,102057
141048200100000,NE 141,RESIDENTIAL,26190,0,26190,45661,0,71851
141048200200000,NE 141,RESIDENTIAL,17460,0,17460,67334,0,84794
141048200300000,NE 141,RESIDENTIAL,17460,0,17460,50780,0,68240
141048200400000,NE 141,RESIDENTIAL,17460,0,17460,48560,0,66020
141048200500000,NE 141,RESIDENTIAL,26190,0,26190,81596,0,107786
141048200600000,NE 141,RESIDENTIAL,26190,0,26190,64976,0,91166
141048200700000,NE 141,RESIDENTIAL,31428,0,31428,64539,0,95967
141048200800000,NE 141,RESIDENTIAL,26190,0,26190,89203,0,115393
141048200900000,NE 141,RESIDENTIAL,26190,0,26190,64749,0,90939
141048201000000,NE 141,RESIDENTIAL,26190,0,26190,48233,0,74423
141048201100000,NE 141,RESIDENTIAL,17460,0,17460,55096,0,72556
141048201200000,NE 141,RESIDENTIAL,15278,0,15278,48960,0,64238
141048201300000,NE 141,RESIDENTIAL,19643,0,19643,64206,0,83849
141048201400000,NE 141,RESIDENTIAL,26190,0,26190,114965,0,141155
141048201500000,NE 141,RESIDENTIAL,26190,0,26190,76626,0,102816
141048300100000,NE 141,RESIDENTIAL,26190,0,26190,89621,0,115811
141048300200000,NE 141,RESIDENTIAL,22500,0,22500,99459,0,121959
141048300300000,NE 141,RESIDENTIAL,22500,0,22500,72993,0,95493
141048300400000,NE 141,RESIDENTIAL,22500,0,22500,63550,0,86050
141048300500000,NE 141,RESIDENTIAL,22500,0,22500,86337,0,108837
141048300600000,NE 141,RESIDENTIAL,22500,0,22500,75718,0,98218
141048300700000,NE 141,RESIDENTIAL,22500,0,22500,94760,0,117260
141048300800000,NE 141,RESIDENTIAL,22500,0,22500,48456,0,70956
141048300900000,NE 141,RESIDENTIAL,16245,0,16245,48239,0,64484
141048301000000,NE 141,RESIDENTIAL,16245,0,16245,65955,0,82200
141048301100000,NE 141,RESIDENTIAL,26190,0,26190,73489,0,99679
141048301200000,NE 141,RESIDENTIAL,26190,0,26190,103211,0,129401
141048301300000,NE 141,RESIDENTIAL,26190,0,26190,88033,0,114223
141048301400000,NE 141,RESIDENTIAL,26190,0,26190,86884,0,113074
141048301500000,NE 141,RESIDENTIAL,26190,0,26190,61770,0,87960
141048301600000,NE 141,RESIDENTIAL,26190,0,26190,51809,0,77999
141048400100000,NE 141,RESIDENTIAL,21600,0,21600,85639,0,107239
141048400200000,NE 141,RESIDENTIAL,29160,0,29160,63504,0,92664
141048400300000,NE 141,RESIDENTIAL,29160,0,29160,93305,0,122465
141048400400000,NE 141,RESIDENTIAL,21600,0,21600,76365,0,97965
141048400500000,NE 141,RESIDENTIAL,21600,0,21600,92148,0,113748
141048400600000,NE 141,RESIDENTIAL,17280,0,17280,64615,0,81895
141048400700000,NE 141,RESIDENTIAL,17280,0,17280,79397,0,96677
141048400800000,NE 141,RESIDENTIAL,18187,0,18187,68073,0,86260
141048500100000,NE 141,RESIDENTIAL,14400,0,14400,0,0,14400
141048500200000,NE 141,RESIDENTIAL,14400,0,14400,9900,0,24300
141048500300000,FLAT PARKING,COMMERCIAL,0,32640,32640,0,24754,57394
141048600100000,NE 141,RESIDENTIAL,15520,0,15520,70569,0,86089
141048600200000,NE 141,RESIDENTIAL,26190,0,26190,105531,0,131721
141048600300000,NE 141,RESIDENTIAL,26190,0,26190,62278,0,88468
141048600400000,NE 141,RESIDENTIAL,26190,0,26190,97781,0,123971
141048600500000,CHURCH,EXEMPT,0,34992,34992,0,78679,113671
141048600600000,NE 141,RESIDENTIAL,24444,0,24444,80075,0,104519
141048600700000,NE 141,RESIDENTIAL,19400,0,19400,119770,0,139170
141048600800000,NE 141,RESIDENTIAL,15520,0,15520,53491,0,69011
141048600900000,NE 141,RESIDENTIAL,15520,0,15520,69122,0,84642
141048601000000,NE 141,RESIDENTIAL,15520,0,15520,63513,0,79033
141048601100000,NE 141,RESIDENTIAL,15520,0,15520,51464,0,66984
141048601200000,NE 141,RESIDENTIAL,15520,0,15520,64748,0,80268
141048700100000,NE 141,RESIDENTIAL,26190,0,26190,58772,0,84962
141048700200000,NE 141,RESIDENTIAL,21717,0,21717,73970,0,95687
141048700300000,NE 141,RESIDENTIAL,31559,0,31559,94191,0,125750
141048700400000,NE 141,RESIDENTIAL,22500,0,22500,86102,0,108602
141048700500000,NE 141,RESIDENTIAL,22500,0,22500,64445,0,86945
141048700600000,NE 141,RESIDENTIAL,22500,0,22500,75625,0,98125
141048700700000,NE 141,RESIDENTIAL,18000,0,18000,48514,0,66514
141048700800000,NE 141,RESIDENTIAL,16650,0,16650,48700,0,65350
141048700900000,NE 141,RESIDENTIAL,16470,0,16470,43400,0,59870
141048701000000,NE 141,RESIDENTIAL,26190,0,26190,62245,0,88435
141048701100000,NE 141,RESIDENTIAL,26190,0,26190,99371,0,125561
141048701200000,NE 141,RESIDENTIAL,26190,0,26190,62222,0,88412
141048701300000,NE 141,RESIDENTIAL,26190,0,26190,100122,0,126312
141048701400000,NE 141,RESIDENTIAL,26190,0,26190,66589,0,92779
141048800100000,NE 141,RESIDENTIAL,21600,0,21600,57984,0,79584
141048800200000,NE 141,RESIDENTIAL,21600,0,21600,83982,0,105582
141048800300000,NE 141,RESIDENTIAL,21600,0,21600,99311,0,120911
141048800400000,NE 141,RESIDENTIAL,21600,0,21600,80643,0,102243
141048800500000,NE 141,RESIDENTIAL,23328,0,23328,85794,0,109122
141048800600000,NE 141,RESIDENTIAL,27083,0,27083,135949,0,163032
141048900100000,NE 142,RESIDENTIAL,33135,0,33135,138884,0,172019
141048900200000,NE 142,RESIDENTIAL,32670,0,32670,146950,0,179620
141048900300000,NE 142,RESIDENTIAL,31742,0,31742,139675,0,171417
141048900400000,NE 142,RESIDENTIAL,33413,0,33413,127435,0,160848
141048900500000,NE 142,RESIDENTIAL,33413,0,33413,139344,0,172757
141048900600000,NE 142,RESIDENTIAL,26062,0,26062,120328,0,146390
141048900700000,NE 142,RESIDENTIAL,26062,0,26062,109378,0,135440
141048900800000,NE 142,RESIDENTIAL,28066,0,28066,82222,0,110288
141048900900000,NE 142,RESIDENTIAL,24759,0,24759,103720,0,128479
141048901000000,NE 142,RESIDENTIAL,26473,0,26473,97498,0,123971
141110100100000,NE 115,RESIDENTIAL,133420,0,133420,607187,0,740607
141110100200000,NE 115,RESIDENTIAL,110000,0,110000,202325,0,312325
141110100300000,NE 115,EXEMPT,0,295200,295200,0,0,295200
141110100400000,NE 115,RESIDENTIAL,30520,0,30520,0,0,30520
141110100500000,NE 115,RESIDENTIAL,122820,0,122820,445699,0,568519
141110100600000,NE 115,RESIDENTIAL,120800,0,120800,322617,0,443417
141110100700000,NE 115,RESIDENTIAL,102721,0,102721,272279,0,375000
141112800300000,APARTMENT,COMMERCIAL,0,20760,20760,0,138362,159122
141120100100000,AUTO REPAIR/SALES,COMMERCIAL,0,1593600,1593600,0,1776040,3369640
141120100200000,AUTO REPAIR/SALES,COMMERCIAL,0,48300,48300,0,90106,138406
141120100300000,APARTMENT,RESIDENTIAL,21600,0,21600,131370,0,152970
141120100400000,APARTMENT,COMMERCIAL,0,21600,21600,0,138926,160526
141120100500000,APARTMENT,COMMERCIAL,0,21600,21600,0,153143,174743
141120100600000,APARTMENT,RESIDENTIAL,21600,0,21600,96063,0,117663
141120100700000,APARTMENT,RESIDENTIAL,21520,0,21520,146359,0,167879
141120100800000,APARTMENT,RESIDENTIAL,21280,0,21280,141244,0,162524
141120100900000,APARTMENT,COMMERCIAL,0,21580,21580,0,138926,160506
141120200100000,OFFICE,COMMERCIAL,0,438000,438000,0,713279,1151279
141120200200000,APARTMENT,COMMERCIAL,0,96640,96640,0,328366,425006
141120200300000,BRANCH BANK/CU,COMMERCIAL,0,339332,339332,0,1181557,1520889
141120200400000,OFFICE,COMMERCIAL,0,168000,168000,0,441247,609247
141120300200000,APARTMENT,COMMERCIAL,0,25255,25255,0,168733,193988
141120300800000,APARTMENT,COMMERCIAL,0,23220,23220,0,155524,178744
141120400200000,SE 201,RESIDENTIAL,365,0,365,0,0,365
141120400400000,APARTMENT,EXEMPT,0,48546,48546,0,1292387,1340933
141120400600000,CENTRALLY ASSESSED,OTHER,0,0,0,0,0,0
141120400700000,RESTAURANT,COMMERCIAL,0,652000,652000,0,706930,1358930
141120400800000,AUTO REPAIR/SALES,COMMERCIAL,0,76230,76230,0,65953,142183
141120400900000,WAREHOUSE,COMMERCIAL,0,249900,249900,0,146167,396067
141120400902000,BILLBOARD(BLL),COMMERCIAL,0,0,0,0,23899,23899
141120401000000,SMALL RETAIL,COMMERCIAL,0,192000,192000,0,106331,298331
141120401100000,RESTAURANT,COMMERCIAL,0,147900,147900,0,221160,369060
141120401300000,WAREHOUSE,COMMERCIAL,0,207500,207500,0,369539,577039
141120401400000,VACANT LAND,COMMERCIAL,0,10109,10109,0,0,10109
141120401500000,AUTO REPAIR/SALES,COMMERCIAL,0,627000,627000,0,944909,1571909
141120401600000,CENTRALLY ASSESSED,OTHER,0,0,0,0,0,0
141120401700000,CENTRALLY ASSESSED,OTHER,0,0,0,0,0,0
141122600100000,NE 129,RESIDENTIAL,35580,0,35580,93750,0,129330
141122600200000,NE 129,RESIDENTIAL,35021,0,35021,112345,0,147366
141122600300000,NE 129,RESIDENTIAL,35021,0,35021,95992,0,131013
141122600400000,NE 129,RESIDENTIAL,35021,0,35021,103413,0,138434
141122600500000,NE 129,RESIDENTIAL,35021,0,35021,90775,0,125796
141122600600000,NE 129,RESIDENTIAL,35021,0,35021,110830,0,145851
141122600700000,NE 129,RESIDENTIAL,34543,0,34543,128737,0,163280
141122700100000,NE 129,RESIDENTIAL,41870,0,41870,80540,0,122410
141122700200000,NE 129,RESIDENTIAL,36288,0,36288,99537,0,135825
141122700300000,NE 129,RESIDENTIAL,36288,0,36288,33790,0,70078
141122700400000,NE 129,RESIDENTIAL,34020,0,34020,118559,0,152579
141122700500000,NE 129,RESIDENTIAL,37044,0,37044,101499,0,138543
141122700600000,NE 129,RESIDENTIAL,41580,0,41580,102155,0,143735
141122700700000,CHURCH,EXEMPT,0,243000,243000,0,1552277,1795277
141122700800000,NE 129,RESIDENTIAL,37791,0,37791,124084,0,161875
141122700900000,NE 129,RESIDENTIAL,34338,0,34338,107839,0,142177
141122701000000,NE 129,RESIDENTIAL,31539,0,31539,102982,0,134521
141122701100000,NE 129,RESIDENTIAL,31464,0,31464,80785,0,112249
141122701200000,NE 129,RESIDENTIAL,31464,0,31464,81084,0,112548
141122701300000,NE 129,RESIDENTIAL,31464,0,31464,102155,0,133619
141122701400000,NE 129,RESIDENTIAL,31637,0,31637,103529,0,135166
141122701500000,NE 129,RESIDENTIAL,29602,0,29602,88605,0,118207
141122701600000,NE 129,RESIDENTIAL,31464,0,31464,115720,0,147184
141122701700000,NE 129,RESIDENTIAL,32568,0,32568,108010,0,140578
141122701800000,NE 129,RESIDENTIAL,31176,0,31176,67803,0,98979
141122701900000,NE 129,RESIDENTIAL,32703,0,32703,110007,0,142710
141122702000000,NE 129,RESIDENTIAL,34312,0,34312,66796,0,101108
141122702100000,NE 129,RESIDENTIAL,34398,0,34398,108637,0,143035
141122800100000,AUTO REPAIR/SALES,COMMERCIAL,0,209109,209109,0,102260,311369
141122800200000,OFFICE,COMMERCIAL,0,56281,56281,0,372079,428360
141122800300000,NE 129,RESIDENTIAL,22320,0,22320,0,0,22320
141122800400000,NE 129,RESIDENTIAL,22320,0,22320,62341,0,84661
141122800500000,NE 129,RESIDENTIAL,22320,0,22320,51410,0,73730
141122800600000,NE 129,RESIDENTIAL,22320,0,22320,73828,0,96148
141122800700000,NE 129,RESIDENTIAL,26064,0,26064,129764,0,155828
141122800800000,NE 129,RESIDENTIAL,25920,0,25920,47639,0,73559
141122800900000,NE 129,RESIDENTIAL,25440,0,25440,43979,0,69419
141122801000000,NE 129,RESIDENTIAL,24480,0,24480,62785,0,87265
141122801100000,NE 129,RESIDENTIAL,24000,0,24000,49206,0,73206
141122801200000,NE 129,RESIDENTIAL,23280,0,23280,49705,0,72985
141122801300000,NE 129,RESIDENTIAL,23478,0,23478,73171,0,96649
141122801400000,NE 129,RESIDENTIAL,26092,0,26092,60844,0,86936
141122801500000,NE 129,RESIDENTIAL,27156,0,27156,78203,0,105359
141122801600000,NE 129,RESIDENTIAL,26786,0,26786,67425,0,94211
141122801700000,NE 129,RESIDENTIAL,25920,0,25920,56480,0,82400
141122801800000,NE 129,RESIDENTIAL,25920,0,25920,99418,0,125338
141122801900000,NE 129,RESIDENTIAL,25493,0,25493,62352,0,87845
141122802000000,NE 129,RESIDENTIAL,24939,0,24939,56627,0,81566
141122802100000,NE 129,RESIDENTIAL,26830,0,26830,67200,0,94030
141122802200000,NE 129,RESIDENTIAL,25682,0,25682,67993,0,93675
141122802300000,NE 129,RESIDENTIAL,26568,0,26568,61793,0,88361
141122802400000,NE 129,RESIDENTIAL,27132,0,27132,62789,0,89921
141122802500000,NE 129,RESIDENTIAL,26732,0,26732,67279,0,94011
141122802600000,NE 129,RESIDENTIAL,21870,0,21870,50992,0,72862
141122802700000,NE 129,RESIDENTIAL,22680,0,22680,71920,0,94600
141122802800000,NE 129,RESIDENTIAL,24300,0,24300,58706,0,83006
141122802900000,NE 129,RESIDENTIAL,29100,0,29100,72388,0,101488
141122803000000,NE 129,RESIDENTIAL,28687,0,28687,86585,0,115272
141122803100000,NE 129,RESIDENTIAL,26932,0,26932,66127,0,93059
141122803200000,NE 129,RESIDENTIAL,25680,0,25680,40869,0,66549
141122803300000,NE 129,RESIDENTIAL,25740,0,25740,50185,0,75925
141122803400000,OFFICE,COMMERCIAL,0,46953,46953,0,96824,143777
141122803500000,BARS/LOUNGE,COMMERCIAL,0,202200,202200,0,129630,331830
141122900100000,NE 130,RESIDENTIAL,18122,0,18122,105047,0,123169
141122900200000,NE 130,RESIDENTIAL,19392,0,19392,89258,0,108650
141122900300000,NE 130,RESIDENTIAL,19392,0,19392,86295,0,105687
141122900400000,NE 130,RESIDENTIAL,16766,0,16766,38625,0,55391
141122900500000,NE 130,RESIDENTIAL,15680,0,15680,103053,0,118733
141122900600000,NE 130,RESIDENTIAL,15680,0,15680,669,0,16349
141122900700000,NE 130,RESIDENTIAL,15680,0,15680,51686,0,67366
141122900800000,NE 130,RESIDENTIAL,15680,0,15680,82973,0,98653
141122900900000,NE 130,RESIDENTIAL,15680,0,15680,67197,0,82877
141122901000000,NE 130,RESIDENTIAL,15680,0,15680,79330,0,95010
141122901100000,NE 130,RESIDENTIAL,15680,0,15680,65167,0,80847
141122901300000,NE 130,RESIDENTIAL,23184,0,23184,93389,0,116573
141123000100000,NE 129,RESIDENTIAL,21973,0,21973,73222,0,95195
141123000200000,NE 129,RESIDENTIAL,27977,0,27977,69864,0,97841
141123000300000,NE 129,RESIDENTIAL,28013,0,28013,56100,0,84113
141123000400000,NE 129,RESIDENTIAL,28633,0,28633,82118,0,110751
141123000500000,NE 129,RESIDENTIAL,28917,0,28917,68082,0,96999
141123000600000,NE 129,RESIDENTIAL,29200,0,29200,60542,0,89742
141123000700000,NE 129,RESIDENTIAL,26932,0,26932,82964,0,109896
141123000800000,NE 129,RESIDENTIAL,28620,0,28620,50767,0,79387
141123000900000,NE 129,RESIDENTIAL,28697,0,28697,64497,0,93194
141123001000000,NE 129,RESIDENTIAL,27753,0,27753,66284,0,94037
141123001100000,NE 129,RESIDENTIAL,25088,0,25088,62909,0,87997
141123001200000,NE 129,RESIDENTIAL,26190,0,26190,59870,0,86060
141123001300000,NE 129,RESIDENTIAL,25920,0,25920,63082,0,89002
141123001400000,NE 129,RESIDENTIAL,21056,0,21056,41165,0,62221
141123001500000,NE 129,RESIDENTIAL,22320,0,22320,61466,0,83786
141123001600000,NE 129,RESIDENTIAL,22080,0,22080,58313,0,80393
141123001700000,NE 129,RESIDENTIAL,30301,0,30301,69318,0,99619
141123001800000,NE 129,RESIDENTIAL,25272,0,25272,59238,0,84510
141123001900000,NE 129,RESIDENTIAL,25038,0,25038,60103,0,85141
141123002000000,NE 129,RESIDENTIAL,24610,0,24610,52599,0,77209
141123002100000,NE 129,RESIDENTIAL,27510,0,27510,57314,0,84824
141123002200000,NE 129,RESIDENTIAL,28016,0,28016,46235,0,74251
141123002300000,NE 129,RESIDENTIAL,27744,0,27744,76878,0,104622
141123002400000,NE 129,RESIDENTIAL,27540,0,27540,73350,0,100890
141123002500000,NE 129,RESIDENTIAL,29750,0,29750,92259,0,122009
141123002600000,NE 129,RESIDENTIAL,30720,0,30720,81881,0,112601
141123002700000,NE 129,RESIDENTIAL,31480,0,31480,0,0,31480
141123002800000,NE 129,RESIDENTIAL,20747,0,20747,65368,0,86115
141123002900000,OFFICE,COMMERCIAL,0,52675,52675,0,53279,105954
141123100100000,OFFICE,COMMERCIAL,0,39419,39419,0,68054,107473
141123100200000,NE 129,RESIDENTIAL,21114,0,21114,74066,0,95180
141123100300000,NE 129,RESIDENTIAL,17712,0,17712,59540,0,77252
141123100400000,NE 129,RESIDENTIAL,26752,0,26752,56805,0,83557
141123100500000,NE 129,RESIDENTIAL,26642,0,26642,78910,0,105552
141123100600000,NE 129,RESIDENTIAL,27360,0,27360,71185,0,98545
141123100700000,NE 129,RESIDENTIAL,16008,0,16008,0,0,16008
141123100800000,NE 129,RESIDENTIAL,21484,0,21484,61966,0,83450
141123100900000,NE 129,RESIDENTIAL,21840,0,21840,52889,0,74729
141123101000000,NE 129,RESIDENTIAL,24660,0,24660,53725,0,78385
141123101100000,NE 129,RESIDENTIAL,28512,0,28512,55215,0,83727
141123101200000,NE 129,RESIDENTIAL,29434,0,29434,69740,0,99174
141123101300000,NE 129,RESIDENTIAL,26332,0,26332,45169,0,71501
141123101400000,NE 129,RESIDENTIAL,33581,0,33581,63317,0,96898
141123101500000,NE 129,RESIDENTIAL,24514,0,24514,49375,0,73889
141123101600000,NE 129,RESIDENTIAL,29135,0,29135,65072,0,94207
141123101700000,NE 129,RESIDENTIAL,30240,0,30240,88801,0,119041
141123101800000,NE 129,RESIDENTIAL,16200,0,16200,87279,0,103479
141123101900000,NE 129,RESIDENTIAL,20210,0,20210,97270,0,117480
141123102000000,NE 129,RESIDENTIAL,19800,0,19800,75109,0,94909
141123102100000,NE 129,RESIDENTIAL,19400,0,19400,61985,0,81385
141123102200000,NE 129,RESIDENTIAL,22500,0,22500,111568,0,134068
141123102300000,NE 129,RESIDENTIAL,25200,0,25200,106687,0,131887
141123102400000,NE 129,RESIDENTIAL,20250,0,20250,60745,0,80995
141123102500000,NE 129,RESIDENTIAL,19000,0,19000,62975,0,81975
141123102600000,NE 129,RESIDENTIAL,14371,0,14371,108884,0,123255
141123102700000,NE 129,RESIDENTIAL,23087,0,23087,74101,0,97188
141123102800000,NE 129,RESIDENTIAL,24750,0,24750,57944,0,82694
141123102900000,NE 129,RESIDENTIAL,21231,0,21231,59521,0,80752
141123103000000,OFFICE,COMMERCIAL,0,62608,62608,0,65895,128503
141123200100000,NE 130,RESIDENTIAL,15680,0,15680,63286,0,78966
141123200200000,NE 130,RESIDENTIAL,15680,0,15680,62172,0,77852
141123200300000,NE 130,RESIDENTIAL,20384,0,20384,104325,0,124709
141123200400000,NE 130,RESIDENTIAL,15680,0,15680,84862,0,100542
141123200500000,NE 130,RESIDENTIAL,15680,0,15680,77124,0,92804
141123200600000,NE 130,RESIDENTIAL,20384,0,20384,89381,0,109765
141123200700000,NE 130,RESIDENTIAL,18816,0,18816,63901,0,82717
141123200800000,NE 130,RESIDENTIAL,27885,0,27885,72144,0,100029
141123200900000,NE 130,RESIDENTIAL,24300,0,24300,81229,0,105529
141123201000000,NE 130,RESIDENTIAL,27641,0,27641,93225,0,120866
141123201100000,NE 130,RESIDENTIAL,27641,0,27641,98624,0,126265
141123201200000,NE 130,RESIDENTIAL,17640,0,17640,113004,0,130644
141123201300000,NE 130,RESIDENTIAL,19110,0,19110,74324,0,93434
141123201400000,NE 130,RESIDENTIAL,19110,0,19110,86044,0,105154
141123201500000,NE 130,RESIDENTIAL,15680,0,15680,41743,0,57423
141123201600000,NE 130,RESIDENTIAL,15680,0,15680,87201,0,102881
141123201700000,NE 130,RESIDENTIAL,15680,0,15680,72388,0,88068
141123300100000,RESTAURANT,COMMERCIAL,0,207712,207712,0,183629,391341
141125100100000,NBHD SHOPPING CENTER,COMMERCIAL,0,1125000,1125000,0,2425000,3550000
141125100200000,SMALL RETAIL,COMMERCIAL,0,59850,59850,0,98370,158220
141125100300000,FLAT PARKING,COMMERCIAL,0,50625,50625,0,23780,74405
141125100400000,LG DISCOUNT/RETAIL,COMMERCIAL,0,77028,77028,0,574542,651570
141125200100000,OFFICE; MEDICAL,COMMERCIAL,0,183070,183070,0,714490,897560
141125200200000,NE 129,RESIDENTIAL,24255,0,24255,96047,0,120302
141125200300000,NE 129,RESIDENTIAL,26250,0,26250,55072,0,81322
141125200400000,NE 129,RESIDENTIAL,26250,0,26250,58640,0,84890
141125200500000,NE 129,RESIDENTIAL,26250,0,26250,65900,0,92150
141125200600000,NE 129,RESIDENTIAL,26250,0,26250,79017,0,105267
141125200700000,NE 129,RESIDENTIAL,26250,0,26250,83459,0,109709
141125200800000,NE 129,RESIDENTIAL,26250,0,26250,108563,0,134813
141125200900000,NE 129,RESIDENTIAL,26250,0,26250,98598,0,124848
141125201000000,NE 129,RESIDENTIAL,26250,0,26250,83638,0,109888
141125201100000,NE 129,RESIDENTIAL,26250,0,26250,74327,0,100577
141125201200000,NE 129,RESIDENTIAL,26250,0,26250,75129,0,101379
141125201300000,NE 129,RESIDENTIAL,26250,0,26250,85996,0,112246
141125201400000,NE 129,RESIDENTIAL,26250,0,26250,78008,0,104258
141125201500000,NE 129,RESIDENTIAL,26250,0,26250,63288,0,89538
141125201600000,NE 129,RESIDENTIAL,25760,0,25760,72992,0,98752
141125201700000,NE 129,RESIDENTIAL,25047,0,25047,74011,0,99058
141125201800000,NE 129,RESIDENTIAL,22707,0,22707,71558,0,94265
141125201900000,NE 129,RESIDENTIAL,24012,0,24012,68700,0,92712
141125202000000,NE 129,RESIDENTIAL,26484,0,26484,76818,0,103302
141125202100000,NE 129,RESIDENTIAL,25300,0,25300,74387,0,99687
141125202200000,NE 129,RESIDENTIAL,26250,0,26250,80979,0,107229
141125202300000,NE 129,RESIDENTIAL,26250,0,26250,63230,0,89480
141125202400000,NE 129,RESIDENTIAL,26250,0,26250,73034,0,99284
141125202500000,NE 129,RESIDENTIAL,26250,0,26250,93310,0,119560
141125202600000,NE 129,RESIDENTIAL,26250,0,26250,81743,0,107993
141125202700000,NE 129,RESIDENTIAL,26250,0,26250,59825,0,86075
141125202800000,NE 129,RESIDENTIAL,26250,0,26250,134509,0,160759
141125202900000,NE 129,RESIDENTIAL,44625,0,44625,110233,0,154858
141125203000000,NE 129,RESIDENTIAL,42735,0,42735,96240,0,138975
141125203100000,NE 129,RESIDENTIAL,21368,0,21368,103805,0,125173
141125203200000,FLAT PARKING,COMMERCIAL,0,50142,50142,0,3600,53742
141125203300000,OFFICE,COMMERCIAL,0,48300,48300,0,138534,186834
141125203400000,SMALL RETAIL,COMMERCIAL,0,66938,66938,0,102066,169004
141125203500000,OFFICE,COMMERCIAL,0,70903,70903,0,133363,204266
141125300100000,CHURCH,EXEMPT,0,164700,164700,0,456418,621118
141125300200000,APARTMENT,COMMERCIAL,0,57840,57840,0,854759,912599
141125300300000,NE 129,RESIDENTIAL,26250,0,26250,81626,0,107876
141125300400000,NE 129,RESIDENTIAL,42000,0,42000,93069,0,135069
141125300500000,NE 129,RESIDENTIAL,42000,0,42000,74058,0,116058
141125300600000,NE 129,RESIDENTIAL,42000,0,42000,71766,0,113766
141125300700000,NE 129,RESIDENTIAL,42000,0,42000,78070,0,120070
141125300800000,NE 129,RESIDENTIAL,35600,0,35600,85213,0,120813
141125300900000,NE 129,RESIDENTIAL,21353,0,21353,77975,0,99328
141125301000000,NE 129,RESIDENTIAL,21353,0,21353,99353,0,120706
141125301100000,NE 129,RESIDENTIAL,24475,0,24475,63550,0,88025
141125301200000,NE 129,RESIDENTIAL,24475,0,24475,97552,0,122027
141125301300000,NE 129,RESIDENTIAL,6400,0,6400,0,0,6400
141125301400000,NE 129,RESIDENTIAL,22250,0,22250,97689,0,119939
141125301500000,NE 129,RESIDENTIAL,31500,0,31500,105242,0,136742
141125301600000,NE 129,RESIDENTIAL,44625,0,44625,139178,0,183803
141125301700000,NE 129,RESIDENTIAL,42000,0,42000,143702,0,185702
141125301800000,NE 129,RESIDENTIAL,42000,0,42000,150492,0,192492
141125301900000,APARTMENT,COMMERCIAL,0,25200,25200,0,134639,159839
141125302000000,CHURCH,EXEMPT,0,45360,45360,0,20370,65730
141125302100000,OFFICE,COMMERCIAL,0,169386,169386,0,738215,907601
141125302400000,CHURCH,EXEMPT,0,81518,81518,0,16234,97752
141125400100000,SE 201,RESIDENTIAL,10220,0,10220,90109,0,100329
141125400200000,SE 201,RESIDENTIAL,10220,0,10220,84919,0,95139
141125400300000,SE 201,RESIDENTIAL,8176,0,8176,60639,0,68815
141125400400000,AUTO REPAIR/SALES,COMMERCIAL,0,147000,147000,0,260679,407679
141125401000000,SE 201,RESIDENTIAL,10248,0,10248,68443,0,78691
141125401100000,SE 201,RESIDENTIAL,10931,0,10931,86679,0,97610
141125401200000,SE 201,RESIDENTIAL,10976,0,10976,83027,0,94003
141125401300000,SE 201,RESIDENTIAL,10976,0,10976,58694,0,69670
141125401400000,SE 201,RESIDENTIAL,10976,0,10976,54640,0,65616
141125401500000,SE 201,RESIDENTIAL,10976,0,10976,65954,0,76930
141125401600000,SE 201,RESIDENTIAL,10976,0,10976,73342,0,84318
141125401700000,SE 201,RESIDENTIAL,10976,0,10976,82723,0,93699
141125401800000,SE 201,RESIDENTIAL,10976,0,10976,74049,0,85025
141125401900000,SE 201,RESIDENTIAL,10976,0,10976,76151,0,87127
141125402000000,NBHD SHOPPING CENTER,COMMERCIAL,0,156800,156800,0,416463,573263
141125402100000,BRANCH BANK/CU,COMMERCIAL,0,184000,184000,0,664715,848715
141125500100000,BRANCH BANK/CU,COMMERCIAL,0,532000,532000,0,384938,916938
141125500200000,NE 129,RESIDENTIAL,36750,0,36750,105704,0,142454
141125500300000,NE 129,RESIDENTIAL,31500,0,31500,77901,0,109401
141125500400000,NE 129,RESIDENTIAL,26250,0,26250,105071,0,131321
141125500500000,NE 129,RESIDENTIAL,26250,0,26250,95592,0,121842
141125500600000,CONVERSION,COMMERCIAL,0,16330,16330,0,46802,63132
141125500700000,NE 129,RESIDENTIAL,42000,0,42000,83391,0,125391
141125500800000,NE 129,RESIDENTIAL,27825,0,27825,89302,0,117127
141125500900000,NE 129,RESIDENTIAL,28350,0,28350,80727,0,109077
141125501000000,NE 129,RESIDENTIAL,27825,0,27825,89121,0,116946
141125501100000,NE 129,RESIDENTIAL,21000,0,21000,58243,0,79243
141125501200000,NE 129,RESIDENTIAL,21000,0,21000,66327,0,87327
141125501300000,NE 129,RESIDENTIAL,18630,0,18630,76419,0,95049
141125501400000,NE 129,RESIDENTIAL,17280,0,17280,85340,0,102620
141125501500000,NE 129,RESIDENTIAL,26676,0,26676,66944,0,93620
141125501600000,NE 129,RESIDENTIAL,25380,0,25380,82268,0,107648
141125501700000,NE 129,RESIDENTIAL,18900,0,18900,42489,0,61389
141125501800000,NE 129,RESIDENTIAL,18900,0,18900,88071,0,106971
141125501900000,NE 129,RESIDENTIAL,28350,0,28350,87099,0,115449
141125502000000,NE 129,RESIDENTIAL,18900,0,18900,61473,0,80373
141125502100000,NE 129,RESIDENTIAL,26932,0,26932,77904,0,104836
141125502200000,NE 129,RESIDENTIAL,23625,0,23625,87284,0,110909
141125502300000,NE 129,RESIDENTIAL,21263,0,21263,65803,0,87066
141125502400000,NE 129,RESIDENTIAL,21263,0,21263,77480,0,98743
141125502500000,NE 129,RESIDENTIAL,16538,0,16538,71586,0,88124
141125502600000,NE 129,RESIDENTIAL,16538,0,16538,80436,0,96974
141127600200000,APARTMENT,RESIDENTIAL,28020,0,28020,110321,0,138341
141127600300000,SE 201,RESIDENTIAL,18200,0,18200,75774,0,93974
141127600400000,VACANT LAND,COMMERCIAL,0,963,963,0,0,963
141127600500000,VACANT LAND,COMMERCIAL,0,14465,14465,0,0,14465
141127600600000,SE 201,RESIDENTIAL,21029,0,21029,58922,0,79951
141127600700000,SE 201,RESIDENTIAL,14197,0,14197,45393,0,59590
141127600800000,SE 201,RESIDENTIAL,12619,0,12619,79912,0,92531
141127600900000,SE 201,RESIDENTIAL,12619,0,12619,67847,0,80466
141127601000000,SE 201,RESIDENTIAL,12619,0,12619,47740,0,60359
141127601100000,SE 201,RESIDENTIAL,12501,0,12501,74365,0,86866
141127601200000,SE 201,RESIDENTIAL,12501,0,12501,62727,0,75228
141127601300000,SE 201,RESIDENTIAL,12501,0,12501,70519,0,83020
141127601400000,SE 201,RESIDENTIAL,12674,0,12674,80459,0,93133
141127601700000,SE 201,RESIDENTIAL,19582,0,19582,109148,0,128730
141127601800000,SE 201,RESIDENTIAL,17371,0,17371,72837,0,90208
141127601900000,SE 201,RESIDENTIAL,15708,0,15708,75377,0,91085
141127602000000,SE 201,RESIDENTIAL,15708,0,15708,56782,0,72490
141127602100000,SE 201,RESIDENTIAL,15708,0,15708,75422,0,91130
141127602200000,SE 201,RESIDENTIAL,20189,0,20189,90372,0,110561
141127602400000,APARTMENT,RESIDENTIAL,495720,0,495720,4005364,0,4501084
141127602500000,SE 201,RESIDENTIAL,16786,0,16786,67357,0,84143
141127602600000,SE 201,RESIDENTIAL,17976,0,17976,57912,0,75888
141127602700000,SE 201,RESIDENTIAL,20016,0,20016,78927,0,98943
141127602800000,SE 201,RESIDENTIAL,22919,0,22919,71172,0,94091
141127602900000,SE 201,RESIDENTIAL,19474,0,19474,67553,0,87027
141127603000000,SE 201,RESIDENTIAL,16478,0,16478,61329,0,77807
141127603100000,SE 201,RESIDENTIAL,19474,0,19474,98231,0,117705
141127603200000,CITY PROPERTY,EXEMPT,0,0,0,0,0,0
141127603300000,SE 201,RESIDENTIAL,14351,0,14351,76250,0,90601
141127603400000,SE 201,RESIDENTIAL,18109,0,18109,114775,0,132884
141127603500000,VACANT LAND,COMMERCIAL,0,4340,4340,0,0,4340
141127603600000,APARTMENT,COMMERCIAL,0,389600,389600,0,2641935,3031535
141130100100000,SE 201,RESIDENTIAL,18278,0,18278,105423,0,123701
141130100200000,SE 201,RESIDENTIAL,18278,0,18278,122907,0,141185
141130100300000,SE 201,RESIDENTIAL,18278,0,18278,123004,0,141282
141130100400000,SE 201,RESIDENTIAL,18278,0,18278,78684,0,96962
141130100500000,SE 201,RESIDENTIAL,11424,0,11424,51405,0,62829
141130100600000,SE 201,RESIDENTIAL,11424,0,11424,35055,0,46479
141130100700000,SE 201,RESIDENTIAL,18278,0,18278,86620,0,104898
141130100800000,SE 201,RESIDENTIAL,18278,0,18278,89800,0,108078
141130100900000,SE 201,RESIDENTIAL,11424,0,11424,81283,0,92707
141130101000000,SE 201,RESIDENTIAL,11424,0,11424,57198,0,68622
141130101100000,SE 201,RESIDENTIAL,18278,0,18278,77025,0,95303
141130101200000,SE 201,RESIDENTIAL,18278,0,18278,75663,0,93941
141130101300000,SE 201,RESIDENTIAL,18278,0,18278,80720,0,98998
141130101400000,SE 201,RESIDENTIAL,18278,0,18278,44824,0,63102
141130101500000,SE 201,RESIDENTIAL,18278,0,18278,139162,0,157440
141130101600000,SE 201,RESIDENTIAL,19992,0,19992,93508,0,113500
141130101700000,SE 201,RESIDENTIAL,17136,0,17136,88706,0,105842
141130101800000,SE 201,RESIDENTIAL,18278,0,18278,62517,0,80795
141130101900000,SE 201,RESIDENTIAL,18278,0,18278,99957,0,118235
141130102000000,SE 201,RESIDENTIAL,18278,0,18278,103162,0,121440
141130102100000,SE 201,RESIDENTIAL,18278,0,18278,85078,0,103356
141130102200000,SE 201,RESIDENTIAL,18278,0,18278,57297,0,75575
141130102300000,SE 201,RESIDENTIAL,18278,0,18278,93209,0,111487
141130102400000,SE 201,RESIDENTIAL,19992,0,19992,98502,0,118494
141130102500000,SE 201,RESIDENTIAL,17136,0,17136,58682,0,75818
141130102600000,SE 201,RESIDENTIAL,14515,0,14515,79517,0,94032
141130102700000,SE 201,RESIDENTIAL,14308,0,14308,86554,0,100862
141130200100000,VACANT LAND,COMMERCIAL,0,16932,16932,0,0,16932
141130200300000,SE 201,RESIDENTIAL,17707,0,17707,108083,0,125790
141130200400000,SE 201,RESIDENTIAL,25133,0,25133,131629,0,156762
141130300100000,APARTMENT,RESIDENTIAL,27456,0,27456,228287,0,255743
141130300200000,SE 201,RESIDENTIAL,11878,0,11878,75906,0,87784
141130300300000,SE 201,RESIDENTIAL,11642,0,11642,79380,0,91022
141130300400000,SE 201,RESIDENTIAL,18816,0,18816,74599,0,93415
141130300500000,SE 201,RESIDENTIAL,17640,0,17640,72278,0,89918
141130300600000,SE 201,RESIDENTIAL,18816,0,18816,105258,0,124074
141130300700000,SE 201,RESIDENTIAL,11760,0,11760,47312,0,59072
141130300800000,SE 201,RESIDENTIAL,11760,0,11760,64232,0,75992
141130300900000,SE 201,RESIDENTIAL,18816,0,18816,57951,0,76767
141130301000000,SE 201,RESIDENTIAL,11760,0,11760,37790,0,49550
141130301100000,SE 201,RESIDENTIAL,11760,0,11760,57184,0,68944
141130301200000,SE 201,RESIDENTIAL,18816,0,18816,76600,0,95416
141130301300000,SE 201,RESIDENTIAL,18816,0,18816,90078,0,108894
141130301400000,SE 201,RESIDENTIAL,18816,0,18816,65193,0,84009
141130301500000,SE 201,RESIDENTIAL,18816,0,18816,78689,0,97505
141130301600000,WAREHOUSE,COMMERCIAL,0,141250,141250,0,246560,387810
141130301700000,WAREHOUSE,COMMERCIAL,0,63360,63360,0,225550,288910
141130301800000,WAREHOUSE,COMMERCIAL,0,230000,230000,0,419901,649901
141130400100000,VACANT LAND,COMMERCIAL,0,11424,11424,0,0,11424
141130400200000,WAREHOUSE,COMMERCIAL,0,76625,76625,0,117093,193718
141130400300000,APARTMENT,COMMERCIAL,0,17165,17165,0,121192,138357
141130400400000,CONVERSION,COMMERCIAL,0,3266,3266,0,120090,123356
141130400600000,VACANT LAND,COMMERCIAL,0,14076,14076,0,0,14076
141130500100000,CEMETERY,EXEMPT,0,0,0,0,0,0
141130500200000,CENTRALLY ASSESSED,OTHER,0,0,0,0,0,0
141130500300000,SHOP,COMMERCIAL,0,49633,49633,0,215557,265190
141130500400000,WAREHOUSE,COMMERCIAL,0,359000,359000,0,612161,971161
141130500500000,FLAT PARKING,COMMERCIAL,0,7861,7861,0,3600,11461
141130500600000,CITY PROPERTY,EXEMPT,0,0,0,0,0,0
141130500700000,CITY PROPERTY,EXEMPT,0,0,0,0,0,0
141130500800000,CITY PROPERTY,EXEMPT,0,0,0,0,0,0
141130500900000,SE 201,RESIDENTIAL,21571,0,21571,110395,0,131966
141132600100000,SE 201,RESIDENTIAL,11424,0,11424,61202,0,72626
141132600200000,SE 201,RESIDENTIAL,11424,0,11424,78020,0,89444
141132600300000,SE 201,RESIDENTIAL,11424,0,11424,53890,0,65314
141132600400000,SE 201,RESIDENTIAL,11424,0,11424,55473,0,66897
141132600500000,OFFICE; MEDICAL,EXEMPT,0,279288,279288,0,616419,895707
141132600600000,APARTMENT,COMMERCIAL,0,25353,25353,0,111657,137010
141132600700000,APARTMENT,COMMERCIAL,0,25110,25110,0,105273,130383
141132600800000,SE 201,RESIDENTIAL,11424,0,11424,53214,0,64638
141132601000000,SE 201,RESIDENTIAL,18278,0,18278,113705,0,131983
141132700100000,CONVENIENCE STORE,COMMERCIAL,0,381200,381200,0,541949,923149
141132700200000,NE 129,RESIDENTIAL,38520,0,38520,85172,0,123692
141132700300000,NE 129,RESIDENTIAL,38520,0,38520,87916,0,126436
141132700400000,NE 129,RESIDENTIAL,19260,0,19260,78626,0,97886
141132700500000,NE 129,RESIDENTIAL,19260,0,19260,88425,0,107685
141132700600000,NE 129,RESIDENTIAL,38520,0,38520,106989,0,145509
141132700700000,SCHOOL,EXEMPT,0,77220,77220,0,622797,700017
141132700800000,NE 129,RESIDENTIAL,24030,0,24030,73067,0,97097
141132700900000,NE 129,RESIDENTIAL,25380,0,25380,60450,0,85830
141132701000000,NE 129,RESIDENTIAL,21150,0,21150,74432,0,95582
141132701100000,NE 129,RESIDENTIAL,24075,0,24075,69637,0,93712
141132701200000,NE 129,RESIDENTIAL,24075,0,24075,97419,0,121494
141132701300000,NE 129,RESIDENTIAL,21150,0,21150,75557,0,96707
141132701400000,NE 129,RESIDENTIAL,24075,0,24075,63220,0,87295
141132701500000,NE 129,RESIDENTIAL,24075,0,24075,80875,0,104950
141132701600000,NE 129,RESIDENTIAL,24075,0,24075,77587,0,101662
141132701700000,NE 129,RESIDENTIAL,24075,0,24075,80579,0,104654
141132701800000,NE 129,RESIDENTIAL,24075,0,24075,61657,0,85732
141132701900000,NE 129,RESIDENTIAL,24075,0,24075,68874,0,92949
141132702000000,NE 129,RESIDENTIAL,18297,0,18297,67514,0,85811
141132702100000,CONVERSION,COMMERCIAL,0,12587,12587,0,96263,108850
141132702200000,NE 129,RESIDENTIAL,15991,0,15991,56970,0,72961
141132702300000,NE 129,RESIDENTIAL,14896,0,14896,69548,0,84444
141132702400000,VACANT LAND,COMMERCIAL,0,33396,33396,0,0,33396
141132702500000,CONVERSIONS; NON-APT,COMMERCIAL,0,91109,91109,0,88420,179529
141132800100000,SE 201,RESIDENTIAL,11536,0,11536,50813,0,62349
141132800200000,SE 201,RESIDENTIAL,17304,0,17304,97974,0,115278
141132800300000,SE 201,RESIDENTIAL,17304,0,17304,61165,0,78469
141132800400000,SE 201,RESIDENTIAL,11536,0,11536,61539,0,73075
141132800500000,SE 201,RESIDENTIAL,11536,0,11536,69733,0,81269
141132800600000,AUTO REPAIR/SALES,COMMERCIAL,0,100184,100184,0,62505,162689
141132800700000,BARS/LOUNGE,COMMERCIAL,0,71404,71404,0,58020,129424
141132800702000,BILLBOARD(BLL),COMMERCIAL,0,0,0,0,23967,23967
141132800800000,OFFICE; MEDICAL,COMMERCIAL,0,66976,66976,0,178755,245731
141132800900000,FAST FOOD,COMMERCIAL,0,90720,90720,0,163018,253738
141132801000000,SE 201,RESIDENTIAL,10304,0,10304,0,0,10304
141132801100000,SE 201,RESIDENTIAL,17976,0,17976,22650,0,40626
141132801200000,SE 201,RESIDENTIAL,17976,0,17976,34319,0,52295
141132801300000,SE 201,RESIDENTIAL,11984,0,11984,69699,0,81683
141132801400000,SE 201,RESIDENTIAL,11984,0,11984,72097,0,84081
141132801500000,SE 201,RESIDENTIAL,11984,0,11984,78495,0,90479
141132900100000,AUTO REPAIR/SALES,COMMERCIAL,0,44030,44030,0,43105,87135
141132900200000,SMALL RETAIL,COMMERCIAL,0,5180,5180,0,83002,88182
141132900300000,VACANT LAND,COMMERCIAL,0,1998,1998,0,0,1998
141132900400000,NE 129,RESIDENTIAL,18630,0,18630,77063,0,95693
141132900500000,NE 129,RESIDENTIAL,38520,0,38520,50158,0,88678
141132900600000,NE 129,RESIDENTIAL,38520,0,38520,104556,0,143076
141132900700000,NE 129,RESIDENTIAL,24075,0,24075,82014,0,106089
141132900800000,NE 129,RESIDENTIAL,24075,0,24075,53687,0,77762
141132901000000,NE 129,RESIDENTIAL,30977,0,30977,75917,0,106894
141132901100000,NE 129,RESIDENTIAL,38520,0,38520,124689,0,163209
141132901200000,NE 129,RESIDENTIAL,33120,0,33120,96301,0,129421
141132901300000,NE 129,RESIDENTIAL,22338,0,22338,62807,0,85145
141132901400000,NE 129,RESIDENTIAL,18068,0,18068,85736,0,103804
141132901500000,NE 129,RESIDENTIAL,34560,0,34560,66894,0,101454
141132901600000,NE 129,RESIDENTIAL,25520,0,25520,93437,0,118957
141132901800000,NE 129,RESIDENTIAL,19260,0,19260,72611,0,91871
141132901900000,NE 129,RESIDENTIAL,38520,0,38520,78125,0,116645
141132902000000,FLAT PARKING,EXEMPT,0,47952,47952,0,19116,67068
141132902100000,NE 129,RESIDENTIAL,27720,0,27720,81985,0,109705
141132902200000,CONVERSION,COMMERCIAL,0,12960,12960,0,65980,78940
141132902600000,RESTAURANT,COMMERCIAL,0,164654,164654,0,206150,370804
141132902602000,FAST FOOD,COMMERCIAL,0,0,0,0,48600,48600
141132902700000,NBHD SHOPPING CENTER,COMMERCIAL,0,240000,240000,0,552453,792453
141132902900000,NE 129,RESIDENTIAL,3555,0,3555,0,0,3555
141132903000000,CHURCH,EXEMPT,0,80500,80500,0,664050,744550
141133000100000,SE 201,RESIDENTIAL,17976,0,17976,26022,0,43998
141133000200000,FLAT PARKING,COMMERCIAL,0,69552,69552,0,1890,71442
141133000300000,FLAT PARKING,COMMERCIAL,0,69552,69552,0,1890,71442
141133000400000,WAREHOUSE,COMMERCIAL,0,50400,50400,0,5985,56385
141133000500000,SMALL RETAIL,COMMERCIAL,0,121380,121380,0,173561,294941
141133000600000,SMALL RETAIL,COMMERCIAL,0,117499,117499,0,185082,302581
141133000700000,SMALL RETAIL,COMMERCIAL,0,68278,68278,0,48608,116886
141133000800000,SMALL RETAIL,COMMERCIAL,0,94504,94504,0,95062,189566
141133000900000,BARS/LOUNGE,COMMERCIAL,0,42210,42210,0,184065,226275
141133001000000,BARS/LOUNGE,COMMERCIAL,0,42210,42210,0,128860,171070
141133001100000,SMALL RETAIL,COMMERCIAL,0,52440,52440,0,78856,131296
141133001200000,SMALL RETAIL,COMMERCIAL,0,19260,19260,0,129720,148980
141133001300000,SMALL RETAIL,COMMERCIAL,0,203750,203750,0,475194,678944
141133100100000,AUTO REPAIR/SALES,COMMERCIAL,0,55860,55860,0,125028,180888
141133100200000,VETERINARY CLINIC,COMMERCIAL,0,20790,20790,0,75995,96785
141133100300000,SMALL RETAIL,COMMERCIAL,0,13920,13920,0,107681,121601
141133100400000,NE 129,RESIDENTIAL,18428,0,18428,80947,0,99375
141133100500000,NE 129,RESIDENTIAL,18630,0,18630,66032,0,84662
141133100600000,NE 129,RESIDENTIAL,41004,0,41004,109209,0,150213
141133100700000,CONVERSION,COMMERCIAL,0,15293,15293,0,53663,68956
141133100800000,NE 129,RESIDENTIAL,17883,0,17883,76638,0,94521
141133100900000,NE 129,RESIDENTIAL,22896,0,22896,63503,0,86399
141133101000000,NE 129,RESIDENTIAL,24804,0,24804,119541,0,144345
141133101100000,NE 129,RESIDENTIAL,35775,0,35775,119739,0,155514
141133101200000,NE 129,RESIDENTIAL,39123,0,39123,88124,0,127247
141133101300000,NE 129,RESIDENTIAL,23490,0,23490,74827,0,98317
141133101400000,NE 129,RESIDENTIAL,20367,0,20367,78798,0,99165
141133101500000,NE 129,RESIDENTIAL,29440,0,29440,80881,0,110321
141133101900000,APARTMENT,COMMERCIAL,0,21960,21960,0,397357,419317
141133102000000,APARTMENT,COMMERCIAL,0,23940,23940,0,207337,231277
141133102100000,APARTMENT,COMMERCIAL,0,22860,22860,0,206679,229539
141133102200000,NE 129,RESIDENTIAL,20520,0,20520,77951,0,98471
141133102300000,NE 129,RESIDENTIAL,25080,0,25080,129649,0,154729
141133102400000,NE 129,RESIDENTIAL,22800,0,22800,87570,0,110370
141133102500000,APARTMENT,COMMERCIAL,0,46128,46128,0,422553,468681
141133102600000,FAST FOOD,COMMERCIAL,0,300800,300800,0,504593,805393
141133102700000,CARWASH,COMMERCIAL,0,92400,92400,0,234699,327099
141133102800000,FRATERNAL,EXEMPT,0,52618,52618,0,186342,238960
141135100100000,WAREHOUSE,COMMERCIAL,0,136250,136250,0,153314,289564
141135100200000,SMALL RETAIL,COMMERCIAL,0,150537,150537,0,210501,361038
141135100300000,OFFICE,COMMERCIAL,0,397067,397067,0,1001286,1398353
141135100400000,SMALL RETAIL,COMMERCIAL,0,98115,98115,0,253501,351616
141135200100000,CONVENIENCE STORE,COMMERCIAL,0,48000,48000,0,0,48000
141135200200000,CONVENIENCE STORE,COMMERCIAL,0,92000,92000,0,0,92000
141135200300000,CONVENIENCE STORE,COMMERCIAL,0,56000,56000,0,0,56000
141135200400000,NE 141,RESIDENTIAL,22000,0,22000,60827,0,82827
141135200500000,NE 141,RESIDENTIAL,22000,0,22000,70429,0,92429
141135200600000,NE 141,RESIDENTIAL,22000,0,22000,46253,0,68253
141135200700000,NE 141,RESIDENTIAL,22000,0,22000,81228,0,103228
141135200800000,NE 141,RESIDENTIAL,22000,0,22000,63104,0,85104
141135200900000,NE 141,RESIDENTIAL,22000,0,22000,60240,0,82240
141135201000000,NE 141,RESIDENTIAL,22000,0,22000,53507,0,75507
141135201100000,NE 141,RESIDENTIAL,22000,0,22000,77458,0,99458
141135201200000,APARTMENT,COMMERCIAL,0,13872,13872,0,114192,128064
141135201300000,APARTMENT,COMMERCIAL,0,14076,14076,0,134381,148457
141135201400000,APARTMENT,COMMERCIAL,0,23016,23016,0,348000,371016
141135201500000,APARTMENT,RESIDENTIAL,32364,0,32364,261443,0,293807
141135201600000,NE 141,RESIDENTIAL,24750,0,24750,52071,0,76821
141135201700000,NE 141,RESIDENTIAL,24750,0,24750,54844,0,79594
141135201800000,NE 141,RESIDENTIAL,24750,0,24750,78382,0,103132
141135201900000,NE 141,RESIDENTIAL,24750,0,24750,60986,0,85736
141135202000000,NE 141,RESIDENTIAL,24750,0,24750,66620,0,91370
141135202100000,NE 141,RESIDENTIAL,24750,0,24750,77664,0,102414
141135202400000,WAREHOUSE,COMMERCIAL,0,57600,57600,0,159172,216772
141135202500000,NE 141,RESIDENTIAL,17460,0,17460,77668,0,95128
141135202600000,NE 141,RESIDENTIAL,21825,0,21825,95285,0,117110
141135202700000,LAUNDROMAT/CLEANERS,COMMERCIAL,0,44100,44100,0,60984,105084
141135202800000,BARS/LOUNGE,COMMERCIAL,0,44100,44100,0,45256,89356
141135202802000,BILLBOARD(BLL),COMMERCIAL,0,0,0,0,19033,19033
141135202900000,CONVENIENCE STORE,COMMERCIAL,0,356000,356000,0,1006322,1362322
141135203000000,CONVENIENCE STORE,COMMERCIAL,0,124000,124000,0,0,124000
141135300100000,OFFICE,COMMERCIAL,0,152950,152950,0,244069,397019
141135300200000,WAREHOUSE,COMMERCIAL,0,139500,139500,0,967804,1107304
141135300300000,CITY PROPERTY,EXEMPT,0,0,0,0,0,0
141135300400000,SHOP,COMMERCIAL,0,15877,15877,0,52417,68294
141135300500000,CITY PROPERTY,EXEMPT,0,0,0,0,0,0
141135300600000,SMALL RETAIL,COMMERCIAL,0,23400,23400,0,101168,124568
141135300700000,SMALL RETAIL,COMMERCIAL,0,142120,142120,0,142430,284550
141135300800000,VACANT LAND,COMMERCIAL,0,472757,472757,0,0,472757
141135300900000,VACANT LAND,COMMERCIAL,0,11760,11760,0,0,11760
141135301000000,VACANT LAND,COMMERCIAL,0,14480,14480,0,0,14480
141135301100000,VACANT LAND,COMMERCIAL,0,8960,8960,0,0,8960
141135301102000,BILLBOARD(BLL),COMMERCIAL,0,0,0,0,21258,21258
141135301200000,WAREHOUSE,COMMERCIAL,0,484080,484080,0,1129235,1613315
141135301300000,VACANT LAND,COMMERCIAL,0,61440,61440,0,0,61440
141135400100000,WAREHOUSE,COMMERCIAL,0,31650,31650,0,152858,184508
141135400200000,WAREHOUSE,COMMERCIAL,0,25500,25500,0,160125,185625
141135400300000,SMALL RETAIL,COMMERCIAL,0,11880,11880,0,100053,111933
141135400400000,SE 201,RESIDENTIAL,5950,0,5950,26645,0,32595
141135400500000,SMALL RETAIL,COMMERCIAL,0,45360,45360,0,85863,131223
141135400600000,VACANT LAND,COMMERCIAL,0,45360,45360,0,100,45460
141135400700000,OFFICE,COMMERCIAL,0,18900,18900,0,95397,114297
141135400800000,WAREHOUSE,COMMERCIAL,0,30780,30780,0,54591,85371
141135400900000,PRINTING,INDUSTRIAL,0,41990,41990,0,176142,218132
141135401000000,SMALL RETAIL,COMMERCIAL,0,126540,126540,0,187161,313701
141137600100000,WAREHOUSE,EXEMPT,0,39690,39690,0,78046,117736
141137600200000,SE 201,RESIDENTIAL,14700,0,14700,48813,0,63513
141137600300000,CEMETERY,EXEMPT,0,0,0,0,0,0
141137600400000,CITY PROPERTY,EXEMPT,0,0,0,0,0,0
141137600500000,CITY PROPERTY,EXEMPT,0,0,0,0,0,0
141137600600000,CITY PROPERTY,EXEMPT,0,0,0,0,0,0
141137600700000,SE 201,RESIDENTIAL,14400,0,14400,69198,0,83598
141137600800000,SE 201,RESIDENTIAL,14400,0,14400,60978,0,75378
141137600900000,SE 201,RESIDENTIAL,14400,0,14400,53123,0,67523
141137601000000,SE 201,RESIDENTIAL,14400,0,14400,76753,0,91153
141137601100000,SE 201,RESIDENTIAL,14400,0,14400,49666,0,64066
141137601200000,SE 201,RESIDENTIAL,14400,0,14400,86745,0,101145
141137601300000,SE 201,RESIDENTIAL,14400,0,14400,80076,0,94476
141137601400000,SE 201,RESIDENTIAL,14400,0,14400,79383,0,93783
141137601500000,SE 201,RESIDENTIAL,18864,0,18864,34148,0,53012
141137601600000,SE 201,RESIDENTIAL,18405,0,18405,66742,0,85147
141137601700000,SE 201,RESIDENTIAL,16950,0,16950,77953,0,94903
141137700100000,SE 201,RESIDENTIAL,11979,0,11979,80433,0,92412
141137700200000,SE 201,RESIDENTIAL,12900,0,12900,53822,0,66722
141137700300000,SE 201,RESIDENTIAL,18648,0,18648,39154,0,57802
141137700600000,WAREHOUSE,INDUSTRIAL,0,1332500,1332500,0,6163171,7495671
141137701500000,SE 201,RESIDENTIAL,18934,0,18934,86997,0,105931
141137800100000,SE 201,RESIDENTIAL,10278,0,10278,23012,0,33290
141137800200000,SE 201,RESIDENTIAL,14118,0,14118,78449,0,92567
141137800300000,SE 201,RESIDENTIAL,14250,0,14250,39910,0,54160
141137800400000,SE 201,RESIDENTIAL,14400,0,14400,36855,0,51255
141137800500000,SE 201,RESIDENTIAL,14400,0,14400,57151,0,71551
141137800600000,SE 201,RESIDENTIAL,14400,0,14400,58712,0,73112
141137800700000,SE 201,RESIDENTIAL,14400,0,14400,33778,0,48178
141137800800000,SE 201,RESIDENTIAL,14400,0,14400,82661,0,97061
141137800900000,SE 201,RESIDENTIAL,15341,0,15341,71616,0,86957
141137801000000,SE 201,RESIDENTIAL,15501,0,15501,81986,0,97487
141137801100000,SE 201,RESIDENTIAL,9600,0,9600,35420,0,45020
141137801200000,SE 201,RESIDENTIAL,9600,0,9600,39292,0,48892
141137801300000,SE 201,RESIDENTIAL,16320,0,16320,43384,0,59704
141137801400000,SE 201,RESIDENTIAL,19844,0,19844,69895,0,89739
141137801500000,SE 201,RESIDENTIAL,9828,0,9828,0,0,9828
141137801600000,SE 201,RESIDENTIAL,10368,0,10368,84341,0,94709
141137801700000,SE 201,RESIDENTIAL,8820,0,8820,0,0,8820
141137801800000,SE 201,RESIDENTIAL,14550,0,14550,52093,0,66643
141137801900000,SE 201,RESIDENTIAL,14400,0,14400,93801,0,108201
141137802000000,SE 201,RESIDENTIAL,14400,0,14400,62646,0,77046
141137802100000,SE 201,RESIDENTIAL,14400,0,14400,35271,0,49671
141137802200000,SE 201,RESIDENTIAL,14400,0,14400,74379,0,88779
141137802300000,SE 201,RESIDENTIAL,14400,0,14400,69087,0,83487
141137802400000,SE 201,RESIDENTIAL,14400,0,14400,40962,0,55362
141137802500000,SE 201,RESIDENTIAL,14400,0,14400,70191,0,84591
141137802600000,SE 201,RESIDENTIAL,11808,0,11808,56880,0,68688
141137802700000,SE 201,RESIDENTIAL,16815,0,16815,21432,0,38247
141137802800000,SE 201,RESIDENTIAL,16405,0,16405,16742,0,33147
141137900100000,SE 201,RESIDENTIAL,14280,0,14280,66025,0,80305
141137900200000,SE 201,RESIDENTIAL,14400,0,14400,50094,0,64494
141137900300000,SE 201,RESIDENTIAL,14400,0,14400,55297,0,69697
141137900400000,SE 201,RESIDENTIAL,14400,0,14400,35181,0,49581
141137900500000,SE 201,RESIDENTIAL,14400,0,14400,66651,0,81051
141137900600000,SE 201,RESIDENTIAL,14400,0,14400,55014,0,69414
141137900700000,SE 201,RESIDENTIAL,14400,0,14400,90644,0,105044
141137900800000,SE 201,RESIDENTIAL,14400,0,14400,79360,0,93760
141137900900000,SE 201,RESIDENTIAL,14400,0,14400,51809,0,66209
141137901000000,SE 201,RESIDENTIAL,14400,0,14400,96875,0,111275
141137901100000,SE 201,RESIDENTIAL,14400,0,14400,82130,0,96530
141137901200000,SE 201,RESIDENTIAL,14400,0,14400,63755,0,78155
141137901300000,SE 201,RESIDENTIAL,14400,0,14400,45072,0,59472
141137901400000,SE 201,RESIDENTIAL,14400,0,14400,67566,0,81966
141137901500000,SE 201,RESIDENTIAL,14100,0,14100,36924,0,51024
141137901600000,SE 201,RESIDENTIAL,12750,0,12750,36454,0,49204
141137901700000,SE 201,RESIDENTIAL,8640,0,8640,44717,0,53357
141137901800000,SE 201,RESIDENTIAL,8640,0,8640,46368,0,55008
141137901900000,SE 201,RESIDENTIAL,8640,0,8640,42278,0,50918
141137902000000,SE 201,RESIDENTIAL,11383,0,11383,60586,0,71969
141137902100000,SE 201,RESIDENTIAL,8986,0,8986,31341,0,40327
141137902200000,SE 201,RESIDENTIAL,8040,0,8040,37907,0,45947
141137902300000,SE 201,RESIDENTIAL,17388,0,17388,0,0,17388
141137902400000,SE 201,RESIDENTIAL,13663,0,13663,106462,0,120125
141137902500000,SE 201,RESIDENTIAL,18137,0,18137,75481,0,93618
141137902600000,SE 201,RESIDENTIAL,22260,0,22260,84614,0,106874
141137902700000,SE 201,RESIDENTIAL,16854,0,16854,91346,0,108200
141137902800000,SE 201,RESIDENTIAL,12720,0,12720,64643,0,77363
141137902900000,SE 201,RESIDENTIAL,15900,0,15900,68547,0,84447
141137903000000,SE 201,RESIDENTIAL,18126,0,18126,61698,0,79824
141137903100000,SE 201,RESIDENTIAL,15821,0,15821,128094,0,143915
141137903200000,SE 201,RESIDENTIAL,15980,0,15980,52609,0,68589
141137903300000,SE 201,RESIDENTIAL,22260,0,22260,69501,0,91761
141137903400000,SE 201,RESIDENTIAL,16059,0,16059,57635,0,73694
141137903500000,SE 201,RESIDENTIAL,16059,0,16059,60030,0,76089
141137903600000,SE 201,RESIDENTIAL,16059,0,16059,71152,0,87211
141137903700000,SE 201,RESIDENTIAL,16059,0,16059,73933,0,89992
141137903800000,SE 201,RESIDENTIAL,19109,0,19109,76866,0,95975
141137903900000,SE 201,RESIDENTIAL,13134,0,13134,63689,0,76823
141137904000000,SE 201,RESIDENTIAL,13650,0,13650,55484,0,69134
141137904100000,SE 201,RESIDENTIAL,13361,0,13361,65229,0,78590
141137904200000,SE 201,RESIDENTIAL,15300,0,15300,89930,0,105230
141138000100000,APARTMENT,COMMERCIAL,0,53040,53040,0,320407,373447
141138000200000,SE 201,RESIDENTIAL,17955,0,17955,62953,0,80908
141138000300000,SE 201,RESIDENTIAL,17325,0,17325,92422,0,109747
141138000400000,SE 201,RESIDENTIAL,11970,0,11970,69125,0,81095
141138000500000,SE 201,RESIDENTIAL,20004,0,20004,80396,0,100400
141138000600000,SE 201,RESIDENTIAL,14489,0,14489,96672,0,111161
141138000700000,SE 201,RESIDENTIAL,14156,0,14156,89045,0,103201
141138000800000,SE 201,RESIDENTIAL,14339,0,14339,77798,0,92137
141138000900000,SE 201,RESIDENTIAL,18900,0,18900,84231,0,103131
141138001000000,APARTMENT,COMMERCIAL,0,17100,17100,0,218410,235510
141138001100000,SE 201,RESIDENTIAL,15600,0,15600,88333,0,103933
141138001200000,APARTMENT,RESIDENTIAL,47334,0,47334,513975,0,561309
141138001300000,SE 201,RESIDENTIAL,22048,0,22048,36075,0,58123
141138001400000,SE 201,RESIDENTIAL,20800,0,20800,49959,0,70759
141138001500000,SE 201,RESIDENTIAL,20800,0,20800,61358,0,82158
141138001700000,CITY PROPERTY,EXEMPT,0,0,0,0,0,0
141138001800000,CITY PROPERTY,EXEMPT,0,0,0,0,0,0
141138001900000,APARTMENT,RESIDENTIAL,82400,0,82400,861781,0,944181
141138100100000,SE 201,RESIDENTIAL,11700,0,11700,74543,0,86243
141138100200000,AUTO REPAIR/SALES,COMMERCIAL,0,51300,51300,0,216366,267666
141138100300000,SHOP,COMMERCIAL,0,28215,28215,0,163419,191634
141138100400000,WAREHOUSE,COMMERCIAL,0,46170,46170,0,203860,250030
141138100500000,VACANT LAND,COMMERCIAL,0,20520,20520,0,0,20520
141138100600000,WAREHOUSE,COMMERCIAL,0,172000,172000,0,724329,896329
141138100700000,OFFICE,COMMERCIAL,0,18240,18240,0,103000,121240
141138100800000,AUTO REPAIR/SALES,COMMERCIAL,0,21681,21681,0,66909,88590
141138100900000,APARTMENT,COMMERCIAL,0,38810,38810,0,282197,321007
141140200600000,SE 202,RESIDENTIAL,34578,0,34578,198552,0,233130
141142601200000,CEMETERY,EXEMPT,0,0,0,0,0,0
141142601300000,CEMETERY,EXEMPT,0,0,0,0,0,0
141145100100000,SE 202,RESIDENTIAL,37638,0,37638,69781,0,107419
141145100200000,SE 202,RESIDENTIAL,30240,0,30240,52880,0,83120
141145100300000,SE 202,RESIDENTIAL,30000,0,30000,93266,0,123266
141145100400000,SE 202,RESIDENTIAL,46390,0,46390,184133,0,230523
141145100500000,SE 202,RESIDENTIAL,38812,0,38812,119415,0,158227
141145100600000,SE 202,RESIDENTIAL,45575,0,45575,119058,0,164633
141145100700000,SE 202,RESIDENTIAL,45393,0,45393,140537,0,185930
141145100800000,SE 202,RESIDENTIAL,30895,0,30895,115393,0,146288
141145100900000,SE 202,RESIDENTIAL,29499,0,29499,94926,0,124425
141145101000000,SE 202,RESIDENTIAL,42322,0,42322,151821,0,194143
141145101100000,SE 202,RESIDENTIAL,23310,0,23310,119469,0,142779
141145101200000,SE 202,RESIDENTIAL,32400,0,32400,123725,0,156125
141145200100000,CEMETERY,EXEMPT,0,0,0,0,0,0
141145200200000,SE 202,RESIDENTIAL,35568,0,35568,76773,0,112341
141145200300000,SE 202,RESIDENTIAL,25536,0,25536,84063,0,109599
141145200400000,SE 202,RESIDENTIAL,25833,0,25833,109715,0,135548
141145200700000,SE 202,RESIDENTIAL,15840,0,15840,118462,0,134302
141145200800000,SE 202,RESIDENTIAL,25440,0,25440,121143,0,146583
141145300100000,SE 202,RESIDENTIAL,39991,0,39991,116690,0,156681
141145300500000,SE 202,RESIDENTIAL,20384,0,20384,142528,0,162912
141145300600000,SE 202,RESIDENTIAL,19260,0,19260,130720,0,149980
141145400100000,SE 202,RESIDENTIAL,16252,0,16252,0,0,16252
141145400200000,SE 202,RESIDENTIAL,11880,0,11880,62910,0,74790
141145500100000,SE 202,RESIDENTIAL,105200,0,105200,209217,0,314417
141145500200000,SE 257,RESIDENTIAL,46404,0,46404,372410,0,418814
141145500300000,SE 257,RESIDENTIAL,58114,0,58114,287662,0,345776
141145500400000,SE 257,RESIDENTIAL,110463,0,110463,297912,0,408375
141145500500000,SE 257,RESIDENTIAL,88574,0,88574,332941,0,421515
141145500600000,SE 257,RESIDENTIAL,81735,0,81735,333078,0,414813
141145500700000,SE 257,RESIDENTIAL,66202,0,66202,263482,0,329684
141145500800000,SE 257,RESIDENTIAL,67952,0,67952,257927,0,325879
141145600100000,SE 202,RESIDENTIAL,85902,0,85902,135589,0,221491
141145700100000,SE 202,RESIDENTIAL,16800,0,16800,0,0,16800
141145700200000,SE 202,RESIDENTIAL,23520,0,23520,137354,0,160874
141145700300000,SE 202,RESIDENTIAL,16800,0,16800,74489,0,91289
141145700400000,SE 202,RESIDENTIAL,31500,0,31500,66959,0,98459
141145700500000,SE 202,RESIDENTIAL,25200,0,25200,53657,0,78857
141145700600000,SE 202,RESIDENTIAL,17098,0,17098,83971,0,101069
141145700700000,CITY PROPERTY,EXEMPT,0,0,0,0,0,0
141147600100000,SE 202,RESIDENTIAL,6509,0,6509,62524,0,69033
141147600200000,SE 202,RESIDENTIAL,24000,0,24000,122592,0,146592
141147600300000,SE 202,RESIDENTIAL,24000,0,24000,100925,0,124925
141147600400000,SE 202,RESIDENTIAL,24480,0,24480,111160,0,135640
141147600500000,SE 202,RESIDENTIAL,24960,0,24960,101812,0,126772
141147600600000,SE 202,RESIDENTIAL,24960,0,24960,168165,0,193125
141147600700000,SE 202,RESIDENTIAL,30600,0,30600,110247,0,140847
141147600800000,SE 202,RESIDENTIAL,3905,0,3905,0,0,3905
141147600900000,SE 202,RESIDENTIAL,24000,0,24000,72415,0,96415
141147700100000,SE 202,RESIDENTIAL,12000,0,12000,117846,0,129846
141147700200000,SE 202,RESIDENTIAL,30600,0,30600,119465,0,150065
141147700300000,SE 202,RESIDENTIAL,32148,0,32148,182577,0,214725
141147700400000,SE 202,RESIDENTIAL,22464,0,22464,181791,0,204255
141147700500000,SE 202,RESIDENTIAL,23712,0,23712,242619,0,266331
141147700600000,SE 202,RESIDENTIAL,2033,0,2033,0,0,2033
141147800100000,SE 202,RESIDENTIAL,35139,0,35139,182098,0,217237
141147800200000,SE 202,RESIDENTIAL,18000,0,18000,80499,0,98499
141147800300000,SE 202,RESIDENTIAL,18000,0,18000,89899,0,107899
141147800400000,SE 202,RESIDENTIAL,24000,0,24000,95358,0,119358
141147800500000,SE 202,RESIDENTIAL,41730,0,41730,124672,0,166402
141147800600000,CENTRALLY ASSESSED,OTHER,0,0,0,0,0,0
141147800700000,CENTRALLY ASSESSED,OTHER,0,0,0,0,0,0
141147800800000,CENTRALLY ASSESSED,OTHER,0,0,0,0,0,0
141147900100000,SE 202,RESIDENTIAL,27183,0,27183,109256,0,136439
141147900200000,SE 202,RESIDENTIAL,15600,0,15600,84283,0,99883
141147900300000,SE 202,RESIDENTIAL,15600,0,15600,89511,0,105111
141147900400000,SE 202,RESIDENTIAL,24000,0,24000,117223,0,141223
141147900500000,SE 202,RESIDENTIAL,16800,0,16800,106261,0,123061
141147900600000,SE 202,RESIDENTIAL,16800,0,16800,0,0,16800
141147900700000,SE 202,RESIDENTIAL,28341,0,28341,65226,0,93567
141147900800000,SE 202,RESIDENTIAL,30994,0,30994,120968,0,151962
141147900900000,SE 202,RESIDENTIAL,18624,0,18624,63882,0,82506
141147901000000,SE 202,RESIDENTIAL,23280,0,23280,137390,0,160670
141147901100000,SE 202,RESIDENTIAL,9894,0,9894,0,0,9894
141147901200000,SE 202,RESIDENTIAL,19788,0,19788,102460,0,122248
141147901300000,SE 202,RESIDENTIAL,5202,0,5202,2118,0,7320
141147901400000,SE 202,RESIDENTIAL,24480,0,24480,126568,0,151048
141147901500000,SE 202,RESIDENTIAL,34473,0,34473,90437,0,124910
141147901600000,SE 202,RESIDENTIAL,16368,0,16368,131535,0,147903
141147901700000,SE 202,RESIDENTIAL,21756,0,21756,103046,0,124802
141147901800000,SE 202,RESIDENTIAL,25029,0,25029,77928,0,102957
141147901900000,SE 202,RESIDENTIAL,20800,0,20800,113389,0,134189
141147902000000,SE 202,RESIDENTIAL,16720,0,16720,55113,0,71833
141147902100000,SE 202,RESIDENTIAL,15828,0,15828,66002,0,81830
141147902200000,SE 202,RESIDENTIAL,7661,0,7661,0,0,7661
141147902300000,SE 202,RESIDENTIAL,4219,0,4219,0,0,4219
141147902400000,SE 202,RESIDENTIAL,8624,0,8624,0,0,8624
141147902500000,SE 202,RESIDENTIAL,4402,0,4402,0,0,4402
141147902600000,SE 202,RESIDENTIAL,8811,0,8811,142638,0,151449
141147903000000,SE 202,RESIDENTIAL,8323,0,8323,0,0,8323
141147903100000,SE 202,RESIDENTIAL,12441,0,12441,0,0,12441
141147903200000,SE 202,RESIDENTIAL,16965,0,16965,191099,0,208064
141147903400000,SE 202,RESIDENTIAL,3600,0,3600,0,0,3600
141147903500000,SE 202,RESIDENTIAL,3600,0,3600,0,0,3600
141147903600000,SE 202,RESIDENTIAL,23400,0,23400,50446,0,73846
141147903700000,SE 202,RESIDENTIAL,23478,0,23478,98468,0,121946
141148000100000,SE 202,RESIDENTIAL,28160,0,28160,125791,0,153951
141148000200000,SE 202,RESIDENTIAL,51271,0,51271,99224,0,150495
141148000300000,SE 202,RESIDENTIAL,39858,0,39858,162845,0,202703
141148000400000,SE 202,RESIDENTIAL,24480,0,24480,122055,0,146535
141148000500000,SE 202,RESIDENTIAL,15624,0,15624,0,0,15624
141148000600000,SE 202,RESIDENTIAL,29012,0,29012,108504,0,137516
141148100100000,SE 202,RESIDENTIAL,45650,0,45650,72947,0,118597
141148100200000,SE 257,RESIDENTIAL,40220,0,40220,288568,0,328788
141148100300000,SE 257,RESIDENTIAL,100280,0,100280,219037,0,319317
141148100400000,SE 257,RESIDENTIAL,20000,0,20000,0,0,20000
141148100600000,SE 257,RESIDENTIAL,103520,0,103520,371182,0,474702
141148100700000,SE 257,RESIDENTIAL,39196,0,39196,0,0,39196
141148100800000,SE 257,RESIDENTIAL,31038,0,31038,0,0,31038
141148100900000,SE 257,RESIDENTIAL,50797,0,50797,0,0,50797
141148101000000,SE 257,RESIDENTIAL,55345,0,55345,338505,0,393850
141148101100000,SE 257,RESIDENTIAL,71214,0,71214,268127,0,339341
141148101200000,SE 257,RESIDENTIAL,89081,0,89081,346201,0,435282
141148101300000,SE 257,RESIDENTIAL,93685,0,93685,319851,0,413536
141148101400000,SE 257,RESIDENTIAL,87664,0,87664,330333,0,417997
141148101500000,SE 257,RESIDENTIAL,84047,0,84047,273754,0,357801
141148101600000,SE 257,RESIDENTIAL,101214,0,101214,315780,0,416994
141148101700000,SE 257,RESIDENTIAL,77195,0,77195,220304,0,297499
141148101800000,SE 257,RESIDENTIAL,102566,0,102566,450279,0,552845
141148101900000,SE 257,RESIDENTIAL,39220,0,39220,261840,0,301060
141148102000000,SE 257,RESIDENTIAL,69370,0,69370,356728,0,426098
141148102100000,SE 257,RESIDENTIAL,60452,0,60452,267188,0,327640
141148102400000,SE 257,RESIDENTIAL,91260,0,91260,303052,0,394312
141148102500000,SE 257,RESIDENTIAL,47950,0,47950,0,0,47950
141148102600000,SE 257,RESIDENTIAL,45753,0,45753,314453,0,360206
141235100600000,SE 202,RESIDENTIAL,34704,0,34704,144716,0,179420
141235100800000,SE 202,RESIDENTIAL,28595,0,28595,138551,0,167146
141235100900000,SE 202,RESIDENTIAL,27692,0,27692,97086,0,124778
141235101000000,SE 202,RESIDENTIAL,43926,0,43926,161250,0,205176
141235200600000,SE 202,RESIDENTIAL,42405,0,42405,111858,0,154263
141235200700000,SE 202,RESIDENTIAL,42330,0,42330,126014,0,168344
141235200800000,SE 202,RESIDENTIAL,53550,0,53550,168691,0,222241
141235200900000,SE 202,RESIDENTIAL,74600,0,74600,133384,0,207984
141235201000000,SE 202,RESIDENTIAL,59940,0,59940,131600,0,191540
141322601500000,SE 202,RESIDENTIAL,159200,0,159200,492775,0,651975
141322601600000,SE 202,RESIDENTIAL,152900,0,152900,579723,0,732623
141330102100000,SE 211,RESIDENTIAL,100650,0,100650,223470,0,324120
141332600900000,CITY PROPERTY,EXEMPT,0,0,0,0,0,0
141332601000000,CHURCH,EXEMPT,0,389394,389394,0,2467650,2857044
141332601100000,CHURCH,EXEMPT,0,302400,302400,0,1719187,2021587
141335100100000,SE 211,RESIDENTIAL,49000,0,49000,0,0,49000
141335100200000,SE 211,RESIDENTIAL,48853,0,48853,318513,0,367366
141335100300000,SE 211,RESIDENTIAL,51362,0,51362,220698,0,272060
141335100400000,SE 211,RESIDENTIAL,6470,0,6470,0,0,6470
141335100500000,SE 211,RESIDENTIAL,64770,0,64770,402145,0,466915
141335100600000,SE 211,RESIDENTIAL,61958,0,61958,0,0,61958
141335100700000,SE 211,RESIDENTIAL,48853,0,48853,0,0,48853
141335100800000,SE 211,RESIDENTIAL,49000,0,49000,214460,0,263460
141335100900000,SE 211,RESIDENTIAL,59042,0,59042,151144,0,210186
141335101000000,SE 211,RESIDENTIAL,59051,0,59051,177566,0,236617
141335101100000,CHURCH,EXEMPT,0,139507,139507,0,413751,553258
141335101600000,SE 211,RESIDENTIAL,105150,0,105150,194445,0,299595
141335101800000,SE 211,RESIDENTIAL,99850,0,99850,329558,0,429408
141335101900000,SE 211,RESIDENTIAL,62417,0,62417,226779,0,289196
141335102000000,SE 211,RESIDENTIAL,145907,0,145907,238762,0,384669
141335102100000,SE 211,RESIDENTIAL,137679,0,137679,405308,0,542987
141335102200000,SE 211,RESIDENTIAL,141680,0,141680,288534,0,430214
141335102300000,SE 211,RESIDENTIAL,145288,0,145288,362507,0,507795
141335102400000,SE 211,RESIDENTIAL,136447,0,136447,313723,0,450170
141335102500000,SE 211,RESIDENTIAL,141781,0,141781,162064,0,303845
141335200100000,SE 211,RESIDENTIAL,55400,0,55400,148960,0,204360
141335200400000,SE 211,RESIDENTIAL,55400,0,55400,166113,0,221513
141335200500000,SE 211,RESIDENTIAL,58717,0,58717,175655,0,234372
141335200600000,SE 211,RESIDENTIAL,51400,0,51400,144666,0,196066
141335200700000,SE 211,RESIDENTIAL,59400,0,59400,160495,0,219895
141337600100000,SE 210,RESIDENTIAL,131200,0,131200,345379,0,476579
141337600200000,SE 210,RESIDENTIAL,100800,0,100800,74864,0,175664
141337600300000,SE 210,RESIDENTIAL,101500,0,101500,85019,0,186519
141337600500000,SE 210,RESIDENTIAL,198600,0,198600,646799,0,845399
141337600600000,SE 210,RESIDENTIAL,194529,0,194529,632471,0,827000
141337600700000,SE 210,RESIDENTIAL,192900,0,192900,571763,0,764663
141337601000000,SE 210,RESIDENTIAL,39235,0,39235,208121,0,247356
141337601100000,SE 210,RESIDENTIAL,38528,0,38528,220409,0,258937
141337601200000,SE 210,RESIDENTIAL,40637,0,40637,203354,0,243991
141337601300000,SE 210,RESIDENTIAL,42299,0,42299,216594,0,258893
141337601400000,SE 210,RESIDENTIAL,43353,0,43353,202289,0,245642
141337601500000,SE 210,RESIDENTIAL,44965,0,44965,228040,0,273005
141337601600000,SE 210,RESIDENTIAL,39350,0,39350,175303,0,214653
141337601700000,SE 210,RESIDENTIAL,43697,0,43697,256322,0,300019
141337601800000,SE 210,RESIDENTIAL,45711,0,45711,219369,0,265080
141337601900000,SE 210,RESIDENTIAL,40534,0,40534,224878,0,265412
141337602000000,CITY PROPERTY,EXEMPT,0,0,0,0,0,0
141337602100000,CITY PROPERTY,EXEMPT,0,0,0,0,0,0
141337700100000,SE 210,RESIDENTIAL,37892,0,37892,184576,0,222468
141337700200000,SE 210,RESIDENTIAL,35998,0,35998,187018,0,223016
141337700300000,SE 210,RESIDENTIAL,35864,0,35864,181165,0,217029
141337700400000,SE 210,RESIDENTIAL,38745,0,38745,204482,0,243227
141337700500000,SE 210,RESIDENTIAL,41944,0,41944,176914,0,218858
141337700600000,SE 210,RESIDENTIAL,44356,0,44356,229120,0,273476
141340100300000,SE 244,RESIDENTIAL,5900,0,5900,0,0,5900
141340200300000,SE 209,RESIDENTIAL,94870,0,94870,195525,0,290395
141340200400000,SE 209,RESIDENTIAL,94420,0,94420,310545,0,404965
141345100100000,SE 209,RESIDENTIAL,58077,0,58077,135623,0,193700
141345100200000,SE 209,RESIDENTIAL,59430,0,59430,156877,0,216307
141345100300000,SE 209,RESIDENTIAL,81515,0,81515,149997,0,231512
141345100500000,SE 209,RESIDENTIAL,84567,0,84567,158416,0,242983
141345100600000,SE 209,RESIDENTIAL,90050,0,90050,130885,0,220935
141345100700000,SE 209,RESIDENTIAL,84908,0,84908,137054,0,221962
141345100800000,SE 209,RESIDENTIAL,56500,0,56500,128790,0,185290
141345100900000,SE 209,RESIDENTIAL,56500,0,56500,150644,0,207144
141345101000000,SE 209,RESIDENTIAL,56501,0,56501,127864,0,184365
141345101100000,SE 209,RESIDENTIAL,47999,0,47999,116573,0,164572
141345101200000,SE 209,RESIDENTIAL,47999,0,47999,132256,0,180255
141345101300000,SE 209,RESIDENTIAL,54500,0,54500,127749,0,182249
141345200100000,SE 209,RESIDENTIAL,45282,0,45282,157890,0,203172
141345200200000,SE 209,RESIDENTIAL,42000,0,42000,140075,0,182075
141345200300000,SE 209,RESIDENTIAL,42000,0,42000,134585,0,176585
141345200400000,SE 209,RESIDENTIAL,42501,0,42501,162009,0,204510
141345200500000,SE 209,RESIDENTIAL,40500,0,40500,109586,0,150086
141345200600000,SE 209,RESIDENTIAL,40000,0,40000,105858,0,145858
141345200700000,SE 209,RESIDENTIAL,39999,0,39999,122272,0,162271
141345200800000,SE 209,RESIDENTIAL,44467,0,44467,101767,0,146234
141345300100000,SE 209,RESIDENTIAL,62900,0,62900,165502,0,228402
141345300200000,SE 209,RESIDENTIAL,82694,0,82694,195067,0,277761
141345300300000,SE 209,RESIDENTIAL,65119,0,65119,163169,0,228288
141345300400000,SE 209,RESIDENTIAL,67833,0,67833,135029,0,202862
141345300500000,SE 209,RESIDENTIAL,64301,0,64301,119161,0,183462
141345300600000,SE 209,RESIDENTIAL,65625,0,65625,163776,0,229401
141345300700000,SE 209,RESIDENTIAL,67679,0,67679,165816,0,233495
141345300800000,SE 209,RESIDENTIAL,63599,0,63599,182031,0,245630
141345300900000,SE 209,RESIDENTIAL,64473,0,64473,172223,0,236696
141345301000000,SE 209,RESIDENTIAL,61997,0,61997,114209,0,176206
141345301100000,SE 209,RESIDENTIAL,49854,0,49854,160312,0,210166
141345301200000,SE 209,RESIDENTIAL,52155,0,52155,151917,0,204072
141345301300000,SE 209,RESIDENTIAL,37270,0,37270,184041,0,221311
141345301400000,SE 209,RESIDENTIAL,42004,0,42004,139394,0,181398
141345301500000,SE 209,RESIDENTIAL,42677,0,42677,186764,0,229441
141345301600000,SE 209,RESIDENTIAL,41638,0,41638,159132,0,200770
141345301700000,SE 209,RESIDENTIAL,41149,0,41149,131469,0,172618
141345301800000,SE 209,RESIDENTIAL,42613,0,42613,139399,0,182012
141345301900000,SE 209,RESIDENTIAL,45210,0,45210,182564,0,227774
141345302000000,SE 209,RESIDENTIAL,45451,0,45451,160128,0,205579
141345302100000,SE 209,RESIDENTIAL,41035,0,41035,127233,0,168268
141345302200000,SE 209,RESIDENTIAL,38962,0,38962,122401,0,161363
141345302300000,SE 209,RESIDENTIAL,38950,0,38950,147660,0,186610
141345302400000,SE 209,RESIDENTIAL,42450,0,42450,138260,0,180710
141345302500000,SE 209,RESIDENTIAL,48925,0,48925,154065,0,202990
141345302600000,SE 209,RESIDENTIAL,38442,0,38442,146545,0,184987
141345302700000,SE 209,RESIDENTIAL,39527,0,39527,124976,0,164503
141345302800000,SE 209,RESIDENTIAL,41410,0,41410,141981,0,183391
141345302900000,SE 209,RESIDENTIAL,41650,0,41650,145916,0,187566
141345303000000,SE 209,RESIDENTIAL,43262,0,43262,127121,0,170383
141345303100000,SE 209,RESIDENTIAL,40999,0,40999,166353,0,207352
141345303200000,SE 209,RESIDENTIAL,45933,0,45933,173876,0,219809
141345303300000,SE 209,RESIDENTIAL,49300,0,49300,185575,0,234875
141345303400000,SE 209,RESIDENTIAL,44083,0,44083,159848,0,203931
141345303500000,SE 209,RESIDENTIAL,58672,0,58672,187394,0,246066
141345303600000,SE 209,RESIDENTIAL,56990,0,56990,167433,0,224423
141345303700000,SE 209,RESIDENTIAL,59274,0,59274,200182,0,259456
141345400100000,CITY PROPERTY,EXEMPT,0,0,0,0,0,0
141347700100000,SE 209,RESIDENTIAL,88766,0,88766,121989,0,210755
141347700200000,SE 209,RESIDENTIAL,81822,0,81822,198664,0,280486
141347700300000,SE 209,RESIDENTIAL,90000,0,90000,81120,0,171120
141347700400000,SE 209,RESIDENTIAL,91300,0,91300,109197,0,200497
141347700500000,SE 209,RESIDENTIAL,90800,0,90800,138536,0,229336
141347700600000,SE 209,RESIDENTIAL,84612,0,84612,137879,0,222491
141347700700000,SE 209,RESIDENTIAL,58036,0,58036,152821,0,210857
141347700800000,SE 209,RESIDENTIAL,90005,0,90005,176691,0,266696
141347700900000,SE 209,RESIDENTIAL,90050,0,90050,125791,0,215841
141347701000000,SE 209,RESIDENTIAL,90800,0,90800,154375,0,245175
141347701100000,SE 209,RESIDENTIAL,91050,0,91050,187395,0,278445
141347701200000,SE 209,RESIDENTIAL,73445,0,73445,116414,0,189859
141347701300000,SE 209,RESIDENTIAL,68413,0,68413,120820,0,189233
141347701400000,SE 209,RESIDENTIAL,61415,0,61415,135354,0,196769
141347701500000,SE 209,RESIDENTIAL,68425,0,68425,153743,0,222168
141347701600000,SE 209,RESIDENTIAL,82331,0,82331,99130,0,181461
141347701700000,SE 209,RESIDENTIAL,90150,0,90150,119739,0,209889
141347701800000,SE 209,RESIDENTIAL,90399,0,90399,165621,0,256020
141347701900000,SE 209,RESIDENTIAL,96350,0,96350,229518,0,325868
141347702000000,SE 209,RESIDENTIAL,54385,0,54385,100026,0,154411
141347800100000,SE 209,RESIDENTIAL,90250,0,90250,151077,0,241327
141347800200000,SE 209,RESIDENTIAL,86255,0,86255,184599,0,270854
141347800300000,SE 209,RESIDENTIAL,90050,0,90050,177342,0,267392
141347800400000,SE 209,RESIDENTIAL,61051,0,61051,194148,0,255199
141347800500000,SE 209,RESIDENTIAL,55980,0,55980,198680,0,254660
141410100100000,GOLF COURSE,COMMERCIAL,0,1047200,1047200,0,4008056,5055256
141420100100000,CITY PROPERTY,EXEMPT,0,0,0,0,0,0
141420100200000,CITY PROPERTY,EXEMPT,0,0,0,0,0,0
141420100300000,SE 201,RESIDENTIAL,24603,0,24603,69216,0,93819
141420100400000,SE 201,RESIDENTIAL,30282,0,30282,86915,0,117197
141420100500000,SE 201,RESIDENTIAL,26265,0,26265,81047,0,107312
141420100600000,SE 201,RESIDENTIAL,20600,0,20600,55836,0,76436
141420100700000,SE 201,RESIDENTIAL,20600,0,20600,132629,0,153229
141420100800000,APARTMENT,COMMERCIAL,0,16274,16274,0,98488,114762
141420100900000,SE 201,RESIDENTIAL,22400,0,22400,105752,0,128152
141420101000000,SE 201,RESIDENTIAL,30000,0,30000,85036,0,115036
141420101100000,SE 201,RESIDENTIAL,33250,0,33250,113172,0,146422
141420101200000,SE 201,RESIDENTIAL,27500,0,27500,63836,0,91336
141420101300000,SE 201,RESIDENTIAL,31725,0,31725,89405,0,121130
141420101400000,SE 201,RESIDENTIAL,37879,0,37879,140435,0,178314
141420200100000,SE 201,RESIDENTIAL,12114,0,12114,80257,0,92371
141420200200000,APARTMENT,COMMERCIAL,0,73600,73600,0,980709,1054309
141420200300000,APARTMENT,COMMERCIAL,0,53144,53144,0,519346,572490
141420200400000,SE 201,RESIDENTIAL,20000,0,20000,105402,0,125402
141420200500000,SE 201,RESIDENTIAL,23520,0,23520,66594,0,90114
141420200600000,SE 201,RESIDENTIAL,23520,0,23520,64664,0,88184
141420200700000,APARTMENT,COMMERCIAL,0,46800,46800,0,671979,718779
141420200800000,SE 201,RESIDENTIAL,20000,0,20000,120937,0,140937
141420200900000,SE 201,RESIDENTIAL,23840,0,23840,114460,0,138300
141420201000000,SE 201,RESIDENTIAL,17800,0,17800,77265,0,95065
141420201100000,SE 201,RESIDENTIAL,13400,0,13400,80122,0,93522
141420300100000,VACANT LAND,COMMERCIAL,0,2540,2540,0,0,2540
141420300200000,SE 203,RESIDENTIAL,148500,0,148500,657265,0,805765
141420300300000,SE 201,RESIDENTIAL,31798,0,31798,128055,0,159853
141420300400000,SE 201,RESIDENTIAL,24250,0,24250,105948,0,130198
141420300500000,SE 201,RESIDENTIAL,25500,0,25500,111712,0,137212
141420300600000,SE 201,RESIDENTIAL,23460,0,23460,121474,0,144934
141420300700000,SE 201,RESIDENTIAL,27063,0,27063,0,0,27063
141420300800000,SE 201,RESIDENTIAL,20400,0,20400,103776,0,124176
141420300900000,SE 201,RESIDENTIAL,21278,0,21278,93933,0,115211
141420301000000,SE 201,RESIDENTIAL,26873,0,26873,91910,0,118783
141420301100000,SE 201,RESIDENTIAL,29154,0,29154,78708,0,107862
141420301200000,SE 201,RESIDENTIAL,22644,0,22644,145175,0,167819
141420301300000,SE 201,RESIDENTIAL,16072,0,16072,120468,0,136540
141420301400000,SE 201,RESIDENTIAL,15680,0,15680,99964,0,115644
141420301500000,SE 201,RESIDENTIAL,15680,0,15680,112818,0,128498
141420301600000,SE 201,RESIDENTIAL,23912,0,23912,137850,0,161762
141420301700000,SE 201,RESIDENTIAL,23912,0,23912,66641,0,90553
141420301800000,SE 201,RESIDENTIAL,19600,0,19600,85141,0,104741
141420301900000,SE 201,RESIDENTIAL,20384,0,20384,116986,0,137370
141420302000000,SE 201,RESIDENTIAL,16072,0,16072,76269,0,92341
141420302100000,SE 201,RESIDENTIAL,15680,0,15680,82135,0,97815
141420302200000,SE 201,RESIDENTIAL,32548,0,32548,114792,0,147340
141420302300000,SE 201,RESIDENTIAL,21702,0,21702,68156,0,89858
141420302400000,SE 203,RESIDENTIAL,66960,0,66960,151639,0,218599
141420302500000,SE 203,RESIDENTIAL,75888,0,75888,193369,0,269257
141420302600000,SE 203,RESIDENTIAL,95100,0,95100,289465,0,384565
141420302700000,SE 203,RESIDENTIAL,131100,0,131100,313458,0,444558
141420302800000,SE 203,RESIDENTIAL,139300,0,139300,563285,0,702585
141420400100000,SE 203,RESIDENTIAL,65025,0,65025,128061,0,193086
141420400200000,SE 203,RESIDENTIAL,41580,0,41580,91347,0,132927
141420400300000,SE 203,RESIDENTIAL,51540,0,51540,0,0,51540
141420400400000,SE 203,RESIDENTIAL,44520,0,44520,143886,0,188406
141420400500000,SE 203,RESIDENTIAL,42000,0,42000,131014,0,173014
141420400600000,SE 203,RESIDENTIAL,33120,0,33120,154707,0,187827
141420400700000,SE 203,RESIDENTIAL,73842,0,73842,133243,0,207085
141420400800000,SE 203,RESIDENTIAL,55965,0,55965,147692,0,203657
141420400900000,SE 203,RESIDENTIAL,54203,0,54203,120158,0,174361
141420401000000,SE 203,RESIDENTIAL,51675,0,51675,137403,0,189078
141420401100000,SE 203,RESIDENTIAL,51675,0,51675,132214,0,183889
141420401200000,SE 203,RESIDENTIAL,52163,0,52163,122615,0,174778
141420401300000,SE 203,RESIDENTIAL,51188,0,51188,120247,0,171435
141420401400000,SE 203,RESIDENTIAL,61100,0,61100,137195,0,198295
141420401500000,SE 203,RESIDENTIAL,60435,0,60435,127748,0,188183
141420500100000,SE 203,RESIDENTIAL,44980,0,44980,109141,0,154121
141420500200000,SE 203,RESIDENTIAL,46375,0,46375,134432,0,180807
141420500300000,SE 203,RESIDENTIAL,49050,0,49050,107955,0,157005
141420500400000,SE 203,RESIDENTIAL,49500,0,49500,156948,0,206448
141420500500000,SE 203,RESIDENTIAL,46350,0,46350,100240,0,146590
141420500600000,SE 203,RESIDENTIAL,47424,0,47424,100686,0,148110
141420500700000,SE 203,RESIDENTIAL,29963,0,29963,99777,0,129740
141420500800000,SE 203,RESIDENTIAL,30260,0,30260,111146,0,141406
141420500900000,SE 203,RESIDENTIAL,22440,0,22440,92817,0,115257
141420501000000,SE 203,RESIDENTIAL,22440,0,22440,85289,0,107729
141422600100000,FLAT PARKING,COMMERCIAL,0,35196,35196,0,4720,39916
141422600200000,FLAT PARKING,COMMERCIAL,0,82800,82800,0,7462,90262
141422600300000,LG DISCOUNT/RETAIL,COMMERCIAL,0,456000,456000,0,821555,1277555
141422600400000,FLAT PARKING,COMMERCIAL,0,148800,148800,0,14924,163724
141422600500000,SE 201,RESIDENTIAL,26160,0,26160,96951,0,123111
141422600600000,FLAT PARKING,COMMERCIAL,0,13200,13200,0,1492,14692
141422700100000,CONVENIENCE STORE,COMMERCIAL,0,199025,199025,0,228132,427157
141422700200000,FLAT PARKING,COMMERCIAL,0,12720,12720,0,2035,14755
141422700300000,SMALL RETAIL,COMMERCIAL,0,10260,10260,0,73039,83299
141422700400000,VACANT LAND,COMMERCIAL,0,16470,16470,0,1200,17670
141422700800000,OFFICE,COMMERCIAL,0,435000,435000,0,1602353,2037353
141422700900000,SMALL RETAIL,COMMERCIAL,0,211500,211500,0,635828,847328
141422701000000,OFFICE,COMMERCIAL,0,456000,456000,0,1134565,1590565
141422701100000,NE 141,RESIDENTIAL,15792,0,15792,61963,0,77755
141422701200000,NE 141,RESIDENTIAL,18432,0,18432,67059,0,85491
141422701300000,NE 141,RESIDENTIAL,31752,0,31752,89810,0,121562
141422701400000,SMALL RETAIL,COMMERCIAL,0,23400,23400,0,159829,183229
141422701500000,FLAT PARKING,COMMERCIAL,0,49000,49000,0,4020,53020
141422701600000,SMALL RETAIL,COMMERCIAL,0,54250,54250,0,151582,205832
141422701700000,SMALL RETAIL,COMMERCIAL,0,52500,52500,0,188908,241408
141422701800000,AUTO REPAIR/SALES,COMMERCIAL,0,131250,131250,0,104509,235759
141422800200000,NE 141,RESIDENTIAL,31200,0,31200,99446,0,130646
141422800300000,NE 141,RESIDENTIAL,31200,0,31200,69242,0,100442
141422800400000,NE 141,RESIDENTIAL,31200,0,31200,76542,0,107742
141422800500000,NE 141,RESIDENTIAL,31200,0,31200,114407,0,145607
141422800600000,NE 141,RESIDENTIAL,31200,0,31200,74482,0,105682
141422800700000,NE 141,RESIDENTIAL,31200,0,31200,72143,0,103343
141422800800000,NE 141,RESIDENTIAL,31200,0,31200,94721,0,125921
141422800900000,NE 141,RESIDENTIAL,31200,0,31200,92419,0,123619
141422801000000,NE 141,RESIDENTIAL,30900,0,30900,62517,0,93417
141422801100000,NE 141,RESIDENTIAL,30900,0,30900,69504,0,100404
141422801200000,NE 141,RESIDENTIAL,30900,0,30900,60913,0,91813
141422801300000,NE 141,RESIDENTIAL,29664,0,29664,45436,0,75100
141422801400000,NE 141,RESIDENTIAL,30282,0,30282,74046,0,104328
141422801500000,NE 141,RESIDENTIAL,30194,0,30194,66851,0,97045
141422801600000,NE 141,RESIDENTIAL,25650,0,25650,60647,0,86297
141422801700000,NE 141,RESIDENTIAL,30323,0,30323,78700,0,109023
141422801800000,APARTMENT,COMMERCIAL,0,14592,14592,0,133688,148280
141422801900000,NE 141,RESIDENTIAL,36239,0,36239,70266,0,106505
141422802000000,OFFICE,COMMERCIAL,0,43090,43090,0,172661,215751
141422802200000,APARTMENT,COMMERCIAL,0,27000,27000,0,122896,149896
141422802300000,CONVERSION,COMMERCIAL,0,25920,25920,0,130384,156304
141422802601000,OFFICE; MEDICAL,COMMERCIAL,0,80225,80225,0,363743,443968
141422802601001,OFFICE; MEDICAL,COMMERCIAL,0,80225,80225,0,380827,461052
141422900100000,SE 201,RESIDENTIAL,24024,0,24024,91078,0,115102
141422900200000,SE 201,RESIDENTIAL,11088,0,11088,73897,0,84985
141422900300000,SE 201,RESIDENTIAL,19404,0,19404,64023,0,83427
141422900400000,SMALL RETAIL,COMMERCIAL,0,138320,138320,0,313821,452141
141422900700000,OFFICE,COMMERCIAL,0,204000,204000,0,146668,350668
141422900900000,SE 201,RESIDENTIAL,10080,0,10080,69058,0,79138
141422901000000,SE 201,RESIDENTIAL,10080,0,10080,0,0,10080
141422901100000,SE 201,RESIDENTIAL,6405,0,6405,0,0,6405
141422901200000,SE 201,RESIDENTIAL,8685,0,8685,5355,0,14040
141422901300000,SE 201,RESIDENTIAL,18643,0,18643,83301,0,101944
141422901400000,SE 201,RESIDENTIAL,17600,0,17600,88519,0,106119
141422901500000,SE 201,RESIDENTIAL,17600,0,17600,75629,0,93229
141422901600000,SE 201,RESIDENTIAL,22400,0,22400,39488,0,61888
141422901700000,OFFICE,COMMERCIAL,0,159000,159000,0,353478,512478
141422901800000,OFFICE; MEDICAL,COMMERCIAL,0,228000,228000,0,380865,608865
141422901900000,FLAT PARKING,COMMERCIAL,0,72000,72000,0,8448,80448
141423000100000,SE 204,RESIDENTIAL,7350,0,7350,88736,0,96086
141423000200000,SE 204,RESIDENTIAL,7350,0,7350,63471,0,70821
141423000300000,SE 204,RESIDENTIAL,6300,0,6300,46811,0,53111
141423000400000,SE 204,RESIDENTIAL,8400,0,8400,71774,0,80174
141423000500000,SE 204,RESIDENTIAL,12669,0,12669,66947,0,79616
141423000600000,SE 204,RESIDENTIAL,7933,0,7933,74153,0,82086
141423000700000,SE 204,RESIDENTIAL,11674,0,11674,59025,0,70699
141423000800000,SE 204,RESIDENTIAL,16168,0,16168,77897,0,94065
141423000900000,SE 204,RESIDENTIAL,21320,0,21320,97059,0,118379
141423001000000,SE 204,RESIDENTIAL,22200,0,22200,51291,0,73491
141423001100000,SE 204,RESIDENTIAL,26272,0,26272,92061,0,118333
141423001200000,SE 204,RESIDENTIAL,24000,0,24000,93690,0,117690
141423001300000,SE 204,RESIDENTIAL,24000,0,24000,106520,0,130520
141423001400000,SE 204,RESIDENTIAL,14880,0,14880,96628,0,111508
141423001500000,SE 204,RESIDENTIAL,24000,0,24000,74431,0,98431
141423001600000,SE 204,RESIDENTIAL,320,0,320,0,0,320
141423001700000,SE 204,RESIDENTIAL,12000,0,12000,28189,0,40189
141423001800000,SE 204,RESIDENTIAL,16000,0,16000,75017,0,91017
141423100200000,NE 154,RESIDENTIAL,18848,0,18848,72565,0,91413
141423100300000,NE 154,RESIDENTIAL,17160,0,17160,78833,0,95993
141423100400000,NE 154,RESIDENTIAL,16981,0,16981,62242,0,79223
141423100500000,NE 154,RESIDENTIAL,22740,0,22740,81139,0,103879
141423100600000,NE 154,RESIDENTIAL,19800,0,19800,95671,0,115471
141423100700000,NE 154,RESIDENTIAL,19800,0,19800,84817,0,104617
141423100800000,NE 154,RESIDENTIAL,19800,0,19800,102967,0,122767
141423100900000,NE 154,RESIDENTIAL,19800,0,19800,101166,0,120966
141423101000000,NE 154,RESIDENTIAL,19800,0,19800,97530,0,117330
141423101100000,NE 154,RESIDENTIAL,28050,0,28050,101087,0,129137
141423101200000,NE 154,RESIDENTIAL,28050,0,28050,63046,0,91096
141423101300000,CONVERSION,COMMERCIAL,0,12312,12312,0,96760,109072
141423101400000,OFFICE,COMMERCIAL,0,92094,92094,0,111900,203994
141423200100000,NE 154,RESIDENTIAL,25560,0,25560,74090,0,99650
141423200200000,NE 154,RESIDENTIAL,12705,0,12705,72560,0,85265
141423200300000,NE 154,RESIDENTIAL,12200,0,12200,74402,0,86602
141423200400000,NE 154,RESIDENTIAL,27200,0,27200,107233,0,134433
141423200500000,NE 154,RESIDENTIAL,26277,0,26277,89284,0,115561
141423200600000,NE 154,RESIDENTIAL,25500,0,25500,93562,0,119062
141423200700000,NE 154,RESIDENTIAL,25500,0,25500,109182,0,134682
141423200800000,NE 154,RESIDENTIAL,25500,0,25500,90128,0,115628
141423200900000,NE 154,RESIDENTIAL,25500,0,25500,89583,0,115083
141423201000000,NE 154,RESIDENTIAL,25500,0,25500,101175,0,126675
141423201100000,NE 154,RESIDENTIAL,25500,0,25500,110761,0,136261
141423201200000,NE 154,RESIDENTIAL,25500,0,25500,114464,0,139964
141423201300000,NE 154,RESIDENTIAL,25500,0,25500,104666,0,130166
141423201400000,NE 154,RESIDENTIAL,25500,0,25500,119629,0,145129
141423201500000,NE 154,RESIDENTIAL,25500,0,25500,98883,0,124383
141425100100000,SE 204,RESIDENTIAL,18240,0,18240,105347,0,123587
141425100200000,SE 204,RESIDENTIAL,20400,0,20400,84581,0,104981
141425100300000,SE 204,RESIDENTIAL,14880,0,14880,77981,0,92861
141425100400000,SE 204,RESIDENTIAL,19920,0,19920,95055,0,114975
141425200100000,NE 154,RESIDENTIAL,28050,0,28050,118667,0,146717
141425200200000,NE 154,RESIDENTIAL,19800,0,19800,90460,0,110260
141425200300000,NE 154,RESIDENTIAL,19800,0,19800,97502,0,117302
141425200400000,NE 154,RESIDENTIAL,19800,0,19800,99558,0,119358
141425200500000,NE 154,RESIDENTIAL,19800,0,19800,105186,0,124986
141425200600000,NE 154,RESIDENTIAL,19958,0,19958,72211,0,92169
141425200700000,NE 154,RESIDENTIAL,19958,0,19958,144432,0,164390
141425200800000,NE 154,RESIDENTIAL,19800,0,19800,86730,0,106530
141425200900000,NE 154,RESIDENTIAL,19958,0,19958,108676,0,128634
141425201000000,NE 154,RESIDENTIAL,22393,0,22393,120140,0,142533
141425201100000,NE 154,RESIDENTIAL,22513,0,22513,115935,0,138448
141425201200000,NE 154,RESIDENTIAL,19800,0,19800,86159,0,105959
141425201300000,NE 154,RESIDENTIAL,19800,0,19800,91656,0,111456
141425201400000,NE 154,RESIDENTIAL,19800,0,19800,78394,0,98194
141425201500000,NE 154,RESIDENTIAL,19800,0,19800,118269,0,138069
141425201600000,NE 154,RESIDENTIAL,21000,0,21000,87903,0,108903
141425201700000,NE 154,RESIDENTIAL,21868,0,21868,108189,0,130057
141425201800000,NE 154,RESIDENTIAL,13800,0,13800,78649,0,92449
141425201900000,NE 154,RESIDENTIAL,19390,0,19390,84185,0,103575
141425202000000,NE 154,RESIDENTIAL,14285,0,14285,78171,0,92456
141425202100000,NE 154,RESIDENTIAL,19668,0,19668,94702,0,114370
141425202200000,NE 154,RESIDENTIAL,28050,0,28050,123588,0,151638
141425202300000,NE 154,RESIDENTIAL,28050,0,28050,105858,0,133908
141425202400000,NE 154,RESIDENTIAL,28050,0,28050,120414,0,148464
141425202500000,NE 154,RESIDENTIAL,28050,0,28050,102275,0,130325
141425202600000,NE 154,RESIDENTIAL,33660,0,33660,101360,0,135020
141425202700000,NE 154,RESIDENTIAL,22440,0,22440,59357,0,81797
141425202800000,NE 154,RESIDENTIAL,28252,0,28252,143202,0,171454
141425202900000,NE 154,RESIDENTIAL,28252,0,28252,122860,0,151112
141425203000000,NE 154,RESIDENTIAL,28050,0,28050,123914,0,151964
141425203100000,NE 154,RESIDENTIAL,28050,0,28050,94936,0,122986
141425203200000,NE 154,RESIDENTIAL,28050,0,28050,99228,0,127278
141425300100000,NE 154,RESIDENTIAL,20400,0,20400,99990,0,120390
141425300200000,NE 154,RESIDENTIAL,25500,0,25500,95503,0,121003
141425300300000,NE 154,RESIDENTIAL,25500,0,25500,89861,0,115361
141425300400000,NE 154,RESIDENTIAL,25500,0,25500,87493,0,112993
141425300500000,NE 154,RESIDENTIAL,25500,0,25500,75324,0,100824
141425300600000,NE 154,RESIDENTIAL,25500,0,25500,112559,0,138059
141425300700000,NE 154,RESIDENTIAL,25500,0,25500,98630,0,124130
141425300800000,NE 154,RESIDENTIAL,25500,0,25500,113537,0,139037
141425300900000,NE 154,RESIDENTIAL,25500,0,25500,89384,0,114884
141425301000000,NE 154,RESIDENTIAL,25500,0,25500,104546,0,130046
141425301100000,NE 154,RESIDENTIAL,13200,0,13200,71862,0,85062
141425301200000,NE 154,RESIDENTIAL,13400,0,13400,76311,0,89711
141425301300000,NE 154,RESIDENTIAL,23978,0,23978,95866,0,119844
141425301400000,NE 154,RESIDENTIAL,20400,0,20400,102230,0,122630
141425301500000,NE 154,RESIDENTIAL,20400,0,20400,107251,0,127651
141425301600000,NE 154,RESIDENTIAL,20400,0,20400,83723,0,104123
141425301700000,NE 154,RESIDENTIAL,20400,0,20400,90110,0,110510
141425301800000,NE 154,RESIDENTIAL,20400,0,20400,78641,0,99041
141425301900000,NE 154,RESIDENTIAL,20400,0,20400,88099,0,108499
141425302000000,NE 154,RESIDENTIAL,20400,0,20400,91955,0,112355
141425302100000,NE 154,RESIDENTIAL,20400,0,20400,88323,0,108723
141425302200000,NE 154,RESIDENTIAL,20400,0,20400,94620,0,115020
141425302300000,NE 154,RESIDENTIAL,20400,0,20400,121748,0,142148
141425302400000,NE 154,RESIDENTIAL,20400,0,20400,81494,0,101894
141425302500000,NE 154,RESIDENTIAL,20400,0,20400,101166,0,121566
141425400100000,SE 204,RESIDENTIAL,19200,0,19200,125363,0,144563
141425400200000,SE 204,RESIDENTIAL,24000,0,24000,96527,0,120527
141425400300000,SE 204,RESIDENTIAL,24000,0,24000,118839,0,142839
141425400400000,SE 204,RESIDENTIAL,28000,0,28000,116597,0,144597
141425400500000,SE 204,RESIDENTIAL,20000,0,20000,118809,0,138809
141425400600000,SE 204,RESIDENTIAL,18000,0,18000,94359,0,112359
141425400700000,SE 204,RESIDENTIAL,15580,0,15580,56971,0,72551
141425400800000,SE 204,RESIDENTIAL,15800,0,15800,47471,0,63271
141425400900000,SE 204,RESIDENTIAL,19403,0,19403,76825,0,96228
141425401000000,SE 204,RESIDENTIAL,19600,0,19600,80105,0,99705
141425401100000,SE 204,RESIDENTIAL,23520,0,23520,65622,0,89142
141425401200000,SE 204,RESIDENTIAL,25500,0,25500,76078,0,101578
141425401300000,SE 204,RESIDENTIAL,25500,0,25500,79485,0,104985
141425401400000,SE 204,RESIDENTIAL,25500,0,25500,88093,0,113593
141425401500000,SE 204,RESIDENTIAL,25500,0,25500,105790,0,131290
141425401600000,SE 204,RESIDENTIAL,25500,0,25500,73660,0,99160
141425401700000,SE 204,RESIDENTIAL,17000,0,17000,77986,0,94986
141425401800000,SE 204,RESIDENTIAL,27200,0,27200,86882,0,114082
141425401900000,SE 204,RESIDENTIAL,14493,0,14493,81798,0,96291
141425500100000,SE 204,RESIDENTIAL,25500,0,25500,125068,0,150568
141425500200000,SE 204,RESIDENTIAL,25500,0,25500,136153,0,161653
141425500300000,SE 204,RESIDENTIAL,12750,0,12750,102744,0,115494
141425500400000,SE 204,RESIDENTIAL,12750,0,12750,68456,0,81206
141425500500000,SE 204,RESIDENTIAL,25500,0,25500,75036,0,100536
141425500600000,SE 204,RESIDENTIAL,25500,0,25500,85985,0,111485
141425500700000,SE 204,RESIDENTIAL,25500,0,25500,118968,0,144468
141425500800000,SE 204,RESIDENTIAL,27200,0,27200,119434,0,146634
141425500900000,SE 204,RESIDENTIAL,17000,0,17000,57830,0,74830
141425501000000,SE 204,RESIDENTIAL,16512,0,16512,89287,0,105799
141425501100000,SE 204,RESIDENTIAL,16093,0,16093,81664,0,97757
141425501200000,SE 204,RESIDENTIAL,14075,0,14075,53839,0,67914
141425501300000,SE 204,RESIDENTIAL,13440,0,13440,73767,0,87207
141425501400000,SE 204,RESIDENTIAL,14615,0,14615,76386,0,91001
141425501500000,SE 204,RESIDENTIAL,16104,0,16104,82543,0,98647
141425501600000,SE 204,RESIDENTIAL,25500,0,25500,92187,0,117687
141425501700000,SE 204,RESIDENTIAL,25500,0,25500,96002,0,121502
141425501800000,SE 204,RESIDENTIAL,25500,0,25500,103816,0,129316
141425501900000,SE 204,RESIDENTIAL,25500,0,25500,98424,0,123924
141425502000000,SE 204,RESIDENTIAL,25500,0,25500,103842,0,129342
141425502100000,SE 204,RESIDENTIAL,25500,0,25500,110569,0,136069
141425502200000,SE 204,RESIDENTIAL,25500,0,25500,87955,0,113455
141425502300000,SE 204,RESIDENTIAL,17000,0,17000,43307,0,60307
141425502400000,SE 204,RESIDENTIAL,17000,0,17000,61621,0,78621
141425502500000,SE 204,RESIDENTIAL,17000,0,17000,81310,0,98310
141425600100000,SE 204,RESIDENTIAL,17000,0,17000,68759,0,85759
141425600200000,SE 204,RESIDENTIAL,17000,0,17000,99144,0,116144
141425600300000,SE 204,RESIDENTIAL,17000,0,17000,33292,0,50292
141425600400000,SE 204,RESIDENTIAL,25500,0,25500,91980,0,117480
141425600500000,SE 204,RESIDENTIAL,25500,0,25500,97769,0,123269
141425600600000,SE 204,RESIDENTIAL,26775,0,26775,140253,0,167028
141425600700000,SE 204,RESIDENTIAL,21250,0,21250,84532,0,105782
141425600800000,SE 204,RESIDENTIAL,25500,0,25500,89236,0,114736
141425600900000,SE 204,RESIDENTIAL,25500,0,25500,86567,0,112067
141425601000000,SE 204,RESIDENTIAL,25500,0,25500,59794,0,85294
141425601100000,SE 204,RESIDENTIAL,21250,0,21250,115737,0,136987
141425601200000,SE 204,RESIDENTIAL,23965,0,23965,109374,0,133339
141425601300000,SE 204,RESIDENTIAL,14551,0,14551,71683,0,86234
141425601400000,SE 204,RESIDENTIAL,13184,0,13184,45036,0,58220
141425601500000,SE 204,RESIDENTIAL,19240,0,19240,64736,0,83976
141425601600000,SE 204,RESIDENTIAL,22185,0,22185,111415,0,133600
141425601700000,SE 204,RESIDENTIAL,19125,0,19125,93021,0,112146
141425601800000,SE 204,RESIDENTIAL,19125,0,19125,99178,0,118303
141425601900000,SE 204,RESIDENTIAL,19125,0,19125,137405,0,156530
141425602000000,SE 204,RESIDENTIAL,21250,0,21250,100663,0,121913
141425602100000,SE 204,RESIDENTIAL,23375,0,23375,101839,0,125214
141425602200000,SE 204,RESIDENTIAL,25500,0,25500,86802,0,112302
141425602300000,SE 204,RESIDENTIAL,25500,0,25500,141659,0,167159
141425602400000,SE 204,RESIDENTIAL,26371,0,26371,84258,0,110629
141425602500000,SE 204,RESIDENTIAL,19975,0,19975,121029,0,141004
141425602600000,SE 204,RESIDENTIAL,19125,0,19125,105092,0,124217
141425602700000,SE 204,RESIDENTIAL,19125,0,19125,94976,0,114101
141425602800000,SE 204,RESIDENTIAL,19125,0,19125,104727,0,123852
141425602900000,SE 204,RESIDENTIAL,19125,0,19125,105499,0,124624
141425700600000,SCHOOL,EXEMPT,0,727488,727488,0,3470821,4198309
141425800100000,NE 154,RESIDENTIAL,19040,0,19040,102440,0,121480
141425800200000,NE 154,RESIDENTIAL,13200,0,13200,64131,0,77331
141425800300000,NE 154,RESIDENTIAL,16500,0,16500,68572,0,85072
141425800400000,NE 154,RESIDENTIAL,20400,0,20400,83347,0,103747
141425800500000,NE 154,RESIDENTIAL,20400,0,20400,94094,0,114494
141425800600000,NE 154,RESIDENTIAL,20400,0,20400,86151,0,106551
141425800700000,NE 154,RESIDENTIAL,20400,0,20400,137236,0,157636
141425800800000,NE 154,RESIDENTIAL,20400,0,20400,82552,0,102952
141425800900000,NE 154,RESIDENTIAL,20400,0,20400,71701,0,92101
141427600100000,SE 203,RESIDENTIAL,63345,0,63345,189077,0,252422
141427700100000,SE 203,RESIDENTIAL,40915,0,40915,142209,0,183124
141427700200000,SE 203,RESIDENTIAL,43350,0,43350,115591,0,158941
141427700300000,SE 203,RESIDENTIAL,79891,0,79891,180409,0,260300
141427700400000,SE 203,RESIDENTIAL,40400,0,40400,82637,0,123037
141427700500000,SE 203,RESIDENTIAL,39600,0,39600,99318,0,138918
141427700600000,SE 203,RESIDENTIAL,39847,0,39847,132147,0,171994
141427700700000,SE 203,RESIDENTIAL,39600,0,39600,109624,0,149224
141427700800000,SE 203,RESIDENTIAL,40800,0,40800,109647,0,150447
141427700900000,SE 203,RESIDENTIAL,44693,0,44693,209250,0,253943
141427701000000,SE 203,RESIDENTIAL,43500,0,43500,143562,0,187062
141427701100000,SE 203,RESIDENTIAL,44188,0,44188,148954,0,193142
141427701200000,SE 203,RESIDENTIAL,44115,0,44115,141618,0,185733
141427701300000,SE 203,RESIDENTIAL,44548,0,44548,154132,0,198680
141427701400000,SE 203,RESIDENTIAL,20,0,20,0,0,20
141427800100000,SE 203,RESIDENTIAL,55900,0,55900,137951,0,193851
141427800200000,SE 203,RESIDENTIAL,52593,0,52593,113597,0,166190
141427800300000,SE 203,RESIDENTIAL,49350,0,49350,145108,0,194458
141427800400000,SE 203,RESIDENTIAL,49899,0,49899,152035,0,201934
141427800500000,SE 203,RESIDENTIAL,54625,0,54625,128467,0,183092
141427800600000,SE 203,RESIDENTIAL,56745,0,56745,170045,0,226790
141427800700000,SE 203,RESIDENTIAL,59045,0,59045,177914,0,236959
141427800800000,SE 203,RESIDENTIAL,62258,0,62258,176316,0,238574
141427800900000,SE 203,RESIDENTIAL,65178,0,65178,244168,0,309346
141427801000000,SE 203,RESIDENTIAL,56375,0,56375,179665,0,236040
141427801100000,SE 203,RESIDENTIAL,56325,0,56325,146468,0,202793
141427801200000,SE 203,RESIDENTIAL,56250,0,56250,203802,0,260052
141427801300000,SE 203,RESIDENTIAL,56250,0,56250,155722,0,211972
141427801400000,SE 203,RESIDENTIAL,56250,0,56250,233271,0,289521
141427801500000,SE 203,RESIDENTIAL,56250,0,56250,136537,0,192787
141427900100000,SE 203,RESIDENTIAL,54270,0,54270,143623,0,197893
141427900200000,SE 203,RESIDENTIAL,61155,0,61155,166662,0,227817
141427900300000,SE 203,RESIDENTIAL,41160,0,41160,175657,0,216817
141427900400000,SE 203,RESIDENTIAL,40800,0,40800,119548,0,160348
141427900500000,SE 203,RESIDENTIAL,40824,0,40824,153588,0,194412
141427900600000,SE 203,RESIDENTIAL,40776,0,40776,166630,0,207406
141427900700000,SE 203,RESIDENTIAL,36960,0,36960,126677,0,163637
141427900800000,SE 203,RESIDENTIAL,38800,0,38800,115409,0,154209
141427900900000,SE 203,RESIDENTIAL,38160,0,38160,124396,0,162556
141427901000000,SE 203,RESIDENTIAL,41400,0,41400,111396,0,152796
141427901100000,SE 203,RESIDENTIAL,49339,0,49339,123402,0,172741
141427901200000,SE 203,RESIDENTIAL,40740,0,40740,134091,0,174831
141427901300000,SE 203,RESIDENTIAL,39950,0,39950,129257,0,169207
141427901400000,SE 203,RESIDENTIAL,46313,0,46313,102672,0,148985
141427901500000,SE 203,RESIDENTIAL,46800,0,46800,121693,0,168493
141427901600000,SE 203,RESIDENTIAL,47288,0,47288,183240,0,230528
141427901700000,SE 203,RESIDENTIAL,45293,0,45293,76277,0,121570
141427901800000,SE 203,RESIDENTIAL,44625,0,44625,89234,0,133859
141427901900000,SE 203,RESIDENTIAL,45063,0,45063,93772,0,138835
141427902000000,SE 203,RESIDENTIAL,45500,0,45500,98881,0,144381
141427902100000,SE 203,RESIDENTIAL,45938,0,45938,119590,0,165528
141427902200000,SE 203,RESIDENTIAL,46375,0,46375,107842,0,154217
141427902300000,SE 203,RESIDENTIAL,46375,0,46375,133549,0,179924
141428000100000,SE 203,RESIDENTIAL,75153,0,75153,236870,0,312023
141428000200000,SE 203,RESIDENTIAL,51752,0,51752,240996,0,292748
141428000300000,SE 203,RESIDENTIAL,52475,0,52475,128330,0,180805
141428000400000,SE 203,RESIDENTIAL,52500,0,52500,107199,0,159699
141428000500000,SE 203,RESIDENTIAL,51200,0,51200,181138,0,232338
141428000600000,SE 203,RESIDENTIAL,53700,0,53700,219304,0,273004
141428000700000,SE 203,RESIDENTIAL,78712,0,78712,238911,0,317623
141428000800000,SE 203,RESIDENTIAL,84084,0,84084,205379,0,289463
141428000900000,SE 203,RESIDENTIAL,84262,0,84262,318648,0,402910
141428100100000,SE 203,RESIDENTIAL,51700,0,51700,122301,0,174001
141428100200000,SE 203,RESIDENTIAL,43165,0,43165,116611,0,159776
141428100300000,SE 203,RESIDENTIAL,39525,0,39525,105503,0,145028
141428100400000,SE 203,RESIDENTIAL,38827,0,38827,103414,0,142241
141428100500000,SE 203,RESIDENTIAL,39013,0,39013,120188,0,159201
141428100600000,SE 203,RESIDENTIAL,36895,0,36895,100824,0,137719
141428100700000,SE 203,RESIDENTIAL,38465,0,38465,115518,0,153983
141428100800000,SE 203,RESIDENTIAL,37588,0,37588,109765,0,147353
141428100900000,SE 203,RESIDENTIAL,33120,0,33120,108608,0,141728
141428101000000,SE 203,RESIDENTIAL,32305,0,32305,136254,0,168559
141428101100000,SE 203,RESIDENTIAL,32660,0,32660,91543,0,124203
141428101200000,SE 203,RESIDENTIAL,36720,0,36720,145644,0,182364
141428101300000,SE 203,RESIDENTIAL,23650,0,23650,111376,0,135026
141428101400000,SE 203,RESIDENTIAL,25850,0,25850,80672,0,106522
141428101500000,SE 203,RESIDENTIAL,42542,0,42542,98458,0,141000
141428101600000,SE 203,RESIDENTIAL,46802,0,46802,98918,0,145720
141428101700000,SE 203,RESIDENTIAL,43937,0,43937,125499,0,169436
141428101800000,SE 203,RESIDENTIAL,37835,0,37835,116790,0,154625
141428101900000,SE 203,RESIDENTIAL,37288,0,37288,123629,0,160917
141428102000000,SE 203,RESIDENTIAL,37680,0,37680,107116,0,144796
141428102100000,SE 203,RESIDENTIAL,37200,0,37200,129224,0,166424
141428102200000,SE 203,RESIDENTIAL,36813,0,36813,107853,0,144666
141428102300000,SE 203,RESIDENTIAL,37600,0,37600,94847,0,132447
141428102400000,SE 203,RESIDENTIAL,51700,0,51700,115774,0,167474
141428102500000,SE 203,RESIDENTIAL,38775,0,38775,125141,0,163916
141428102600000,SE 203,RESIDENTIAL,38775,0,38775,126553,0,165328
141428200100000,SE 203,RESIDENTIAL,66150,0,66150,357130,0,423280
141428200200000,SE 203,RESIDENTIAL,73848,0,73848,244296,0,318144
141428200300000,SE 203,RESIDENTIAL,97402,0,97402,389429,0,486831
141428200400000,SE 203,RESIDENTIAL,93480,0,93480,207972,0,301452
141428200500000,SE 203,RESIDENTIAL,83967,0,83967,213817,0,297784
141428200600000,SE 203,RESIDENTIAL,108360,0,108360,291623,0,399983
141428200700000,SE 203,RESIDENTIAL,75600,0,75600,215200,0,290800
141428200800000,SE 203,RESIDENTIAL,75600,0,75600,289156,0,364756
141428200900000,SE 203,RESIDENTIAL,48600,0,48600,189249,0,237849
141428201000000,SE 203,RESIDENTIAL,46710,0,46710,175015,0,221725
141428201100000,SE 203,RESIDENTIAL,55105,0,55105,182597,0,237702
141428201200000,SE 203,RESIDENTIAL,43725,0,43725,142982,0,186707
141428201300000,SE 203,RESIDENTIAL,42263,0,42263,130585,0,172848
141428201400000,SE 203,RESIDENTIAL,38480,0,38480,125461,0,163941
141428201500000,SE 203,RESIDENTIAL,37740,0,37740,70851,0,108591
141428201600000,SE 203,RESIDENTIAL,37370,0,37370,105539,0,142909
141428201700000,SE 203,RESIDENTIAL,37240,0,37240,112149,0,149389
141428201800000,SE 203,RESIDENTIAL,37050,0,37050,84711,0,121761
141428201900000,SE 203,RESIDENTIAL,42300,0,42300,114303,0,156603
141428300100000,SE 203,RESIDENTIAL,41600,0,41600,80031,0,121631
141428300200000,SE 203,RESIDENTIAL,28665,0,28665,65576,0,94241
141428300300000,SE 203,RESIDENTIAL,34010,0,34010,79287,0,113297
141428300400000,SE 203,RESIDENTIAL,37620,0,37620,108082,0,145702
141428300500000,SE 203,RESIDENTIAL,37588,0,37588,107801,0,145389
141428300600000,SE 203,RESIDENTIAL,49743,0,49743,108842,0,158585
141428300700000,SE 203,RESIDENTIAL,41860,0,41860,95268,0,137128
141428300800000,SE 203,RESIDENTIAL,30708,0,30708,84131,0,114839
141430100100000,SE 203,RESIDENTIAL,111900,0,111900,347083,0,458983
141430100200000,SCHOOL,EXEMPT,0,0,0,0,0,0
141432600100000,SE 208,RESIDENTIAL,32700,0,32700,104989,0,137689
141432600200000,SE 208,RESIDENTIAL,32700,0,32700,134954,0,167654
141432600300000,SE 208,RESIDENTIAL,32700,0,32700,90406,0,123106
141432600400000,SE 208,RESIDENTIAL,32700,0,32700,98844,0,131544
141432600500000,SE 208,RESIDENTIAL,34360,0,34360,161530,0,195890
141432600600000,SE 208,RESIDENTIAL,35000,0,35000,143019,0,178019
141432600700000,SE 208,RESIDENTIAL,35640,0,35640,168961,0,204601
141432600800000,SE 208,RESIDENTIAL,40131,0,40131,156956,0,197087
141432600900000,SE 208,RESIDENTIAL,39600,0,39600,130655,0,170255
141432601000000,SE 208,RESIDENTIAL,39069,0,39069,161757,0,200826
141432601100000,SE 208,RESIDENTIAL,34360,0,34360,103121,0,137481
141432601200000,SE 208,RESIDENTIAL,35000,0,35000,94218,0,129218
141432601300000,SE 208,RESIDENTIAL,35640,0,35640,139626,0,175266
141432700100000,SE 208,RESIDENTIAL,35633,0,35633,189126,0,224759
141432700200000,SE 208,RESIDENTIAL,31500,0,31500,105868,0,137368
141432700300000,SE 208,RESIDENTIAL,31500,0,31500,83387,0,114887
141432800100000,NE 154,RESIDENTIAL,40000,0,40000,0,0,40000
141432800102000,ANTENNAS/TOWERS(BLL),COMMERCIAL,0,0,0,0,12370,12370
141432800300000,OFFICE,COMMERCIAL,0,194400,194400,0,135838,330238
141432800400000,VACANT LAND,COMMERCIAL,0,48480,48480,0,0,48480
141432800500000,OFFICE,COMMERCIAL,0,129664,129664,0,169637,299301
141432900100000,CHURCH,EXEMPT,0,32724,32724,0,21373,54097
141432900200000,SE 208,RESIDENTIAL,70200,0,70200,186178,0,256378
141432900300000,SE 208,RESIDENTIAL,70200,0,70200,201880,0,272080
141432900400000,SE 208,RESIDENTIAL,70200,0,70200,199004,0,269204
141432900500000,SE 208,RESIDENTIAL,70200,0,70200,229685,0,299885
141432900600000,SE 208,RESIDENTIAL,69000,0,69000,0,0,69000
141432900700000,SE 208,RESIDENTIAL,109200,0,109200,222724,0,331924
141432900800000,SE 208,RESIDENTIAL,43307,0,43307,0,0,43307
141432900900000,VACANT LAND,COMMERCIAL,0,540,540,0,0,540
141432901000000,APARTMENT,RESIDENTIAL,517320,0,517320,18806897,0,19324217
141432901400000,CHURCH,EXEMPT,0,101520,101520,0,1326868,1428388
141432901501000,VACANT LAND,COMMERCIAL,0,588,588,0,0,588
141435201500000,SE 218,RESIDENTIAL,116000,0,116000,158192,0,274192
141435400100000,SE 207,RESIDENTIAL,26500,0,26500,46267,0,72767
141435400200000,SE 207,RESIDENTIAL,24000,0,24000,98628,0,122628
141435400300000,SE 207,RESIDENTIAL,38987,0,38987,80685,0,119672
141435400400000,SE 207,RESIDENTIAL,42613,0,42613,88869,0,131482
141435400500000,SE 207,RESIDENTIAL,43200,0,43200,85630,0,128830
141435500100000,SE 207,RESIDENTIAL,89600,0,89600,176187,0,265787
141435500200000,SE 207,RESIDENTIAL,51406,0,51406,191874,0,243280
141435500300000,SE 207,RESIDENTIAL,59567,0,59567,146895,0,206462
141437600100000,SE 207,RESIDENTIAL,90050,0,90050,168951,0,259001
141437600200000,SE 207,RESIDENTIAL,82350,0,82350,113245,0,195595
141437600300000,SE 207,RESIDENTIAL,64050,0,64050,165700,0,229750
141437600400000,SE 207,RESIDENTIAL,64050,0,64050,192519,0,256569
141437600500000,SE 207,RESIDENTIAL,56682,0,56682,162516,0,219198
141437600600000,SE 207,RESIDENTIAL,25300,0,25300,76901,0,102201
141437600700000,SE 207,RESIDENTIAL,31815,0,31815,100139,0,131954
141437600800000,SE 207,RESIDENTIAL,28280,0,28280,69204,0,97484
141437600900000,SE 207,RESIDENTIAL,32825,0,32825,132116,0,164941
141437601000000,SE 207,RESIDENTIAL,33132,0,33132,111822,0,144954
141437601100000,SE 207,RESIDENTIAL,31415,0,31415,69111,0,100526
141437601200000,SE 207,RESIDENTIAL,31415,0,31415,94146,0,125561
141437601300000,SE 207,RESIDENTIAL,37698,0,37698,153490,0,191188
141437601400000,SE 207,RESIDENTIAL,35342,0,35342,111710,0,147052
141437601500000,SE 207,RESIDENTIAL,34776,0,34776,182340,0,217116
141437700100000,SE 207,RESIDENTIAL,23397,0,23397,138153,0,161550
141437700200000,SE 207,RESIDENTIAL,48111,0,48111,111029,0,159140
141437700300000,SE 207,RESIDENTIAL,38174,0,38174,113500,0,151674
141437700400000,SE 207,RESIDENTIAL,25000,0,25000,101057,0,126057
141437700500000,SE 207,RESIDENTIAL,20000,0,20000,66041,0,86041
141437700600000,SE 207,RESIDENTIAL,20000,0,20000,74990,0,94990
141437700700000,SE 207,RESIDENTIAL,20000,0,20000,75234,0,95234
141437700800000,SE 207,RESIDENTIAL,20000,0,20000,65962,0,85962
141437700900000,SE 207,RESIDENTIAL,20000,0,20000,80499,0,100499
141437701000000,SE 207,RESIDENTIAL,25000,0,25000,59045,0,84045
141437701100000,SE 207,RESIDENTIAL,25000,0,25000,69124,0,94124
141437701200000,SE 207,RESIDENTIAL,25000,0,25000,75432,0,100432
141437701300000,SE 207,RESIDENTIAL,20000,0,20000,74979,0,94979
141437701400000,SE 207,RESIDENTIAL,20000,0,20000,72889,0,92889
141437701500000,SE 207,RESIDENTIAL,25000,0,25000,61796,0,86796
141437701600000,SE 207,RESIDENTIAL,28000,0,28000,55195,0,83195
141437800100000,SE 207,RESIDENTIAL,70190,0,70190,130316,0,200506
141437800200000,SE 207,RESIDENTIAL,25000,0,25000,65152,0,90152
141437800400000,SE 207,RESIDENTIAL,35000,0,35000,85671,0,120671
141437800500000,SE 207,RESIDENTIAL,25000,0,25000,76793,0,101793
141437800600000,SE 207,RESIDENTIAL,35000,0,35000,122423,0,157423
141437800700000,SE 207,RESIDENTIAL,18200,0,18200,57425,0,75625
141437800800000,SE 207,RESIDENTIAL,21750,0,21750,62372,0,84122
141437800900000,SE 207,RESIDENTIAL,21750,0,21750,64049,0,85799
141437801000000,SE 207,RESIDENTIAL,25000,0,25000,72788,0,97788
141437801100000,SE 207,RESIDENTIAL,25000,0,25000,73909,0,98909
141437801200000,SE 207,RESIDENTIAL,25000,0,25000,83852,0,108852
141437801300000,SE 207,RESIDENTIAL,27000,0,27000,104105,0,131105
141437900100000,SE 207,RESIDENTIAL,36720,0,36720,113908,0,150628
141437900200000,SE 207,RESIDENTIAL,30300,0,30300,88581,0,118881
141437900300000,SE 207,RESIDENTIAL,30300,0,30300,73596,0,103896
141437900400000,SE 207,RESIDENTIAL,31200,0,31200,59258,0,90458
141437900500000,SE 207,RESIDENTIAL,41003,0,41003,68633,0,109636
141437900600000,SE 207,RESIDENTIAL,36360,0,36360,189650,0,226010
141437900700000,SE 207,RESIDENTIAL,52380,0,52380,84572,0,136952
141437900800000,SE 207,RESIDENTIAL,33950,0,33950,80696,0,114646
141437900900000,SE 207,RESIDENTIAL,34821,0,34821,122006,0,156827
141438000100000,SE 207,RESIDENTIAL,31101,0,31101,96573,0,127674
141438000200000,SE 207,RESIDENTIAL,31101,0,31101,116159,0,147260
141438000300000,SE 207,RESIDENTIAL,25250,0,25250,80623,0,105873
141438000400000,SE 207,RESIDENTIAL,25250,0,25250,81800,0,107050
141438000500000,SE 207,RESIDENTIAL,35350,0,35350,89733,0,125083
141438000600000,SE 207,RESIDENTIAL,25250,0,25250,91701,0,116951
141438000700000,SE 207,RESIDENTIAL,25250,0,25250,51202,0,76452
141438000800000,SE 207,RESIDENTIAL,25250,0,25250,110472,0,135722
141438000900000,SE 207,RESIDENTIAL,34340,0,34340,86462,0,120802
141438001000000,SE 207,RESIDENTIAL,37875,0,37875,137260,0,175135
141438001100000,SE 207,RESIDENTIAL,32137,0,32137,81127,0,113264
141438001200000,SE 207,RESIDENTIAL,32194,0,32194,71585,0,103779
141438001300000,SE 207,RESIDENTIAL,29357,0,29357,66476,0,95833
141438001400000,SE 207,RESIDENTIAL,29290,0,29290,68911,0,98201
141438001500000,SE 207,RESIDENTIAL,29290,0,29290,99083,0,128373
141438100100000,SE 207,RESIDENTIAL,25000,0,25000,113959,0,138959
141438100200000,SE 207,RESIDENTIAL,25000,0,25000,63585,0,88585
141438100300000,SE 207,RESIDENTIAL,25000,0,25000,77867,0,102867
141438100400000,SE 207,RESIDENTIAL,25000,0,25000,80667,0,105667
141438100500000,SE 207,RESIDENTIAL,25000,0,25000,63673,0,88673
141438100600000,SE 207,RESIDENTIAL,25000,0,25000,63531,0,88531
141438100700000,SE 207,RESIDENTIAL,25000,0,25000,64938,0,89938
141438100800000,SE 207,RESIDENTIAL,25000,0,25000,62260,0,87260
141438100900000,SE 207,RESIDENTIAL,25000,0,25000,60910,0,85910
141438101000000,SE 207,RESIDENTIAL,25000,0,25000,65614,0,90614
141438101100000,SE 207,RESIDENTIAL,35000,0,35000,111370,0,146370
141438101200000,SE 207,RESIDENTIAL,35000,0,35000,150050,0,185050
141438101300000,SE 207,RESIDENTIAL,25000,0,25000,84192,0,109192
141438101400000,SE 207,RESIDENTIAL,25000,0,25000,60057,0,85057
141438101500000,SE 207,RESIDENTIAL,25000,0,25000,65163,0,90163
141438101600000,SE 207,RESIDENTIAL,25000,0,25000,111329,0,136329
141438101700000,SE 207,RESIDENTIAL,25000,0,25000,75176,0,100176
141438101800000,SE 207,RESIDENTIAL,25000,0,25000,69808,0,94808
141438101900000,SE 207,RESIDENTIAL,25000,0,25000,78912,0,103912
141438102000000,SE 207,RESIDENTIAL,25000,0,25000,104595,0,129595
141438200100000,SE 207,RESIDENTIAL,25000,0,25000,81727,0,106727
141438200200000,SE 207,RESIDENTIAL,25000,0,25000,122999,0,147999
141438200300000,SE 207,RESIDENTIAL,32800,0,32800,148072,0,180872
141438200400000,SE 207,RESIDENTIAL,32000,0,32000,137280,0,169280
141438200500000,SE 207,RESIDENTIAL,32062,0,32062,107132,0,139194
141438200600000,SE 207,RESIDENTIAL,33425,0,33425,149457,0,182882
141438200700000,SE 207,RESIDENTIAL,28125,0,28125,65536,0,93661
141438200800000,SE 207,RESIDENTIAL,32500,0,32500,146144,0,178644
141438200900000,SE 207,RESIDENTIAL,27300,0,27300,109449,0,136749
141438201000000,SE 207,RESIDENTIAL,29074,0,29074,96942,0,126016
141438201100000,SE 207,RESIDENTIAL,25000,0,25000,72410,0,97410
141438201200000,SE 207,RESIDENTIAL,25000,0,25000,61308,0,86308
141438201300000,SE 207,RESIDENTIAL,25000,0,25000,41306,0,66306
141438201400000,SE 207,RESIDENTIAL,25000,0,25000,72827,0,97827
141438201500000,SE 207,RESIDENTIAL,25000,0,25000,66146,0,91146
141438201600000,SE 207,RESIDENTIAL,25000,0,25000,73985,0,98985
141438201700000,SE 207,RESIDENTIAL,25000,0,25000,72308,0,97308
141438201800000,SE 207,RESIDENTIAL,25000,0,25000,79789,0,104789
141438300100000,SE 207,RESIDENTIAL,100510,0,100510,122732,0,223242
141438300200000,SE 207,RESIDENTIAL,76700,0,76700,232138,0,308838
141438300300000,SE 207,RESIDENTIAL,100300,0,100300,149720,0,250020
141438300400000,SE 207,RESIDENTIAL,64165,0,64165,126156,0,190321
141438300500000,SE 207,RESIDENTIAL,56500,0,56500,116706,0,173206
141438300600000,SE 207,RESIDENTIAL,56500,0,56500,129476,0,185976
141438300700000,SE 207,RESIDENTIAL,56500,0,56500,91464,0,147964
141438300800000,SE 207,RESIDENTIAL,28250,0,28250,60471,0,88721
141438300900000,SE 207,RESIDENTIAL,28250,0,28250,77565,0,105815
141438301000000,SE 207,RESIDENTIAL,28250,0,28250,53406,0,81656
141438301100000,SE 207,RESIDENTIAL,28250,0,28250,70113,0,98363
141438301200000,SE 207,RESIDENTIAL,28250,0,28250,53594,0,81844
141438301300000,SE 207,RESIDENTIAL,32205,0,32205,71986,0,104191
141438301400000,SE 207,RESIDENTIAL,32544,0,32544,64774,0,97318
141438301500000,SE 207,RESIDENTIAL,26500,0,26500,90756,0,117256
141440100100000,SE 211,RESIDENTIAL,6280,0,6280,0,0,6280
141440100200000,SE 211,RESIDENTIAL,175500,0,175500,438381,0,613881
141440100300000,SE 211,RESIDENTIAL,160500,0,160500,311024,0,471524
141440100400000,SE 211,RESIDENTIAL,162000,0,162000,306322,0,468322
141440100500000,SE 211,RESIDENTIAL,103400,0,103400,290867,0,394267
141440100600000,SE 211,RESIDENTIAL,75075,0,75075,257318,0,332393
141440100700000,SE 211,RESIDENTIAL,82338,0,82338,288865,0,371203
141440100800000,SE 211,RESIDENTIAL,85020,0,85020,265239,0,350259
141440100900000,SE 211,RESIDENTIAL,85902,0,85902,362635,0,448537
141440101000000,SE 211,RESIDENTIAL,83046,0,83046,259323,0,342369
141440101100000,SE 211,RESIDENTIAL,155250,0,155250,237265,0,392515
141440101200000,SE 211,RESIDENTIAL,153900,0,153900,96971,0,250871
141440101300000,SE 211,RESIDENTIAL,153150,0,153150,150263,0,303413
141440101400000,SE 211,RESIDENTIAL,82800,0,82800,187712,0,270512
141440101500000,SE 211,RESIDENTIAL,82650,0,82650,220397,0,303047
141440101600000,SE 211,RESIDENTIAL,84150,0,84150,226204,0,310354
141440101700000,SE 211,RESIDENTIAL,83850,0,83850,243496,0,327346
141440101800000,SE 211,RESIDENTIAL,94050,0,94050,289852,0,383902
141440101900000,SE 211,RESIDENTIAL,175500,0,175500,227465,0,402965
141440102000000,SE 211,RESIDENTIAL,3600,0,3600,0,0,3600
141440102100000,SE 211,RESIDENTIAL,20,0,20,0,0,20
141440200100000,SE 211,RESIDENTIAL,113295,0,113295,119481,0,232776
141440200200000,SE 211,RESIDENTIAL,20,0,20,0,0,20
141442600100000,SE 206,RESIDENTIAL,52688,0,52688,243786,0,296474
141442600200000,SE 206,RESIDENTIAL,53760,0,53760,135658,0,189418
141442600300000,SE 206,RESIDENTIAL,85429,0,85429,238283,0,323712
141442600400000,SE 206,RESIDENTIAL,87768,0,87768,175842,0,263610
141442600500000,SE 206,RESIDENTIAL,77190,0,77190,202722,0,279912
141442600600000,SE 206,RESIDENTIAL,50867,0,50867,253631,0,304498
141442600700000,SE 206,RESIDENTIAL,49817,0,49817,224387,0,274204
141442600800000,SE 206,RESIDENTIAL,53350,0,53350,208554,0,261904
141442600900000,SE 206,RESIDENTIAL,45900,0,45900,174354,0,220254
141442601000000,SE 206,RESIDENTIAL,48150,0,48150,182726,0,230876
141442601100000,SE 206,RESIDENTIAL,48925,0,48925,136214,0,185139
141442601200000,SE 206,RESIDENTIAL,51000,0,51000,158111,0,209111
141442601300000,SE 206,RESIDENTIAL,51000,0,51000,153903,0,204903
141442601400000,SE 206,RESIDENTIAL,54708,0,54708,185117,0,239825
141442700100000,SE 203,RESIDENTIAL,99816,0,99816,354652,0,454468
141442700200000,SE 203,RESIDENTIAL,58938,0,58938,195347,0,254285
141442700300000,SE 203,RESIDENTIAL,61813,0,61813,124574,0,186387
141442700400000,SE 203,RESIDENTIAL,44508,0,44508,133071,0,177579
141442700500000,SE 203,RESIDENTIAL,39600,0,39600,181614,0,221214
141442800100000,SE 206,RESIDENTIAL,52938,0,52938,164200,0,217138
141442800200000,SE 206,RESIDENTIAL,79407,0,79407,172819,0,252226
141442800300000,SE 206,RESIDENTIAL,76860,0,76860,173171,0,250031
141442800400000,SE 206,RESIDENTIAL,68520,0,68520,182156,0,250676
141442800500000,SE 206,RESIDENTIAL,78192,0,78192,177716,0,255908
141442800600000,SE 206,RESIDENTIAL,52003,0,52003,153208,0,205211
141442800700000,SE 206,RESIDENTIAL,50666,0,50666,210987,0,261653
141442800800000,SE 206,RESIDENTIAL,50065,0,50065,157331,0,207396
141442800900000,SE 206,RESIDENTIAL,48925,0,48925,95324,0,144249
141442801000000,SE 206,RESIDENTIAL,49559,0,49559,166165,0,215724
141442801100000,SE 206,RESIDENTIAL,52316,0,52316,173415,0,225731
141442900100000,SE 206,RESIDENTIAL,56385,0,56385,144785,0,201170
141442900200000,SE 206,RESIDENTIAL,50000,0,50000,184996,0,234996
141442900300000,SE 206,RESIDENTIAL,50000,0,50000,169760,0,219760
141442900400000,SE 206,RESIDENTIAL,47667,0,47667,152025,0,199692
141442900500000,SE 206,RESIDENTIAL,48825,0,48825,182922,0,231747
141442900600000,SE 206,RESIDENTIAL,47260,0,47260,111551,0,158811
141442900700000,SE 206,RESIDENTIAL,45167,0,45167,167312,0,212479
141442900800000,SE 206,RESIDENTIAL,50307,0,50307,166456,0,216763
141442900900000,SE 206,RESIDENTIAL,50309,0,50309,184175,0,234484
141442901000000,SE 206,RESIDENTIAL,50490,0,50490,186202,0,236692
141442901100000,SE 206,RESIDENTIAL,52352,0,52352,146971,0,199323
141442901200000,SE 206,RESIDENTIAL,49254,0,49254,179806,0,229060
141442901300000,SE 206,RESIDENTIAL,52500,0,52500,169525,0,222025
141442901400000,SE 206,RESIDENTIAL,47520,0,47520,141680,0,189200
141442901500000,SE 206,RESIDENTIAL,50400,0,50400,111908,0,162308
141442901600000,SE 206,RESIDENTIAL,44455,0,44455,176636,0,221091
141442901700000,SE 206,RESIDENTIAL,42717,0,42717,142340,0,185057
141442901800000,SE 206,RESIDENTIAL,54083,0,54083,126662,0,180745
141442901900000,SE 206,RESIDENTIAL,47853,0,47853,171120,0,218973
141442902000000,SE 206,RESIDENTIAL,48753,0,48753,144344,0,193097
141442902100000,SE 206,RESIDENTIAL,46550,0,46550,156899,0,203449
141442902200000,SE 206,RESIDENTIAL,44550,0,44550,111473,0,156023
141442902300000,SE 206,RESIDENTIAL,56928,0,56928,151628,0,208556
141442902400000,SE 206,RESIDENTIAL,54080,0,54080,209187,0,263267
141442902500000,SE 206,RESIDENTIAL,50674,0,50674,140533,0,191207
141442902600000,SE 206,RESIDENTIAL,20,0,20,0,0,20
141443000100000,SE 206,RESIDENTIAL,53536,0,53536,223761,0,277297
141443000200000,SE 206,RESIDENTIAL,55200,0,55200,151799,0,206999
141443000300000,SE 206,RESIDENTIAL,55200,0,55200,215135,0,270335
141443000400000,SE 206,EXEMPT,0,53900,53900,0,173756,227656
141443000500000,SE 206,RESIDENTIAL,47975,0,47975,120803,0,168778
141443000600000,SE 206,RESIDENTIAL,51883,0,51883,213618,0,265501
141443000700000,SE 206,RESIDENTIAL,46973,0,46973,203128,0,250101
141443000800000,SE 206,RESIDENTIAL,52618,0,52618,176238,0,228856
141443000900000,SE 206,RESIDENTIAL,52013,0,52013,161618,0,213631
141443001000000,SE 206,RESIDENTIAL,54586,0,54586,160906,0,215492
141443001100000,SE 206,RESIDENTIAL,47203,0,47203,182446,0,229649
141445100100000,SE 211,RESIDENTIAL,160000,0,160000,245366,0,405366
141445100200000,SE 211,RESIDENTIAL,132500,0,132500,335704,0,468204
141445100300000,CITY PROPERTY,EXEMPT,0,0,0,0,0,0
141445100400000,SE 211,RESIDENTIAL,181100,0,181100,503447,0,684547
141445200100000,CITY PROPERTY,EXEMPT,0,0,0,0,0,0
141445200200000,SE 211,RESIDENTIAL,96000,0,96000,260443,0,356443
141445200300000,SE 211,RESIDENTIAL,109300,0,109300,256899,0,366199
141445200400000,CITY PROPERTY,EXEMPT,0,0,0,0,0,0
141447600100000,SE 211,RESIDENTIAL,7300,0,7300,0,0,7300
141447600200000,SE 211,RESIDENTIAL,76875,0,76875,574237,0,651112
141447600300000,SE 211,RESIDENTIAL,61500,0,61500,206642,0,268142
141447600400000,SE 211,RESIDENTIAL,62000,0,62000,235862,0,297862
141447600500000,SE 211,RESIDENTIAL,77393,0,77393,199206,0,276599
141447600600000,SE 211,RESIDENTIAL,178650,0,178650,335697,0,514347
141447600700000,SE 211,RESIDENTIAL,101700,0,101700,510612,0,612312
141447600800000,SE 211,RESIDENTIAL,103700,0,103700,237290,0,340990
141447600900000,SE 211,RESIDENTIAL,103600,0,103600,306288,0,409888
141447601000000,SE 211,RESIDENTIAL,105700,0,105700,262362,0,368062
141447601100000,SE 211,RESIDENTIAL,73080,0,73080,143393,0,216473
141447601200000,SE 211,RESIDENTIAL,90720,0,90720,0,0,90720
141447601300000,SE 211,RESIDENTIAL,106200,0,106200,86475,0,192675
141447601400000,SE 211,RESIDENTIAL,15000,0,15000,0,0,15000
141447601500000,SE 211,RESIDENTIAL,100000,0,100000,340139,0,440139
141447601600000,SE 211,RESIDENTIAL,100000,0,100000,313993,0,413993
141447601700000,SE 211,RESIDENTIAL,80148,0,80148,335622,0,415770
141447601800000,SE 211,RESIDENTIAL,86181,0,86181,180391,0,266572
141447601900000,SE 211,RESIDENTIAL,76380,0,76380,155019,0,231399
141447602000000,SE 211,RESIDENTIAL,93704,0,93704,263724,0,357428
141447602100000,SE 211,RESIDENTIAL,101600,0,101600,227622,0,329222
141447602200000,SE 211,RESIDENTIAL,5471,0,5471,0,0,5471
141447602300000,SE 211,RESIDENTIAL,100100,0,100100,329082,0,429182
141447602400000,SE 211,RESIDENTIAL,20,0,20,0,0,20
141447602500000,SE 211,RESIDENTIAL,20,0,20,0,0,20
141447700100000,SE 211,RESIDENTIAL,76046,0,76046,240594,0,316640
141447700200000,SE 211,RESIDENTIAL,2080,0,2080,0,0,2080
141447800100000,SE 211,RESIDENTIAL,249960,0,249960,433784,0,683744
141447800200000,SE 212,RESIDENTIAL,126150,0,126150,778750,0,904900
141447800300000,SE 212,RESIDENTIAL,128450,0,128450,394238,0,522688
141447800400000,CITY PROPERTY,EXEMPT,0,0,0,0,0,0
141510100100000,CENTRALLY ASSESSED,OTHER,0,0,0,0,0,0
141510100200000,NE 141,RESIDENTIAL,26166,0,26166,100035,0,126201
141510100300000,NE 141,RESIDENTIAL,26520,0,26520,102115,0,128635
141510100400000,NE 141,RESIDENTIAL,26520,0,26520,115419,0,141939
141510100500000,NE 141,RESIDENTIAL,24480,0,24480,95331,0,119811
141510100600000,NE 141,RESIDENTIAL,24480,0,24480,78169,0,102649
141510100700000,NE 141,RESIDENTIAL,24480,0,24480,113717,0,138197
141510100800000,NE 141,RESIDENTIAL,24480,0,24480,84769,0,109249
141510100900000,NE 141,RESIDENTIAL,26520,0,26520,82233,0,108753
141510101000000,NE 141,RESIDENTIAL,26520,0,26520,111753,0,138273
141510101100000,NE 141,RESIDENTIAL,26520,0,26520,101293,0,127813
141510101200000,NE 141,RESIDENTIAL,26520,0,26520,91177,0,117697
141510101300000,NE 141,RESIDENTIAL,26520,0,26520,92276,0,118796
141510101400000,NE 141,RESIDENTIAL,25990,0,25990,97137,0,123127
141510101500000,SCHOOL,EXEMPT,0,0,0,0,0,0
141510200100000,NE 141,RESIDENTIAL,27824,0,27824,91833,0,119657
141510200200000,NE 141,RESIDENTIAL,26150,0,26150,108581,0,134731
141510200300000,NE 141,RESIDENTIAL,26520,0,26520,95569,0,122089
141510200400000,NE 141,RESIDENTIAL,29413,0,29413,117259,0,146672
141510200500000,NE 141,RESIDENTIAL,28633,0,28633,98793,0,127426
141510200600000,NE 141,RESIDENTIAL,33705,0,33705,102242,0,135947
141510200700000,NE 141,RESIDENTIAL,32588,0,32588,123689,0,156277
141510200800000,NE 141,RESIDENTIAL,22723,0,22723,126191,0,148914
141510200900000,NE 141,RESIDENTIAL,26525,0,26525,119878,0,146403
141510201000000,NE 141,RESIDENTIAL,26525,0,26525,90972,0,117497
141510201100000,NE 141,RESIDENTIAL,28600,0,28600,124516,0,153116
141510201200000,NE 141,RESIDENTIAL,27300,0,27300,125361,0,152661
141510201300000,NE 141,RESIDENTIAL,25740,0,25740,101667,0,127407
141510201400000,NE 141,RESIDENTIAL,23660,0,23660,110961,0,134621
141510201500000,NE 141,RESIDENTIAL,29388,0,29388,120688,0,150076
141510201600000,NE 141,RESIDENTIAL,25813,0,25813,102499,0,128312
141510201700000,NE 141,RESIDENTIAL,25994,0,25994,125381,0,151375
141510201800000,NE 141,RESIDENTIAL,27560,0,27560,100516,0,128076
141510201900000,NE 141,RESIDENTIAL,28416,0,28416,138705,0,167121
141510202000000,NE 141,RESIDENTIAL,29648,0,29648,127193,0,156841
141510202100000,NE 141,RESIDENTIAL,26208,0,26208,125772,0,151980
141510202200000,NE 141,RESIDENTIAL,26520,0,26520,94672,0,121192
141510300100000,NE 142,RESIDENTIAL,26094,0,26094,106312,0,132406
141510300200000,NE 142,RESIDENTIAL,26150,0,26150,121204,0,147354
141510300300000,NE 142,RESIDENTIAL,29843,0,29843,122090,0,151933
141510300400000,NE 142,RESIDENTIAL,29648,0,29648,103803,0,133451
141510300500000,NE 142,RESIDENTIAL,29773,0,29773,107621,0,137394
141510300600000,NE 142,RESIDENTIAL,26928,0,26928,100045,0,126973
141510300700000,NE 142,RESIDENTIAL,28644,0,28644,120201,0,148845
141510300800000,NE 142,RESIDENTIAL,33184,0,33184,98966,0,132150
141510300900000,NE 142,RESIDENTIAL,31200,0,31200,129976,0,161176
141510301000000,NE 142,RESIDENTIAL,32100,0,32100,122256,0,154356
141510301100000,NE 142,RESIDENTIAL,31500,0,31500,126547,0,158047
141510400100000,SCHOOL,EXEMPT,0,0,0,0,0,0
141510400200000,NE 154,RESIDENTIAL,20200,0,20200,92299,0,112499
141510400300000,NE 154,RESIDENTIAL,20400,0,20400,93178,0,113578
141510400400000,NE 154,RESIDENTIAL,25500,0,25500,106271,0,131771
141510400500000,NE 154,RESIDENTIAL,25500,0,25500,106261,0,131761
141510500100000,NE 154,RESIDENTIAL,25000,0,25000,103609,0,128609
141510500200000,NE 154,RESIDENTIAL,22050,0,22050,107427,0,129477
141510500300000,NE 154,RESIDENTIAL,21825,0,21825,84799,0,106624
141510500400000,NE 154,RESIDENTIAL,7750,0,7750,0,0,7750
141510500500000,NE 154,RESIDENTIAL,24086,0,24086,138966,0,163052
141510500600000,NE 154,RESIDENTIAL,18400,0,18400,78811,0,97211
141510500700000,NE 154,RESIDENTIAL,21630,0,21630,68177,0,89807
141510500800000,NE 154,RESIDENTIAL,26780,0,26780,141107,0,167887
141510500900000,NE 154,RESIDENTIAL,20600,0,20600,100180,0,120780
141510501000000,NE 154,RESIDENTIAL,20600,0,20600,88072,0,108672
141510501100000,NE 154,RESIDENTIAL,21200,0,21200,90477,0,111677
141510501200000,NE 154,RESIDENTIAL,21200,0,21200,84290,0,105490
141510501300000,NE 154,RESIDENTIAL,21200,0,21200,78113,0,99313
141510501400000,NE 154,RESIDENTIAL,21200,0,21200,100422,0,121622
141510501500000,NE 154,RESIDENTIAL,21200,0,21200,84353,0,105553
141510501600000,NE 154,RESIDENTIAL,21200,0,21200,83508,0,104708
141510501700000,NE 154,RESIDENTIAL,20000,0,20000,100599,0,120599
141510600100000,NE 154,RESIDENTIAL,23017,0,23017,76465,0,99482
141510700100000,NE 142,RESIDENTIAL,26400,0,26400,101045,0,127445
141510700200000,NE 142,RESIDENTIAL,22800,0,22800,153438,0,176238
141510700300000,NE 142,RESIDENTIAL,24000,0,24000,116015,0,140015
141510700400000,NE 142,RESIDENTIAL,24000,0,24000,105685,0,129685
141510700500000,NE 142,RESIDENTIAL,24000,0,24000,99962,0,123962
141510700600000,NE 142,RESIDENTIAL,24000,0,24000,85185,0,109185
141510700700000,NE 142,RESIDENTIAL,24000,0,24000,103745,0,127745
141510700800000,NE 142,RESIDENTIAL,26000,0,26000,67431,0,93431
141510700900000,NE 154,RESIDENTIAL,20000,0,20000,116655,0,136655
141510701000000,NE 154,RESIDENTIAL,20000,0,20000,85362,0,105362
141510701100000,NE 154,RESIDENTIAL,25000,0,25000,70014,0,95014
141510701200000,NE 154,RESIDENTIAL,25000,0,25000,81065,0,106065
141510701300000,NE 154,RESIDENTIAL,25000,0,25000,59246,0,84246
141510701400000,NE 154,RESIDENTIAL,25000,0,25000,79356,0,104356
141510701500000,NE 154,RESIDENTIAL,25000,0,25000,87623,0,112623
141510701600000,NE 154,RESIDENTIAL,25000,0,25000,84879,0,109879
141510701700000,NE 154,RESIDENTIAL,26000,0,26000,99076,0,125076
141510701800000,NE 154,RESIDENTIAL,23585,0,23585,80197,0,103782
141510701900000,NE 154,RESIDENTIAL,18165,0,18165,88748,0,106913
141510702000000,NE 154,RESIDENTIAL,26492,0,26492,98038,0,124530
141510800100000,NE 142,RESIDENTIAL,35244,0,35244,113821,0,149065
141510800200000,NE 142,RESIDENTIAL,28959,0,28959,94694,0,123653
141510800300000,NE 142,RESIDENTIAL,29255,0,29255,80343,0,109598
141510800400000,NE 142,RESIDENTIAL,29255,0,29255,85204,0,114459
141510800500000,NE 142,RESIDENTIAL,28364,0,28364,91304,0,119668
141510800600000,NE 142,RESIDENTIAL,26946,0,26946,133636,0,160582
141510800700000,NE 142,RESIDENTIAL,31050,0,31050,65847,0,96897
141510800800000,NE 142,RESIDENTIAL,26000,0,26000,76768,0,102768
141510800900000,NE 142,RESIDENTIAL,24000,0,24000,128562,0,152562
141510801000000,NE 142,RESIDENTIAL,24000,0,24000,116978,0,140978
141510801100000,NE 142,RESIDENTIAL,25994,0,25994,100896,0,126890
141510801200000,NE 142,RESIDENTIAL,22368,0,22368,75631,0,97999
141510900100000,NE 142,RESIDENTIAL,31275,0,31275,64996,0,96271
141510900200000,NE 142,RESIDENTIAL,30000,0,30000,83455,0,113455
141510900300000,NE 154,RESIDENTIAL,20000,0,20000,77871,0,97871
141512600100000,NE 142,RESIDENTIAL,31741,0,31741,134690,0,166431
141512600200000,NE 142,RESIDENTIAL,31454,0,31454,110363,0,141817
141512600300000,NE 142,RESIDENTIAL,27994,0,27994,111800,0,139794
141512600400000,NE 142,RESIDENTIAL,27994,0,27994,107182,0,135176
141512600500000,NE 142,RESIDENTIAL,27994,0,27994,111959,0,139953
141512600600000,NE 142,RESIDENTIAL,24862,0,24862,98183,0,123045
141512600700000,NE 142,RESIDENTIAL,27330,0,27330,123790,0,151120
141512600800000,NE 142,RESIDENTIAL,28980,0,28980,121482,0,150462
141512600900000,NE 142,RESIDENTIAL,27560,0,27560,107499,0,135059
141512601000000,NE 142,RESIDENTIAL,27820,0,27820,120678,0,148498
141512601100000,NE 142,RESIDENTIAL,29520,0,29520,119083,0,148603
141512700100000,NE 142,EXEMPT,0,31027,31027,0,115305,146332
141512700200000,NE 142,RESIDENTIAL,30748,0,30748,123455,0,154203
141512700300000,NE 142,RESIDENTIAL,28220,0,28220,117379,0,145599
141512700400000,NE 142,RESIDENTIAL,25446,0,25446,102863,0,128309
141512700500000,NE 142,RESIDENTIAL,32318,0,32318,102246,0,134564
141512700600000,NE 142,RESIDENTIAL,30265,0,30265,105502,0,135767
141512700700000,NE 142,RESIDENTIAL,25860,0,25860,111885,0,137745
141512700800000,NE 142,RESIDENTIAL,23819,0,23819,92045,0,115864
141512700900000,NE 142,RESIDENTIAL,25519,0,25519,93424,0,118943
141512701000000,NE 142,RESIDENTIAL,26518,0,26518,115736,0,142254
141512701100000,NE 142,RESIDENTIAL,26589,0,26589,86890,0,113479
141512701200000,NE 142,RESIDENTIAL,26325,0,26325,96815,0,123140
141512701300000,NE 142,RESIDENTIAL,25499,0,25499,110587,0,136086
141512701400000,NE 142,RESIDENTIAL,33167,0,33167,124973,0,158140
141512701500000,NE 142,RESIDENTIAL,31250,0,31250,94152,0,125402
141512701600000,NE 142,RESIDENTIAL,31250,0,31250,100341,0,131591
141512701700000,NE 142,RESIDENTIAL,31563,0,31563,82359,0,113922
141512701800000,NE 142,RESIDENTIAL,30300,0,30300,85142,0,115442
141512701900000,NE 142,RESIDENTIAL,31563,0,31563,76276,0,107839
141512702000000,NE 142,RESIDENTIAL,31875,0,31875,109807,0,141682
141512702100000,NE 142,RESIDENTIAL,34157,0,34157,121591,0,155748
141512702200000,NE 142,RESIDENTIAL,27030,0,27030,83477,0,110507
141512702300000,NE 142,RESIDENTIAL,30900,0,30900,110563,0,141463
141512702400000,NE 142,RESIDENTIAL,30213,0,30213,71838,0,102051
141512702500000,NE 142,RESIDENTIAL,30160,0,30160,99147,0,129307
141512702600000,NE 142,RESIDENTIAL,30160,0,30160,113730,0,143890
141512702700000,NE 142,RESIDENTIAL,30975,0,30975,71817,0,102792
141512800100000,NE 142,RESIDENTIAL,28364,0,28364,89312,0,117676
141512800200000,NE 142,RESIDENTIAL,28077,0,28077,85584,0,113661
141512800300000,NE 142,RESIDENTIAL,35475,0,35475,148838,0,184313
141512800400000,NE 142,RESIDENTIAL,36450,0,36450,91437,0,127887
141512800500000,NE 142,RESIDENTIAL,28875,0,28875,83237,0,112112
141512800600000,NE 142,RESIDENTIAL,33300,0,33300,81930,0,115230
141512900100000,NE 142,RESIDENTIAL,28747,0,28747,112814,0,141561
141512900200000,NE 142,RESIDENTIAL,28583,0,28583,131068,0,159651
141512900300000,NE 142,RESIDENTIAL,28583,0,28583,99428,0,128011
141512900400000,NE 142,RESIDENTIAL,29890,0,29890,111167,0,141057
141512900500000,NE 142,RESIDENTIAL,28420,0,28420,84305,0,112725
141512900600000,NE 142,RESIDENTIAL,28420,0,28420,60745,0,89165
141512900700000,NE 142,RESIDENTIAL,28257,0,28257,79378,0,107635
141512900800000,NE 142,RESIDENTIAL,29237,0,29237,114843,0,144080
141512900900000,NE 142,RESIDENTIAL,26950,0,26950,73509,0,100459
141512901000000,NE 142,RESIDENTIAL,26950,0,26950,73694,0,100644
141512901100000,NE 142,RESIDENTIAL,26950,0,26950,84311,0,111261
141512901200000,NE 142,RESIDENTIAL,26950,0,26950,71258,0,98208
141512901300000,NE 142,RESIDENTIAL,26675,0,26675,97430,0,124105
141512901400000,NE 142,RESIDENTIAL,33255,0,33255,102162,0,135417
141513000100000,NE 142,RESIDENTIAL,32667,0,32667,72702,0,105369
141513000200000,NE 142,RESIDENTIAL,30625,0,30625,66879,0,97504
141513000300000,NE 142,RESIDENTIAL,30625,0,30625,68990,0,99615
141513000400000,NE 142,RESIDENTIAL,30625,0,30625,73628,0,104253
141513000500000,NE 142,RESIDENTIAL,29400,0,29400,106589,0,135989
141513000600000,NE 142,RESIDENTIAL,30625,0,30625,73776,0,104401
141513000700000,NE 142,RESIDENTIAL,30625,0,30625,109456,0,140081
141513000800000,NE 142,RESIDENTIAL,30625,0,30625,98956,0,129581
141513000900000,NE 142,RESIDENTIAL,29890,0,29890,89002,0,118892
141513001000000,NE 142,RESIDENTIAL,26950,0,26950,75560,0,102510
141513001100000,NE 142,RESIDENTIAL,26950,0,26950,72361,0,99311
141513001200000,NE 142,RESIDENTIAL,26950,0,26950,82444,0,109394
141513001300000,NE 142,RESIDENTIAL,26950,0,26950,63086,0,90036
141513001400000,NE 142,RESIDENTIAL,26950,0,26950,45313,0,72263
141513001500000,NE 142,RESIDENTIAL,26950,0,26950,102487,0,129437
141513001600000,NE 142,RESIDENTIAL,26950,0,26950,50188,0,77138
141513001700000,NE 142,RESIDENTIAL,26950,0,26950,61419,0,88369
141513001800000,NE 142,RESIDENTIAL,26950,0,26950,78341,0,105291
141513001900000,NE 142,RESIDENTIAL,32013,0,32013,100901,0,132914
141513100100000,NE 142,RESIDENTIAL,27650,0,27650,103341,0,130991
141513100200000,NE 142,RESIDENTIAL,27150,0,27150,66128,0,93278
141513100300000,NE 142,RESIDENTIAL,27150,0,27150,76378,0,103528
141513100400000,NE 142,RESIDENTIAL,27150,0,27150,76393,0,103543
141513100500000,NE 142,RESIDENTIAL,27150,0,27150,84051,0,111201
141513100600000,NE 142,RESIDENTIAL,27150,0,27150,66764,0,93914
141513100700000,NE 142,RESIDENTIAL,27150,0,27150,87318,0,114468
141513100800000,NE 142,RESIDENTIAL,27150,0,27150,85259,0,112409
141513100900000,NE 142,RESIDENTIAL,27150,0,27150,84022,0,111172
141513101000000,NE 142,RESIDENTIAL,27150,0,27150,96397,0,123547
141513101100000,NE 142,RESIDENTIAL,27150,0,27150,78013,0,105163
141513101200000,NE 142,RESIDENTIAL,27150,0,27150,77574,0,104724
141513101300000,NE 142,RESIDENTIAL,27500,0,27500,84250,0,111750
141513101400000,NE 142,RESIDENTIAL,27500,0,27500,91383,0,118883
141513101500000,NE 142,RESIDENTIAL,26125,0,26125,92687,0,118812
141513101600000,NE 142,RESIDENTIAL,27500,0,27500,83316,0,110816
141513101700000,NE 142,RESIDENTIAL,27500,0,27500,69285,0,96785
141513101800000,NE 142,RESIDENTIAL,27500,0,27500,91359,0,118859
141513101900000,NE 142,RESIDENTIAL,27500,0,27500,85818,0,113318
141513102000000,NE 142,RESIDENTIAL,27500,0,27500,89092,0,116592
141513102100000,NE 142,RESIDENTIAL,30000,0,30000,84118,0,114118
141513200100000,CHURCH,EXEMPT,0,39426,39426,0,232398,271824
141513200200000,NE 142,RESIDENTIAL,28200,0,28200,72663,0,100863
141513200300000,NE 142,RESIDENTIAL,30065,0,30065,88191,0,118256
141513200400000,NE 142,RESIDENTIAL,30226,0,30226,90338,0,120564
141513200500000,NE 142,RESIDENTIAL,27500,0,27500,78791,0,106291
141513200600000,NE 142,RESIDENTIAL,27500,0,27500,74146,0,101646
141513200700000,NE 142,RESIDENTIAL,27500,0,27500,75569,0,103069
141513200800000,NE 142,RESIDENTIAL,27500,0,27500,80723,0,108223
141513200900000,NE 142,RESIDENTIAL,27500,0,27500,87467,0,114967
141513201000000,NE 142,RESIDENTIAL,28900,0,28900,52498,0,81398
141513201100000,NE 142,RESIDENTIAL,30300,0,30300,67848,0,98148
141513201200000,NE 142,RESIDENTIAL,28500,0,28500,85186,0,113686
141513201300000,NE 142,RESIDENTIAL,28500,0,28500,94209,0,122709
141513201400000,NE 142,RESIDENTIAL,27800,0,27800,117254,0,145054
141513201500000,NE 142,RESIDENTIAL,28650,0,28650,65788,0,94438
141513201600000,NE 142,RESIDENTIAL,28967,0,28967,74808,0,103775
141513201700000,NE 142,RESIDENTIAL,29633,0,29633,81763,0,111396
141513201800000,NE 142,RESIDENTIAL,27500,0,27500,76585,0,104085
141513201900000,NE 142,RESIDENTIAL,27500,0,27500,88119,0,115619
141513202000000,NE 142,RESIDENTIAL,27500,0,27500,93063,0,120563
141513202100000,NE 142,RESIDENTIAL,27500,0,27500,113503,0,141003
141513202200000,NE 142,RESIDENTIAL,27500,0,27500,70138,0,97638
141513202300000,NE 142,RESIDENTIAL,27388,0,27388,84812,0,112200
141513202400000,NE 142,RESIDENTIAL,28200,0,28200,74026,0,102226
141513300100000,NE 142,RESIDENTIAL,34584,0,34584,60158,0,94742
141513300200000,NE 142,RESIDENTIAL,28700,0,28700,62877,0,91577
141513300300000,NE 142,RESIDENTIAL,27730,0,27730,64532,0,92262
141513300400000,NE 142,RESIDENTIAL,29500,0,29500,85981,0,115481
141513300500000,NE 142,RESIDENTIAL,33150,0,33150,70214,0,103364
141513300600000,NE 142,RESIDENTIAL,32110,0,32110,68972,0,101082
141513300700000,NE 142,RESIDENTIAL,30300,0,30300,97363,0,127663
141513300800000,NE 142,RESIDENTIAL,30900,0,30900,68042,0,98942
141513300900000,NE 142,RESIDENTIAL,28800,0,28800,83959,0,112759
141513301000000,NE 142,RESIDENTIAL,31315,0,31315,92247,0,123562
141513301100000,NE 142,RESIDENTIAL,29655,0,29655,66702,0,96357
141513301200000,NE 142,RESIDENTIAL,30225,0,30225,99310,0,129535
141513301300000,NE 142,RESIDENTIAL,30000,0,30000,81748,0,111748
141513301400000,NE 142,RESIDENTIAL,31027,0,31027,81433,0,112460
141513301500000,NE 142,RESIDENTIAL,29733,0,29733,91138,0,120871
141513301600000,NE 142,RESIDENTIAL,27730,0,27730,85538,0,113268
141513301700000,NE 142,RESIDENTIAL,27867,0,27867,72929,0,100796
141513400100000,NE 142,RESIDENTIAL,30000,0,30000,87839,0,117839
141513400200000,NE 142,RESIDENTIAL,30000,0,30000,87961,0,117961
141513400300000,NE 142,RESIDENTIAL,30000,0,30000,75093,0,105093
141515100100000,NE 142,RESIDENTIAL,30000,0,30000,88001,0,118001
141515100200000,NE 142,RESIDENTIAL,30000,0,30000,80418,0,110418
141515100300000,NE 142,RESIDENTIAL,30000,0,30000,71328,0,101328
141515100400000,NE 142,RESIDENTIAL,30000,0,30000,79295,0,109295
141515100500000,NE 142,RESIDENTIAL,30000,0,30000,74590,0,104590
141515100600000,NE 142,RESIDENTIAL,30000,0,30000,92054,0,122054
141515100700000,NE 142,RESIDENTIAL,31550,0,31550,93214,0,124764
141515100800000,NE 142,RESIDENTIAL,25833,0,25833,78471,0,104304
141515100900000,NE 142,RESIDENTIAL,27500,0,27500,80102,0,107602
141515101000000,NE 142,RESIDENTIAL,27500,0,27500,73650,0,101150
141515101100000,NE 142,RESIDENTIAL,27500,0,27500,95508,0,123008
141515101200000,NE 142,RESIDENTIAL,27500,0,27500,89497,0,116997
141515101300000,NE 142,RESIDENTIAL,27500,0,27500,93847,0,121347
141515101400000,NE 142,RESIDENTIAL,28001,0,28001,105279,0,133280
141515101500000,NE 142,RESIDENTIAL,32082,0,32082,88173,0,120255
141515101600000,NE 154,RESIDENTIAL,26541,0,26541,78981,0,105522
141515101700000,NE 154,RESIDENTIAL,23500,0,23500,90778,0,114278
141515101800000,NE 154,RESIDENTIAL,26500,0,26500,88497,0,114997
141515101900000,NE 154,RESIDENTIAL,27912,0,27912,87602,0,115514
141515102000000,NE 154,RESIDENTIAL,23275,0,23275,51958,0,75233
141515102100000,CITY PROPERTY,EXEMPT,0,0,0,0,0,0
141515102200000,NE 154,RESIDENTIAL,30856,0,30856,124370,0,155226
141515102300000,NE 154,RESIDENTIAL,26540,0,26540,119108,0,145648
141515102400000,NE 154,RESIDENTIAL,21500,0,21500,86335,0,107835
141515102500000,CITY PROPERTY,EXEMPT,0,0,0,0,0,0
141515200100000,NE 142,RESIDENTIAL,27500,0,27500,102822,0,130322
141515200200000,NE 142,RESIDENTIAL,27500,0,27500,85059,0,112559
141515200300000,NE 142,RESIDENTIAL,27500,0,27500,98093,0,125593
141515200400000,NE 142,RESIDENTIAL,28625,0,28625,64184,0,92809
141515200500000,NE 142,RESIDENTIAL,28333,0,28333,77636,0,105969
141515200600000,NE 142,RESIDENTIAL,31225,0,31225,94685,0,125910
141515200700000,NE 142,RESIDENTIAL,31225,0,31225,83912,0,115137
141515200800000,NE 142,RESIDENTIAL,31050,0,31050,84265,0,115315
141515200900000,NE 142,RESIDENTIAL,32534,0,32534,110722,0,143256
141515201000000,NE 142,RESIDENTIAL,27500,0,27500,78421,0,105921
141515201100000,NE 142,RESIDENTIAL,27500,0,27500,80645,0,108145
141515201200000,NE 142,RESIDENTIAL,27500,0,27500,74603,0,102103
141515201300000,NE 142,RESIDENTIAL,28967,0,28967,79876,0,108843
141515201400000,NE 142,RESIDENTIAL,28325,0,28325,76696,0,105021
141515300100000,NE 142,RESIDENTIAL,28650,0,28650,90959,0,119609
141515300200000,NE 142,RESIDENTIAL,31403,0,31403,126600,0,158003
141515400100000,NE 154,RESIDENTIAL,25433,0,25433,88231,0,113664
141515400200000,NE 154,RESIDENTIAL,26910,0,26910,107448,0,134358
141515400300000,NE 154,RESIDENTIAL,25867,0,25867,88052,0,113919
141515400400000,NE 154,RESIDENTIAL,26010,0,26010,77902,0,103912
141515400500000,NE 154,RESIDENTIAL,26775,0,26775,67031,0,93806
141515400600000,NE 154,RESIDENTIAL,25769,0,25769,75466,0,101235
141515400700000,NE 154,RESIDENTIAL,24700,0,24700,58014,0,82714
141515400800000,NE 154,RESIDENTIAL,25372,0,25372,74030,0,99402
141515400900000,NE 154,RESIDENTIAL,22476,0,22476,48455,0,70931
141515401000000,NE 154,RESIDENTIAL,21825,0,21825,57476,0,79301
141515401100000,NE 154,RESIDENTIAL,23744,0,23744,103720,0,127464
141515401200000,NE 154,RESIDENTIAL,25680,0,25680,94326,0,120006
141515401300000,NE 154,RESIDENTIAL,25680,0,25680,121241,0,146921
141515401400000,NE 154,RESIDENTIAL,21400,0,21400,94163,0,115563
141515401500000,NE 154,RESIDENTIAL,21400,0,21400,87846,0,109246
141515401600000,NE 154,RESIDENTIAL,21200,0,21200,81721,0,102921
141515401700000,NE 154,RESIDENTIAL,21000,0,21000,87774,0,108774
141515401800000,NE 154,RESIDENTIAL,21000,0,21000,91328,0,112328
141515401900000,NE 154,RESIDENTIAL,20800,0,20800,83506,0,104306
141515402000000,NE 154,RESIDENTIAL,20600,0,20600,70723,0,91323
141515402100000,NE 154,RESIDENTIAL,20600,0,20600,74638,0,95238
141515402200000,NE 154,RESIDENTIAL,20400,0,20400,64672,0,85072
141515402300000,NE 154,RESIDENTIAL,20200,0,20200,85819,0,106019
141515402400000,NE 154,RESIDENTIAL,20200,0,20200,100576,0,120776
141515500100000,NE 154,RESIDENTIAL,22140,0,22140,72538,0,94678
141515500200000,NE 154,RESIDENTIAL,20300,0,20300,100626,0,120926
141515500300000,NE 154,RESIDENTIAL,21500,0,21500,72803,0,94303
141515500400000,NE 154,RESIDENTIAL,21500,0,21500,112065,0,133565
141515500500000,NE 154,RESIDENTIAL,21500,0,21500,91090,0,112590
141515500600000,NE 154,RESIDENTIAL,21500,0,21500,94357,0,115857
141515500700000,NE 154,RESIDENTIAL,21667,0,21667,85756,0,107423
141515500800000,NE 154,RESIDENTIAL,25833,0,25833,117902,0,143735
141515500900000,NE 154,RESIDENTIAL,23460,0,23460,134141,0,157601
141515501000000,NE 154,RESIDENTIAL,22893,0,22893,125104,0,147997
141515600100000,NE 154,RESIDENTIAL,22667,0,22667,86798,0,109465
141515600200000,NE 154,RESIDENTIAL,20167,0,20167,99382,0,119549
141515600300000,NE 154,RESIDENTIAL,20000,0,20000,69924,0,89924
141515600400000,NE 154,RESIDENTIAL,21683,0,21683,75662,0,97345
141515700100000,NE 154,RESIDENTIAL,26500,0,26500,34229,0,60729
141515700200000,NE 154,RESIDENTIAL,22128,0,22128,57214,0,79342
141515700300000,NE 154,RESIDENTIAL,22100,0,22100,78132,0,100232
141515700400000,NE 154,RESIDENTIAL,22620,0,22620,72866,0,95486
141515700500000,NE 154,RESIDENTIAL,20800,0,20800,70690,0,91490
141515700600000,NE 154,RESIDENTIAL,20800,0,20800,80160,0,100960
141515700700000,NE 154,RESIDENTIAL,22733,0,22733,59916,0,82649
141515700800000,NE 154,RESIDENTIAL,22500,0,22500,58353,0,80853
141515700900000,NE 154,RESIDENTIAL,24760,0,24760,75079,0,99839
141515701000000,NE 154,RESIDENTIAL,28280,0,28280,92082,0,120362
141515701100000,NE 154,RESIDENTIAL,20400,0,20400,81455,0,101855
141515701200000,NE 154,RESIDENTIAL,20600,0,20600,88987,0,109587
141515701300000,NE 154,RESIDENTIAL,20800,0,20800,86836,0,107636
141515701400000,NE 154,RESIDENTIAL,20800,0,20800,73931,0,94731
141515701500000,NE 154,RESIDENTIAL,21000,0,21000,97558,0,118558
141517600100000,NE 154,RESIDENTIAL,25500,0,25500,102227,0,127727
141517600200000,NE 154,RESIDENTIAL,20400,0,20400,97920,0,118320
141517600300000,NE 154,RESIDENTIAL,20400,0,20400,109353,0,129753
141517600400000,NE 154,RESIDENTIAL,20400,0,20400,85506,0,105906
141517600500000,NE 154,RESIDENTIAL,20400,0,20400,94935,0,115335
141517600600000,NE 154,RESIDENTIAL,20400,0,20400,98980,0,119380
141517600700000,NE 154,RESIDENTIAL,20400,0,20400,96805,0,117205
141517600800000,NE 154,RESIDENTIAL,20400,0,20400,92237,0,112637
141517600900000,NE 154,RESIDENTIAL,20400,0,20400,77242,0,97642
141517601000000,NE 154,RESIDENTIAL,20400,0,20400,77971,0,98371
141517601100000,NE 154,RESIDENTIAL,17606,0,17606,90586,0,108192
141517601200000,NE 154,RESIDENTIAL,14000,0,14000,65209,0,79209
141517601300000,NE 154,RESIDENTIAL,16800,0,16800,88918,0,105718
141517601400000,NE 154,RESIDENTIAL,17000,0,17000,84785,0,101785
141517601500000,NE 154,RESIDENTIAL,23600,0,23600,83207,0,106807
141517601600000,NE 154,RESIDENTIAL,20158,0,20158,77435,0,97593
141517601700000,NE 154,RESIDENTIAL,25500,0,25500,97115,0,122615
141517601800000,NE 154,RESIDENTIAL,25500,0,25500,110103,0,135603
141517601900000,NE 154,RESIDENTIAL,25500,0,25500,93483,0,118983
141517602000000,NE 154,RESIDENTIAL,25500,0,25500,76054,0,101554
141517602100000,NE 154,RESIDENTIAL,25500,0,25500,83499,0,108999
141517602200000,NE 154,RESIDENTIAL,25500,0,25500,155143,0,180643
141517602300000,NE 154,RESIDENTIAL,25500,0,25500,94605,0,120105
141517700100000,NE 154,RESIDENTIAL,21200,0,21200,120974,0,142174
141517700200000,NE 154,RESIDENTIAL,20600,0,20600,103054,0,123654
141517700300000,NE 154,RESIDENTIAL,20600,0,20600,92892,0,113492
141517700400000,NE 154,RESIDENTIAL,20600,0,20600,82742,0,103342
141517700500000,NE 154,RESIDENTIAL,20600,0,20600,67677,0,88277
141517700600000,NE 154,RESIDENTIAL,20600,0,20600,80493,0,101093
141517700700000,NE 154,RESIDENTIAL,20600,0,20600,83919,0,104519
141517700800000,NE 154,RESIDENTIAL,20600,0,20600,105805,0,126405
141517700900000,NE 154,RESIDENTIAL,20600,0,20600,109140,0,129740
141517701000000,NE 154,RESIDENTIAL,21200,0,21200,109473,0,130673
141517701100000,NE 154,RESIDENTIAL,21200,0,21200,91176,0,112376
141517701200000,NE 154,RESIDENTIAL,21200,0,21200,77985,0,99185
141517701300000,NE 154,RESIDENTIAL,21200,0,21200,81894,0,103094
141517701400000,NE 154,RESIDENTIAL,21200,0,21200,107359,0,128559
141517701500000,NE 154,RESIDENTIAL,21200,0,21200,96220,0,117420
141517701600000,NE 154,RESIDENTIAL,21200,0,21200,89639,0,110839
141517701700000,NE 154,RESIDENTIAL,21200,0,21200,100894,0,122094
141517800100000,NE 154,RESIDENTIAL,17600,0,17600,84960,0,102560
141517800200000,NE 154,RESIDENTIAL,19200,0,19200,71497,0,90697
141517800300000,NE 154,RESIDENTIAL,20335,0,20335,105916,0,126251
141517800400000,NE 154,RESIDENTIAL,17200,0,17200,67143,0,84343
141517800500000,NE 154,RESIDENTIAL,15800,0,15800,80667,0,96467
141517800600000,NE 154,RESIDENTIAL,24700,0,24700,67145,0,91845
141517800700000,NE 154,RESIDENTIAL,20850,0,20850,119377,0,140227
141517800800000,NE 154,RESIDENTIAL,17600,0,17600,74882,0,92482
141517800900000,NE 154,RESIDENTIAL,16600,0,16600,84684,0,101284
141517900100000,NE 154,RESIDENTIAL,20000,0,20000,54497,0,74497
141517900200000,NE 154,RESIDENTIAL,25000,0,25000,70520,0,95520
141517900300000,NE 154,RESIDENTIAL,25000,0,25000,87174,0,112174
141517900400000,NE 154,RESIDENTIAL,25000,0,25000,83224,0,108224
141517900500000,NE 154,RESIDENTIAL,25000,0,25000,83892,0,108892
141517900600000,NE 154,RESIDENTIAL,20000,0,20000,91013,0,111013
141518000100000,NE 154,RESIDENTIAL,25500,0,25500,95678,0,121178
141518000200000,NE 154,RESIDENTIAL,19256,0,19256,76218,0,95474
141518000300000,NE 154,RESIDENTIAL,19950,0,19950,62773,0,82723
141518100100000,NE 154,RESIDENTIAL,18000,0,18000,84363,0,102363
141518100200000,NE 154,RESIDENTIAL,16246,0,16246,69528,0,85774
141518100300000,NE 154,RESIDENTIAL,16720,0,16720,71711,0,88431
141518100400000,NE 154,RESIDENTIAL,25500,0,25500,67192,0,92692
141518100500000,NE 154,RESIDENTIAL,25500,0,25500,82161,0,107661
141518100600000,NE 154,RESIDENTIAL,20400,0,20400,85982,0,106382
141518100700000,NE 154,RESIDENTIAL,20400,0,20400,74748,0,95148
141518100800000,NE 154,RESIDENTIAL,25500,0,25500,85855,0,111355
141518100900000,NE 154,RESIDENTIAL,25500,0,25500,143511,0,169011
141518101000000,NE 154,RESIDENTIAL,25500,0,25500,120848,0,146348
141518101100000,NE 154,RESIDENTIAL,25500,0,25500,92524,0,118024
141518101200000,NE 154,RESIDENTIAL,26146,0,26146,93898,0,120044
141518101300000,NE 154,RESIDENTIAL,21879,0,21879,72996,0,94875
141518101400000,NE 154,RESIDENTIAL,20400,0,20400,70761,0,91161
141518101500000,NE 154,RESIDENTIAL,20400,0,20400,70536,0,90936
141518101600000,NE 154,RESIDENTIAL,20400,0,20400,70647,0,91047
141518101700000,NE 154,RESIDENTIAL,20400,0,20400,70052,0,90452
141518200100000,NE 154,RESIDENTIAL,22139,0,22139,86425,0,108564
141518200200000,NE 154,RESIDENTIAL,21545,0,21545,72257,0,93802
141518200300000,NE 154,RESIDENTIAL,18675,0,18675,70617,0,89292
141518200400000,NE 154,RESIDENTIAL,14700,0,14700,71787,0,86487
141518200500000,NE 154,RESIDENTIAL,18653,0,18653,78557,0,97210
141518200600000,NE 154,RESIDENTIAL,14000,0,14000,66372,0,80372
141518200700000,NE 154,RESIDENTIAL,20400,0,20400,90862,0,111262
141518200800000,NE 154,RESIDENTIAL,20400,0,20400,88103,0,108503
141518200900000,NE 154,RESIDENTIAL,20400,0,20400,94527,0,114927
141518201000000,NE 154,RESIDENTIAL,20400,0,20400,107652,0,128052
141518201100000,NE 154,RESIDENTIAL,20400,0,20400,87671,0,108071
141518201200000,NE 154,RESIDENTIAL,20400,0,20400,86529,0,106929
141518201300000,NE 154,RESIDENTIAL,20400,0,20400,112227,0,132627
141518201400000,NE 154,RESIDENTIAL,20400,0,20400,78566,0,98966
141518201500000,NE 154,RESIDENTIAL,20400,0,20400,104219,0,124619
141518201600000,NE 154,RESIDENTIAL,21375,0,21375,91696,0,113071
141518201700000,NE 154,RESIDENTIAL,21978,0,21978,82001,0,103979
141518201800000,NE 154,RESIDENTIAL,17700,0,17700,96958,0,114658
141518201900000,NE 154,RESIDENTIAL,23829,0,23829,82324,0,106153
141518202000000,NE 154,RESIDENTIAL,25500,0,25500,89885,0,115385
141518202100000,NE 154,RESIDENTIAL,25500,0,25500,108502,0,134002
141518202200000,NE 154,RESIDENTIAL,25500,0,25500,113624,0,139124
141518202300000,NE 154,RESIDENTIAL,25500,0,25500,97998,0,123498
141518202400000,NE 154,RESIDENTIAL,22950,0,22950,0,0,22950
141518202500000,NE 154,RESIDENTIAL,22950,0,22950,69167,0,92117
141518202600000,NE 154,RESIDENTIAL,25500,0,25500,91711,0,117211
141518202700000,NE 154,RESIDENTIAL,25500,0,25500,113708,0,139208
141518300100000,NE 154,RESIDENTIAL,18119,0,18119,78097,0,96216
141518300200000,NE 154,RESIDENTIAL,18200,0,18200,93961,0,112161
141518300300000,NE 154,RESIDENTIAL,19975,0,19975,77300,0,97275
141518300400000,NE 154,RESIDENTIAL,20783,0,20783,78470,0,99253
141518300500000,NE 154,RESIDENTIAL,19975,0,19975,88744,0,108719
141518300600000,NE 154,RESIDENTIAL,20000,0,20000,99755,0,119755
141518300700000,NE 154,RESIDENTIAL,20000,0,20000,73875,0,93875
141518300800000,NE 154,RESIDENTIAL,20000,0,20000,64273,0,84273
141518300900000,NE 154,RESIDENTIAL,20000,0,20000,79135,0,99135
141518301000000,NE 154,RESIDENTIAL,20000,0,20000,82565,0,102565
141518301100000,NE 154,RESIDENTIAL,20000,0,20000,85162,0,105162
141518301200000,NE 154,RESIDENTIAL,20000,0,20000,106605,0,126605
141518301300000,NE 154,RESIDENTIAL,20000,0,20000,122601,0,142601
141518301400000,NE 154,RESIDENTIAL,24900,0,24900,96492,0,121392
141518301500000,NE 154,RESIDENTIAL,16800,0,16800,112520,0,129320
141518301600000,NE 154,RESIDENTIAL,16800,0,16800,107200,0,124000
141518301700000,NE 154,RESIDENTIAL,15390,0,15390,85131,0,100521
141518301800000,NE 154,RESIDENTIAL,22384,0,22384,108813,0,131197
141518301900000,NE 154,RESIDENTIAL,20000,0,20000,101611,0,121611
141518302000000,NE 154,RESIDENTIAL,20000,0,20000,84139,0,104139
141518302100000,NE 154,RESIDENTIAL,20000,0,20000,80868,0,100868
141518302200000,NE 154,RESIDENTIAL,20000,0,20000,84988,0,104988
141518302300000,NE 154,RESIDENTIAL,20000,0,20000,106013,0,126013
141518302400000,NE 154,RESIDENTIAL,20000,0,20000,108244,0,128244
141518302500000,NE 154,RESIDENTIAL,20000,0,20000,78581,0,98581
141518302600000,NE 154,RESIDENTIAL,20000,0,20000,84303,0,104303
141518302700000,NE 154,RESIDENTIAL,20000,0,20000,81688,0,101688
141518302800000,NE 154,RESIDENTIAL,20000,0,20000,105019,0,125019
141518400100000,NE 154,RESIDENTIAL,25700,0,25700,97206,0,122906
141518400200000,NE 154,RESIDENTIAL,19264,0,19264,69611,0,88875
141518400300000,NE 154,RESIDENTIAL,26082,0,26082,105516,0,131598
141518400400000,NE 154,RESIDENTIAL,20000,0,20000,104851,0,124851
141518400500000,NE 154,RESIDENTIAL,20000,0,20000,78416,0,98416
141518400600000,NE 154,RESIDENTIAL,20000,0,20000,92917,0,112917
141518400700000,NE 154,RESIDENTIAL,20000,0,20000,90738,0,110738
141518400800000,NE 154,RESIDENTIAL,20000,0,20000,96880,0,116880
141518400900000,NE 154,RESIDENTIAL,20000,0,20000,109487,0,129487
141518401000000,NE 154,RESIDENTIAL,20000,0,20000,95008,0,115008
141518401100000,NE 154,RESIDENTIAL,20000,0,20000,97251,0,117251
141518401200000,NE 154,RESIDENTIAL,20600,0,20600,92891,0,113491
141518401300000,NE 154,RESIDENTIAL,21200,0,21200,96977,0,118177
141518401400000,NE 154,RESIDENTIAL,28000,0,28000,123930,0,151930
141518401500000,NE 154,RESIDENTIAL,20000,0,20000,71185,0,91185
141518401600000,NE 154,RESIDENTIAL,20000,0,20000,109518,0,129518
141518401700000,NE 154,RESIDENTIAL,20000,0,20000,92361,0,112361
141518401800000,NE 154,RESIDENTIAL,20000,0,20000,95085,0,115085
141518401900000,NE 154,RESIDENTIAL,20000,0,20000,102813,0,122813
141518402000000,NE 154,RESIDENTIAL,20000,0,20000,77966,0,97966
141518402100000,NE 154,RESIDENTIAL,20000,0,20000,82353,0,102353
141518402200000,NE 154,RESIDENTIAL,20000,0,20000,86072,0,106072
141518500100000,NE 154,RESIDENTIAL,37284,0,37284,101116,0,138400
141518500200000,NE 154,RESIDENTIAL,37895,0,37895,114966,0,152861
141518500300000,NE 154,RESIDENTIAL,36478,0,36478,133126,0,169604
141518500400000,NE 154,RESIDENTIAL,24627,0,24627,113962,0,138589
141518500500000,NE 154,RESIDENTIAL,29547,0,29547,111762,0,141309
141518500600000,NE 154,RESIDENTIAL,28123,0,28123,93959,0,122082
141518600100000,NE 154,RESIDENTIAL,21227,0,21227,100784,0,122011
141518600200000,NE 154,RESIDENTIAL,22575,0,22575,78511,0,101086
141518600300000,NE 154,RESIDENTIAL,22360,0,22360,117189,0,139549
141518600400000,NE 154,RESIDENTIAL,22145,0,22145,97848,0,119993
141518600500000,NE 154,RESIDENTIAL,21930,0,21930,112732,0,134662
141518600600000,NE 154,RESIDENTIAL,22624,0,22624,79936,0,102560
141518600700000,NE 154,RESIDENTIAL,30000,0,30000,107112,0,137112
141518600800000,NE 154,RESIDENTIAL,19800,0,19800,91113,0,110913
141518600900000,NE 154,RESIDENTIAL,19600,0,19600,97957,0,117557
141518601000000,NE 154,RESIDENTIAL,19400,0,19400,91546,0,110946
141518601100000,NE 154,RESIDENTIAL,19200,0,19200,102571,0,121771
141518601200000,NE 154,RESIDENTIAL,18800,0,18800,84647,0,103447
141518601300000,NE 154,RESIDENTIAL,18600,0,18600,83855,0,102455
141518601400000,NE 154,RESIDENTIAL,19262,0,19262,77535,0,96797
141518601500000,NE 154,RESIDENTIAL,21160,0,21160,86301,0,107461
141518601600000,NE 154,RESIDENTIAL,18600,0,18600,79648,0,98248
141518601700000,NE 154,RESIDENTIAL,18800,0,18800,80302,0,99102
141518601800000,NE 154,RESIDENTIAL,19200,0,19200,84923,0,104123
141518601900000,NE 154,RESIDENTIAL,19400,0,19400,88573,0,107973
141518602000000,NE 154,RESIDENTIAL,29400,0,29400,118064,0,147464
141518602100000,NE 154,RESIDENTIAL,21714,0,21714,84621,0,106335
141518602200000,NE 154,RESIDENTIAL,23833,0,23833,80352,0,104185
141518602300000,NE 154,RESIDENTIAL,21210,0,21210,84907,0,106117
141518602400000,NE 154,RESIDENTIAL,21420,0,21420,93073,0,114493
141518602500000,NE 154,RESIDENTIAL,21840,0,21840,136398,0,158238
141518602600000,NE 154,RESIDENTIAL,21350,0,21350,117650,0,139000
141518602700000,NE 154,RESIDENTIAL,23000,0,23000,104026,0,127026
141518602800000,NE 154,RESIDENTIAL,19400,0,19400,105810,0,125210
141518602900000,NE 154,RESIDENTIAL,24509,0,24509,137720,0,162229
141518603000000,NE 154,RESIDENTIAL,19529,0,19529,102132,0,121661
141518700100000,NE 154,RESIDENTIAL,19500,0,19500,93225,0,112725
141518700200000,NE 154,RESIDENTIAL,17550,0,17550,77412,0,94962
141518700300000,NE 154,RESIDENTIAL,17775,0,17775,68442,0,86217
141518700400000,NE 154,RESIDENTIAL,16380,0,16380,65120,0,81500
141518700500000,NE 154,RESIDENTIAL,16380,0,16380,91278,0,107658
141518700600000,NE 154,RESIDENTIAL,20000,0,20000,97580,0,117580
141518700700000,NE 154,RESIDENTIAL,22000,0,22000,99135,0,121135
141518700800000,NE 154,RESIDENTIAL,22667,0,22667,131136,0,153803
141518700900000,NE 154,RESIDENTIAL,22893,0,22893,85923,0,108816
141518701000000,NE 154,RESIDENTIAL,22893,0,22893,85049,0,107942
141518701100000,NE 154,RESIDENTIAL,22893,0,22893,126323,0,149216
141518701200000,NE 154,RESIDENTIAL,22893,0,22893,89950,0,112843
141518800100000,NE 154,RESIDENTIAL,19071,0,19071,68086,0,87157
141518800200000,NE 154,RESIDENTIAL,18871,0,18871,114229,0,133100
141518800300000,NE 154,RESIDENTIAL,18670,0,18670,95366,0,114036
141518800400000,NE 154,RESIDENTIAL,18423,0,18423,71455,0,89878
141518800500000,NE 154,RESIDENTIAL,23508,0,23508,104226,0,127734
141520100200000,NE 142,RESIDENTIAL,28359,0,28359,102707,0,131066
141520100300000,NE 142,RESIDENTIAL,31047,0,31047,102588,0,133635
141520100400000,NE 142,RESIDENTIAL,28786,0,28786,102102,0,130888
141520100500000,NE 142,RESIDENTIAL,22716,0,22716,78783,0,101499
141520200100000,NE 142,RESIDENTIAL,30075,0,30075,96421,0,126496
141520200200000,NE 142,RESIDENTIAL,23060,0,23060,79929,0,102989
141520200300000,NE 142,RESIDENTIAL,24300,0,24300,95751,0,120051
141520200400000,NE 142,RESIDENTIAL,24543,0,24543,75709,0,100252
141520200500000,NE 142,RESIDENTIAL,25029,0,25029,79191,0,104220
141520200600000,NE 142,RESIDENTIAL,25515,0,25515,101456,0,126971
141520200700000,NE 142,RESIDENTIAL,25758,0,25758,86024,0,111782
141520200800000,NE 142,RESIDENTIAL,26244,0,26244,94550,0,120794
141520200900000,NE 142,RESIDENTIAL,26487,0,26487,77932,0,104419
141520201000000,NE 142,RESIDENTIAL,26730,0,26730,70140,0,96870
141520201100000,NE 142,RESIDENTIAL,29221,0,29221,75714,0,104935
141520201200000,NE 142,RESIDENTIAL,29484,0,29484,103571,0,133055
141520201300000,NE 144,RESIDENTIAL,31465,0,31465,113974,0,145439
141520201400000,NE 144,RESIDENTIAL,31987,0,31987,130186,0,162173
141520201500000,NE 144,RESIDENTIAL,33862,0,33862,119404,0,153266
141520201600000,NE 142,RESIDENTIAL,29200,0,29200,160453,0,189653
141520201700000,NE 142,RESIDENTIAL,26532,0,26532,77305,0,103837
141520201800000,NE 142,RESIDENTIAL,28080,0,28080,97331,0,125411
141520201900000,NE 142,RESIDENTIAL,28860,0,28860,141088,0,169948
141520202000000,NE 142,RESIDENTIAL,29067,0,29067,70622,0,99689
141520202100000,NE 142,RESIDENTIAL,28656,0,28656,110584,0,139240
141520202200000,NE 142,RESIDENTIAL,26719,0,26719,126099,0,152818
141520202300000,NE 142,RESIDENTIAL,27553,0,27553,117522,0,145075
141520202400000,NE 142,RESIDENTIAL,27064,0,27064,151603,0,178667
141520202500000,NE 142,RESIDENTIAL,26799,0,26799,125240,0,152039
141520202600000,NE 142,RESIDENTIAL,26799,0,26799,82455,0,109254
141520202700000,NE 142,RESIDENTIAL,26533,0,26533,96206,0,122739
141520202800000,NE 142,RESIDENTIAL,24533,0,24533,94784,0,119317
141520202900000,NE 142,RESIDENTIAL,24779,0,24779,97059,0,121838
141520203000000,NE 142,RESIDENTIAL,28346,0,28346,115688,0,144034
141520300100000,NE 142,RESIDENTIAL,32259,0,32259,96704,0,128963
141520300200000,NE 142,RESIDENTIAL,22997,0,22997,85038,0,108035
141520300300000,NE 142,RESIDENTIAL,22997,0,22997,90725,0,113722
141520300400000,NE 142,RESIDENTIAL,22971,0,22971,111755,0,134726
141520300500000,NE 142,RESIDENTIAL,26717,0,26717,89322,0,116039
141520300600000,NE 142,RESIDENTIAL,23467,0,23467,81591,0,105058
141520300700000,NE 142,RESIDENTIAL,23701,0,23701,92113,0,115814
141520300800000,NE 142,RESIDENTIAL,23701,0,23701,92453,0,116154
141520300900000,NE 142,RESIDENTIAL,23701,0,23701,122217,0,145918
141520301000000,NE 142,RESIDENTIAL,23701,0,23701,95299,0,119000
141520301100000,NE 142,RESIDENTIAL,23467,0,23467,110841,0,134308
141520301200000,NE 142,RESIDENTIAL,23467,0,23467,127972,0,151439
141520301300000,NE 142,RESIDENTIAL,26970,0,26970,136341,0,163311
141520301400000,NE 142,RESIDENTIAL,27440,0,27440,97059,0,124499
141520301500000,NE 142,RESIDENTIAL,25349,0,25349,103951,0,129300
141520301600000,NE 142,RESIDENTIAL,24957,0,24957,135886,0,160843
141520301700000,NE 142,RESIDENTIAL,25991,0,25991,142627,0,168618
141520301800000,NE 142,RESIDENTIAL,31555,0,31555,105707,0,137262
141520301900000,NE 142,RESIDENTIAL,22420,0,22420,105388,0,127808
141520302000000,NE 142,RESIDENTIAL,22848,0,22848,103168,0,126016
141520302100000,NE 142,RESIDENTIAL,23940,0,23940,102382,0,126322
141520302200000,NE 142,RESIDENTIAL,31622,0,31622,153495,0,185117
141520302300000,NE 142,RESIDENTIAL,33884,0,33884,108570,0,142454
141520302400000,NE 142,RESIDENTIAL,31388,0,31388,106711,0,138099
141520302500000,NE 142,RESIDENTIAL,25587,0,25587,85745,0,111332
141520302600000,NE 142,RESIDENTIAL,25476,0,25476,95035,0,120511
141520302700000,NE 142,RESIDENTIAL,25740,0,25740,76023,0,101763
141520302800000,NE 142,RESIDENTIAL,25220,0,25220,81810,0,107030
141520302900000,NE 142,RESIDENTIAL,23680,0,23680,105471,0,129151
141520303000000,NE 142,RESIDENTIAL,23280,0,23280,79338,0,102618
141520303100000,NE 142,RESIDENTIAL,23280,0,23280,85252,0,108532
141520303200000,NE 142,RESIDENTIAL,23520,0,23520,87232,0,110752
141520303300000,NE 142,RESIDENTIAL,22633,0,22633,70837,0,93470
141520400100000,NE 142,RESIDENTIAL,29813,0,29813,118996,0,148809
141520400200000,NE 142,RESIDENTIAL,24480,0,24480,111008,0,135488
141520400300000,NE 142,RESIDENTIAL,23760,0,23760,147951,0,171711
141520400400000,NE 142,RESIDENTIAL,23040,0,23040,101897,0,124937
141520400500000,NE 142,RESIDENTIAL,23903,0,23903,89399,0,113302
141520400600000,NE 142,RESIDENTIAL,23520,0,23520,106398,0,129918
141520400700000,NE 142,RESIDENTIAL,20814,0,20814,61599,0,82413
141520400800000,NE 142,RESIDENTIAL,29580,0,29580,121725,0,151305
141520400900000,NE 142,RESIDENTIAL,26000,0,26000,103127,0,129127
141520401000000,NE 142,RESIDENTIAL,25480,0,25480,140998,0,166478
141520401100000,NE 142,RESIDENTIAL,22800,0,22800,81293,0,104093
141520401200000,NE 142,RESIDENTIAL,23520,0,23520,87496,0,111016
141520401300000,NE 142,RESIDENTIAL,24240,0,24240,94969,0,119209
141520401400000,NE 142,RESIDENTIAL,24720,0,24720,96063,0,120783
141520401500000,NE 142,RESIDENTIAL,29344,0,29344,99170,0,128514
141522600100000,NE 144,RESIDENTIAL,31919,0,31919,115114,0,147033
141522600200000,NE 145,RESIDENTIAL,35802,0,35802,104553,0,140355
141522600300000,NE 145,RESIDENTIAL,24618,0,24618,94581,0,119199
141522600400000,NE 145,RESIDENTIAL,29452,0,29452,133229,0,162681
141522600500000,NE 145,RESIDENTIAL,32400,0,32400,121096,0,153496
141522600600000,NE 145,RESIDENTIAL,32400,0,32400,139800,0,172200
141522600700000,NE 145,RESIDENTIAL,32400,0,32400,137137,0,169537
141522600800000,NE 145,RESIDENTIAL,31590,0,31590,149997,0,181587
141522600900000,NE 145,RESIDENTIAL,31169,0,31169,126668,0,157837
141522601000000,NE 145,RESIDENTIAL,30982,0,30982,112514,0,143496
141522601100000,NE 145,RESIDENTIAL,27675,0,27675,109977,0,137652
141522601300000,NE 145,RESIDENTIAL,34020,0,34020,99059,0,133079
141522601400000,NE 145,RESIDENTIAL,34181,0,34181,90835,0,125016
141522601500000,NE 145,RESIDENTIAL,22599,0,22599,72290,0,94889
141522601600000,NE 145,RESIDENTIAL,32100,0,32100,73107,0,105207
141522601700000,NE 145,RESIDENTIAL,36413,0,36413,140195,0,176608
141522601800000,NE 145,RESIDENTIAL,27500,0,27500,119938,0,147438
141522601900000,NE 145,RESIDENTIAL,27500,0,27500,90456,0,117956
141522602100000,NE 145,RESIDENTIAL,36400,0,36400,138364,0,174764
141522602200000,NE 145,RESIDENTIAL,34775,0,34775,94661,0,129436
141522602300000,NE 145,RESIDENTIAL,36483,0,36483,126409,0,162892
141522602400000,NE 145,RESIDENTIAL,30680,0,30680,86218,0,116898
141522602500000,NE 145,RESIDENTIAL,34147,0,34147,137636,0,171783
141522602600000,NE 144,RESIDENTIAL,32165,0,32165,126378,0,158543
141522602700000,NE 144,RESIDENTIAL,30600,0,30600,138591,0,169191
141522602800000,NE 144,RESIDENTIAL,34707,0,34707,120017,0,154724
141522602900000,NE 144,RESIDENTIAL,33528,0,33528,121100,0,154628
141522603000000,NE 144,RESIDENTIAL,28400,0,28400,124989,0,153389
141522603100000,NE 144,RESIDENTIAL,26395,0,26395,134586,0,160981
141522603200000,NE 144,RESIDENTIAL,42124,0,42124,146145,0,188269
141522700100000,NE 144,RESIDENTIAL,35142,0,35142,138841,0,173983
141522700200000,NE 144,RESIDENTIAL,28644,0,28644,116955,0,145599
141522700300000,NE 144,RESIDENTIAL,31552,0,31552,122958,0,154510
141522700400000,NE 144,RESIDENTIAL,31293,0,31293,127759,0,159052
141522700500000,NE 144,RESIDENTIAL,35094,0,35094,130278,0,165372
141522700600000,NE 145,RESIDENTIAL,34840,0,34840,96489,0,131329
141522700700000,NE 145,RESIDENTIAL,33453,0,33453,117467,0,150920
141522700800000,NE 145,RESIDENTIAL,33453,0,33453,134833,0,168286
141522700900000,NE 145,RESIDENTIAL,33453,0,33453,107268,0,140721
141522701000000,NE 145,RESIDENTIAL,32084,0,32084,96385,0,128469
141522701100000,NE 145,RESIDENTIAL,36141,0,36141,116525,0,152666
141522701200000,NE 145,RESIDENTIAL,32069,0,32069,137511,0,169580
141522701300000,NE 145,RESIDENTIAL,31601,0,31601,156907,0,188508
141522701400000,NE 145,RESIDENTIAL,27160,0,27160,141249,0,168409
141522701500000,NE 145,RESIDENTIAL,28000,0,28000,156583,0,184583
141522701600000,NE 145,RESIDENTIAL,30267,0,30267,84385,0,114652
141522800100000,NE 145,RESIDENTIAL,45333,0,45333,127295,0,172628
141522800200000,NE 145,RESIDENTIAL,45000,0,45000,120888,0,165888
141522800300000,NE 145,RESIDENTIAL,44427,0,44427,125673,0,170100
141522800400000,NE 145,RESIDENTIAL,35990,0,35990,113385,0,149375
141522800500000,NE 145,RESIDENTIAL,35931,0,35931,160075,0,196006
141522800600000,NE 145,RESIDENTIAL,34515,0,34515,141485,0,176000
141522800700000,NE 145,RESIDENTIAL,41535,0,41535,90247,0,131782
141522800800000,NE 145,RESIDENTIAL,20925,0,20925,116649,0,137574
141522800900000,NE 145,RESIDENTIAL,21600,0,21600,96218,0,117818
141522801000000,NE 145,RESIDENTIAL,24250,0,24250,87923,0,112173
141522801100000,NE 145,RESIDENTIAL,25398,0,25398,90231,0,115629
141522801200000,NE 145,RESIDENTIAL,25500,0,25500,100376,0,125876
141522801300000,NE 145,RESIDENTIAL,25500,0,25500,97330,0,122830
141522801400000,NE 145,RESIDENTIAL,25500,0,25500,82033,0,107533
141522801500000,NE 145,RESIDENTIAL,29073,0,29073,80597,0,109670
141522801600000,NE 145,RESIDENTIAL,28000,0,28000,86774,0,114774
141522801700000,NE 145,RESIDENTIAL,25500,0,25500,104658,0,130158
141522801800000,NE 145,RESIDENTIAL,25500,0,25500,99596,0,125096
141522801900000,NE 145,RESIDENTIAL,25500,0,25500,92945,0,118445
141522802000000,NE 145,RESIDENTIAL,25500,0,25500,106654,0,132154
141522802100000,NE 145,RESIDENTIAL,25500,0,25500,77260,0,102760
141522802200000,NE 145,RESIDENTIAL,25500,0,25500,76074,0,101574
141522802300000,NE 145,RESIDENTIAL,24750,0,24750,109838,0,134588
141522802400000,NE 145,RESIDENTIAL,30947,0,30947,87970,0,118917
141522802700000,NE 145,RESIDENTIAL,27986,0,27986,119135,0,147121
141522802800000,NE 145,RESIDENTIAL,33825,0,33825,107067,0,140892
141522802900000,NE 145,RESIDENTIAL,21800,0,21800,93925,0,115725
141522803000000,NE 145,RESIDENTIAL,21600,0,21600,83546,0,105146
141522803100000,NE 145,RESIDENTIAL,32400,0,32400,93920,0,126320
141522803400000,NE 145,RESIDENTIAL,29613,0,29613,106993,0,136606
141522803500000,NE 145,RESIDENTIAL,31100,0,31100,83939,0,115039
141522900100000,NE 145,RESIDENTIAL,36048,0,36048,95322,0,131370
141522900200000,NE 145,RESIDENTIAL,20800,0,20800,85783,0,106583
141522900300000,NE 145,RESIDENTIAL,20800,0,20800,74367,0,95167
141522900400000,NE 145,RESIDENTIAL,20800,0,20800,94493,0,115293
141522900500000,NE 145,RESIDENTIAL,26000,0,26000,135606,0,161606
141522900600000,NE 145,RESIDENTIAL,26000,0,26000,92730,0,118730
141522900700000,NE 145,RESIDENTIAL,26000,0,26000,82936,0,108936
141522900800000,NE 145,RESIDENTIAL,26000,0,26000,80039,0,106039
141522900900000,NE 145,RESIDENTIAL,26000,0,26000,99544,0,125544
141522901000000,NE 145,RESIDENTIAL,26000,0,26000,117467,0,143467
141523000100000,NE 145,RESIDENTIAL,38916,0,38916,98749,0,137665
141523000200000,NE 145,RESIDENTIAL,19817,0,19817,83950,0,103767
141523000300000,NE 145,RESIDENTIAL,22475,0,22475,40148,0,62623
141523000400000,NE 145,RESIDENTIAL,25740,0,25740,47939,0,73679
141523000500000,NE 145,RESIDENTIAL,25922,0,25922,79771,0,105693
141523000600000,NE 145,RESIDENTIAL,26640,0,26640,118637,0,145277
141523000700000,NE 145,RESIDENTIAL,27685,0,27685,117309,0,144994
141523000800000,NE 145,RESIDENTIAL,27930,0,27930,85274,0,113204
141523000900000,NE 145,RESIDENTIAL,33820,0,33820,135778,0,169598
141523001000000,NE 145,RESIDENTIAL,23850,0,23850,63730,0,87580
141523001100000,NE 145,RESIDENTIAL,28730,0,28730,124919,0,153649
141523001200000,NE 145,RESIDENTIAL,25500,0,25500,71451,0,96951
141523001300000,NE 145,RESIDENTIAL,36375,0,36375,107763,0,144138
141523001400000,NE 145,RESIDENTIAL,27950,0,27950,61914,0,89864
141523100100000,NE 145,RESIDENTIAL,26000,0,26000,81085,0,107085
141523100200000,NE 145,RESIDENTIAL,26000,0,26000,62456,0,88456
141523100300000,NE 145,RESIDENTIAL,26000,0,26000,119048,0,145048
141523100400000,NE 145,RESIDENTIAL,26000,0,26000,75659,0,101659
141523100500000,NE 145,RESIDENTIAL,26000,0,26000,58098,0,84098
141523100600000,NE 145,RESIDENTIAL,26000,0,26000,67955,0,93955
141523100700000,NE 145,RESIDENTIAL,31200,0,31200,66558,0,97758
141523100800000,NE 145,RESIDENTIAL,26000,0,26000,55918,0,81918
141525100100000,NE 146,RESIDENTIAL,17675,0,17675,75934,0,93609
141525100200000,NE 146,RESIDENTIAL,19775,0,19775,93670,0,113445
141525100300000,NE 146,RESIDENTIAL,14140,0,14140,76281,0,90421
141525100400000,NE 146,RESIDENTIAL,20076,0,20076,79670,0,99746
141525200100000,NE 145,RESIDENTIAL,35295,0,35295,101346,0,136641
141525200200000,NE 145,RESIDENTIAL,26540,0,26540,64635,0,91175
141525200300000,NE 145,RESIDENTIAL,25186,0,25186,109240,0,134426
141525200400000,NE 145,RESIDENTIAL,22950,0,22950,77394,0,100344
141525200500000,NE 145,EXEMPT,0,29290,29290,0,67151,96441
141525200600000,NE 145,RESIDENTIAL,27540,0,27540,78252,0,105792
141525200700000,NE 145,RESIDENTIAL,26928,0,26928,92089,0,119017
141525200800000,NE 145,RESIDENTIAL,26000,0,26000,80824,0,106824
141525200900000,NE 145,RESIDENTIAL,25317,0,25317,97966,0,123283
141525201000000,NE 145,RESIDENTIAL,33957,0,33957,94649,0,128606
141525201100000,NE 145,RESIDENTIAL,30777,0,30777,78226,0,109003
141525201200000,NE 145,RESIDENTIAL,26404,0,26404,71635,0,98039
141525201300000,NE 145,EXEMPT,0,27582,27582,0,99659,127241
141525201400000,NE 145,RESIDENTIAL,30816,0,30816,86917,0,117733
141525300100000,NE 145,RESIDENTIAL,27250,0,27250,72364,0,99614
141525300200000,NE 145,RESIDENTIAL,33820,0,33820,78047,0,111867
141525300300000,NE 145,RESIDENTIAL,34883,0,34883,113610,0,148493
141525300400000,NE 145,RESIDENTIAL,35295,0,35295,75284,0,110579
141525300500000,NE 145,RESIDENTIAL,35597,0,35597,82429,0,118026
141525300600000,NE 145,RESIDENTIAL,35685,0,35685,114949,0,150634
141525300700000,NE 145,RESIDENTIAL,36733,0,36733,89903,0,126636
141525300800000,NE 145,RESIDENTIAL,36480,0,36480,73874,0,110354
141525300900000,NE 145,RESIDENTIAL,32205,0,32205,75079,0,107284
141525301000000,NE 145,RESIDENTIAL,32745,0,32745,41559,0,74304
141525301100000,NE 145,RESIDENTIAL,32230,0,32230,63543,0,95773
141525301200000,NE 145,RESIDENTIAL,32700,0,32700,72513,0,105213
141525301300000,NE 145,RESIDENTIAL,36551,0,36551,107351,0,143902
141525301400000,NE 145,RESIDENTIAL,33600,0,33600,126475,0,160075
141525301500000,NE 145,RESIDENTIAL,30179,0,30179,75591,0,105770
141525301600000,NE 145,RESIDENTIAL,29585,0,29585,84559,0,114144
141525301700000,NE 145,RESIDENTIAL,24250,0,24250,93431,0,117681
141525301800000,NE 145,RESIDENTIAL,24250,0,24250,30242,0,54492
141525301900000,NE 145,RESIDENTIAL,41040,0,41040,75972,0,117012
141525302000000,NE 145,RESIDENTIAL,23200,0,23200,80625,0,103825
141525302100000,NE 145,RESIDENTIAL,39200,0,39200,115806,0,155006
141525302200000,NE 145,RESIDENTIAL,36822,0,36822,128819,0,165641
141525302300000,NE 145,RESIDENTIAL,30940,0,30940,94313,0,125253
141525302400000,NE 145,RESIDENTIAL,35227,0,35227,62661,0,97888
141525302500000,NE 145,RESIDENTIAL,33600,0,33600,118862,0,152462
141525302600000,NE 145,RESIDENTIAL,24935,0,24935,61332,0,86267
141525302700000,NE 145,RESIDENTIAL,25200,0,25200,41804,0,67004
141525302800000,NE 145,RESIDENTIAL,27750,0,27750,56450,0,84200
141525302900000,NE 145,RESIDENTIAL,23375,0,23375,65707,0,89082
141525303000000,NE 145,RESIDENTIAL,26160,0,26160,70769,0,96929
141525303100000,NE 145,RESIDENTIAL,32436,0,32436,155447,0,187883
141525303200000,NE 145,RESIDENTIAL,38520,0,38520,108201,0,146721
141525303300000,NE 145,RESIDENTIAL,30240,0,30240,72356,0,102596
141525303400000,NE 145,RESIDENTIAL,27500,0,27500,111608,0,139108
141525303500000,NE 145,RESIDENTIAL,29150,0,29150,173798,0,202948
141525303600000,NE 145,RESIDENTIAL,29680,0,29680,67273,0,96953
141525303700000,NE 145,RESIDENTIAL,27750,0,27750,73453,0,101203
141525400100000,NE 145,RESIDENTIAL,32985,0,32985,58934,0,91919
141525400200000,NE 145,RESIDENTIAL,30611,0,30611,42119,0,72730
141525400300000,NE 145,RESIDENTIAL,31200,0,31200,55792,0,86992
141525400400000,NE 145,RESIDENTIAL,31373,0,31373,63950,0,95323
141525400500000,NE 145,RESIDENTIAL,33820,0,33820,31707,0,65527
141525400600000,NE 145,RESIDENTIAL,26767,0,26767,70912,0,97679
141525400700000,NE 145,RESIDENTIAL,28560,0,28560,87677,0,116237
141525400800000,NE 145,RESIDENTIAL,36489,0,36489,78088,0,114577
141525400900000,SCHOOL,EXEMPT,0,0,0,0,0,0
141525401000000,NE 145,RESIDENTIAL,33799,0,33799,92346,0,126145
141525401100000,NE 145,RESIDENTIAL,25380,0,25380,102773,0,128153
141525401200000,NE 145,RESIDENTIAL,28253,0,28253,90012,0,118265
141525401300000,NE 145,RESIDENTIAL,26500,0,26500,110190,0,136690
141525401400000,NE 145,RESIDENTIAL,29280,0,29280,103354,0,132634
141525401500000,NE 145,RESIDENTIAL,35490,0,35490,120582,0,156072
141525500100000,NE 146,RESIDENTIAL,17500,0,17500,106746,0,124246
141525500200000,NE 146,RESIDENTIAL,11550,0,11550,67669,0,79219
141525500300000,NE 146,RESIDENTIAL,11900,0,11900,54855,0,66755
141525500400000,NE 146,RESIDENTIAL,11550,0,11550,49657,0,61207
141525500500000,NE 146,RESIDENTIAL,17500,0,17500,62503,0,80003
141525500600000,NE 146,RESIDENTIAL,17500,0,17500,52480,0,69980
141525500700000,NE 146,RESIDENTIAL,12320,0,12320,54584,0,66904
141525500800000,NE 146,RESIDENTIAL,19550,0,19550,85268,0,104818
141525500900000,NE 146,RESIDENTIAL,18488,0,18488,56194,0,74682
141525501000000,NE 146,RESIDENTIAL,16660,0,16660,88430,0,105090
141525501100000,NE 146,RESIDENTIAL,16150,0,16150,113166,0,129316
141525501200000,NE 146,RESIDENTIAL,19763,0,19763,70369,0,90132
141525501300000,NE 146,RESIDENTIAL,19550,0,19550,88347,0,107897
141525501400000,NE 146,RESIDENTIAL,17500,0,17500,102653,0,120153
141525501500000,NE 146,RESIDENTIAL,17500,0,17500,62530,0,80030
141525501600000,NE 146,RESIDENTIAL,17500,0,17500,116133,0,133633
141525501700000,NE 146,RESIDENTIAL,17500,0,17500,82583,0,100083
141525501800000,NE 146,RESIDENTIAL,17500,0,17500,75255,0,92755
141525600100000,NE 146,RESIDENTIAL,13430,0,13430,64194,0,77624
141525600200000,NE 146,RESIDENTIAL,14110,0,14110,77430,0,91540
141525600300000,NE 146,RESIDENTIAL,21250,0,21250,73924,0,95174
141525600400000,NE 146,RESIDENTIAL,21250,0,21250,81671,0,102921
141525600500000,NE 146,RESIDENTIAL,21250,0,21250,98309,0,119559
141525600600000,NE 146,RESIDENTIAL,21250,0,21250,87101,0,108351
141525600700000,NE 146,RESIDENTIAL,21250,0,21250,80925,0,102175
141525600800000,NE 146,RESIDENTIAL,21250,0,21250,72537,0,93787
141525600900000,NE 146,RESIDENTIAL,21250,0,21250,77484,0,98734
141525601000000,NE 146,RESIDENTIAL,21250,0,21250,103920,0,125170
141525601100000,NE 146,RESIDENTIAL,17850,0,17850,57333,0,75183
141525601200000,NE 146,RESIDENTIAL,19763,0,19763,95880,0,115643
141525601300000,NE 146,RESIDENTIAL,16660,0,16660,68226,0,84886
141525601400000,NE 146,RESIDENTIAL,12920,0,12920,86003,0,98923
141525601500000,NE 146,RESIDENTIAL,17638,0,17638,80330,0,97968
141525601600000,NE 146,RESIDENTIAL,18488,0,18488,101032,0,119520
141525601700000,NE 146,RESIDENTIAL,21250,0,21250,75510,0,96760
141525601800000,NE 146,RESIDENTIAL,21250,0,21250,59454,0,80704
141525601900000,NE 146,RESIDENTIAL,21250,0,21250,55302,0,76552
141525602000000,NE 146,RESIDENTIAL,21250,0,21250,90528,0,111778
141525602100000,NE 146,RESIDENTIAL,21250,0,21250,77093,0,98343
141525602200000,NE 146,RESIDENTIAL,21250,0,21250,67962,0,89212
141525602300000,NE 146,RESIDENTIAL,21250,0,21250,75857,0,97107
141525602400000,NE 146,RESIDENTIAL,21250,0,21250,75221,0,96471
141525602500000,NE 146,RESIDENTIAL,21250,0,21250,79182,0,100432
141525602600000,NE 146,RESIDENTIAL,21250,0,21250,73544,0,94794
141525602700000,NE 146,RESIDENTIAL,21250,0,21250,60338,0,81588
141525602800000,NE 146,RESIDENTIAL,21038,0,21038,113351,0,134389
141525602900000,NE 146,RESIDENTIAL,16490,0,16490,88680,0,105170
141525603000000,NE 146,RESIDENTIAL,21463,0,21463,107666,0,129129
141525603100000,NE 146,RESIDENTIAL,18275,0,18275,76241,0,94516
141527600100000,SCHOOL,EXEMPT,0,476874,476874,0,1263358,1740232
141527600200000,CHURCH,COMMERCIAL,0,2404620,2404620,0,18851791,21256411
141527601200000,NE 145,RESIDENTIAL,38377,0,38377,136623,0,175000
141527602000000,NE 145,RESIDENTIAL,33082,0,33082,173394,0,206476
141527700100000,NE 146,RESIDENTIAL,18223,0,18223,65608,0,83831
141527700200000,NE 146,RESIDENTIAL,17500,0,17500,49826,0,67326
141527700300000,NE 146,RESIDENTIAL,17500,0,17500,59096,0,76596
141527700400000,NE 146,RESIDENTIAL,17500,0,17500,61705,0,79205
141527700500000,NE 146,RESIDENTIAL,17500,0,17500,63331,0,80831
141527700600000,NE 146,RESIDENTIAL,17500,0,17500,54047,0,71547
141527700700000,NE 146,RESIDENTIAL,17500,0,17500,64302,0,81802
141527700800000,NE 146,RESIDENTIAL,17500,0,17500,62090,0,79590
141527700900000,NE 146,RESIDENTIAL,17500,0,17500,65807,0,83307
141527701000000,NE 146,RESIDENTIAL,17500,0,17500,74749,0,92249
141527701100000,NE 146,RESIDENTIAL,17500,0,17500,76252,0,93752
141527701200000,NE 146,RESIDENTIAL,17500,0,17500,62161,0,79661
141527701300000,NE 146,RESIDENTIAL,17500,0,17500,44775,0,62275
141527701400000,NE 146,RESIDENTIAL,17500,0,17500,63200,0,80700
141527701500000,NE 146,RESIDENTIAL,17500,0,17500,46947,0,64447
141527701600000,NE 146,RESIDENTIAL,17500,0,17500,42559,0,60059
141527701700000,NE 146,RESIDENTIAL,17500,0,17500,56875,0,74375
141527701800000,NE 146,RESIDENTIAL,17500,0,17500,56882,0,74382
141527701900000,NE 146,RESIDENTIAL,17500,0,17500,49766,0,67266
141527702000000,NE 146,RESIDENTIAL,17500,0,17500,57281,0,74781
141527702100000,NE 146,RESIDENTIAL,17500,0,17500,27932,0,45432
141527702200000,NE 146,RESIDENTIAL,17500,0,17500,36984,0,54484
141527702300000,NE 146,RESIDENTIAL,17500,0,17500,58030,0,75530
141527702400000,NE 146,RESIDENTIAL,17500,0,17500,44444,0,61944
141527702500000,NE 146,RESIDENTIAL,17500,0,17500,43059,0,60559
141527702600000,NE 146,RESIDENTIAL,19289,0,19289,51114,0,70403
141530100100000,EQUIPMENT MFG;INDUST,INDUSTRIAL,0,139903,139903,0,16384,156287
141530100200000,WAREHOUSE,COMMERCIAL,0,67500,67500,0,97957,165457
141530100300000,WAREHOUSE,COMMERCIAL,0,63000,63000,0,122692,185692
141530100400000,WAREHOUSE,COMMERCIAL,0,42000,42000,0,41426,83426
141530100500000,VACANT LAND,COMMERCIAL,0,21500,21500,0,0,21500
141530100600000,WAREHOUSE,COMMERCIAL,0,21500,21500,0,39960,61460
141530100700000,WAREHOUSE,COMMERCIAL,0,21500,21500,0,19139,40639
141530100800000,WAREHOUSE,COMMERCIAL,0,21500,21500,0,28727,50227
141530100900000,WAREHOUSE,COMMERCIAL,0,21500,21500,0,49911,71411
141530101000000,WAREHOUSE,COMMERCIAL,0,21500,21500,0,25140,46640
141530101100000,CITY PROPERTY,EXEMPT,0,0,0,0,0,0
141530101200000,FLAT PARKING,INDUSTRIAL,0,55566,55566,0,0,55566
141530200100000,EQUIPMENT MFG;INDUST,INDUSTRIAL,0,644178,644178,0,1945822,2590000
141530300100000,FLAT PARKING,INDUSTRIAL,0,19748,19748,0,17345,37093
141530300200000,EQUIPMENT MFG;INDUST,INDUSTRIAL,0,97605,97605,0,66653,164258
141530400100000,NE 154,RESIDENTIAL,23959,0,23959,90858,0,114817
141530400200000,NE 154,RESIDENTIAL,23959,0,23959,62277,0,86236
141530400300000,NE 154,RESIDENTIAL,25234,0,25234,72762,0,97996
141530500100000,NE 155,RESIDENTIAL,22000,0,22000,70421,0,92421
141530500200000,NE 155,RESIDENTIAL,25740,0,25740,68706,0,94446
141530500300000,NE 155,RESIDENTIAL,26180,0,26180,57339,0,83519
141530500400000,NE 155,RESIDENTIAL,22990,0,22990,67728,0,90718
141530500600000,NE 155,RESIDENTIAL,20000,0,20000,71008,0,91008
141530500700000,LITERARY/LIBRARY/ART,EXEMPT,0,63000,63000,0,348212,411212
141530501000000,NE 155,RESIDENTIAL,20000,0,20000,58139,0,78139
141530501100000,NE 155,RESIDENTIAL,23800,0,23800,58248,0,82048
141530501200000,NE 155,RESIDENTIAL,13200,0,13200,50901,0,64101
141530501300000,NE 155,RESIDENTIAL,12800,0,12800,56820,0,69620
141530501400000,NE 155,RESIDENTIAL,20000,0,20000,93259,0,113259
141530501500000,NE 155,RESIDENTIAL,20000,0,20000,60979,0,80979
141530501600000,NE 155,RESIDENTIAL,20000,0,20000,111143,0,131143
141530501700000,NE 155,RESIDENTIAL,20000,0,20000,57067,0,77067
141530501800000,NE 155,RESIDENTIAL,20000,0,20000,61657,0,81657
141530501900000,NE 155,RESIDENTIAL,20000,0,20000,55208,0,75208
141532600100000,NE 146,RESIDENTIAL,17150,0,17150,93576,0,110726
141532600200000,NE 146,RESIDENTIAL,16384,0,16384,0,0,16384
141532600300000,NE 146,RESIDENTIAL,25500,0,25500,58550,0,84050
141532600400000,NE 146,RESIDENTIAL,25500,0,25500,65077,0,90577
141532600500000,NE 146,RESIDENTIAL,25500,0,25500,88495,0,113995
141532600600000,NE 146,RESIDENTIAL,25500,0,25500,62386,0,87886
141532600700000,NE 146,RESIDENTIAL,25500,0,25500,70650,0,96150
141532600800000,NE 146,RESIDENTIAL,12750,0,12750,58681,0,71431
141532600900000,NE 146,RESIDENTIAL,12750,0,12750,57840,0,70590
141532601000000,NE 146,RESIDENTIAL,12750,0,12750,63828,0,76578
141532601100000,NE 146,RESIDENTIAL,12750,0,12750,66494,0,79244
141532601200000,NE 146,RESIDENTIAL,17000,0,17000,67331,0,84331
141532601300000,NE 146,RESIDENTIAL,17000,0,17000,52726,0,69726
141532601400000,NE 146,RESIDENTIAL,17000,0,17000,71805,0,88805
141532601500000,NE 146,RESIDENTIAL,17000,0,17000,48800,0,65800
141532601600000,NE 146,RESIDENTIAL,17000,0,17000,50895,0,67895
141532601700000,NE 146,RESIDENTIAL,17000,0,17000,51260,0,68260
141532601800000,SHOP,COMMERCIAL,0,262600,262600,0,306248,568848
141532700100000,NE 146,RESIDENTIAL,25500,0,25500,67266,0,92766
141532700200000,NE 146,RESIDENTIAL,18014,0,18014,60395,0,78409
141532700300000,NE 146,RESIDENTIAL,17170,0,17170,78803,0,95973
141532700400000,NE 146,RESIDENTIAL,17170,0,17170,57031,0,74201
141532700500000,NE 146,RESIDENTIAL,17170,0,17170,87112,0,104282
141532700600000,NE 146,RESIDENTIAL,17170,0,17170,72003,0,89173
141532700700000,NE 146,RESIDENTIAL,17170,0,17170,72905,0,90075
141532700800000,NE 146,RESIDENTIAL,13584,0,13584,67318,0,80902
141532700900000,NE 146,RESIDENTIAL,13983,0,13983,64042,0,78025
141532701000000,NE 146,RESIDENTIAL,13770,0,13770,83255,0,97025
141532701100000,NE 146,RESIDENTIAL,12743,0,12743,82570,0,95313
141532701200000,NE 146,RESIDENTIAL,17170,0,17170,52088,0,69258
141532701300000,NE 146,RESIDENTIAL,17170,0,17170,80753,0,97923
141532701400000,NE 146,RESIDENTIAL,17170,0,17170,65134,0,82304
141532701500000,NE 146,RESIDENTIAL,17170,0,17170,61859,0,79029
141532701600000,NE 146,RESIDENTIAL,17170,0,17170,70395,0,87565
141532701700000,NE 146,RESIDENTIAL,16540,0,16540,70920,0,87460
141532701800000,NE 146,RESIDENTIAL,25500,0,25500,59908,0,85408
141532701900000,NE 146,RESIDENTIAL,17000,0,17000,59155,0,76155
141532702000000,NE 146,RESIDENTIAL,22500,0,22500,94718,0,117218
141532702100000,NE 146,RESIDENTIAL,14875,0,14875,58268,0,73143
141532702200000,NE 146,RESIDENTIAL,25500,0,25500,110784,0,136284
141532800100000,NE 146,RESIDENTIAL,14034,0,14034,67710,0,81744
141532800200000,NE 146,RESIDENTIAL,16150,0,16150,63368,0,79518
141532800300000,NE 146,RESIDENTIAL,18481,0,18481,83809,0,102290
141532800400000,NE 146,RESIDENTIAL,16150,0,16150,33003,0,49153
141532800500000,NE 146,RESIDENTIAL,16150,0,16150,68808,0,84958
141532800600000,NE 146,RESIDENTIAL,16150,0,16150,57018,0,73168
141532800700000,NE 146,RESIDENTIAL,16150,0,16150,66798,0,82948
141532800800000,NE 146,RESIDENTIAL,16150,0,16150,77628,0,93778
141532800900000,NE 146,RESIDENTIAL,19380,0,19380,53606,0,72986
141532801000000,NE 146,RESIDENTIAL,19380,0,19380,105826,0,125206
141532801100000,NE 146,RESIDENTIAL,16150,0,16150,82808,0,98958
141532801200000,NE 146,RESIDENTIAL,16150,0,16150,52162,0,68312
141532801300000,NE 146,RESIDENTIAL,10497,0,10497,106101,0,116598
141532801400000,NE 146,RESIDENTIAL,10497,0,10497,0,0,10497
141532801500000,NE 146,RESIDENTIAL,22380,0,22380,65789,0,88169
141532801600000,NE 146,RESIDENTIAL,15335,0,15335,85999,0,101334
141532801700000,NE 146,RESIDENTIAL,12920,0,12920,62076,0,74996
141532801800000,NE 146,RESIDENTIAL,12920,0,12920,65409,0,78329
141532801900000,NE 146,RESIDENTIAL,12920,0,12920,56146,0,69066
141532802000000,NE 146,RESIDENTIAL,12920,0,12920,52772,0,65692
141532802100000,NE 146,RESIDENTIAL,12920,0,12920,53114,0,66034
141532802200000,NE 146,RESIDENTIAL,12920,0,12920,65264,0,78184
141532802300000,NE 146,RESIDENTIAL,12920,0,12920,52975,0,65895
141532802400000,NE 146,RESIDENTIAL,12920,0,12920,44877,0,57797
141532802500000,NE 146,RESIDENTIAL,12920,0,12920,41117,0,54037
141532802600000,NE 146,RESIDENTIAL,12920,0,12920,72940,0,85860
141532802700000,NE 146,RESIDENTIAL,12920,0,12920,110244,0,123164
141532802800000,NE 146,RESIDENTIAL,12920,0,12920,43467,0,56387
141532802900000,NE 146,RESIDENTIAL,12920,0,12920,70071,0,82991
141532803000000,NE 146,RESIDENTIAL,12920,0,12920,55041,0,67961
141532900100000,NE 146,RESIDENTIAL,21250,0,21250,76129,0,97379
141532900200000,NE 146,RESIDENTIAL,17793,0,17793,61826,0,79619
141532900300000,NE 146,RESIDENTIAL,17000,0,17000,78800,0,95800
141532900400000,NE 146,RESIDENTIAL,17000,0,17000,59545,0,76545
141532900500000,NE 146,RESIDENTIAL,17000,0,17000,59040,0,76040
141532900600000,NE 146,RESIDENTIAL,17000,0,17000,52871,0,69871
141532900700000,NE 146,RESIDENTIAL,17000,0,17000,68252,0,85252
141532900800000,NE 146,RESIDENTIAL,18502,0,18502,58744,0,77246
141532900900000,NE 146,RESIDENTIAL,18079,0,18079,59892,0,77971
141532901000000,NE 146,RESIDENTIAL,17000,0,17000,64762,0,81762
141532901100000,NE 146,RESIDENTIAL,17000,0,17000,54291,0,71291
141532901200000,NE 146,RESIDENTIAL,17000,0,17000,61743,0,78743
141532901300000,NE 146,RESIDENTIAL,17000,0,17000,51943,0,68943
141532901400000,NE 146,RESIDENTIAL,21585,0,21585,55389,0,76974
141532901500000,NE 146,RESIDENTIAL,25500,0,25500,108219,0,133719
141532901600000,NE 146,RESIDENTIAL,25500,0,25500,73930,0,99430
141532901700000,NE 146,RESIDENTIAL,17000,0,17000,62390,0,79390
141532901800000,NE 146,RESIDENTIAL,17000,0,17000,63705,0,80705
141532901900000,NE 146,RESIDENTIAL,21250,0,21250,70068,0,91318
141533000100000,CENTRALLY ASSESSED,OTHER,0,0,0,0,0,0
141533000900000,SHOP,COMMERCIAL,0,25200,25200,0,57311,82511
141533001000000,FLAT PARKING,COMMERCIAL,0,23400,23400,0,9600,33000
141533100100000,EQUIPMENT MFG;INDUST,INDUSTRIAL,0,19124,19124,0,225876,245000
141533100200000,NE 146,RESIDENTIAL,21328,0,21328,58351,0,79679
141533100300000,NE 146,RESIDENTIAL,17340,0,17340,43028,0,60368
141533100400000,NE 146,RESIDENTIAL,17340,0,17340,50010,0,67350
141533100500000,NE 146,RESIDENTIAL,17340,0,17340,80627,0,97967
141533100600000,NE 146,RESIDENTIAL,17340,0,17340,62830,0,80170
141533100700000,NE 146,RESIDENTIAL,17873,0,17873,57882,0,75755
141533100800000,EQUIPMENT MFG;INDUST,INDUSTRIAL,0,51354,51354,0,613646,665000
141533200200000,NE 146,RESIDENTIAL,17711,0,17711,73905,0,91616
141533200300000,NE 146,RESIDENTIAL,16150,0,16150,71563,0,87713
141533200400000,NE 146,RESIDENTIAL,16150,0,16150,82622,0,98772
141533200500000,NE 146,RESIDENTIAL,16150,0,16150,76612,0,92762
141533200600000,NE 146,RESIDENTIAL,16150,0,16150,89909,0,106059
141533200700000,NE 146,RESIDENTIAL,16150,0,16150,70079,0,86229
141533200800000,NE 146,RESIDENTIAL,16150,0,16150,89299,0,105449
141533200900000,NE 146,RESIDENTIAL,16150,0,16150,74837,0,90987
141533201000000,NE 146,RESIDENTIAL,16150,0,16150,64341,0,80491
141533201100000,NE 146,RESIDENTIAL,16150,0,16150,87311,0,103461
141533201200000,NE 146,RESIDENTIAL,16150,0,16150,73392,0,89542
141533201300000,NE 146,RESIDENTIAL,16150,0,16150,51462,0,67612
141533201400000,NE 146,RESIDENTIAL,16150,0,16150,62963,0,79113
141533201500000,NE 146,RESIDENTIAL,16150,0,16150,57541,0,73691
141533300100000,NE 146,RESIDENTIAL,11665,0,11665,65768,0,77433
141533301600000,NE 146,RESIDENTIAL,10920,0,10920,59416,0,70336
141533301700000,NE 146,RESIDENTIAL,10920,0,10920,45989,0,56909
141533301800000,NE 146,RESIDENTIAL,11602,0,11602,59415,0,71017
141533301900000,NE 146,RESIDENTIAL,13377,0,13377,68055,0,81432
141533302000000,NE 146,RESIDENTIAL,10920,0,10920,52607,0,63527
141533302100000,NE 146,RESIDENTIAL,10920,0,10920,46824,0,57744
141533302200000,NE 146,RESIDENTIAL,14196,0,14196,58052,0,72248
141535100100000,WAREHOUSE,COMMERCIAL,0,140000,140000,0,90267,230267
141535100200000,VACANT LAND,COMMERCIAL,0,1722,1722,0,0,1722
141535100300000,RESTAURANT,COMMERCIAL,0,33600,33600,0,97638,131238
141535100400000,FLAT PARKING,COMMERCIAL,0,16800,16800,0,3360,20160
141535200200000,CENTRALLY ASSESSED,OTHER,0,0,0,0,0,0
141535200400000,SMALL RETAIL,COMMERCIAL,0,129922,129922,0,1131938,1261860
141535200500000,CENTRALLY ASSESSED,OTHER,0,0,0,0,0,0
141535200700000,WAREHOUSE,COMMERCIAL,0,126000,126000,0,174281,300281
141535200800000,FLAT PARKING,COMMERCIAL,0,65025,65025,0,24285,89310
141535300100000,FLAT PARKING,INDUSTRIAL,0,9850,9850,0,7803,17653
141535300200000,NE 146,RESIDENTIAL,16150,0,16150,68003,0,84153
141535300300000,NE 146,RESIDENTIAL,16150,0,16150,56930,0,73080
141535300400000,NE 146,RESIDENTIAL,16150,0,16150,52848,0,68998
141535300500000,BARS/LOUNGE,COMMERCIAL,0,20387,20387,0,34927,55314
141535400100000,NE 156,RESIDENTIAL,11200,0,11200,47000,0,58200
141535400200000,NE 156,RESIDENTIAL,8943,0,8943,42784,0,51727
141535400300000,NE 156,RESIDENTIAL,8943,0,8943,34806,0,43749
141535400400000,WAREHOUSE,COMMERCIAL,0,50250,50250,0,47738,97988
141535400500000,VACANT LAND,COMMERCIAL,0,10445,10445,0,0,10445
141535400800000,WAREHOUSE,COMMERCIAL,0,94000,94000,0,185883,279883
141535401000000,WAREHOUSE,COMMERCIAL,0,29878,29878,0,1661,31539
141535401100000,WAREHOUSE,COMMERCIAL,0,6307,6307,0,16158,22465
141535401200000,FLAT PARKING,COMMERCIAL,0,11172,11172,0,2480,13652
141535401300000,BARS/LOUNGE,COMMERCIAL,0,9044,9044,0,68922,77966
141535401400000,SMALL RETAIL,COMMERCIAL,0,17024,17024,0,98754,115778
141535401500000,OFFICE,COMMERCIAL,0,117250,117250,0,626709,743959
141535401600000,NE 156,RESIDENTIAL,21600,0,21600,53626,0,75226
141535401700000,NE 156,RESIDENTIAL,13400,0,13400,43347,0,56747
141535500100000,FOOD GRADE;INDUST,INDUSTRIAL,0,510997,510997,0,3489003,4000000
141535600100000,NE 156,RESIDENTIAL,10413,0,10413,40064,0,50477
141535600200000,NE 156,RESIDENTIAL,11025,0,11025,53105,0,64130
141535600300000,NE 156,RESIDENTIAL,8820,0,8820,39584,0,48404
141535600400000,NE 156,RESIDENTIAL,8820,0,8820,42185,0,51005
141535600500000,NE 156,RESIDENTIAL,20636,0,20636,75768,0,96404
141535600600000,NE 156,RESIDENTIAL,19760,0,19760,49437,0,69197
141535600700000,NE 156,RESIDENTIAL,19760,0,19760,47403,0,67163
141535600800000,NE 156,RESIDENTIAL,16000,0,16000,54242,0,70242
141535600900000,NE 156,RESIDENTIAL,20800,0,20800,50985,0,71785
141535601000000,NE 156,RESIDENTIAL,20140,0,20140,59184,0,79324
141535601100000,NE 156,RESIDENTIAL,20140,0,20140,41666,0,61806
141535601200000,NE 156,RESIDENTIAL,20140,0,20140,58984,0,79124
141535601300000,NE 156,RESIDENTIAL,10720,0,10720,39696,0,50416
141535601400000,CONVERSION,COMMERCIAL,0,8965,8965,0,56256,65221
141535601500000,NE 156,RESIDENTIAL,16672,0,16672,57225,0,73897
141535601600000,NE 156,RESIDENTIAL,17622,0,17622,67871,0,85493
141535601700000,NE 156,RESIDENTIAL,17622,0,17622,79847,0,97469
141535601800000,NE 156,RESIDENTIAL,17290,0,17290,46664,0,63954
141535601900000,NE 156,RESIDENTIAL,17290,0,17290,50882,0,68172
141535602000000,NE 156,RESIDENTIAL,17290,0,17290,57923,0,75213
141535602100000,CONVERSION,COMMERCIAL,0,11794,11794,0,42750,54544
141535602200000,NE 156,RESIDENTIAL,613,0,613,0,0,613
141535700100000,FLAT PARKING,INDUSTRIAL,0,664,664,0,0,664
141535700200000,NE 156,EXEMPT,0,13515,13515,82825,0,96340
141535700300000,NE 156,RESIDENTIAL,21216,0,21216,60476,0,81692
141535700400000,APARTMENT,EXEMPT,0,14276,14276,0,167651,181927
141535700500000,NE 156,RESIDENTIAL,22176,0,22176,14134,0,36310
141535800100000,NE 156,RESIDENTIAL,17290,0,17290,47795,0,65085
141535800200000,NE 156,RESIDENTIAL,17622,0,17622,59409,0,77031
141535800300000,CONVERSION,COMMERCIAL,0,12020,12020,0,63932,75952
141535800400000,NE 156,RESIDENTIAL,17622,0,17622,58216,0,75838
141535800500000,NE 156,RESIDENTIAL,12865,0,12865,37766,0,50631
141535800600000,NE 156,RESIDENTIAL,7524,0,7524,32935,0,40459
141535800700000,NE 156,RESIDENTIAL,7398,0,7398,43188,0,50586
141535800800000,NE 156,RESIDENTIAL,4216,0,4216,1214,0,5430
141535800900000,NE 156,RESIDENTIAL,18924,0,18924,41813,0,60737
141535801000000,CONVERSION,COMMERCIAL,0,12020,12020,0,50941,62961
141535801100000,NE 156,RESIDENTIAL,20140,0,20140,50868,0,71008
141535900100000,FLAT PARKING,COMMERCIAL,0,21000,21000,0,0,21000
141535900102000,FAST FOOD,COMMERCIAL,0,0,0,0,57538,57538
141535900200000,NE 156,RESIDENTIAL,9920,0,9920,41366,0,51286
141535900300000,NE 156,RESIDENTIAL,12400,0,12400,48535,0,60935
141535900400000,NE 156,RESIDENTIAL,11160,0,11160,38785,0,49945
141535900500000,NE 156,RESIDENTIAL,11160,0,11160,48861,0,60021
141535900600000,APARTMENT,RESIDENTIAL,16800,0,16800,127613,0,144413
141535900700000,NE 156,RESIDENTIAL,12000,0,12000,38865,0,50865
141535900800000,NE 156,RESIDENTIAL,12000,0,12000,35670,0,47670
141535900900000,NE 156,RESIDENTIAL,20400,0,20400,45821,0,66221
141535901000000,NE 156,RESIDENTIAL,20400,0,20400,46502,0,66902
141535901100000,NE 156,RESIDENTIAL,20400,0,20400,23381,0,43781
141535901200000,NE 156,RESIDENTIAL,12000,0,12000,49414,0,61414
141535901300000,NE 156,RESIDENTIAL,12000,0,12000,47673,0,59673
141535901400000,NE 156,RESIDENTIAL,12000,0,12000,43300,0,55300
141535901500000,NE 156,RESIDENTIAL,12000,0,12000,47244,0,59244
141535901600000,CONVERSION,COMMERCIAL,0,13608,13608,0,32118,45726
141535901700000,NE 156,RESIDENTIAL,18533,0,18533,71545,0,90078
141535901800000,NE 156,RESIDENTIAL,9920,0,9920,46220,0,56140
141535901900000,NE 156,RESIDENTIAL,12000,0,12000,45884,0,57884
141535902000000,NE 156,RESIDENTIAL,12000,0,12000,38672,0,50672
141535902100000,NE 156,RESIDENTIAL,12000,0,12000,49408,0,61408
141535902200000,NE 156,RESIDENTIAL,12000,0,12000,49608,0,61608
141535902300000,NE 156,RESIDENTIAL,12000,0,12000,46933,0,58933
141535902400000,NE 156,RESIDENTIAL,20400,0,20400,61403,0,81803
141535902500000,NE 156,RESIDENTIAL,16000,0,16000,57512,0,73512
141535902600000,NE 156,RESIDENTIAL,16000,0,16000,48984,0,64984
141535902700000,NE 156,RESIDENTIAL,12800,0,12800,49771,0,62571
141535902800000,NE 156,RESIDENTIAL,21760,0,21760,80225,0,101985
141536000100000,NE 156,RESIDENTIAL,9920,0,9920,45399,0,55319
141536000200000,OFFICE,COMMERCIAL,0,8400,8400,0,26370,34770
141536000300000,NE 156,RESIDENTIAL,6480,0,6480,46910,0,53390
141536000400000,NE 156,RESIDENTIAL,14000,0,14000,73538,0,87538
141536000500000,NE 156,RESIDENTIAL,11520,0,11520,54573,0,66093
141536000600000,NE 156,RESIDENTIAL,20000,0,20000,52087,0,72087
141536000700000,NE 156,RESIDENTIAL,16000,0,16000,66222,0,82222
141536100100000,CITY PROPERTY,EXEMPT,0,0,0,0,0,0
141537600100000,NE 155,RESIDENTIAL,20000,0,20000,61254,0,81254
141537600200000,NE 155,RESIDENTIAL,20000,0,20000,73863,0,93863
141537600300000,NE 155,RESIDENTIAL,20000,0,20000,58890,0,78890
141537600400000,NE 155,RESIDENTIAL,24000,0,24000,93233,0,117233
141537600500000,NE 155,RESIDENTIAL,20000,0,20000,90919,0,110919
141537600600000,NE 155,RESIDENTIAL,20000,0,20000,80420,0,100420
141537600700000,NE 155,RESIDENTIAL,26400,0,26400,127424,0,153824
141537600800000,NE 155,RESIDENTIAL,16000,0,16000,81636,0,97636
141537600900000,NE 155,RESIDENTIAL,15400,0,15400,59760,0,75160
141537601000000,NE 155,RESIDENTIAL,15400,0,15400,49169,0,64569
141537601100000,NE 155,RESIDENTIAL,15400,0,15400,82498,0,97898
141537601200000,NE 155,RESIDENTIAL,15400,0,15400,69918,0,85318
141537601300000,APARTMENT,RESIDENTIAL,20250,0,20250,246525,0,266775
141537601400000,APARTMENT,RESIDENTIAL,14750,0,14750,97223,0,111973
141537601500000,NE 155,RESIDENTIAL,15000,0,15000,67846,0,82846
141537601600000,NE 155,RESIDENTIAL,15000,0,15000,69605,0,84605
141537601700000,NE 155,RESIDENTIAL,20000,0,20000,74720,0,94720
141537601800000,NE 155,RESIDENTIAL,16000,0,16000,69285,0,85285
141537601900000,NE 155,RESIDENTIAL,18000,0,18000,79376,0,97376
141537602000000,NE 155,RESIDENTIAL,22100,0,22100,99043,0,121143
141537602100000,NE 155,RESIDENTIAL,20000,0,20000,60078,0,80078
141537700100000,NE 155,RESIDENTIAL,20000,0,20000,79493,0,99493
141537700200000,NE 155,RESIDENTIAL,20000,0,20000,56335,0,76335
141537700300000,NE 155,RESIDENTIAL,20000,0,20000,63640,0,83640
141537700400000,NE 155,RESIDENTIAL,20000,0,20000,72119,0,92119
141537700500000,NE 155,RESIDENTIAL,20000,0,20000,49546,0,69546
141537700600000,NE 155,RESIDENTIAL,18028,0,18028,65226,0,83254
141537700700000,NE 155,RESIDENTIAL,16600,0,16600,56058,0,72658
141537700800000,NE 155,RESIDENTIAL,19000,0,19000,52095,0,71095
141537700900000,NE 155,RESIDENTIAL,20000,0,20000,68887,0,88887
141537701000000,NE 155,RESIDENTIAL,20000,0,20000,69952,0,89952
141537701100000,NE 155,RESIDENTIAL,20000,0,20000,69471,0,89471
141537800100000,NE 155,RESIDENTIAL,27600,0,27600,114990,0,142590
141537800200000,NE 155,RESIDENTIAL,17600,0,17600,23528,0,41128
141537800300000,NE 155,RESIDENTIAL,17600,0,17600,37657,0,55257
141537800400000,NE 155,RESIDENTIAL,15400,0,15400,47129,0,62529
141537800500000,NE 155,RESIDENTIAL,9125,0,9125,37561,0,46686
141537800600000,NE 155,RESIDENTIAL,9125,0,9125,39185,0,48310
141537800700000,NE 155,RESIDENTIAL,12500,0,12500,51961,0,64461
141537800800000,NE 155,RESIDENTIAL,12500,0,12500,40386,0,52886
141537800900000,NE 155,RESIDENTIAL,12750,0,12750,46469,0,59219
141537801000000,NE 155,RESIDENTIAL,12750,0,12750,77141,0,89891
141537801100000,NE 155,RESIDENTIAL,13200,0,13200,67816,0,81016
141537801200000,NE 155,RESIDENTIAL,10375,0,10375,23741,0,34116
141537801300000,NE 155,RESIDENTIAL,10375,0,10375,74472,0,84847
141537801400000,NE 155,RESIDENTIAL,22000,0,22000,73264,0,95264
141537801500000,APARTMENT,RESIDENTIAL,10000,0,10000,124133,0,134133
141537801600000,NE 155,RESIDENTIAL,22000,0,22000,77315,0,99315
141537801700000,CONVERSION,COMMERCIAL,0,21870,21870,0,60053,81923
141537802100000,NE 155,RESIDENTIAL,30600,0,30600,104215,0,134815
141537802200000,NE 155,RESIDENTIAL,31200,0,31200,141158,0,172358
141537802300000,NE 155,RESIDENTIAL,23604,0,23604,119658,0,143262
141537802400000,NE 155,RESIDENTIAL,23604,0,23604,117353,0,140957
141537900100000,SHOP,COMMERCIAL,0,97500,97500,0,280300,377800
141537900200000,WAREHOUSE,COMMERCIAL,0,36000,36000,0,109072,145072
141537900300000,VACANT LAND,COMMERCIAL,0,2152,2152,0,0,2152
141537900400000,SHOP,COMMERCIAL,0,69750,69750,0,191839,261589
141538000100000,NE 155,RESIDENTIAL,20400,0,20400,71282,0,91682
141538000200000,NE 155,RESIDENTIAL,20400,0,20400,68224,0,88624
141538000300000,NE 155,RESIDENTIAL,20400,0,20400,62972,0,83372
141538000400000,NE 155,RESIDENTIAL,20400,0,20400,71048,0,91448
141538000500000,NE 155,RESIDENTIAL,17600,0,17600,43181,0,60781
141538000600000,NE 155,RESIDENTIAL,17600,0,17600,48648,0,66248
141538000700000,APARTMENT,RESIDENTIAL,16600,0,16600,124185,0,140785
141538000800000,CONVERSION,COMMERCIAL,0,18954,18954,0,123597,142551
141538000900000,NE 155,RESIDENTIAL,24480,0,24480,160652,0,185132
141538100100000,NE 155,RESIDENTIAL,32500,0,32500,123805,0,156305
141538100200000,NE 155,RESIDENTIAL,30000,0,30000,129923,0,159923
141538100300000,NE 155,RESIDENTIAL,25000,0,25000,71811,0,96811
141538100400000,NE 155,RESIDENTIAL,25000,0,25000,62384,0,87384
141538100500000,NE 155,RESIDENTIAL,25000,0,25000,79793,0,104793
141538100600000,NE 155,RESIDENTIAL,25000,0,25000,66382,0,91382
141538100700000,NE 156,RESIDENTIAL,17500,0,17500,57727,0,75227
141538100800000,CONVERSION,COMMERCIAL,0,11340,11340,0,40709,52049
141538100900000,CONVERSION,COMMERCIAL,0,11340,11340,0,78233,89573
141538101000000,NE 155,RESIDENTIAL,25000,0,25000,69741,0,94741
141538101100000,NE 155,RESIDENTIAL,23500,0,23500,62894,0,86394
141538101200000,NE 155,RESIDENTIAL,17500,0,17500,56039,0,73539
141538101300000,NE 155,RESIDENTIAL,10850,0,10850,51429,0,62279
141538101400000,NE 155,RESIDENTIAL,10850,0,10850,56676,0,67526
141538101500000,NE 155,RESIDENTIAL,13300,0,13300,67504,0,80804
141538101600000,NE 156,RESIDENTIAL,12478,0,12478,63477,0,75955
141538101700000,NE 155,RESIDENTIAL,13400,0,13400,63539,0,76939
141538101800000,NE 155,RESIDENTIAL,13400,0,13400,63684,0,77084
141538101900000,NE 155,RESIDENTIAL,18350,0,18350,73189,0,91539
141538102000000,NE 155,RESIDENTIAL,25992,0,25992,79484,0,105476
141538102100000,APARTMENT,RESIDENTIAL,18000,0,18000,208596,0,226596
141538102200000,NE 155,RESIDENTIAL,25000,0,25000,78259,0,103259
141538102300000,NE 155,RESIDENTIAL,25500,0,25500,34409,0,59909
141538102400000,NE 155,RESIDENTIAL,25000,0,25000,97273,0,122273
141538102500000,NE 155,RESIDENTIAL,25000,0,25000,84733,0,109733
141538102600000,NE 155,RESIDENTIAL,25000,0,25000,79088,0,104088
141538200100000,NE 156,RESIDENTIAL,10241,0,10241,50793,0,61034
141538200200000,NE 156,RESIDENTIAL,10241,0,10241,37651,0,47892
141538200300000,NE 156,RESIDENTIAL,5880,0,5880,34123,0,40003
141538200400000,NE 156,RESIDENTIAL,17290,0,17290,61812,0,79102
141538300100000,NE 155,RESIDENTIAL,17750,0,17750,99610,0,117360
141538300200000,NE 155,RESIDENTIAL,14688,0,14688,88076,0,102764
141538300300000,NE 155,RESIDENTIAL,10800,0,10800,47559,0,58359
141538300400000,NE 155,RESIDENTIAL,10800,0,10800,70727,0,81527
141538300500000,NE 155,RESIDENTIAL,15500,0,15500,77734,0,93234
141538300600000,NE 155,RESIDENTIAL,15000,0,15000,60719,0,75719
141538300700000,NE 155,RESIDENTIAL,17500,0,17500,56287,0,73787
141538300800000,NE 155,RESIDENTIAL,17500,0,17500,67288,0,84788
141538300900000,NE 155,RESIDENTIAL,25000,0,25000,90250,0,115250
141538301000000,CONVERSION,COMMERCIAL,0,11340,11340,0,60801,72141
141538301100000,NE 155,RESIDENTIAL,25000,0,25000,74187,0,99187
141538301200000,NE 155,RESIDENTIAL,16500,0,16500,75689,0,92189
141538301300000,NE 155,RESIDENTIAL,16500,0,16500,67445,0,83945
141538301400000,NE 155,RESIDENTIAL,17000,0,17000,55964,0,72964
141538301500000,APARTMENT,COMMERCIAL,0,14000,14000,0,158916,172916
141538301600000,NE 155,RESIDENTIAL,25000,0,25000,58324,0,83324
141538301700000,NE 155,RESIDENTIAL,15500,0,15500,69682,0,85182
141538301800000,NE 155,RESIDENTIAL,15500,0,15500,60786,0,76286
141538301900000,NE 155,RESIDENTIAL,22000,0,22000,77444,0,99444
141538302000000,NE 155,RESIDENTIAL,13200,0,13200,77628,0,90828
141538302100000,CHURCH,EXEMPT,0,45144,45144,0,569104,614248
141538302200000,NE 155,RESIDENTIAL,20000,0,20000,67365,0,87365
141538302300000,NE 155,RESIDENTIAL,20000,0,20000,66315,0,86315
141538302400000,NE 155,RESIDENTIAL,25500,0,25500,131776,0,157276
141538302500000,NE 155,RESIDENTIAL,25000,0,25000,77054,0,102054
141538302600000,CONVERSION,COMMERCIAL,0,11340,11340,0,59827,71167
141538302700000,NE 155,RESIDENTIAL,25000,0,25000,63264,0,88264
141538400100000,NE 156,RESIDENTIAL,16401,0,16401,38005,0,54406
141538400200000,NE 156,RESIDENTIAL,9800,0,9800,58853,0,68653
141538400300000,NE 156,RESIDENTIAL,9800,0,9800,52647,0,62447
141538400400000,NE 156,RESIDENTIAL,8820,0,8820,33790,0,42610
141538400500000,NE 156,RESIDENTIAL,8820,0,8820,40682,0,49502
141538400600000,NE 156,RESIDENTIAL,17290,0,17290,55364,0,72654
141538400700000,NE 156,RESIDENTIAL,17290,0,17290,52160,0,69450
141538400800000,NE 156,RESIDENTIAL,12250,0,12250,50101,0,62351
141538400900000,NE 156,RESIDENTIAL,12250,0,12250,62510,0,74760
141538401000000,NE 156,RESIDENTIAL,11900,0,11900,45221,0,57121
141538401100000,NE 156,RESIDENTIAL,20140,0,20140,34903,0,55043
141538401200000,NE 156,RESIDENTIAL,19926,0,19926,67385,0,87311
141538401300000,NE 156,RESIDENTIAL,20800,0,20800,0,0,20800
141538401400000,NE 156,RESIDENTIAL,19760,0,19760,55332,0,75092
141538401500000,NE 156,RESIDENTIAL,19760,0,19760,54690,0,74450
141538401600000,NE 156,RESIDENTIAL,19760,0,19760,73426,0,93186
141538500100000,APARTMENT,RESIDENTIAL,28000,0,28000,266839,0,294839
141538500200000,CONVERSION,COMMERCIAL,0,5103,5103,0,70662,75765
141538500300000,NE 155,RESIDENTIAL,18750,0,18750,59127,0,77877
141538500400000,NE 155,RESIDENTIAL,16500,0,16500,84039,0,100539
141538500500000,NE 155,RESIDENTIAL,17000,0,17000,67001,0,84001
141538500600000,NE 155,RESIDENTIAL,16500,0,16500,82994,0,99494
141538500700000,NE 155,RESIDENTIAL,25000,0,25000,73219,0,98219
141538500800000,NE 155,RESIDENTIAL,25000,0,25000,75655,0,100655
141538500900000,NE 155,RESIDENTIAL,25000,0,25000,88872,0,113872
141538501000000,NE 155,RESIDENTIAL,25000,0,25000,99832,0,124832
141538501100000,NE 155,RESIDENTIAL,25000,0,25000,84975,0,109975
141538501200000,NE 155,RESIDENTIAL,25000,0,25000,78177,0,103177
141538501300000,NE 155,RESIDENTIAL,25000,0,25000,63509,0,88509
141538501400000,NE 155,RESIDENTIAL,25000,0,25000,62307,0,87307
141538501500000,NE 155,RESIDENTIAL,12500,0,12500,87645,0,100145
141538501600000,NE 155,RESIDENTIAL,12500,0,12500,65011,0,77511
141538501700000,NE 155,RESIDENTIAL,12500,0,12500,0,0,12500
141538501800000,NE 155,RESIDENTIAL,10000,0,10000,59157,0,69157
141538501900000,NE 155,RESIDENTIAL,12750,0,12750,78788,0,91538
141538600100000,NE 156,RESIDENTIAL,16598,0,16598,67079,0,83677
141538600200000,NE 156,RESIDENTIAL,9604,0,9604,44009,0,53613
141538600300000,NE 156,RESIDENTIAL,10976,0,10976,58601,0,69577
141538600400000,NE 156,RESIDENTIAL,13832,0,13832,45592,0,59424
141538600500000,NE 156,RESIDENTIAL,19760,0,19760,57142,0,76902
141538600600000,NE 156,RESIDENTIAL,19760,0,19760,57269,0,77029
141538600700000,NE 156,RESIDENTIAL,19760,0,19760,55038,0,74798
141538600800000,NE 156,RESIDENTIAL,19760,0,19760,14575,0,34335
141538600900000,NE 156,RESIDENTIAL,19760,0,19760,45635,0,65395
141538601000000,NE 156,RESIDENTIAL,20800,0,20800,53840,0,74640
141540100100000,NE 154,RESIDENTIAL,32725,0,32725,85723,0,118448
141540100200000,NE 154,RESIDENTIAL,35992,0,35992,82765,0,118757
141540100300000,NE 154,RESIDENTIAL,32760,0,32760,103494,0,136254
141540100400000,NE 154,RESIDENTIAL,42978,0,42978,162887,0,205865
141540100500000,NE 154,RESIDENTIAL,39567,0,39567,135553,0,175120
141540100600000,NE 154,RESIDENTIAL,12753,0,12753,62890,0,75643
141540100700000,NE 154,RESIDENTIAL,41580,0,41580,87787,0,129367
141540100800000,NE 154,RESIDENTIAL,53980,0,53980,188458,0,242438
141540100900000,NE 154,RESIDENTIAL,35237,0,35237,90329,0,125566
141540200100000,NE 154,RESIDENTIAL,20200,0,20200,103704,0,123904
141540200200000,NE 154,RESIDENTIAL,25543,0,25543,111097,0,136640
141540200300000,NE 154,RESIDENTIAL,22500,0,22500,84738,0,107238
141540200400000,NE 154,RESIDENTIAL,25160,0,25160,119975,0,145135
141540300100000,NE 154,RESIDENTIAL,22714,0,22714,143693,0,166407
141540300200000,NE 154,RESIDENTIAL,23265,0,23265,115589,0,138854
141540300300000,NE 154,RESIDENTIAL,23230,0,23230,92267,0,115497
141540300400000,NE 154,RESIDENTIAL,25480,0,25480,96352,0,121832
141540300500000,NE 154,RESIDENTIAL,21802,0,21802,87778,0,109580
141540300600000,NE 154,RESIDENTIAL,21699,0,21699,92070,0,113769
141540300700000,NE 154,RESIDENTIAL,25235,0,25235,123194,0,148429
141540300800000,NE 154,RESIDENTIAL,22454,0,22454,67016,0,89470
141540300900000,NE 154,RESIDENTIAL,20600,0,20600,75528,0,96128
141540301000000,NE 154,RESIDENTIAL,28840,0,28840,152571,0,181411
141540301100000,NE 154,RESIDENTIAL,20200,0,20200,83492,0,103692
141540301200000,NE 154,RESIDENTIAL,20000,0,20000,87268,0,107268
141540301300000,NE 154,RESIDENTIAL,20000,0,20000,78148,0,98148
141540301400000,NE 154,RESIDENTIAL,19812,0,19812,109128,0,128940
141540301500000,NE 154,RESIDENTIAL,19473,0,19473,91245,0,110718
141540301600000,NE 154,RESIDENTIAL,19272,0,19272,87088,0,106360
141540301700000,NE 154,RESIDENTIAL,23265,0,23265,106931,0,130196
141540301800000,NE 154,RESIDENTIAL,18400,0,18400,75338,0,93738
141540301900000,NE 154,RESIDENTIAL,18600,0,18600,67590,0,86190
141540302000000,NE 154,RESIDENTIAL,18800,0,18800,87051,0,105851
141540302100000,NE 154,RESIDENTIAL,25920,0,25920,102089,0,128009
141540302200000,NE 154,RESIDENTIAL,26190,0,26190,136743,0,162933
141540302300000,NE 154,RESIDENTIAL,21887,0,21887,80850,0,102737
141540302400000,NE 154,RESIDENTIAL,20444,0,20444,92434,0,112878
141540302500000,NE 154,RESIDENTIAL,20493,0,20493,59594,0,80087
141540302600000,NE 154,RESIDENTIAL,20967,0,20967,67045,0,88012
141540302700000,NE 154,RESIDENTIAL,21133,0,21133,104181,0,125314
141540302800000,NE 154,RESIDENTIAL,21345,0,21345,113932,0,135277
141540302900000,NE 154,RESIDENTIAL,21850,0,21850,85758,0,107608
141540303000000,NE 154,RESIDENTIAL,21896,0,21896,76917,0,98813
141540303100000,NE 154,RESIDENTIAL,20600,0,20600,74255,0,94855
141540303200000,NE 154,RESIDENTIAL,21320,0,21320,102180,0,123500
141540303300000,NE 154,RESIDENTIAL,21320,0,21320,69166,0,90486
141540303400000,NE 154,RESIDENTIAL,20943,0,20943,62749,0,83692
141540303500000,NE 154,RESIDENTIAL,21420,0,21420,60079,0,81499
141540400100000,SCHOOL,EXEMPT,0,0,0,0,0,0
141540400200000,NE 154,RESIDENTIAL,24273,0,24273,87231,0,111504
141540400300000,NE 154,RESIDENTIAL,23500,0,23500,72185,0,95685
141540500100000,NE 154,RESIDENTIAL,34768,0,34768,61698,0,96466
141540500200000,NE 154,RESIDENTIAL,26208,0,26208,25426,0,51634
141540500300000,NE 154,RESIDENTIAL,27349,0,27349,108908,0,136257
141540500400000,NE 154,RESIDENTIAL,30096,0,30096,115894,0,145990
141540500500000,CHURCH,EXEMPT,0,382644,382644,0,578741,961385
141540500600000,NE 154,RESIDENTIAL,26950,0,26950,101469,0,128419
141540500700000,NE 154,RESIDENTIAL,28417,0,28417,87494,0,115911
141540500800000,NE 154,RESIDENTIAL,33611,0,33611,86852,0,120463
141540600100000,NE 154,RESIDENTIAL,25079,0,25079,60472,0,85551
141540600200000,NE 154,RESIDENTIAL,17000,0,17000,77270,0,94270
141540600300000,NE 154,RESIDENTIAL,17000,0,17000,70715,0,87715
141540600400000,NE 154,RESIDENTIAL,14700,0,14700,68900,0,83600
141540600500000,NE 154,RESIDENTIAL,14525,0,14525,68790,0,83315
141540600600000,NE 154,RESIDENTIAL,16400,0,16400,74459,0,90859
141540600700000,NE 154,RESIDENTIAL,16000,0,16000,72687,0,88687
141540600800000,NE 154,RESIDENTIAL,26385,0,26385,84663,0,111048
141540600900000,NE 154,RESIDENTIAL,25802,0,25802,118206,0,144008
141540601000000,NE 154,RESIDENTIAL,26730,0,26730,106546,0,133276
141540601100000,NE 154,RESIDENTIAL,27645,0,27645,121803,0,149448
141540601200000,NE 154,RESIDENTIAL,28000,0,28000,111684,0,139684
141540601300000,NE 154,RESIDENTIAL,18517,0,18517,110942,0,129459
141540601400000,NE 154,RESIDENTIAL,25900,0,25900,92534,0,118434
141540601500000,NE 154,RESIDENTIAL,25900,0,25900,111454,0,137354
141540601600000,NE 154,RESIDENTIAL,33900,0,33900,153626,0,187526
141540601700000,NE 154,RESIDENTIAL,30800,0,30800,125290,0,156090
141540601800000,NE 154,RESIDENTIAL,22000,0,22000,90869,0,112869
141540601900000,NE 154,RESIDENTIAL,22000,0,22000,101141,0,123141
141540602000000,NE 154,RESIDENTIAL,20400,0,20400,84484,0,104884
141540602100000,NE 154,RESIDENTIAL,29970,0,29970,97090,0,127060
141540602200000,NE 154,RESIDENTIAL,19360,0,19360,77955,0,97315
141540602300000,NE 154,RESIDENTIAL,19360,0,19360,91213,0,110573
141540602400000,NE 154,RESIDENTIAL,19360,0,19360,77156,0,96516
141540602500000,NE 154,RESIDENTIAL,19360,0,19360,65130,0,84490
141540602700000,FLAT PARKING,COMMERCIAL,0,60640,60640,0,10260,70900
141540602800000,APARTMENT,RESIDENTIAL,57840,0,57840,755178,0,813018
141540602900000,NE 154,RESIDENTIAL,28728,0,28728,91192,0,119920
141540603000000,NE 154,RESIDENTIAL,23158,0,23158,85240,0,108398
141540603100000,NE 154,RESIDENTIAL,22284,0,22284,91179,0,113463
141540603200000,NE 154,RESIDENTIAL,19508,0,19508,58665,0,78173
141540603300000,APARTMENT,COMMERCIAL,0,99760,99760,0,1681723,1781483
141540603400000,NE 154,RESIDENTIAL,24200,0,24200,4596,0,28796
141540700100000,NE 154,RESIDENTIAL,20520,0,20520,130430,0,150950
141540700200000,NE 154,RESIDENTIAL,15200,0,15200,78688,0,93888
141540700300000,NE 154,RESIDENTIAL,23750,0,23750,87417,0,111167
141540700400000,NE 154,RESIDENTIAL,25500,0,25500,76799,0,102299
141540700500000,NE 154,RESIDENTIAL,22950,0,22950,80975,0,103925
141540700600000,NE 154,RESIDENTIAL,19800,0,19800,62907,0,82707
141540700700000,NE 154,RESIDENTIAL,22440,0,22440,86001,0,108441
141540700800000,NE 154,RESIDENTIAL,17600,0,17600,72620,0,90220
141540700900000,NE 154,RESIDENTIAL,20400,0,20400,73795,0,94195
141540701000000,NE 154,RESIDENTIAL,20400,0,20400,103785,0,124185
141540701100000,NE 154,RESIDENTIAL,17600,0,17600,103421,0,121021
141540800100000,SE 218,RESIDENTIAL,51916,0,51916,134237,0,186153
141542600100000,NE 154,RESIDENTIAL,25323,0,25323,91172,0,116495
141542600200000,NE 154,RESIDENTIAL,25080,0,25080,128450,0,153530
141542600300000,NE 154,RESIDENTIAL,23333,0,23333,89872,0,113205
141542600400000,NE 154,RESIDENTIAL,26792,0,26792,86038,0,112830
141542600500000,NE 154,RESIDENTIAL,20000,0,20000,90853,0,110853
141542600600000,NE 154,RESIDENTIAL,25000,0,25000,95479,0,120479
141542600700000,NE 154,RESIDENTIAL,26775,0,26775,81443,0,108218
141542600800000,NE 154,RESIDENTIAL,21000,0,21000,71209,0,92209
141542600900000,NE 154,RESIDENTIAL,20400,0,20400,79639,0,100039
141542601000000,NE 154,RESIDENTIAL,20400,0,20400,72587,0,92987
141542601100000,NE 154,RESIDENTIAL,27249,0,27249,65562,0,92811
141542700100000,SCHOOL,EXEMPT,0,0,0,0,0,0
141542800100000,NE 154,RESIDENTIAL,26477,0,26477,98463,0,124940
141542800200000,NE 154,RESIDENTIAL,25215,0,25215,132991,0,158206
141542800300000,NE 154,RESIDENTIAL,20400,0,20400,69855,0,90255
141542800400000,NE 154,RESIDENTIAL,20400,0,20400,91573,0,111973
141542800500000,NE 154,RESIDENTIAL,20400,0,20400,88681,0,109081
141542800600000,NE 154,RESIDENTIAL,21014,0,21014,84007,0,105021
141542800700000,NE 154,RESIDENTIAL,19000,0,19000,77846,0,96846
141542800800000,NE 154,RESIDENTIAL,17100,0,17100,78489,0,95589
141542900100000,NE 154,RESIDENTIAL,25753,0,25753,97026,0,122779
141542900200000,NE 154,RESIDENTIAL,25164,0,25164,144964,0,170128
141542900300000,NE 154,RESIDENTIAL,24180,0,24180,79766,0,103946
141542900400000,NE 154,RESIDENTIAL,24180,0,24180,78966,0,103146
141542900500000,NE 154,RESIDENTIAL,24180,0,24180,92683,0,116863
141542900600000,NE 154,RESIDENTIAL,24180,0,24180,82849,0,107029
141542900700000,NE 154,RESIDENTIAL,24180,0,24180,99059,0,123239
141542900800000,NE 154,RESIDENTIAL,24180,0,24180,94677,0,118857
141542900900000,NE 154,RESIDENTIAL,24180,0,24180,96709,0,120889
141542901000000,NE 154,RESIDENTIAL,24180,0,24180,106643,0,130823
141542901100000,NE 154,RESIDENTIAL,24180,0,24180,85614,0,109794
141542901200000,NE 154,RESIDENTIAL,24180,0,24180,96688,0,120868
141542901300000,NE 154,RESIDENTIAL,24180,0,24180,89944,0,114124
141542901400000,NE 154,RESIDENTIAL,25922,0,25922,131654,0,157576
141542901500000,NE 154,RESIDENTIAL,25271,0,25271,88906,0,114177
141542901600000,NE 154,RESIDENTIAL,24180,0,24180,97059,0,121239
141542901700000,NE 154,RESIDENTIAL,24180,0,24180,101507,0,125687
141542901800000,NE 154,RESIDENTIAL,24180,0,24180,68564,0,92744
141542901900000,NE 154,RESIDENTIAL,24180,0,24180,104578,0,128758
141542902000000,NE 154,RESIDENTIAL,24180,0,24180,100533,0,124713
141542902100000,NE 154,RESIDENTIAL,24180,0,24180,99278,0,123458
141542902200000,NE 154,RESIDENTIAL,24180,0,24180,76128,0,100308
141542902300000,NE 154,RESIDENTIAL,24180,0,24180,118701,0,142881
141542902400000,NE 154,RESIDENTIAL,24180,0,24180,75709,0,99889
141542902500000,NE 154,RESIDENTIAL,24180,0,24180,74667,0,98847
141542902600000,NE 154,RESIDENTIAL,24180,0,24180,103997,0,128177
141543000100000,NE 154,RESIDENTIAL,25893,0,25893,105553,0,131446
141543000200000,NE 154,RESIDENTIAL,25304,0,25304,76592,0,101896
141543000300000,NE 154,RESIDENTIAL,24180,0,24180,79689,0,103869
141543000400000,NE 154,RESIDENTIAL,24180,0,24180,82718,0,106898
141543000500000,NE 154,RESIDENTIAL,24180,0,24180,100442,0,124622
141543000600000,NE 154,RESIDENTIAL,24180,0,24180,92246,0,116426
141543000700000,NE 154,RESIDENTIAL,24180,0,24180,101809,0,125989
141543000800000,NE 154,RESIDENTIAL,24180,0,24180,107427,0,131607
141543000900000,NE 154,RESIDENTIAL,24180,0,24180,100274,0,124454
141543001000000,NE 154,RESIDENTIAL,24180,0,24180,99563,0,123743
141543001100000,NE 154,RESIDENTIAL,24180,0,24180,107037,0,131217
141543001200000,NE 154,RESIDENTIAL,24180,0,24180,92400,0,116580
141543001300000,NE 154,RESIDENTIAL,24180,0,24180,101074,0,125254
141543001400000,NE 154,RESIDENTIAL,25924,0,25924,109801,0,135725
141543001500000,NE 154,RESIDENTIAL,25273,0,25273,80136,0,105409
141543001600000,NE 154,RESIDENTIAL,24180,0,24180,93254,0,117434
141543001700000,NE 154,RESIDENTIAL,24180,0,24180,90012,0,114192
141543001800000,NE 154,RESIDENTIAL,24180,0,24180,89728,0,113908
141543001900000,NE 154,RESIDENTIAL,24230,0,24230,83252,0,107482
141543002000000,NE 154,RESIDENTIAL,24180,0,24180,94550,0,118730
141543002100000,NE 154,RESIDENTIAL,24180,0,24180,78483,0,102663
141543002200000,NE 154,RESIDENTIAL,24180,0,24180,85637,0,109817
141543002300000,NE 154,RESIDENTIAL,24180,0,24180,97422,0,121602
141543002400000,NE 154,RESIDENTIAL,24180,0,24180,100075,0,124255
141543002500000,NE 154,RESIDENTIAL,24180,0,24180,83767,0,107947
141543002600000,NE 154,RESIDENTIAL,24180,0,24180,141287,0,165467
141543100100000,NE 154,RESIDENTIAL,30110,0,30110,87747,0,117857
141543100200000,NE 154,RESIDENTIAL,25418,0,25418,93077,0,118495
141543100300000,NE 154,RESIDENTIAL,24180,0,24180,80457,0,104637
141543100400000,NE 154,RESIDENTIAL,24180,0,24180,89551,0,113731
141543100500000,NE 154,RESIDENTIAL,24180,0,24180,102600,0,126780
141543100600000,NE 154,RESIDENTIAL,24180,0,24180,76279,0,100459
141543100700000,NE 154,RESIDENTIAL,24180,0,24180,92331,0,116511
141543100800000,NE 154,RESIDENTIAL,24180,0,24180,73238,0,97418
141543100900000,NE 154,RESIDENTIAL,24180,0,24180,90572,0,114752
141543101000000,NE 154,RESIDENTIAL,24180,0,24180,100865,0,125045
141543101100000,NE 154,RESIDENTIAL,24180,0,24180,87694,0,111874
141543101200000,NE 154,RESIDENTIAL,24180,0,24180,86206,0,110386
141543101300000,NE 154,RESIDENTIAL,24180,0,24180,73792,0,97972
141543101400000,NE 154,RESIDENTIAL,25924,0,25924,88904,0,114828
141543101500000,NE 154,RESIDENTIAL,25273,0,25273,91211,0,116484
141543101600000,NE 154,RESIDENTIAL,24180,0,24180,78817,0,102997
141543101700000,NE 154,RESIDENTIAL,24180,0,24180,97339,0,121519
141543101800000,NE 154,RESIDENTIAL,24180,0,24180,77608,0,101788
141543101900000,NE 154,RESIDENTIAL,24180,0,24180,105307,0,129487
141543102000000,NE 154,RESIDENTIAL,24180,0,24180,85891,0,110071
141543102100000,NE 154,RESIDENTIAL,24180,0,24180,64388,0,88568
141543102200000,NE 154,RESIDENTIAL,24180,0,24180,106219,0,130399
141543102300000,NE 154,RESIDENTIAL,24180,0,24180,87924,0,112104
141543102400000,NE 154,RESIDENTIAL,24180,0,24180,89755,0,113935
141543102500000,NE 154,RESIDENTIAL,24180,0,24180,107308,0,131488
141543200100000,NE 154,RESIDENTIAL,24812,0,24812,88400,0,113212
141543200200000,NE 154,RESIDENTIAL,23959,0,23959,84505,0,108464
141543200300000,NE 154,RESIDENTIAL,23959,0,23959,100485,0,124444
141543200400000,NE 154,RESIDENTIAL,23959,0,23959,99191,0,123150
141543200500000,NE 154,RESIDENTIAL,23959,0,23959,77574,0,101533
141543200600000,NE 154,RESIDENTIAL,23959,0,23959,90819,0,114778
141543200700000,NE 154,RESIDENTIAL,23959,0,23959,84577,0,108536
141543200800000,NE 154,RESIDENTIAL,23959,0,23959,112455,0,136414
141543200900000,NE 154,RESIDENTIAL,23959,0,23959,97879,0,121838
141543201000000,NE 154,RESIDENTIAL,23959,0,23959,105688,0,129647
141543201100000,NE 154,RESIDENTIAL,25753,0,25753,49020,0,74773
141543201200000,NE 154,RESIDENTIAL,25277,0,25277,98669,0,123946
141543201300000,NE 154,RESIDENTIAL,24180,0,24180,99721,0,123901
141543201400000,NE 154,RESIDENTIAL,24180,0,24180,83033,0,107213
141543201500000,NE 154,RESIDENTIAL,24180,0,24180,92575,0,116755
141543201600000,NE 154,RESIDENTIAL,24180,0,24180,103199,0,127379
141543201700000,NE 154,RESIDENTIAL,24180,0,24180,107375,0,131555
141543201800000,NE 154,RESIDENTIAL,24180,0,24180,101422,0,125602
141543201900000,NE 154,RESIDENTIAL,24180,0,24180,67779,0,91959
141543202000000,NE 154,RESIDENTIAL,24180,0,24180,79462,0,103642
141543202100000,NE 154,RESIDENTIAL,24180,0,24180,86170,0,110350
141543202200000,NE 154,RESIDENTIAL,24180,0,24180,99987,0,124167
141543202300000,NE 154,RESIDENTIAL,24180,0,24180,90870,0,115050
141543300100000,NE 154,RESIDENTIAL,25500,0,25500,92208,0,117708
141543300200000,NE 154,RESIDENTIAL,25500,0,25500,88876,0,114376
141543300300000,NE 154,RESIDENTIAL,25500,0,25500,92339,0,117839
141543300400000,NE 154,RESIDENTIAL,25500,0,25500,92048,0,117548
141543300500000,NE 154,RESIDENTIAL,25500,0,25500,76582,0,102082
141543300600000,NE 154,RESIDENTIAL,25500,0,25500,112542,0,138042
141543300700000,NE 154,RESIDENTIAL,25500,0,25500,101442,0,126942
141543300800000,NE 154,RESIDENTIAL,25500,0,25500,95631,0,121131
141543300900000,NE 154,RESIDENTIAL,25500,0,25500,110788,0,136288
141543301000000,NE 154,RESIDENTIAL,25500,0,25500,101078,0,126578
141543301100000,NE 154,RESIDENTIAL,25500,0,25500,110256,0,135756
141543301200000,NE 154,RESIDENTIAL,20400,0,20400,78281,0,98681
141543301300000,NE 154,RESIDENTIAL,20400,0,20400,73915,0,94315
141543301400000,NE 154,RESIDENTIAL,20400,0,20400,77269,0,97669
141543301500000,NE 154,RESIDENTIAL,20400,0,20400,89577,0,109977
141543301600000,NE 154,RESIDENTIAL,20400,0,20400,85761,0,106161
141543301700000,NE 154,RESIDENTIAL,25500,0,25500,78823,0,104323
141543301800000,NE 154,RESIDENTIAL,25500,0,25500,91067,0,116567
141543301900000,NE 154,RESIDENTIAL,28177,0,28177,128953,0,157130
141543302000000,NE 154,RESIDENTIAL,28560,0,28560,116687,0,145247
141543302100000,NE 154,RESIDENTIAL,28177,0,28177,116744,0,144921
141543302200000,NE 154,RESIDENTIAL,33150,0,33150,129810,0,162960
141543302300000,NE 154,RESIDENTIAL,25500,0,25500,110658,0,136158
141543302400000,NE 154,RESIDENTIAL,25500,0,25500,107624,0,133124
141543302500000,NE 154,RESIDENTIAL,22950,0,22950,119812,0,142762
141543302600000,NE 154,RESIDENTIAL,26647,0,26647,120526,0,147173
141543302700000,NE 154,RESIDENTIAL,25500,0,25500,128871,0,154371
141543302800000,NE 154,RESIDENTIAL,25500,0,25500,105858,0,131358
141543302900000,NE 154,RESIDENTIAL,24990,0,24990,92796,0,117786
141543303000000,NE 154,RESIDENTIAL,26010,0,26010,94002,0,120012
141543400100000,NE 155,RESIDENTIAL,22990,0,22990,55585,0,78575
141543400200000,NE 155,RESIDENTIAL,15400,0,15400,56388,0,71788
141543400300000,NE 155,RESIDENTIAL,22000,0,22000,64575,0,86575
141543500100000,NE 154,RESIDENTIAL,27000,0,27000,70471,0,97471
141543500200000,NE 154,RESIDENTIAL,27000,0,27000,159328,0,186328
141543500300000,NE 154,RESIDENTIAL,25500,0,25500,86173,0,111673
141543500400000,NE 154,RESIDENTIAL,25500,0,25500,110222,0,135722
141545100100000,NE 154,RESIDENTIAL,18360,0,18360,93095,0,111455
141545100200000,NE 154,RESIDENTIAL,18360,0,18360,67672,0,86032
141545100300000,NE 154,RESIDENTIAL,18360,0,18360,82814,0,101174
141545100400000,NE 154,RESIDENTIAL,25500,0,25500,122497,0,147997
141545100500000,NE 154,RESIDENTIAL,25500,0,25500,61697,0,87197
141545100600000,NE 154,RESIDENTIAL,25500,0,25500,106521,0,132021
141545100700000,NE 154,RESIDENTIAL,25500,0,25500,107011,0,132511
141545100800000,NE 154,RESIDENTIAL,27250,0,27250,80505,0,107755
141545100900000,NE 154,RESIDENTIAL,25500,0,25500,128176,0,153676
141545101000000,NE 154,RESIDENTIAL,25500,0,25500,118607,0,144107
141545101100000,NE 154,RESIDENTIAL,25500,0,25500,83327,0,108827
141545101200000,NE 154,RESIDENTIAL,25500,0,25500,153400,0,178900
141545101300000,NE 154,RESIDENTIAL,25500,0,25500,71662,0,97162
141545101400000,APARTMENT,COMMERCIAL,0,54160,54160,0,852282,906442
141545101500000,APARTMENT,RESIDENTIAL,54160,0,54160,852650,0,906810
141545101600000,APARTMENT,COMMERCIAL,0,14500,14500,0,117882,132382
141545101700000,CONVERSION,COMMERCIAL,0,13041,13041,0,59022,72063
141545101800000,NE 154,RESIDENTIAL,14398,0,14398,61220,0,75618
141545101900000,NE 154,RESIDENTIAL,15298,0,15298,55118,0,70416
141545102000000,NE 154,RESIDENTIAL,19888,0,19888,62359,0,82247
141545102100000,NE 154,RESIDENTIAL,18360,0,18360,98652,0,117012
141545102200000,NE 154,RESIDENTIAL,20700,0,20700,96261,0,116961
141545102300000,NE 154,RESIDENTIAL,22950,0,22950,97986,0,120936
141545102400000,NE 154,RESIDENTIAL,22950,0,22950,78076,0,101026
141545102500000,NE 154,RESIDENTIAL,18360,0,18360,78831,0,97191
141545102600000,NE 154,RESIDENTIAL,18360,0,18360,67262,0,85622
141545200100000,NE 154,RESIDENTIAL,25500,0,25500,104338,0,129838
141545200200000,NE 154,RESIDENTIAL,25500,0,25500,98488,0,123988
141545200300000,NE 154,RESIDENTIAL,25500,0,25500,82909,0,108409
141545200400000,NE 154,RESIDENTIAL,25500,0,25500,82378,0,107878
141545200500000,NE 154,RESIDENTIAL,25500,0,25500,91281,0,116781
141545200600000,NE 154,RESIDENTIAL,22000,0,22000,75794,0,97794
141545200700000,NE 154,RESIDENTIAL,20900,0,20900,101943,0,122843
141545200800000,NE 154,RESIDENTIAL,20900,0,20900,97011,0,117911
141545200900000,NE 154,RESIDENTIAL,24225,0,24225,91054,0,115279
141545201000000,NE 154,RESIDENTIAL,36337,0,36337,121823,0,158160
141545201100000,NE 154,RESIDENTIAL,25500,0,25500,83684,0,109184
141545201200000,NE 154,RESIDENTIAL,25500,0,25500,86570,0,112070
141545300100000,NE 155,RESIDENTIAL,28125,0,28125,124420,0,152545
141545300200000,NE 155,RESIDENTIAL,22500,0,22500,80512,0,103012
141545300300000,NE 155,RESIDENTIAL,20000,0,20000,72362,0,92362
141545300400000,NE 155,RESIDENTIAL,20000,0,20000,65177,0,85177
141545400100000,NE 155,RESIDENTIAL,79443,0,79443,145134,0,224577
141545400200000,NE 155,RESIDENTIAL,24120,0,24120,68390,0,92510
141545400300000,NE 155,RESIDENTIAL,22356,0,22356,101440,0,123796
141545400400000,NE 155,RESIDENTIAL,18468,0,18468,85123,0,103591
141545400500000,NE 155,RESIDENTIAL,19125,0,19125,83293,0,102418
141545400600000,NE 155,RESIDENTIAL,18768,0,18768,97489,0,116257
141545400700000,NE 155,EXEMPT,0,20400,20400,0,63775,84175
141545400800000,NE 155,RESIDENTIAL,22848,0,22848,54025,0,76873
141545400900000,NE 155,RESIDENTIAL,22848,0,22848,105819,0,128667
141545401000000,NE 155,RESIDENTIAL,21318,0,21318,94019,0,115337
141545401100000,NE 155,RESIDENTIAL,22760,0,22760,172348,0,195108
141545401200000,NE 155,RESIDENTIAL,26796,0,26796,109223,0,136019
141545500400000,FLAT PARKING,COMMERCIAL,0,16560,16560,0,9101,25661
141545500500000,CENTRALLY ASSESSED,OTHER,0,0,0,0,0,0
141545500600000,FLAT PARKING,COMMERCIAL,0,9304,9304,0,5630,14934
141545500700000,VACANT LAND,COMMERCIAL,0,18742,18742,0,0,18742
141545500800000,VACANT LAND,COMMERCIAL,0,18742,18742,0,0,18742
141545500900000,VACANT LAND,COMMERCIAL,0,18742,18742,0,0,18742
141545501000000,FLAT PARKING,COMMERCIAL,0,40711,40711,0,1548,42259
141545501100000,FLAT PARKING,COMMERCIAL,0,40711,40711,0,370,41081
141545501200000,OFFICE,EXEMPT,0,24300,24300,0,47176,71476
141545501300000,FLAT PARKING,COMMERCIAL,0,70450,70450,0,4080,74530
141545501400000,OFFICE,COMMERCIAL,0,391200,391200,0,817411,1208611
141545501500000,VACANT LAND,COMMERCIAL,0,141015,141015,0,0,141015
141545501600000,SR/NURSING/ASSTD LIV,COMMERCIAL,0,121600,121600,0,1762964,1884564
141545600100000,NE 155,RESIDENTIAL,22000,0,22000,87359,0,109359
141545600200000,NE 155,RESIDENTIAL,22000,0,22000,73755,0,95755
141545600300000,NE 155,RESIDENTIAL,28314,0,28314,104007,0,132321
141545600400000,NE 155,RESIDENTIAL,19992,0,19992,107900,0,127892
141545600500000,NE 155,RESIDENTIAL,15680,0,15680,64839,0,80519
141545600700000,NE 155,RESIDENTIAL,13800,0,13800,64994,0,78794
141545600800000,NE 155,RESIDENTIAL,20400,0,20400,66212,0,86612
141545600900000,NE 155,RESIDENTIAL,21600,0,21600,65470,0,87070
141545601000000,NE 155,RESIDENTIAL,20400,0,20400,71200,0,91600
141545601100000,NE 155,RESIDENTIAL,21000,0,21000,108196,0,129196
141545601200000,APARTMENT,COMMERCIAL,0,16500,16500,0,101129,117629
141545601300000,NE 155,RESIDENTIAL,20800,0,20800,109443,0,130243
141545601400000,APARTMENT,COMMERCIAL,0,16000,16000,0,102713,118713
141545601500000,CONVERSION,COMMERCIAL,0,13365,13365,0,95896,109261
141545601600000,CONVERSION,COMMERCIAL,0,10935,10935,0,62145,73080
141545601700000,NE 155,RESIDENTIAL,18400,0,18400,50270,0,68670
141545601800000,NE 155,RESIDENTIAL,12400,0,12400,63616,0,76016
141545601900000,NE 155,RESIDENTIAL,14040,0,14040,52219,0,66259
141545602000000,NE 155,RESIDENTIAL,16720,0,16720,33064,0,49784
141545602100000,NE 155,RESIDENTIAL,26400,0,26400,56467,0,82867
141545602200000,NE 155,RESIDENTIAL,22440,0,22440,56906,0,79346
141545602300000,CONVERSION,COMMERCIAL,0,9720,9720,0,68669,78389
141545602400000,APARTMENT,COMMERCIAL,0,36000,36000,0,221920,257920
141545602500000,APARTMENT,COMMERCIAL,0,34000,34000,0,288728,322728
141545602700000,APARTMENT,COMMERCIAL,0,16500,16500,0,132475,148975
141545603100000,APARTMENT,COMMERCIAL,0,26200,26200,0,163708,189908
141545603200000,NE 155,RESIDENTIAL,25500,0,25500,76154,0,101654
141545603300000,NE 155,RESIDENTIAL,26010,0,26010,90202,0,116212
141545603400000,NE 155,RESIDENTIAL,25500,0,25500,84658,0,110158
141545603500000,OFFICE,COMMERCIAL,0,242250,242250,0,151012,393262
141545603600000,FLAT PARKING,COMMERCIAL,0,113700,113700,0,23142,136842
141545603700000,FUNERAL HOME,COMMERCIAL,0,227400,227400,0,197016,424416
141545603800000,APARTMENT,COMMERCIAL,0,60640,60640,0,406956,467596
141545603900000,BRANCH BANK/CU,COMMERCIAL,0,564000,564000,0,2489747,3053747
141545604000000,NE 155,RESIDENTIAL,6600,0,6600,76271,0,82871
141545604100000,NE 155,RESIDENTIAL,7700,0,7700,62890,0,70590
141545604200000,NE 155,RESIDENTIAL,7700,0,7700,78545,0,86245
141545604300000,NE 155,RESIDENTIAL,8800,0,8800,74080,0,82880
141545700100000,SE 215,RESIDENTIAL,20700,0,20700,64324,0,85024
141545700200000,SE 215,RESIDENTIAL,17345,0,17345,83769,0,101114
141545700300000,CONVERSION,EXEMPT,0,40327,40327,0,61257,101584
141545700400000,OFFICE; MEDICAL,COMMERCIAL,0,312000,312000,0,650589,962589
141545700500000,SE 218,RESIDENTIAL,66000,0,66000,115659,0,181659
141545700600000,SE 215,RESIDENTIAL,18900,0,18900,93316,0,112216
141545700700000,SE 215,RESIDENTIAL,18900,0,18900,84994,0,103894
141545800100000,SE 218,RESIDENTIAL,24900,0,24900,29111,0,54011
141545800200000,SE 218,RESIDENTIAL,16200,0,16200,20925,0,37125
141545800300000,OFFICE,COMMERCIAL,0,133000,133000,0,83455,216455
141545800400000,OFFICE,COMMERCIAL,0,192850,192850,0,385224,578074
141545800700000,SE 218,RESIDENTIAL,30000,0,30000,68294,0,98294
141547600100000,SE 218,RESIDENTIAL,61640,0,61640,101250,0,162890
141547600200000,SE 218,RESIDENTIAL,172497,0,172497,0,0,172497
141547600400000,OFFICE,COMMERCIAL,0,327000,327000,0,2070742,2397742
141547600500000,OFFICE; MEDICAL,COMMERCIAL,0,384000,384000,0,791485,1175485
141547600600000,OFFICE; MEDICAL,COMMERCIAL,0,65072,65072,0,164648,229720
141547600700000,FLAT PARKING,COMMERCIAL,0,79478,79478,0,5985,85463
141547600800000,SE 215,RESIDENTIAL,18094,0,18094,117265,0,135359
141547600900000,SE 215,RESIDENTIAL,16200,0,16200,91178,0,107378
141547601000000,SE 215,RESIDENTIAL,16200,0,16200,89705,0,105905
141547601100000,SE 215,RESIDENTIAL,12600,0,12600,79515,0,92115
141547601200000,SE 215,RESIDENTIAL,14400,0,14400,79227,0,93627
141547601300000,SE 215,RESIDENTIAL,12600,0,12600,94499,0,107099
141547601400000,SE 215,RESIDENTIAL,15300,0,15300,104601,0,119901
141547700100000,OFFICE,COMMERCIAL,0,107800,107800,0,283427,391227
141547800100000,NE 154,RESIDENTIAL,25300,0,25300,89070,0,114370
141547800200000,NE 154,RESIDENTIAL,22440,0,22440,134210,0,156650
141547800300000,NE 154,RESIDENTIAL,22440,0,22440,95263,0,117703
141547800400000,NE 154,RESIDENTIAL,17600,0,17600,97510,0,115110
141547800500000,NE 154,RESIDENTIAL,22440,0,22440,96748,0,119188
141547800600000,OFFICE,COMMERCIAL,0,220500,220500,0,289314,509814
141547800700000,OFFICE,COMMERCIAL,0,184200,184200,0,303110,487310
141547800800000,NE 154,RESIDENTIAL,24651,0,24651,66353,0,91004
141547800900000,OFFICE; MEDICAL,COMMERCIAL,0,530700,530700,0,1281776,1812476
141547801000000,NE 154,RESIDENTIAL,25300,0,25300,91928,0,117228
141547900100000,NE 154,RESIDENTIAL,20925,0,20925,70666,0,91591
141547900200000,NE 154,RESIDENTIAL,21375,0,21375,112407,0,133782
141548000100000,SE 218,RESIDENTIAL,119250,0,119250,277943,0,397193
141548000200000,LITERARY/LIBRARY/ART,EXEMPT,0,1420200,1420200,0,1389667,2809867
141548000300000,SE 215,RESIDENTIAL,14400,0,14400,107604,0,122004
141548000400000,SE 215,RESIDENTIAL,14400,0,14400,68749,0,83149
141548000500000,SE 215,RESIDENTIAL,14148,0,14148,79815,0,93963
141548000600000,SE 215,RESIDENTIAL,14400,0,14400,92499,0,106899
141548000700000,SE 215,RESIDENTIAL,14400,0,14400,68749,0,83149
141548000800000,SE 215,RESIDENTIAL,14400,0,14400,79396,0,93796
141548000900000,SE 215,RESIDENTIAL,15390,0,15390,82747,0,98137
141548001000000,SE 215,RESIDENTIAL,18600,0,18600,101334,0,119934
141548001100000,SE 218,RESIDENTIAL,99150,0,99150,309603,0,408753
141548001200000,SE 218,EXEMPT,0,72000,72000,0,141666,213666
141548100100000,SE 215,RESIDENTIAL,19872,0,19872,88123,0,107995
141548100200000,SE 215,RESIDENTIAL,15225,0,15225,85297,0,100522
141548100300000,SE 215,RESIDENTIAL,16920,0,16920,92913,0,109833
141548100400000,SE 215,RESIDENTIAL,17100,0,17100,84096,0,101196
141548100500000,SE 215,RESIDENTIAL,17462,0,17462,92376,0,109838
141548100600000,SE 215,RESIDENTIAL,17462,0,17462,107765,0,125227
141548100700000,SE 215,RESIDENTIAL,19958,0,19958,103462,0,123420
141548200100000,SE 218,RESIDENTIAL,101005,0,101005,141045,0,242050
141548200200000,SE 218,RESIDENTIAL,51666,0,51666,258669,0,310335
141548200300000,SE 218,RESIDENTIAL,49869,0,49869,150542,0,200411
141548200400000,SE 215,RESIDENTIAL,18251,0,18251,103506,0,121757
141548200500000,SE 215,RESIDENTIAL,17779,0,17779,103631,0,121410
141548200600000,SE 218,RESIDENTIAL,46176,0,46176,130288,0,176464
141548200700000,SE 218,RESIDENTIAL,81744,0,81744,120451,0,202195
141610100100000,CHURCH,EXEMPT,0,31565,31565,0,114473,146038
141610100200000,NE 145,RESIDENTIAL,30233,0,30233,118721,0,148954
141610100300000,NE 145,RESIDENTIAL,30523,0,30523,90857,0,121380
141610100400000,NE 145,RESIDENTIAL,30528,0,30528,78885,0,109413
141610100500000,NE 145,RESIDENTIAL,31376,0,31376,95827,0,127203
141610100600000,NE 145,RESIDENTIAL,36653,0,36653,52183,0,88836
141610100700000,NE 145,RESIDENTIAL,25250,0,25250,62796,0,88046
141610100800000,NE 145,RESIDENTIAL,25250,0,25250,90454,0,115704
141610100900000,NE 145,RESIDENTIAL,25250,0,25250,87092,0,112342
141610101000000,NE 145,RESIDENTIAL,25250,0,25250,84308,0,109558
141610101100000,NE 145,RESIDENTIAL,25250,0,25250,78298,0,103548
141610101200000,NE 145,RESIDENTIAL,25250,0,25250,48343,0,73593
141610101300000,NE 145,RESIDENTIAL,25688,0,25688,61496,0,87184
141610200200000,NE 145,RESIDENTIAL,18540,0,18540,72478,0,91018
141610200300000,NE 145,RESIDENTIAL,18540,0,18540,98419,0,116959
141610200400000,NE 145,RESIDENTIAL,18466,0,18466,81031,0,99497
141610200500000,NE 145,RESIDENTIAL,18540,0,18540,50940,0,69480
141610200600000,NE 145,RESIDENTIAL,18540,0,18540,60567,0,79107
141610200700000,NE 145,RESIDENTIAL,31360,0,31360,72004,0,103364
141610200800000,NE 145,RESIDENTIAL,31360,0,31360,57528,0,88888
141610200900000,NE 145,RESIDENTIAL,33792,0,33792,104452,0,138244
141610201000000,NE 145,RESIDENTIAL,28979,0,28979,83021,0,112000
141610201100000,NE 145,RESIDENTIAL,29767,0,29767,46618,0,76385
141610201200000,NE 145,RESIDENTIAL,31765,0,31765,102455,0,134220
141610201300000,NE 145,RESIDENTIAL,25440,0,25440,112986,0,138426
141610201400000,NE 145,RESIDENTIAL,19953,0,19953,53615,0,73568
141610201500000,NE 145,RESIDENTIAL,19861,0,19861,93265,0,113126
141610201600000,NE 145,RESIDENTIAL,19861,0,19861,84065,0,103926
141610201700000,NE 145,RESIDENTIAL,24625,0,24625,99699,0,124324
141610201800000,NE 145,RESIDENTIAL,25179,0,25179,139487,0,164666
141610201900000,NE 145,RESIDENTIAL,23520,0,23520,95530,0,119050
141610202000000,NE 145,RESIDENTIAL,23520,0,23520,82389,0,105909
141610202100000,NE 145,RESIDENTIAL,35282,0,35282,99257,0,134539
141610202200000,NE 145,RESIDENTIAL,24970,0,24970,71830,0,96800
141610202300000,NE 145,RESIDENTIAL,29120,0,29120,0,0,29120
141610300100000,NE 145,RESIDENTIAL,18540,0,18540,43979,0,62519
141610300200000,NE 145,RESIDENTIAL,18540,0,18540,56421,0,74961
141610300300000,NE 145,RESIDENTIAL,18540,0,18540,84833,0,103373
141610300400000,NE 145,RESIDENTIAL,18540,0,18540,72545,0,91085
141610300500000,NE 145,RESIDENTIAL,18911,0,18911,54330,0,73241
141610300600000,NE 145,RESIDENTIAL,15660,0,15660,45117,0,60777
141610300700000,NE 145,RESIDENTIAL,15400,0,15400,52287,0,67687
141610300800000,NE 145,RESIDENTIAL,19968,0,19968,73011,0,92979
141610300900000,NE 145,RESIDENTIAL,20384,0,20384,74003,0,94387
141610301000000,NE 145,RESIDENTIAL,52555,0,52555,95016,0,147571
141610301100000,NE 145,RESIDENTIAL,28560,0,28560,100011,0,128571
141610301200000,NE 145,RESIDENTIAL,32256,0,32256,86306,0,118562
141610301300000,NE 145,RESIDENTIAL,30720,0,30720,80083,0,110803
141610301400000,NE 145,RESIDENTIAL,30720,0,30720,106273,0,136993
141610301500000,NE 145,RESIDENTIAL,32890,0,32890,114621,0,147511
141610301600000,NE 145,RESIDENTIAL,24480,0,24480,101777,0,126257
141610301700000,NE 145,RESIDENTIAL,24480,0,24480,89621,0,114101
141610301800000,NE 145,RESIDENTIAL,24480,0,24480,70068,0,94548
141610301900000,NE 145,RESIDENTIAL,20400,0,20400,75810,0,96210
141610302000000,NE 145,RESIDENTIAL,25039,0,25039,97562,0,122601
141610302100000,NE 145,RESIDENTIAL,26052,0,26052,89479,0,115531
141610302200000,NE 145,RESIDENTIAL,25920,0,25920,84474,0,110394
141610302300000,NE 145,RESIDENTIAL,22540,0,22540,84131,0,106671
141610302400000,NE 145,RESIDENTIAL,21149,0,21149,87254,0,108403
141610302600000,NE 145,RESIDENTIAL,30184,0,30184,132019,0,162203
141610303100000,NE 145,RESIDENTIAL,24000,0,24000,75603,0,99603
141610400100000,NE 145,RESIDENTIAL,26024,0,26024,79968,0,105992
141610400200000,NE 145,RESIDENTIAL,25250,0,25250,92793,0,118043
141610400300000,NE 145,RESIDENTIAL,25250,0,25250,50281,0,75531
141610400400000,NE 145,RESIDENTIAL,25250,0,25250,92922,0,118172
141610400500000,NE 145,RESIDENTIAL,25250,0,25250,108001,0,133251
141610400600000,NE 145,RESIDENTIAL,25250,0,25250,82087,0,107337
141610400700000,NE 145,RESIDENTIAL,25250,0,25250,84095,0,109345
141610400800000,NE 145,RESIDENTIAL,25250,0,25250,78079,0,103329
141610400900000,NE 145,RESIDENTIAL,33974,0,33974,75012,0,108986
141610401000000,NE 145,RESIDENTIAL,27840,0,27840,75771,0,103611
141610401100000,APARTMENT,COMMERCIAL,0,22500,22500,0,273407,295907
141610401200000,NE 145,RESIDENTIAL,27376,0,27376,93800,0,121176
141610401300000,NE 145,RESIDENTIAL,31821,0,31821,86391,0,118212
141610401400000,NE 145,RESIDENTIAL,23460,0,23460,95119,0,118579
141610401500000,NE 145,RESIDENTIAL,23460,0,23460,72408,0,95868
141610401600000,NE 145,RESIDENTIAL,17800,0,17800,87193,0,104993
141610401700000,APARTMENT,COMMERCIAL,0,390400,390400,0,1854784,2245184
141610500100000,NE 145,RESIDENTIAL,33207,0,33207,78220,0,111427
141610500200000,NE 145,RESIDENTIAL,35316,0,35316,62590,0,97906
141610500600000,NE 145,RESIDENTIAL,23450,0,23450,60364,0,83814
141610500700000,APARTMENT,RESIDENTIAL,30820,0,30820,253528,0,284348
141610500800000,APARTMENT,RESIDENTIAL,30820,0,30820,278369,0,309189
141610600100000,NE 145,RESIDENTIAL,25075,0,25075,114132,0,139207
141610600200000,NE 145,RESIDENTIAL,22447,0,22447,103717,0,126164
141610600300000,NE 145,RESIDENTIAL,19600,0,19600,90029,0,109629
141610600400000,NE 145,RESIDENTIAL,19600,0,19600,72580,0,92180
141610600500000,NE 145,RESIDENTIAL,19600,0,19600,84220,0,103820
141610600600000,NE 145,RESIDENTIAL,24960,0,24960,97097,0,122057
141610600700000,NE 145,RESIDENTIAL,26400,0,26400,50410,0,76810
141610600800000,NE 145,RESIDENTIAL,30940,0,30940,94662,0,125602
141610600900000,NE 145,RESIDENTIAL,28829,0,28829,87157,0,115986
141610601100000,NE 145,RESIDENTIAL,42669,0,42669,71376,0,114045
141610601200000,NE 145,RESIDENTIAL,24720,0,24720,71746,0,96466
141610601300000,NE 145,RESIDENTIAL,23520,0,23520,71716,0,95236
141610601400000,NE 145,RESIDENTIAL,23520,0,23520,85547,0,109067
141610700100000,NE 145,RESIDENTIAL,22176,0,22176,85888,0,108064
141610700200000,NE 145,RESIDENTIAL,18432,0,18432,79925,0,98357
141610700300000,NE 145,RESIDENTIAL,17040,0,17040,85844,0,102884
141610700400000,NE 145,RESIDENTIAL,24304,0,24304,76897,0,101201
141610700500000,NE 145,RESIDENTIAL,21948,0,21948,95211,0,117159
141610700600000,NE 145,RESIDENTIAL,28570,0,28570,51288,0,79858
141610700700000,APARTMENT,COMMERCIAL,0,108000,108000,0,512000,620000
141610700800000,NE 145,RESIDENTIAL,22120,0,22120,88921,0,111041
141610700900000,NE 145,RESIDENTIAL,22120,0,22120,89012,0,111132
141610701000000,NE 145,RESIDENTIAL,23700,0,23700,98891,0,122591
141610701100000,NE 145,RESIDENTIAL,19800,0,19800,79426,0,99226
141612600100000,AUTO REPAIR/SALES,COMMERCIAL,0,79008,79008,0,53950,132958
141612600200000,OFFICE,COMMERCIAL,0,187800,187800,0,371490,559290
141612600300000,DAY CARE CENTER,COMMERCIAL,0,98143,98143,0,102887,201030
141612600400000,NE 146,RESIDENTIAL,30721,0,30721,109494,0,140215
141612600900000,NE 146,RESIDENTIAL,29575,0,29575,131251,0,160826
141612601100000,OFFICE; MEDICAL,COMMERCIAL,0,141325,141325,0,217237,358562
141612601200000,NE 146,RESIDENTIAL,25097,0,25097,54149,0,79246
141612601300000,NE 146,RESIDENTIAL,25947,0,25947,47807,0,73754
141612601400000,APARTMENT,RESIDENTIAL,15682,0,15682,133997,0,149679
141612601700000,NE 146,RESIDENTIAL,11655,0,11655,26457,0,38112
141612601800000,APARTMENT,RESIDENTIAL,72000,0,72000,668154,0,740154
141612601900000,SMALL RETAIL,COMMERCIAL,0,26000,26000,0,82751,108751
141612602000000,WAREHOUSE,COMMERCIAL,0,28000,28000,0,72097,100097
141612602100000,APARTMENT,RESIDENTIAL,16552,0,16552,141319,0,157871
141612602200000,APARTMENT,RESIDENTIAL,15682,0,15682,144269,0,159951
141612700100000,NE 147,RESIDENTIAL,31226,0,31226,149772,0,180998
141612700200000,NE 147,RESIDENTIAL,30202,0,30202,143558,0,173760
141612700300000,NE 147,RESIDENTIAL,31266,0,31266,124133,0,155399
141612700400000,NE 147,RESIDENTIAL,31266,0,31266,132358,0,163624
141612700500000,NE 147,RESIDENTIAL,31266,0,31266,129337,0,160603
141612700600000,NE 147,RESIDENTIAL,31824,0,31824,162541,0,194365
141612800100000,APARTMENT,RESIDENTIAL,27094,0,27094,99863,0,126957
141612800200000,NE 146,RESIDENTIAL,36325,0,36325,0,0,36325
141612800300000,NE 146,RESIDENTIAL,24043,0,24043,0,0,24043
141612800400000,NE 146,RESIDENTIAL,25394,0,25394,0,0,25394
141615100100000,NE 146,RESIDENTIAL,22575,0,22575,0,0,22575
141615100200000,NE 146,RESIDENTIAL,22575,0,22575,0,0,22575
141615100300000,VACANT LAND,COMMERCIAL,0,115750,115750,0,0,115750
141615100400000,NE 146,RESIDENTIAL,22797,0,22797,69459,0,92256
141615100600000,OFFICE; MEDICAL,COMMERCIAL,0,94100,94100,0,277308,371408
141615100800000,NE 146,RESIDENTIAL,30807,0,30807,103271,0,134078
141615100900000,NE 146,RESIDENTIAL,27718,0,27718,66849,0,94567
141615200100000,CITY PROPERTY,EXEMPT,0,0,0,0,0,0
141615300100000,NE 146,RESIDENTIAL,16091,0,16091,55108,0,71199
141615300200000,NE 146,RESIDENTIAL,14000,0,14000,31970,0,45970
141615300300000,NE 146,RESIDENTIAL,14000,0,14000,73873,0,87873
141615300400000,NE 146,RESIDENTIAL,14000,0,14000,70179,0,84179
141615300500000,NE 146,RESIDENTIAL,25200,0,25200,55211,0,80411
141615300600000,NE 146,RESIDENTIAL,13194,0,13194,76985,0,90179
141615300700000,NE 146,RESIDENTIAL,14730,0,14730,62264,0,76994
141615300800000,NE 146,RESIDENTIAL,14000,0,14000,65361,0,79361
141615300900000,NE 146,RESIDENTIAL,14000,0,14000,90017,0,104017
141615301000000,NE 146,RESIDENTIAL,14000,0,14000,82472,0,96472
141615301100000,NE 146,RESIDENTIAL,14000,0,14000,44909,0,58909
141615301200000,NE 146,RESIDENTIAL,14000,0,14000,54599,0,68599
141615301300000,NE 146,RESIDENTIAL,14000,0,14000,35444,0,49444
141615301400000,NE 146,RESIDENTIAL,14000,0,14000,62789,0,76789
141615301500000,NE 146,RESIDENTIAL,14000,0,14000,63781,0,77781
141615301600000,NE 146,RESIDENTIAL,11550,0,11550,44400,0,55950
141615301700000,NE 146,RESIDENTIAL,13183,0,13183,32979,0,46162
141615301800000,NE 146,RESIDENTIAL,20344,0,20344,45677,0,66021
141615301900000,OFFICE,COMMERCIAL,0,25200,25200,0,70513,95713
141615302000000,SMALL RETAIL,COMMERCIAL,0,22400,22400,0,59325,81725
141615302100000,WAREHOUSE,COMMERCIAL,0,22400,22400,0,31438,53838
141615302200000,NE 146,RESIDENTIAL,14000,0,14000,56540,0,70540
141615302300000,NE 146,RESIDENTIAL,11550,0,11550,55598,0,67148
141615302400000,NE 146,RESIDENTIAL,11900,0,11900,55738,0,67638
141615302500000,NE 146,RESIDENTIAL,11550,0,11550,40564,0,52114
141615302600000,NE 146,RESIDENTIAL,21000,0,21000,85642,0,106642
141615302700000,NE 146,RESIDENTIAL,14000,0,14000,53820,0,67820
141615500200000,NE 146,RESIDENTIAL,21350,0,21350,46627,0,67977
141615500300000,NE 146,RESIDENTIAL,26418,0,26418,36636,0,63054
141615500400000,NE 146,RESIDENTIAL,18648,0,18648,49332,0,67980
141615500500000,NE 146,RESIDENTIAL,15540,0,15540,62484,0,78024
141615500600000,NE 146,RESIDENTIAL,15680,0,15680,31235,0,46915
141615500700000,NE 146,RESIDENTIAL,18816,0,18816,85435,0,104251
141615500800000,NE 146,RESIDENTIAL,18984,0,18984,61579,0,80563
141615500900000,NE 146,RESIDENTIAL,6331,0,6331,0,0,6331
141615501000000,NE 146,RESIDENTIAL,12565,0,12565,47781,0,60346
141615501100000,NE 146,RESIDENTIAL,14700,0,14700,76700,0,91400
141615501200000,NE 146,RESIDENTIAL,23839,0,23839,56969,0,80808
141615501300000,NE 146,RESIDENTIAL,16408,0,16408,0,0,16408
141615501400000,NE 146,RESIDENTIAL,21209,0,21209,0,0,21209
141617600100000,NE 145,RESIDENTIAL,34362,0,34362,54673,0,89035
141617600200000,VACANT LAND,COMMERCIAL,0,20,20,0,0,20
141617600300000,NE 145,RESIDENTIAL,34720,0,34720,56399,0,91119
141617600400000,APARTMENT,COMMERCIAL,0,400000,400000,0,2320341,2720341
141617600500000,NE 145,RESIDENTIAL,29265,0,29265,50573,0,79838
141617600600000,NE 145,RESIDENTIAL,5105,0,5105,71794,0,76899
141617600800000,NE 145,RESIDENTIAL,22000,0,22000,80600,0,102600
141617600900000,NE 145,RESIDENTIAL,22000,0,22000,85010,0,107010
141617601000000,NE 145,RESIDENTIAL,22000,0,22000,64154,0,86154
141617601200000,NE 145,RESIDENTIAL,24480,0,24480,84846,0,109326
141617601300000,NE 145,RESIDENTIAL,24480,0,24480,63911,0,88391
141617601400000,NE 145,RESIDENTIAL,32640,0,32640,80646,0,113286
141617601500000,APARTMENT,COMMERCIAL,0,63360,63360,0,615644,679004
141617601600000,NE 145,RESIDENTIAL,25320,0,25320,80741,0,106061
141617601700000,NE 145,RESIDENTIAL,29760,0,29760,106172,0,135932
141617601800000,CONVERSION,COMMERCIAL,0,14885,14885,0,74965,89850
141617601900000,NE 145,RESIDENTIAL,24065,0,24065,104370,0,128435
141617602000000,NE 145,RESIDENTIAL,24813,0,24813,89353,0,114166
141617602100000,COUNTY PROPERTY,EXEMPT,0,0,0,0,0,0
141617602200000,SCHOOL,EXEMPT,0,0,0,0,0,0
141617700100000,NE 145,RESIDENTIAL,23460,0,23460,101790,0,125250
141617700200000,NE 145,RESIDENTIAL,33685,0,33685,105964,0,139649
141617700300000,NE 145,RESIDENTIAL,19002,0,19002,88493,0,107495
141617700400000,CONVERSION,COMMERCIAL,0,16211,16211,0,62908,79119
141617700500000,NE 145,RESIDENTIAL,25536,0,25536,70378,0,95914
141617800100000,NE 145,RESIDENTIAL,21334,0,21334,58221,0,79555
141617800200000,NE 145,RESIDENTIAL,15246,0,15246,51992,0,67238
141617800300000,NE 145,RESIDENTIAL,16112,0,16112,77227,0,93339
141617800400000,NE 145,RESIDENTIAL,14380,0,14380,52179,0,66559
141617800500000,NE 145,RESIDENTIAL,15246,0,15246,46675,0,61921
141617800600000,NE 145,RESIDENTIAL,15246,0,15246,98429,0,113675
141617800700000,NE 145,RESIDENTIAL,18043,0,18043,64154,0,82197
141617900100000,NE 145,RESIDENTIAL,23760,0,23760,81932,0,105692
141617900300000,NE 145,RESIDENTIAL,18176,0,18176,71395,0,89571
141617900400000,APARTMENT,RESIDENTIAL,47840,0,47840,423052,0,470892
141617900500000,APARTMENT,RESIDENTIAL,44499,0,44499,75001,0,119500
141617900600000,NE 145,RESIDENTIAL,27216,0,27216,77675,0,104891
141617900700000,APARTMENT,RESIDENTIAL,52400,0,52400,534171,0,586571
141618000100000,NE 145,RESIDENTIAL,16719,0,16719,60401,0,77120
141618000200000,NE 145,RESIDENTIAL,15554,0,15554,72845,0,88399
141618000300000,NE 145,RESIDENTIAL,15554,0,15554,68441,0,83995
141618000400000,NE 145,RESIDENTIAL,15554,0,15554,52886,0,68440
141618000500000,NE 145,RESIDENTIAL,15554,0,15554,58751,0,74305
141618000600000,NE 145,RESIDENTIAL,15554,0,15554,31089,0,46643
141618000700000,NE 145,RESIDENTIAL,21437,0,21437,117286,0,138723
141618000800000,NE 145,RESIDENTIAL,19264,0,19264,65892,0,85156
141618000900000,NE 145,RESIDENTIAL,22097,0,22097,78966,0,101063
141618001000000,NE 145,RESIDENTIAL,15554,0,15554,53432,0,68986
141618001100000,NE 145,RESIDENTIAL,15554,0,15554,51458,0,67012
141618001200000,NE 145,RESIDENTIAL,15554,0,15554,43636,0,59190
141618001300000,NE 145,RESIDENTIAL,15554,0,15554,44580,0,60134
141618001400000,NE 145,RESIDENTIAL,15554,0,15554,57062,0,72616
141618001500000,NE 145,RESIDENTIAL,14777,0,14777,57164,0,71941
141618100100000,NE 145,RESIDENTIAL,27242,0,27242,73735,0,100977
141618100200000,APARTMENT,COMMERCIAL,0,114400,114400,0,1258175,1372575
141618100300000,NE 145,RESIDENTIAL,25498,0,25498,91344,0,116842
141618100400000,NE 145,RESIDENTIAL,31320,0,31320,83804,0,115124
141618100500000,NE 145,RESIDENTIAL,21600,0,21600,82566,0,104166
141618200100000,NE 145,RESIDENTIAL,15986,0,15986,63417,0,79403
141618200200000,NE 145,RESIDENTIAL,15554,0,15554,49083,0,64637
141618200300000,NE 145,RESIDENTIAL,15554,0,15554,72492,0,88046
141618200400000,NE 145,RESIDENTIAL,15554,0,15554,80507,0,96061
141618200500000,NE 145,RESIDENTIAL,15554,0,15554,53618,0,69172
141618200600000,NE 145,RESIDENTIAL,15554,0,15554,43856,0,59410
141618200700000,NE 145,RESIDENTIAL,15554,0,15554,48462,0,64016
141618200800000,NE 145,RESIDENTIAL,16909,0,16909,54743,0,71652
141618200900000,NE 145,RESIDENTIAL,19981,0,19981,47624,0,67605
141618201000000,NE 145,RESIDENTIAL,14014,0,14014,59608,0,73622
141618201100000,NE 145,RESIDENTIAL,15554,0,15554,50591,0,66145
141618201200000,NE 145,RESIDENTIAL,15554,0,15554,64960,0,80514
141618201300000,NE 145,RESIDENTIAL,15554,0,15554,62654,0,78208
141618201400000,NE 145,RESIDENTIAL,15554,0,15554,60966,0,76520
141618201500000,NE 145,RESIDENTIAL,10888,0,10888,65931,0,76819
141618201600000,NE 145,RESIDENTIAL,9829,0,9829,0,0,9829
141618300100000,NE 145,RESIDENTIAL,26006,0,26006,94119,0,120125
141618300200000,NE 145,RESIDENTIAL,18403,0,18403,39168,0,57571
141618300300000,NE 145,RESIDENTIAL,34248,0,34248,75891,0,110139
141618300400000,NE 145,RESIDENTIAL,30000,0,30000,66754,0,96754
141618300500000,NE 145,RESIDENTIAL,27667,0,27667,95113,0,122780
141618300600000,NE 145,RESIDENTIAL,27076,0,27076,78826,0,105902
141618300700000,NE 145,RESIDENTIAL,26482,0,26482,86327,0,112809
141618300800000,NE 145,RESIDENTIAL,22289,0,22289,102983,0,125272
141618300900000,NE 145,RESIDENTIAL,20976,0,20976,88840,0,109816
141618301000000,NE 145,RESIDENTIAL,20976,0,20976,59151,0,80127
141618301100000,NE 145,RESIDENTIAL,20976,0,20976,100335,0,121311
141618301200000,CHURCH,EXEMPT,0,16686,16686,0,67975,84661
141618301300000,NE 145,RESIDENTIAL,23112,0,23112,123614,0,146726
141618301400000,NE 145,RESIDENTIAL,23654,0,23654,70103,0,93757
141618301500000,NE 145,RESIDENTIAL,22464,0,22464,77665,0,100129
141618400100000,NE 145,RESIDENTIAL,15262,0,15262,60831,0,76093
141618400200000,NE 145,RESIDENTIAL,15554,0,15554,38334,0,53888
141618400300000,NE 145,RESIDENTIAL,15554,0,15554,78284,0,93838
141618400400000,NE 145,RESIDENTIAL,15554,0,15554,91787,0,107341
141618400500000,NE 145,RESIDENTIAL,15554,0,15554,79268,0,94822
141618400600000,NE 145,RESIDENTIAL,15554,0,15554,31640,0,47194
141618400700000,NE 145,RESIDENTIAL,15554,0,15554,38883,0,54437
141618400800000,NE 145,RESIDENTIAL,13636,0,13636,52730,0,66366
141618400900000,NE 145,RESIDENTIAL,11440,0,11440,40433,0,51873
141618401200000,OFFICE,COMMERCIAL,0,66663,66663,0,131959,198622
141618401300000,AUTO REPAIR/SALES,COMMERCIAL,0,26010,26010,0,37793,63803
141618401400000,NE 145,RESIDENTIAL,20532,0,20532,77938,0,98470
141618401500000,NE 145,RESIDENTIAL,10025,0,10025,0,0,10025
141618401600000,NE 145,RESIDENTIAL,20281,0,20281,93348,0,113629
141618401700000,NE 145,RESIDENTIAL,20720,0,20720,55846,0,76566
141618401800000,NE 145,RESIDENTIAL,20655,0,20655,44466,0,65121
141618401900000,NE 145,RESIDENTIAL,20976,0,20976,70007,0,90983
141620100100000,NE 147,RESIDENTIAL,28248,0,28248,90907,0,119155
141620100200000,NE 147,RESIDENTIAL,28928,0,28928,75045,0,103973
141620100300000,NE 147,RESIDENTIAL,28928,0,28928,122824,0,151752
141620100400000,NE 147,RESIDENTIAL,28928,0,28928,123053,0,151981
141620100500000,NE 147,RESIDENTIAL,28928,0,28928,85744,0,114672
141620100600000,NE 147,RESIDENTIAL,28928,0,28928,100777,0,129705
141620100700000,NE 147,RESIDENTIAL,29024,0,29024,112133,0,141157
141620100800000,NE 147,RESIDENTIAL,29920,0,29920,86519,0,116439
141620100900000,NE 147,RESIDENTIAL,29232,0,29232,136643,0,165875
141620101000000,NE 147,RESIDENTIAL,31559,0,31559,156594,0,188153
141620101100000,NE 147,RESIDENTIAL,39312,0,39312,118934,0,158246
141620101200000,APARTMENT,COMMERCIAL,0,24259,24259,0,135741,160000
141620200100000,NE 147,RESIDENTIAL,27259,0,27259,127417,0,154676
141620200200000,NE 147,RESIDENTIAL,18432,0,18432,104520,0,122952
141620200300000,NE 147,RESIDENTIAL,20544,0,20544,100968,0,121512
141620200400000,NE 147,RESIDENTIAL,19968,0,19968,114679,0,134647
141620200500000,NE 147,RESIDENTIAL,19008,0,19008,86959,0,105967
141620200600000,NE 147,RESIDENTIAL,18432,0,18432,94151,0,112583
141620200700000,NE 147,RESIDENTIAL,20116,0,20116,112172,0,132288
141620200800000,NE 147,RESIDENTIAL,8602,0,8602,0,0,8602
141620200900000,NE 147,RESIDENTIAL,32413,0,32413,89720,0,122133
141620201000000,NE 147,RESIDENTIAL,27783,0,27783,81693,0,109476
141620201100000,NE 147,RESIDENTIAL,27783,0,27783,90917,0,118700
141620201200000,NE 147,RESIDENTIAL,27783,0,27783,80757,0,108540
141620201300000,NE 147,RESIDENTIAL,27783,0,27783,96959,0,124742
141620201400000,NE 147,RESIDENTIAL,27783,0,27783,79304,0,107087
141620201500000,NE 147,RESIDENTIAL,27783,0,27783,87745,0,115528
141620201600000,NE 147,RESIDENTIAL,28067,0,28067,98863,0,126930
141620201700000,NE 147,RESIDENTIAL,28917,0,28917,87789,0,116706
141620201800000,NE 147,RESIDENTIAL,28776,0,28776,90499,0,119275
141620201900000,NE 147,RESIDENTIAL,32301,0,32301,128691,0,160992
141620202000000,NE 147,RESIDENTIAL,30495,0,30495,114950,0,145445
141620202100000,NE 147,RESIDENTIAL,32781,0,32781,107106,0,139887
141620202200000,NE 147,RESIDENTIAL,31930,0,31930,116742,0,148672
141620202300000,NE 147,RESIDENTIAL,31200,0,31200,92492,0,123692
141620202400000,NE 147,RESIDENTIAL,30282,0,30282,103849,0,134131
141620202500000,NE 147,RESIDENTIAL,30991,0,30991,108709,0,139700
141620202600000,NE 147,RESIDENTIAL,31680,0,31680,98059,0,129739
141620202700000,NE 147,RESIDENTIAL,31680,0,31680,98622,0,130302
141620202800000,NE 147,RESIDENTIAL,31719,0,31719,124232,0,155951
141620202900000,NE 147,RESIDENTIAL,33430,0,33430,92528,0,125958
141620203000000,NE 147,RESIDENTIAL,34627,0,34627,102856,0,137483
141620203100000,NE 147,RESIDENTIAL,32752,0,32752,118647,0,151399
141620203200000,NE 147,RESIDENTIAL,33060,0,33060,120508,0,153568
141620203300000,NE 147,RESIDENTIAL,31741,0,31741,99105,0,130846
141620203400000,NE 147,RESIDENTIAL,32566,0,32566,84616,0,117182
141620203500000,NE 147,RESIDENTIAL,28841,0,28841,88972,0,117813
141620203600000,NE 147,RESIDENTIAL,24056,0,24056,106596,0,130652
141620203700000,NE 147,RESIDENTIAL,24056,0,24056,86242,0,110298
141620203800000,NE 147,RESIDENTIAL,26720,0,26720,85444,0,112164
141620300100000,SCHOOL,EXEMPT,0,192429,192429,0,637735,830164
141620400100000,NE 147,RESIDENTIAL,26624,0,26624,99335,0,125959
141620400200000,NE 147,RESIDENTIAL,36300,0,36300,100973,0,137273
141620400300000,NE 147,RESIDENTIAL,33705,0,33705,121193,0,154898
141620400400000,NE 147,RESIDENTIAL,35316,0,35316,119466,0,154782
141620400500000,NE 147,RESIDENTIAL,39404,0,39404,129790,0,169194
141620400600000,NE 147,RESIDENTIAL,36873,0,36873,109155,0,146028
141620400700000,NE 147,RESIDENTIAL,37942,0,37942,128680,0,166622
141620400800000,NE 147,RESIDENTIAL,39390,0,39390,102327,0,141717
141620400900000,NE 147,RESIDENTIAL,37872,0,37872,102458,0,140330
141620401000000,NE 147,RESIDENTIAL,35880,0,35880,116479,0,152359
141620401100000,NE 147,RESIDENTIAL,34304,0,34304,108557,0,142861
141620401200000,NE 147,RESIDENTIAL,35788,0,35788,103956,0,139744
141620401300000,NE 147,RESIDENTIAL,39658,0,39658,102737,0,142395
141620401400000,NE 147,RESIDENTIAL,40025,0,40025,112871,0,152896
141620401500000,NE 147,RESIDENTIAL,39220,0,39220,134352,0,173572
141620401600000,NE 147,RESIDENTIAL,39981,0,39981,123463,0,163444
141620401700000,NE 147,RESIDENTIAL,31485,0,31485,120605,0,152090
141620401800000,NE 147,RESIDENTIAL,29488,0,29488,102575,0,132063
141620401900000,NE 147,RESIDENTIAL,33174,0,33174,107969,0,141143
141620500100000,NE 147,RESIDENTIAL,31104,0,31104,114846,0,145950
141620500200000,NE 147,RESIDENTIAL,39867,0,39867,123937,0,163804
141620500300000,NE 147,RESIDENTIAL,40763,0,40763,110350,0,151113
141620500400000,NE 147,RESIDENTIAL,42019,0,42019,111257,0,153276
141620500500000,NE 147,RESIDENTIAL,42942,0,42942,110708,0,153650
141620500600000,NE 147,RESIDENTIAL,40392,0,40392,153968,0,194360
141620500700000,NE 147,RESIDENTIAL,40838,0,40838,101275,0,142113
141620500800000,NE 147,RESIDENTIAL,35445,0,35445,99936,0,135381
141620500900000,NE 147,RESIDENTIAL,40500,0,40500,159782,0,200282
141620501000000,NE 147,RESIDENTIAL,39204,0,39204,136625,0,175829
141620501100000,NE 147,RESIDENTIAL,40014,0,40014,133085,0,173099
141620501200000,NE 147,RESIDENTIAL,35955,0,35955,117928,0,153883
141620501300000,NE 147,RESIDENTIAL,32972,0,32972,110351,0,143323
141620501400000,NE 147,RESIDENTIAL,32634,0,32634,114695,0,147329
141620501500000,NE 147,RESIDENTIAL,36450,0,36450,121217,0,157667
141620501600000,NE 147,RESIDENTIAL,39828,0,39828,114678,0,154506
141620501700000,NE 147,RESIDENTIAL,35789,0,35789,113400,0,149189
141620501800000,NE 147,RESIDENTIAL,21512,0,21512,163720,0,185232
141620501900000,NE 147,RESIDENTIAL,24696,0,24696,7409,0,32105
141620502000000,NE 147,RESIDENTIAL,39690,0,39690,145568,0,185258
141620502100000,NE 147,RESIDENTIAL,37926,0,37926,155153,0,193079
141620502200000,NE 147,RESIDENTIAL,39300,0,39300,173076,0,212376
141620502300000,NE 147,RESIDENTIAL,38862,0,38862,144434,0,183296
141620502400000,NE 147,RESIDENTIAL,41059,0,41059,145575,0,186634
141620502500000,NE 147,RESIDENTIAL,35496,0,35496,140593,0,176089
141620502600000,NE 147,RESIDENTIAL,31815,0,31815,141854,0,173669
141620502700000,NE 147,RESIDENTIAL,34500,0,34500,139104,0,173604
141620502800000,NE 147,RESIDENTIAL,37508,0,37508,133632,0,171140
141620502900000,NE 147,RESIDENTIAL,37026,0,37026,122776,0,159802
141620503000000,NE 147,RESIDENTIAL,33152,0,33152,146761,0,179913
141620503100000,NE 147,RESIDENTIAL,29488,0,29488,129854,0,159342
141620503200000,NE 147,RESIDENTIAL,29488,0,29488,147153,0,176641
141620600100000,NE 147,RESIDENTIAL,30080,0,30080,123552,0,153632
141620600200000,NE 147,RESIDENTIAL,27788,0,27788,125499,0,153287
141620600300000,NE 147,RESIDENTIAL,29520,0,29520,117725,0,147245
141620600400000,NE 147,RESIDENTIAL,29700,0,29700,113689,0,143389
141620600500000,NE 147,RESIDENTIAL,32040,0,32040,144757,0,176797
141620600600000,NE 147,RESIDENTIAL,40767,0,40767,131030,0,171797
141620600700000,NE 147,RESIDENTIAL,34742,0,34742,152541,0,187283
141620600800000,NE 147,RESIDENTIAL,40698,0,40698,167251,0,207949
141620600900000,NE 147,RESIDENTIAL,41409,0,41409,139591,0,181000
141620601000000,NE 147,RESIDENTIAL,40630,0,40630,136434,0,177064
141620601100000,NE 147,RESIDENTIAL,38543,0,38543,130533,0,169076
141620601200000,NE 147,RESIDENTIAL,40644,0,40644,131021,0,171665
141620601300000,NE 148,RESIDENTIAL,40637,0,40637,143651,0,184288
141622600100000,NE 147,RESIDENTIAL,32100,0,32100,127257,0,159357
141622600200000,NE 147,RESIDENTIAL,32400,0,32400,108323,0,140723
141622600300000,NE 147,RESIDENTIAL,32700,0,32700,175502,0,208202
141622600400000,NE 147,RESIDENTIAL,33136,0,33136,141055,0,174191
141622600500000,NE 147,RESIDENTIAL,35992,0,35992,172059,0,208051
141622600600000,NE 147,RESIDENTIAL,31603,0,31603,107766,0,139369
141622600700000,NE 147,RESIDENTIAL,34314,0,34314,129003,0,163317
141622600800000,NE 147,RESIDENTIAL,34238,0,34238,126419,0,160657
141622600900000,NE 147,RESIDENTIAL,29700,0,29700,131749,0,161449
141622601000000,NE 147,RESIDENTIAL,35616,0,35616,121546,0,157162
141622601100000,NE 147,RESIDENTIAL,27913,0,27913,151777,0,179690
141622601200000,NE 147,RESIDENTIAL,30995,0,30995,100777,0,131772
141622601300000,NE 147,RESIDENTIAL,33120,0,33120,154008,0,187128
141622601400000,NE 147,RESIDENTIAL,37890,0,37890,127082,0,164972
141622601500000,NE 147,RESIDENTIAL,52250,0,52250,93860,0,146110
141622601600000,NE 147,RESIDENTIAL,40938,0,40938,162076,0,203014
141622601700000,NE 147,RESIDENTIAL,41992,0,41992,113378,0,155370
141622601800000,NE 147,RESIDENTIAL,48413,0,48413,119896,0,168309
141622601900000,NE 147,RESIDENTIAL,39520,0,39520,227724,0,267244
141622602000000,NE 147,RESIDENTIAL,33427,0,33427,165999,0,199426
141622602100000,NE 147,RESIDENTIAL,30084,0,30084,119908,0,149992
141622602200000,NE 147,RESIDENTIAL,31240,0,31240,173871,0,205111
141622602300000,NE 147,RESIDENTIAL,31497,0,31497,130515,0,162012
141622602400000,NE 147,RESIDENTIAL,30280,0,30280,131388,0,161668
141622602500000,NE 147,RESIDENTIAL,26438,0,26438,104366,0,130804
141622602600000,NE 147,RESIDENTIAL,26977,0,26977,96868,0,123845
141622602700000,NE 147,RESIDENTIAL,26977,0,26977,103342,0,130319
141622602800000,NE 147,RESIDENTIAL,26794,0,26794,96389,0,123183
141622602900000,NE 147,RESIDENTIAL,28320,0,28320,70820,0,99140
141622603000000,NE 147,RESIDENTIAL,24099,0,24099,95049,0,119148
141622603100000,NE 147,RESIDENTIAL,200,0,200,0,0,200
141622603200000,NE 147,RESIDENTIAL,29,0,29,0,0,29
141623100100000,NE 147,RESIDENTIAL,35515,0,35515,115553,0,151068
141623100200000,NE 147,RESIDENTIAL,33197,0,33197,134643,0,167840
141623100300000,NE 147,RESIDENTIAL,33163,0,33163,115345,0,148508
141623100400000,NE 147,RESIDENTIAL,34211,0,34211,146123,0,180334
141623100500000,NE 147,RESIDENTIAL,37485,0,37485,152539,0,190024
141623100600000,NE 147,RESIDENTIAL,37926,0,37926,134229,0,172155
141625100100000,NE 147,RESIDENTIAL,37842,0,37842,139009,0,176851
141625100200000,CITY PROPERTY,EXEMPT,0,0,0,0,0,0
141625100400000,CARWASH,COMMERCIAL,0,60428,60428,0,87412,147840
141625100500000,OFFICE,COMMERCIAL,0,73250,73250,0,137303,210553
141627600100000,NE 147,RESIDENTIAL,35008,0,35008,128346,0,163354
141627600400000,VACANT LAND,COMMERCIAL,0,69520,69520,0,0,69520
141627600500000,BRANCH BANK/CU,COMMERCIAL,0,229400,229400,0,861636,1091036
141627700100000,NE 147,RESIDENTIAL,27440,0,27440,129453,0,156893
141627700200000,NE 147,RESIDENTIAL,33681,0,33681,136102,0,169783
141627700300000,NE 147,RESIDENTIAL,29253,0,29253,127617,0,156870
141627700400000,NE 147,RESIDENTIAL,25507,0,25507,143210,0,168717
141627700500000,NE 147,RESIDENTIAL,41176,0,41176,151212,0,192388
141627700600000,NE 147,RESIDENTIAL,39847,0,39847,124353,0,164200
141627700700000,NE 147,RESIDENTIAL,43890,0,43890,134574,0,178464
141627700800000,NE 147,RESIDENTIAL,36288,0,36288,148268,0,184556
141627700900000,NE 147,RESIDENTIAL,35550,0,35550,150961,0,186511
141627701000000,NE 148,RESIDENTIAL,45389,0,45389,185666,0,231055
141627701100000,NE 148,RESIDENTIAL,34098,0,34098,0,0,34098
141627701200000,NE 148,RESIDENTIAL,37950,0,37950,153895,0,191845
141627701300000,NE 148,RESIDENTIAL,33120,0,33120,151832,0,184952
141627701400000,NE 148,RESIDENTIAL,38936,0,38936,179908,0,218844
141627701500000,NE 148,RESIDENTIAL,35511,0,35511,162296,0,197807
141627701600000,NE 148,RESIDENTIAL,18540,0,18540,145400,0,163940
141627701700000,NE 148,RESIDENTIAL,18720,0,18720,145982,0,164702
141627800200000,NE 148,RESIDENTIAL,19392,0,19392,128747,0,148139
141627800300000,NE 148,RESIDENTIAL,20196,0,20196,132090,0,152286
141627800400000,NE 148,RESIDENTIAL,19125,0,19125,127222,0,146347
141627800500000,NE 148,RESIDENTIAL,18695,0,18695,124154,0,142849
141627800600000,NE 148,RESIDENTIAL,17680,0,17680,130018,0,147698
141627800700000,NE 148,RESIDENTIAL,19032,0,19032,126801,0,145833
141627800800000,NE 148,RESIDENTIAL,38934,0,38934,136241,0,175175
141627800900000,NE 148,RESIDENTIAL,40086,0,40086,158361,0,198447
141627801000000,NE 148,RESIDENTIAL,43512,0,43512,203430,0,246942
141627801100000,NE 148,RESIDENTIAL,42923,0,42923,178841,0,221764
141627801200000,NE 148,RESIDENTIAL,40013,0,40013,160239,0,200252
141627801300000,NE 148,RESIDENTIAL,44550,0,44550,142229,0,186779
141627801400000,NE 148,RESIDENTIAL,43605,0,43605,133292,0,176897
141627801500000,NE 148,RESIDENTIAL,41658,0,41658,143916,0,185574
141627801600000,VACANT LAND,COMMERCIAL,0,420020,420020,0,0,420020
141627801700000,VACANT LAND,COMMERCIAL,0,1540,1540,0,0,1540
141627801800000,OFFICE,COMMERCIAL,0,250350,250350,0,1677996,1928346
141630100100000,CITY PROPERTY,EXEMPT,0,0,0,0,0,0
141630100200000,WAREHOUSE,COMMERCIAL,0,332000,332000,0,1279255,1611255
141630100300000,WAREHOUSE,COMMERCIAL,0,250200,250200,0,1911039,2161239
141630100400000,CITY PROPERTY,EXEMPT,0,0,0,0,0,0
141630100500000,PAPER; INDUSTRIAL,INDUSTRIAL,0,493236,493236,0,3426738,3919974
141630100600000,CENTRALLY ASSESSED,OTHER,0,0,0,0,0,0
141630200100000,CENTRALLY ASSESSED,OTHER,0,0,0,0,0,0
141632600100000,CITY PROPERTY,EXEMPT,0,0,0,0,0,0
141632600400000,CITY PROPERTY,EXEMPT,0,0,0,0,0,0
141632600600000,VACANT LAND,COMMERCIAL,0,3000,3000,0,0,3000
141632600700000,CITY PROPERTY,EXEMPT,0,0,0,0,0,0
141632600900000,CENTRALLY ASSESSED,OTHER,0,0,0,0,0,0
141632601400000,FOOD GRADE;INDUST,INDUSTRIAL,0,135000,135000,0,829765,964765
141632601500000,FOOD GRADE;INDUST,INDUSTRIAL,0,232038,232038,0,907988,1140026
141632601600000,WAREHOUSE,COMMERCIAL,0,687000,687000,0,781618,1468618
141635100100000,VACANT LAND,INDUSTRIAL,0,20250,20250,0,0,20250
141635100200000,CITY PROPERTY,EXEMPT,0,0,0,0,0,0
141635100400000,CENTRALLY ASSESSED,OTHER,0,0,0,0,0,0
141637600100000,FLAT PARKING,COMMERCIAL,0,26175,26175,0,24000,50175
141637600102000,BILLBOARD(BLL),COMMERCIAL,0,0,0,0,10203,10203
141637600200000,CENTRALLY ASSESSED,OTHER,0,0,0,0,0,0
141637700100000,CITY PROPERTY,EXEMPT,0,0,0,0,0,0
141637700200000,OFFICE,COMMERCIAL,0,42152,42152,0,274505,316657
141637700600000,SHOP,COMMERCIAL,0,143100,143100,0,813191,956291
141637700700000,CENTRALLY ASSESSED,OTHER,0,0,0,0,0,0
141637700800000,CENTRALLY ASSESSED,OTHER,0,0,0,0,0,0
141637700900000,SHOP,COMMERCIAL,0,253000,253000,0,1035775,1288775
141640100100000,CITY PROPERTY,EXEMPT,0,0,0,0,0,0
141640200100000,NE 145,RESIDENTIAL,24480,0,24480,102271,0,126751
141640200200000,APARTMENT,COMMERCIAL,0,15153,15153,0,78131,93284
141640200300000,NE 145,RESIDENTIAL,18180,0,18180,79201,0,97381
141640200400000,NE 145,RESIDENTIAL,19089,0,19089,61999,0,81088
141640200500000,NE 145,RESIDENTIAL,19089,0,19089,56762,0,75851
141640200600000,NE 145,RESIDENTIAL,30011,0,30011,53410,0,83421
141640200700000,NE 145,RESIDENTIAL,30011,0,30011,44355,0,74366
141640200800000,NE 145,RESIDENTIAL,29695,0,29695,79474,0,109169
141640200900000,NE 145,RESIDENTIAL,25272,0,25272,93742,0,119014
141640201000000,NE 145,RESIDENTIAL,24300,0,24300,53807,0,78107
141640201100000,NE 145,RESIDENTIAL,31882,0,31882,66145,0,98027
141640201200000,NE 145,RESIDENTIAL,30278,0,30278,44475,0,74753
141640201300000,NE 145,RESIDENTIAL,16674,0,16674,82917,0,99591
141640201400000,NE 145,RESIDENTIAL,18360,0,18360,66117,0,84477
141640201500000,NE 145,RESIDENTIAL,23520,0,23520,80888,0,104408
141640201600000,NE 145,RESIDENTIAL,19600,0,19600,92085,0,111685
141640201700000,NE 145,RESIDENTIAL,15680,0,15680,71806,0,87486
141640201800000,NE 145,RESIDENTIAL,15680,0,15680,74416,0,90096
141640201900000,NE 145,RESIDENTIAL,25056,0,25056,213333,0,238389
141640202000000,NE 145,RESIDENTIAL,17400,0,17400,82751,0,100151
141640202100000,NE 145,RESIDENTIAL,26914,0,26914,100446,0,127360
141640202200000,NE 145,RESIDENTIAL,26417,0,26417,62837,0,89254
141640202300000,NE 145,RESIDENTIAL,26417,0,26417,72644,0,99061
141640202400000,NE 145,RESIDENTIAL,27907,0,27907,85016,0,112923
141640202500000,NE 145,RESIDENTIAL,23803,0,23803,69545,0,93348
141640202600000,NE 145,RESIDENTIAL,26676,0,26676,91016,0,117692
141640202700000,NE 145,RESIDENTIAL,26676,0,26676,94002,0,120678
141640202800000,NE 145,RESIDENTIAL,26112,0,26112,125202,0,151314
141640300100000,NE 145,RESIDENTIAL,27540,0,27540,73519,0,101059
141640300200000,SMALL RETAIL,COMMERCIAL,0,23200,23200,0,68140,91340
141640300300000,NE 145,RESIDENTIAL,16480,0,16480,41184,0,57664
141640300400000,NE 145,RESIDENTIAL,16480,0,16480,0,0,16480
141640300500000,NE 145,RESIDENTIAL,16480,0,16480,51015,0,67495
141640300600000,NE 145,RESIDENTIAL,16480,0,16480,0,0,16480
141640300700000,NE 145,RESIDENTIAL,16480,0,16480,66740,0,83220
141640300800000,NE 145,RESIDENTIAL,16480,0,16480,91955,0,108435
141640300900000,NE 145,RESIDENTIAL,16480,0,16480,58780,0,75260
141640301000000,NE 145,RESIDENTIAL,16480,0,16480,78930,0,95410
141640301100000,NE 145,RESIDENTIAL,16480,0,16480,41636,0,58116
141640301200000,NE 145,RESIDENTIAL,16480,0,16480,60811,0,77291
141640301300000,NE 145,RESIDENTIAL,16480,0,16480,77561,0,94041
141640301400000,NE 145,RESIDENTIAL,12360,0,12360,63807,0,76167
141640301500000,NE 145,RESIDENTIAL,12360,0,12360,57219,0,69579
141640301600000,NE 145,RESIDENTIAL,16480,0,16480,64964,0,81444
141640301700000,NE 145,RESIDENTIAL,15360,0,15360,56563,0,71923
141640301800000,NE 145,RESIDENTIAL,20506,0,20506,72223,0,92729
141640301900000,NE 145,RESIDENTIAL,15800,0,15800,61324,0,77124
141640302000000,NE 145,RESIDENTIAL,17984,0,17984,57744,0,75728
141640302100000,NE 145,RESIDENTIAL,17984,0,17984,65301,0,83285
141640302200000,NE 145,RESIDENTIAL,27810,0,27810,90961,0,118771
141640302300000,NE 145,RESIDENTIAL,13905,0,13905,70677,0,84582
141640302400000,NE 145,RESIDENTIAL,13905,0,13905,58609,0,72514
141640302500000,NE 145,RESIDENTIAL,27810,0,27810,83694,0,111504
141640302600000,NE 145,RESIDENTIAL,18540,0,18540,44190,0,62730
141640302700000,NE 145,RESIDENTIAL,18540,0,18540,77245,0,95785
141640302800000,NE 145,RESIDENTIAL,18540,0,18540,55558,0,74098
141640302900000,NE 145,RESIDENTIAL,18540,0,18540,58503,0,77043
141640303000000,NE 145,RESIDENTIAL,18540,0,18540,104256,0,122796
141640303100000,NE 145,RESIDENTIAL,18540,0,18540,99798,0,118338
141640303200000,NE 145,RESIDENTIAL,18540,0,18540,59775,0,78315
141640303300000,NE 145,RESIDENTIAL,18540,0,18540,72445,0,90985
141640303400000,NE 145,RESIDENTIAL,18540,0,18540,70349,0,88889
141640400100000,NE 145,RESIDENTIAL,20731,0,20731,67207,0,87938
141640400200000,NE 145,RESIDENTIAL,16856,0,16856,134569,0,151425
141640400300000,NE 145,RESIDENTIAL,17091,0,17091,73871,0,90962
141640400400000,NE 145,RESIDENTIAL,19992,0,19992,74273,0,94265
141640400500000,NE 145,RESIDENTIAL,19680,0,19680,64221,0,83901
141640400600000,NE 145,RESIDENTIAL,19680,0,19680,64683,0,84363
141640400700000,NE 145,RESIDENTIAL,17460,0,17460,76062,0,93522
141640400800000,NE 145,RESIDENTIAL,19440,0,19440,61428,0,80868
141640400900000,NE 145,RESIDENTIAL,29792,0,29792,80869,0,110661
141640401000000,NE 145,RESIDENTIAL,29831,0,29831,73216,0,103047
141640401100000,NE 145,RESIDENTIAL,19620,0,19620,83051,0,102671
141640401200000,NE 145,RESIDENTIAL,19620,0,19620,99593,0,119213
141640401300000,NE 145,RESIDENTIAL,19620,0,19620,69556,0,89176
141640401400000,NE 145,RESIDENTIAL,19865,0,19865,75542,0,95407
141640401500000,NE 145,RESIDENTIAL,19620,0,19620,68226,0,87846
141640401600000,NE 145,RESIDENTIAL,17460,0,17460,73488,0,90948
141640401700000,NE 145,RESIDENTIAL,17460,0,17460,70968,0,88428
141640401800000,NE 145,RESIDENTIAL,17266,0,17266,57453,0,74719
141640401900000,NE 145,RESIDENTIAL,17072,0,17072,67772,0,84844
141640402000000,SMALL RETAIL,COMMERCIAL,0,82635,82635,0,107779,190414
141640402100000,NE 145,RESIDENTIAL,17440,0,17440,43312,0,60752
141640402200000,NE 145,RESIDENTIAL,28050,0,28050,77868,0,105918
141640402300000,NE 145,RESIDENTIAL,17440,0,17440,41124,0,58564
141640402400000,NE 145,RESIDENTIAL,17440,0,17440,71472,0,88912
141640402500000,NE 145,RESIDENTIAL,17876,0,17876,89223,0,107099
141640402600000,NE 145,RESIDENTIAL,18007,0,18007,88068,0,106075
141640402700000,NE 145,RESIDENTIAL,17440,0,17440,114446,0,131886
141640402800000,NE 145,RESIDENTIAL,17440,0,17440,108834,0,126274
141640402900000,NE 145,RESIDENTIAL,20160,0,20160,55029,0,75189
141640500100000,NE 145,RESIDENTIAL,11610,0,11610,28078,0,39688
141640500200000,NE 145,RESIDENTIAL,16500,0,16500,71597,0,88097
141640500300000,NE 145,RESIDENTIAL,9720,0,9720,49814,0,59534
141640500400000,NE 145,RESIDENTIAL,16198,0,16198,68744,0,84942
141640500500000,NE 145,RESIDENTIAL,16480,0,16480,42442,0,58922
141640500600000,NE 145,RESIDENTIAL,16480,0,16480,65331,0,81811
141640500700000,NE 145,RESIDENTIAL,16480,0,16480,64649,0,81129
141640500800000,NE 145,RESIDENTIAL,16480,0,16480,87556,0,104036
141640500900000,NE 145,RESIDENTIAL,16480,0,16480,67614,0,84094
141640501000000,NE 145,RESIDENTIAL,16480,0,16480,69575,0,86055
141640501100000,NE 145,RESIDENTIAL,16480,0,16480,77735,0,94215
141640501200000,NE 145,RESIDENTIAL,16480,0,16480,65045,0,81525
141640501300000,NE 145,RESIDENTIAL,16480,0,16480,34883,0,51363
141640501400000,NE 145,RESIDENTIAL,16480,0,16480,62673,0,79153
141640501500000,NE 145,RESIDENTIAL,16480,0,16480,79482,0,95962
141640501600000,NE 145,RESIDENTIAL,16480,0,16480,83542,0,100022
141640501700000,NE 145,RESIDENTIAL,14560,0,14560,58807,0,73367
141640501800000,NE 145,RESIDENTIAL,30996,0,30996,71586,0,102582
141640501900000,NE 145,RESIDENTIAL,17784,0,17784,72276,0,90060
141640502000000,NE 145,RESIDENTIAL,21060,0,21060,119074,0,140134
141640502100000,NE 145,RESIDENTIAL,21060,0,21060,93853,0,114913
141640502200000,NE 145,RESIDENTIAL,21060,0,21060,71875,0,92935
141640502300000,NE 145,RESIDENTIAL,21060,0,21060,80413,0,101473
141640502400000,NE 145,RESIDENTIAL,28080,0,28080,126363,0,154443
141640502500000,NE 145,RESIDENTIAL,28080,0,28080,78696,0,106776
141640502600000,NE 145,RESIDENTIAL,28080,0,28080,66454,0,94534
141640502700000,NE 145,RESIDENTIAL,13352,0,13352,48409,0,61761
141642600100000,BARS/LOUNGE,COMMERCIAL,0,44800,44800,0,96299,141099
141642600200000,NE 146,RESIDENTIAL,14000,0,14000,56159,0,70159
141642600300000,NE 146,RESIDENTIAL,14000,0,14000,45704,0,59704
141642600400000,NE 146,RESIDENTIAL,14000,0,14000,47008,0,61008
141642600500000,NE 146,RESIDENTIAL,13160,0,13160,41950,0,55110
141642600600000,NE 146,RESIDENTIAL,14000,0,14000,54943,0,68943
141642600700000,NE 146,RESIDENTIAL,14000,0,14000,47254,0,61254
141642600800000,NE 146,RESIDENTIAL,14000,0,14000,48144,0,62144
141642600900000,NE 146,RESIDENTIAL,14000,0,14000,53560,0,67560
141642601000000,NE 146,RESIDENTIAL,14000,0,14000,50188,0,64188
141642601100000,NE 146,RESIDENTIAL,14000,0,14000,51877,0,65877
141642601200000,NE 146,RESIDENTIAL,14000,0,14000,49640,0,63640
141642601300000,NE 146,RESIDENTIAL,14000,0,14000,83983,0,97983
141642601400000,NE 146,RESIDENTIAL,14000,0,14000,34220,0,48220
141642601500000,NE 146,RESIDENTIAL,14000,0,14000,52793,0,66793
141642601600000,NE 146,RESIDENTIAL,14000,0,14000,46625,0,60625
141642601700000,NE 146,RESIDENTIAL,14000,0,14000,62628,0,76628
141642601800000,NE 146,RESIDENTIAL,14000,0,14000,63815,0,77815
141642601900000,NE 146,RESIDENTIAL,4200,0,4200,37773,0,41973
141642602000000,NE 146,RESIDENTIAL,9800,0,9800,46776,0,56576
141642602100000,NE 146,RESIDENTIAL,14000,0,14000,69065,0,83065
141642602200000,NE 146,RESIDENTIAL,14000,0,14000,57865,0,71865
141642602300000,NE 146,RESIDENTIAL,14000,0,14000,50261,0,64261
141642602400000,NE 146,RESIDENTIAL,14000,0,14000,64663,0,78663
141642602500000,NE 146,RESIDENTIAL,14000,0,14000,30207,0,44207
141642602600000,NE 146,RESIDENTIAL,14000,0,14000,58909,0,72909
141642602700000,NE 146,RESIDENTIAL,14000,0,14000,62240,0,76240
141642602800000,NE 146,RESIDENTIAL,14000,0,14000,52799,0,66799
141642602900000,NE 146,RESIDENTIAL,14000,0,14000,55695,0,69695
141642603000000,NE 146,RESIDENTIAL,14000,0,14000,45266,0,59266
141642603100000,NE 146,RESIDENTIAL,14000,0,14000,57898,0,71898
141642603200000,NE 146,RESIDENTIAL,14000,0,14000,53718,0,67718
141642603300000,NE 146,RESIDENTIAL,13160,0,13160,47897,0,61057
141642603400000,NE 146,RESIDENTIAL,14000,0,14000,47993,0,61993
141642700100000,NE 146,RESIDENTIAL,14000,0,14000,50989,0,64989
141642700200000,MATERIALS MFG;INDUST,INDUSTRIAL,0,87210,87210,0,641231,728441
141642700300000,NE 146,RESIDENTIAL,16800,0,16800,51529,0,68329
141642700400000,NE 146,RESIDENTIAL,14000,0,14000,64302,0,78302
141642700500000,NE 146,RESIDENTIAL,11830,0,11830,58229,0,70059
141642700600000,NE 146,RESIDENTIAL,14000,0,14000,53810,0,67810
141642700700000,NE 146,RESIDENTIAL,14000,0,14000,104258,0,118258
141642700800000,NE 146,RESIDENTIAL,14000,0,14000,33655,0,47655
141642800100000,FLAT PARKING,COMMERCIAL,0,21266,21266,0,0,21266
141642800200000,NE 146,RESIDENTIAL,14420,0,14420,84203,0,98623
141642800300000,SHOP,COMMERCIAL,0,21980,21980,0,93587,115567
141642800400000,WAREHOUSE,COMMERCIAL,0,19600,19600,0,50629,70229
141642800500000,VETERINARY CLINIC,COMMERCIAL,0,52052,52052,0,111286,163338
141642800600000,NE 146,RESIDENTIAL,14391,0,14391,57989,0,72380
141642800700000,NE 146,RESIDENTIAL,12000,0,12000,25079,0,37079
141642800800000,NE 146,RESIDENTIAL,12000,0,12000,25439,0,37439
141642800900000,WAREHOUSE,COMMERCIAL,0,18840,18840,0,80116,98956
141642801000000,MATERIALS MFG;INDUST,INDUSTRIAL,0,34290,34290,0,6240,40530
141642900100000,CONVERSION,COMMERCIAL,0,9072,9072,0,64462,73534
141642900200000,NE 146,RESIDENTIAL,14601,0,14601,70160,0,84761
141642900300000,NE 146,RESIDENTIAL,16479,0,16479,64652,0,81131
141642900400000,NE 146,RESIDENTIAL,14487,0,14487,29133,0,43620
141642900500000,NE 146,RESIDENTIAL,14420,0,14420,58120,0,72540
141642900600000,NE 146,RESIDENTIAL,14601,0,14601,62350,0,76951
141642900700000,NE 146,RESIDENTIAL,14000,0,14000,45387,0,59387
141642900800000,NE 146,RESIDENTIAL,16800,0,16800,51688,0,68488
141642900900000,NE 146,RESIDENTIAL,11830,0,11830,39233,0,51063
141642901000000,NE 146,RESIDENTIAL,14000,0,14000,63944,0,77944
141642901100000,NE 146,RESIDENTIAL,14000,0,14000,72693,0,86693
141642901200000,NE 146,RESIDENTIAL,14000,0,14000,37740,0,51740
141643000100000,SHOP,COMMERCIAL,0,25929,25929,0,50868,76797
141643000200000,NE 146,RESIDENTIAL,14420,0,14420,74604,0,89024
141643000300000,WAREHOUSE,COMMERCIAL,0,16800,16800,0,52057,68857
141643000400000,NE 146,RESIDENTIAL,12000,0,12000,31086,0,43086
141643000600000,WAREHOUSE,COMMERCIAL,0,64596,64596,0,182875,247471
141643000700000,NE 146,RESIDENTIAL,12000,0,12000,44523,0,56523
141643000800000,NE 146,RESIDENTIAL,12000,0,12000,22404,0,34404
141643000900000,SHOP,COMMERCIAL,0,38481,38481,0,110080,148561
141643100100000,NE 146,RESIDENTIAL,14017,0,14017,87493,0,101510
141643100200000,NE 146,RESIDENTIAL,14017,0,14017,51519,0,65536
141643100500000,NE 146,RESIDENTIAL,14000,0,14000,61416,0,75416
141643100600000,NE 146,RESIDENTIAL,16800,0,16800,41895,0,58695
141643100700000,NE 146,RESIDENTIAL,14000,0,14000,53191,0,67191
141643100800000,NE 146,RESIDENTIAL,14000,0,14000,40522,0,54522
141643100900000,NE 146,RESIDENTIAL,14000,0,14000,64959,0,78959
141643101000000,NE 146,RESIDENTIAL,14000,0,14000,83000,0,97000
141643101100000,NE 146,RESIDENTIAL,16800,0,16800,70992,0,87792
141643101200000,NE 146,RESIDENTIAL,14000,0,14000,58497,0,72497
141643101300000,NE 146,RESIDENTIAL,14000,0,14000,54023,0,68023
141643101400000,NE 146,RESIDENTIAL,14000,0,14000,34864,0,48864
141643101500000,NE 146,RESIDENTIAL,14000,0,14000,60661,0,74661
141643101600000,NE 146,RESIDENTIAL,14000,0,14000,64839,0,78839
141643101900000,NE 146,RESIDENTIAL,14000,0,14000,44536,0,58536
141643102000000,NE 146,RESIDENTIAL,14000,0,14000,50028,0,64028
141643102100000,NE 146,RESIDENTIAL,14000,0,14000,114007,0,128007
141643102200000,NE 146,RESIDENTIAL,14000,0,14000,81233,0,95233
141643102300000,NE 146,RESIDENTIAL,14000,0,14000,47342,0,61342
141643102400000,NE 146,RESIDENTIAL,14000,0,14000,52935,0,66935
141643102500000,NE 146,RESIDENTIAL,14000,0,14000,58917,0,72917
141643102600000,NE 146,RESIDENTIAL,14000,0,14000,53959,0,67959
141643102700000,NE 146,RESIDENTIAL,14000,0,14000,97537,0,111537
141643102800000,NE 146,RESIDENTIAL,16800,0,16800,58120,0,74920
141643200100000,NE 146,RESIDENTIAL,15750,0,15750,63602,0,79352
141643200200000,NE 146,RESIDENTIAL,14175,0,14175,57652,0,71827
141643200300000,NE 146,RESIDENTIAL,14000,0,14000,77560,0,91560
141643200400000,NE 146,RESIDENTIAL,15390,0,15390,62599,0,77989
141643200500000,NE 146,RESIDENTIAL,17109,0,17109,38210,0,55319
141643200600000,NE 146,RESIDENTIAL,14000,0,14000,44641,0,58641
141643200700000,NE 146,RESIDENTIAL,14175,0,14175,70358,0,84533
141643200800000,NE 146,RESIDENTIAL,14000,0,14000,64625,0,78625
141643200900000,NE 146,RESIDENTIAL,14000,0,14000,47606,0,61606
141643201000000,NE 146,RESIDENTIAL,14000,0,14000,57097,0,71097
141643201100000,NE 146,RESIDENTIAL,13055,0,13055,56907,0,69962
141643201200000,NE 146,RESIDENTIAL,15750,0,15750,59061,0,74811
141643300100000,WAREHOUSE,COMMERCIAL,0,27126,27126,0,65617,92743
141643300200000,SHOP,COMMERCIAL,0,14400,14400,0,68128,82528
141643300300000,SHOP,COMMERCIAL,0,36000,36000,0,78553,114553
141643300400000,NE 146,RESIDENTIAL,11190,0,11190,40220,0,51410
141643300500000,NE 146,RESIDENTIAL,12000,0,12000,54439,0,66439
141643300600000,NE 146,RESIDENTIAL,17077,0,17077,71970,0,89047
141643300700000,SHOP,COMMERCIAL,0,119360,119360,0,123233,242593
141643300800000,VACANT LAND,COMMERCIAL,0,1135,1135,0,0,1135
141643300900000,VACANT LAND,COMMERCIAL,0,22476,22476,0,0,22476
141643400100000,NE 146,RESIDENTIAL,16800,0,16800,42059,0,58859
141643400200000,OFFICE; MEDICAL,COMMERCIAL,0,144000,144000,0,966177,1110177
141643400300000,NE 146,RESIDENTIAL,14000,0,14000,45038,0,59038
141643400400000,NE 146,RESIDENTIAL,14000,0,14000,0,0,14000
141643400500000,NE 146,RESIDENTIAL,17563,0,17563,0,0,17563
141645100100000,CONVERSION,COMMERCIAL,0,8951,8951,0,65548,74499
141645100200000,NE 146,RESIDENTIAL,14000,0,14000,47854,0,61854
141645200100000,NE 146,RESIDENTIAL,14000,0,14000,29281,0,43281
141645300100000,NE 146,RESIDENTIAL,12635,0,12635,54779,0,67414
141645300200000,NE 146,RESIDENTIAL,12285,0,12285,52049,0,64334
141645300300000,NE 146,RESIDENTIAL,13230,0,13230,42035,0,55265
141645300400000,NE 146,RESIDENTIAL,12250,0,12250,48453,0,60703
141645300500000,NE 146,RESIDENTIAL,14000,0,14000,57428,0,71428
141645300600000,NE 146,RESIDENTIAL,14000,0,14000,20892,0,34892
141645300700000,NE 146,RESIDENTIAL,14000,0,14000,42907,0,56907
141645300800000,NE 146,RESIDENTIAL,14000,0,14000,53333,0,67333
141645300900000,NE 146,RESIDENTIAL,14000,0,14000,59635,0,73635
141645301000000,NE 146,RESIDENTIAL,14000,0,14000,51195,0,65195
141645301100000,NE 146,RESIDENTIAL,14000,0,14000,47856,0,61856
141645301200000,NE 146,RESIDENTIAL,14000,0,14000,37664,0,51664
141645301300000,NE 146,RESIDENTIAL,14000,0,14000,41791,0,55791
141645301400000,NE 146,RESIDENTIAL,14000,0,14000,104129,0,118129
141645301500000,NE 146,RESIDENTIAL,14000,0,14000,44327,0,58327
141645301600000,NE 146,RESIDENTIAL,14000,0,14000,33583,0,47583
141645301700000,NE 146,RESIDENTIAL,14000,0,14000,64211,0,78211
141645301800000,NE 146,RESIDENTIAL,14000,0,14000,46380,0,60380
141645301900000,NE 146,RESIDENTIAL,16100,0,16100,52275,0,68375
141645302000000,NE 146,RESIDENTIAL,5670,0,5670,36322,0,41992
141645302100000,BARS/LOUNGE,COMMERCIAL,0,28000,28000,0,117965,145965
141645302200000,NE 146,RESIDENTIAL,14000,0,14000,79182,0,93182
141645302300000,NE 146,RESIDENTIAL,14000,0,14000,74145,0,88145
141645302400000,NE 146,RESIDENTIAL,14000,0,14000,51654,0,65654
141645302500000,NE 146,RESIDENTIAL,14000,0,14000,43918,0,57918
141645302600000,NE 146,RESIDENTIAL,14000,0,14000,45273,0,59273
141645302700000,NE 146,RESIDENTIAL,14000,0,14000,57386,0,71386
141645302800000,NE 146,RESIDENTIAL,14000,0,14000,51730,0,65730
141645302900000,NE 146,RESIDENTIAL,14000,0,14000,57243,0,71243
141645303000000,NE 146,RESIDENTIAL,14000,0,14000,78244,0,92244
141645303100000,NE 146,RESIDENTIAL,14000,0,14000,44745,0,58745
141645303200000,NE 146,RESIDENTIAL,14000,0,14000,76487,0,90487
141645303300000,NE 146,RESIDENTIAL,14000,0,14000,72138,0,86138
141645303400000,NE 146,RESIDENTIAL,14000,0,14000,42222,0,56222
141645303500000,NE 146,RESIDENTIAL,14000,0,14000,57575,0,71575
141645400100000,NE 146,RESIDENTIAL,15750,0,15750,56708,0,72458
141645400200000,NE 146,RESIDENTIAL,16065,0,16065,87444,0,103509
141645400300000,NE 146,RESIDENTIAL,18564,0,18564,98696,0,117260
141645400400000,NE 146,RESIDENTIAL,18386,0,18386,43447,0,61833
141645400500000,WAREHOUSE;MINI STORG,COMMERCIAL,0,30844,30844,0,54613,85457
141645400600000,WAREHOUSE;MINI STORG,COMMERCIAL,0,16875,16875,0,66253,83128
141645400700000,NE 146,RESIDENTIAL,15750,0,15750,42567,0,58317
141645400800000,NE 146,RESIDENTIAL,15750,0,15750,68471,0,84221
141645400900000,NE 146,RESIDENTIAL,14000,0,14000,64419,0,78419
141645401000000,NE 146,RESIDENTIAL,14000,0,14000,49460,0,63460
141645401100000,NE 146,RESIDENTIAL,14000,0,14000,50943,0,64943
141645401200000,NE 146,RESIDENTIAL,15750,0,15750,52948,0,68698
141645500100000,NE 146,RESIDENTIAL,15750,0,15750,80009,0,95759
141645500200000,VACANT LAND,COMMERCIAL,0,32250,32250,0,0,32250
141645500300000,WAREHOUSE,COMMERCIAL,0,16125,16125,0,41103,57228
141645500400000,NE 146,RESIDENTIAL,15750,0,15750,72963,0,88713
141645500500000,NE 146,RESIDENTIAL,15750,0,15750,61026,0,76776
141645500600000,NE 146,RESIDENTIAL,14000,0,14000,54224,0,68224
141645500700000,CONVERSION,COMMERCIAL,0,18144,18144,0,38687,56831
141645500800000,NE 146,RESIDENTIAL,8000,0,8000,0,0,8000
141645600100000,AUTO REPAIR/SALES,COMMERCIAL,0,50400,50400,0,40838,91238
141645600200000,NE 146,RESIDENTIAL,14962,0,14962,42168,0,57130
141645600300000,NE 156,RESIDENTIAL,12000,0,12000,0,0,12000
141645600400000,NE 146,RESIDENTIAL,6000,0,6000,0,0,6000
141645600500000,NE 146,RESIDENTIAL,6000,0,6000,0,0,6000
141645600600000,NE 146,RESIDENTIAL,14000,0,14000,37621,0,51621
141645600700000,NE 146,RESIDENTIAL,14000,0,14000,47602,0,61602
141645600800000,NE 146,RESIDENTIAL,17255,0,17255,56668,0,73923
141645600900000,NE 146,RESIDENTIAL,20300,0,20300,43259,0,63559
141645601000000,NE 146,RESIDENTIAL,14000,0,14000,42932,0,56932
141645601100000,NE 146,RESIDENTIAL,14000,0,14000,50186,0,64186
141645601200000,NE 146,RESIDENTIAL,14000,0,14000,54842,0,68842
141645601300000,NE 146,RESIDENTIAL,14000,0,14000,49304,0,63304
141645700100000,NE 146,RESIDENTIAL,16459,0,16459,45225,0,61684
141645700200000,NE 146,RESIDENTIAL,18228,0,18228,57356,0,75584
141645700300000,NE 146,RESIDENTIAL,5000,0,5000,0,0,5000
141645700400000,NE 146,RESIDENTIAL,6972,0,6972,29319,0,36291
141645700500000,NE 146,RESIDENTIAL,11525,0,11525,0,0,11525
141645700600000,CENTRALLY ASSESSED,OTHER,0,0,0,0,0,0
141645800100000,WAREHOUSE,COMMERCIAL,0,88146,88146,0,130890,219036
141645800200000,WAREHOUSE,COMMERCIAL,0,48600,48600,0,155285,203885
141645900100000,CITY PROPERTY,EXEMPT,0,0,0,0,0,0
141645900200000,CITY PROPERTY,EXEMPT,0,0,0,0,0,0
141645900300000,CITY PROPERTY,EXEMPT,0,0,0,0,0,0
141645900400000,CITY PROPERTY,EXEMPT,0,0,0,0,0,0
141645900500000,CITY PROPERTY,EXEMPT,0,0,0,0,0,0
141645900600000,SHOP,COMMERCIAL,0,38360,38360,0,39031,77391
141645900700000,CITY PROPERTY,EXEMPT,0,0,0,0,0,0
141645900800000,CITY PROPERTY,EXEMPT,0,0,0,0,0,0
141645900900000,CITY PROPERTY,EXEMPT,0,0,0,0,0,0
141645901000000,SHOP,COMMERCIAL,0,32755,32755,0,70620,103375
141645901100000,SHOP,COMMERCIAL,0,62718,62718,0,252767,315485
141645901200000,MATERIALS MFG;INDUST,INDUSTRIAL,0,39269,39269,0,13275,52544
141645901300000,CITY PROPERTY,EXEMPT,0,0,0,0,0,0
141645901400000,CENTRALLY ASSESSED,OTHER,0,0,0,0,0,0
141645901500000,CENTRALLY ASSESSED,OTHER,0,0,0,0,0,0
141645901600000,CENTRALLY ASSESSED,OTHER,0,0,0,0,0,0
141645901700000,CENTRALLY ASSESSED,OTHER,0,0,0,0,0,0
141647600100000,NE 146,RESIDENTIAL,8943,0,8943,40996,0,49939
141647600200000,NE 146,RESIDENTIAL,9065,0,9065,43352,0,52417
141647600300000,NE 146,RESIDENTIAL,9692,0,9692,40839,0,50531
141647600400000,NE 146,RESIDENTIAL,6461,0,6461,0,0,6461
141647600500000,NE 146,RESIDENTIAL,14000,0,14000,40708,0,54708
141647600600000,NE 146,RESIDENTIAL,14000,0,14000,50604,0,64604
141647600700000,NE 146,RESIDENTIAL,14000,0,14000,42472,0,56472
141647600800000,NE 146,RESIDENTIAL,13860,0,13860,38314,0,52174
141647600900000,NE 146,RESIDENTIAL,13860,0,13860,50951,0,64811
141647601000000,NE 146,RESIDENTIAL,13860,0,13860,0,0,13860
141647601100000,NE 146,RESIDENTIAL,16632,0,16632,58870,0,75502
141647601200000,NE 146,RESIDENTIAL,13720,0,13720,27871,0,41591
141647601300000,NE 146,RESIDENTIAL,13720,0,13720,42048,0,55768
141647601400000,NE 146,RESIDENTIAL,13720,0,13720,0,0,13720
141647601500000,NE 146,RESIDENTIAL,13580,0,13580,51794,0,65374
141647601600000,NE 146,RESIDENTIAL,13580,0,13580,39665,0,53245
141647601700000,NE 146,RESIDENTIAL,13440,0,13440,40220,0,53660
141647601800000,NE 146,RESIDENTIAL,13440,0,13440,51872,0,65312
141647601900000,VACANT LAND,COMMERCIAL,0,13068,13068,0,0,13068
141647602000000,FLAT PARKING,COMMERCIAL,0,12625,12625,0,3036,15661
141647602100000,FLAT PARKING,COMMERCIAL,0,11875,11875,0,3866,15741
141647602200000,FLAT PARKING,COMMERCIAL,0,10750,10750,0,2553,13303
141647602300000,WAREHOUSE,COMMERCIAL,0,93400,93400,0,344433,437833
141647700100000,NE 146,RESIDENTIAL,10644,0,10644,50266,0,60910
141647700200000,NE 146,RESIDENTIAL,9923,0,9923,49829,0,59752
141647700300000,NE 146,RESIDENTIAL,11883,0,11883,62161,0,74044
141647700400000,NE 146,RESIDENTIAL,19152,0,19152,106042,0,125194
141647700500000,NE 146,RESIDENTIAL,14000,0,14000,85961,0,99961
141647700600000,NE 146,RESIDENTIAL,14000,0,14000,78039,0,92039
141647700700000,NE 146,RESIDENTIAL,14000,0,14000,73967,0,87967
141647700800000,NE 146,RESIDENTIAL,14000,0,14000,59389,0,73389
141647700900000,NE 146,RESIDENTIAL,14000,0,14000,78826,0,92826
141647701000000,NE 146,RESIDENTIAL,14000,0,14000,81373,0,95373
141647701100000,NE 146,RESIDENTIAL,14000,0,14000,81673,0,95673
141647701200000,NE 146,RESIDENTIAL,14000,0,14000,60313,0,74313
141647701300000,NE 146,RESIDENTIAL,14000,0,14000,85374,0,99374
141647701400000,NE 146,RESIDENTIAL,14000,0,14000,67977,0,81977
141647701500000,NE 146,RESIDENTIAL,14000,0,14000,63286,0,77286
141647701600000,NE 146,RESIDENTIAL,14000,0,14000,68571,0,82571
141647701700000,NE 146,RESIDENTIAL,14000,0,14000,68659,0,82659
141647701800000,NE 146,RESIDENTIAL,14000,0,14000,67337,0,81337
141647701900000,NE 146,RESIDENTIAL,14000,0,14000,65976,0,79976
141647702000000,NE 146,RESIDENTIAL,14000,0,14000,51873,0,65873
141647702100000,NE 146,RESIDENTIAL,14000,0,14000,78929,0,92929
141647702200000,NE 146,RESIDENTIAL,14000,0,14000,102213,0,116213
141647702300000,NE 146,RESIDENTIAL,14000,0,14000,68420,0,82420
141647702400000,NE 146,RESIDENTIAL,12320,0,12320,50020,0,62340
141647702500000,NE 146,RESIDENTIAL,12918,0,12918,39678,0,52596
141647702600000,NE 146,RESIDENTIAL,11340,0,11340,44313,0,55653
141647702900000,NE 146,RESIDENTIAL,10290,0,10290,40264,0,50554
141647703000000,NE 146,RESIDENTIAL,13762,0,13762,40266,0,54028
141647703100000,NE 146,RESIDENTIAL,9800,0,9800,43999,0,53799
141647703200000,NE 146,RESIDENTIAL,14000,0,14000,47826,0,61826
141647703300000,NE 146,RESIDENTIAL,14000,0,14000,47549,0,61549
141647703400000,NE 146,RESIDENTIAL,14000,0,14000,0,0,14000
141647703500000,NE 146,RESIDENTIAL,14000,0,14000,23575,0,37575
141647703600000,NE 146,RESIDENTIAL,14000,0,14000,48575,0,62575
141647703700000,NE 146,RESIDENTIAL,16800,0,16800,56413,0,73213
141647703800000,NE 146,RESIDENTIAL,14000,0,14000,48618,0,62618
141647703900000,NE 146,RESIDENTIAL,14000,0,14000,51651,0,65651
141647704000000,NE 146,RESIDENTIAL,14000,0,14000,54105,0,68105
141647704100000,NE 146,RESIDENTIAL,14000,0,14000,54854,0,68854
141647704200000,NE 146,RESIDENTIAL,14000,0,14000,62596,0,76596
141647704300000,NE 146,RESIDENTIAL,14000,0,14000,57362,0,71362
141647704400000,NE 146,RESIDENTIAL,14000,0,14000,52522,0,66522
141647704500000,NE 146,RESIDENTIAL,14000,0,14000,58206,0,72206
141647704600000,NE 146,RESIDENTIAL,14000,0,14000,24975,0,38975
141647704700000,NE 146,RESIDENTIAL,14000,0,14000,47755,0,61755
141647704800000,NE 146,RESIDENTIAL,12600,0,12600,0,0,12600
141647704900000,NE 146,RESIDENTIAL,9800,0,9800,67542,0,77342
141647705000000,NE 146,RESIDENTIAL,10168,0,10168,62483,0,72651
141647800100000,NE 145,RESIDENTIAL,17460,0,17460,60289,0,77749
141647900100000,NE 145,RESIDENTIAL,24570,0,24570,63563,0,88133
141647900200000,NE 145,RESIDENTIAL,14150,0,14150,64581,0,78731
141647900300000,NE 145,RESIDENTIAL,14400,0,14400,70881,0,85281
141647900400000,NE 145,RESIDENTIAL,14560,0,14560,72392,0,86952
141648000100000,NE 146,RESIDENTIAL,25436,0,25436,97675,0,123111
141648000200000,NE 146,RESIDENTIAL,14099,0,14099,58822,0,72921
141648000300000,NE 146,RESIDENTIAL,15400,0,15400,80244,0,95644
141648000400000,NE 146,RESIDENTIAL,18351,0,18351,82427,0,100778
141648000500000,NE 146,RESIDENTIAL,14980,0,14980,79000,0,93980
141648000600000,NE 146,RESIDENTIAL,14980,0,14980,75171,0,90151
141648000700000,NE 146,RESIDENTIAL,22283,0,22283,84898,0,107181
141648000800000,NE 146,RESIDENTIAL,22283,0,22283,64477,0,86760
141648000900000,NE 146,RESIDENTIAL,14493,0,14493,30038,0,44531
141648001000000,NE 146,RESIDENTIAL,22470,0,22470,78961,0,101431
141648001100000,NE 146,RESIDENTIAL,22470,0,22470,65054,0,87524
141648001200000,NE 146,RESIDENTIAL,14980,0,14980,54039,0,69019
141648001300000,NE 146,RESIDENTIAL,14343,0,14343,70828,0,85171
141648001400000,NE 146,RESIDENTIAL,14606,0,14606,51402,0,66008
141648001500000,NE 146,RESIDENTIAL,14606,0,14606,70821,0,85427
141648001600000,NE 146,RESIDENTIAL,14980,0,14980,58517,0,73497
141648001700000,NE 146,RESIDENTIAL,22226,0,22226,83376,0,105602
141648001800000,NE 146,RESIDENTIAL,22226,0,22226,82003,0,104229
141648001900000,NE 146,RESIDENTIAL,14099,0,14099,54159,0,68258
141648002000000,NE 146,RESIDENTIAL,15120,0,15120,69503,0,84623
141648002100000,NE 146,RESIDENTIAL,15120,0,15120,90475,0,105595
141648002200000,NE 146,RESIDENTIAL,19798,0,19798,79792,0,99590
141648002300000,NE 146,RESIDENTIAL,18900,0,18900,64993,0,83893
141648002400000,NE 146,RESIDENTIAL,18900,0,18900,64283,0,83183
141648002500000,NE 146,RESIDENTIAL,18795,0,18795,52419,0,71214
141648002600000,NE 146,RESIDENTIAL,14000,0,14000,75077,0,89077
141648002700000,NE 146,RESIDENTIAL,14000,0,14000,72058,0,86058
141648002800000,NE 146,RESIDENTIAL,21000,0,21000,75884,0,96884
141648002900000,NE 146,RESIDENTIAL,15120,0,15120,59739,0,74859
141648003000000,NE 146,RESIDENTIAL,15120,0,15120,79350,0,94470
141648003100000,NE 146,RESIDENTIAL,14099,0,14099,89799,0,103898
141648003200000,NE 146,RESIDENTIAL,22226,0,22226,74907,0,97133
141648003300000,NE 146,RESIDENTIAL,22226,0,22226,56505,0,78731
141648003400000,CONVERSION,COMMERCIAL,0,16918,16918,0,97357,114275
141648003500000,NE 146,RESIDENTIAL,22096,0,22096,44916,0,67012
141648003600000,NE 146,RESIDENTIAL,14343,0,14343,97780,0,112123
141648003700000,NE 146,RESIDENTIAL,14980,0,14980,69393,0,84373
141648003800000,NE 146,RESIDENTIAL,14980,0,14980,45549,0,60529
141648003900000,NE 146,RESIDENTIAL,14119,0,14119,73021,0,87140
141648004000000,NE 146,RESIDENTIAL,14980,0,14980,33142,0,48122
141648004100000,NE 146,RESIDENTIAL,14980,0,14980,58486,0,73466
141648004200000,NE 146,RESIDENTIAL,14980,0,14980,66315,0,81295
141648004300000,NE 146,RESIDENTIAL,14980,0,14980,63638,0,78618
141648004400000,NE 146,RESIDENTIAL,14980,0,14980,63865,0,78845
141648004500000,NE 146,RESIDENTIAL,18725,0,18725,86120,0,104845
141648004600000,NE 146,RESIDENTIAL,16590,0,16590,67598,0,84188
141648100100000,NE 146,RESIDENTIAL,20549,0,20549,77514,0,98063
141648100200000,NE 146,RESIDENTIAL,9923,0,9923,57325,0,67248
141648100300000,NE 146,RESIDENTIAL,10920,0,10920,61525,0,72445
141648100400000,NE 146,RESIDENTIAL,14140,0,14140,58619,0,72759
141648100500000,NE 146,RESIDENTIAL,14140,0,14140,41827,0,55967
141648100600000,NE 146,RESIDENTIAL,14140,0,14140,67240,0,81380
141648100700000,NE 146,RESIDENTIAL,14140,0,14140,55524,0,69664
141648100800000,NE 146,RESIDENTIAL,14140,0,14140,79017,0,93157
141648100900000,NE 146,RESIDENTIAL,14140,0,14140,89045,0,103185
141648101000000,NE 146,RESIDENTIAL,14140,0,14140,55944,0,70084
141648101100000,NE 146,RESIDENTIAL,23755,0,23755,47705,0,71460
141648101200000,NE 146,RESIDENTIAL,13787,0,13787,51291,0,65078
141648101300000,NE 146,RESIDENTIAL,14140,0,14140,46838,0,60978
141648101400000,NE 146,RESIDENTIAL,14140,0,14140,64277,0,78417
141648101500000,NE 146,RESIDENTIAL,21210,0,21210,60766,0,81976
141648101600000,NE 146,RESIDENTIAL,20857,0,20857,71054,0,91911
141648101700000,NE 146,RESIDENTIAL,20786,0,20786,86780,0,107566
141648101800000,NE 146,RESIDENTIAL,20786,0,20786,89098,0,109884
141648101900000,NE 146,RESIDENTIAL,13645,0,13645,66015,0,79660
141648102000000,FLAT PARKING,COMMERCIAL,0,57932,57932,0,12989,70921
141648102100000,NE 146,RESIDENTIAL,18900,0,18900,37224,0,56124
141648102200000,NE 146,RESIDENTIAL,18900,0,18900,51044,0,69944
141648102300000,NE 146,RESIDENTIAL,18900,0,18900,86350,0,105250
141648102400000,NE 146,RESIDENTIAL,17850,0,17850,58340,0,76190
141648102500000,NE 146,RESIDENTIAL,21330,0,21330,43802,0,65132
141648102600000,NE 146,RESIDENTIAL,10665,0,10665,56864,0,67529
141648102700000,NE 146,RESIDENTIAL,10665,0,10665,66074,0,76739
141648102800000,NE 146,RESIDENTIAL,21403,0,21403,70178,0,91581
141648102900000,NE 146,RESIDENTIAL,21403,0,21403,71719,0,93122
141648103000000,NE 146,RESIDENTIAL,21476,0,21476,67401,0,88877
141648103100000,NE 146,RESIDENTIAL,21476,0,21476,113064,0,134540
141648103200000,NE 146,RESIDENTIAL,13832,0,13832,52284,0,66116
141648103300000,NE 146,RESIDENTIAL,14560,0,14560,47334,0,61894
141648103400000,NE 146,RESIDENTIAL,14560,0,14560,59801,0,74361
141648103500000,NE 146,RESIDENTIAL,21840,0,21840,90886,0,112726
141648103600000,NE 146,RESIDENTIAL,21630,0,21630,57525,0,79155
141648103700000,NE 146,RESIDENTIAL,21630,0,21630,68811,0,90441
141648103800000,NE 146,RESIDENTIAL,21630,0,21630,88349,0,109979
141648103900000,NE 146,RESIDENTIAL,21630,0,21630,56196,0,77826
141648104000000,NE 146,RESIDENTIAL,21630,0,21630,69138,0,90768
141648200100000,NE 146,RESIDENTIAL,25480,0,25480,77461,0,102941
141648200200000,NE 146,RESIDENTIAL,22372,0,22372,2030,0,24402
141648200300000,NE 146,RESIDENTIAL,22312,0,22312,92494,0,114806
141648200400000,NE 146,RESIDENTIAL,21000,0,21000,85901,0,106901
141648200500000,NE 146,RESIDENTIAL,20790,0,20790,54599,0,75389
141648200600000,NE 146,RESIDENTIAL,20580,0,20580,0,0,20580
141648200700000,NE 146,RESIDENTIAL,15836,0,15836,50141,0,65977
141648200800000,NE 146,RESIDENTIAL,14853,0,14853,50233,0,65086
141648200900000,AUTO REPAIR/SALES,COMMERCIAL,0,29874,29874,0,34756,64630
141710100200000,NE 135,RESIDENTIAL,67950,0,67950,937632,0,1005582
141710100300000,NE 135,RESIDENTIAL,43120,0,43120,182320,0,225440
141710100400000,NE 135,RESIDENTIAL,40375,0,40375,254134,0,294509
141710100500000,NE 135,RESIDENTIAL,35696,0,35696,0,0,35696
141710100600000,NE 149,RESIDENTIAL,37350,0,37350,0,0,37350
141710100700000,NE 149,RESIDENTIAL,20,0,20,0,0,20
141710101400000,NE 149,RESIDENTIAL,20,0,20,0,0,20
141710200300000,OFFICE,EXEMPT,0,546575,546575,0,472732,1019307
141712600100000,NE 135,RESIDENTIAL,41275,0,41275,0,0,41275
141712600200000,NE 149,RESIDENTIAL,39957,0,39957,0,0,39957
141712600300000,NE 149,RESIDENTIAL,40766,0,40766,196416,0,237182
141712600400000,NE 149,RESIDENTIAL,41472,0,41472,196841,0,238313
141712600500000,NE 149,RESIDENTIAL,43372,0,43372,168235,0,211607
141712600600000,NE 149,RESIDENTIAL,38480,0,38480,251338,0,289818
141712600700000,NE 149,RESIDENTIAL,63270,0,63270,0,0,63270
141712600900000,NE 149,RESIDENTIAL,40759,0,40759,273129,0,313888
141712601100000,NE 149,RESIDENTIAL,35853,0,35853,284590,0,320443
141712601200000,NE 149,RESIDENTIAL,49184,0,49184,218847,0,268031
141712601300000,NE 149,RESIDENTIAL,8150,0,8150,0,0,8150
141712601400000,NE 149,RESIDENTIAL,487,0,487,0,0,487
141712601500000,NE 149,RESIDENTIAL,8287,0,8287,0,0,8287
141712601600000,NE 135,RESIDENTIAL,36300,0,36300,328078,0,364378
141712700100000,NE 149,RESIDENTIAL,73920,0,73920,361170,0,435090
141712700200000,NE 149,RESIDENTIAL,74970,0,74970,349005,0,423975
141712700300000,NE 149,RESIDENTIAL,73088,0,73088,226872,0,299960
141712700400000,NE 149,RESIDENTIAL,70560,0,70560,281928,0,352488
141712700500000,NE 149,RESIDENTIAL,63756,0,63756,320952,0,384708
141712700600000,NE 149,RESIDENTIAL,46453,0,46453,218801,0,265254
141712700700000,NE 149,RESIDENTIAL,46283,0,46283,202126,0,248409
141712700800000,NE 149,RESIDENTIAL,46283,0,46283,217922,0,264205
141712700900000,NE 149,RESIDENTIAL,46750,0,46750,237899,0,284649
141712701000000,NE 149,RESIDENTIAL,52773,0,52773,230657,0,283430
141712701100000,NE 149,RESIDENTIAL,43956,0,43956,241863,0,285819
141712701200000,NE 149,RESIDENTIAL,61180,0,61180,271377,0,332557
141712701300000,NE 149,RESIDENTIAL,37502,0,37502,0,0,37502
141712701400000,NE 149,RESIDENTIAL,47333,0,47333,157255,0,204588
141712701500000,NE 149,RESIDENTIAL,90319,0,90319,181640,0,271959
141712701700000,NE 149,RESIDENTIAL,72765,0,72765,249859,0,322624
141712701800000,NE 149,RESIDENTIAL,72803,0,72803,208205,0,281008
141712701900000,NE 149,RESIDENTIAL,144621,0,144621,705379,0,850000
141712702000000,NE 149,RESIDENTIAL,58598,0,58598,476753,0,535351
141712702100000,NE 149,RESIDENTIAL,79352,0,79352,217149,0,296501
141712702200000,NE 149,RESIDENTIAL,6260,0,6260,0,0,6260
141712702300000,NE 149,RESIDENTIAL,100300,0,100300,347578,0,447878
141712702400000,NE 149,RESIDENTIAL,10870,0,10870,0,0,10870
141712702500000,NE 149,RESIDENTIAL,75290,0,75290,212119,0,287409
141712702600000,NE 149,RESIDENTIAL,76261,0,76261,301394,0,377655
141712702800000,NE 149,RESIDENTIAL,50456,0,50456,0,0,50456
141712702900000,NE 149,RESIDENTIAL,69557,0,69557,202253,0,271810
141712703000000,NE 149,RESIDENTIAL,70331,0,70331,185027,0,255358
141712703100000,NE 149,RESIDENTIAL,39031,0,39031,234543,0,273574
141712703200000,NE 149,RESIDENTIAL,60515,0,60515,216689,0,277204
141712703300000,NE 149,RESIDENTIAL,43218,0,43218,252949,0,296167
141712703400000,NE 149,RESIDENTIAL,71176,0,71176,262349,0,333525
141712703500000,NE 149,RESIDENTIAL,69889,0,69889,233173,0,303062
141712703600000,NE 149,RESIDENTIAL,46750,0,46750,174959,0,221709
141712703700000,NE 149,RESIDENTIAL,41710,0,41710,197242,0,238952
141712703800000,NE 149,RESIDENTIAL,37632,0,37632,222069,0,259701
141712703900000,NE 149,RESIDENTIAL,36279,0,36279,180059,0,216338
141712704000000,NE 149,RESIDENTIAL,15881,0,15881,0,0,15881
141712800100000,NE 149,RESIDENTIAL,49555,0,49555,219185,0,268740
141712800200000,NE 149,RESIDENTIAL,49516,0,49516,196499,0,246015
141712800300000,NE 149,RESIDENTIAL,73901,0,73901,329147,0,403048
141712800400000,NE 149,RESIDENTIAL,74881,0,74881,316688,0,391569
141712800500000,NE 149,RESIDENTIAL,77162,0,77162,321060,0,398222
141715100100000,NE 149,RESIDENTIAL,4200,0,4200,0,0,4200
141715200100000,NE 149,RESIDENTIAL,58557,0,58557,0,0,58557
141715200200000,NE 149,RESIDENTIAL,78477,0,78477,194242,0,272719
141715300100000,CITY PROPERTY,EXEMPT,0,0,0,0,0,0
141717600300000,NE 149,RESIDENTIAL,13537,0,13537,0,0,13537
141717700100000,SHOP,COMMERCIAL,0,402497,402497,0,662630,1065127
141717700200000,FLAT PARKING,COMMERCIAL,0,8250,8250,0,9600,17850
141717700300000,WAREHOUSE,COMMERCIAL,0,131760,131760,0,352989,484749
141717700400000,WAREHOUSE,COMMERCIAL,0,30963,30963,0,109151,140114
141717800100000,FLAT PARKING,COMMERCIAL,0,1330,1330,0,0,1330
141717800200000,CITY PROPERTY,EXEMPT,0,0,0,0,0,0
141720100200000,NE 149,RESIDENTIAL,79934,0,79934,347331,0,427265
141720100300000,NE 149,RESIDENTIAL,69958,0,69958,342650,0,412608
141720100400000,NE 149,RESIDENTIAL,76425,0,76425,323465,0,399890
141720100600000,NE 149,RESIDENTIAL,118050,0,118050,456458,0,574508
141720100700000,NE 149,RESIDENTIAL,78481,0,78481,273454,0,351935
141720100900000,NE 167,RESIDENTIAL,66564,0,66564,0,0,66564
141720101000000,NE 167,RESIDENTIAL,37000,0,37000,268657,0,305657
141720101100000,NE 167,RESIDENTIAL,91550,0,91550,334188,0,425738
141720200100000,NE 167,RESIDENTIAL,27250,0,27250,0,0,27250
141720200600000,NE 167,RESIDENTIAL,74060,0,74060,0,0,74060
141720200700000,NE 167,RESIDENTIAL,70056,0,70056,0,0,70056
141720300100000,CITY PROPERTY,EXEMPT,0,0,0,0,0,0
141720300200000,CITY PROPERTY,EXEMPT,0,0,0,0,0,0
141722600100000,CITY PROPERTY,EXEMPT,0,0,0,0,0,0
141725100100000,NW 301,RESIDENTIAL,22984,0,22984,61205,0,84189
141725100200000,NW 301,RESIDENTIAL,26519,0,26519,78062,0,104581
141725100300000,NW 301,RESIDENTIAL,49980,0,49980,0,0,49980
141725100400000,CITY PROPERTY,EXEMPT,0,0,0,0,0,0
141725100500000,CITY PROPERTY,EXEMPT,0,0,0,0,0,0
141725100600000,NW 301,RESIDENTIAL,24804,0,24804,39312,0,64116
141725100700000,NW 301,RESIDENTIAL,20670,0,20670,48071,0,68741
141725100800000,NW 301,RESIDENTIAL,27904,0,27904,131922,0,159826
141725100900000,NW 301,RESIDENTIAL,27030,0,27030,96352,0,123382
141725101000000,NW 301,RESIDENTIAL,31164,0,31164,98622,0,129786
141725101100000,NW 301,RESIDENTIAL,25200,0,25200,130841,0,156041
141725101200000,CITY PROPERTY,EXEMPT,0,0,0,0,0,0
141725200100000,CITY PROPERTY,EXEMPT,0,0,0,0,0,0
141725200200000,CITY PROPERTY,EXEMPT,0,0,0,0,0,0
141725200300000,NW 303,RESIDENTIAL,18075,0,18075,198456,0,216531
141725200400000,NW 303,RESIDENTIAL,14996,0,14996,205409,0,220405
141725200500000,NW 303,RESIDENTIAL,15016,0,15016,205197,0,220213
141725200600000,NW 303,RESIDENTIAL,16988,0,16988,205714,0,222702
141725200700000,NW 303,RESIDENTIAL,17200,0,17200,204124,0,221324
141725200800000,NW 303,RESIDENTIAL,14900,0,14900,202716,0,217616
141725200900000,NW 303,RESIDENTIAL,15000,0,15000,199756,0,214756
141725201000000,NW 303,RESIDENTIAL,15000,0,15000,207882,0,222882
141725201100000,NW 303,RESIDENTIAL,15000,0,15000,204839,0,219839
141725201200000,NW 303,RESIDENTIAL,15372,0,15372,203650,0,219022
141725201300000,NW 303,RESIDENTIAL,31496,0,31496,221913,0,253409
141725201400000,NW 303,RESIDENTIAL,15123,0,15123,197714,0,212837
141725201500000,NW 303,RESIDENTIAL,21493,0,21493,189211,0,210704
141725201600000,NW 303,RESIDENTIAL,13851,0,13851,203415,0,217266
141725201700000,NW 303,RESIDENTIAL,17136,0,17136,214872,0,232008
141725201800000,NW 303,RESIDENTIAL,16560,0,16560,178129,0,194689
141725201900000,NW 303,RESIDENTIAL,24400,0,24400,198232,0,222632
141725202000000,NW 303,RESIDENTIAL,27208,0,27208,220699,0,247907
141725202100000,NW 303,RESIDENTIAL,15120,0,15120,182707,0,197827
141725202200000,NW 303,RESIDENTIAL,15120,0,15120,178972,0,194092
141725202300000,NW 303,RESIDENTIAL,15120,0,15120,201052,0,216172
141725202400000,NW 303,RESIDENTIAL,33624,0,33624,241389,0,275013
141725202500000,NW 303,RESIDENTIAL,43241,0,43241,230759,0,274000
141725202600000,NW 303,RESIDENTIAL,18364,0,18364,194713,0,213077
141725202700000,NW 301,RESIDENTIAL,38619,0,38619,146003,0,184622
141725202800000,NW 301,RESIDENTIAL,30164,0,30164,2046,0,32210
141725202900000,NW 301,RESIDENTIAL,22923,0,22923,0,0,22923
141725203000000,NW 301,RESIDENTIAL,4096,0,4096,0,0,4096
141725203100000,NW 301,RESIDENTIAL,32770,0,32770,0,0,32770
141725203200000,NW 301,RESIDENTIAL,29520,0,29520,55490,0,85010
141725203300000,NW 301,RESIDENTIAL,38376,0,38376,94569,0,132945
141725203400000,NW 301,RESIDENTIAL,29520,0,29520,81328,0,110848
141725203500000,NW 301,RESIDENTIAL,29520,0,29520,78365,0,107885
141725203600000,NW 301,RESIDENTIAL,29520,0,29520,68057,0,97577
141725203700000,NW 301,RESIDENTIAL,19344,0,19344,63385,0,82729
141725203800000,NW 301,RESIDENTIAL,17534,0,17534,0,0,17534
141725203900000,NW 301,RESIDENTIAL,31200,0,31200,95091,0,126291
141725204000000,NW 301,RESIDENTIAL,31200,0,31200,62970,0,94170
141725204100000,NW 301,RESIDENTIAL,27000,0,27000,86476,0,113476
141725204200000,NW 301,RESIDENTIAL,27000,0,27000,72477,0,99477
141725204300000,NW 301,RESIDENTIAL,18000,0,18000,55071,0,73071
141725204400000,NW 301,RESIDENTIAL,25500,0,25500,56043,0,81543
141725204500000,NW 301,RESIDENTIAL,31512,0,31512,80184,0,111696
141727600200000,CITY PROPERTY,EXEMPT,0,0,0,0,0,0
141730100100000,CITY PROPERTY,EXEMPT,0,0,0,0,0,0
141732600100000,CITY PROPERTY,EXEMPT,0,0,0,0,0,0
141735100100000,NW 307,RESIDENTIAL,42420,0,42420,187856,0,230276
141735100200000,NW 307,RESIDENTIAL,38400,0,38400,181752,0,220152
141735100300000,NW 307,RESIDENTIAL,38880,0,38880,177945,0,216825
141735100400000,NW 307,RESIDENTIAL,42000,0,42000,188527,0,230527
141735100500000,NW 307,RESIDENTIAL,42000,0,42000,156782,0,198782
141735100600000,NW 307,RESIDENTIAL,42082,0,42082,158087,0,200169
141735100700000,NW 307,RESIDENTIAL,42900,0,42900,188903,0,231803
141735100800000,NW 307,RESIDENTIAL,38720,0,38720,187057,0,225777
141735100900000,NW 307,RESIDENTIAL,37074,0,37074,226470,0,263544
141735101000000,NW 307,RESIDENTIAL,43000,0,43000,222373,0,265373
141735101100000,NW 307,RESIDENTIAL,42853,0,42853,194838,0,237691
141735101200000,NW 307,RESIDENTIAL,43860,0,43860,157338,0,201198
141735101300000,NW 307,RESIDENTIAL,33487,0,33487,157235,0,190722
141735101400000,NW 307,RESIDENTIAL,42000,0,42000,185746,0,227746
141735101500000,NW 307,RESIDENTIAL,44400,0,44400,183149,0,227549
141735101600000,NW 307,RESIDENTIAL,43700,0,43700,160524,0,204224
141735101700000,NW 307,RESIDENTIAL,37762,0,37762,193596,0,231358
141735101800000,NW 307,RESIDENTIAL,33253,0,33253,138938,0,172191
141735101900000,NW 307,RESIDENTIAL,33135,0,33135,189382,0,222517
141735102000000,NW 307,RESIDENTIAL,33018,0,33018,120392,0,153410
141735102100000,NW 307,RESIDENTIAL,33250,0,33250,134753,0,168003
141735102200000,NW 307,RESIDENTIAL,33250,0,33250,334,0,33584
141735102300000,NW 307,RESIDENTIAL,35091,0,35091,167937,0,203028
141735102400000,NW 307,RESIDENTIAL,33705,0,33705,169592,0,203297
141735102500000,NW 307,RESIDENTIAL,33063,0,33063,150311,0,183374
141735102600000,NW 307,RESIDENTIAL,39174,0,39174,164352,0,203526
141735102700000,NW 307,RESIDENTIAL,40495,0,40495,228558,0,269053
141735102800000,NW 307,RESIDENTIAL,35019,0,35019,131528,0,166547
141735102900000,NW 307,RESIDENTIAL,35280,0,35280,138739,0,174019
141735103000000,NW 307,RESIDENTIAL,33600,0,33600,150626,0,184226
141735103100000,NW 307,RESIDENTIAL,36000,0,36000,149509,0,185509
141735103200000,NW 307,RESIDENTIAL,35280,0,35280,130871,0,166151
141735200100000,NW 307,RESIDENTIAL,35496,0,35496,203833,0,239329
141735200200000,NW 307,RESIDENTIAL,33182,0,33182,135831,0,169013
141735200300000,NW 307,RESIDENTIAL,33182,0,33182,159479,0,192661
141735200400000,NW 307,RESIDENTIAL,33182,0,33182,153649,0,186831
141735200500000,NW 307,RESIDENTIAL,33182,0,33182,185556,0,218738
141735200600000,NW 307,RESIDENTIAL,35250,0,35250,161129,0,196379
141735200700000,NW 307,RESIDENTIAL,36000,0,36000,160452,0,196452
141735200800000,NW 307,RESIDENTIAL,34790,0,34790,184569,0,219359
141735200900000,NW 307,RESIDENTIAL,39608,0,39608,170418,0,210026
141735201000000,NW 307,RESIDENTIAL,38833,0,38833,170242,0,209075
141735201100000,NW 307,RESIDENTIAL,42840,0,42840,186438,0,229278
141735201200000,NW 307,RESIDENTIAL,43690,0,43690,157867,0,201557
141735201300000,NW 307,RESIDENTIAL,40899,0,40899,181177,0,222076
141735201400000,NW 307,RESIDENTIAL,36000,0,36000,160917,0,196917
141735201500000,NW 307,RESIDENTIAL,33701,0,33701,149040,0,182741
141735201600000,NW 307,RESIDENTIAL,36456,0,36456,141889,0,178345
141735201700000,NW 307,RESIDENTIAL,39675,0,39675,175502,0,215177
141735201800000,NW 307,RESIDENTIAL,38640,0,38640,167463,0,206103
141735201900000,NW 307,RESIDENTIAL,37605,0,37605,210830,0,248435
141735202000000,NW 307,RESIDENTIAL,40519,0,40519,167944,0,208463
141735202100000,NW 307,RESIDENTIAL,39958,0,39958,150120,0,190078
141735202200000,NW 307,RESIDENTIAL,35250,0,35250,126641,0,161891
141735202300000,NW 307,RESIDENTIAL,33182,0,33182,133288,0,166470
141735202400000,NW 307,RESIDENTIAL,33182,0,33182,132695,0,165877
141735202500000,NW 307,RESIDENTIAL,33182,0,33182,137490,0,170672
141735202600000,NW 307,RESIDENTIAL,33182,0,33182,128559,0,161741
141735202700000,NW 307,RESIDENTIAL,35496,0,35496,129605,0,165101
141735300100000,NW 307,RESIDENTIAL,35203,0,35203,124101,0,159304
141735300200000,NW 307,RESIDENTIAL,34560,0,34560,140659,0,175219
141735300300000,NW 307,RESIDENTIAL,34560,0,34560,135304,0,169864
141735300400000,NW 307,RESIDENTIAL,35520,0,35520,154625,0,190145
141735300500000,NW 307,RESIDENTIAL,33600,0,33600,142511,0,176111
141735300600000,NW 307,RESIDENTIAL,34560,0,34560,159816,0,194376
141735300700000,NW 307,RESIDENTIAL,34560,0,34560,175977,0,210537
141735300800000,NW 307,RESIDENTIAL,34560,0,34560,173500,0,208060
141735300900000,NW 307,RESIDENTIAL,34560,0,34560,183129,0,217689
141735301000000,NW 307,RESIDENTIAL,34560,0,34560,180888,0,215448
141735301100000,NW 307,RESIDENTIAL,34610,0,34610,151179,0,185789
141740200200000,CITY PROPERTY,EXEMPT,0,0,0,0,0,0
141745100100000,NW 310,RESIDENTIAL,47940,0,47940,34098,0,82038
141745100200000,NW 310,RESIDENTIAL,31706,0,31706,43210,0,74916
141745100300000,CITY PROPERTY,EXEMPT,0,0,0,0,0,0
141745100400000,CITY PROPERTY,EXEMPT,0,0,0,0,0,0
141745100500000,CITY PROPERTY,EXEMPT,0,0,0,0,0,0
141745100600000,CITY PROPERTY,EXEMPT,0,0,0,0,0,0
141745100700000,NW 310,RESIDENTIAL,59580,0,59580,83177,0,142757
141745100800000,NW 310,RESIDENTIAL,35575,0,35575,0,0,35575
141745100900000,NW 310,RESIDENTIAL,37260,0,37260,59580,0,96840
141745101000000,NW 310,RESIDENTIAL,48400,0,48400,76966,0,125366
141745101100000,NW 310,RESIDENTIAL,36300,0,36300,48398,0,84698
141745101200000,NW 310,RESIDENTIAL,35392,0,35392,64663,0,100055
141745101300000,NW 310,RESIDENTIAL,45375,0,45375,60113,0,105488
141745101400000,NW 310,RESIDENTIAL,51750,0,51750,36723,0,88473
141745101500000,NW 310,RESIDENTIAL,17496,0,17496,49377,0,66873
141745200100000,CITY PROPERTY,EXEMPT,0,0,0,0,0,0
141745200200000,CITY PROPERTY,EXEMPT,0,0,0,0,0,0
141745200300000,NW 310,RESIDENTIAL,15525,0,15525,56901,0,72426
141745200400000,CITY PROPERTY,EXEMPT,0,0,0,0,0,0
141745200700000,CITY PROPERTY,EXEMPT,0,0,0,0,0,0
141745200800000,CITY PROPERTY,EXEMPT,0,0,0,0,0,0
141745200900000,CITY PROPERTY,EXEMPT,0,0,0,0,0,0
141745201000000,CITY PROPERTY,EXEMPT,0,0,0,0,0,0
141745201100000,CITY PROPERTY,EXEMPT,0,0,0,0,0,0
141745201200000,CITY PROPERTY,EXEMPT,0,0,0,0,0,0
141745201300000,NW 310,RESIDENTIAL,17284,0,17284,45119,0,62403
141745201400000,CITY PROPERTY,EXEMPT,0,0,0,0,0,0
141745201500000,CITY PROPERTY,EXEMPT,0,0,0,0,0,0
141745201700000,NW 310,RESIDENTIAL,22583,0,22583,0,0,22583
141745201800000,NW 310,AG LAND,974,0,974,0,60679,61653
141745201900000,NW 310,RESIDENTIAL,19438,0,19438,52242,0,71680
141745202000000,NW 310,RESIDENTIAL,16078,0,16078,55816,0,71894
141745202100000,CITY PROPERTY,EXEMPT,0,0,0,0,0,0
141745202200000,NW 310,RESIDENTIAL,11640,0,11640,61704,0,73344
141745202300000,CITY PROPERTY,EXEMPT,0,0,0,0,0,0
141745202400000,CITY PROPERTY,EXEMPT,0,0,0,0,0,0
141745202500000,NW 310,RESIDENTIAL,12076,0,12076,46006,0,58082
141745202600000,NW 310,RESIDENTIAL,12885,0,12885,45724,0,58609
141745202700000,NW 310,RESIDENTIAL,12611,0,12611,37240,0,49851
141745202800000,NW 310,AG LAND,256,0,256,0,0,256
141745300100000,CITY PROPERTY,EXEMPT,0,0,0,0,0,0
141745300200000,CITY PROPERTY,EXEMPT,0,0,0,0,0,0
141745300300000,NW 310,RESIDENTIAL,26250,0,26250,88480,0,114730
141745300400000,NW 310,RESIDENTIAL,25220,0,25220,103172,0,128392
141745300500000,CITY PROPERTY,EXEMPT,0,0,0,0,0,0
141745300600000,CITY PROPERTY,EXEMPT,0,0,0,0,0,0
141745300700000,CITY PROPERTY,EXEMPT,0,0,0,0,0,0
141745300800000,CITY PROPERTY,EXEMPT,0,0,0,0,0,0
141745300900000,CITY PROPERTY,EXEMPT,0,0,0,0,0,0
141745301000000,CITY PROPERTY,EXEMPT,0,0,0,0,0,0
141745301100000,CITY PROPERTY,EXEMPT,0,0,0,0,0,0
141745301200000,CITY PROPERTY,EXEMPT,0,0,0,0,0,0
141745301300000,CITY PROPERTY,EXEMPT,0,0,0,0,0,0
141745301400000,NW 310,RESIDENTIAL,19594,0,19594,0,0,19594
141745301500000,CITY PROPERTY,EXEMPT,0,0,0,0,0,0
141745301600000,CITY PROPERTY,EXEMPT,0,0,0,0,0,0
141745301700000,NW 310,RESIDENTIAL,18750,0,18750,37116,0,55866
141747600100000,CITY PROPERTY,EXEMPT,0,0,0,0,0,0
141747600200000,CITY PROPERTY,EXEMPT,0,0,0,0,0,0
141747600300000,NW 310,RESIDENTIAL,39487,0,39487,54246,0,93733
141747600400000,CITY PROPERTY,EXEMPT,0,0,0,0,0,0
141747600500000,CITY PROPERTY,EXEMPT,0,0,0,0,0,0
141747600600000,NW 310,RESIDENTIAL,68005,0,68005,86330,0,154335
141810100100000,CITY PROPERTY,EXEMPT,0,0,0,0,0,0
141810100200000,APARTMENT,COMMERCIAL,0,745500,745500,0,4582305,5327805
141810300100000,APARTMENT,COMMERCIAL,0,134750,134750,0,2991477,3126227
141812600100000,APARTMENT,COMMERCIAL,0,25250,25250,0,391967,417217
141812600200000,APARTMENT,COMMERCIAL,0,188500,188500,0,4904800,5093300
141812600300000,APARTMENT,COMMERCIAL,0,161500,161500,0,5947580,6109080
141815100100000,NW 303,RESIDENTIAL,35280,0,35280,106105,0,141385
141815100200000,NW 303,RESIDENTIAL,13621,0,13621,79206,0,92827
141815100300000,NW 303,RESIDENTIAL,12736,0,12736,67971,0,80707
141815100400000,NW 303,RESIDENTIAL,13314,0,13314,73061,0,86375
141815100500000,NW 303,RESIDENTIAL,12582,0,12582,96770,0,109352
141815100600000,NW 303,RESIDENTIAL,12867,0,12867,102234,0,115101
141815100700000,NW 303,RESIDENTIAL,12977,0,12977,100561,0,113538
141815100800000,NW 303,RESIDENTIAL,12813,0,12813,100907,0,113720
141815100900000,NW 303,RESIDENTIAL,13031,0,13031,100576,0,113607
141815101000000,NW 303,RESIDENTIAL,16124,0,16124,106584,0,122708
141815101100000,NW 303,RESIDENTIAL,15882,0,15882,106373,0,122255
141815101200000,NW 303,RESIDENTIAL,13711,0,13711,117243,0,130954
141815101300000,NW 303,RESIDENTIAL,15863,0,15863,110007,0,125870
141815101400000,NW 303,RESIDENTIAL,31866,0,31866,154840,0,186706
141815101500000,NW 303,RESIDENTIAL,31220,0,31220,155776,0,186996
141815101600000,NW 303,RESIDENTIAL,14087,0,14087,138083,0,152170
141815101700000,NW 303,RESIDENTIAL,14193,0,14193,131204,0,145397
141815101800000,NW 303,RESIDENTIAL,25099,0,25099,112134,0,137233
141815101900000,NW 303,RESIDENTIAL,25099,0,25099,107602,0,132701
141815102000000,NW 303,RESIDENTIAL,25071,0,25071,61307,0,86378
141815102100000,NW 303,RESIDENTIAL,25099,0,25099,117831,0,142930
141815102200000,NW 303,RESIDENTIAL,26247,0,26247,113169,0,139416
141815102300000,NW 303,RESIDENTIAL,26628,0,26628,98038,0,124666
141815102400000,NW 303,RESIDENTIAL,24948,0,24948,121426,0,146374
141815102500000,NW 303,RESIDENTIAL,24948,0,24948,133867,0,158815
141815102600000,NW 303,RESIDENTIAL,24948,0,24948,121717,0,146665
141815102700000,NW 303,RESIDENTIAL,24948,0,24948,117858,0,142806
141815102800000,NW 303,RESIDENTIAL,24896,0,24896,131999,0,156895
141815102900000,NW 303,RESIDENTIAL,28597,0,28597,131764,0,160361
141815103000000,NW 303,RESIDENTIAL,29135,0,29135,146927,0,176062
141815103100000,NW 303,RESIDENTIAL,26371,0,26371,132117,0,158488
141815103200000,NW 303,RESIDENTIAL,27016,0,27016,129595,0,156611
141815103300000,NW 303,RESIDENTIAL,25778,0,25778,159552,0,185330
141815103400000,NW 303,RESIDENTIAL,27210,0,27210,145220,0,172430
141815103500000,NW 303,RESIDENTIAL,25724,0,25724,123225,0,148949
141815103600000,NW 303,RESIDENTIAL,27939,0,27939,67418,0,95357
141815103700000,NW 303,RESIDENTIAL,29106,0,29106,51469,0,80575
141815103800000,NW 303,RESIDENTIAL,29106,0,29106,3018,0,32124
141815103900000,NW 303,RESIDENTIAL,28350,0,28350,169229,0,197579
141815104000000,NW 303,RESIDENTIAL,26460,0,26460,169749,0,196209
141815104100000,NW 303,RESIDENTIAL,26460,0,26460,174689,0,201149
141815104200000,NW 303,RESIDENTIAL,26119,0,26119,187333,0,213452
141815104300000,NW 303,RESIDENTIAL,30686,0,30686,187078,0,217764
141815104400000,NW 303,RESIDENTIAL,21840,0,21840,34805,0,56645
141815104500000,NW 303,RESIDENTIAL,33843,0,33843,166528,0,200371
141815104600000,NW 303,RESIDENTIAL,33509,0,33509,274610,0,308119
141815104700000,NW 303,RESIDENTIAL,30205,0,30205,158776,0,188981
141815104800000,NW 303,RESIDENTIAL,26095,0,26095,183224,0,209319
141815104900000,NW 303,RESIDENTIAL,26460,0,26460,192434,0,218894
141815105000000,NW 303,RESIDENTIAL,26460,0,26460,159622,0,186082
141815105100000,NW 303,RESIDENTIAL,28350,0,28350,151835,0,180185
141815105200000,NW 303,RESIDENTIAL,63150,0,63150,84541,0,147691
141815105300000,CITY PROPERTY,EXEMPT,0,0,0,0,0,0
141817600100000,CITY PROPERTY,EXEMPT,0,0,0,0,0,0
141820100100000,ANTENNAS/TOWERS(BLL),COMMERCIAL,0,42955,42955,0,45112,88067
141820100200000,CITY PROPERTY,EXEMPT,0,0,0,0,0,0
141820200700000,SCHOOL,EXEMPT,0,0,0,0,0,0
141820300100000,NW 302,RESIDENTIAL,63200,0,63200,59512,0,122712
141822600100000,CITY PROPERTY,EXEMPT,0,0,0,0,0,0
141822600200000,NW 302,RESIDENTIAL,5000,0,5000,0,0,5000
141822600300000,NW 302,RESIDENTIAL,48624,0,48624,120744,0,169368
141822600400000,CITY PROPERTY,EXEMPT,0,0,0,0,0,0
141822600500000,CITY PROPERTY,EXEMPT,0,0,0,0,0,0
141822600700000,CITY PROPERTY,EXEMPT,0,0,0,0,0,0
141822700200000,NW 302,RESIDENTIAL,37537,0,37537,0,0,37537
141822700300000,NW 302,RESIDENTIAL,15889,0,15889,66217,0,82106
141822800100000,CITY PROPERTY,EXEMPT,0,0,0,0,0,0
141825100700000,NW 302,AG LAND,2612,0,2612,0,0,2612
141825100800000,NW 302,RESIDENTIAL,5550,0,5550,0,0,5550
141825101000000,NW 302,RESIDENTIAL,61162,0,61162,282627,0,343789
141825101500000,NW 302,RESIDENTIAL,45920,0,45920,0,0,45920
141825101600000,NW 302,RESIDENTIAL,50260,0,50260,0,0,50260
141825101700000,NW 302,RESIDENTIAL,36260,0,36260,6744,0,43004
141825101800000,NW 302,RESIDENTIAL,2720,0,2720,0,0,2720
141825200100000,NW 302,RESIDENTIAL,46480,0,46480,0,0,46480
141825200200000,NW 302,RESIDENTIAL,9520,0,9520,0,0,9520
141825200300000,NW 302,RESIDENTIAL,47460,0,47460,0,0,47460
141825200400000,NW 302,RESIDENTIAL,54460,0,54460,0,0,54460
141825200500000,NW 302,RESIDENTIAL,9440,0,9440,0,0,9440
141825300100000,NW 302,RESIDENTIAL,1000,0,1000,0,0,1000
141827600100000,NW 302,RESIDENTIAL,42728,0,42728,104530,0,147258
141827600200000,NW 302,RESIDENTIAL,27846,0,27846,127154,0,155000
141827600500000,CHURCH,EXEMPT,0,228000,228000,0,751017,979017
141827600600000,CHURCH,EXEMPT,0,508248,508248,0,620802,1129050
141827700500000,CHURCH,EXEMPT,0,403040,403040,0,456098,859138
141827800100000,VACANT LAND,EXEMPT,0,27840,27840,0,0,27840
141830100100000,NW 308,RESIDENTIAL,16913,0,16913,100402,0,117315
141830100200000,NW 308,RESIDENTIAL,17820,0,17820,116189,0,134009
141830100300000,NW 308,RESIDENTIAL,17531,0,17531,126661,0,144192
141830100400000,NW 302,RESIDENTIAL,60650,0,60650,61638,0,122288
141830100500000,NW 308,RESIDENTIAL,17093,0,17093,100100,0,117193
141830100600000,NW 308,RESIDENTIAL,17820,0,17820,128642,0,146462
141830100700000,NW 308,RESIDENTIAL,19883,0,19883,112702,0,132585
141830100800000,NW 308,RESIDENTIAL,22035,0,22035,104632,0,126667
141830200100000,APARTMENT,RESIDENTIAL,437760,0,437760,2183504,0,2621264
141830200200000,VACANT LAND,COMMERCIAL,0,44400,44400,0,0,44400
141830200500000,NW 302,RESIDENTIAL,53950,0,53950,0,0,53950
141830200600000,NW 302,RESIDENTIAL,55950,0,55950,0,0,55950
141830300100000,NW 308,RESIDENTIAL,22685,0,22685,113014,0,135699
141830300200000,NW 308,RESIDENTIAL,21153,0,21153,102838,0,123991
141832600400000,NW 302,AG LAND,25827,0,25827,0,0,25827
141832600500000,NW 302,RESIDENTIAL,58450,0,58450,0,0,58450
141835100100000,NW 302,RESIDENTIAL,62500,0,62500,0,0,62500
141835100400000,NW 302,RESIDENTIAL,30900,0,30900,80479,0,111379
141835100500000,NW 302,RESIDENTIAL,88000,0,88000,0,0,88000
141835100600000,NW 302,RESIDENTIAL,112500,0,112500,54520,0,167020
141835200100000,NW 308,RESIDENTIAL,72000,0,72000,0,0,72000
141835200200000,NW 308,RESIDENTIAL,65250,0,65250,168648,0,233898
141837600200000,NW 336,RESIDENTIAL,30080,0,30080,219882,0,249962
141837600300000,NW 336,RESIDENTIAL,34881,0,34881,244358,0,279239
141837600400000,NW 336,RESIDENTIAL,40950,0,40950,175619,0,216569
141837600500000,NW 336,RESIDENTIAL,37120,0,37120,192420,0,229540
141837600600000,NW 336,RESIDENTIAL,39353,0,39353,217471,0,256824
141837600700000,NW 336,RESIDENTIAL,42000,0,42000,257718,0,299718
141837600800000,NW 336,RESIDENTIAL,43600,0,43600,207287,0,250887
141837600900000,NW 336,RESIDENTIAL,41600,0,41600,245633,0,287233
141837601000000,NW 336,RESIDENTIAL,43661,0,43661,231946,0,275607
141837601100000,NW 336,RESIDENTIAL,41853,0,41853,194203,0,236056
141837601200000,NW 336,RESIDENTIAL,40511,0,40511,189349,0,229860
141837601300000,NW 336,RESIDENTIAL,40614,0,40614,223365,0,263979
141837601400000,NW 308,RESIDENTIAL,27560,0,27560,142721,0,170281
141837601500000,NW 308,RESIDENTIAL,24681,0,24681,157957,0,182638
141837601600000,NW 308,RESIDENTIAL,25433,0,25433,152457,0,177890
141837601700000,NW 308,RESIDENTIAL,25373,0,25373,138826,0,164199
141837601800000,NW 308,RESIDENTIAL,26640,0,26640,138811,0,165451
141837602000000,NW 308,RESIDENTIAL,25620,0,25620,144298,0,169918
141837602100000,NW 308,RESIDENTIAL,24240,0,24240,157760,0,182000
141837602200000,NW 308,RESIDENTIAL,7550,0,7550,0,0,7550
141837602300000,NW 308,RESIDENTIAL,2550,0,2550,0,0,2550
141837602400000,NW 308,RESIDENTIAL,1150,0,1150,0,0,1150
141837602500000,NW 308,RESIDENTIAL,1150,0,1150,0,0,1150
141837602600000,NW 308,RESIDENTIAL,1100,0,1100,0,0,1100
141837602700000,NW 308,RESIDENTIAL,1150,0,1150,0,0,1150
141837602800000,NW 308,RESIDENTIAL,1350,0,1350,0,0,1350
141837602900000,NW 308,RESIDENTIAL,1100,0,1100,0,0,1100
141837603000000,NW 308,RESIDENTIAL,1150,0,1150,0,0,1150
141837603100000,NW 308,RESIDENTIAL,450,0,450,0,0,450
141837603200000,NW 308,RESIDENTIAL,1150,0,1150,0,0,1150
141837603300000,NW 308,RESIDENTIAL,3600,0,3600,0,0,3600
141837700100000,NW 336,RESIDENTIAL,39672,0,39672,189288,0,228960
141837700200000,NW 336,RESIDENTIAL,35774,0,35774,189992,0,225766
141837700300000,NW 336,RESIDENTIAL,52257,0,52257,227859,0,280116
141837700600000,NW 336,RESIDENTIAL,31838,0,31838,189755,0,221593
141837700700000,NW 336,RESIDENTIAL,38056,0,38056,227579,0,265635
141837700800000,NW 336,RESIDENTIAL,37760,0,37760,174340,0,212100
141837700900000,NW 336,RESIDENTIAL,35520,0,35520,258900,0,294420
141837701000000,NW 336,RESIDENTIAL,36469,0,36469,174517,0,210986
141837701100000,NW 336,RESIDENTIAL,38160,0,38160,213640,0,251800
141837701200000,NW 308,RESIDENTIAL,26752,0,26752,138345,0,165097
141837701300000,NW 308,RESIDENTIAL,27084,0,27084,145726,0,172810
141837701400000,NW 308,RESIDENTIAL,26108,0,26108,131460,0,157568
141837701500000,NW 308,RESIDENTIAL,24480,0,24480,131317,0,155797
141837701600000,NW 308,RESIDENTIAL,24888,0,24888,131635,0,156523
141837701700000,NW 308,RESIDENTIAL,21063,0,21063,131635,0,152698
141837701800000,NW 308,RESIDENTIAL,29120,0,29120,139891,0,169011
141837900100000,NW 336,RESIDENTIAL,44182,0,44182,272398,0,316580
141837900200000,NW 336,RESIDENTIAL,42457,0,42457,243454,0,285911
141837900300000,NW 336,RESIDENTIAL,47092,0,47092,245676,0,292768
141837900400000,NW 336,RESIDENTIAL,44502,0,44502,0,0,44502
141837900500000,NW 336,RESIDENTIAL,42000,0,42000,209450,0,251450
141837900600000,NW 336,RESIDENTIAL,40400,0,40400,229396,0,269796
141837900700000,NW 336,RESIDENTIAL,38400,0,38400,217285,0,255685
141837900800000,NW 336,RESIDENTIAL,35374,0,35374,209683,0,245057
141837900900000,NW 336,RESIDENTIAL,34651,0,34651,174104,0,208755
141837901000000,NW 336,RESIDENTIAL,33728,0,33728,153607,0,187335
141837901100000,NW 308,RESIDENTIAL,28080,0,28080,125156,0,153236
141837901200000,NW 308,RESIDENTIAL,29600,0,29600,115599,0,145199
141837901300000,NW 308,RESIDENTIAL,31169,0,31169,120900,0,152069
141837901400000,NW 308,RESIDENTIAL,31435,0,31435,114816,0,146251
141837901500000,NW 308,RESIDENTIAL,31435,0,31435,127952,0,159387
141837901600000,NW 308,RESIDENTIAL,31702,0,31702,135708,0,167410
141837901700000,NW 308,RESIDENTIAL,32396,0,32396,131525,0,163921
141837901800000,NW 308,RESIDENTIAL,34432,0,34432,137839,0,172271
141837901900000,NW 308,RESIDENTIAL,31181,0,31181,127649,0,158830
141837902000000,NW 308,RESIDENTIAL,33012,0,33012,109789,0,142801
141838000100000,NW 336,RESIDENTIAL,31590,0,31590,166283,0,197873
141838000200000,NW 336,RESIDENTIAL,36987,0,36987,235130,0,272117
141838000300000,NW 336,RESIDENTIAL,36160,0,36160,218976,0,255136
141838000400000,NW 336,RESIDENTIAL,35840,0,35840,253922,0,289762
141838000500000,NW 336,RESIDENTIAL,35200,0,35200,232540,0,267740
141838000600000,NW 336,RESIDENTIAL,34240,0,34240,207971,0,242211
141838000700000,NW 308,RESIDENTIAL,31528,0,31528,124063,0,155591
141838000800000,NW 308,RESIDENTIAL,31386,0,31386,119191,0,150577
141838000900000,NW 308,RESIDENTIAL,33601,0,33601,109039,0,142640
141838001000000,NW 308,RESIDENTIAL,31793,0,31793,114771,0,146564
141838001100000,NW 308,RESIDENTIAL,27930,0,27930,111067,0,138997
141838001200000,NW 308,RESIDENTIAL,27930,0,27930,109607,0,137537
141838001300000,NW 308,RESIDENTIAL,27664,0,27664,113262,0,140926
141838001400000,NW 308,RESIDENTIAL,27664,0,27664,130959,0,158623
141838100100000,NW 308,RESIDENTIAL,28310,0,28310,116441,0,144751
141838100200000,NW 308,RESIDENTIAL,27720,0,27720,111816,0,139536
141838100300000,NW 308,RESIDENTIAL,28642,0,28642,140072,0,168714
141838100400000,NW 308,RESIDENTIAL,27751,0,27751,127446,0,155197
141838100500000,NW 308,RESIDENTIAL,26836,0,26836,137460,0,164296
141838100600000,NW 308,RESIDENTIAL,27424,0,27424,127207,0,154631
141838100700000,NW 308,RESIDENTIAL,27941,0,27941,122917,0,150858
141838100800000,NW 308,RESIDENTIAL,26928,0,26928,135830,0,162758
141840100200000,NW 302,RESIDENTIAL,38145,0,38145,60174,0,98319
141840100500000,NW 307,RESIDENTIAL,37972,0,37972,126951,0,164923
141840100600000,NW 307,RESIDENTIAL,37500,0,37500,145827,0,183327
141840100700000,NW 307,RESIDENTIAL,37500,0,37500,137070,0,174570
141840100800000,NW 307,RESIDENTIAL,37500,0,37500,119987,0,157487
141840100900000,NW 307,RESIDENTIAL,30,0,30,0,0,30
141840101000000,NW 307,RESIDENTIAL,44362,0,44362,144580,0,188942
141840101100000,NW 307,RESIDENTIAL,52306,0,52306,210643,0,262949
141840101200000,NW 307,RESIDENTIAL,56169,0,56169,185063,0,241232
141840101300000,NW 307,RESIDENTIAL,40953,0,40953,185213,0,226166
141840101400000,NW 307,RESIDENTIAL,44921,0,44921,198625,0,243546
141840101500000,NW 307,RESIDENTIAL,45949,0,45949,156676,0,202625
141840101600000,NW 307,RESIDENTIAL,44780,0,44780,202771,0,247551
141840101700000,CITY PROPERTY,EXEMPT,0,0,0,0,0,0
141840102100000,CITY PROPERTY,EXEMPT,0,0,0,0,0,0
141840102200000,NW 302,RESIDENTIAL,42542,0,42542,139219,0,181761
141840102300000,NW 302,RESIDENTIAL,42542,0,42542,142726,0,185268
141840102400000,NW 302,RESIDENTIAL,103520,0,103520,178999,0,282519
141840102500000,NW 302,RESIDENTIAL,54900,0,54900,113404,0,168304
141840102600000,NW 302,RESIDENTIAL,136572,0,136572,151879,0,288451
141840200100000,NW 302,RESIDENTIAL,25658,0,25658,135810,0,161468
141840200200000,NW 302,RESIDENTIAL,66500,0,66500,138736,0,205236
141840200400000,NW 302,RESIDENTIAL,40700,0,40700,179613,0,220313
141840200700000,NW 302,RESIDENTIAL,64700,0,64700,165072,0,229772
141840200800000,NW 302,RESIDENTIAL,22275,0,22275,58166,0,80441
141840200900000,NW 302,RESIDENTIAL,22846,0,22846,93434,0,116280
141840201000000,NW 302,RESIDENTIAL,24481,0,24481,112381,0,136862
141840201100000,NW 302,RESIDENTIAL,24480,0,24480,112861,0,137341
141840201200000,NW 302,RESIDENTIAL,26010,0,26010,93447,0,119457
141840201300000,NW 302,RESIDENTIAL,21925,0,21925,0,0,21925
141840201400000,NW 302,RESIDENTIAL,21925,0,21925,0,0,21925
141840201500000,NW 302,RESIDENTIAL,20932,0,20932,0,0,20932
141840201600000,NW 302,RESIDENTIAL,20163,0,20163,0,0,20163
141840201700000,NW 302,RESIDENTIAL,20163,0,20163,0,0,20163
141840201800000,NW 302,RESIDENTIAL,41825,0,41825,86461,0,128286
141840300100000,NW 307,RESIDENTIAL,46200,0,46200,173074,0,219274
141840300200000,NW 307,RESIDENTIAL,42435,0,42435,171856,0,214291
141840300300000,NW 307,RESIDENTIAL,41073,0,41073,160011,0,201084
141840300400000,NW 307,RESIDENTIAL,41600,0,41600,169559,0,211159
141840300500000,NW 307,RESIDENTIAL,43926,0,43926,168630,0,212556
141840300600000,NW 307,RESIDENTIAL,43926,0,43926,174354,0,218280
141840300700000,NW 307,RESIDENTIAL,41597,0,41597,180465,0,222062
141840300800000,NW 307,RESIDENTIAL,40484,0,40484,158414,0,198898
141840400100000,NW 307,RESIDENTIAL,38368,0,38368,182264,0,220632
141840400200000,NW 307,RESIDENTIAL,37500,0,37500,158497,0,195997
141840400300000,NW 307,RESIDENTIAL,35250,0,35250,160962,0,196212
141840400400000,NW 307,RESIDENTIAL,37296,0,37296,128794,0,166090
141840400500000,NW 307,RESIDENTIAL,42405,0,42405,163650,0,206055
141840400600000,NW 307,RESIDENTIAL,42638,0,42638,202471,0,245109
141842600200000,NW 302,RESIDENTIAL,34560,0,34560,47460,0,82020
141842600300000,NW 302,RESIDENTIAL,21120,0,21120,0,0,21120
141842600400000,NW 302,RESIDENTIAL,71200,0,71200,39674,0,110874
141842600500000,NW 302,RESIDENTIAL,35174,0,35174,62558,0,97732
141842600600000,NW 302,RESIDENTIAL,54516,0,54516,120495,0,175011
141842600700000,NW 308,RESIDENTIAL,30408,0,30408,127611,0,158019
141842600800000,NW 308,RESIDENTIAL,30359,0,30359,140310,0,170669
141842600900000,NW 308,RESIDENTIAL,33395,0,33395,210110,0,243505
141842601000000,NW 308,RESIDENTIAL,33395,0,33395,195514,0,228909
141842601100000,NW 308,RESIDENTIAL,33275,0,33275,207792,0,241067
141842601200000,NW 308,RESIDENTIAL,48400,0,48400,252597,0,300997
141842601300000,NW 308,RESIDENTIAL,72350,0,72350,86968,0,159318
141842601400000,NW 352,RESIDENTIAL,41305,0,41305,127464,0,168769
141842601500000,SECTION 42,RESIDENTIAL,5800,0,5800,23861,0,29661
141842601600000,SECTION 42,RESIDENTIAL,5922,0,5922,23861,0,29783
141842601700000,NW 352,RESIDENTIAL,180,0,180,0,0,180
141842601800000,NW 352,RESIDENTIAL,225,0,225,0,0,225
141842601900000,NW 352,RESIDENTIAL,332,0,332,0,0,332
141842602000000,NW 352,RESIDENTIAL,250,0,250,0,0,250
141842602100000,NW 352,RESIDENTIAL,180,0,180,0,0,180
141842602200000,NW 352,RESIDENTIAL,151,0,151,0,0,151
141842602300000,NW 352,RESIDENTIAL,127,0,127,0,0,127
141842602400000,NW 352,RESIDENTIAL,127,0,127,0,0,127
141842602500000,SECTION 42,RESIDENTIAL,6157,0,6157,25298,0,31455
141842602600000,SECTION 42,RESIDENTIAL,6204,0,6204,25298,0,31502
141842602700000,SECTION 42,RESIDENTIAL,6204,0,6204,25298,0,31502
141842602800000,NW 352,RESIDENTIAL,128,0,128,0,0,128
141842602900000,NW 352,RESIDENTIAL,129,0,129,0,0,129
141842603000000,NW 352,RESIDENTIAL,129,0,129,0,0,129
141842603100000,NW 352,RESIDENTIAL,129,0,129,0,0,129
141842603200000,NW 352,RESIDENTIAL,132,0,132,0,0,132
141842603300000,NW 352,RESIDENTIAL,140,0,140,0,0,140
141842603400000,NW 352,RESIDENTIAL,143,0,143,0,0,143
141842603500000,NW 352,RESIDENTIAL,148,0,148,0,0,148
141842603600000,NW 352,RESIDENTIAL,185,0,185,0,0,185
141842603700000,NW 352,RESIDENTIAL,220,0,220,0,0,220
141842603800000,NW 352,RESIDENTIAL,305,0,305,0,0,305
141842603900000,NW 352,RESIDENTIAL,337,0,337,0,0,337
141842604000000,NW 352,RESIDENTIAL,220,0,220,0,0,220
141842604100000,NW 352,RESIDENTIAL,170,0,170,0,0,170
141842604500000,NW 302,AG LAND,6539,0,6539,0,0,6539
141842800100000,SECTION 42,RESIDENTIAL,7096,0,7096,24292,0,31388
141842800200000,SECTION 42,RESIDENTIAL,6237,0,6237,24293,0,30530
141842800300000,SECTION 42,RESIDENTIAL,5875,0,5875,24579,0,30454
141842800400000,SECTION 42,RESIDENTIAL,6519,0,6519,23861,0,30380
141842800500000,SECTION 42,RESIDENTIAL,6251,0,6251,24579,0,30830
141842800600000,SECTION 42,RESIDENTIAL,6157,0,6157,23861,0,30018
141842800700000,SECTION 42,RESIDENTIAL,6251,0,6251,25897,0,32148
141842800800000,NW 352,RESIDENTIAL,132,0,132,0,0,132
141842800900000,NW 352,RESIDENTIAL,25284,0,25284,143306,0,168590
141842801000000,NW 352,RESIDENTIAL,29700,0,29700,151201,0,180901
141842801100000,NW 352,RESIDENTIAL,35511,0,35511,149476,0,184987
141842801200000,SECTION 42,RESIDENTIAL,5969,0,5969,23861,0,29830
141842801300000,SECTION 42,RESIDENTIAL,6157,0,6157,23861,0,30018
141842801400000,SECTION 42,RESIDENTIAL,6345,0,6345,24579,0,30924
141842801500000,SECTION 42,RESIDENTIAL,6392,0,6392,24579,0,30971
141842801800000,SECTION 42,RESIDENTIAL,5805,0,5805,24580,0,30385
141842801900000,SECTION 42,RESIDENTIAL,5642,0,5642,24580,0,30222
141842802000000,SECTION 42,RESIDENTIAL,5129,0,5129,24293,0,29422
141842802100000,SECTION 42,RESIDENTIAL,6292,0,6292,24293,0,30585
141842900500000,NW 352,RESIDENTIAL,199,0,199,0,0,199
141842900600000,NW 352,RESIDENTIAL,133,0,133,0,0,133
141842900800000,NW 352,RESIDENTIAL,120,0,120,0,0,120
141842900900000,NW 352,RESIDENTIAL,123,0,123,0,0,123
141842901000000,NW 352,RESIDENTIAL,118,0,118,0,0,118
141842901200000,NW 352,RESIDENTIAL,136,0,136,0,0,136
141842901300000,NW 352,RESIDENTIAL,120,0,120,0,0,120
141842901400000,NW 352,RESIDENTIAL,28944,0,28944,145149,0,174093
141842901500000,NW 352,RESIDENTIAL,31072,0,31072,145739,0,176811
141842901600000,NW 352,RESIDENTIAL,27048,0,27048,143113,0,170161
141842901700000,NW 352,RESIDENTIAL,98,0,98,0,0,98
141842901800000,NW 352,RESIDENTIAL,116,0,116,0,0,116
141842901900000,NW 352,RESIDENTIAL,162,0,162,0,0,162
141842902000000,NW 352,RESIDENTIAL,169,0,169,0,0,169
141842902100000,NW 352,RESIDENTIAL,32352,0,32352,144705,0,177057
141842902200000,NW 352,RESIDENTIAL,31200,0,31200,145062,0,176262
141842902300000,NW 352,RESIDENTIAL,30000,0,30000,148319,0,178319
141842902400000,NW 352,RESIDENTIAL,30000,0,30000,151372,0,181372
141842902500000,NW 352,RESIDENTIAL,30000,0,30000,146595,0,176595
141842902600000,NW 352,RESIDENTIAL,30000,0,30000,148594,0,178594
141842902700000,NW 352,RESIDENTIAL,30000,0,30000,150297,0,180297
141842902800000,NW 352,RESIDENTIAL,30000,0,30000,132434,0,162434
141842902900000,NW 352,RESIDENTIAL,30000,0,30000,139714,0,169714
141842903000000,NW 352,RESIDENTIAL,30000,0,30000,144178,0,174178
141842903100000,NW 352,RESIDENTIAL,129,0,129,0,0,129
141842903200000,NW 302,AG LAND,1998,0,1998,0,0,1998
141842903300000,NW 352,RESIDENTIAL,134,0,134,0,0,134
141842903500000,NW 352,RESIDENTIAL,165,0,165,0,0,165
141842903700000,NW 352,RESIDENTIAL,35564,0,35564,127449,0,163013
141842903900000,NW 352,RESIDENTIAL,35853,0,35853,127449,0,163302
141845100100000,NW 352,RESIDENTIAL,155000,0,155000,0,0,155000
141845100300000,NW 302,RESIDENTIAL,155000,0,155000,123582,0,278582
141847600200000,NW 307,RESIDENTIAL,51208,0,51208,135020,0,186228
141847600300000,NW 307,RESIDENTIAL,42287,0,42287,212893,0,255180
141847600400000,NW 307,RESIDENTIAL,40112,0,40112,166444,0,206556
141847600500000,NW 307,RESIDENTIAL,41463,0,41463,176906,0,218369
141847600700000,NW 308,RESIDENTIAL,21645,0,21645,110091,0,131736
141847600800000,NW 308,RESIDENTIAL,32350,0,32350,100925,0,133275
141847600900000,NW 308,RESIDENTIAL,30525,0,30525,86862,0,117387
141847601000000,NW 308,RESIDENTIAL,27540,0,27540,114504,0,142044
141847601100000,NW 308,RESIDENTIAL,22530,0,22530,131300,0,153830
141847601200000,NW 308,RESIDENTIAL,27631,0,27631,111683,0,139314
141847601300000,NW 307,RESIDENTIAL,41623,0,41623,165062,0,206685
141847601400000,NW 307,RESIDENTIAL,40800,0,40800,153499,0,194299
141847601500000,NW 307,RESIDENTIAL,43600,0,43600,156634,0,200234
141847601600000,NW 307,RESIDENTIAL,41735,0,41735,158103,0,199838
141847601700000,NW 307,RESIDENTIAL,40328,0,40328,160957,0,201285
141847601800000,NW 307,RESIDENTIAL,41333,0,41333,153139,0,194472
141847601900000,NW 307,RESIDENTIAL,40136,0,40136,166043,0,206179
141847602000000,NW 307,RESIDENTIAL,43400,0,43400,216342,0,259742
141847602100000,NW 307,RESIDENTIAL,36160,0,36160,154464,0,190624
141847602200000,NW 307,RESIDENTIAL,41572,0,41572,157733,0,199305
141847602300000,NW 307,RESIDENTIAL,41830,0,41830,150489,0,192319
141847602400000,NW 307,RESIDENTIAL,38070,0,38070,149362,0,187432
141847602500000,NW 307,RESIDENTIAL,40731,0,40731,211708,0,252439
141847602600000,NW 307,RESIDENTIAL,43664,0,43664,172992,0,216656
141847602700000,NW 302,RESIDENTIAL,34974,0,34974,280887,0,315861
141847602800000,NW 302,RESIDENTIAL,34974,0,34974,224584,0,259558
141847602900000,NW 302,RESIDENTIAL,30577,0,30577,108399,0,138976
141847603000000,CITY PROPERTY,EXEMPT,0,0,0,0,0,0
141847700100000,NW 302,RESIDENTIAL,101250,0,101250,45798,0,147048
141847700300000,NW 308,RESIDENTIAL,24480,0,24480,110808,0,135288
141847700400000,NW 308,RESIDENTIAL,22451,0,22451,118455,0,140906
141847700500000,NW 308,RESIDENTIAL,22486,0,22486,86163,0,108649
141847700600000,NW 308,RESIDENTIAL,23932,0,23932,113937,0,137869
141847700700000,NW 308,RESIDENTIAL,21450,0,21450,81378,0,102828
141847700800000,NW 308,RESIDENTIAL,21840,0,21840,42959,0,64799
141847700900000,NW 308,RESIDENTIAL,22260,0,22260,131467,0,153727
141847701000000,NW 308,RESIDENTIAL,22563,0,22563,126829,0,149392
141847701100000,NW 308,RESIDENTIAL,20763,0,20763,99704,0,120467
141847701200000,NW 308,RESIDENTIAL,21000,0,21000,108464,0,129464
141847701300000,NW 302,RESIDENTIAL,42980,0,42980,0,0,42980
141847701400000,NW 302,RESIDENTIAL,48970,0,48970,249140,0,298110
141847701500000,NW 302,RESIDENTIAL,51098,0,51098,229448,0,280546
141847701600000,NW 302,RESIDENTIAL,43660,0,43660,236087,0,279747
141847701700000,NW 302,RESIDENTIAL,69996,0,69996,279670,0,349666
141847701800000,NW 302,RESIDENTIAL,54054,0,54054,220252,0,274306
141847701900000,NW 302,RESIDENTIAL,70455,0,70455,276003,0,346458
141847702000000,NW 302,RESIDENTIAL,52962,0,52962,0,0,52962
141847800100000,NW 307,RESIDENTIAL,43055,0,43055,160121,0,203176
141847800200000,NW 307,RESIDENTIAL,42166,0,42166,187487,0,229653
141847800300000,NW 307,RESIDENTIAL,41692,0,41692,163623,0,205315
141847800400000,NW 307,RESIDENTIAL,42432,0,42432,181079,0,223511
141847800500000,NW 307,RESIDENTIAL,40656,0,40656,186942,0,227598
141847800600000,NW 307,RESIDENTIAL,44921,0,44921,109936,0,154857
141847800700000,NW 308,RESIDENTIAL,18834,0,18834,94840,0,113674
141847800800000,NW 308,RESIDENTIAL,18600,0,18600,78866,0,97466
141847800900000,NW 308,RESIDENTIAL,23900,0,23900,125337,0,149237
141910100100000,NW 308,RESIDENTIAL,24444,0,24444,95766,0,120210
141910100200000,NW 308,RESIDENTIAL,24624,0,24624,113565,0,138189
141910100300000,NW 308,RESIDENTIAL,24624,0,24624,91350,0,115974
141910100400000,NW 308,RESIDENTIAL,24655,0,24655,111249,0,135904
141910100500000,NW 308,RESIDENTIAL,22800,0,22800,92736,0,115536
141910100600000,NW 308,RESIDENTIAL,29981,0,29981,85773,0,115754
141910100700000,NW 308,RESIDENTIAL,24716,0,24716,98201,0,122917
141910100800000,NW 308,RESIDENTIAL,30347,0,30347,82465,0,112812
141910200100000,NW 308,RESIDENTIAL,16600,0,16600,0,0,16600
141910200300000,NW 308,RESIDENTIAL,50100,0,50100,0,0,50100
141910200400000,NW 308,RESIDENTIAL,24189,0,24189,110695,0,134884
141910200500000,NW 308,RESIDENTIAL,23688,0,23688,99395,0,123083
141910200600000,NW 308,RESIDENTIAL,24354,0,24354,97184,0,121538
141910200700000,NW 308,RESIDENTIAL,26072,0,26072,126487,0,152559
141910200800000,NW 308,RESIDENTIAL,24440,0,24440,82693,0,107133
141910200900000,NW 308,RESIDENTIAL,24407,0,24407,103607,0,128014
141910201000000,NW 308,RESIDENTIAL,24486,0,24486,89132,0,113618
141910201100000,NW 308,RESIDENTIAL,23688,0,23688,102207,0,125895
141910201200000,NW 308,RESIDENTIAL,23184,0,23184,105475,0,128659
141910201300000,NW 308,RESIDENTIAL,26800,0,26800,100327,0,127127
141910201400000,NW 308,RESIDENTIAL,7300,0,7300,0,0,7300
141910300100000,NW 308,RESIDENTIAL,26362,0,26362,101194,0,127556
141910300200000,NW 308,RESIDENTIAL,26600,0,26600,89473,0,116073
141910300300000,NW 308,RESIDENTIAL,25920,0,25920,88159,0,114079
141910300400000,NW 308,RESIDENTIAL,24000,0,24000,101375,0,125375
141910300500000,NW 308,RESIDENTIAL,24265,0,24265,110797,0,135062
141910300600000,NW 308,RESIDENTIAL,26676,0,26676,58538,0,85214
141910300700000,NW 308,RESIDENTIAL,25492,0,25492,84010,0,109502
141910300800000,NW 308,RESIDENTIAL,24816,0,24816,115211,0,140027
141910300900000,NW 308,RESIDENTIAL,24504,0,24504,102725,0,127229
141910301000000,NW 308,RESIDENTIAL,25654,0,25654,103598,0,129252
141910301100000,NW 308,RESIDENTIAL,24252,0,24252,102864,0,127116
141910301200000,NW 308,RESIDENTIAL,24252,0,24252,104411,0,128663
141910301300000,NW 308,RESIDENTIAL,24252,0,24252,107403,0,131655
141910301400000,NW 308,RESIDENTIAL,24252,0,24252,96400,0,120652
141910301500000,NW 308,RESIDENTIAL,24252,0,24252,95172,0,119424
141910301600000,NW 308,RESIDENTIAL,25477,0,25477,99208,0,124685
141910301800000,NW 308,RESIDENTIAL,24864,0,24864,105524,0,130388
141910301900000,NW 308,RESIDENTIAL,36733,0,36733,108925,0,145658
141910302000000,NW 308,RESIDENTIAL,24703,0,24703,87739,0,112442
141910302100000,NW 308,RESIDENTIAL,28017,0,28017,98769,0,126786
141910302200000,NW 308,RESIDENTIAL,29229,0,29229,92645,0,121874
141910302300000,NW 308,RESIDENTIAL,25920,0,25920,105643,0,131563
141910302400000,NW 308,RESIDENTIAL,29487,0,29487,96774,0,126261
141910302500000,NW 308,RESIDENTIAL,26288,0,26288,118713,0,145001
141910302600000,NW 308,RESIDENTIAL,27090,0,27090,97752,0,124842
141910302700000,NW 308,RESIDENTIAL,24252,0,24252,95853,0,120105
141910302800000,NW 308,RESIDENTIAL,24252,0,24252,99361,0,123613
141910302900000,NW 308,RESIDENTIAL,24252,0,24252,110430,0,134682
141910303000000,NW 308,RESIDENTIAL,24504,0,24504,90547,0,115051
141910303100000,NW 308,RESIDENTIAL,28216,0,28216,88692,0,116908
141910303200000,NW 308,RESIDENTIAL,28210,0,28210,85438,0,113648
141910400100000,NW 308,RESIDENTIAL,23980,0,23980,92547,0,116527
141910400200000,NW 308,RESIDENTIAL,23980,0,23980,100082,0,124062
141910400300000,NW 308,RESIDENTIAL,24308,0,24308,91168,0,115476
141910400400000,NW 308,RESIDENTIAL,25680,0,25680,49354,0,75034
141910400500000,NW 308,RESIDENTIAL,27860,0,27860,107195,0,135055
141910400600000,NW 308,RESIDENTIAL,43982,0,43982,101998,0,145980
141910400700000,NW 308,RESIDENTIAL,27853,0,27853,107574,0,135427
141910400800000,NW 308,RESIDENTIAL,26917,0,26917,138257,0,165174
141910400900000,NW 308,RESIDENTIAL,24056,0,24056,125038,0,149094
141910401000000,NW 308,RESIDENTIAL,24056,0,24056,109647,0,133703
141910401100000,NW 308,RESIDENTIAL,24056,0,24056,106377,0,130433
141910401200000,NW 308,RESIDENTIAL,24056,0,24056,111255,0,135311
141910401300000,NW 308,RESIDENTIAL,24056,0,24056,99846,0,123902
141910401400000,NW 308,RESIDENTIAL,24056,0,24056,93402,0,117458
141910401500000,NW 308,RESIDENTIAL,24494,0,24494,97712,0,122206
141910401600000,NW 308,RESIDENTIAL,25785,0,25785,113074,0,138859
141910401700000,NW 308,RESIDENTIAL,24056,0,24056,84115,0,108171
141910401800000,NW 308,RESIDENTIAL,24056,0,24056,91453,0,115509
141910401900000,NW 308,RESIDENTIAL,24056,0,24056,97265,0,121321
141910402000000,NW 308,RESIDENTIAL,24056,0,24056,96118,0,120174
141910402100000,NW 308,RESIDENTIAL,24056,0,24056,96418,0,120474
141910402200000,NW 308,RESIDENTIAL,24056,0,24056,106868,0,130924
141910402300000,NW 308,RESIDENTIAL,24056,0,24056,79078,0,103134
141910402400000,NW 308,RESIDENTIAL,30981,0,30981,117883,0,148864
141910500100000,NW 308,RESIDENTIAL,39552,0,39552,124559,0,164111
141910500200000,NW 308,RESIDENTIAL,39780,0,39780,102791,0,142571
141910500300000,NW 308,RESIDENTIAL,8650,0,8650,0,0,8650
141910500400000,NW 308,RESIDENTIAL,40230,0,40230,109840,0,150070
141910500500000,NW 308,RESIDENTIAL,21210,0,21210,0,0,21210
141910500600000,NW 308,RESIDENTIAL,54240,0,54240,123344,0,177584
141910500700000,NW 308,RESIDENTIAL,33148,0,33148,99012,0,132160
141910500800000,NW 308,RESIDENTIAL,25816,0,25816,102940,0,128756
141910500900000,NW 308,RESIDENTIAL,24056,0,24056,93010,0,117066
141910501000000,NW 308,RESIDENTIAL,24056,0,24056,99768,0,123824
141910501100000,NW 308,RESIDENTIAL,24056,0,24056,98901,0,122957
141910501200000,NW 308,RESIDENTIAL,24056,0,24056,122307,0,146363
141910501300000,NW 308,RESIDENTIAL,24056,0,24056,128,0,24184
141910501400000,NW 308,RESIDENTIAL,24056,0,24056,124266,0,148322
141910501500000,NW 308,RESIDENTIAL,24056,0,24056,122652,0,146708
141910501600000,NW 308,RESIDENTIAL,24056,0,24056,115360,0,139416
141910501700000,NW 308,RESIDENTIAL,25977,0,25977,118939,0,144916
141912600100000,NW 308,RESIDENTIAL,37009,0,37009,204135,0,241144
141912600200000,NW 308,RESIDENTIAL,38410,0,38410,231971,0,270381
141912600300000,NW 308,RESIDENTIAL,38410,0,38410,234910,0,273320
141912600400000,NW 308,RESIDENTIAL,34569,0,34569,185910,0,220479
141912600500000,NW 308,RESIDENTIAL,36186,0,36186,218578,0,254764
141912600600000,NW 308,RESIDENTIAL,38090,0,38090,250078,0,288168
141912600700000,NW 308,RESIDENTIAL,35881,0,35881,196088,0,231969
141912600800000,NW 308,RESIDENTIAL,36701,0,36701,161012,0,197713
141912600900000,NW 308,RESIDENTIAL,27898,0,27898,122026,0,149924
141912601000000,NW 308,RESIDENTIAL,27963,0,27963,113495,0,141458
141912601100000,NW 308,RESIDENTIAL,27727,0,27727,104869,0,132596
141912601200000,NW 308,RESIDENTIAL,27878,0,27878,86989,0,114867
141912601300000,NW 308,RESIDENTIAL,27793,0,27793,82133,0,109926
141912601400000,NW 308,RESIDENTIAL,28307,0,28307,102367,0,130674
141912601500000,NW 308,RESIDENTIAL,28275,0,28275,102783,0,131058
141912601600000,NW 308,RESIDENTIAL,27508,0,27508,70277,0,97785
141912601700000,NW 308,RESIDENTIAL,28177,0,28177,76865,0,105042
141912601800000,NW 308,RESIDENTIAL,26460,0,26460,81522,0,107982
141912601900000,NW 308,RESIDENTIAL,23429,0,23429,69636,0,93065
141912700100000,NW 308,RESIDENTIAL,41313,0,41313,184227,0,225540
141912700200000,NW 338,RESIDENTIAL,36654,0,36654,156420,0,193074
141912700300000,NW 338,RESIDENTIAL,36649,0,36649,129540,0,166189
141912700400000,NW 338,RESIDENTIAL,36649,0,36649,155562,0,192211
141912700500000,NW 338,RESIDENTIAL,36647,0,36647,117260,0,153907
141912700600000,NW 338,RESIDENTIAL,33742,0,33742,146585,0,180327
141912700700000,NW 338,RESIDENTIAL,33742,0,33742,119061,0,152803
141912700800000,NW 338,RESIDENTIAL,33741,0,33741,124064,0,157805
141912700900000,NW 338,RESIDENTIAL,34073,0,34073,131093,0,165166
141912701000000,NW 338,RESIDENTIAL,34073,0,34073,111546,0,145619
141912701100000,NW 338,RESIDENTIAL,34073,0,34073,144578,0,178651
141912701200000,NW 338,RESIDENTIAL,34073,0,34073,132915,0,166988
141912701300000,NW 338,RESIDENTIAL,34071,0,34071,156013,0,190084
141912701400000,NW 338,RESIDENTIAL,34588,0,34588,147496,0,182084
141912701500000,NW 338,RESIDENTIAL,35983,0,35983,135626,0,171609
141912701600000,NW 338,RESIDENTIAL,31350,0,31350,179454,0,210804
141912701700000,NW 338,RESIDENTIAL,31350,0,31350,141097,0,172447
141912701800000,NW 308,RESIDENTIAL,25536,0,25536,97323,0,122859
141912701900000,NW 308,RESIDENTIAL,25774,0,25774,91127,0,116901
141912702000000,NW 308,RESIDENTIAL,19627,0,19627,107975,0,127602
141912702100000,NW 308,RESIDENTIAL,18375,0,18375,92009,0,110384
141912702200000,NW 308,RESIDENTIAL,23152,0,23152,88056,0,111208
141912702300000,NW 308,RESIDENTIAL,22694,0,22694,80293,0,102987
141912702400000,NW 308,RESIDENTIAL,23893,0,23893,130488,0,154381
141912702500000,NW 308,RESIDENTIAL,23657,0,23657,93484,0,117141
141912702600000,NW 308,RESIDENTIAL,25705,0,25705,95053,0,120758
141912702700000,NW 308,RESIDENTIAL,26112,0,26112,95823,0,121935
141912702800000,NW 308,RESIDENTIAL,26520,0,26520,65874,0,92394
141912702900000,NW 308,RESIDENTIAL,26600,0,26600,96658,0,123258
141912703000000,NW 308,RESIDENTIAL,26785,0,26785,90827,0,117612
141912703100000,NW 308,RESIDENTIAL,26785,0,26785,86458,0,113243
141912703200000,NW 308,RESIDENTIAL,26022,0,26022,80799,0,106821
141912703300000,NW 308,RESIDENTIAL,25536,0,25536,68725,0,94261
141912703400000,NW 308,RESIDENTIAL,25976,0,25976,79131,0,105107
141912703500000,NW 308,RESIDENTIAL,25898,0,25898,85905,0,111803
141912703600000,NW 308,RESIDENTIAL,68350,0,68350,217747,0,286097
141912703700000,NW 308,RESIDENTIAL,25085,0,25085,101157,0,126242
141912703800000,NW 308,RESIDENTIAL,25556,0,25556,88093,0,113649
141912703900000,NW 308,RESIDENTIAL,26763,0,26763,98643,0,125406
141912704000000,NW 308,RESIDENTIAL,26347,0,26347,91151,0,117498
141912704100000,NW 308,RESIDENTIAL,26346,0,26346,90374,0,116720
141912704200000,NW 308,RESIDENTIAL,26509,0,26509,96975,0,123484
141912704300000,NW 308,RESIDENTIAL,25688,0,25688,86136,0,111824
141912704400000,NW 308,RESIDENTIAL,26346,0,26346,106759,0,133105
141912704500000,NW 308,RESIDENTIAL,26088,0,26088,84583,0,110671
141912704600000,NW 308,RESIDENTIAL,26519,0,26519,101259,0,127778
141912704700000,NW 308,RESIDENTIAL,26613,0,26613,107000,0,133613
141912704800000,NW 308,RESIDENTIAL,26710,0,26710,88936,0,115646
141912704900000,NW 308,RESIDENTIAL,26710,0,26710,76567,0,103277
141912705000000,NW 308,RESIDENTIAL,27160,0,27160,102430,0,129590
141912705100000,NW 308,RESIDENTIAL,27269,0,27269,86327,0,113596
141912705200000,NW 308,RESIDENTIAL,26457,0,26457,110257,0,136714
141912705300000,NW 308,RESIDENTIAL,26674,0,26674,99561,0,126235
141912705400000,NW 308,RESIDENTIAL,26965,0,26965,97942,0,124907
141912705500000,NW 308,RESIDENTIAL,26921,0,26921,90676,0,117597
141912705600000,NW 308,RESIDENTIAL,35966,0,35966,150663,0,186629
141912705700000,NW 308,RESIDENTIAL,35255,0,35255,198412,0,233667
141912705800000,NW 308,RESIDENTIAL,36777,0,36777,194703,0,231480
141912705900000,NW 308,RESIDENTIAL,34932,0,34932,186062,0,220994
141912706000000,NW 308,RESIDENTIAL,36453,0,36453,245196,0,281649
141912706100000,NW 308,RESIDENTIAL,36133,0,36133,177735,0,213868
141912706200000,NW 308,RESIDENTIAL,42210,0,42210,242197,0,284407
141912800100000,NW 338,RESIDENTIAL,33700,0,33700,125979,0,159679
141912800200000,NW 308,RESIDENTIAL,26344,0,26344,135215,0,161559
141912800300000,NW 308,RESIDENTIAL,25536,0,25536,114064,0,139600
141912800400000,NW 308,RESIDENTIAL,24960,0,24960,115041,0,140001
141912800500000,NW 308,RESIDENTIAL,26112,0,26112,129625,0,155737
141912800600000,NW 308,RESIDENTIAL,26320,0,26320,111136,0,137456
141912800700000,NW 308,RESIDENTIAL,26320,0,26320,94811,0,121131
141912800800000,NW 308,RESIDENTIAL,26320,0,26320,110759,0,137079
141912800900000,NW 308,RESIDENTIAL,26320,0,26320,101520,0,127840
141912801000000,NW 308,RESIDENTIAL,26320,0,26320,117435,0,143755
141912801100000,NW 308,RESIDENTIAL,26320,0,26320,108656,0,134976
141912801200000,NW 308,RESIDENTIAL,26320,0,26320,103800,0,130120
141912801300000,NW 308,RESIDENTIAL,26320,0,26320,115829,0,142149
141912801400000,NW 308,RESIDENTIAL,26320,0,26320,108199,0,134519
141912801500000,NW 338,RESIDENTIAL,34465,0,34465,120923,0,155388
141912801600000,NW 338,RESIDENTIAL,33697,0,33697,121912,0,155609
141912801700000,NW 338,RESIDENTIAL,33697,0,33697,137983,0,171680
141912801800000,NW 338,RESIDENTIAL,33697,0,33697,151054,0,184751
141912801900000,NW 338,RESIDENTIAL,33697,0,33697,151842,0,185539
141912802000000,NW 338,RESIDENTIAL,33697,0,33697,166346,0,200043
141912802100000,NW 338,RESIDENTIAL,33697,0,33697,151640,0,185337
141912802200000,NW 338,RESIDENTIAL,33697,0,33697,145755,0,179452
141912802300000,NW 338,RESIDENTIAL,33697,0,33697,155307,0,189004
141912802400000,NW 338,RESIDENTIAL,33697,0,33697,144965,0,178662
141912802500000,NW 338,RESIDENTIAL,33697,0,33697,132131,0,165828
141912802600000,NW 338,RESIDENTIAL,33697,0,33697,132371,0,166068
141912900100000,NW 308,RESIDENTIAL,27193,0,27193,126853,0,154046
141912900200000,NW 308,RESIDENTIAL,26730,0,26730,116140,0,142870
141912900300000,NW 308,RESIDENTIAL,26730,0,26730,115866,0,142596
141912900400000,NW 308,RESIDENTIAL,26730,0,26730,143069,0,169799
141912900500000,NW 308,RESIDENTIAL,25026,0,25026,127948,0,152974
141912900600000,NW 308,RESIDENTIAL,25026,0,25026,97147,0,122173
141912900700000,NW 308,RESIDENTIAL,25026,0,25026,90682,0,115708
141912900800000,NW 308,RESIDENTIAL,25026,0,25026,81593,0,106619
141912900900000,NW 308,RESIDENTIAL,25026,0,25026,98597,0,123623
141912901000000,NW 308,RESIDENTIAL,25026,0,25026,76223,0,101249
141912901100000,NW 308,RESIDENTIAL,25026,0,25026,102766,0,127792
141912901200000,NW 308,RESIDENTIAL,25026,0,25026,105609,0,130635
141912901300000,NW 308,RESIDENTIAL,25026,0,25026,83788,0,108814
141912901400000,NW 308,RESIDENTIAL,25026,0,25026,99406,0,124432
141912901500000,NW 308,RESIDENTIAL,25026,0,25026,85734,0,110760
141912901600000,NW 308,RESIDENTIAL,25026,0,25026,97057,0,122083
141912901700000,NW 308,RESIDENTIAL,25309,0,25309,107746,0,133055
141912901800000,NW 308,RESIDENTIAL,24275,0,24275,104920,0,129195
141915100100000,NW 306,RESIDENTIAL,38846,0,38846,120538,0,159384
141915100200000,NW 306,RESIDENTIAL,32304,0,32304,56799,0,89103
141915100300000,NW 306,RESIDENTIAL,56970,0,56970,153973,0,210943
141915100400000,NW 306,RESIDENTIAL,28018,0,28018,120638,0,148656
141915100500000,NW 306,RESIDENTIAL,25970,0,25970,117894,0,143864
141915100600000,NW 306,RESIDENTIAL,25970,0,25970,118709,0,144679
141915100700000,NW 306,RESIDENTIAL,26215,0,26215,117766,0,143981
141915100800000,NW 306,RESIDENTIAL,26460,0,26460,98890,0,125350
141915100900000,NW 306,RESIDENTIAL,26950,0,26950,106502,0,133452
141915101000000,NW 306,RESIDENTIAL,27685,0,27685,114954,0,142639
141915101100000,NW 306,RESIDENTIAL,27668,0,27668,109060,0,136728
141915101200000,NW 306,RESIDENTIAL,23219,0,23219,119554,0,142773
141915101300000,NW 306,RESIDENTIAL,23310,0,23310,94158,0,117468
141915101400000,NW 306,RESIDENTIAL,24780,0,24780,120527,0,145307
141915101500000,NW 306,RESIDENTIAL,26525,0,26525,102096,0,128621
141915101600000,NW 306,RESIDENTIAL,28175,0,28175,98495,0,126670
141915101700000,NW 306,RESIDENTIAL,32928,0,32928,121725,0,154653
141915200100000,NW 306,RESIDENTIAL,23938,0,23938,93440,0,117378
141915200200000,NW 306,RESIDENTIAL,21840,0,21840,85724,0,107564
141915200300000,NW 306,RESIDENTIAL,24938,0,24938,107043,0,131981
141915200400000,NW 306,RESIDENTIAL,26250,0,26250,84834,0,111084
141915200500000,NW 306,RESIDENTIAL,26250,0,26250,78697,0,104947
141915200600000,NW 306,RESIDENTIAL,26040,0,26040,66028,0,92068
141915200700000,NW 306,RESIDENTIAL,26040,0,26040,63264,0,89304
141915200800000,NW 306,RESIDENTIAL,26040,0,26040,70801,0,96841
141915200900000,NW 308,RESIDENTIAL,29363,0,29363,68447,0,97810
141915201000000,NW 308,RESIDENTIAL,23345,0,23345,91467,0,114812
141915201100000,NW 308,RESIDENTIAL,23042,0,23042,88398,0,111440
141915201200000,NW 308,RESIDENTIAL,20790,0,20790,84292,0,105082
141915201300000,NW 308,RESIDENTIAL,22349,0,22349,100252,0,122601
141915201400000,NW 308,RESIDENTIAL,22973,0,22973,120637,0,143610
141915201500000,NW 308,RESIDENTIAL,22973,0,22973,112538,0,135511
141915201600000,NW 308,RESIDENTIAL,23353,0,23353,97062,0,120415
141915201700000,NW 308,RESIDENTIAL,28342,0,28342,137865,0,166207
141915201800000,NW 308,RESIDENTIAL,24722,0,24722,101048,0,125770
141915201900000,NW 308,RESIDENTIAL,26957,0,26957,91974,0,118931
141915202000000,NW 308,RESIDENTIAL,26412,0,26412,88200,0,114612
141915202100000,NW 308,RESIDENTIAL,24768,0,24768,93309,0,118077
141915202200000,NW 308,RESIDENTIAL,24768,0,24768,95889,0,120657
141915202300000,NW 308,RESIDENTIAL,24445,0,24445,92955,0,117400
141915202400000,NW 306,RESIDENTIAL,63600,0,63600,211024,0,274624
141915202500000,NW 308,RESIDENTIAL,26362,0,26362,107660,0,134022
141915202600000,NW 308,RESIDENTIAL,25034,0,25034,110379,0,135413
141915202700000,NW 308,RESIDENTIAL,25478,0,25478,119851,0,145329
141915202800000,NW 308,RESIDENTIAL,27580,0,27580,124238,0,151818
141915202900000,NW 308,RESIDENTIAL,28485,0,28485,112238,0,140723
141915203000000,NW 308,RESIDENTIAL,28159,0,28159,121274,0,149433
141915203100000,NW 308,RESIDENTIAL,27160,0,27160,98982,0,126142
141915203200000,NW 308,RESIDENTIAL,27160,0,27160,91762,0,118922
141915203300000,NW 308,RESIDENTIAL,27160,0,27160,98568,0,125728
141915203400000,NW 308,RESIDENTIAL,26995,0,26995,106612,0,133607
141915203500000,NW 308,RESIDENTIAL,26880,0,26880,120247,0,147127
141915203600000,NW 308,RESIDENTIAL,26880,0,26880,111654,0,138534
141915203700000,NW 341,RESIDENTIAL,34182,0,34182,195291,0,229473
141915203800000,NW 341,RESIDENTIAL,34182,0,34182,151562,0,185744
141915203900000,NW 341,RESIDENTIAL,33648,0,33648,150972,0,184620
141915204000000,NW 341,RESIDENTIAL,34032,0,34032,166792,0,200824
141915204100000,NW 341,RESIDENTIAL,32560,0,32560,0,0,32560
141915204200000,NW 341,RESIDENTIAL,40195,0,40195,216760,0,256955
141915204300000,NW 341,RESIDENTIAL,35978,0,35978,222994,0,258972
141915204400000,NW 341,RESIDENTIAL,33764,0,33764,0,0,33764
141915204500000,NW 341,RESIDENTIAL,32967,0,32967,254916,0,287883
141915204600000,NW 341,RESIDENTIAL,40061,0,40061,187575,0,227636
141915204700000,NW 341,RESIDENTIAL,34426,0,34426,0,0,34426
141915204800000,NW 341,RESIDENTIAL,33293,0,33293,0,0,33293
141915204900000,NW 341,RESIDENTIAL,29723,0,29723,201930,0,231653
141915205000000,NW 306,RESIDENTIAL,33844,0,33844,97270,0,131114
141915205100000,NW 306,RESIDENTIAL,29055,0,29055,112442,0,141497
141915205200000,NW 306,RESIDENTIAL,29689,0,29689,110653,0,140342
141915205300000,NW 306,RESIDENTIAL,28476,0,28476,119113,0,147589
141915205400000,NW 306,RESIDENTIAL,28665,0,28665,112087,0,140752
141915205500000,NW 306,RESIDENTIAL,28910,0,28910,107025,0,135935
141915205600000,NW 306,RESIDENTIAL,34707,0,34707,90834,0,125541
141915205700000,NW 306,RESIDENTIAL,30637,0,30637,140534,0,171171
141915205800000,NW 306,RESIDENTIAL,21271,0,21271,94443,0,115714
141915205900000,NW 306,RESIDENTIAL,27283,0,27283,79554,0,106837
141915206000000,NW 306,RESIDENTIAL,27268,0,27268,81694,0,108962
141915206100000,NW 306,RESIDENTIAL,23373,0,23373,88565,0,111938
141915300100000,NW 308,RESIDENTIAL,26328,0,26328,93680,0,120008
141915300200000,NW 308,RESIDENTIAL,25544,0,25544,99990,0,125534
141915300300000,NW 308,RESIDENTIAL,26342,0,26342,94318,0,120660
141915300400000,NW 308,RESIDENTIAL,26994,0,26994,106421,0,133415
141915400100000,NW 308,RESIDENTIAL,26362,0,26362,94333,0,120695
141915400200000,NW 308,RESIDENTIAL,25735,0,25735,93028,0,118763
141915400300000,NW 308,RESIDENTIAL,25624,0,25624,96843,0,122467
141915400400000,NW 308,RESIDENTIAL,26352,0,26352,107287,0,133639
141915400500000,NW 308,RESIDENTIAL,26624,0,26624,112276,0,138900
141915400600000,NW 308,RESIDENTIAL,23761,0,23761,90064,0,113825
141915400700000,NW 308,RESIDENTIAL,24945,0,24945,96984,0,121929
141915400800000,NW 308,RESIDENTIAL,24444,0,24444,129297,0,153741
141915400900000,NW 308,RESIDENTIAL,25525,0,25525,126589,0,152114
141915401000000,NW 308,RESIDENTIAL,27455,0,27455,136475,0,163930
141915401100000,NW 308,RESIDENTIAL,27518,0,27518,124740,0,152258
141915401200000,NW 308,RESIDENTIAL,27535,0,27535,126023,0,153558
141915401300000,NW 308,RESIDENTIAL,29131,0,29131,125802,0,154933
141915401400000,NW 308,RESIDENTIAL,26531,0,26531,124393,0,150924
141915401500000,NW 308,RESIDENTIAL,26272,0,26272,99887,0,126159
141915401600000,NW 308,RESIDENTIAL,25034,0,25034,102384,0,127418
141915500100000,NW 341,RESIDENTIAL,37200,0,37200,224288,0,261488
141915500200000,NW 341,RESIDENTIAL,34235,0,34235,186461,0,220696
141915500300000,NW 341,RESIDENTIAL,34235,0,34235,163397,0,197632
141915500400000,NW 341,RESIDENTIAL,34235,0,34235,185786,0,220021
141915500500000,NW 341,RESIDENTIAL,34235,0,34235,167572,0,201807
141915500600000,NW 341,RESIDENTIAL,29375,0,29375,0,0,29375
141915500700000,NW 341,RESIDENTIAL,30456,0,30456,0,0,30456
141915500800000,NW 341,RESIDENTIAL,28764,0,28764,198142,0,226906
141915500900000,NW 341,RESIDENTIAL,33840,0,33840,210941,0,244781
141915501000000,NW 341,RESIDENTIAL,37200,0,37200,167311,0,204511
141917600100000,NW 306,RESIDENTIAL,43190,0,43190,105942,0,149132
141917600200000,NW 306,RESIDENTIAL,43050,0,43050,216247,0,259297
141917600300000,NW 306,RESIDENTIAL,23949,0,23949,68841,0,92790
141917600400000,NW 306,RESIDENTIAL,23949,0,23949,91494,0,115443
141917600500000,NW 306,RESIDENTIAL,23949,0,23949,80141,0,104090
141917600600000,NW 306,RESIDENTIAL,23949,0,23949,79874,0,103823
141917600700000,NW 306,RESIDENTIAL,42665,0,42665,69971,0,112636
141917600800000,NW 306,RESIDENTIAL,33529,0,33529,96065,0,129594
141917600900000,NW 306,RESIDENTIAL,49805,0,49805,55599,0,105404
141917601000000,NW 306,RESIDENTIAL,23741,0,23741,97803,0,121544
141917601100000,NW 306,RESIDENTIAL,5233,0,5233,0,0,5233
141917601200000,NW 306,RESIDENTIAL,24157,0,24157,85165,0,109322
141917601300000,NW 306,RESIDENTIAL,26163,0,26163,106448,0,132611
141917601400000,NW 306,RESIDENTIAL,26163,0,26163,52729,0,78892
141917601500000,NW 306,RESIDENTIAL,24255,0,24255,99758,0,124013
141917601600000,NW 306,RESIDENTIAL,22358,0,22358,82610,0,104968
141917601700000,NW 306,RESIDENTIAL,22354,0,22354,90364,0,112718
141917601800000,NW 306,RESIDENTIAL,22354,0,22354,93261,0,115615
141917601900000,NW 306,RESIDENTIAL,24435,0,24435,90376,0,114811
141917602000000,NW 306,RESIDENTIAL,63850,0,63850,141093,0,204943
141917602100000,NW 306,RESIDENTIAL,80600,0,80600,83100,0,163700
141917602200000,NW 306,RESIDENTIAL,74950,0,74950,0,0,74950
141917602300000,NW 306,RESIDENTIAL,45175,0,45175,158004,0,203179
141917602400000,NW 306,RESIDENTIAL,20700,0,20700,1335,0,22035
141917602500000,NW 306,RESIDENTIAL,19698,0,19698,98604,0,118302
141917602600000,NW 306,RESIDENTIAL,61950,0,61950,214102,0,276052
141917602700000,NW 313,RESIDENTIAL,38261,0,38261,242185,0,280446
141917602800000,NW 313,RESIDENTIAL,37800,0,37800,187167,0,224967
141917602900000,NW 313,RESIDENTIAL,38497,0,38497,212519,0,251016
141917603000000,NW 313,RESIDENTIAL,52819,0,52819,275337,0,328156
141917603100000,NW 313,RESIDENTIAL,46852,0,46852,242504,0,289356
141917603200000,NW 313,RESIDENTIAL,36248,0,36248,313123,0,349371
141917603300000,NW 313,RESIDENTIAL,33600,0,33600,250146,0,283746
141917603400000,NW 313,RESIDENTIAL,33600,0,33600,230888,0,264488
141917603500000,NW 313,RESIDENTIAL,39173,0,39173,269626,0,308799
141917603600000,NW 306,RESIDENTIAL,78750,0,78750,217912,0,296662
141917603700000,NW 306,RESIDENTIAL,3540,0,3540,0,0,3540
141917603800000,NW 306,RESIDENTIAL,3694,0,3694,0,0,3694
141917700100000,NW 306,RESIDENTIAL,34468,0,34468,36680,0,71148
141920100100000,NW 308,RESIDENTIAL,24521,0,24521,105174,0,129695
141920100200000,NW 308,RESIDENTIAL,25088,0,25088,112007,0,137095
141920100300000,NW 308,RESIDENTIAL,25088,0,25088,110467,0,135555
141920100400000,NW 308,RESIDENTIAL,25088,0,25088,114124,0,139212
141920100500000,NW 308,RESIDENTIAL,25088,0,25088,113208,0,138296
141920100600000,NW 308,RESIDENTIAL,25088,0,25088,114652,0,139740
141920100700000,NW 308,RESIDENTIAL,25088,0,25088,119478,0,144566
141920100800000,NW 308,RESIDENTIAL,25062,0,25062,125527,0,150589
141920100900000,NW 308,RESIDENTIAL,29400,0,29400,118544,0,147944
141920101000000,NW 308,RESIDENTIAL,26460,0,26460,101152,0,127612
141920101100000,NW 308,RESIDENTIAL,25284,0,25284,92517,0,117801
141920101200000,NW 308,RESIDENTIAL,26460,0,26460,111648,0,138108
141920101300000,NW 308,RESIDENTIAL,26460,0,26460,83933,0,110393
141920101400000,NW 308,RESIDENTIAL,26177,0,26177,113554,0,139731
141920101500000,NW 308,RESIDENTIAL,25284,0,25284,101223,0,126507
141920101600000,NW 308,RESIDENTIAL,25284,0,25284,102534,0,127818
141920101700000,NW 308,RESIDENTIAL,25787,0,25787,90965,0,116752
141920101800000,NW 308,RESIDENTIAL,24751,0,24751,90450,0,115201
141920101900000,NW 308,RESIDENTIAL,25633,0,25633,98113,0,123746
141920200100000,NW 308,RESIDENTIAL,26147,0,26147,98167,0,124314
141920200200000,NW 308,RESIDENTIAL,27124,0,27124,121231,0,148355
141920200300000,NW 308,RESIDENTIAL,27234,0,27234,125478,0,152712
141920200400000,NW 308,RESIDENTIAL,28534,0,28534,104356,0,132890
141920200500000,NW 308,RESIDENTIAL,36870,0,36870,120486,0,157356
141920200600000,NW 308,RESIDENTIAL,26533,0,26533,117348,0,143881
141920200700000,NW 308,RESIDENTIAL,26775,0,26775,104997,0,131772
141920200800000,NW 308,RESIDENTIAL,26226,0,26226,127645,0,153871
141920200900000,NW 308,RESIDENTIAL,26226,0,26226,114812,0,141038
141920201000000,NW 308,RESIDENTIAL,26316,0,26316,116596,0,142912
141920201100000,NW 308,RESIDENTIAL,25284,0,25284,122221,0,147505
141920201200000,NW 308,RESIDENTIAL,25026,0,25026,110851,0,135877
141920201300000,NW 308,RESIDENTIAL,25026,0,25026,128845,0,153871
141920201400000,NW 308,RESIDENTIAL,25026,0,25026,93497,0,118523
141920201500000,NW 308,RESIDENTIAL,25026,0,25026,134240,0,159266
141920201600000,NW 308,RESIDENTIAL,25026,0,25026,121108,0,146134
141920201700000,NW 308,RESIDENTIAL,25026,0,25026,103696,0,128722
141920201800000,NW 308,RESIDENTIAL,25026,0,25026,102667,0,127693
141920201900000,NW 308,RESIDENTIAL,25026,0,25026,108452,0,133478
141920202000000,NW 308,RESIDENTIAL,24488,0,24488,101869,0,126357
141920202100000,APARTMENT,COMMERCIAL,0,48561,48561,0,298737,347298
141920202200000,APARTMENT,RESIDENTIAL,48138,0,48138,322150,0,370288
141920202300000,APARTMENT,RESIDENTIAL,51040,0,51040,308482,0,359522
141920202400000,APARTMENT,RESIDENTIAL,80800,0,80800,563818,0,644618
141920202600000,NW 308,RESIDENTIAL,20160,0,20160,85688,0,105848
141920202700000,NW 308,RESIDENTIAL,20167,0,20167,83788,0,103955
141920202800000,NW 308,RESIDENTIAL,25320,0,25320,90115,0,115435
141920202900000,NW 308,RESIDENTIAL,25800,0,25800,93626,0,119426
141920203000000,NW 308,RESIDENTIAL,25800,0,25800,89173,0,114973
141920203100000,NW 308,RESIDENTIAL,26712,0,26712,93672,0,120384
141920203200000,NW 308,RESIDENTIAL,27000,0,27000,112130,0,139130
141920203300000,NW 308,RESIDENTIAL,27000,0,27000,109463,0,136463
141920203400000,NW 308,RESIDENTIAL,25800,0,25800,94371,0,120171
141920203500000,NW 308,RESIDENTIAL,27000,0,27000,98780,0,125780
141920203600000,NW 308,RESIDENTIAL,27000,0,27000,100648,0,127648
141920203700000,NW 308,RESIDENTIAL,25587,0,25587,128088,0,153675
141920203800000,NW 308,RESIDENTIAL,25600,0,25600,126162,0,151762
141920203900000,NW 308,RESIDENTIAL,26640,0,26640,132578,0,159218
141920204000000,NW 308,RESIDENTIAL,33384,0,33384,170218,0,203602
141920204100000,NW 308,RESIDENTIAL,26961,0,26961,130855,0,157816
141920204200000,NW 308,RESIDENTIAL,29155,0,29155,113757,0,142912
141920204400000,NW 308,RESIDENTIAL,64650,0,64650,147245,0,211895
141920300100000,NW 308,RESIDENTIAL,28350,0,28350,119059,0,147409
141920300200000,NW 308,RESIDENTIAL,28984,0,28984,116677,0,145661
141920300300000,NW 308,RESIDENTIAL,28194,0,28194,107378,0,135572
141920300400000,NW 308,RESIDENTIAL,28638,0,28638,100251,0,128889
141920300500000,NW 308,RESIDENTIAL,27606,0,27606,108460,0,136066
141920300600000,NW 308,RESIDENTIAL,29807,0,29807,101681,0,131488
141920300700000,NW 308,RESIDENTIAL,24768,0,24768,101739,0,126507
141920300800000,NW 308,RESIDENTIAL,24768,0,24768,107391,0,132159
141920300900000,NW 308,RESIDENTIAL,24768,0,24768,100869,0,125637
141920301000000,NW 308,RESIDENTIAL,24768,0,24768,102480,0,127248
141920301100000,NW 308,RESIDENTIAL,24768,0,24768,111571,0,136339
141920301200000,NW 308,RESIDENTIAL,24768,0,24768,109604,0,134372
141920301300000,NW 308,RESIDENTIAL,24768,0,24768,105028,0,129796
141920301400000,NW 308,RESIDENTIAL,24768,0,24768,115524,0,140292
141920301500000,NW 308,RESIDENTIAL,25023,0,25023,98905,0,123928
141920301600000,NW 308,RESIDENTIAL,26042,0,26042,112933,0,138975
141920301700000,NW 308,RESIDENTIAL,24768,0,24768,102587,0,127355
141920301800000,NW 308,RESIDENTIAL,24768,0,24768,115534,0,140302
141920301900000,NW 308,RESIDENTIAL,24768,0,24768,114289,0,139057
141920302000000,NW 308,RESIDENTIAL,24768,0,24768,110092,0,134860
141920302100000,NW 308,RESIDENTIAL,28762,0,28762,122098,0,150860
141920302200000,NW 308,RESIDENTIAL,29131,0,29131,108238,0,137369
141920302300000,NW 308,RESIDENTIAL,31500,0,31500,116312,0,147812
141920302400000,NW 308,RESIDENTIAL,29181,0,29181,112166,0,141347
141920302500000,NW 308,RESIDENTIAL,25542,0,25542,109290,0,134832
141920302600000,NW 308,RESIDENTIAL,25542,0,25542,100181,0,125723
141920302700000,NW 308,RESIDENTIAL,25542,0,25542,113441,0,138983
141920302800000,NW 308,RESIDENTIAL,25542,0,25542,108837,0,134379
141920302900000,NW 308,RESIDENTIAL,25542,0,25542,103846,0,129388
141920303000000,NW 308,RESIDENTIAL,25542,0,25542,123363,0,148905
141920303100000,NW 308,RESIDENTIAL,25828,0,25828,116100,0,141928
141920303200000,NW 308,RESIDENTIAL,26729,0,26729,109655,0,136384
141920303300000,NW 308,RESIDENTIAL,25284,0,25284,102990,0,128274
141920303400000,NW 308,RESIDENTIAL,25284,0,25284,106664,0,131948
141920303500000,NW 308,RESIDENTIAL,25284,0,25284,104084,0,129368
141920303600000,NW 308,RESIDENTIAL,25284,0,25284,109373,0,134657
141920303700000,NW 308,RESIDENTIAL,25284,0,25284,119925,0,145209
141920303800000,NW 308,RESIDENTIAL,25284,0,25284,114434,0,139718
141920303900000,NW 308,RESIDENTIAL,25284,0,25284,114717,0,140001
141920304000000,NW 308,RESIDENTIAL,28953,0,28953,105115,0,134068
141920304100000,NW 308,RESIDENTIAL,27580,0,27580,147242,0,174822
141920304200000,NW 308,RESIDENTIAL,30742,0,30742,132447,0,163189
141920304300000,NW 308,RESIDENTIAL,28413,0,28413,124185,0,152598
141920400100000,APARTMENT,RESIDENTIAL,48600,0,48600,303796,0,352396
141920400200000,APARTMENT,RESIDENTIAL,25518,0,25518,141222,0,166740
141920400300000,APARTMENT,RESIDENTIAL,49758,0,49758,278242,0,328000
141922600100000,NW 308,RESIDENTIAL,27540,0,27540,100473,0,128013
141922600200000,NW 308,RESIDENTIAL,27632,0,27632,118112,0,145744
141922600300000,NW 308,RESIDENTIAL,27618,0,27618,114735,0,142353
141922600400000,NW 308,RESIDENTIAL,27832,0,27832,84796,0,112628
141922600500000,NW 308,RESIDENTIAL,31282,0,31282,95600,0,126882
141922600600000,NW 308,RESIDENTIAL,25284,0,25284,107186,0,132470
141922600700000,NW 308,RESIDENTIAL,25284,0,25284,113572,0,138856
141922600800000,NW 308,RESIDENTIAL,25284,0,25284,101374,0,126658
141922600900000,NW 308,RESIDENTIAL,25284,0,25284,101008,0,126292
141922601000000,NW 308,RESIDENTIAL,25284,0,25284,98291,0,123575
141922601100000,NW 308,RESIDENTIAL,25284,0,25284,87431,0,112715
141922601200000,NW 308,RESIDENTIAL,25284,0,25284,88518,0,113802
141922601300000,NW 308,RESIDENTIAL,25284,0,25284,96127,0,121411
141922601400000,NW 308,RESIDENTIAL,25284,0,25284,86706,0,111990
141922601500000,NW 308,RESIDENTIAL,25561,0,25561,87703,0,113264
141922601600000,NW 308,RESIDENTIAL,26405,0,26405,109406,0,135811
141922601700000,NW 308,RESIDENTIAL,25800,0,25800,113076,0,138876
141922601800000,NW 308,RESIDENTIAL,25800,0,25800,102203,0,128003
141922601900000,NW 308,RESIDENTIAL,25800,0,25800,105454,0,131254
141922602000000,NW 308,RESIDENTIAL,25800,0,25800,102308,0,128108
141922602100000,NW 308,RESIDENTIAL,25800,0,25800,110806,0,136606
141922602200000,NW 308,RESIDENTIAL,25800,0,25800,96929,0,122729
141922602300000,NW 308,RESIDENTIAL,25800,0,25800,97437,0,123237
141922602400000,NW 308,RESIDENTIAL,25800,0,25800,98361,0,124161
141922602500000,NW 308,RESIDENTIAL,26058,0,26058,102761,0,128819
141922602600000,NW 308,RESIDENTIAL,28832,0,28832,83427,0,112259
141922602700000,NW 308,RESIDENTIAL,27370,0,27370,110645,0,138015
141922700100000,NW 308,RESIDENTIAL,24530,0,24530,99112,0,123642
141922700200000,NW 308,RESIDENTIAL,29290,0,29290,103508,0,132798
141922700300000,NW 308,RESIDENTIAL,22372,0,22372,106132,0,128504
141922700400000,NW 308,RESIDENTIAL,23312,0,23312,90226,0,113538
141922700500000,NW 308,RESIDENTIAL,23312,0,23312,77479,0,100791
141922700600000,NW 308,RESIDENTIAL,24252,0,24252,104303,0,128555
141922700700000,NW 308,RESIDENTIAL,24252,0,24252,104653,0,128905
141922700800000,NW 308,RESIDENTIAL,24252,0,24252,82114,0,106366
141922700900000,NW 308,RESIDENTIAL,24510,0,24510,88417,0,112927
141922701000000,NW 308,RESIDENTIAL,24510,0,24510,78753,0,103263
141922701100000,NW 308,RESIDENTIAL,24510,0,24510,80844,0,105354
141922701200000,NW 308,RESIDENTIAL,24510,0,24510,96754,0,121264
141922701300000,NW 308,RESIDENTIAL,26220,0,26220,85992,0,112212
141922701400000,NW 308,RESIDENTIAL,25080,0,25080,91590,0,116670
141922701500000,NW 308,RESIDENTIAL,26170,0,26170,120643,0,146813
141922701600000,NW 308,RESIDENTIAL,26729,0,26729,112010,0,138739
141922701700000,NW 308,RESIDENTIAL,26320,0,26320,98826,0,125146
141922701800000,NW 308,RESIDENTIAL,25944,0,25944,108103,0,134047
141922701900000,NW 308,RESIDENTIAL,24252,0,24252,85445,0,109697
141922702000000,NW 308,RESIDENTIAL,24252,0,24252,91422,0,115674
141922702100000,NW 308,RESIDENTIAL,24252,0,24252,80174,0,104426
141922702200000,NW 308,RESIDENTIAL,24252,0,24252,99797,0,124049
141922702300000,NW 308,RESIDENTIAL,24252,0,24252,86333,0,110585
141922702400000,NW 308,RESIDENTIAL,24252,0,24252,86444,0,110696
141922702500000,NW 308,RESIDENTIAL,24252,0,24252,102170,0,126422
141922702600000,NW 308,RESIDENTIAL,24252,0,24252,91779,0,116031
141922702700000,NW 308,RESIDENTIAL,24252,0,24252,128859,0,153111
141922702800000,NW 308,RESIDENTIAL,24252,0,24252,109519,0,133771
141922800100000,NW 308,RESIDENTIAL,25634,0,25634,116002,0,141636
141922800200000,NW 308,RESIDENTIAL,26006,0,26006,91194,0,117200
141922800300000,NW 308,RESIDENTIAL,25439,0,25439,83643,0,109082
141922800400000,NW 308,RESIDENTIAL,26316,0,26316,91189,0,117505
141922800500000,NW 308,RESIDENTIAL,26755,0,26755,98812,0,125567
141922800600000,NW 308,RESIDENTIAL,25802,0,25802,114001,0,139803
141922800700000,NW 308,RESIDENTIAL,25026,0,25026,87286,0,112312
141922800800000,NW 308,RESIDENTIAL,26140,0,26140,95081,0,121221
141922800900000,NW 308,RESIDENTIAL,27744,0,27744,83816,0,111560
141922801000000,NW 308,RESIDENTIAL,21015,0,21015,106543,0,127558
141922801100000,NW 308,RESIDENTIAL,25181,0,25181,104395,0,129576
141922801200000,NW 308,RESIDENTIAL,25181,0,25181,108468,0,133649
141922801300000,NW 308,RESIDENTIAL,25181,0,25181,89474,0,114655
141922801400000,NW 308,RESIDENTIAL,25181,0,25181,85750,0,110931
141922801500000,NW 308,RESIDENTIAL,25026,0,25026,98164,0,123190
141922801600000,NW 308,RESIDENTIAL,25841,0,25841,92834,0,118675
141922801700000,NW 308,RESIDENTIAL,29145,0,29145,106322,0,135467
141922801800000,NW 308,RESIDENTIAL,27409,0,27409,102806,0,130215
141922801900000,NW 308,RESIDENTIAL,25830,0,25830,108636,0,134466
141922802000000,NW 308,RESIDENTIAL,25981,0,25981,98174,0,124155
141922802100000,NW 308,RESIDENTIAL,25981,0,25981,85338,0,111319
141922802200000,NW 308,RESIDENTIAL,25981,0,25981,89059,0,115040
141922802300000,NW 308,RESIDENTIAL,26264,0,26264,85205,0,111469
141922802400000,NW 308,RESIDENTIAL,30860,0,30860,79368,0,110228
141922802500000,NW 308,RESIDENTIAL,30736,0,30736,73568,0,104304
141922802600000,NW 308,RESIDENTIAL,29328,0,29328,79232,0,108560
141922802700000,NW 308,RESIDENTIAL,28388,0,28388,75222,0,103610
141922802800000,NW 308,RESIDENTIAL,28921,0,28921,102396,0,131317
141922802900000,NW 308,RESIDENTIAL,25988,0,25988,94067,0,120055
141922803000000,NW 308,RESIDENTIAL,20983,0,20983,110731,0,131714
141922803100000,NW 308,RESIDENTIAL,20668,0,20668,88184,0,108852
141922803200000,NW 308,RESIDENTIAL,24146,0,24146,78797,0,102943
141922803300000,NW 308,RESIDENTIAL,24416,0,24416,132112,0,156528
141922803400000,NW 308,RESIDENTIAL,24321,0,24321,77922,0,102243
141922803500000,NW 308,RESIDENTIAL,24321,0,24321,115959,0,140280
141922803600000,NW 308,RESIDENTIAL,24321,0,24321,97119,0,121440
141922803700000,NW 308,RESIDENTIAL,30520,0,30520,88242,0,118762
141922803800000,CITY PROPERTY,EXEMPT,0,0,0,0,0,0
141922900300000,APARTMENT,RESIDENTIAL,107200,0,107200,644736,0,751936
141923000100000,NW 308,RESIDENTIAL,25026,0,25026,97884,0,122910
141923000200000,NW 308,RESIDENTIAL,26896,0,26896,100303,0,127199
141923000300000,NW 308,RESIDENTIAL,25230,0,25230,95530,0,120760
141923000400000,NW 308,RESIDENTIAL,25659,0,25659,92372,0,118031
141923000500000,NW 308,RESIDENTIAL,26397,0,26397,77467,0,103864
141923000600000,NW 308,RESIDENTIAL,27832,0,27832,94945,0,122777
141923000700000,NW 308,RESIDENTIAL,25542,0,25542,102414,0,127956
141923000800000,NW 308,RESIDENTIAL,24768,0,24768,91352,0,116120
141923000900000,NW 308,RESIDENTIAL,24570,0,24570,93170,0,117740
141923001000000,NW 308,RESIDENTIAL,25026,0,25026,98565,0,123591
141923001100000,NW 308,RESIDENTIAL,25026,0,25026,94299,0,119325
141923001200000,NW 308,RESIDENTIAL,25026,0,25026,100984,0,126010
141923001300000,NW 308,RESIDENTIAL,25026,0,25026,93466,0,118492
141923100100000,APARTMENT,RESIDENTIAL,20445,0,20445,143812,0,164257
141923200100000,NW 308,RESIDENTIAL,28500,0,28500,96044,0,124544
141923200200000,NW 308,RESIDENTIAL,28500,0,28500,94902,0,123402
141923200300000,NW 308,RESIDENTIAL,28500,0,28500,100533,0,129033
141923200400000,NW 308,RESIDENTIAL,28500,0,28500,97595,0,126095
141923200500000,NW 308,RESIDENTIAL,27072,0,27072,103432,0,130504
141923200600000,NW 308,RESIDENTIAL,24500,0,24500,72064,0,96564
141923200700000,NW 308,RESIDENTIAL,26162,0,26162,131248,0,157410
141923200800000,NW 308,RESIDENTIAL,28175,0,28175,75492,0,103667
141925100100000,NW 314,RESIDENTIAL,24358,0,24358,93413,0,117771
141925100200000,NW 314,RESIDENTIAL,32825,0,32825,82286,0,115111
141925100300000,NW 314,RESIDENTIAL,30527,0,30527,88069,0,118596
141925100400000,NW 314,RESIDENTIAL,29680,0,29680,96039,0,125719
141925100500000,NW 314,RESIDENTIAL,27195,0,27195,95563,0,122758
141925100600000,NW 314,RESIDENTIAL,34644,0,34644,100816,0,135460
141925100700000,NW 314,RESIDENTIAL,50610,0,50610,92525,0,143135
141925100800000,NW 314,RESIDENTIAL,34153,0,34153,92794,0,126947
141925100900000,NW 314,RESIDENTIAL,32554,0,32554,156486,0,189040
141925101000000,NW 314,RESIDENTIAL,31538,0,31538,103301,0,134839
141925101200000,NW 314,RESIDENTIAL,21117,0,21117,80124,0,101241
141925101300000,NW 314,RESIDENTIAL,32498,0,32498,57836,0,90334
141925101400000,NW 314,RESIDENTIAL,32799,0,32799,80922,0,113721
141925101500000,NW 314,RESIDENTIAL,33868,0,33868,118335,0,152203
141925101600000,NW 314,RESIDENTIAL,30138,0,30138,85588,0,115726
141925101700000,NW 314,RESIDENTIAL,33669,0,33669,104114,0,137783
141925101800000,NW 314,RESIDENTIAL,27132,0,27132,81946,0,109078
141925101900000,NW 314,RESIDENTIAL,27216,0,27216,49472,0,76688
141925102000000,NW 314,RESIDENTIAL,22000,0,22000,85486,0,107486
141925102100000,NW 314,RESIDENTIAL,25966,0,25966,69282,0,95248
141925102200000,NW 314,RESIDENTIAL,26703,0,26703,86044,0,112747
141925102300000,NW 314,RESIDENTIAL,29040,0,29040,66410,0,95450
141925102400000,NW 314,RESIDENTIAL,28800,0,28800,79844,0,108644
141925102500000,NW 314,RESIDENTIAL,51382,0,51382,50304,0,101686
141925102600000,NW 314,RESIDENTIAL,26790,0,26790,62974,0,89764
141925102700000,NW 314,RESIDENTIAL,26741,0,26741,119862,0,146603
141925102800000,NW 314,RESIDENTIAL,28560,0,28560,113752,0,142312
141925102900000,NW 314,RESIDENTIAL,22624,0,22624,74937,0,97561
141925103000000,NW 314,RESIDENTIAL,22624,0,22624,81959,0,104583
141925103100000,NW 314,RESIDENTIAL,22624,0,22624,59635,0,82259
141925103200000,NW 314,RESIDENTIAL,22624,0,22624,72835,0,95459
141925103300000,NW 314,RESIDENTIAL,50050,0,50050,70168,0,120218
141925103400000,NW 314,RESIDENTIAL,26572,0,26572,96694,0,123266
141925200100000,NW 314,RESIDENTIAL,30854,0,30854,136884,0,167738
141925200200000,NW 314,RESIDENTIAL,26302,0,26302,59606,0,85908
141925200300000,NW 314,RESIDENTIAL,23205,0,23205,88568,0,111773
141925200400000,NW 314,EXEMPT,0,23205,23205,0,92536,115741
141925200500000,NW 314,RESIDENTIAL,23205,0,23205,76300,0,99505
141925200600000,NW 314,RESIDENTIAL,23205,0,23205,95895,0,119100
141925200700000,NW 314,RESIDENTIAL,24500,0,24500,83060,0,107560
141925200800000,NW 314,RESIDENTIAL,24500,0,24500,88183,0,112683
141925200900000,NW 314,RESIDENTIAL,24500,0,24500,86666,0,111166
141925201000000,NW 314,RESIDENTIAL,22995,0,22995,86982,0,109977
141925201100000,NW 314,RESIDENTIAL,7740,0,7740,478,0,8218
141925201300000,NW 314,RESIDENTIAL,54929,0,54929,114830,0,169759
141925201400000,NW 314,RESIDENTIAL,42952,0,42952,53333,0,96285
141925201500000,NW 314,RESIDENTIAL,28462,0,28462,52831,0,81293
141925201600000,NW 314,RESIDENTIAL,30131,0,30131,67970,0,98101
141925201700000,NW 314,RESIDENTIAL,31783,0,31783,104607,0,136390
141925201800000,NW 314,RESIDENTIAL,24157,0,24157,45360,0,69517
141925201900000,NW 314,RESIDENTIAL,30377,0,30377,58465,0,88842
141925202000000,NW 314,RESIDENTIAL,28171,0,28171,102350,0,130521
141925202100000,NW 314,RESIDENTIAL,31572,0,31572,103603,0,135175
141925202200000,NW 314,RESIDENTIAL,31515,0,31515,124097,0,155612
141925202300000,NW 314,RESIDENTIAL,35783,0,35783,62650,0,98433
141925202400000,NW 314,RESIDENTIAL,21604,0,21604,98394,0,119998
141925202500000,NW 314,RESIDENTIAL,20398,0,20398,85332,0,105730
141925202600000,NW 314,RESIDENTIAL,23134,0,23134,77495,0,100629
141925202700000,NW 314,RESIDENTIAL,23205,0,23205,87714,0,110919
141925202800000,NW 314,RESIDENTIAL,31973,0,31973,73138,0,105111
141925202900000,NW 314,RESIDENTIAL,53050,0,53050,22503,0,75553
141925203000000,NW 314,RESIDENTIAL,32000,0,32000,235,0,32235
141925203100000,NW 314,RESIDENTIAL,18900,0,18900,171668,0,190568
141925203200000,NW 314,RESIDENTIAL,41511,0,41511,89833,0,131344
141925203300000,NW 314,RESIDENTIAL,37192,0,37192,74839,0,112031
141925203400000,NW 314,RESIDENTIAL,46350,0,46350,62718,0,109068
141925203500000,NW 314,RESIDENTIAL,30235,0,30235,78796,0,109031
141927600100000,NW 308,RESIDENTIAL,45136,0,45136,51467,0,96603
141927600300000,NW 308,RESIDENTIAL,19845,0,19845,14844,0,34689
141927600400000,NW 308,RESIDENTIAL,17766,0,17766,64743,0,82509
141927600500000,NW 308,RESIDENTIAL,29016,0,29016,48125,0,77141
141927600600000,NW 308,RESIDENTIAL,20141,0,20141,116576,0,136717
141927600700000,APARTMENT,COMMERCIAL,0,20854,20854,0,147140,167994
141927600800000,APARTMENT,COMMERCIAL,0,25625,25625,0,185779,211404
141927600900000,NW 308,RESIDENTIAL,24890,0,24890,99889,0,124779
141927601000000,NW 308,RESIDENTIAL,30188,0,30188,87837,0,118025
141927601100000,NW 308,RESIDENTIAL,24675,0,24675,86106,0,110781
141927601200000,NW 308,RESIDENTIAL,23448,0,23448,85565,0,109013
141927601300000,NW 308,RESIDENTIAL,27245,0,27245,119621,0,146866
141927601400000,NW 308,RESIDENTIAL,26790,0,26790,95211,0,122001
141927601500000,NW 308,RESIDENTIAL,29431,0,29431,73201,0,102632
141927601600000,NW 308,RESIDENTIAL,24617,0,24617,111531,0,136148
141927601700000,NW 308,RESIDENTIAL,24888,0,24888,128492,0,153380
141927700100000,NW 308,RESIDENTIAL,22844,0,22844,83734,0,106578
141927700200000,NW 308,RESIDENTIAL,22747,0,22747,119630,0,142377
141927700300000,NW 308,RESIDENTIAL,23263,0,23263,91930,0,115193
141927700400000,NW 308,RESIDENTIAL,26340,0,26340,89638,0,115978
141927700500000,NW 308,RESIDENTIAL,27581,0,27581,60730,0,88311
141927700600000,NW 308,RESIDENTIAL,31824,0,31824,122535,0,154359
141927700700000,NW 308,RESIDENTIAL,27609,0,27609,90689,0,118298
141927700800000,NW 308,RESIDENTIAL,24508,0,24508,88238,0,112746
141927700900000,NW 308,RESIDENTIAL,25764,0,25764,98528,0,124292
141927701000000,NW 308,RESIDENTIAL,25748,0,25748,84285,0,110033
141927701100000,NW 308,RESIDENTIAL,25866,0,25866,79604,0,105470
141927701200000,NW 308,RESIDENTIAL,26135,0,26135,95029,0,121164
141927701300000,NW 308,RESIDENTIAL,25792,0,25792,103557,0,129349
141927701400000,NW 308,RESIDENTIAL,25792,0,25792,98910,0,124702
141927701500000,NW 308,RESIDENTIAL,26711,0,26711,95771,0,122482
141927800100000,NW 308,RESIDENTIAL,27083,0,27083,124498,0,151581
141927800200000,NW 308,RESIDENTIAL,31361,0,31361,130310,0,161671
141927900100000,NW 308,RESIDENTIAL,24608,0,24608,117409,0,142017
141927900200000,NW 308,RESIDENTIAL,82450,0,82450,0,0,82450
141927900300000,NW 308,RESIDENTIAL,74350,0,74350,215454,0,289804
141927900400000,NW 308,RESIDENTIAL,22565,0,22565,90536,0,113101
141927900500000,NW 308,RESIDENTIAL,22560,0,22560,93121,0,115681
141927900600000,NW 308,RESIDENTIAL,22560,0,22560,109064,0,131624
141927900700000,NW 308,RESIDENTIAL,22560,0,22560,95081,0,117641
141927900800000,NW 308,RESIDENTIAL,22853,0,22853,98147,0,121000
141927900900000,NW 308,RESIDENTIAL,22751,0,22751,78915,0,101666
141927901000000,NW 308,RESIDENTIAL,22560,0,22560,97268,0,119828
141927901100000,NW 308,RESIDENTIAL,22560,0,22560,97359,0,119919
141927901200000,NW 308,RESIDENTIAL,22560,0,22560,82373,0,104933
141927901300000,NW 308,RESIDENTIAL,22688,0,22688,90536,0,113224
141927901400000,NW 308,RESIDENTIAL,25023,0,25023,81186,0,106209
141927901500000,NW 308,RESIDENTIAL,24816,0,24816,91732,0,116548
141927901600000,NW 308,RESIDENTIAL,24816,0,24816,88828,0,113644
141927901700000,NW 308,RESIDENTIAL,24816,0,24816,89895,0,114711
141927901800000,NW 308,RESIDENTIAL,24946,0,24946,99924,0,124870
141927901900000,NW 308,RESIDENTIAL,22678,0,22678,83978,0,106656
141927902000000,NW 308,RESIDENTIAL,22560,0,22560,76832,0,99392
141927902100000,NW 308,RESIDENTIAL,22560,0,22560,85453,0,108013
141927902200000,NW 308,RESIDENTIAL,22560,0,22560,80429,0,102989
141927902300000,NW 308,RESIDENTIAL,22846,0,22846,75596,0,98442
141927902400000,SCHOOL,EXEMPT,0,0,0,0,0,0
141927902500000,NW 308,RESIDENTIAL,29425,0,29425,142167,0,171592
141927902600000,NW 308,RESIDENTIAL,27445,0,27445,170232,0,197677
141927902700000,NW 308,RESIDENTIAL,28566,0,28566,133972,0,162538
141927902800000,NW 308,RESIDENTIAL,28566,0,28566,137310,0,165876
141927902900000,NW 308,RESIDENTIAL,28566,0,28566,138045,0,166611
141927903000000,NW 308,RESIDENTIAL,27156,0,27156,120740,0,147896
141927903100000,NW 308,RESIDENTIAL,22955,0,22955,94407,0,117362
141927903200000,NW 308,RESIDENTIAL,23280,0,23280,99987,0,123267
141927903300000,NW 308,RESIDENTIAL,23280,0,23280,105571,0,128851
141927903400000,NW 308,RESIDENTIAL,23280,0,23280,104260,0,127540
141927903500000,NW 308,RESIDENTIAL,23280,0,23280,115148,0,138428
141928000100000,NW 308,RESIDENTIAL,29260,0,29260,137380,0,166640
141928000200000,NW 308,RESIDENTIAL,30589,0,30589,199098,0,229687
141928100100000,NW 308,RESIDENTIAL,29695,0,29695,176458,0,206153
141930100100000,NW 308,RESIDENTIAL,29743,0,29743,142365,0,172108
141930100200000,NW 308,RESIDENTIAL,31634,0,31634,165266,0,196900
141930100300000,NW 308,RESIDENTIAL,33322,0,33322,137440,0,170762
141930100400000,NW 308,RESIDENTIAL,34793,0,34793,168245,0,203038
141930100500000,NW 308,RESIDENTIAL,23520,0,23520,130684,0,154204
141930100600000,NW 308,RESIDENTIAL,37634,0,37634,94068,0,131702
141930100700000,NW 308,RESIDENTIAL,37961,0,37961,47631,0,85592
141930100800000,NW 308,RESIDENTIAL,38288,0,38288,60430,0,98718
141930100900000,NW 308,RESIDENTIAL,38288,0,38288,75195,0,113483
141930101000000,NW 308,RESIDENTIAL,63550,0,63550,226911,0,290461
141930101100000,NW 308,RESIDENTIAL,38288,0,38288,87016,0,125304
141930101200000,NW 308,RESIDENTIAL,39011,0,39011,111322,0,150333
141930101300000,NW 308,RESIDENTIAL,30683,0,30683,81399,0,112082
141930101400000,NW 308,RESIDENTIAL,27741,0,27741,124196,0,151937
141930101500000,NW 308,RESIDENTIAL,27300,0,27300,95573,0,122873
141930101600000,NW 308,RESIDENTIAL,29274,0,29274,112543,0,141817
141930200100000,NW 308,RESIDENTIAL,21132,0,21132,114023,0,135155
141930200200000,NW 308,RESIDENTIAL,24561,0,24561,93055,0,117616
141930200300000,NW 308,RESIDENTIAL,24561,0,24561,101864,0,126425
141930200400000,NW 308,RESIDENTIAL,24561,0,24561,100825,0,125386
141930200500000,NW 308,RESIDENTIAL,24561,0,24561,102063,0,126624
141930200600000,NW 308,RESIDENTIAL,52957,0,52957,67095,0,120052
141930200700000,NW 308,RESIDENTIAL,23086,0,23086,118213,0,141299
141930200800000,NW 308,RESIDENTIAL,24798,0,24798,107770,0,132568
141930200900000,NW 308,RESIDENTIAL,24931,0,24931,91548,0,116479
141930201000000,NW 308,RESIDENTIAL,30623,0,30623,120505,0,151128
141930201100000,NW 308,RESIDENTIAL,31864,0,31864,144565,0,176429
141930201200000,NW 308,RESIDENTIAL,31521,0,31521,59753,0,91274
141930201300000,NW 308,RESIDENTIAL,31621,0,31621,59748,0,91369
141930201400000,NW 308,RESIDENTIAL,27767,0,27767,95230,0,122997
141930201500000,NW 308,RESIDENTIAL,28747,0,28747,106592,0,135339
141930201600000,NW 308,RESIDENTIAL,27245,0,27245,103017,0,130262
141930201700000,NW 308,RESIDENTIAL,27443,0,27443,92586,0,120029
141930201800000,NW 308,RESIDENTIAL,27229,0,27229,124140,0,151369
141930201900000,NW 308,RESIDENTIAL,26166,0,26166,91526,0,117692
141930202000000,NW 308,RESIDENTIAL,27254,0,27254,104805,0,132059
141930202100000,NW 308,RESIDENTIAL,30192,0,30192,164610,0,194802
141930202200000,NW 308,RESIDENTIAL,61650,0,61650,60653,0,122303
141930202300000,NW 308,RESIDENTIAL,58425,0,58425,65609,0,124034
141930202400000,NW 308,RESIDENTIAL,27232,0,27232,62335,0,89567
141930202500000,NW 308,RESIDENTIAL,25148,0,25148,44108,0,69256
141930202600000,NW 308,RESIDENTIAL,27306,0,27306,86906,0,114212
141930202700000,NW 308,RESIDENTIAL,37730,0,37730,41277,0,79007
141930202800000,NW 308,RESIDENTIAL,24239,0,24239,100571,0,124810
141930300100000,NW 308,RESIDENTIAL,24807,0,24807,117229,0,142036
141930300200000,NW 308,RESIDENTIAL,24807,0,24807,116103,0,140910
141930300300000,NW 308,RESIDENTIAL,24807,0,24807,120055,0,144862
141930300400000,NW 308,RESIDENTIAL,24807,0,24807,112014,0,136821
141930300500000,NW 308,RESIDENTIAL,24807,0,24807,111597,0,136404
141930300600000,NW 308,RESIDENTIAL,25389,0,25389,115649,0,141038
141930300700000,NW 323,RESIDENTIAL,31945,0,31945,159822,0,191767
141930300800000,NW 323,RESIDENTIAL,33035,0,33035,153276,0,186311
141930300900000,NW 323,RESIDENTIAL,28218,0,28218,119988,0,148206
141930301000000,NW 323,RESIDENTIAL,28200,0,28200,0,0,28200
141930301100000,NW 323,RESIDENTIAL,34448,0,34448,136640,0,171088
141930301200000,NW 323,RESIDENTIAL,33008,0,33008,133554,0,166562
141930301300000,NW 323,RESIDENTIAL,33132,0,33132,129411,0,162543
141930301400000,NW 323,RESIDENTIAL,31912,0,31912,141655,0,173567
141930301500000,NW 323,RESIDENTIAL,32797,0,32797,139934,0,172731
141930400100000,NW 323,RESIDENTIAL,32997,0,32997,116534,0,149531
141930400200000,NW 308,RESIDENTIAL,29400,0,29400,69841,0,99241
141930400300000,NW 308,RESIDENTIAL,29048,0,29048,62373,0,91421
141930400400000,NW 308,RESIDENTIAL,26013,0,26013,77295,0,103308
141930400500000,NW 308,RESIDENTIAL,26000,0,26000,99721,0,125721
141930400600000,NW 308,RESIDENTIAL,26000,0,26000,87768,0,113768
141930400700000,NW 308,RESIDENTIAL,26000,0,26000,101623,0,127623
141930400800000,NW 308,RESIDENTIAL,22572,0,22572,103243,0,125815
141930400900000,NW 308,RESIDENTIAL,22572,0,22572,99775,0,122347
141930401000000,NW 308,RESIDENTIAL,22572,0,22572,97973,0,120545
141930401100000,NW 308,RESIDENTIAL,22572,0,22572,101461,0,124033
141930401200000,NW 308,RESIDENTIAL,22536,0,22536,97327,0,119863
141930401300000,NW 308,RESIDENTIAL,30366,0,30366,0,0,30366
141930401400000,NW 308,RESIDENTIAL,31350,0,31350,0,0,31350
141930401500000,NW 323,RESIDENTIAL,29743,0,29743,119112,0,148855
141930401600000,NW 323,RESIDENTIAL,29760,0,29760,119485,0,149245
141930500100000,NW 323,RESIDENTIAL,30825,0,30825,176948,0,207773
141930500200000,NW 323,RESIDENTIAL,30455,0,30455,108457,0,138912
141930500300000,NW 323,RESIDENTIAL,29056,0,29056,122111,0,151167
141930500400000,NW 323,RESIDENTIAL,30400,0,30400,133790,0,164190
141930500500000,NW 323,RESIDENTIAL,30400,0,30400,144453,0,174853
141930500600000,NW 323,RESIDENTIAL,30400,0,30400,130155,0,160555
141930500700000,NW 323,RESIDENTIAL,30400,0,30400,115174,0,145574
141930500800000,NW 323,RESIDENTIAL,30381,0,30381,125644,0,156025
141930500900000,NW 308,RESIDENTIAL,23554,0,23554,91363,0,114917
141930501000000,NW 308,RESIDENTIAL,24172,0,24172,92174,0,116346
141930600100000,NW 308,RESIDENTIAL,20888,0,20888,96033,0,116921
141930600200000,NW 308,RESIDENTIAL,21560,0,21560,109027,0,130587
141932600100000,NW 308,RESIDENTIAL,31002,0,31002,101705,0,132707
141932700100000,NW 314,RESIDENTIAL,26565,0,26565,65581,0,92146
141932700200000,NW 314,RESIDENTIAL,30030,0,30030,111229,0,141259
141932800100000,NW 314,RESIDENTIAL,31131,0,31131,55619,0,86750
141932800200000,NW 314,RESIDENTIAL,28003,0,28003,80369,0,108372
141932800300000,NW 314,RESIDENTIAL,28813,0,28813,121587,0,150400
141932800400000,NW 314,RESIDENTIAL,28105,0,28105,49229,0,77334
141932900100000,NW 308,RESIDENTIAL,27767,0,27767,130648,0,158415
141932900200000,NW 314,RESIDENTIAL,26347,0,26347,165371,0,191718
141932900300000,NW 314,RESIDENTIAL,27972,0,27972,125536,0,153508
141932900400000,NW 314,RESIDENTIAL,30323,0,30323,97001,0,127324
141932900500000,NW 314,RESIDENTIAL,29307,0,29307,148154,0,177461
141932900600000,NW 314,RESIDENTIAL,28783,0,28783,129106,0,157889
141932900700000,NW 308,RESIDENTIAL,39619,0,39619,96164,0,135783
141932900800000,NW 308,RESIDENTIAL,34934,0,34934,15735,0,50669
141932900900000,NW 308,RESIDENTIAL,31080,0,31080,44303,0,75383
141933000200000,NW 314,RESIDENTIAL,39060,0,39060,78196,0,117256
141933000300000,NW 314,RESIDENTIAL,35000,0,35000,96219,0,131219
141933000400000,NW 314,RESIDENTIAL,24620,0,24620,65157,0,89777
141933000500000,NW 314,RESIDENTIAL,26478,0,26478,78184,0,104662
141933000600000,NW 314,RESIDENTIAL,24513,0,24513,95084,0,119597
141933000700000,NW 314,RESIDENTIAL,35131,0,35131,103340,0,138471
141933000800000,NW 314,RESIDENTIAL,28238,0,28238,97689,0,125927
141933000900000,NW 314,RESIDENTIAL,26701,0,26701,109808,0,136509
141933001000000,NW 314,RESIDENTIAL,30398,0,30398,157019,0,187417
141933001100000,NW 314,RESIDENTIAL,32875,0,32875,93478,0,126353
141933001200000,NW 314,RESIDENTIAL,32485,0,32485,173556,0,206041
141933001300000,NW 314,RESIDENTIAL,24000,0,24000,87673,0,111673
141933001400000,NW 314,RESIDENTIAL,25334,0,25334,79317,0,104651
141933001500000,NW 314,RESIDENTIAL,24563,0,24563,96897,0,121460
141933001600000,NW 314,RESIDENTIAL,24067,0,24067,79016,0,103083
141933001700000,NW 314,RESIDENTIAL,25536,0,25536,88449,0,113985
141933001800000,NW 314,RESIDENTIAL,26330,0,26330,77180,0,103510
141933001900000,NW 314,RESIDENTIAL,5242,0,5242,0,0,5242
141933002000000,NW 314,RESIDENTIAL,5564,0,5564,0,0,5564
141933002100000,NW 314,RESIDENTIAL,4440,0,4440,0,0,4440
141933002200000,NW 314,RESIDENTIAL,25763,0,25763,120392,0,146155
141933002300000,NW 314,RESIDENTIAL,30517,0,30517,88770,0,119287
141933002400000,NW 314,RESIDENTIAL,26676,0,26676,90284,0,116960
141933002500000,NW 314,RESIDENTIAL,24000,0,24000,96063,0,120063
141933002600000,NW 314,RESIDENTIAL,24000,0,24000,99618,0,123618
141933002700000,NW 314,RESIDENTIAL,24000,0,24000,85530,0,109530
141933002800000,NW 314,RESIDENTIAL,31640,0,31640,89199,0,120839
141933003100000,NW 314,RESIDENTIAL,31191,0,31191,71449,0,102640
141933003200000,NW 314,RESIDENTIAL,26520,0,26520,99938,0,126458
141933003300000,NW 314,RESIDENTIAL,31378,0,31378,107906,0,139284
141933003400000,NW 314,RESIDENTIAL,28816,0,28816,87668,0,116484
141933003500000,NW 314,RESIDENTIAL,36453,0,36453,120390,0,156843
141933003600000,NW 314,RESIDENTIAL,42325,0,42325,58572,0,100897
141933003700000,NW 314,RESIDENTIAL,36000,0,36000,183111,0,219111
141933003800000,NW 314,RESIDENTIAL,34320,0,34320,52326,0,86646
141933003900000,NW 314,RESIDENTIAL,29400,0,29400,141598,0,170998
141933004000000,NW 314,RESIDENTIAL,32562,0,32562,0,0,32562
141933004100000,NW 314,RESIDENTIAL,32300,0,32300,99239,0,131539
141933100100000,NW 314,RESIDENTIAL,26008,0,26008,84626,0,110634
141933100200000,NW 314,RESIDENTIAL,27152,0,27152,104343,0,131495
141933100300000,NW 314,RESIDENTIAL,26045,0,26045,80280,0,106325
141933100400000,NW 314,RESIDENTIAL,32130,0,32130,77413,0,109543
141933100500000,NW 314,RESIDENTIAL,43686,0,43686,43343,0,87029
141933100600000,NW 314,RESIDENTIAL,26000,0,26000,69681,0,95681
141933100700000,NW 314,RESIDENTIAL,26000,0,26000,71584,0,97584
141933100800000,NW 314,RESIDENTIAL,26000,0,26000,80403,0,106403
141933100900000,NW 314,RESIDENTIAL,26000,0,26000,88429,0,114429
141933101000000,NW 314,RESIDENTIAL,24000,0,24000,72949,0,96949
141933200100000,NW 308,RESIDENTIAL,26600,0,26600,97501,0,124101
141933200200000,NW 308,RESIDENTIAL,26588,0,26588,103422,0,130010
141933200300000,NW 314,RESIDENTIAL,29400,0,29400,73345,0,102745
141933200400000,NW 314,RESIDENTIAL,28046,0,28046,77500,0,105546
141933200500000,NW 314,RESIDENTIAL,42595,0,42595,105393,0,147988
141933200600000,NW 314,RESIDENTIAL,28890,0,28890,114962,0,143852
141933200700000,NW 314,RESIDENTIAL,26000,0,26000,62838,0,88838
141933200800000,NW 314,RESIDENTIAL,39000,0,39000,81925,0,120925
141933200900000,NW 314,RESIDENTIAL,42490,0,42490,111333,0,153823
141933201000000,NW 314,RESIDENTIAL,33280,0,33280,88272,0,121552
141933201100000,NW 314,RESIDENTIAL,39000,0,39000,78170,0,117170
141933201200000,NW 314,RESIDENTIAL,34149,0,34149,76882,0,111031
141933201300000,NW 314,RESIDENTIAL,24507,0,24507,96144,0,120651
141933201400000,NW 314,RESIDENTIAL,24400,0,24400,84393,0,108793
141933201500000,NW 314,RESIDENTIAL,24400,0,24400,90599,0,114999
141933201600000,NW 314,RESIDENTIAL,26370,0,26370,94671,0,121041
141933201700000,NW 314,RESIDENTIAL,25116,0,25116,99915,0,125031
141933201800000,NW 314,RESIDENTIAL,24156,0,24156,89496,0,113652
141933201900000,NW 314,RESIDENTIAL,24156,0,24156,75592,0,99748
141933202000000,NW 314,RESIDENTIAL,24156,0,24156,77888,0,102044
141933202100000,NW 314,RESIDENTIAL,24156,0,24156,76730,0,100886
141933202200000,NW 314,RESIDENTIAL,26205,0,26205,74250,0,100455
141933202300000,NW 314,RESIDENTIAL,28000,0,28000,142872,0,170872
141933202400000,NW 314,RESIDENTIAL,26320,0,26320,119081,0,145401
141933202500000,NW 308,RESIDENTIAL,22996,0,22996,95159,0,118155
141933202600000,NW 308,RESIDENTIAL,22572,0,22572,94369,0,116941
141933300100000,NW 308,RESIDENTIAL,21560,0,21560,87730,0,109290
141933300200000,NW 308,RESIDENTIAL,22004,0,22004,89134,0,111138
141933300300000,NW 314,RESIDENTIAL,27720,0,27720,97555,0,125275
141933300400000,NW 314,RESIDENTIAL,27720,0,27720,105253,0,132973
141933300500000,NW 314,RESIDENTIAL,25895,0,25895,96213,0,122108
141933300600000,NW 314,RESIDENTIAL,24156,0,24156,68092,0,92248
141933300700000,NW 314,RESIDENTIAL,24156,0,24156,87166,0,111322
141933300800000,NW 314,RESIDENTIAL,24156,0,24156,91736,0,115892
141933300900000,NW 314,RESIDENTIAL,24156,0,24156,75573,0,99729
141933301000000,NW 314,RESIDENTIAL,24973,0,24973,86470,0,111443
141935100300000,CHURCH,EXEMPT,0,1708,1708,0,0,1708
141935100400000,NW 322,RESIDENTIAL,1525,0,1525,0,0,1525
141935101100000,FUNERAL HOME,COMMERCIAL,0,259125,259125,0,404778,663903
141935101200000,NW 324,RESIDENTIAL,2530,0,2530,960,0,3490
141935101300000,NW 324,RESIDENTIAL,26795,0,26795,112853,0,139648
141935101400000,NW 324,RESIDENTIAL,25200,0,25200,92458,0,117658
141935101500000,NW 324,RESIDENTIAL,25200,0,25200,106316,0,131516
141935101600000,NW 324,RESIDENTIAL,24978,0,24978,120304,0,145282
141935101700000,NW 324,RESIDENTIAL,24727,0,24727,105758,0,130485
141935101800000,APARTMENT,COMMERCIAL,0,25495,25495,0,134267,159762
141935101900000,NW 324,RESIDENTIAL,24913,0,24913,96825,0,121738
141935102000000,NW 324,RESIDENTIAL,23280,0,23280,103587,0,126867
141935102100000,NW 324,RESIDENTIAL,23280,0,23280,120630,0,143910
141935102200000,NW 324,RESIDENTIAL,23040,0,23040,88430,0,111470
141935102300000,NW 324,RESIDENTIAL,24960,0,24960,93649,0,118609
141935102400000,NW 324,RESIDENTIAL,24363,0,24363,96868,0,121231
141935102500000,NW 324,RESIDENTIAL,23040,0,23040,92936,0,115976
141935102600000,NW 324,RESIDENTIAL,23280,0,23280,76200,0,99480
141935102700000,NW 324,RESIDENTIAL,23280,0,23280,80411,0,103691
141935102800000,NW 324,RESIDENTIAL,24337,0,24337,73972,0,98309
141935102900000,APARTMENT,COMMERCIAL,0,24862,24862,0,118182,143044
141935103000000,APARTMENT,COMMERCIAL,0,21635,21635,0,115735,137370
141935103100000,OFFICE,COMMERCIAL,0,56039,56039,0,199844,255883
141935103200000,NW 324,RESIDENTIAL,23994,0,23994,95960,0,119954
141935103300000,NW 324,RESIDENTIAL,23280,0,23280,80546,0,103826
141935103400000,NW 324,RESIDENTIAL,23280,0,23280,94540,0,117820
141935103500000,NW 324,RESIDENTIAL,23280,0,23280,93578,0,116858
141935103600000,NW 324,RESIDENTIAL,24050,0,24050,100068,0,124118
141935103800000,CHURCH,EXEMPT,0,494208,494208,0,783535,1277743
141935200100000,SR/NURSING/ASSTD LIV,COMMERCIAL,0,142738,142738,0,3867147,4009885
141935200200000,SR/NURSING/ASSTD LIV,COMMERCIAL,0,156000,156000,0,3931817,4087817
141935200300000,NW 324,RESIDENTIAL,56737,0,56737,122276,0,179013
141935200400000,SR/NURSING/ASSTD LIV,COMMERCIAL,0,168800,168800,0,2968479,3137279
141935200500000,NW 324,RESIDENTIAL,31351,0,31351,69446,0,100797
141935200600000,SHOP,COMMERCIAL,0,125145,125145,0,374997,500142
141935200700000,CONVENIENCE STORE,COMMERCIAL,0,425700,425700,0,586469,1012169
141935200800000,CHURCH,EXEMPT,0,806760,806760,0,429812,1236572
141935200900000,NW 324,RESIDENTIAL,29441,0,29441,115695,0,145136
141935201000000,OFFICE,COMMERCIAL,0,139050,139050,0,601950,741000
141935201100000,OFFICE,COMMERCIAL,0,148650,148650,0,632297,780947
141935201200000,WAREHOUSE;MINI STORG,COMMERCIAL,0,95200,95200,0,16613,111813
141937600100000,NW 322,RESIDENTIAL,25753,0,25753,103121,0,128874
141937600200000,NW 323,RESIDENTIAL,30746,0,30746,172546,0,203292
141937600300000,NW 323,RESIDENTIAL,31744,0,31744,154193,0,185937
141937600400000,NW 323,RESIDENTIAL,31944,0,31944,137720,0,169664
141937600500000,NW 323,RESIDENTIAL,32864,0,32864,129121,0,161985
141937600600000,NW 323,RESIDENTIAL,32956,0,32956,152581,0,185537
141937600700000,NW 323,RESIDENTIAL,37664,0,37664,141310,0,178974
141937600800000,NW 323,RESIDENTIAL,31659,0,31659,150086,0,181745
141937600900000,NW 323,RESIDENTIAL,35182,0,35182,185941,0,221123
141937601000000,NW 323,RESIDENTIAL,37054,0,37054,186961,0,224015
141937601100000,NW 323,RESIDENTIAL,30659,0,30659,165788,0,196447
141937601200000,NW 323,RESIDENTIAL,28224,0,28224,157987,0,186211
141937601300000,NW 323,RESIDENTIAL,34301,0,34301,140546,0,174847
141937601400000,NW 323,RESIDENTIAL,94650,0,94650,216273,0,310923
141937601500000,NW 323,RESIDENTIAL,34259,0,34259,181735,0,215994
141937601600000,NW 323,RESIDENTIAL,34381,0,34381,155807,0,190188
141937601700000,NW 323,RESIDENTIAL,33962,0,33962,139478,0,173440
141937601800000,NW 323,RESIDENTIAL,33640,0,33640,137493,0,171133
141937601900000,NW 323,RESIDENTIAL,32680,0,32680,158537,0,191217
141937602000000,NW 323,RESIDENTIAL,28030,0,28030,174597,0,202627
141937602100000,NW 323,RESIDENTIAL,30045,0,30045,139991,0,170036
141937602200000,NW 323,RESIDENTIAL,32023,0,32023,135989,0,168012
141937602300000,NW 323,RESIDENTIAL,28281,0,28281,174135,0,202416
141937602400000,NW 322,RESIDENTIAL,25287,0,25287,99699,0,124986
141937602500000,NW 322,RESIDENTIAL,25371,0,25371,105653,0,131024
141937602600000,NW 323,RESIDENTIAL,28534,0,28534,124057,0,152591
141937602700000,NW 323,RESIDENTIAL,32995,0,32995,132205,0,165200
141937602800000,NW 323,RESIDENTIAL,32203,0,32203,141852,0,174055
141937602900000,NW 323,RESIDENTIAL,32292,0,32292,131332,0,163624
141937603000000,NW 323,RESIDENTIAL,31087,0,31087,125910,0,156997
141937603100000,NW 323,RESIDENTIAL,30871,0,30871,138315,0,169186
141937603200000,NW 323,RESIDENTIAL,30492,0,30492,122701,0,153193
141937603300000,NW 323,RESIDENTIAL,31040,0,31040,126880,0,157920
141937603400000,NW 323,RESIDENTIAL,31360,0,31360,128070,0,159430
141937603500000,NW 323,RESIDENTIAL,31680,0,31680,144780,0,176460
141937603600000,NW 323,RESIDENTIAL,31040,0,31040,110953,0,141993
141937603700000,NW 323,RESIDENTIAL,31040,0,31040,126240,0,157280
141937603800000,NW 323,RESIDENTIAL,31040,0,31040,127690,0,158730
141937700100000,NW 322,RESIDENTIAL,23921,0,23921,114944,0,138865
141937700200000,NW 322,RESIDENTIAL,23668,0,23668,104778,0,128446
141937700300000,NW 322,RESIDENTIAL,25303,0,25303,106921,0,132224
141937700400000,NW 322,RESIDENTIAL,23668,0,23668,90841,0,114509
141937700500000,NW 322,RESIDENTIAL,25303,0,25303,125479,0,150782
141937700600000,NW 322,RESIDENTIAL,23668,0,23668,110137,0,133805
141937700700000,NW 322,RESIDENTIAL,23668,0,23668,95759,0,119427
141937700800000,NW 322,RESIDENTIAL,23668,0,23668,97632,0,121300
141937701000000,NW 322,RESIDENTIAL,23668,0,23668,109308,0,132976
141937701100000,NW 322,RESIDENTIAL,24092,0,24092,103702,0,127794
141937701200000,NW 322,RESIDENTIAL,35248,0,35248,110191,0,145439
141937800100000,NW 323,RESIDENTIAL,30080,0,30080,137767,0,167847
141937800200000,NW 323,RESIDENTIAL,29328,0,29328,117767,0,147095
141937800300000,NW 323,RESIDENTIAL,29328,0,29328,122284,0,151612
141937800400000,NW 323,RESIDENTIAL,29640,0,29640,145578,0,175218
141937800500000,NW 323,RESIDENTIAL,29952,0,29952,167854,0,197806
141937800600000,NW 323,RESIDENTIAL,30264,0,30264,155627,0,185891
141937800700000,NW 323,RESIDENTIAL,31266,0,31266,142845,0,174111
141937800800000,NW 323,RESIDENTIAL,30968,0,30968,147485,0,178453
141937800900000,NW 323,RESIDENTIAL,31733,0,31733,149607,0,181340
141937801000000,NW 323,RESIDENTIAL,33280,0,33280,169457,0,202737
141937801100000,NW 323,RESIDENTIAL,32969,0,32969,130380,0,163349
141937801200000,NW 323,RESIDENTIAL,33600,0,33600,131449,0,165049
141937801300000,NW 323,EXEMPT,0,32272,32272,0,143848,176120
141937801400000,NW 322,RESIDENTIAL,25446,0,25446,98914,0,124360
141937801500000,NW 322,RESIDENTIAL,26673,0,26673,90655,0,117328
141937900100000,NW 322,RESIDENTIAL,22295,0,22295,80247,0,102542
141937900200000,NW 322,RESIDENTIAL,22295,0,22295,76263,0,98558
141937900300000,NW 322,RESIDENTIAL,23436,0,23436,90412,0,113848
141937900400000,NW 322,RESIDENTIAL,23436,0,23436,74589,0,98025
141937900500000,NW 322,RESIDENTIAL,24039,0,24039,91623,0,115662
141937900600000,NW 322,RESIDENTIAL,25443,0,25443,96150,0,121593
141937900700000,NW 322,RESIDENTIAL,25695,0,25695,125852,0,151547
141937900800000,NW 322,RESIDENTIAL,26460,0,26460,101792,0,128252
141937900900000,NW 322,RESIDENTIAL,26816,0,26816,123862,0,150678
141937901000000,NW 322,RESIDENTIAL,24710,0,24710,97123,0,121833
141937901100000,NW 322,RESIDENTIAL,24816,0,24816,107778,0,132594
141937901200000,NW 322,RESIDENTIAL,25128,0,25128,92495,0,117623
141937901300000,NW 322,RESIDENTIAL,24502,0,24502,94792,0,119294
141937901400000,NW 322,RESIDENTIAL,25792,0,25792,78748,0,104540
141937901500000,NW 322,RESIDENTIAL,24010,0,24010,84443,0,108453
141937901600000,NW 322,RESIDENTIAL,22295,0,22295,104693,0,126988
141937901700000,NW 322,RESIDENTIAL,24010,0,24010,97073,0,121083
141937901800000,NW 322,RESIDENTIAL,25725,0,25725,90761,0,116486
141937901900000,NW 322,RESIDENTIAL,25200,0,25200,92455,0,117655
141937902000000,NW 322,RESIDENTIAL,24570,0,24570,76635,0,101205
141937902100000,NW 322,RESIDENTIAL,24336,0,24336,77087,0,101423
141937902200000,NW 322,RESIDENTIAL,25143,0,25143,112510,0,137653
141937902300000,NW 322,RESIDENTIAL,25200,0,25200,122998,0,148198
141937902400000,NW 322,RESIDENTIAL,25365,0,25365,77219,0,102584
141938000100000,NW 322,RESIDENTIAL,26229,0,26229,113851,0,140080
141938000200000,NW 322,RESIDENTIAL,24570,0,24570,82457,0,107027
141938000300000,NW 322,RESIDENTIAL,24852,0,24852,82998,0,107850
141938000400000,NW 322,RESIDENTIAL,23206,0,23206,96254,0,119460
141938000500000,NW 322,RESIDENTIAL,22848,0,22848,114835,0,137683
141938000600000,NW 322,RESIDENTIAL,22901,0,22901,87266,0,110167
141938000700000,NW 322,RESIDENTIAL,27300,0,27300,103460,0,130760
141938000800000,NW 322,RESIDENTIAL,25944,0,25944,100252,0,126196
141938000900000,NW 322,RESIDENTIAL,42206,0,42206,121060,0,163266
141938001000000,NW 322,RESIDENTIAL,25920,0,25920,98373,0,124293
141938001100000,NW 322,RESIDENTIAL,27305,0,27305,103776,0,131081
141938001200000,NW 322,RESIDENTIAL,27359,0,27359,97164,0,124523
141938001300000,NW 322,RESIDENTIAL,24478,0,24478,101280,0,125758
141938001400000,NW 322,RESIDENTIAL,22560,0,22560,92170,0,114730
141938001500000,NW 322,RESIDENTIAL,22800,0,22800,86881,0,109681
141938001600000,NW 322,RESIDENTIAL,23520,0,23520,88078,0,111598
141938001700000,NW 322,RESIDENTIAL,24618,0,24618,91576,0,116194
141938001800000,NW 322,RESIDENTIAL,22295,0,22295,95524,0,117819
141938001900000,NW 322,RESIDENTIAL,22295,0,22295,71298,0,93593
141938002000000,NW 322,RESIDENTIAL,22295,0,22295,95139,0,117434
141938002100000,NW 322,RESIDENTIAL,22295,0,22295,76955,0,99250
141938002200000,NW 322,RESIDENTIAL,22295,0,22295,92762,0,115057
141938002300000,NW 322,RESIDENTIAL,22295,0,22295,88131,0,110426
141938002400000,NW 322,RESIDENTIAL,23330,0,23330,78124,0,101454
141938002500000,NW 322,RESIDENTIAL,35666,0,35666,79853,0,115519
141938002600000,NW 322,RESIDENTIAL,22862,0,22862,87343,0,110205
141938002700000,NW 322,RESIDENTIAL,40653,0,40653,106391,0,147044
141940100100000,CITY PROPERTY,EXEMPT,0,0,0,0,0,0
141940100200000,NW 313,RESIDENTIAL,38400,0,38400,217045,0,255445
141940100300000,NW 313,RESIDENTIAL,32195,0,32195,212793,0,244988
141940100400000,NW 313,RESIDENTIAL,31973,0,31973,233501,0,265474
141940100500000,NW 313,RESIDENTIAL,36593,0,36593,210596,0,247189
141940100600000,NW 313,RESIDENTIAL,40949,0,40949,267233,0,308182
141940100700000,NW 313,RESIDENTIAL,35944,0,35944,271196,0,307140
141940100800000,NW 313,RESIDENTIAL,40787,0,40787,261213,0,302000
141940100900000,NW 313,RESIDENTIAL,40054,0,40054,284287,0,324341
141940101000000,NW 313,RESIDENTIAL,39924,0,39924,225799,0,265723
141940101100000,NW 313,RESIDENTIAL,46122,0,46122,238558,0,284680
141940101200000,NW 313,RESIDENTIAL,45562,0,45562,228414,0,273976
141940101300000,NW 313,RESIDENTIAL,47060,0,47060,215837,0,262897
141940101400000,NW 313,RESIDENTIAL,46968,0,46968,258032,0,305000
141940101500000,NW 313,RESIDENTIAL,41168,0,41168,228493,0,269661
141940101600000,NW 313,RESIDENTIAL,35700,0,35700,242904,0,278604
141940101700000,NW 313,RESIDENTIAL,34320,0,34320,107258,0,141578
141940101800000,NW 313,RESIDENTIAL,45696,0,45696,141064,0,186760
141940101900000,NW 313,RESIDENTIAL,38760,0,38760,117156,0,155916
141940102000000,NW 313,RESIDENTIAL,67040,0,67040,144995,0,212035
141940102100000,NW 313,RESIDENTIAL,40698,0,40698,102028,0,142726
141940102200000,NW 313,RESIDENTIAL,29640,0,29640,128086,0,157726
141940102300000,NW 313,RESIDENTIAL,30152,0,30152,122833,0,152985
141942600100000,NW 313,RESIDENTIAL,38206,0,38206,86280,0,124486
141942600200000,NW 313,RESIDENTIAL,27706,0,27706,113751,0,141457
141942600300000,NW 313,RESIDENTIAL,23205,0,23205,88593,0,111798
141942600400000,NW 313,RESIDENTIAL,24798,0,24798,115638,0,140436
141942600500000,NW 313,RESIDENTIAL,25253,0,25253,106093,0,131346
141942600600000,NW 313,RESIDENTIAL,43819,0,43819,36910,0,80729
141942600700000,NW 313,RESIDENTIAL,24379,0,24379,0,0,24379
141942600800000,NW 313,RESIDENTIAL,27527,0,27527,134283,0,161810
141942600900000,NW 313,RESIDENTIAL,33385,0,33385,55769,0,89154
141942601000000,NW 313,RESIDENTIAL,29400,0,29400,114255,0,143655
141942601100000,NW 313,RESIDENTIAL,30975,0,30975,125452,0,156427
141942601200000,NW 313,RESIDENTIAL,50710,0,50710,92193,0,142903
141942601300000,NW 313,RESIDENTIAL,30085,0,30085,87277,0,117362
141942601400000,NW 313,RESIDENTIAL,31518,0,31518,105591,0,137109
141942601500000,NW 313,RESIDENTIAL,39039,0,39039,101430,0,140469
141942700100000,NW 313,RESIDENTIAL,35640,0,35640,49327,0,84967
141942700200000,NW 313,RESIDENTIAL,48200,0,48200,56548,0,104748
141942700300000,NW 313,RESIDENTIAL,34116,0,34116,75766,0,109882
141942700400000,NW 313,RESIDENTIAL,51600,0,51600,134300,0,185900
141942700500000,NW 313,RESIDENTIAL,39060,0,39060,505,0,39565
141942700600000,NW 313,RESIDENTIAL,60550,0,60550,121557,0,182107
141942700700000,NW 313,RESIDENTIAL,60300,0,60300,94555,0,154855
141942700800000,NW 313,RESIDENTIAL,37217,0,37217,122261,0,159478
141942700900000,NW 313,RESIDENTIAL,34336,0,34336,99183,0,133519
141942701000000,NW 313,RESIDENTIAL,32760,0,32760,55783,0,88543
141942701100000,NW 313,RESIDENTIAL,31024,0,31024,196435,0,227459
141942701200000,NW 313,RESIDENTIAL,28420,0,28420,143716,0,172136
141942701300000,NW 313,RESIDENTIAL,28420,0,28420,129985,0,158405
141942701400000,NW 308,RESIDENTIAL,30166,0,30166,0,0,30166
141942701500000,NW 308,RESIDENTIAL,15162,0,15162,0,0,15162
141942701600000,NW 308,RESIDENTIAL,33755,0,33755,128819,0,162574
141942701700000,NW 313,RESIDENTIAL,33271,0,33271,136412,0,169683
141942701800000,NW 313,RESIDENTIAL,25438,0,25438,165942,0,191380
141942701900000,NW 313,RESIDENTIAL,24330,0,24330,101535,0,125865
141942702000000,NW 313,RESIDENTIAL,20518,0,20518,56154,0,76672
141942702100000,NW 313,RESIDENTIAL,20160,0,20160,0,0,20160
141942702200000,NW 308,RESIDENTIAL,20790,0,20790,103165,0,123955
141942800100000,NW 313,RESIDENTIAL,41623,0,41623,137676,0,179299
141942800200000,NW 313,RESIDENTIAL,25956,0,25956,110614,0,136570
141942800300000,NW 313,RESIDENTIAL,45433,0,45433,100270,0,145703
141942800400000,NW 313,RESIDENTIAL,42546,0,42546,103586,0,146132
141942800500000,NW 313,RESIDENTIAL,31083,0,31083,80965,0,112048
141942800600000,NW 313,RESIDENTIAL,29686,0,29686,89261,0,118947
141942800700000,NW 313,RESIDENTIAL,30492,0,30492,92533,0,123025
141942800800000,NW 313,RESIDENTIAL,46150,0,46150,95308,0,141458
141942800900000,NW 313,RESIDENTIAL,43286,0,43286,38020,0,81306
141942801000000,NW 313,RESIDENTIAL,32602,0,32602,109009,0,141611
141942801100000,NW 313,RESIDENTIAL,30479,0,30479,130676,0,161155
141942801200000,NW 313,RESIDENTIAL,39263,0,39263,105472,0,144735
141942801300000,NW 313,RESIDENTIAL,31914,0,31914,123927,0,155841
141942801400000,NW 313,RESIDENTIAL,28413,0,28413,110495,0,138908
141942801500000,NW 313,RESIDENTIAL,29307,0,29307,61749,0,91056
141942801600000,NW 313,RESIDENTIAL,31480,0,31480,218845,0,250325
141942801700000,NW 313,RESIDENTIAL,27440,0,27440,99367,0,126807
141942900100000,NW 313,RESIDENTIAL,22068,0,22068,126628,0,148696
141942900200000,NW 308,RESIDENTIAL,20136,0,20136,123013,0,143149
141942900300000,NW 308,RESIDENTIAL,22973,0,22973,73364,0,96337
141942900400000,NW 308,RESIDENTIAL,25749,0,25749,66358,0,92107
141942900500000,NW 313,RESIDENTIAL,25222,0,25222,96436,0,121658
141942900600000,NW 313,RESIDENTIAL,21056,0,21056,97346,0,118402
141942900700000,NW 313,RESIDENTIAL,22176,0,22176,93947,0,116123
141943000100000,NW 308,RESIDENTIAL,26418,0,26418,132802,0,159220
141943000200000,NW 308,RESIDENTIAL,24807,0,24807,124561,0,149368
141943000300000,NW 308,RESIDENTIAL,24807,0,24807,116200,0,141007
141943000400000,NW 323,RESIDENTIAL,32747,0,32747,142161,0,174908
141943000500000,NW 323,RESIDENTIAL,33164,0,33164,172495,0,205659
141943000600000,NW 323,RESIDENTIAL,33592,0,33592,0,0,33592
141943000700000,NW 313,RESIDENTIAL,27506,0,27506,114638,0,142144
141943000800000,NW 313,RESIDENTIAL,28495,0,28495,115897,0,144392
141943000900000,NW 313,RESIDENTIAL,28994,0,28994,125271,0,154265
141945100100000,NW 313,RESIDENTIAL,32278,0,32278,105213,0,137491
141945100200000,NW 313,RESIDENTIAL,30361,0,30361,102860,0,133221
141945100300000,NW 313,RESIDENTIAL,31122,0,31122,96656,0,127778
141945100400000,NW 322,RESIDENTIAL,32257,0,32257,111198,0,143455
141945100500000,NW 322,RESIDENTIAL,30141,0,30141,116191,0,146332
141945100600000,NW 322,RESIDENTIAL,22400,0,22400,113674,0,136074
141945100700000,NW 322,RESIDENTIAL,21933,0,21933,116729,0,138662
141945100800000,NW 322,RESIDENTIAL,24811,0,24811,87724,0,112535
141945100900000,NW 322,RESIDENTIAL,25312,0,25312,82348,0,107660
141945101000000,NW 322,RESIDENTIAL,24663,0,24663,122812,0,147475
141945101100000,NW 322,RESIDENTIAL,50000,0,50000,183841,0,233841
141945200100000,NW 313,RESIDENTIAL,33784,0,33784,91303,0,125087
141945200200000,NW 313,RESIDENTIAL,31500,0,31500,91666,0,123166
141945200300000,NW 313,RESIDENTIAL,28093,0,28093,113386,0,141479
141945200400000,NW 313,RESIDENTIAL,28467,0,28467,147478,0,175945
141945200500000,NW 313,RESIDENTIAL,26849,0,26849,80055,0,106904
141945200600000,NW 322,RESIDENTIAL,28613,0,28613,155286,0,183899
141945200700000,NW 322,RESIDENTIAL,26215,0,26215,0,0,26215
141945200800000,NW 322,RESIDENTIAL,41639,0,41639,58737,0,100376
141945200900000,NW 322,RESIDENTIAL,28552,0,28552,106622,0,135174
141945201000000,NW 322,RESIDENTIAL,29180,0,29180,103208,0,132388
141945201100000,NW 313,RESIDENTIAL,41920,0,41920,77619,0,119539
141945300100000,NW 322,RESIDENTIAL,30510,0,30510,87037,0,117547
141945300200000,NW 322,RESIDENTIAL,27930,0,27930,87685,0,115615
141945300300000,NW 322,RESIDENTIAL,28938,0,28938,91859,0,120797
141945300400000,NW 322,RESIDENTIAL,27685,0,27685,116393,0,144078
141945300500000,NW 322,RESIDENTIAL,27440,0,27440,79540,0,106980
141945300600000,NW 322,RESIDENTIAL,27504,0,27504,141797,0,169301
141945300700000,NW 322,RESIDENTIAL,31298,0,31298,139664,0,170962
141945300800000,NW 322,RESIDENTIAL,29568,0,29568,117956,0,147524
141945300900000,NW 322,RESIDENTIAL,26880,0,26880,127633,0,154513
141945301000000,NW 322,RESIDENTIAL,26880,0,26880,100921,0,127801
141945301100000,NW 322,RESIDENTIAL,28575,0,28575,116646,0,145221
141945301200000,NW 323,RESIDENTIAL,32879,0,32879,138938,0,171817
141945301300000,NW 323,RESIDENTIAL,31620,0,31620,139248,0,170868
141945301400000,NW 323,RESIDENTIAL,31620,0,31620,135365,0,166985
141945301500000,NW 323,RESIDENTIAL,31620,0,31620,135485,0,167105
141945301600000,NW 323,RESIDENTIAL,32075,0,32075,141539,0,173614
141945301700000,NW 323,RESIDENTIAL,36337,0,36337,144611,0,180948
141945301800000,NW 323,RESIDENTIAL,36749,0,36749,146430,0,183179
141945301900000,NW 323,RESIDENTIAL,38719,0,38719,150022,0,188741
141945302000000,NW 323,RESIDENTIAL,34218,0,34218,151808,0,186026
141945302100000,NW 323,RESIDENTIAL,33627,0,33627,146324,0,179951
141945302200000,NW 323,RESIDENTIAL,28777,0,28777,129006,0,157783
141945302300000,NW 323,RESIDENTIAL,29328,0,29328,132731,0,162059
141945302400000,NW 323,RESIDENTIAL,30080,0,30080,129675,0,159755
141945400100000,NW 323,RESIDENTIAL,31040,0,31040,144586,0,175626
141945400200000,NW 323,RESIDENTIAL,31040,0,31040,141940,0,172980
141945400300000,NW 323,RESIDENTIAL,31040,0,31040,144432,0,175472
141945400400000,NW 323,RESIDENTIAL,30400,0,30400,131052,0,161452
141945400500000,NW 323,RESIDENTIAL,30400,0,30400,117192,0,147592
141945400600000,NW 323,RESIDENTIAL,32948,0,32948,128503,0,161451
141945400700000,NW 323,RESIDENTIAL,33657,0,33657,151392,0,185049
141945400800000,NW 323,RESIDENTIAL,31041,0,31041,0,0,31041
141945400900000,NW 323,RESIDENTIAL,31040,0,31040,130994,0,162034
141945401000000,NW 323,RESIDENTIAL,31040,0,31040,114645,0,145685
141945500100000,NW 322,RESIDENTIAL,49240,0,49240,85372,0,134612
141945500200000,NW 322,RESIDENTIAL,48360,0,48360,0,0,48360
141945500300000,CITY PROPERTY,EXEMPT,0,0,0,0,0,0
141945500400000,NW 322,RESIDENTIAL,42706,0,42706,123831,0,166537
141945600100000,NW 322,RESIDENTIAL,29978,0,29978,125864,0,155842
141945600200000,NW 322,RESIDENTIAL,22560,0,22560,122121,0,144681
141945600300000,NW 322,RESIDENTIAL,25004,0,25004,110970,0,135974
141945600400000,NW 322,RESIDENTIAL,24705,0,24705,94691,0,119396
141945600500000,NW 322,RESIDENTIAL,24864,0,24864,112820,0,137684
141945600600000,NW 322,RESIDENTIAL,24651,0,24651,103667,0,128318
141945600700000,NW 322,RESIDENTIAL,25133,0,25133,139719,0,164852
141945600800000,NW 322,RESIDENTIAL,24598,0,24598,145171,0,169769
141945600900000,NW 322,RESIDENTIAL,25088,0,25088,118855,0,143943
141945601000000,NW 322,RESIDENTIAL,24354,0,24354,116296,0,140650
141945601100000,NW 322,RESIDENTIAL,23558,0,23558,105561,0,129119
141945601200000,NW 322,RESIDENTIAL,23882,0,23882,117018,0,140900
141945601300000,NW 322,RESIDENTIAL,24624,0,24624,87405,0,112029
141945601400000,NW 322,RESIDENTIAL,25142,0,25142,84068,0,109210
141945601500000,NW 322,RESIDENTIAL,25142,0,25142,94412,0,119554
141945601600000,NW 322,RESIDENTIAL,24541,0,24541,98516,0,123057
141945601700000,CITY PROPERTY,EXEMPT,0,0,0,0,0,0
141945601800000,NW 322,RESIDENTIAL,29680,0,29680,79016,0,108696
141945601900000,NW 322,RESIDENTIAL,22750,0,22750,95733,0,118483
141945602000000,NW 322,RESIDENTIAL,26775,0,26775,94446,0,121221
141945602100000,NW 322,RESIDENTIAL,38274,0,38274,105328,0,143602
141945602200000,NW 322,RESIDENTIAL,39019,0,39019,105575,0,144594
141945602300000,NW 322,RESIDENTIAL,28560,0,28560,101698,0,130258
141945700100000,NW 322,RESIDENTIAL,25659,0,25659,89892,0,115551
141945700200000,NW 322,RESIDENTIAL,24909,0,24909,67891,0,92800
141945700300000,NW 322,RESIDENTIAL,24909,0,24909,109886,0,134795
141945700400000,NW 322,RESIDENTIAL,34138,0,34138,112956,0,147094
141945700500000,NW 322,RESIDENTIAL,24909,0,24909,90242,0,115151
141945700600000,NW 322,RESIDENTIAL,22295,0,22295,80788,0,103083
141945700700000,NW 322,RESIDENTIAL,21609,0,21609,73797,0,95406
141947600100000,NW 312,RESIDENTIAL,26192,0,26192,97860,0,124052
141947600200000,NW 312,RESIDENTIAL,25650,0,25650,98308,0,123958
141947600300000,NW 312,RESIDENTIAL,26836,0,26836,124664,0,151500
141947600400000,NW 312,RESIDENTIAL,29120,0,29120,114571,0,143691
141947600500000,NW 312,RESIDENTIAL,26316,0,26316,119974,0,146290
141947600600000,NW 312,RESIDENTIAL,26316,0,26316,131998,0,158314
141947600700000,NW 312,RESIDENTIAL,29296,0,29296,132136,0,161432
141947600800000,NW 312,RESIDENTIAL,30416,0,30416,138800,0,169216
141947600900000,NW 312,RESIDENTIAL,28744,0,28744,105579,0,134323
141947601000000,NW 312,RESIDENTIAL,29030,0,29030,122033,0,151063
141947601100000,NW 312,RESIDENTIAL,29006,0,29006,121196,0,150202
141947601200000,NW 312,RESIDENTIAL,27090,0,27090,133438,0,160528
141947601300000,NW 312,RESIDENTIAL,27090,0,27090,100861,0,127951
141947601400000,NW 312,RESIDENTIAL,27090,0,27090,107890,0,134980
141947601500000,NW 312,RESIDENTIAL,27090,0,27090,118679,0,145769
141947601600000,NW 312,RESIDENTIAL,25908,0,25908,60266,0,86174
141947601700000,NW 312,RESIDENTIAL,26561,0,26561,85594,0,112155
141947601800000,NW 322,RESIDENTIAL,28560,0,28560,87690,0,116250
141947601900000,NW 322,RESIDENTIAL,28672,0,28672,87883,0,116555
141947602000000,NW 322,RESIDENTIAL,41720,0,41720,71385,0,113105
141947602100000,CHURCH,EXEMPT,0,229500,229500,0,212738,442238
141947700100000,NW 322,RESIDENTIAL,50400,0,50400,119331,0,169731
141947700200000,NW 322,RESIDENTIAL,50400,0,50400,127571,0,177971
141947700300000,CHURCH,EXEMPT,0,416286,416286,0,462193,878479
141947800100000,NW 322,RESIDENTIAL,42315,0,42315,155318,0,197633
141947800200000,NW 322,RESIDENTIAL,35781,0,35781,54198,0,89979
141947800300000,NW 322,RESIDENTIAL,49200,0,49200,75406,0,124606
141947800400000,NW 322,RESIDENTIAL,28140,0,28140,92281,0,120421
141947800500000,NW 322,RESIDENTIAL,32830,0,32830,79482,0,112312
141947800600000,NW 322,RESIDENTIAL,26282,0,26282,91864,0,118146
141947800700000,NW 322,RESIDENTIAL,24476,0,24476,103773,0,128249
141947800800000,NW 322,RESIDENTIAL,25253,0,25253,93709,0,118962
141947800900000,NW 322,RESIDENTIAL,29672,0,29672,112016,0,141688
141947801000000,NW 322,RESIDENTIAL,26224,0,26224,111004,0,137228
141947801100000,NW 322,RESIDENTIAL,33939,0,33939,71017,0,104956
141947900100000,CITY PROPERTY,EXEMPT,0,0,0,0,0,0
141947900200000,NW 322,RESIDENTIAL,65250,0,65250,145440,0,210690
141947900300000,NW 322,RESIDENTIAL,46425,0,46425,150471,0,196896
141947900400000,NW 322,RESIDENTIAL,43750,0,43750,75917,0,119667
141947900500000,NW 322,RESIDENTIAL,28498,0,28498,115651,0,144149
141947900600000,NW 322,RESIDENTIAL,30412,0,30412,68123,0,98535
141947900700000,NW 322,RESIDENTIAL,26211,0,26211,150163,0,176374
141947900800000,NW 322,RESIDENTIAL,26211,0,26211,104721,0,130932
141947900900000,NW 322,RESIDENTIAL,27563,0,27563,150300,0,177863
141947901000000,NW 322,RESIDENTIAL,31237,0,31237,62643,0,93880
141947901100000,NW 322,RESIDENTIAL,41326,0,41326,99893,0,141219
142010100100000,CITY PROPERTY,EXEMPT,0,0,0,0,0,0
142010100300000,NW 310,RESIDENTIAL,35400,0,35400,36520,0,71920
142010100400000,CITY PROPERTY,EXEMPT,0,0,0,0,0,0
142010100500000,NW 310,RESIDENTIAL,65205,0,65205,0,0,65205
142010100600000,CITY PROPERTY,EXEMPT,0,0,0,0,0,0
142010100700000,CITY PROPERTY,EXEMPT,0,0,0,0,0,0
142010100800000,NW 310,RESIDENTIAL,18720,0,18720,46335,0,65055
142010100900000,NW 310,RESIDENTIAL,13650,0,13650,31127,0,44777
142010101000000,NW 310,RESIDENTIAL,12741,0,12741,31796,0,44537
142010101100000,CITY PROPERTY,EXEMPT,0,0,0,0,0,0
142010101200000,NW 310,RESIDENTIAL,49459,0,49459,72816,0,122275
142010101300000,NW 310,RESIDENTIAL,28400,0,28400,5746,0,34146
142010101400000,CITY PROPERTY,EXEMPT,0,0,0,0,0,0
142010200100000,CITY PROPERTY,EXEMPT,0,0,0,0,0,0
142010200200000,CITY PROPERTY,EXEMPT,0,0,0,0,0,0
142010300100000,CITY PROPERTY,EXEMPT,0,0,0,0,0,0
142010300200000,NW 310,RESIDENTIAL,13686,0,13686,0,0,13686
142010300300000,CITY PROPERTY,EXEMPT,0,0,0,0,0,0
142010300400000,CITY PROPERTY,EXEMPT,0,0,0,0,0,0
142010300500000,CITY PROPERTY,EXEMPT,0,0,0,0,0,0
142010300600000,CITY PROPERTY,EXEMPT,0,0,0,0,0,0
142010300700000,CITY PROPERTY,EXEMPT,0,0,0,0,0,0
142010300800000,CITY PROPERTY,EXEMPT,0,0,0,0,0,0
142010300900000,CITY PROPERTY,EXEMPT,0,0,0,0,0,0
142010301000000,CITY PROPERTY,EXEMPT,0,0,0,0,0,0
142010301100000,CITY PROPERTY,EXEMPT,0,0,0,0,0,0
142010301200000,CITY PROPERTY,EXEMPT,0,0,0,0,0,0
142010301300000,CITY PROPERTY,EXEMPT,0,0,0,0,0,0
142010301400000,CITY PROPERTY,EXEMPT,0,0,0,0,0,0
142010301500000,CITY PROPERTY,EXEMPT,0,0,0,0,0,0
142010400100000,CITY PROPERTY,EXEMPT,0,0,0,0,0,0
142010400200000,NW 310,RESIDENTIAL,14850,0,14850,53948,0,68798
142010400300000,CITY PROPERTY,EXEMPT,0,0,0,0,0,0
142010400400000,CITY PROPERTY,EXEMPT,0,0,0,0,0,0
142010400500000,CITY PROPERTY,EXEMPT,0,0,0,0,0,0
142010400600000,CITY PROPERTY,EXEMPT,0,0,0,0,0,0
142010400700000,CITY PROPERTY,EXEMPT,0,0,0,0,0,0
142010400800000,CITY PROPERTY,EXEMPT,0,0,0,0,0,0
142010400900000,CITY PROPERTY,EXEMPT,0,0,0,0,0,0
142010401000000,CITY PROPERTY,EXEMPT,0,0,0,0,0,0
142010401100000,CITY PROPERTY,EXEMPT,0,0,0,0,0,0
142010401200000,CITY PROPERTY,EXEMPT,0,0,0,0,0,0
142010401300000,CITY PROPERTY,EXEMPT,0,0,0,0,0,0
142010401400000,CITY PROPERTY,EXEMPT,0,0,0,0,0,0
142010401500000,CITY PROPERTY,EXEMPT,0,0,0,0,0,0
142010401600000,CITY PROPERTY,EXEMPT,0,0,0,0,0,0
142010401700000,CITY PROPERTY,EXEMPT,0,0,0,0,0,0
142010401800000,CITY PROPERTY,EXEMPT,0,0,0,0,0,0
142010401900000,CITY PROPERTY,EXEMPT,0,0,0,0,0,0
142010402000000,NW 310,RESIDENTIAL,14850,0,14850,0,0,14850
142010402100000,CITY PROPERTY,EXEMPT,0,0,0,0,0,0
142010402200000,CITY PROPERTY,EXEMPT,0,0,0,0,0,0
142010402300000,CITY PROPERTY,EXEMPT,0,0,0,0,0,0
142010402400000,CITY PROPERTY,EXEMPT,0,0,0,0,0,0
142010500100000,CITY PROPERTY,EXEMPT,0,0,0,0,0,0
142010500200000,CITY PROPERTY,EXEMPT,0,0,0,0,0,0
142010500300000,CITY PROPERTY,EXEMPT,0,0,0,0,0,0
142010500400000,CITY PROPERTY,EXEMPT,0,0,0,0,0,0
142010500500000,CITY PROPERTY,EXEMPT,0,0,0,0,0,0
142010500600000,CITY PROPERTY,EXEMPT,0,0,0,0,0,0
142010500700000,CITY PROPERTY,EXEMPT,0,0,0,0,0,0
142010500800000,NW 310,RESIDENTIAL,14850,0,14850,45851,0,60701
142010500900000,CITY PROPERTY,EXEMPT,0,0,0,0,0,0
142010501000000,CITY PROPERTY,EXEMPT,0,0,0,0,0,0
142010501100000,CITY PROPERTY,EXEMPT,0,0,0,0,0,0
142010501200000,CITY PROPERTY,EXEMPT,0,0,0,0,0,0
142010501300000,CITY PROPERTY,EXEMPT,0,0,0,0,0,0
142010501400000,SMALL RETAIL,COMMERCIAL,0,10800,10800,0,36941,47741
142010501500000,CITY PROPERTY,EXEMPT,0,0,0,0,0,0
142010501600000,CITY PROPERTY,EXEMPT,0,0,0,0,0,0
142010501700000,CITY PROPERTY,EXEMPT,0,0,0,0,0,0
142010501800000,CITY PROPERTY,EXEMPT,0,0,0,0,0,0
142010501900000,CITY PROPERTY,EXEMPT,0,0,0,0,0,0
142010502000000,CITY PROPERTY,EXEMPT,0,0,0,0,0,0
142010502100000,CITY PROPERTY,EXEMPT,0,0,0,0,0,0
142010502200000,CITY PROPERTY,EXEMPT,0,0,0,0,0,0
142010502300000,CITY PROPERTY,EXEMPT,0,0,0,0,0,0
142010502400000,CITY PROPERTY,EXEMPT,0,0,0,0,0,0
142010502500000,CITY PROPERTY,EXEMPT,0,0,0,0,0,0
142010502600000,CITY PROPERTY,EXEMPT,0,0,0,0,0,0
142010502700000,CITY PROPERTY,EXEMPT,0,0,0,0,0,0
142010502800000,CITY PROPERTY,EXEMPT,0,0,0,0,0,0
142012600100000,NW 310,RESIDENTIAL,16083,0,16083,60056,0,76139
142012600200000,CITY PROPERTY,EXEMPT,0,0,0,0,0,0
142012600300000,CITY PROPERTY,EXEMPT,0,0,0,0,0,0
142012600400000,CITY PROPERTY,EXEMPT,0,0,0,0,0,0
142012600500000,CITY PROPERTY,EXEMPT,0,0,0,0,0,0
142012600600000,CITY PROPERTY,EXEMPT,0,0,0,0,0,0
142012600700000,CITY PROPERTY,EXEMPT,0,0,0,0,0,0
142012600800000,CITY PROPERTY,EXEMPT,0,0,0,0,0,0
142012600900000,NW 310,RESIDENTIAL,18960,0,18960,64679,0,83639
142012601000000,NW 310,RESIDENTIAL,16209,0,16209,0,0,16209
142012601100000,NW 310,RESIDENTIAL,16038,0,16038,50323,0,66361
142012601200000,CITY PROPERTY,EXEMPT,0,0,0,0,0,0
142012601300000,CITY PROPERTY,EXEMPT,0,0,0,0,0,0
142012601400000,CITY PROPERTY,EXEMPT,0,0,0,0,0,0
142012601500000,NW 310,RESIDENTIAL,14850,0,14850,49467,0,64317
142012601600000,NW 310,RESIDENTIAL,14850,0,14850,48891,0,63741
142012601700000,NW 310,RESIDENTIAL,14850,0,14850,48704,0,63554
142012700100000,NW 310,RESIDENTIAL,22659,0,22659,78225,0,100884
142012700200000,NW 310,RESIDENTIAL,28546,0,28546,70904,0,99450
142012700300000,NW 310,RESIDENTIAL,29700,0,29700,89665,0,119365
142012700400000,NW 310,RESIDENTIAL,28908,0,28908,79266,0,108174
142012700500000,NW 310,RESIDENTIAL,29718,0,29718,77152,0,106870
142012700600000,CITY PROPERTY,EXEMPT,0,0,0,0,0,0
142012700700000,CITY PROPERTY,EXEMPT,0,0,0,0,0,0
142012700800000,NW 310,RESIDENTIAL,24806,0,24806,0,0,24806
142012700900000,NW 310,RESIDENTIAL,19845,0,19845,79629,0,99474
142012701000000,NW 310,RESIDENTIAL,19845,0,19845,51725,0,71570
142012701100000,CITY PROPERTY,EXEMPT,0,0,0,0,0,0
142012701200000,NW 310,RESIDENTIAL,19845,0,19845,0,0,19845
142012701300000,CITY PROPERTY,EXEMPT,0,0,0,0,0,0
142012701400000,NW 310,RESIDENTIAL,19845,0,19845,57588,0,77433
142012800100000,NW 310,RESIDENTIAL,25480,0,25480,73046,0,98526
142012800200000,NW 310,RESIDENTIAL,24304,0,24304,81042,0,105346
142012800300000,NW 310,RESIDENTIAL,31360,0,31360,74678,0,106038
142012800400000,NW 310,RESIDENTIAL,27160,0,27160,83777,0,110937
142012800500000,NW 310,RESIDENTIAL,25220,0,25220,70733,0,95953
142012800600000,NW 310,RESIDENTIAL,26384,0,26384,89747,0,116131
142012800700000,NW 310,RESIDENTIAL,26573,0,26573,71846,0,98419
142012800800000,NW 310,RESIDENTIAL,25475,0,25475,70907,0,96382
142012800900000,NW 310,RESIDENTIAL,29100,0,29100,102230,0,131330
142012801000000,NW 310,RESIDENTIAL,25220,0,25220,110685,0,135905
142012801100000,NW 310,RESIDENTIAL,27160,0,27160,75364,0,102524
142012801200000,NW 310,RESIDENTIAL,27440,0,27440,72872,0,100312
142012900100000,NW 310,RESIDENTIAL,27166,0,27166,88382,0,115548
142012900200000,FRATERNAL,COMMERCIAL,0,130747,130747,0,122096,252843
142012900300000,NW 304,RESIDENTIAL,30800,0,30800,106615,0,137415
142012900400000,NW 304,RESIDENTIAL,28875,0,28875,84983,0,113858
142012900500000,NW 304,RESIDENTIAL,28875,0,28875,82088,0,110963
142012900600000,NW 304,RESIDENTIAL,28875,0,28875,103626,0,132501
142012900700000,NW 304,RESIDENTIAL,28875,0,28875,104961,0,133836
142012900800000,NW 304,RESIDENTIAL,28613,0,28613,110521,0,139134
142012900900000,NW 304,RESIDENTIAL,28350,0,28350,79090,0,107440
142012901000000,NW 304,RESIDENTIAL,22470,0,22470,79958,0,102428
142012901100000,NW 304,RESIDENTIAL,21889,0,21889,83483,0,105372
142012901200000,NW 304,RESIDENTIAL,23520,0,23520,98573,0,122093
142012901300000,NW 304,RESIDENTIAL,20748,0,20748,73879,0,94627
142012901400000,NW 304,RESIDENTIAL,18200,0,18200,53472,0,71672
142012901500000,NW 310,RESIDENTIAL,24467,0,24467,79035,0,103502
142012901600000,NW 310,RESIDENTIAL,22400,0,22400,74020,0,96420
142012901700000,NW 310,RESIDENTIAL,22400,0,22400,70206,0,92606
142012901800000,NW 310,RESIDENTIAL,22400,0,22400,67540,0,89940
142012901900000,NW 310,RESIDENTIAL,22400,0,22400,84293,0,106693
142012902000000,NW 310,RESIDENTIAL,25448,0,25448,65772,0,91220
142012902100000,NW 310,RESIDENTIAL,26194,0,26194,76984,0,103178
142012902200000,NW 310,RESIDENTIAL,26194,0,26194,67792,0,93986
142012902300000,NW 310,RESIDENTIAL,27558,0,27558,67324,0,94882
142012902400000,NW 310,RESIDENTIAL,29394,0,29394,67720,0,97114
142012902500000,NW 310,RESIDENTIAL,29394,0,29394,69342,0,98736
142012902600000,NW 310,RESIDENTIAL,29394,0,29394,69911,0,99305
142012902700000,NW 310,RESIDENTIAL,31096,0,31096,68554,0,99650
142012902800000,NW 304,RESIDENTIAL,27540,0,27540,99388,0,126928
142012902900000,NW 304,RESIDENTIAL,27810,0,27810,74308,0,102118
142012903000000,NW 310,RESIDENTIAL,31704,0,31704,87183,0,118887
142012903100000,NW 310,RESIDENTIAL,24000,0,24000,74186,0,98186
142012903200000,NW 310,RESIDENTIAL,25740,0,25740,70204,0,95944
142012903300000,NW 304,RESIDENTIAL,5408,0,5408,0,0,5408
142013000100000,CITY PROPERTY,EXEMPT,0,0,0,0,0,0
142013000200000,CITY PROPERTY,EXEMPT,0,0,0,0,0,0
142013000300000,NW 310,RESIDENTIAL,19305,0,19305,46512,0,65817
142013000400000,CITY PROPERTY,EXEMPT,0,0,0,0,0,0
142013000500000,NW 310,RESIDENTIAL,14850,0,14850,46624,0,61474
142013000600000,CITY PROPERTY,EXEMPT,0,0,0,0,0,0
142013000700000,NW 310,RESIDENTIAL,14850,0,14850,49763,0,64613
142013000800000,NW 310,RESIDENTIAL,14850,0,14850,40556,0,55406
142013000900000,CITY PROPERTY,EXEMPT,0,0,0,0,0,0
142013001000000,NW 310,RESIDENTIAL,14850,0,14850,53010,0,67860
142013001100000,NW 310,RESIDENTIAL,14850,0,14850,50876,0,65726
142013001200000,CITY PROPERTY,EXEMPT,0,0,0,0,0,0
142013001300000,NW 310,RESIDENTIAL,15750,0,15750,55574,0,71324
142013001400000,CITY PROPERTY,EXEMPT,0,0,0,0,0,0
142013001500000,CITY PROPERTY,EXEMPT,0,0,0,0,0,0
142013001600000,NW 310,RESIDENTIAL,14850,0,14850,50815,0,65665
142013001700000,CITY PROPERTY,EXEMPT,0,0,0,0,0,0
142013001800000,CITY PROPERTY,EXEMPT,0,0,0,0,0,0
142013001900000,CITY PROPERTY,EXEMPT,0,0,0,0,0,0
142013002000000,CITY PROPERTY,EXEMPT,0,0,0,0,0,0
142013002100000,CITY PROPERTY,EXEMPT,0,0,0,0,0,0
142013002200000,CITY PROPERTY,EXEMPT,0,0,0,0,0,0
142013002300000,CITY PROPERTY,EXEMPT,0,0,0,0,0,0
142013002400000,CITY PROPERTY,EXEMPT,0,0,0,0,0,0
142013002500000,CITY PROPERTY,EXEMPT,0,0,0,0,0,0
142013002600000,NW 310,RESIDENTIAL,14850,0,14850,33507,0,48357
142013002700000,NW 310,RESIDENTIAL,14850,0,14850,62925,0,77775
142013002800000,CITY PROPERTY,EXEMPT,0,0,0,0,0,0
142013002900000,NW 310,RESIDENTIAL,14750,0,14750,0,0,14750
142013100100000,NW 310,RESIDENTIAL,21384,0,21384,40740,0,62124
142013100200000,NW 310,RESIDENTIAL,23456,0,23456,81924,0,105380
142013100300000,NW 310,RESIDENTIAL,23760,0,23760,69482,0,93242
142013100400000,NW 310,RESIDENTIAL,23760,0,23760,63259,0,87019
142013100500000,NW 310,RESIDENTIAL,23760,0,23760,79675,0,103435
142013100600000,NW 310,RESIDENTIAL,23760,0,23760,114110,0,137870
142013100700000,NW 310,RESIDENTIAL,23760,0,23760,61131,0,84891
142013100800000,NW 310,RESIDENTIAL,23760,0,23760,45217,0,68977
142013100900000,NW 310,RESIDENTIAL,29047,0,29047,61795,0,90842
142013101000000,NW 310,RESIDENTIAL,28314,0,28314,68007,0,96321
142013101100000,NW 310,RESIDENTIAL,20592,0,20592,65484,0,86076
142013101200000,NW 310,RESIDENTIAL,17773,0,17773,46353,0,64126
142013101300000,NW 310,RESIDENTIAL,25130,0,25130,0,0,25130
142013101400000,NW 310,RESIDENTIAL,19800,0,19800,74420,0,94220
142013101500000,NW 310,RESIDENTIAL,19800,0,19800,120398,0,140198
142013101600000,NW 310,RESIDENTIAL,19800,0,19800,91298,0,111098
142013101700000,NW 310,RESIDENTIAL,19800,0,19800,71947,0,91747
142013101800000,NW 310,RESIDENTIAL,19800,0,19800,71685,0,91485
142013101900000,NW 310,RESIDENTIAL,19800,0,19800,48428,0,68228
142013102000000,NW 310,RESIDENTIAL,19800,0,19800,107169,0,126969
142013102100000,NW 310,RESIDENTIAL,19800,0,19800,0,0,19800
142013102200000,NW 310,RESIDENTIAL,19800,0,19800,82807,0,102607
142013102300000,NW 310,RESIDENTIAL,19800,0,19800,81620,0,101420
142013102400000,CITY PROPERTY,EXEMPT,0,0,0,0,0,0
142013102500000,CITY PROPERTY,EXEMPT,0,0,0,0,0,0
142013102600000,NW 310,RESIDENTIAL,19800,0,19800,81283,0,101083
142013102700000,NW 310,RESIDENTIAL,19800,0,19800,45852,0,65652
142013200200000,NW 310,RESIDENTIAL,24646,0,24646,86312,0,110958
142013200300000,NW 310,RESIDENTIAL,23520,0,23520,90316,0,113836
142013200400000,NW 310,RESIDENTIAL,19992,0,19992,70471,0,90463
142013200500000,NW 310,RESIDENTIAL,23760,0,23760,81865,0,105625
142013200600000,NW 310,RESIDENTIAL,23760,0,23760,75017,0,98777
142013200700000,NW 310,RESIDENTIAL,23760,0,23760,65121,0,88881
142013200800000,NW 310,RESIDENTIAL,24000,0,24000,69675,0,93675
142013200900000,NW 310,RESIDENTIAL,25000,0,25000,75141,0,100141
142013201000000,NW 310,RESIDENTIAL,11785,0,11785,45480,0,57265
142013201100000,NW 310,RESIDENTIAL,24934,0,24934,98799,0,123733
142013201200000,NW 310,RESIDENTIAL,21600,0,21600,68394,0,89994
142013201300000,NW 310,RESIDENTIAL,21600,0,21600,56756,0,78356
142013201400000,NW 310,RESIDENTIAL,21600,0,21600,81157,0,102757
142013201500000,NW 310,RESIDENTIAL,21600,0,21600,63761,0,85361
142013201600000,NW 310,RESIDENTIAL,22013,0,22013,69030,0,91043
142013201700000,NW 310,RESIDENTIAL,24240,0,24240,67374,0,91614
142013201800000,NW 310,RESIDENTIAL,24000,0,24000,62050,0,86050
142013201900000,NW 310,RESIDENTIAL,24000,0,24000,46959,0,70959
142013202000000,NW 310,RESIDENTIAL,23760,0,23760,61285,0,85045
142013202100000,NW 310,RESIDENTIAL,23760,0,23760,66564,0,90324
142013202200000,NW 310,RESIDENTIAL,23520,0,23520,80164,0,103684
142013202300000,NW 310,RESIDENTIAL,23280,0,23280,65441,0,88721
142013202400000,NW 310,RESIDENTIAL,23280,0,23280,58417,0,81697
142013202500000,NW 310,RESIDENTIAL,25728,0,25728,109220,0,134948
142013202600000,NW 310,RESIDENTIAL,25840,0,25840,121921,0,147761
142015100100000,CONVENIENCE STORE,COMMERCIAL,0,102400,102400,0,267884,370284
142015100200000,NW 310,RESIDENTIAL,22016,0,22016,0,0,22016
142015100300000,NW 310,RESIDENTIAL,22016,0,22016,0,0,22016
142015100400000,NW 310,RESIDENTIAL,19948,0,19948,34141,0,54089
142015100500000,NW 310,RESIDENTIAL,20117,0,20117,113323,0,133440
142015100600000,NW 310,RESIDENTIAL,21574,0,21574,73473,0,95047
142015100700000,NW 310,RESIDENTIAL,22018,0,22018,79943,0,101961
142015100800000,NW 310,RESIDENTIAL,21908,0,21908,92253,0,114161
142015100900000,NW 310,RESIDENTIAL,23412,0,23412,89276,0,112688
142015101000000,CHURCH,EXEMPT,0,153900,153900,0,263440,417340
142015101100000,NW 310,RESIDENTIAL,26144,0,26144,72150,0,98294
142015101200000,NW 310,RESIDENTIAL,15960,0,15960,45435,0,61395
142015101300000,NW 310,RESIDENTIAL,5000,0,5000,0,0,5000
142015101400000,NW 310,RESIDENTIAL,13068,0,13068,42236,0,55304
142015101500000,NW 310,RESIDENTIAL,17820,0,17820,49611,0,67431
142015101600000,NW 310,EXEMPT,0,16335,16335,0,68021,84356
142015101700000,CHURCH,EXEMPT,0,92205,92205,0,10800,103005
142015200100000,NW 310,RESIDENTIAL,21013,0,21013,0,0,21013
142015200200000,NW 310,RESIDENTIAL,18576,0,18576,57709,0,76285
142015200300000,NW 310,RESIDENTIAL,26973,0,26973,119444,0,146417
142015200400000,NW 310,RESIDENTIAL,18576,0,18576,51963,0,70539
142015200500000,NW 310,RESIDENTIAL,18919,0,18919,54916,0,73835
142015200600000,NW 310,RESIDENTIAL,18800,0,18800,62279,0,81079
142015200700000,NW 310,RESIDENTIAL,18033,0,18033,53572,0,71605
142015200800000,NW 310,RESIDENTIAL,22118,0,22118,77672,0,99790
142015200900000,NW 310,RESIDENTIAL,21412,0,21412,80084,0,101496
142015201000000,NW 310,RESIDENTIAL,26147,0,26147,76497,0,102644
142015201100000,NW 310,RESIDENTIAL,25856,0,25856,84307,0,110163
142015201200000,NW 310,RESIDENTIAL,21329,0,21329,75426,0,96755
142015201300000,NW 310,RESIDENTIAL,20604,0,20604,77260,0,97864
142015201400000,NW 310,RESIDENTIAL,20604,0,20604,79954,0,100558
142015201500000,NW 310,RESIDENTIAL,20949,0,20949,76572,0,97521
142015201600000,NW 310,RESIDENTIAL,15960,0,15960,56257,0,72217
142015201700000,NW 310,RESIDENTIAL,16720,0,16720,45705,0,62425
142015201800000,NW 310,RESIDENTIAL,15960,0,15960,73133,0,89093
142015201900000,NW 310,RESIDENTIAL,15960,0,15960,68437,0,84397
142015202000000,NW 310,RESIDENTIAL,26144,0,26144,96705,0,122849
142015202100000,NW 310,RESIDENTIAL,21264,0,21264,75585,0,96849
142015202200000,NW 310,RESIDENTIAL,20604,0,20604,76356,0,96960
142015202300000,NW 310,RESIDENTIAL,20604,0,20604,93608,0,114212
142015202400000,NW 310,RESIDENTIAL,20935,0,20935,81055,0,101990
142015202500000,NW 310,RESIDENTIAL,23270,0,23270,83684,0,106954
142015202600000,NW 310,RESIDENTIAL,23861,0,23861,96604,0,120465
142015202700000,NW 310,RESIDENTIAL,21412,0,21412,85247,0,106659
142015202800000,NW 310,RESIDENTIAL,21765,0,21765,52029,0,73794
142015202900000,NW 310,RESIDENTIAL,18687,0,18687,108845,0,127532
142015203000000,NW 310,RESIDENTIAL,18800,0,18800,56246,0,75046
142015300100000,NW 310,RESIDENTIAL,18686,0,18686,58703,0,77389
142015300200000,NW 310,RESIDENTIAL,18576,0,18576,56667,0,75243
142015300300000,NW 310,RESIDENTIAL,23760,0,23760,64237,0,87997
142015300400000,NW 310,RESIDENTIAL,18576,0,18576,62718,0,81294
142015300500000,NW 310,RESIDENTIAL,18911,0,18911,53487,0,72398
142015300600000,NW 310,RESIDENTIAL,18048,0,18048,58900,0,76948
142015300700000,NW 310,RESIDENTIAL,17669,0,17669,53944,0,71613
142015300800000,NW 310,RESIDENTIAL,22155,0,22155,79907,0,102062
142015300900000,NW 310,RESIDENTIAL,21412,0,21412,81192,0,102604
142015301000000,NW 310,RESIDENTIAL,26121,0,26121,79332,0,105453
142015301100000,NW 310,RESIDENTIAL,26570,0,26570,82075,0,108645
142015301200000,NW 310,RESIDENTIAL,20604,0,20604,100621,0,121225
142015301300000,NW 310,RESIDENTIAL,20604,0,20604,72407,0,93011
142015301400000,NW 310,RESIDENTIAL,23813,0,23813,82816,0,106629
142015301500000,NW 310,RESIDENTIAL,17453,0,17453,63887,0,81340
142015301600000,NW 310,RESIDENTIAL,15960,0,15960,48635,0,64595
142015301700000,NW 310,RESIDENTIAL,22876,0,22876,63168,0,86044
142015301800000,NW 310,RESIDENTIAL,21280,0,21280,57242,0,78522
142015301900000,NW 310,RESIDENTIAL,16720,0,16720,46271,0,62991
142015302000000,NW 310,RESIDENTIAL,15960,0,15960,75068,0,91028
142015302100000,NW 310,RESIDENTIAL,21775,0,21775,77330,0,99105
142015302200000,NW 310,RESIDENTIAL,20604,0,20604,80379,0,100983
142015302300000,NW 310,RESIDENTIAL,20604,0,20604,78736,0,99340
142015302400000,NW 310,RESIDENTIAL,20918,0,20918,66393,0,87311
142015302500000,NW 310,RESIDENTIAL,25856,0,25856,88296,0,114152
142015302600000,NW 310,RESIDENTIAL,26504,0,26504,76758,0,103262
142015302700000,NW 310,RESIDENTIAL,21412,0,21412,87712,0,109124
142015302800000,NW 310,RESIDENTIAL,21765,0,21765,103599,0,125364
142015302900000,NW 310,RESIDENTIAL,9779,0,9779,0,0,9779
142015303000000,NW 310,RESIDENTIAL,18800,0,18800,57491,0,76291
142015400100000,NW 310,RESIDENTIAL,21413,0,21413,66331,0,87744
142015400200000,NW 310,RESIDENTIAL,20680,0,20680,48670,0,69350
142015400300000,NW 310,RESIDENTIAL,24200,0,24200,52204,0,76404
142015400400000,NW 310,RESIDENTIAL,23892,0,23892,54471,0,78363
142015400500000,NW 310,RESIDENTIAL,30477,0,30477,70191,0,100668
142015400600000,NW 310,RESIDENTIAL,21744,0,21744,76052,0,97796
142015400700000,NW 310,RESIDENTIAL,22248,0,22248,72150,0,94398
142015400800000,NW 310,RESIDENTIAL,22823,0,22823,77765,0,100588
142015400900000,NW 310,RESIDENTIAL,24308,0,24308,63888,0,88196
142015401000000,NW 310,RESIDENTIAL,17982,0,17982,55137,0,73119
142015401100000,NW 310,RESIDENTIAL,27644,0,27644,82204,0,109848
142015401200000,NW 310,RESIDENTIAL,27188,0,27188,72334,0,99522
142015401300000,NW 310,RESIDENTIAL,17982,0,17982,86985,0,104967
142015401400000,NW 310,RESIDENTIAL,16720,0,16720,47032,0,63752
142015401500000,NW 310,RESIDENTIAL,19000,0,19000,70597,0,89597
142015401600000,NW 310,RESIDENTIAL,16720,0,16720,41531,0,58251
142015401700000,NW 310,RESIDENTIAL,15960,0,15960,44389,0,60349
142015401800000,NW 310,RESIDENTIAL,16720,0,16720,37144,0,53864
142015401900000,NW 310,RESIDENTIAL,15960,0,15960,44513,0,60473
142015402000000,NW 310,RESIDENTIAL,21781,0,21781,95024,0,116805
142015402100000,NW 310,RESIDENTIAL,20604,0,20604,67691,0,88295
142015402200000,NW 310,RESIDENTIAL,20604,0,20604,77420,0,98024
142015402300000,NW 310,RESIDENTIAL,20790,0,20790,77707,0,98497
142015402400000,NW 310,RESIDENTIAL,26367,0,26367,71766,0,98133
142015402500000,NW 310,RESIDENTIAL,25686,0,25686,71345,0,97031
142015402600000,NW 310,RESIDENTIAL,21816,0,21816,76088,0,97904
142015402700000,NW 310,RESIDENTIAL,22188,0,22188,81196,0,103384
142015500100000,NW 310,RESIDENTIAL,19404,0,19404,64080,0,83484
142015500200000,NW 310,RESIDENTIAL,19404,0,19404,63083,0,82487
142015500300000,NW 310,RESIDENTIAL,15444,0,15444,77037,0,92481
142015500400000,NW 310,RESIDENTIAL,15048,0,15048,83547,0,98595
142015500500000,NW 310,RESIDENTIAL,15048,0,15048,52253,0,67301
142015500600000,NW 310,RESIDENTIAL,15048,0,15048,48470,0,63518
142015500700000,NW 310,RESIDENTIAL,15048,0,15048,68711,0,83759
142015500800000,NW 310,RESIDENTIAL,15048,0,15048,55549,0,70597
142015500900000,CITY PROPERTY,EXEMPT,0,0,0,0,0,0
142015501000000,NW 310,RESIDENTIAL,19800,0,19800,82489,0,102289
142015501100000,CITY PROPERTY,EXEMPT,0,0,0,0,0,0
142015501200000,NW 310,RESIDENTIAL,9800,0,9800,0,0,9800
142015501300000,CITY PROPERTY,EXEMPT,0,0,0,0,0,0
142015501400000,NW 310,RESIDENTIAL,15840,0,15840,76719,0,92559
142015501500000,CITY PROPERTY,EXEMPT,0,0,0,0,0,0
142015501600000,CITY PROPERTY,EXEMPT,0,0,0,0,0,0
142015501700000,CITY PROPERTY,EXEMPT,0,0,0,0,0,0
142015501800000,CITY PROPERTY,EXEMPT,0,0,0,0,0,0
142015501900000,CITY PROPERTY,EXEMPT,0,0,0,0,0,0
142015502000000,CITY PROPERTY,EXEMPT,0,0,0,0,0,0
142015600100000,NW 310,RESIDENTIAL,19404,0,19404,122569,0,141973
142015600200000,NW 310,EXEMPT,0,14432,14432,0,0,14432
142015600300000,NW 310,EXEMPT,0,11487,11487,0,0,11487
142015600400000,FRATERNAL,EXEMPT,0,51011,51011,0,22553,73564
142015600500000,NW 310,RESIDENTIAL,17325,0,17325,84117,0,101442
142015600600000,NW 310,RESIDENTIAL,11261,0,11261,0,0,11261
142015600700000,NW 310,RESIDENTIAL,11261,0,11261,95835,0,107096
142015600800000,NW 310,RESIDENTIAL,17325,0,17325,80441,0,97766
142015600900000,NW 310,RESIDENTIAL,25344,0,25344,88974,0,114318
142015601000000,NW 310,RESIDENTIAL,15840,0,15840,0,0,15840
142015601100000,NW 310,RESIDENTIAL,15840,0,15840,65563,0,81403
142015601200000,NW 310,RESIDENTIAL,15840,0,15840,49513,0,65353
142015601300000,NW 310,RESIDENTIAL,19800,0,19800,58858,0,78658
142015601400000,NW 310,RESIDENTIAL,15642,0,15642,56005,0,71647
142015601500000,NW 310,RESIDENTIAL,15642,0,15642,53372,0,69014
142015601600000,NW 310,RESIDENTIAL,15642,0,15642,93898,0,109540
142015601700000,NW 310,RESIDENTIAL,12514,0,12514,0,0,12514
142015601800000,NW 310,RESIDENTIAL,17325,0,17325,128237,0,145562
142015700100000,NW 310,RESIDENTIAL,16979,0,16979,116034,0,133013
142015700200000,NW 310,RESIDENTIAL,19404,0,19404,95083,0,114487
142015700300000,NW 310,RESIDENTIAL,11906,0,11906,65312,0,77218
142015700400000,NW 310,RESIDENTIAL,14652,0,14652,32163,0,46815
142015700500000,NW 310,RESIDENTIAL,19800,0,19800,59078,0,78878
142015700600000,NW 310,RESIDENTIAL,19800,0,19800,67376,0,87176
142015700700000,NW 310,RESIDENTIAL,19800,0,19800,63483,0,83283
142015700800000,NW 310,RESIDENTIAL,19800,0,19800,33874,0,53674
142015700900000,NW 310,RESIDENTIAL,19800,0,19800,80638,0,100438
142015701000000,NW 310,RESIDENTIAL,19800,0,19800,66140,0,85940
142015701100000,NW 310,RESIDENTIAL,19800,0,19800,86182,0,105982
142015701200000,NW 310,RESIDENTIAL,17325,0,17325,59703,0,77028
142015701300000,NW 310,RESIDENTIAL,17325,0,17325,109395,0,126720
142015701400000,NW 310,RESIDENTIAL,17325,0,17325,55331,0,72656
142015701500000,NW 310,RESIDENTIAL,17325,0,17325,72682,0,90007
142015701600000,NW 310,RESIDENTIAL,17325,0,17325,0,0,17325
142015701700000,NW 310,RESIDENTIAL,17325,0,17325,73921,0,91246
142015701800000,NW 310,RESIDENTIAL,17325,0,17325,75663,0,92988
142015701900000,NW 310,RESIDENTIAL,22093,0,22093,75717,0,97810
142015800100000,NW 310,RESIDENTIAL,19404,0,19404,64699,0,84103
142015800200000,NW 310,RESIDENTIAL,19992,0,19992,81053,0,101045
142015800300000,NW 310,RESIDENTIAL,29566,0,29566,70377,0,99943
142015800400000,NW 310,RESIDENTIAL,20400,0,20400,73822,0,94222
142015800500000,NW 310,RESIDENTIAL,20400,0,20400,72662,0,93062
142015800600000,NW 310,RESIDENTIAL,20400,0,20400,49987,0,70387
142015800700000,NW 310,RESIDENTIAL,20400,0,20400,52258,0,72658
142015800800000,NW 310,RESIDENTIAL,20400,0,20400,58173,0,78573
142015800900000,NW 310,RESIDENTIAL,20400,0,20400,66404,0,86804
142015801000000,NW 310,RESIDENTIAL,20400,0,20400,60493,0,80893
142015801100000,NW 310,RESIDENTIAL,19800,0,19800,53166,0,72966
142015801200000,NW 310,RESIDENTIAL,19800,0,19800,49052,0,68852
142015801300000,NW 310,RESIDENTIAL,19800,0,19800,62450,0,82250
142015801400000,NW 310,RESIDENTIAL,19800,0,19800,57789,0,77589
142015801500000,NW 310,RESIDENTIAL,19800,0,19800,50428,0,70228
142015801600000,NW 310,RESIDENTIAL,19800,0,19800,47141,0,66941
142015801700000,NW 310,RESIDENTIAL,19800,0,19800,59092,0,78892
142015801800000,NW 310,RESIDENTIAL,27482,0,27482,84928,0,112410
142017600100000,CITY PROPERTY,EXEMPT,0,0,0,0,0,0
142017600200000,CITY PROPERTY,EXEMPT,0,0,0,0,0,0
142017600300000,CITY PROPERTY,EXEMPT,0,0,0,0,0,0
142017600400000,CITY PROPERTY,EXEMPT,0,0,0,0,0,0
142017600500000,CITY PROPERTY,EXEMPT,0,0,0,0,0,0
142017600600000,CITY PROPERTY,EXEMPT,0,0,0,0,0,0
142017600700000,CITY PROPERTY,EXEMPT,0,0,0,0,0,0
142017600800000,CITY PROPERTY,EXEMPT,0,0,0,0,0,0
142017600900000,CITY PROPERTY,EXEMPT,0,0,0,0,0,0
142017601000000,CITY PROPERTY,EXEMPT,0,0,0,0,0,0
142017601100000,CITY PROPERTY,EXEMPT,0,0,0,0,0,0
142017601200000,CITY PROPERTY,EXEMPT,0,0,0,0,0,0
142017601300000,CITY PROPERTY,EXEMPT,0,0,0,0,0,0
142017601400000,CITY PROPERTY,EXEMPT,0,0,0,0,0,0
142017601500000,CITY PROPERTY,EXEMPT,0,0,0,0,0,0
142017601600000,CITY PROPERTY,EXEMPT,0,0,0,0,0,0
142017700100000,CITY PROPERTY,EXEMPT,0,0,0,0,0,0
142017700200000,CITY PROPERTY,EXEMPT,0,0,0,0,0,0
142017700300000,CITY PROPERTY,EXEMPT,0,0,0,0,0,0
142017700400000,NW 310,RESIDENTIAL,19305,0,19305,45563,0,64868
142017700500000,CITY PROPERTY,EXEMPT,0,0,0,0,0,0
142017700600000,CITY PROPERTY,EXEMPT,0,0,0,0,0,0
142017700700000,CITY PROPERTY,EXEMPT,0,0,0,0,0,0
142017700800000,CITY PROPERTY,EXEMPT,0,0,0,0,0,0
142017700900000,CITY PROPERTY,EXEMPT,0,0,0,0,0,0
142017701000000,CITY PROPERTY,EXEMPT,0,0,0,0,0,0
142017701100000,NW 310,RESIDENTIAL,5197,0,5197,0,0,5197
142017701200000,CITY PROPERTY,EXEMPT,0,0,0,0,0,0
142017701300000,CITY PROPERTY,EXEMPT,0,0,0,0,0,0
142017800100000,CITY PROPERTY,EXEMPT,0,0,0,0,0,0
142017800200000,CITY PROPERTY,EXEMPT,0,0,0,0,0,0
142017800300000,CITY PROPERTY,EXEMPT,0,0,0,0,0,0
142017800400000,CITY PROPERTY,EXEMPT,0,0,0,0,0,0
142017800500000,CITY PROPERTY,EXEMPT,0,0,0,0,0,0
142017800600000,CITY PROPERTY,EXEMPT,0,0,0,0,0,0
142017800700000,CITY PROPERTY,EXEMPT,0,0,0,0,0,0
142017800800000,CITY PROPERTY,EXEMPT,0,0,0,0,0,0
142017800900000,CITY PROPERTY,EXEMPT,0,0,0,0,0,0
142017801000000,CITY PROPERTY,EXEMPT,0,0,0,0,0,0
142017801100000,CITY PROPERTY,EXEMPT,0,0,0,0,0,0
142017801200000,CITY PROPERTY,EXEMPT,0,0,0,0,0,0
142017801300000,CITY PROPERTY,EXEMPT,0,0,0,0,0,0
142017801400000,CITY PROPERTY,EXEMPT,0,0,0,0,0,0
142017900100000,CITY PROPERTY,EXEMPT,0,0,0,0,0,0
142017900200000,NW 310,RESIDENTIAL,10048,0,10048,0,0,10048
142017900300000,CITY PROPERTY,EXEMPT,0,0,0,0,0,0
142017900400000,CITY PROPERTY,EXEMPT,0,0,0,0,0,0
142017900500000,CITY PROPERTY,EXEMPT,0,0,0,0,0,0
142017900600000,CITY PROPERTY,EXEMPT,0,0,0,0,0,0
142017900700000,CITY PROPERTY,EXEMPT,0,0,0,0,0,0
142017900800000,CITY PROPERTY,EXEMPT,0,0,0,0,0,0
142017900900000,NW 310,RESIDENTIAL,13860,0,13860,85258,0,99118
142017901000000,CITY PROPERTY,EXEMPT,0,0,0,0,0,0
142017901100000,NW 310,RESIDENTIAL,9800,0,9800,0,0,9800
142017901200000,NW 310,RESIDENTIAL,19800,0,19800,0,0,19800
142017901300000,CITY PROPERTY,EXEMPT,0,0,0,0,0,0
142018000100000,CITY PROPERTY,EXEMPT,0,0,0,0,0,0
142018000200000,CITY PROPERTY,EXEMPT,0,0,0,0,0,0
142018000300000,CITY PROPERTY,EXEMPT,0,0,0,0,0,0
142018000400000,CITY PROPERTY,EXEMPT,0,0,0,0,0,0
142018000500000,CITY PROPERTY,EXEMPT,0,0,0,0,0,0
142018000600000,CITY PROPERTY,EXEMPT,0,0,0,0,0,0
142018000700000,CITY PROPERTY,EXEMPT,0,0,0,0,0,0
142018000800000,CITY PROPERTY,EXEMPT,0,0,0,0,0,0
142018000900000,CITY PROPERTY,EXEMPT,0,0,0,0,0,0
142018001000000,CITY PROPERTY,EXEMPT,0,0,0,0,0,0
142018001100000,CITY PROPERTY,EXEMPT,0,0,0,0,0,0
142018001200000,CITY PROPERTY,EXEMPT,0,0,0,0,0,0
142018001300000,CITY PROPERTY,EXEMPT,0,0,0,0,0,0
142018001400000,CITY PROPERTY,EXEMPT,0,0,0,0,0,0
142018100100000,CITY PROPERTY,EXEMPT,0,0,0,0,0,0
142018100200000,CITY PROPERTY,EXEMPT,0,0,0,0,0,0
142018100300000,CITY PROPERTY,EXEMPT,0,0,0,0,0,0
142018100400000,CITY PROPERTY,EXEMPT,0,0,0,0,0,0
142018100500000,CITY PROPERTY,EXEMPT,0,0,0,0,0,0
142018100600000,NW 310,RESIDENTIAL,9800,0,9800,0,0,9800
142018100700000,CITY PROPERTY,EXEMPT,0,0,0,0,0,0
142018100800000,CITY PROPERTY,EXEMPT,0,0,0,0,0,0
142018100900000,CITY PROPERTY,EXEMPT,0,0,0,0,0,0
142018101000000,CITY PROPERTY,EXEMPT,0,0,0,0,0,0
142018101100000,CITY PROPERTY,EXEMPT,0,0,0,0,0,0
142018101200000,CITY PROPERTY,EXEMPT,0,0,0,0,0,0
142018101300000,NW 310,RESIDENTIAL,12994,0,12994,0,0,12994
142018101400000,CITY PROPERTY,EXEMPT,0,0,0,0,0,0
142018200100000,CITY PROPERTY,EXEMPT,0,0,0,0,0,0
142018200200000,CITY PROPERTY,EXEMPT,0,0,0,0,0,0
142018200300000,CITY PROPERTY,EXEMPT,0,0,0,0,0,0
142018200400000,NW 310,RESIDENTIAL,15840,0,15840,53414,0,69254
142018200500000,CITY PROPERTY,EXEMPT,0,0,0,0,0,0
142018200600000,NW 310,RESIDENTIAL,19800,0,19800,62443,0,82243
142018200700000,CITY PROPERTY,EXEMPT,0,0,0,0,0,0
142018200800000,CITY PROPERTY,EXEMPT,0,0,0,0,0,0
142018200900000,CITY PROPERTY,EXEMPT,0,0,0,0,0,0
142018201000000,NW 310,RESIDENTIAL,2800,0,2800,0,0,2800
142018201100000,NW 310,RESIDENTIAL,17000,0,17000,35558,0,52558
142018201200000,CITY PROPERTY,EXEMPT,0,0,0,0,0,0
142018201300000,NW 310,RESIDENTIAL,19800,0,19800,58124,0,77924
142018201400000,CITY PROPERTY,EXEMPT,0,0,0,0,0,0
142018201500000,CITY PROPERTY,EXEMPT,0,0,0,0,0,0
142018201600000,CITY PROPERTY,EXEMPT,0,0,0,0,0,0
142018300100000,CITY PROPERTY,EXEMPT,0,0,0,0,0,0
142018300200000,CITY PROPERTY,EXEMPT,0,0,0,0,0,0
142018300300000,NW 310,RESIDENTIAL,19800,0,19800,51789,0,71589
142018300400000,CITY PROPERTY,EXEMPT,0,0,0,0,0,0
142018300500000,CITY PROPERTY,EXEMPT,0,0,0,0,0,0
142018300600000,NW 310,RESIDENTIAL,19800,0,19800,110745,0,130545
142018300700000,NW 310,RESIDENTIAL,19800,0,19800,59537,0,79337
142018300800000,NW 310,RESIDENTIAL,19800,0,19800,61649,0,81449
142018300900000,CENTRALLY ASSESSED,OTHER,0,0,0,0,0,0
142018301000000,CITY PROPERTY,EXEMPT,0,0,0,0,0,0
142018301100000,NW 310,RESIDENTIAL,19800,0,19800,53728,0,73528
142018301200000,NW 310,RESIDENTIAL,19800,0,19800,48322,0,68122
142018301300000,CITY PROPERTY,EXEMPT,0,0,0,0,0,0
142018301400000,NW 310,RESIDENTIAL,19800,0,19800,71256,0,91056
142018400100000,CITY PROPERTY,EXEMPT,0,0,0,0,0,0
142018400200000,CITY PROPERTY,EXEMPT,0,0,0,0,0,0
142018400300000,CITY PROPERTY,EXEMPT,0,0,0,0,0,0
142018400400000,NW 310,RESIDENTIAL,7325,0,7325,0,0,7325
142018400500000,CITY PROPERTY,EXEMPT,0,0,0,0,0,0
142018400600000,CITY PROPERTY,EXEMPT,0,0,0,0,0,0
142018400700000,CITY PROPERTY,EXEMPT,0,0,0,0,0,0
142018400800000,CITY PROPERTY,EXEMPT,0,0,0,0,0,0
142018400900000,CITY PROPERTY,EXEMPT,0,0,0,0,0,0
142018401000000,CITY PROPERTY,EXEMPT,0,0,0,0,0,0
142018401100000,CITY PROPERTY,EXEMPT,0,0,0,0,0,0
142018401200000,CITY PROPERTY,EXEMPT,0,0,0,0,0,0
142018401300000,CITY PROPERTY,EXEMPT,0,0,0,0,0,0
142018401400000,CITY PROPERTY,EXEMPT,0,0,0,0,0,0
142018401500000,CITY PROPERTY,EXEMPT,0,0,0,0,0,0
142018401600000,CITY PROPERTY,EXEMPT,0,0,0,0,0,0
142018401700000,CITY PROPERTY,EXEMPT,0,0,0,0,0,0
142018401800000,CITY PROPERTY,EXEMPT,0,0,0,0,0,0
142018401900000,CITY PROPERTY,EXEMPT,0,0,0,0,0,0
142018500100000,CITY PROPERTY,EXEMPT,0,0,0,0,0,0
142018500200000,CITY PROPERTY,EXEMPT,0,0,0,0,0,0
142018500300000,CITY PROPERTY,EXEMPT,0,0,0,0,0,0
142018500400000,CITY PROPERTY,EXEMPT,0,0,0,0,0,0
142018500500000,CITY PROPERTY,EXEMPT,0,0,0,0,0,0
142018500600000,CITY PROPERTY,EXEMPT,0,0,0,0,0,0
142018500700000,CITY PROPERTY,EXEMPT,0,0,0,0,0,0
142018500800000,CITY PROPERTY,EXEMPT,0,0,0,0,0,0
142018500900000,CITY PROPERTY,EXEMPT,0,0,0,0,0,0
142018501000000,CITY PROPERTY,EXEMPT,0,0,0,0,0,0
142018501100000,CITY PROPERTY,EXEMPT,0,0,0,0,0,0
142018501200000,NW 310,RESIDENTIAL,18191,0,18191,51824,0,70015
142018501300000,CITY PROPERTY,EXEMPT,0,0,0,0,0,0
142018501400000,CITY PROPERTY,EXEMPT,0,0,0,0,0,0
142018501500000,CITY PROPERTY,EXEMPT,0,0,0,0,0,0
142018501600000,NW 310,RESIDENTIAL,12994,0,12994,37938,0,50932
142018501700000,CITY PROPERTY,EXEMPT,0,0,0,0,0,0
142018501800000,CITY PROPERTY,EXEMPT,0,0,0,0,0,0
142018600100000,NW 310,RESIDENTIAL,13800,0,13800,34220,0,48020
142018600200000,NW 310,RESIDENTIAL,12992,0,12992,53495,0,66487
142018600300000,NW 310,RESIDENTIAL,5000,0,5000,0,0,5000
142018600400000,CITY PROPERTY,EXEMPT,0,0,0,0,0,0
142018600500000,CITY PROPERTY,EXEMPT,0,0,0,0,0,0
142018600600000,CITY PROPERTY,EXEMPT,0,0,0,0,0,0
142018600700000,NW 310,RESIDENTIAL,19800,0,19800,73461,0,93261
142018600800000,CITY PROPERTY,EXEMPT,0,0,0,0,0,0
142018600900000,CITY PROPERTY,EXEMPT,0,0,0,0,0,0
142018601000000,CITY PROPERTY,EXEMPT,0,0,0,0,0,0
142018601100000,NW 310,RESIDENTIAL,7920,0,7920,0,0,7920
142018601200000,CITY PROPERTY,EXEMPT,0,0,0,0,0,0
142018601300000,CITY PROPERTY,EXEMPT,0,0,0,0,0,0
142018601400000,NW 310,RESIDENTIAL,19800,0,19800,84270,0,104070
142018601500000,NW 310,RESIDENTIAL,19800,0,19800,67865,0,87665
142018601600000,CITY PROPERTY,EXEMPT,0,0,0,0,0,0
142018601700000,CITY PROPERTY,EXEMPT,0,0,0,0,0,0
142018601800000,NW 310,RESIDENTIAL,19800,0,19800,91003,0,110803
142018601900000,NW 310,RESIDENTIAL,19800,0,19800,94326,0,114126
142018602000000,CITY PROPERTY,EXEMPT,0,0,0,0,0,0
142018602100000,CITY PROPERTY,EXEMPT,0,0,0,0,0,0
142018700100000,CITY PROPERTY,EXEMPT,0,0,0,0,0,0
142018700200000,NW 310,RESIDENTIAL,5000,0,5000,0,0,5000
142018700300000,CITY PROPERTY,EXEMPT,0,0,0,0,0,0
142018700400000,NW 310,RESIDENTIAL,15840,0,15840,73637,0,89477
142018700500000,CITY PROPERTY,EXEMPT,0,0,0,0,0,0
142018700600000,CITY PROPERTY,EXEMPT,0,0,0,0,0,0
142018700700000,NW 310,RESIDENTIAL,5000,0,5000,0,0,5000
142018700800000,CITY PROPERTY,EXEMPT,0,0,0,0,0,0
142018700900000,NW 310,RESIDENTIAL,13199,0,13199,71901,0,85100
142018701000000,CITY PROPERTY,EXEMPT,0,0,0,0,0,0
142018701100000,NW 310,RESIDENTIAL,21780,0,21780,86266,0,108046
142018701200000,NW 310,RESIDENTIAL,19800,0,19800,63889,0,83689
142018701300000,CITY PROPERTY,EXEMPT,0,0,0,0,0,0
142018701400000,CITY PROPERTY,EXEMPT,0,0,0,0,0,0
142018701500000,CITY PROPERTY,EXEMPT,0,0,0,0,0,0
142018701600000,NW 310,RESIDENTIAL,15840,0,15840,56550,0,72390
142018701700000,CITY PROPERTY,EXEMPT,0,0,0,0,0,0
142018701800000,NW 310,RESIDENTIAL,9900,0,9900,0,0,9900
142018701900000,NW 310,RESIDENTIAL,19800,0,19800,45776,0,65576
142018702000000,NW 310,RESIDENTIAL,19800,0,19800,49178,0,68978
142018702100000,NW 310,RESIDENTIAL,19800,0,19800,0,0,19800
142020100100000,NW 304,RESIDENTIAL,28704,0,28704,62851,0,91555
142020100200000,NW 304,RESIDENTIAL,18900,0,18900,51998,0,70898
142020100300000,NW 304,RESIDENTIAL,16800,0,16800,78967,0,95767
142020100400000,NW 304,RESIDENTIAL,18200,0,18200,156544,0,174744
142020100500000,NW 304,RESIDENTIAL,18550,0,18550,64785,0,83335
142020100600000,NW 304,RESIDENTIAL,18900,0,18900,94805,0,113705
142020100700000,NW 304,RESIDENTIAL,18900,0,18900,61548,0,80448
142020100900000,NW 304,RESIDENTIAL,22400,0,22400,122413,0,144813
142020101000000,NW 304,RESIDENTIAL,22575,0,22575,81480,0,104055
142020101100000,NW 304,RESIDENTIAL,22575,0,22575,81423,0,103998
142020101200000,NW 304,RESIDENTIAL,22575,0,22575,71668,0,94243
142020101300000,NW 304,RESIDENTIAL,22400,0,22400,80516,0,102916
142020101400000,NW 304,RESIDENTIAL,22225,0,22225,58056,0,80281
142020101500000,NW 304,RESIDENTIAL,21875,0,21875,81877,0,103752
142020101600000,NW 304,RESIDENTIAL,21525,0,21525,68741,0,90266
142020101700000,NW 304,RESIDENTIAL,29645,0,29645,83028,0,112673
142020101800000,NW 304,RESIDENTIAL,20300,0,20300,60560,0,80860
142020101900000,NW 304,RESIDENTIAL,22890,0,22890,41399,0,64289
142020102000000,NW 304,RESIDENTIAL,27809,0,27809,103374,0,131183
142020102100000,NW 304,RESIDENTIAL,24980,0,24980,0,0,24980
142020200300000,NW 304,RESIDENTIAL,28175,0,28175,96518,0,124693
142020200400000,NW 304,RESIDENTIAL,15575,0,15575,78219,0,93794
142020200500000,NW 304,RESIDENTIAL,25777,0,25777,107080,0,132857
142020200600000,NW 304,RESIDENTIAL,29558,0,29558,131024,0,160582
142020200700000,NW 304,RESIDENTIAL,28169,0,28169,35507,0,63676
142020300100000,NW 304,RESIDENTIAL,68300,0,68300,58827,0,127127
142020300200000,NW 304,RESIDENTIAL,68300,0,68300,110719,0,179019
142020300300000,NW 304,RESIDENTIAL,54400,0,54400,82372,0,136772
142020300400000,NW 304,RESIDENTIAL,32078,0,32078,133901,0,165979
142020300500000,NW 304,RESIDENTIAL,54300,0,54300,85131,0,139431
142020300600000,NW 304,RESIDENTIAL,1750,0,1750,0,0,1750
142020300700000,NW 304,RESIDENTIAL,1750,0,1750,0,0,1750
142020300800000,NW 304,RESIDENTIAL,26936,0,26936,90783,0,117719
142020300900000,NW 304,RESIDENTIAL,26208,0,26208,88241,0,114449
142020301000000,NW 304,RESIDENTIAL,26208,0,26208,75279,0,101487
142020301100000,NW 304,RESIDENTIAL,30744,0,30744,83498,0,114242
142020301200000,NW 304,RESIDENTIAL,55650,0,55650,223506,0,279156
142020301300000,NW 304,RESIDENTIAL,22932,0,22932,13272,0,36204
142020400100000,NW 304,RESIDENTIAL,26985,0,26985,85445,0,112430
142020400200000,NW 304,RESIDENTIAL,27667,0,27667,147818,0,175485
142020400300000,NW 304,RESIDENTIAL,30536,0,30536,122715,0,153251
142020400400000,NW 304,RESIDENTIAL,18375,0,18375,92303,0,110678
142020400500000,NW 304,RESIDENTIAL,32188,0,32188,94864,0,127052
142020400600000,NW 304,RESIDENTIAL,235,0,235,0,0,235
142020400700000,NW 304,RESIDENTIAL,21663,0,21663,54811,0,76474
142020400800000,NW 304,RESIDENTIAL,21420,0,21420,85965,0,107385
142020400900000,NW 304,RESIDENTIAL,12992,0,12992,0,0,12992
142020401000000,NW 304,RESIDENTIAL,26163,0,26163,74567,0,100730
142020401100000,NW 304,RESIDENTIAL,25463,0,25463,101231,0,126694
142020401200000,NW 304,RESIDENTIAL,17500,0,17500,83165,0,100665
142020401300000,NW 304,RESIDENTIAL,17675,0,17675,90162,0,107837
142020401400000,NW 304,RESIDENTIAL,18200,0,18200,60231,0,78431
142020401500000,NW 304,RESIDENTIAL,19250,0,19250,53453,0,72703
142020401600000,NW 304,RESIDENTIAL,19250,0,19250,44696,0,63946
142020401700000,NW 304,RESIDENTIAL,23765,0,23765,92871,0,116636
142020401800000,NW 304,RESIDENTIAL,21168,0,21168,97297,0,118465
142020401900000,NW 304,RESIDENTIAL,21049,0,21049,119587,0,140636
142020402000000,NW 304,RESIDENTIAL,21355,0,21355,79683,0,101038
142020402100000,NW 304,RESIDENTIAL,18693,0,18693,95522,0,114215
142020402200000,NW 304,RESIDENTIAL,19833,0,19833,86649,0,106482
142020402500000,NW 304,RESIDENTIAL,27392,0,27392,114196,0,141588
142020402600000,NW 304,RESIDENTIAL,24948,0,24948,87076,0,112024
142020402700000,SECTION 42,COMMERCIAL,0,127440,127440,0,872560,1000000
142022600100000,NW 304,RESIDENTIAL,166040,0,166040,0,0,166040
142022600200000,NW 304,RESIDENTIAL,33950,0,33950,259016,0,292966
142022600300000,NW 304,RESIDENTIAL,38332,0,38332,209807,0,248139
142022600400000,NW 304,RESIDENTIAL,35420,0,35420,150392,0,185812
142022600500000,NW 304,RESIDENTIAL,57403,0,57403,157251,0,214654
142022700100000,NW 304,RESIDENTIAL,45377,0,45377,102116,0,147493
142022700200000,NW 304,RESIDENTIAL,51650,0,51650,146890,0,198540
142022700300000,NW 304,RESIDENTIAL,4455,0,4455,0,0,4455
142022700400000,NW 304,RESIDENTIAL,49000,0,49000,85799,0,134799
142022700500000,NW 304,RESIDENTIAL,39340,0,39340,87180,0,126520
142022700600000,NW 304,RESIDENTIAL,178,0,178,0,0,178
142022700700000,NW 304,RESIDENTIAL,1095,0,1095,0,0,1095
142022700800000,NW 304,RESIDENTIAL,18500,0,18500,78109,0,96609
142022700900000,NW 304,RESIDENTIAL,19950,0,19950,0,0,19950
142022701000000,NW 304,RESIDENTIAL,18125,0,18125,109218,0,127343
142022701100000,NW 304,RESIDENTIAL,35490,0,35490,121950,0,157440
142022701300000,NW 304,RESIDENTIAL,26705,0,26705,131384,0,158089
142022701400000,NW 304,RESIDENTIAL,40920,0,40920,85664,0,126584
142022701500000,NW 304,RESIDENTIAL,38570,0,38570,187086,0,225656
142022701600000,NW 304,RESIDENTIAL,36540,0,36540,200489,0,237029
142022701700000,NW 304,RESIDENTIAL,36540,0,36540,175473,0,212013
142022701800000,NW 304,RESIDENTIAL,37374,0,37374,129424,0,166798
142022701900000,NW 304,RESIDENTIAL,35000,0,35000,100235,0,135235
142022702000000,NW 304,RESIDENTIAL,34644,0,34644,140202,0,174846
142022702100000,NW 304,RESIDENTIAL,73200,0,73200,71149,0,144349
142022702200000,NW 304,RESIDENTIAL,40200,0,40200,66550,0,106750
142022702300000,NW 304,RESIDENTIAL,30069,0,30069,111190,0,141259
142022702400000,NW 304,RESIDENTIAL,41160,0,41160,87553,0,128713
142025100300000,NW 304,RESIDENTIAL,19901,0,19901,78601,0,98502
142025100400000,NW 304,RESIDENTIAL,19285,0,19285,86440,0,105725
142025100500000,NW 304,RESIDENTIAL,19285,0,19285,94797,0,114082
142025100600000,NW 304,RESIDENTIAL,19488,0,19488,85687,0,105175
142025100700000,NW 304,RESIDENTIAL,19488,0,19488,82856,0,102344
142025200100000,NW 304,RESIDENTIAL,25437,0,25437,90597,0,116034
142025200200000,NW 304,RESIDENTIAL,21446,0,21446,106474,0,127920
142025200300000,NW 304,RESIDENTIAL,21446,0,21446,104071,0,125517
142025200400000,NW 304,RESIDENTIAL,21221,0,21221,102215,0,123436
142025200500000,NW 304,RESIDENTIAL,25311,0,25311,76318,0,101629
142025200600000,SR/NURSING/ASSTD LIV,EXEMPT,0,342427,342427,0,4374203,4716630
142025200800000,DAY CARE CENTER,EXEMPT,0,297216,297216,0,764898,1062114
142025300100000,VACANT LAND,COMMERCIAL,0,2925,2925,0,0,2925
142027600100000,NW 304,RESIDENTIAL,29106,0,29106,79505,0,108611
142027600200000,NW 304,RESIDENTIAL,20370,0,20370,73585,0,93955
142027600300000,NW 304,RESIDENTIAL,20370,0,20370,70557,0,90927
142027600400000,NW 304,RESIDENTIAL,20370,0,20370,85291,0,105661
142027600500000,NW 304,RESIDENTIAL,20370,0,20370,114825,0,135195
142027600600000,NW 304,RESIDENTIAL,20370,0,20370,88747,0,109117
142027600700000,NW 304,RESIDENTIAL,20370,0,20370,120036,0,140406
142027600800000,NW 304,RESIDENTIAL,25208,0,25208,102731,0,127939
142027600900000,NW 304,RESIDENTIAL,28009,0,28009,103825,0,131834
142027601000000,NW 304,RESIDENTIAL,34883,0,34883,88387,0,123270
142027601100000,NW 304,RESIDENTIAL,37064,0,37064,128653,0,165717
142027601200000,NW 304,RESIDENTIAL,30744,0,30744,109226,0,139970
142027601300000,NW 304,RESIDENTIAL,26901,0,26901,99970,0,126871
142027601400000,NW 304,RESIDENTIAL,29890,0,29890,99615,0,129505
142027601700000,NW 304,RESIDENTIAL,23086,0,23086,105390,0,128476
142027601800000,NW 304,RESIDENTIAL,23765,0,23765,85656,0,109421
142027601900000,NW 304,RESIDENTIAL,22124,0,22124,84396,0,106520
142027602000000,NW 304,RESIDENTIAL,22124,0,22124,78486,0,100610
142027602100000,NW 304,RESIDENTIAL,22124,0,22124,74038,0,96162
142027602200000,NW 304,RESIDENTIAL,22523,0,22523,82023,0,104546
142027602300000,NW 304,RESIDENTIAL,24255,0,24255,83817,0,108072
142027602400000,NW 304,RESIDENTIAL,24500,0,24500,78937,0,103437
142027602500000,NW 304,RESIDENTIAL,22750,0,22750,75003,0,97753
142027602600000,NW 304,RESIDENTIAL,22978,0,22978,76960,0,99938
142027602700000,NW 304,RESIDENTIAL,22369,0,22369,76204,0,98573
142027602800000,NW 304,RESIDENTIAL,23438,0,23438,74346,0,97784
142027602900000,NW 304,RESIDENTIAL,27417,0,27417,70948,0,98365
142027603000000,NW 304,RESIDENTIAL,26810,0,26810,134998,0,161808
142027603100000,NW 304,RESIDENTIAL,24055,0,24055,72310,0,96365
142027603200000,NW 304,RESIDENTIAL,21420,0,21420,80229,0,101649
142027603300000,NW 304,RESIDENTIAL,21420,0,21420,79578,0,100998
142027603400000,NW 304,RESIDENTIAL,21420,0,21420,91697,0,113117
142027603500000,NW 304,RESIDENTIAL,21420,0,21420,68555,0,89975
142027603600000,NW 304,RESIDENTIAL,21420,0,21420,82896,0,104316
142027603700000,NW 304,RESIDENTIAL,21420,0,21420,83072,0,104492
142027603800000,NW 304,RESIDENTIAL,22122,0,22122,79812,0,101934
142027700100000,CITY PROPERTY,EXEMPT,0,0,0,0,0,0
142027700200000,NW 304,RESIDENTIAL,22068,0,22068,81917,0,103985
142027700300000,NW 304,RESIDENTIAL,22068,0,22068,89881,0,111949
142027700400000,NW 304,RESIDENTIAL,26787,0,26787,99114,0,125901
142027700500000,CITY PROPERTY,EXEMPT,0,0,0,0,0,0
142027700600000,SCHOOL,EXEMPT,0,0,0,0,0,0
142027700700000,NW 304,RESIDENTIAL,24990,0,24990,122602,0,147592
142027700800000,NW 304,RESIDENTIAL,19459,0,19459,0,0,19459
142027700900000,NW 304,RESIDENTIAL,25480,0,25480,123878,0,149358
142027701000000,NW 304,RESIDENTIAL,25042,0,25042,121699,0,146741
142027701100000,NW 304,RESIDENTIAL,21952,0,21952,85788,0,107740
142027701200000,NW 304,RESIDENTIAL,21336,0,21336,76402,0,97738
142027701300000,NW 304,RESIDENTIAL,21672,0,21672,88551,0,110223
142027701400000,NW 304,RESIDENTIAL,21672,0,21672,81632,0,103304
142027701500000,NW 304,RESIDENTIAL,21672,0,21672,84625,0,106297
142027701600000,NW 304,RESIDENTIAL,21446,0,21446,84750,0,106196
142027800100000,SCHOOL,EXEMPT,0,0,0,0,0,0
142027800200000,SCHOOL,EXEMPT,0,0,0,0,0,0
142027800300000,APARTMENT,RESIDENTIAL,873180,0,873180,12390307,0,13263487
142030100100000,NW 311,RESIDENTIAL,16000,0,16000,59831,0,75831
142030100200000,NW 311,RESIDENTIAL,20976,0,20976,82401,0,103377
142030100300000,NW 311,RESIDENTIAL,19872,0,19872,64575,0,84447
142030100400000,NW 311,RESIDENTIAL,19872,0,19872,71463,0,91335
142030100500000,NW 311,RESIDENTIAL,19872,0,19872,52037,0,71909
142030100600000,NW 311,RESIDENTIAL,19872,0,19872,51465,0,71337
142030100700000,NW 311,RESIDENTIAL,19872,0,19872,53114,0,72986
142030100800000,NW 311,RESIDENTIAL,19872,0,19872,58230,0,78102
142030100900000,NW 311,RESIDENTIAL,19872,0,19872,51664,0,71536
142030101000000,NW 311,RESIDENTIAL,20829,0,20829,65149,0,85978
142030101100000,NW 311,RESIDENTIAL,25920,0,25920,71879,0,97799
142030101200000,NW 311,RESIDENTIAL,20800,0,20800,87124,0,107924
142030101300000,NW 311,RESIDENTIAL,16000,0,16000,76328,0,92328
142030101400000,NW 311,RESIDENTIAL,27200,0,27200,85136,0,112336
142030101500000,NW 311,RESIDENTIAL,16000,0,16000,77889,0,93889
142030101600000,NW 311,RESIDENTIAL,16000,0,16000,56818,0,72818
142030101700000,NW 311,RESIDENTIAL,16000,0,16000,52328,0,68328
142030101800000,NW 311,RESIDENTIAL,16000,0,16000,61716,0,77716
142030101900000,NW 311,RESIDENTIAL,16000,0,16000,61063,0,77063
142030200100000,NW 311,RESIDENTIAL,23104,0,23104,0,0,23104
142030200200000,NW 311,RESIDENTIAL,22593,0,22593,0,0,22593
142030200300000,NW 312,RESIDENTIAL,21600,0,21600,74954,0,96554
142030200400000,NW 312,RESIDENTIAL,25569,0,25569,91175,0,116744
142030200500000,NW 312,RESIDENTIAL,29430,0,29430,92504,0,121934
142030200600000,NW 312,RESIDENTIAL,30240,0,30240,103200,0,133440
142030200700000,NW 312,RESIDENTIAL,30395,0,30395,86697,0,117092
142030200800000,NW 312,RESIDENTIAL,26208,0,26208,76749,0,102957
142030200900000,NW 312,RESIDENTIAL,26208,0,26208,102760,0,128968
142030201000000,NW 312,RESIDENTIAL,24804,0,24804,90612,0,115416
142030201100000,NW 312,RESIDENTIAL,27612,0,27612,79944,0,107556
142030201200000,NW 312,RESIDENTIAL,26208,0,26208,92140,0,118348
142030201300000,NW 312,RESIDENTIAL,26208,0,26208,98014,0,124222
142030201400000,NW 312,RESIDENTIAL,28080,0,28080,85729,0,113809
142030201500000,NW 312,RESIDENTIAL,28080,0,28080,94857,0,122937
142030201600000,NW 312,RESIDENTIAL,28080,0,28080,90845,0,118925
142030201700000,NW 311,RESIDENTIAL,33858,0,33858,92954,0,126812
142030201800000,NW 311,RESIDENTIAL,33858,0,33858,101766,0,135624
142030201900000,NW 311,RESIDENTIAL,32405,0,32405,74361,0,106766
142030202000000,NW 311,RESIDENTIAL,27600,0,27600,66048,0,93648
142030202100000,NW 311,RESIDENTIAL,33060,0,33060,115703,0,148763
142030202200000,NW 311,RESIDENTIAL,27600,0,27600,94387,0,121987
142030202300000,NW 311,RESIDENTIAL,27600,0,27600,67400,0,95000
142030202400000,NW 311,RESIDENTIAL,24840,0,24840,114848,0,139688
142030202500000,NW 311,RESIDENTIAL,24840,0,24840,114848,0,139688
142030202800000,SR/NURSING/ASSTD LIV,EXEMPT,0,113940,113940,0,1851114,1965054
142030202900000,SR/NURSING/ASSTD LIV,EXEMPT,0,8370,8370,0,0,8370
142030203000000,NW 311,RESIDENTIAL,18216,0,18216,56946,0,75162
142030203100000,NW 311,RESIDENTIAL,18624,0,18624,0,0,18624
142030203200000,NW 311,RESIDENTIAL,19552,0,19552,0,0,19552
142030203300000,NW 311,RESIDENTIAL,24840,0,24840,116816,0,141656
142030203400000,NW 311,RESIDENTIAL,25254,0,25254,114848,0,140102
142030300100000,NW 311,RESIDENTIAL,16497,0,16497,56752,0,73249
142030300200000,NW 311,RESIDENTIAL,16320,0,16320,52899,0,69219
142030300300000,NW 311,RESIDENTIAL,16320,0,16320,46665,0,62985
142030300400000,NW 311,RESIDENTIAL,16320,0,16320,72067,0,88387
142030300500000,NW 311,RESIDENTIAL,16320,0,16320,58759,0,75079
142030300600000,NW 311,RESIDENTIAL,16320,0,16320,62132,0,78452
142030300700000,NW 311,RESIDENTIAL,16320,0,16320,57298,0,73618
142030300800000,NW 311,RESIDENTIAL,16320,0,16320,57560,0,73880
142030300900000,NW 311,RESIDENTIAL,16480,0,16480,36743,0,53223
142030301000000,NW 311,RESIDENTIAL,16480,0,16480,74903,0,91383
142030301100000,NW 311,RESIDENTIAL,16480,0,16480,61224,0,77704
142030301200000,NW 311,RESIDENTIAL,16480,0,16480,55352,0,71832
142030301300000,NW 311,RESIDENTIAL,16480,0,16480,66733,0,83213
142030301400000,NW 311,RESIDENTIAL,16480,0,16480,66935,0,83415
142030301500000,NW 311,RESIDENTIAL,16123,0,16123,46868,0,62991
142030301600000,NW 311,RESIDENTIAL,16320,0,16320,55319,0,71639
142030301700000,NW 311,RESIDENTIAL,16320,0,16320,68726,0,85046
142030301800000,NW 311,RESIDENTIAL,16320,0,16320,52709,0,69029
142030301900000,NW 311,RESIDENTIAL,16320,0,16320,64845,0,81165
142030302000000,NW 311,RESIDENTIAL,16320,0,16320,78043,0,94363
142030302100000,NW 311,RESIDENTIAL,16320,0,16320,63760,0,80080
142030302200000,NW 311,RESIDENTIAL,16320,0,16320,80757,0,97077
142030302300000,NW 311,RESIDENTIAL,16320,0,16320,59512,0,75832
142030302400000,NW 311,RESIDENTIAL,16320,0,16320,54193,0,70513
142030302500000,NW 311,RESIDENTIAL,16320,0,16320,48968,0,65288
142030302600000,NW 311,RESIDENTIAL,16320,0,16320,56787,0,73107
142030302700000,NW 311,RESIDENTIAL,16320,0,16320,57972,0,74292
142030302800000,NW 311,RESIDENTIAL,16320,0,16320,63404,0,79724
142030302900000,NW 311,RESIDENTIAL,16800,0,16800,55907,0,72707
142030303000000,NW 311,RESIDENTIAL,12160,0,12160,51007,0,63167
142030303100000,NW 311,RESIDENTIAL,12160,0,12160,70474,0,82634
142030400100000,NW 312,RESIDENTIAL,25088,0,25088,88648,0,113736
142030400200000,NW 312,RESIDENTIAL,21816,0,21816,90962,0,112778
142030400300000,NW 312,RESIDENTIAL,23836,0,23836,84350,0,108186
142030400400000,NW 312,RESIDENTIAL,23836,0,23836,85083,0,108919
142030500100000,NW 311,RESIDENTIAL,16480,0,16480,79633,0,96113
142030500200000,NW 311,RESIDENTIAL,16480,0,16480,69147,0,85627
142030500300000,NW 311,RESIDENTIAL,16480,0,16480,68654,0,85134
142030500400000,NW 311,RESIDENTIAL,16480,0,16480,73417,0,89897
142030500500000,NW 311,RESIDENTIAL,16320,0,16320,60865,0,77185
142030500600000,NW 310,RESIDENTIAL,16640,0,16640,0,0,16640
142030500700000,NW 311,RESIDENTIAL,16320,0,16320,46097,0,62417
142030500800000,NW 311,RESIDENTIAL,16320,0,16320,66243,0,82563
142030500900000,NW 311,RESIDENTIAL,19584,0,19584,72666,0,92250
142030501000000,NW 311,RESIDENTIAL,19584,0,19584,87686,0,107270
142030501100000,NW 311,RESIDENTIAL,16320,0,16320,69105,0,85425
142030501200000,NW 311,RESIDENTIAL,16160,0,16160,82769,0,98929
142030501300000,NW 311,RESIDENTIAL,21008,0,21008,64360,0,85368
142030501400000,NW 311,RESIDENTIAL,19872,0,19872,75884,0,95756
142030501500000,NW 311,RESIDENTIAL,19790,0,19790,69626,0,89416
142030501600000,NW 311,RESIDENTIAL,19590,0,19590,56108,0,75698
142030501700000,NW 311,RESIDENTIAL,14560,0,14560,64268,0,78828
142030501800000,NW 311,RESIDENTIAL,14560,0,14560,43518,0,58078
142030501900000,CITY PROPERTY,EXEMPT,0,0,0,0,0,0
142030502000000,NW 311,RESIDENTIAL,14560,0,14560,43103,0,57663
142030502100000,NW 311,RESIDENTIAL,14560,0,14560,59023,0,73583
142030502200000,NW 311,RESIDENTIAL,14560,0,14560,51211,0,65771
142030502300000,NW 311,RESIDENTIAL,14560,0,14560,105618,0,120178
142030502400000,NW 311,RESIDENTIAL,14560,0,14560,59875,0,74435
142030502500000,NW 311,RESIDENTIAL,14560,0,14560,84498,0,99058
142030502600000,NW 311,RESIDENTIAL,14560,0,14560,58174,0,72734
142030502700000,NW 311,RESIDENTIAL,21504,0,21504,68648,0,90152
142030502800000,NW 311,RESIDENTIAL,20967,0,20967,67507,0,88474
142030600100000,NW 312,RESIDENTIAL,25088,0,25088,99827,0,124915
142030600200000,NW 312,RESIDENTIAL,21168,0,21168,79800,0,100968
142030600300000,NW 312,RESIDENTIAL,22176,0,22176,77799,0,99975
142030600400000,NW 312,RESIDENTIAL,21384,0,21384,100449,0,121833
142030600500000,NW 312,RESIDENTIAL,20839,0,20839,89226,0,110065
142032600100000,NW 312,RESIDENTIAL,24404,0,24404,72205,0,96609
142032600200000,NW 312,RESIDENTIAL,26520,0,26520,111252,0,137772
142032600300000,NW 312,RESIDENTIAL,29376,0,29376,110485,0,139861
142032600400000,NW 312,RESIDENTIAL,25349,0,25349,79993,0,105342
142032600500000,NW 312,RESIDENTIAL,24960,0,24960,86466,0,111426
142032600600000,NW 312,RESIDENTIAL,27120,0,27120,91865,0,118985
142032600700000,NW 312,RESIDENTIAL,25680,0,25680,85054,0,110734
142032600800000,NW 312,RESIDENTIAL,23970,0,23970,97775,0,121745
142032600900000,NW 312,RESIDENTIAL,32425,0,32425,115697,0,148122
142032601000000,NW 312,RESIDENTIAL,24133,0,24133,98172,0,122305
142032601100000,NW 312,RESIDENTIAL,24000,0,24000,80085,0,104085
142032601200000,NW 312,RESIDENTIAL,24000,0,24000,85060,0,109060
142032601300000,NW 312,RESIDENTIAL,24000,0,24000,92841,0,116841
142032601400000,NW 312,RESIDENTIAL,24768,0,24768,83202,0,107970
142032700100000,NW 312,RESIDENTIAL,63550,0,63550,111647,0,175197
142032700200000,NW 312,RESIDENTIAL,31718,0,31718,94348,0,126066
142032700300000,NW 312,RESIDENTIAL,27901,0,27901,89543,0,117444
142032700400000,NW 312,RESIDENTIAL,25220,0,25220,99596,0,124816
142032700500000,NW 312,RESIDENTIAL,27677,0,27677,96800,0,124477
142032700600000,NW 312,RESIDENTIAL,28777,0,28777,90218,0,118995
142032700700000,NW 312,RESIDENTIAL,29837,0,29837,87830,0,117667
142032700800000,NW 312,RESIDENTIAL,27179,0,27179,98749,0,125928
142032701000000,NW 312,RESIDENTIAL,26700,0,26700,95147,0,121847
142032701100000,NW 312,RESIDENTIAL,26668,0,26668,102244,0,128912
142032701200000,NW 312,RESIDENTIAL,28120,0,28120,92729,0,120849
142032701300000,NW 312,RESIDENTIAL,28747,0,28747,89793,0,118540
142032702100000,NW 312,RESIDENTIAL,23467,0,23467,92811,0,116278
142032800100000,NW 312,RESIDENTIAL,23823,0,23823,97800,0,121623
142032800200000,NW 312,RESIDENTIAL,24000,0,24000,97034,0,121034
142032800300000,NW 312,RESIDENTIAL,24000,0,24000,90050,0,114050
142032800400000,NW 312,RESIDENTIAL,24000,0,24000,105846,0,129846
142032800500000,NW 312,RESIDENTIAL,24000,0,24000,81298,0,105298
142032800600000,NW 312,RESIDENTIAL,24000,0,24000,75862,0,99862
142032800700000,NW 312,RESIDENTIAL,24000,0,24000,80782,0,104782
142032800800000,NW 312,RESIDENTIAL,24000,0,24000,94910,0,118910
142032800900000,NW 312,RESIDENTIAL,24000,0,24000,85947,0,109947
142032801000000,NW 312,RESIDENTIAL,24000,0,24000,77246,0,101246
142032801100000,NW 312,RESIDENTIAL,24000,0,24000,90178,0,114178
142032801200000,NW 312,RESIDENTIAL,24000,0,24000,92746,0,116746
142032801300000,NW 312,RESIDENTIAL,24000,0,24000,82349,0,106349
142032801400000,NW 312,RESIDENTIAL,24000,0,24000,94633,0,118633
142032801500000,NW 312,RESIDENTIAL,25600,0,25600,92152,0,117752
142032801600000,NW 312,RESIDENTIAL,25600,0,25600,77895,0,103495
142032801700000,NW 312,RESIDENTIAL,25600,0,25600,64935,0,90535
142032801800000,NW 312,RESIDENTIAL,25600,0,25600,95812,0,121412
142032801900000,NW 312,RESIDENTIAL,25600,0,25600,96134,0,121734
142032802000000,NW 312,RESIDENTIAL,28000,0,28000,97984,0,125984
142032802100000,NW 312,RESIDENTIAL,27781,0,27781,101294,0,129075
142032900100000,NW 312,RESIDENTIAL,25700,0,25700,98783,0,124483
142032900200000,NW 312,RESIDENTIAL,26520,0,26520,92334,0,118854
142032900300000,NW 312,RESIDENTIAL,26520,0,26520,103924,0,130444
142032900400000,NW 312,RESIDENTIAL,26539,0,26539,76893,0,103432
142032900500000,NW 312,RESIDENTIAL,28955,0,28955,88292,0,117247
142032900600000,NW 312,RESIDENTIAL,28400,0,28400,81777,0,110177
142032900700000,NW 312,RESIDENTIAL,26787,0,26787,76324,0,103111
142032900800000,NW 312,RESIDENTIAL,28496,0,28496,90637,0,119133
142032900900000,NW 312,RESIDENTIAL,29702,0,29702,70956,0,100658
142032901000000,NW 312,RESIDENTIAL,29430,0,29430,81145,0,110575
142032901100000,NW 312,RESIDENTIAL,29430,0,29430,69528,0,98958
142032901200000,NW 312,RESIDENTIAL,31280,0,31280,85582,0,116862
142033000100000,NW 312,RESIDENTIAL,25480,0,25480,84920,0,110400
142033000200000,NW 312,RESIDENTIAL,29161,0,29161,90270,0,119431
142033000300000,NW 312,RESIDENTIAL,27440,0,27440,92119,0,119559
142033000400000,NW 312,RESIDENTIAL,26160,0,26160,68611,0,94771
142033000500000,NW 312,RESIDENTIAL,26400,0,26400,116843,0,143243
142033000600000,NW 312,RESIDENTIAL,29380,0,29380,76014,0,105394
142033000700000,NW 312,RESIDENTIAL,28340,0,28340,85299,0,113639
142033000800000,NW 312,RESIDENTIAL,28000,0,28000,85228,0,113228
142033000900000,NW 312,RESIDENTIAL,28000,0,28000,84433,0,112433
142033001000000,NW 312,RESIDENTIAL,28000,0,28000,86413,0,114413
142033001100000,NW 312,RESIDENTIAL,27720,0,27720,83651,0,111371
142033001200000,NW 312,RESIDENTIAL,27701,0,27701,94882,0,122583
142033001300000,NW 312,RESIDENTIAL,27160,0,27160,92939,0,120099
142033001400000,NW 312,RESIDENTIAL,30652,0,30652,85148,0,115800
142033001500000,NW 312,RESIDENTIAL,29165,0,29165,95954,0,125119
142033001600000,NW 312,RESIDENTIAL,25600,0,25600,86532,0,112132
142033001700000,NW 312,RESIDENTIAL,25600,0,25600,98723,0,124323
142033001800000,NW 312,RESIDENTIAL,25344,0,25344,90028,0,115372
142033001900000,NW 312,RESIDENTIAL,29200,0,29200,106805,0,136005
142033002000000,NW 312,RESIDENTIAL,30368,0,30368,85286,0,115654
142033002100000,NW 312,RESIDENTIAL,29349,0,29349,85078,0,114427
142033002200000,NW 312,RESIDENTIAL,30766,0,30766,96150,0,126916
142033002300000,NW 312,RESIDENTIAL,29397,0,29397,91971,0,121368
142033002400000,NW 312,RESIDENTIAL,26000,0,26000,90414,0,116414
142033002500000,NW 312,RESIDENTIAL,27744,0,27744,103001,0,130745
142033002600000,NW 312,RESIDENTIAL,28928,0,28928,66743,0,95671
142033002700000,NW 312,RESIDENTIAL,29136,0,29136,85789,0,114925
142033002800000,NW 312,RESIDENTIAL,27120,0,27120,98276,0,125396
142033002900000,NW 312,RESIDENTIAL,26400,0,26400,99415,0,125815
142033003000000,NW 312,RESIDENTIAL,28672,0,28672,80316,0,108988
142033100100000,NW 312,RESIDENTIAL,30396,0,30396,69914,0,100310
142033100200000,NW 312,RESIDENTIAL,29845,0,29845,94789,0,124634
142033100300000,NW 312,RESIDENTIAL,22116,0,22116,76090,0,98206
142033100400000,NW 312,RESIDENTIAL,23280,0,23280,76735,0,100015
142033100500000,NW 312,RESIDENTIAL,23280,0,23280,95901,0,119181
142033100600000,NW 312,RESIDENTIAL,23280,0,23280,80371,0,103651
142033100700000,NW 312,RESIDENTIAL,23280,0,23280,76751,0,100031
142033100800000,NW 312,RESIDENTIAL,23280,0,23280,81740,0,105020
142033100900000,NW 312,RESIDENTIAL,23280,0,23280,78401,0,101681
142033101000000,NW 312,RESIDENTIAL,23280,0,23280,81866,0,105146
142033101100000,NW 312,RESIDENTIAL,23280,0,23280,74361,0,97641
142033101200000,NW 312,RESIDENTIAL,23280,0,23280,90103,0,113383
142033101300000,NW 312,RESIDENTIAL,24832,0,24832,89499,0,114331
142033101400000,NW 312,RESIDENTIAL,24832,0,24832,72239,0,97071
142033101500000,NW 312,RESIDENTIAL,24832,0,24832,81675,0,106507
142033101600000,NW 312,RESIDENTIAL,24832,0,24832,61269,0,86101
142033101700000,NW 312,RESIDENTIAL,24832,0,24832,77809,0,102641
142033101800000,NW 312,RESIDENTIAL,27160,0,27160,89811,0,116971
142033101900000,NW 312,RESIDENTIAL,27160,0,27160,80049,0,107209
142033102000000,NW 312,RESIDENTIAL,28000,0,28000,74508,0,102508
142033102100000,NW 312,RESIDENTIAL,28239,0,28239,80519,0,108758
142033102200000,NW 312,RESIDENTIAL,27160,0,27160,78159,0,105319
142033102300000,NW 312,RESIDENTIAL,27160,0,27160,82742,0,109902
142033102400000,NW 312,RESIDENTIAL,27160,0,27160,77330,0,104490
142033102500000,NW 312,RESIDENTIAL,27160,0,27160,77372,0,104532
142033102600000,NW 312,RESIDENTIAL,24444,0,24444,105200,0,129644
142033102700000,NW 312,RESIDENTIAL,24444,0,24444,89292,0,113736
142033102800000,NW 312,RESIDENTIAL,23280,0,23280,93323,0,116603
142033102900000,NW 312,RESIDENTIAL,23280,0,23280,81271,0,104551
142033103000000,NW 312,RESIDENTIAL,23280,0,23280,87580,0,110860
142033103100000,NW 312,RESIDENTIAL,23280,0,23280,78381,0,101661
142033103200000,NW 312,RESIDENTIAL,21560,0,21560,103311,0,124871
142033200100000,NW 312,RESIDENTIAL,29675,0,29675,87663,0,117338
142033200200000,NW 312,RESIDENTIAL,30977,0,30977,85049,0,116026
142033200300000,NW 312,RESIDENTIAL,28195,0,28195,90256,0,118451
142033200400000,NW 312,RESIDENTIAL,29400,0,29400,87311,0,116711
142033200500000,NW 312,RESIDENTIAL,29640,0,29640,91615,0,121255
142033200600000,NW 312,RESIDENTIAL,28718,0,28718,105488,0,134206
142033200700000,NW 312,RESIDENTIAL,25160,0,25160,75432,0,100592
142033200800000,NW 312,RESIDENTIAL,25440,0,25440,86591,0,112031
142033200900000,NW 312,RESIDENTIAL,25920,0,25920,88692,0,114612
142033201000000,NW 312,RESIDENTIAL,29205,0,29205,116377,0,145582
142035100100000,APARTMENT,COMMERCIAL,0,190850,190850,0,1385640,1576490
142035100200000,NW 312,RESIDENTIAL,29184,0,29184,86346,0,115530
142035100300000,NW 312,RESIDENTIAL,24000,0,24000,80910,0,104910
142035100400000,NW 312,RESIDENTIAL,24000,0,24000,75646,0,99646
142035100500000,NW 312,RESIDENTIAL,24000,0,24000,103429,0,127429
142035100600000,NW 312,RESIDENTIAL,24000,0,24000,94831,0,118831
142035100700000,NW 312,RESIDENTIAL,24000,0,24000,83420,0,107420
142035100800000,NW 312,RESIDENTIAL,25317,0,25317,85356,0,110673
142035100900000,NW 312,RESIDENTIAL,25625,0,25625,76283,0,101908
142035101800000,APARTMENT,COMMERCIAL,0,181600,181600,0,1444398,1625998
142035101900000,NW 312,RESIDENTIAL,26624,0,26624,116476,0,143100
142035102000000,NW 312,RESIDENTIAL,20188,0,20188,83356,0,103544
142035102100000,NW 312,RESIDENTIAL,23760,0,23760,76435,0,100195
142035102200000,NW 312,RESIDENTIAL,17607,0,17607,145639,0,163246
142035102300000,NW 312,RESIDENTIAL,23760,0,23760,93303,0,117063
142035102400000,NW 312,RESIDENTIAL,23760,0,23760,84509,0,108269
142035102500000,NW 312,RESIDENTIAL,23760,0,23760,110166,0,133926
142035102600000,NW 312,RESIDENTIAL,30969,0,30969,105347,0,136316
142035102700000,NW 312,RESIDENTIAL,479,0,479,0,0,479
142035102800000,NW 312,RESIDENTIAL,28200,0,28200,110901,0,139101
142035102900000,NW 312,RESIDENTIAL,19176,0,19176,111480,0,130656
142035103000000,NW 312,RESIDENTIAL,930,0,930,0,0,930
142035103100000,NW 312,RESIDENTIAL,51200,0,51200,230810,0,282010
142035200100000,NW 312,RESIDENTIAL,28613,0,28613,88729,0,117342
142035200200000,NW 312,RESIDENTIAL,27720,0,27720,66097,0,93817
142035200300000,NW 312,RESIDENTIAL,28280,0,28280,63446,0,91726
142035200400000,NW 312,RESIDENTIAL,28560,0,28560,82334,0,110894
142035200500000,NW 312,RESIDENTIAL,28560,0,28560,98366,0,126926
142035200600000,NW 312,RESIDENTIAL,28682,0,28682,67741,0,96423
142035200700000,NW 312,RESIDENTIAL,29387,0,29387,84982,0,114369
142035200800000,NW 312,RESIDENTIAL,26069,0,26069,99465,0,125534
142035200900000,NW 312,RESIDENTIAL,25433,0,25433,82669,0,108102
142035201000000,NW 312,RESIDENTIAL,23280,0,23280,79790,0,103070
142035201100000,NW 312,RESIDENTIAL,23433,0,23433,82292,0,105725
142035201200000,NW 312,RESIDENTIAL,24827,0,24827,71282,0,96109
142035201300000,NW 312,RESIDENTIAL,28292,0,28292,87651,0,115943
142035201400000,NW 312,RESIDENTIAL,28280,0,28280,69881,0,98161
142035201500000,NW 312,RESIDENTIAL,28280,0,28280,81720,0,110000
142035201600000,NW 312,RESIDENTIAL,29484,0,29484,85650,0,115134
142035300100000,NW 312,RESIDENTIAL,28000,0,28000,93029,0,121029
142035300200000,NW 312,RESIDENTIAL,28000,0,28000,74041,0,102041
142035300300000,NW 312,RESIDENTIAL,28000,0,28000,85781,0,113781
142035300400000,NW 312,RESIDENTIAL,28000,0,28000,72334,0,100334
142035300500000,NW 312,RESIDENTIAL,28479,0,28479,82025,0,110504
142035300600000,NW 312,RESIDENTIAL,29682,0,29682,70932,0,100614
142035400100000,APARTMENT,COMMERCIAL,0,16988,16988,0,102181,119169
142035400200000,NW 312,RESIDENTIAL,19012,0,19012,79573,0,98585
142035400300000,NW 312,RESIDENTIAL,20923,0,20923,100526,0,121449
142035501000000,NW 312,RESIDENTIAL,29316,0,29316,98973,0,128289
142035501100000,NW 312,RESIDENTIAL,23040,0,23040,65249,0,88289
142035501200000,NW 312,RESIDENTIAL,23040,0,23040,75051,0,98091
142035501300000,NW 312,RESIDENTIAL,23040,0,23040,81608,0,104648
142035501400000,NW 312,RESIDENTIAL,29100,0,29100,82505,0,111605
142035501500000,NW 312,RESIDENTIAL,29400,0,29400,87926,0,117326
142035501600000,NW 312,RESIDENTIAL,25600,0,25600,84652,0,110252
142035501700000,NW 312,RESIDENTIAL,25976,0,25976,96892,0,122868
142035600100000,NW 312,RESIDENTIAL,244,0,244,0,0,244
142035700100000,APARTMENT,COMMERCIAL,0,38024,38024,0,466521,504545
142035700200000,APARTMENT,COMMERCIAL,0,36275,36275,0,381314,417589
142035700300000,CITY PROPERTY,EXEMPT,0,0,0,0,0,0
142035700400000,NW 322,RESIDENTIAL,26705,0,26705,88325,0,115030
142035700500000,CITY PROPERTY,EXEMPT,0,0,0,0,0,0
142035700600000,NW 322,RESIDENTIAL,40757,0,40757,126734,0,167491
142035700700000,NW 322,RESIDENTIAL,30625,0,30625,80310,0,110935
142035700800000,NW 322,RESIDENTIAL,24745,0,24745,91288,0,116033
142035700900000,NW 322,RESIDENTIAL,23520,0,23520,83768,0,107288
142035701000000,NW 322,RESIDENTIAL,23280,0,23280,83016,0,106296
142035701100000,NW 322,RESIDENTIAL,29582,0,29582,101076,0,130658
142035701200000,NW 322,RESIDENTIAL,30660,0,30660,89612,0,120272
142035701300000,NW 322,RESIDENTIAL,28800,0,28800,82509,0,111309
142035701400000,NW 322,RESIDENTIAL,28453,0,28453,86083,0,114536
142035701500000,NW 322,RESIDENTIAL,24480,0,24480,88446,0,112926
142035701600000,NW 322,RESIDENTIAL,24360,0,24360,62596,0,86956
142035701700000,NW 322,RESIDENTIAL,26536,0,26536,80621,0,107157
142035701800000,NW 322,RESIDENTIAL,25920,0,25920,74622,0,100542
142035701900000,NW 322,RESIDENTIAL,26160,0,26160,53167,0,79327
142035702000000,NW 322,RESIDENTIAL,26400,0,26400,82224,0,108624
142035800100000,NW 322,RESIDENTIAL,22100,0,22100,68819,0,90919
142035800200000,NW 322,RESIDENTIAL,22560,0,22560,74186,0,96746
142035800300000,NW 322,RESIDENTIAL,22560,0,22560,82651,0,105211
142035800400000,NW 322,RESIDENTIAL,22560,0,22560,78832,0,101392
142035800500000,NW 322,RESIDENTIAL,22560,0,22560,67220,0,89780
142035800600000,NW 322,RESIDENTIAL,22560,0,22560,85556,0,108116
142035800700000,NW 322,RESIDENTIAL,23855,0,23855,107226,0,131081
142035800800000,NW 322,RESIDENTIAL,19967,0,19967,83701,0,103668
142035800900000,NW 322,RESIDENTIAL,19740,0,19740,93877,0,113617
142035801000000,NW 322,RESIDENTIAL,19740,0,19740,78954,0,98694
142035801100000,NW 322,RESIDENTIAL,19740,0,19740,88976,0,108716
142035801200000,NW 322,RESIDENTIAL,19740,0,19740,78109,0,97849
142035801300000,NW 322,RESIDENTIAL,19740,0,19740,91692,0,111432
142035801400000,NW 322,RESIDENTIAL,21385,0,21385,78955,0,100340
142037600100000,NW 311,RESIDENTIAL,20418,0,20418,72803,0,93221
142037600200000,NW 311,RESIDENTIAL,19796,0,19796,60246,0,80042
142037600300000,NW 311,RESIDENTIAL,12250,0,12250,56317,0,68567
142037600400000,NW 311,RESIDENTIAL,12250,0,12250,39101,0,51351
142037600500000,NW 311,RESIDENTIAL,14000,0,14000,70412,0,84412
142037600600000,NW 311,RESIDENTIAL,14000,0,14000,46790,0,60790
142037600700000,NW 311,RESIDENTIAL,14000,0,14000,0,0,14000
142037600800000,NW 311,RESIDENTIAL,19600,0,19600,53499,0,73099
142037600900000,NW 311,RESIDENTIAL,14000,0,14000,56095,0,70095
142037601000000,NW 311,RESIDENTIAL,14000,0,14000,61138,0,75138
142037601100000,NW 311,RESIDENTIAL,13860,0,13860,52881,0,66741
142037601200000,NW 311,RESIDENTIAL,13860,0,13860,56417,0,70277
142037601300000,NW 311,RESIDENTIAL,19404,0,19404,82563,0,101967
142037601400000,NW 311,RESIDENTIAL,16982,0,16982,53520,0,70502
142037700100000,NW 311,RESIDENTIAL,28433,0,28433,78663,0,107096
142037700200000,NW 312,RESIDENTIAL,29136,0,29136,93618,0,122754
142037700300000,NW 312,RESIDENTIAL,29280,0,29280,72657,0,101937
142037700400000,NW 312,RESIDENTIAL,30973,0,30973,110112,0,141085
142037700500000,NW 312,RESIDENTIAL,29520,0,29520,84490,0,114010
142037700600000,NW 312,RESIDENTIAL,26400,0,26400,98201,0,124601
142037700700000,NW 312,RESIDENTIAL,27060,0,27060,93416,0,120476
142037700800000,NW 312,RESIDENTIAL,29520,0,29520,98980,0,128500
142037700900000,NW 312,RESIDENTIAL,29295,0,29295,93233,0,122528
142037701000000,NW 312,RESIDENTIAL,34648,0,34648,85105,0,119753
142037701100000,NW 312,RESIDENTIAL,29036,0,29036,91752,0,120788
142037701200000,NW 312,RESIDENTIAL,28798,0,28798,88285,0,117083
142037701300000,NW 312,RESIDENTIAL,29621,0,29621,99502,0,129123
142037701400000,NW 312,RESIDENTIAL,23590,0,23590,99856,0,123446
142037701500000,NW 312,RESIDENTIAL,23280,0,23280,84460,0,107740
142037701600000,NW 312,RESIDENTIAL,25973,0,25973,84180,0,110153
142037701700000,NW 312,RESIDENTIAL,28120,0,28120,84846,0,112966
142037701800000,NW 311,RESIDENTIAL,34227,0,34227,115725,0,149952
142037701900000,NW 311,RESIDENTIAL,25235,0,25235,59282,0,84517
142037702000000,NW 311,RESIDENTIAL,20703,0,20703,91563,0,112266
142037702100000,NW 311,RESIDENTIAL,23888,0,23888,102956,0,126844
142037702200000,NW 311,RESIDENTIAL,24000,0,24000,75446,0,99446
142037702300000,NW 311,RESIDENTIAL,24000,0,24000,79332,0,103332
142037702400000,NW 311,RESIDENTIAL,24000,0,24000,53320,0,77320
142037702500000,NW 311,RESIDENTIAL,24000,0,24000,59912,0,83912
142037702600000,NW 311,RESIDENTIAL,24000,0,24000,49334,0,73334
142037702700000,NW 311,RESIDENTIAL,24000,0,24000,75983,0,99983
142037702800000,NW 311,RESIDENTIAL,24240,0,24240,72897,0,97137
142037702900000,NW 311,RESIDENTIAL,24480,0,24480,63420,0,87900
142037703000000,NW 311,RESIDENTIAL,24720,0,24720,51087,0,75807
142037703100000,NW 311,RESIDENTIAL,28600,0,28600,86062,0,114662
142037703200000,NW 311,RESIDENTIAL,24960,0,24960,61714,0,86674
142037703300000,NW 311,RESIDENTIAL,27300,0,27300,77630,0,104930
142037800100000,NW 312,RESIDENTIAL,23538,0,23538,90752,0,114290
142037800300000,NW 312,RESIDENTIAL,22346,0,22346,113082,0,135428
142037800400000,NW 312,RESIDENTIAL,1188,0,1188,0,0,1188
142037900100000,NW 312,RESIDENTIAL,22560,0,22560,89887,0,112447
142037900200000,NW 312,RESIDENTIAL,1200,0,1200,0,0,1200
142037900300000,NW 312,RESIDENTIAL,23760,0,23760,97807,0,121567
142037900400000,NW 312,RESIDENTIAL,23760,0,23760,124976,0,148736
142037900500000,NW 312,RESIDENTIAL,27720,0,27720,83654,0,111374
142037900600000,NW 312,RESIDENTIAL,28000,0,28000,97257,0,125257
142037900700000,NW 312,RESIDENTIAL,27040,0,27040,99382,0,126422
142037900800000,NW 312,RESIDENTIAL,26784,0,26784,85439,0,112223
142037900900000,NW 312,RESIDENTIAL,29392,0,29392,91244,0,120636
142037901000000,NW 312,RESIDENTIAL,29088,0,29088,85223,0,114311
142038000100000,NW 311,RESIDENTIAL,14440,0,14440,96766,0,111206
142038000200000,NW 311,RESIDENTIAL,19600,0,19600,64283,0,83883
142038000300000,NW 311,RESIDENTIAL,18900,0,18900,46746,0,65646
142038000400000,NW 311,RESIDENTIAL,18900,0,18900,69700,0,88600
142038000500000,NW 311,RESIDENTIAL,14000,0,14000,68598,0,82598
142038000600000,NW 311,RESIDENTIAL,19600,0,19600,66772,0,86372
142038000700000,NW 311,RESIDENTIAL,27300,0,27300,74672,0,101972
142038000800000,NW 311,RESIDENTIAL,14000,0,14000,44768,0,58768
142038000900000,NW 311,RESIDENTIAL,19600,0,19600,55145,0,74745
142038001000000,NW 311,RESIDENTIAL,14000,0,14000,44951,0,58951
142038001100000,NW 311,RESIDENTIAL,19798,0,19798,74547,0,94345
142038001200000,NW 311,RESIDENTIAL,15000,0,15000,51726,0,66726
142038001300000,NW 311,RESIDENTIAL,11900,0,11900,60307,0,72207
142038001500000,NW 311,RESIDENTIAL,12861,0,12861,47426,0,60287
142038001600000,NW 311,RESIDENTIAL,19981,0,19981,79793,0,99774
142038001700000,NW 311,RESIDENTIAL,16000,0,16000,58459,0,74459
142038001800000,NW 311,RESIDENTIAL,16000,0,16000,70398,0,86398
142038001900000,NW 311,RESIDENTIAL,16000,0,16000,63646,0,79646
142038002000000,NW 311,RESIDENTIAL,16000,0,16000,68852,0,84852
142038002100000,NW 311,RESIDENTIAL,14000,0,14000,55235,0,69235
142038002200000,NW 311,RESIDENTIAL,16000,0,16000,64672,0,80672
142038002300000,NW 311,RESIDENTIAL,16000,0,16000,53216,0,69216
142038002400000,NW 311,RESIDENTIAL,19200,0,19200,51190,0,70390
142038002500000,NW 311,RESIDENTIAL,18700,0,18700,68512,0,87212
142038002600000,NW 311,RESIDENTIAL,16000,0,16000,64595,0,80595
142038002700000,NW 311,RESIDENTIAL,16000,0,16000,41583,0,57583
142038002800000,NW 311,RESIDENTIAL,16000,0,16000,69321,0,85321
142038002900000,NW 311,RESIDENTIAL,15560,0,15560,70007,0,85567
142038100100000,NW 311,RESIDENTIAL,16440,0,16440,57241,0,73681
142038100200000,NW 311,RESIDENTIAL,16000,0,16000,55071,0,71071
142038100300000,NW 311,RESIDENTIAL,16000,0,16000,62679,0,78679
142038100400000,NW 311,RESIDENTIAL,14000,0,14000,70502,0,84502
142038100500000,NW 311,RESIDENTIAL,16000,0,16000,77429,0,93429
142038100600000,NW 311,RESIDENTIAL,16000,0,16000,64271,0,80271
142038100700000,NW 311,RESIDENTIAL,16000,0,16000,69192,0,85192
142038100800000,NW 311,RESIDENTIAL,16000,0,16000,58249,0,74249
142038100900000,NW 311,RESIDENTIAL,14000,0,14000,54608,0,68608
142038101000000,NW 311,RESIDENTIAL,16000,0,16000,77126,0,93126
142038101100000,NW 311,RESIDENTIAL,16000,0,16000,62169,0,78169
142038101200000,NW 311,RESIDENTIAL,16000,0,16000,75962,0,91962
142038101300000,NW 311,RESIDENTIAL,16000,0,16000,75237,0,91237
142038101400000,NW 311,RESIDENTIAL,16000,0,16000,56325,0,72325
142038101500000,NW 311,RESIDENTIAL,14651,0,14651,60397,0,75048
142038101600000,NW 311,RESIDENTIAL,14781,0,14781,73553,0,88334
142038101700000,NW 311,RESIDENTIAL,17220,0,17220,64178,0,81398
142038101800000,NW 311,RESIDENTIAL,18900,0,18900,77343,0,96243
142038101900000,NW 311,RESIDENTIAL,14317,0,14317,75725,0,90042
142038102000000,NW 311,RESIDENTIAL,14000,0,14000,58973,0,72973
142038102100000,NW 311,RESIDENTIAL,16000,0,16000,54636,0,70636
142038102200000,NW 311,RESIDENTIAL,16000,0,16000,63429,0,79429
142038102300000,NW 311,RESIDENTIAL,16000,0,16000,62961,0,78961
142038102400000,NW 311,RESIDENTIAL,16000,0,16000,69434,0,85434
142038102500000,NW 311,RESIDENTIAL,16000,0,16000,57257,0,73257
142038102600000,NW 311,RESIDENTIAL,16000,0,16000,82807,0,98807
142038102700000,NW 311,RESIDENTIAL,16000,0,16000,62904,0,78904
142038102800000,NW 311,RESIDENTIAL,15560,0,15560,50633,0,66193
142038102900000,NW 311,RESIDENTIAL,17600,0,17600,70867,0,88467
142038103000000,NW 311,RESIDENTIAL,17600,0,17600,59888,0,77488
142038103100000,NW 311,RESIDENTIAL,17600,0,17600,71657,0,89257
142038103200000,NW 311,RESIDENTIAL,17600,0,17600,85604,0,103204
142038103300000,NW 311,RESIDENTIAL,17600,0,17600,73656,0,91256
142038200100000,NW 311,RESIDENTIAL,17600,0,17600,80150,0,97750
142038200200000,NW 311,RESIDENTIAL,17600,0,17600,65314,0,82914
142038200300000,NW 311,RESIDENTIAL,17600,0,17600,74162,0,91762
142038200400000,NW 311,RESIDENTIAL,19200,0,19200,52024,0,71224
142038200500000,NW 311,RESIDENTIAL,16000,0,16000,77475,0,93475
142038200600000,NW 311,RESIDENTIAL,16440,0,16440,74883,0,91323
142038200700000,NW 311,RESIDENTIAL,16000,0,16000,67124,0,83124
142038200800000,NW 311,RESIDENTIAL,16000,0,16000,47363,0,63363
142038200900000,NW 311,RESIDENTIAL,16000,0,16000,52792,0,68792
142038201000000,NW 311,RESIDENTIAL,16000,0,16000,67539,0,83539
142038201100000,NW 311,RESIDENTIAL,16000,0,16000,68521,0,84521
142038201200000,NW 311,RESIDENTIAL,16000,0,16000,67538,0,83538
142038201300000,NW 311,RESIDENTIAL,16000,0,16000,73545,0,89545
142038201400000,NW 311,RESIDENTIAL,18000,0,18000,53809,0,71809
142038201500000,NW 311,RESIDENTIAL,17765,0,17765,72218,0,89983
142038201600000,NW 311,RESIDENTIAL,12180,0,12180,44100,0,56280
142038201700000,NW 311,RESIDENTIAL,12600,0,12600,65513,0,78113
142038201800000,NW 311,RESIDENTIAL,19224,0,19224,76955,0,96179
142038201900000,NW 311,RESIDENTIAL,19550,0,19550,54220,0,73770
142038202000000,NW 311,RESIDENTIAL,16000,0,16000,0,0,16000
142038202100000,NW 311,RESIDENTIAL,16000,0,16000,44871,0,60871
142038202200000,NW 311,RESIDENTIAL,16000,0,16000,65449,0,81449
142038202300000,NW 311,RESIDENTIAL,16000,0,16000,57081,0,73081
142038202400000,NW 311,RESIDENTIAL,16000,0,16000,54174,0,70174
142038202500000,NW 311,RESIDENTIAL,17560,0,17560,86865,0,104425
142038202600000,NW 311,RESIDENTIAL,14000,0,14000,78180,0,92180
142038202700000,NW 311,RESIDENTIAL,17600,0,17600,72983,0,90583
142038202800000,NW 311,RESIDENTIAL,17600,0,17600,0,0,17600
142038202900000,NW 311,RESIDENTIAL,17600,0,17600,71575,0,89175
142038203000000,NW 311,RESIDENTIAL,16000,0,16000,61879,0,77879
142038203100000,NW 311,RESIDENTIAL,19200,0,19200,63260,0,82460
142038300100000,NW 311,RESIDENTIAL,16669,0,16669,58770,0,75439
142038300200000,NW 311,RESIDENTIAL,16450,0,16450,70491,0,86941
142038300300000,NW 311,RESIDENTIAL,14280,0,14280,36767,0,51047
142038300400000,NW 311,RESIDENTIAL,21210,0,21210,55215,0,76425
142038300500000,NW 311,RESIDENTIAL,15283,0,15283,60154,0,75437
142038300600000,NW 311,RESIDENTIAL,15633,0,15633,57665,0,73298
142038300700000,NW 311,RESIDENTIAL,16632,0,16632,65524,0,82156
142038300800000,NW 311,RESIDENTIAL,15957,0,15957,56966,0,72923
142038300900000,CITY PROPERTY,EXEMPT,0,0,0,0,0,0
142038301000000,NW 311,RESIDENTIAL,20503,0,20503,62598,0,83101
142038301100000,NW 311,RESIDENTIAL,18207,0,18207,31596,0,49803
142038301200000,NW 311,RESIDENTIAL,21728,0,21728,61395,0,83123
142038301300000,NW 311,RESIDENTIAL,16000,0,16000,33363,0,49363
142038301400000,NW 311,RESIDENTIAL,20400,0,20400,59594,0,79994
142038301500000,NW 311,RESIDENTIAL,20400,0,20400,52856,0,73256
142038301600000,NW 311,RESIDENTIAL,21326,0,21326,73566,0,94892
142038301700000,NW 311,RESIDENTIAL,21000,0,21000,28708,0,49708
142038301800000,NW 311,RESIDENTIAL,12460,0,12460,51594,0,64054
142038400100000,APARTMENT,COMMERCIAL,0,38347,38347,0,368617,406964
142040100100000,CITY PROPERTY,EXEMPT,0,0,0,0,0,0
142040100200000,CITY PROPERTY,EXEMPT,0,0,0,0,0,0
142040100300000,CITY PROPERTY,EXEMPT,0,0,0,0,0,0
142040100400000,CITY PROPERTY,EXEMPT,0,0,0,0,0,0
142040100500000,NW 317,RESIDENTIAL,9900,0,9900,0,0,9900
142040100600000,CITY PROPERTY,EXEMPT,0,0,0,0,0,0
142040100700000,CITY PROPERTY,EXEMPT,0,0,0,0,0,0
142040100800000,CITY PROPERTY,EXEMPT,0,0,0,0,0,0
142040100900000,CITY PROPERTY,EXEMPT,0,0,0,0,0,0
142040101000000,CITY PROPERTY,EXEMPT,0,0,0,0,0,0
142040200100000,CITY PROPERTY,EXEMPT,0,0,0,0,0,0
142040200200000,CITY PROPERTY,EXEMPT,0,0,0,0,0,0
142040200300000,CITY PROPERTY,EXEMPT,0,0,0,0,0,0
142040200400000,CITY PROPERTY,EXEMPT,0,0,0,0,0,0
142040200500000,CITY PROPERTY,EXEMPT,0,0,0,0,0,0
142040200600000,CITY PROPERTY,EXEMPT,0,0,0,0,0,0
142040200700000,CITY PROPERTY,EXEMPT,0,0,0,0,0,0
142040200800000,CITY PROPERTY,EXEMPT,0,0,0,0,0,0
142040200900000,CITY PROPERTY,EXEMPT,0,0,0,0,0,0
142040201000000,CITY PROPERTY,EXEMPT,0,0,0,0,0,0
142040201100000,CITY PROPERTY,EXEMPT,0,0,0,0,0,0
142040201200000,CITY PROPERTY,EXEMPT,0,0,0,0,0,0
142040201300000,CITY PROPERTY,EXEMPT,0,0,0,0,0,0
142040201400000,CITY PROPERTY,EXEMPT,0,0,0,0,0,0
142040201500000,CITY PROPERTY,EXEMPT,0,0,0,0,0,0
142040201600000,CITY PROPERTY,EXEMPT,0,0,0,0,0,0
142040201700000,CITY PROPERTY,EXEMPT,0,0,0,0,0,0
142040201800000,CITY PROPERTY,EXEMPT,0,0,0,0,0,0
142040201900000,CITY PROPERTY,EXEMPT,0,0,0,0,0,0
142040202000000,CITY PROPERTY,EXEMPT,0,0,0,0,0,0
142040202200000,NW 317,RESIDENTIAL,12870,0,12870,59542,0,72412
142040202300000,CITY PROPERTY,EXEMPT,0,0,0,0,0,0
142040300100000,CITY PROPERTY,EXEMPT,0,0,0,0,0,0
142040300200000,CITY PROPERTY,EXEMPT,0,0,0,0,0,0
142040300300000,CITY PROPERTY,EXEMPT,0,0,0,0,0,0
142040300400000,CITY PROPERTY,EXEMPT,0,0,0,0,0,0
142040300500000,CITY PROPERTY,EXEMPT,0,0,0,0,0,0
142040300600000,CITY PROPERTY,EXEMPT,0,0,0,0,0,0
142040300700000,CITY PROPERTY,EXEMPT,0,0,0,0,0,0
142040300800000,NW 317,RESIDENTIAL,8137,0,8137,41531,0,49668
142040300900000,VACANT LAND,COMMERCIAL,0,2610,2610,0,0,2610
142040301100000,CITY PROPERTY,EXEMPT,0,0,0,0,0,0
142040301200000,CITY PROPERTY,EXEMPT,0,0,0,0,0,0
142040301400000,NW 317,RESIDENTIAL,11250,0,11250,0,0,11250
142040301500000,CITY PROPERTY,EXEMPT,0,0,0,0,0,0
142040301600000,CITY PROPERTY,EXEMPT,0,0,0,0,0,0
142040301700000,NW 317,RESIDENTIAL,11250,0,11250,43971,0,55221
142040301800000,CITY PROPERTY,EXEMPT,0,0,0,0,0,0
142040301900000,CITY PROPERTY,EXEMPT,0,0,0,0,0,0
142040400100000,NW 310,RESIDENTIAL,17325,0,17325,78677,0,96002
142040400200000,CITY PROPERTY,EXEMPT,0,0,0,0,0,0
142040400300000,NW 310,RESIDENTIAL,14553,0,14553,47601,0,62154
142040400400000,NW 310,RESIDENTIAL,9702,0,9702,63934,0,73636
142040400600000,CITY PROPERTY,EXEMPT,0,0,0,0,0,0
142040400700000,CITY PROPERTY,EXEMPT,0,0,0,0,0,0
142040400800000,CITY PROPERTY,EXEMPT,0,0,0,0,0,0
142040400900000,CITY PROPERTY,EXEMPT,0,0,0,0,0,0
142040401000000,CITY PROPERTY,EXEMPT,0,0,0,0,0,0
142040401100000,CITY PROPERTY,EXEMPT,0,0,0,0,0,0
142040401200000,CITY PROPERTY,EXEMPT,0,0,0,0,0,0
142040401300000,CITY PROPERTY,EXEMPT,0,0,0,0,0,0
142040401400000,NW 310,RESIDENTIAL,17325,0,17325,65515,0,82840
142040401500000,NW 310,RESIDENTIAL,17325,0,17325,64960,0,82285
142040401600000,CITY PROPERTY,EXEMPT,0,0,0,0,0,0
142040401700000,CITY PROPERTY,EXEMPT,0,0,0,0,0,0
142040500100000,NW 310,RESIDENTIAL,17325,0,17325,46600,0,63925
142040500300000,NW 310,RESIDENTIAL,16800,0,16800,62873,0,79673
142040500400000,CITY PROPERTY,EXEMPT,0,0,0,0,0,0
142040500500000,NW 310,RESIDENTIAL,14850,0,14850,61563,0,76413
142040500600000,CITY PROPERTY,EXEMPT,0,0,0,0,0,0
142040500700000,CITY PROPERTY,EXEMPT,0,0,0,0,0,0
142040500800000,RESTAURANT,COMMERCIAL,0,43200,43200,0,152239,195439
142040500900000,VACANT LAND,COMMERCIAL,0,3664,3664,0,6336,10000
142040501000000,CITY PROPERTY,EXEMPT,0,0,0,0,0,0
142040501100000,CITY PROPERTY,EXEMPT,0,0,0,0,0,0
142040501200000,NW 310,RESIDENTIAL,17325,0,17325,33230,0,50555
142040501300000,CITY PROPERTY,EXEMPT,0,0,0,0,0,0
142040501400000,NW 310,RESIDENTIAL,17325,0,17325,43548,0,60873
142040501500000,NW 310,RESIDENTIAL,17325,0,17325,45779,0,63104
142040501600000,NW 310,RESIDENTIAL,17325,0,17325,46805,0,64130
142040501700000,CITY PROPERTY,EXEMPT,0,0,0,0,0,0
142040501800000,NW 310,RESIDENTIAL,20,0,20,0,0,20
142040600100000,WAREHOUSE,COMMERCIAL,0,342750,342750,0,1364565,1707315
142040600200000,CITY PROPERTY,EXEMPT,0,0,0,0,0,0
142040600300000,CITY PROPERTY,EXEMPT,0,0,0,0,0,0
142040600400000,CITY PROPERTY,EXEMPT,0,0,0,0,0,0
142040600500000,CITY PROPERTY,EXEMPT,0,0,0,0,0,0
142040600600000,NW 310,RESIDENTIAL,5000,0,5000,0,0,5000
142040600700000,NW 310,RESIDENTIAL,7325,0,7325,0,0,7325
142040600800000,NW 310,RESIDENTIAL,17325,0,17325,47119,0,64444
142040600900000,CITY PROPERTY,EXEMPT,0,0,0,0,0,0
142040601000000,CITY PROPERTY,EXEMPT,0,0,0,0,0,0
142040601100000,CITY PROPERTY,EXEMPT,0,0,0,0,0,0
142040601200000,CITY PROPERTY,EXEMPT,0,0,0,0,0,0
142040601300000,CITY PROPERTY,EXEMPT,0,0,0,0,0,0
142040601400000,CITY PROPERTY,EXEMPT,0,0,0,0,0,0
142040601500000,CITY PROPERTY,EXEMPT,0,0,0,0,0,0
142040601600000,CITY PROPERTY,EXEMPT,0,0,0,0,0,0
142040602400000,CITY PROPERTY,EXEMPT,0,0,0,0,0,0
142040602500000,CITY PROPERTY,EXEMPT,0,0,0,0,0,0
142040602600000,CITY PROPERTY,EXEMPT,0,0,0,0,0,0
142040602700000,CITY PROPERTY,EXEMPT,0,0,0,0,0,0
142040602800000,CITY PROPERTY,EXEMPT,0,0,0,0,0,0
142040602900000,CITY PROPERTY,EXEMPT,0,0,0,0,0,0
142040700100000,CITY PROPERTY,EXEMPT,0,0,0,0,0,0
142040700200000,CITY PROPERTY,EXEMPT,0,0,0,0,0,0
142040700300000,CITY PROPERTY,EXEMPT,0,0,0,0,0,0
142040700400000,CITY PROPERTY,EXEMPT,0,0,0,0,0,0
142040700500000,CITY PROPERTY,EXEMPT,0,0,0,0,0,0
142040700600000,NW 310,RESIDENTIAL,19800,0,19800,66388,0,86188
142040700700000,CITY PROPERTY,EXEMPT,0,0,0,0,0,0
142040700800000,CITY PROPERTY,EXEMPT,0,0,0,0,0,0
142040700900000,CITY PROPERTY,EXEMPT,0,0,0,0,0,0
142040701000000,CITY PROPERTY,EXEMPT,0,0,0,0,0,0
142040701100000,CITY PROPERTY,EXEMPT,0,0,0,0,0,0
142040701200000,NW 310,RESIDENTIAL,4830,0,4830,0,0,4830
142040701300000,CITY PROPERTY,EXEMPT,0,0,0,0,0,0
142040701400000,CITY PROPERTY,EXEMPT,0,0,0,0,0,0
142040701500000,CITY PROPERTY,EXEMPT,0,0,0,0,0,0
142040701600000,CITY PROPERTY,EXEMPT,0,0,0,0,0,0
142040701700000,NW 310,RESIDENTIAL,5000,0,5000,0,0,5000
142040701800000,NW 310,RESIDENTIAL,17325,0,17325,56151,0,73476
142040701900000,CITY PROPERTY,EXEMPT,0,0,0,0,0,0
142040800100000,CITY PROPERTY,EXEMPT,0,0,0,0,0,0
142040800200000,CITY PROPERTY,EXEMPT,0,0,0,0,0,0
142040800300000,CITY PROPERTY,EXEMPT,0,0,0,0,0,0
142040800400000,CITY PROPERTY,EXEMPT,0,0,0,0,0,0
142040800500000,CITY PROPERTY,EXEMPT,0,0,0,0,0,0
142040800600000,CITY PROPERTY,EXEMPT,0,0,0,0,0,0
142040800700000,CITY PROPERTY,EXEMPT,0,0,0,0,0,0
142040800800000,CITY PROPERTY,EXEMPT,0,0,0,0,0,0
142040800900000,CITY PROPERTY,EXEMPT,0,0,0,0,0,0
142040801000000,CITY PROPERTY,EXEMPT,0,0,0,0,0,0
142040801100000,COUNTY PROPERTY,EXEMPT,0,0,0,0,0,0
142040801200000,CITY PROPERTY,EXEMPT,0,0,0,0,0,0
142040801300000,CITY PROPERTY,EXEMPT,0,0,0,0,0,0
142040801400000,NW 317,RESIDENTIAL,10800,0,10800,33725,0,44525
142040801500000,CITY PROPERTY,EXEMPT,0,0,0,0,0,0
142040801600000,CITY PROPERTY,EXEMPT,0,0,0,0,0,0
142040801700000,CITY PROPERTY,EXEMPT,0,0,0,0,0,0
142040901700000,CITY PROPERTY,EXEMPT,0,0,0,0,0,0
142040901800000,CITY PROPERTY,EXEMPT,0,0,0,0,0,0
142040901900000,NW 310,RESIDENTIAL,17325,0,17325,78867,0,96192
142040902000000,NW 310,RESIDENTIAL,17325,0,17325,0,0,17325
142040902100000,NW 310,RESIDENTIAL,12375,0,12375,64858,0,77233
142040902200000,CITY PROPERTY,EXEMPT,0,0,0,0,0,0
142040902300000,NW 310,RESIDENTIAL,12375,0,12375,48195,0,60570
142041000100000,CITY PROPERTY,EXEMPT,0,0,0,0,0,0
142041000200000,NW 310,RESIDENTIAL,13860,0,13860,0,0,13860
142041000300000,CITY PROPERTY,EXEMPT,0,0,0,0,0,0
142041000400000,CITY PROPERTY,EXEMPT,0,0,0,0,0,0
142041000500000,CITY PROPERTY,EXEMPT,0,0,0,0,0,0
142041000600000,CITY PROPERTY,EXEMPT,0,0,0,0,0,0
142041000700000,CITY PROPERTY,EXEMPT,0,0,0,0,0,0
142041000800000,NW 310,RESIDENTIAL,15593,0,15593,73434,0,89027
142041000900000,CITY PROPERTY,EXEMPT,0,0,0,0,0,0
142041001000000,CITY PROPERTY,EXEMPT,0,0,0,0,0,0
142041001100000,NW 310,RESIDENTIAL,5000,0,5000,0,0,5000
142041001200000,CITY PROPERTY,EXEMPT,0,0,0,0,0,0
142041001300000,NW 310,RESIDENTIAL,15593,0,15593,66844,0,82437
142041001400000,CITY PROPERTY,EXEMPT,0,0,0,0,0,0
142041001500000,CITY PROPERTY,EXEMPT,0,0,0,0,0,0
142041100100000,CITY PROPERTY,EXEMPT,0,0,0,0,0,0
142041100200000,CITY PROPERTY,EXEMPT,0,0,0,0,0,0
142041100300000,CITY PROPERTY,EXEMPT,0,0,0,0,0,0
142041100400000,CITY PROPERTY,EXEMPT,0,0,0,0,0,0
142041100500000,CENTRALLY ASSESSED,OTHER,0,0,0,0,0,0
142042600100000,NW 310,RESIDENTIAL,19800,0,19800,85128,0,104928
142042600200000,NW 310,RESIDENTIAL,19800,0,19800,79995,0,99795
142042600300000,CITY PROPERTY,EXEMPT,0,0,0,0,0,0
142042600400000,CITY PROPERTY,EXEMPT,0,0,0,0,0,0
142042600500000,NW 310,RESIDENTIAL,19800,0,19800,28530,0,48330
142042600600000,NW 310,RESIDENTIAL,19800,0,19800,86181,0,105981
142042600700000,NW 310,RESIDENTIAL,2970,0,2970,0,0,2970
142042600800000,SMALL RETAIL,COMMERCIAL,0,41063,41063,0,78497,119560
142042600900000,SHOP,COMMERCIAL,0,17280,17280,0,51042,68322
142042601000000,CONVERSION,COMMERCIAL,0,7776,7776,0,69682,77458
142042601100000,FLAT PARKING,COMMERCIAL,0,10000,10000,0,0,10000
142042601200000,CITY PROPERTY,EXEMPT,0,0,0,0,0,0
142042601300000,NW 310,RESIDENTIAL,19800,0,19800,69374,0,89174
142042601400000,NW 310,RESIDENTIAL,19800,0,19800,74178,0,93978
142042601500000,NW 310,RESIDENTIAL,19800,0,19800,59455,0,79255
142042700100000,NW 310,RESIDENTIAL,19800,0,19800,60698,0,80498
142042700200000,NW 310,RESIDENTIAL,19800,0,19800,36633,0,56433
142042700300000,NW 310,RESIDENTIAL,19800,0,19800,83236,0,103036
142042700400000,NW 310,RESIDENTIAL,19800,0,19800,50042,0,69842
142042700500000,NW 310,RESIDENTIAL,19800,0,19800,0,0,19800
142042700600000,NW 310,RESIDENTIAL,19800,0,19800,87688,0,107488
142042700700000,NW 310,RESIDENTIAL,19800,0,19800,44284,0,64084
142042700800000,NW 310,RESIDENTIAL,19800,0,19800,52483,0,72283
142042700900000,NW 310,RESIDENTIAL,19800,0,19800,47886,0,67686
142042701000000,NW 310,RESIDENTIAL,19800,0,19800,112893,0,132693
142042701100000,NW 310,RESIDENTIAL,9900,0,9900,46876,0,56776
142042701200000,NW 310,RESIDENTIAL,9900,0,9900,51163,0,61063
142042701300000,NW 310,RESIDENTIAL,19800,0,19800,32723,0,52523
142042701400000,NW 310,RESIDENTIAL,19800,0,19800,47067,0,66867
142042701500000,NW 310,RESIDENTIAL,19800,0,19800,50021,0,69821
142042701600000,NW 310,RESIDENTIAL,19800,0,19800,46127,0,65927
142042701700000,NW 310,RESIDENTIAL,19800,0,19800,49254,0,69054
142042800100000,NW 310,RESIDENTIAL,19800,0,19800,44296,0,64096
142042800200000,NW 310,RESIDENTIAL,20790,0,20790,61047,0,81837
142042800300000,NW 310,RESIDENTIAL,15840,0,15840,109014,0,124854
142042800400000,NW 310,RESIDENTIAL,15840,0,15840,47848,0,63688
142042800500000,NW 310,RESIDENTIAL,19800,0,19800,64843,0,84643
142042800600000,NW 310,RESIDENTIAL,19800,0,19800,46424,0,66224
142042800700000,NW 310,RESIDENTIAL,19800,0,19800,53777,0,73577
142042800800000,NW 310,RESIDENTIAL,19800,0,19800,116198,0,135998
142042800900000,NW 310,RESIDENTIAL,19800,0,19800,40927,0,60727
142042801000000,CITY PROPERTY,EXEMPT,0,0,0,0,0,0
142042801100000,NW 310,RESIDENTIAL,19800,0,19800,46680,0,66480
142042801400000,NW 310,RESIDENTIAL,19800,0,19800,89288,0,109088
142042801500000,NW 310,RESIDENTIAL,19800,0,19800,121782,0,141582
142042801600000,NW 310,RESIDENTIAL,19800,0,19800,32039,0,51839
142042801700000,NW 310,RESIDENTIAL,14574,0,14574,48000,0,62574
142042801900000,NW 310,RESIDENTIAL,15138,0,15138,38550,0,53688
142042900100000,NW 310,RESIDENTIAL,19800,0,19800,0,0,19800
142042900200000,NW 310,RESIDENTIAL,20400,0,20400,37719,0,58119
142042900300000,NW 310,RESIDENTIAL,20400,0,20400,81775,0,102175
142042900400000,NW 310,RESIDENTIAL,20400,0,20400,54892,0,75292
142042900500000,NW 310,RESIDENTIAL,20400,0,20400,65657,0,86057
142042900600000,NW 310,RESIDENTIAL,20400,0,20400,51320,0,71720
142042900700000,NW 310,RESIDENTIAL,20400,0,20400,59342,0,79742
142042900800000,NW 310,RESIDENTIAL,20400,0,20400,53648,0,74048
142042900900000,NW 310,RESIDENTIAL,18360,0,18360,0,0,18360
142042901000000,NW 310,RESIDENTIAL,19800,0,19800,75466,0,95266
142042901100000,NW 310,RESIDENTIAL,19800,0,19800,45625,0,65425
142042901200000,NW 310,RESIDENTIAL,19800,0,19800,51674,0,71474
142042901300000,NW 310,RESIDENTIAL,14850,0,14850,55178,0,70028
142042901400000,NW 310,RESIDENTIAL,19800,0,19800,56516,0,76316
142042901500000,NW 310,RESIDENTIAL,19800,0,19800,54946,0,74746
142042901600000,NW 310,RESIDENTIAL,19800,0,19800,78436,0,98236
142043000100000,CITY PROPERTY,EXEMPT,0,0,0,0,0,0
142043000200000,NW 310,RESIDENTIAL,19800,0,19800,43261,0,63061
142043000300000,NW 310,RESIDENTIAL,19800,0,19800,42892,0,62692
142043000400000,CITY PROPERTY,EXEMPT,0,0,0,0,0,0
142043000500000,CITY PROPERTY,EXEMPT,0,0,0,0,0,0
142043000600000,NW 310,RESIDENTIAL,19800,0,19800,68961,0,88761
142043000700000,NW 310,RESIDENTIAL,19800,0,19800,62186,0,81986
142043001100000,CITY PROPERTY,EXEMPT,0,0,0,0,0,0
142043001200000,CITY PROPERTY,EXEMPT,0,0,0,0,0,0
142043001300000,NW 310,RESIDENTIAL,9900,0,9900,34889,0,44789
142043001400000,CITY PROPERTY,EXEMPT,0,0,0,0,0,0
142043001500000,NW 310,RESIDENTIAL,19800,0,19800,27876,0,47676
142043001600000,NW 310,RESIDENTIAL,13464,0,13464,50457,0,63921
142043001700000,NW 310,RESIDENTIAL,13068,0,13068,61748,0,74816
142043001800000,CITY PROPERTY,EXEMPT,0,0,0,0,0,0
142043001900000,CITY PROPERTY,EXEMPT,0,0,0,0,0,0
142043002000000,NW 310,RESIDENTIAL,23760,0,23760,47958,0,71718
142043100100000,NW 310,RESIDENTIAL,19800,0,19800,50559,0,70359
142043100200000,NW 310,RESIDENTIAL,19800,0,19800,67284,0,87084
142043100300000,NW 310,RESIDENTIAL,19800,0,19800,57731,0,77531
142043100400000,NW 310,RESIDENTIAL,19800,0,19800,27820,0,47620
142043100500000,NW 310,RESIDENTIAL,19800,0,19800,79849,0,99649
142043100600000,NW 310,RESIDENTIAL,19800,0,19800,68513,0,88313
142043100700000,NW 310,RESIDENTIAL,19800,0,19800,59683,0,79483
142043100800000,NW 310,RESIDENTIAL,19800,0,19800,4897,0,24697
142043100900000,NW 310,RESIDENTIAL,19800,0,19800,56622,0,76422
142043101000000,NW 310,RESIDENTIAL,19800,0,19800,64539,0,84339
142043101100000,CITY PROPERTY,EXEMPT,0,0,0,0,0,0
142043101200000,CITY PROPERTY,EXEMPT,0,0,0,0,0,0
142043101300000,NW 310,RESIDENTIAL,19800,0,19800,42478,0,62278
142043101400000,NW 310,RESIDENTIAL,19800,0,19800,31878,0,51678
142043101500000,NW 310,RESIDENTIAL,19800,0,19800,60997,0,80797
142043101600000,NW 310,RESIDENTIAL,19800,0,19800,34914,0,54714
142043200100000,NW 310,RESIDENTIAL,19800,0,19800,56626,0,76426
142043200200000,NW 310,RESIDENTIAL,19800,0,19800,87660,0,107460
142043200300000,NW 310,RESIDENTIAL,19800,0,19800,42846,0,62646
142043200400000,NW 310,RESIDENTIAL,19800,0,19800,71132,0,90932
142043200500000,NW 310,RESIDENTIAL,19800,0,19800,119342,0,139142
142043200600000,NW 310,RESIDENTIAL,19800,0,19800,75654,0,95454
142043200700000,NW 310,RESIDENTIAL,19800,0,19800,60432,0,80232
142043200800000,NW 310,RESIDENTIAL,19800,0,19800,55482,0,75282
142043200900000,NW 310,RESIDENTIAL,19800,0,19800,64691,0,84491
142043201000000,NW 310,RESIDENTIAL,7267,0,7267,35915,0,43182
142043201100000,NW 310,RESIDENTIAL,14790,0,14790,93753,0,108543
142043201200000,NW 310,RESIDENTIAL,14850,0,14850,127565,0,142415
142043201300000,NW 310,RESIDENTIAL,19800,0,19800,65996,0,85796
142043201400000,NW 310,RESIDENTIAL,19800,0,19800,61436,0,81236
142043201500000,NW 310,RESIDENTIAL,19800,0,19800,65255,0,85055
142043201600000,NW 310,RESIDENTIAL,14850,0,14850,0,0,14850
142043201700000,NW 310,RESIDENTIAL,19800,0,19800,62847,0,82647
142043300100000,NW 310,RESIDENTIAL,19800,0,19800,54891,0,74691
142043300200000,NW 310,RESIDENTIAL,20400,0,20400,118155,0,138555
142043300300000,NW 310,RESIDENTIAL,20400,0,20400,58928,0,79328
142043300400000,NW 310,RESIDENTIAL,20400,0,20400,117966,0,138366
142043300500000,NW 310,RESIDENTIAL,20400,0,20400,52626,0,73026
142043300600000,NW 310,RESIDENTIAL,20400,0,20400,97176,0,117576
142043300700000,CITY PROPERTY,EXEMPT,0,0,0,0,0,0
142043300800000,NW 310,RESIDENTIAL,16000,0,16000,56595,0,72595
142043300900000,NW 310,RESIDENTIAL,16000,0,16000,65249,0,81249
142043301000000,NW 310,RESIDENTIAL,18473,0,18473,62431,0,80904
142043301100000,NW 310,RESIDENTIAL,5790,0,5790,0,0,5790
142043301200000,NW 310,RESIDENTIAL,22275,0,22275,54510,0,76785
142043301300000,NW 310,RESIDENTIAL,19800,0,19800,59728,0,79528
142043301400000,NW 310,RESIDENTIAL,19800,0,19800,66805,0,86605
142043301500000,NW 310,RESIDENTIAL,19800,0,19800,73213,0,93013
142043301600000,NW 310,RESIDENTIAL,19800,0,19800,27523,0,47323
142043400100000,NW 310,RESIDENTIAL,19800,0,19800,94447,0,114247
142043400200000,CITY PROPERTY,EXEMPT,0,0,0,0,0,0
142043400300000,CITY PROPERTY,EXEMPT,0,0,0,0,0,0
142043400400000,CITY PROPERTY,EXEMPT,0,0,0,0,0,0
142043400500000,NW 310,RESIDENTIAL,19800,0,19800,52455,0,72255
142043400600000,NW 310,RESIDENTIAL,19800,0,19800,63592,0,83392
142043400700000,CITY PROPERTY,EXEMPT,0,0,0,0,0,0
142043400800000,CITY PROPERTY,EXEMPT,0,0,0,0,0,0
142043400900000,CITY PROPERTY,EXEMPT,0,0,0,0,0,0
142043401000000,CITY PROPERTY,EXEMPT,0,0,0,0,0,0
142043401100000,NW 310,RESIDENTIAL,19800,0,19800,51111,0,70911
142043401200000,APARTMENT,COMMERCIAL,0,9600,9600,0,84338,93938
142043401300000,APARTMENT,COMMERCIAL,0,9600,9600,0,85529,95129
142043401400000,CITY PROPERTY,EXEMPT,0,0,0,0,0,0
142043500100000,NW 310,RESIDENTIAL,14850,0,14850,35343,0,50193
142043500200000,NW 310,RESIDENTIAL,17325,0,17325,36922,0,54247
142043500300000,NW 310,RESIDENTIAL,17325,0,17325,50756,0,68081
142043500400000,NW 310,RESIDENTIAL,17325,0,17325,53571,0,70896
142043500500000,NW 310,RESIDENTIAL,17325,0,17325,86986,0,104311
142043500600000,NW 310,RESIDENTIAL,16088,0,16088,122590,0,138678
142043500700000,NW 310,RESIDENTIAL,17325,0,17325,70031,0,87356
142043500800000,NW 310,RESIDENTIAL,13860,0,13860,60636,0,74496
142043500900000,NW 310,RESIDENTIAL,15840,0,15840,74256,0,90096
142043501000000,NW 310,RESIDENTIAL,19800,0,19800,126406,0,146206
142043501100000,NW 310,RESIDENTIAL,19800,0,19800,28843,0,48643
142043501200000,NW 310,RESIDENTIAL,19800,0,19800,109087,0,128887
142043501300000,NW 310,RESIDENTIAL,15840,0,15840,0,0,15840
142043501400000,NW 310,RESIDENTIAL,13860,0,13860,0,0,13860
142043501500000,NW 310,RESIDENTIAL,14850,0,14850,0,0,14850
142043600100000,NW 310,RESIDENTIAL,19800,0,19800,54956,0,74756
142043600200000,NW 310,RESIDENTIAL,19800,0,19800,51246,0,71046
142043600300000,NW 310,RESIDENTIAL,19800,0,19800,107761,0,127561
142043600400000,NW 310,RESIDENTIAL,19800,0,19800,74014,0,93814
142043600500000,NW 310,RESIDENTIAL,19800,0,19800,82882,0,102682
142043600600000,NW 310,RESIDENTIAL,19800,0,19800,91146,0,110946
142043600700000,NW 310,RESIDENTIAL,19800,0,19800,116694,0,136494
142043600800000,NW 310,RESIDENTIAL,11880,0,11880,0,0,11880
142043600900000,NW 310,RESIDENTIAL,13860,0,13860,92745,0,106605
142043601000000,NW 310,RESIDENTIAL,17325,0,17325,69212,0,86537
142043601100000,NW 310,RESIDENTIAL,17325,0,17325,67027,0,84352
142043601200000,NW 310,RESIDENTIAL,17325,0,17325,71742,0,89067
142043601300000,NW 310,RESIDENTIAL,17325,0,17325,70054,0,87379
142043601400000,NW 310,RESIDENTIAL,17325,0,17325,69184,0,86509
142043700100000,NW 310,RESIDENTIAL,19800,0,19800,115542,0,135342
142043700200000,NW 310,RESIDENTIAL,20400,0,20400,46599,0,66999
142043700300000,NW 310,RESIDENTIAL,10400,0,10400,0,0,10400
142043700400000,NW 310,RESIDENTIAL,20400,0,20400,53423,0,73823
142043700500000,NW 310,RESIDENTIAL,20400,0,20400,85957,0,106357
142043700600000,NW 310,RESIDENTIAL,13260,0,13260,0,0,13260
142043700700000,NW 310,RESIDENTIAL,13260,0,13260,62469,0,75729
142043700800000,NW 310,RESIDENTIAL,16320,0,16320,35497,0,51817
142043700900000,NW 310,RESIDENTIAL,15840,0,15840,72500,0,88340
142043701000000,NW 310,RESIDENTIAL,19800,0,19800,69380,0,89180
142043701100000,NW 310,RESIDENTIAL,19800,0,19800,78859,0,98659
142043701200000,NW 310,RESIDENTIAL,19800,0,19800,115540,0,135340
142043701300000,NW 310,RESIDENTIAL,19800,0,19800,45310,0,65110
142043701400000,NW 310,RESIDENTIAL,19800,0,19800,116028,0,135828
142045100100000,NW 311,RESIDENTIAL,13300,0,13300,70180,0,83480
142045100200000,NW 311,RESIDENTIAL,5000,0,5000,0,0,5000
142045100300000,NW 311,RESIDENTIAL,10640,0,10640,58346,0,68986
142045100400000,NW 311,RESIDENTIAL,10944,0,10944,71149,0,82093
142045100500000,NW 311,RESIDENTIAL,14400,0,14400,54882,0,69282
142045100600000,NW 311,RESIDENTIAL,16000,0,16000,75279,0,91279
142045100700000,NW 311,RESIDENTIAL,16000,0,16000,93460,0,109460
142045100800000,NW 311,RESIDENTIAL,24000,0,24000,98155,0,122155
142045100900000,NW 311,RESIDENTIAL,24000,0,24000,87612,0,111612
142045200100000,NW 311,RESIDENTIAL,7403,0,7403,61247,0,68650
142045200200000,NW 311,RESIDENTIAL,13600,0,13600,55014,0,68614
142045200300000,NW 311,RESIDENTIAL,16000,0,16000,62438,0,78438
142045200400000,NW 311,RESIDENTIAL,16000,0,16000,77203,0,93203
142045200500000,NW 311,RESIDENTIAL,9940,0,9940,17992,0,27932
142045200600000,NW 311,RESIDENTIAL,11360,0,11360,50196,0,61556
142045200700000,NW 311,RESIDENTIAL,16000,0,16000,60003,0,76003
142045200800000,NW 311,RESIDENTIAL,16000,0,16000,38781,0,54781
142045200900000,NW 311,RESIDENTIAL,16000,0,16000,39393,0,55393
142045201000000,NW 311,RESIDENTIAL,16000,0,16000,90548,0,106548
142045300100000,NW 311,RESIDENTIAL,16000,0,16000,50196,0,66196
142045300200000,NW 311,RESIDENTIAL,16000,0,16000,74310,0,90310
142045300300000,NW 311,RESIDENTIAL,16000,0,16000,56585,0,72585
142045300400000,NW 311,RESIDENTIAL,16000,0,16000,59976,0,75976
142045300500000,NW 311,RESIDENTIAL,16000,0,16000,53309,0,69309
142045300600000,NW 311,RESIDENTIAL,16000,0,16000,48160,0,64160
142045300700000,NW 311,RESIDENTIAL,16000,0,16000,57994,0,73994
142045300800000,NW 311,RESIDENTIAL,16000,0,16000,65511,0,81511
142045400100000,NW 311,RESIDENTIAL,19754,0,19754,68203,0,87957
142045400200000,NW 311,RESIDENTIAL,16000,0,16000,78655,0,94655
142045400300000,NW 311,RESIDENTIAL,11360,0,11360,41025,0,52385
142045400400000,NW 311,RESIDENTIAL,9660,0,9660,58122,0,67782
142045500100000,NW 311,RESIDENTIAL,15200,0,15200,64720,0,79920
142045500200000,NW 311,RESIDENTIAL,16000,0,16000,58744,0,74744
142045500300000,NW 311,RESIDENTIAL,16000,0,16000,53506,0,69506
142045500400000,CITY PROPERTY,EXEMPT,0,0,0,0,0,0
142045500500000,NW 311,RESIDENTIAL,16000,0,16000,0,0,16000
142045500600000,NW 311,RESIDENTIAL,14400,0,14400,69193,0,83593
142045500700000,NW 311,RESIDENTIAL,14400,0,14400,53368,0,67768
142045500800000,CITY PROPERTY,EXEMPT,0,0,0,0,0,0
142045500900000,NW 311,RESIDENTIAL,10640,0,10640,55909,0,66549
142045501000000,CITY PROPERTY,EXEMPT,0,0,0,0,0,0
142045501100000,NW 311,RESIDENTIAL,11200,0,11200,54476,0,65676
142045501200000,NW 311,RESIDENTIAL,11200,0,11200,67734,0,78934
142045501300000,NW 311,RESIDENTIAL,16000,0,16000,88405,0,104405
142045501400000,NW 311,RESIDENTIAL,16000,0,16000,80713,0,96713
142045501500000,CITY PROPERTY,EXEMPT,0,0,0,0,0,0
142045501600000,CITY PROPERTY,EXEMPT,0,0,0,0,0,0
142045501700000,NW 311,RESIDENTIAL,12000,0,12000,10260,0,22260
142045501800000,NW 311,RESIDENTIAL,19392,0,19392,77146,0,96538
142045501900000,SMALL RETAIL,COMMERCIAL,0,4218,4218,0,21470,25688
142045502000000,CITY PROPERTY,EXEMPT,0,0,0,0,0,0
142045502100000,NW 311,RESIDENTIAL,13680,0,13680,64585,0,78265
142045600100000,NW 311,RESIDENTIAL,11200,0,11200,57388,0,68588
142045600200000,NW 311,RESIDENTIAL,11200,0,11200,58781,0,69981
142045600300000,NW 311,RESIDENTIAL,16000,0,16000,89162,0,105162
142045600400000,NW 311,RESIDENTIAL,16000,0,16000,95981,0,111981
142045600500000,NW 311,RESIDENTIAL,16000,0,16000,36784,0,52784
142045600600000,NW 311,RESIDENTIAL,16000,0,16000,47404,0,63404
142045600700000,NW 311,RESIDENTIAL,16000,0,16000,88405,0,104405
142045600800000,NW 311,RESIDENTIAL,16000,0,16000,71918,0,87918
142045600900000,NW 311,RESIDENTIAL,16000,0,16000,58206,0,74206
142045601000000,NW 311,RESIDENTIAL,16000,0,16000,43796,0,59796
142045601100000,NW 311,RESIDENTIAL,16000,0,16000,73653,0,89653
142045601200000,NW 311,RESIDENTIAL,16000,0,16000,63144,0,79144
142045601300000,NW 311,RESIDENTIAL,16000,0,16000,61877,0,77877
142045601400000,NW 311,RESIDENTIAL,16000,0,16000,76770,0,92770
142045601500000,CITY PROPERTY,EXEMPT,0,0,0,0,0,0
142045601800000,NW 311,RESIDENTIAL,18088,0,18088,0,0,18088
142045700100000,NW 311,RESIDENTIAL,11200,0,11200,48577,0,59777
142045700200000,NW 311,RESIDENTIAL,11200,0,11200,61826,0,73026
142045700300000,NW 311,RESIDENTIAL,16000,0,16000,66035,0,82035
142045700400000,NW 311,RESIDENTIAL,16000,0,16000,66723,0,82723
142045700500000,NW 311,RESIDENTIAL,16000,0,16000,49226,0,65226
142045700600000,NW 311,RESIDENTIAL,16000,0,16000,56535,0,72535
142045700700000,NW 311,RESIDENTIAL,11200,0,11200,47228,0,58428
142045700800000,NW 311,RESIDENTIAL,11200,0,11200,65483,0,76683
142045700900000,NW 311,RESIDENTIAL,10640,0,10640,50798,0,61438
142045701000000,NW 311,RESIDENTIAL,10640,0,10640,55449,0,66089
142045701100000,NW 311,RESIDENTIAL,16000,0,16000,68682,0,84682
142045701200000,NW 311,RESIDENTIAL,16000,0,16000,81328,0,97328
142045701300000,NW 311,RESIDENTIAL,16000,0,16000,105857,0,121857
142045701400000,NW 311,RESIDENTIAL,16000,0,16000,84446,0,100446
142045701500000,CITY PROPERTY,EXEMPT,0,0,0,0,0,0
142045701600000,NW 311,RESIDENTIAL,16000,0,16000,66699,0,82699
142045701700000,NW 311,RESIDENTIAL,22400,0,22400,62200,0,84600
142045701800000,NW 311,RESIDENTIAL,9310,0,9310,48538,0,57848
142045701900000,NW 311,RESIDENTIAL,9310,0,9310,72722,0,82032
142045702000000,NW 311,RESIDENTIAL,9310,0,9310,30722,0,40032
142045702100000,NW 311,RESIDENTIAL,9310,0,9310,67285,0,76595
142045800100000,NW 311,RESIDENTIAL,12040,0,12040,89450,0,101490
142045800200000,NW 311,RESIDENTIAL,11200,0,11200,51333,0,62533
142045800300000,NW 311,RESIDENTIAL,16000,0,16000,102838,0,118838
142045800400000,NW 311,RESIDENTIAL,16000,0,16000,57191,0,73191
142045800500000,NW 311,RESIDENTIAL,16000,0,16000,98264,0,114264
142045800600000,NW 311,RESIDENTIAL,17200,0,17200,76409,0,93609
142045800700000,NW 311,RESIDENTIAL,16000,0,16000,46475,0,62475
142045800800000,NW 311,RESIDENTIAL,16000,0,16000,65990,0,81990
142045800900000,NW 311,RESIDENTIAL,11060,0,11060,53904,0,64964
142045801000000,NW 311,RESIDENTIAL,11060,0,11060,52362,0,63422
142045900100000,NW 311,RESIDENTIAL,17600,0,17600,110987,0,128587
142045900200000,CITY PROPERTY,EXEMPT,0,0,0,0,0,0
142045900300000,NW 311,RESIDENTIAL,20000,0,20000,86170,0,106170
142045900400000,NW 311,RESIDENTIAL,16000,0,16000,60179,0,76179
142045900500000,NW 311,RESIDENTIAL,16000,0,16000,0,0,16000
142045900600000,NW 311,RESIDENTIAL,18000,0,18000,61822,0,79822
142045900700000,NW 311,RESIDENTIAL,14940,0,14940,111153,0,126093
142045900800000,NW 311,RESIDENTIAL,5000,0,5000,0,0,5000
142045900900000,NW 311,RESIDENTIAL,16000,0,16000,75415,0,91415
142045901000000,CITY PROPERTY,EXEMPT,0,0,0,0,0,0
142045901100000,CONVERSION,COMMERCIAL,0,5400,5400,0,0,5400
142045901200000,NW 311,RESIDENTIAL,5000,0,5000,0,0,5000
142045901300000,NW 311,RESIDENTIAL,16000,0,16000,109311,0,125311
142045901400000,CONVERSION,COMMERCIAL,0,6804,6804,0,72756,79560
142045901500000,NW 311,RESIDENTIAL,30000,0,30000,29295,0,59295
142045901600000,NW 311,RESIDENTIAL,9920,0,9920,37263,0,47183
142046000100000,CITY PROPERTY,EXEMPT,0,0,0,0,0,0
142046000200000,NW 311,RESIDENTIAL,5000,0,5000,0,0,5000
142046000300000,NW 311,RESIDENTIAL,16000,0,16000,99878,0,115878
142046000400000,NW 311,RESIDENTIAL,16000,0,16000,74225,0,90225
142046000500000,NW 311,RESIDENTIAL,16000,0,16000,78690,0,94690
142046000600000,CITY PROPERTY,EXEMPT,0,0,0,0,0,0
142046000700000,CITY PROPERTY,EXEMPT,0,0,0,0,0,0
142046000800000,NW 311,RESIDENTIAL,8680,0,8680,68098,0,76778
142046000900000,NW 311,RESIDENTIAL,14400,0,14400,71040,0,85440
142046001000000,NW 311,RESIDENTIAL,11200,0,11200,50053,0,61253
142046001100000,CITY PROPERTY,EXEMPT,0,0,0,0,0,0
142046001200000,NW 311,RESIDENTIAL,24000,0,24000,74726,0,98726
142046001300000,NW 311,RESIDENTIAL,16000,0,16000,93256,0,109256
142046001400000,NW 311,RESIDENTIAL,16000,0,16000,67987,0,83987
142046001500000,NW 311,RESIDENTIAL,16000,0,16000,58528,0,74528
142046001600000,NW 311,RESIDENTIAL,12160,0,12160,74051,0,86211
142046001700000,NW 311,RESIDENTIAL,10800,0,10800,68947,0,79747
142046001800000,NW 311,RESIDENTIAL,17735,0,17735,89253,0,106988
142046001900000,NW 311,RESIDENTIAL,14185,0,14185,80927,0,95112
142046100100000,NW 311,RESIDENTIAL,11200,0,11200,77624,0,88824
142046100200000,NW 311,RESIDENTIAL,11200,0,11200,76848,0,88048
142046100300000,NW 311,RESIDENTIAL,16000,0,16000,73944,0,89944
142046100400000,NW 311,RESIDENTIAL,16000,0,16000,91718,0,107718
142046100500000,NW 311,RESIDENTIAL,16000,0,16000,85622,0,101622
142046100600000,NW 311,RESIDENTIAL,16000,0,16000,71125,0,87125
142046100700000,NW 311,RESIDENTIAL,16000,0,16000,70749,0,86749
142046100800000,NW 311,RESIDENTIAL,16000,0,16000,68193,0,84193
142046100900000,NW 311,RESIDENTIAL,16000,0,16000,77281,0,93281
142046101000000,CITY PROPERTY,EXEMPT,0,0,0,0,0,0
142046101100000,NW 311,RESIDENTIAL,16000,0,16000,122154,0,138154
142046101200000,NW 311,RESIDENTIAL,16000,0,16000,95925,0,111925
142046101300000,NW 311,RESIDENTIAL,5000,0,5000,0,0,5000
142046101400000,NW 311,RESIDENTIAL,16000,0,16000,85300,0,101300
142046101500000,NW 311,RESIDENTIAL,16000,0,16000,74663,0,90663
142046101600000,NW 311,RESIDENTIAL,16000,0,16000,68207,0,84207
142046101700000,NW 311,RESIDENTIAL,10640,0,10640,76351,0,86991
142046101800000,NW 311,RESIDENTIAL,5000,0,5000,0,0,5000
142046200100000,NW 311,RESIDENTIAL,17200,0,17200,60909,0,78109
142046200200000,NW 311,RESIDENTIAL,16000,0,16000,77078,0,93078
142046200300000,NW 311,RESIDENTIAL,16000,0,16000,58796,0,74796
142046200400000,NW 311,RESIDENTIAL,16800,0,16800,73027,0,89827
142046200500000,NW 311,RESIDENTIAL,16000,0,16000,57974,0,73974
142046200600000,NW 311,RESIDENTIAL,16000,0,16000,67309,0,83309
142046200700000,NW 311,RESIDENTIAL,17840,0,17840,73361,0,91201
142046200800000,NW 311,RESIDENTIAL,12040,0,12040,83504,0,95544
142046200900000,NW 311,RESIDENTIAL,11060,0,11060,64062,0,75122
142046300100000,CONVERSION,COMMERCIAL,0,8334,8334,0,56414,64748
142046300200000,NW 311,RESIDENTIAL,16000,0,16000,55667,0,71667
142046300300000,CITY PROPERTY,EXEMPT,0,0,0,0,0,0
142046300400000,NW 311,RESIDENTIAL,16000,0,16000,58968,0,74968
142046300500000,NW 311,RESIDENTIAL,16000,0,16000,81530,0,97530
142046300600000,NW 311,RESIDENTIAL,16000,0,16000,58874,0,74874
142046300700000,NW 311,RESIDENTIAL,11680,0,11680,67885,0,79565
142046300800000,NW 311,RESIDENTIAL,11700,0,11700,68244,0,79944
142046300900000,NW 311,RESIDENTIAL,14000,0,14000,84581,0,98581
142046301000000,NW 311,RESIDENTIAL,14000,0,14000,52035,0,66035
142046301100000,CONVERSION,COMMERCIAL,0,6804,6804,0,52010,58814
142046301200000,CONVERSION,COMMERCIAL,0,6804,6804,0,61285,68089
142046301300000,NW 311,RESIDENTIAL,8750,0,8750,47124,0,55874
142046301400000,NW 311,RESIDENTIAL,8750,0,8750,52124,0,60874
142046301500000,NW 311,RESIDENTIAL,14000,0,14000,67437,0,81437
142046301600000,CITY PROPERTY,EXEMPT,0,0,0,0,0,0
142046301700000,BARS/LOUNGE,COMMERCIAL,0,9445,9445,0,106607,116052
142046301800000,NW 311,RESIDENTIAL,9800,0,9800,66941,0,76741
142046301900000,CITY PROPERTY,EXEMPT,0,0,0,0,0,0
142046302000000,NW 311,RESIDENTIAL,7963,0,7963,37622,0,45585
142046400100000,CITY PROPERTY,EXEMPT,0,0,0,0,0,0
142046400200000,NW 311,RESIDENTIAL,16000,0,16000,89205,0,105205
142046400300000,NW 311,RESIDENTIAL,16000,0,16000,95381,0,111381
142046400400000,NW 311,RESIDENTIAL,16000,0,16000,60469,0,76469
142046400500000,NW 311,RESIDENTIAL,16000,0,16000,69988,0,85988
142046400600000,NW 311,RESIDENTIAL,16000,0,16000,50137,0,66137
142046400700000,NW 311,RESIDENTIAL,16000,0,16000,70472,0,86472
142046400800000,NW 311,RESIDENTIAL,16000,0,16000,81569,0,97569
142046400900000,NW 311,RESIDENTIAL,16000,0,16000,78609,0,94609
142046401000000,NW 311,RESIDENTIAL,16000,0,16000,71134,0,87134
142046401100000,NW 311,RESIDENTIAL,33600,0,33600,86030,0,119630
142046401200000,NW 311,RESIDENTIAL,16000,0,16000,66204,0,82204
142046401300000,NW 311,RESIDENTIAL,16000,0,16000,83965,0,99965
142046401400000,NW 311,RESIDENTIAL,16000,0,16000,81617,0,97617
142046401500000,NW 311,RESIDENTIAL,12600,0,12600,72820,0,85420
142046500100000,NW 311,RESIDENTIAL,24000,0,24000,77220,0,101220
142046500200000,NW 311,RESIDENTIAL,24000,0,24000,85924,0,109924
142046500300000,NW 311,RESIDENTIAL,16000,0,16000,107286,0,123286
142046500400000,NW 311,RESIDENTIAL,16000,0,16000,0,0,16000
142046500500000,CONVERSION,COMMERCIAL,0,4039,4039,0,61751,65790
142046500600000,SMALL RETAIL,COMMERCIAL,0,11200,11200,0,51855,63055
142046500700000,NW 311,RESIDENTIAL,16000,0,16000,54257,0,70257
142046500800000,NW 311,RESIDENTIAL,16000,0,16000,74105,0,90105
142046500900000,NW 311,RESIDENTIAL,16000,0,16000,70776,0,86776
142046501000000,NW 311,RESIDENTIAL,25600,0,25600,84552,0,110152
142046501100000,NW 311,RESIDENTIAL,16000,0,16000,76785,0,92785
142046501200000,NW 311,RESIDENTIAL,16000,0,16000,59543,0,75543
142046501300000,NW 311,RESIDENTIAL,16000,0,16000,61598,0,77598
142046501400000,NW 311,RESIDENTIAL,16000,0,16000,72071,0,88071
142046600100000,NW 311,RESIDENTIAL,17200,0,17200,75416,0,92616
142046600200000,NW 311,RESIDENTIAL,16000,0,16000,101078,0,117078
142046600300000,NW 311,RESIDENTIAL,16000,0,16000,86097,0,102097
142046600400000,NW 311,RESIDENTIAL,16000,0,16000,69120,0,85120
142046600500000,NW 311,RESIDENTIAL,17200,0,17200,77445,0,94645
142046600600000,NW 311,RESIDENTIAL,16000,0,16000,75551,0,91551
142046600700000,NW 311,RESIDENTIAL,16000,0,16000,84591,0,100591
142046600800000,NW 311,RESIDENTIAL,16000,0,16000,62431,0,78431
142047600100000,CITY PROPERTY,EXEMPT,0,0,0,0,0,0
142047600200000,CITY PROPERTY,EXEMPT,0,0,0,0,0,0
142047600300000,CITY PROPERTY,EXEMPT,0,0,0,0,0,0
142047600400000,CITY PROPERTY,EXEMPT,0,0,0,0,0,0
142047600500000,CITY PROPERTY,EXEMPT,0,0,0,0,0,0
142047600600000,NW 317,RESIDENTIAL,6030,0,6030,0,0,6030
142047600700000,CITY PROPERTY,EXEMPT,0,0,0,0,0,0
142047600800000,NW 317,RESIDENTIAL,6030,0,6030,43752,0,49782
142047600900000,CITY PROPERTY,EXEMPT,0,0,0,0,0,0
142047601000000,CITY PROPERTY,EXEMPT,0,0,0,0,0,0
142047601100000,CITY PROPERTY,EXEMPT,0,0,0,0,0,0
142047601200000,CITY PROPERTY,EXEMPT,0,0,0,0,0,0
142047601300000,NW 317,RESIDENTIAL,5000,0,5000,0,0,5000
142047601400000,CITY PROPERTY,EXEMPT,0,0,0,0,0,0
142047700100000,CITY PROPERTY,EXEMPT,0,0,0,0,0,0
142047700200000,NW 317,RESIDENTIAL,8223,0,8223,0,0,8223
142047700300000,CITY PROPERTY,EXEMPT,0,0,0,0,0,0
142047700400000,CITY PROPERTY,EXEMPT,0,0,0,0,0,0
142047800100000,FEED/ADDITIVE;INDUST,INDUSTRIAL,0,278424,278424,0,1625855,1904279
142047900100000,NW 317,RESIDENTIAL,10500,0,10500,42061,0,52561
142047900200000,NW 317,RESIDENTIAL,7455,0,7455,38908,0,46363
142047900300000,CITY PROPERTY,EXEMPT,0,0,0,0,0,0
142047900400000,NW 317,RESIDENTIAL,10500,0,10500,45986,0,56486
142047900500000,CITY PROPERTY,EXEMPT,0,0,0,0,0,0
142047900600000,NW 317,RESIDENTIAL,7455,0,7455,54942,0,62397
142047900700000,CITY PROPERTY,EXEMPT,0,0,0,0,0,0
142047900800000,CITY PROPERTY,EXEMPT,0,0,0,0,0,0
142047901100000,CITY PROPERTY,EXEMPT,0,0,0,0,0,0
142047901200000,NW 317,RESIDENTIAL,11542,0,11542,44384,0,55926
142047901300000,NW 317,RESIDENTIAL,7455,0,7455,48105,0,55560
142047901400000,CITY PROPERTY,EXEMPT,0,0,0,0,0,0
142048000100000,CITY PROPERTY,EXEMPT,0,0,0,0,0,0
142048000200000,CITY PROPERTY,EXEMPT,0,0,0,0,0,0
142048000300000,CITY PROPERTY,EXEMPT,0,0,0,0,0,0
142048000400000,CITY PROPERTY,EXEMPT,0,0,0,0,0,0
142048000500000,NW 317,RESIDENTIAL,5000,0,5000,0,0,5000
142048000600000,CITY PROPERTY,EXEMPT,0,0,0,0,0,0
142048000700000,NW 317,RESIDENTIAL,5000,0,5000,0,0,5000
142048000800000,CITY PROPERTY,EXEMPT,0,0,0,0,0,0
142048000900000,NW 317,RESIDENTIAL,5000,0,5000,0,0,5000
142048001100000,CITY PROPERTY,EXEMPT,0,0,0,0,0,0
142048001200000,CITY PROPERTY,EXEMPT,0,0,0,0,0,0
142048001300000,CITY PROPERTY,EXEMPT,0,0,0,0,0,0
142048001400000,CITY PROPERTY,EXEMPT,0,0,0,0,0,0
142048001500000,CITY PROPERTY,EXEMPT,0,0,0,0,0,0
142048001600000,CITY PROPERTY,EXEMPT,0,0,0,0,0,0
142048001700000,CITY PROPERTY,EXEMPT,0,0,0,0,0,0
142048001800000,CITY PROPERTY,EXEMPT,0,0,0,0,0,0
142048100100000,FLAT PARKING,COMMERCIAL,0,7219,7219,0,7330,14549
142048100200000,SHOP,INDUSTRIAL,0,72657,72657,0,178278,250935
142048100300000,CITY PROPERTY,EXEMPT,0,0,0,0,0,0
142048100400000,NW 317,RESIDENTIAL,6014,0,6014,25559,0,31573
142048100500000,CITY PROPERTY,EXEMPT,0,0,0,0,0,0
142048100600000,CITY PROPERTY,EXEMPT,0,0,0,0,0,0
142048100700000,CONVERSION,COMMERCIAL,0,5880,5880,0,47603,53483
142048100800000,NW 317,RESIDENTIAL,9000,0,9000,40943,0,49943
142048100900000,NW 317,RESIDENTIAL,9000,0,9000,42979,0,51979
142048101000000,CITY PROPERTY,EXEMPT,0,0,0,0,0,0
142048101100000,CITY PROPERTY,EXEMPT,0,0,0,0,0,0
142048101200000,CITY PROPERTY,EXEMPT,0,0,0,0,0,0
142048101300000,CITY PROPERTY,EXEMPT,0,0,0,0,0,0
142048101400000,CITY PROPERTY,EXEMPT,0,0,0,0,0,0
142048101500000,CITY PROPERTY,EXEMPT,0,0,0,0,0,0
142048101600000,NW 317,RESIDENTIAL,6,0,6,0,0,6
142048200100000,CITY PROPERTY,EXEMPT,0,0,0,0,0,0
142048200200000,NW 317,RESIDENTIAL,5000,0,5000,0,0,5000
142048200300000,NW 317,RESIDENTIAL,10500,0,10500,61545,0,72045
142048200400000,NW 317,RESIDENTIAL,10500,0,10500,0,0,10500
142048200500000,NW 317,RESIDENTIAL,10500,0,10500,0,0,10500
142048200600000,CITY PROPERTY,EXEMPT,0,0,0,0,0,0
142048200700000,NW 317,RESIDENTIAL,11400,0,11400,58129,0,69529
142048200800000,NW 317,RESIDENTIAL,10260,0,10260,51186,0,61446
142048200900000,CITY PROPERTY,EXEMPT,0,0,0,0,0,0
142048201000000,CITY PROPERTY,EXEMPT,0,0,0,0,0,0
142048201100000,NW 317,RESIDENTIAL,5670,0,5670,43836,0,49506
142048201200000,NW 317,RESIDENTIAL,2976,0,2976,0,0,2976
142048201300000,NW 317,RESIDENTIAL,5000,0,5000,0,0,5000
142048201400000,NW 317,RESIDENTIAL,5000,0,5000,0,0,5000
142048201500000,NW 317,RESIDENTIAL,9000,0,9000,0,0,9000
142048201600000,CITY PROPERTY,EXEMPT,0,0,0,0,0,0
142048201700000,NW 317,RESIDENTIAL,9000,0,9000,84020,0,93020
142048201800000,NW 317,RESIDENTIAL,9000,0,9000,49831,0,58831
142048201900000,NW 317,RESIDENTIAL,9000,0,9000,40988,0,49988
142048300100000,CITY PROPERTY,EXEMPT,0,0,0,0,0,0
142048300200000,CITY PROPERTY,EXEMPT,0,0,0,0,0,0
142048300300000,CITY PROPERTY,EXEMPT,0,0,0,0,0,0
142048300400000,CITY PROPERTY,EXEMPT,0,0,0,0,0,0
142048300500000,CONVERSION,COMMERCIAL,0,4536,4536,0,25910,30446
142048300600000,CITY PROPERTY,EXEMPT,0,0,0,0,0,0
142048300700000,CITY PROPERTY,EXEMPT,0,0,0,0,0,0
142048300800000,CITY PROPERTY,EXEMPT,0,0,0,0,0,0
142048300900000,CITY PROPERTY,EXEMPT,0,0,0,0,0,0
142048301000000,CITY PROPERTY,EXEMPT,0,0,0,0,0,0
142048301100000,CITY PROPERTY,EXEMPT,0,0,0,0,0,0
142048301200000,CITY PROPERTY,EXEMPT,0,0,0,0,0,0
142048400100000,CITY PROPERTY,EXEMPT,0,0,0,0,0,0
142048400200000,CITY PROPERTY,EXEMPT,0,0,0,0,0,0
142048400300000,NW 317,EXEMPT,0,9000,9000,0,46023,55023
142048400400000,NW 317,RESIDENTIAL,9000,0,9000,33234,0,42234
142048400500000,CITY PROPERTY,EXEMPT,0,0,0,0,0,0
142048400600000,NW 317,RESIDENTIAL,8550,0,8550,55135,0,63685
142048400700000,CITY PROPERTY,EXEMPT,0,0,0,0,0,0
142048400800000,CITY PROPERTY,EXEMPT,0,0,0,0,0,0
142048400900000,CITY PROPERTY,EXEMPT,0,0,0,0,0,0
142048401000000,CITY PROPERTY,EXEMPT,0,0,0,0,0,0
142048401100000,FEED/ADDITIVE;INDUST,INDUSTRIAL,0,21514,21514,0,9960,31474
142048401200000,CITY PROPERTY,EXEMPT,0,0,0,0,0,0
142048401300000,CITY PROPERTY,EXEMPT,0,0,0,0,0,0
142048401400000,CITY PROPERTY,EXEMPT,0,0,0,0,0,0
142048401500000,CITY PROPERTY,EXEMPT,0,0,0,0,0,0
142048401800000,FLAT PARKING,COMMERCIAL,0,33600,33600,0,4862,38462
142048401900000,NW 317,RESIDENTIAL,9000,0,9000,0,0,9000
142048402000000,BARS/LOUNGE,COMMERCIAL,0,40320,40320,0,203682,244002
142048402100000,NW 317,RESIDENTIAL,8190,0,8190,46471,0,54661
142048402200000,NW 317,RESIDENTIAL,19200,0,19200,97936,0,117136
142048500300000,SCHOOL,EXEMPT,0,0,0,0,0,0
142048500400000,CONVENIENCE STORE,COMMERCIAL,0,90720,90720,0,217297,308017
142048500500000,OFFICE,COMMERCIAL,0,67200,67200,0,123552,190752
142048500600000,CITY PROPERTY,EXEMPT,0,0,0,0,0,0
142048500700000,CITY PROPERTY,EXEMPT,0,0,0,0,0,0
142048500800000,WAREHOUSE,COMMERCIAL,0,89679,89679,0,113243,202922
142048600200000,CITY PROPERTY,EXEMPT,0,0,0,0,0,0
142048600300000,CITY PROPERTY,EXEMPT,0,0,0,0,0,0
142048600400000,CITY PROPERTY,EXEMPT,0,0,0,0,0,0
142048600500000,CITY PROPERTY,EXEMPT,0,0,0,0,0,0
142048600600000,CITY PROPERTY,EXEMPT,0,0,0,0,0,0
142048600700000,CITY PROPERTY,EXEMPT,0,0,0,0,0,0
142048600800000,CITY PROPERTY,EXEMPT,0,0,0,0,0,0
142048600900000,CITY PROPERTY,EXEMPT,0,0,0,0,0,0
142048601000000,CITY PROPERTY,EXEMPT,0,0,0,0,0,0
142048601100000,CITY PROPERTY,EXEMPT,0,0,0,0,0,0
142048601200000,CITY PROPERTY,EXEMPT,0,0,0,0,0,0
142048601300000,NW 317,RESIDENTIAL,5000,0,5000,0,0,5000
142048601400000,NW 317,RESIDENTIAL,4282,0,4282,59051,0,63333
142048601500000,CITY PROPERTY,EXEMPT,0,0,0,0,0,0
142048601600000,CITY PROPERTY,EXEMPT,0,0,0,0,0,0
142048601700000,CITY PROPERTY,EXEMPT,0,0,0,0,0,0
142048601800000,CITY PROPERTY,EXEMPT,0,0,0,0,0,0
142048601900000,CITY PROPERTY,EXEMPT,0,0,0,0,0,0
142048602300000,BARS/LOUNGE,COMMERCIAL,0,40320,40320,0,143055,183375
142048700100000,CONVERSION,COMMERCIAL,0,4180,4180,0,73302,77482
142048700200000,NW 317,RESIDENTIAL,9000,0,9000,69344,0,78344
142048700300000,NW 317,RESIDENTIAL,9000,0,9000,71649,0,80649
142048700400000,CITY PROPERTY,EXEMPT,0,0,0,0,0,0
142048700500000,NW 317,RESIDENTIAL,9000,0,9000,67091,0,76091
142048700600000,CITY PROPERTY,EXEMPT,0,0,0,0,0,0
142048700700000,NW 317,RESIDENTIAL,9000,0,9000,80614,0,89614
142048700800000,NW 317,RESIDENTIAL,6300,0,6300,54930,0,61230
142048700900000,NW 317,RESIDENTIAL,4725,0,4725,48417,0,53142
142048701000000,NW 317,RESIDENTIAL,4725,0,4725,47055,0,51780
142048701100000,NW 317,RESIDENTIAL,6480,0,6480,38100,0,44580
142048701200000,CITY PROPERTY,EXEMPT,0,0,0,0,0,0
142048701300000,CITY PROPERTY,EXEMPT,0,0,0,0,0,0
142048701400000,NW 317,RESIDENTIAL,5563,0,5563,43382,0,48945
142048701500000,CITY PROPERTY,EXEMPT,0,0,0,0,0,0
142048701600000,NW 317,RESIDENTIAL,4324,0,4324,40798,0,45122
142048701700000,CITY PROPERTY,EXEMPT,0,0,0,0,0,0
142048701800000,CITY PROPERTY,EXEMPT,0,0,0,0,0,0
142048701900000,CITY PROPERTY,EXEMPT,0,0,0,0,0,0
142048702000000,CITY PROPERTY,EXEMPT,0,0,0,0,0,0
142048800100000,WAREHOUSE,COMMERCIAL,0,17326,17326,0,30536,47862
142048800200000,EQUIPMENT MFG;INDUST,INDUSTRIAL,0,36315,36315,0,11063,47378
142048800300000,NW 317,RESIDENTIAL,5182,0,5182,14448,0,19630
142048800400000,NW 317,RESIDENTIAL,5000,0,5000,0,0,5000
142048800500000,CONVENIENCE STORE,COMMERCIAL,0,43005,43005,0,184180,227185
142048900300000,FLAT PARKING,COMMERCIAL,0,25200,25200,0,0,25200
142048900400000,FLAT PARKING,COMMERCIAL,0,25200,25200,0,0,25200
142048900500000,FLAT PARKING,COMMERCIAL,0,25200,25200,0,1312,26512
142048900600000,BARS/LOUNGE,COMMERCIAL,0,60480,60480,0,171563,232043
142048900700000,EQUIPMENT MFG;INDUST,INDUSTRIAL,0,123660,123660,0,344524,468184
142048900800000,WAREHOUSE,COMMERCIAL,0,61668,61668,0,118365,180033
142110100100000,VACANT LAND,EXEMPT,0,10996,10996,0,0,10996
142110100200000,NE 156,RESIDENTIAL,16932,0,16932,39314,0,56246
142110100300000,SHOP,COMMERCIAL,0,16200,16200,0,75971,92171
142110100400000,WAREHOUSE,COMMERCIAL,0,143000,143000,0,325668,468668
142110100500000,SHOP,COMMERCIAL,0,48539,48539,0,92007,140546
142110200100000,SMALL RETAIL,COMMERCIAL,0,36751,36751,0,133784,170535
142110200200000,WAREHOUSE,COMMERCIAL,0,53397,53397,0,151869,205266
142110200300000,SMALL RETAIL,COMMERCIAL,0,41088,41088,0,127300,168388
142110200400000,SHOP,COMMERCIAL,0,36072,36072,0,72776,108848
142110200500000,SHOP,COMMERCIAL,0,28860,28860,0,113437,142297
142110300100000,SHOP,COMMERCIAL,0,33600,33600,0,144001,177601
142110300200000,WAREHOUSE,COMMERCIAL,0,25200,25200,0,114991,140191
142110300300000,FLAT PARKING,COMMERCIAL,0,12600,12600,0,1166,13766
142110300400000,FLAT PARKING,COMMERCIAL,0,12600,12600,0,2580,15180
142110300500000,SHOP,COMMERCIAL,0,25200,25200,0,160073,185273
142110300600000,OFFICE,EXEMPT,0,161482,161482,0,319160,480642
142110300602000,BILLBOARD(BLL),COMMERCIAL,0,0,0,0,44004,44004
142110400100000,VACANT LAND,COMMERCIAL,0,40749,40749,0,0,40749
142110400102000,BILLBOARD(BLL),COMMERCIAL,0,0,0,0,10292,10292
142110400200000,FLAT PARKING,COMMERCIAL,0,33600,33600,0,4800,38400
142110400300000,WAREHOUSE,COMMERCIAL,0,29400,29400,0,46165,75565
142110500100000,EDUCATIONAL/COLLEGE,EXEMPT,0,18144,18144,0,1120,19264
142110500200000,NE 156,EXEMPT,0,10000,10000,0,59837,69837
142110500300000,NE 156,RESIDENTIAL,11000,0,11000,2070,0,13070
142110500400000,NE 156,RESIDENTIAL,16000,0,16000,41349,0,57349
142110500500000,NE 156,RESIDENTIAL,5400,0,5400,3733,0,9133
142110500600000,NE 156,RESIDENTIAL,8640,0,8640,0,0,8640
142110500700000,NE 156,RESIDENTIAL,8640,0,8640,0,0,8640
142110500800000,NE 156,EXEMPT,0,10000,10000,0,52303,62303
142110500900000,NE 156,RESIDENTIAL,16000,0,16000,40027,0,56027
142110501000000,APARTMENT,EXEMPT,0,18144,18144,0,234532,252676
142110501100000,AUTO REPAIR/SALES,COMMERCIAL,0,57360,57360,0,62285,119645
142110501200000,OFFICE,EXEMPT,0,5326,5326,0,33660,38986
142110501300000,APARTMENT,EXEMPT,0,266112,266112,0,248755,514867
142110600100000,VACANT LAND,COMMERCIAL,0,15000,15000,0,0,15000
142110600200000,VACANT LAND,COMMERCIAL,0,28290,28290,0,0,28290
142110600300000,BARS/LOUNGE,COMMERCIAL,0,40800,40800,0,109174,149974
142110600400000,SMALL RETAIL,COMMERCIAL,0,16320,16320,0,78442,94762
142110600500000,SMALL RETAIL,COMMERCIAL,0,16320,16320,0,44897,61217
142110600600000,AUTO REPAIR/SALES,COMMERCIAL,0,47736,47736,0,82788,130524
142110600700000,CENTRALLY ASSESSED,OTHER,0,0,0,0,0,0
142110700100000,NBHD SHOPPING CENTER,COMMERCIAL,0,264000,264000,0,261690,525690
142110700200000,CENTRALLY ASSESSED,OTHER,0,0,0,0,0,0
142110700300000,CENTRALLY ASSESSED,OTHER,0,0,0,0,0,0
142110700400000,CENTRALLY ASSESSED,OTHER,0,0,0,0,0,0
142110700500000,CENTRALLY ASSESSED,OTHER,0,0,0,0,0,0
142110700600000,EDUCATIONAL/COLLEGE,EXEMPT,0,34353,34353,0,0,34353
142110700602000,BILLBOARD(BLL),COMMERCIAL,0,0,0,0,10292,10292
142110800100000,SCHOOL,EXEMPT,0,444960,444960,0,4119228,4564188
142112600100000,WAREHOUSE,COMMERCIAL,0,14400,14400,0,12573,26973
142112600200000,CENTRALLY ASSESSED,OTHER,0,0,0,0,0,0
142112600300000,CENTRALLY ASSESSED,OTHER,0,0,0,0,0,0
142112600400000,CENTRALLY ASSESSED,OTHER,0,0,0,0,0,0
142112700100000,CENTRALLY ASSESSED,OTHER,0,0,0,0,0,0
142112700200000,CENTRALLY ASSESSED,OTHER,0,0,0,0,0,0
142112700300000,CENTRALLY ASSESSED,OTHER,0,0,0,0,0,0
142112800100000,CENTRALLY ASSESSED,OTHER,0,0,0,0,0,0
142115100100000,CENTRALLY ASSESSED,OTHER,0,0,0,0,0,0
142115200100000,CENTRALLY ASSESSED,OTHER,0,0,0,0,0,0
142115200300000,FOOD GRADE;INDUST,INDUSTRIAL,0,11599,11599,0,500620,512219
142115200400000,VACANT LAND,INDUSTRIAL,0,5000,5000,0,0,5000
142115200700000,EQUIPMENT MFG;INDUST,INDUSTRIAL,0,1000,1000,0,0,1000
142115200800000,EQUIPMENT MFG;INDUST,INDUSTRIAL,0,11500,11500,0,0,11500
142115200900000,CENTRALLY ASSESSED,OTHER,0,0,0,0,0,0
142115300100000,CENTRALLY ASSESSED,OTHER,0,0,0,0,0,0
142117600100000,SCHOOL,EXEMPT,0,2202000,2202000,0,22693333,24895333
142117700100000,HOSPITAL,EXEMPT,0,969840,969840,0,19495423,20465263
142117700102000,BILLBOARD(BLL),COMMERCIAL,0,0,0,0,44118,44118
142117700200000,CITY PROPERTY,EXEMPT,0,0,0,0,0,0
142117800100000,HOSPITAL,COMMERCIAL,0,1083240,1083240,0,84707690,85790930
142120100100000,CENTRALLY ASSESSED,OTHER,0,0,0,0,0,0
142120100200000,VACANT LAND,AG LAND,4057,0,4057,0,0,4057
142122600100000,CENTRALLY ASSESSED,OTHER,0,0,0,0,0,0
142125100100000,CITY PROPERTY,EXEMPT,0,0,0,0,0,0
142125100200000,NW 310,RESIDENTIAL,14850,0,14850,35403,0,50253
142125100300000,CITY PROPERTY,EXEMPT,0,0,0,0,0,0
142125100400000,CITY PROPERTY,EXEMPT,0,0,0,0,0,0
142125100500000,CITY PROPERTY,EXEMPT,0,0,0,0,0,0
142125100600000,CITY PROPERTY,EXEMPT,0,0,0,0,0,0
142125100700000,CITY PROPERTY,EXEMPT,0,0,0,0,0,0
142125100800000,CITY PROPERTY,EXEMPT,0,0,0,0,0,0
142125100900000,CITY PROPERTY,EXEMPT,0,0,0,0,0,0
142125101000000,CITY PROPERTY,EXEMPT,0,0,0,0,0,0
142125101100000,CITY PROPERTY,EXEMPT,0,0,0,0,0,0
142125200100000,CITY PROPERTY,EXEMPT,0,0,0,0,0,0
142125200200000,CITY PROPERTY,EXEMPT,0,0,0,0,0,0
142125200300000,CITY PROPERTY,EXEMPT,0,0,0,0,0,0
142125200400000,CITY PROPERTY,EXEMPT,0,0,0,0,0,0
142125200500000,CITY PROPERTY,EXEMPT,0,0,0,0,0,0
142125200600000,CITY PROPERTY,EXEMPT,0,0,0,0,0,0
142125200700000,CITY PROPERTY,EXEMPT,0,0,0,0,0,0
142125200800000,NW 310,RESIDENTIAL,11210,0,11210,0,0,11210
142125200900000,CITY PROPERTY,EXEMPT,0,0,0,0,0,0
142125201000000,CITY PROPERTY,EXEMPT,0,0,0,0,0,0
142125201100000,CITY PROPERTY,EXEMPT,0,0,0,0,0,0
142125201200000,CITY PROPERTY,EXEMPT,0,0,0,0,0,0
142125201300000,CITY PROPERTY,EXEMPT,0,0,0,0,0,0
142125201400000,CITY PROPERTY,EXEMPT,0,0,0,0,0,0
142125201500000,CITY PROPERTY,EXEMPT,0,0,0,0,0,0
142125201600000,CITY PROPERTY,EXEMPT,0,0,0,0,0,0
142125201700000,CITY PROPERTY,EXEMPT,0,0,0,0,0,0
142125201800000,CITY PROPERTY,EXEMPT,0,0,0,0,0,0
142127600100000,VACANT LAND,AG LAND,11502,0,11502,0,0,11502
142127600200000,VACANT LAND,AG LAND,2127,0,2127,0,0,2127
142127600300000,WAREHOUSE,COMMERCIAL,0,265090,265090,0,984030,1249120
142127600400000,VACANT LAND,COMMERCIAL,0,4380,4380,0,0,4380
142130100100000,CENTRALLY ASSESSED,OTHER,0,0,0,0,0,0
142130100200000,VACANT LAND,INDUSTRIAL,0,4711,4711,0,0,4711
142130100300000,CENTRALLY ASSESSED,OTHER,0,0,0,0,0,0
142130100400000,CENTRALLY ASSESSED,OTHER,0,0,0,0,0,0
142130100500000,CENTRALLY ASSESSED,OTHER,0,0,0,0,0,0
142130100600000,CENTRALLY ASSESSED,OTHER,0,0,0,0,0,0
142130200100000,FOOD GRADE;INDUST,INDUSTRIAL,0,26038,26038,0,45725,71763
142130200200000,CENTRALLY ASSESSED,OTHER,0,0,0,0,0,0
142130400100000,CENTRALLY ASSESSED,OTHER,0,0,0,0,0,0
142130400200000,CENTRALLY ASSESSED,OTHER,0,0,0,0,0,0
142130400300000,CENTRALLY ASSESSED,OTHER,0,0,0,0,0,0
142130400400000,FOOD GRADE;INDUST,INDUSTRIAL,0,10157,10157,0,306222,316379
142130500100000,CENTRALLY ASSESSED,OTHER,0,0,0,0,0,0
142130500200000,CENTRALLY ASSESSED,OTHER,0,0,0,0,0,0
142130600100000,FOOD GRADE;INDUST,INDUSTRIAL,0,716353,716353,0,7715072,8431425
142132600100000,SHOP,COMMERCIAL,0,72600,72600,0,242028,314628
142132600200000,WAREHOUSE,COMMERCIAL,0,18365,18365,0,18428,36793
142132600300000,WAREHOUSE,COMMERCIAL,0,28125,28125,0,32558,60683
142132600400000,CITY PROPERTY,EXEMPT,0,0,0,0,0,0
142132600500000,CITY PROPERTY,EXEMPT,0,0,0,0,0,0
142132600600000,CITY PROPERTY,EXEMPT,0,0,0,0,0,0
142132600700000,CITY PROPERTY,EXEMPT,0,0,0,0,0,0
142132600800000,CITY PROPERTY,EXEMPT,0,0,0,0,0,0
142132600900000,CITY PROPERTY,EXEMPT,0,0,0,0,0,0
142132601000000,CITY PROPERTY,EXEMPT,0,0,0,0,0,0
142132601100000,CITY PROPERTY,EXEMPT,0,0,0,0,0,0
142132601200000,CITY PROPERTY,EXEMPT,0,0,0,0,0,0
142132601300000,WAREHOUSE,COMMERCIAL,0,21178,21178,0,132999,154177
142132700100000,CITY PROPERTY,EXEMPT,0,0,0,0,0,0
142135100100000,CITY PROPERTY,EXEMPT,0,0,0,0,0,0
142135200100000,CITY PROPERTY,EXEMPT,0,0,0,0,0,0
142135200200000,CITY PROPERTY,EXEMPT,0,0,0,0,0,0
142135200300000,CITY PROPERTY,EXEMPT,0,0,0,0,0,0
142135200400000,CITY PROPERTY,EXEMPT,0,0,0,0,0,0
142135300100000,HOTEL,COMMERCIAL,0,147187,147187,0,1865186,2012373
142135400100000,CITY PROPERTY,EXEMPT,0,0,0,0,0,0
142135500100000,CITY PROPERTY,EXEMPT,0,0,0,0,0,0
142135500200000,VACANT LAND,COMMERCIAL,0,20,20,0,0,20
142135600100000,CITY PROPERTY,EXEMPT,0,0,0,0,0,0
142135600200000,CITY PROPERTY,EXEMPT,0,0,0,0,0,0
142137600200000,FOOD GRADE;INDUST,INDUSTRIAL,0,4158,4158,0,5475,9633
142137600300000,FOOD GRADE;INDUST,INDUSTRIAL,0,4374,4374,0,23191,27565
142137600500000,FOOD GRADE;INDUST,INDUSTRIAL,0,24565,24565,0,1170437,1195002
142137700500000,STATE PROPERTY,EXEMPT,0,0,0,0,0,0
142137700600000,HOTEL,EXEMPT,0,0,0,0,0,0
142137700602000,HOTEL,COMMERCIAL,0,0,0,0,11187309,11187309
142137800401000,SMALL RET; CTRL CR,COMMERCIAL,0,44800,44800,0,1478137,1522937
142137800401001,SECTION 42,COMMERCIAL,0,403200,403200,0,1288779,1691979
142137900100000,BRNCH BK/CR; CTRL CR,COMMERCIAL,0,672000,672000,0,3071330,3743330
142137900200000,FLAT PARKING,COMMERCIAL,0,72500,72500,0,5040,77540
142137900300000,FLAT PARKING,COMMERCIAL,0,37395,37395,0,5500,42895
142137900501000,OFFICE; CTRL CR,COMMERCIAL,0,8000,8000,0,63678,71678
142137900501001,OFFICE; CTRL CR,COMMERCIAL,0,8000,8000,0,156543,164543
142137900501002,OFFICE; CTRL CR,COMMERCIAL,0,8008,8008,0,14896,22904
142137900501003,OFFICE; CTRL CR,COMMERCIAL,0,8000,8000,0,97756,105756
142137900501004,OFFICE; CTRL CR,COMMERCIAL,0,8640,8640,0,242109,250749
142137900501005,OFFICE; CTRL CR,COMMERCIAL,0,8000,8000,0,195399,203399
142138000100000,CITY PROPERTY,EXEMPT,0,0,0,0,0,0
142138100100000,FLAT PARKING,COMMERCIAL,0,476000,476000,0,22782,498782
142138100200000,SMALL RET; CTRL CR,COMMERCIAL,0,113400,113400,0,64805,178205
142138100300000,SMALL RET; CTRL CR,COMMERCIAL,0,63000,63000,0,64228,127228
142138100400000,RESTAURANT; CTRL CR,COMMERCIAL,0,98000,98000,0,249254,347254
142138100500000,OFFICE; CTRL CR,COMMERCIAL,0,44000,44000,0,103744,147744
142138100600000,OFFICE; CTRL CR,COMMERCIAL,0,120000,120000,0,643266,763266
142138100700000,RESTAURANT; CTRL CR,COMMERCIAL,0,31000,31000,0,82630,113630
142138100800000,RESTAURANT; CTRL CR,COMMERCIAL,0,31000,31000,0,85129,116129
142138100900000,OFFICE; CTRL CR,COMMERCIAL,0,80000,80000,0,382833,462833
142138101000000,OFFICE; CTRL CR,COMMERCIAL,0,120000,120000,0,724415,844415
142138101100000,OFFICE; CTRL CR,COMMERCIAL,0,96000,96000,0,543902,639902
142138101200000,OFFICE; CTRL CR,COMMERCIAL,0,112000,112000,0,772455,884455
142138101300000,BRNCH BK/CR; CTRL CR,COMMERCIAL,0,123200,123200,0,792801,916001
142138101400000,MISCELLANEOUS,COMMERCIAL,0,0,0,0,20,20
142138200100000,OFFICE; CTRL CR,COMMERCIAL,0,462297,462297,0,4271334,4733631
142138200200000,OFFICE; CTRL CR,COMMERCIAL,0,350000,350000,0,1302083,1652083
142138200300000,OFFICE; CTRL CR,COMMERCIAL,0,70000,70000,0,337024,407024
142138200400000,OFFICE; CTRL CR,COMMERCIAL,0,252000,252000,0,968673,1220673
142138200402000,BILLBOARD(BLL),COMMERCIAL,0,0,0,0,9736,9736
142138200500000,OFFICE; CTRL CR,COMMERCIAL,0,282800,282800,0,1171745,1454545
142140100100000,RESTAURANT,COMMERCIAL,0,84000,84000,0,151869,235869
142140100200000,OFFICE,COMMERCIAL,0,84000,84000,0,413505,497505
142140100300000,FLAT PARKING,COMMERCIAL,0,84000,84000,0,9467,93467
142140100500000,FLAT PARKING,COMMERCIAL,0,33600,33600,0,0,33600
142140300100000,PARKING STRUCTURE,COMMERCIAL,0,272160,272160,0,2837841,3110001
142140400200000,OFFICE; MEDICAL,COMMERCIAL,0,450000,450000,0,5374793,5824793
142140400700000,OFFICE; MED; CTRL CR,COMMERCIAL,0,1150000,1150000,0,14447107,15597107
142140500100000,OFFICE; CTRL CR,COMMERCIAL,0,33600,33600,0,212831,246431
142140500200000,FLAT PARKING,COMMERCIAL,0,32760,32760,0,2160,34920
142140500300000,FLAT PARKING,COMMERCIAL,0,21840,21840,0,0,21840
142140500600000,LAUNDROMAT/CLEANERS,COMMERCIAL,0,116480,116480,0,173361,289841
142140500602000,BILLBOARD(BLL),COMMERCIAL,0,0,0,0,12529,12529
142140500700000,FLAT PARKING,EXEMPT,0,297756,297756,0,34520,332276
142140500800000,FLAT PARKING,EXEMPT,0,25760,25760,0,2576,28336
142140500900000,OFFICE; CTRL CR,COMMERCIAL,0,168000,168000,0,404347,572347
142140501000000,OFFICE,EXEMPT,0,78926,78926,0,576145,655071
142140501100000,FLAT PARKING,EXEMPT,0,78926,78926,0,6496,85422
142140501200000,FLAT PARKING,EXEMPT,0,78926,78926,0,6496,85422
142140501300000,OFFICE,EXEMPT,0,78926,78926,0,1079836,1158762
142140501400000,BARS/LOUNGE; CTRL CR,COMMERCIAL,0,97440,97440,0,90696,188136
142140501500000,LAUNDROMAT/CLEANERS,COMMERCIAL,0,97440,97440,0,119414,216854
142140501600000,FLAT PARKING,COMMERCIAL,0,97440,97440,0,8620,106060
142140501700000,FLAT PARKING,COMMERCIAL,0,97440,97440,0,5600,103040
142140501800000,OFFICE; CTRL CR,COMMERCIAL,0,56160,56160,0,136188,192348
142140501900000,FLAT PARKING,COMMERCIAL,0,31920,31920,0,2128,34048
142140502000000,CITY PROPERTY,EXEMPT,0,0,0,0,0,0
142140502100000,OFFICE; MED; CTRL CR,COMMERCIAL,0,297500,297500,0,12260014,12557514
142140600200000,CHURCH,EXEMPT,0,362880,362880,0,3439442,3802322
142140700300000,APARTMENT; CNTRL CR,COMMERCIAL,0,48480,48480,0,512309,560789
142140700400000,FRATERNAL,EXEMPT,0,473785,473785,0,2914803,3388588
142140700900000,FUNERAL HOME,COMMERCIAL,0,271452,271452,0,317304,588756
142140701000000,SMALL RET; CTRL CR,COMMERCIAL,0,31054,31054,0,257143,288197
142140701100000,FLAT PARKING,COMMERCIAL,0,76774,76774,0,4880,81654
142140701200000,PARKING STRUCTURE,COMMERCIAL,0,666500,666500,0,4921566,5588066
142140701300000,FLAT PARKING,COMMERCIAL,0,185220,185220,0,56081,241301
142140800900000,CITY PROPERTY,EXEMPT,0,0,0,0,0,0
142140801000000,CITY PROPERTY,EXEMPT,0,0,0,0,0,0
142140900200000,AUTO REP/SAL;CTRL CR,COMMERCIAL,0,216000,216000,0,294820,510820
142140900600000,PRINTING,INDUSTRIAL,0,61396,61396,0,202002,263398
142140900900000,SMALL RET; CTRL CR,COMMERCIAL,0,64665,64665,0,56263,120928
142140901000000,FLAT PARKING,COMMERCIAL,0,18250,18250,0,2555,20805
142140901100000,RESTAURANT; CTRL CR,COMMERCIAL,0,11775,11775,0,115546,127321
142140901200000,SMALL RET; CTRL CR,COMMERCIAL,0,156648,156648,0,177593,334241
142140901300000,CONVERSION,COMMERCIAL,0,13316,13316,0,122339,135655
142140901400000,PRINTING,INDUSTRIAL,0,31298,31298,0,43030,74328
142140901500000,CONVERSION,COMMERCIAL,0,14580,14580,0,60097,74677
142140901600000,VACANT LAND,EXEMPT,0,13500,13500,0,0,13500
142140901800000,SMALL RET; CTRL CR,COMMERCIAL,0,70525,70525,0,115875,186400
142140901802000,BILLBOARD(BLL),COMMERCIAL,0,0,0,0,17017,17017
142140901900000,FLAT PARKING,COMMERCIAL,0,1015000,1015000,0,188555,1203555
142141000100000,CHURCH,EXEMPT,0,169344,169344,0,1312911,1482255
142141000200000,CONVERSION,COMMERCIAL,0,17010,17010,0,142534,159544
142142600100000,CENTRALLY ASSESSED,OTHER,0,0,0,0,0,0
142142700100000,SHOP,COMMERCIAL,0,122762,122762,0,359905,482667
142142700200000,WAREHOUSE,COMMERCIAL,0,142500,142500,0,234285,376785
142142700300000,FOOD GRADE;INDUST,INDUSTRIAL,0,40662,40662,0,203713,244375
142142800200000,FOOD GRADE;INDUST,INDUSTRIAL,0,378265,378265,0,2919068,3297333
142142800300000,EQUIPMENT MFG;INDUST,INDUSTRIAL,0,39150,39150,0,0,39150
142142800400000,VACANT LAND,INDUSTRIAL,0,11000,11000,0,0,11000
142142900100000,OFFICE; MED; CTRL CR,COMMERCIAL,0,420000,420000,0,1113319,1533319
142142900200000,BRNCH BK/CR; CTRL CR,COMMERCIAL,0,490205,490205,0,2509795,3000000
142143000100000,BARS/LOUNGE,COMMERCIAL,0,156492,156492,0,173671,330163
142143000200000,FLAT PARKING,COMMERCIAL,0,182980,182980,0,13600,196580
142143100100000,FAST FOOD,COMMERCIAL,0,302400,302400,0,468886,771286
142143100200000,WAREHOUSE,EXEMPT,0,108864,108864,0,570258,679122
142143100300000,FLAT PARKING,COMMERCIAL,0,67200,67200,0,6400,73600
142143100400000,FLAT PARKING,COMMERCIAL,0,67200,67200,0,6400,73600
142143100500000,FLAT PARKING,COMMERCIAL,0,67200,67200,0,6400,73600
142143100600000,FLAT PARKING,COMMERCIAL,0,126000,126000,0,10302,136302
142143100700000,FLAT PARKING,COMMERCIAL,0,75600,75600,0,4800,80400
142143200200000,VACANT LAND,EXEMPT,0,5513,5513,0,0,5513
142143200300000,FRATERNAL,EXEMPT,0,264638,264638,0,2155957,2420595
142143300100000,CHURCH,EXEMPT,0,121176,121176,0,582807,703983
142143300200000,FLAT PARKING,EXEMPT,0,33048,33048,0,0,33048
142143400100000,FLAT PARKING,COMMERCIAL,0,200731,200731,0,22642,223373
142143500100000,SMALL RET; CTRL CR,COMMERCIAL,0,134006,134006,0,208520,342526
142145100100000,LG DISCOUNT/RETAIL,COMMERCIAL,0,97631,97631,0,230124,327755
142145100300000,WAREHOUSE,EXEMPT,0,369623,369623,0,637741,1007364
142145100400000,WAREHOUSE; CTRL CR,COMMERCIAL,0,76204,76204,0,95136,171340
142145100500000,SE 238,RESIDENTIAL,68880,0,68880,113204,0,182084
142145100600000,WAREHOUSE; CTRL CR,COMMERCIAL,0,68880,68880,0,80680,149560
142145100700000,BARS/LOUNGE; CTRL CR,COMMERCIAL,0,59640,59640,0,109431,169071
142145100800000,FLAT PARKING,COMMERCIAL,0,81824,81824,0,4773,86597
142145200201000,OFFICE; CTRL CR,COMMERCIAL,0,140640,140640,0,1372978,1513618
142145200201001,BRNCH BK/CR; CTRL CR,COMMERCIAL,0,154080,154080,0,1875597,2029677
142145200201002,OFFICE; CTRL CR,COMMERCIAL,0,140640,140640,0,1358932,1499572
142145200201003,OFFICE; CTRL CR,COMMERCIAL,0,140640,140640,0,1422773,1563413
142145200300000,CHURCH,EXEMPT,0,117936,117936,0,104266,222202
142145300100000,WAREHOUSE; CTRL CR,COMMERCIAL,0,100800,100800,0,318949,419749
142145300200000,OFFICE,EXEMPT,0,95256,95256,0,613863,709119
142145400100000,OFFICE; CTRL CR,COMMERCIAL,0,134400,134400,0,607869,742269
142145400200000,PARKING STRUCTURE,COMMERCIAL,0,504000,504000,0,1090149,1594149
142145400300000,OFFICE,OTHER,0,0,0,0,0,0
142145500100000,OFFICE; CTRL CR,COMMERCIAL,0,142200,142200,0,348202,490402
142145500200000,CITY PROPERTY,EXEMPT,0,0,0,0,0,0
142145500300000,CITY PROPERTY,EXEMPT,0,0,0,0,0,0
142145600200000,PARKING STRUCTURE,COMMERCIAL,0,134400,134400,0,75800,210200
142145600300000,OFFICE; CTRL CR,COMMERCIAL,0,168000,168000,0,943000,1111000
142145600500000,PARKING STRUCTURE,COMMERCIAL,0,201600,201600,0,85600,287200
142145600700000,FLAT PARKING,COMMERCIAL,0,36000,36000,0,4800,40800
142145600800000,OFFICE; CTRL CR,COMMERCIAL,0,504000,504000,0,1833973,2337973
142145700100000,OFFICE; CTRL CR,COMMERCIAL,0,100800,100800,0,1328794,1429594
142145700200000,AUTO REP/SAL;CTRL CR,COMMERCIAL,0,154560,154560,0,156727,311287
142145700300000,OFFICE; CTRL CR,COMMERCIAL,0,80640,80640,0,549369,630009
142145700400000,OFFICE; CTRL CR,COMMERCIAL,0,168000,168000,0,1308863,1476863
142145700500000,FLAT PARKING,COMMERCIAL,0,100800,100800,0,6720,107520
142145700600000,FLAT PARKING,COMMERCIAL,0,100800,100800,0,8230,109030
142145700700000,AUTO REP/SAL;CTRL CR,COMMERCIAL,0,252000,252000,0,415893,667893
142145700800000,SMALL RET; CTRL CR,COMMERCIAL,0,50400,50400,0,151943,202343
142145800100000,CHURCH,EXEMPT,0,42336,42336,0,3680,46016
142145800200000,CHURCH,EXEMPT,0,148176,148176,0,2521842,2670018
142145900100000,CITY PROPERTY,EXEMPT,0,0,0,0,0,0
142145900200000,BARS/LOUNGE; CTRL CR,COMMERCIAL,0,100800,100800,0,299825,400625
142145900300000,FLAT PARKING,COMMERCIAL,0,50400,50400,0,3360,53760
142145900400000,SMALL RET; CTRL CR,COMMERCIAL,0,50400,50400,0,165165,215565
142145900500000,CITY PROPERTY,EXEMPT,0,0,0,0,0,0
142145900600000,FLAT PARKING,COMMERCIAL,0,100800,100800,0,8160,108960
142145900700000,CITY PROPERTY,EXEMPT,0,72576,72576,0,0,72576
142146000100000,CITY PROPERTY,EXEMPT,0,0,0,0,0,0
142146000200000,CITY PROPERTY,EXEMPT,0,0,0,0,0,0
142146000300000,CITY PROPERTY,EXEMPT,0,0,0,0,0,0
142146000400000,THEATER,EXEMPT,0,237248,237248,0,684485,921733
142146000500000,OFFICE; CTRL CR,EXEMPT,0,124854,124854,0,305963,430817
142146000600000,PARKING STRUCTURE,COMMERCIAL,0,199920,199920,0,1842639,2042559
142146000700000,BRNCH BK/CR; CTRL CR,COMMERCIAL,0,84000,84000,0,0,84000
142146000800000,BRNCH BK/CR; CTRL CR,COMMERCIAL,0,47250,47250,0,0,47250
142146000900000,BRNCH BK/CR; CTRL CR,COMMERCIAL,0,47250,47250,0,0,47250
142146001000000,BRNCH BK/CR; CTRL CR,COMMERCIAL,0,52500,52500,0,0,52500
142146001100000,BARS/LOUNGE; CTRL CR,COMMERCIAL,0,42000,42000,0,132930,174930
142146001200000,CITY PROPERTY,EXEMPT,0,0,0,0,0,0
142146001300000,CITY PROPERTY,EXEMPT,0,0,0,0,0,0
142146001400000,CITY PROPERTY,EXEMPT,0,0,0,0,0,0
142146001500000,CITY PROPERTY,EXEMPT,0,0,0,0,0,0
142146100100000,CITY PROPERTY,EXEMPT,0,0,0,0,0,0
142146200300000,OFFICE; CTRL CR,COMMERCIAL,0,77400,77400,0,165344,242744
142146200500000,BARS/LOUNGE; CTRL CR,COMMERCIAL,0,88200,88200,0,236924,325124
142146200600000,OFFICE; CTRL CR,COMMERCIAL,0,448000,448000,0,1231604,1679604
142146200700000,OFFICE; CTRL CR,COMMERCIAL,0,378000,378000,0,983486,1361486
142146200800000,WAREHOUSE; CTRL CR,COMMERCIAL,0,126000,126000,0,28908,154908
142146201000000,FLAT PARKING,COMMERCIAL,0,397267,397267,0,97056,494323
142146300100000,BRNCH BK/CR; CTRL CR,COMMERCIAL,0,294588,294588,0,4581229,4875817
142146300200000,BRNCH BK/CR; CTRL CR,COMMERCIAL,0,170212,170212,0,1930117,2100329
142146400100000,OFFICE; CTRL CR,COMMERCIAL,0,108000,108000,0,858554,966554
142146400200000,SMALL RET; CTRL CR,COMMERCIAL,0,72000,72000,0,369421,441421
142146400300000,OFFICE; CTRL CR,COMMERCIAL,0,46348,46348,0,142359,188707
142146400400000,OFFICE; CTRL CR,COMMERCIAL,0,174669,174669,0,605844,780513
142146400500000,SMALL RET; CTRL CR,COMMERCIAL,0,126016,126016,0,706643,832659
142146400600000,FLAT PARKING,COMMERCIAL,0,4800,4800,0,288,5088
142146400800000,SMALL RET; CTRL CR,COMMERCIAL,0,56000,56000,0,217719,273719
142146400900000,OFFICE; CTRL CR,COMMERCIAL,0,420000,420000,0,945150,1365150
142146401001000,SMALL RET; CTRL CR,COMMERCIAL,0,40257,40257,0,161972,202229
142146401001001,OFFICE; CTRL CR,COMMERCIAL,0,37275,37275,0,205732,243007
142146401001002,OFFICE; CTRL CR,COMMERCIAL,0,37275,37275,0,207723,244998
142146401001003,OFFICE; CTRL CR,COMMERCIAL,0,37275,37275,0,82510,119785
142147600100000,OFFICE,EXEMPT,0,184464,184464,0,324669,509133
142147600200000,OFFICE; MED; CTRL CR,COMMERCIAL,0,330000,330000,0,459067,789067
142147600400000,RESTAURANT; CTRL CR,COMMERCIAL,0,100800,100800,0,108094,208894
142147600600000,SMALL RET; CTRL CR,COMMERCIAL,0,184800,184800,0,310470,495270
142147600700000,OFFICE; MED; CTRL CR,COMMERCIAL,0,455000,455000,0,1122873,1577873
142147700100000,SHOP,COMMERCIAL,0,51072,51072,0,31319,82391
142147700200000,FLAT PARKING,COMMERCIAL,0,25200,25200,0,1470,26670
142147800100000,SMALL RET; CTRL CR,COMMERCIAL,0,100800,100800,0,505144,605944
142147800200000,WAREHOUSE; CTRL CR,COMMERCIAL,0,23000,23000,0,74723,97723
142147800300000,AUTO REP/SAL;CTRL CR,COMMERCIAL,0,98820,98820,0,44006,142826
142147800302000,BILLBOARD(BLL),COMMERCIAL,0,0,0,0,18661,18661
142147800400000,FLAT PARKING,COMMERCIAL,0,74340,74340,0,4336,78676
142147800500000,BARS/LOUNGE; CTRL CR,COMMERCIAL,0,74340,74340,0,48764,123104
142147800600000,SMALL RET; CTRL CR,COMMERCIAL,0,100800,100800,0,309560,410360
142147800700000,FLAT PARKING,COMMERCIAL,0,100800,100800,0,5880,106680
142147800800000,FLAT PARKING,COMMERCIAL,0,100800,100800,0,5880,106680
142147800900000,FLAT PARKING,COMMERCIAL,0,100800,100800,0,5880,106680
142147801000000,SMALL RET; CTRL CR,COMMERCIAL,0,100800,100800,0,220474,321274
142147801100000,SMALL RET; CTRL CR,COMMERCIAL,0,100800,100800,0,193964,294764
142147900100000,VACANT LAND,EXEMPT,0,13500,13500,0,65964,79464
142147900200000,FLAT PARKING,EXEMPT,0,248832,248832,0,77304,326136
142147900300000,SE 238,RESIDENTIAL,15300,0,15300,44689,0,59989
142147900400000,FLAT PARKING,EXEMPT,0,38880,38880,0,0,38880
142148000100000,CONVERSION,COMMERCIAL,0,6440,6440,0,52364,58804
142148000200000,CONVERSION,COMMERCIAL,0,10530,10530,0,64170,74700
142148000300000,CONVERSION,COMMERCIAL,0,5832,5832,0,97295,103127
142148000400000,FLAT PARKING,COMMERCIAL,0,57600,57600,0,3360,60960
142148000500000,SMALL RETAIL,EXEMPT,0,90720,90720,0,259603,350323
142148000600000,SMALL RET; CTRL CR,COMMERCIAL,0,16876,16876,0,51857,68733
142148000700000,SMALL RET; CTRL CR,COMMERCIAL,0,16758,16758,0,51857,68615
142148000800000,SMALL RET; CTRL CR,COMMERCIAL,0,16766,16766,0,51857,68623
142148000900000,SMALL RET; CTRL CR,COMMERCIAL,0,16846,16846,0,51857,68703
142148001000000,SMALL RET; CTRL CR,COMMERCIAL,0,16855,16855,0,51857,68712
142148001100000,SMALL RET; CTRL CR,COMMERCIAL,0,16846,16846,0,51857,68703
142148001200000,SMALL RET; CTRL CR,COMMERCIAL,0,33936,33936,0,56756,90692
142148001300000,FLAT PARKING,COMMERCIAL,0,101018,101018,0,5810,106828
142148001400000,FLAT PARKING,EXEMPT,0,88906,88906,0,20580,109486
142148001500000,CONVERSION,RESIDENTIAL,12020,0,12020,190395,0,202415
142148001600000,SE 238,RESIDENTIAL,8578,0,8578,24831,0,33409
142148100300000,SMALL RET; CTRL CR,COMMERCIAL,0,21000,21000,0,142347,163347
142148100400000,FLAT PARKING,COMMERCIAL,0,50400,50400,0,0,50400
142148100500000,FLAT PARKING,COMMERCIAL,0,151200,151200,0,7200,158400
142148100700000,OFFICE; CTRL CR,COMMERCIAL,0,504000,504000,0,3068703,3572703
142148200100000,OFFICE; MED; CTRL CR,COMMERCIAL,0,217800,217800,0,731368,949168
142148300100000,OFFICE; MED; CTRL CR,COMMERCIAL,0,145152,145152,0,402009,547161
142148301000000,FLAT PARKING,EXEMPT,0,189000,189000,0,35155,224155
142148301100000,FLAT PARKING,EXEMPT,0,67372,67372,0,6720,74092
142148400200000,CENTRALLY ASSESSED,OTHER,0,0,0,0,0,0
142148400300000,CENTRALLY ASSESSED,OTHER,0,0,0,0,0,0
142148400400000,CENTRALLY ASSESSED,OTHER,0,0,0,0,0,0
142148400500000,CENTRALLY ASSESSED,OTHER,0,0,0,0,0,0
142148400600000,SE 238,RESIDENTIAL,4425,0,4425,27783,0,32208
142148400700000,SE 238,RESIDENTIAL,4425,0,4425,27637,0,32062
142148400800000,FLAT PARKING,COMMERCIAL,0,35200,35200,0,3200,38400
142148400900000,CENTRALLY ASSESSED,OTHER,0,0,0,0,0,0
142148401000000,CONVERSIONS; NON-APT,COMMERCIAL,0,67200,67200,0,45734,112934
142148401200000,OFFICE; CTRL CR,COMMERCIAL,0,134400,134400,0,126127,260527
142148500100000,OFFICE; MED; CTRL CR,COMMERCIAL,0,995250,995250,0,9069750,10065000
142148500200000,APARTMENT; CNTRL CR,COMMERCIAL,0,25160,25160,0,507976,533136
142148600200000,VACANT LAND,EXEMPT,0,4500,4500,0,0,4500
142148600700000,WAREHOUSE,EXEMPT,0,27216,27216,0,0,27216
142148600800000,FLAT PARKING,EXEMPT,0,113540,113540,0,14550,128090
142148600900000,CHURCH,EXEMPT,0,10368,10368,0,43039,53407
142148601100000,FLAT PARKING,COMMERCIAL,0,117631,117631,0,0,117631
142148601300000,OFFICE; MED; CTRL CR,COMMERCIAL,0,270000,270000,0,2097331,2367331
142148700100000,SMALL RET; CTRL CR,COMMERCIAL,0,37800,37800,0,86329,124129
142148700200000,FLAT PARKING,EXEMPT,0,49248,49248,0,9200,58448
142148700300000,OFFICE,EXEMPT,0,181440,181440,0,550797,732237
142148700400000,VACANT LAND,EXEMPT,0,36288,36288,0,0,36288
142148700500000,CONVERSION,EXEMPT,0,18144,18144,0,88333,106477
142148700600000,WAREHOUSE; CTRL CR,COMMERCIAL,0,88200,88200,0,128063,216263
142148800100000,OFFICE,EXEMPT,0,68040,68040,0,927666,995706
142148800200000,FLAT PARKING,EXEMPT,0,63504,63504,0,5760,69264
142148800300000,FLAT PARKING,EXEMPT,0,63504,63504,0,5760,69264
142148800400000,OFFICE,EXEMPT,0,136080,136080,0,1302784,1438864
142148800500000,FLAT PARKING,EXEMPT,0,22680,22680,0,4332,27012
142148900100000,FLAT PARKING,COMMERCIAL,0,80360,80360,0,17024,97384
142148900300000,BARS/LOUNGE; CTRL CR,COMMERCIAL,0,58800,58800,0,95544,154344
142148900400000,FLAT PARKING,COMMERCIAL,0,78400,78400,0,11220,89620
142148900500000,SMALL RET; CTRL CR,COMMERCIAL,0,39200,39200,0,30837,70037
142148900600000,FLAT PARKING,COMMERCIAL,0,29400,29400,0,3444,32844
142148900700000,SHOP,COMMERCIAL,0,29400,29400,0,53649,83049
142148900800000,BRNCH BK/CR; CTRL CR,COMMERCIAL,0,58800,58800,0,202818,261618
142148900900000,VACANT LAND,COMMERCIAL,0,21000,21000,0,0,21000
142148901000000,SHOP,COMMERCIAL,0,88200,88200,0,49586,137786
142148901300000,VACANT LAND,COMMERCIAL,0,37240,37240,0,0,37240
142210100100000,SE 248,RESIDENTIAL,74900,0,74900,230785,0,305685
142210100200000,SE 248,RESIDENTIAL,59851,0,59851,156699,0,216550
142210100300000,SE 248,RESIDENTIAL,75600,0,75600,248780,0,324380
142210100400000,SE 248,RESIDENTIAL,147550,0,147550,223181,0,370731
142210100500000,SE 248,RESIDENTIAL,84750,0,84750,283854,0,368604
142210100600000,SE 248,RESIDENTIAL,82500,0,82500,214837,0,297337
142210100700000,SE 248,RESIDENTIAL,73600,0,73600,189709,0,263309
142210100800000,SE 248,RESIDENTIAL,39375,0,39375,212798,0,252173
142210100900000,SE 248,RESIDENTIAL,92085,0,92085,159568,0,251653
142210200100000,SE 248,RESIDENTIAL,51849,0,51849,244985,0,296834
142210200200000,SE 248,RESIDENTIAL,56875,0,56875,351467,0,408342
142210200300000,SE 248,RESIDENTIAL,81774,0,81774,615224,0,696998
142210200400000,SE 248,RESIDENTIAL,77700,0,77700,338147,0,415847
142210200500000,SE 248,RESIDENTIAL,46620,0,46620,261929,0,308549
142210200600000,SE 248,RESIDENTIAL,41625,0,41625,282742,0,324367
142210200700000,SE 248,RESIDENTIAL,43214,0,43214,232148,0,275362
142210200800000,SE 248,RESIDENTIAL,57607,0,57607,392378,0,449985
142210200900000,SE 248,RESIDENTIAL,53158,0,53158,168240,0,221398
142210201000000,SE 248,RESIDENTIAL,54833,0,54833,176934,0,231767
142210201100000,SE 248,RESIDENTIAL,50880,0,50880,310195,0,361075
142210201200000,SE 248,RESIDENTIAL,36400,0,36400,274873,0,311273
142210201300000,SE 248,RESIDENTIAL,42568,0,42568,138251,0,180819
142210201400000,SE 248,RESIDENTIAL,46577,0,46577,192933,0,239510
142210201500000,SE 248,RESIDENTIAL,30907,0,30907,142749,0,173656
142210201600000,SE 248,RESIDENTIAL,64750,0,64750,402880,0,467630
142210201700000,SE 248,RESIDENTIAL,54617,0,54617,120301,0,174918
142210201800000,SE 248,RESIDENTIAL,44070,0,44070,187884,0,231954
142210201900000,SE 248,RESIDENTIAL,68930,0,68930,331898,0,400828
142210202000000,SE 248,RESIDENTIAL,55040,0,55040,349238,0,404278
142210300100000,SE 248,RESIDENTIAL,59400,0,59400,277294,0,336694
142210300200000,SE 248,RESIDENTIAL,33750,0,33750,215201,0,248951
142210300300000,SE 248,RESIDENTIAL,33750,0,33750,220746,0,254496
142210300400000,SE 248,RESIDENTIAL,64375,0,64375,318928,0,383303
142210300500000,SE 248,RESIDENTIAL,76000,0,76000,298220,0,374220
142210400100000,SE 248,EXEMPT,0,141450,141450,0,476788,618238
142210400200000,SE 248,RESIDENTIAL,52400,0,52400,310861,0,363261
142210400300000,SE 248,RESIDENTIAL,52380,0,52380,176417,0,228797
142210400400000,SE 248,RESIDENTIAL,21560,0,21560,135057,0,156617
142210400500000,SE 248,RESIDENTIAL,39263,0,39263,206849,0,246112
142210400600000,SE 248,RESIDENTIAL,24000,0,24000,153207,0,177207
142210400700000,SE 248,RESIDENTIAL,24000,0,24000,165681,0,189681
142210400800000,SE 248,RESIDENTIAL,28280,0,28280,183663,0,211943
142210400900000,SE 248,RESIDENTIAL,24480,0,24480,149218,0,173698
142210401000000,SE 248,RESIDENTIAL,38185,0,38185,139275,0,177460
142210401100000,SE 248,RESIDENTIAL,36298,0,36298,177228,0,213526
142210401200000,SE 248,RESIDENTIAL,31800,0,31800,167726,0,199526
142210401300000,SE 248,RESIDENTIAL,34397,0,34397,172773,0,207170
142210401400000,SE 248,RESIDENTIAL,32100,0,32100,108186,0,140286
142210401500000,SE 248,RESIDENTIAL,76840,0,76840,243247,0,320087
142210401600000,SE 248,RESIDENTIAL,81771,0,81771,681253,0,763024
142210401700000,SE 248,RESIDENTIAL,83000,0,83000,435776,0,518776
142210500100000,SE 216,RESIDENTIAL,49756,0,49756,95672,0,145428
142210600100000,SE 216,RESIDENTIAL,45934,0,45934,99350,0,145284
142210600200000,SE 216,RESIDENTIAL,20958,0,20958,130669,0,151627
142210600300000,SE 216,RESIDENTIAL,48000,0,48000,150757,0,198757
142210600400000,SE 216,RESIDENTIAL,48000,0,48000,142026,0,190026
142210600500000,SE 216,RESIDENTIAL,48000,0,48000,124938,0,172938
142210600600000,SE 216,RESIDENTIAL,51200,0,51200,119703,0,170903
142210600700000,SE 216,RESIDENTIAL,48000,0,48000,78494,0,126494
142210600800000,SE 216,RESIDENTIAL,40000,0,40000,116859,0,156859
142210600900000,SE 216,RESIDENTIAL,56000,0,56000,140656,0,196656
142210601000000,SE 216,RESIDENTIAL,48000,0,48000,134825,0,182825
142210601100000,SE 216,RESIDENTIAL,48000,0,48000,109884,0,157884
142210601200000,SE 216,RESIDENTIAL,48000,0,48000,130990,0,178990
142210601300000,SE 216,RESIDENTIAL,48000,0,48000,150228,0,198228
142210601400000,SE 216,RESIDENTIAL,48000,0,48000,150089,0,198089
142210601500000,SE 216,RESIDENTIAL,32000,0,32000,118085,0,150085
142210601600000,SE 216,RESIDENTIAL,32000,0,32000,107878,0,139878
142210601700000,SE 216,RESIDENTIAL,44000,0,44000,110305,0,154305
142210601800000,SE 216,RESIDENTIAL,39240,0,39240,118331,0,157571
142210601900000,SE 216,RESIDENTIAL,36520,0,36520,113306,0,149826
142210602000000,SE 216,RESIDENTIAL,12450,0,12450,101831,0,114281
142210900100000,SE 231,RESIDENTIAL,17500,0,17500,57450,0,74950
142210900800000,CONVERSION,COMMERCIAL,0,13608,13608,0,63763,77371
142212600100000,SE 218,RESIDENTIAL,39000,0,39000,101972,0,140972
142212600200000,SE 218,RESIDENTIAL,39000,0,39000,130121,0,169121
142212600300000,SE 218,RESIDENTIAL,36000,0,36000,0,0,36000
142212600400000,SE 218,RESIDENTIAL,36000,0,36000,130060,0,166060
142212600500000,SE 218,RESIDENTIAL,36000,0,36000,123187,0,159187
142212600600000,SE 218,RESIDENTIAL,36000,0,36000,140029,0,176029
142212600700000,SE 218,RESIDENTIAL,36000,0,36000,142770,0,178770
142212600800000,SE 218,RESIDENTIAL,36000,0,36000,0,0,36000
142212600900000,SE 218,RESIDENTIAL,36000,0,36000,177974,0,213974
142212601000000,SE 218,RESIDENTIAL,36000,0,36000,97359,0,133359
142212601100000,SE 218,RESIDENTIAL,36000,0,36000,153865,0,189865
142212601200000,SE 218,RESIDENTIAL,36000,0,36000,102845,0,138845
142212601300000,SE 218,RESIDENTIAL,36000,0,36000,114397,0,150397
142212601400000,SE 218,RESIDENTIAL,36000,0,36000,110299,0,146299
142212601500000,SE 218,RESIDENTIAL,36000,0,36000,99918,0,135918
142212601600000,SE 218,RESIDENTIAL,36000,0,36000,129162,0,165162
142212601700000,SE 218,RESIDENTIAL,36000,0,36000,89109,0,125109
142212601800000,SE 218,RESIDENTIAL,36000,0,36000,99796,0,135796
142212601900000,SE 218,RESIDENTIAL,36000,0,36000,104895,0,140895
142212602000000,SE 218,RESIDENTIAL,36000,0,36000,103105,0,139105
142212700100000,SE 218,RESIDENTIAL,60000,0,60000,198243,0,258243
142212700200000,SE 218,RESIDENTIAL,50474,0,50474,192970,0,243444
142212700300000,SE 218,RESIDENTIAL,50320,0,50320,188396,0,238716
142212700700000,OFFICE,COMMERCIAL,0,58800,58800,0,88537,147337
142212700800000,SE 218,RESIDENTIAL,36000,0,36000,139145,0,175145
142212700900000,SE 218,RESIDENTIAL,36000,0,36000,89284,0,125284
142212701000000,SE 218,RESIDENTIAL,36000,0,36000,147069,0,183069
142212701100000,SE 218,RESIDENTIAL,36000,0,36000,115609,0,151609
142212701300000,OFFICE; MEDICAL,COMMERCIAL,0,288000,288000,0,1016811,1304811
142212800100000,OFFICE,COMMERCIAL,0,105000,105000,0,121090,226090
142212900100000,SE 217,RESIDENTIAL,13680,0,13680,75079,0,88759
142212900200000,SE 217,RESIDENTIAL,21623,0,21623,75100,0,96723
142212900300000,SE 217,RESIDENTIAL,11856,0,11856,74603,0,86459
142212900400000,SE 217,RESIDENTIAL,7826,0,7826,86766,0,94592
142212900500000,SE 217,RESIDENTIAL,12600,0,12600,69036,0,81636
142212900600000,SE 217,RESIDENTIAL,30736,0,30736,87033,0,117769
142212900700000,SE 217,RESIDENTIAL,23200,0,23200,74645,0,97845
142212900800000,SE 217,RESIDENTIAL,16431,0,16431,81575,0,98006
142212900900000,SE 217,RESIDENTIAL,24000,0,24000,112052,0,136052
142212901000000,SE 217,RESIDENTIAL,9920,0,9920,68529,0,78449
142213000100000,SE 218,RESIDENTIAL,30600,0,30600,94396,0,124996
142213000200000,SE 218,RESIDENTIAL,24000,0,24000,79242,0,103242
142213000300000,SE 218,RESIDENTIAL,24000,0,24000,74557,0,98557
142213000400000,SE 218,RESIDENTIAL,24000,0,24000,76497,0,100497
142213000500000,SE 218,RESIDENTIAL,24000,0,24000,73795,0,97795
142213000600000,SE 218,RESIDENTIAL,24000,0,24000,86349,0,110349
142213000700000,SE 218,RESIDENTIAL,24000,0,24000,84317,0,108317
142213000800000,SE 218,RESIDENTIAL,24000,0,24000,37627,0,61627
142213000900000,CONVERSION,COMMERCIAL,0,13608,13608,0,72566,86174
142213001000000,SE 218,RESIDENTIAL,24000,0,24000,100888,0,124888
142213001100000,SE 218,RESIDENTIAL,24000,0,24000,127706,0,151706
142213001200000,SE 218,RESIDENTIAL,24000,0,24000,107033,0,131033
142213001300000,SE 218,RESIDENTIAL,24000,0,24000,73666,0,97666
142213001400000,SE 218,RESIDENTIAL,24000,0,24000,92899,0,116899
142213001500000,SE 218,RESIDENTIAL,24000,0,24000,103529,0,127529
142213001600000,SE 218,RESIDENTIAL,24000,0,24000,78275,0,102275
142213100100000,SE 222,EXEMPT,0,17136,17136,0,176003,193139
142213100200000,BRANCH BANK/CU,COMMERCIAL,0,231300,231300,0,797640,1028940
142213100300000,OFFICE,COMMERCIAL,0,173554,173554,0,775590,949144
142213100400000,FLAT PARKING,COMMERCIAL,0,57851,57851,0,4155,62006
142213100500000,SE 218,RESIDENTIAL,28000,0,28000,129696,0,157696
142213100600000,SE 218,RESIDENTIAL,20000,0,20000,84754,0,104754
142213100700000,SE 218,RESIDENTIAL,24000,0,24000,90668,0,114668
142213100800000,SE 218,RESIDENTIAL,24000,0,24000,111175,0,135175
142213100900000,SE 218,RESIDENTIAL,24000,0,24000,139442,0,163442
142213101000000,SE 218,RESIDENTIAL,22000,0,22000,100491,0,122491
142213101100000,SE 218,RESIDENTIAL,22000,0,22000,117504,0,139504
142213200100000,SE 231,RESIDENTIAL,17500,0,17500,109332,0,126832
142213200400000,SE 217,RESIDENTIAL,7634,0,7634,69151,0,76785
142213200500000,SE 217,RESIDENTIAL,8468,0,8468,74559,0,83027
142213200600000,SE 217,RESIDENTIAL,12455,0,12455,73529,0,85984
142213300100000,SE 217,RESIDENTIAL,19920,0,19920,86296,0,106216
142213300200000,SE 217,RESIDENTIAL,24000,0,24000,85314,0,109314
142213300300000,SE 217,RESIDENTIAL,16000,0,16000,96625,0,112625
142213300400000,SE 217,RESIDENTIAL,16000,0,16000,75867,0,91867
142213300500000,SE 217,RESIDENTIAL,16000,0,16000,67902,0,83902
142213300600000,SE 217,RESIDENTIAL,24000,0,24000,33704,0,57704
142213300700000,SE 217,RESIDENTIAL,24000,0,24000,68903,0,92903
142213300800000,SE 217,RESIDENTIAL,21120,0,21120,120002,0,141122
142213300900000,SE 217,RESIDENTIAL,12400,0,12400,67335,0,79735
142213301000000,SE 217,RESIDENTIAL,14880,0,14880,70131,0,85011
142213301100000,SE 217,RESIDENTIAL,25200,0,25200,90819,0,116019
142213301200000,SE 217,RESIDENTIAL,15000,0,15000,57063,0,72063
142213301300000,SE 217,RESIDENTIAL,15000,0,15000,57168,0,72168
142213301400000,SE 217,RESIDENTIAL,19400,0,19400,70044,0,89444
142213301500000,SE 217,RESIDENTIAL,600,0,600,5118,0,5718
142213301600000,SE 217,RESIDENTIAL,20000,0,20000,62793,0,82793
142213301700000,SE 217,RESIDENTIAL,20000,0,20000,87686,0,107686
142213301800000,SE 217,RESIDENTIAL,20000,0,20000,69593,0,89593
142213301900000,SE 217,RESIDENTIAL,22500,0,22500,82552,0,105052
142213302000000,SE 217,RESIDENTIAL,17500,0,17500,64717,0,82217
142213302100000,SE 217,RESIDENTIAL,24900,0,24900,85102,0,110002
142213302200000,SE 217,RESIDENTIAL,12400,0,12400,66325,0,78725
142213302300000,SE 217,RESIDENTIAL,12400,0,12400,86214,0,98614
142213400100000,SE 217,RESIDENTIAL,8671,0,8671,60513,0,69184
142213400200000,SE 217,RESIDENTIAL,8568,0,8568,62280,0,70848
142213400300000,SE 217,RESIDENTIAL,8311,0,8311,56465,0,64776
142213400700000,SE 217,RESIDENTIAL,13200,0,13200,64517,0,77717
142213400800000,SE 217,RESIDENTIAL,20000,0,20000,84765,0,104765
142213400900000,SE 217,RESIDENTIAL,20000,0,20000,73203,0,93203
142213401000000,SE 217,RESIDENTIAL,22100,0,22100,106625,0,128725
142213401100000,SE 217,RESIDENTIAL,17504,0,17504,67494,0,84998
142213401200000,SE 217,RESIDENTIAL,8750,0,8750,61444,0,70194
142213500100000,SE 231,RESIDENTIAL,8400,0,8400,60475,0,68875
142213500200000,SE 231,RESIDENTIAL,9310,0,9310,36211,0,45521
142213500300000,SE 231,RESIDENTIAL,9310,0,9310,38753,0,48063
142213500400000,CONVERSION,COMMERCIAL,0,9072,9072,0,57455,66527
142213500500000,CONVERSION,COMMERCIAL,0,27216,27216,0,192973,220189
142213500600000,CONVERSION,EXEMPT,0,9072,9072,0,109969,119041
142213500700000,SE 231,RESIDENTIAL,17500,0,17500,38823,0,56323
142213500800000,SE 231,RESIDENTIAL,14000,0,14000,59651,0,73651
142213500900000,CONVERSION,COMMERCIAL,0,9072,9072,0,73723,82795
142213501000000,SE 231,RESIDENTIAL,12000,0,12000,47890,0,59890
142213501100000,SE 231,RESIDENTIAL,12000,0,12000,62350,0,74350
142213501200000,SE 231,RESIDENTIAL,12000,0,12000,55755,0,67755
142213501300000,SE 231,RESIDENTIAL,12000,0,12000,58682,0,70682
142213501400000,SE 231,RESIDENTIAL,12000,0,12000,74564,0,86564
142213501500000,CONVERSION,COMMERCIAL,0,8400,8400,0,0,8400
142213501600000,SE 231,RESIDENTIAL,8400,0,8400,60968,0,69368
142213600100000,SE 217,RESIDENTIAL,21165,0,21165,64211,0,85376
142213600200000,SE 217,RESIDENTIAL,9300,0,9300,80629,0,89929
142213600300000,SE 217,RESIDENTIAL,25000,0,25000,71892,0,96892
142213600400000,SE 217,RESIDENTIAL,20000,0,20000,75567,0,95567
142213600500000,SE 217,RESIDENTIAL,20000,0,20000,73878,0,93878
142213600600000,SE 217,RESIDENTIAL,20000,0,20000,71653,0,91653
142213600700000,SE 217,RESIDENTIAL,20000,0,20000,75833,0,95833
142213600800000,SE 217,RESIDENTIAL,20000,0,20000,75024,0,95024
142213600900000,SE 217,RESIDENTIAL,24150,0,24150,79003,0,103153
142213601000000,SE 217,RESIDENTIAL,19380,0,19380,52819,0,72199
142213601100000,SE 217,RESIDENTIAL,17510,0,17510,70257,0,87767
142213700100000,SE 217,RESIDENTIAL,19337,0,19337,76063,0,95400
142213700200000,SE 217,RESIDENTIAL,18760,0,18760,69006,0,87766
142213700300000,SE 217,RESIDENTIAL,25500,0,25500,75140,0,100640
142213700400000,SE 217,RESIDENTIAL,20000,0,20000,78560,0,98560
142213700500000,SE 217,RESIDENTIAL,25000,0,25000,65588,0,90588
142213700600000,SE 217,RESIDENTIAL,22500,0,22500,77983,0,100483
142213700700000,SE 217,RESIDENTIAL,20795,0,20795,58748,0,79543
142213700800000,SE 217,RESIDENTIAL,17850,0,17850,78060,0,95910
142213700900000,SE 217,RESIDENTIAL,20748,0,20748,61651,0,82399
142213800100000,SE 217,RESIDENTIAL,17235,0,17235,48835,0,66070
142213800200000,SE 217,RESIDENTIAL,9009,0,9009,53472,0,62481
142215100100000,SE 217,RESIDENTIAL,9300,0,9300,67195,0,76495
142215100200000,SE 217,RESIDENTIAL,21165,0,21165,74238,0,95403
142215100300000,SE 217,RESIDENTIAL,20000,0,20000,85977,0,105977
142215100400000,SE 217,RESIDENTIAL,20000,0,20000,76344,0,96344
142215100500000,SE 217,RESIDENTIAL,20000,0,20000,82827,0,102827
142215100600000,SE 217,RESIDENTIAL,20000,0,20000,72331,0,92331
142215100700000,SE 217,RESIDENTIAL,20000,0,20000,71185,0,91185
142215100800000,SE 217,RESIDENTIAL,20000,0,20000,62143,0,82143
142215100900000,SE 217,RESIDENTIAL,24480,0,24480,92145,0,116625
142215101000000,SE 217,RESIDENTIAL,17850,0,17850,70164,0,88014
142215101100000,SE 217,RESIDENTIAL,19380,0,19380,73879,0,93259
142215200100000,SE 217,RESIDENTIAL,16000,0,16000,70526,0,86526
142215200200000,SE 217,RESIDENTIAL,1180,0,1180,0,0,1180
142215200300000,SE 217,RESIDENTIAL,19855,0,19855,77083,0,96938
142215200400000,SE 217,RESIDENTIAL,19405,0,19405,74755,0,94160
142215200500000,SE 217,RESIDENTIAL,20000,0,20000,79499,0,99499
142215200600000,SE 217,RESIDENTIAL,20000,0,20000,68861,0,88861
142215200700000,SE 217,RESIDENTIAL,20000,0,20000,75066,0,95066
142215200800000,SE 217,RESIDENTIAL,20000,0,20000,80328,0,100328
142215200900000,SE 217,RESIDENTIAL,25000,0,25000,97664,0,122664
142215201000000,SE 217,RESIDENTIAL,15810,0,15810,75915,0,91725
142215201100000,SE 217,RESIDENTIAL,19380,0,19380,89448,0,108828
142215300100000,SE 217,RESIDENTIAL,21280,0,21280,82460,0,103740
142215300200000,SE 217,RESIDENTIAL,14000,0,14000,71683,0,85683
142215300300000,SE 217,RESIDENTIAL,14000,0,14000,75697,0,89697
142215300400000,SE 217,RESIDENTIAL,20000,0,20000,59357,0,79357
142215300500000,SE 217,RESIDENTIAL,8889,0,8889,70221,0,79110
142215300600000,SE 217,RESIDENTIAL,17850,0,17850,80295,0,98145
142215300700000,SE 217,RESIDENTIAL,21886,0,21886,46979,0,68865
142215300800000,SE 217,RESIDENTIAL,8707,0,8707,66572,0,75279
142215400100000,SE 217,RESIDENTIAL,39200,0,39200,137709,0,176909
142215400200000,SE 217,RESIDENTIAL,24000,0,24000,77610,0,101610
142215400300000,SE 217,RESIDENTIAL,21000,0,21000,86733,0,107733
142215400400000,SE 217,RESIDENTIAL,20000,0,20000,84425,0,104425
142215400500000,SE 217,RESIDENTIAL,20000,0,20000,82641,0,102641
142215400600000,SE 217,RESIDENTIAL,25500,0,25500,82890,0,108390
142215400700000,SE 217,RESIDENTIAL,20000,0,20000,85595,0,105595
142215400800000,SE 217,RESIDENTIAL,12250,0,12250,50406,0,62656
142215400900000,SE 217,RESIDENTIAL,15750,0,15750,73443,0,89193
142215401000000,SE 217,RESIDENTIAL,15200,0,15200,60306,0,75506
142215401100000,SE 217,RESIDENTIAL,11400,0,11400,64244,0,75644
142215401200000,SE 217,RESIDENTIAL,13300,0,13300,52387,0,65687
142215401300000,SE 217,RESIDENTIAL,13300,0,13300,58686,0,71986
142215401400000,SE 217,RESIDENTIAL,15750,0,15750,64484,0,80234
142215401500000,SE 217,RESIDENTIAL,12250,0,12250,46240,0,58490
142215401600000,SE 217,RESIDENTIAL,20000,0,20000,62851,0,82851
142215401700000,SE 217,RESIDENTIAL,20000,0,20000,71458,0,91458
142215401800000,SE 217,RESIDENTIAL,20000,0,20000,58990,0,78990
142215401900000,SE 217,RESIDENTIAL,15000,0,15000,51222,0,66222
142215402000000,SE 217,RESIDENTIAL,25000,0,25000,88881,0,113881
142215402100000,SE 217,RESIDENTIAL,20000,0,20000,56196,0,76196
142215402200000,SE 217,RESIDENTIAL,20000,0,20000,88433,0,108433
142215402300000,SE 217,RESIDENTIAL,10840,0,10840,65151,0,75991
142215402400000,SE 217,RESIDENTIAL,10500,0,10500,45909,0,56409
142215402500000,SE 217,RESIDENTIAL,5580,0,5580,54218,0,59798
142215402600000,SE 217,RESIDENTIAL,7440,0,7440,43442,0,50882
142215402700000,SE 217,RESIDENTIAL,7440,0,7440,68213,0,75653
142215500100000,SE 217,RESIDENTIAL,16200,0,16200,101728,0,117928
142215500200000,SE 217,RESIDENTIAL,15060,0,15060,82086,0,97146
142215500300000,SE 217,RESIDENTIAL,20000,0,20000,73457,0,93457
142215500400000,SE 217,RESIDENTIAL,20000,0,20000,83853,0,103853
142215500500000,SE 217,RESIDENTIAL,20000,0,20000,65328,0,85328
142215500600000,SE 217,RESIDENTIAL,20000,0,20000,87456,0,107456
142215500700000,SE 217,RESIDENTIAL,20000,0,20000,79260,0,99260
142215500800000,SE 217,RESIDENTIAL,14600,0,14600,51144,0,65744
142215500900000,SE 217,RESIDENTIAL,14600,0,14600,94012,0,108612
142215501000000,SE 217,RESIDENTIAL,12350,0,12350,41438,0,53788
142215501100000,SE 217,RESIDENTIAL,12350,0,12350,53546,0,65896
142215501200000,SE 217,RESIDENTIAL,12250,0,12250,66527,0,78777
142215501300000,SE 217,RESIDENTIAL,12250,0,12250,63898,0,76148
142215501400000,SE 217,RESIDENTIAL,14000,0,14000,62071,0,76071
142215501500000,SE 217,RESIDENTIAL,10500,0,10500,57073,0,67573
142215501600000,SE 217,RESIDENTIAL,15000,0,15000,64726,0,79726
142215501700000,SE 217,RESIDENTIAL,20000,0,20000,55637,0,75637
142215501800000,SE 217,RESIDENTIAL,20000,0,20000,76653,0,96653
142215501900000,SE 217,RESIDENTIAL,20000,0,20000,68587,0,88587
142215502000000,SE 217,RESIDENTIAL,20000,0,20000,75118,0,95118
142215502100000,SE 217,RESIDENTIAL,20000,0,20000,70852,0,90852
142215502200000,SE 217,RESIDENTIAL,11375,0,11375,67949,0,79324
142215502300000,SE 217,RESIDENTIAL,11375,0,11375,57678,0,69053
142215502400000,SE 217,RESIDENTIAL,11725,0,11725,51180,0,62905
142215502500000,SE 217,RESIDENTIAL,11725,0,11725,48941,0,60666
142215502600000,SE 217,RESIDENTIAL,13000,0,13000,57024,0,70024
142215502700000,SE 217,RESIDENTIAL,13330,0,13330,55497,0,68827
142215600100000,APARTMENT,RESIDENTIAL,23800,0,23800,184165,0,207965
142215600200000,SE 231,RESIDENTIAL,14000,0,14000,72291,0,86291
142215600300000,SE 231,RESIDENTIAL,14000,0,14000,58181,0,72181
142215600400000,SE 231,RESIDENTIAL,14000,0,14000,60630,0,74630
142215600500000,SE 231,RESIDENTIAL,14000,0,14000,67583,0,81583
142215600600000,SE 231,RESIDENTIAL,14000,0,14000,60923,0,74923
142215600700000,APARTMENT,COMMERCIAL,0,16800,16800,0,152474,169274
142215600800000,SE 231,RESIDENTIAL,9800,0,9800,71758,0,81558
142215600900000,SE 231,RESIDENTIAL,12775,0,12775,61086,0,73861
142215601000000,SE 231,RESIDENTIAL,17430,0,17430,25621,0,43051
142215601100000,SE 231,RESIDENTIAL,13173,0,13173,65305,0,78478
142215601200000,SE 231,RESIDENTIAL,14000,0,14000,65949,0,79949
142215601300000,SE 231,RESIDENTIAL,14000,0,14000,60605,0,74605
142215601400000,SE 231,RESIDENTIAL,14000,0,14000,70944,0,84944
142215601500000,SE 231,RESIDENTIAL,14000,0,14000,60733,0,74733
142215601600000,SE 231,RESIDENTIAL,14000,0,14000,62707,0,76707
142215601700000,SE 231,RESIDENTIAL,13536,0,13536,55864,0,69400
142215601800000,SE 231,RESIDENTIAL,8208,0,8208,47101,0,55309
142215601900000,SE 231,RESIDENTIAL,8208,0,8208,26765,0,34973
142215700100000,CHURCH,EXEMPT,0,11340,11340,0,294829,306169
142215700200000,SE 217,RESIDENTIAL,20000,0,20000,67143,0,87143
142215700300000,SE 217,RESIDENTIAL,20000,0,20000,79697,0,99697
142215700400000,SE 217,RESIDENTIAL,20000,0,20000,71305,0,91305
142215700500000,SE 217,RESIDENTIAL,25000,0,25000,66282,0,91282
142215700600000,SE 217,RESIDENTIAL,20000,0,20000,100406,0,120406
142215700700000,SE 217,RESIDENTIAL,20000,0,20000,67716,0,87716
142215700800000,SE 217,RESIDENTIAL,14000,0,14000,51165,0,65165
142215700900000,SE 217,RESIDENTIAL,10500,0,10500,55259,0,65759
142215701000000,FLAT PARKING,EXEMPT,0,0,0,0,0,0
142215701100000,SCHOOL,EXEMPT,0,0,0,0,0,0
142215701200000,SE 217,RESIDENTIAL,10075,0,10075,46888,0,56963
142215701300000,SE 217,RESIDENTIAL,18615,0,18615,61463,0,80078
142215701400000,SE 217,RESIDENTIAL,15000,0,15000,48766,0,63766
142215701500000,SE 217,RESIDENTIAL,15000,0,15000,56035,0,71035
142215701600000,SE 217,RESIDENTIAL,20000,0,20000,73928,0,93928
142215701700000,SE 217,RESIDENTIAL,20000,0,20000,62965,0,82965
142215701800000,SE 217,RESIDENTIAL,20000,0,20000,65036,0,85036
142215701900000,SE 217,RESIDENTIAL,20000,0,20000,70442,0,90442
142215702000000,SE 217,RESIDENTIAL,20000,0,20000,57334,0,77334
142215702100000,SE 217,RESIDENTIAL,20000,0,20000,73415,0,93415
142215702200000,SE 217,RESIDENTIAL,10500,0,10500,65987,0,76487
142215702300000,SE 217,RESIDENTIAL,10500,0,10500,63160,0,73660
142215702400000,SE 217,RESIDENTIAL,6510,0,6510,49567,0,56077
142215702500000,SE 217,RESIDENTIAL,6510,0,6510,46127,0,52637
142215800100000,SCHOOL,EXEMPT,0,0,0,0,0,0
142215900100000,SE 231,RESIDENTIAL,8304,0,8304,47486,0,55790
142215900200000,SE 231,RESIDENTIAL,8304,0,8304,51857,0,60161
142215900300000,SE 231,RESIDENTIAL,14000,0,14000,60252,0,74252
142215900400000,SE 231,RESIDENTIAL,21000,0,21000,61304,0,82304
142215900500000,SE 231,RESIDENTIAL,17850,0,17850,63447,0,81297
142215900600000,SE 231,RESIDENTIAL,14000,0,14000,65366,0,79366
142215900700000,SE 231,RESIDENTIAL,14000,0,14000,79420,0,93420
142215900800000,SE 231,RESIDENTIAL,11067,0,11067,57822,0,68889
142215900900000,SE 231,RESIDENTIAL,8680,0,8680,50672,0,59352
142215901000000,SE 231,RESIDENTIAL,8680,0,8680,53002,0,61682
142215901100000,SE 216,RESIDENTIAL,17000,0,17000,0,0,17000
142215901200000,CONVERSION,COMMERCIAL,0,11794,11794,0,15836,27630
142215901300000,CHURCH,EXEMPT,0,13608,13608,0,448,14056
142215901400000,CHURCH,EXEMPT,0,13608,13608,0,0,13608
142215901500000,CHURCH,EXEMPT,0,28350,28350,0,841342,869692
142215901600000,SE 231,RESIDENTIAL,7621,0,7621,52861,0,60482
142215901700000,SE 231,RESIDENTIAL,7621,0,7621,49170,0,56791
142216000100000,SE 217,RESIDENTIAL,10720,0,10720,61254,0,71974
142216000200000,SE 217,RESIDENTIAL,12100,0,12100,62378,0,74478
142216000300000,SE 217,RESIDENTIAL,16630,0,16630,81113,0,97743
142216000400000,SE 217,RESIDENTIAL,19273,0,19273,67135,0,86408
142216000500000,SE 217,RESIDENTIAL,17000,0,17000,70950,0,87950
142216000600000,SE 217,RESIDENTIAL,17000,0,17000,47858,0,64858
142216000700000,SE 217,RESIDENTIAL,16000,0,16000,69234,0,85234
142216000800000,SE 217,RESIDENTIAL,20000,0,20000,78897,0,98897
142216000900000,SE 217,RESIDENTIAL,20000,0,20000,64691,0,84691
142216001000000,SE 217,RESIDENTIAL,20000,0,20000,51757,0,71757
142216001100000,SE 217,RESIDENTIAL,10500,0,10500,42359,0,52859
142216001200000,SE 217,RESIDENTIAL,10500,0,10500,47028,0,57528
142216001300000,SE 217,RESIDENTIAL,10850,0,10850,58993,0,69843
142216001400000,SE 217,RESIDENTIAL,10850,0,10850,64443,0,75293
142216001500000,SE 217,RESIDENTIAL,10850,0,10850,53363,0,64213
142216001600000,SE 217,RESIDENTIAL,10850,0,10850,63052,0,73902
142216001700000,SE 217,RESIDENTIAL,17850,0,17850,84389,0,102239
142216001800000,SE 217,RESIDENTIAL,20000,0,20000,96473,0,116473
142216001900000,SE 217,RESIDENTIAL,18000,0,18000,73699,0,91699
142216002000000,SE 217,RESIDENTIAL,22000,0,22000,70913,0,92913
142216002100000,SE 217,RESIDENTIAL,20000,0,20000,64552,0,84552
142216002200000,SE 217,RESIDENTIAL,20000,0,20000,60295,0,80295
142216002300000,SE 217,RESIDENTIAL,20000,0,20000,74158,0,94158
142216002400000,SE 217,RESIDENTIAL,20000,0,20000,89768,0,109768
142216002500000,SE 217,RESIDENTIAL,19800,0,19800,67797,0,87597
142216002600000,SE 217,RESIDENTIAL,14600,0,14600,80950,0,95550
142216002700000,SE 217,RESIDENTIAL,10260,0,10260,64623,0,74883
142216002800000,SE 217,RESIDENTIAL,7560,0,7560,57606,0,65166
142216002900000,SE 217,RESIDENTIAL,8091,0,8091,70081,0,78172
142216100100000,CONVERSION,COMMERCIAL,0,7371,7371,0,37904,45275
142216100200000,SE 217,RESIDENTIAL,20000,0,20000,79726,0,99726
142216100300000,SE 217,RESIDENTIAL,20000,0,20000,69085,0,89085
142216100400000,SE 217,RESIDENTIAL,20000,0,20000,98353,0,118353
142216100500000,SE 217,RESIDENTIAL,20000,0,20000,76878,0,96878
142216100600000,SE 217,RESIDENTIAL,20000,0,20000,67929,0,87929
142216100700000,SE 217,RESIDENTIAL,20000,0,20000,0,0,20000
142216100800000,SE 217,RESIDENTIAL,15748,0,15748,54956,0,70704
142216100900000,SE 217,RESIDENTIAL,12400,0,12400,54730,0,67130
142216101000000,SE 217,RESIDENTIAL,12400,0,12400,66528,0,78928
142216101100000,SE 217,RESIDENTIAL,10950,0,10950,65584,0,76534
142216101200000,SE 217,RESIDENTIAL,25734,0,25734,66870,0,92604
142216101300000,SE 217,RESIDENTIAL,20000,0,20000,81282,0,101282
142216101400000,SE 217,RESIDENTIAL,20000,0,20000,80882,0,100882
142216101500000,SE 217,EXEMPT,0,10000,10000,57754,0,67754
142216101600000,SE 217,RESIDENTIAL,20000,0,20000,105005,0,125005
142216101700000,SE 217,RESIDENTIAL,17500,0,17500,88981,0,106481
142216101800000,SE 217,RESIDENTIAL,25289,0,25289,93290,0,118579
142216101900000,SE 217,RESIDENTIAL,16197,0,16197,87925,0,104122
142216102000000,SE 217,RESIDENTIAL,13640,0,13640,68315,0,81955
142216102100000,SE 217,RESIDENTIAL,11880,0,11880,69941,0,81821
142216102200000,SE 217,RESIDENTIAL,11725,0,11725,72300,0,84025
142216102300000,SE 217,RESIDENTIAL,11725,0,11725,63223,0,74948
142216200100000,SE 231,RESIDENTIAL,11989,0,11989,69406,0,81395
142216200200000,SE 231,RESIDENTIAL,14000,0,14000,49559,0,63559
142216200300000,SE 231,RESIDENTIAL,14000,0,14000,58576,0,72576
142216200400000,SE 231,RESIDENTIAL,14000,0,14000,52084,0,66084
142216200500000,SE 231,RESIDENTIAL,14000,0,14000,47125,0,61125
142216200600000,SE 231,RESIDENTIAL,14000,0,14000,51816,0,65816
142216200700000,SE 231,RESIDENTIAL,14000,0,14000,57949,0,71949
142216200800000,SE 231,RESIDENTIAL,12495,0,12495,50295,0,62790
142216200900000,SE 231,RESIDENTIAL,7595,0,7595,41318,0,48913
142216201000000,SE 231,RESIDENTIAL,7595,0,7595,49452,0,57047
142216201100000,SE 231,RESIDENTIAL,10850,0,10850,48213,0,59063
142216201200000,SE 231,RESIDENTIAL,14815,0,14815,70068,0,84883
142216201300000,SE 231,RESIDENTIAL,17850,0,17850,59904,0,77754
142216201400000,CONVERSION,COMMERCIAL,0,13608,13608,0,66418,80026
142216201500000,SE 231,EXEMPT,0,14000,14000,0,50480,64480
142216201600000,SE 231,RESIDENTIAL,14000,0,14000,60301,0,74301
142216201700000,SE 231,RESIDENTIAL,14000,0,14000,62015,0,76015
142216201800000,SE 231,RESIDENTIAL,12757,0,12757,77761,0,90518
142216201900000,SE 231,RESIDENTIAL,8677,0,8677,47939,0,56616
142216202000000,SE 231,RESIDENTIAL,8208,0,8208,42480,0,50688
142216202100000,SE 231,RESIDENTIAL,9180,0,9180,35817,0,44997
142216202200000,SE 231,RESIDENTIAL,9314,0,9314,39357,0,48671
142217600100000,SE 216,RESIDENTIAL,33440,0,33440,131926,0,165366
142217600200000,SE 216,RESIDENTIAL,38400,0,38400,105897,0,144297
142217700100000,SE 216,RESIDENTIAL,31217,0,31217,93579,0,124796
142217700200000,SE 216,RESIDENTIAL,30000,0,30000,160203,0,190203
142217700300000,SE 216,RESIDENTIAL,30000,0,30000,152576,0,182576
142217700400000,SE 216,RESIDENTIAL,30000,0,30000,144085,0,174085
142217700500000,SE 216,RESIDENTIAL,30000,0,30000,150765,0,180765
142217700600000,SE 216,RESIDENTIAL,30000,0,30000,149374,0,179374
142217700700000,SE 216,RESIDENTIAL,30000,0,30000,143255,0,173255
142217700800000,SE 216,RESIDENTIAL,37500,0,37500,196930,0,234430
142217700900000,SE 216,RESIDENTIAL,32500,0,32500,172241,0,204741
142217701000000,SE 216,RESIDENTIAL,30000,0,30000,147732,0,177732
142217701100000,SE 216,RESIDENTIAL,30000,0,30000,119585,0,149585
142217701200000,SE 216,RESIDENTIAL,30000,0,30000,130127,0,160127
142217701300000,SE 216,RESIDENTIAL,30000,0,30000,115031,0,145031
142217701400000,SE 216,RESIDENTIAL,30000,0,30000,132580,0,162580
142217701500000,SE 216,RESIDENTIAL,30000,0,30000,113886,0,143886
142217701600000,SE 216,RESIDENTIAL,30000,0,30000,105142,0,135142
142217701700000,SE 216,RESIDENTIAL,30000,0,30000,121367,0,151367
142217701800000,SE 216,RESIDENTIAL,30000,0,30000,131634,0,161634
142217800100000,SE 216,RESIDENTIAL,17549,0,17549,96783,0,114332
142217800200000,SE 216,RESIDENTIAL,19381,0,19381,99387,0,118768
142217800300000,SE 216,RESIDENTIAL,18500,0,18500,95150,0,113650
142217800400000,SE 216,RESIDENTIAL,20500,0,20500,122718,0,143218
142217800500000,SE 216,RESIDENTIAL,20000,0,20000,107171,0,127171
142217800600000,SE 216,RESIDENTIAL,20000,0,20000,82364,0,102364
142217800700000,SE 216,RESIDENTIAL,19000,0,19000,96392,0,115392
142217800800000,SE 216,RESIDENTIAL,19000,0,19000,105498,0,124498
142217800900000,SE 216,RESIDENTIAL,19000,0,19000,105488,0,124488
142217801000000,SE 216,RESIDENTIAL,17000,0,17000,72733,0,89733
142217801100000,SE 216,RESIDENTIAL,18287,0,18287,126601,0,144888
142217801200000,SE 216,RESIDENTIAL,16800,0,16800,96925,0,113725
142217801300000,SE 216,RESIDENTIAL,13300,0,13300,78406,0,91706
142217801400000,SE 216,RESIDENTIAL,13300,0,13300,94538,0,107838
142217801500000,SE 216,RESIDENTIAL,13300,0,13300,93254,0,106554
142217801600000,SE 216,RESIDENTIAL,14000,0,14000,93964,0,107964
142217801700000,SE 216,RESIDENTIAL,14000,0,14000,72035,0,86035
142217801800000,SE 216,RESIDENTIAL,20000,0,20000,87908,0,107908
142217801900000,SE 216,RESIDENTIAL,20000,0,20000,97290,0,117290
142217802000000,SE 216,RESIDENTIAL,20000,0,20000,83712,0,103712
142217802100000,SE 216,RESIDENTIAL,14842,0,14842,54354,0,69196
142217802200000,SE 216,RESIDENTIAL,20000,0,20000,87650,0,107650
142217802300000,SE 216,RESIDENTIAL,20000,0,20000,94340,0,114340
142217802400000,SE 216,RESIDENTIAL,20000,0,20000,94901,0,114901
142217802500000,SE 216,RESIDENTIAL,20475,0,20475,113397,0,133872
142217802600000,SE 216,RESIDENTIAL,20000,0,20000,86813,0,106813
142217802700000,SE 216,RESIDENTIAL,14000,0,14000,57287,0,71287
142217802800000,SE 216,RESIDENTIAL,14117,0,14117,91976,0,106093
142217802900000,SE 216,RESIDENTIAL,17395,0,17395,101822,0,119217
142217803000000,SE 216,RESIDENTIAL,16575,0,16575,63717,0,80292
142217900100000,SE 216,RESIDENTIAL,17000,0,17000,100668,0,117668
142217900200000,SE 216,RESIDENTIAL,17000,0,17000,79614,0,96614
142217900300000,SE 216,RESIDENTIAL,20000,0,20000,103083,0,123083
142217900400000,SE 216,RESIDENTIAL,20000,0,20000,124331,0,144331
142217900500000,SE 216,RESIDENTIAL,17500,0,17500,96595,0,114095
142217900600000,SE 216,RESIDENTIAL,17500,0,17500,85156,0,102656
142217900700000,SE 216,RESIDENTIAL,20000,0,20000,103546,0,123546
142217900800000,SE 216,RESIDENTIAL,22500,0,22500,117721,0,140221
142217900900000,SE 216,RESIDENTIAL,22500,0,22500,101640,0,124140
142217901000000,SE 216,RESIDENTIAL,20000,0,20000,98503,0,118503
142217901100000,SE 216,RESIDENTIAL,22100,0,22100,84348,0,106448
142217901200000,SE 216,RESIDENTIAL,19000,0,19000,84953,0,103953
142217901300000,SE 216,RESIDENTIAL,24000,0,24000,123540,0,147540
142217901400000,SE 216,RESIDENTIAL,7980,0,7980,87995,0,95975
142217901500000,SE 216,RESIDENTIAL,7980,0,7980,87647,0,95627
142217901600000,SE 216,RESIDENTIAL,14000,0,14000,95088,0,109088
142217901700000,SE 216,RESIDENTIAL,14000,0,14000,95539,0,109539
142217901800000,SE 216,RESIDENTIAL,20000,0,20000,95320,0,115320
142217901900000,SE 216,RESIDENTIAL,20000,0,20000,87397,0,107397
142217902000000,SE 216,RESIDENTIAL,20000,0,20000,102950,0,122950
142217902100000,SE 216,RESIDENTIAL,20000,0,20000,93490,0,113490
142217902200000,SE 216,RESIDENTIAL,20000,0,20000,88885,0,108885
142217902300000,SE 216,RESIDENTIAL,20000,0,20000,98569,0,118569
142217902400000,SE 216,RESIDENTIAL,20000,0,20000,55027,0,75027
142217902500000,SE 216,RESIDENTIAL,20000,0,20000,106806,0,126806
142217902600000,SE 216,RESIDENTIAL,20000,0,20000,57404,0,77404
142217902700000,SE 216,RESIDENTIAL,20000,0,20000,85924,0,105924
142217902800000,SE 216,RESIDENTIAL,19250,0,19250,68180,0,87430
142217902900000,SE 216,RESIDENTIAL,14000,0,14000,76138,0,90138
142217903000000,SE 216,RESIDENTIAL,14000,0,14000,76613,0,90613
142217903100000,SE 216,RESIDENTIAL,13300,0,13300,83635,0,96935
142217903200000,SE 216,RESIDENTIAL,15050,0,15050,85772,0,100822
142217903300000,SE 216,RESIDENTIAL,15958,0,15958,93840,0,109798
142218000100000,SE 216,RESIDENTIAL,13067,0,13067,94682,0,107749
142218000200000,SE 216,RESIDENTIAL,14000,0,14000,77854,0,91854
142218000300000,SE 216,RESIDENTIAL,20000,0,20000,83989,0,103989
142218000400000,SE 216,RESIDENTIAL,20000,0,20000,83523,0,103523
142218000500000,SE 216,RESIDENTIAL,20000,0,20000,77779,0,97779
142218000600000,SE 216,RESIDENTIAL,20000,0,20000,97279,0,117279
142218000700000,SE 216,RESIDENTIAL,20000,0,20000,105248,0,125248
142218000800000,SE 216,RESIDENTIAL,20000,0,20000,62521,0,82521
142218000900000,SE 216,RESIDENTIAL,20000,0,20000,84883,0,104883
142218001000000,SE 216,RESIDENTIAL,20000,0,20000,29816,0,49816
142218001100000,SE 216,RESIDENTIAL,21250,0,21250,103036,0,124286
142218001200000,SE 216,RESIDENTIAL,14000,0,14000,68732,0,82732
142218001300000,SE 216,RESIDENTIAL,14000,0,14000,0,0,14000
142218001400000,SE 216,RESIDENTIAL,8000,0,8000,0,0,8000
142218001500000,SE 216,RESIDENTIAL,13300,0,13300,86704,0,100004
142218001600000,SE 216,RESIDENTIAL,13300,0,13300,83063,0,96363
142218001700000,SE 216,RESIDENTIAL,13300,0,13300,75963,0,89263
142218001800000,SE 216,RESIDENTIAL,14000,0,14000,89096,0,103096
142218001900000,SE 216,RESIDENTIAL,14000,0,14000,89014,0,103014
142218002000000,SE 216,RESIDENTIAL,20000,0,20000,81202,0,101202
142218002100000,SE 216,RESIDENTIAL,20000,0,20000,68113,0,88113
142218002200000,SE 216,RESIDENTIAL,17500,0,17500,78169,0,95669
142218002300000,SE 216,RESIDENTIAL,17500,0,17500,76406,0,93906
142218002400000,SE 216,RESIDENTIAL,20000,0,20000,70187,0,90187
142218002500000,SE 216,RESIDENTIAL,20000,0,20000,77221,0,97221
142218002600000,SE 216,RESIDENTIAL,20000,0,20000,62691,0,82691
142218002700000,SE 216,RESIDENTIAL,20000,0,20000,74687,0,94687
142218002800000,SE 216,RESIDENTIAL,20000,0,20000,99192,0,119192
142218002900000,SE 216,RESIDENTIAL,16780,0,16780,92934,0,109714
142218003000000,SE 216,RESIDENTIAL,16210,0,16210,95835,0,112045
142218003100000,SE 216,RESIDENTIAL,16567,0,16567,87789,0,104356
142218003200000,SE 216,RESIDENTIAL,12425,0,12425,76335,0,88760
142218003300000,SE 216,RESIDENTIAL,12600,0,12600,75322,0,87922
142218003400000,SE 216,RESIDENTIAL,14000,0,14000,90679,0,104679
142218003500000,SE 216,RESIDENTIAL,13650,0,13650,70799,0,84449
142218100100000,SE 216,RESIDENTIAL,18000,0,18000,100026,0,118026
142218100200000,SE 216,RESIDENTIAL,18000,0,18000,104978,0,122978
142218100300000,SE 216,RESIDENTIAL,20000,0,20000,99336,0,119336
142218100400000,SE 216,RESIDENTIAL,20000,0,20000,89464,0,109464
142218100500000,SE 216,RESIDENTIAL,20000,0,20000,94392,0,114392
142218100600000,SE 216,RESIDENTIAL,20000,0,20000,81362,0,101362
142218100700000,SE 216,RESIDENTIAL,20000,0,20000,88384,0,108384
142218100800000,SE 216,RESIDENTIAL,20000,0,20000,82605,0,102605
142218100900000,SE 216,RESIDENTIAL,20000,0,20000,91617,0,111617
142218101000000,SE 216,RESIDENTIAL,20000,0,20000,71602,0,91602
142218101100000,SE 216,RESIDENTIAL,20000,0,20000,100568,0,120568
142218101200000,SE 216,RESIDENTIAL,20000,0,20000,102238,0,122238
142218101300000,SE 216,RESIDENTIAL,19865,0,19865,92283,0,112148
142218101400000,SE 216,RESIDENTIAL,14135,0,14135,70137,0,84272
142218101500000,SE 216,RESIDENTIAL,13683,0,13683,73956,0,87639
142218101600000,SE 216,RESIDENTIAL,7980,0,7980,87474,0,95454
142218101700000,SE 216,RESIDENTIAL,7980,0,7980,80154,0,88134
142218101800000,SE 216,RESIDENTIAL,7980,0,7980,87239,0,95219
142218101900000,SE 216,RESIDENTIAL,18000,0,18000,87461,0,105461
142218102000000,SE 216,RESIDENTIAL,18000,0,18000,84958,0,102958
142218102100000,SE 216,RESIDENTIAL,20000,0,20000,88409,0,108409
142218102200000,SE 216,RESIDENTIAL,20000,0,20000,96088,0,116088
142218102300000,SE 216,RESIDENTIAL,20000,0,20000,93721,0,113721
142218102400000,SE 216,RESIDENTIAL,20000,0,20000,93531,0,113531
142218102500000,SE 216,RESIDENTIAL,20000,0,20000,105252,0,125252
142218102600000,SE 216,RESIDENTIAL,20000,0,20000,83577,0,103577
142218102700000,SE 216,RESIDENTIAL,20000,0,20000,103088,0,123088
142218102800000,SE 216,RESIDENTIAL,20000,0,20000,114511,0,134511
142218102900000,SE 216,RESIDENTIAL,20000,0,20000,102260,0,122260
142218103000000,SE 216,RESIDENTIAL,20000,0,20000,105415,0,125415
142218103100000,SE 216,RESIDENTIAL,20000,0,20000,78780,0,98780
142218103200000,SE 216,RESIDENTIAL,14000,0,14000,92105,0,106105
142218103300000,SE 216,RESIDENTIAL,14000,0,14000,92671,0,106671
142218103400000,SE 216,RESIDENTIAL,13300,0,13300,82983,0,96283
142218103500000,SE 216,RESIDENTIAL,13300,0,13300,100254,0,113554
142218103600000,SE 216,RESIDENTIAL,13300,0,13300,99570,0,112870
142218200100000,SE 216,RESIDENTIAL,16338,0,16338,68891,0,85229
142218200200000,SE 216,RESIDENTIAL,18000,0,18000,79115,0,97115
142218200300000,SE 216,RESIDENTIAL,20000,0,20000,97329,0,117329
142218200400000,SE 216,RESIDENTIAL,20000,0,20000,75715,0,95715
142218200500000,SE 216,RESIDENTIAL,20000,0,20000,70661,0,90661
142218200600000,SE 216,RESIDENTIAL,20000,0,20000,87900,0,107900
142218200700000,SE 216,RESIDENTIAL,20000,0,20000,105600,0,125600
142218200800000,SE 216,RESIDENTIAL,20000,0,20000,91567,0,111567
142218200900000,SE 216,RESIDENTIAL,20000,0,20000,102565,0,122565
142218201000000,SE 216,RESIDENTIAL,20000,0,20000,87276,0,107276
142218201100000,SE 216,RESIDENTIAL,20900,0,20900,83389,0,104289
142218201200000,SE 216,RESIDENTIAL,20900,0,20900,99419,0,120319
142218201300000,SE 216,RESIDENTIAL,14200,0,14200,79059,0,93259
142218201400000,SE 216,RESIDENTIAL,14164,0,14164,100173,0,114337
142218201500000,SE 216,RESIDENTIAL,13650,0,13650,89294,0,102944
142218201600000,SE 216,RESIDENTIAL,13650,0,13650,86221,0,99871
142218201700000,SE 216,RESIDENTIAL,17220,0,17220,96126,0,113346
142218201800000,SE 216,RESIDENTIAL,16359,0,16359,88420,0,104779
142218201900000,SE 216,RESIDENTIAL,16974,0,16974,103977,0,120951
142218202000000,SE 216,RESIDENTIAL,20000,0,20000,103102,0,123102
142218202100000,SE 216,RESIDENTIAL,20000,0,20000,86255,0,106255
142218202200000,SE 216,RESIDENTIAL,19950,0,19950,92260,0,112210
142218202300000,SE 216,RESIDENTIAL,20000,0,20000,117232,0,137232
142218202400000,SE 216,RESIDENTIAL,20000,0,20000,96374,0,116374
142218202500000,SE 216,RESIDENTIAL,20900,0,20900,100480,0,121380
142218202600000,SE 216,RESIDENTIAL,20000,0,20000,90467,0,110467
142218202700000,SE 216,RESIDENTIAL,20000,0,20000,106841,0,126841
142218202800000,SE 216,RESIDENTIAL,20000,0,20000,99825,0,119825
142218202900000,SE 216,RESIDENTIAL,20000,0,20000,101331,0,121331
142218203000000,SE 216,RESIDENTIAL,18560,0,18560,94952,0,113512
142218203100000,SE 216,RESIDENTIAL,18061,0,18061,139955,0,158016
142218203200000,SE 216,RESIDENTIAL,14245,0,14245,59570,0,73815
142218203300000,SE 216,RESIDENTIAL,13825,0,13825,102129,0,115954
142218300100000,SE 216,RESIDENTIAL,14880,0,14880,87257,0,102137
142218300200000,CHURCH,EXEMPT,0,18144,18144,0,131243,149387
142218300300000,SE 216,EXEMPT,0,11340,11340,0,64799,76139
142218300400000,SE 216,RESIDENTIAL,25000,0,25000,79387,0,104387
142218300500000,SE 216,RESIDENTIAL,21250,0,21250,82624,0,103874
142218300600000,SE 216,RESIDENTIAL,21250,0,21250,72137,0,93387
142218300700000,SE 216,RESIDENTIAL,20000,0,20000,97262,0,117262
142218300800000,SE 216,RESIDENTIAL,20000,0,20000,96709,0,116709
142218300900000,SE 216,RESIDENTIAL,20000,0,20000,96583,0,116583
142218301000000,SE 216,RESIDENTIAL,20000,0,20000,80579,0,100579
142218301100000,SE 216,RESIDENTIAL,14000,0,14000,90372,0,104372
142218301200000,SE 216,RESIDENTIAL,14000,0,14000,94993,0,108993
142218301300000,SE 216,RESIDENTIAL,7980,0,7980,98816,0,106796
142218301400000,SE 216,RESIDENTIAL,7980,0,7980,100195,0,108175
142218301500000,SE 216,RESIDENTIAL,7980,0,7980,81214,0,89194
142218301600000,SE 216,RESIDENTIAL,7980,0,7980,86807,0,94787
142218301700000,SE 216,RESIDENTIAL,14000,0,14000,109436,0,123436
142218301800000,SE 216,RESIDENTIAL,14000,0,14000,77514,0,91514
142218301900000,SE 216,RESIDENTIAL,20000,0,20000,62641,0,82641
142218302000000,SE 216,RESIDENTIAL,20000,0,20000,115528,0,135528
142218302100000,SE 216,RESIDENTIAL,20000,0,20000,95229,0,115229
142218302200000,SE 216,RESIDENTIAL,20250,0,20250,99206,0,119456
142218302300000,SE 216,RESIDENTIAL,20000,0,20000,80137,0,100137
142218302400000,SE 216,RESIDENTIAL,17500,0,17500,68452,0,85952
142218302500000,SE 216,RESIDENTIAL,20000,0,20000,89018,0,109018
142218302600000,SE 216,RESIDENTIAL,21250,0,21250,104507,0,125757
142218302700000,SE 216,RESIDENTIAL,21250,0,21250,84645,0,105895
142218302800000,SE 216,RESIDENTIAL,22500,0,22500,96488,0,118988
142218302900000,SE 216,RESIDENTIAL,14000,0,14000,73326,0,87326
142218303000000,SE 216,RESIDENTIAL,14000,0,14000,101132,0,115132
142218303100000,SE 216,RESIDENTIAL,13300,0,13300,102275,0,115575
142218303200000,SE 216,RESIDENTIAL,13300,0,13300,91135,0,104435
142218303300000,SE 216,RESIDENTIAL,13300,0,13300,104439,0,117739
142218303400000,SE 216,RESIDENTIAL,15390,0,15390,87521,0,102911
142220100100000,APARTMENT,COMMERCIAL,0,30000,30000,0,137551,167551
142220100200000,NE 155,RESIDENTIAL,12750,0,12750,76480,0,89230
142220100300000,NE 155,RESIDENTIAL,12750,0,12750,58193,0,70943
142220100400000,NE 155,RESIDENTIAL,10200,0,10200,60580,0,70780
142220100500000,NE 155,RESIDENTIAL,10200,0,10200,72246,0,82446
142220100600000,NE 155,RESIDENTIAL,10200,0,10200,75836,0,86036
142220100700000,NE 155,RESIDENTIAL,10200,0,10200,66069,0,76269
142220100800000,NE 155,RESIDENTIAL,10200,0,10200,84237,0,94437
142220100900000,NE 155,RESIDENTIAL,13005,0,13005,71103,0,84108
142220101000000,NE 155,RESIDENTIAL,10200,0,10200,63068,0,73268
142220101100000,NE 155,RESIDENTIAL,5400,0,5400,71934,0,77334
142220101200000,NE 155,RESIDENTIAL,6885,0,6885,32104,0,38989
142220101300000,CONVERSION,COMMERCIAL,0,8100,8100,0,55442,63542
142220101400000,CONVERSION,COMMERCIAL,0,8100,8100,0,65303,73403
142220101500000,OFFICE; MEDICAL,COMMERCIAL,0,206700,206700,0,686685,893385
142220101600000,OFFICE; MEDICAL,COMMERCIAL,0,309000,309000,0,1482500,1791500
142220200100000,NE 155,RESIDENTIAL,12500,0,12500,82034,0,94534
142220200200000,NE 155,RESIDENTIAL,12500,0,12500,76758,0,89258
142220200300000,NE 155,RESIDENTIAL,12500,0,12500,77745,0,90245
142220200400000,NE 155,RESIDENTIAL,10000,0,10000,78736,0,88736
142220200500000,NE 155,RESIDENTIAL,5250,0,5250,59982,0,65232
142220200600000,NE 155,RESIDENTIAL,5250,0,5250,40459,0,45709
142220200700000,NE 155,RESIDENTIAL,5425,0,5425,54611,0,60036
142220200800000,NE 155,RESIDENTIAL,5425,0,5425,61801,0,67226
142220200900000,NE 155,RESIDENTIAL,12500,0,12500,89519,0,102019
142220300100000,NE 156,RESIDENTIAL,10510,0,10510,49289,0,59799
142220300200000,NE 156,RESIDENTIAL,11972,0,11972,40140,0,52112
142220300300000,NE 156,RESIDENTIAL,11972,0,11972,37943,0,49915
142220300400000,NE 156,RESIDENTIAL,10950,0,10950,41473,0,52423
142220300500000,NE 156,RESIDENTIAL,10950,0,10950,39214,0,50164
142220300600000,NE 156,RESIDENTIAL,4644,0,4644,22931,0,27575
142220300700000,NE 156,RESIDENTIAL,8256,0,8256,35975,0,44231
142220300800000,NE 156,RESIDENTIAL,10827,0,10827,54211,0,65038
142220300900000,NE 156,RESIDENTIAL,16487,0,16487,6520,0,23007
142220301000000,NE 156,RESIDENTIAL,13770,0,13770,62604,0,76374
142220301100000,CONVERSION,COMMERCIAL,0,12150,12150,0,40922,53072
142220301200000,NE 156,RESIDENTIAL,20400,0,20400,45133,0,65533
142220301300000,NE 156,RESIDENTIAL,20400,0,20400,49890,0,70290
142220301400000,CONVERSION,COMMERCIAL,0,12150,12150,0,66010,78160
142220301500000,NE 156,RESIDENTIAL,20400,0,20400,62600,0,83000
142220301600000,NE 156,RESIDENTIAL,20400,0,20400,55096,0,75496
142220301700000,NE 156,RESIDENTIAL,20400,0,20400,16611,0,37011
142220302000000,NE 156,RESIDENTIAL,16320,0,16320,68951,0,85271
142220302100000,NE 156,RESIDENTIAL,20400,0,20400,69907,0,90307
142220302200000,NE 156,RESIDENTIAL,20400,0,20400,50372,0,70772
142220302300000,NE 156,RESIDENTIAL,20400,0,20400,54983,0,75383
142220302400000,NE 156,RESIDENTIAL,20400,0,20400,62146,0,82546
142220302500000,NE 156,RESIDENTIAL,20400,0,20400,64311,0,84711
142220302600000,CONVERSION,COMMERCIAL,0,12150,12150,0,80984,93134
142220302700000,NE 156,RESIDENTIAL,15137,0,15137,46032,0,61169
142220302800000,NE 156,RESIDENTIAL,15137,0,15137,49846,0,64983
142220302900000,NE 156,RESIDENTIAL,9936,0,9936,41034,0,50970
142220303100000,NE 156,RESIDENTIAL,21120,0,21120,85706,0,106826
142220303200000,LAUNDROMAT/CLEANERS,COMMERCIAL,0,36694,36694,0,186990,223684
142220400100000,NE 156,RESIDENTIAL,20800,0,20800,77439,0,98239
142220400200000,NE 156,RESIDENTIAL,19760,0,19760,60422,0,80182
142220400300000,CONVERSION,COMMERCIAL,0,11794,11794,0,67120,78914
142220400400000,CONVERSION,COMMERCIAL,0,11794,11794,0,55022,66816
142220400500000,NE 156,RESIDENTIAL,20140,0,20140,56139,0,76279
142220400600000,NE 156,RESIDENTIAL,20140,0,20140,44183,0,64323
142220400700000,NE 156,RESIDENTIAL,20140,0,20140,62794,0,82934
142220400800000,NE 156,RESIDENTIAL,18126,0,18126,48641,0,66767
142220400900000,NE 156,RESIDENTIAL,8151,0,8151,36879,0,45030
142220401000000,NE 156,RESIDENTIAL,6840,0,6840,34404,0,41244
142220401100000,NE 156,RESIDENTIAL,9120,0,9120,55617,0,64737
142220401200000,NE 156,RESIDENTIAL,14098,0,14098,50470,0,64568
142220401300000,NE 156,RESIDENTIAL,20140,0,20140,54078,0,74218
142220401400000,NE 156,RESIDENTIAL,20140,0,20140,58711,0,78851
142220401500000,NE 156,RESIDENTIAL,20140,0,20140,78933,0,99073
142220500100000,CITY PROPERTY,EXEMPT,0,0,0,0,0,0
142220500200000,NE 156,RESIDENTIAL,6580,0,6580,47179,0,53759
142220500300000,NE 156,RESIDENTIAL,6580,0,6580,44600,0,51180
142220500400000,NE 156,RESIDENTIAL,19760,0,19760,60282,0,80042
142220600100000,SE 231,RESIDENTIAL,8418,0,8418,40117,0,48535
142220600200000,SE 231,RESIDENTIAL,4568,0,4568,38417,0,42985
142220600300000,SE 231,RESIDENTIAL,8400,0,8400,41275,0,49675
142220600400000,SE 231,RESIDENTIAL,11460,0,11460,47537,0,58997
142220600500000,APARTMENT,COMMERCIAL,0,11200,11200,0,69543,80743
142220600600000,SE 231,RESIDENTIAL,9000,0,9000,38791,0,47791
142220600700000,SE 231,RESIDENTIAL,9000,0,9000,41959,0,50959
142220600801000,OFFICE,COMMERCIAL,0,68600,68600,0,230225,298825
142220600801001,OFFICE,COMMERCIAL,0,68600,68600,0,228653,297253
142220600900000,OFFICE; MEDICAL,COMMERCIAL,0,137200,137200,0,181408,318608
142220601000000,CONVERSION,COMMERCIAL,0,4536,4536,0,57868,62404
142220601100000,SE 231,RESIDENTIAL,9800,0,9800,59742,0,69542
142220601200000,SE 231,RESIDENTIAL,14000,0,14000,76489,0,90489
142220601300000,SE 231,RESIDENTIAL,14000,0,14000,64109,0,78109
142220601400000,SE 231,RESIDENTIAL,10500,0,10500,51529,0,62029
142220601500000,SE 231,RESIDENTIAL,10500,0,10500,56129,0,66629
142220601600000,SE 231,RESIDENTIAL,14000,0,14000,46975,0,60975
142220601700000,SE 231,RESIDENTIAL,14000,0,14000,62716,0,76716
142220601800000,SE 231,RESIDENTIAL,14000,0,14000,57378,0,71378
142220601900000,SE 231,RESIDENTIAL,14000,0,14000,68444,0,82444
142220602000000,SE 231,RESIDENTIAL,14000,0,14000,61407,0,75407
142220602100000,SE 231,RESIDENTIAL,17500,0,17500,44837,0,62337
142220700100000,OFFICE; MEDICAL,COMMERCIAL,0,606600,606600,0,2503286,3109886
142220700200000,APARTMENT,COMMERCIAL,0,15000,15000,0,88945,103945
142220700300000,NE 156,RESIDENTIAL,20400,0,20400,25333,0,45733
142220700400000,NE 156,RESIDENTIAL,7440,0,7440,44954,0,52394
142220700500000,NE 156,RESIDENTIAL,7440,0,7440,40839,0,48279
142220700600000,NE 156,RESIDENTIAL,9920,0,9920,54304,0,64224
142220700700000,NE 156,RESIDENTIAL,13024,0,13024,58868,0,71892
142220700800000,CONVERSION,COMMERCIAL,0,6480,6480,0,46932,53412
142220700900000,VACANT LAND,COMMERCIAL,0,6772,6772,0,0,6772
142220701000000,CONVERSION,COMMERCIAL,0,6000,6000,0,82012,88012
142220701100000,SMALL RETAIL,COMMERCIAL,0,64000,64000,0,80562,144562
142220701200000,RESTAURANT,COMMERCIAL,0,120000,120000,0,94944,214944
142220701300000,FLAT PARKING,COMMERCIAL,0,56000,56000,0,6132,62132
142220701400000,OFFICE,COMMERCIAL,0,52500,52500,0,145313,197813
142220800100000,NE 156,RESIDENTIAL,9920,0,9920,34770,0,44690
142220800200000,NE 156,RESIDENTIAL,11974,0,11974,34168,0,46142
142220800300000,NE 156,RESIDENTIAL,17600,0,17600,52773,0,70373
142220800400000,CONVERSION,COMMERCIAL,0,14580,14580,0,48296,62876
142220800500000,NE 156,RESIDENTIAL,22032,0,22032,53117,0,75149
142220800600000,NE 156,RESIDENTIAL,20400,0,20400,56275,0,76675
142220800700000,NE 156,RESIDENTIAL,20400,0,20400,64872,0,85272
142220800800000,NE 156,RESIDENTIAL,20000,0,20000,57003,0,77003
142220800900000,NE 156,RESIDENTIAL,20400,0,20400,68132,0,88532
142220801000000,NE 156,RESIDENTIAL,16000,0,16000,60320,0,76320
142220801100000,NE 156,RESIDENTIAL,16000,0,16000,53626,0,69626
142220801200000,CONVERSION,COMMERCIAL,0,9072,9072,0,19012,28084
142220801300000,NE 156,RESIDENTIAL,16000,0,16000,60025,0,76025
142220801400000,NE 156,RESIDENTIAL,16000,0,16000,37961,0,53961
142220801500000,NE 156,RESIDENTIAL,16465,0,16465,20546,0,37011
142220801600000,NE 156,RESIDENTIAL,14280,0,14280,53335,0,67615
142220801700000,CONVERSION,COMMERCIAL,0,10935,10935,0,46901,57836
142220801800000,NE 156,RESIDENTIAL,10560,0,10560,39760,0,50320
142220801900000,NE 156,EXEMPT,0,6600,6600,0,68787,75387
142220802000000,NE 156,RESIDENTIAL,9920,0,9920,57964,0,67884
142220900200000,SE 231,RESIDENTIAL,14000,0,14000,42867,0,56867
142220900300000,SE 231,RESIDENTIAL,14000,0,14000,48470,0,62470
142220900400000,SE 231,RESIDENTIAL,15708,0,15708,43931,0,59639
142220900500000,SE 231,RESIDENTIAL,8680,0,8680,43398,0,52078
142220900600000,SE 231,RESIDENTIAL,12152,0,12152,51575,0,63727
142220900700000,APARTMENT,COMMERCIAL,0,8400,8400,0,100366,108766
142221000100000,CONVERSION,COMMERCIAL,0,15552,15552,0,95546,111098
142221000200000,SE 231,RESIDENTIAL,9240,0,9240,45343,0,54583
142221000300000,SE 231,RESIDENTIAL,10500,0,10500,40582,0,51082
142221100100000,CONVERSION,COMMERCIAL,0,13608,13608,0,70809,84417
142221100200000,CONVENIENCE STORE,COMMERCIAL,0,112000,112000,0,206003,318003
142221100300000,FLAT PARKING,COMMERCIAL,0,44800,44800,0,10080,54880
142221100400000,SMALL RETAIL,COMMERCIAL,0,33600,33600,0,106321,139921
142221100500000,FAST FOOD,COMMERCIAL,0,117600,117600,0,210969,328569
142221100600000,CONVERSION,COMMERCIAL,0,3402,3402,0,67025,70427
142221100700000,VACANT LAND,COMMERCIAL,0,14280,14280,0,0,14280
142221100800000,SE 231,RESIDENTIAL,17850,0,17850,87539,0,105389
142221100900000,CONVERSION,COMMERCIAL,0,13608,13608,0,67988,81596
142221101000000,CONVERSION,COMMERCIAL,0,13608,13608,0,80669,94277
142221200100000,SE 231,RESIDENTIAL,1500,0,1500,0,0,1500
142221200200000,SE 231,RESIDENTIAL,2778,0,2778,0,0,2778
142221200300000,SMALL RETAIL,COMMERCIAL,0,21584,21584,0,49828,71412
142221200400000,SE 231,RESIDENTIAL,11349,0,11349,40664,0,52013
142221200500000,SMALL RETAIL,COMMERCIAL,0,43376,43376,0,127264,170640
142221200600000,SMALL RETAIL,COMMERCIAL,0,33600,33600,0,85244,118844
142221300100000,GROCERY STORE,COMMERCIAL,0,662900,662900,0,1124186,1787086
142221300500000,FLAT PARKING,COMMERCIAL,0,60200,60200,0,5658,65858
142221300600000,FAST FOOD,COMMERCIAL,0,420000,420000,0,731392,1151392
142221300700000,FLAT PARKING,COMMERCIAL,0,22500,22500,0,12847,35347
142221300800000,FLAT PARKING,COMMERCIAL,0,22500,22500,0,5067,27567
142221300900000,CONVERSION,COMMERCIAL,0,7290,7290,0,73712,81002
142221301000000,SMALL RETAIL,COMMERCIAL,0,7500,7500,0,91468,98968
142221301100000,CITY PROPERTY,EXEMPT,0,0,0,0,0,0
142221301200000,SMALL RETAIL,COMMERCIAL,0,90000,90000,0,244277,334277
142221301300000,SMALL RETAIL,COMMERCIAL,0,24000,24000,0,61231,85231
142221301400000,SMALL RETAIL,COMMERCIAL,0,24000,24000,0,62982,86982
142221301500000,SMALL RETAIL,COMMERCIAL,0,48000,48000,0,120249,168249
142222600100000,NE 156,RESIDENTIAL,8680,0,8680,55952,0,64632
142222600200000,NE 156,RESIDENTIAL,8680,0,8680,50367,0,59047
142222600300000,NE 156,RESIDENTIAL,7440,0,7440,49651,0,57091
142222600400000,NE 156,RESIDENTIAL,20000,0,20000,57483,0,77483
142222600500000,NE 156,RESIDENTIAL,16000,0,16000,52016,0,68016
142222600600000,NE 156,RESIDENTIAL,16000,0,16000,56133,0,72133
142222600700000,NE 156,RESIDENTIAL,12000,0,12000,56212,0,68212
142222600800000,NE 156,RESIDENTIAL,12000,0,12000,55028,0,67028
142222600900000,NE 156,RESIDENTIAL,12000,0,12000,56083,0,68083
142222601000000,NE 156,RESIDENTIAL,12000,0,12000,50049,0,62049
142222601100000,NE 156,RESIDENTIAL,12000,0,12000,46116,0,58116
142222601200000,NE 156,RESIDENTIAL,12000,0,12000,36218,0,48218
142222601300000,NE 156,RESIDENTIAL,16000,0,16000,47661,0,63661
142222601400000,NE 156,RESIDENTIAL,11200,0,11200,40385,0,51585
142222601500000,NE 156,RESIDENTIAL,11200,0,11200,50237,0,61437
142222601600000,NE 156,RESIDENTIAL,10640,0,10640,43789,0,54429
142222601700000,NE 156,RESIDENTIAL,10640,0,10640,46741,0,57381
142222601800000,NE 156,RESIDENTIAL,11200,0,11200,53449,0,64649
142222601900000,CONVERSION,COMMERCIAL,0,12960,12960,0,49062,62022
142222602000000,NE 156,RESIDENTIAL,20000,0,20000,21978,0,41978
142222602100000,NE 156,RESIDENTIAL,13600,0,13600,57150,0,70750
142222602200000,NE 156,RESIDENTIAL,10400,0,10400,67976,0,78376
142222602300000,NE 156,RESIDENTIAL,12000,0,12000,49605,0,61605
142222602400000,NE 156,RESIDENTIAL,14000,0,14000,65356,0,79356
142222602500000,NE 156,RESIDENTIAL,14000,0,14000,54537,0,68537
142222602600000,NE 156,RESIDENTIAL,16000,0,16000,47377,0,63377
142222602700000,NE 156,RESIDENTIAL,16000,0,16000,56201,0,72201
142222602800000,NE 156,RESIDENTIAL,12000,0,12000,59869,0,71869
142222602900000,NE 156,RESIDENTIAL,12000,0,12000,41883,0,53883
142222603000000,NE 156,RESIDENTIAL,12000,0,12000,45647,0,57647
142222603100000,NE 156,RESIDENTIAL,12000,0,12000,42497,0,54497
142222603200000,NE 156,RESIDENTIAL,12000,0,12000,44726,0,56726
142222603300000,NE 156,RESIDENTIAL,12000,0,12000,48121,0,60121
142222700100000,NE 156,RESIDENTIAL,12000,0,12000,51800,0,63800
142222700200000,NE 156,RESIDENTIAL,12000,0,12000,43442,0,55442
142222700300000,NE 156,RESIDENTIAL,12000,0,12000,36040,0,48040
142222700400000,NE 156,RESIDENTIAL,8453,0,8453,43500,0,51953
142222700500000,NE 156,RESIDENTIAL,13627,0,13627,40393,0,54020
142222700600000,NE 156,RESIDENTIAL,7688,0,7688,38915,0,46603
142222800100000,EDUCATIONAL/COLLEGE,EXEMPT,0,443988,443988,0,393386,837374
142222900100000,NE 156,RESIDENTIAL,19200,0,19200,47587,0,66787
142223000100000,NE 156,RESIDENTIAL,11760,0,11760,35565,0,47325
142223000200000,NE 156,RESIDENTIAL,15200,0,15200,61891,0,77091
142223000300000,NE 156,RESIDENTIAL,16000,0,16000,59633,0,75633
142223000400000,NE 156,RESIDENTIAL,13800,0,13800,43824,0,57624
142223000500000,NE 156,RESIDENTIAL,13700,0,13700,41300,0,55000
142223000600000,SCHOOL,EXEMPT,0,0,0,0,0,0
142223000700000,SCHOOL,EXEMPT,0,0,0,0,0,0
142223000800000,CITY PROPERTY,EXEMPT,0,0,0,0,0,0
142223000900000,SCHOOL,EXEMPT,0,0,0,0,0,0
142223001000000,NE 156,RESIDENTIAL,12000,0,12000,41648,0,53648
142223001100000,NE 156,RESIDENTIAL,16000,0,16000,67460,0,83460
142223001200000,NE 156,RESIDENTIAL,20400,0,20400,102540,0,122940
142223100100000,NE 156,RESIDENTIAL,20924,0,20924,68190,0,89114
142223100200000,NE 156,RESIDENTIAL,20400,0,20400,58297,0,78697
142223100300000,NE 156,RESIDENTIAL,20400,0,20400,63027,0,83427
142223100400000,NE 156,RESIDENTIAL,20400,0,20400,63175,0,83575
142223100500000,NE 156,RESIDENTIAL,14892,0,14892,54213,0,69105
142223100600000,NE 156,RESIDENTIAL,8184,0,8184,54698,0,62882
142223100700000,NE 156,RESIDENTIAL,8060,0,8060,58415,0,66475
142223100800000,NE 156,RESIDENTIAL,9800,0,9800,51891,0,61691
142223100900000,NE 156,RESIDENTIAL,9800,0,9800,53518,0,63318
142223101000000,NE 156,RESIDENTIAL,15680,0,15680,51125,0,66805
142223101100000,NE 156,RESIDENTIAL,16000,0,16000,68523,0,84523
142223101200000,NE 156,RESIDENTIAL,16000,0,16000,46487,0,62487
142223200100000,APARTMENT,EXEMPT,0,9720,9720,0,84037,93757
142223200200000,NE 156,EXEMPT,0,6200,6200,0,68576,74776
142223200300000,VACANT LAND,EXEMPT,0,13608,13608,0,0,13608
142223200400000,NE 156,EXEMPT,0,36288,36288,0,96892,133180
142223200500000,NE 156,EXEMPT,0,16800,16800,0,0,16800
142223200600000,NE 156,EXEMPT,0,16800,16800,0,0,16800
142223200700000,NE 156,EXEMPT,0,16800,16800,0,0,16800
142223200800000,NE 156,EXEMPT,0,16800,16800,0,0,16800
142223200900000,VACANT LAND,EXEMPT,0,18144,18144,0,0,18144
142223201000000,NE 156,EXEMPT,0,16800,16800,0,0,16800
142223201100000,VACANT LAND,EXEMPT,0,18144,18144,0,0,18144
142223201200000,VACANT LAND,EXEMPT,0,18144,18144,0,0,18144
142223201300000,VACANT LAND,EXEMPT,0,17626,17626,0,0,17626
142223201400000,VACANT LAND,EXEMPT,0,11146,11146,0,0,11146
142223201500000,VACANT LAND,EXEMPT,0,4536,4536,0,0,4536
142223201600000,VACANT LAND,EXEMPT,0,8294,8294,0,0,8294
142223201700000,NE 156,RESIDENTIAL,14440,0,14440,45415,0,59855
142223201800000,CONVERSION,COMMERCIAL,0,13608,13608,0,62607,76215
142223201900000,NE 156,RESIDENTIAL,24000,0,24000,71003,0,95003
142223202000000,NE 156,RESIDENTIAL,16000,0,16000,65083,0,81083
142223202100000,VACANT LAND,EXEMPT,0,18144,18144,0,0,18144
142223202200000,CITY PROPERTY,EXEMPT,0,0,0,0,0,0
142223202300000,CITY PROPERTY,EXEMPT,0,0,0,0,0,0
142223202400000,VACANT LAND,EXEMPT,0,6804,6804,0,0,6804
142223202500000,NE 156,RESIDENTIAL,12000,0,12000,60770,0,72770
142223202600000,VACANT LAND,EXEMPT,0,7350,7350,0,0,7350
142223202700000,VACANT LAND,EXEMPT,0,7350,7350,0,0,7350
142223300100000,VACANT LAND,EXEMPT,0,9126,9126,0,0,9126
142223300200000,VACANT LAND,EXEMPT,0,6845,6845,0,0,6845
142223300300000,EDUCATIONAL/COLLEGE,EXEMPT,0,19440,19440,0,0,19440
142223300400000,VACANT LAND,EXEMPT,0,26163,26163,0,0,26163
142223400100000,VACANT LAND,EXEMPT,0,6804,6804,0,0,6804
142223400200000,VACANT LAND,EXEMPT,0,6804,6804,0,0,6804
142223400300000,VACANT LAND,EXEMPT,0,5163,5163,0,0,5163
142223400400000,VACANT LAND,EXEMPT,0,12096,12096,0,0,12096
142223400500000,NE 156,RESIDENTIAL,10640,0,10640,49273,0,59913
142223400600000,SMALL RETAIL,COMMERCIAL,0,8400,8400,0,38240,46640
142223400700000,VACANT LAND,EXEMPT,0,6700,6700,0,0,6700
142223400800000,NE 156,RESIDENTIAL,16000,0,16000,53171,0,69171
142223400900000,VACANT LAND,EXEMPT,0,18144,18144,0,0,18144
142223401000000,VACANT LAND,EXEMPT,0,24192,24192,0,0,24192
142223401100000,NE 156,RESIDENTIAL,16000,0,16000,65497,0,81497
142223401200000,VACANT LAND,EXEMPT,0,9800,9800,0,0,9800
142223401300000,VACANT LAND,EXEMPT,0,86022,86022,0,0,86022
142223401600000,NE 156,RESIDENTIAL,11780,0,11780,68642,0,80422
142223402000000,VACANT LAND,EXEMPT,0,72576,72576,0,0,72576
142223402100000,NE 156,RESIDENTIAL,20400,0,20400,64578,0,84978
142223402200000,NE 156,RESIDENTIAL,20400,0,20400,76794,0,97194
142223402300000,CONVERSION,COMMERCIAL,0,13608,13608,0,52041,65649
142223402400000,VACANT LAND,EXEMPT,0,9800,9800,0,0,9800
142223402500000,VACANT LAND,EXEMPT,0,9526,9526,0,0,9526
142223402600000,VACANT LAND,EXEMPT,0,22982,22982,0,0,22982
142223402700000,NE 156,EXEMPT,0,5250,5250,0,0,5250
142223500100000,NE 156,RESIDENTIAL,16000,0,16000,50762,0,66762
142225100100000,CONVENIENCE STORE,COMMERCIAL,0,291200,291200,0,343129,634329
142225100200000,VACANT LAND,EXEMPT,0,72576,72576,0,3294,75870
142225100400000,VACANT LAND,EXEMPT,0,36288,36288,0,0,36288
142225101000000,OFFICE; MEDICAL,COMMERCIAL,0,13650,13650,0,110251,123901
142225101100000,SMALL RETAIL,COMMERCIAL,0,40500,40500,0,58051,98551
142225101200000,CONVERSION,COMMERCIAL,0,13608,13608,0,100458,114066
142225101400000,OFFICE,COMMERCIAL,0,191520,191520,0,497188,688708
142225101600000,FLAT PARKING,COMMERCIAL,0,29400,29400,0,8480,37880
142225101700000,EDUCATIONAL/COLLEGE,EXEMPT,0,72576,72576,0,0,72576
142225300100000,APARTMENT,EXEMPT,0,1191510,1191510,0,3847054,5038564
142225300200000,HOTEL,EXEMPT,0,290304,290304,0,1014392,1304696
142225300300000,APARTMENT,EXEMPT,0,266112,266112,0,1194091,1460203
142225300400000,FLAT PARKING,EXEMPT,0,181440,181440,0,15120,196560
142225300500000,FLAT PARKING,COMMERCIAL,0,56000,56000,0,4480,60480
142225300600000,FAST FOOD,COMMERCIAL,0,196000,196000,0,412340,608340
142225301200000,SMALL RETAIL,COMMERCIAL,0,126000,126000,0,160687,286687
142225301300000,VACANT LAND,COMMERCIAL,0,42000,42000,0,0,42000
142225301400000,OFFICE,COMMERCIAL,0,84000,84000,0,162795,246795
142225400100000,FAST FOOD,COMMERCIAL,0,151200,151200,0,467289,618489
142225400200000,RESTAURANT,COMMERCIAL,0,85320,85320,0,95209,180529
142225400300000,OFFICE,COMMERCIAL,0,25620,25620,0,163876,189496
142225400400000,APARTMENT,COMMERCIAL,0,35996,35996,0,1153586,1189582
142225500100000,CONVERSION,COMMERCIAL,0,8165,8165,0,73440,81605
142225500200000,OFFICE; MEDICAL,COMMERCIAL,0,11760,11760,0,107536,119296
142225500300000,RESTAURANT,COMMERCIAL,0,252000,252000,0,460221,712221
142225500400000,RESTAURANT,COMMERCIAL,0,126000,126000,0,191394,317394
142225500500000,CARWASH,COMMERCIAL,0,126000,126000,0,100032,226032
142225500502000,BILLBOARD(BLL),COMMERCIAL,0,0,0,0,27565,27565
142225500600000,BRANCH BANK/CU,COMMERCIAL,0,201600,201600,0,520702,722302
142225500700000,OFFICE; MEDICAL,COMMERCIAL,0,67200,67200,0,354649,421849
142225500800000,APARTMENT,RESIDENTIAL,42000,0,42000,308323,0,350323
142225500900000,OFFICE,EXEMPT,0,90720,90720,0,344041,434761
142225600100000,APARTMENT,COMMERCIAL,0,17640,17640,0,283115,300755
142225600200000,APARTMENT,COMMERCIAL,0,15960,15960,0,206508,222468
142225601200000,CONVERSION,COMMERCIAL,0,9072,9072,0,51939,61011
142225601300000,CONVERSION,COMMERCIAL,0,12474,12474,0,68683,81157
142225601400000,CONVERSION,COMMERCIAL,0,11340,11340,0,58419,69759
142225601500000,SE 232,EXEMPT,0,12500,12500,0,49209,61709
142225601600000,CHURCH,EXEMPT,0,24192,24192,0,5170,29362
142225601800000,CHURCH,EXEMPT,0,370980,370980,0,3198234,3569214
142225601900000,VACANT LAND,EXEMPT,0,12442,12442,0,4463,16905
142225700100000,OFFICE; MEDICAL,COMMERCIAL,0,100800,100800,0,859822,960622
142225700200000,SMALL RETAIL,COMMERCIAL,0,100800,100800,0,104407,205207
142225700202000,BILLBOARD(BLL),COMMERCIAL,0,0,0,0,39826,39826
142225700300000,APARTMENT,EXEMPT,0,27216,27216,0,543523,570739
142225700400000,FLAT PARKING,COMMERCIAL,0,70000,70000,0,5600,75600
142225700500000,OFFICE,COMMERCIAL,0,140000,140000,0,100154,240154
142225700600000,SMALL RETAIL,COMMERCIAL,0,84000,84000,0,259537,343537
142225700700000,SMALL RETAIL,COMMERCIAL,0,60984,60984,0,239173,300157
142225700800000,OFFICE,COMMERCIAL,0,51016,51016,0,123823,174839
142225700900000,OFFICE,COMMERCIAL,0,42000,42000,0,75026,117026
142225701000000,SMALL RETAIL,COMMERCIAL,0,70000,70000,0,93439,163439
142225701100000,SE 231,RESIDENTIAL,26040,0,26040,134303,0,160343
142225701200000,FLAT PARKING,COMMERCIAL,0,33600,33600,0,5831,39431
142225800100000,FLAT PARKING,COMMERCIAL,0,74050,74050,0,6150,80200
142227600100000,CONVERSION,COMMERCIAL,0,13608,13608,0,205713,219321
142227600200000,SE 231,RESIDENTIAL,14000,0,14000,60115,0,74115
142227600300000,SE 231,RESIDENTIAL,14000,0,14000,66502,0,80502
142227600400000,SE 231,RESIDENTIAL,14000,0,14000,50852,0,64852
142227600500000,SE 231,RESIDENTIAL,11067,0,11067,45770,0,56837
142227600600000,SE 231,RESIDENTIAL,9765,0,9765,49300,0,59065
142227600700000,SE 231,RESIDENTIAL,7595,0,7595,45177,0,52772
142227600800000,CONVERSION,COMMERCIAL,0,18144,18144,0,78479,96623
142227600900000,SE 231,RESIDENTIAL,18000,0,18000,93643,0,111643
142227700100000,OFFICE,COMMERCIAL,0,29400,29400,0,175055,204455
142227700200000,CONVERSION,EXEMPT,0,36288,36288,0,141171,177459
142227700300000,CONVERSION,COMMERCIAL,0,13608,13608,0,81839,95447
142227700500000,SMALL RETAIL,COMMERCIAL,0,89600,89600,0,76793,166393
142227700600000,VACANT LAND,COMMERCIAL,0,15000,15000,0,0,15000
142227700700000,SMALL RETAIL,COMMERCIAL,0,38976,38976,0,70087,109063
142227700800000,SMALL RETAIL,COMMERCIAL,0,33600,33600,0,81410,115010
142227700900000,SMALL RETAIL,COMMERCIAL,0,33600,33600,0,59767,93367
142227701000000,SMALL RETAIL,COMMERCIAL,0,84000,84000,0,285971,369971
142227701100000,OFFICE,COMMERCIAL,0,144600,144600,0,431170,575770
142227701200000,OFFICE,COMMERCIAL,0,78400,78400,0,222510,300910
142227800100000,CITY PROPERTY,EXEMPT,0,0,0,0,0,0
142227900100000,SE 231,RESIDENTIAL,14280,0,14280,54667,0,68947
142227900200000,SE 231,RESIDENTIAL,11338,0,11338,48482,0,59820
142227900300000,SE 231,EXEMPT,0,5425,5425,0,68766,74191
142227900400000,SE 231,RESIDENTIAL,7595,0,7595,41069,0,48664
142227900500000,SE 231,RESIDENTIAL,7704,0,7704,54567,0,62271
142227900600000,SE 231,RESIDENTIAL,7595,0,7595,59045,0,66640
142227900700000,SE 231,RESIDENTIAL,10500,0,10500,0,0,10500
142227900800000,SE 231,RESIDENTIAL,10500,0,10500,35958,0,46458
142227900900000,SE 231,RESIDENTIAL,17583,0,17583,65809,0,83392
142227901000000,SE 231,RESIDENTIAL,17850,0,17850,40699,0,58549
142227901100000,SE 231,RESIDENTIAL,17850,0,17850,69343,0,87193
142227901200000,CONVERSION,COMMERCIAL,0,6300,6300,0,40734,47034
142227901300000,SE 231,RESIDENTIAL,10500,0,10500,37650,0,48150
142227901400000,CONVERSION,COMMERCIAL,0,13608,13608,0,80281,93889
142227901500000,CONVERSION,COMMERCIAL,0,13608,13608,0,73645,87253
142227901600000,SE 231,RESIDENTIAL,10720,0,10720,67757,0,78477
142227901700000,SE 231,RESIDENTIAL,17220,0,17220,94919,0,112139
142227901800000,CONVERSION,COMMERCIAL,0,13608,13608,0,62566,76174
142227901900000,SE 231,RESIDENTIAL,10500,0,10500,57319,0,67819
142227902000000,SE 231,RESIDENTIAL,10500,0,10500,52819,0,63319
142227902100000,SE 231,RESIDENTIAL,17850,0,17850,55553,0,73403
142227902200000,SE 231,RESIDENTIAL,17850,0,17850,78931,0,96781
142227902300000,APARTMENT,RESIDENTIAL,16800,0,16800,72051,0,88851
142227902400000,SE 231,RESIDENTIAL,17850,0,17850,40399,0,58249
142228000100000,OFFICE; MEDICAL,COMMERCIAL,0,67200,67200,0,255816,323016
142228000200000,CONVERSION,COMMERCIAL,0,3686,3686,0,31403,35089
142228000300000,CONVERSION,COMMERCIAL,0,3686,3686,0,34249,37935
142228000400000,SMALL RETAIL,COMMERCIAL,0,28000,28000,0,79425,107425
142228000500000,SMALL RETAIL,COMMERCIAL,0,17500,17500,0,53680,71180
142228000600000,CONVERSION,COMMERCIAL,0,7938,7938,0,55639,63577
142228000700000,RESTAURANT,COMMERCIAL,0,100800,100800,0,87640,188440
142228000800000,FLAT PARKING,COMMERCIAL,0,75600,75600,0,13776,89376
142228000900000,FLAT PARKING,COMMERCIAL,0,25712,25712,0,8400,34112
142228001000000,FLAT PARKING,COMMERCIAL,0,15427,15427,0,4800,20227
142228001100000,OFFICE,COMMERCIAL,0,26880,26880,0,50621,77501
142228100100000,SE 231,RESIDENTIAL,7350,0,7350,70871,0,78221
142228100200000,SE 231,RESIDENTIAL,7350,0,7350,61498,0,68848
142228100300000,SE 231,RESIDENTIAL,14000,0,14000,54269,0,68269
142228100400000,SE 231,RESIDENTIAL,13821,0,13821,45690,0,59511
142228100500000,SE 231,RESIDENTIAL,13967,0,13967,38574,0,52541
142228100600000,SE 231,RESIDENTIAL,17850,0,17850,59753,0,77603
142228100700000,SE 231,RESIDENTIAL,15750,0,15750,57961,0,73711
142228100800000,SE 231,RESIDENTIAL,15750,0,15750,58512,0,74262
142228100900000,SE 231,RESIDENTIAL,17500,0,17500,65616,0,83116
142228101000000,SE 231,RESIDENTIAL,14000,0,14000,59891,0,73891
142228101100000,SE 231,RESIDENTIAL,14211,0,14211,51822,0,66033
142228101200000,SE 231,RESIDENTIAL,13216,0,13216,71988,0,85204
142228101300000,CONVERSION,COMMERCIAL,0,4253,4253,0,53123,57376
142228101400000,CONVERSION,COMMERCIAL,0,6736,6736,0,64343,71079
142228101500000,SE 231,RESIDENTIAL,15960,0,15960,61939,0,77899
142228101600000,SE 231,RESIDENTIAL,19927,0,19927,54383,0,74310
142228101700000,SE 231,RESIDENTIAL,7980,0,7980,47273,0,55253
142228101800000,SE 231,RESIDENTIAL,10780,0,10780,42845,0,53625
142228101900000,SE 231,RESIDENTIAL,17290,0,17290,67246,0,84536
142228102000000,APARTMENT,COMMERCIAL,0,16800,16800,0,94123,110923
142228102100000,SE 231,RESIDENTIAL,14000,0,14000,64571,0,78571
142228102200000,SE 231,RESIDENTIAL,14000,0,14000,55746,0,69746
142228102300000,SE 231,RESIDENTIAL,14000,0,14000,45657,0,59657
142228102400000,SE 231,RESIDENTIAL,10500,0,10500,53605,0,64105
142228102500000,SE 231,RESIDENTIAL,10500,0,10500,55887,0,66387
142228102600000,SE 231,RESIDENTIAL,10500,0,10500,40331,0,50831
142228102700000,SE 231,RESIDENTIAL,10500,0,10500,33623,0,44123
142228102800000,CONVERSION,COMMERCIAL,0,13608,13608,0,102268,115876
142228102900000,SE 231,RESIDENTIAL,6899,0,6899,45868,0,52767
142228103000000,SE 231,RESIDENTIAL,8432,0,8432,58172,0,66604
142228103100000,SE 231,RESIDENTIAL,7161,0,7161,49548,0,56709
142228103200000,SE 231,RESIDENTIAL,7161,0,7161,48422,0,55583
142228103300000,SE 231,RESIDENTIAL,7378,0,7378,54800,0,62178
142228103400000,SE 231,RESIDENTIAL,7812,0,7812,46008,0,53820
142228200100000,CITY PROPERTY,EXEMPT,0,0,0,0,0,0
142228300100000,SE 231,RESIDENTIAL,7350,0,7350,52378,0,59728
142228300200000,SE 231,RESIDENTIAL,7595,0,7595,36979,0,44574
142228300300000,SE 231,RESIDENTIAL,7595,0,7595,35654,0,43249
142228300400000,APARTMENT,COMMERCIAL,0,7840,7840,0,39771,47611
142228300500000,CONVERSION,COMMERCIAL,0,9526,9526,0,70562,80088
142228300600000,CONVERSION,COMMERCIAL,0,11340,11340,0,59585,70925
142228300700000,SE 231,RESIDENTIAL,10500,0,10500,32009,0,42509
142228300800000,SE 231,RESIDENTIAL,10500,0,10500,52364,0,62864
142228300900000,CONVERSION,COMMERCIAL,0,13608,13608,0,48711,62319
142228301000000,CONVERSION,COMMERCIAL,0,9072,9072,0,42975,52047
142228301100000,FLAT PARKING,EXEMPT,0,48384,48384,0,14440,62824
142228301200000,CONVERSION,COMMERCIAL,0,13608,13608,0,46735,60343
142228301300000,SE 231,RESIDENTIAL,17850,0,17850,98564,0,116414
142228301400000,FLAT PARKING,EXEMPT,0,72576,72576,0,14640,87216
142228301500000,FLAT PARKING,EXEMPT,0,36288,36288,0,9243,45531
142228301600000,CONVERSION,COMMERCIAL,0,9072,9072,0,63974,73046
142228301700000,SE 231,RESIDENTIAL,14000,0,14000,0,0,14000
142228301800000,SE 231,RESIDENTIAL,14000,0,14000,48381,0,62381
142228301900000,SE 231,RESIDENTIAL,10500,0,10500,53705,0,64205
142228302000000,SE 231,RESIDENTIAL,11046,0,11046,49210,0,60256
142228302100000,SE 231,RESIDENTIAL,20832,0,20832,50630,0,71462
142228302200000,SE 231,RESIDENTIAL,7350,0,7350,48373,0,55723
142228400100000,SE 231,RESIDENTIAL,13545,0,13545,32105,0,45650
142228400200000,SE 231,RESIDENTIAL,11515,0,11515,28485,0,40000
142228400300000,SE 231,RESIDENTIAL,10500,0,10500,53693,0,64193
142228400400000,SE 231,RESIDENTIAL,9800,0,9800,41130,0,50930
142228400500000,SE 231,RESIDENTIAL,14700,0,14700,38191,0,52891
142228400600000,SE 231,RESIDENTIAL,17850,0,17850,56517,0,74367
142228400700000,SE 231,RESIDENTIAL,14000,0,14000,61015,0,75015
142228400800000,SE 231,RESIDENTIAL,14000,0,14000,59359,0,73359
142228400900000,SE 231,RESIDENTIAL,14000,0,14000,38496,0,52496
142228401000000,SE 231,RESIDENTIAL,14000,0,14000,52447,0,66447
142228401100000,SE 231,RESIDENTIAL,14000,0,14000,44231,0,58231
142228401200000,CONVERSION,COMMERCIAL,0,9072,9072,0,68018,77090
142228401300000,SE 231,RESIDENTIAL,17850,0,17850,35725,0,53575
142228401400000,SE 231,RESIDENTIAL,7350,0,7350,55103,0,62453
142228401500000,SE 231,RESIDENTIAL,7350,0,7350,48924,0,56274
142228401600000,SE 231,EXEMPT,0,7595,7595,0,24588,32183
142228401700000,SE 231,RESIDENTIAL,7595,0,7595,38069,0,45664
142228401800000,SE 231,RESIDENTIAL,7702,0,7702,44271,0,51973
142228401900000,SE 231,RESIDENTIAL,7595,0,7595,42302,0,49897
142228402000000,SE 231,RESIDENTIAL,7350,0,7350,41796,0,49146
142228402100000,SE 231,EXEMPT,0,5250,5250,54180,0,59430
142228402200000,SE 231,RESIDENTIAL,17850,0,17850,50945,0,68795
142228402300000,SE 231,RESIDENTIAL,10500,0,10500,52866,0,63366
142228402400000,SE 231,RESIDENTIAL,10500,0,10500,53634,0,64134
142228402500000,SE 231,RESIDENTIAL,10500,0,10500,47607,0,58107
142228402600000,SE 231,RESIDENTIAL,12250,0,12250,58821,0,71071
142228402700000,SE 231,RESIDENTIAL,12250,0,12250,49167,0,61417
142228402800000,SE 231,RESIDENTIAL,14000,0,14000,73186,0,87186
142228402900000,SE 231,RESIDENTIAL,14000,0,14000,53546,0,67546
142228403000000,SE 231,RESIDENTIAL,14000,0,14000,49228,0,63228
142228403100000,CONVERSION,EXEMPT,0,8400,8400,0,6683,15083
142228403200000,SE 231,RESIDENTIAL,14119,0,14119,39972,0,54091
142228403300000,SE 231,RESIDENTIAL,14000,0,14000,58895,0,72895
142228403400000,SE 231,RESIDENTIAL,9450,0,9450,49235,0,58685
142228403500000,SE 231,RESIDENTIAL,12250,0,12250,81713,0,93963
142228403600000,SE 231,RESIDENTIAL,7595,0,7595,47646,0,55241
142228403700000,SE 231,RESIDENTIAL,7595,0,7595,45850,0,53445
142228403800000,SE 231,RESIDENTIAL,9765,0,9765,43177,0,52942
142228500100000,CONVERSION,COMMERCIAL,0,7517,7517,0,80544,88061
142228500200000,SE 231,RESIDENTIAL,11445,0,11445,23006,0,34451
142228500300000,SE 231,RESIDENTIAL,17675,0,17675,35642,0,53317
142228500400000,SE 231,RESIDENTIAL,17290,0,17290,48346,0,65636
142228500500000,SE 231,RESIDENTIAL,10500,0,10500,50274,0,60774
142228500600000,SE 231,RESIDENTIAL,6912,0,6912,39131,0,46043
142228500700000,SE 231,RESIDENTIAL,10859,0,10859,11011,0,21870
142228500800000,SE 231,RESIDENTIAL,10290,0,10290,38321,0,48611
142228500900000,SE 231,EXEMPT,0,6471,6471,0,40395,46866
142228501000000,SE 231,RESIDENTIAL,9252,0,9252,35955,0,45207
142228501100000,SE 231,EXEMPT,0,7260,7260,19336,0,26596
142228501200000,APARTMENT,EXEMPT,0,8751,8751,0,136537,145288
142228501300000,SE 231,EXEMPT,0,6490,6490,0,0,6490
142228501400000,SE 231,EXEMPT,0,4000,4000,0,0,4000
142228501500000,SE 231,RESIDENTIAL,14000,0,14000,51833,0,65833
142228501600000,SE 231,RESIDENTIAL,14000,0,14000,48089,0,62089
142228501700000,SE 231,RESIDENTIAL,10500,0,10500,43245,0,53745
142228501800000,SE 231,RESIDENTIAL,10500,0,10500,45002,0,55502
142228501900000,SE 231,RESIDENTIAL,14000,0,14000,26676,0,40676
142228502000000,SE 231,RESIDENTIAL,14000,0,14000,45403,0,59403
142228502100000,SE 231,RESIDENTIAL,17500,0,17500,56067,0,73567
142228502200000,SE 231,RESIDENTIAL,17066,0,17066,46342,0,63408
142228502300000,CONVERSION,EXEMPT,0,6026,6026,0,82402,88428
142228502400000,SE 231,RESIDENTIAL,8680,0,8680,0,0,8680
142228502500000,SE 231,EXEMPT,0,6200,6200,39396,0,45596
142228502600000,SE 231,RESIDENTIAL,7812,0,7812,68061,0,75873
142230100100000,CONVERSION,COMMERCIAL,0,5511,5511,0,61444,66955
142230100200000,CONVERSION,COMMERCIAL,0,5511,5511,0,61900,67411
142230100300000,SE 231,RESIDENTIAL,14000,0,14000,49032,0,63032
142230100400000,SE 231,RESIDENTIAL,14000,0,14000,56408,0,70408
142230100500000,SE 231,EXEMPT,0,12600,12600,49754,0,62354
142230100600000,SE 231,RESIDENTIAL,14000,0,14000,62597,0,76597
142230100700000,SE 231,RESIDENTIAL,14000,0,14000,54062,0,68062
142230100800000,SE 231,RESIDENTIAL,14000,0,14000,63949,0,77949
142230100900000,SE 231,RESIDENTIAL,14000,0,14000,52012,0,66012
142230101000000,SE 231,RESIDENTIAL,14000,0,14000,9592,0,23592
142230101100000,SE 231,RESIDENTIAL,14000,0,14000,71951,0,85951
142230101200000,SE 231,RESIDENTIAL,14000,0,14000,59398,0,73398
142230101300000,SE 231,RESIDENTIAL,14000,0,14000,44814,0,58814
142230101400000,SE 231,RESIDENTIAL,14000,0,14000,46559,0,60559
142230101500000,SE 231,RESIDENTIAL,14000,0,14000,65344,0,79344
142230101600000,SE 231,RESIDENTIAL,13030,0,13030,57038,0,70068
142230101700000,SE 231,EXEMPT,0,5038,5038,31781,0,36819
142230101800000,SE 231,RESIDENTIAL,7053,0,7053,39555,0,46608
142230101900000,SE 231,RESIDENTIAL,7378,0,7378,0,0,7378
142230102000000,SE 231,EXEMPT,0,7378,7378,0,34259,41637
142230102100000,SE 231,RESIDENTIAL,7455,0,7455,41984,0,49439
142230102200000,SE 231,RESIDENTIAL,7455,0,7455,48887,0,56342
142230102300000,SE 231,RESIDENTIAL,14000,0,14000,30708,0,44708
142230102400000,SE 231,RESIDENTIAL,14000,0,14000,58770,0,72770
142230102500000,SE 231,EXEMPT,0,10000,10000,0,56108,66108
142230102600000,SE 231,RESIDENTIAL,17850,0,17850,58371,0,76221
142230102700000,SE 231,RESIDENTIAL,14000,0,14000,59598,0,73598
142230102800000,SE 231,RESIDENTIAL,17500,0,17500,71268,0,88768
142230102900000,CONVERSION,COMMERCIAL,0,11340,11340,0,69426,80766
142230103000000,SE 231,RESIDENTIAL,14000,0,14000,50369,0,64369
142230103100000,SE 231,RESIDENTIAL,14000,0,14000,63936,0,77936
142230103200000,SE 231,RESIDENTIAL,14000,0,14000,43092,0,57092
142230103300000,SE 231,RESIDENTIAL,14000,0,14000,49264,0,63264
142230103400000,SE 231,RESIDENTIAL,18544,0,18544,50549,0,69093
142230103500000,SE 231,EXEMPT,0,5475,5475,0,41705,47180
142230103600000,SE 231,RESIDENTIAL,8185,0,8185,58204,0,66389
142230103700000,SE 231,EXEMPT,0,5038,5038,50175,0,55213
142230103800000,SE 231,RESIDENTIAL,6939,0,6939,42067,0,49006
142230103900000,SE 231,RESIDENTIAL,7508,0,7508,53466,0,60974
142230200100000,SE 231,RESIDENTIAL,11067,0,11067,57385,0,68452
142230200200000,SE 231,EXEMPT,0,10000,10000,40489,0,50489
142230200300000,SE 231,RESIDENTIAL,14000,0,14000,51043,0,65043
142230200400000,SE 231,RESIDENTIAL,14000,0,14000,55320,0,69320
142230200500000,SE 231,RESIDENTIAL,10500,0,10500,50813,0,61313
142230200600000,SE 231,RESIDENTIAL,10500,0,10500,40396,0,50896
142230200700000,SE 231,RESIDENTIAL,10500,0,10500,46499,0,56999
142230200800000,SE 231,RESIDENTIAL,10500,0,10500,49015,0,59515
142230200900000,SE 231,RESIDENTIAL,15750,0,15750,39847,0,55597
142230201000000,SE 231,EXEMPT,0,18750,18750,0,0,18750
142230201100000,CONVERSION,COMMERCIAL,0,6309,6309,0,43338,49647
142230201200000,SE 231,EXEMPT,0,7000,7000,37164,0,44164
142230201300000,SE 231,RESIDENTIAL,7665,0,7665,0,0,7665
142230201400000,SE 231,RESIDENTIAL,7980,0,7980,28672,0,36652
142230201500000,SE 231,RESIDENTIAL,7089,0,7089,41657,0,48746
142230201600000,SE 231,RESIDENTIAL,6510,0,6510,42527,0,49037
142230201700000,SE 231,RESIDENTIAL,7595,0,7595,42558,0,50153
142230201800000,SE 231,EXEMPT,0,5425,5425,44359,0,49784
142230201900000,SE 231,EXEMPT,0,10500,10500,0,0,10500
142230202000000,SE 231,RESIDENTIAL,17850,0,17850,44239,0,62089
142230202100000,SE 231,EXEMPT,0,10500,10500,0,26474,36974
142230202200000,SE 231,RESIDENTIAL,10500,0,10500,56732,0,67232
142230202300000,SE 231,RESIDENTIAL,10500,0,10500,36658,0,47158
142230202400000,SE 231,EXEMPT,0,7500,7500,24377,0,31877
142230202500000,SE 231,EXEMPT,0,10040,10040,23960,0,34000
142230202600000,SE 231,RESIDENTIAL,14000,0,14000,45311,0,59311
142230202700000,SE 231,EXEMPT,0,10000,10000,36667,0,46667
142230202800000,SE 231,RESIDENTIAL,14270,0,14270,53730,0,68000
142230203100000,SE 231,RESIDENTIAL,7350,0,7350,42923,0,50273
142230203200000,SE 231,RESIDENTIAL,5145,0,5145,0,0,5145
142230203300000,SE 231,RESIDENTIAL,7595,0,7595,35712,0,43307
142230203400000,SE 231,RESIDENTIAL,7595,0,7595,46039,0,53634
142230203500000,CONVERSION,COMMERCIAL,0,3600,3600,0,26848,30448
142230203600000,SE 231,RESIDENTIAL,8680,0,8680,39183,0,47863
142230203700000,SE 231,RESIDENTIAL,14000,0,14000,64217,0,78217
142230203800000,SE 231,RESIDENTIAL,14000,0,14000,0,0,14000
142230300100000,SE 231,RESIDENTIAL,10987,0,10987,61217,0,72204
142230300200000,SE 231,RESIDENTIAL,10220,0,10220,50813,0,61033
142230300300000,SE 231,RESIDENTIAL,14000,0,14000,45032,0,59032
142230300400000,SE 231,EXEMPT,0,10000,10000,57655,0,67655
142230300500000,SE 231,RESIDENTIAL,14000,0,14000,58413,0,72413
142230300600000,SE 231,RESIDENTIAL,14000,0,14000,40744,0,54744
142230300700000,SE 231,RESIDENTIAL,14000,0,14000,55430,0,69430
142230300800000,SE 231,RESIDENTIAL,14000,0,14000,55950,0,69950
142230300900000,SE 231,RESIDENTIAL,14000,0,14000,50463,0,64463
142230301000000,SE 231,RESIDENTIAL,14000,0,14000,57195,0,71195
142230301100000,SE 231,RESIDENTIAL,14000,0,14000,43109,0,57109
142230301200000,SE 231,RESIDENTIAL,14000,0,14000,54354,0,68354
142230301300000,SE 231,RESIDENTIAL,14000,0,14000,45806,0,59806
142230301400000,SE 231,RESIDENTIAL,14000,0,14000,46902,0,60902
142230301500000,SE 231,RESIDENTIAL,14000,0,14000,48867,0,62867
142230301600000,SE 231,RESIDENTIAL,7644,0,7644,26356,0,34000
142230301700000,SE 231,RESIDENTIAL,7921,0,7921,33546,0,41467
142230301800000,SE 231,RESIDENTIAL,6484,0,6484,38666,0,45150
142230301900000,SE 231,RESIDENTIAL,6484,0,6484,40062,0,46546
142230302000000,SE 231,RESIDENTIAL,1138,0,1138,0,0,1138
142230302100000,SE 231,RESIDENTIAL,7053,0,7053,38340,0,45393
142230302200000,SE 231,RESIDENTIAL,7053,0,7053,42320,0,49373
142230302300000,SE 231,RESIDENTIAL,13030,0,13030,45358,0,58388
142230302400000,SE 231,RESIDENTIAL,14000,0,14000,66892,0,80892
142230302500000,SE 231,RESIDENTIAL,14276,0,14276,29181,0,43457
142230302600000,SE 231,RESIDENTIAL,17629,0,17629,62325,0,79954
142230302700000,SE 231,RESIDENTIAL,14000,0,14000,55479,0,69479
142230302900000,SE 231,RESIDENTIAL,12250,0,12250,29599,0,41849
142230303000000,CONVERSION,COMMERCIAL,0,11340,11340,0,57978,69318
142230303100000,SE 231,RESIDENTIAL,14000,0,14000,65999,0,79999
142230303200000,SE 231,RESIDENTIAL,14000,0,14000,63794,0,77794
142230303300000,SE 231,RESIDENTIAL,14000,0,14000,63279,0,77279
142230303400000,SE 231,RESIDENTIAL,14000,0,14000,62137,0,76137
142230303500000,SE 231,RESIDENTIAL,14000,0,14000,64516,0,78516
142230303600000,SE 231,RESIDENTIAL,14000,0,14000,53005,0,67005
142230303700000,CONVERSION,COMMERCIAL,0,7727,7727,0,72899,80626
142230303800000,SE 231,RESIDENTIAL,7508,0,7508,39254,0,46762
142230303900000,SE 231,RESIDENTIAL,7508,0,7508,43760,0,51268
142230304000000,SE 231,RESIDENTIAL,8986,0,8986,50186,0,59172
142230304100000,SE 231,RESIDENTIAL,8986,0,8986,31950,0,40936
142230400100000,SE 231,RESIDENTIAL,6510,0,6510,0,0,6510
142230400200000,SE 231,EXEMPT,0,4650,4650,0,0,4650
142230400300000,SE 231,RESIDENTIAL,14000,0,14000,48895,0,62895
142230400400000,SE 231,RESIDENTIAL,14000,0,14000,68539,0,82539
142230400500000,SE 231,RESIDENTIAL,14000,0,14000,57245,0,71245
142230400600000,SE 231,RESIDENTIAL,14000,0,14000,55800,0,69800
142230400700000,SE 231,EXEMPT,0,10000,10000,29967,0,39967
142230400800000,SE 231,RESIDENTIAL,14000,0,14000,40253,0,54253
142230400900000,SE 231,RESIDENTIAL,14000,0,14000,29499,0,43499
142230401000000,SE 231,RESIDENTIAL,14000,0,14000,41059,0,55059
142230401100000,SE 231,RESIDENTIAL,14000,0,14000,46468,0,60468
142230401200000,SE 231,RESIDENTIAL,235,0,235,0,0,235
142230401300000,SE 231,RESIDENTIAL,10283,0,10283,37213,0,47496
142230401400000,SE 231,RESIDENTIAL,10500,0,10500,42496,0,52996
142230401500000,SE 231,RESIDENTIAL,8536,0,8536,47958,0,56494
142230401600000,SE 231,RESIDENTIAL,6667,0,6667,49532,0,56199
142230401700000,APARTMENT,COMMERCIAL,0,8400,8400,0,63270,71670
142230401800000,SE 231,RESIDENTIAL,10850,0,10850,52636,0,63486
142230401900000,SE 231,RESIDENTIAL,14815,0,14815,10137,0,24952
142230402000000,SE 231,RESIDENTIAL,10500,0,10500,0,0,10500
142230402100000,SE 231,RESIDENTIAL,10500,0,10500,32753,0,43253
142230402200000,SE 231,RESIDENTIAL,14000,0,14000,51155,0,65155
142230402300000,SE 231,RESIDENTIAL,14000,0,14000,49814,0,63814
142230402400000,SE 231,RESIDENTIAL,14340,0,14340,43805,0,58145
142230402500000,SE 231,RESIDENTIAL,14000,0,14000,60567,0,74567
142230402600000,SE 231,RESIDENTIAL,14000,0,14000,50924,0,64924
142230402700000,SE 231,RESIDENTIAL,14000,0,14000,36954,0,50954
142230402800000,SE 231,RESIDENTIAL,14000,0,14000,55504,0,69504
142230402900000,SE 231,RESIDENTIAL,14000,0,14000,55210,0,69210
142230403000000,SE 231,RESIDENTIAL,14000,0,14000,40734,0,54734
142230403100000,SE 231,RESIDENTIAL,7665,0,7665,37040,0,44705
142230403200000,SE 231,RESIDENTIAL,7665,0,7665,55509,0,63174
142230403300000,SE 231,RESIDENTIAL,7053,0,7053,27786,0,34839
142230403400000,SE 231,RESIDENTIAL,7053,0,7053,36408,0,43461
142230403600000,SE 231,RESIDENTIAL,8680,0,8680,40262,0,48942
142230403700000,SE 231,RESIDENTIAL,8791,0,8791,35600,0,44391
142230500100000,SE 231,RESIDENTIAL,11165,0,11165,42038,0,53203
142230500200000,SE 231,RESIDENTIAL,10220,0,10220,51612,0,61832
142230500300000,SE 231,RESIDENTIAL,14000,0,14000,55507,0,69507
142230500400000,SE 231,RESIDENTIAL,14000,0,14000,54000,0,68000
142230500500000,SE 231,RESIDENTIAL,14000,0,14000,55608,0,69608
142230500600000,APARTMENT,COMMERCIAL,0,11200,11200,0,84054,95254
142230500700000,SE 231,RESIDENTIAL,14000,0,14000,65873,0,79873
142230500800000,SE 231,RESIDENTIAL,14000,0,14000,59228,0,73228
142230500900000,SE 231,RESIDENTIAL,14000,0,14000,55600,0,69600
142230501000000,SE 231,RESIDENTIAL,14000,0,14000,55200,0,69200
142230501100000,SE 231,RESIDENTIAL,14094,0,14094,51843,0,65937
142230501200000,SE 231,RESIDENTIAL,14000,0,14000,58779,0,72779
142230501300000,SE 231,RESIDENTIAL,14144,0,14144,58046,0,72190
142230501400000,SE 231,RESIDENTIAL,14000,0,14000,58150,0,72150
142230501500000,SE 231,RESIDENTIAL,14000,0,14000,54977,0,68977
142230501600000,SE 231,RESIDENTIAL,7350,0,7350,38404,0,45754
142230501700000,SE 231,EXEMPT,0,7350,7350,0,30601,37951
142230501800000,SE 231,RESIDENTIAL,7595,0,7595,38683,0,46278
142230501900000,SE 231,RESIDENTIAL,7595,0,7595,45614,0,53209
142230502000000,SE 231,RESIDENTIAL,7903,0,7903,44131,0,52034
142230502100000,SE 231,RESIDENTIAL,7508,0,7508,37639,0,45147
142230502200000,SE 231,RESIDENTIAL,7350,0,7350,43855,0,51205
142230502300000,SE 231,RESIDENTIAL,8299,0,8299,29237,0,37536
142230502400000,SE 231,RESIDENTIAL,14000,0,14000,23430,0,37430
142230502500000,SE 231,RESIDENTIAL,14000,0,14000,35000,0,49000
142230502600000,SE 231,RESIDENTIAL,14000,0,14000,30597,0,44597
142230502700000,SE 231,RESIDENTIAL,14000,0,14000,42284,0,56284
142230502800000,SE 231,RESIDENTIAL,14000,0,14000,69208,0,83208
142230502900000,SE 231,RESIDENTIAL,14000,0,14000,64800,0,78800
142230503000000,SE 231,RESIDENTIAL,14000,0,14000,52614,0,66614
142230503100000,SE 231,RESIDENTIAL,14000,0,14000,45206,0,59206
142230503200000,SE 231,RESIDENTIAL,14000,0,14000,39421,0,53421
142230503300000,SE 231,RESIDENTIAL,14000,0,14000,50756,0,64756
142230503400000,SE 231,RESIDENTIAL,14000,0,14000,52632,0,66632
142230503500000,SE 231,RESIDENTIAL,14000,0,14000,52781,0,66781
142230503600000,SE 231,RESIDENTIAL,13969,0,13969,52266,0,66235
142230503700000,SE 231,RESIDENTIAL,10220,0,10220,30632,0,40852
142230503800000,SE 231,RESIDENTIAL,10923,0,10923,31573,0,42496
142230503900000,SE 231,RESIDENTIAL,8645,0,8645,38254,0,46899
142230504000000,SE 231,RESIDENTIAL,8645,0,8645,49048,0,57693
142230504100000,SE 231,EXEMPT,0,6419,6419,49266,0,55685
142230504200000,SE 231,RESIDENTIAL,8986,0,8986,43324,0,52310
142230600100000,SE 231,RESIDENTIAL,7665,0,7665,40505,0,48170
142230600200000,SE 231,RESIDENTIAL,7665,0,7665,41583,0,49248
142230600300000,SE 231,EXEMPT,0,14000,14000,0,34695,48695
142230600400000,SE 231,RESIDENTIAL,14000,0,14000,0,0,14000
142230600500000,CITY PROPERTY,EXEMPT,0,0,0,0,0,0
142230600600000,SE 231,RESIDENTIAL,14000,0,14000,43533,0,57533
142230600700000,SE 231,RESIDENTIAL,14000,0,14000,37417,0,51417
142230600800000,SE 231,RESIDENTIAL,12950,0,12950,39487,0,52437
142230600900000,SE 231,RESIDENTIAL,7665,0,7665,38161,0,45826
142230601000000,SE 231,RESIDENTIAL,7808,0,7808,48355,0,56163
142230601100000,SE 231,RESIDENTIAL,6510,0,6510,50542,0,57052
142230601200000,SE 231,RESIDENTIAL,10168,0,10168,42534,0,52702
142230601300000,SE 231,RESIDENTIAL,11725,0,11725,51014,0,62739
142230601400000,SE 231,RESIDENTIAL,14640,0,14640,61234,0,75874
142230601500000,SE 231,RESIDENTIAL,14000,0,14000,57695,0,71695
142230601600000,SE 231,RESIDENTIAL,14000,0,14000,47622,0,61622
142230601700000,SE 231,RESIDENTIAL,17850,0,17850,43606,0,61456
142230601800000,SE 231,RESIDENTIAL,14000,0,14000,41000,0,55000
142230601900000,SE 231,RESIDENTIAL,14000,0,14000,42746,0,56746
142230602000000,SE 231,RESIDENTIAL,10285,0,10285,41814,0,52099
142230602100000,SE 231,EXEMPT,0,10640,10640,0,34391,45031
142230602200000,SE 231,RESIDENTIAL,13030,0,13030,51568,0,64598
142230602300000,SE 231,RESIDENTIAL,7053,0,7053,37556,0,44609
142230602400000,SE 231,RESIDENTIAL,7053,0,7053,40764,0,47817
142230700100000,CONVERSION,COMMERCIAL,0,4528,4528,0,5000,9528
142230700200000,SE 232,RESIDENTIAL,10070,0,10070,57172,0,67242
142230700300000,SE 232,RESIDENTIAL,9085,0,9085,46219,0,55304
142230700500000,SE 232,RESIDENTIAL,5850,0,5850,42254,0,48104
142230700600000,SE 232,RESIDENTIAL,4200,0,4200,46814,0,51014
142230700700000,SE 232,RESIDENTIAL,9231,0,9231,19684,0,28915
142230700800000,SE 232,RESIDENTIAL,9900,0,9900,33061,0,42961
142230700900000,SE 232,EXEMPT,0,9900,9900,0,41571,51471
142230701000000,SE 232,RESIDENTIAL,7673,0,7673,40762,0,48435
142230701100000,SE 232,RESIDENTIAL,7673,0,7673,46417,0,54090
142230701200000,SE 232,RESIDENTIAL,7673,0,7673,29327,0,37000
142230701300000,SE 232,EXEMPT,0,9900,9900,0,34163,44063
142230701400000,SE 232,RESIDENTIAL,6200,0,6200,48898,0,55098
142230701500000,SE 232,EXEMPT,0,6975,6975,0,56447,63422
142230701600000,SE 232,RESIDENTIAL,7595,0,7595,49822,0,57417
142230800100000,SE 231,RESIDENTIAL,10028,0,10028,38053,0,48081
142230800200000,SE 231,RESIDENTIAL,8984,0,8984,33171,0,42155
142230800300000,SE 231,RESIDENTIAL,8531,0,8531,35815,0,44346
142230800400000,SE 231,RESIDENTIAL,8645,0,8645,39468,0,48113
142230800500000,SE 231,RESIDENTIAL,14000,0,14000,46048,0,60048
142230800600000,SE 231,RESIDENTIAL,14000,0,14000,48188,0,62188
142230800700000,SE 231,RESIDENTIAL,14000,0,14000,34119,0,48119
142230800800000,SE 231,RESIDENTIAL,14000,0,14000,46128,0,60128
142230800900000,SE 231,RESIDENTIAL,14000,0,14000,38607,0,52607
142230801000000,SE 231,RESIDENTIAL,14000,0,14000,53927,0,67927
142230801100000,SE 231,RESIDENTIAL,17850,0,17850,46538,0,64388
142230801200000,SE 231,RESIDENTIAL,17850,0,17850,56394,0,74244
142230801300000,SE 231,RESIDENTIAL,14000,0,14000,42197,0,56197
142230801400000,SE 231,RESIDENTIAL,14000,0,14000,39538,0,53538
142230801500000,SE 231,RESIDENTIAL,14000,0,14000,46372,0,60372
142230801600000,SE 231,EXEMPT,0,10000,10000,65991,0,75991
142230801700000,SE 231,RESIDENTIAL,19274,0,19274,39142,0,58416
142230900100000,SE 231,RESIDENTIAL,13168,0,13168,57389,0,70557
142230900200000,SE 231,EXEMPT,0,12279,12279,0,27314,39593
142230900300000,SE 231,RESIDENTIAL,13874,0,13874,38670,0,52544
142230900400000,SE 231,RESIDENTIAL,14000,0,14000,52338,0,66338
142230900500000,SE 231,RESIDENTIAL,14000,0,14000,38896,0,52896
142230900600000,SE 231,RESIDENTIAL,14000,0,14000,45090,0,59090
142230900700000,SE 231,RESIDENTIAL,14000,0,14000,29928,0,43928
142230900800000,SE 231,RESIDENTIAL,14000,0,14000,52995,0,66995
142230900900000,SE 231,RESIDENTIAL,8038,0,8038,47077,0,55115
142230901000000,SE 231,RESIDENTIAL,9305,0,9305,41450,0,50755
142230901100000,SE 231,RESIDENTIAL,7392,0,7392,44704,0,52096
142230901200000,SE 231,RESIDENTIAL,7280,0,7280,39372,0,46652
142232600100000,CHURCH,EXEMPT,0,210816,210816,0,3140691,3351507
142232600300000,CHURCH,EXEMPT,0,9800,9800,0,46842,56642
142232600400000,SE 232,EXEMPT,0,10000,10000,0,55399,65399
142232600500000,CONVERSION,COMMERCIAL,0,9072,9072,0,67600,76672
142232600600000,SE 232,RESIDENTIAL,10000,0,10000,29598,0,39598
142232600700000,VACANT LAND,EXEMPT,0,8400,8400,0,0,8400
142232600800000,APARTMENT,COMMERCIAL,0,11200,11200,0,102449,113649
142232600900000,APARTMENT,COMMERCIAL,0,11200,11200,0,102449,113649
142232601000000,SE 232,RESIDENTIAL,10000,0,10000,0,0,10000
142232601100000,OFFICE,COMMERCIAL,0,22400,22400,0,71485,93885
142232601201000,OFFICE,EXEMPT,0,56480,56480,0,262596,319076
142232601201001,OFFICE,EXEMPT,0,56480,56480,0,277303,333783
142232601300000,FLAT PARKING,COMMERCIAL,0,102847,102847,0,21320,124167
142232601400000,SE 232,RESIDENTIAL,12500,0,12500,0,0,12500
142232601700000,SE 232,RESIDENTIAL,12500,0,12500,71600,0,84100
142232601800000,SE 232,RESIDENTIAL,12500,0,12500,54067,0,66567
142232601900000,SE 232,RESIDENTIAL,10000,0,10000,34716,0,44716
142232602000000,FLAT PARKING,EXEMPT,0,48384,48384,0,21078,69462
142232602200000,SE 232,RESIDENTIAL,10000,0,10000,53031,0,63031
142232602300000,SE 232,RESIDENTIAL,10000,0,10000,36623,0,46623
142232602400000,FLAT PARKING,EXEMPT,0,24192,24192,0,10751,34943
142232602500000,FLAT PARKING,EXEMPT,0,89662,89662,0,40740,130402
142232602600000,SECTION 42,COMMERCIAL,0,22400,22400,0,77296,99696
142232700100000,OFFICE; MEDICAL,COMMERCIAL,0,125760,125760,0,822375,948135
142232700400000,CONVERSION,EXEMPT,0,12474,12474,0,160262,172736
142232700500000,SE 232,RESIDENTIAL,7575,0,7575,0,0,7575
142232700600000,SE 232,RESIDENTIAL,10000,0,10000,0,0,10000
142232700700000,CONVERSION,COMMERCIAL,0,11340,11340,0,74321,85661
142232700800000,SE 232,RESIDENTIAL,7500,0,7500,0,0,7500
142232700900000,SE 232,RESIDENTIAL,7906,0,7906,41607,0,49513
142232701000000,CONVERSION,COMMERCIAL,0,6156,6156,0,51068,57224
142232701100000,CONVERSION,COMMERCIAL,0,2592,2592,0,40195,42787
142232701200000,FLAT PARKING,COMMERCIAL,0,8320,8320,0,2281,10601
142232701300000,CONVERSION,COMMERCIAL,0,12814,12814,0,97115,109929
142232701500000,OFFICE,COMMERCIAL,0,65240,65240,0,160730,225970
142232701600000,CONVERSION,COMMERCIAL,0,11340,11340,0,77689,89029
142232701700000,CONVERSION,COMMERCIAL,0,15876,15876,0,70464,86340
142232701800000,SE 232,RESIDENTIAL,16750,0,16750,94085,0,110835
142232701900000,CONVERSION,COMMERCIAL,0,6804,6804,0,46738,53542
142232702000000,SE 232,RESIDENTIAL,7500,0,7500,44140,0,51640
142232702100000,SE 232,RESIDENTIAL,7500,0,7500,38001,0,45501
142232702200000,CONVERSION,COMMERCIAL,0,6804,6804,0,51948,58752
142232702300000,OFFICE; MEDICAL,COMMERCIAL,0,113120,113120,0,940616,1053736
142232702400000,CONVERSION,COMMERCIAL,0,8278,8278,0,68638,76916
142232800100000,FLAT PARKING,COMMERCIAL,0,32200,32200,0,5486,37686
142232800200000,VACANT LAND,COMMERCIAL,0,24348,24348,0,0,24348
142232800300000,FLAT PARKING,COMMERCIAL,0,23800,23800,0,4988,28788
142232800400000,FLAT PARKING,COMMERCIAL,0,23800,23800,0,2236,26036
142232800500000,SMALL RETAIL,COMMERCIAL,0,16800,16800,0,32300,49100
142232800600000,SMALL RETAIL,COMMERCIAL,0,16800,16800,0,30899,47699
142232800700000,SMALL RETAIL,COMMERCIAL,0,51800,51800,0,198058,249858
142232800800000,CONVENIENCE STORE,COMMERCIAL,0,201600,201600,0,258271,459871
142232800900000,FLAT PARKING,COMMERCIAL,0,100800,100800,0,6396,107196
142232900100000,RESTAURANT,COMMERCIAL,0,100800,100800,0,118354,219154
142232900102000,BILLBOARD(BLL),COMMERCIAL,0,0,0,0,40879,40879
142232900200000,OFFICE,COMMERCIAL,0,67200,67200,0,190284,257484
142232900300000,VACANT LAND,COMMERCIAL,0,20,20,0,0,20
142233000700000,VACANT LAND,COMMERCIAL,0,20,20,0,0,20
142233001100000,OFFICE; MED; CTRL CR,COMMERCIAL,0,552500,552500,0,6197250,6749750
142233100100000,SR/NURSING/ASSTD LIV,EXEMPT,0,263520,263520,0,3162796,3426316
142233100200000,FLAT PARKING,COMMERCIAL,0,28920,28920,0,7331,36251
142233100300000,FLAT PARKING,COMMERCIAL,0,22750,22750,0,11175,33925
142233100400000,FLAT PARKING,COMMERCIAL,0,25835,25835,0,12691,38526
142233100500000,FLAT PARKING,COMMERCIAL,0,30854,30854,0,15155,46009
142233100600000,FLAT PARKING,COMMERCIAL,0,30854,30854,0,19125,49979
142233100700000,FLAT PARKING,COMMERCIAL,0,20569,20569,0,5809,26378
142233100900000,FLAT PARKING,COMMERCIAL,0,64279,64279,0,7675,71954
142233101000000,FLAT PARKING,COMMERCIAL,0,77135,77135,0,8384,85519
142233101100000,FLAT PARKING,COMMERCIAL,0,77135,77135,0,8448,85583
142233101200000,OFFICE; MEDICAL,COMMERCIAL,0,323200,323200,0,2539274,2862474
142233101300000,VACANT LAND,EXEMPT,0,6890,6890,0,0,6890
142233101500000,HOSPITAL,EXEMPT,0,42071,42071,0,0,42071
142233101600000,OFFICE,EXEMPT,0,41434,41434,0,598139,639573
142233200200000,VACANT LAND,EXEMPT,0,23085,23085,0,0,23085
142233200500000,APARTMENT,EXEMPT,0,27234,27234,0,228186,255420
142233200600000,SE 232,EXEMPT,0,0,0,0,0,0
142233200700000,VACANT LAND,COMMERCIAL,0,12600,12600,0,0,12600
142233200800000,WAREHOUSE,COMMERCIAL,0,16800,16800,0,83426,100226
142233201000000,OFFICE; MEDICAL,EXEMPT,0,22032,22032,0,135758,157790
142233201100000,SE 232,EXEMPT,0,0,0,0,0,0
142233201200000,SR/NURSING/ASSTD LIV,EXEMPT,0,300672,300672,0,2891942,3192614
142233201300000,SE 232,RESIDENTIAL,9700,0,9700,54900,0,64600
142233201400000,SE 232,RESIDENTIAL,10875,0,10875,45408,0,56283
142233300100000,SMALL RETAIL,COMMERCIAL,0,5250,5250,0,108026,113276
142233300200000,FLAT PARKING,COMMERCIAL,0,5175,5175,0,1360,6535
142233300300000,SE 232,RESIDENTIAL,4185,0,4185,39282,0,43467
142233300400000,SE 232,RESIDENTIAL,6750,0,6750,37362,0,44112
142233300500000,SE 232,RESIDENTIAL,5400,0,5400,35701,0,41101
142233300600000,SCHOOL,EXEMPT,0,0,0,0,0,0
142233400100000,CONVERSION,COMMERCIAL,0,7128,7128,0,47887,55015
142233400200000,SE 232,RESIDENTIAL,10000,0,10000,65446,0,75446
142233400300000,SE 232,RESIDENTIAL,12750,0,12750,26058,0,38808
142233400400000,SE 232,RESIDENTIAL,7500,0,7500,39353,0,46853
142233400500000,SE 232,RESIDENTIAL,7500,0,7500,32743,0,40243
142233400600000,SE 232,RESIDENTIAL,12750,0,12750,62491,0,75241
142233400700000,CONVERSION,COMMERCIAL,0,6804,6804,0,53115,59919
142233400800000,SE 232,RESIDENTIAL,7500,0,7500,46397,0,53897
142233400900000,CONVERSION,COMMERCIAL,0,9234,9234,0,72265,81499
142233401000000,SE 232,RESIDENTIAL,6975,0,6975,33007,0,39982
142233401100000,SE 232,RESIDENTIAL,6650,0,6650,40182,0,46832
142233401200000,SE 232,RESIDENTIAL,6650,0,6650,62835,0,69485
142233401300000,SE 232,RESIDENTIAL,4500,0,4500,0,0,4500
142233401400000,SE 232,RESIDENTIAL,12750,0,12750,0,0,12750
142233401500000,SE 232,RESIDENTIAL,8000,0,8000,49636,0,57636
142233401600000,SE 232,RESIDENTIAL,6817,0,6817,27462,0,34279
142233401700000,SE 232,EXEMPT,0,7320,7320,0,41802,49122
142233500100000,SE 232,EXEMPT,0,12750,12750,0,87693,100443
142233500200000,SE 232,EXEMPT,0,7725,7725,0,44124,51849
142235100100000,SE 232,RESIDENTIAL,7000,0,7000,0,0,7000
142235100200000,SE 232,RESIDENTIAL,3375,0,3375,37354,0,40729
142235100300000,SE 232,RESIDENTIAL,4500,0,4500,32292,0,36792
142235200100000,SCHOOL,EXEMPT,0,0,0,0,0,0
142235200200000,SCHOOL,EXEMPT,0,0,0,0,0,0
142235200300000,SCHOOL,EXEMPT,0,0,0,0,0,0
142235200400000,SE 232,RESIDENTIAL,6200,0,6200,40081,0,46281
142235200500000,SE 232,RESIDENTIAL,5700,0,5700,15924,0,21624
142235200600000,SE 232,RESIDENTIAL,5700,0,5700,25382,0,31082
142235200700000,SE 232,RESIDENTIAL,5700,0,5700,36082,0,41782
142235200800000,SE 232,RESIDENTIAL,5700,0,5700,0,0,5700
142235200900000,SE 232,RESIDENTIAL,12936,0,12936,0,0,12936
142235201000000,SE 232,RESIDENTIAL,4940,0,4940,0,0,4940
142235201100000,SE 232,RESIDENTIAL,7600,0,7600,34758,0,42358
142235201200000,SCHOOL,EXEMPT,0,0,0,0,0,0
142235201300000,SE 232,RESIDENTIAL,8800,0,8800,35704,0,44504
142235201400000,SE 232,RESIDENTIAL,9386,0,9386,48126,0,57512
142235201500000,SCHOOL,EXEMPT,0,0,0,0,0,0
142235201600000,SCHOOL,EXEMPT,0,0,0,0,0,0
142235201700000,SCHOOL,EXEMPT,0,0,0,0,0,0
142235202000000,SE 232,RESIDENTIAL,9925,0,9925,0,0,9925
142235202100000,CITY PROPERTY,EXEMPT,0,0,0,0,0,0
142235202200000,CONVERSION,COMMERCIAL,0,5832,5832,0,80026,85858
142235202300000,SE 232,RESIDENTIAL,7350,0,7350,32558,0,39908
142235202400000,SE 232,RESIDENTIAL,7350,0,7350,29190,0,36540
142235202500000,SE 232,RESIDENTIAL,12495,0,12495,41722,0,54217
142235202600000,SE 232,RESIDENTIAL,7040,0,7040,36795,0,43835
142235202700000,CONVERSION,EXEMPT,0,6156,6156,0,101990,108146
142235202800000,CONVERSION,COMMERCIAL,0,8100,8100,0,78384,86484
142235202900000,SE 232,RESIDENTIAL,11500,0,11500,50795,0,62295
142235203000000,SE 232,RESIDENTIAL,12512,0,12512,0,0,12512
142235203100000,SCHOOL,EXEMPT,0,0,0,0,0,0
142235203200000,SCHOOL,EXEMPT,0,0,0,0,0,0
142235203300000,SCHOOL,EXEMPT,0,0,0,0,0,0
142235203500000,FLAT PARKING,EXEMPT,0,160989,160989,0,16660,177649
142235203600000,SE 232,RESIDENTIAL,8050,0,8050,42917,0,50967
142235203700000,VACANT LAND,EXEMPT,0,19800,19800,0,0,19800
142235203800000,OFFICE; MEDICAL,EXEMPT,0,183902,183902,0,471453,655355
142235203900000,FLAT PARKING,EXEMPT,0,40824,40824,0,4160,44984
142235204000000,OFFICE; MEDICAL,COMMERCIAL,0,159315,159315,0,262970,422285
142235204100000,HOSPITAL,EXEMPT,0,55404,55404,0,0,55404
142235204400000,OFFICE,COMMERCIAL,0,25380,25380,0,86713,112093
142235300100000,NBHD SHOPPING CENTER,COMMERCIAL,0,496000,496000,0,933677,1429677
142235400100000,OFFICE; MED; CTRL CR,COMMERCIAL,0,142500,142500,0,401763,544263
142235400102000,BILLBOARD(BLL),COMMERCIAL,0,0,0,0,20342,20342
142235400200000,OFFICE; MED; CTRL CR,COMMERCIAL,0,854000,854000,0,2469763,3323763
142235500800000,FLAT PARKING,COMMERCIAL,0,61983,61983,0,8036,70019
142235500900000,HOSPITAL,COMMERCIAL,0,1099440,1099440,0,125171486,126270926
142235600100000,WAREHOUSE,EXEMPT,0,153187,153187,0,267678,420865
142235600400000,CITY PROPERTY,EXEMPT,0,0,0,0,0,0
142235600500000,CITY PROPERTY,EXEMPT,0,0,0,0,0,0
142235600600000,HOSPITAL,EXEMPT,0,1296,1296,0,0,1296
142235600900000,FLAT PARKING,EXEMPT,0,10368,10368,0,6426,16794
142237600100000,SE 231,RESIDENTIAL,8759,0,8759,40305,0,49064
142237600200000,SE 231,RESIDENTIAL,8873,0,8873,31349,0,40222
142237600300000,SE 231,RESIDENTIAL,11689,0,11689,54872,0,66561
142237600400000,SE 231,RESIDENTIAL,10220,0,10220,35676,0,45896
142237600500000,SE 231,RESIDENTIAL,14000,0,14000,34450,0,48450
142237600600000,SE 231,RESIDENTIAL,14000,0,14000,51821,0,65821
142237600700000,SE 231,RESIDENTIAL,14000,0,14000,57361,0,71361
142237600800000,SE 231,RESIDENTIAL,14000,0,14000,45997,0,59997
142237600900000,SE 231,RESIDENTIAL,14000,0,14000,59133,0,73133
142237601000000,SE 231,RESIDENTIAL,14000,0,14000,52885,0,66885
142237601100000,SE 231,RESIDENTIAL,14000,0,14000,51807,0,65807
142237601200000,SE 231,RESIDENTIAL,14000,0,14000,46008,0,60008
142237601300000,SE 231,RESIDENTIAL,14000,0,14000,50616,0,64616
142237601400000,SE 231,RESIDENTIAL,14000,0,14000,39911,0,53911
142237601500000,SE 231,RESIDENTIAL,14000,0,14000,38003,0,52003
142237601600000,SE 231,RESIDENTIAL,14000,0,14000,49959,0,63959
142237601700000,SE 231,RESIDENTIAL,14000,0,14000,12195,0,26195
142237601800000,SE 231,RESIDENTIAL,8085,0,8085,34128,0,42213
142237601900000,SE 231,RESIDENTIAL,7840,0,7840,37485,0,45325
142237602000000,SE 231,RESIDENTIAL,12928,0,12928,42339,0,55267
142237700100000,SE 231,RESIDENTIAL,10351,0,10351,41445,0,51796
142237700200000,SE 231,RESIDENTIAL,10465,0,10465,42173,0,52638
142237700300000,SE 231,RESIDENTIAL,11689,0,11689,41804,0,53493
142237700400000,SE 231,RESIDENTIAL,8432,0,8432,24011,0,32443
142237700500000,SE 231,RESIDENTIAL,8687,0,8687,40940,0,49627
142237700600000,SE 231,RESIDENTIAL,11550,0,11550,43747,0,55297
142237700700000,SE 231,RESIDENTIAL,14000,0,14000,43841,0,57841
142237700800000,SE 231,RESIDENTIAL,14000,0,14000,56540,0,70540
142237700900000,SE 231,RESIDENTIAL,14000,0,14000,48145,0,62145
142237701000000,SE 231,RESIDENTIAL,14000,0,14000,25880,0,39880
142237701100000,SE 231,EXEMPT,0,9005,9005,0,46100,55105
142237701200000,SE 231,RESIDENTIAL,8006,0,8006,32156,0,40162
142237701300000,SE 231,RESIDENTIAL,7053,0,7053,35166,0,42219
142237800100000,SMALL RETAIL,COMMERCIAL,0,61600,61600,0,154208,215808
142237800200000,SE 231,RESIDENTIAL,14000,0,14000,44466,0,58466
142237800300000,FLAT PARKING,COMMERCIAL,0,16800,16800,0,7344,24144
142237900100000,SE 231,RESIDENTIAL,10028,0,10028,49540,0,59568
142237900200000,SE 231,RESIDENTIAL,8943,0,8943,37871,0,46814
142237900300000,SE 231,RESIDENTIAL,14000,0,14000,61388,0,75388
142237900400000,SE 231,RESIDENTIAL,14000,0,14000,48205,0,62205
142237900500000,SE 231,RESIDENTIAL,14000,0,14000,53519,0,67519
142237900600000,SE 231,RESIDENTIAL,14000,0,14000,66790,0,80790
142237900700000,SE 231,RESIDENTIAL,14000,0,14000,51703,0,65703
142237900800000,SE 231,RESIDENTIAL,14000,0,14000,38560,0,52560
142237900900000,SE 231,RESIDENTIAL,14000,0,14000,40635,0,54635
142237901000000,SE 231,RESIDENTIAL,14000,0,14000,52884,0,66884
142237901100000,SE 231,RESIDENTIAL,14000,0,14000,47813,0,61813
142237901200000,SE 231,RESIDENTIAL,14000,0,14000,39873,0,53873
142237901300000,SE 231,RESIDENTIAL,14000,0,14000,71197,0,85197
142237901400000,SE 231,RESIDENTIAL,14000,0,14000,44230,0,58230
142237901500000,SE 231,RESIDENTIAL,14000,0,14000,52191,0,66191
142237901600000,SE 231,RESIDENTIAL,9041,0,9041,35964,0,45005
142237901700000,SE 231,RESIDENTIAL,8943,0,8943,40709,0,49652
142237901800000,SE 231,RESIDENTIAL,7849,0,7849,36950,0,44799
142237901900000,SE 231,RESIDENTIAL,7621,0,7621,43433,0,51054
142237902000000,SE 231,RESIDENTIAL,12936,0,12936,42707,0,55643
142237902100000,SE 231,RESIDENTIAL,7350,0,7350,45123,0,52473
142237902200000,SE 231,RESIDENTIAL,7138,0,7138,40528,0,47666
142237902300000,SE 231,RESIDENTIAL,14000,0,14000,46323,0,60323
142237902400000,SE 231,RESIDENTIAL,14000,0,14000,47994,0,61994
142237902500000,SE 231,RESIDENTIAL,14000,0,14000,40316,0,54316
142237902600000,SE 231,RESIDENTIAL,14000,0,14000,46549,0,60549
142237902700000,SE 231,RESIDENTIAL,14000,0,14000,53356,0,67356
142237902800000,SE 231,RESIDENTIAL,14000,0,14000,53663,0,67663
142237902900000,SE 231,RESIDENTIAL,14000,0,14000,38951,0,52951
142237903000000,SE 231,RESIDENTIAL,14000,0,14000,53683,0,67683
142237903100000,SE 231,RESIDENTIAL,14000,0,14000,55089,0,69089
142237903200000,SE 231,RESIDENTIAL,14000,0,14000,42817,0,56817
142237903300000,SE 231,RESIDENTIAL,14000,0,14000,43957,0,57957
142237903400000,SE 231,RESIDENTIAL,11666,0,11666,43842,0,55508
142237903500000,SE 231,RESIDENTIAL,11666,0,11666,39595,0,51261
142237903600000,SE 231,RESIDENTIAL,11666,0,11666,57689,0,69355
142237903700000,SE 231,RESIDENTIAL,13439,0,13439,54797,0,68236
142237903800000,SE 231,RESIDENTIAL,7280,0,7280,36016,0,43296
142237903900000,SE 231,RESIDENTIAL,7280,0,7280,48169,0,55449
142237904000000,SE 231,RESIDENTIAL,8645,0,8645,29108,0,37753
142237904100000,SE 231,RESIDENTIAL,8531,0,8531,30705,0,39236
142238000100000,SE 231,RESIDENTIAL,12607,0,12607,40858,0,53465
142238000200000,SE 231,RESIDENTIAL,14000,0,14000,44143,0,58143
142238000300000,SE 231,RESIDENTIAL,14000,0,14000,62782,0,76782
142238000400000,SE 231,RESIDENTIAL,14000,0,14000,45181,0,59181
142238000500000,SE 231,EXEMPT,0,14000,14000,0,27131,41131
142238000600000,SE 231,RESIDENTIAL,14000,0,14000,47966,0,61966
142238000700000,SE 231,RESIDENTIAL,14000,0,14000,47524,0,61524
142238000800000,SE 231,RESIDENTIAL,9151,0,9151,45719,0,54870
142238000900000,SE 231,RESIDENTIAL,9877,0,9877,49391,0,59268
142238001000000,SE 231,RESIDENTIAL,11200,0,11200,58880,0,70080
142238001100000,SE 231,RESIDENTIAL,7053,0,7053,48396,0,55449
142238001200000,SE 231,RESIDENTIAL,7644,0,7644,41557,0,49201
142238001300000,SE 231,RESIDENTIAL,12295,0,12295,53727,0,66022
142238001400000,SE 231,RESIDENTIAL,14000,0,14000,47187,0,61187
142238001500000,SE 231,RESIDENTIAL,14000,0,14000,55963,0,69963
142238001600000,SE 231,RESIDENTIAL,14000,0,14000,50868,0,64868
142238001700000,SE 231,RESIDENTIAL,17500,0,17500,53718,0,71218
142238001800000,SE 231,RESIDENTIAL,17500,0,17500,58690,0,76190
142238001900000,SE 231,RESIDENTIAL,15336,0,15336,57576,0,72912
142238002000000,SE 231,RESIDENTIAL,8759,0,8759,38280,0,47039
142238002100000,SE 231,RESIDENTIAL,8873,0,8873,7568,0,16441
142238002200000,SE 231,RESIDENTIAL,7595,0,7595,33785,0,41380
142238002300000,SE 231,RESIDENTIAL,7473,0,7473,44783,0,52256
142238100100000,SE 231,RESIDENTIAL,7785,0,7785,44794,0,52579
142238100200000,SE 231,RESIDENTIAL,8667,0,8667,36832,0,45499
142238100300000,SE 231,RESIDENTIAL,7621,0,7621,32014,0,39635
142238100400000,SE 231,RESIDENTIAL,7621,0,7621,39249,0,46870
142238100500000,SE 231,RESIDENTIAL,7053,0,7053,31557,0,38610
142238100600000,SE 231,RESIDENTIAL,7053,0,7053,32038,0,39091
142238100700000,SE 231,RESIDENTIAL,7665,0,7665,36219,0,43884
142238100800000,SE 231,RESIDENTIAL,7665,0,7665,36498,0,44163
142238100900000,SE 231,RESIDENTIAL,15575,0,15575,43179,0,58754
142238101000000,SE 231,RESIDENTIAL,14000,0,14000,51472,0,65472
142238101100000,SE 231,RESIDENTIAL,14000,0,14000,51063,0,65063
142238101200000,SE 231,RESIDENTIAL,14000,0,14000,29835,0,43835
142238101300000,SE 231,RESIDENTIAL,14000,0,14000,47400,0,61400
142238101400000,SE 231,RESIDENTIAL,14000,0,14000,42655,0,56655
142238101500000,SE 231,RESIDENTIAL,14000,0,14000,57462,0,71462
142238101600000,SE 231,RESIDENTIAL,17500,0,17500,24951,0,42451
142238101700000,SE 231,RESIDENTIAL,14000,0,14000,26818,0,40818
142238101800000,SE 231,RESIDENTIAL,14000,0,14000,45529,0,59529
142238101900000,SE 231,RESIDENTIAL,14000,0,14000,42962,0,56962
142238102000000,SE 231,RESIDENTIAL,17500,0,17500,63602,0,81102
142238102100000,SE 231,RESIDENTIAL,14000,0,14000,25858,0,39858
142238102200000,SE 231,RESIDENTIAL,14000,0,14000,34435,0,48435
142238102300000,SE 231,RESIDENTIAL,17850,0,17850,47075,0,64925
142238102400000,SE 231,RESIDENTIAL,18795,0,18795,47816,0,66611
142238102500000,SE 230,RESIDENTIAL,23940,0,23940,64256,0,88196
142238102600000,SE 231,RESIDENTIAL,5764,0,5764,29309,0,35073
142238102700000,SE 230,RESIDENTIAL,23360,0,23360,83772,0,107132
142238102800000,SE 230,RESIDENTIAL,19337,0,19337,73290,0,92627
142238102900000,SE 231,RESIDENTIAL,17325,0,17325,57887,0,75212
142238103000000,SE 231,RESIDENTIAL,13860,0,13860,55450,0,69310
142238103100000,SE 231,RESIDENTIAL,13860,0,13860,52491,0,66351
142238103200000,SE 231,RESIDENTIAL,13860,0,13860,43454,0,57314
142238103300000,SE 231,RESIDENTIAL,4480,0,4480,19547,0,24027
142238103400000,SE 231,RESIDENTIAL,9380,0,9380,46875,0,56255
142238200100000,SE 231,RESIDENTIAL,12103,0,12103,48608,0,60711
142238200200000,SE 231,RESIDENTIAL,11025,0,11025,35382,0,46407
142238200300000,SE 231,RESIDENTIAL,11025,0,11025,45392,0,56417
142238200400000,SE 231,RESIDENTIAL,8925,0,8925,53562,0,62487
142238200500000,SE 231,RESIDENTIAL,11837,0,11837,45886,0,57723
142238200600000,SE 231,RESIDENTIAL,14000,0,14000,55835,0,69835
142238200700000,SE 231,RESIDENTIAL,10500,0,10500,40646,0,51146
142238200800000,SE 231,RESIDENTIAL,10500,0,10500,36950,0,47450
142238200900000,SE 231,RESIDENTIAL,14000,0,14000,49043,0,63043
142238201000000,SE 231,RESIDENTIAL,14000,0,14000,50496,0,64496
142238201100000,SE 231,RESIDENTIAL,14000,0,14000,55866,0,69866
142238201200000,SE 231,RESIDENTIAL,14000,0,14000,46062,0,60062
142238201300000,SE 231,RESIDENTIAL,14000,0,14000,41713,0,55713
142238201400000,SE 231,RESIDENTIAL,14000,0,14000,45629,0,59629
142238201500000,SE 231,RESIDENTIAL,14000,0,14000,50002,0,64002
142238201600000,SE 231,RESIDENTIAL,14000,0,14000,50704,0,64704
142238201700000,SE 231,RESIDENTIAL,14000,0,14000,56359,0,70359
142238201800000,SE 231,RESIDENTIAL,14000,0,14000,39324,0,53324
142238201900000,SE 231,RESIDENTIAL,14000,0,14000,44593,0,58593
142238202000000,SE 231,RESIDENTIAL,17850,0,17850,53918,0,71768
142238202100000,AUTO REPAIR/SALES,COMMERCIAL,0,13000,13000,0,13979,26979
142238202200000,SMALL RETAIL,COMMERCIAL,0,18540,18540,0,63571,82111
142238202300000,SMALL RETAIL,COMMERCIAL,0,12000,12000,0,59399,71399
142238202400000,SE 231,RESIDENTIAL,14815,0,14815,40043,0,54858
142238202500000,SE 231,RESIDENTIAL,14000,0,14000,28206,0,42206
142238202600000,SE 231,RESIDENTIAL,14000,0,14000,33542,0,47542
142238202700000,SE 231,RESIDENTIAL,14000,0,14000,55617,0,69617
142238202800000,SE 231,RESIDENTIAL,14000,0,14000,38803,0,52803
142238202900000,SE 231,RESIDENTIAL,12600,0,12600,51348,0,63948
142238203000000,SE 231,RESIDENTIAL,15400,0,15400,45327,0,60727
142238203100000,SE 231,RESIDENTIAL,14000,0,14000,40860,0,54860
142238203200000,SE 231,RESIDENTIAL,14000,0,14000,43875,0,57875
142238203300000,CONVERSION,COMMERCIAL,0,13608,13608,0,57935,71543
142238203400000,SE 231,RESIDENTIAL,14000,0,14000,43964,0,57964
142238203500000,SE 231,RESIDENTIAL,14000,0,14000,56143,0,70143
142238203600000,SE 231,RESIDENTIAL,14000,0,14000,42409,0,56409
142238203700000,SE 231,RESIDENTIAL,14000,0,14000,47021,0,61021
142238203800000,SE 231,RESIDENTIAL,12243,0,12243,41385,0,53628
142238300100000,SE 231,RESIDENTIAL,7035,0,7035,34853,0,41888
142238300200000,SE 231,RESIDENTIAL,7595,0,7595,45765,0,53360
142238300300000,SE 231,RESIDENTIAL,7595,0,7595,45817,0,53412
142238300400000,SE 231,RESIDENTIAL,7595,0,7595,42928,0,50523
142238300500000,SE 231,RESIDENTIAL,12152,0,12152,49028,0,61180
142238300600000,SE 231,RESIDENTIAL,14815,0,14815,54684,0,69499
142238300700000,SE 231,RESIDENTIAL,14840,0,14840,48080,0,62920
142238300800000,SE 231,RESIDENTIAL,14840,0,14840,53367,0,68207
142238300900000,SE 231,RESIDENTIAL,14840,0,14840,56431,0,71271
142238301000000,SE 231,RESIDENTIAL,14840,0,14840,59931,0,74771
142238301100000,SE 231,RESIDENTIAL,14840,0,14840,61326,0,76166
142238301200000,SE 231,RESIDENTIAL,14840,0,14840,47136,0,61976
142238301300000,SE 231,RESIDENTIAL,3301,0,3301,771,0,4072
142238301400000,SE 231,RESIDENTIAL,15211,0,15211,47096,0,62307
142238301500000,SMALL RETAIL,COMMERCIAL,0,30600,30600,0,96039,126639
142238302200000,SE 231,RESIDENTIAL,18921,0,18921,50271,0,69192
142238302300000,SE 231,RESIDENTIAL,15211,0,15211,46959,0,62170
142238302400000,SE 231,RESIDENTIAL,15399,0,15399,44601,0,60000
142238302500000,SE 231,RESIDENTIAL,14840,0,14840,46410,0,61250
142238302600000,SE 231,RESIDENTIAL,14840,0,14840,38683,0,53523
142238302700000,SE 231,RESIDENTIAL,11130,0,11130,53400,0,64530
142238302800000,SE 231,RESIDENTIAL,12985,0,12985,60638,0,73623
142238302900000,SE 231,RESIDENTIAL,12985,0,12985,37279,0,50264
142238303000000,SE 231,RESIDENTIAL,18921,0,18921,55672,0,74593
142238303100000,SE 231,RESIDENTIAL,7035,0,7035,31050,0,38085
142238303200000,SE 231,RESIDENTIAL,11911,0,11911,33929,0,45840
142238303300000,CONVENIENCE STORE,COMMERCIAL,0,297600,297600,0,681734,979334
142240100100000,SE 228,RESIDENTIAL,24479,0,24479,104457,0,128936
142240100200000,SE 228,RESIDENTIAL,25000,0,25000,98602,0,123602
142240100300000,SE 228,RESIDENTIAL,30000,0,30000,142753,0,172753
142240100400000,SE 228,RESIDENTIAL,30000,0,30000,128698,0,158698
142240100500000,SE 228,RESIDENTIAL,30000,0,30000,132859,0,162859
142240100600000,SE 228,RESIDENTIAL,30000,0,30000,115648,0,145648
142240100700000,SE 228,RESIDENTIAL,30000,0,30000,125426,0,155426
142240100800000,SE 228,RESIDENTIAL,30000,0,30000,132959,0,162959
142240100900000,SE 228,RESIDENTIAL,30000,0,30000,122759,0,152759
142240101000000,SE 228,RESIDENTIAL,30716,0,30716,203747,0,234463
142240101100000,SE 228,RESIDENTIAL,27667,0,27667,145526,0,173193
142240101200000,SE 228,RESIDENTIAL,30000,0,30000,165158,0,195158
142240101300000,SE 228,RESIDENTIAL,30000,0,30000,119048,0,149048
142240101400000,SE 228,RESIDENTIAL,30000,0,30000,93395,0,123395
142240101500000,SE 228,RESIDENTIAL,30000,0,30000,132547,0,162547
142240101600000,SE 228,RESIDENTIAL,30000,0,30000,141270,0,171270
142240101700000,SE 228,RESIDENTIAL,33750,0,33750,141860,0,175610
142240101800000,SE 228,RESIDENTIAL,33750,0,33750,131809,0,165559
142240101900000,SE 228,RESIDENTIAL,23999,0,23999,81702,0,105701
142240102000000,SE 228,RESIDENTIAL,20800,0,20800,96997,0,117797
142240102100000,SE 228,RESIDENTIAL,18975,0,18975,98964,0,117939
142240200100000,SE 228,RESIDENTIAL,31034,0,31034,148990,0,180024
142240200200000,SE 228,RESIDENTIAL,25000,0,25000,103773,0,128773
142240200300000,SE 228,RESIDENTIAL,30000,0,30000,122031,0,152031
142240200400000,SE 228,RESIDENTIAL,30000,0,30000,144949,0,174949
142240200500000,SE 228,RESIDENTIAL,30000,0,30000,104908,0,134908
142240200600000,SE 228,RESIDENTIAL,30000,0,30000,134482,0,164482
142240200700000,SE 228,RESIDENTIAL,32000,0,32000,111165,0,143165
142240200800000,SE 228,RESIDENTIAL,25000,0,25000,121777,0,146777
142240200900000,SE 228,RESIDENTIAL,25000,0,25000,102387,0,127387
142240201000000,SE 228,RESIDENTIAL,30716,0,30716,155462,0,186178
142240201100000,SE 228,RESIDENTIAL,10980,0,10980,86209,0,97189
142240201200000,SE 228,RESIDENTIAL,20647,0,20647,85362,0,106009
142240201300000,SE 228,RESIDENTIAL,30000,0,30000,107244,0,137244
142240201400000,SE 228,RESIDENTIAL,30000,0,30000,117995,0,147995
142240201500000,SE 228,RESIDENTIAL,30000,0,30000,150049,0,180049
142240201600000,SE 228,RESIDENTIAL,30000,0,30000,106166,0,136166
142240201700000,SE 228,RESIDENTIAL,30000,0,30000,152916,0,182916
142240201800000,SE 228,RESIDENTIAL,30000,0,30000,101447,0,131447
142240201900000,SE 228,RESIDENTIAL,30000,0,30000,100287,0,130287
142240202000000,SE 228,RESIDENTIAL,30000,0,30000,169271,0,199271
142240202100000,SE 228,RESIDENTIAL,25824,0,25824,120677,0,146501
142240202200000,SE 228,RESIDENTIAL,16000,0,16000,85316,0,101316
142240300100000,SE 228,RESIDENTIAL,26462,0,26462,93300,0,119762
142240300200000,SE 228,RESIDENTIAL,25810,0,25810,87253,0,113063
142240300300000,SE 228,RESIDENTIAL,29610,0,29610,111051,0,140661
142240300400000,SE 228,RESIDENTIAL,30566,0,30566,138828,0,169394
142240300500000,SE 228,RESIDENTIAL,30000,0,30000,194363,0,224363
142240300600000,SE 228,RESIDENTIAL,30000,0,30000,112483,0,142483
142240300700000,SE 228,RESIDENTIAL,30000,0,30000,115169,0,145169
142240300800000,SE 228,RESIDENTIAL,30000,0,30000,104795,0,134795
142240300900000,SE 228,RESIDENTIAL,25824,0,25824,105326,0,131150
142240301000000,SE 228,RESIDENTIAL,16000,0,16000,77708,0,93708
142240301100000,SE 228,RESIDENTIAL,15500,0,15500,93826,0,109326
142240301200000,SE 228,RESIDENTIAL,27141,0,27141,9673,0,36814
142240301300000,SE 228,RESIDENTIAL,36000,0,36000,107520,0,143520
142240301400000,SE 228,RESIDENTIAL,36000,0,36000,201819,0,237819
142240301500000,SE 228,RESIDENTIAL,36000,0,36000,140585,0,176585
142240301600000,SE 228,RESIDENTIAL,36000,0,36000,110266,0,146266
142240301700000,SE 228,RESIDENTIAL,35340,0,35340,179611,0,214951
142240301800000,SE 228,RESIDENTIAL,35340,0,35340,172395,0,207735
142240301900000,SE 228,RESIDENTIAL,37400,0,37400,173566,0,210966
142240302000000,SE 228,RESIDENTIAL,35800,0,35800,126338,0,162138
142240302100000,SE 228,RESIDENTIAL,34987,0,34987,122335,0,157322
142240400100000,SE 228,RESIDENTIAL,26284,0,26284,111764,0,138048
142240400200000,SE 228,RESIDENTIAL,30000,0,30000,70120,0,100120
142240400300000,SE 228,RESIDENTIAL,30000,0,30000,127298,0,157298
142240400400000,SE 228,RESIDENTIAL,30000,0,30000,124293,0,154293
142240400500000,SE 228,RESIDENTIAL,30000,0,30000,92335,0,122335
142240400600000,SE 228,RESIDENTIAL,30000,0,30000,91495,0,121495
142240400700000,SE 228,RESIDENTIAL,30000,0,30000,106315,0,136315
142240400800000,SE 228,RESIDENTIAL,30000,0,30000,123351,0,153351
142240400900000,SE 228,RESIDENTIAL,30000,0,30000,100369,0,130369
142240401000000,SE 228,RESIDENTIAL,27020,0,27020,118763,0,145783
142240401100000,SE 228,RESIDENTIAL,8256,0,8256,95068,0,103324
142240401200000,SE 228,RESIDENTIAL,27667,0,27667,81738,0,109405
142240401300000,SE 228,RESIDENTIAL,30000,0,30000,151297,0,181297
142240401400000,SE 228,RESIDENTIAL,30000,0,30000,116500,0,146500
142240401500000,SE 228,RESIDENTIAL,30000,0,30000,169933,0,199933
142240401600000,SE 228,RESIDENTIAL,30000,0,30000,115369,0,145369
142240401700000,SE 228,RESIDENTIAL,30000,0,30000,140082,0,170082
142240401800000,SE 228,RESIDENTIAL,30000,0,30000,123590,0,153590
142240401900000,SE 228,RESIDENTIAL,30000,0,30000,141638,0,171638
142240402000000,SE 228,RESIDENTIAL,30000,0,30000,146491,0,176491
142240402100000,SE 228,RESIDENTIAL,25824,0,25824,136480,0,162304
142240402200000,SE 228,RESIDENTIAL,16000,0,16000,88903,0,104903
142240500100000,CITY PROPERTY,EXEMPT,0,0,0,0,0,0
142240600100000,SE 247,RESIDENTIAL,73491,0,73491,210842,0,284333
142240600200000,SE 247,RESIDENTIAL,74529,0,74529,165844,0,240373
142240600300000,SE 247,RESIDENTIAL,76714,0,76714,156114,0,232828
142240600400000,SE 247,RESIDENTIAL,68450,0,68450,246868,0,315318
142240600500000,SE 247,RESIDENTIAL,71155,0,71155,177772,0,248927
142240600600000,SE 247,RESIDENTIAL,73480,0,73480,206621,0,280101
142240600700000,SE 247,RESIDENTIAL,64750,0,64750,155510,0,220260
142240600800000,SE 247,RESIDENTIAL,60720,0,60720,191711,0,252431
142240600900000,SE 247,RESIDENTIAL,77760,0,77760,230315,0,308075
142240601000000,CITY PROPERTY,EXEMPT,0,0,0,0,0,0
142240601100000,SE 247,RESIDENTIAL,176950,0,176950,308687,0,485637
142240601200000,SE 247,RESIDENTIAL,54672,0,54672,170335,0,225007
142240601300000,SE 247,RESIDENTIAL,70808,0,70808,237324,0,308132
142240601400000,SE 247,RESIDENTIAL,66156,0,66156,206234,0,272390
142240601500000,SE 247,RESIDENTIAL,70531,0,70531,336737,0,407268
142240601600000,SE 247,RESIDENTIAL,900,0,900,0,0,900
142240700100000,SE 247,RESIDENTIAL,175150,0,175150,142540,0,317690
142240800100000,SE 247,RESIDENTIAL,142975,0,142975,247846,0,390821
142240800200000,SE 247,RESIDENTIAL,83250,0,83250,239265,0,322515
142240800300000,SE 247,RESIDENTIAL,68000,0,68000,117005,0,185005
142240800400000,SE 247,RESIDENTIAL,60000,0,60000,119843,0,179843
142240800500000,SE 247,RESIDENTIAL,67500,0,67500,259852,0,327352
142242600100000,SE 230,RESIDENTIAL,19384,0,19384,98547,0,117931
142242600200000,SE 230,RESIDENTIAL,14000,0,14000,71533,0,85533
142242600300000,SE 230,RESIDENTIAL,15750,0,15750,54572,0,70322
142242600400000,SE 230,RESIDENTIAL,17500,0,17500,79019,0,96519
142242600500000,SE 230,RESIDENTIAL,14000,0,14000,60576,0,74576
142242600600000,SE 230,RESIDENTIAL,14000,0,14000,78206,0,92206
142242600700000,SE 230,RESIDENTIAL,14000,0,14000,56851,0,70851
142242600800000,SE 230,RESIDENTIAL,8432,0,8432,65159,0,73591
142242600900000,SE 230,RESIDENTIAL,9134,0,9134,55856,0,64990
142242601000000,SE 230,RESIDENTIAL,7621,0,7621,54613,0,62234
142242601100000,SE 230,RESIDENTIAL,7508,0,7508,51918,0,59426
142242601200000,SE 230,RESIDENTIAL,7849,0,7849,57936,0,65785
142242601300000,SE 230,RESIDENTIAL,7849,0,7849,50052,0,57901
142242601400000,SE 230,RESIDENTIAL,13954,0,13954,53807,0,67761
142242601500000,SE 230,RESIDENTIAL,14000,0,14000,40973,0,54973
142242601600000,SE 230,RESIDENTIAL,14000,0,14000,69832,0,83832
142242601700000,SE 230,RESIDENTIAL,17500,0,17500,52712,0,70212
142242601800000,SE 230,RESIDENTIAL,17500,0,17500,83040,0,100540
142242601900000,SE 230,RESIDENTIAL,14000,0,14000,73951,0,87951
142242602000000,SE 230,RESIDENTIAL,14000,0,14000,54971,0,68971
142242602100000,SE 230,RESIDENTIAL,12542,0,12542,56599,0,69141
142242602200000,SE 230,RESIDENTIAL,14445,0,14445,88588,0,103033
142242602300000,SE 230,RESIDENTIAL,19000,0,19000,58032,0,77032
142242602400000,SE 230,RESIDENTIAL,20290,0,20290,59547,0,79837
142242700100000,SE 230,RESIDENTIAL,11210,0,11210,56647,0,67857
142242700200000,SE 230,RESIDENTIAL,12795,0,12795,44241,0,57036
142242700300000,SE 230,RESIDENTIAL,15790,0,15790,38300,0,54090
142242700400000,CONVERSION,EXEMPT,0,13206,13206,0,80558,93764
142242700500000,SE 230,RESIDENTIAL,13685,0,13685,60003,0,73688
142242700600000,SE 230,RESIDENTIAL,11680,0,11680,56416,0,68096
142242700700000,SE 230,RESIDENTIAL,17850,0,17850,61452,0,79302
142242700800000,SE 230,RESIDENTIAL,14000,0,14000,57580,0,71580
142242700900000,SE 230,RESIDENTIAL,14000,0,14000,65835,0,79835
142242701000000,SE 230,RESIDENTIAL,14000,0,14000,66577,0,80577
142242701100000,APARTMENT,COMMERCIAL,0,16800,16800,0,123194,139994
142242701200000,SMALL RETAIL,COMMERCIAL,0,12600,12600,0,60025,72625
142242701300000,SE 230,RESIDENTIAL,6510,0,6510,39596,0,46106
142242701400000,SE 230,RESIDENTIAL,8680,0,8680,52379,0,61059
142242701500000,SE 230,RESIDENTIAL,13860,0,13860,56856,0,70716
142242701600000,SE 230,RESIDENTIAL,13860,0,13860,80239,0,94099
142242701700000,SE 230,RESIDENTIAL,17325,0,17325,77752,0,95077
142242701800000,SE 230,RESIDENTIAL,13629,0,13629,75820,0,89449
142242701900000,SE 230,RESIDENTIAL,13167,0,13167,75878,0,89045
142242702000000,SE 230,RESIDENTIAL,7728,0,7728,52434,0,60162
142242702100000,SE 230,RESIDENTIAL,8275,0,8275,65224,0,73499
142242702200000,SE 230,RESIDENTIAL,7508,0,7508,50898,0,58406
142242702300000,SE 230,RESIDENTIAL,7280,0,7280,12720,0,20000
142242702400000,SE 230,RESIDENTIAL,10780,0,10780,70341,0,81121
142242702500000,SE 230,RESIDENTIAL,10780,0,10780,62068,0,72848
142242800100000,SE 230,RESIDENTIAL,21000,0,21000,70869,0,91869
142242800200000,SE 230,RESIDENTIAL,11270,0,11270,59398,0,70668
142242800300000,SE 230,RESIDENTIAL,12880,0,12880,25817,0,38697
142242800400000,SE 230,RESIDENTIAL,12236,0,12236,64192,0,76428
142242800500000,SE 230,RESIDENTIAL,11914,0,11914,20683,0,32597
142242800600000,SE 230,RESIDENTIAL,12236,0,12236,58806,0,71042
142242800700000,SE 230,RESIDENTIAL,11914,0,11914,50408,0,62322
142242800800000,SMALL RETAIL,EXEMPT,0,26730,26730,0,127926,154656
142242800900000,SE 230,RESIDENTIAL,7053,0,7053,32969,0,40022
142242801000000,SE 230,RESIDENTIAL,7053,0,7053,49606,0,56659
142242801100000,SE 230,EXEMPT,0,5813,5813,26344,0,32157
142242801200000,SE 230,EXEMPT,0,8138,8138,0,25764,33902
142242801300000,SE 230,RESIDENTIAL,17850,0,17850,58955,0,76805
142242801400000,SE 230,RESIDENTIAL,10500,0,10500,56395,0,66895
142242801500000,SE 230,RESIDENTIAL,10500,0,10500,58691,0,69191
142242801600000,SE 230,RESIDENTIAL,17850,0,17850,49589,0,67439
142242900100000,SE 230,RESIDENTIAL,15040,0,15040,82546,0,97586
142242900200000,SE 230,RESIDENTIAL,14000,0,14000,43033,0,57033
142242900300000,SE 230,RESIDENTIAL,14000,0,14000,59584,0,73584
142242900400000,SE 230,RESIDENTIAL,14000,0,14000,60683,0,74683
142242900500000,SE 230,RESIDENTIAL,14000,0,14000,64176,0,78176
142242900600000,SE 230,RESIDENTIAL,14000,0,14000,59178,0,73178
142242900700000,SE 230,RESIDENTIAL,10500,0,10500,45153,0,55653
142242900800000,SE 230,RESIDENTIAL,10500,0,10500,42128,0,52628
142242900900000,SE 230,RESIDENTIAL,10500,0,10500,48972,0,59472
142242901000000,SE 230,RESIDENTIAL,11826,0,11826,43657,0,55483
142242901100000,SE 230,RESIDENTIAL,9390,0,9390,51792,0,61182
142242901200000,SE 230,RESIDENTIAL,7621,0,7621,46586,0,54207
142242901300000,SE 230,RESIDENTIAL,7508,0,7508,45515,0,53023
142242901400000,SE 230,RESIDENTIAL,7366,0,7366,43296,0,50662
142242901500000,SE 230,RESIDENTIAL,8332,0,8332,49036,0,57368
142242901600000,SE 230,RESIDENTIAL,8495,0,8495,36181,0,44676
142242901700000,SE 230,RESIDENTIAL,7921,0,7921,36014,0,43935
142242901800000,SE 230,RESIDENTIAL,14000,0,14000,40066,0,54066
142242901900000,SE 230,RESIDENTIAL,14000,0,14000,59959,0,73959
142242902000000,SE 230,RESIDENTIAL,17500,0,17500,67522,0,85022
142242902100000,SE 230,RESIDENTIAL,17500,0,17500,56877,0,74377
142242902200000,SE 230,RESIDENTIAL,14000,0,14000,51479,0,65479
142242902300000,SE 230,RESIDENTIAL,14000,0,14000,76451,0,90451
142242902400000,SE 230,RESIDENTIAL,14000,0,14000,80102,0,94102
142242902500000,SE 230,RESIDENTIAL,14946,0,14946,67122,0,82068
142242902600000,SE 230,RESIDENTIAL,12825,0,12825,58265,0,71090
142242902700000,SE 230,RESIDENTIAL,15500,0,15500,60093,0,75593
142243000100000,SE 230,RESIDENTIAL,8504,0,8504,53752,0,62256
142243000200000,SE 230,RESIDENTIAL,8176,0,8176,42135,0,50311
142243000300000,SE 230,RESIDENTIAL,13300,0,13300,62077,0,75377
142243000400000,SE 230,RESIDENTIAL,12833,0,12833,48007,0,60840
142243000500000,SE 230,RESIDENTIAL,10500,0,10500,58188,0,68688
142243000600000,SE 230,RESIDENTIAL,10500,0,10500,0,0,10500
142243000700000,SE 230,RESIDENTIAL,10500,0,10500,48905,0,59405
142243000800000,SE 230,RESIDENTIAL,14000,0,14000,46651,0,60651
142243000900000,OFFICE,EXEMPT,0,27216,27216,0,363202,390418
142243001000000,VACANT LAND,EXEMPT,0,27216,27216,0,32228,59444
142243001100000,APARTMENT,COMMERCIAL,0,16800,16800,0,132494,149294
142243001200000,SE 230,RESIDENTIAL,17850,0,17850,64206,0,82056
142243001300000,CONVERSION,COMMERCIAL,0,5832,5832,0,91182,97014
142243001400000,SE 230,RESIDENTIAL,9765,0,9765,26783,0,36548
142243001500000,SE 230,RESIDENTIAL,7595,0,7595,45676,0,53271
142243001600000,SE 230,RESIDENTIAL,14000,0,14000,48166,0,62166
142243001700000,SE 230,RESIDENTIAL,17500,0,17500,41473,0,58973
142243001800000,SE 230,RESIDENTIAL,14000,0,14000,43568,0,57568
142243001900000,SE 230,RESIDENTIAL,13767,0,13767,66713,0,80480
142243002000000,SE 230,RESIDENTIAL,13300,0,13300,67455,0,80755
142243002100000,SE 230,RESIDENTIAL,12779,0,12779,53227,0,66006
142243002200000,SE 230,RESIDENTIAL,8400,0,8400,62264,0,70664
142243002300000,SE 230,RESIDENTIAL,7053,0,7053,42031,0,49084
142243002400000,SE 230,RESIDENTIAL,7963,0,7963,71982,0,79945
142243002500000,SE 230,RESIDENTIAL,7849,0,7849,35105,0,42954
142243100100000,SE 230,RESIDENTIAL,9800,0,9800,64034,0,73834
142243100200000,SE 230,RESIDENTIAL,9310,0,9310,53101,0,62411
142243100300000,SE 230,RESIDENTIAL,9310,0,9310,66889,0,76199
142243100400000,SE 230,EXEMPT,0,9500,9500,40197,0,49697
142243100500000,SE 230,RESIDENTIAL,9800,0,9800,55456,0,65256
142243100600000,SE 230,RESIDENTIAL,7000,0,7000,0,0,7000
142243100700000,SE 230,RESIDENTIAL,9800,0,9800,58819,0,68619
142243100800000,SE 230,RESIDENTIAL,12880,0,12880,57920,0,70800
142243100900000,SE 230,RESIDENTIAL,12880,0,12880,75142,0,88022
142243101000000,SE 230,RESIDENTIAL,12880,0,12880,54416,0,67296
142243101100000,SE 230,RESIDENTIAL,16422,0,16422,68419,0,84841
142243101200000,APARTMENT,COMMERCIAL,0,9000,9000,0,91046,100046
142243101300000,SE 230,RESIDENTIAL,6402,0,6402,12250,0,18652
142243101400000,SE 230,EXEMPT,0,7704,7704,0,48713,56417
142243101500000,SE 230,RESIDENTIAL,10500,0,10500,54228,0,64728
142243101600000,SE 230,RESIDENTIAL,10500,0,10500,50755,0,61255
142243101700000,SE 230,RESIDENTIAL,17850,0,17850,62504,0,80354
142243101800000,SE 230,RESIDENTIAL,14000,0,14000,62614,0,76614
142243101900000,SE 230,RESIDENTIAL,9800,0,9800,57079,0,66879
142243200100000,SE 230,RESIDENTIAL,15087,0,15087,45913,0,61000
142243200200000,SE 230,RESIDENTIAL,13717,0,13717,42754,0,56471
142243200300000,SE 230,RESIDENTIAL,14000,0,14000,75070,0,89070
142243200400000,SE 230,RESIDENTIAL,14000,0,14000,51326,0,65326
142243200500000,SE 230,RESIDENTIAL,14000,0,14000,44000,0,58000
142243200600000,SE 230,RESIDENTIAL,14000,0,14000,72216,0,86216
142243200700000,SE 230,RESIDENTIAL,14000,0,14000,62857,0,76857
142243200800000,SE 230,RESIDENTIAL,10500,0,10500,52975,0,63475
142243200900000,SE 230,RESIDENTIAL,7665,0,7665,48572,0,56237
142243201000000,SE 230,RESIDENTIAL,14035,0,14035,73663,0,87698
142243201100000,SE 230,RESIDENTIAL,16437,0,16437,64337,0,80774
142243201200000,SE 230,RESIDENTIAL,7849,0,7849,46616,0,54465
142243201300000,SE 230,RESIDENTIAL,7849,0,7849,41033,0,48882
142243201400000,SE 230,RESIDENTIAL,8495,0,8495,65364,0,73859
142243201500000,SE 230,RESIDENTIAL,7921,0,7921,44121,0,52042
142243201600000,SE 230,RESIDENTIAL,14000,0,14000,43480,0,57480
142243201700000,SE 230,RESIDENTIAL,14000,0,14000,59539,0,73539
142243201800000,SE 230,RESIDENTIAL,10500,0,10500,40673,0,51173
142243201900000,SE 230,RESIDENTIAL,14000,0,14000,57058,0,71058
142243202000000,SE 230,RESIDENTIAL,10500,0,10500,42930,0,53430
142243202100000,SE 230,RESIDENTIAL,14000,0,14000,61354,0,75354
142243202200000,SE 230,RESIDENTIAL,14000,0,14000,48304,0,62304
142243202300000,SE 230,RESIDENTIAL,14000,0,14000,55455,0,69455
142243202400000,SE 230,RESIDENTIAL,20636,0,20636,55192,0,75828
142243202500000,SE 230,RESIDENTIAL,14250,0,14250,66071,0,80321
142243202600000,SE 230,RESIDENTIAL,16455,0,16455,50108,0,66563
142243300100000,SE 230,RESIDENTIAL,8598,0,8598,48984,0,57582
142243300200000,SE 230,RESIDENTIAL,8176,0,8176,45849,0,54025
142243300300000,SE 230,RESIDENTIAL,13300,0,13300,58232,0,71532
142243300400000,SE 230,RESIDENTIAL,12833,0,12833,69807,0,82640
142243300500000,SE 230,RESIDENTIAL,15750,0,15750,66985,0,82735
142243300600000,SE 230,RESIDENTIAL,12250,0,12250,58816,0,71066
142243300700000,SE 230,RESIDENTIAL,14000,0,14000,64781,0,78781
142243300800000,SE 230,RESIDENTIAL,14000,0,14000,53636,0,67636
142243300900000,SE 230,RESIDENTIAL,14000,0,14000,75639,0,89639
142243301000000,SE 230,EXEMPT,0,10333,10333,63182,0,73515
142243301100000,APARTMENT,COMMERCIAL,0,13720,13720,0,114780,128500
142243301200000,SE 230,RESIDENTIAL,8575,0,8575,40616,0,49191
142243301300000,SE 230,RESIDENTIAL,8575,0,8575,51027,0,59602
142243301400000,SE 230,RESIDENTIAL,8575,0,8575,47607,0,56182
142243301500000,SE 230,RESIDENTIAL,8575,0,8575,50359,0,58934
142243301600000,SE 230,RESIDENTIAL,14000,0,14000,54025,0,68025
142243301700000,SE 230,RESIDENTIAL,14000,0,14000,70253,0,84253
142243301800000,SE 230,RESIDENTIAL,14000,0,14000,60653,0,74653
142243301900000,SE 230,RESIDENTIAL,15750,0,15750,77640,0,93390
142243302000000,CENTRALLY ASSESSED,OTHER,0,0,0,0,0,0
142243302100000,SE 230,RESIDENTIAL,16276,0,16276,35261,0,51537
142243302200000,SE 230,RESIDENTIAL,13767,0,13767,48198,0,61965
142243302300000,SE 230,RESIDENTIAL,12103,0,12103,42890,0,54993
142243302400000,SE 230,RESIDENTIAL,8176,0,8176,48943,0,57119
142243302500000,SE 230,RESIDENTIAL,8470,0,8470,45520,0,53990
142243302600000,SE 230,RESIDENTIAL,7280,0,7280,44211,0,51491
142243302700000,SE 230,RESIDENTIAL,9896,0,9896,60230,0,70126
142243302800000,SE 230,RESIDENTIAL,8575,0,8575,53584,0,62159
142243302900000,SE 230,RESIDENTIAL,7245,0,7245,37131,0,44376
142243400100000,SE 230,RESIDENTIAL,13922,0,13922,70772,0,84694
142243400200000,SE 230,RESIDENTIAL,14000,0,14000,59905,0,73905
142243400300000,SE 230,EXEMPT,0,10000,10000,75915,0,85915
142243400400000,SE 230,RESIDENTIAL,13650,0,13650,68311,0,81961
142243400500000,SE 230,RESIDENTIAL,14000,0,14000,54061,0,68061
142243400600000,SE 230,RESIDENTIAL,11808,0,11808,57471,0,69279
142243400700000,SE 230,EXEMPT,0,5344,5344,75120,0,80464
142243400800000,SE 230,RESIDENTIAL,7481,0,7481,37626,0,45107
142243400900000,SE 230,RESIDENTIAL,10787,0,10787,67271,0,78058
142243401000000,SE 230,EXEMPT,0,5025,5025,51530,0,56555
142243401100000,SE 230,RESIDENTIAL,7623,0,7623,43530,0,51153
142243401200000,SE 230,RESIDENTIAL,7623,0,7623,39244,0,46867
142243401300000,SE 230,RESIDENTIAL,14117,0,14117,41460,0,55577
142243401400000,SE 230,RESIDENTIAL,13883,0,13883,47973,0,61856
142243401500000,SE 230,RESIDENTIAL,13650,0,13650,49687,0,63337
142243401600000,SE 230,RESIDENTIAL,8575,0,8575,57859,0,66434
142243401700000,SE 230,RESIDENTIAL,11025,0,11025,62680,0,73705
142243401800000,SE 230,RESIDENTIAL,9310,0,9310,37434,0,46744
142243401900000,SE 230,RESIDENTIAL,9310,0,9310,44903,0,54213
142243402000000,SE 230,RESIDENTIAL,6983,0,6983,41551,0,48534
142243402100000,SE 230,RESIDENTIAL,4190,0,4190,23854,0,28044
142243500100000,SE 230,RESIDENTIAL,21486,0,21486,91128,0,112614
142243500200000,SE 230,RESIDENTIAL,15500,0,15500,45859,0,61359
142243500300000,SE 230,RESIDENTIAL,14000,0,14000,48642,0,62642
142243500400000,SE 230,RESIDENTIAL,14000,0,14000,56598,0,70598
142243500500000,SE 230,RESIDENTIAL,14000,0,14000,58713,0,72713
142243500600000,SE 230,RESIDENTIAL,14000,0,14000,71489,0,85489
142243500700000,SE 230,RESIDENTIAL,13898,0,13898,74698,0,88596
142243500800000,SE 230,RESIDENTIAL,14000,0,14000,76659,0,90659
142243500900000,SE 230,RESIDENTIAL,14000,0,14000,63356,0,77356
142243501000000,SE 230,RESIDENTIAL,10220,0,10220,42322,0,52542
142243501100000,SE 230,RESIDENTIAL,12456,0,12456,64016,0,76472
142243501200000,SE 230,RESIDENTIAL,9100,0,9100,52595,0,61695
142243501300000,SE 230,RESIDENTIAL,8986,0,8986,45467,0,54453
142243600100000,SE 230,RESIDENTIAL,8598,0,8598,65508,0,74106
142243600200000,SE 230,RESIDENTIAL,8176,0,8176,44473,0,52649
142243600300000,SE 230,RESIDENTIAL,13300,0,13300,63513,0,76813
142243600400000,SE 230,EXEMPT,0,9167,9167,67335,0,76502
142243600500000,SE 230,RESIDENTIAL,17582,0,17582,54001,0,71583
142243600600000,SE 230,RESIDENTIAL,14000,0,14000,62620,0,76620
142243600700000,SE 230,RESIDENTIAL,14000,0,14000,64740,0,78740
142243600800000,SE 230,RESIDENTIAL,14000,0,14000,57069,0,71069
142243600900000,SE 230,RESIDENTIAL,14000,0,14000,62128,0,76128
142243601000000,SE 230,RESIDENTIAL,14350,0,14350,74106,0,88456
142243601100000,SE 230,RESIDENTIAL,8902,0,8902,61665,0,70567
142243601200000,SE 230,RESIDENTIAL,14155,0,14155,69077,0,83232
142243601300000,SE 230,RESIDENTIAL,7718,0,7718,55685,0,63403
142243601400000,SE 230,RESIDENTIAL,8090,0,8090,55638,0,63728
142243700100000,SE 230,RESIDENTIAL,9800,0,9800,43593,0,53393
142243700200000,SE 230,RESIDENTIAL,9800,0,9800,58516,0,68316
142243700300000,SE 230,RESIDENTIAL,14000,0,14000,72804,0,86804
142243700400000,SE 230,RESIDENTIAL,14000,0,14000,67015,0,81015
142243700500000,SE 230,RESIDENTIAL,14000,0,14000,55181,0,69181
142243700600000,SE 230,EXEMPT,0,6125,6125,42771,0,48896
142243700700000,SE 230,RESIDENTIAL,8575,0,8575,73543,0,82118
142243700800000,SE 230,RESIDENTIAL,8575,0,8575,44329,0,52904
142243700900000,SE 230,RESIDENTIAL,8575,0,8575,0,0,8575
142243701000000,SE 230,RESIDENTIAL,9310,0,9310,51018,0,60328
142243701100000,SE 230,RESIDENTIAL,9310,0,9310,59440,0,68750
142245100100000,SE 230,RESIDENTIAL,14250,0,14250,30652,0,44902
142245100200000,SE 230,RESIDENTIAL,15295,0,15295,80392,0,95687
142245100300000,SE 230,RESIDENTIAL,10500,0,10500,60598,0,71098
142245100400000,SE 230,RESIDENTIAL,10500,0,10500,61470,0,71970
142245100500000,SE 230,RESIDENTIAL,14000,0,14000,51420,0,65420
142245100600000,SE 230,RESIDENTIAL,14000,0,14000,55301,0,69301
142245100700000,SE 230,RESIDENTIAL,14000,0,14000,55910,0,69910
142245100800000,SE 230,RESIDENTIAL,14000,0,14000,66117,0,80117
142245100900000,SE 230,RESIDENTIAL,19600,0,19600,74825,0,94425
142245101000000,SE 230,RESIDENTIAL,7849,0,7849,46267,0,54116
142245101100000,SE 230,RESIDENTIAL,7849,0,7849,39503,0,47352
142245101200000,SE 230,RESIDENTIAL,8495,0,8495,46196,0,54691
142245101300000,SE 230,RESIDENTIAL,7921,0,7921,45085,0,53006
142245200100000,SE 230,RESIDENTIAL,8304,0,8304,55338,0,63642
142245200200000,SE 230,RESIDENTIAL,12171,0,12171,52497,0,64668
142245200300000,SE 230,RESIDENTIAL,10514,0,10514,46918,0,57432
142245200400000,SE 230,RESIDENTIAL,13790,0,13790,45464,0,59254
142245200500000,SE 230,RESIDENTIAL,20498,0,20498,80653,0,101151
142245200600000,SE 230,RESIDENTIAL,14000,0,14000,49072,0,63072
142245200700000,SE 230,RESIDENTIAL,12250,0,12250,56226,0,68476
142245200800000,SE 230,RESIDENTIAL,15750,0,15750,70097,0,85847
142245200900000,SE 230,RESIDENTIAL,14000,0,14000,60397,0,74397
142245201000000,SE 230,RESIDENTIAL,14175,0,14175,53078,0,67253
142245201100000,SE 230,RESIDENTIAL,11620,0,11620,58455,0,70075
142245201200000,SE 230,RESIDENTIAL,12094,0,12094,61942,0,74036
142245300100000,SE 230,RESIDENTIAL,9310,0,9310,38123,0,47433
142245300200000,SE 230,RESIDENTIAL,9310,0,9310,43515,0,52825
142245300300000,SE 230,RESIDENTIAL,9800,0,9800,52673,0,62473
142245300400000,SE 230,RESIDENTIAL,9800,0,9800,45124,0,54924
142245300500000,SE 230,RESIDENTIAL,14000,0,14000,58002,0,72002
142245300600000,SE 230,RESIDENTIAL,14000,0,14000,57140,0,71140
142245300700000,SE 230,RESIDENTIAL,14000,0,14000,65419,0,79419
142245300800000,SE 230,RESIDENTIAL,8575,0,8575,44605,0,53180
142245300900000,SE 230,RESIDENTIAL,8575,0,8575,48583,0,57158
142245301100000,SE 230,RESIDENTIAL,8575,0,8575,45969,0,54544
142245302000000,SE 230,RESIDENTIAL,8575,0,8575,49356,0,57931
142245400100000,SE 230,RESIDENTIAL,13755,0,13755,66161,0,79916
142245400200000,SE 230,RESIDENTIAL,13720,0,13720,70515,0,84235
142245400300000,SE 230,RESIDENTIAL,13720,0,13720,70321,0,84041
142245400400000,SE 230,RESIDENTIAL,13720,0,13720,50132,0,63852
142245400500000,SE 230,RESIDENTIAL,10290,0,10290,55570,0,65860
142245400600000,SE 230,RESIDENTIAL,10290,0,10290,56469,0,66759
142245400700000,SE 230,RESIDENTIAL,13720,0,13720,43493,0,57213
142245400800000,SE 230,RESIDENTIAL,13720,0,13720,46666,0,60386
142245400900000,SE 230,RESIDENTIAL,13565,0,13565,79457,0,93022
142245401000000,SE 230,RESIDENTIAL,10976,0,10976,55778,0,66754
142245401100000,SE 230,RESIDENTIAL,11433,0,11433,58528,0,69961
142245401200000,SE 230,RESIDENTIAL,11241,0,11241,48353,0,59594
142245401300000,SE 230,RESIDENTIAL,7046,0,7046,43436,0,50482
142245401400000,SE 230,RESIDENTIAL,7739,0,7739,53148,0,60887
142245401500000,SE 230,RESIDENTIAL,8201,0,8201,57493,0,65694
142245401600000,SE 230,RESIDENTIAL,10500,0,10500,59348,0,69848
142245401700000,SE 230,RESIDENTIAL,11200,0,11200,49016,0,60216
142245401800000,SE 230,RESIDENTIAL,11900,0,11900,65414,0,77314
142245401900000,SE 230,RESIDENTIAL,15561,0,15561,63257,0,78818
142245402000000,SE 230,RESIDENTIAL,14600,0,14600,49049,0,63649
142245402100000,SE 230,RESIDENTIAL,17347,0,17347,66068,0,83415
142245402200000,SE 230,RESIDENTIAL,15250,0,15250,62809,0,78059
142245500100000,SE 230,RESIDENTIAL,10413,0,10413,60884,0,71297
142245500200000,SE 230,RESIDENTIAL,10710,0,10710,31600,0,42310
142245500300000,SE 230,RESIDENTIAL,14887,0,14887,79575,0,94462
142245500400000,SE 230,RESIDENTIAL,14000,0,14000,54469,0,68469
142245500500000,SE 230,RESIDENTIAL,14000,0,14000,53575,0,67575
142245500600000,SE 230,RESIDENTIAL,14000,0,14000,68343,0,82343
142245500700000,SE 230,RESIDENTIAL,14000,0,14000,76335,0,90335
142245500800000,SE 230,RESIDENTIAL,14427,0,14427,77252,0,91679
142245500900000,SE 230,RESIDENTIAL,14697,0,14697,68497,0,83194
142245501000000,SE 230,RESIDENTIAL,11183,0,11183,67523,0,78706
142245501100000,SE 230,RESIDENTIAL,15575,0,15575,53612,0,69187
142245501200000,SE 230,RESIDENTIAL,15034,0,15034,56295,0,71329
142245501300000,SE 230,RESIDENTIAL,11620,0,11620,46267,0,57887
142245501400000,SE 230,RESIDENTIAL,19600,0,19600,84191,0,103791
142245501500000,SE 230,RESIDENTIAL,16100,0,16100,56170,0,72270
142245501600000,SE 230,RESIDENTIAL,18760,0,18760,86507,0,105267
142245501700000,SE 230,RESIDENTIAL,13416,0,13416,58865,0,72281
142245501800000,SE 230,RESIDENTIAL,16100,0,16100,56296,0,72396
142245501900000,SE 230,RESIDENTIAL,15925,0,15925,66798,0,82723
142245502000000,SE 230,RESIDENTIAL,15120,0,15120,58266,0,73386
142245502100000,SE 230,RESIDENTIAL,14805,0,14805,51204,0,66009
142245502200000,SE 230,RESIDENTIAL,12320,0,12320,53577,0,65897
142245502300000,SE 230,RESIDENTIAL,12180,0,12180,50297,0,62477
142245502400000,SE 230,RESIDENTIAL,12040,0,12040,49454,0,61494
142245502500000,SE 230,RESIDENTIAL,11327,0,11327,46153,0,57480
142245502600000,SE 230,RESIDENTIAL,10360,0,10360,38135,0,48495
142245502700000,SE 230,RESIDENTIAL,10500,0,10500,47330,0,57830
142245502800000,SE 230,RESIDENTIAL,10500,0,10500,0,0,10500
142245502900000,SE 230,RESIDENTIAL,10229,0,10229,44543,0,54772
142245503000000,SE 230,RESIDENTIAL,12880,0,12880,60838,0,73718
142245503100000,SE 230,RESIDENTIAL,12740,0,12740,51212,0,63952
142245503200000,SE 230,RESIDENTIAL,12740,0,12740,50238,0,62978
142245503300000,SE 230,RESIDENTIAL,14175,0,14175,59791,0,73966
142245503400000,SE 230,RESIDENTIAL,15750,0,15750,51992,0,67742
142245503500000,SE 230,RESIDENTIAL,15575,0,15575,52880,0,68455
142245503600000,SE 230,RESIDENTIAL,14525,0,14525,47114,0,61639
142245503700000,SE 230,RESIDENTIAL,14719,0,14719,46007,0,60726
142245503800000,SE 230,RESIDENTIAL,18900,0,18900,56521,0,75421
142245503900000,SE 230,RESIDENTIAL,14420,0,14420,46291,0,60711
142245504000000,SE 230,RESIDENTIAL,14140,0,14140,43905,0,58045
142245504100000,SE 230,RESIDENTIAL,13860,0,13860,39828,0,53688
142245504200000,SE 230,RESIDENTIAL,9882,0,9882,61830,0,71712
142245504300000,SE 230,RESIDENTIAL,10234,0,10234,35835,0,46069
142245600100000,SE 230,RESIDENTIAL,14000,0,14000,53655,0,67655
142245600200000,SE 230,RESIDENTIAL,14000,0,14000,55207,0,69207
142245600300000,SE 230,RESIDENTIAL,14000,0,14000,67784,0,81784
142245600400000,SE 230,RESIDENTIAL,14000,0,14000,55272,0,69272
142245600500000,SE 230,RESIDENTIAL,14000,0,14000,40863,0,54863
142245600600000,SE 230,RESIDENTIAL,8575,0,8575,36137,0,44712
142245600700000,SE 230,RESIDENTIAL,8575,0,8575,43418,0,51993
142245600800000,SE 230,RESIDENTIAL,8575,0,8575,46654,0,55229
142245600900000,SE 230,RESIDENTIAL,8575,0,8575,41722,0,50297
142245601000000,SE 230,RESIDENTIAL,7963,0,7963,47797,0,55760
142245601100000,SE 230,RESIDENTIAL,7963,0,7963,54901,0,62864
142245601200000,SE 230,RESIDENTIAL,8943,0,8943,44995,0,53938
142245601300000,SE 230,RESIDENTIAL,8943,0,8943,40460,0,49403
142245601400000,SE 230,RESIDENTIAL,14000,0,14000,40644,0,54644
142245601500000,SE 230,RESIDENTIAL,14000,0,14000,72931,0,86931
142245601600000,SE 230,RESIDENTIAL,19600,0,19600,73125,0,92725
142245601700000,SE 230,RESIDENTIAL,14000,0,14000,57780,0,71780
142245700100000,SE 230,RESIDENTIAL,22800,0,22800,60638,0,83438
142245700200000,SE 230,RESIDENTIAL,13020,0,13020,54072,0,67092
142245700300000,SE 230,RESIDENTIAL,13440,0,13440,66178,0,79618
142245700400000,SE 230,RESIDENTIAL,13580,0,13580,57340,0,70920
142245700500000,SE 230,RESIDENTIAL,13860,0,13860,63567,0,77427
142245700600000,SE 230,RESIDENTIAL,12460,0,12460,50140,0,62600
142245700700000,SE 230,RESIDENTIAL,18707,0,18707,51387,0,70094
142245700800000,SE 230,RESIDENTIAL,10780,0,10780,43134,0,53914
142245700900000,SE 230,RESIDENTIAL,14420,0,14420,46006,0,60426
142245701000000,SE 230,RESIDENTIAL,14420,0,14420,49445,0,63865
142245701100000,SE 230,RESIDENTIAL,14420,0,14420,51188,0,65608
142245701200000,SE 230,RESIDENTIAL,14560,0,14560,49948,0,64508
142245701300000,SE 230,RESIDENTIAL,14560,0,14560,46097,0,60657
142245701400000,SE 230,RESIDENTIAL,11472,0,11472,48694,0,60166
142245701500000,SE 230,RESIDENTIAL,10780,0,10780,44748,0,55528
142245701600000,SE 230,RESIDENTIAL,10780,0,10780,54571,0,65351
142245701700000,SE 230,RESIDENTIAL,10286,0,10286,25872,0,36158
142245701800000,SE 230,RESIDENTIAL,14336,0,14336,39873,0,54209
142245701900000,SE 230,RESIDENTIAL,10780,0,10780,46139,0,56919
142245702000000,SE 230,RESIDENTIAL,10780,0,10780,45374,0,56154
142245702100000,SE 230,RESIDENTIAL,10654,0,10654,53592,0,64246
142245702200000,SE 230,RESIDENTIAL,18800,0,18800,56361,0,75161
142245702300000,SE 230,RESIDENTIAL,20800,0,20800,59631,0,80431
142245702400000,SE 230,RESIDENTIAL,20800,0,20800,68059,0,88859
142245702500000,SE 230,RESIDENTIAL,20800,0,20800,58153,0,78953
142245702600000,SE 230,RESIDENTIAL,20800,0,20800,59694,0,80494
142245702700000,SE 230,RESIDENTIAL,16600,0,16600,58898,0,75498
142245800100000,SE 230,RESIDENTIAL,15965,0,15965,54739,0,70704
142245800200000,SE 230,RESIDENTIAL,15400,0,15400,67282,0,82682
142245800300000,SE 230,RESIDENTIAL,15400,0,15400,44291,0,59691
142245800400000,SE 230,RESIDENTIAL,15400,0,15400,48183,0,63583
142245800500000,SE 230,RESIDENTIAL,17025,0,17025,72280,0,89305
142245800600000,SE 230,RESIDENTIAL,26617,0,26617,60961,0,87578
142245800700000,SE 230,RESIDENTIAL,26796,0,26796,81064,0,107860
142245800800000,SE 230,RESIDENTIAL,26796,0,26796,118917,0,145713
142245800900000,SE 230,RESIDENTIAL,26979,0,26979,94373,0,121352
142245801000000,SE 230,RESIDENTIAL,30000,0,30000,87276,0,117276
142245801100000,SR/NURSING/ASSTD LIV,COMMERCIAL,0,136800,136800,0,1867996,2004796
142245801200000,SE 230,RESIDENTIAL,13230,0,13230,47128,0,60358
142245801300000,SE 230,RESIDENTIAL,13195,0,13195,76543,0,89738
142245801400000,SE 230,RESIDENTIAL,12620,0,12620,59969,0,72589
142245801500000,SE 230,RESIDENTIAL,8943,0,8943,42947,0,51890
142245801600000,SE 230,RESIDENTIAL,9700,0,9700,50901,0,60601
142245801700000,SE 230,RESIDENTIAL,8076,0,8076,52483,0,60559
142245801800000,SE 230,RESIDENTIAL,7963,0,7963,43368,0,51331
142245801900000,SE 230,RESIDENTIAL,14308,0,14308,74204,0,88512
142245802000000,SE 230,RESIDENTIAL,9585,0,9585,55502,0,65087
142245802100000,SE 230,RESIDENTIAL,9310,0,9310,35351,0,44661
142245802200000,SE 230,RESIDENTIAL,13388,0,13388,37686,0,51074
142245802300000,SE 230,RESIDENTIAL,13388,0,13388,51989,0,65377
142245802400000,SE 230,RESIDENTIAL,13388,0,13388,44620,0,58008
142245802500000,SE 230,RESIDENTIAL,12233,0,12233,41840,0,54073
142245802600000,SE 230,RESIDENTIAL,20020,0,20020,68049,0,88069
142245802700000,SE 230,RESIDENTIAL,22701,0,22701,58331,0,81032
142245802800000,SE 230,RESIDENTIAL,19145,0,19145,55724,0,74869
142245802900000,SE 230,RESIDENTIAL,19145,0,19145,48865,0,68010
142245803000000,SE 230,RESIDENTIAL,17678,0,17678,38924,0,56602
142245900100000,APARTMENT,COMMERCIAL,0,13362,13362,0,78092,91454
142245900200000,SE 230,RESIDENTIAL,15435,0,15435,59376,0,74811
142245900300000,SE 230,RESIDENTIAL,10220,0,10220,36562,0,46782
142245900400000,SE 230,RESIDENTIAL,7665,0,7665,42638,0,50303
142245900500000,SE 230,RESIDENTIAL,8943,0,8943,37026,0,45969
142245900600000,SE 230,RESIDENTIAL,9450,0,9450,57188,0,66638
142245900700000,SE 230,RESIDENTIAL,13699,0,13699,45630,0,59329
142245900800000,SE 230,RESIDENTIAL,13300,0,13300,64675,0,77975
142245900900000,SE 230,RESIDENTIAL,13300,0,13300,71717,0,85017
142245901000000,SE 230,RESIDENTIAL,25215,0,25215,82313,0,107528
142245901100000,SE 230,RESIDENTIAL,21607,0,21607,69129,0,90736
142245901200000,SE 230,RESIDENTIAL,13041,0,13041,70402,0,83443
142245901300000,SE 230,RESIDENTIAL,15698,0,15698,68253,0,83951
142245901400000,SE 230,RESIDENTIAL,22705,0,22705,71049,0,93754
142245901500000,SE 230,RESIDENTIAL,64260,0,64260,182796,0,247056
142245901600000,APARTMENT,COMMERCIAL,0,22200,22200,0,93013,115213
142245901700000,CONVERSION,COMMERCIAL,0,8879,8879,0,77283,86162
142246000100000,SE 230,RESIDENTIAL,9419,0,9419,44470,0,53889
142246000200000,SE 230,RESIDENTIAL,8943,0,8943,52197,0,61140
142246000300000,SE 230,RESIDENTIAL,14306,0,14306,54711,0,69017
142246000400000,SE 230,RESIDENTIAL,14140,0,14140,49943,0,64083
142246000500000,SE 230,RESIDENTIAL,14140,0,14140,38867,0,53007
142246000600000,SE 230,RESIDENTIAL,14642,0,14642,62839,0,77481
142246000700000,SE 230,RESIDENTIAL,14140,0,14140,80680,0,94820
142246000800000,SE 230,RESIDENTIAL,9188,0,9188,45410,0,54598
142246000900000,SE 230,RESIDENTIAL,8916,0,8916,52170,0,61086
142246001000000,SE 230,RESIDENTIAL,8442,0,8442,55970,0,64412
142246001100000,SE 230,RESIDENTIAL,7973,0,7973,52440,0,60413
142246001200000,SE 230,RESIDENTIAL,8025,0,8025,39372,0,47397
142246001300000,SE 230,RESIDENTIAL,8190,0,8190,53708,0,61898
142246001400000,SE 230,RESIDENTIAL,9104,0,9104,55414,0,64518
142246001500000,SE 230,RESIDENTIAL,8968,0,8968,10714,0,19682
142246001600000,SE 230,RESIDENTIAL,14061,0,14061,68371,0,82432
142246001700000,SE 230,RESIDENTIAL,13860,0,13860,54125,0,67985
142246001800000,SE 230,RESIDENTIAL,13860,0,13860,52605,0,66465
142246001900000,SE 230,RESIDENTIAL,13860,0,13860,73604,0,87464
142246002000000,SE 230,RESIDENTIAL,13860,0,13860,50921,0,64781
142246002100000,SE 230,RESIDENTIAL,13661,0,13661,55821,0,69482
142246002200000,SE 230,RESIDENTIAL,11863,0,11863,38636,0,50499
142246002300000,SE 230,RESIDENTIAL,11700,0,11700,48723,0,60423
142246002400000,SE 230,RESIDENTIAL,13300,0,13300,44871,0,58171
142246002500000,SE 230,RESIDENTIAL,13125,0,13125,38883,0,52008
142246100100000,SE 230,RESIDENTIAL,26010,0,26010,69523,0,95533
142246100200000,SE 230,RESIDENTIAL,31900,0,31900,101896,0,133796
142246100300000,SE 230,RESIDENTIAL,22599,0,22599,114561,0,137160
142246100400000,SE 230,RESIDENTIAL,17850,0,17850,53999,0,71849
142246100500000,SE 230,RESIDENTIAL,18751,0,18751,83726,0,102477
142246100600000,SE 230,RESIDENTIAL,23205,0,23205,67675,0,90880
142246100700000,SE 230,RESIDENTIAL,2419,0,2419,0,0,2419
142247600100000,SE 247,RESIDENTIAL,72452,0,72452,315408,0,387860
142247600200000,SE 247,RESIDENTIAL,69850,0,69850,333940,0,403790
142247600300000,SE 247,RESIDENTIAL,71262,0,71262,222828,0,294090
142247600400000,SE 247,RESIDENTIAL,71968,0,71968,235897,0,307865
142247700100000,SE 247,RESIDENTIAL,98033,0,98033,323857,0,421890
142247700200000,SE 247,RESIDENTIAL,70414,0,70414,218537,0,288951
142247700300000,SE 247,RESIDENTIAL,70342,0,70342,156265,0,226607
142247700400000,SE 247,RESIDENTIAL,68659,0,68659,198752,0,267411
142247700500000,SE 247,RESIDENTIAL,67936,0,67936,171162,0,239098
142247700600000,SE 247,RESIDENTIAL,98121,0,98121,203512,0,301633
142247800100000,SE 247,RESIDENTIAL,181600,0,181600,441233,0,622833
142247800200000,SE 247,RESIDENTIAL,68462,0,68462,263110,0,331572
142247800300000,SE 247,RESIDENTIAL,68462,0,68462,307084,0,375546
142247800400000,SE 247,RESIDENTIAL,148400,0,148400,0,0,148400
142247800500000,SE 247,RESIDENTIAL,71971,0,71971,172142,0,244113
142247900100000,SE 247,RESIDENTIAL,67500,0,67500,268913,0,336413
142247900200000,SE 247,RESIDENTIAL,60000,0,60000,146558,0,206558
142247900300000,SE 247,RESIDENTIAL,61799,0,61799,88754,0,150553
142247900400000,SE 247,RESIDENTIAL,70410,0,70410,207485,0,277895
142247900500000,SE 247,RESIDENTIAL,67500,0,67500,190218,0,257718
142248000100000,SE 247,RESIDENTIAL,36456,0,36456,97213,0,133669
142248000200000,SE 247,RESIDENTIAL,47000,0,47000,139914,0,186914
142248000300000,SE 247,RESIDENTIAL,47998,0,47998,129510,0,177508
142248000400000,SE 247,RESIDENTIAL,48600,0,48600,115059,0,163659
142248000500000,SE 229,RESIDENTIAL,35664,0,35664,59336,0,95000
142248000600000,SE 229,RESIDENTIAL,25000,0,25000,102168,0,127168
142248000700000,SE 229,RESIDENTIAL,26333,0,26333,93713,0,120046
142248100100000,SE 247,RESIDENTIAL,48416,0,48416,178801,0,227217
142248100200000,SE 247,RESIDENTIAL,59594,0,59594,161118,0,220712
142248100300000,SE 247,RESIDENTIAL,40495,0,40495,109573,0,150068
142248100400000,SE 247,RESIDENTIAL,38878,0,38878,97365,0,136243
142248100500000,SE 229,RESIDENTIAL,24750,0,24750,101953,0,126703
142248100600000,SE 229,RESIDENTIAL,24750,0,24750,58561,0,83311
142248100700000,SE 229,RESIDENTIAL,24750,0,24750,117051,0,141801
142248100800000,SE 247,RESIDENTIAL,34068,0,34068,92857,0,126925
142248100900000,SE 247,RESIDENTIAL,34068,0,34068,117706,0,151774
142248101000000,SE 247,RESIDENTIAL,36430,0,36430,124436,0,160866
142248101100000,SE 247,RESIDENTIAL,38893,0,38893,134201,0,173094
142248200100000,SE 247,RESIDENTIAL,65306,0,65306,219267,0,284573
142248200200000,SE 247,RESIDENTIAL,39690,0,39690,131663,0,171353
142248200300000,SE 247,RESIDENTIAL,39690,0,39690,142244,0,181934
142248200400000,SE 229,RESIDENTIAL,24750,0,24750,84140,0,108890
142248200500000,SE 229,RESIDENTIAL,24750,0,24750,82715,0,107465
142248200600000,SE 229,RESIDENTIAL,24750,0,24750,84167,0,108917
142248200700000,SE 229,RESIDENTIAL,24750,0,24750,68512,0,93262
142248200800000,SE 229,RESIDENTIAL,25245,0,25245,103143,0,128388
142248200900000,SE 229,RESIDENTIAL,19800,0,19800,79868,0,99668
142248201000000,CITY PROPERTY,EXEMPT,0,0,0,0,0,0
142248201100000,SE 229,RESIDENTIAL,24750,0,24750,93158,0,117908
142248201200000,SE 229,RESIDENTIAL,24750,0,24750,70063,0,94813
142248201300000,SE 229,RESIDENTIAL,24750,0,24750,102636,0,127386
142248201400000,SE 229,RESIDENTIAL,24750,0,24750,83826,0,108576
142248201500000,SE 229,RESIDENTIAL,24750,0,24750,122788,0,147538
142248300100000,SE 229,RESIDENTIAL,17600,0,17600,100835,0,118435
142248300200000,SE 229,RESIDENTIAL,30400,0,30400,121492,0,151892
142248300300000,SE 229,RESIDENTIAL,30400,0,30400,93274,0,123674
142248300400000,SE 229,RESIDENTIAL,30000,0,30000,76726,0,106726
142248300500000,SE 229,RESIDENTIAL,18620,0,18620,85168,0,103788
142248300600000,SE 229,RESIDENTIAL,16660,0,16660,66336,0,82996
142248300700000,SE 229,RESIDENTIAL,19600,0,19600,70553,0,90153
142248300800000,SE 229,RESIDENTIAL,19600,0,19600,94651,0,114251
142248300900000,SE 229,RESIDENTIAL,21560,0,21560,60348,0,81908
142248301000000,SE 229,RESIDENTIAL,18600,0,18600,100596,0,119196
142248301100000,SE 229,RESIDENTIAL,18600,0,18600,77650,0,96250
142248301200000,SE 229,RESIDENTIAL,18600,0,18600,72489,0,91089
142248301300000,SE 229,RESIDENTIAL,18600,0,18600,83065,0,101665
142248301400000,SE 229,RESIDENTIAL,18600,0,18600,84601,0,103201
142248301500000,SE 229,RESIDENTIAL,14400,0,14400,85188,0,99588
142248301600000,SE 229,RESIDENTIAL,14400,0,14400,71244,0,85644
142248301700000,SE 229,RESIDENTIAL,15200,0,15200,73190,0,88390
142248301800000,SE 229,RESIDENTIAL,22270,0,22270,78887,0,101157
142248301900000,SE 229,RESIDENTIAL,19380,0,19380,43141,0,62521
142248302000000,SE 229,RESIDENTIAL,22950,0,22950,60923,0,83873
142248302100000,SE 229,RESIDENTIAL,24480,0,24480,102508,0,126988
142248302200000,SE 229,RESIDENTIAL,20200,0,20200,76566,0,96766
142248302300000,SE 229,RESIDENTIAL,20000,0,20000,93415,0,113415
142248302400000,SE 229,RESIDENTIAL,16000,0,16000,73154,0,89154
142248302500000,SE 229,RESIDENTIAL,16000,0,16000,87718,0,103718
142248302600000,SE 229,RESIDENTIAL,26719,0,26719,135395,0,162114
142248302700000,SE 229,RESIDENTIAL,17600,0,17600,99843,0,117443
142248302800000,SE 229,RESIDENTIAL,17600,0,17600,56845,0,74445
142248302900000,SE 229,RESIDENTIAL,17600,0,17600,63350,0,80950
142248303000000,SE 229,RESIDENTIAL,17600,0,17600,68356,0,85956
142248303100000,SE 229,RESIDENTIAL,17600,0,17600,73057,0,90657
142248303200000,SE 229,RESIDENTIAL,17600,0,17600,82422,0,100022
142248400100000,SE 247,RESIDENTIAL,45080,0,45080,137093,0,182173
142248400200000,SE 247,RESIDENTIAL,36623,0,36623,141677,0,178300
142248400300000,SE 247,RESIDENTIAL,37675,0,37675,117580,0,155255
142248400400000,SE 247,RESIDENTIAL,39679,0,39679,159030,0,198709
142248400500000,SE 235,RESIDENTIAL,21574,0,21574,87169,0,108743
142248400600000,SE 235,RESIDENTIAL,23415,0,23415,69722,0,93137
142248400700000,SE 235,RESIDENTIAL,22488,0,22488,78675,0,101163
142248400800000,SE 235,RESIDENTIAL,17500,0,17500,81741,0,99241
142248400900000,SE 235,RESIDENTIAL,17500,0,17500,68531,0,86031
142248500100000,SE 229,RESIDENTIAL,17600,0,17600,89048,0,106648
142248500200000,SE 229,RESIDENTIAL,21330,0,21330,69792,0,91122
142248500300000,SE 229,RESIDENTIAL,21330,0,21330,84111,0,105441
142248500400000,SE 229,RESIDENTIAL,21330,0,21330,64496,0,85826
142248500500000,SE 229,RESIDENTIAL,15200,0,15200,71832,0,87032
142248500600000,SE 229,RESIDENTIAL,15200,0,15200,78801,0,94001
142248500700000,SE 229,RESIDENTIAL,25840,0,25840,88010,0,113850
142248500800000,SE 229,RESIDENTIAL,16000,0,16000,50723,0,66723
142248500900000,SE 229,RESIDENTIAL,16000,0,16000,62605,0,78605
142248501000000,SE 229,RESIDENTIAL,15200,0,15200,65444,0,80644
142248501100000,SE 229,RESIDENTIAL,15200,0,15200,69513,0,84713
142248501200000,SE 229,RESIDENTIAL,22572,0,22572,63509,0,86081
142248501300000,SE 229,RESIDENTIAL,18250,0,18250,72328,0,90578
142248501400000,SE 229,RESIDENTIAL,18250,0,18250,71348,0,89598
142248501500000,SE 229,RESIDENTIAL,23417,0,23417,85544,0,108961
142248501600000,CONVENIENCE STORE,COMMERCIAL,0,53760,53760,0,191041,244801
142248501700000,SMALL RETAIL,COMMERCIAL,0,47232,47232,0,107764,154996
142248501800000,FLAT PARKING,COMMERCIAL,0,58752,58752,0,4640,63392
142248501900000,SE 229,RESIDENTIAL,22800,0,22800,45250,0,68050
142248502000000,SE 229,RESIDENTIAL,31616,0,31616,74110,0,105726
142248502100000,SE 229,RESIDENTIAL,31616,0,31616,89929,0,121545
142248502200000,SE 229,RESIDENTIAL,30400,0,30400,46520,0,76920
142248502300000,SE 229,RESIDENTIAL,30400,0,30400,59054,0,89454
142248502400000,SE 229,RESIDENTIAL,23750,0,23750,55092,0,78842
142248502500000,SE 229,RESIDENTIAL,23750,0,23750,59212,0,82962
142248502600000,SE 229,RESIDENTIAL,17600,0,17600,81483,0,99083
142248502700000,SE 229,RESIDENTIAL,17600,0,17600,61039,0,78639
142248502800000,SE 229,RESIDENTIAL,17600,0,17600,61152,0,78752
142310100100000,SE 212,RESIDENTIAL,5450,0,5450,0,0,5450
142310100200000,SE 212,RESIDENTIAL,126200,0,126200,307627,0,433827
142310100300000,SE 212,RESIDENTIAL,118692,0,118692,620051,0,738743
142310100400000,SE 212,RESIDENTIAL,130950,0,130950,436479,0,567429
142310100500000,SE 212,RESIDENTIAL,94735,0,94735,276568,0,371303
142310100600000,SE 212,RESIDENTIAL,89706,0,89706,379497,0,469203
142310100700000,SE 212,RESIDENTIAL,94002,0,94002,358845,0,452847
142310100800000,SE 212,RESIDENTIAL,85406,0,85406,328380,0,413786
142310100900000,SE 212,RESIDENTIAL,91060,0,91060,343234,0,434294
142310101000000,SE 212,RESIDENTIAL,128300,0,128300,610767,0,739067
142310101100000,SE 212,RESIDENTIAL,89779,0,89779,390384,0,480163
142310101200000,SE 211,RESIDENTIAL,35904,0,35904,193609,0,229513
142310101300000,SE 211,RESIDENTIAL,34680,0,34680,158470,0,193150
142310101400000,SE 211,RESIDENTIAL,34680,0,34680,142623,0,177303
142310101500000,SE 211,RESIDENTIAL,35092,0,35092,170616,0,205708
142310101600000,SE 211,RESIDENTIAL,33858,0,33858,174163,0,208021
142310101700000,SE 211,RESIDENTIAL,37120,0,37120,201573,0,238693
142310101800000,SE 211,RESIDENTIAL,38972,0,38972,242301,0,281273
142310101900000,SE 212,RESIDENTIAL,70720,0,70720,348649,0,419369
142310102000000,SE 212,RESIDENTIAL,84032,0,84032,0,0,84032
142310102100000,SE 212,RESIDENTIAL,101419,0,101419,426891,0,528310
142310102200000,SE 212,RESIDENTIAL,103369,0,103369,298013,0,401382
142310102300000,SE 211,RESIDENTIAL,38500,0,38500,191458,0,229958
142310102400000,SE 211,RESIDENTIAL,38149,0,38149,221173,0,259322
142310102500000,SE 211,RESIDENTIAL,35934,0,35934,185702,0,221636
142310102600000,SE 211,RESIDENTIAL,34688,0,34688,177925,0,212613
142310102700000,SE 211,RESIDENTIAL,37845,0,37845,168269,0,206114
142310102800000,SE 211,RESIDENTIAL,38089,0,38089,217940,0,256029
142310102900000,SE 211,RESIDENTIAL,34248,0,34248,140393,0,174641
142310103000000,SE 211,RESIDENTIAL,34680,0,34680,131364,0,166044
142310103100000,SE 211,RESIDENTIAL,34680,0,34680,141197,0,175877
142310103200000,SE 211,RESIDENTIAL,34680,0,34680,154843,0,189523
142310103300000,SE 211,RESIDENTIAL,91750,0,91750,198988,0,290738
142310103400000,SE 212,RESIDENTIAL,139200,0,139200,282696,0,421896
142310103500000,SE 212,RESIDENTIAL,133300,0,133300,430509,0,563809
142310103600000,SE 211,RESIDENTIAL,40520,0,40520,229371,0,269891
142310103700000,SE 211,RESIDENTIAL,60320,0,60320,151455,0,211775
142310103800000,SE 211,RESIDENTIAL,69032,0,69032,199800,0,268832
142310104000000,SE 211,RESIDENTIAL,69768,0,69768,175868,0,245636
142310104100000,SE 211,RESIDENTIAL,66008,0,66008,0,0,66008
142310104200000,SE 212,RESIDENTIAL,2195,0,2195,0,0,2195
142310104300000,SE 212,RESIDENTIAL,0,0,0,0,0,0
142310104400000,SE 212,RESIDENTIAL,20,0,20,0,0,20
142312600100000,CITY PROPERTY,EXEMPT,0,0,0,0,0,0
142312600200000,CITY PROPERTY,EXEMPT,0,0,0,0,0,0
142312600300000,SE 211,RESIDENTIAL,37968,0,37968,170414,0,208382
142312600400000,SE 211,RESIDENTIAL,38330,0,38330,218411,0,256741
142312600500000,SE 211,RESIDENTIAL,38964,0,38964,222109,0,261073
142312600600000,SE 211,RESIDENTIAL,37108,0,37108,170491,0,207599
142312800100000,SE 211,RESIDENTIAL,35308,0,35308,158803,0,194111
142315100100000,SE 213,RESIDENTIAL,34780,0,34780,134309,0,169089
142315200100000,SE 213,RESIDENTIAL,39355,0,39355,132908,0,172263
142315200200000,SE 213,RESIDENTIAL,39375,0,39375,170498,0,209873
142315200300000,SE 213,RESIDENTIAL,38632,0,38632,134183,0,172815
142315200400000,SE 213,RESIDENTIAL,38250,0,38250,155273,0,193523
142315200500000,SE 213,RESIDENTIAL,35640,0,35640,190794,0,226434
142315200600000,SE 213,RESIDENTIAL,35640,0,35640,104810,0,140450
142315200700000,SE 213,RESIDENTIAL,35640,0,35640,93513,0,129153
142315200800000,SE 213,RESIDENTIAL,34942,0,34942,90664,0,125606
142315200900000,SE 213,RESIDENTIAL,20700,0,20700,105436,0,126136
142315201000000,SE 213,RESIDENTIAL,18000,0,18000,56096,0,74096
142315201100000,SE 213,RESIDENTIAL,18000,0,18000,79299,0,97299
142315201200000,SE 213,RESIDENTIAL,18000,0,18000,52197,0,70197
142315201300000,SE 213,RESIDENTIAL,26451,0,26451,49379,0,75830
142315201400000,SE 213,RESIDENTIAL,18549,0,18549,51972,0,70521
142315201500000,SE 213,RESIDENTIAL,18000,0,18000,51627,0,69627
142315201600000,SE 213,RESIDENTIAL,18000,0,18000,40537,0,58537
142315201700000,SE 213,RESIDENTIAL,18000,0,18000,46896,0,64896
142315201800000,SE 213,RESIDENTIAL,18000,0,18000,41754,0,59754
142315201900000,SE 213,RESIDENTIAL,18000,0,18000,38970,0,56970
142315202000000,SE 213,RESIDENTIAL,30375,0,30375,25781,0,56156
142315202100000,SE 213,RESIDENTIAL,22500,0,22500,51048,0,73548
142315300100000,SE 213,RESIDENTIAL,34827,0,34827,125450,0,160277
142315300200000,SE 213,RESIDENTIAL,34627,0,34627,155510,0,190137
142315300300000,SE 213,RESIDENTIAL,34627,0,34627,131721,0,166348
142315400100000,SE 213,RESIDENTIAL,35640,0,35640,121556,0,157196
142315400200000,SE 213,RESIDENTIAL,35001,0,35001,110430,0,145431
142315400300000,SE 213,RESIDENTIAL,20700,0,20700,39559,0,60259
142315400400000,SE 213,RESIDENTIAL,25200,0,25200,50644,0,75844
142315400500000,SE 213,RESIDENTIAL,32175,0,32175,119453,0,151628
142315400600000,SE 213,RESIDENTIAL,18000,0,18000,22310,0,40310
142315400700000,SE 213,RESIDENTIAL,18000,0,18000,40096,0,58096
142315400800000,SE 213,RESIDENTIAL,18000,0,18000,46293,0,64293
142315400900000,SE 213,RESIDENTIAL,25200,0,25200,57900,0,83100
142315401000000,SE 213,RESIDENTIAL,21780,0,21780,64851,0,86631
142315401100000,SE 213,RESIDENTIAL,28350,0,28350,63838,0,92188
142315401200000,SE 213,RESIDENTIAL,20916,0,20916,104902,0,125818
142315401300000,SE 213,RESIDENTIAL,31500,0,31500,71084,0,102584
142317600100000,SE 213,RESIDENTIAL,78050,0,78050,287211,0,365261
142317600200000,SE 213,RESIDENTIAL,40856,0,40856,146317,0,187173
142317600300000,SE 213,RESIDENTIAL,42006,0,42006,115535,0,157541
142317600400000,SE 213,RESIDENTIAL,41723,0,41723,177019,0,218742
142317600500000,SE 213,RESIDENTIAL,38823,0,38823,165509,0,204332
142317600600000,SE 213,RESIDENTIAL,35455,0,35455,126839,0,162294
142317600700000,SE 213,RESIDENTIAL,37006,0,37006,151087,0,188093
142317600800000,SE 213,RESIDENTIAL,35500,0,35500,130547,0,166047
142317600900000,SE 213,RESIDENTIAL,37238,0,37238,144887,0,182125
142317601000000,SE 213,RESIDENTIAL,35618,0,35618,155828,0,191446
142317601100000,SE 213,RESIDENTIAL,35313,0,35313,128429,0,163742
142317601200000,SE 213,RESIDENTIAL,35633,0,35633,157455,0,193088
142317601300000,SE 213,RESIDENTIAL,35677,0,35677,152254,0,187931
142317700100000,SE 213,RESIDENTIAL,38298,0,38298,124903,0,163201
142317700200000,SE 213,RESIDENTIAL,38632,0,38632,161254,0,199886
142317700300000,SE 213,RESIDENTIAL,38632,0,38632,133220,0,171852
142317700400000,SE 213,RESIDENTIAL,39015,0,39015,141993,0,181008
142317700500000,SE 213,RESIDENTIAL,39015,0,39015,141725,0,180740
142317700600000,SE 213,RESIDENTIAL,37179,0,37179,137567,0,174746
142317700700000,SE 213,RESIDENTIAL,36360,0,36360,154853,0,191213
142317700800000,SE 213,RESIDENTIAL,37269,0,37269,141183,0,178452
142317700900000,SE 213,RESIDENTIAL,36966,0,36966,128462,0,165428
142317701000000,SE 213,RESIDENTIAL,34363,0,34363,146735,0,181098
142317701100000,SE 213,RESIDENTIAL,35640,0,35640,111880,0,147520
142317701200000,SE 213,RESIDENTIAL,36531,0,36531,145035,0,181566
142317701300000,SE 213,RESIDENTIAL,36085,0,36085,85079,0,121164
142317701400000,SE 213,RESIDENTIAL,38250,0,38250,166663,0,204913
142317701500000,SE 213,RESIDENTIAL,38250,0,38250,171540,0,209790
142317701600000,SE 213,RESIDENTIAL,38250,0,38250,112720,0,150970
142317701700000,SE 213,RESIDENTIAL,38632,0,38632,160482,0,199114
142317701800000,SE 213,RESIDENTIAL,37856,0,37856,166804,0,204660
142317800100000,SE 213,RESIDENTIAL,93050,0,93050,286424,0,379474
142317800200000,SE 213,RESIDENTIAL,30488,0,30488,107328,0,137816
142317800300000,SE 213,RESIDENTIAL,41064,0,41064,144952,0,186016
142317800400000,SE 213,RESIDENTIAL,40025,0,40025,131424,0,171449
142317800500000,SE 213,RESIDENTIAL,38410,0,38410,163898,0,202308
142317800600000,SE 213,RESIDENTIAL,38499,0,38499,148479,0,186978
142317800700000,SE 213,RESIDENTIAL,37485,0,37485,155004,0,192489
142317800800000,SE 213,RESIDENTIAL,37485,0,37485,173068,0,210553
142317800900000,SE 213,RESIDENTIAL,37867,0,37867,130232,0,168099
142317801000000,SE 213,RESIDENTIAL,37577,0,37577,131331,0,168908
142317801100000,SE 213,RESIDENTIAL,35640,0,35640,131997,0,167637
142317801200000,SE 213,RESIDENTIAL,35640,0,35640,122679,0,158319
142317801300000,SE 213,RESIDENTIAL,39025,0,39025,104412,0,143437
142317801400000,SE 213,RESIDENTIAL,38069,0,38069,91946,0,130015
142317801500000,SE 213,RESIDENTIAL,35291,0,35291,88213,0,123504
142317801600000,SE 213,RESIDENTIAL,31365,0,31365,51973,0,83338
142317801700000,SE 213,RESIDENTIAL,32130,0,32130,27789,0,59919
142317801800000,SE 213,RESIDENTIAL,23940,0,23940,45373,0,69313
142317801900000,SE 213,RESIDENTIAL,31500,0,31500,79075,0,110575
142317802000000,SE 213,RESIDENTIAL,27000,0,27000,68085,0,95085
142317802100000,SE 213,RESIDENTIAL,37520,0,37520,0,0,37520
142317802200000,SE 213,RESIDENTIAL,34783,0,34783,0,0,34783
142317802300000,SE 213,RESIDENTIAL,36338,0,36338,126057,0,162395
142317802400000,SE 213,RESIDENTIAL,27788,0,27788,106284,0,134072
142317802500000,SE 213,RESIDENTIAL,27788,0,27788,56008,0,83796
142317802600000,SE 213,RESIDENTIAL,35721,0,35721,87649,0,123370
142317802700000,SE 213,RESIDENTIAL,35280,0,35280,74250,0,109530
142317802800000,SE 213,RESIDENTIAL,35280,0,35280,108139,0,143419
142317802900000,SE 213,RESIDENTIAL,36338,0,36338,140978,0,177316
142317803000000,SE 213,RESIDENTIAL,36720,0,36720,114694,0,151414
142317803100000,SE 213,RESIDENTIAL,34600,0,34600,150546,0,185146
142317803200000,SE 213,RESIDENTIAL,39060,0,39060,172931,0,211991
142317803300000,SE 213,RESIDENTIAL,49507,0,49507,192652,0,242159
142317803400000,SE 213,RESIDENTIAL,48650,0,48650,154397,0,203047
142317803500000,SE 213,RESIDENTIAL,36915,0,36915,141050,0,177965
142317803600000,SE 213,RESIDENTIAL,45935,0,45935,155046,0,200981
142317803700000,SE 213,RESIDENTIAL,46632,0,46632,130533,0,177165
142317803800000,SE 213,RESIDENTIAL,32314,0,32314,179997,0,212311
142317803900000,SCHOOL,EXEMPT,0,102600,102600,0,985316,1087916
142317804000000,SE 213,RESIDENTIAL,32193,0,32193,92340,0,124533
142317804100000,SE 213,RESIDENTIAL,31311,0,31311,135126,0,166437
142317804200000,SE 213,RESIDENTIAL,31311,0,31311,99400,0,130711
142317804300000,SE 213,RESIDENTIAL,33075,0,33075,80391,0,113466
142317804400000,SE 213,RESIDENTIAL,37485,0,37485,149897,0,187382
142317804500000,SE 213,RESIDENTIAL,37485,0,37485,155427,0,192912
142317804600000,SE 213,RESIDENTIAL,77799,0,77799,216352,0,294151
142317804700000,SE 213,RESIDENTIAL,95334,0,95334,356611,0,451945
142317804800000,SE 213,RESIDENTIAL,65664,0,65664,228298,0,293962
142320100100000,SE 248,RESIDENTIAL,101375,0,101375,295560,0,396935
142320100200000,SE 248,RESIDENTIAL,107125,0,107125,609072,0,716197
142320100300000,SE 248,RESIDENTIAL,10763,0,10763,0,0,10763
142320100400000,SE 248,RESIDENTIAL,89600,0,89600,452832,0,542432
142320100500000,SE 248,RESIDENTIAL,114500,0,114500,364391,0,478891
142320100600000,SE 248,RESIDENTIAL,87000,0,87000,316719,0,403719
142320100700000,SE 248,RESIDENTIAL,95100,0,95100,285892,0,380992
142320100800000,SE 248,RESIDENTIAL,136250,0,136250,511499,0,647749
142320100900000,SE 248,RESIDENTIAL,114395,0,114395,536810,0,651205
142320101000000,SE 248,RESIDENTIAL,38342,0,38342,145354,0,183696
142320101100000,SE 248,RESIDENTIAL,44520,0,44520,207161,0,251681
142320101200000,SE 248,RESIDENTIAL,41667,0,41667,198253,0,239920
142320101300000,SE 248,RESIDENTIAL,49067,0,49067,213224,0,262291
142320101400000,SE 248,RESIDENTIAL,48950,0,48950,203402,0,252352
142320101500000,SE 248,RESIDENTIAL,44400,0,44400,147557,0,191957
142320101600000,SE 248,RESIDENTIAL,50000,0,50000,213391,0,263391
142320101700000,SE 248,RESIDENTIAL,50000,0,50000,131200,0,181200
142320101800000,SE 248,RESIDENTIAL,102918,0,102918,290627,0,393545
142320101900000,SE 248,RESIDENTIAL,51764,0,51764,224337,0,276101
142320102000000,SE 248,RESIDENTIAL,103895,0,103895,475502,0,579397
142320102100000,SE 248,RESIDENTIAL,49677,0,49677,0,0,49677
142320102200000,SE 248,RESIDENTIAL,49643,0,49643,0,0,49643
142320102300000,SE 248,RESIDENTIAL,103625,0,103625,194040,0,297665
142320102400000,SE 248,RESIDENTIAL,59500,0,59500,183894,0,243394
142320102500000,SE 248,RESIDENTIAL,33950,0,33950,174248,0,208198
142320102600000,SE 248,RESIDENTIAL,35067,0,35067,176582,0,211649
142320102700000,SE 248,RESIDENTIAL,39100,0,39100,257803,0,296903
142320102800000,SE 248,RESIDENTIAL,57688,0,57688,190136,0,247824
142320200100000,SE 248,RESIDENTIAL,32967,0,32967,229382,0,262349
142320200200000,SE 248,RESIDENTIAL,33733,0,33733,164650,0,198383
142320200300000,SE 248,RESIDENTIAL,36150,0,36150,130371,0,166521
142320200400000,SE 248,RESIDENTIAL,38333,0,38333,139121,0,177454
142320300100000,SE 248,RESIDENTIAL,32724,0,32724,132241,0,164965
142320300200000,SE 248,RESIDENTIAL,33048,0,33048,174404,0,207452
142322600100000,SE 248,RESIDENTIAL,105875,0,105875,336899,0,442774
142322600200000,SE 248,RESIDENTIAL,98400,0,98400,269974,0,368374
142322700100000,SE 248,RESIDENTIAL,98000,0,98000,332778,0,430778
142322700200000,SE 248,RESIDENTIAL,110625,0,110625,307643,0,418268
142322700300000,SE 248,RESIDENTIAL,64379,0,64379,490978,0,555357
142322800100000,SE 248,RESIDENTIAL,71709,0,71709,244669,0,316378
142322800200000,SE 248,RESIDENTIAL,35013,0,35013,240523,0,275536
142322800300000,SE 248,RESIDENTIAL,48348,0,48348,155945,0,204293
142322800400000,SE 248,RESIDENTIAL,38400,0,38400,158162,0,196562
142322800500000,SE 248,RESIDENTIAL,31450,0,31450,184417,0,215867
142322800600000,SE 248,RESIDENTIAL,34980,0,34980,114274,0,149254
142322800700000,SE 248,RESIDENTIAL,61010,0,61010,162415,0,223425
142322800800000,SE 248,RESIDENTIAL,49231,0,49231,183330,0,232561
142322800900000,SE 248,RESIDENTIAL,53250,0,53250,174188,0,227438
142322801000000,SE 248,RESIDENTIAL,39200,0,39200,204775,0,243975
142322900100000,SE 248,RESIDENTIAL,99912,0,99912,490206,0,590118
142322900200000,SE 248,RESIDENTIAL,76150,0,76150,155492,0,231642
142322900300000,SE 248,RESIDENTIAL,90653,0,90653,338009,0,428662
142322900400000,SE 248,RESIDENTIAL,71223,0,71223,464931,0,536154
142322900500000,SE 248,RESIDENTIAL,86300,0,86300,330120,0,416420
142322900600000,SE 248,RESIDENTIAL,47300,0,47300,218710,0,266010
142322900700000,SE 248,RESIDENTIAL,27000,0,27000,132993,0,159993
142322900800000,SE 248,RESIDENTIAL,70414,0,70414,307942,0,378356
142322900900000,SE 248,RESIDENTIAL,53483,0,53483,284150,0,337633
142322901000000,SE 248,RESIDENTIAL,27250,0,27250,183295,0,210545
142322901100000,SE 248,RESIDENTIAL,27250,0,27250,145882,0,173132
142322901200000,SE 248,RESIDENTIAL,27250,0,27250,142721,0,169971
142322901300000,SE 248,RESIDENTIAL,27250,0,27250,168812,0,196062
142322901400000,SE 248,RESIDENTIAL,29975,0,29975,163925,0,193900
142322901500000,SE 248,RESIDENTIAL,30250,0,30250,121579,0,151829
142322901600000,SE 248,RESIDENTIAL,38500,0,38500,174010,0,212510
142322901700000,SE 248,RESIDENTIAL,104250,0,104250,382427,0,486677
142323000100000,SE 248,RESIDENTIAL,62040,0,62040,188542,0,250582
142323100100000,SE 248,RESIDENTIAL,34542,0,34542,208567,0,243109
142323200100000,SE 248,RESIDENTIAL,43680,0,43680,182593,0,226273
142323200200000,SE 248,RESIDENTIAL,34300,0,34300,193001,0,227301
142323200300000,SE 248,RESIDENTIAL,46144,0,46144,186497,0,232641
142323200400000,SE 248,RESIDENTIAL,104152,0,104152,279382,0,383534
142323200500000,SE 248,RESIDENTIAL,100925,0,100925,366147,0,467072
142323200600000,SE 248,RESIDENTIAL,76400,0,76400,197961,0,274361
142323200700000,SE 248,RESIDENTIAL,59000,0,59000,360940,0,419940
142323200800000,SE 248,RESIDENTIAL,69600,0,69600,263656,0,333256
142323200900000,SE 248,RESIDENTIAL,42375,0,42375,240007,0,282382
142323201000000,SE 248,RESIDENTIAL,30800,0,30800,152913,0,183713
142323201100000,SE 248,RESIDENTIAL,37093,0,37093,162517,0,199610
142323201200000,SE 248,RESIDENTIAL,34900,0,34900,175704,0,210604
142323201300000,SE 248,RESIDENTIAL,40400,0,40400,200992,0,241392
142323201400000,SE 248,RESIDENTIAL,29320,0,29320,135038,0,164358
142323201500000,SE 216,RESIDENTIAL,41867,0,41867,109321,0,151188
142325100100000,SE 248,RESIDENTIAL,36333,0,36333,202391,0,238724
142325100200000,SE 248,RESIDENTIAL,36333,0,36333,163794,0,200127
142325100300000,SE 248,RESIDENTIAL,57602,0,57602,206371,0,263973
142325100400000,SE 248,RESIDENTIAL,55000,0,55000,193945,0,248945
142325200100000,SE 248,RESIDENTIAL,35833,0,35833,175570,0,211403
142325200200000,SE 248,RESIDENTIAL,35117,0,35117,139167,0,174284
142325200300000,SE 248,RESIDENTIAL,43557,0,43557,216435,0,259992
142325200400000,SE 248,RESIDENTIAL,39375,0,39375,210336,0,249711
142325200500000,SE 248,RESIDENTIAL,38552,0,38552,208888,0,247440
142325200600000,SE 248,RESIDENTIAL,40559,0,40559,269838,0,310397
142325200700000,SE 248,RESIDENTIAL,39375,0,39375,163465,0,202840
142325200800000,SE 248,RESIDENTIAL,39375,0,39375,193506,0,232881
142325200900000,SE 248,RESIDENTIAL,39375,0,39375,174218,0,213593
142325201000000,SE 248,RESIDENTIAL,39375,0,39375,142495,0,181870
142325201100000,SE 248,RESIDENTIAL,39375,0,39375,337608,0,376983
142325201200000,SE 248,RESIDENTIAL,39375,0,39375,266098,0,305473
142325201300000,SE 248,RESIDENTIAL,47250,0,47250,207782,0,255032
142325201400000,SE 248,RESIDENTIAL,25200,0,25200,148851,0,174051
142325201500000,SE 248,RESIDENTIAL,22050,0,22050,107819,0,129869
142325201600000,SE 248,RESIDENTIAL,36816,0,36816,144501,0,181317
142325201700000,SE 248,RESIDENTIAL,36312,0,36312,140364,0,176676
142325201800000,SE 248,RESIDENTIAL,32160,0,32160,147809,0,179969
142325300100000,SE 248,RESIDENTIAL,81700,0,81700,230322,0,312022
142325300200000,SE 248,RESIDENTIAL,68940,0,68940,190770,0,259710
142325300300000,SE 248,RESIDENTIAL,71550,0,71550,259672,0,331222
142325300400000,SE 248,RESIDENTIAL,59400,0,59400,242653,0,302053
142325300500000,SE 248,RESIDENTIAL,64384,0,64384,334584,0,398968
142325300600000,SE 248,RESIDENTIAL,60490,0,60490,346693,0,407183
142325400100000,SE 248,RESIDENTIAL,52629,0,52629,256708,0,309337
142325400200000,SE 248,RESIDENTIAL,53000,0,53000,405209,0,458209
142325400300000,SE 248,RESIDENTIAL,51057,0,51057,296959,0,348016
142325400400000,SE 248,RESIDENTIAL,46050,0,46050,150073,0,196123
142325400500000,SE 248,RESIDENTIAL,48913,0,48913,182496,0,231409
142325400600000,SE 248,RESIDENTIAL,52683,0,52683,204054,0,256737
142325400700000,SE 248,RESIDENTIAL,50400,0,50400,187244,0,237644
142325400800000,SE 248,RESIDENTIAL,74227,0,74227,343131,0,417358
142325400900000,SE 248,RESIDENTIAL,40755,0,40755,214303,0,255058
142325401000000,SE 248,RESIDENTIAL,39840,0,39840,220214,0,260054
142325500100000,SE 248,RESIDENTIAL,39363,0,39363,268105,0,307468
142325500200000,SE 248,RESIDENTIAL,46475,0,46475,207199,0,253674
142325500300000,SE 248,RESIDENTIAL,53867,0,53867,215657,0,269524
142325500400000,SE 248,RESIDENTIAL,46640,0,46640,248555,0,295195
142325500500000,SE 248,RESIDENTIAL,36960,0,36960,203442,0,240402
142325500600000,SE 248,RESIDENTIAL,32200,0,32200,134180,0,166380
142325500700000,SE 248,RESIDENTIAL,39766,0,39766,150977,0,190743
142325500800000,SE 248,RESIDENTIAL,38220,0,38220,216670,0,254890
142325500900000,SE 248,RESIDENTIAL,42432,0,42432,181703,0,224135
142325501000000,SE 248,RESIDENTIAL,48429,0,48429,172611,0,221040
142325501100000,SE 248,RESIDENTIAL,43197,0,43197,150929,0,194126
142325501200000,SE 248,RESIDENTIAL,42649,0,42649,156476,0,199125
142325501300000,SE 248,RESIDENTIAL,39525,0,39525,170739,0,210264
142325501400000,SE 248,RESIDENTIAL,43000,0,43000,177602,0,220602
142325600100000,SE 248,RESIDENTIAL,115000,0,115000,822523,0,937523
142325600200000,SE 227,RESIDENTIAL,30149,0,30149,102451,0,132600
142325600300000,SE 227,RESIDENTIAL,27900,0,27900,122889,0,150789
142325600400000,SE 227,RESIDENTIAL,27621,0,27621,62537,0,90158
142325600500000,SE 227,RESIDENTIAL,26966,0,26966,115356,0,142322
142325600600000,SE 227,RESIDENTIAL,28500,0,28500,148027,0,176527
142325600700000,SE 227,RESIDENTIAL,27233,0,27233,103872,0,131105
142325600800000,SE 248,RESIDENTIAL,38843,0,38843,119897,0,158740
142325600900000,SE 248,RESIDENTIAL,53799,0,53799,263678,0,317477
142325601000000,SE 248,RESIDENTIAL,34338,0,34338,159398,0,193736
142325601100000,SE 248,RESIDENTIAL,22275,0,22275,135865,0,158140
142325601200000,SE 248,RESIDENTIAL,28250,0,28250,166445,0,194695
142325601300000,SE 248,RESIDENTIAL,47664,0,47664,137876,0,185540
142325700100000,SE 248,RESIDENTIAL,47232,0,47232,209956,0,257188
142325700200000,SE 248,RESIDENTIAL,50000,0,50000,201437,0,251437
142325700300000,SE 248,RESIDENTIAL,45450,0,45450,206989,0,252439
142325700400000,SE 248,RESIDENTIAL,45900,0,45900,162798,0,208698
142325700500000,SE 248,RESIDENTIAL,47814,0,47814,170127,0,217941
142325700600000,SE 248,RESIDENTIAL,49237,0,49237,206539,0,255776
142325700700000,SE 248,RESIDENTIAL,53900,0,53900,214112,0,268012
142325700800000,SE 248,RESIDENTIAL,46500,0,46500,134014,0,180514
142325700900000,SE 248,RESIDENTIAL,54270,0,54270,235098,0,289368
142325701000000,SE 227,RESIDENTIAL,34976,0,34976,159242,0,194218
142325701100000,SE 227,RESIDENTIAL,29760,0,29760,127048,0,156808
142325701200000,SE 227,RESIDENTIAL,30000,0,30000,118644,0,148644
142325701300000,SE 227,RESIDENTIAL,30000,0,30000,110915,0,140915
142325701400000,SE 227,RESIDENTIAL,30000,0,30000,126136,0,156136
142325701500000,SE 227,RESIDENTIAL,30000,0,30000,153027,0,183027
142325701600000,SE 227,RESIDENTIAL,30000,0,30000,129787,0,159787
142325701700000,SE 227,RESIDENTIAL,30000,0,30000,215000,0,245000
142325701800000,SE 227,RESIDENTIAL,30000,0,30000,157737,0,187737
142325701900000,SE 227,RESIDENTIAL,30000,0,30000,136989,0,166989
142325702000000,SE 227,RESIDENTIAL,30000,0,30000,137360,0,167360
142325702100000,SE 227,RESIDENTIAL,30000,0,30000,109328,0,139328
142325702200000,SE 227,RESIDENTIAL,33750,0,33750,146365,0,180115
142325702300000,SE 227,RESIDENTIAL,38539,0,38539,81908,0,120447
142325800100000,SE 227,RESIDENTIAL,33997,0,33997,110922,0,144919
142325800200000,SE 227,RESIDENTIAL,31298,0,31298,74069,0,105367
142325800300000,SE 227,RESIDENTIAL,30262,0,30262,118921,0,149183
142325800400000,SE 227,RESIDENTIAL,36920,0,36920,149863,0,186783
142325800500000,SE 227,RESIDENTIAL,26145,0,26145,100911,0,127056
142325800600000,SE 227,RESIDENTIAL,26145,0,26145,87547,0,113692
142325800700000,SE 227,RESIDENTIAL,29700,0,29700,115217,0,144917
142327600100000,SE 248,RESIDENTIAL,36888,0,36888,168408,0,205296
142327600200000,SE 248,RESIDENTIAL,28875,0,28875,161849,0,190724
142327600300000,SE 248,RESIDENTIAL,26070,0,26070,109281,0,135351
142327600400000,SE 248,RESIDENTIAL,30574,0,30574,139104,0,169678
142327600500000,SE 248,RESIDENTIAL,26070,0,26070,144953,0,171023
142327600600000,SE 248,RESIDENTIAL,28760,0,28760,135993,0,164753
142327600700000,SE 248,RESIDENTIAL,27750,0,27750,145884,0,173634
142327600800000,SE 248,RESIDENTIAL,43000,0,43000,170661,0,213661
142327700100000,SE 248,RESIDENTIAL,37440,0,37440,164009,0,201449
142327700200000,SE 248,RESIDENTIAL,30942,0,30942,156628,0,187570
142327700300000,SE 248,RESIDENTIAL,29200,0,29200,132659,0,161859
142327700400000,SE 248,RESIDENTIAL,29930,0,29930,136167,0,166097
142327700500000,SE 248,RESIDENTIAL,33057,0,33057,126128,0,159185
142327700600000,SE 248,RESIDENTIAL,27983,0,27983,135336,0,163319
142327800100000,SE 248,RESIDENTIAL,27375,0,27375,154616,0,181991
142327800200000,SE 248,RESIDENTIAL,26997,0,26997,143141,0,170138
142327800300000,SE 248,RESIDENTIAL,29221,0,29221,158670,0,187891
142327800400000,SE 248,RESIDENTIAL,29304,0,29304,119462,0,148766
142327800500000,SE 248,RESIDENTIAL,30150,0,30150,187392,0,217542
142327800600000,SE 248,RESIDENTIAL,30401,0,30401,218928,0,249329
142327800700000,SE 248,RESIDENTIAL,65962,0,65962,264842,0,330804
142327800800000,SE 248,RESIDENTIAL,46761,0,46761,201211,0,247972
142327800900000,SE 248,RESIDENTIAL,42940,0,42940,218962,0,261902
142327801000000,SE 248,RESIDENTIAL,41489,0,41489,158572,0,200061
142327801100000,SE 248,RESIDENTIAL,42657,0,42657,251349,0,294006
142327801200000,SE 248,RESIDENTIAL,34517,0,34517,152294,0,186811
142327801300000,SE 248,RESIDENTIAL,83700,0,83700,366027,0,449727
142327801400000,SE 248,RESIDENTIAL,49725,0,49725,160801,0,210526
142327801500000,SE 248,RESIDENTIAL,38350,0,38350,230436,0,268786
142327801600000,SE 248,RESIDENTIAL,57447,0,57447,264631,0,322078
142327801700000,SE 248,RESIDENTIAL,42510,0,42510,204948,0,247458
142327801800000,SE 248,RESIDENTIAL,42550,0,42550,185508,0,228058
142327801900000,SE 248,RESIDENTIAL,35970,0,35970,193271,0,229241
142327802000000,SE 248,RESIDENTIAL,33162,0,33162,170536,0,203698
142327802100000,SE 248,RESIDENTIAL,32876,0,32876,111834,0,144710
142327900100000,SE 248,RESIDENTIAL,84300,0,84300,451689,0,535989
142327900200000,SE 248,RESIDENTIAL,54500,0,54500,204973,0,259473
142327900300000,SE 248,RESIDENTIAL,66790,0,66790,178258,0,245048
142327900400000,SE 248,RESIDENTIAL,83900,0,83900,407144,0,491044
142327900500000,SE 248,RESIDENTIAL,73150,0,73150,290582,0,363732
142327900600000,SE 248,RESIDENTIAL,68400,0,68400,299288,0,367688
142327900700000,SE 248,RESIDENTIAL,64492,0,64492,220185,0,284677
142327900800000,SE 248,RESIDENTIAL,68042,0,68042,216917,0,284959
142327900900000,SE 248,RESIDENTIAL,40660,0,40660,162978,0,203638
142327901000000,SE 248,RESIDENTIAL,38333,0,38333,94873,0,133206
142327901100000,SE 248,RESIDENTIAL,30000,0,30000,125364,0,155364
142327901200000,SE 248,RESIDENTIAL,30000,0,30000,161316,0,191316
142327901300000,SE 248,RESIDENTIAL,30000,0,30000,134357,0,164357
142327901400000,SE 248,RESIDENTIAL,30833,0,30833,179622,0,210455
142328000100000,SE 248,RESIDENTIAL,42432,0,42432,174535,0,216967
142328000200000,SE 248,RESIDENTIAL,39600,0,39600,229957,0,269557
142328000300000,SE 248,RESIDENTIAL,40800,0,40800,183554,0,224354
142328000400000,SE 248,RESIDENTIAL,40500,0,40500,208704,0,249204
142328000500000,SE 248,RESIDENTIAL,45857,0,45857,217447,0,263304
142328000600000,SE 248,RESIDENTIAL,35500,0,35500,228183,0,263683
142328000700000,SE 248,RESIDENTIAL,31516,0,31516,152561,0,184077
142328000800000,SE 248,RESIDENTIAL,42827,0,42827,205326,0,248153
142328000900000,SE 248,RESIDENTIAL,28055,0,28055,214440,0,242495
142328001000000,SE 248,RESIDENTIAL,27824,0,27824,129367,0,157191
142328001100000,SE 248,RESIDENTIAL,30302,0,30302,98494,0,128796
142328001200000,SE 248,RESIDENTIAL,31110,0,31110,174273,0,205383
142328001300000,SE 248,RESIDENTIAL,33150,0,33150,148270,0,181420
142328001400000,SE 248,RESIDENTIAL,37324,0,37324,249152,0,286476
142328001500000,SE 248,RESIDENTIAL,39409,0,39409,259640,0,299049
142328001600000,SE 248,RESIDENTIAL,51459,0,51459,198621,0,250080
142328001700000,SE 227,RESIDENTIAL,32628,0,32628,99519,0,132147
142328001800000,SE 227,RESIDENTIAL,29530,0,29530,114309,0,143839
142328001900000,SE 227,RESIDENTIAL,30000,0,30000,147166,0,177166
142328002000000,SE 227,RESIDENTIAL,30000,0,30000,123560,0,153560
142328002100000,SE 227,RESIDENTIAL,30000,0,30000,125024,0,155024
142328002200000,SE 227,RESIDENTIAL,29167,0,29167,99838,0,129005
142328002300000,SE 248,RESIDENTIAL,44625,0,44625,135552,0,180177
142328100100000,SE 227,RESIDENTIAL,50972,0,50972,167993,0,218965
142328100200000,SE 248,RESIDENTIAL,52347,0,52347,229908,0,282255
142328100300000,SE 248,RESIDENTIAL,51410,0,51410,373736,0,425146
142328100400000,SE 248,RESIDENTIAL,104775,0,104775,647438,0,752213
142328100500000,SE 248,RESIDENTIAL,103395,0,103395,686605,0,790000
142328100600000,SE 248,RESIDENTIAL,68625,0,68625,480031,0,548656
142328100700000,SE 248,RESIDENTIAL,74098,0,74098,307932,0,382030
142328100800000,SE 248,RESIDENTIAL,51490,0,51490,358802,0,410292
142328100900000,SE 248,RESIDENTIAL,68590,0,68590,258446,0,327036
142328101000000,SE 248,RESIDENTIAL,64187,0,64187,0,0,64187
142328101100000,SE 227,RESIDENTIAL,43840,0,43840,171298,0,215138
142328101200000,SE 227,RESIDENTIAL,32825,0,32825,144931,0,177756
142328101300000,SE 227,RESIDENTIAL,31200,0,31200,118618,0,149818
142328101400000,SE 227,RESIDENTIAL,37450,0,37450,178267,0,215717
142328101500000,SE 227,RESIDENTIAL,33800,0,33800,108597,0,142397
142328101600000,SE 227,RESIDENTIAL,33800,0,33800,183466,0,217266
142328101700000,SE 227,RESIDENTIAL,31200,0,31200,117392,0,148592
142328101800000,SE 227,RESIDENTIAL,30000,0,30000,174195,0,204195
142328101900000,SE 227,RESIDENTIAL,33750,0,33750,124093,0,157843
142330100100000,SE 227,RESIDENTIAL,25800,0,25800,101197,0,126997
142330100200000,SE 227,RESIDENTIAL,24000,0,24000,86197,0,110197
142330100300000,SE 227,RESIDENTIAL,24000,0,24000,98447,0,122447
142330100400000,SE 227,RESIDENTIAL,23333,0,23333,107452,0,130785
142330100500000,SE 227,RESIDENTIAL,27340,0,27340,106648,0,133988
142330100600000,SE 227,RESIDENTIAL,27340,0,27340,109516,0,136856
142330100700000,SE 227,RESIDENTIAL,27340,0,27340,151071,0,178411
142330100800000,SE 227,RESIDENTIAL,25590,0,25590,127818,0,153408
142330100900000,SE 227,RESIDENTIAL,25376,0,25376,101303,0,126679
142330101000000,SE 227,RESIDENTIAL,25245,0,25245,88308,0,113553
142330101100000,SE 227,RESIDENTIAL,20062,0,20062,93355,0,113417
142330101200000,SE 227,RESIDENTIAL,24500,0,24500,23993,0,48493
142330101300000,SE 227,RESIDENTIAL,24500,0,24500,97991,0,122491
142330101400000,SE 227,RESIDENTIAL,24500,0,24500,100831,0,125331
142330101500000,SE 227,RESIDENTIAL,26550,0,26550,117462,0,144012
142330101600000,SE 227,RESIDENTIAL,26550,0,26550,84571,0,111121
142330101700000,SE 227,RESIDENTIAL,24500,0,24500,100774,0,125274
142330101800000,SE 227,RESIDENTIAL,27000,0,27000,96565,0,123565
142330101900000,SE 227,RESIDENTIAL,24500,0,24500,118095,0,142595
142330102000000,SE 227,RESIDENTIAL,24500,0,24500,83351,0,107851
142330102100000,SE 227,RESIDENTIAL,23928,0,23928,99385,0,123313
142330102200000,SE 227,RESIDENTIAL,24500,0,24500,87933,0,112433
142330102300000,SE 227,RESIDENTIAL,27697,0,27697,96566,0,124263
142330102400000,SE 227,RESIDENTIAL,27306,0,27306,102720,0,130026
142330102500000,SE 227,RESIDENTIAL,26250,0,26250,56588,0,82838
142330102600000,SE 227,RESIDENTIAL,26250,0,26250,48201,0,74451
142330102700000,SE 227,RESIDENTIAL,26250,0,26250,86874,0,113124
142330102800000,SE 227,RESIDENTIAL,26250,0,26250,99603,0,125853
142330102900000,SE 227,RESIDENTIAL,23625,0,23625,129271,0,152896
142330103000000,SE 227,RESIDENTIAL,23347,0,23347,83590,0,106937
142330103100000,SE 227,RESIDENTIAL,28092,0,28092,119570,0,147662
142330103200000,SE 227,RESIDENTIAL,33300,0,33300,136674,0,169974
142330103300000,SE 227,RESIDENTIAL,32492,0,32492,105086,0,137578
142330103400000,SE 227,RESIDENTIAL,32828,0,32828,129576,0,162404
142330103500000,SE 227,RESIDENTIAL,27750,0,27750,96338,0,124088
142330103600000,SE 227,RESIDENTIAL,24975,0,24975,106777,0,131752
142330103700000,SE 227,RESIDENTIAL,24975,0,24975,93677,0,118652
142330103800000,SE 227,RESIDENTIAL,26048,0,26048,91539,0,117587
142330200100000,SE 227,RESIDENTIAL,46022,0,46022,183963,0,229985
142330200200000,SE 227,RESIDENTIAL,30231,0,30231,153702,0,183933
142330200300000,SE 227,RESIDENTIAL,25500,0,25500,84399,0,109899
142330200400000,SE 227,RESIDENTIAL,21930,0,21930,80033,0,101963
142330200500000,SE 227,RESIDENTIAL,26163,0,26163,103271,0,129434
142330200600000,SE 227,RESIDENTIAL,26112,0,26112,129601,0,155713
142330200700000,SE 227,RESIDENTIAL,26010,0,26010,141269,0,167279
142330200800000,SE 227,RESIDENTIAL,24885,0,24885,115888,0,140773
142330200900000,SE 227,RESIDENTIAL,25500,0,25500,110248,0,135748
142330201000000,SE 227,RESIDENTIAL,25500,0,25500,158040,0,183540
142330201100000,SE 227,RESIDENTIAL,25500,0,25500,136187,0,161687
142330201200000,SE 227,RESIDENTIAL,26000,0,26000,92836,0,118836
142330201300000,SE 227,RESIDENTIAL,27285,0,27285,132962,0,160247
142330201400000,SE 227,RESIDENTIAL,27500,0,27500,123824,0,151324
142330201500000,SE 227,RESIDENTIAL,27262,0,27262,142715,0,169977
142330201600000,SE 227,RESIDENTIAL,21957,0,21957,96262,0,118219
142330201700000,SE 227,RESIDENTIAL,23403,0,23403,108813,0,132216
142330201800000,SE 227,RESIDENTIAL,22372,0,22372,97159,0,119531
142330201900000,SE 227,RESIDENTIAL,26588,0,26588,92182,0,118770
142330202000000,SE 227,RESIDENTIAL,22680,0,22680,153993,0,176673
142330202100000,SE 227,RESIDENTIAL,24472,0,24472,97675,0,122147
142330202200000,SE 227,RESIDENTIAL,25327,0,25327,101368,0,126695
142330202300000,SE 227,RESIDENTIAL,24080,0,24080,88063,0,112143
142330202400000,SE 227,RESIDENTIAL,20257,0,20257,119606,0,139863
142330202500000,SE 227,RESIDENTIAL,19740,0,19740,98937,0,118677
142330202600000,SE 227,RESIDENTIAL,19458,0,19458,93709,0,113167
142330202700000,SE 227,RESIDENTIAL,19174,0,19174,82171,0,101345
142330202800000,SE 227,RESIDENTIAL,24250,0,24250,92333,0,116583
142330202900000,SE 227,RESIDENTIAL,24250,0,24250,88088,0,112338
142330203000000,SE 227,RESIDENTIAL,24250,0,24250,98600,0,122850
142330203100000,SE 227,RESIDENTIAL,24250,0,24250,85562,0,109812
142330203200000,SE 227,RESIDENTIAL,24250,0,24250,93535,0,117785
142330203300000,SE 227,RESIDENTIAL,24250,0,24250,99071,0,123321
142330203400000,SE 227,RESIDENTIAL,24848,0,24848,73616,0,98464
142330203500000,SE 227,RESIDENTIAL,24250,0,24250,97699,0,121949
142330203600000,SE 227,RESIDENTIAL,24250,0,24250,130275,0,154525
142330203700000,SE 227,RESIDENTIAL,21835,0,21835,112227,0,134062
142330203800000,SE 227,RESIDENTIAL,25332,0,25332,106611,0,131943
142330203900000,SE 227,RESIDENTIAL,24250,0,24250,128653,0,152903
142330204000000,SE 227,RESIDENTIAL,24250,0,24250,76167,0,100417
142330204100000,SE 227,RESIDENTIAL,24250,0,24250,112174,0,136424
142330204200000,SE 227,RESIDENTIAL,24250,0,24250,93339,0,117589
142330204300000,SE 227,RESIDENTIAL,24250,0,24250,69429,0,93679
142330300100000,SE 227,RESIDENTIAL,26175,0,26175,123679,0,149854
142330300200000,SE 227,RESIDENTIAL,25000,0,25000,125312,0,150312
142330300300000,SE 227,RESIDENTIAL,25000,0,25000,97046,0,122046
142330300400000,SE 227,RESIDENTIAL,25000,0,25000,116100,0,141100
142330300500000,SE 227,RESIDENTIAL,25000,0,25000,98191,0,123191
142330300600000,SE 227,RESIDENTIAL,25000,0,25000,109483,0,134483
142330300700000,SE 227,RESIDENTIAL,25050,0,25050,121632,0,146682
142330300800000,SE 227,RESIDENTIAL,26250,0,26250,88620,0,114870
142330300900000,SE 227,RESIDENTIAL,25000,0,25000,107052,0,132052
142330301000000,SE 227,RESIDENTIAL,25000,0,25000,102465,0,127465
142330301100000,SE 227,RESIDENTIAL,25000,0,25000,96065,0,121065
142330301200000,SE 227,RESIDENTIAL,25000,0,25000,117221,0,142221
142330301300000,SE 227,RESIDENTIAL,25000,0,25000,131969,0,156969
142330301400000,SE 227,RESIDENTIAL,24630,0,24630,75962,0,100592
142330400100000,SE 227,RESIDENTIAL,25590,0,25590,134458,0,160048
142330400200000,SE 227,RESIDENTIAL,25000,0,25000,93811,0,118811
142330400300000,SE 227,RESIDENTIAL,25000,0,25000,136804,0,161804
142330400400000,SE 227,RESIDENTIAL,25000,0,25000,108070,0,133070
142330400500000,SE 227,RESIDENTIAL,25000,0,25000,131100,0,156100
142330400600000,SE 227,RESIDENTIAL,25000,0,25000,123523,0,148523
142330400700000,SE 227,RESIDENTIAL,25050,0,25050,130248,0,155298
142330400800000,SE 227,RESIDENTIAL,29120,0,29120,121783,0,150903
142330400900000,SE 227,RESIDENTIAL,28560,0,28560,112446,0,141006
142330401000000,SE 227,RESIDENTIAL,26208,0,26208,94132,0,120340
142330401100000,SE 227,RESIDENTIAL,26443,0,26443,129566,0,156009
142330401200000,SE 227,RESIDENTIAL,27310,0,27310,111040,0,138350
142330401300000,SE 227,RESIDENTIAL,25039,0,25039,111350,0,136389
142330500100000,SE 227,RESIDENTIAL,26716,0,26716,108319,0,135035
142330500200000,SE 227,RESIDENTIAL,27487,0,27487,112054,0,139541
142330500300000,SE 227,RESIDENTIAL,26657,0,26657,92682,0,119339
142330500400000,SE 227,RESIDENTIAL,26657,0,26657,74854,0,101511
142330600100000,SE 227,RESIDENTIAL,24353,0,24353,76993,0,101346
142330600200000,SE 227,RESIDENTIAL,30222,0,30222,132178,0,162400
142330600300000,SE 227,RESIDENTIAL,26250,0,26250,97404,0,123654
142330600400000,SE 227,RESIDENTIAL,26250,0,26250,84170,0,110420
142330600500000,SE 227,RESIDENTIAL,15750,0,15750,79179,0,94929
142330600600000,SE 227,RESIDENTIAL,15246,0,15246,0,0,15246
142330600700000,SE 227,RESIDENTIAL,25154,0,25154,100436,0,125590
142330600800000,SE 227,RESIDENTIAL,24500,0,24500,97736,0,122236
142330600900000,SE 227,RESIDENTIAL,25072,0,25072,74111,0,99183
142330601000000,SE 227,RESIDENTIAL,28106,0,28106,113174,0,141280
142330601100000,SE 227,RESIDENTIAL,27589,0,27589,85659,0,113248
142330601200000,SE 227,RESIDENTIAL,27589,0,27589,92425,0,120014
142330601300000,SE 227,RESIDENTIAL,27589,0,27589,150892,0,178481
142330601400000,SE 227,RESIDENTIAL,27589,0,27589,106027,0,133616
142330601500000,SE 227,RESIDENTIAL,27589,0,27589,106399,0,133988
142330601600000,SE 227,RESIDENTIAL,28788,0,28788,114320,0,143108
142330601700000,SE 227,RESIDENTIAL,35591,0,35591,115634,0,151225
142330601800000,SE 227,RESIDENTIAL,23250,0,23250,84826,0,108076
142330601900000,SE 227,RESIDENTIAL,22000,0,22000,75697,0,97697
142330700100000,SE 227,RESIDENTIAL,27777,0,27777,118225,0,146002
142330700200000,SE 227,RESIDENTIAL,28200,0,28200,112757,0,140957
142330700300000,SE 227,RESIDENTIAL,28200,0,28200,102504,0,130704
142330700400000,SE 227,RESIDENTIAL,28200,0,28200,116461,0,144661
142330700500000,SE 227,RESIDENTIAL,28200,0,28200,84117,0,112317
142330800100000,SE 227,RESIDENTIAL,24440,0,24440,102501,0,126941
142330800200000,SE 227,RESIDENTIAL,24440,0,24440,89802,0,114242
142330800300000,SE 227,RESIDENTIAL,24440,0,24440,88540,0,112980
142330800400000,SE 227,RESIDENTIAL,24440,0,24440,85448,0,109888
142330800500000,SE 227,RESIDENTIAL,24440,0,24440,61132,0,85572
142330800600000,SE 227,RESIDENTIAL,21698,0,21698,74512,0,96210
142330900100000,SE 227,RESIDENTIAL,23490,0,23490,105620,0,129110
142330900200000,SE 227,RESIDENTIAL,24840,0,24840,102696,0,127536
142330900300000,SE 227,RESIDENTIAL,24030,0,24030,112166,0,136196
142330900400000,SE 227,RESIDENTIAL,24300,0,24300,117738,0,142038
142330900500000,SE 227,RESIDENTIAL,26634,0,26634,115872,0,142506
142330900600000,SE 227,RESIDENTIAL,25668,0,25668,124723,0,150391
142330900700000,SE 227,RESIDENTIAL,28594,0,28594,80991,0,109585
142330900800000,SE 227,RESIDENTIAL,32182,0,32182,116699,0,148881
142330900900000,SE 227,RESIDENTIAL,26250,0,26250,89636,0,115886
142330901000000,SE 227,RESIDENTIAL,26250,0,26250,89799,0,116049
142330901100000,SE 227,RESIDENTIAL,26250,0,26250,98655,0,124905
142330901200000,SE 227,RESIDENTIAL,26250,0,26250,103477,0,129727
142330901300000,SE 227,RESIDENTIAL,26250,0,26250,122730,0,148980
142330901400000,SE 227,RESIDENTIAL,26910,0,26910,159135,0,186045
142330901500000,SE 227,RESIDENTIAL,34320,0,34320,110319,0,144639
142330901600000,SE 227,RESIDENTIAL,24412,0,24412,128290,0,152702
142330901700000,SE 227,RESIDENTIAL,23400,0,23400,113404,0,136804
142330901800000,SE 227,RESIDENTIAL,21900,0,21900,103888,0,125788
142330901900000,SE 227,RESIDENTIAL,30077,0,30077,148869,0,178946
142332600100000,SE 227,RESIDENTIAL,28467,0,28467,215331,0,243798
142332600200000,SE 227,RESIDENTIAL,28000,0,28000,142028,0,170028
142332600300000,SE 227,RESIDENTIAL,25000,0,25000,122291,0,147291
142332600400000,SE 227,RESIDENTIAL,25000,0,25000,131444,0,156444
142332600500000,SE 227,RESIDENTIAL,24333,0,24333,91106,0,115439
142332600600000,SE 227,RESIDENTIAL,25667,0,25667,123518,0,149185
142332600700000,SE 227,RESIDENTIAL,25000,0,25000,95716,0,120716
142332600800000,SE 227,RESIDENTIAL,25000,0,25000,103677,0,128677
142332600900000,SE 227,RESIDENTIAL,25000,0,25000,116008,0,141008
142332601000000,SE 227,RESIDENTIAL,25000,0,25000,102501,0,127501
142332601100000,SE 227,RESIDENTIAL,24333,0,24333,110195,0,134528
142332700100000,SE 227,RESIDENTIAL,25667,0,25667,99323,0,124990
142332700200000,SE 227,RESIDENTIAL,25000,0,25000,101848,0,126848
142332700300000,SE 227,RESIDENTIAL,25000,0,25000,97233,0,122233
142332700400000,SE 227,RESIDENTIAL,25000,0,25000,122631,0,147631
142332700500000,SE 227,RESIDENTIAL,25000,0,25000,124401,0,149401
142332700600000,SE 227,RESIDENTIAL,26066,0,26066,98952,0,125018
142332700700000,SE 227,RESIDENTIAL,27310,0,27310,135390,0,162700
142332700800000,SE 227,RESIDENTIAL,25241,0,25241,131128,0,156369
142332700900000,SE 227,RESIDENTIAL,25200,0,25200,109969,0,135169
142332701000000,SE 227,RESIDENTIAL,24975,0,24975,92366,0,117341
142332800100000,SE 227,RESIDENTIAL,23363,0,23363,102905,0,126268
142332800200000,SE 227,RESIDENTIAL,23696,0,23696,105972,0,129668
142332800300000,SE 227,RESIDENTIAL,23850,0,23850,88271,0,112121
142332800400000,SE 227,RESIDENTIAL,24181,0,24181,95756,0,119937
142332800500000,SE 227,RESIDENTIAL,29700,0,29700,117926,0,147626
142332800600000,SE 227,RESIDENTIAL,29700,0,29700,106108,0,135808
142332800700000,SE 227,RESIDENTIAL,29700,0,29700,102573,0,132273
142332800800000,SE 227,RESIDENTIAL,29700,0,29700,116080,0,145780
142332800900000,SE 227,RESIDENTIAL,29700,0,29700,111733,0,141433
142332801000000,SE 227,RESIDENTIAL,29700,0,29700,137702,0,167402
142332801100000,SE 227,RESIDENTIAL,29700,0,29700,123403,0,153103
142332801200000,SE 227,RESIDENTIAL,23726,0,23726,123129,0,146855
142332801300000,SE 227,RESIDENTIAL,23700,0,23700,132698,0,156398
142332801400000,SE 227,RESIDENTIAL,25830,0,25830,120688,0,146518
142332801500000,SE 227,RESIDENTIAL,25882,0,25882,109507,0,135389
142332801600000,SE 227,RESIDENTIAL,30000,0,30000,97459,0,127459
142332801700000,SE 227,RESIDENTIAL,29316,0,29316,149841,0,179157
142332801800000,SE 227,RESIDENTIAL,30000,0,30000,140708,0,170708
142332801900000,SE 227,RESIDENTIAL,29700,0,29700,122563,0,152263
142332802000000,SE 227,RESIDENTIAL,35640,0,35640,101155,0,136795
142332802100000,SE 227,RESIDENTIAL,29700,0,29700,100886,0,130586
142332900100000,SE 227,RESIDENTIAL,24000,0,24000,119880,0,143880
142332900200000,SE 227,RESIDENTIAL,22440,0,22440,116350,0,138790
142332900300000,SE 227,RESIDENTIAL,26743,0,26743,126669,0,153412
142333000100000,SE 227,RESIDENTIAL,25000,0,25000,139992,0,164992
142333000200000,SE 227,RESIDENTIAL,25000,0,25000,151114,0,176114
142333000300000,SE 227,RESIDENTIAL,25000,0,25000,65328,0,90328
142333000400000,SE 227,RESIDENTIAL,31875,0,31875,150669,0,182544
142333000500000,SE 227,RESIDENTIAL,31875,0,31875,91753,0,123628
142333000600000,SE 227,RESIDENTIAL,25000,0,25000,139723,0,164723
142333000700000,SE 227,RESIDENTIAL,25000,0,25000,134168,0,159168
142333000800000,SE 227,RESIDENTIAL,25000,0,25000,139359,0,164359
142333000900000,SE 227,RESIDENTIAL,25000,0,25000,110161,0,135161
142333001000000,SE 227,RESIDENTIAL,33640,0,33640,168571,0,202211
142333001100000,SE 227,RESIDENTIAL,32807,0,32807,159004,0,191811
142333001200000,SE 227,RESIDENTIAL,25000,0,25000,69798,0,94798
142333001300000,SE 227,RESIDENTIAL,25000,0,25000,106548,0,131548
142333001400000,SE 227,RESIDENTIAL,25000,0,25000,136270,0,161270
142333001500000,SE 227,RESIDENTIAL,25000,0,25000,123173,0,148173
142333001600000,SE 227,RESIDENTIAL,31875,0,31875,131088,0,162963
142333001700000,SE 227,RESIDENTIAL,31875,0,31875,104739,0,136614
142333001800000,SE 227,RESIDENTIAL,25000,0,25000,159347,0,184347
142333100100000,SE 227,RESIDENTIAL,26454,0,26454,128880,0,155334
142333100200000,SE 227,RESIDENTIAL,27000,0,27000,124878,0,151878
142333100300000,SE 227,RESIDENTIAL,26750,0,26750,120457,0,147207
142333100400000,SE 227,RESIDENTIAL,26500,0,26500,129816,0,156316
142333100500000,SE 227,RESIDENTIAL,26250,0,26250,153351,0,179601
142333100600000,SE 227,RESIDENTIAL,26000,0,26000,132696,0,158696
142333100700000,SE 227,RESIDENTIAL,25500,0,25500,128512,0,154012
142333100800000,SE 227,RESIDENTIAL,25000,0,25000,89818,0,114818
142333100900000,SE 227,RESIDENTIAL,25000,0,25000,119995,0,144995
142333101000000,SE 227,RESIDENTIAL,25000,0,25000,81122,0,106122
142333101100000,SE 227,RESIDENTIAL,25000,0,25000,155063,0,180063
142333101200000,SE 227,RESIDENTIAL,26125,0,26125,131212,0,157337
142333101300000,SE 227,RESIDENTIAL,22500,0,22500,142045,0,164545
142333101400000,SE 227,RESIDENTIAL,25000,0,25000,138148,0,163148
142333101500000,SE 227,RESIDENTIAL,25000,0,25000,127716,0,152716
142333101600000,SE 227,RESIDENTIAL,28035,0,28035,99715,0,127750
142333101700000,SE 227,RESIDENTIAL,27370,0,27370,114133,0,141503
142333200100000,SE 227,RESIDENTIAL,27661,0,27661,118436,0,146097
142333200200000,SE 227,RESIDENTIAL,27281,0,27281,135164,0,162445
142333200300000,SE 227,RESIDENTIAL,21900,0,21900,81581,0,103481
142333200400000,SE 227,RESIDENTIAL,21900,0,21900,145779,0,167679
142333200500000,SE 227,RESIDENTIAL,28787,0,28787,138866,0,167653
142333200600000,SE 227,RESIDENTIAL,25900,0,25900,135024,0,160924
142333300100000,SE 227,RESIDENTIAL,21900,0,21900,122534,0,144434
142333300200000,SE 227,RESIDENTIAL,21600,0,21600,111489,0,133089
142333300300000,SE 227,RESIDENTIAL,27349,0,27349,102666,0,130015
142333300400000,SE 227,RESIDENTIAL,26520,0,26520,97731,0,124251
142333300500000,SE 227,RESIDENTIAL,37444,0,37444,190871,0,228315
142333400100000,SE 227,RESIDENTIAL,26010,0,26010,130240,0,156250
142333400200000,SE 227,RESIDENTIAL,31158,0,31158,139859,0,171017
142333400300000,SE 227,RESIDENTIAL,29850,0,29850,136070,0,165920
142333400400000,SE 227,RESIDENTIAL,30564,0,30564,126872,0,157436
142333400500000,SE 227,RESIDENTIAL,30780,0,30780,119210,0,149990
142333400600000,SE 227,RESIDENTIAL,25000,0,25000,82673,0,107673
142333400700000,SE 227,RESIDENTIAL,25000,0,25000,123596,0,148596
142333400800000,SE 227,RESIDENTIAL,26362,0,26362,148271,0,174633
142333400900000,SE 227,RESIDENTIAL,30420,0,30420,103959,0,134379
142333401000000,SE 227,RESIDENTIAL,30480,0,30480,117821,0,148301
142333401100000,SE 227,RESIDENTIAL,31158,0,31158,101303,0,132461
142333401200000,SE 227,RESIDENTIAL,28367,0,28367,163257,0,191624
142333401300000,SE 227,RESIDENTIAL,25000,0,25000,120305,0,145305
142333401400000,SE 227,RESIDENTIAL,25000,0,25000,146420,0,171420
142333401500000,SE 227,RESIDENTIAL,26500,0,26500,159706,0,186206
142333500100000,SE 227,RESIDENTIAL,42630,0,42630,165274,0,207904
142333500200000,SE 227,RESIDENTIAL,40180,0,40180,150019,0,190199
142333500300000,SE 227,RESIDENTIAL,25000,0,25000,91899,0,116899
142333500400000,SE 227,RESIDENTIAL,25000,0,25000,89448,0,114448
142333500500000,SE 227,RESIDENTIAL,25000,0,25000,86437,0,111437
142333500600000,SE 227,RESIDENTIAL,25000,0,25000,90172,0,115172
142333500700000,SE 227,RESIDENTIAL,25000,0,25000,113869,0,138869
142333500800000,SE 227,RESIDENTIAL,25000,0,25000,105776,0,130776
142333500900000,SE 227,RESIDENTIAL,26667,0,26667,151454,0,178121
142333501000000,SE 227,RESIDENTIAL,27300,0,27300,34368,0,61668
142333501100000,SE 227,RESIDENTIAL,25000,0,25000,89557,0,114557
142333501200000,SE 227,RESIDENTIAL,25000,0,25000,118877,0,143877
142333501300000,SE 227,RESIDENTIAL,25000,0,25000,111951,0,136951
142333600100000,SE 227,RESIDENTIAL,138562,0,138562,206484,0,345046
142333600200000,SE 227,RESIDENTIAL,47625,0,47625,199814,0,247439
142333600300000,SE 227,RESIDENTIAL,58986,0,58986,331524,0,390510
142333600400000,SE 227,RESIDENTIAL,57330,0,57330,363918,0,421248
142335100100000,SE 243,RESIDENTIAL,80401,0,80401,152458,0,232859
142335100200000,SE 243,RESIDENTIAL,85440,0,85440,143223,0,228663
142335100300000,SE 243,RESIDENTIAL,72320,0,72320,75747,0,148067
142335100400000,SE 243,RESIDENTIAL,72320,0,72320,189833,0,262153
142335100500000,SE 243,RESIDENTIAL,114000,0,114000,230272,0,344272
142335100600000,SE 243,RESIDENTIAL,140000,0,140000,229253,0,369253
142335100700000,SE 243,RESIDENTIAL,84240,0,84240,238550,0,322790
142335100800000,SE 243,RESIDENTIAL,76524,0,76524,211435,0,287959
142335100900000,SE 243,RESIDENTIAL,78874,0,78874,192367,0,271241
142335101000000,SE 243,RESIDENTIAL,75802,0,75802,190582,0,266384
142335101100000,SE 243,RESIDENTIAL,84634,0,84634,219503,0,304137
142335101200000,SE 243,RESIDENTIAL,96219,0,96219,233550,0,329769
142335101300000,SE 243,RESIDENTIAL,91228,0,91228,279856,0,371084
142335101400000,SE 247,RESIDENTIAL,177693,0,177693,707199,0,884892
142335101500000,SE 247,RESIDENTIAL,51120,0,51120,197916,0,249036
142335101600000,SE 247,RESIDENTIAL,51920,0,51920,226037,0,277957
142335101700000,SE 247,RESIDENTIAL,56862,0,56862,368687,0,425549
142335101800000,SE 247,RESIDENTIAL,57730,0,57730,258782,0,316512
142335101900000,SE 243,RESIDENTIAL,109388,0,109388,221711,0,331099
142335102000000,SE 243,RESIDENTIAL,93643,0,93643,144067,0,237710
142335102100000,SE 243,RESIDENTIAL,93643,0,93643,267905,0,361548
142335102200000,SE 243,RESIDENTIAL,78376,0,78376,150474,0,228850
142335200100000,SE 247,RESIDENTIAL,54390,0,54390,139059,0,193449
142335200200000,SE 247,RESIDENTIAL,68342,0,68342,369572,0,437914
142335200300000,SE 247,RESIDENTIAL,65268,0,65268,230584,0,295852
142335200400000,SE 247,RESIDENTIAL,69488,0,69488,164462,0,233950
142335200500000,SE 247,RESIDENTIAL,82253,0,82253,310204,0,392457
142335200600000,SE 247,RESIDENTIAL,69216,0,69216,288416,0,357632
142335200700000,SE 247,RESIDENTIAL,69165,0,69165,282099,0,351264
142335300100000,SE 247,RESIDENTIAL,59462,0,59462,188321,0,247783
142335300200000,SE 247,RESIDENTIAL,59462,0,59462,229957,0,289419
142335300300000,SE 247,RESIDENTIAL,48740,0,48740,190865,0,239605
142335300400000,SE 247,RESIDENTIAL,135275,0,135275,385482,0,520757
142335300500000,SE 247,RESIDENTIAL,71478,0,71478,210633,0,282111
142335300600000,SE 247,RESIDENTIAL,70096,0,70096,265735,0,335831
142335300700000,SE 247,RESIDENTIAL,62100,0,62100,183507,0,245607
142335300800000,SE 247,RESIDENTIAL,57024,0,57024,134566,0,191590
142335300900000,SE 247,RESIDENTIAL,49820,0,49820,100996,0,150816
142335301000000,SE 235,RESIDENTIAL,48000,0,48000,81038,0,129038
142335301100000,SE 235,RESIDENTIAL,22838,0,22838,80973,0,103811
142335301200000,SE 235,RESIDENTIAL,40880,0,40880,64610,0,105490
142335301300000,SE 247,RESIDENTIAL,71257,0,71257,169989,0,241246
142335301400000,SE 247,RESIDENTIAL,61800,0,61800,156034,0,217834
142335301500000,SE 247,RESIDENTIAL,62916,0,62916,162350,0,225266
142335301600000,SE 247,RESIDENTIAL,58208,0,58208,124386,0,182594
142335301700000,SE 247,RESIDENTIAL,52800,0,52800,140146,0,192946
142335400100000,SE 235,RESIDENTIAL,22120,0,22120,57918,0,80038
142335400200000,SE 247,RESIDENTIAL,69486,0,69486,153002,0,222488
142335400300000,SE 247,RESIDENTIAL,66798,0,66798,234274,0,301072
142335400400000,SE 247,RESIDENTIAL,67122,0,67122,240600,0,307722
142335400500000,SE 247,RESIDENTIAL,65574,0,65574,202088,0,267662
142335400600000,SE 247,RESIDENTIAL,70877,0,70877,243780,0,314657
142335400700000,SE 247,RESIDENTIAL,70646,0,70646,382160,0,452806
142335400800000,SE 247,RESIDENTIAL,73780,0,73780,207831,0,281611
142335400900000,SE 247,RESIDENTIAL,65400,0,65400,278993,0,344393
142335401000000,SE 247,RESIDENTIAL,72760,0,72760,169870,0,242630
142335401100000,SE 247,RESIDENTIAL,73416,0,73416,155639,0,229055
142335401200000,SE 235,RESIDENTIAL,36960,0,36960,105188,0,142148
142335401300000,SE 235,RESIDENTIAL,44160,0,44160,89296,0,133456
142335401400000,SE 235,RESIDENTIAL,21000,0,21000,88156,0,109156
142335401500000,SE 235,RESIDENTIAL,21000,0,21000,90843,0,111843
142335401600000,SE 235,RESIDENTIAL,21000,0,21000,70958,0,91958
142335401700000,SE 235,RESIDENTIAL,21000,0,21000,68088,0,89088
142335401800000,SE 235,RESIDENTIAL,21000,0,21000,68860,0,89860
142335401900000,SE 235,RESIDENTIAL,22050,0,22050,97322,0,119372
142335500100000,SE 247,RESIDENTIAL,54315,0,54315,153331,0,207646
142335500200000,SE 247,RESIDENTIAL,37862,0,37862,143345,0,181207
142335600100000,SE 235,RESIDENTIAL,54400,0,54400,101523,0,155923
142335600200000,SE 235,RESIDENTIAL,41547,0,41547,118869,0,160416
142335600300000,SE 247,RESIDENTIAL,52164,0,52164,145282,0,197446
142335600400000,SE 247,RESIDENTIAL,53550,0,53550,170546,0,224096
142335600500000,SE 247,RESIDENTIAL,56448,0,56448,201131,0,257579
142335600600000,SE 247,RESIDENTIAL,47306,0,47306,181725,0,229031
142335600700000,SE 247,RESIDENTIAL,46920,0,46920,186547,0,233467
142335600800000,SE 235,RESIDENTIAL,17500,0,17500,85265,0,102765
142335600900000,SE 235,RESIDENTIAL,17500,0,17500,79090,0,96590
142335601000000,SE 235,RESIDENTIAL,17500,0,17500,89677,0,107177
142335601100000,SE 235,RESIDENTIAL,17500,0,17500,113792,0,131292
142335601200000,SE 235,RESIDENTIAL,17500,0,17500,83087,0,100587
142337600100000,SE 224,RESIDENTIAL,38850,0,38850,102954,0,141804
142337600200000,SE 224,RESIDENTIAL,27721,0,27721,109348,0,137069
142337600300000,SE 224,RESIDENTIAL,27034,0,27034,76893,0,103927
142337600400000,SE 224,RESIDENTIAL,28636,0,28636,105974,0,134610
142337600500000,SE 224,RESIDENTIAL,26422,0,26422,99626,0,126048
142337600600000,SE 224,RESIDENTIAL,26833,0,26833,101507,0,128340
142337600700000,SE 224,RESIDENTIAL,28436,0,28436,87151,0,115587
142337600800000,SE 224,RESIDENTIAL,33300,0,33300,132766,0,166066
142337600900000,SE 224,RESIDENTIAL,38850,0,38850,107277,0,146127
142337601000000,SE 224,RESIDENTIAL,33966,0,33966,84209,0,118175
142337601100000,SE 224,RESIDENTIAL,33966,0,33966,82670,0,116636
142337700100000,SE 224,RESIDENTIAL,32310,0,32310,106653,0,138963
142337700200000,SE 224,RESIDENTIAL,28305,0,28305,76369,0,104674
142337700300000,SE 224,RESIDENTIAL,28305,0,28305,73540,0,101845
142337700400000,SE 224,RESIDENTIAL,28305,0,28305,69721,0,98026
142337700500000,SE 224,RESIDENTIAL,28305,0,28305,100095,0,128400
142337700600000,SE 224,RESIDENTIAL,26700,0,26700,64811,0,91511
142337700700000,SE 224,RESIDENTIAL,26700,0,26700,89960,0,116660
142337700800000,SE 224,RESIDENTIAL,27145,0,27145,73960,0,101105
142337700900000,SE 224,RESIDENTIAL,27540,0,27540,71023,0,98563
142337701000000,SE 224,RESIDENTIAL,27540,0,27540,72641,0,100181
142337701100000,SE 224,RESIDENTIAL,28593,0,28593,95443,0,124036
142337701200000,SE 224,RESIDENTIAL,28435,0,28435,77625,0,106060
142337701300000,SE 224,RESIDENTIAL,27034,0,27034,118981,0,146015
142337701400000,SE 224,RESIDENTIAL,28148,0,28148,94880,0,123028
142337800100000,SCHOOL,EXEMPT,0,0,0,0,0,0
142337800200000,SE 227,RESIDENTIAL,34650,0,34650,127034,0,161684
142337800300000,SE 227,RESIDENTIAL,26250,0,26250,117251,0,143501
142337800400000,SE 227,RESIDENTIAL,26250,0,26250,97441,0,123691
142337800500000,SE 227,RESIDENTIAL,26250,0,26250,122671,0,148921
142337800600000,SE 227,RESIDENTIAL,26250,0,26250,123874,0,150124
142337800700000,SE 227,RESIDENTIAL,26250,0,26250,136782,0,163032
142337800800000,SE 227,RESIDENTIAL,26250,0,26250,93697,0,119947
142337800900000,SE 227,RESIDENTIAL,26250,0,26250,143567,0,169817
142337801000000,SE 227,RESIDENTIAL,26250,0,26250,111740,0,137990
142337801100000,SE 227,RESIDENTIAL,26250,0,26250,95233,0,121483
142337801200000,SE 227,RESIDENTIAL,23100,0,23100,111714,0,134814
142337801300000,SE 227,RESIDENTIAL,26250,0,26250,92267,0,118517
142337801400000,SE 227,RESIDENTIAL,26250,0,26250,88774,0,115024
142337801500000,SE 227,RESIDENTIAL,26250,0,26250,114981,0,141231
142337801600000,SE 227,RESIDENTIAL,26250,0,26250,119972,0,146222
142337801700000,SE 227,RESIDENTIAL,26250,0,26250,98121,0,124371
142337801800000,SE 227,RESIDENTIAL,26250,0,26250,90800,0,117050
142337801900000,SE 227,RESIDENTIAL,26250,0,26250,84418,0,110668
142337802000000,SE 227,RESIDENTIAL,26250,0,26250,92560,0,118810
142337802100000,SE 227,RESIDENTIAL,26250,0,26250,109247,0,135497
142337802200000,SE 227,RESIDENTIAL,26250,0,26250,69345,0,95595
142337802300000,SE 227,RESIDENTIAL,26250,0,26250,114605,0,140855
142337802400000,SE 227,RESIDENTIAL,26250,0,26250,80912,0,107162
142337802500000,SE 227,RESIDENTIAL,26250,0,26250,82913,0,109163
142337802600000,SE 227,RESIDENTIAL,25724,0,25724,84961,0,110685
142337802700000,CITY PROPERTY,EXEMPT,0,0,0,0,0,0
142337802800000,SE 224,RESIDENTIAL,17374,0,17374,62531,0,79905
142337802900000,SE 224,RESIDENTIAL,26513,0,26513,75778,0,102291
142337803000000,SE 224,RESIDENTIAL,26505,0,26505,80679,0,107184
142337803100000,SE 224,RESIDENTIAL,27000,0,27000,98274,0,125274
142337803200000,SE 224,RESIDENTIAL,27360,0,27360,93800,0,121160
142337803300000,SE 224,RESIDENTIAL,26100,0,26100,96152,0,122252
142337803400000,SE 224,RESIDENTIAL,25375,0,25375,80044,0,105419
142337900100000,SE 224,RESIDENTIAL,31080,0,31080,74309,0,105389
142337900200000,SE 224,RESIDENTIAL,26939,0,26939,103685,0,130624
142337900300000,SE 224,RESIDENTIAL,26700,0,26700,91146,0,117846
142337900400000,SE 224,RESIDENTIAL,26700,0,26700,111390,0,138090
142337900500000,SE 224,RESIDENTIAL,26700,0,26700,97876,0,124576
142337900600000,SE 224,RESIDENTIAL,27268,0,27268,107397,0,134665
142337900700000,SE 224,RESIDENTIAL,27268,0,27268,99830,0,127098
142337900800000,SE 224,RESIDENTIAL,26700,0,26700,106494,0,133194
142337900900000,SE 224,RESIDENTIAL,29053,0,29053,121487,0,150540
142337901000000,SE 224,RESIDENTIAL,28533,0,28533,82173,0,110706
142337901100000,SE 224,RESIDENTIAL,34565,0,34565,116446,0,151011
142337901200000,SE 224,RESIDENTIAL,33389,0,33389,104132,0,137521
142337901300000,SE 224,RESIDENTIAL,28533,0,28533,88385,0,116918
142337901400000,SE 224,RESIDENTIAL,30963,0,30963,100375,0,131338
142337901500000,SE 224,RESIDENTIAL,26700,0,26700,81616,0,108316
142337901600000,SE 224,RESIDENTIAL,27268,0,27268,87583,0,114851
142337901700000,SE 224,RESIDENTIAL,27268,0,27268,109693,0,136961
142337901800000,SE 224,RESIDENTIAL,26700,0,26700,85779,0,112479
142337901900000,SE 224,RESIDENTIAL,26700,0,26700,83866,0,110566
142337902000000,SE 224,RESIDENTIAL,26633,0,26633,83659,0,110292
142337902100000,SE 224,RESIDENTIAL,27753,0,27753,101029,0,128782
142337902200000,SE 224,RESIDENTIAL,27553,0,27553,85619,0,113172
142337902300000,SE 224,RESIDENTIAL,27622,0,27622,94662,0,122284
142337902400000,SE 224,RESIDENTIAL,26700,0,26700,107795,0,134495
142337902500000,SE 224,RESIDENTIAL,26255,0,26255,88363,0,114618
142337902600000,SE 224,RESIDENTIAL,26550,0,26550,100525,0,127075
142337902700000,SE 224,RESIDENTIAL,26550,0,26550,59501,0,86051
142337902800000,SE 224,RESIDENTIAL,26550,0,26550,87097,0,113647
142337902900000,SE 224,RESIDENTIAL,26550,0,26550,66522,0,93072
142337903000000,SE 224,RESIDENTIAL,26550,0,26550,84173,0,110723
142337903100000,SE 224,RESIDENTIAL,26550,0,26550,80510,0,107060
142337903200000,SE 224,RESIDENTIAL,26550,0,26550,95893,0,122443
142337903300000,SE 224,RESIDENTIAL,26550,0,26550,74357,0,100907
142337903400000,SE 224,RESIDENTIAL,26550,0,26550,120885,0,147435
142337903500000,SE 224,RESIDENTIAL,27000,0,27000,99700,0,126700
142337903600000,SE 224,RESIDENTIAL,17437,0,17437,76463,0,93900
142337903700000,SE 224,RESIDENTIAL,17424,0,17424,92452,0,109876
142337903800000,SE 224,RESIDENTIAL,25299,0,25299,77758,0,103057
142337903900000,SE 224,RESIDENTIAL,25235,0,25235,89016,0,114251
142337904000000,SE 224,RESIDENTIAL,19600,0,19600,73230,0,92830
142337904100000,SE 224,RESIDENTIAL,16100,0,16100,84635,0,100735
142337904200000,SE 224,RESIDENTIAL,31185,0,31185,104136,0,135321
142337904300000,SE 224,RESIDENTIAL,21475,0,21475,73334,0,94809
142337904400000,SE 224,RESIDENTIAL,18568,0,18568,54975,0,73543
142337904500000,SE 224,RESIDENTIAL,27652,0,27652,37348,0,65000
142337904600000,SE 224,RESIDENTIAL,27750,0,27750,68080,0,95830
142337904700000,SE 224,RESIDENTIAL,27195,0,27195,54940,0,82135
142337904800000,SE 224,RESIDENTIAL,27750,0,27750,119610,0,147360
142337904900000,SE 224,RESIDENTIAL,33300,0,33300,92382,0,125682
142337905000000,SE 224,RESIDENTIAL,33000,0,33000,121880,0,154880
142337905100000,SE 224,RESIDENTIAL,23773,0,23773,62493,0,86266
142337905200000,SE 224,RESIDENTIAL,26363,0,26363,89902,0,116265
142337905300000,SE 224,RESIDENTIAL,25530,0,25530,76050,0,101580
142337905400000,SE 224,RESIDENTIAL,21830,0,21830,0,0,21830
142337905500000,SE 224,RESIDENTIAL,19000,0,19000,79543,0,98543
142337905600000,SE 224,RESIDENTIAL,31080,0,31080,110838,0,141918
142337905700000,SE 224,RESIDENTIAL,31080,0,31080,67498,0,98578
142337905800000,SE 224,RESIDENTIAL,31080,0,31080,108588,0,139668
142338000100000,SE 224,RESIDENTIAL,25163,0,25163,61527,0,86690
142338000200000,SE 224,RESIDENTIAL,25092,0,25092,80352,0,105444
142338000300000,SE 224,RESIDENTIAL,25266,0,25266,81761,0,107027
142338000400000,SE 224,RESIDENTIAL,24743,0,24743,84929,0,109672
142338000500000,SE 224,RESIDENTIAL,25583,0,25583,71035,0,96618
142338000600000,SE 224,RESIDENTIAL,16450,0,16450,81467,0,97917
142338000700000,SE 224,RESIDENTIAL,22751,0,22751,102977,0,125728
142338000800000,SE 224,RESIDENTIAL,18725,0,18725,66163,0,84888
142338000900000,SE 224,RESIDENTIAL,18725,0,18725,93711,0,112436
142338001000000,SE 224,RESIDENTIAL,24500,0,24500,74620,0,99120
142338001100000,SE 224,RESIDENTIAL,24990,0,24990,68656,0,93646
142338001200000,SE 224,RESIDENTIAL,25480,0,25480,78579,0,104059
142338001300000,SE 224,RESIDENTIAL,24500,0,24500,72354,0,96854
142340100100000,SE 210,RESIDENTIAL,7560,0,7560,0,0,7560
142340100200000,SE 210,RESIDENTIAL,54300,0,54300,437806,0,492106
142340100300000,SE 210,RESIDENTIAL,1290,0,1290,0,0,1290
142340100400000,SE 210,RESIDENTIAL,1035,0,1035,0,0,1035
142340100500000,SE 210,RESIDENTIAL,39640,0,39640,128415,0,168055
142340100600000,SE 210,RESIDENTIAL,27738,0,27738,155929,0,183667
142340100700000,SE 210,RESIDENTIAL,28444,0,28444,112586,0,141030
142340100800000,SE 210,RESIDENTIAL,35087,0,35087,158860,0,193947
142340100900000,SE 210,RESIDENTIAL,35425,0,35425,119143,0,154568
142340101000000,SE 210,RESIDENTIAL,38362,0,38362,210237,0,248599
142340101100000,SE 210,RESIDENTIAL,29044,0,29044,175483,0,204527
142340101200000,SE 210,RESIDENTIAL,26750,0,26750,133841,0,160591
142340101300000,SE 210,RESIDENTIAL,24304,0,24304,113514,0,137818
142340101400000,SE 224,RESIDENTIAL,31268,0,31268,134939,0,166207
142340101500000,SE 210,RESIDENTIAL,42049,0,42049,136941,0,178990
142340101600000,SE 210,RESIDENTIAL,28609,0,28609,124947,0,153556
142340101700000,SE 210,RESIDENTIAL,31040,0,31040,0,0,31040
142340101800000,SE 210,RESIDENTIAL,33950,0,33950,126108,0,160058
142340101900000,SE 210,RESIDENTIAL,28420,0,28420,105778,0,134198
142340102000000,SE 210,RESIDENTIAL,30400,0,30400,152881,0,183281
142340102100000,SE 210,RESIDENTIAL,31416,0,31416,121945,0,153361
142340102200000,SE 210,RESIDENTIAL,29376,0,29376,106215,0,135591
142340102300000,SE 210,RESIDENTIAL,29029,0,29029,157059,0,186088
142340102400000,SE 210,RESIDENTIAL,25398,0,25398,121307,0,146705
142340200100000,SE 224,RESIDENTIAL,29460,0,29460,113772,0,143232
142340200200000,SE 224,RESIDENTIAL,29452,0,29452,96209,0,125661
142340200300000,SE 224,RESIDENTIAL,34009,0,34009,94477,0,128486
142340200400000,SE 224,RESIDENTIAL,35363,0,35363,110012,0,145375
142340200500000,SE 224,RESIDENTIAL,28200,0,28200,94968,0,123168
142340200600000,SE 224,RESIDENTIAL,28200,0,28200,91411,0,119611
142340200700000,SE 224,RESIDENTIAL,29022,0,29022,93018,0,122040
142340200800000,SE 224,RESIDENTIAL,31587,0,31587,128420,0,160007
142340200900000,SE 224,RESIDENTIAL,32062,0,32062,89394,0,121456
142340300100000,SE 224,RESIDENTIAL,28458,0,28458,118729,0,147187
142340300200000,SE 224,RESIDENTIAL,38663,0,38663,95528,0,134191
142340300300000,SE 224,RESIDENTIAL,24847,0,24847,115251,0,140098
142340300400000,SE 224,RESIDENTIAL,32831,0,32831,105229,0,138060
142340300500000,SE 224,RESIDENTIAL,32831,0,32831,114100,0,146931
142340400100000,SE 210,RESIDENTIAL,28458,0,28458,153702,0,182160
142340400200000,SE 210,RESIDENTIAL,31512,0,31512,177024,0,208536
142340400300000,SE 210,RESIDENTIAL,29892,0,29892,124189,0,154081
142340400400000,SE 210,RESIDENTIAL,22873,0,22873,102411,0,125284
142340400500000,SE 210,RESIDENTIAL,21150,0,21150,94664,0,115814
142340400600000,SE 210,RESIDENTIAL,21840,0,21840,141937,0,163777
142340400700000,SE 210,RESIDENTIAL,21312,0,21312,110719,0,132031
142340400800000,SE 210,RESIDENTIAL,21150,0,21150,106960,0,128110
142340400900000,SE 210,RESIDENTIAL,18960,0,18960,97506,0,116466
142340401000000,SE 210,RESIDENTIAL,26901,0,26901,123524,0,150425
142340401100000,SE 224,RESIDENTIAL,26560,0,26560,102486,0,129046
142340401200000,SE 224,RESIDENTIAL,30600,0,30600,83986,0,114586
142340401300000,SE 224,RESIDENTIAL,31185,0,31185,124735,0,155920
142340401400000,SE 224,RESIDENTIAL,29808,0,29808,95663,0,125471
142340401500000,SE 224,RESIDENTIAL,30576,0,30576,93568,0,124144
142340401600000,SE 224,RESIDENTIAL,26987,0,26987,136589,0,163576
142340401700000,SE 224,RESIDENTIAL,25200,0,25200,89629,0,114829
142340401800000,SE 224,RESIDENTIAL,25200,0,25200,90871,0,116071
142340401900000,SE 224,RESIDENTIAL,31196,0,31196,119118,0,150314
142340402000000,SE 224,RESIDENTIAL,30080,0,30080,104451,0,134531
142340402100000,SE 224,RESIDENTIAL,34000,0,34000,108984,0,142984
142340402200000,SE 224,RESIDENTIAL,34000,0,34000,111968,0,145968
142340402300000,SE 224,RESIDENTIAL,31512,0,31512,96585,0,128097
142340500100000,SE 224,RESIDENTIAL,29782,0,29782,101482,0,131264
142340500200000,SE 224,RESIDENTIAL,29469,0,29469,79415,0,108884
142340500300000,SE 224,RESIDENTIAL,29469,0,29469,68528,0,97997
142340500400000,SE 224,RESIDENTIAL,29469,0,29469,88083,0,117552
142340500500000,SE 224,RESIDENTIAL,29469,0,29469,97540,0,127009
142340500600000,SE 224,RESIDENTIAL,29469,0,29469,76132,0,105601
142340500700000,SE 224,RESIDENTIAL,29782,0,29782,84472,0,114254
142340500800000,SE 224,RESIDENTIAL,29782,0,29782,85278,0,115060
142340500900000,SE 224,RESIDENTIAL,29782,0,29782,91608,0,121390
142340501000000,SE 224,RESIDENTIAL,29782,0,29782,101018,0,130800
142340600100000,SE 224,RESIDENTIAL,32290,0,32290,99900,0,132190
142340600200000,SE 224,RESIDENTIAL,32290,0,32290,71823,0,104113
142340600300000,SE 224,RESIDENTIAL,32290,0,32290,85345,0,117635
142340600400000,SE 224,RESIDENTIAL,32290,0,32290,115152,0,147442
142340600500000,SE 224,RESIDENTIAL,32290,0,32290,83946,0,116236
142340700100000,SE 224,RESIDENTIAL,26752,0,26752,109103,0,135855
142340700200000,SE 224,RESIDENTIAL,23936,0,23936,81124,0,105060
142340700300000,SE 224,RESIDENTIAL,24218,0,24218,76663,0,100881
142340700400000,SE 224,RESIDENTIAL,25740,0,25740,78298,0,104038
142340700500000,SE 224,RESIDENTIAL,29100,0,29100,96571,0,125671
142340700600000,SE 224,RESIDENTIAL,23520,0,23520,80143,0,103663
142340800100000,SE 224,RESIDENTIAL,29991,0,29991,144996,0,174987
142340800200000,SE 224,RESIDENTIAL,25200,0,25200,81056,0,106256
142340800300000,SE 224,RESIDENTIAL,24600,0,24600,93013,0,117613
142340800400000,SE 224,RESIDENTIAL,29999,0,29999,108764,0,138763
142340800500000,SE 224,RESIDENTIAL,28583,0,28583,80158,0,108741
142340800600000,SE 224,RESIDENTIAL,29400,0,29400,76902,0,106302
142340800700000,SE 224,RESIDENTIAL,29400,0,29400,81864,0,111264
142340800800000,SE 224,RESIDENTIAL,29400,0,29400,79113,0,108513
142340800900000,SE 224,RESIDENTIAL,27900,0,27900,76049,0,103949
142340801000000,SE 224,RESIDENTIAL,30750,0,30750,81438,0,112188
142340801100000,SE 224,RESIDENTIAL,28350,0,28350,86951,0,115301
142340900100000,SE 224,RESIDENTIAL,28500,0,28500,113518,0,142018
142340900200000,SE 224,RESIDENTIAL,29331,0,29331,113170,0,142501
142340900300000,SE 224,RESIDENTIAL,30720,0,30720,111808,0,142528
142340900400000,SE 224,RESIDENTIAL,31040,0,31040,102187,0,133227
142340900500000,SE 224,RESIDENTIAL,29949,0,29949,117995,0,147944
142340900600000,SE 224,RESIDENTIAL,29988,0,29988,104156,0,134144
142340900700000,SE 224,RESIDENTIAL,29700,0,29700,72466,0,102166
142340900800000,SE 224,RESIDENTIAL,30856,0,30856,112528,0,143384
142340900900000,SE 224,RESIDENTIAL,29925,0,29925,78645,0,108570
142340901000000,SE 224,RESIDENTIAL,30887,0,30887,93529,0,124416
142340901100000,SE 224,RESIDENTIAL,29925,0,29925,82210,0,112135
142340901200000,SE 224,RESIDENTIAL,30400,0,30400,84812,0,115212
142340901300000,SE 224,RESIDENTIAL,28500,0,28500,94261,0,122761
142340901400000,SE 224,RESIDENTIAL,28500,0,28500,73750,0,102250
142341000100000,SE 224,RESIDENTIAL,29589,0,29589,101858,0,131447
142341000200000,SE 224,RESIDENTIAL,30600,0,30600,93630,0,124230
142341000300000,SE 224,RESIDENTIAL,32946,0,32946,95745,0,128691
142341000400000,SE 224,RESIDENTIAL,32320,0,32320,81888,0,114208
142341000500000,SE 224,RESIDENTIAL,31500,0,31500,109444,0,140944
142341000600000,SE 224,RESIDENTIAL,31500,0,31500,125112,0,156612
142341000700000,SE 224,RESIDENTIAL,30891,0,30891,96526,0,127417
142341100100000,SE 224,RESIDENTIAL,29073,0,29073,65838,0,94911
142341100200000,SE 224,RESIDENTIAL,28800,0,28800,84088,0,112888
142341100300000,SE 224,RESIDENTIAL,28800,0,28800,67519,0,96319
142341100400000,SE 224,RESIDENTIAL,29440,0,29440,68656,0,98096
142341100500000,SE 224,RESIDENTIAL,29440,0,29440,70493,0,99933
142341100600000,SE 224,RESIDENTIAL,30053,0,30053,79529,0,109582
142341100700000,SE 224,RESIDENTIAL,28520,0,28520,116964,0,145484
142342600100000,SE 224,RESIDENTIAL,28432,0,28432,72215,0,100647
142342600200000,SE 224,RESIDENTIAL,19892,0,19892,50785,0,70677
142342600300000,SE 224,RESIDENTIAL,17600,0,17600,37027,0,54627
142342600400000,SE 224,RESIDENTIAL,20000,0,20000,55401,0,75401
142342600500000,SE 224,RESIDENTIAL,20000,0,20000,36206,0,56206
142342600600000,SE 224,RESIDENTIAL,20000,0,20000,33063,0,53063
142342600800000,SE 224,EXEMPT,0,16000,16000,0,63642,79642
142342600900000,SE 224,EXEMPT,0,16534,16534,0,79722,96256
142342700100000,SE 224,RESIDENTIAL,33429,0,33429,95459,0,128888
142342700200000,SE 224,RESIDENTIAL,31680,0,31680,88931,0,120611
142342700300000,SE 224,RESIDENTIAL,26928,0,26928,76457,0,103385
142342700400000,SE 224,RESIDENTIAL,37975,0,37975,93162,0,131137
142342700500000,SE 224,RESIDENTIAL,33660,0,33660,66786,0,100446
142342700600000,SE 224,RESIDENTIAL,30000,0,30000,74263,0,104263
142342700700000,SE 224,RESIDENTIAL,30000,0,30000,92943,0,122943
142342700800000,SE 224,RESIDENTIAL,43680,0,43680,112801,0,156481
142342700900000,SE 224,RESIDENTIAL,31200,0,31200,62400,0,93600
142342701000000,SE 224,RESIDENTIAL,30600,0,30600,98554,0,129154
142342701100000,SE 224,RESIDENTIAL,30600,0,30600,66214,0,96814
142342701200000,SE 224,RESIDENTIAL,30600,0,30600,81146,0,111746
142342701300000,SE 224,RESIDENTIAL,36000,0,36000,78123,0,114123
142342701400000,SE 224,RESIDENTIAL,30000,0,30000,90668,0,120668
142342701500000,SE 224,RESIDENTIAL,30000,0,30000,80710,0,110710
142342701600000,SE 224,RESIDENTIAL,36000,0,36000,67976,0,103976
142342701700000,SE 224,RESIDENTIAL,36000,0,36000,76324,0,112324
142342702100000,SE 224,RESIDENTIAL,22275,0,22275,0,0,22275
142342702200000,SE 224,RESIDENTIAL,24750,0,24750,79558,0,104308
142342702300000,SE 224,RESIDENTIAL,22275,0,22275,98167,0,120442
142342702400000,SE 224,RESIDENTIAL,23000,0,23000,72190,0,95190
142342702500000,SE 224,RESIDENTIAL,30000,0,30000,64054,0,94054
142342702600000,SE 224,RESIDENTIAL,25000,0,25000,73620,0,98620
142342702700000,SE 224,RESIDENTIAL,25000,0,25000,85782,0,110782
142342702800000,SE 224,RESIDENTIAL,30000,0,30000,90150,0,120150
142342702900000,SE 224,RESIDENTIAL,25500,0,25500,87760,0,113260
142342703000000,SE 224,RESIDENTIAL,25500,0,25500,64349,0,89849
142342703100000,SE 224,RESIDENTIAL,25500,0,25500,103453,0,128953
142342703300000,SE 224,RESIDENTIAL,35000,0,35000,88924,0,123924
142342703400000,SE 224,RESIDENTIAL,26000,0,26000,52328,0,78328
142342703500000,SE 224,RESIDENTIAL,26000,0,26000,65266,0,91266
142342703600000,SE 224,RESIDENTIAL,28050,0,28050,57969,0,86019
142342703700000,SE 224,RESIDENTIAL,29835,0,29835,99384,0,129219
142342703800000,SE 224,RESIDENTIAL,29835,0,29835,53991,0,83826
142342703900000,SE 224,RESIDENTIAL,21333,0,21333,88392,0,109725
142342704000000,SE 224,RESIDENTIAL,20000,0,20000,109322,0,129322
142342704100000,SE 224,RESIDENTIAL,32000,0,32000,82521,0,114521
142342704200000,SE 224,RESIDENTIAL,20000,0,20000,53833,0,73833
142342704300000,BRANCH BANK/CU,COMMERCIAL,0,50964,50964,0,352315,403279
142342704400000,SE 224,RESIDENTIAL,25000,0,25000,103977,0,128977
142342800100000,SE 224,RESIDENTIAL,33466,0,33466,44399,0,77865
142342800200000,SE 224,RESIDENTIAL,32000,0,32000,122900,0,154900
142342800300000,SE 224,RESIDENTIAL,20000,0,20000,44440,0,64440
142342800400000,SE 224,RESIDENTIAL,20000,0,20000,73464,0,93464
142342800500000,SE 224,RESIDENTIAL,20000,0,20000,44152,0,64152
142342800600000,SE 224,RESIDENTIAL,23167,0,23167,74566,0,97733
142342900100000,SE 224,RESIDENTIAL,21167,0,21167,73178,0,94345
142342900200000,SE 224,RESIDENTIAL,34069,0,34069,72896,0,106965
142342900300000,SE 224,RESIDENTIAL,28250,0,28250,82828,0,111078
142342900400000,SE 224,RESIDENTIAL,31075,0,31075,87927,0,119002
142342900500000,SE 224,RESIDENTIAL,28000,0,28000,57346,0,85346
142342900600000,SE 224,RESIDENTIAL,28000,0,28000,88264,0,116264
142342900700000,SE 224,RESIDENTIAL,40600,0,40600,134553,0,175153
142342900900000,SE 224,RESIDENTIAL,29000,0,29000,75710,0,104710
142342901000000,SE 224,RESIDENTIAL,29000,0,29000,105396,0,134396
142342901100000,SE 224,RESIDENTIAL,29000,0,29000,67847,0,96847
142342901200000,SE 224,RESIDENTIAL,33900,0,33900,66756,0,100656
142342901300000,SE 224,RESIDENTIAL,25000,0,25000,100000,0,125000
142342901400000,SE 224,RESIDENTIAL,25000,0,25000,90482,0,115482
142342901500000,SE 224,RESIDENTIAL,30000,0,30000,64797,0,94797
142342901600000,SE 224,RESIDENTIAL,30000,0,30000,72431,0,102431
142342901700000,SE 224,RESIDENTIAL,23750,0,23750,108391,0,132141
142342901800000,SE 224,RESIDENTIAL,21375,0,21375,131818,0,153193
142342901900000,SE 224,RESIDENTIAL,21375,0,21375,83317,0,104692
142342902000000,SE 224,RESIDENTIAL,37088,0,37088,97498,0,134586
142342902100000,SE 224,RESIDENTIAL,33744,0,33744,126634,0,160378
142342902200000,SE 224,RESIDENTIAL,34271,0,34271,119045,0,153316
142342902300000,SE 224,RESIDENTIAL,27750,0,27750,111895,0,139645
142342902400000,SE 224,RESIDENTIAL,30250,0,30250,133368,0,163618
142342902500000,SE 224,RESIDENTIAL,40438,0,40438,91061,0,131499
142342902600000,SE 224,RESIDENTIAL,24720,0,24720,119255,0,143975
142342902700000,SE 224,RESIDENTIAL,24720,0,24720,133451,0,158171
142342902800000,SE 224,RESIDENTIAL,24720,0,24720,127522,0,152242
142342902900000,SE 224,RESIDENTIAL,24651,0,24651,118544,0,143195
142342903000000,SE 224,RESIDENTIAL,23105,0,23105,153705,0,176810
142342903100000,SE 224,RESIDENTIAL,27300,0,27300,159007,0,186307
142342903200000,SE 224,RESIDENTIAL,29748,0,29748,153399,0,183147
142342903300000,SE 224,RESIDENTIAL,32408,0,32408,153521,0,185929
142342903400000,SE 224,RESIDENTIAL,23806,0,23806,150362,0,174168
142342903500000,SE 224,RESIDENTIAL,21120,0,21120,106035,0,127155
142342903600000,SE 224,RESIDENTIAL,21120,0,21120,98607,0,119727
142342903700000,SE 224,RESIDENTIAL,22016,0,22016,120934,0,142950
142342903800000,SE 224,RESIDENTIAL,24738,0,24738,112929,0,137667
142342903900000,SE 224,RESIDENTIAL,24010,0,24010,122424,0,146434
142342904000000,SE 224,RESIDENTIAL,20401,0,20401,108067,0,128468
142342904100000,SE 224,RESIDENTIAL,21056,0,21056,117380,0,138436
142342904200000,SE 224,RESIDENTIAL,21060,0,21060,123214,0,144274
142342904300000,SE 224,RESIDENTIAL,21060,0,21060,100915,0,121975
142342904400000,SE 224,RESIDENTIAL,22477,0,22477,143301,0,165778
142342904500000,SE 224,RESIDENTIAL,34247,0,34247,131289,0,165536
142342904600000,SE 224,RESIDENTIAL,26807,0,26807,79132,0,105939
142342904700000,SE 224,RESIDENTIAL,24960,0,24960,84953,0,109913
142342904800000,SE 224,RESIDENTIAL,25460,0,25460,85161,0,110621
142342904900000,SE 223,RESIDENTIAL,25970,0,25970,79513,0,105483
142342905000000,SE 223,RESIDENTIAL,28090,0,28090,80828,0,108918
142342905100000,SE 223,RESIDENTIAL,28090,0,28090,91626,0,119716
142342905200000,SE 223,RESIDENTIAL,28090,0,28090,88476,0,116566
142342905300000,SE 223,RESIDENTIAL,28090,0,28090,68649,0,96739
142342905400000,SE 223,RESIDENTIAL,28090,0,28090,67137,0,95227
142342905500000,SE 223,RESIDENTIAL,27825,0,27825,69762,0,97587
142342905600000,SE 223,RESIDENTIAL,27825,0,27825,85387,0,113212
142342905700000,SE 223,RESIDENTIAL,28665,0,28665,54455,0,83120
142342905800000,SE 223,RESIDENTIAL,29250,0,29250,77443,0,106693
142342905900000,SE 223,RESIDENTIAL,29250,0,29250,58546,0,87796
142342906000000,SE 223,RESIDENTIAL,24250,0,24250,85859,0,110109
142342906100000,SE 223,RESIDENTIAL,29250,0,29250,68127,0,97377
142342906200000,SE 223,RESIDENTIAL,26550,0,26550,80698,0,107248
142342906300000,SE 223,RESIDENTIAL,26550,0,26550,76457,0,103007
142342906400000,SE 223,RESIDENTIAL,25370,0,25370,70405,0,95775
142342906500000,SE 223,RESIDENTIAL,23010,0,23010,91620,0,114630
142342906600000,SE 224,RESIDENTIAL,23197,0,23197,96755,0,119952
142342906700000,SE 224,RESIDENTIAL,36000,0,36000,84686,0,120686
142342906800000,SE 224,RESIDENTIAL,20000,0,20000,61576,0,81576
142342906900000,SE 224,RESIDENTIAL,33150,0,33150,112800,0,145950
142342907000000,SE 224,RESIDENTIAL,21000,0,21000,89056,0,110056
142342907100000,SE 224,RESIDENTIAL,20000,0,20000,69779,0,89779
142342907200000,SE 224,RESIDENTIAL,20000,0,20000,57771,0,77771
142342907300000,SE 224,RESIDENTIAL,20000,0,20000,78051,0,98051
142342907400000,SE 224,RESIDENTIAL,21167,0,21167,80968,0,102135
142342907500000,SE 224,RESIDENTIAL,28186,0,28186,105662,0,133848
142342907600000,SE 224,RESIDENTIAL,28186,0,28186,100331,0,128517
142342907700000,SE 224,RESIDENTIAL,19780,0,19780,99049,0,118829
142342907800000,SE 224,RESIDENTIAL,23000,0,23000,126721,0,149721
142342907900000,SE 224,RESIDENTIAL,24800,0,24800,99099,0,123899
142342908000000,SR/NURSING/ASSTD LIV,COMMERCIAL,0,48800,48800,0,328674,377474
142342908100000,SE 224,RESIDENTIAL,21840,0,21840,66509,0,88349
142342908200000,SE 224,RESIDENTIAL,19200,0,19200,70474,0,89674
142342908300000,SE 224,RESIDENTIAL,19200,0,19200,76122,0,95322
142342908400000,SE 224,RESIDENTIAL,20894,0,20894,110212,0,131106
142342908500000,SE 224,RESIDENTIAL,20857,0,20857,106202,0,127059
142342908600000,SE 224,RESIDENTIAL,20857,0,20857,105817,0,126674
142342908700000,SE 224,RESIDENTIAL,23833,0,23833,65529,0,89362
142342908800000,SE 224,RESIDENTIAL,25000,0,25000,65402,0,90402
142342908900000,SE 224,RESIDENTIAL,30000,0,30000,90272,0,120272
142342909000000,SE 224,RESIDENTIAL,25000,0,25000,100348,0,125348
142342909100000,SE 224,RESIDENTIAL,32000,0,32000,86094,0,118094
142342909200000,SE 224,RESIDENTIAL,29000,0,29000,89000,0,118000
142343000100000,SE 224,RESIDENTIAL,21833,0,21833,66975,0,88808
142343000200000,SE 224,RESIDENTIAL,32000,0,32000,92917,0,124917
142343000300000,SE 224,RESIDENTIAL,20000,0,20000,63381,0,83381
142343000400000,SE 224,RESIDENTIAL,20000,0,20000,63453,0,83453
142343000500000,SE 224,RESIDENTIAL,20000,0,20000,76998,0,96998
142343000600000,SE 224,RESIDENTIAL,20000,0,20000,70141,0,90141
142343000700000,SE 224,RESIDENTIAL,20000,0,20000,74920,0,94920
142343000800000,SE 224,RESIDENTIAL,20000,0,20000,70535,0,90535
142343000900000,SE 224,RESIDENTIAL,32000,0,32000,81770,0,113770
142343001000000,SE 224,RESIDENTIAL,22403,0,22403,89190,0,111593
142345100100000,SE 223,RESIDENTIAL,23375,0,23375,0,0,23375
142345100200000,SE 223,RESIDENTIAL,34680,0,34680,112777,0,147457
142345100300000,SE 223,RESIDENTIAL,24072,0,24072,78539,0,102611
142345100400000,SE 223,RESIDENTIAL,24745,0,24745,77688,0,102433
142345100500000,SE 223,RESIDENTIAL,25250,0,25250,94179,0,119429
142345100600000,SE 223,RESIDENTIAL,26462,0,26462,79901,0,106363
142345100700000,SE 223,RESIDENTIAL,25385,0,25385,97142,0,122527
142345100800000,SE 223,RESIDENTIAL,23735,0,23735,75266,0,99001
142345100900000,SE 223,RESIDENTIAL,30300,0,30300,92026,0,122326
142345101000000,SE 223,RESIDENTIAL,30300,0,30300,67700,0,98000
142345101100000,SE 223,RESIDENTIAL,30855,0,30855,95962,0,126817
142345200100000,SE 223,RESIDENTIAL,22865,0,22865,111207,0,134072
142345200200000,SE 223,RESIDENTIAL,22185,0,22185,80516,0,102701
142345200300000,SE 223,RESIDENTIAL,23035,0,23035,67212,0,90247
142345200400000,SE 223,RESIDENTIAL,23338,0,23338,76802,0,100140
142345200500000,SE 223,RESIDENTIAL,22145,0,22145,77155,0,99300
142345200600000,SE 223,RESIDENTIAL,22660,0,22660,75884,0,98544
142345200700000,SE 223,RESIDENTIAL,22145,0,22145,60301,0,82446
142345200800000,SE 223,RESIDENTIAL,22660,0,22660,74414,0,97074
142345200900000,SE 223,RESIDENTIAL,28677,0,28677,87639,0,116316
142345201000000,SE 223,RESIDENTIAL,23347,0,23347,69348,0,92695
142345201100000,SE 223,RESIDENTIAL,22145,0,22145,83224,0,105369
142345201200000,SE 223,RESIDENTIAL,22660,0,22660,41249,0,63909
142345201300000,SE 223,RESIDENTIAL,29123,0,29123,79452,0,108575
142345201400000,SE 223,RESIDENTIAL,22145,0,22145,60600,0,82745
142345201500000,SE 223,RESIDENTIAL,21937,0,21937,40973,0,62910
142345201600000,SE 223,RESIDENTIAL,23685,0,23685,87228,0,110913
142345201700000,SE 223,RESIDENTIAL,30636,0,30636,99290,0,129926
142345300100000,SE 223,RESIDENTIAL,26500,0,26500,101410,0,127910
142345300200000,SE 223,RESIDENTIAL,31005,0,31005,91129,0,122134
142345300300000,SE 223,RESIDENTIAL,35535,0,35535,89596,0,125131
142345300400000,SE 223,RESIDENTIAL,25056,0,25056,83640,0,108696
142345300500000,SE 223,RESIDENTIAL,24784,0,24784,74749,0,99533
142345300600000,SE 223,RESIDENTIAL,24250,0,24250,78612,0,102862
142345300700000,SE 223,RESIDENTIAL,24250,0,24250,79535,0,103785
142345300800000,SE 223,RESIDENTIAL,24735,0,24735,62468,0,87203
142345300900000,SE 223,RESIDENTIAL,24250,0,24250,119088,0,143338
142345301000000,SE 223,RESIDENTIAL,24250,0,24250,85056,0,109306
142345301100000,SE 223,RESIDENTIAL,24250,0,24250,84095,0,108345
142345301200000,SE 223,RESIDENTIAL,24250,0,24250,73834,0,98084
142345301300000,SE 223,RESIDENTIAL,25000,0,25000,90360,0,115360
142345301400000,SE 223,RESIDENTIAL,24921,0,24921,99159,0,124080
142345301500000,SE 223,RESIDENTIAL,26070,0,26070,65505,0,91575
142345301600000,SE 223,RESIDENTIAL,25750,0,25750,82315,0,108065
142345301700000,SE 223,RESIDENTIAL,27300,0,27300,100335,0,127635
142345301800000,SE 223,RESIDENTIAL,27300,0,27300,75127,0,102427
142345301900000,SE 223,RESIDENTIAL,26250,0,26250,90540,0,116790
142345302000000,SE 223,RESIDENTIAL,26250,0,26250,92839,0,119089
142345302100000,SE 223,RESIDENTIAL,25257,0,25257,92609,0,117866
142345302200000,SE 223,RESIDENTIAL,26314,0,26314,76892,0,103206
142345302300000,SE 223,RESIDENTIAL,33000,0,33000,129253,0,162253
142345302400000,SE 223,RESIDENTIAL,28840,0,28840,125618,0,154458
142345302500000,SE 224,RESIDENTIAL,40930,0,40930,143331,0,184261
142345302600000,SE 224,RESIDENTIAL,35280,0,35280,80131,0,115411
142345302700000,SE 224,RESIDENTIAL,33129,0,33129,130694,0,163823
142345302800000,SE 224,RESIDENTIAL,36720,0,36720,82373,0,119093
142345302900000,SE 224,RESIDENTIAL,31620,0,31620,85604,0,117224
142345303000000,SE 224,RESIDENTIAL,30600,0,30600,74873,0,105473
142345303100000,SE 224,RESIDENTIAL,30600,0,30600,89159,0,119759
142345303200000,SE 224,RESIDENTIAL,31289,0,31289,78046,0,109335
142345303300000,SE 224,RESIDENTIAL,29610,0,29610,58888,0,88498
142345303400000,SE 224,RESIDENTIAL,28964,0,28964,57467,0,86431
142345303500000,SE 223,RESIDENTIAL,25500,0,25500,79328,0,104828
142345303600000,SE 223,RESIDENTIAL,25500,0,25500,78500,0,104000
142345303700000,SE 223,RESIDENTIAL,25500,0,25500,54798,0,80298
142345303800000,SE 223,RESIDENTIAL,25500,0,25500,87329,0,112829
142345303900000,SE 223,RESIDENTIAL,25500,0,25500,60187,0,85687
142345304000000,SE 223,RESIDENTIAL,25500,0,25500,85097,0,110597
142345304100000,SE 223,RESIDENTIAL,25419,0,25419,71383,0,96802
142345304200000,SE 223,RESIDENTIAL,25500,0,25500,64469,0,89969
142345304300000,SE 223,RESIDENTIAL,25500,0,25500,64821,0,90321
142345304400000,SE 223,RESIDENTIAL,25500,0,25500,91367,0,116867
142345304500000,SE 223,RESIDENTIAL,31319,0,31319,90960,0,122279
142345304600000,SE 223,RESIDENTIAL,20400,0,20400,71271,0,91671
142345304700000,SE 223,RESIDENTIAL,20400,0,20400,81502,0,101902
142345304800000,SE 223,RESIDENTIAL,30600,0,30600,92672,0,123272
142345304900000,SE 223,RESIDENTIAL,30600,0,30600,55795,0,86395
142345305000000,SE 223,RESIDENTIAL,20400,0,20400,75602,0,96002
142345305100000,SE 223,RESIDENTIAL,30600,0,30600,66853,0,97453
142345305200000,SE 223,RESIDENTIAL,32130,0,32130,79934,0,112064
142345305300000,SE 223,RESIDENTIAL,25500,0,25500,64902,0,90402
142345400100000,SE 223,RESIDENTIAL,24964,0,24964,42145,0,67109
142345400200000,SE 223,RESIDENTIAL,23287,0,23287,94585,0,117872
142345400300000,SE 223,RESIDENTIAL,22145,0,22145,70099,0,92244
142345400400000,SE 223,RESIDENTIAL,22660,0,22660,73727,0,96387
142345400500000,SE 223,RESIDENTIAL,22145,0,22145,73855,0,96000
142345400600000,SE 223,RESIDENTIAL,22660,0,22660,54058,0,76718
142345400700000,SE 223,RESIDENTIAL,22145,0,22145,57324,0,79469
142345400800000,SE 223,RESIDENTIAL,21973,0,21973,84564,0,106537
142345400900000,SE 223,RESIDENTIAL,23347,0,23347,84755,0,108102
142345401000000,SE 223,RESIDENTIAL,22145,0,22145,77205,0,99350
142345401100000,SE 223,RESIDENTIAL,23896,0,23896,78284,0,102180
142345401200000,SE 223,RESIDENTIAL,23896,0,23896,89126,0,113022
142345401300000,SE 223,RESIDENTIAL,23896,0,23896,81797,0,105693
142345401400000,SE 223,RESIDENTIAL,21879,0,21879,67841,0,89720
142345401500000,SE 223,RESIDENTIAL,23685,0,23685,65156,0,88841
142345401600000,SE 223,RESIDENTIAL,22725,0,22725,73291,0,96016
142345401700000,SE 223,RESIDENTIAL,22725,0,22725,65594,0,88319
142345401800000,SE 223,RESIDENTIAL,22725,0,22725,76012,0,98737
142345401900000,SE 223,RESIDENTIAL,22725,0,22725,59011,0,81736
142345500100000,SE 223,RESIDENTIAL,27089,0,27089,57441,0,84530
142345500200000,SE 223,RESIDENTIAL,28265,0,28265,89994,0,118259
142345500300000,SE 223,RESIDENTIAL,24745,0,24745,55716,0,80461
142345500400000,SE 223,RESIDENTIAL,24745,0,24745,60223,0,84968
142345500500000,SE 223,RESIDENTIAL,24745,0,24745,54737,0,79482
142345500600000,SE 223,RESIDENTIAL,24745,0,24745,97897,0,122642
142345500700000,SE 223,RESIDENTIAL,24745,0,24745,67137,0,91882
142345500800000,SE 223,RESIDENTIAL,24745,0,24745,68481,0,93226
142345500900000,SE 223,RESIDENTIAL,24745,0,24745,70325,0,95070
142345501000000,SE 223,RESIDENTIAL,24745,0,24745,70298,0,95043
142345501100000,OFFICE,COMMERCIAL,0,45350,45350,0,65209,110559
142345501200000,RESTAURANT,COMMERCIAL,0,37853,37853,0,58827,96680
142345600100000,SE 223,RESIDENTIAL,29286,0,29286,132113,0,161399
142345600200000,SE 223,RESIDENTIAL,26849,0,26849,75855,0,102704
142345600600000,CHURCH,EXEMPT,0,25500,25500,0,0,25500
142345600700000,SE 223,RESIDENTIAL,25500,0,25500,80248,0,105748
142345600800000,SE 223,RESIDENTIAL,27030,0,27030,93782,0,120812
142345600900000,SE 223,RESIDENTIAL,23970,0,23970,71194,0,95164
142345601000000,SE 223,RESIDENTIAL,27030,0,27030,72014,0,99044
142345601100000,SE 224,RESIDENTIAL,29440,0,29440,80839,0,110279
142345601200000,SE 224,RESIDENTIAL,27600,0,27600,105982,0,133582
142345601300000,SE 224,RESIDENTIAL,30000,0,30000,42359,0,72359
142345601400000,SE 224,RESIDENTIAL,30000,0,30000,0,0,30000
142345601700000,SMALL RETAIL,COMMERCIAL,0,184000,184000,0,340160,524160
142345601800000,CHURCH,EXEMPT,0,12015,12015,0,0,12015
142345601900000,CHURCH,EXEMPT,0,13203,13203,0,0,13203
142345602000000,SMALL RETAIL,COMMERCIAL,0,54210,54210,0,25297,79507
142345602002000,ANTENNAS/TOWERS(BLL),COMMERCIAL,0,0,0,0,110662,110662
142345602100000,SMALL RETAIL,COMMERCIAL,0,113466,113466,0,171735,285201
142345602300000,SE 223,RESIDENTIAL,24745,0,24745,59629,0,84374
142345602400000,SE 223,RESIDENTIAL,24745,0,24745,87174,0,111919
142345602500000,SE 223,RESIDENTIAL,24745,0,24745,54398,0,79143
142345602600000,SE 223,RESIDENTIAL,24745,0,24745,77716,0,102461
142345602700000,SE 223,RESIDENTIAL,24745,0,24745,74375,0,99120
142345602800000,SE 223,RESIDENTIAL,24745,0,24745,61864,0,86609
142345602900000,SE 223,RESIDENTIAL,24745,0,24745,57925,0,82670
142345603000000,VACANT LAND,COMMERCIAL,0,63093,63093,0,0,63093
142345603100000,CHURCH,EXEMPT,0,669870,669870,0,6485170,7155040
142347600100000,SE 225,RESIDENTIAL,32550,0,32550,66028,0,98578
142347600200000,SE 225,RESIDENTIAL,30000,0,30000,71464,0,101464
142347600300000,SE 225,RESIDENTIAL,22700,0,22700,63580,0,86280
142347600400000,SE 225,RESIDENTIAL,33750,0,33750,76940,0,110690
142347700100000,SE 225,RESIDENTIAL,24583,0,24583,85337,0,109920
142347700200000,SE 225,RESIDENTIAL,25417,0,25417,66948,0,92365
142347700300000,SE 225,RESIDENTIAL,25000,0,25000,93916,0,118916
142347700400000,SE 225,RESIDENTIAL,25000,0,25000,73802,0,98802
142347700500000,SE 225,RESIDENTIAL,25000,0,25000,75558,0,100558
142347700600000,SE 225,RESIDENTIAL,25000,0,25000,76081,0,101081
142347700700000,SE 225,RESIDENTIAL,25000,0,25000,66198,0,91198
142347700800000,SE 225,RESIDENTIAL,25000,0,25000,71672,0,96672
142347700900000,SE 225,RESIDENTIAL,24500,0,24500,79807,0,104307
142347800100000,SE 225,RESIDENTIAL,29538,0,29538,90956,0,120494
142347800300000,CHURCH,EXEMPT,0,68291,68291,0,1248185,1316476
142347800400000,SE 223,RESIDENTIAL,27270,0,27270,91192,0,118462
142347800500000,SE 223,RESIDENTIAL,27270,0,27270,86951,0,114221
142347800600000,SE 223,RESIDENTIAL,27270,0,27270,83189,0,110459
142347800700000,SE 223,RESIDENTIAL,27270,0,27270,120309,0,147579
142347800800000,SE 223,RESIDENTIAL,27270,0,27270,67742,0,95012
142347800900000,SE 223,RESIDENTIAL,30991,0,30991,85173,0,116164
142347801000000,SE 223,RESIDENTIAL,29814,0,29814,73284,0,103098
142347801100000,SE 225,RESIDENTIAL,30559,0,30559,89255,0,119814
142347801200000,SE 225,RESIDENTIAL,25000,0,25000,76773,0,101773
142347801300000,SE 225,RESIDENTIAL,25000,0,25000,79141,0,104141
142347801400000,SE 225,RESIDENTIAL,25000,0,25000,84666,0,109666
142347801500000,SE 225,RESIDENTIAL,25000,0,25000,73726,0,98726
142347801600000,SE 225,RESIDENTIAL,25000,0,25000,87993,0,112993
142347801700000,SE 225,RESIDENTIAL,25000,0,25000,67360,0,92360
142347801800000,SE 225,RESIDENTIAL,25000,0,25000,69618,0,94618
142347802000000,SE 225,EXEMPT,0,25000,25000,1140,66789,92929
142347900100000,SE 223,RESIDENTIAL,30991,0,30991,102639,0,133630
142347900200000,SE 223,RESIDENTIAL,29500,0,29500,81612,0,111112
142347900300000,SE 223,RESIDENTIAL,33936,0,33936,101128,0,135064
142347900400000,SE 223,RESIDENTIAL,30300,0,30300,74909,0,105209
142347900500000,SE 223,RESIDENTIAL,30300,0,30300,66103,0,96403
142347900600000,SE 223,RESIDENTIAL,30300,0,30300,84829,0,115129
142347900700000,SE 223,RESIDENTIAL,30300,0,30300,106152,0,136452
142347900800000,SE 223,RESIDENTIAL,30300,0,30300,80767,0,111067
142347900900000,SE 223,RESIDENTIAL,30117,0,30117,61245,0,91362
142347901000000,SE 223,RESIDENTIAL,29808,0,29808,85555,0,115363
142348000100000,SE 223,RESIDENTIAL,23760,0,23760,65117,0,88877
142348000200000,SE 225,RESIDENTIAL,22968,0,22968,74721,0,97689
142348000300000,SE 225,RESIDENTIAL,22968,0,22968,44757,0,67725
142348000400000,SE 225,RESIDENTIAL,22968,0,22968,54985,0,77953
142348000500000,SE 225,RESIDENTIAL,22968,0,22968,61743,0,84711
142348000600000,SE 225,RESIDENTIAL,22968,0,22968,52390,0,75358
142348000700000,SE 225,RESIDENTIAL,22968,0,22968,68376,0,91344
142348000800000,SE 225,RESIDENTIAL,22968,0,22968,91177,0,114145
142348001000000,SE 225,RESIDENTIAL,41343,0,41343,82408,0,123751
142348001200000,SE 225,RESIDENTIAL,22968,0,22968,87511,0,110479
142348001300000,SE 225,RESIDENTIAL,22968,0,22968,70062,0,93030
142348001400000,SE 223,RESIDENTIAL,23760,0,23760,72449,0,96209
142348001500000,SE 223,RESIDENTIAL,22968,0,22968,62620,0,85588
142348001600000,SE 223,RESIDENTIAL,23760,0,23760,67469,0,91229
142348001700000,SE 223,RESIDENTIAL,23760,0,23760,75103,0,98863
142348001800000,SE 223,RESIDENTIAL,22968,0,22968,84876,0,107844
142348001900000,SE 223,RESIDENTIAL,22968,0,22968,53068,0,76036
142348002000000,SE 223,RESIDENTIAL,22968,0,22968,71801,0,94769
142348002100000,SE 223,RESIDENTIAL,22968,0,22968,69931,0,92899
142348100100000,SE 225,RESIDENTIAL,25000,0,25000,69937,0,94937
142348100200000,SE 225,RESIDENTIAL,25000,0,25000,34823,0,59823
142348100300000,SE 225,RESIDENTIAL,25000,0,25000,68572,0,93572
142348100400000,SE 225,RESIDENTIAL,25000,0,25000,79487,0,104487
142348100500000,SE 225,RESIDENTIAL,25000,0,25000,76630,0,101630
142348100600000,SE 225,RESIDENTIAL,25000,0,25000,80717,0,105717
142348100700000,SE 225,RESIDENTIAL,25000,0,25000,117785,0,142785
142348100800000,SE 225,RESIDENTIAL,25000,0,25000,69791,0,94791
142348100900000,SE 225,RESIDENTIAL,25000,0,25000,74891,0,99891
142348101000000,SE 225,RESIDENTIAL,25000,0,25000,116012,0,141012
142348101100000,SE 225,RESIDENTIAL,25000,0,25000,86801,0,111801
142348101200000,SE 225,RESIDENTIAL,25000,0,25000,68449,0,93449
142348101300000,SE 225,RESIDENTIAL,25000,0,25000,73782,0,98782
142348101400000,SE 225,RESIDENTIAL,25000,0,25000,79018,0,104018
142348101500000,SE 225,RESIDENTIAL,25000,0,25000,56657,0,81657
142348101600000,SE 225,RESIDENTIAL,25000,0,25000,64784,0,89784
142348101700000,SE 225,RESIDENTIAL,25000,0,25000,77136,0,102136
142348101800000,SE 225,RESIDENTIAL,25000,0,25000,89692,0,114692
142348200100000,SE 225,RESIDENTIAL,25000,0,25000,89069,0,114069
142348200200000,SE 225,RESIDENTIAL,25000,0,25000,93398,0,118398
142348200300000,SE 225,RESIDENTIAL,25000,0,25000,84970,0,109970
142348200400000,SE 225,RESIDENTIAL,25000,0,25000,67323,0,92323
142348200500000,SE 225,RESIDENTIAL,25000,0,25000,72761,0,97761
142348200600000,SE 225,RESIDENTIAL,25000,0,25000,57734,0,82734
142348200700000,SE 225,RESIDENTIAL,25000,0,25000,85077,0,110077
142348200800000,SE 225,RESIDENTIAL,25000,0,25000,52317,0,77317
142348200900000,SE 225,RESIDENTIAL,25000,0,25000,90471,0,115471
142348201000000,SE 225,RESIDENTIAL,25000,0,25000,97369,0,122369
142348201100000,SE 225,RESIDENTIAL,25000,0,25000,95091,0,120091
142348201200000,SE 225,RESIDENTIAL,35000,0,35000,85523,0,120523
142348201300000,SE 225,RESIDENTIAL,25000,0,25000,74710,0,99710
142348201400000,SE 225,RESIDENTIAL,25000,0,25000,60263,0,85263
142348201500000,SE 225,RESIDENTIAL,25000,0,25000,53547,0,78547
142348201600000,SE 225,RESIDENTIAL,35000,0,35000,141694,0,176694
142348300100000,SE 223,RESIDENTIAL,24840,0,24840,91738,0,116578
142348300200000,SE 225,RESIDENTIAL,23400,0,23400,77582,0,100982
142348300300000,SE 225,RESIDENTIAL,23400,0,23400,81760,0,105160
142348300400000,SE 225,RESIDENTIAL,23400,0,23400,88966,0,112366
142348300500000,SE 225,RESIDENTIAL,23400,0,23400,78766,0,102166
142348300600000,SE 225,RESIDENTIAL,23400,0,23400,86276,0,109676
142348300700000,SE 225,RESIDENTIAL,23400,0,23400,93163,0,116563
142348300800000,SE 225,RESIDENTIAL,23400,0,23400,66437,0,89837
142348300900000,SE 225,RESIDENTIAL,23400,0,23400,53428,0,76828
142348301000000,SE 225,RESIDENTIAL,23400,0,23400,55544,0,78944
142348301100000,CARWASH,COMMERCIAL,0,94238,94238,0,106178,200416
142348301200000,BRANCH BANK/CU,COMMERCIAL,0,351000,351000,0,817914,1168914
142348301500000,SE 223,RESIDENTIAL,24840,0,24840,91957,0,116797
142348400100000,SE 225,RESIDENTIAL,25000,0,25000,60388,0,85388
142348400400000,SE 225,RESIDENTIAL,25000,0,25000,78982,0,103982
142348400500000,SE 225,RESIDENTIAL,25000,0,25000,81060,0,106060
142348400600000,SE 225,RESIDENTIAL,25000,0,25000,107140,0,132140
142348400700000,SE 225,RESIDENTIAL,25000,0,25000,81526,0,106526
142348400800000,SE 225,RESIDENTIAL,25000,0,25000,83557,0,108557
142348400900000,SE 225,RESIDENTIAL,25000,0,25000,81275,0,106275
142348401000000,SE 225,RESIDENTIAL,25000,0,25000,85684,0,110684
142348401100000,SE 225,RESIDENTIAL,25000,0,25000,96593,0,121593
142348401200000,SE 225,RESIDENTIAL,25000,0,25000,79021,0,104021
142348401300000,SE 225,RESIDENTIAL,25000,0,25000,63234,0,88234
142348401400000,SE 225,RESIDENTIAL,25000,0,25000,65393,0,90393
142348401500000,SE 225,RESIDENTIAL,25000,0,25000,68511,0,93511
142348401600000,SE 225,RESIDENTIAL,25000,0,25000,96247,0,121247
142348401700000,SE 225,RESIDENTIAL,25000,0,25000,65877,0,90877
142348401800000,SE 225,RESIDENTIAL,24723,0,24723,59472,0,84195
142348402000000,SE 225,RESIDENTIAL,35000,0,35000,91064,0,126064
142348500100000,SE 225,RESIDENTIAL,33345,0,33345,81671,0,115016
142348500200000,SE 223,RESIDENTIAL,26320,0,26320,63014,0,89334
142348500300000,SE 223,RESIDENTIAL,26618,0,26618,60453,0,87071
142348500400000,SE 223,RESIDENTIAL,26010,0,26010,41615,0,67625
142348500500000,SE 223,RESIDENTIAL,26010,0,26010,38714,0,64724
142348500600000,SE 223,RESIDENTIAL,26010,0,26010,82551,0,108561
142348500700000,SE 223,RESIDENTIAL,26285,0,26285,45140,0,71425
142348500800000,SE 223,RESIDENTIAL,25500,0,25500,40790,0,66290
142348500900000,SE 223,RESIDENTIAL,25500,0,25500,54102,0,79602
142348501000000,LAUNDROMAT/CLEANERS,COMMERCIAL,0,58422,58422,0,117566,175988
142348501200000,SE 225,RESIDENTIAL,25000,0,25000,79678,0,104678
142348501300000,SE 225,RESIDENTIAL,25000,0,25000,87385,0,112385
142348501400000,SE 225,RESIDENTIAL,25000,0,25000,59404,0,84404
142348501500000,SE 225,RESIDENTIAL,25000,0,25000,54607,0,79607
142348501600000,SE 225,RESIDENTIAL,25000,0,25000,59900,0,84900
142348501700000,SE 225,RESIDENTIAL,25000,0,25000,88655,0,113655
142348501800000,SE 225,RESIDENTIAL,25000,0,25000,60591,0,85591
142348501900000,SMALL RETAIL,COMMERCIAL,0,141132,141132,0,510865,651997
142348600100000,SE 223,RESIDENTIAL,28684,0,28684,104794,0,133478
142348600200000,SE 223,RESIDENTIAL,28350,0,28350,54932,0,83282
142348600300000,SE 223,RESIDENTIAL,26520,0,26520,84919,0,111439
142348600400000,SE 223,RESIDENTIAL,26129,0,26129,60048,0,86177
142348600500000,SE 223,RESIDENTIAL,30600,0,30600,58938,0,89538
142348600600000,SE 223,RESIDENTIAL,30600,0,30600,68295,0,98895
142348600700000,FAST FOOD,COMMERCIAL,0,223250,223250,0,673378,896628
142348700100000,SE 225,RESIDENTIAL,25000,0,25000,103085,0,128085
142348700200000,SE 225,RESIDENTIAL,25000,0,25000,89033,0,114033
142348700300000,SE 225,RESIDENTIAL,25000,0,25000,85317,0,110317
142348700400000,SE 225,RESIDENTIAL,25000,0,25000,65510,0,90510
142348700500000,SE 225,RESIDENTIAL,25000,0,25000,83954,0,108954
142348700600000,SE 225,RESIDENTIAL,25000,0,25000,69622,0,94622
142348700700000,SE 225,RESIDENTIAL,25000,0,25000,77009,0,102009
142348700800000,SE 225,RESIDENTIAL,30000,0,30000,75021,0,105021
142348700900000,SE 225,RESIDENTIAL,16920,0,16920,69473,0,86393
142348701000000,SE 225,RESIDENTIAL,14430,0,14430,4662,0,19092
142348701100000,SE 225,RESIDENTIAL,17150,0,17150,42888,0,60038
142348701200000,SE 225,RESIDENTIAL,17150,0,17150,37316,0,54466
142348701300000,SE 225,RESIDENTIAL,17150,0,17150,59922,0,77072
142348701400000,SE 225,RESIDENTIAL,17150,0,17150,59069,0,76219
142348701500000,FAST FOOD,COMMERCIAL,0,101700,101700,0,249670,351370
142410200100000,SE 209,RESIDENTIAL,53602,0,53602,151522,0,205124
142410200200000,SE 209,RESIDENTIAL,51263,0,51263,165054,0,216317
142410200300000,SE 209,RESIDENTIAL,52393,0,52393,196230,0,248623
142410300100000,CITY PROPERTY,EXEMPT,0,0,0,0,0,0
142412600100000,CITY PROPERTY,EXEMPT,0,0,0,0,0,0
142412600200000,SE 221,RESIDENTIAL,319700,0,319700,1228631,0,1548331
142412600500000,SE 221,RESIDENTIAL,110001,0,110001,188473,0,298474
142412700100000,SE 245,RESIDENTIAL,91624,0,91624,323387,0,415011
142412700200000,SE 245,RESIDENTIAL,100000,0,100000,327599,0,427599
142412700300000,SE 245,RESIDENTIAL,93767,0,93767,249281,0,343048
142415100100000,CHURCH,EXEMPT,0,301752,301752,0,1050436,1352188
142415100200000,SE 245,RESIDENTIAL,67305,0,67305,442599,0,509904
142415100300000,SE 245,RESIDENTIAL,64200,0,64200,340275,0,404475
142415100400000,SE 245,RESIDENTIAL,58752,0,58752,243198,0,301950
142415100500000,SE 245,RESIDENTIAL,61904,0,61904,314219,0,376123
142415100600000,SE 245,RESIDENTIAL,71734,0,71734,437691,0,509425
142415100700000,SE 245,RESIDENTIAL,81127,0,81127,439169,0,520296
142415100800000,SE 245,RESIDENTIAL,71168,0,71168,364696,0,435864
142415100900000,SE 245,RESIDENTIAL,75816,0,75816,359022,0,434838
142415101000000,SE 245,RESIDENTIAL,73776,0,73776,301842,0,375618
142415101100000,SE 245,RESIDENTIAL,77367,0,77367,318847,0,396214
142415101200000,SE 245,RESIDENTIAL,80922,0,80922,262415,0,343337
142415101300000,SE 245,RESIDENTIAL,74943,0,74943,326043,0,400986
142415101400000,SE 245,RESIDENTIAL,79860,0,79860,320001,0,399861
142415101500000,SE 245,RESIDENTIAL,83405,0,83405,277215,0,360620
142415101600000,SE 245,RESIDENTIAL,75504,0,75504,268513,0,344017
142415101700000,SE 245,RESIDENTIAL,73726,0,73726,264860,0,338586
142415101800000,SE 245,RESIDENTIAL,83941,0,83941,315721,0,399662
142415101900000,SE 245,RESIDENTIAL,87621,0,87621,340509,0,428130
142415200100000,SE 220,RESIDENTIAL,37440,0,37440,135804,0,173244
142415200200000,SE 220,RESIDENTIAL,38848,0,38848,133968,0,172816
142415200400000,SE 221,RESIDENTIAL,32000,0,32000,132539,0,164539
142415200500000,SE 221,RESIDENTIAL,31680,0,31680,119241,0,150921
142415200600000,SE 221,RESIDENTIAL,31680,0,31680,120530,0,152210
142415200700000,SE 221,RESIDENTIAL,32194,0,32194,130081,0,162275
142415300100000,SE 221,RESIDENTIAL,32000,0,32000,132900,0,164900
142415300200000,SE 221,RESIDENTIAL,32000,0,32000,136280,0,168280
142415300300000,SE 221,RESIDENTIAL,31999,0,31999,165263,0,197262
142415301900000,SE 221,RESIDENTIAL,35017,0,35017,122315,0,157332
142415302000000,SE 221,RESIDENTIAL,35378,0,35378,133238,0,168616
142415302100000,SE 221,RESIDENTIAL,35569,0,35569,114426,0,149995
142415302200000,SE 221,RESIDENTIAL,37482,0,37482,191954,0,229436
142415302300000,SE 221,RESIDENTIAL,39047,0,39047,145272,0,184319
142415302400000,SE 221,RESIDENTIAL,34497,0,34497,144547,0,179044
142415302500000,SE 221,RESIDENTIAL,31680,0,31680,159154,0,190834
142415302600000,SE 221,RESIDENTIAL,31680,0,31680,129522,0,161202
142415400100000,SE 221,RESIDENTIAL,31680,0,31680,169584,0,201264
142415400200000,SE 221,RESIDENTIAL,31680,0,31680,108914,0,140594
142415400300000,SE 221,RESIDENTIAL,31680,0,31680,121066,0,152746
142415400400000,SE 221,RESIDENTIAL,31679,0,31679,123817,0,155496
142415400500000,SE 221,RESIDENTIAL,31680,0,31680,128050,0,159730
142415400600000,SE 221,RESIDENTIAL,30790,0,30790,132702,0,163492
142415400700000,SE 221,RESIDENTIAL,37647,0,37647,126417,0,164064
142415400800000,SE 221,RESIDENTIAL,33815,0,33815,138925,0,172740
142415400900000,SE 221,RESIDENTIAL,32640,0,32640,112155,0,144795
142415401000000,SE 221,RESIDENTIAL,35672,0,35672,90266,0,125938
142415401100000,SE 221,RESIDENTIAL,37737,0,37737,140736,0,178473
142415401200000,SE 221,RESIDENTIAL,36267,0,36267,117926,0,154193
142415401300000,SE 221,RESIDENTIAL,32592,0,32592,155916,0,188508
142415401400000,SE 221,RESIDENTIAL,32592,0,32592,130671,0,163263
142415401500000,SE 221,RESIDENTIAL,32592,0,32592,132729,0,165321
142415401600000,SE 221,RESIDENTIAL,32593,0,32593,123423,0,156016
142415401700000,SE 221,RESIDENTIAL,38016,0,38016,184433,0,222449
142415401800000,SE 221,RESIDENTIAL,39110,0,39110,126013,0,165123
142415402600000,SE 221,RESIDENTIAL,31679,0,31679,147516,0,179195
142415402700000,SE 221,RESIDENTIAL,31368,0,31368,157510,0,188878
142415402800000,SE 221,RESIDENTIAL,36018,0,36018,140722,0,176740
142415402900000,SE 221,RESIDENTIAL,34910,0,34910,133218,0,168128
142415403000000,SE 221,RESIDENTIAL,31680,0,31680,139953,0,171633
142415403100000,SE 221,RESIDENTIAL,31680,0,31680,135422,0,167102
142415403200000,SE 221,RESIDENTIAL,31680,0,31680,134948,0,166628
142415403300000,SE 221,RESIDENTIAL,31681,0,31681,114370,0,146051
142415403400000,SE 221,RESIDENTIAL,31680,0,31680,135919,0,167599
142415500100000,SE 221,RESIDENTIAL,37153,0,37153,126313,0,163466
142415500200000,SE 221,RESIDENTIAL,35600,0,35600,133275,0,168875
142415500300000,SE 221,RESIDENTIAL,33320,0,33320,130338,0,163658
142415500400000,SE 221,RESIDENTIAL,34580,0,34580,126772,0,161352
142415500500000,SE 221,RESIDENTIAL,36972,0,36972,127446,0,164418
142415500600000,SE 221,RESIDENTIAL,36704,0,36704,157096,0,193800
142415500700000,SE 221,RESIDENTIAL,34579,0,34579,168892,0,203471
142415500800000,SE 221,RESIDENTIAL,33320,0,33320,118633,0,151953
142415600100000,SE 221,RESIDENTIAL,32592,0,32592,156996,0,189588
142415600200000,SE 221,RESIDENTIAL,32592,0,32592,129550,0,162142
142415600300000,SE 221,RESIDENTIAL,32592,0,32592,152106,0,184698
142415600400000,SE 221,RESIDENTIAL,32592,0,32592,134636,0,167228
142415600500000,SE 221,RESIDENTIAL,34144,0,34144,130487,0,164631
142415600600000,SE 221,RESIDENTIAL,32592,0,32592,151153,0,183745
142415600700000,SE 221,RESIDENTIAL,32592,0,32592,149946,0,182538
142415600800000,SE 221,RESIDENTIAL,33244,0,33244,128753,0,161997
142417600100000,SE 219,RESIDENTIAL,105020,0,105020,721119,0,826139
142417600200000,SE 219,RESIDENTIAL,103620,0,103620,0,0,103620
142417600400000,SE 219,RESIDENTIAL,57000,0,57000,704,0,57704
142417600500000,SE 219,RESIDENTIAL,64816,0,64816,322159,0,386975
142417600600000,SE 219,RESIDENTIAL,64662,0,64662,252997,0,317659
142417600700000,SE 219,RESIDENTIAL,79726,0,79726,310455,0,390181
142417600800000,SE 219,RESIDENTIAL,66569,0,66569,373048,0,439617
142417600900000,SE 219,RESIDENTIAL,68462,0,68462,354593,0,423055
142417601000000,SE 219,RESIDENTIAL,59684,0,59684,0,0,59684
142417601100000,SE 219,RESIDENTIAL,75420,0,75420,376292,0,451712
142417601200000,SE 219,RESIDENTIAL,53774,0,53774,288124,0,341898
142417601300000,SE 219,RESIDENTIAL,76500,0,76500,278188,0,354688
142417601400000,SE 219,RESIDENTIAL,55930,0,55930,314390,0,370320
142417601500000,SE 219,RESIDENTIAL,109220,0,109220,406450,0,515670
142417601600000,CENTRALLY ASSESSED,OTHER,0,0,0,0,0,0
142417700100000,SE 220,RESIDENTIAL,36117,0,36117,128432,0,164549
142417700200000,SE 220,RESIDENTIAL,36492,0,36492,125079,0,161571
142417700300000,SE 220,RESIDENTIAL,42330,0,42330,195288,0,237618
142417700400000,SE 220,RESIDENTIAL,35948,0,35948,146387,0,182335
142417700500000,SE 220,RESIDENTIAL,34744,0,34744,147458,0,182202
142417800100000,SE 220,RESIDENTIAL,39206,0,39206,170719,0,209925
142417800200000,SE 220,RESIDENTIAL,42714,0,42714,151655,0,194369
142417800300000,SE 220,RESIDENTIAL,42039,0,42039,146215,0,188254
142417800400000,SE 220,RESIDENTIAL,41600,0,41600,187161,0,228761
142417800500000,SE 220,RESIDENTIAL,36960,0,36960,201466,0,238426
142417800600000,SE 220,RESIDENTIAL,34513,0,34513,163448,0,197961
142417800700000,SE 220,RESIDENTIAL,34200,0,34200,163109,0,197309
142417800800000,SE 220,RESIDENTIAL,46147,0,46147,212027,0,258174
142417900100000,SE 220,RESIDENTIAL,42776,0,42776,144117,0,186893
142417900200000,SE 220,RESIDENTIAL,51979,0,51979,171672,0,223651
142417900300000,SE 220,RESIDENTIAL,38548,0,38548,237981,0,276529
142417900400000,SE 220,RESIDENTIAL,39661,0,39661,110810,0,150471
142417900500000,SE 220,RESIDENTIAL,38280,0,38280,129449,0,167729
142417900600000,SE 220,RESIDENTIAL,42016,0,42016,120168,0,162184
142417900700000,SE 220,RESIDENTIAL,35067,0,35067,102645,0,137712
142417900800000,SE 220,RESIDENTIAL,33560,0,33560,129310,0,162870
142417900900000,SE 220,RESIDENTIAL,44336,0,44336,118088,0,162424
142417901000000,SE 220,RESIDENTIAL,44708,0,44708,211665,0,256373
142417901100000,SE 220,RESIDENTIAL,43003,0,43003,141090,0,184093
142417901200000,SE 220,RESIDENTIAL,39240,0,39240,149856,0,189096
142417901300000,SE 220,RESIDENTIAL,41283,0,41283,118962,0,160245
142417901400000,SE 220,RESIDENTIAL,38178,0,38178,174373,0,212551
142417901500000,SE 220,RESIDENTIAL,37353,0,37353,129578,0,166931
142417901600000,SE 220,RESIDENTIAL,36040,0,36040,230877,0,266917
142417901700000,SE 220,RESIDENTIAL,36000,0,36000,167698,0,203698
142417901800000,SE 220,RESIDENTIAL,36000,0,36000,120307,0,156307
142417901900000,SE 220,RESIDENTIAL,33067,0,33067,148376,0,181443
142417902000000,SE 220,RESIDENTIAL,35687,0,35687,164680,0,200367
142417902100000,SE 220,RESIDENTIAL,36393,0,36393,116865,0,153258
142417902200000,SE 220,RESIDENTIAL,36720,0,36720,126578,0,163298
142417902300000,SE 220,RESIDENTIAL,39520,0,39520,152289,0,191809
142418000100000,SE 220,RESIDENTIAL,20,0,20,0,0,20
142420100100000,SE 210,RESIDENTIAL,33840,0,33840,175218,0,209058
142420100200000,SE 210,RESIDENTIAL,33840,0,33840,177006,0,210846
142420100300000,SE 210,RESIDENTIAL,28200,0,28200,169064,0,197264
142420100400000,SE 210,RESIDENTIAL,27900,0,27900,190045,0,217945
142420100500000,SE 210,RESIDENTIAL,45685,0,45685,184315,0,230000
142420100600000,SE 210,RESIDENTIAL,43537,0,43537,186463,0,230000
142420100700000,SE 210,RESIDENTIAL,42584,0,42584,173084,0,215668
142420100800000,SE 210,RESIDENTIAL,36664,0,36664,242382,0,279046
142420100900000,SE 210,RESIDENTIAL,36720,0,36720,200999,0,237719
142420101000000,SE 210,RESIDENTIAL,36720,0,36720,186773,0,223493
142420101100000,SE 210,RESIDENTIAL,36290,0,36290,202941,0,239231
142420101200000,CENTRALLY ASSESSED,OTHER,0,0,0,0,0,0
142420101300000,SE 210,RESIDENTIAL,61244,0,61244,230882,0,292126
142420101400000,SE 210,RESIDENTIAL,44000,0,44000,265744,0,309744
142420101500000,SE 210,RESIDENTIAL,36800,0,36800,246119,0,282919
142420101600000,SE 210,RESIDENTIAL,37200,0,37200,230140,0,267340
142420101700000,SE 210,RESIDENTIAL,37600,0,37600,249796,0,287396
142420101800000,SE 210,RESIDENTIAL,43062,0,43062,169955,0,213017
142420101900000,SE 210,RESIDENTIAL,42749,0,42749,245651,0,288400
142420102000000,SE 210,RESIDENTIAL,49099,0,49099,229044,0,278143
142420102100000,SE 210,RESIDENTIAL,45288,0,45288,269515,0,314803
142420102200000,SE 210,RESIDENTIAL,51760,0,51760,305580,0,357340
142420200100000,SE 210,RESIDENTIAL,41072,0,41072,278049,0,319121
142420300100000,SE 210,RESIDENTIAL,36720,0,36720,195280,0,232000
142420400100000,SE 210,RESIDENTIAL,40320,0,40320,170102,0,210422
142420400200000,SE 210,RESIDENTIAL,34168,0,34168,114806,0,148974
142420400300000,SE 210,RESIDENTIAL,34950,0,34950,127117,0,162067
142420400400000,SE 210,RESIDENTIAL,36480,0,36480,127381,0,163861
142420400500000,SE 210,RESIDENTIAL,37760,0,37760,180225,0,217985
142420400600000,SE 210,RESIDENTIAL,39040,0,39040,126407,0,165447
142420400700000,SE 210,RESIDENTIAL,38400,0,38400,202556,0,240956
142420400800000,SE 210,RESIDENTIAL,41200,0,41200,103603,0,144803
142420400900000,SE 210,RESIDENTIAL,41040,0,41040,153272,0,194312
142420401000000,SE 210,RESIDENTIAL,40320,0,40320,128416,0,168736
142420500100000,SE 210,RESIDENTIAL,39016,0,39016,108546,0,147562
142420500200000,SE 210,RESIDENTIAL,38766,0,38766,124458,0,163224
142420500300000,SE 210,RESIDENTIAL,38102,0,38102,102450,0,140552
142420500400000,SE 210,RESIDENTIAL,38800,0,38800,171074,0,209874
142420500500000,SE 210,RESIDENTIAL,38800,0,38800,116389,0,155189
142420500600000,SE 210,RESIDENTIAL,39461,0,39461,175537,0,214998
142420500700000,SE 210,RESIDENTIAL,39600,0,39600,168096,0,207696
142420500800000,SE 210,RESIDENTIAL,39531,0,39531,126920,0,166451
142420500900000,SE 210,RESIDENTIAL,37440,0,37440,107954,0,145394
142420501000000,SE 210,RESIDENTIAL,35280,0,35280,164555,0,199835
142420501100000,SE 210,RESIDENTIAL,36360,0,36360,149428,0,185788
142420501200000,SE 210,RESIDENTIAL,35640,0,35640,122688,0,158328
142420501300000,SE 210,RESIDENTIAL,33690,0,33690,147079,0,180769
142420501400000,SE 210,RESIDENTIAL,36403,0,36403,138640,0,175043
142420501500000,SE 210,RESIDENTIAL,38528,0,38528,94224,0,132752
142420501600000,SE 210,RESIDENTIAL,38800,0,38800,191887,0,230687
142420501700000,SE 210,RESIDENTIAL,34920,0,34920,138244,0,173164
142420600100000,SE 210,RESIDENTIAL,35944,0,35944,155003,0,190947
142420600200000,SE 210,RESIDENTIAL,2750,0,2750,0,0,2750
142420600300000,SE 210,RESIDENTIAL,34772,0,34772,116881,0,151653
142420600400000,SE 210,RESIDENTIAL,36860,0,36860,102017,0,138877
142420600500000,SE 210,RESIDENTIAL,36860,0,36860,121270,0,158130
142420600600000,SE 210,RESIDENTIAL,38800,0,38800,137793,0,176593
142420600700000,SE 210,RESIDENTIAL,38800,0,38800,129893,0,168693
142420600800000,SE 210,RESIDENTIAL,38800,0,38800,143571,0,182371
142420600900000,SE 210,RESIDENTIAL,38800,0,38800,145497,0,184297
142420601000000,SE 210,RESIDENTIAL,39318,0,39318,104115,0,143433
142420601100000,SE 210,RESIDENTIAL,33827,0,33827,128931,0,162758
142420601200000,SE 210,RESIDENTIAL,34515,0,34515,148749,0,183264
142420601300000,SE 210,RESIDENTIAL,34920,0,34920,110883,0,145803
142420601400000,SE 210,RESIDENTIAL,34920,0,34920,170351,0,205271
142420601500000,SE 210,RESIDENTIAL,34920,0,34920,146375,0,181295
142420601600000,SE 210,RESIDENTIAL,34920,0,34920,129551,0,164471
142420700100000,SE 210,RESIDENTIAL,36495,0,36495,163110,0,199605
142420700200000,SE 210,RESIDENTIAL,34705,0,34705,107171,0,141876
142420700300000,SE 210,RESIDENTIAL,35280,0,35280,124997,0,160277
142420700400000,SE 210,RESIDENTIAL,35280,0,35280,181743,0,217023
142420700500000,SE 210,RESIDENTIAL,35280,0,35280,112135,0,147415
142420700600000,SE 210,RESIDENTIAL,36456,0,36456,131271,0,167727
142420700700000,SE 210,RESIDENTIAL,36456,0,36456,97714,0,134170
142420700800000,SE 210,RESIDENTIAL,36456,0,36456,156939,0,193395
142420700900000,SE 210,RESIDENTIAL,36456,0,36456,143530,0,179986
142420701000000,SE 210,RESIDENTIAL,36456,0,36456,146163,0,182619
142420701100000,SE 210,RESIDENTIAL,34783,0,34783,174363,0,209146
142420800100000,SE 210,RESIDENTIAL,44440,0,44440,200636,0,245076
142420800200000,SE 210,RESIDENTIAL,36360,0,36360,104413,0,140773
142420800300000,SE 210,RESIDENTIAL,36360,0,36360,115413,0,151773
142420800400000,SE 210,RESIDENTIAL,36360,0,36360,109016,0,145376
142422600100000,SE 211,RESIDENTIAL,100,0,100,0,0,100
142422600200000,SE 211,RESIDENTIAL,59042,0,59042,161707,0,220749
142422600300000,SE 211,RESIDENTIAL,60437,0,60437,177305,0,237742
142422600400000,SE 211,RESIDENTIAL,60437,0,60437,199000,0,259437
142422600500000,SE 211,RESIDENTIAL,59649,0,59649,165040,0,224689
142422600600000,SE 211,RESIDENTIAL,54947,0,54947,169045,0,223992
142422600700000,SE 211,RESIDENTIAL,64755,0,64755,118860,0,183615
142422600800000,SE 211,RESIDENTIAL,138550,0,138550,276562,0,415112
142422600900000,SE 211,RESIDENTIAL,59207,0,59207,149857,0,209064
142422601000000,SE 211,RESIDENTIAL,62985,0,62985,175557,0,238542
142422601100000,SE 211,RESIDENTIAL,67925,0,67925,161918,0,229843
142422601200000,SE 211,RESIDENTIAL,46900,0,46900,184534,0,231434
142422601300000,SE 211,RESIDENTIAL,49300,0,49300,116843,0,166143
142422601400000,SE 211,RESIDENTIAL,48346,0,48346,206054,0,254400
142422601500000,SE 211,RESIDENTIAL,57545,0,57545,191722,0,249267
142422601600000,SE 211,RESIDENTIAL,51848,0,51848,141181,0,193029
142422601700000,SE 211,RESIDENTIAL,50325,0,50325,131223,0,181548
142422601800000,SE 211,RESIDENTIAL,51667,0,51667,132936,0,184603
142422601900000,SE 211,RESIDENTIAL,52250,0,52250,127119,0,179369
142422602000000,SE 211,RESIDENTIAL,49284,0,49284,129154,0,178438
142422602100000,SE 211,RESIDENTIAL,41600,0,41600,165245,0,206845
142422602200000,SE 211,RESIDENTIAL,62243,0,62243,159310,0,221553
142422602300000,SE 211,RESIDENTIAL,60442,0,60442,207480,0,267922
142422602400000,SE 211,RESIDENTIAL,49000,0,49000,173979,0,222979
142422602500000,SE 211,RESIDENTIAL,49000,0,49000,162043,0,211043
142422602600000,SE 211,RESIDENTIAL,62100,0,62100,346841,0,408941
142422602700000,SE 211,RESIDENTIAL,60375,0,60375,194836,0,255211
142422602800000,SE 211,RESIDENTIAL,62675,0,62675,307704,0,370379
142422602900000,SE 211,RESIDENTIAL,66125,0,66125,218868,0,284993
142422603000000,SE 211,RESIDENTIAL,75839,0,75839,202513,0,278352
142422603100000,SE 211,RESIDENTIAL,71860,0,71860,222746,0,294606
142422603200000,SE 211,RESIDENTIAL,67996,0,67996,208585,0,276581
142422603300000,SE 211,RESIDENTIAL,52866,0,52866,222970,0,275836
142422603400000,SE 211,RESIDENTIAL,67999,0,67999,200482,0,268481
142422603500000,SE 211,RESIDENTIAL,70150,0,70150,246095,0,316245
142422603600000,SE 211,RESIDENTIAL,70725,0,70725,256033,0,326758
142422603700000,SE 211,RESIDENTIAL,4895,0,4895,0,0,4895
142422603800000,SE 211,RESIDENTIAL,64200,0,64200,217837,0,282037
142422603900000,SE 211,RESIDENTIAL,65895,0,65895,203796,0,269691
142422604000000,SE 211,RESIDENTIAL,56320,0,56320,287706,0,344026
142422604100000,SE 211,RESIDENTIAL,48500,0,48500,132237,0,180737
142422604200000,SE 211,RESIDENTIAL,50642,0,50642,134316,0,184958
142422604300000,SE 211,RESIDENTIAL,69212,0,69212,162444,0,231656
142422604400000,SE 211,RESIDENTIAL,65914,0,65914,168234,0,234148
142422604500000,SE 211,RESIDENTIAL,53580,0,53580,160454,0,214034
142422604600000,SE 211,RESIDENTIAL,39949,0,39949,166623,0,206572
142422604700000,SE 211,RESIDENTIAL,2060,0,2060,0,0,2060
142422700100000,SE 211,RESIDENTIAL,52800,0,52800,165562,0,218362
142422700200000,SE 211,RESIDENTIAL,55290,0,55290,138149,0,193439
142422700300000,SE 211,RESIDENTIAL,43120,0,43120,187613,0,230733
142422700400000,SE 211,RESIDENTIAL,43120,0,43120,167188,0,210308
142422700500000,SE 211,RESIDENTIAL,43120,0,43120,128196,0,171316
142422700600000,SE 211,RESIDENTIAL,52525,0,52525,135430,0,187955
142422700700000,SE 211,RESIDENTIAL,52800,0,52800,130297,0,183097
142422700800000,SE 211,RESIDENTIAL,53900,0,53900,136749,0,190649
142422700900000,SE 211,RESIDENTIAL,53900,0,53900,131146,0,185046
142422701000000,SE 211,RESIDENTIAL,53900,0,53900,143823,0,197723
142425100100000,SE 211,RESIDENTIAL,132900,0,132900,322663,0,455563
142425100200000,SE 211,RESIDENTIAL,98745,0,98745,361853,0,460598
142425100300000,SE 211,RESIDENTIAL,84989,0,84989,0,0,84989
142425100400000,SE 211,RESIDENTIAL,96344,0,96344,384916,0,481260
142425100500000,SE 211,RESIDENTIAL,86966,0,86966,340221,0,427187
142425100600000,SE 211,RESIDENTIAL,83470,0,83470,316694,0,400164
142425100700000,SE 211,RESIDENTIAL,88571,0,88571,349155,0,437726
142425100800000,SE 211,RESIDENTIAL,106880,0,106880,563704,0,670584
142425100900000,SE 211,RESIDENTIAL,91205,0,91205,293863,0,385068
142425101200000,SE 211,RESIDENTIAL,128400,0,128400,521407,0,649807
142425101400000,SE 211,RESIDENTIAL,112500,0,112500,286741,0,399241
142425101500000,SE 211,RESIDENTIAL,100000,0,100000,235254,0,335254
142425101600000,SE 211,RESIDENTIAL,94711,0,94711,283048,0,377759
142425101700000,SE 211,RESIDENTIAL,93065,0,93065,270513,0,363578
142425101800000,SE 211,RESIDENTIAL,101420,0,101420,272529,0,373949
142425101900000,SE 211,RESIDENTIAL,100820,0,100820,280851,0,381671
142425102000000,SE 211,RESIDENTIAL,104420,0,104420,249558,0,353978
142425102100000,SE 211,RESIDENTIAL,104720,0,104720,282513,0,387233
142425102200000,SE 211,RESIDENTIAL,73234,0,73234,251091,0,324325
142425102300000,SE 211,EXEMPT,0,118020,118020,0,580852,698872
142425102400000,SE 211,RESIDENTIAL,62080,0,62080,203074,0,265154
142425102500000,SE 210,RESIDENTIAL,48300,0,48300,180521,0,228821
142425102600000,SE 210,RESIDENTIAL,53500,0,53500,251484,0,304984
142425102700000,SE 210,RESIDENTIAL,52428,0,52428,154756,0,207184
142425102800000,SE 210,RESIDENTIAL,52364,0,52364,119061,0,171425
142425102900000,SE 210,RESIDENTIAL,47080,0,47080,144765,0,191845
142425103000000,SE 210,RESIDENTIAL,43248,0,43248,115514,0,158762
142425103100000,SE 210,RESIDENTIAL,43370,0,43370,117123,0,160493
142425103200000,SE 210,RESIDENTIAL,43956,0,43956,148995,0,192951
142425103300000,SE 210,RESIDENTIAL,47460,0,47460,134399,0,181859
142425103400000,SE 210,RESIDENTIAL,60250,0,60250,179467,0,239717
142425103500000,SE 210,RESIDENTIAL,47834,0,47834,119099,0,166933
142425103700000,SE 211,RESIDENTIAL,74375,0,74375,0,0,74375
142425103900000,SE 211,RESIDENTIAL,51450,0,51450,0,0,51450
142425104000000,SE 211,RESIDENTIAL,135000,0,135000,667410,0,802410
142425200100000,SE 210,RESIDENTIAL,41205,0,41205,180782,0,221987
142425200200000,SE 210,RESIDENTIAL,42835,0,42835,91865,0,134700
142425200300000,SE 210,RESIDENTIAL,41189,0,41189,83000,0,124189
142427600100000,SE 210,RESIDENTIAL,36360,0,36360,131407,0,167767
142427600200000,SE 210,RESIDENTIAL,36360,0,36360,123734,0,160094
142427600300000,SE 210,RESIDENTIAL,36360,0,36360,117842,0,154202
142427600400000,SE 210,RESIDENTIAL,36360,0,36360,107211,0,143571
142427600500000,SE 210,RESIDENTIAL,36360,0,36360,133685,0,170045
142427600600000,SE 210,RESIDENTIAL,41778,0,41778,133425,0,175203
142427700100000,SE 210,RESIDENTIAL,42800,0,42800,143720,0,186520
142427700200000,SE 210,RESIDENTIAL,35640,0,35640,128125,0,163765
142427700300000,SE 210,RESIDENTIAL,40073,0,40073,161464,0,201537
142427700400000,SE 210,RESIDENTIAL,37200,0,37200,166136,0,203336
142427700500000,SE 210,RESIDENTIAL,36800,0,36800,194551,0,231351
142427700600000,SE 210,RESIDENTIAL,36800,0,36800,124552,0,161352
142427800100000,SE 210,RESIDENTIAL,41013,0,41013,141985,0,182998
142427800200000,SE 210,RESIDENTIAL,35020,0,35020,125359,0,160379
142427800300000,SE 210,RESIDENTIAL,33660,0,33660,94770,0,128430
142427800400000,SE 210,RESIDENTIAL,36432,0,36432,107962,0,144394
142427800500000,SE 210,RESIDENTIAL,34796,0,34796,113552,0,148348
142427900100000,SE 210,RESIDENTIAL,34000,0,34000,101437,0,135437
142427900200000,SE 210,RESIDENTIAL,34000,0,34000,108312,0,142312
142427900300000,SE 210,RESIDENTIAL,34000,0,34000,104920,0,138920
142427900400000,SE 210,RESIDENTIAL,34000,0,34000,157416,0,191416
142427900500000,SE 210,RESIDENTIAL,34000,0,34000,115630,0,149630
142427900600000,SE 210,RESIDENTIAL,33867,0,33867,144051,0,177918
142427900700000,SE 210,RESIDENTIAL,37482,0,37482,127393,0,164875
142427900800000,SE 210,RESIDENTIAL,36040,0,36040,118918,0,154958
142427900900000,SE 210,RESIDENTIAL,36040,0,36040,108885,0,144925
142427901000000,SE 210,RESIDENTIAL,36040,0,36040,114183,0,150223
142427901100000,SE 210,RESIDENTIAL,36040,0,36040,108065,0,144105
142427901200000,SE 210,RESIDENTIAL,36040,0,36040,114946,0,150986
142427901300000,SE 210,RESIDENTIAL,36040,0,36040,126603,0,162643
142428000100000,SE 210,RESIDENTIAL,37642,0,37642,127800,0,165442
142428000200000,SE 210,RESIDENTIAL,45635,0,45635,175087,0,220722
142428000300000,SE 210,RESIDENTIAL,44147,0,44147,160585,0,204732
142428000400000,SE 210,RESIDENTIAL,39573,0,39573,111373,0,150946
142428000500000,SE 210,RESIDENTIAL,40000,0,40000,140452,0,180452
142428000600000,SE 210,RESIDENTIAL,41894,0,41894,113064,0,154958
142428000700000,SE 210,RESIDENTIAL,43795,0,43795,103300,0,147095
142428000800000,SE 210,RESIDENTIAL,45108,0,45108,327631,0,372739
142428000900000,SE 210,RESIDENTIAL,44478,0,44478,141225,0,185703
142428100100000,SE 210,RESIDENTIAL,33392,0,33392,118126,0,151518
142428100200000,SE 210,RESIDENTIAL,33762,0,33762,155516,0,189278
142428100300000,SE 210,RESIDENTIAL,34204,0,34204,139009,0,173213
142428100400000,SE 210,RESIDENTIAL,34333,0,34333,124141,0,158474
142428100500000,SE 210,RESIDENTIAL,34804,0,34804,109475,0,144279
142428100600000,SE 210,RESIDENTIAL,35343,0,35343,138609,0,173952
142428100700000,SE 210,RESIDENTIAL,35086,0,35086,120810,0,155896
142428200100000,SE 210,RESIDENTIAL,38170,0,38170,113438,0,151608
142428200200000,SE 210,RESIDENTIAL,37740,0,37740,133145,0,170885
142428200300000,SE 210,RESIDENTIAL,37740,0,37740,163408,0,201148
142428200400000,SE 210,RESIDENTIAL,37475,0,37475,84504,0,121979
142428200500000,SE 210,RESIDENTIAL,36720,0,36720,121091,0,157811
142428200600000,SE 210,RESIDENTIAL,36040,0,36040,118713,0,154753
142428200700000,SE 210,RESIDENTIAL,37536,0,37536,103887,0,141423
142428200800000,SE 210,RESIDENTIAL,40032,0,40032,149475,0,189507
142428200900000,SE 210,RESIDENTIAL,42154,0,42154,120473,0,162627
142428201000000,SE 210,RESIDENTIAL,46250,0,46250,144292,0,190542
142428201100000,SE 210,RESIDENTIAL,42401,0,42401,143698,0,186099
142428201200000,SE 210,RESIDENTIAL,41636,0,41636,130478,0,172114
142428201300000,SE 210,RESIDENTIAL,48561,0,48561,126456,0,175017
142428201400000,SE 210,RESIDENTIAL,46354,0,46354,147683,0,194037
142428201500000,SE 210,RESIDENTIAL,47236,0,47236,132264,0,179500
142428201600000,SE 210,RESIDENTIAL,48576,0,48576,178782,0,227358
142428201700000,SE 210,RESIDENTIAL,48536,0,48536,163625,0,212161
142428201800000,SE 210,RESIDENTIAL,46398,0,46398,123152,0,169550
142428201900000,SE 210,RESIDENTIAL,45562,0,45562,143363,0,188925
142428202000000,SE 210,RESIDENTIAL,49426,0,49426,238838,0,288264
142428202100000,SE 210,RESIDENTIAL,41208,0,41208,199981,0,241189
142428202200000,SE 210,RESIDENTIAL,43639,0,43639,186167,0,229806
142428202300000,SE 210,RESIDENTIAL,42636,0,42636,102397,0,145033
142428202400000,SE 210,RESIDENTIAL,43890,0,43890,100619,0,144509
142428202500000,SE 210,RESIDENTIAL,41616,0,41616,152549,0,194165
142428202600000,SE 210,RESIDENTIAL,45426,0,45426,119834,0,165260
142428300100000,SE 210,RESIDENTIAL,44727,0,44727,111496,0,156223
142428300200000,SE 210,RESIDENTIAL,40293,0,40293,132176,0,172469
142428300300000,SE 210,RESIDENTIAL,40656,0,40656,151334,0,191990
142428300400000,SE 210,RESIDENTIAL,40577,0,40577,119799,0,160376
142428300500000,SE 210,RESIDENTIAL,40669,0,40669,100197,0,140866
142428300600000,SE 210,RESIDENTIAL,38247,0,38247,81084,0,119331
142428300700000,SE 210,RESIDENTIAL,38318,0,38318,88850,0,127168
142430100100000,SE 210,RESIDENTIAL,37318,0,37318,110308,0,147626
142430100200000,SE 210,RESIDENTIAL,31360,0,31360,111375,0,142735
142430100300000,SE 210,RESIDENTIAL,29074,0,29074,110167,0,139241
142430100400000,SE 210,RESIDENTIAL,32275,0,32275,79204,0,111479
142430100500000,SE 210,RESIDENTIAL,31020,0,31020,95039,0,126059
142430100600000,SE 210,RESIDENTIAL,34533,0,34533,119500,0,154033
142430100700000,SE 210,RESIDENTIAL,27744,0,27744,109450,0,137194
142430100800000,SE 210,RESIDENTIAL,28149,0,28149,128607,0,156756
142430100900000,SE 210,RESIDENTIAL,28420,0,28420,80893,0,109313
142430101000000,SE 210,RESIDENTIAL,28420,0,28420,78008,0,106428
142430101100000,SE 210,RESIDENTIAL,28420,0,28420,87925,0,116345
142430101200000,SE 210,RESIDENTIAL,28980,0,28980,74710,0,103690
142430101300000,SE 210,RESIDENTIAL,28704,0,28704,90741,0,119445
142430101400000,SE 210,RESIDENTIAL,31428,0,31428,106776,0,138204
142430101500000,SE 210,RESIDENTIAL,28037,0,28037,74334,0,102371
142430200100000,SE 210,RESIDENTIAL,64350,0,64350,194984,0,259334
142430200200000,SE 210,RESIDENTIAL,61050,0,61050,142492,0,203542
142430200300000,SE 210,RESIDENTIAL,34593,0,34593,125188,0,159781
142430200400000,SE 210,RESIDENTIAL,35178,0,35178,128898,0,164076
142430200500000,SE 210,RESIDENTIAL,37625,0,37625,140956,0,178581
142430200600000,SE 210,RESIDENTIAL,34092,0,34092,142075,0,176167
142430200700000,SE 210,RESIDENTIAL,30975,0,30975,145218,0,176193
142430200800000,SE 210,RESIDENTIAL,29808,0,29808,142497,0,172305
142430200900000,SE 210,RESIDENTIAL,39268,0,39268,153185,0,192453
142430201000000,SE 210,RESIDENTIAL,37223,0,37223,147453,0,184676
142430201100000,SE 210,RESIDENTIAL,32724,0,32724,149220,0,181944
142430201200000,SE 210,RESIDENTIAL,34542,0,34542,148442,0,182984
142430201300000,SE 210,RESIDENTIAL,34200,0,34200,133251,0,167451
142430201400000,SE 210,RESIDENTIAL,31960,0,31960,173397,0,205357
142430201500000,SE 210,RESIDENTIAL,34295,0,34295,144564,0,178859
142430201600000,SE 210,RESIDENTIAL,36442,0,36442,109754,0,146196
142430201700000,SE 210,RESIDENTIAL,30456,0,30456,159629,0,190085
142430201800000,SE 210,RESIDENTIAL,30053,0,30053,151748,0,181801
142430201900000,SE 210,RESIDENTIAL,39000,0,39000,80978,0,119978
142430202100000,SE 210,RESIDENTIAL,27989,0,27989,84883,0,112872
142430202200000,SE 210,RESIDENTIAL,26802,0,26802,131337,0,158139
142430202300000,SE 210,RESIDENTIAL,30403,0,30403,103511,0,133914
142430202400000,SE 210,RESIDENTIAL,29478,0,29478,111112,0,140590
142430202500000,SE 210,RESIDENTIAL,34639,0,34639,118129,0,152768
142430202600000,SE 210,RESIDENTIAL,34031,0,34031,113286,0,147317
142430202700000,SE 210,RESIDENTIAL,33920,0,33920,106523,0,140443
142430202800000,SE 210,RESIDENTIAL,34240,0,34240,121649,0,155889
142430202900000,SE 210,RESIDENTIAL,33379,0,33379,98988,0,132367
142430203000000,SE 210,RESIDENTIAL,32760,0,32760,100626,0,133386
142430203100000,SE 210,RESIDENTIAL,34299,0,34299,160251,0,194550
142430203200000,SE 210,RESIDENTIAL,34560,0,34560,121000,0,155560
142430203300000,SE 210,RESIDENTIAL,35136,0,35136,101519,0,136655
142430203400000,SE 210,RESIDENTIAL,35100,0,35100,87584,0,122684
142430300100000,SE 210,RESIDENTIAL,36708,0,36708,154077,0,190785
142430300200000,SE 210,RESIDENTIAL,31368,0,31368,175082,0,206450
142430300300000,SE 210,RESIDENTIAL,31583,0,31583,160153,0,191736
142430300400000,SE 210,RESIDENTIAL,32244,0,32244,151720,0,183964
142430300500000,SE 210,RESIDENTIAL,32896,0,32896,97735,0,130631
142430300600000,SE 210,RESIDENTIAL,34592,0,34592,126822,0,161414
142430300700000,SE 210,RESIDENTIAL,33743,0,33743,116009,0,149752
142430300800000,SE 210,RESIDENTIAL,31450,0,31450,120198,0,151648
142430300900000,SE 210,RESIDENTIAL,30053,0,30053,163309,0,193362
142430301000000,SE 210,RESIDENTIAL,33927,0,33927,135094,0,169021
142430301100000,SE 210,RESIDENTIAL,38782,0,38782,114260,0,153042
142430400100000,SE 210,RESIDENTIAL,31772,0,31772,158099,0,189871
142430400200000,SE 210,RESIDENTIAL,28032,0,28032,129563,0,157595
142430400300000,SE 210,RESIDENTIAL,29223,0,29223,117718,0,146941
142430400400000,SE 210,RESIDENTIAL,32605,0,32605,97671,0,130276
142430400500000,SE 210,RESIDENTIAL,28356,0,28356,95221,0,123577
142430400600000,SE 210,RESIDENTIAL,28717,0,28717,109862,0,138579
142430400700000,SE 210,RESIDENTIAL,27200,0,27200,112614,0,139814
142430500100000,SE 210,RESIDENTIAL,33617,0,33617,112801,0,146418
142430500200000,SE 210,RESIDENTIAL,32980,0,32980,103089,0,136069
142430500300000,SE 210,RESIDENTIAL,28149,0,28149,166181,0,194330
142430500400000,SE 210,RESIDENTIAL,27388,0,27388,121014,0,148402
142430500500000,SE 210,RESIDENTIAL,25637,0,25637,146793,0,172430
142430500600000,SE 210,RESIDENTIAL,26727,0,26727,110923,0,137650
142430500700000,SE 210,RESIDENTIAL,22568,0,22568,84080,0,106648
142430500800000,SE 210,RESIDENTIAL,24752,0,24752,116016,0,140768
142430500900000,SE 210,RESIDENTIAL,25760,0,25760,122539,0,148299
142430501000000,SE 210,RESIDENTIAL,27160,0,27160,116585,0,143745
142430501100000,SE 210,RESIDENTIAL,30714,0,30714,107063,0,137777
142430501200000,SE 210,RESIDENTIAL,29488,0,29488,90965,0,120453
142430501300000,SE 210,RESIDENTIAL,29488,0,29488,100193,0,129681
142430501400000,SE 210,RESIDENTIAL,29488,0,29488,103765,0,133253
142430501500000,SE 210,EXEMPT,0,29488,29488,0,112420,141908
142430501600000,SE 210,RESIDENTIAL,29488,0,29488,97910,0,127398
142430501700000,SE 210,RESIDENTIAL,29488,0,29488,102285,0,131773
142430501800000,SE 210,RESIDENTIAL,29488,0,29488,107695,0,137183
142430600100000,SE 210,RESIDENTIAL,26640,0,26640,101113,0,127753
142430600200000,SE 210,RESIDENTIAL,27540,0,27540,97908,0,125448
142430600300000,SE 210,RESIDENTIAL,25989,0,25989,85498,0,111487
142430600400000,SE 210,RESIDENTIAL,26218,0,26218,164890,0,191108
142430600600000,SE 210,RESIDENTIAL,30264,0,30264,32434,0,62698
142430600700000,SE 210,RESIDENTIAL,29841,0,29841,102606,0,132447
142430600800000,SE 210,RESIDENTIAL,29488,0,29488,87786,0,117274
142430600900000,SE 210,RESIDENTIAL,29488,0,29488,102385,0,131873
142430601000000,SE 210,RESIDENTIAL,29488,0,29488,105928,0,135416
142430601100000,SE 210,RESIDENTIAL,29488,0,29488,96984,0,126472
142430601200000,SE 210,RESIDENTIAL,29488,0,29488,91944,0,121432
142430601300000,SE 210,RESIDENTIAL,29488,0,29488,100986,0,130474
142430601400000,SE 210,RESIDENTIAL,29488,0,29488,99422,0,128910
142430601500000,SE 210,RESIDENTIAL,30638,0,30638,104990,0,135628
142430601700000,SE 210,RESIDENTIAL,21060,0,21060,39102,0,60162
142432600100000,SE 210,RESIDENTIAL,43061,0,43061,106700,0,149761
142432600200000,SE 210,RESIDENTIAL,46463,0,46463,146834,0,193297
142432700100000,SE 210,RESIDENTIAL,41692,0,41692,183378,0,225070
142432700400000,SE 210,RESIDENTIAL,43546,0,43546,126674,0,170220
142432700500000,SE 210,RESIDENTIAL,42269,0,42269,140634,0,182903
142432700600000,SE 210,RESIDENTIAL,46104,0,46104,167813,0,213917
142432700700000,SE 210,RESIDENTIAL,46104,0,46104,200937,0,247041
142432700800000,SE 210,RESIDENTIAL,46104,0,46104,143987,0,190091
142432700900000,SE 210,RESIDENTIAL,46104,0,46104,258496,0,304600
142432701000000,SE 210,RESIDENTIAL,31237,0,31237,86874,0,118111
142432701100000,SE 210,RESIDENTIAL,29400,0,29400,106086,0,135486
142432701200000,SE 210,RESIDENTIAL,27930,0,27930,97532,0,125462
142432701300000,SE 210,RESIDENTIAL,27930,0,27930,95717,0,123647
142432701400000,SE 210,RESIDENTIAL,32100,0,32100,105854,0,137954
142432701500000,SE 210,RESIDENTIAL,32100,0,32100,115183,0,147283
142432701600000,SE 210,RESIDENTIAL,32100,0,32100,86388,0,118488
142432701700000,SE 210,RESIDENTIAL,32100,0,32100,103413,0,135513
142432701800000,SE 210,RESIDENTIAL,32100,0,32100,128413,0,160513
142432701900000,SE 210,RESIDENTIAL,32742,0,32742,119431,0,152173
142432702000000,SE 210,RESIDENTIAL,32742,0,32742,105432,0,138174
142432702100000,SE 210,RESIDENTIAL,32742,0,32742,109008,0,141750
142432702200000,SE 210,RESIDENTIAL,41580,0,41580,130672,0,172252
142432800100000,SE 210,RESIDENTIAL,45937,0,45937,110016,0,155953
142432800200000,SE 210,RESIDENTIAL,20800,0,20800,86204,0,107004
142432800300000,SE 210,RESIDENTIAL,43597,0,43597,131017,0,174614
142432800400000,SE 210,RESIDENTIAL,39200,0,39200,118925,0,158125
142432800500000,SE 210,RESIDENTIAL,39200,0,39200,120580,0,159780
142432800600000,SE 210,RESIDENTIAL,38701,0,38701,106956,0,145657
142432800700000,SE 210,RESIDENTIAL,29100,0,29100,94045,0,123145
142432800800000,SE 210,RESIDENTIAL,29100,0,29100,93781,0,122881
142432800900000,SE 210,RESIDENTIAL,29100,0,29100,107343,0,136443
142432801000000,SE 210,RESIDENTIAL,28567,0,28567,96373,0,124940
142432801100000,SE 210,RESIDENTIAL,30020,0,30020,96485,0,126505
142432801200000,SE 210,RESIDENTIAL,33174,0,33174,124073,0,157247
142432801300000,SE 210,RESIDENTIAL,15770,0,15770,112824,0,128594
142432801400000,SE 210,RESIDENTIAL,30109,0,30109,101197,0,131306
142432900100000,SE 222,RESIDENTIAL,28000,0,28000,121033,0,149033
142432900200000,SE 222,RESIDENTIAL,24700,0,24700,96666,0,121366
142432900300000,SE 222,RESIDENTIAL,24000,0,24000,65277,0,89277
142432900400000,SE 222,RESIDENTIAL,24000,0,24000,91103,0,115103
142432900500000,SE 222,RESIDENTIAL,24000,0,24000,85659,0,109659
142432900600000,SE 222,RESIDENTIAL,24000,0,24000,77167,0,101167
142432900700000,SE 222,RESIDENTIAL,24700,0,24700,79064,0,103764
142432900800000,SE 222,RESIDENTIAL,24000,0,24000,57730,0,81730
142432900900000,SE 222,RESIDENTIAL,24000,0,24000,78049,0,102049
142432901000000,SE 222,RESIDENTIAL,24000,0,24000,70360,0,94360
142432901100000,SE 222,RESIDENTIAL,24000,0,24000,86411,0,110411
142432901200000,SE 222,RESIDENTIAL,24000,0,24000,112458,0,136458
142432901300000,SE 222,RESIDENTIAL,24000,0,24000,74946,0,98946
142432901400000,SE 222,RESIDENTIAL,24000,0,24000,76644,0,100644
142432901500000,SE 222,RESIDENTIAL,24000,0,24000,82733,0,106733
142432901600000,SE 222,RESIDENTIAL,24700,0,24700,92395,0,117095
142432901700000,SE 222,RESIDENTIAL,24700,0,24700,105325,0,130025
142432901800000,SE 222,RESIDENTIAL,24480,0,24480,87126,0,111606
142432901900000,SE 222,RESIDENTIAL,24480,0,24480,88894,0,113374
142433000100000,SE 222,RESIDENTIAL,24000,0,24000,86725,0,110725
142433000200000,SE 222,RESIDENTIAL,24000,0,24000,96977,0,120977
142433000300000,SE 222,RESIDENTIAL,24000,0,24000,93824,0,117824
142433000400000,SE 222,RESIDENTIAL,24000,0,24000,104329,0,128329
142433000500000,SE 222,RESIDENTIAL,24000,0,24000,52030,0,76030
142433000600000,SE 222,RESIDENTIAL,24000,0,24000,57982,0,81982
142433000700000,SE 222,RESIDENTIAL,24000,0,24000,58676,0,82676
142433000800000,SE 222,RESIDENTIAL,24000,0,24000,67053,0,91053
142433000900000,SE 222,RESIDENTIAL,24000,0,24000,56599,0,80599
142433001000000,SE 222,RESIDENTIAL,24000,0,24000,75062,0,99062
142433001100000,SE 222,RESIDENTIAL,25200,0,25200,75426,0,100626
142433001200000,CITY PROPERTY,EXEMPT,0,0,0,0,0,0
142433001300000,SE 222,RESIDENTIAL,24725,0,24725,59932,0,84657
142433001400000,SE 222,RESIDENTIAL,25200,0,25200,95478,0,120678
142433001500000,SE 223,RESIDENTIAL,24461,0,24461,86981,0,111442
142433001600000,SE 223,RESIDENTIAL,20200,0,20200,73801,0,94001
142433001700000,SE 223,RESIDENTIAL,26438,0,26438,88861,0,115299
142433001800000,SE 222,RESIDENTIAL,25200,0,25200,89288,0,114488
142433001900000,SE 222,RESIDENTIAL,24000,0,24000,82626,0,106626
142433002000000,SE 222,RESIDENTIAL,24000,0,24000,88417,0,112417
142433002100000,SE 222,RESIDENTIAL,24000,0,24000,81769,0,105769
142433002200000,SE 222,RESIDENTIAL,24000,0,24000,71109,0,95109
142433002300000,SE 222,RESIDENTIAL,24000,0,24000,89830,0,113830
142433002400000,SE 222,RESIDENTIAL,24000,0,24000,93488,0,117488
142433002500000,SE 222,RESIDENTIAL,24000,0,24000,85917,0,109917
142433002600000,SE 222,RESIDENTIAL,24000,0,24000,104106,0,128106
142433100100000,SE 210,RESIDENTIAL,32174,0,32174,89926,0,122100
142433100200000,SE 210,RESIDENTIAL,32183,0,32183,111320,0,143503
142433100300000,SE 210,RESIDENTIAL,32183,0,32183,67654,0,99837
142433100400000,SE 210,RESIDENTIAL,32183,0,32183,113638,0,145821
142433100500000,SE 210,RESIDENTIAL,30214,0,30214,102417,0,132631
142433100600000,SE 210,RESIDENTIAL,28028,0,28028,109686,0,137714
142433100700000,SE 210,RESIDENTIAL,29400,0,29400,117690,0,147090
142433100800000,SE 210,RESIDENTIAL,29400,0,29400,131884,0,161284
142433100900000,SE 210,RESIDENTIAL,29100,0,29100,98044,0,127144
142433101000000,SE 210,RESIDENTIAL,29100,0,29100,124398,0,153498
142433101100000,SE 210,RESIDENTIAL,29100,0,29100,106159,0,135259
142433101200000,SE 210,RESIDENTIAL,28509,0,28509,119546,0,148055
142433101300000,SE 210,RESIDENTIAL,33274,0,33274,73326,0,106600
142433101400000,SE 210,RESIDENTIAL,30186,0,30186,96460,0,126646
142433101500000,SE 210,RESIDENTIAL,30186,0,30186,106427,0,136613
142433101600000,SE 210,RESIDENTIAL,29992,0,29992,113008,0,143000
142433200100000,SE 223,RESIDENTIAL,22010,0,22010,106671,0,128681
142433200200000,SE 223,RESIDENTIAL,21709,0,21709,77420,0,99129
142433200300000,SE 223,RESIDENTIAL,24480,0,24480,88289,0,112769
142433200400000,SE 223,RESIDENTIAL,23520,0,23520,80744,0,104264
142433200500000,SE 223,RESIDENTIAL,21840,0,21840,101423,0,123263
142435100100000,SCHOOL,EXEMPT,0,0,0,0,0,0
142435200100000,SE 223,RESIDENTIAL,21840,0,21840,90099,0,111939
142435200200000,SE 223,RESIDENTIAL,24027,0,24027,83695,0,107722
142435200300000,SE 223,RESIDENTIAL,21840,0,21840,101684,0,123524
142435200400000,SE 223,RESIDENTIAL,21840,0,21840,84877,0,106717
142435200500000,SE 223,RESIDENTIAL,21840,0,21840,93428,0,115268
142435200600000,SE 223,RESIDENTIAL,21840,0,21840,90103,0,111943
142435200700000,SE 223,RESIDENTIAL,21840,0,21840,103088,0,124928
142435200800000,SE 223,RESIDENTIAL,21840,0,21840,81224,0,103064
142435200900000,SE 223,RESIDENTIAL,23617,0,23617,129451,0,153068
142435201000000,SE 223,RESIDENTIAL,23514,0,23514,132626,0,156140
142435201100000,SE 223,RESIDENTIAL,24752,0,24752,105204,0,129956
142435201200000,SE 223,RESIDENTIAL,22859,0,22859,77740,0,100599
142435201300000,SE 223,RESIDENTIAL,23228,0,23228,87417,0,110645
142435201400000,SE 223,RESIDENTIAL,23296,0,23296,79488,0,102784
142435201500000,SE 223,RESIDENTIAL,21840,0,21840,76341,0,98181
142435201600000,SE 223,RESIDENTIAL,21840,0,21840,77609,0,99449
142435201700000,SE 223,RESIDENTIAL,21840,0,21840,79824,0,101664
142435201800000,SE 223,RESIDENTIAL,21840,0,21840,85044,0,106884
142435201900000,SE 223,RESIDENTIAL,21840,0,21840,77884,0,99724
142435202000000,SE 223,RESIDENTIAL,21840,0,21840,103354,0,125194
142435202100000,SE 223,RESIDENTIAL,21840,0,21840,78088,0,99928
142435300100000,SE 223,RESIDENTIAL,26600,0,26600,122169,0,148769
142435300200000,SE 223,RESIDENTIAL,27669,0,27669,84100,0,111769
142435300300000,SE 223,RESIDENTIAL,28848,0,28848,95021,0,123869
142435300400000,SE 223,RESIDENTIAL,23280,0,23280,77692,0,100972
142435300500000,SE 223,RESIDENTIAL,23280,0,23280,75737,0,99017
142435300600000,SE 223,RESIDENTIAL,24624,0,24624,71833,0,96457
142435300700000,SE 223,RESIDENTIAL,32604,0,32604,63528,0,96132
142435300800000,SE 223,RESIDENTIAL,25080,0,25080,62317,0,87397
142435300900000,SE 223,RESIDENTIAL,24000,0,24000,71706,0,95706
142435301000000,SE 223,RESIDENTIAL,24000,0,24000,101211,0,125211
142435301100000,SE 223,RESIDENTIAL,23040,0,23040,70904,0,93944
142435301200000,SE 223,RESIDENTIAL,26240,0,26240,89756,0,115996
142435301300000,SE 223,RESIDENTIAL,23600,0,23600,74067,0,97667
142435301400000,SE 223,RESIDENTIAL,22890,0,22890,84109,0,106999
142435301500000,SE 223,RESIDENTIAL,22632,0,22632,85507,0,108139
142435301600000,SE 223,RESIDENTIAL,22632,0,22632,109869,0,132501
142435301700000,SE 223,RESIDENTIAL,22632,0,22632,90522,0,113154
142435301800000,SE 223,RESIDENTIAL,21340,0,21340,94285,0,115625
142435301900000,SE 223,RESIDENTIAL,21340,0,21340,85701,0,107041
142435302000000,SE 223,RESIDENTIAL,21185,0,21185,73145,0,94330
142435302100000,SE 223,RESIDENTIAL,27120,0,27120,108135,0,135255
142435302200000,SE 223,RESIDENTIAL,24960,0,24960,85997,0,110957
142435302300000,SE 223,RESIDENTIAL,2160,0,2160,0,0,2160
142435302400000,SE 223,RESIDENTIAL,25197,0,25197,96964,0,122161
142435400100000,SE 223,RESIDENTIAL,24177,0,24177,86838,0,111015
142435400200000,SE 223,RESIDENTIAL,24317,0,24317,91245,0,115562
142435400300000,SE 223,RESIDENTIAL,24464,0,24464,99385,0,123849
142435400400000,SE 223,RESIDENTIAL,24177,0,24177,101244,0,125421
142435400500000,SE 223,RESIDENTIAL,24317,0,24317,109513,0,133830
142435400600000,SE 223,RESIDENTIAL,24464,0,24464,89431,0,113895
142435500200000,APARTMENT,COMMERCIAL,0,22524,22524,0,104353,126877
142435500300000,APARTMENT,RESIDENTIAL,21756,0,21756,104572,0,126328
142435500600000,CHURCH,EXEMPT,0,168750,168750,0,399079,567829
142435500700000,OFFICE; MEDICAL,COMMERCIAL,0,280000,280000,0,1028486,1308486
142435600100000,SE 223,RESIDENTIAL,22162,0,22162,75839,0,98001
142435600200000,SE 223,RESIDENTIAL,22575,0,22575,80523,0,103098
142435600300000,SE 223,RESIDENTIAL,22477,0,22477,91010,0,113487
142435600400000,SE 223,RESIDENTIAL,22568,0,22568,79085,0,101653
142435600500000,SE 223,RESIDENTIAL,22896,0,22896,112900,0,135796
142435600600000,SE 223,RESIDENTIAL,23296,0,23296,94931,0,118227
142435600700000,OFFICE; MEDICAL,COMMERCIAL,0,140762,140762,0,308799,449561
142435600800000,SE 223,RESIDENTIAL,18200,0,18200,96536,0,114736
142435600900000,SE 223,RESIDENTIAL,18200,0,18200,96161,0,114361
142435601000000,SE 223,RESIDENTIAL,21840,0,21840,86519,0,108359
142435601100000,SE 223,RESIDENTIAL,21840,0,21840,71798,0,93638
142435601200000,SE 223,RESIDENTIAL,21840,0,21840,79126,0,100966
142435601300000,SE 223,RESIDENTIAL,21840,0,21840,77582,0,99422
142435601400000,SE 223,RESIDENTIAL,21840,0,21840,76553,0,98393
142435700100000,SE 223,RESIDENTIAL,23893,0,23893,105852,0,129745
142435700200000,SE 223,RESIDENTIAL,25085,0,25085,122090,0,147175
142435700300000,SE 223,RESIDENTIAL,20972,0,20972,57364,0,78336
142435700400000,SE 223,RESIDENTIAL,21400,0,21400,66567,0,87967
142435700500000,SE 223,RESIDENTIAL,29680,0,29680,95164,0,124844
142435700600000,SE 223,RESIDENTIAL,31434,0,31434,0,0,31434
142435700700000,SMALL RETAIL,COMMERCIAL,0,78840,78840,0,204841,283681
142435700800000,RESTAURANT,COMMERCIAL,0,72954,72954,0,148826,221780
142435700900000,BRANCH BANK/CU,COMMERCIAL,0,205000,205000,0,615598,820598
142435701000000,SE 223,RESIDENTIAL,18952,0,18952,74772,0,93724
142435701100000,SE 223,RESIDENTIAL,18983,0,18983,79757,0,98740
142435701200000,SE 223,RESIDENTIAL,23230,0,23230,102483,0,125713
142435701300000,SE 223,RESIDENTIAL,23147,0,23147,89324,0,112471
142435701400000,SE 223,RESIDENTIAL,23147,0,23147,96451,0,119598
142435800100000,SE 223,RESIDENTIAL,24424,0,24424,90149,0,114573
142435800200000,SE 223,RESIDENTIAL,24571,0,24571,114866,0,139437
142435800300000,SE 223,RESIDENTIAL,24725,0,24725,90429,0,115154
142435800400000,SE 223,RESIDENTIAL,21367,0,21367,118696,0,140063
142435800500000,SE 223,RESIDENTIAL,21499,0,21499,106492,0,127991
142435800600000,SE 223,RESIDENTIAL,21638,0,21638,81671,0,103309
142437600100000,SE 223,RESIDENTIAL,22846,0,22846,89590,0,112436
142437600200000,SE 223,RESIDENTIAL,22800,0,22800,91046,0,113846
142437600300000,SE 223,RESIDENTIAL,22800,0,22800,103641,0,126441
142437600400000,SE 223,RESIDENTIAL,27720,0,27720,108977,0,136697
142437600500000,SE 223,RESIDENTIAL,27720,0,27720,118406,0,146126
142437600600000,SE 223,RESIDENTIAL,27720,0,27720,85526,0,113246
142437600700000,SE 223,RESIDENTIAL,27500,0,27500,90983,0,118483
142437600800000,SE 223,RESIDENTIAL,27500,0,27500,94163,0,121663
142437600900000,SE 223,RESIDENTIAL,27500,0,27500,85253,0,112753
142437601000000,SE 223,RESIDENTIAL,27553,0,27553,86051,0,113604
142437601100000,SE 223,RESIDENTIAL,23320,0,23320,101120,0,124440
142437601200000,SE 223,RESIDENTIAL,27073,0,27073,63059,0,90132
142437601300000,SE 223,RESIDENTIAL,26240,0,26240,109821,0,136061
142437601400000,SE 223,RESIDENTIAL,23548,0,23548,89798,0,113346
142437601500000,SE 223,RESIDENTIAL,23940,0,23940,107241,0,131181
142437601600000,SE 223,RESIDENTIAL,24051,0,24051,120793,0,144844
142437601700000,SE 223,RESIDENTIAL,22851,0,22851,72892,0,95743
142437601800000,SE 223,RESIDENTIAL,23328,0,23328,90750,0,114078
142437601900000,SE 223,RESIDENTIAL,23560,0,23560,100770,0,124330
142437602000000,SE 223,RESIDENTIAL,28679,0,28679,127273,0,155952
142437602100000,SE 223,RESIDENTIAL,26611,0,26611,95684,0,122295
142437602200000,SE 223,RESIDENTIAL,23501,0,23501,117423,0,140924
142437602300000,SE 223,RESIDENTIAL,22560,0,22560,111673,0,134233
142437602400000,SE 223,RESIDENTIAL,22793,0,22793,106980,0,129773
142437602500000,SE 223,RESIDENTIAL,24365,0,24365,103104,0,127469
142437602600000,SE 223,RESIDENTIAL,26825,0,26825,128019,0,154844
142437602700000,SE 223,RESIDENTIAL,26905,0,26905,141934,0,168839
142437602800000,SE 223,RESIDENTIAL,26780,0,26780,75959,0,102739
142437602900000,SE 223,RESIDENTIAL,26780,0,26780,108819,0,135599
142437603000000,SE 223,RESIDENTIAL,26780,0,26780,76788,0,103568
142437603100000,SE 223,RESIDENTIAL,26780,0,26780,119399,0,146179
142437603200000,SE 223,RESIDENTIAL,26780,0,26780,83278,0,110058
142437603300000,SE 223,RESIDENTIAL,26780,0,26780,84284,0,111064
142437603400000,SE 223,RESIDENTIAL,25868,0,25868,78067,0,103935
142437603500000,SE 223,RESIDENTIAL,25086,0,25086,89711,0,114797
142437603600000,SE 223,RESIDENTIAL,27346,0,27346,92731,0,120077
142437603700000,SE 223,RESIDENTIAL,27572,0,27572,97604,0,125176
142437603800000,SE 223,RESIDENTIAL,27572,0,27572,93147,0,120719
142437603900000,SE 223,RESIDENTIAL,23219,0,23219,103981,0,127200
142437604000000,SE 223,RESIDENTIAL,24327,0,24327,119737,0,144064
142437604100000,SE 223,RESIDENTIAL,28016,0,28016,106234,0,134250
142437604200000,SE 223,RESIDENTIAL,28044,0,28044,101100,0,129144
142437604300000,SE 223,RESIDENTIAL,23760,0,23760,78070,0,101830
142437604400000,SE 223,RESIDENTIAL,24683,0,24683,94265,0,118948
142437604500000,SE 223,RESIDENTIAL,24440,0,24440,111393,0,135833
142437604600000,SE 223,RESIDENTIAL,25503,0,25503,113538,0,139041
142437604700000,SE 223,RESIDENTIAL,28938,0,28938,111717,0,140655
142437604800000,SE 223,RESIDENTIAL,29765,0,29765,104460,0,134225
142437700100000,SE 223,RESIDENTIAL,26585,0,26585,73812,0,100397
142437700200000,SE 223,RESIDENTIAL,26585,0,26585,103577,0,130162
142437700300000,SE 223,RESIDENTIAL,26585,0,26585,71479,0,98064
142437700400000,SE 223,RESIDENTIAL,26585,0,26585,76121,0,102706
142437700500000,SE 223,RESIDENTIAL,26585,0,26585,85738,0,112323
142437700600000,SE 223,RESIDENTIAL,25987,0,25987,101084,0,127071
142437700700000,SE 223,RESIDENTIAL,25920,0,25920,89791,0,115711
142437700800000,SE 223,RESIDENTIAL,25900,0,25900,80333,0,106233
142437700900000,SE 223,RESIDENTIAL,25142,0,25142,93910,0,119052
142437701000000,SE 223,RESIDENTIAL,26385,0,26385,74141,0,100526
142437701100000,SE 223,RESIDENTIAL,26088,0,26088,113651,0,139739
142437701200000,SE 223,RESIDENTIAL,26182,0,26182,117220,0,143402
142437701300000,SE 223,RESIDENTIAL,25776,0,25776,87940,0,113716
142437701400000,SE 223,RESIDENTIAL,29469,0,29469,91422,0,120891
142437701500000,SE 223,RESIDENTIAL,30096,0,30096,110535,0,140631
142437701600000,SE 223,RESIDENTIAL,29992,0,29992,94160,0,124152
142437701700000,SE 223,RESIDENTIAL,35708,0,35708,107528,0,143236
142437701800000,SE 223,RESIDENTIAL,33152,0,33152,101978,0,135130
142437701900000,SE 223,RESIDENTIAL,33220,0,33220,107075,0,140295
142437702000000,SE 223,RESIDENTIAL,33220,0,33220,100562,0,133782
142437702100000,SE 223,RESIDENTIAL,33242,0,33242,114912,0,148154
142437702200000,SE 223,RESIDENTIAL,33242,0,33242,106288,0,139530
142437800100000,SE 223,RESIDENTIAL,33792,0,33792,146366,0,180158
142437800200000,SE 223,RESIDENTIAL,35200,0,35200,102784,0,137984
142437800300000,SE 223,RESIDENTIAL,35244,0,35244,119221,0,154465
142437800400000,SE 223,RESIDENTIAL,29788,0,29788,105000,0,134788
142437800500000,SE 223,RESIDENTIAL,26384,0,26384,111811,0,138195
142437800600000,SE 223,RESIDENTIAL,32548,0,32548,108960,0,141508
142437800700000,SE 223,RESIDENTIAL,27333,0,27333,101771,0,129104
142437800800000,SE 223,RESIDENTIAL,29229,0,29229,104455,0,133684
142437800900000,SE 223,RESIDENTIAL,30258,0,30258,83471,0,113729
142437801000000,SE 223,RESIDENTIAL,24952,0,24952,86781,0,111733
142437801100000,SE 223,RESIDENTIAL,25160,0,25160,98474,0,123634
142437801200000,SE 223,RESIDENTIAL,25452,0,25452,92356,0,117808
142437801300000,SE 223,RESIDENTIAL,25376,0,25376,107870,0,133246
142437801400000,SE 223,RESIDENTIAL,26400,0,26400,98823,0,125223
142437801500000,SE 223,RESIDENTIAL,29018,0,29018,84992,0,114010
142437801600000,SE 223,RESIDENTIAL,27986,0,27986,83848,0,111834
142437801700000,SE 223,RESIDENTIAL,29172,0,29172,100632,0,129804
142437801800000,SE 223,RESIDENTIAL,29260,0,29260,90862,0,120122
142437900100000,SE 223,RESIDENTIAL,26198,0,26198,73944,0,100142
142437900200000,SE 223,RESIDENTIAL,24192,0,24192,74942,0,99134
142437900300000,SE 223,RESIDENTIAL,23040,0,23040,112603,0,135643
142437900400000,SE 223,RESIDENTIAL,23040,0,23040,101615,0,124655
142437900500000,SE 223,RESIDENTIAL,23040,0,23040,120107,0,143147
142437900600000,SE 223,RESIDENTIAL,23040,0,23040,84943,0,107983
142437900700000,SE 223,RESIDENTIAL,23040,0,23040,109237,0,132277
142437900800000,SE 223,RESIDENTIAL,23841,0,23841,79137,0,102978
142437900900000,SE 223,RESIDENTIAL,24879,0,24879,143067,0,167946
142437901000000,SE 223,RESIDENTIAL,23040,0,23040,94505,0,117545
142437901100000,SE 223,RESIDENTIAL,23040,0,23040,85694,0,108734
142437901200000,SE 223,RESIDENTIAL,23040,0,23040,88014,0,111054
142437901300000,SE 223,RESIDENTIAL,23040,0,23040,84992,0,108032
142437901400000,SE 223,RESIDENTIAL,23040,0,23040,88473,0,111513
142437901500000,SE 223,RESIDENTIAL,24192,0,24192,84857,0,109049
142437901600000,SE 223,RESIDENTIAL,26188,0,26188,111340,0,137528
142437901700000,SE 223,RESIDENTIAL,24948,0,24948,96149,0,121097
142438000100000,SE 223,RESIDENTIAL,25615,0,25615,80230,0,105845
142438000200000,SE 223,RESIDENTIAL,25724,0,25724,88638,0,114362
142438000300000,SE 223,RESIDENTIAL,25724,0,25724,86203,0,111927
142438000400000,SE 223,RESIDENTIAL,25791,0,25791,74373,0,100164
142438000500000,SE 223,RESIDENTIAL,24471,0,24471,72938,0,97409
142438000600000,SE 223,RESIDENTIAL,24735,0,24735,91291,0,116026
142438000700000,SE 223,RESIDENTIAL,24339,0,24339,97272,0,121611
142438000800000,SE 223,RESIDENTIAL,25395,0,25395,81475,0,106870
142438000900000,SE 223,RESIDENTIAL,24576,0,24576,101426,0,126002
142438001000000,SE 223,RESIDENTIAL,24576,0,24576,84118,0,108694
142438001100000,SE 223,RESIDENTIAL,21297,0,21297,80518,0,101815
142438001200000,SE 223,RESIDENTIAL,21644,0,21644,87378,0,109022
142438001300000,SE 223,RESIDENTIAL,21597,0,21597,82105,0,103702
142438001400000,SE 223,RESIDENTIAL,20385,0,20385,87132,0,107517
142438001500000,SE 223,RESIDENTIAL,21618,0,21618,91186,0,112804
142438001600000,SE 223,RESIDENTIAL,21185,0,21185,80259,0,101444
142438001700000,SE 223,RESIDENTIAL,21275,0,21275,95801,0,117076
142438100100000,SE 223,RESIDENTIAL,26560,0,26560,120186,0,146746
142438100200000,SE 223,RESIDENTIAL,23280,0,23280,76238,0,99518
142438100300000,SE 223,RESIDENTIAL,23280,0,23280,89530,0,112810
142438100400000,SE 223,RESIDENTIAL,23280,0,23280,74420,0,97700
142438100500000,SE 223,RESIDENTIAL,23280,0,23280,93961,0,117241
142438100600000,SE 223,RESIDENTIAL,23280,0,23280,90942,0,114222
142438100700000,SE 223,RESIDENTIAL,24056,0,24056,95732,0,119788
142438100800000,SE 223,RESIDENTIAL,24806,0,24806,131509,0,156315
142438100900000,SE 223,RESIDENTIAL,21452,0,21452,92165,0,113617
142438101000000,SE 223,RESIDENTIAL,21049,0,21049,92420,0,113469
142438101100000,SE 223,RESIDENTIAL,20370,0,20370,78115,0,98485
142438101200000,SE 223,RESIDENTIAL,20370,0,20370,74434,0,94804
142438101300000,SE 223,RESIDENTIAL,20370,0,20370,81349,0,101719
142438101400000,SE 223,RESIDENTIAL,20370,0,20370,67377,0,87747
142438101500000,SE 223,RESIDENTIAL,20370,0,20370,96788,0,117158
142438101600000,SE 223,RESIDENTIAL,26880,0,26880,90031,0,116911
142438101700000,SE 223,RESIDENTIAL,25200,0,25200,107902,0,133102
142440100100000,SE 220,RESIDENTIAL,38890,0,38890,279135,0,318025
142440200100000,SE 220,RESIDENTIAL,44080,0,44080,171441,0,215521
142440200200000,SE 220,RESIDENTIAL,6700,0,6700,0,0,6700
142440200400000,SE 220,RESIDENTIAL,103820,0,103820,271858,0,375678
142440200500000,SE 220,RESIDENTIAL,152620,0,152620,476023,0,628643
142440200600000,SE 220,RESIDENTIAL,42667,0,42667,155644,0,198311
142440200700000,SE 220,RESIDENTIAL,43264,0,43264,221485,0,264749
142440200800000,SE 220,RESIDENTIAL,48336,0,48336,197629,0,245965
142440200900000,SE 220,RESIDENTIAL,63000,0,63000,228347,0,291347
142440201000000,SE 220,RESIDENTIAL,43942,0,43942,156840,0,200782
142440201100000,SE 220,RESIDENTIAL,44475,0,44475,220158,0,264633
142440201200000,SE 220,RESIDENTIAL,44080,0,44080,120980,0,165060
142440201300000,SE 220,RESIDENTIAL,41240,0,41240,159323,0,200563
142440201400000,SE 220,RESIDENTIAL,43904,0,43904,158828,0,202732
142440201500000,SE 220,RESIDENTIAL,42397,0,42397,196993,0,239390
142440201600000,SE 220,RESIDENTIAL,42960,0,42960,139636,0,182596
142440201700000,SE 220,RESIDENTIAL,46862,0,46862,154343,0,201205
142440201800000,SE 220,RESIDENTIAL,46400,0,46400,153958,0,200358
142440300100000,SE 220,RESIDENTIAL,34048,0,34048,192537,0,226585
142440300200000,SE 220,RESIDENTIAL,39342,0,39342,257216,0,296558
142440400100000,SE 220,RESIDENTIAL,33317,0,33317,150491,0,183808
142440400200000,SE 220,RESIDENTIAL,46683,0,46683,125824,0,172507
142440400300000,SE 220,RESIDENTIAL,41885,0,41885,183404,0,225289
142440400400000,SE 220,RESIDENTIAL,38443,0,38443,207720,0,246163
142440400500000,SE 220,RESIDENTIAL,35733,0,35733,232881,0,268614
142440400600000,SE 220,RESIDENTIAL,34920,0,34920,152981,0,187901
142440400700000,SE 220,RESIDENTIAL,33618,0,33618,154874,0,188492
142440400800000,SE 220,RESIDENTIAL,38216,0,38216,205526,0,243742
142440400900000,SE 220,RESIDENTIAL,37060,0,37060,202132,0,239192
142440401000000,SE 220,RESIDENTIAL,39324,0,39324,273236,0,312560
142440401100000,SE 220,RESIDENTIAL,4900,0,4900,0,0,4900
142440401200000,SE 220,RESIDENTIAL,40624,0,40624,201670,0,242294
142440401300000,SE 220,RESIDENTIAL,37595,0,37595,150447,0,188042
142442600200000,SE 220,RESIDENTIAL,80070,0,80070,204393,0,284463
142442600400000,SE 220,RESIDENTIAL,72320,0,72320,277885,0,350205
142442600500000,SE 220,RESIDENTIAL,100600,0,100600,283058,0,383658
142442600600000,SE 220,RESIDENTIAL,91300,0,91300,200964,0,292264
142442600700000,SE 220,RESIDENTIAL,106200,0,106200,249875,0,356075
142442600800000,SE 220,RESIDENTIAL,103920,0,103920,251631,0,355551
142442600900000,SE 220,RESIDENTIAL,98520,0,98520,223747,0,322267
142442601000000,SE 220,RESIDENTIAL,99800,0,99800,938059,0,1037859
142442601100000,SE 220,RESIDENTIAL,120650,0,120650,422468,0,543118
142442700100000,SE 221,RESIDENTIAL,37674,0,37674,137805,0,175479
142442700200000,SE 221,RESIDENTIAL,35390,0,35390,146484,0,181874
142442700300000,SE 221,RESIDENTIAL,33647,0,33647,130086,0,163733
142442700400000,SE 221,RESIDENTIAL,33711,0,33711,153670,0,187381
142442700500000,SE 221,RESIDENTIAL,31999,0,31999,111066,0,143065
142442700600000,SE 221,RESIDENTIAL,75457,0,75457,225178,0,300635
142442700700000,SE 221,RESIDENTIAL,50520,0,50520,0,0,50520
142442700800000,SE 221,RESIDENTIAL,68513,0,68513,245799,0,314312
142442700900000,SE 221,RESIDENTIAL,65726,0,65726,230936,0,296662
142442701000000,SE 221,RESIDENTIAL,70641,0,70641,260112,0,330753
142442701100000,SE 221,RESIDENTIAL,65767,0,65767,273764,0,339531
142442701200000,SE 223,RESIDENTIAL,50000,0,50000,102625,0,152625
142442701600000,SE 221,RESIDENTIAL,52380,0,52380,0,0,52380
142442701800000,SE 221,RESIDENTIAL,34145,0,34145,56800,0,90945
142442701900000,SE 221,RESIDENTIAL,33696,0,33696,115961,0,149657
142442702200000,SE 221,RESIDENTIAL,49150,0,49150,263352,0,312502
142442702400000,SE 221,RESIDENTIAL,32000,0,32000,139750,0,171750
142442702500000,SE 221,RESIDENTIAL,32000,0,32000,154704,0,186704
142442702600000,SE 221,RESIDENTIAL,32500,0,32500,127984,0,160484
142442702700000,SE 221,RESIDENTIAL,35401,0,35401,149462,0,184863
142442702800000,SE 221,RESIDENTIAL,38548,0,38548,154797,0,193345
142442702900000,SE 221,RESIDENTIAL,38456,0,38456,130962,0,169418
142442703000000,SE 221,RESIDENTIAL,20,0,20,0,0,20
142442703100000,SE 221,RESIDENTIAL,20,0,20,0,0,20
142442703400000,SE 221,RESIDENTIAL,62801,0,62801,213323,0,276124
142442800100000,SE 223,RESIDENTIAL,56450,0,56450,47020,0,103470
142442800200000,CITY PROPERTY,EXEMPT,0,0,0,0,0,0
142445100100000,SE 220,RESIDENTIAL,101120,0,101120,358879,0,459999
142445100200000,SE 220,RESIDENTIAL,103820,0,103820,356074,0,459894
142445100300000,SE 220,RESIDENTIAL,106820,0,106820,266585,0,373405
142445100400000,SE 220,RESIDENTIAL,102520,0,102520,318080,0,420600
142445100700000,SE 220,RESIDENTIAL,101120,0,101120,410655,0,511775
142445100800000,SE 220,RESIDENTIAL,85820,0,85820,370106,0,455926
142445100900000,SE 220,RESIDENTIAL,82340,0,82340,350717,0,433057
142445200200000,SE 223,RESIDENTIAL,5200,0,5200,0,0,5200
142445200300000,SE 223,RESIDENTIAL,30084,0,30084,77671,0,107755
142445200400000,SE 223,RESIDENTIAL,29627,0,29627,87128,0,116755
142445200500000,SE 223,RESIDENTIAL,31108,0,31108,98355,0,129463
142445200600000,SE 223,RESIDENTIAL,32832,0,32832,123600,0,156432
142445200800000,SE 221,RESIDENTIAL,32148,0,32148,130117,0,162265
142445300100000,SE 223,RESIDENTIAL,27589,0,27589,147565,0,175154
142445300200000,SE 223,RESIDENTIAL,27619,0,27619,137207,0,164826
142445300300000,SE 222,RESIDENTIAL,28408,0,28408,120824,0,149232
142445300400000,SE 223,RESIDENTIAL,28125,0,28125,155769,0,183894
142445300500000,SE 223,RESIDENTIAL,28215,0,28215,90490,0,118705
142445300600000,SE 223,RESIDENTIAL,27032,0,27032,91292,0,118324
142445300700000,SE 223,RESIDENTIAL,26784,0,26784,94040,0,120824
142445300800000,SE 223,RESIDENTIAL,26288,0,26288,107205,0,133493
142445300900000,SE 223,RESIDENTIAL,26932,0,26932,117135,0,144067
142445400100000,SE 222,RESIDENTIAL,24710,0,24710,96056,0,120766
142445400200000,SE 223,RESIDENTIAL,23775,0,23775,100211,0,123986
142445400300000,SE 223,RESIDENTIAL,23775,0,23775,103425,0,127200
142445400400000,SE 223,RESIDENTIAL,23775,0,23775,90903,0,114678
142445400500000,SE 223,RESIDENTIAL,23678,0,23678,94856,0,118534
142445400600000,SE 223,RESIDENTIAL,23873,0,23873,76185,0,100058
142445400700000,SE 223,RESIDENTIAL,24328,0,24328,118173,0,142501
142445400800000,SE 223,RESIDENTIAL,24328,0,24328,51360,0,75688
142445400900000,SE 223,RESIDENTIAL,24328,0,24328,95050,0,119378
142445401000000,SE 223,RESIDENTIAL,24230,0,24230,68269,0,92499
142447600100000,SE 220,RESIDENTIAL,40128,0,40128,188850,0,228978
142447600200000,SE 220,RESIDENTIAL,42933,0,42933,208372,0,251305
142447600300000,SE 220,RESIDENTIAL,34200,0,34200,232718,0,266918
142447600400000,SE 220,RESIDENTIAL,45798,0,45798,170603,0,216401
142447600500000,SE 220,RESIDENTIAL,13000,0,13000,47040,0,60040
142447600600000,SE 220,RESIDENTIAL,30386,0,30386,0,0,30386
142447600700000,SE 220,RESIDENTIAL,42372,0,42372,182417,0,224789
142447600800000,SE 220,RESIDENTIAL,37579,0,37579,132717,0,170296
142447600900000,SE 220,RESIDENTIAL,33368,0,33368,127963,0,161331
142447601000000,SE 220,RESIDENTIAL,32703,0,32703,126267,0,158970
142447601100000,SE 220,RESIDENTIAL,43180,0,43180,222417,0,265597
142447601200000,SE 233,RESIDENTIAL,43656,0,43656,131047,0,174703
142447601300000,SE 233,RESIDENTIAL,1200,0,1200,0,0,1200
142447601400000,SHOP,COMMERCIAL,0,76000,76000,0,44989,120989
142447601700000,SE 233,RESIDENTIAL,12400,0,12400,19381,0,31781
142447601800000,SE 233,RESIDENTIAL,11600,0,11600,20775,0,32375
142447601900000,SE 233,RESIDENTIAL,695,0,695,0,0,695
142447602000000,SE 233,RESIDENTIAL,20240,0,20240,0,0,20240
142447700100000,SE 220,RESIDENTIAL,40115,0,40115,171139,0,211254
142447700200000,SE 220,RESIDENTIAL,140020,0,140020,601862,0,741882
142447700300000,SE 220,RESIDENTIAL,100720,0,100720,315259,0,415979
142447700400000,SE 220,RESIDENTIAL,82320,0,82320,540083,0,622403
142447700500000,SE 220,RESIDENTIAL,100920,0,100920,240011,0,340931
142447700600000,SE 220,RESIDENTIAL,119820,0,119820,377383,0,497203
142447700700000,SE 220,RESIDENTIAL,103017,0,103017,292230,0,395247
142447700800000,SE 220,RESIDENTIAL,78420,0,78420,337366,0,415786
142447700900000,CITY PROPERTY,EXEMPT,0,0,0,0,0,0
142447700902000,ANTENNAS/TOWERS(BLL),COMMERCIAL,0,0,0,0,29519,29519
142447700902001,ANTENNAS/TOWERS(BLL),COMMERCIAL,0,0,0,0,38789,38789
142447701000000,SE 233,RESIDENTIAL,40950,0,40950,86723,0,127673
142447701100000,SE 233,RESIDENTIAL,40200,0,40200,48088,0,88288
142447701300000,SE 220,RESIDENTIAL,41040,0,41040,226184,0,267224
142447701400000,SE 220,RESIDENTIAL,41269,0,41269,194902,0,236171
142447701500000,SE 220,RESIDENTIAL,39179,0,39179,145288,0,184467
142447701600000,SE 220,RESIDENTIAL,39200,0,39200,142341,0,181541
142447701700000,SE 220,RESIDENTIAL,39200,0,39200,147005,0,186205
142447701800000,SE 220,RESIDENTIAL,39200,0,39200,153702,0,192902
142510100400000,SE 233,RESIDENTIAL,37640,0,37640,0,0,37640
142510100700000,SE 233,RESIDENTIAL,36500,0,36500,0,0,36500
142510100800000,SE 233,RESIDENTIAL,37000,0,37000,205183,0,242183
142510100900000,SE 233,RESIDENTIAL,37000,0,37000,0,0,37000
142510101300000,SE 233,RESIDENTIAL,52450,0,52450,181972,0,234422
142510101800000,SE 233,RESIDENTIAL,56225,0,56225,244988,0,301213
142512600100000,VACANT LAND,COMMERCIAL,0,246712,246712,0,0,246712
142512600300000,AUTO REPAIR/SALES,COMMERCIAL,0,269150,269150,0,452321,721471
142512600400000,AUTO REPAIR/SALES,COMMERCIAL,0,123020,123020,0,137395,260415
142512600500000,CARWASH,COMMERCIAL,0,91898,91898,0,159219,251117
142512600600000,OFFICE; MEDICAL,COMMERCIAL,0,132450,132450,0,532070,664520
142515100200000,SE 246,RESIDENTIAL,60160,0,60160,0,0,60160
142515100700000,SE 246,RESIDENTIAL,74356,0,74356,272683,0,347039
142515100800000,SE 246,RESIDENTIAL,73566,0,73566,460256,0,533822
142515100900000,SE 246,RESIDENTIAL,92610,0,92610,243766,0,336376
142515101000000,SE 246,RESIDENTIAL,74670,0,74670,229880,0,304550
142515101100000,SE 246,RESIDENTIAL,67900,0,67900,223522,0,291422
142515101200000,SE 246,RESIDENTIAL,70700,0,70700,247535,0,318235
142520100100000,VACANT LAND,COMMERCIAL,0,193240,193240,0,0,193240
142520100200000,LG DISCOUNT/RETAIL,COMMERCIAL,0,906680,906680,0,2543320,3450000
142520100300000,OFFICE,COMMERCIAL,0,269450,269450,0,144052,413502
142520100400000,OFFICE; MEDICAL,COMMERCIAL,0,420000,420000,0,759037,1179037
142520100500000,SE 234,RESIDENTIAL,19075,0,19075,49753,0,68828
142520100600000,SE 234,RESIDENTIAL,16975,0,16975,46430,0,63405
142520100700000,SE 234,RESIDENTIAL,16975,0,16975,57860,0,74835
142520100800000,SE 234,RESIDENTIAL,17183,0,17183,56798,0,73981
142520100900000,SE 234,RESIDENTIAL,18875,0,18875,63531,0,82406
142520101000000,SE 234,RESIDENTIAL,18321,0,18321,72263,0,90584
142520101100000,SE 234,RESIDENTIAL,19250,0,19250,76023,0,95273
142520101200000,SE 234,RESIDENTIAL,18550,0,18550,87864,0,106414
142520101300000,SE 234,RESIDENTIAL,17325,0,17325,73233,0,90558
142520101400000,SE 234,RESIDENTIAL,16263,0,16263,71651,0,87914
142520101600000,SE 234,RESIDENTIAL,19250,0,19250,85855,0,105105
142520101700000,SE 234,RESIDENTIAL,20615,0,20615,81855,0,102470
142520101800000,SE 234,RESIDENTIAL,21420,0,21420,81156,0,102576
142520101900000,SE 234,RESIDENTIAL,21099,0,21099,78647,0,99746
142520102000000,SE 234,RESIDENTIAL,19460,0,19460,90966,0,110426
142520102100000,SE 234,RESIDENTIAL,20750,0,20750,78705,0,99455
142520102200000,SE 234,RESIDENTIAL,20790,0,20790,84317,0,105107
142520102300000,SE 234,RESIDENTIAL,20790,0,20790,94136,0,114926
142520102400000,SE 234,RESIDENTIAL,20790,0,20790,78492,0,99282
142520102500000,SE 234,RESIDENTIAL,20790,0,20790,93945,0,114735
142520102600000,SE 234,RESIDENTIAL,20790,0,20790,84354,0,105144
142520102700000,SE 234,RESIDENTIAL,20790,0,20790,72792,0,93582
142520102800000,SE 234,RESIDENTIAL,20790,0,20790,93583,0,114373
142520102900000,APARTMENT,EXEMPT,0,302400,302400,0,2272182,2574582
142520200100000,SE 234,RESIDENTIAL,17325,0,17325,66644,0,83969
142520200200000,SE 234,RESIDENTIAL,15750,0,15750,57930,0,73680
142520200300000,SE 234,RESIDENTIAL,17500,0,17500,57810,0,75310
142520200400000,SE 234,RESIDENTIAL,18594,0,18594,60431,0,79025
142520200500000,SE 234,RESIDENTIAL,17500,0,17500,81361,0,98861
142520200600000,SE 234,RESIDENTIAL,17500,0,17500,81047,0,98547
142520200700000,SE 234,RESIDENTIAL,17500,0,17500,59450,0,76950
142520200800000,SE 234,RESIDENTIAL,17500,0,17500,73406,0,90906
142520200900000,SE 234,RESIDENTIAL,17500,0,17500,67721,0,85221
142520201000000,SE 234,RESIDENTIAL,17500,0,17500,81496,0,98996
142520201100000,SE 234,RESIDENTIAL,17325,0,17325,81515,0,98840
142520201200000,SE 234,RESIDENTIAL,17325,0,17325,69604,0,86929
142520201300000,SE 234,RESIDENTIAL,17500,0,17500,68769,0,86269
142520201400000,SE 234,RESIDENTIAL,17500,0,17500,85501,0,103001
142520201500000,SE 234,RESIDENTIAL,17500,0,17500,81784,0,99284
142520201600000,SE 234,RESIDENTIAL,17500,0,17500,68225,0,85725
142520201700000,SE 234,RESIDENTIAL,20118,0,20118,87769,0,107887
142520201800000,SE 234,RESIDENTIAL,20223,0,20223,84455,0,104678
142520300100000,SE 234,RESIDENTIAL,19604,0,19604,75559,0,95163
142520300200000,SE 234,RESIDENTIAL,19651,0,19651,70736,0,90387
142520300300000,SE 234,RESIDENTIAL,19297,0,19297,92641,0,111938
142520300400000,SE 234,RESIDENTIAL,19297,0,19297,86105,0,105402
142520300500000,SE 234,RESIDENTIAL,21043,0,21043,82271,0,103314
142520300600000,SE 234,RESIDENTIAL,21000,0,21000,92746,0,113746
142520300700000,SE 234,RESIDENTIAL,21000,0,21000,90675,0,111675
142520300800000,SE 234,RESIDENTIAL,21000,0,21000,85447,0,106447
142520300900000,SE 234,RESIDENTIAL,21000,0,21000,83410,0,104410
142520301000000,SE 234,RESIDENTIAL,21000,0,21000,80914,0,101914
142520301100000,SE 234,RESIDENTIAL,21000,0,21000,78512,0,99512
142520301200000,SE 234,RESIDENTIAL,21000,0,21000,86798,0,107798
142520301300000,COUNTY PROPERTY,EXEMPT,0,0,0,0,0,0
142522600100000,SE 234,RESIDENTIAL,23193,0,23193,57066,0,80259
142522600200000,SE 234,RESIDENTIAL,19950,0,19950,59095,0,79045
142522600300000,SE 234,RESIDENTIAL,17500,0,17500,81967,0,99467
142522600400000,SE 234,RESIDENTIAL,17500,0,17500,76246,0,93746
142522700100000,SE 234,RESIDENTIAL,23675,0,23675,56876,0,80551
142522700200000,SE 234,RESIDENTIAL,20506,0,20506,50468,0,70974
142522700300000,SE 234,RESIDENTIAL,21609,0,21609,50969,0,72578
142522700400000,SE 234,RESIDENTIAL,21829,0,21829,66334,0,88163
142522700500000,SE 234,RESIDENTIAL,21829,0,21829,73015,0,94844
142522700600000,HOTEL,EXEMPT,0,181710,181710,0,131810,313520
142522700700000,OFFICE,COMMERCIAL,0,64800,64800,0,100219,165019
142522700800000,SE 234,RESIDENTIAL,20947,0,20947,107748,0,128695
142522700900000,SE 234,RESIDENTIAL,19656,0,19656,78990,0,98646
142522701000000,SE 234,RESIDENTIAL,20173,0,20173,100308,0,120481
142522701100000,SE 234,RESIDENTIAL,19775,0,19775,86671,0,106446
142522701200000,SE 234,RESIDENTIAL,19775,0,19775,97853,0,117628
142522701300000,SE 234,RESIDENTIAL,19880,0,19880,89879,0,109759
142522701400000,SE 234,RESIDENTIAL,24150,0,24150,60505,0,84655
142522701500000,SE 234,RESIDENTIAL,20125,0,20125,85275,0,105400
142522701600000,SE 234,RESIDENTIAL,20125,0,20125,85772,0,105897
142522701700000,SE 234,RESIDENTIAL,20125,0,20125,72414,0,92539
142522701800000,SE 234,RESIDENTIAL,20125,0,20125,91178,0,111303
142522701900000,SE 234,RESIDENTIAL,21349,0,21349,66151,0,87500
142522702000000,SE 234,RESIDENTIAL,21397,0,21397,92415,0,113812
142522702100000,SE 234,RESIDENTIAL,25095,0,25095,106987,0,132082
142522702200000,SE 234,RESIDENTIAL,23730,0,23730,96105,0,119835
142522702300000,SE 234,RESIDENTIAL,23730,0,23730,71652,0,95382
142522702400000,SE 234,RESIDENTIAL,23822,0,23822,100479,0,124301
142522702500000,SE 234,RESIDENTIAL,21034,0,21034,91088,0,112122
142522702600000,SE 234,RESIDENTIAL,20628,0,20628,95732,0,116360
142522702700000,SE 234,RESIDENTIAL,20464,0,20464,89634,0,110098
142522702800000,SE 234,RESIDENTIAL,20974,0,20974,88860,0,109834
142522702900000,SE 234,RESIDENTIAL,20316,0,20316,87428,0,107744
142522703000000,SE 234,RESIDENTIAL,20316,0,20316,79831,0,100147
142522703100000,SE 234,RESIDENTIAL,20316,0,20316,67257,0,87573
142522703200000,SE 234,RESIDENTIAL,20532,0,20532,90634,0,111166
142522703300000,SE 234,RESIDENTIAL,21180,0,21180,82208,0,103388
142522703400000,SE 234,RESIDENTIAL,21612,0,21612,86443,0,108055
142522703500000,SE 234,RESIDENTIAL,21000,0,21000,78678,0,99678
142522703600000,SE 234,RESIDENTIAL,21000,0,21000,71194,0,92194
142522703700000,SE 234,RESIDENTIAL,21000,0,21000,76681,0,97681
142522703800000,SE 234,RESIDENTIAL,21000,0,21000,69826,0,90826
142522703900000,SE 234,RESIDENTIAL,21000,0,21000,83822,0,104822
142522704000000,SE 234,RESIDENTIAL,22050,0,22050,86825,0,108875
142522704100000,SE 234,RESIDENTIAL,23007,0,23007,95276,0,118283
142522704200000,SE 234,RESIDENTIAL,23205,0,23205,95752,0,118957
142522704300000,SE 234,RESIDENTIAL,25004,0,25004,84053,0,109057
142522704400000,SE 234,RESIDENTIAL,23230,0,23230,88219,0,111449
142522704500000,SE 234,RESIDENTIAL,21168,0,21168,63548,0,84716
142522704600000,SE 234,RESIDENTIAL,20481,0,20481,63649,0,84130
142522800100000,LG DISCOUNT/RETAIL,COMMERCIAL,0,570000,570000,0,946271,1516271
142522800200000,BRANCH BANK/CU,COMMERCIAL,0,177590,177590,0,216141,393731
142522800300000,SE 234,RESIDENTIAL,25270,0,25270,105392,0,130662
142522800400000,SE 234,RESIDENTIAL,25648,0,25648,148870,0,174518
142522800500000,SE 234,RESIDENTIAL,26375,0,26375,119818,0,146193
142522800600000,SE 234,RESIDENTIAL,20628,0,20628,123716,0,144344
142522800700000,SE 234,RESIDENTIAL,22066,0,22066,85345,0,107411
142522800800000,SE 234,RESIDENTIAL,22932,0,22932,93342,0,116274
142522800900000,SE 234,RESIDENTIAL,22823,0,22823,92395,0,115218
142522801000000,SE 234,RESIDENTIAL,21970,0,21970,104689,0,126659
142522801100000,SE 234,RESIDENTIAL,20532,0,20532,110257,0,130789
142522801200000,SE 234,RESIDENTIAL,21047,0,21047,90882,0,111929
142522801300000,SE 234,RESIDENTIAL,25096,0,25096,92505,0,117601
142522801400000,SE 234,RESIDENTIAL,20417,0,20417,84411,0,104828
142522801500000,SE 234,RESIDENTIAL,25689,0,25689,113806,0,139495
142522801600000,SE 234,RESIDENTIAL,24570,0,24570,117719,0,142289
142522801700000,SE 234,RESIDENTIAL,26205,0,26205,107502,0,133707
142522802700000,SE 234,RESIDENTIAL,21023,0,21023,83786,0,104809
142522900100000,SE 234,RESIDENTIAL,24500,0,24500,99452,0,123952
142522900200000,SE 234,RESIDENTIAL,21612,0,21612,74520,0,96132
142522900300000,SE 234,RESIDENTIAL,21612,0,21612,80033,0,101645
142522900400000,SE 234,RESIDENTIAL,22086,0,22086,68621,0,90707
142522900500000,SE 234,RESIDENTIAL,21934,0,21934,77640,0,99574
142522900600000,SE 234,RESIDENTIAL,22050,0,22050,71366,0,93416
142522900700000,SE 234,RESIDENTIAL,19744,0,19744,89807,0,109551
142522900800000,SE 234,RESIDENTIAL,20122,0,20122,90046,0,110168
142522900900000,SE 234,RESIDENTIAL,20300,0,20300,78813,0,99113
142522901000000,SE 234,RESIDENTIAL,20300,0,20300,74615,0,94915
142522901100000,SE 234,RESIDENTIAL,20300,0,20300,85307,0,105607
142522901200000,SE 234,RESIDENTIAL,20813,0,20813,97583,0,118396
142522901300000,SE 234,RESIDENTIAL,20603,0,20603,90689,0,111292
142522901400000,SE 234,RESIDENTIAL,20603,0,20603,81478,0,102081
142522901500000,SE 234,RESIDENTIAL,20603,0,20603,84586,0,105189
142522901600000,SE 234,RESIDENTIAL,20160,0,20160,89641,0,109801
142522901700000,SE 234,RESIDENTIAL,20160,0,20160,80879,0,101039
142522901800000,SE 234,RESIDENTIAL,20160,0,20160,82469,0,102629
142522901900000,SE 234,RESIDENTIAL,20131,0,20131,93578,0,113709
142522902100000,SE 234,RESIDENTIAL,21672,0,21672,85876,0,107548
142522902200000,SE 234,RESIDENTIAL,20160,0,20160,78319,0,98479
142522902300000,SE 234,RESIDENTIAL,20160,0,20160,77621,0,97781
142522902400000,SE 234,RESIDENTIAL,20160,0,20160,90924,0,111084
142522902500000,SE 234,RESIDENTIAL,20160,0,20160,90022,0,110182
142522902600000,SE 234,RESIDENTIAL,19972,0,19972,81287,0,101259
142522902700000,SE 234,RESIDENTIAL,20813,0,20813,85809,0,106622
142522902900000,SE 234,RESIDENTIAL,20300,0,20300,67432,0,87732
142522903000000,SE 234,RESIDENTIAL,20300,0,20300,85814,0,106114
142522903100000,SE 234,RESIDENTIAL,20300,0,20300,79729,0,100029
142522903200000,SE 234,RESIDENTIAL,20265,0,20265,58050,0,78315
142522903300000,SE 234,RESIDENTIAL,19600,0,19600,74246,0,93846
142522903400000,SE 234,RESIDENTIAL,22372,0,22372,66218,0,88590
142522903500000,SE 234,RESIDENTIAL,22491,0,22491,72466,0,94957
142522903600000,SE 234,RESIDENTIAL,27720,0,27720,71006,0,98726
142523000100000,SE 234,RESIDENTIAL,19874,0,19874,75798,0,95672
142523000200000,SE 234,RESIDENTIAL,21714,0,21714,79730,0,101444
142523000300000,SE 234,RESIDENTIAL,21095,0,21095,81118,0,102213
142523000400000,SE 234,RESIDENTIAL,18095,0,18095,76175,0,94270
142523000500000,SE 234,RESIDENTIAL,18673,0,18673,63123,0,81796
142523000600000,SE 234,RESIDENTIAL,19058,0,19058,78762,0,97820
142523000700000,SE 234,RESIDENTIAL,22050,0,22050,78269,0,100319
142523000800000,SE 234,RESIDENTIAL,23152,0,23152,81776,0,104928
142523000900000,SE 234,RESIDENTIAL,23769,0,23769,132998,0,156767
142523001000000,CEMETERY,EXEMPT,0,0,0,0,0,0
142523100100000,SE 234,RESIDENTIAL,20836,0,20836,106704,0,127540
142523100200000,SE 234,RESIDENTIAL,19691,0,19691,148325,0,168016
142523100300000,SE 234,RESIDENTIAL,20836,0,20836,87107,0,107943
142523100400000,SE 234,RESIDENTIAL,22500,0,22500,79579,0,102079
142523100500000,SE 234,RESIDENTIAL,22712,0,22712,101121,0,123833
142523100600000,SE 234,RESIDENTIAL,22541,0,22541,101347,0,123888
142523100700000,SE 234,RESIDENTIAL,20826,0,20826,101040,0,121866
142523100800000,SE 234,RESIDENTIAL,21714,0,21714,110782,0,132496
142523100900000,SE 234,RESIDENTIAL,22125,0,22125,95956,0,118081
142523101000000,SE 234,RESIDENTIAL,32882,0,32882,145028,0,177910
142523101100000,SE 234,RESIDENTIAL,33348,0,33348,166208,0,199556
142523101200000,SE 234,RESIDENTIAL,31422,0,31422,0,0,31422
142523101300000,SE 234,RESIDENTIAL,11052,0,11052,0,0,11052
142523101400000,SE 234,RESIDENTIAL,21723,0,21723,98146,0,119869
142523101500000,SE 234,RESIDENTIAL,21316,0,21316,103789,0,125105
142523101600000,SE 234,RESIDENTIAL,21316,0,21316,136157,0,157473
142523101700000,SE 234,RESIDENTIAL,22371,0,22371,112807,0,135178
142523101800000,SE 234,RESIDENTIAL,26932,0,26932,117053,0,143985
142523200100000,SE 234,RESIDENTIAL,18687,0,18687,0,0,18687
142523200200000,SE 234,RESIDENTIAL,30812,0,30812,320673,0,351485
142523200300000,SE 234,RESIDENTIAL,1156,0,1156,0,0,1156
142525100100000,SE 234,RESIDENTIAL,22890,0,22890,75854,0,98744
142525100200000,SE 234,RESIDENTIAL,23520,0,23520,88925,0,112445
142525100300000,SE 234,RESIDENTIAL,24150,0,24150,85858,0,110008
142525100400000,SE 234,RESIDENTIAL,22680,0,22680,77899,0,100579
142525100500000,SE 234,RESIDENTIAL,22422,0,22422,79805,0,102227
142525200100000,SE 234,RESIDENTIAL,23358,0,23358,82419,0,105777
142525200200000,SE 234,RESIDENTIAL,19869,0,19869,75664,0,95533
142525300100000,SE 234,RESIDENTIAL,22400,0,22400,81240,0,103640
142525300200000,SE 234,RESIDENTIAL,21420,0,21420,85630,0,107050
142525300300000,SE 234,RESIDENTIAL,21244,0,21244,83840,0,105084
142525300400000,SE 234,RESIDENTIAL,21000,0,21000,79945,0,100945
142525300500000,SE 234,RESIDENTIAL,21266,0,21266,85885,0,107151
142525300600000,SE 234,RESIDENTIAL,21049,0,21049,90188,0,111237
142525300700000,SE 234,RESIDENTIAL,21616,0,21616,95784,0,117400
142525300800000,SE 234,RESIDENTIAL,21834,0,21834,88741,0,110575
142525300900000,SE 234,RESIDENTIAL,20417,0,20417,90095,0,110512
142525301000000,SE 234,RESIDENTIAL,21067,0,21067,80367,0,101434
142525301100000,SE 234,RESIDENTIAL,20802,0,20802,112234,0,133036
142525301200000,SE 234,RESIDENTIAL,20802,0,20802,95622,0,116424
142525301300000,SE 234,RESIDENTIAL,20802,0,20802,85186,0,105988
142525301400000,SE 234,RESIDENTIAL,21945,0,21945,111674,0,133619
142525301500000,SE 234,RESIDENTIAL,22164,0,22164,94259,0,116423
142525301600000,SE 234,RESIDENTIAL,21840,0,21840,90351,0,112191
142525301700000,SE 234,RESIDENTIAL,21000,0,21000,94709,0,115709
142525301800000,SE 234,RESIDENTIAL,21700,0,21700,82711,0,104411
142525301900000,SE 234,RESIDENTIAL,21583,0,21583,89167,0,110750
142525302000000,SE 234,RESIDENTIAL,21265,0,21265,88404,0,109669
142525302100000,SE 234,RESIDENTIAL,20777,0,20777,96014,0,116791
142525302200000,SE 234,RESIDENTIAL,20965,0,20965,95419,0,116384
142525302300000,SE 234,RESIDENTIAL,20965,0,20965,126015,0,146980
142525302400000,SE 234,RESIDENTIAL,20965,0,20965,87915,0,108880
142525302500000,SE 234,RESIDENTIAL,20965,0,20965,80817,0,101782
142525302600000,SE 234,RESIDENTIAL,20003,0,20003,94008,0,114011
142525302700000,SE 234,RESIDENTIAL,20026,0,20026,84247,0,104273
142525302800000,SE 234,RESIDENTIAL,20211,0,20211,89979,0,110190
142525302900000,SE 234,RESIDENTIAL,20110,0,20110,71807,0,91917
142525303000000,SE 234,RESIDENTIAL,20111,0,20111,68657,0,88768
142525303100000,SE 234,RESIDENTIAL,20429,0,20429,87997,0,108426
142525400100000,SE 234,RESIDENTIAL,19784,0,19784,99637,0,119421
142525400200000,SE 234,RESIDENTIAL,29960,0,29960,183132,0,213092
142525400300000,SE 234,RESIDENTIAL,22470,0,22470,118998,0,141468
142525400400000,SE 234,RESIDENTIAL,22470,0,22470,154131,0,176601
142525400500000,SE 234,RESIDENTIAL,22470,0,22470,137737,0,160207
142525400600000,SE 234,RESIDENTIAL,22470,0,22470,156287,0,178757
142525400700000,SE 234,RESIDENTIAL,22470,0,22470,133067,0,155537
142525400800000,SE 234,RESIDENTIAL,24343,0,24343,121039,0,145382
142525400900000,SE 234,RESIDENTIAL,24491,0,24491,131389,0,155880
142525401000000,SE 234,RESIDENTIAL,24818,0,24818,170122,0,194940
142525401100000,SE 234,RESIDENTIAL,34494,0,34494,203669,0,238163
142525401200000,SE 234,RESIDENTIAL,23496,0,23496,89442,0,112938
142525401300000,SE 234,RESIDENTIAL,25780,0,25780,115253,0,141033
142525401400000,SE 234,RESIDENTIAL,23683,0,23683,104180,0,127863
142525401500000,SE 234,RESIDENTIAL,20580,0,20580,97381,0,117961
142525401600000,SE 234,RESIDENTIAL,22068,0,22068,73028,0,95096
142525401700000,SE 234,RESIDENTIAL,22260,0,22260,73474,0,95734
142525401800000,SE 234,RESIDENTIAL,24403,0,24403,117149,0,141552
142525401900000,SE 234,RESIDENTIAL,25410,0,25410,89925,0,115335
142525402000000,SE 234,RESIDENTIAL,24150,0,24150,85770,0,109920
142525402100000,SE 234,RESIDENTIAL,20790,0,20790,79938,0,100728
142525402200000,SE 234,RESIDENTIAL,22499,0,22499,86020,0,108519
142525402300000,SE 234,RESIDENTIAL,22114,0,22114,90107,0,112221
142525402400000,SE 234,RESIDENTIAL,21000,0,21000,73601,0,94601
142525402500000,SE 234,RESIDENTIAL,21000,0,21000,70206,0,91206
142525402600000,SE 234,RESIDENTIAL,21000,0,21000,75834,0,96834
142525402700000,SE 234,RESIDENTIAL,21000,0,21000,73900,0,94900
142525402800000,SE 234,RESIDENTIAL,22062,0,22062,75314,0,97376
142525402900000,SE 234,RESIDENTIAL,21829,0,21829,105405,0,127234
142525403000000,SE 234,RESIDENTIAL,21168,0,21168,107271,0,128439
142525403100000,SE 234,RESIDENTIAL,20727,0,20727,94932,0,115659
142525403200000,SE 234,RESIDENTIAL,19850,0,19850,86241,0,106091
142525403300000,SE 234,RESIDENTIAL,19740,0,19740,96452,0,116192
142525403400000,SE 234,RESIDENTIAL,19740,0,19740,80733,0,100473
142525403500000,SE 234,RESIDENTIAL,19740,0,19740,95495,0,115235
142525500100000,SE 234,RESIDENTIAL,30520,0,30520,211528,0,242048
142525500200000,SE 234,RESIDENTIAL,22890,0,22890,198561,0,221451
142525500300000,SE 234,RESIDENTIAL,22890,0,22890,0,0,22890
142525500400000,SE 234,RESIDENTIAL,22215,0,22215,211359,0,233574
142525500500000,SE 234,RESIDENTIAL,23351,0,23351,202181,0,225532
142525500600000,SE 234,RESIDENTIAL,22890,0,22890,180686,0,203576
142525500700000,SE 234,RESIDENTIAL,24798,0,24798,188473,0,213271
142525500800000,SE 234,RESIDENTIAL,24798,0,24798,153625,0,178423
142525500900000,SE 234,RESIDENTIAL,24070,0,24070,208972,0,233042
142525501000000,SE 234,RESIDENTIAL,21706,0,21706,119145,0,140851
142525501100000,SE 234,RESIDENTIAL,21210,0,21210,111978,0,133188
142525501200000,SE 234,RESIDENTIAL,21367,0,21367,83493,0,104860
142525600100000,SE 234,RESIDENTIAL,20631,0,20631,77436,0,98067
142525600200000,SE 234,RESIDENTIAL,20762,0,20762,75608,0,96370
142525600300000,SE 234,RESIDENTIAL,21037,0,21037,89806,0,110843
142525600400000,SE 234,RESIDENTIAL,21450,0,21450,78182,0,99632
142525600500000,SE 234,RESIDENTIAL,21450,0,21450,91098,0,112548
142525600600000,SE 234,RESIDENTIAL,21202,0,21202,73093,0,94295
142525600700000,SE 234,RESIDENTIAL,21532,0,21532,87249,0,108781
142525600800000,SE 234,RESIDENTIAL,21878,0,21878,94470,0,116348
142525600900000,SE 234,RESIDENTIAL,22131,0,22131,98393,0,120524
142525601000000,SE 234,RESIDENTIAL,22246,0,22246,78169,0,100415
142525601100000,SE 234,RESIDENTIAL,20972,0,20972,71670,0,92642
142525601200000,SE 234,RESIDENTIAL,20790,0,20790,84801,0,105591
142525601300000,SE 234,RESIDENTIAL,22344,0,22344,92862,0,115206
142525601400000,SE 234,RESIDENTIAL,23089,0,23089,97625,0,120714
142525601500000,SE 234,RESIDENTIAL,22050,0,22050,77524,0,99574
142525601600000,SE 234,RESIDENTIAL,21168,0,21168,84879,0,106047
142525601700000,SE 234,RESIDENTIAL,24476,0,24476,81071,0,105547
142525601800000,SE 234,RESIDENTIAL,25969,0,25969,116463,0,142432
142525601900000,SE 234,RESIDENTIAL,24038,0,24038,99985,0,124023
142525602000000,SE 234,RESIDENTIAL,23190,0,23190,132251,0,155441
142525602100000,SE 234,RESIDENTIAL,24255,0,24255,115929,0,140184
142525602200000,SE 234,RESIDENTIAL,23742,0,23742,123533,0,147275
142525602300000,SE 234,RESIDENTIAL,20727,0,20727,112277,0,133004
142525602400000,SE 234,RESIDENTIAL,21414,0,21414,96173,0,117587
142525602500000,SE 234,RESIDENTIAL,22329,0,22329,82545,0,104874
142525602600000,SE 234,RESIDENTIAL,20532,0,20532,90263,0,110795
142525602700000,SE 234,RESIDENTIAL,20370,0,20370,85737,0,106107
142525602800000,SE 234,RESIDENTIAL,20790,0,20790,66723,0,87513
142525700100000,SE 234,RESIDENTIAL,22680,0,22680,82983,0,105663
142525700200000,SE 234,RESIDENTIAL,22890,0,22890,82398,0,105288
142525700300000,SE 234,RESIDENTIAL,23653,0,23653,83223,0,106876
142525700400000,SE 234,RESIDENTIAL,22999,0,22999,79030,0,102029
142525700500000,SE 234,RESIDENTIAL,22954,0,22954,71064,0,94018
142525700600000,SE 234,RESIDENTIAL,22680,0,22680,97903,0,120583
142525700700000,SE 234,RESIDENTIAL,22050,0,22050,85744,0,107794
142525700800000,SE 234,RESIDENTIAL,23676,0,23676,80265,0,103941
142525700900000,SE 234,RESIDENTIAL,23275,0,23275,74032,0,97307
142525701000000,SE 234,RESIDENTIAL,22575,0,22575,92967,0,115542
142525701100000,SE 234,RESIDENTIAL,92400,0,92400,0,0,92400
142525800100000,SE 234,RESIDENTIAL,21000,0,21000,100770,0,121770
142525800200000,SE 234,RESIDENTIAL,21000,0,21000,93408,0,114408
142525800300000,SE 234,RESIDENTIAL,21000,0,21000,73742,0,94742
142525800400000,SE 234,RESIDENTIAL,21000,0,21000,95278,0,116278
142525800500000,SE 234,RESIDENTIAL,21000,0,21000,101002,0,122002
142525800600000,SE 234,RESIDENTIAL,20580,0,20580,94355,0,114935
142525800700000,SE 234,RESIDENTIAL,21000,0,21000,95599,0,116599
142525800800000,SE 234,RESIDENTIAL,21000,0,21000,89407,0,110407
142525800900000,SE 234,RESIDENTIAL,21000,0,21000,138016,0,159016
142525801000000,SE 234,RESIDENTIAL,20872,0,20872,100923,0,121795
142525801100000,SE 234,RESIDENTIAL,20790,0,20790,92933,0,113723
142525801200000,SE 234,RESIDENTIAL,20790,0,20790,79688,0,100478
142527600100000,SE 234,RESIDENTIAL,23452,0,23452,70694,0,94146
142527600200000,SE 234,RESIDENTIAL,21846,0,21846,121470,0,143316
142527600300000,SE 234,RESIDENTIAL,20003,0,20003,101415,0,121418
142527600400000,SE 234,RESIDENTIAL,19740,0,19740,86911,0,106651
142527600500000,SE 234,RESIDENTIAL,20727,0,20727,86772,0,107499
142527600600000,SE 234,RESIDENTIAL,20003,0,20003,99183,0,119186
142527600700000,SE 234,RESIDENTIAL,19691,0,19691,109706,0,129397
142527600800000,SE 234,RESIDENTIAL,19691,0,19691,117077,0,136768
142527600900000,SE 234,RESIDENTIAL,20003,0,20003,112889,0,132892
142527601000000,SE 234,RESIDENTIAL,19691,0,19691,83680,0,103371
142527601100000,SE 234,RESIDENTIAL,20284,0,20284,91721,0,112005
142527700100000,SE 234,RESIDENTIAL,20941,0,20941,103756,0,124697
142527700200000,SE 234,RESIDENTIAL,20790,0,20790,86597,0,107387
142527700300000,SE 234,RESIDENTIAL,20790,0,20790,80907,0,101697
142527700400000,SE 234,RESIDENTIAL,20790,0,20790,105575,0,126365
142527700500000,SE 234,RESIDENTIAL,20790,0,20790,72756,0,93546
142527700600000,SE 234,RESIDENTIAL,20790,0,20790,77797,0,98587
142527700700000,SE 234,RESIDENTIAL,21894,0,21894,87452,0,109346
142527700800000,SE 234,RESIDENTIAL,21271,0,21271,86330,0,107601
142527700900000,SE 234,RESIDENTIAL,14308,0,14308,87542,0,101850
142527701000000,SE 234,RESIDENTIAL,14787,0,14787,6292,0,21079
142527701100000,SE 234,RESIDENTIAL,21612,0,21612,96974,0,118586
142527701200000,SE 234,RESIDENTIAL,21397,0,21397,104022,0,125419
142527800100000,SE 234,RESIDENTIAL,21000,0,21000,88697,0,109697
142527800200000,SE 234,RESIDENTIAL,21000,0,21000,89229,0,110229
142527800300000,SE 234,RESIDENTIAL,21000,0,21000,71452,0,92452
142527800400000,SE 234,RESIDENTIAL,21000,0,21000,82676,0,103676
142527800500000,SE 234,RESIDENTIAL,21350,0,21350,73585,0,94935
142527800600000,SE 234,RESIDENTIAL,21495,0,21495,78382,0,99877
142527900100000,SE 234,RESIDENTIAL,21148,0,21148,73350,0,94498
142527900200000,SE 234,RESIDENTIAL,22011,0,22011,114938,0,136949
142527900300000,SE 234,RESIDENTIAL,21579,0,21579,109468,0,131047
142527900400000,SE 234,RESIDENTIAL,20808,0,20808,92431,0,113239
142527900500000,SE 234,RESIDENTIAL,20284,0,20284,84889,0,105173
142527900600000,SE 234,RESIDENTIAL,20550,0,20550,102674,0,123224
142527900700000,SE 234,RESIDENTIAL,20284,0,20284,91861,0,112145
142527900800000,SE 234,RESIDENTIAL,20284,0,20284,106348,0,126632
142527900900000,SE 234,RESIDENTIAL,20284,0,20284,86179,0,106463
142527901000000,SE 234,RESIDENTIAL,20284,0,20284,136073,0,156357
142527901100000,SE 234,RESIDENTIAL,20717,0,20717,92868,0,113585
142527901200000,SE 234,RESIDENTIAL,20472,0,20472,83831,0,104303
142527901300000,SE 234,RESIDENTIAL,20806,0,20806,82424,0,103230
142527901400000,SE 234,RESIDENTIAL,20687,0,20687,82483,0,103170
142527901500000,SE 234,RESIDENTIAL,22015,0,22015,72143,0,94158
142527901600000,SE 234,RESIDENTIAL,21700,0,21700,90961,0,112661
142527901700000,SE 234,RESIDENTIAL,21266,0,21266,99588,0,120854
142527901800000,SE 234,RESIDENTIAL,21162,0,21162,83807,0,104969
142527901900000,SE 234,RESIDENTIAL,21591,0,21591,113666,0,135257
142527902000000,SE 234,RESIDENTIAL,21325,0,21325,111978,0,133303
142527902100000,SE 234,RESIDENTIAL,21721,0,21721,82981,0,104702
142527902200000,SE 234,RESIDENTIAL,22844,0,22844,109565,0,132409
142527902300000,SE 234,RESIDENTIAL,22064,0,22064,51503,0,73567
142527902400000,SE 234,RESIDENTIAL,26162,0,26162,68839,0,95001
142527902500000,SE 234,RESIDENTIAL,20698,0,20698,97962,0,118660
142528000100000,SE 234,RESIDENTIAL,21000,0,21000,83527,0,104527
142528000200000,SE 234,RESIDENTIAL,21000,0,21000,91762,0,112762
142528000300000,SE 234,RESIDENTIAL,22253,0,22253,82299,0,104552
142528000400000,SE 234,RESIDENTIAL,23593,0,23593,122065,0,145658
142528000500000,SE 234,RESIDENTIAL,23598,0,23598,92078,0,115676
142528000600000,SE 234,RESIDENTIAL,24980,0,24980,80350,0,105330
142528000700000,SE 234,RESIDENTIAL,24918,0,24918,83475,0,108393
142528000800000,SE 234,RESIDENTIAL,24918,0,24918,89895,0,114813
142528000900000,SE 234,RESIDENTIAL,24693,0,24693,112936,0,137629
142528001000000,SE 234,RESIDENTIAL,24766,0,24766,88422,0,113188
142528001100000,SE 234,RESIDENTIAL,24150,0,24150,91802,0,115952
142528001200000,SE 234,RESIDENTIAL,23844,0,23844,71330,0,95174
142528001300000,SE 234,RESIDENTIAL,21728,0,21728,76366,0,98094
142528001400000,SE 234,RESIDENTIAL,23663,0,23663,82025,0,105688
142528001500000,SE 234,RESIDENTIAL,22925,0,22925,0,0,22925
142528001600000,SE 234,RESIDENTIAL,30500,0,30500,0,0,30500
142528001700000,SE 234,RESIDENTIAL,26705,0,26705,0,0,26705
142528001800000,SE 234,RESIDENTIAL,27000,0,27000,0,0,27000
142528001900000,SE 234,RESIDENTIAL,45815,0,45815,252518,0,298333
142528002000000,SE 234,RESIDENTIAL,27000,0,27000,0,0,27000
142528002100000,SE 234,RESIDENTIAL,26950,0,26950,0,0,26950
142528002200000,SE 234,RESIDENTIAL,52163,0,52163,259484,0,311647
142528002300000,SE 234,RESIDENTIAL,35500,0,35500,0,0,35500
142528002400000,SE 234,RESIDENTIAL,19800,0,19800,0,0,19800
142528002500000,SE 234,RESIDENTIAL,57899,0,57899,348960,0,406859
142528002600000,SE 234,RESIDENTIAL,55327,0,55327,304944,0,360271
142528002700000,SE 234,RESIDENTIAL,36580,0,36580,0,0,36580
142528002800000,SE 234,RESIDENTIAL,50000,0,50000,313355,0,363355
142528002900000,SE 234,RESIDENTIAL,60480,0,60480,346188,0,406668
142528003000000,SE 234,RESIDENTIAL,30200,0,30200,0,0,30200
142528003100000,SE 234,RESIDENTIAL,52430,0,52430,268008,0,320438
142528003200000,SE 234,RESIDENTIAL,59360,0,59360,272226,0,331586
142528003300000,CITY PROPERTY,EXEMPT,0,0,0,0,0,0
142528100100000,SE 234,RESIDENTIAL,24547,0,24547,74851,0,99398
142528100200000,SE 234,RESIDENTIAL,20293,0,20293,93315,0,113608
142528100300000,SE 234,RESIDENTIAL,20790,0,20790,66842,0,87632
142528100400000,SE 234,RESIDENTIAL,20790,0,20790,71538,0,92328
142528100500000,SE 234,RESIDENTIAL,20790,0,20790,89202,0,109992
142528100600000,SE 234,RESIDENTIAL,20790,0,20790,78840,0,99630
142528100700000,SE 234,RESIDENTIAL,20790,0,20790,104894,0,125684
142528100800000,SE 234,RESIDENTIAL,20790,0,20790,64747,0,85537
142528100900000,SE 234,RESIDENTIAL,20790,0,20790,75948,0,96738
142528101000000,SE 234,RESIDENTIAL,24806,0,24806,86495,0,111301
142528101100000,SE 234,RESIDENTIAL,22400,0,22400,74641,0,97041
142528101200000,SE 234,RESIDENTIAL,32950,0,32950,0,0,32950
142528200100000,SE 234,RESIDENTIAL,21967,0,21967,85596,0,107563
142528200200000,SE 234,RESIDENTIAL,21000,0,21000,86120,0,107120
142528200300000,SE 234,RESIDENTIAL,20626,0,20626,76691,0,97317
142528200400000,SE 234,RESIDENTIAL,20790,0,20790,79396,0,100186
142528200500000,SE 234,RESIDENTIAL,20790,0,20790,81639,0,102429
142528200600000,SE 234,RESIDENTIAL,20790,0,20790,78869,0,99659
142528200700000,SE 234,RESIDENTIAL,20790,0,20790,76761,0,97551
142528200800000,SE 234,RESIDENTIAL,20790,0,20790,77326,0,98116
142528300100000,SE 234,RESIDENTIAL,20790,0,20790,81329,0,102119
142528300200000,SE 234,RESIDENTIAL,20790,0,20790,75296,0,96086
142528400100000,SE 234,RESIDENTIAL,20790,0,20790,78782,0,99572
142528400200000,SE 234,RESIDENTIAL,24128,0,24128,111878,0,136006
142530100100000,SE 239,RESIDENTIAL,59100,0,59100,0,0,59100
142530100300000,SE 239,RESIDENTIAL,71875,0,71875,170033,0,241908
142530100400000,SE 239,RESIDENTIAL,71875,0,71875,7636,0,79511
142530100500000,SE 239,RESIDENTIAL,45392,0,45392,219993,0,265385
142530100600000,SE 239,RESIDENTIAL,42420,0,42420,183319,0,225739
142530100700000,SE 239,RESIDENTIAL,50400,0,50400,280178,0,330578
142530100800000,SE 239,RESIDENTIAL,53125,0,53125,209810,0,262935
142530100900000,SE 239,RESIDENTIAL,63913,0,63913,227741,0,291654
142530101000000,SE 239,RESIDENTIAL,60646,0,60646,244129,0,304775
142530101100000,SE 239,RESIDENTIAL,66299,0,66299,263511,0,329810
142530101200000,SE 239,RESIDENTIAL,61086,0,61086,276995,0,338081
142530101300000,SE 239,RESIDENTIAL,62160,0,62160,276691,0,338851
142530101400000,SE 239,RESIDENTIAL,54390,0,54390,214417,0,268807
142530101500000,SE 246,RESIDENTIAL,62905,0,62905,198369,0,261274
142530101600000,SE 246,RESIDENTIAL,59916,0,59916,181034,0,240950
142530101700000,SE 246,RESIDENTIAL,54920,0,54920,189941,0,244861
142530101800000,SE 246,RESIDENTIAL,58853,0,58853,6037,0,64890
142530101900000,SE 246,RESIDENTIAL,56587,0,56587,224491,0,281078
142530102000000,CITY PROPERTY,EXEMPT,0,0,0,0,0,0
142530102100000,SE 246,RESIDENTIAL,54075,0,54075,257617,0,311692
142530102200000,SE 246,RESIDENTIAL,56700,0,56700,208377,0,265077
142530102300000,SE 246,RESIDENTIAL,56021,0,56021,227848,0,283869
142530200100000,SE 239,RESIDENTIAL,45816,0,45816,163625,0,209441
142530200200000,SE 246,RESIDENTIAL,56270,0,56270,184009,0,240279
142530300100000,SE 246,RESIDENTIAL,55578,0,55578,269742,0,325320
142530300200000,SE 246,RESIDENTIAL,52020,0,52020,221235,0,273255
142530300300000,SE 246,RESIDENTIAL,53104,0,53104,235876,0,288980
142530300400000,SE 246,RESIDENTIAL,52675,0,52675,199590,0,252265
142530300500000,SE 246,RESIDENTIAL,57117,0,57117,217039,0,274156
142530300600000,SE 246,RESIDENTIAL,57120,0,57120,178583,0,235703
142530300700000,SE 246,RESIDENTIAL,55162,0,55162,263982,0,319144
142530300800000,SE 246,RESIDENTIAL,55064,0,55064,220004,0,275068
142530300900000,SE 246,RESIDENTIAL,48361,0,48361,148998,0,197359
142530301000000,SE 246,RESIDENTIAL,50190,0,50190,167687,0,217877
142532600100000,SE 239,RESIDENTIAL,125700,0,125700,0,0,125700
142532600300000,SE 239,RESIDENTIAL,49600,0,49600,79158,0,128758
142532600600000,SE 239,RESIDENTIAL,49550,0,49550,115431,0,164981
142532600700000,SE 239,RESIDENTIAL,49800,0,49800,91561,0,141361
142532600800000,SE 239,RESIDENTIAL,59300,0,59300,146807,0,206107
142532600900000,SE 239,RESIDENTIAL,40000,0,40000,109547,0,149547
142532601100000,SE 239,RESIDENTIAL,54720,0,54720,167021,0,221741
142532601200000,SE 239,RESIDENTIAL,8949,0,8949,0,0,8949
142532601300000,SE 239,RESIDENTIAL,50925,0,50925,203786,0,254711
142532601400000,SE 239,RESIDENTIAL,66126,0,66126,162485,0,228611
142532601500000,SE 239,RESIDENTIAL,54023,0,54023,185231,0,239254
142532601600000,SE 239,RESIDENTIAL,54488,0,54488,191618,0,246106
142532601700000,SE 239,RESIDENTIAL,43700,0,43700,159784,0,203484
142532601800000,SE 239,RESIDENTIAL,46332,0,46332,163727,0,210059
142532601900000,SE 239,RESIDENTIAL,51888,0,51888,167821,0,219709
142540100500000,SE 246,RESIDENTIAL,79867,0,79867,98679,0,178546
142540100600000,SE 246,RESIDENTIAL,77093,0,77093,0,0,77093
142540100700000,SE 246,RESIDENTIAL,73320,0,73320,0,0,73320
142540100800000,SE 246,RESIDENTIAL,71879,0,71879,330361,0,402240
142540100900000,SE 246,RESIDENTIAL,71265,0,71265,0,0,71265
142540101000000,SE 246,RESIDENTIAL,73283,0,73283,0,0,73283
142540101100000,SE 246,RESIDENTIAL,71658,0,71658,306502,0,378160
142540101200000,SE 246,RESIDENTIAL,115855,0,115855,293708,0,409563
142540101300000,SE 246,RESIDENTIAL,87668,0,87668,239786,0,327454
142540101400000,SE 246,RESIDENTIAL,86036,0,86036,341786,0,427822
142540101500000,SE 246,RESIDENTIAL,82311,0,82311,0,0,82311
142540101700000,SE 246,RESIDENTIAL,85061,0,85061,245532,0,330593
142540101800000,SE 246,RESIDENTIAL,88307,0,88307,246898,0,335205
142540101900000,SE 246,RESIDENTIAL,125740,0,125740,572707,0,698447
142540200100000,SE 246,RESIDENTIAL,83026,0,83026,266787,0,349813
142540200200000,SE 246,RESIDENTIAL,92232,0,92232,248341,0,340573
142540200300000,SE 246,RESIDENTIAL,82047,0,82047,240318,0,322365
142540200400000,SE 246,RESIDENTIAL,9982,0,9982,0,0,9982
142540200500000,SE 246,RESIDENTIAL,104915,0,104915,290134,0,395049
142540200600000,SE 246,RESIDENTIAL,5986,0,5986,0,0,5986
142540200700000,SE 246,RESIDENTIAL,5264,0,5264,0,0,5264
142540200800000,SE 246,RESIDENTIAL,5533,0,5533,0,0,5533
142540200900000,SE 246,RESIDENTIAL,9556,0,9556,0,0,9556
142540201000000,SE 246,RESIDENTIAL,6906,0,6906,0,0,6906
142540201100000,SE 246,RESIDENTIAL,80512,0,80512,292851,0,373363
142540201200000,SE 246,RESIDENTIAL,88920,0,88920,282529,0,371449
142540201300000,SE 246,RESIDENTIAL,97378,0,97378,352532,0,449910
142540201400000,SE 246,RESIDENTIAL,7927,0,7927,0,0,7927
142540201500000,SE 246,RESIDENTIAL,5620,0,5620,0,0,5620
142540201600000,SE 246,RESIDENTIAL,5733,0,5733,0,0,5733
142540201700000,SE 246,RESIDENTIAL,8019,0,8019,0,0,8019
142540201800000,SE 246,RESIDENTIAL,11614,0,11614,0,0,11614
142542600100000,SE 246,RESIDENTIAL,72144,0,72144,202325,0,274469
142542600200000,SE 246,RESIDENTIAL,69767,0,69767,311260,0,381027
142542600300000,SE 246,RESIDENTIAL,77880,0,77880,230836,0,308716
142542600400000,SE 246,RESIDENTIAL,73383,0,73383,234306,0,307689
142542600500000,SE 246,RESIDENTIAL,64492,0,64492,223600,0,288092
142542600600000,SE 246,RESIDENTIAL,55500,0,55500,0,0,55500
142542700100000,SE 246,RESIDENTIAL,71140,0,71140,247306,0,318446
142542700200000,SE 246,RESIDENTIAL,56862,0,56862,226863,0,283725
142542700300000,SE 246,RESIDENTIAL,55283,0,55283,237794,0,293077
142542700400000,SE 246,RESIDENTIAL,60067,0,60067,267174,0,327241
142542700500000,SE 246,RESIDENTIAL,71383,0,71383,321553,0,392936
142542700600000,SE 246,RESIDENTIAL,73523,0,73523,281457,0,354980
142542700700000,SE 246,RESIDENTIAL,71370,0,71370,233651,0,305021
142542700800000,SE 246,RESIDENTIAL,71797,0,71797,246360,0,318157
142542800100000,SE 246,RESIDENTIAL,80784,0,80784,250726,0,331510
142542800200000,SE 246,RESIDENTIAL,100100,0,100100,295293,0,395393
142542800300000,SE 246,RESIDENTIAL,57720,0,57720,233476,0,291196
142542800400000,SE 246,RESIDENTIAL,57068,0,57068,350256,0,407324
142542800500000,SE 246,RESIDENTIAL,58240,0,58240,248243,0,306483
142542800600000,SE 246,RESIDENTIAL,60600,0,60600,264473,0,325073
142542900300000,SE 246,RESIDENTIAL,125800,0,125800,0,0,125800
142542900400000,SE 246,RESIDENTIAL,60473,0,60473,201071,0,261544
142542900500000,SE 246,RESIDENTIAL,68950,0,68950,206627,0,275577
142542900600000,SE 246,RESIDENTIAL,66640,0,66640,189392,0,256032
142542900700000,SE 246,RESIDENTIAL,49000,0,49000,304430,0,353430
142542900800000,SE 246,RESIDENTIAL,49000,0,49000,203733,0,252733
142542900900000,SE 246,RESIDENTIAL,51000,0,51000,217988,0,268988
142542901000000,SE 246,RESIDENTIAL,53500,0,53500,215732,0,269232
142542901100000,CITY PROPERTY,EXEMPT,0,0,0,0,0,0
142542901200000,SE 246,RESIDENTIAL,99100,0,99100,233119,0,332219
142610100300000,NBHD SHOPPING CENTER,COMMERCIAL,0,119880,119880,0,331619,451499
142610100400000,SE 234,RESIDENTIAL,20422,0,20422,73769,0,94191
142610100500000,SE 234,RESIDENTIAL,18375,0,18375,86028,0,104403
142610100600000,SE 234,RESIDENTIAL,20370,0,20370,100420,0,120790
142610100700000,SE 234,RESIDENTIAL,21389,0,21389,78711,0,100100
142610100800000,SE 234,RESIDENTIAL,19012,0,19012,93736,0,112748
142610100900000,SE 234,RESIDENTIAL,17654,0,17654,91170,0,108824
142610101000000,SE 234,RESIDENTIAL,20962,0,20962,94119,0,115081
142610101100000,SE 234,RESIDENTIAL,21232,0,21232,53014,0,74246
142610101200000,CONVENIENCE STORE,COMMERCIAL,0,363000,363000,0,1010956,1373956
142610200100000,RESTAURANT,COMMERCIAL,0,60180,60180,0,106450,166630
142610200200000,SE 234,RESIDENTIAL,15604,0,15604,70287,0,85891
142610200300000,SE 234,RESIDENTIAL,15246,0,15246,67398,0,82644
142610200400000,SE 234,RESIDENTIAL,15581,0,15581,79171,0,94752
142610200500000,SE 234,RESIDENTIAL,16380,0,16380,76660,0,93040
142610200600000,SE 234,RESIDENTIAL,16380,0,16380,76245,0,92625
142610200700000,SE 234,RESIDENTIAL,18200,0,18200,82799,0,100999
142610200800000,SE 234,RESIDENTIAL,19845,0,19845,79691,0,99536
142610200900000,SE 234,RESIDENTIAL,19845,0,19845,49207,0,69052
142610300100000,OFFICE,COMMERCIAL,0,35559,35559,0,102909,138468
142610300200000,NBHD SHOPPING CENTER,COMMERCIAL,0,185000,185000,0,390876,575876
142610300800000,SE 234,RESIDENTIAL,15593,0,15593,39108,0,54701
142610300900000,SE 234,RESIDENTIAL,15828,0,15828,43325,0,59153
142610301000000,SE 234,RESIDENTIAL,20370,0,20370,88888,0,109258
142610301100000,SE 234,RESIDENTIAL,18673,0,18673,63345,0,82018
142610301200000,SE 234,RESIDENTIAL,24079,0,24079,97011,0,121090
142610301300000,SE 234,RESIDENTIAL,19742,0,19742,90839,0,110581
142610301400000,SE 234,RESIDENTIAL,17162,0,17162,105786,0,122948
142610301500000,SE 234,RESIDENTIAL,17394,0,17394,77993,0,95387
142610301600000,SE 234,RESIDENTIAL,14718,0,14718,69119,0,83837
142610400100000,SE 234,RESIDENTIAL,61800,0,61800,107146,0,168946
142610400400000,SE 234,RESIDENTIAL,22447,0,22447,107034,0,129481
142610400500000,SE 234,RESIDENTIAL,22624,0,22624,111876,0,134500
142610400600000,SE 234,RESIDENTIAL,22624,0,22624,108595,0,131219
142610400700000,SE 234,RESIDENTIAL,22624,0,22624,114891,0,137515
142610400800000,SE 234,RESIDENTIAL,22624,0,22624,88879,0,111503
142610400900000,SE 234,RESIDENTIAL,23013,0,23013,136987,0,160000
142610401000000,SE 234,RESIDENTIAL,20962,0,20962,87100,0,108062
142610401100000,SE 234,RESIDENTIAL,21302,0,21302,75388,0,96690
142610401200000,SE 234,RESIDENTIAL,19404,0,19404,80565,0,99969
142610401300000,SE 234,RESIDENTIAL,19312,0,19312,82838,0,102150
142610401400000,SE 234,RESIDENTIAL,19312,0,19312,82465,0,101777
142610401500000,SE 234,RESIDENTIAL,19312,0,19312,92971,0,112283
142610401600000,SE 234,RESIDENTIAL,19312,0,19312,70360,0,89672
142610401700000,SE 234,RESIDENTIAL,19312,0,19312,99063,0,118375
142610401800000,SE 234,RESIDENTIAL,55000,0,55000,163098,0,218098
142610401900000,SE 234,RESIDENTIAL,19312,0,19312,85026,0,104338
142610402000000,SE 234,RESIDENTIAL,19312,0,19312,75894,0,95206
142610402100000,SE 234,RESIDENTIAL,19312,0,19312,78227,0,97539
142610402200000,SE 234,RESIDENTIAL,19312,0,19312,82702,0,102014
142610402300000,SE 234,RESIDENTIAL,19312,0,19312,109917,0,129229
142610402400000,SE 234,RESIDENTIAL,19404,0,19404,105252,0,124656
142610402500000,SE 234,RESIDENTIAL,17658,0,17658,106182,0,123840
142610402600000,SE 234,RESIDENTIAL,18375,0,18375,73638,0,92013
142610402700000,SE 234,RESIDENTIAL,18375,0,18375,48537,0,66912
142610402800000,SE 234,RESIDENTIAL,18375,0,18375,78647,0,97022
142610402900000,SE 234,RESIDENTIAL,18375,0,18375,104608,0,122983
142610403000000,SE 234,RESIDENTIAL,18375,0,18375,72322,0,90697
142610403100000,SE 234,RESIDENTIAL,18375,0,18375,68970,0,87345
142610403200000,SE 234,RESIDENTIAL,18375,0,18375,73672,0,92047
142610403300000,SE 234,RESIDENTIAL,18375,0,18375,115461,0,133836
142610403400000,SE 234,RESIDENTIAL,18375,0,18375,66576,0,84951
142610403500000,SE 234,RESIDENTIAL,25725,0,25725,111408,0,137133
142610403600000,SE 234,RESIDENTIAL,18375,0,18375,98281,0,116656
142610403700000,SE 234,RESIDENTIAL,24240,0,24240,66991,0,91231
142610403800000,SE 234,RESIDENTIAL,23520,0,23520,84061,0,107581
142610403900000,SE 234,RESIDENTIAL,23429,0,23429,80169,0,103598
142610404000000,SE 234,RESIDENTIAL,31238,0,31238,110737,0,141975
142610404100000,SE 234,RESIDENTIAL,30904,0,30904,119635,0,150539
142610500100000,SE 234,RESIDENTIAL,21000,0,21000,75199,0,96199
142610500200000,SE 234,RESIDENTIAL,21000,0,21000,64276,0,85276
142610500300000,SE 234,RESIDENTIAL,21000,0,21000,73033,0,94033
142610500400000,SE 234,RESIDENTIAL,21268,0,21268,61959,0,83227
142610500500000,SE 234,RESIDENTIAL,18200,0,18200,77075,0,95275
142610500600000,SE 234,RESIDENTIAL,17640,0,17640,85801,0,103441
142610500700000,SE 234,RESIDENTIAL,18900,0,18900,81276,0,100176
142610500800000,SE 234,RESIDENTIAL,19250,0,19250,91431,0,110681
142610500900000,SE 234,RESIDENTIAL,19425,0,19425,68827,0,88252
142610501000000,SE 234,RESIDENTIAL,24767,0,24767,114428,0,139195
142610501100000,SE 234,RESIDENTIAL,24544,0,24544,94576,0,119120
142610501200000,SE 234,RESIDENTIAL,23348,0,23348,105285,0,128633
142610501300000,SE 234,RESIDENTIAL,23323,0,23323,75639,0,98962
142610501400000,SE 234,RESIDENTIAL,18725,0,18725,65734,0,84459
142610501500000,SE 234,RESIDENTIAL,18725,0,18725,53467,0,72192
142610501600000,SE 234,RESIDENTIAL,18725,0,18725,85780,0,104505
142610501700000,SE 234,RESIDENTIAL,18725,0,18725,73342,0,92067
142610501800000,SE 234,RESIDENTIAL,18725,0,18725,77931,0,96656
142610501900000,SE 234,RESIDENTIAL,18725,0,18725,73062,0,91787
142610502000000,SE 234,RESIDENTIAL,18725,0,18725,80287,0,99012
142610502100000,SE 234,RESIDENTIAL,18725,0,18725,84500,0,103225
142610502200000,SE 234,RESIDENTIAL,18725,0,18725,72310,0,91035
142610600100000,SE 234,RESIDENTIAL,22021,0,22021,116855,0,138876
142610600200000,SE 234,RESIDENTIAL,24544,0,24544,112396,0,136940
142610600300000,SE 234,RESIDENTIAL,21683,0,21683,86826,0,108509
142610600400000,SE 234,RESIDENTIAL,26749,0,26749,117738,0,144487
142610600500000,SE 234,RESIDENTIAL,20159,0,20159,62689,0,82848
142610600600000,SE 234,RESIDENTIAL,18850,0,18850,76476,0,95326
142610600700000,SE 234,RESIDENTIAL,17273,0,17273,69081,0,86354
142610600800000,SE 234,RESIDENTIAL,19944,0,19944,66337,0,86281
142610600900000,SE 234,RESIDENTIAL,20100,0,20100,81370,0,101470
142610601000000,SE 234,RESIDENTIAL,16853,0,16853,82665,0,99518
142610601100000,SE 234,RESIDENTIAL,17010,0,17010,59744,0,76754
142610601200000,SE 234,RESIDENTIAL,21252,0,21252,108334,0,129586
142610601300000,SE 234,RESIDENTIAL,21352,0,21352,79093,0,100445
142610700100000,SE 234,RESIDENTIAL,22384,0,22384,72641,0,95025
142610700200000,SE 234,RESIDENTIAL,17850,0,17850,58291,0,76141
142610700300000,SE 234,RESIDENTIAL,17850,0,17850,82364,0,100214
142610700400000,SE 234,RESIDENTIAL,18200,0,18200,75268,0,93468
142610700500000,SE 234,RESIDENTIAL,18375,0,18375,69360,0,87735
142610700600000,SE 234,RESIDENTIAL,18900,0,18900,109279,0,128179
142610700700000,SE 234,RESIDENTIAL,23593,0,23593,120003,0,143596
142610700800000,SE 234,RESIDENTIAL,23593,0,23593,74210,0,97803
142610700900000,SE 234,RESIDENTIAL,20598,0,20598,69049,0,89647
142610701000000,SE 234,RESIDENTIAL,20405,0,20405,77242,0,97647
142610701100000,SE 234,RESIDENTIAL,36571,0,36571,118157,0,154728
142610800100000,SE 234,RESIDENTIAL,17640,0,17640,82427,0,100067
142610800200000,SE 234,RESIDENTIAL,25490,0,25490,89177,0,114667
142610800300000,SE 234,RESIDENTIAL,22204,0,22204,93227,0,115431
142610800400000,SE 234,RESIDENTIAL,22099,0,22099,115902,0,138001
142610800500000,SE 234,RESIDENTIAL,22857,0,22857,135025,0,157882
142610800600000,SE 234,RESIDENTIAL,21875,0,21875,81961,0,103836
142610800700000,SE 234,RESIDENTIAL,31031,0,31031,128215,0,159246
142610800800000,SE 234,RESIDENTIAL,30380,0,30380,107774,0,138154
142610800900000,SE 234,RESIDENTIAL,18725,0,18725,72159,0,90884
142610801000000,SE 234,RESIDENTIAL,23875,0,23875,92147,0,116022
142610801100000,SE 234,RESIDENTIAL,23875,0,23875,105086,0,128961
142610801200000,SE 234,RESIDENTIAL,25660,0,25660,108476,0,134136
142610801300000,SE 234,RESIDENTIAL,25660,0,25660,77568,0,103228
142612600100000,OFFICE,COMMERCIAL,0,92400,92400,0,271935,364335
142612600200000,OFFICE,COMMERCIAL,0,225000,225000,0,323832,548832
142612600300000,RESTAURANT,COMMERCIAL,0,151200,151200,0,230441,381641
142612600400000,SE 234,RESIDENTIAL,27709,0,27709,112447,0,140156
142612600500000,SMALL RETAIL,COMMERCIAL,0,101088,101088,0,66786,167874
142612600600000,SMALL RETAIL,COMMERCIAL,0,36187,36187,0,95024,131211
142612600700000,SMALL RETAIL,COMMERCIAL,0,52080,52080,0,427134,479214
142612600800000,SE 234,RESIDENTIAL,32149,0,32149,78458,0,110607
142612600900000,SE 234,RESIDENTIAL,20299,0,20299,83531,0,103830
142612601000000,SE 234,RESIDENTIAL,22260,0,22260,92851,0,115111
142612601100000,SE 234,RESIDENTIAL,21420,0,21420,116868,0,138288
142612601200000,SE 234,RESIDENTIAL,21420,0,21420,137884,0,159304
142612601300000,SE 234,RESIDENTIAL,20353,0,20353,114278,0,134631
142612601400000,SE 234,RESIDENTIAL,21756,0,21756,126331,0,148087
142612601500000,SE 234,RESIDENTIAL,21436,0,21436,94995,0,116431
142612601600000,SE 234,RESIDENTIAL,21896,0,21896,127304,0,149200
142612601700000,SE 234,RESIDENTIAL,21488,0,21488,142465,0,163953
142612601800000,SE 234,RESIDENTIAL,20065,0,20065,100050,0,120115
142612601900000,SE 234,RESIDENTIAL,20316,0,20316,116332,0,136648
142612602000000,SE 234,RESIDENTIAL,20317,0,20317,106099,0,126416
142612602100000,SE 234,RESIDENTIAL,22477,0,22477,87604,0,110081
142612602200000,SE 234,RESIDENTIAL,20020,0,20020,88938,0,108958
142612602300000,SE 234,RESIDENTIAL,20020,0,20020,96140,0,116160
142612602400000,SE 234,RESIDENTIAL,20020,0,20020,108431,0,128451
142612602500000,SE 234,RESIDENTIAL,20020,0,20020,115346,0,135366
142612602600000,SE 234,RESIDENTIAL,20020,0,20020,88561,0,108581
142612602700000,SE 234,RESIDENTIAL,20020,0,20020,71673,0,91693
142612602800000,SE 234,RESIDENTIAL,20020,0,20020,105793,0,125813
142612602900000,SE 234,RESIDENTIAL,20020,0,20020,86149,0,106169
142612603000000,SE 234,RESIDENTIAL,20020,0,20020,68653,0,88673
142612603100000,SE 234,RESIDENTIAL,20020,0,20020,85223,0,105243
142612603200000,SE 234,RESIDENTIAL,20020,0,20020,51590,0,71610
142612603300000,SE 234,RESIDENTIAL,20020,0,20020,76032,0,96052
142612603400000,CITY PROPERTY,EXEMPT,0,0,0,0,0,0
142612603500000,SE 234,RESIDENTIAL,21441,0,21441,72565,0,94006
142612603600000,SE 234,RESIDENTIAL,20573,0,20573,99150,0,119723
142612603700000,SE 234,RESIDENTIAL,20573,0,20573,88239,0,108812
142612603800000,SE 234,RESIDENTIAL,20573,0,20573,62568,0,83141
142612603900000,SE 234,RESIDENTIAL,20573,0,20573,67298,0,87871
142612604000000,SE 234,RESIDENTIAL,20573,0,20573,83382,0,103955
142612604100000,SE 234,RESIDENTIAL,20573,0,20573,81212,0,101785
142612604200000,SE 234,RESIDENTIAL,21206,0,21206,80334,0,101540
142612604300000,SE 234,RESIDENTIAL,21420,0,21420,97629,0,119049
142612604400000,SE 234,RESIDENTIAL,22057,0,22057,75957,0,98014
142612604500000,SE 234,RESIDENTIAL,22214,0,22214,72124,0,94338
142612604600000,SE 234,RESIDENTIAL,22006,0,22006,73375,0,95381
142612604700000,SE 234,RESIDENTIAL,21945,0,21945,76043,0,97988
142612604800000,SE 234,RESIDENTIAL,21848,0,21848,81096,0,102944
142612604900000,SE 234,RESIDENTIAL,22890,0,22890,64073,0,86963
142612605000000,SE 234,RESIDENTIAL,22588,0,22588,127920,0,150508
142612605100000,SE 234,RESIDENTIAL,22090,0,22090,96051,0,118141
142612605200000,SE 234,RESIDENTIAL,22382,0,22382,113446,0,135828
142612605300000,SE 234,RESIDENTIAL,23925,0,23925,117918,0,141843
142612605400000,SE 234,RESIDENTIAL,20751,0,20751,79318,0,100069
142612605500000,SE 234,RESIDENTIAL,21168,0,21168,84997,0,106165
142612605600000,SE 234,RESIDENTIAL,20965,0,20965,84417,0,105382
142612605700000,SE 234,RESIDENTIAL,21397,0,21397,78878,0,100275
142612605800000,SE 234,RESIDENTIAL,21945,0,21945,68360,0,90305
142612605900000,SE 234,RESIDENTIAL,40500,0,40500,136562,0,177062
142612606000000,SE 234,RESIDENTIAL,25725,0,25725,105966,0,131691
142612606100000,SE 234,RESIDENTIAL,23054,0,23054,102031,0,125085
142612700100000,SMALL RETAIL,COMMERCIAL,0,76440,76440,0,85391,161831
142612700200000,LG DISCOUNT/RETAIL,COMMERCIAL,0,577500,577500,0,1074041,1651541
142612700300000,VETERINARY CLINIC,COMMERCIAL,0,83250,83250,0,207313,290563
142612700600000,SE 234,RESIDENTIAL,27212,0,27212,74999,0,102211
142612700700000,SE 234,RESIDENTIAL,27212,0,27212,82602,0,109814
142612700800000,SE 234,RESIDENTIAL,27212,0,27212,91006,0,118218
142612700900000,SE 234,RESIDENTIAL,26553,0,26553,79173,0,105726
142612701000000,SE 234,RESIDENTIAL,21343,0,21343,117469,0,138812
142612701100000,SE 234,RESIDENTIAL,20748,0,20748,103289,0,124037
142612701200000,SE 234,RESIDENTIAL,22932,0,22932,90272,0,113204
142612701300000,SE 234,RESIDENTIAL,22477,0,22477,84404,0,106881
142612701400000,SE 234,RESIDENTIAL,21840,0,21840,106897,0,128737
142612701500000,SE 234,RESIDENTIAL,21250,0,21250,75794,0,97044
142612701600000,SE 234,RESIDENTIAL,21840,0,21840,84364,0,106204
142612701700000,SE 234,RESIDENTIAL,21840,0,21840,85585,0,107425
142612701800000,SE 234,RESIDENTIAL,22477,0,22477,106710,0,129187
142612701900000,SE 234,RESIDENTIAL,23227,0,23227,89630,0,112857
142612702000000,SE 234,RESIDENTIAL,22932,0,22932,86129,0,109061
142612702100000,SE 234,RESIDENTIAL,25725,0,25725,74787,0,100512
142612702200000,SE 234,RESIDENTIAL,22694,0,22694,128707,0,151401
142612702300000,CENTRALLY ASSESSED,OTHER,0,0,0,0,0,0
142612702400000,FLAT PARKING,COMMERCIAL,0,8838,8838,0,3528,12366
142612702500000,FLAT PARKING,COMMERCIAL,0,40576,40576,0,11341,51917
142612702600000,SE 234,RESIDENTIAL,24806,0,24806,53525,0,78331
142612702700000,APARTMENT,COMMERCIAL,0,13500,13500,0,132360,145860
142612702900000,APARTMENT,COMMERCIAL,0,212000,212000,0,1871935,2083935
142612703000000,SE 234,RESIDENTIAL,32107,0,32107,53809,0,85916
142612800100000,SE 234,RESIDENTIAL,24642,0,24642,95687,0,120329
142612800200000,SE 234,RESIDENTIAL,22386,0,22386,85584,0,107970
142612800300000,SE 234,RESIDENTIAL,23532,0,23532,130896,0,154428
142612800400000,SE 234,RESIDENTIAL,23398,0,23398,78552,0,101950
142612800500000,SE 234,RESIDENTIAL,22407,0,22407,91097,0,113504
142612800600000,SE 234,RESIDENTIAL,20639,0,20639,112922,0,133561
142612800700000,SE 234,RESIDENTIAL,23757,0,23757,110167,0,133924
142612800800000,SE 234,RESIDENTIAL,25188,0,25188,94793,0,119981
142612800900000,SE 234,RESIDENTIAL,20151,0,20151,98396,0,118547
142612801000000,SE 234,RESIDENTIAL,20370,0,20370,100590,0,120960
142612801100000,SE 234,RESIDENTIAL,20790,0,20790,72222,0,93012
142612801200000,SE 234,RESIDENTIAL,21210,0,21210,87523,0,108733
142612801300000,SE 234,RESIDENTIAL,21420,0,21420,78353,0,99773
142612801400000,SE 234,RESIDENTIAL,21840,0,21840,81288,0,103128
142612801500000,SE 234,RESIDENTIAL,22930,0,22930,91907,0,114837
142612801600000,SE 234,RESIDENTIAL,22477,0,22477,70186,0,92663
142612801700000,SE 234,RESIDENTIAL,22694,0,22694,89476,0,112170
142612801800000,SE 234,RESIDENTIAL,22694,0,22694,73673,0,96367
142612801900000,SE 234,RESIDENTIAL,22458,0,22458,96588,0,119046
142612802000000,SE 234,RESIDENTIAL,22315,0,22315,95271,0,117586
142615100100000,SE 234,RESIDENTIAL,22332,0,22332,81069,0,103401
142615100200000,SE 234,RESIDENTIAL,21840,0,21840,81972,0,103812
142615100300000,SE 234,RESIDENTIAL,21840,0,21840,85931,0,107771
142615100400000,SE 234,RESIDENTIAL,21840,0,21840,75051,0,96891
142615100500000,SE 234,RESIDENTIAL,21840,0,21840,77293,0,99133
142615100600000,SE 234,RESIDENTIAL,21840,0,21840,110973,0,132813
142615100700000,SE 234,RESIDENTIAL,21840,0,21840,80647,0,102487
142615100800000,SE 234,RESIDENTIAL,21840,0,21840,73862,0,95702
142615100900000,SE 234,RESIDENTIAL,24484,0,24484,100142,0,124626
142615101000000,SE 234,RESIDENTIAL,21054,0,21054,64964,0,86018
142615101100000,SE 234,RESIDENTIAL,21476,0,21476,90489,0,111965
142615101200000,SE 234,RESIDENTIAL,21476,0,21476,73644,0,95120
142615101300000,SE 234,RESIDENTIAL,21935,0,21935,68537,0,90472
142615101400000,SE 234,RESIDENTIAL,20460,0,20460,85818,0,106278
142615101500000,SE 234,RESIDENTIAL,24465,0,24465,102942,0,127407
142615101600000,SE 234,RESIDENTIAL,21840,0,21840,89734,0,111574
142615101700000,SE 234,RESIDENTIAL,21840,0,21840,100764,0,122604
142615101800000,SE 234,RESIDENTIAL,21840,0,21840,101533,0,123373
142615101900000,SE 234,RESIDENTIAL,21840,0,21840,103272,0,125112
142615102000000,SE 234,RESIDENTIAL,21840,0,21840,79443,0,101283
142615102100000,SE 234,RESIDENTIAL,21840,0,21840,121464,0,143304
142615102200000,SE 234,RESIDENTIAL,21840,0,21840,90532,0,112372
142615102300000,SE 234,RESIDENTIAL,21000,0,21000,105773,0,126773
142615102400000,SE 234,RESIDENTIAL,21000,0,21000,78080,0,99080
142615102500000,SE 234,RESIDENTIAL,22332,0,22332,88994,0,111326
142615200100000,SE 234,RESIDENTIAL,19604,0,19604,88849,0,108453
142615200200000,SE 234,RESIDENTIAL,20947,0,20947,97721,0,118668
142615200300000,SE 234,RESIDENTIAL,21531,0,21531,85370,0,106901
142615200400000,SE 234,RESIDENTIAL,19950,0,19950,97899,0,117849
142615200500000,SE 234,RESIDENTIAL,19950,0,19950,110921,0,130871
142615200600000,SE 234,RESIDENTIAL,16625,0,16625,76649,0,93274
142615200700000,SE 234,RESIDENTIAL,20766,0,20766,87934,0,108700
142615300100000,SE 234,RESIDENTIAL,21658,0,21658,82394,0,104052
142615300200000,SE 234,RESIDENTIAL,22994,0,22994,61735,0,84729
142615300300000,SE 234,RESIDENTIAL,22495,0,22495,82294,0,104789
142615300400000,SE 234,RESIDENTIAL,23296,0,23296,115039,0,138335
142615300500000,SE 234,RESIDENTIAL,21728,0,21728,95976,0,117704
142615300600000,SE 234,RESIDENTIAL,19712,0,19712,95983,0,115695
142615300700000,SE 234,RESIDENTIAL,17034,0,17034,84236,0,101270
142615300800000,SE 234,RESIDENTIAL,20580,0,20580,87891,0,108471
142615300900000,SE 234,RESIDENTIAL,19294,0,19294,64502,0,83796
142615301000000,SE 234,RESIDENTIAL,21670,0,21670,69492,0,91162
142615301100000,SE 234,RESIDENTIAL,25452,0,25452,91082,0,116534
142615301200000,SE 234,RESIDENTIAL,21349,0,21349,80504,0,101853
142615301300000,SE 234,RESIDENTIAL,21759,0,21759,89277,0,111036
142615301400000,SE 234,RESIDENTIAL,21434,0,21434,87662,0,109096
142615301500000,SE 234,RESIDENTIAL,21000,0,21000,56756,0,77756
142615301600000,SE 234,RESIDENTIAL,21000,0,21000,71954,0,92954
142615301700000,SE 234,RESIDENTIAL,21000,0,21000,87809,0,108809
142615301800000,SE 234,RESIDENTIAL,21000,0,21000,88692,0,109692
142615400100000,SE 234,RESIDENTIAL,20296,0,20296,91094,0,111390
142615400200000,SE 234,RESIDENTIAL,19950,0,19950,83240,0,103190
142615400300000,SE 234,RESIDENTIAL,19950,0,19950,95603,0,115553
142615400400000,SE 234,RESIDENTIAL,19950,0,19950,90272,0,110222
142615400500000,SE 234,RESIDENTIAL,19950,0,19950,68029,0,87979
142615400600000,SE 234,RESIDENTIAL,19950,0,19950,90072,0,110022
142615400700000,SE 234,RESIDENTIAL,20098,0,20098,91716,0,111814
142615400800000,SE 234,RESIDENTIAL,21970,0,21970,116179,0,138149
142615400900000,SE 234,RESIDENTIAL,24003,0,24003,111832,0,135835
142615401000000,SE 234,RESIDENTIAL,22312,0,22312,105617,0,127929
142615401100000,SE 234,RESIDENTIAL,22015,0,22015,76110,0,98125
142615401200000,SE 234,RESIDENTIAL,24150,0,24150,104561,0,128711
142615401300000,SE 234,RESIDENTIAL,22676,0,22676,119567,0,142243
142615401400000,SE 234,RESIDENTIAL,22491,0,22491,120584,0,143075
142615401500000,SE 234,RESIDENTIAL,21974,0,21974,86729,0,108703
142615500100000,SE 234,RESIDENTIAL,19600,0,19600,96224,0,115824
142615500200000,SE 234,RESIDENTIAL,19600,0,19600,109136,0,128736
142615500300000,SE 234,RESIDENTIAL,23128,0,23128,87575,0,110703
142615500400000,SE 234,RESIDENTIAL,27329,0,27329,131048,0,158377
142615500500000,SE 234,RESIDENTIAL,32025,0,32025,128052,0,160077
142615500600000,SE 234,RESIDENTIAL,40425,0,40425,164406,0,204831
142615500700000,SE 234,RESIDENTIAL,40125,0,40125,162340,0,202465
142615500800000,SE 234,RESIDENTIAL,21105,0,21105,143765,0,164870
142615500900000,SE 234,RESIDENTIAL,22863,0,22863,81625,0,104488
142615501000000,SE 234,RESIDENTIAL,27485,0,27485,98659,0,126144
142615501100000,SE 234,RESIDENTIAL,42650,0,42650,201144,0,243794
142615501200000,SE 234,RESIDENTIAL,30176,0,30176,183559,0,213735
142615501300000,SE 234,RESIDENTIAL,28239,0,28239,100751,0,128990
142615501400000,SE 234,RESIDENTIAL,23625,0,23625,114074,0,137699
142615501500000,SE 234,RESIDENTIAL,21848,0,21848,106617,0,128465
142615501600000,SE 234,RESIDENTIAL,21896,0,21896,85510,0,107406
142615501700000,SE 234,RESIDENTIAL,22491,0,22491,133799,0,156290
142615501800000,SE 234,RESIDENTIAL,25942,0,25942,84509,0,110451
142615501900000,SE 234,RESIDENTIAL,26578,0,26578,94651,0,121229
142615502000000,SE 234,RESIDENTIAL,19899,0,19899,81530,0,101429
142615502100000,SE 234,RESIDENTIAL,20032,0,20032,84530,0,104562
142615502200000,SE 234,RESIDENTIAL,40650,0,40650,79560,0,120210
142615502300000,SE 234,RESIDENTIAL,24471,0,24471,159665,0,184136
142615502400000,SE 234,RESIDENTIAL,41575,0,41575,277214,0,318789
142615502500000,SE 234,RESIDENTIAL,46975,0,46975,55730,0,102705
142615502600000,SE 234,RESIDENTIAL,27328,0,27328,73812,0,101140
142615502700000,SE 234,RESIDENTIAL,41075,0,41075,63779,0,104854
142615502800000,SE 234,RESIDENTIAL,31381,0,31381,44744,0,76125
142615502900000,SE 234,RESIDENTIAL,21612,0,21612,80576,0,102188
142615503000000,SE 234,RESIDENTIAL,21612,0,21612,74802,0,96414
142617600100000,SE 234,RESIDENTIAL,27204,0,27204,154705,0,181909
142617600200000,SE 234,RESIDENTIAL,17920,0,17920,70267,0,88187
142617600300000,SE 234,RESIDENTIAL,22958,0,22958,90409,0,113367
142617600400000,SE 234,RESIDENTIAL,36375,0,36375,125636,0,162011
142617600500000,SE 234,RESIDENTIAL,38050,0,38050,141495,0,179545
142617600600000,SE 234,RESIDENTIAL,36125,0,36125,106071,0,142196
142617600700000,SE 234,RESIDENTIAL,24244,0,24244,149197,0,173441
142617600800000,SE 234,RESIDENTIAL,24721,0,24721,105465,0,130186
142617600900000,SE 234,RESIDENTIAL,22927,0,22927,84415,0,107342
142617601000000,SE 234,RESIDENTIAL,23043,0,23043,126342,0,149385
142617601100000,SE 234,RESIDENTIAL,22384,0,22384,90201,0,112585
142617601200000,SE 234,RESIDENTIAL,23701,0,23701,98393,0,122094
142617601300000,CITY PROPERTY,EXEMPT,0,0,0,0,0,0
142617601400000,SE 234,RESIDENTIAL,18480,0,18480,122174,0,140654
142617601500000,SE 234,RESIDENTIAL,18480,0,18480,125494,0,143974
142617601600000,SE 234,RESIDENTIAL,18391,0,18391,92285,0,110676
142617601700000,SE 234,RESIDENTIAL,20790,0,20790,80564,0,101354
142617601800000,SE 234,RESIDENTIAL,20884,0,20884,87304,0,108188
142617601900000,SE 234,RESIDENTIAL,24206,0,24206,106637,0,130843
142617602000000,SE 234,RESIDENTIAL,22050,0,22050,81536,0,103586
142617602100000,SE 234,RESIDENTIAL,22233,0,22233,114852,0,137085
142617602200000,SE 234,RESIDENTIAL,34839,0,34839,108987,0,143826
142617602300000,SE 234,RESIDENTIAL,29371,0,29371,73042,0,102413
142617602400000,SE 234,RESIDENTIAL,32073,0,32073,143526,0,175599
142617602500000,SE 234,RESIDENTIAL,27783,0,27783,125668,0,153451
142617602600000,SE 234,RESIDENTIAL,30666,0,30666,165048,0,195714
142617603100000,SE 234,RESIDENTIAL,25439,0,25439,108005,0,133444
142617603200000,SE 234,RESIDENTIAL,25725,0,25725,134663,0,160388
142617603400000,SCHOOL,EXEMPT,0,0,0,0,0,0
142617603500000,SE 234,RESIDENTIAL,24742,0,24742,156803,0,181545
142617603600000,SE 234,RESIDENTIAL,23880,0,23880,0,0,23880
142617603700000,SE 234,RESIDENTIAL,24978,0,24978,0,0,24978
142617603800000,SE 234,RESIDENTIAL,21233,0,21233,0,0,21233
142617603900000,SE 234,RESIDENTIAL,21192,0,21192,127902,0,149094
142617604000000,SE 234,RESIDENTIAL,19437,0,19437,116908,0,136345
142617700100000,SE 234,RESIDENTIAL,25291,0,25291,86746,0,112037
142617700200000,SE 234,RESIDENTIAL,23205,0,23205,104881,0,128086
142617700300000,SE 234,RESIDENTIAL,25175,0,25175,74866,0,100041
142617700400000,SE 234,RESIDENTIAL,26050,0,26050,105806,0,131856
142617700500000,SE 234,RESIDENTIAL,25935,0,25935,85024,0,110959
142617700600000,SE 234,RESIDENTIAL,27626,0,27626,72965,0,100591
142617700700000,SE 234,RESIDENTIAL,25760,0,25760,153186,0,178946
142617700900000,SE 234,RESIDENTIAL,22365,0,22365,111441,0,133806
142617701000000,SE 234,RESIDENTIAL,22050,0,22050,102304,0,124354
142617701100000,SE 234,RESIDENTIAL,19413,0,19413,119773,0,139186
142617701200000,SE 234,RESIDENTIAL,20230,0,20230,69243,0,89473
142617701400000,SE 234,RESIDENTIAL,26698,0,26698,78049,0,104747
142617701500000,SE 234,RESIDENTIAL,23205,0,23205,63509,0,86714
142617800100000,SE 234,RESIDENTIAL,23850,0,23850,108852,0,132702
142617800200000,SE 234,RESIDENTIAL,21829,0,21829,69826,0,91655
142617800300000,SE 234,RESIDENTIAL,21777,0,21777,109958,0,131735
142617800400000,SE 234,RESIDENTIAL,21819,0,21819,80321,0,102140
142617800500000,SE 234,RESIDENTIAL,20709,0,20709,75866,0,96575
142617800600000,SE 234,RESIDENTIAL,20637,0,20637,65147,0,85784
142617800700000,SE 234,RESIDENTIAL,20965,0,20965,86763,0,107728
142617800800000,SE 234,RESIDENTIAL,21516,0,21516,84984,0,106500
142617800900000,SE 234,RESIDENTIAL,21539,0,21539,76242,0,97781
142617801000000,SE 234,RESIDENTIAL,22050,0,22050,80401,0,102451
142617801100000,SE 234,RESIDENTIAL,21370,0,21370,95780,0,117150
142617801200000,SE 234,RESIDENTIAL,22277,0,22277,67396,0,89673
142617801300000,SE 234,RESIDENTIAL,22318,0,22318,86895,0,109213
142617801400000,SE 234,RESIDENTIAL,23520,0,23520,110730,0,134250
142620100100000,RESTAURANT,COMMERCIAL,0,210000,210000,0,160437,370437
142620100200000,SE 235,RESIDENTIAL,17500,0,17500,75113,0,92613
142620100300000,SE 235,RESIDENTIAL,17500,0,17500,67191,0,84691
142620100400000,SE 235,RESIDENTIAL,17500,0,17500,105009,0,122509
142620100500000,SE 235,RESIDENTIAL,31248,0,31248,74763,0,106011
142620100600000,SE 235,RESIDENTIAL,28215,0,28215,85951,0,114166
142620100700000,SE 235,RESIDENTIAL,28842,0,28842,77778,0,106620
142620100800000,SE 235,RESIDENTIAL,28842,0,28842,139533,0,168375
142620100900000,SE 235,RESIDENTIAL,32291,0,32291,86987,0,119278
142620101000000,SE 235,RESIDENTIAL,32291,0,32291,104766,0,137057
142620101100000,SE 235,RESIDENTIAL,26010,0,26010,86620,0,112630
142620101200000,SE 235,RESIDENTIAL,31622,0,31622,70872,0,102494
142620101300000,SE 235,RESIDENTIAL,33672,0,33672,85444,0,119116
142620101400000,SE 235,RESIDENTIAL,49840,0,49840,89074,0,138914
142620101500000,SE 235,RESIDENTIAL,30520,0,30520,77033,0,107553
142620101600000,SE 235,RESIDENTIAL,30515,0,30515,77931,0,108446
142620101700000,SE 235,RESIDENTIAL,30510,0,30510,65943,0,96453
142620101800000,SE 235,RESIDENTIAL,30505,0,30505,54794,0,85299
142620101900000,SE 235,RESIDENTIAL,30361,0,30361,85501,0,115862
142620102000000,SE 235,RESIDENTIAL,25832,0,25832,71418,0,97250
142620102100000,SE 235,RESIDENTIAL,25832,0,25832,81378,0,107210
142620102200000,SE 235,RESIDENTIAL,22766,0,22766,146794,0,169560
142620102300000,SE 235,RESIDENTIAL,29394,0,29394,113879,0,143273
142620102400000,SE 235,RESIDENTIAL,28340,0,28340,119413,0,147753
142620200100000,SE 235,RESIDENTIAL,15030,0,15030,56070,0,71100
142620200200000,SE 235,RESIDENTIAL,16957,0,16957,72696,0,89653
142620200300000,SE 235,RESIDENTIAL,21168,0,21168,67545,0,88713
142620200400000,SE 235,RESIDENTIAL,21168,0,21168,96972,0,118140
142620200500000,SE 235,RESIDENTIAL,24333,0,24333,90754,0,115087
142620200600000,SE 235,RESIDENTIAL,25000,0,25000,84816,0,109816
142620200700000,SE 235,RESIDENTIAL,25000,0,25000,118780,0,143780
142620200800000,SE 235,RESIDENTIAL,25000,0,25000,98119,0,123119
142620200900000,SE 235,RESIDENTIAL,25000,0,25000,114157,0,139157
142620201000000,SE 235,RESIDENTIAL,25000,0,25000,66787,0,91787
142620201100000,SE 235,RESIDENTIAL,25000,0,25000,100485,0,125485
142620201200000,SE 235,RESIDENTIAL,25000,0,25000,103154,0,128154
142620201300000,SE 235,RESIDENTIAL,25000,0,25000,83618,0,108618
142620201400000,SE 235,RESIDENTIAL,25000,0,25000,69148,0,94148
142620201500000,SE 235,RESIDENTIAL,25000,0,25000,61295,0,86295
142620201600000,SE 235,RESIDENTIAL,25000,0,25000,83156,0,108156
142620201700000,SE 235,RESIDENTIAL,25667,0,25667,88064,0,113731
142620201800000,SE 235,RESIDENTIAL,945,0,945,0,0,945
142620201900000,SE 235,RESIDENTIAL,8650,0,8650,0,0,8650
142620202000000,SE 235,RESIDENTIAL,54700,0,54700,232351,0,287051
142620202100000,SE 235,RESIDENTIAL,31957,0,31957,99664,0,131621
142620202200000,SE 235,RESIDENTIAL,28350,0,28350,97074,0,125424
142620202300000,SE 235,RESIDENTIAL,28125,0,28125,76383,0,104508
142620202400000,SE 235,RESIDENTIAL,28125,0,28125,89945,0,118070
142620202500000,SE 235,RESIDENTIAL,24750,0,24750,73156,0,97906
142620202600000,SE 235,RESIDENTIAL,27787,0,27787,87795,0,115582
142620202700000,SE 235,RESIDENTIAL,24750,0,24750,94810,0,119560
142620202800000,SE 235,RESIDENTIAL,24750,0,24750,93797,0,118547
142620202900000,SE 235,RESIDENTIAL,25200,0,25200,89115,0,114315
142620300100000,SE 235,RESIDENTIAL,18371,0,18371,74652,0,93023
142620300200000,SE 235,RESIDENTIAL,17108,0,17108,86080,0,103188
142620300300000,SE 235,RESIDENTIAL,18835,0,18835,63077,0,81912
142620300400000,SE 235,RESIDENTIAL,19058,0,19058,112733,0,131791
142620300500000,SE 235,RESIDENTIAL,27830,0,27830,81945,0,109775
142620300600000,SE 235,RESIDENTIAL,27600,0,27600,92000,0,119600
142620300700000,SE 235,RESIDENTIAL,27600,0,27600,73667,0,101267
142620300800000,SE 235,RESIDENTIAL,27600,0,27600,84488,0,112088
142620300900000,SE 235,RESIDENTIAL,27600,0,27600,80015,0,107615
142620301000000,SE 235,RESIDENTIAL,27600,0,27600,90697,0,118297
142620301100000,SE 235,RESIDENTIAL,27600,0,27600,89035,0,116635
142620301200000,SE 235,RESIDENTIAL,27600,0,27600,107954,0,135554
142620301300000,SE 235,RESIDENTIAL,27600,0,27600,96568,0,124168
142620301400000,SE 235,RESIDENTIAL,27600,0,27600,113277,0,140877
142620301500000,SE 235,RESIDENTIAL,27231,0,27231,98258,0,125489
142620301600000,SE 235,RESIDENTIAL,26400,0,26400,80888,0,107288
142620301700000,SE 235,RESIDENTIAL,1082,0,1082,0,0,1082
142620301800000,SE 235,RESIDENTIAL,36518,0,36518,199874,0,236392
142620301900000,SE 235,RESIDENTIAL,32456,0,32456,92405,0,124861
142620302000000,SE 235,RESIDENTIAL,22725,0,22725,78430,0,101155
142620302100000,SE 235,RESIDENTIAL,25250,0,25250,97017,0,122267
142620302200000,SE 235,RESIDENTIAL,25250,0,25250,79448,0,104698
142620302300000,SE 235,RESIDENTIAL,25250,0,25250,94186,0,119436
142620302400000,SE 235,RESIDENTIAL,25250,0,25250,88250,0,113500
142620302500000,SE 235,RESIDENTIAL,25250,0,25250,92883,0,118133
142620302600000,SE 235,RESIDENTIAL,25250,0,25250,91391,0,116641
142620302700000,SE 235,RESIDENTIAL,25250,0,25250,90587,0,115837
142620302800000,SE 235,RESIDENTIAL,25250,0,25250,118920,0,144170
142620302900000,SE 235,RESIDENTIAL,25250,0,25250,117007,0,142257
142620303000000,SE 235,RESIDENTIAL,25250,0,25250,116588,0,141838
142620303100000,SE 235,RESIDENTIAL,37902,0,37902,98523,0,136425
142620303200000,SE 235,RESIDENTIAL,21500,0,21500,85022,0,106522
142620400100000,SE 235,RESIDENTIAL,19058,0,19058,59899,0,78957
142620400200000,LG DISCOUNT/RETAIL,COMMERCIAL,0,317500,317500,0,483561,801061
142620400300000,APARTMENT,COMMERCIAL,0,19000,19000,0,81862,100862
142620400400000,APARTMENT,RESIDENTIAL,20880,0,20880,99977,0,120857
142620400500000,APARTMENT,COMMERCIAL,0,19880,19880,0,81285,101165
142620400600000,APARTMENT,RESIDENTIAL,21404,0,21404,87599,0,109003
142620400700000,SE 235,RESIDENTIAL,27210,0,27210,104973,0,132183
142620400800000,SE 235,RESIDENTIAL,27000,0,27000,80295,0,107295
142620400900000,SE 235,RESIDENTIAL,27000,0,27000,82051,0,109051
142620401000000,SE 235,RESIDENTIAL,27000,0,27000,90294,0,117294
142620401100000,SE 235,RESIDENTIAL,26790,0,26790,91050,0,117840
142620500100000,SE 235,RESIDENTIAL,26790,0,26790,96667,0,123457
142620500200000,SE 235,RESIDENTIAL,21488,0,21488,78041,0,99529
142620500300000,SE 235,RESIDENTIAL,23500,0,23500,69230,0,92730
142620500400000,SE 235,RESIDENTIAL,23970,0,23970,84333,0,108303
142620500500000,SE 235,RESIDENTIAL,23500,0,23500,96950,0,120450
142620500600000,SE 235,RESIDENTIAL,24957,0,24957,102831,0,127788
142620500700000,SE 235,RESIDENTIAL,38100,0,38100,144992,0,183092
142620500800000,SE 235,RESIDENTIAL,42049,0,42049,164405,0,206454
142620500900000,SE 235,RESIDENTIAL,4240,0,4240,0,0,4240
142620501000000,SE 235,RESIDENTIAL,27723,0,27723,123922,0,151645
142620501100000,SE 235,RESIDENTIAL,27000,0,27000,90383,0,117383
142620501200000,SE 235,RESIDENTIAL,27000,0,27000,72486,0,99486
142620501300000,SE 235,RESIDENTIAL,27000,0,27000,64360,0,91360
142620501400000,SE 235,RESIDENTIAL,27000,0,27000,87632,0,114632
142622600100000,NBHD SHOPPING CENTER,COMMERCIAL,0,272500,272500,0,459070,731570
142622600200000,SE 235,RESIDENTIAL,25486,0,25486,80981,0,106467
142622600300000,SE 235,RESIDENTIAL,15397,0,15397,58297,0,73694
142622600400000,SE 235,RESIDENTIAL,14994,0,14994,76838,0,91832
142622600500000,SE 235,RESIDENTIAL,22500,0,22500,55658,0,78158
142622600600000,SE 235,RESIDENTIAL,22500,0,22500,77473,0,99973
142622600700000,SE 235,RESIDENTIAL,21600,0,21600,51869,0,73469
142622600800000,SE 235,RESIDENTIAL,22500,0,22500,73537,0,96037
142622600900000,SE 235,RESIDENTIAL,27880,0,27880,93523,0,121403
142622601000000,SE 235,RESIDENTIAL,26250,0,26250,82315,0,108565
142622601100000,SE 235,EXEMPT,0,25626,25626,0,73635,99261
142622601200000,SE 235,RESIDENTIAL,28700,0,28700,77822,0,106522
142622700100000,SE 235,RESIDENTIAL,16625,0,16625,81807,0,98432
142622700200000,SE 235,RESIDENTIAL,19332,0,19332,64765,0,84097
142622700300000,SE 235,RESIDENTIAL,16461,0,16461,56588,0,73049
142622700400000,SE 235,RESIDENTIAL,22968,0,22968,65904,0,88872
142622700500000,SE 235,RESIDENTIAL,24404,0,24404,75001,0,99405
142622700600000,SE 235,RESIDENTIAL,19140,0,19140,76816,0,95956
142622700700000,SE 235,RESIDENTIAL,24283,0,24283,82110,0,106393
142622700800000,SE 235,RESIDENTIAL,20380,0,20380,78156,0,98536
142622700900000,SE 235,RESIDENTIAL,19600,0,19600,86874,0,106474
142622701000000,SE 235,RESIDENTIAL,16632,0,16632,56726,0,73358
142622701100000,SE 235,RESIDENTIAL,30600,0,30600,93689,0,124289
142622701200000,SE 235,RESIDENTIAL,25500,0,25500,75196,0,100696
142622701300000,SE 235,RESIDENTIAL,25500,0,25500,76450,0,101950
142622800100000,SE 235,RESIDENTIAL,21538,0,21538,54710,0,76248
142622800200000,SE 235,RESIDENTIAL,22500,0,22500,71231,0,93731
142622800300000,SE 235,RESIDENTIAL,21805,0,21805,67193,0,88998
142622800400000,SE 235,RESIDENTIAL,21805,0,21805,69246,0,91051
142622800500000,SE 235,RESIDENTIAL,21805,0,21805,73799,0,95604
142622800600000,SE 235,RESIDENTIAL,21805,0,21805,73387,0,95192
142622800700000,SE 235,RESIDENTIAL,21805,0,21805,62946,0,84751
142622800800000,SE 235,RESIDENTIAL,22250,0,22250,64662,0,86912
142622800900000,SE 235,RESIDENTIAL,22250,0,22250,95753,0,118003
142622801000000,SE 235,RESIDENTIAL,28200,0,28200,106633,0,134833
142622801100000,SE 235,RESIDENTIAL,28200,0,28200,71490,0,99690
142622801200000,SE 235,RESIDENTIAL,27829,0,27829,87416,0,115245
142622801300000,SE 235,RESIDENTIAL,25850,0,25850,83355,0,109205
142622900100000,SE 235,RESIDENTIAL,21750,0,21750,67961,0,89711
142622900200000,SE 235,RESIDENTIAL,21750,0,21750,69489,0,91239
142622900300000,SE 235,RESIDENTIAL,21750,0,21750,71318,0,93068
142622900400000,SE 235,RESIDENTIAL,23100,0,23100,83426,0,106526
142622900500000,SE 235,RESIDENTIAL,22050,0,22050,73880,0,95930
142622900600000,SE 235,RESIDENTIAL,22050,0,22050,72370,0,94420
142622900700000,SE 235,RESIDENTIAL,22050,0,22050,78507,0,100557
142622900800000,SE 235,RESIDENTIAL,22500,0,22500,78096,0,100596
142622900900000,SE 235,RESIDENTIAL,22250,0,22250,63367,0,85617
142622901000000,SE 235,RESIDENTIAL,22250,0,22250,70891,0,93141
142622901100000,SE 235,RESIDENTIAL,22500,0,22500,53358,0,75858
142622901200000,SE 235,RESIDENTIAL,22050,0,22050,60594,0,82644
142622901300000,SE 235,RESIDENTIAL,22050,0,22050,66530,0,88580
142622901400000,SE 235,RESIDENTIAL,22050,0,22050,78967,0,101017
142623000100000,SE 235,RESIDENTIAL,29362,0,29362,70340,0,99702
142623000200000,SE 235,RESIDENTIAL,510,0,510,0,0,510
142623000300000,SE 235,RESIDENTIAL,28323,0,28323,83413,0,111736
142623000400000,SE 235,RESIDENTIAL,28547,0,28547,112526,0,141073
142623000500000,SE 235,RESIDENTIAL,29003,0,29003,83117,0,112120
142623000600000,SE 235,RESIDENTIAL,37625,0,37625,85443,0,123068
142623000700000,SE 235,RESIDENTIAL,27567,0,27567,109678,0,137245
142623000800000,SE 235,RESIDENTIAL,37625,0,37625,90087,0,127712
142623000900000,SE 235,RESIDENTIAL,40075,0,40075,106025,0,146100
142623001000000,SE 235,RESIDENTIAL,28175,0,28175,93260,0,121435
142623001100000,SE 235,RESIDENTIAL,21250,0,21250,95221,0,116471
142623001200000,SE 235,RESIDENTIAL,23970,0,23970,58588,0,82558
142623001300000,SE 235,RESIDENTIAL,24480,0,24480,75101,0,99581
142623001400000,SE 235,RESIDENTIAL,24480,0,24480,67623,0,92103
142623001500000,SE 235,RESIDENTIAL,26010,0,26010,68750,0,94760
142623001600000,CITY PROPERTY,EXEMPT,0,0,0,0,0,0
142623001700000,COUNTY PROPERTY,EXEMPT,0,0,0,0,0,0
142623001800000,CENTRALLY ASSESSED,OTHER,0,0,0,0,0,0
142623001900000,CENTRALLY ASSESSED,OTHER,0,0,0,0,0,0
142623002000000,SE 235,RESIDENTIAL,39800,0,39800,155831,0,195631
142623002100000,SE 235,RESIDENTIAL,39800,0,39800,107825,0,147625
142625100100000,CITY PROPERTY,EXEMPT,0,0,0,0,0,0
142627600100000,SE 236,RESIDENTIAL,32640,0,32640,88610,0,121250
142627600200000,SE 236,RESIDENTIAL,36397,0,36397,144810,0,181207
142627600300000,SE 236,RESIDENTIAL,35462,0,35462,148969,0,184431
142627600400000,SE 236,RESIDENTIAL,32810,0,32810,111524,0,144334
142627600500000,SE 236,RESIDENTIAL,29591,0,29591,118981,0,148572
142627600600000,SE 236,RESIDENTIAL,23436,0,23436,106101,0,129537
142627600700000,SE 236,RESIDENTIAL,25048,0,25048,83761,0,108809
142627600800000,SE 236,RESIDENTIAL,32736,0,32736,111270,0,144006
142627600900000,SE 236,RESIDENTIAL,27880,0,27880,92946,0,120826
142627601000000,SE 236,RESIDENTIAL,26400,0,26400,104470,0,130870
142627601100000,SE 236,RESIDENTIAL,25480,0,25480,119918,0,145398
142627601200000,SE 236,RESIDENTIAL,26320,0,26320,104859,0,131179
142627601300000,SE 236,RESIDENTIAL,30132,0,30132,145372,0,175504
142627601400000,SE 236,RESIDENTIAL,26600,0,26600,90244,0,116844
142627601500000,SE 236,RESIDENTIAL,24960,0,24960,100450,0,125410
142627601600000,SE 236,RESIDENTIAL,24444,0,24444,102439,0,126883
142627601700000,SE 236,RESIDENTIAL,25931,0,25931,89749,0,115680
142627601800000,SE 236,RESIDENTIAL,25996,0,25996,93047,0,119043
142627601900000,SE 236,RESIDENTIAL,24341,0,24341,93984,0,118325
142627602000000,SE 236,RESIDENTIAL,25220,0,25220,86648,0,111868
142627602100000,SE 236,RESIDENTIAL,25220,0,25220,81517,0,106737
142627602200000,SE 236,RESIDENTIAL,25996,0,25996,82674,0,108670
142627602300000,SE 236,RESIDENTIAL,24960,0,24960,88024,0,112984
142627700100000,SE 236,RESIDENTIAL,36980,0,36980,168128,0,205108
142627700200000,SE 236,RESIDENTIAL,34608,0,34608,128963,0,163571
142627700300000,SE 236,RESIDENTIAL,31620,0,31620,118959,0,150579
142627700400000,SE 236,RESIDENTIAL,23797,0,23797,94295,0,118092
142627700500000,SE 236,RESIDENTIAL,23074,0,23074,101151,0,124225
142627700600000,SE 236,RESIDENTIAL,22811,0,22811,103813,0,126624
142627700700000,SE 236,RESIDENTIAL,22196,0,22196,83177,0,105373
142627700800000,SE 236,RESIDENTIAL,24800,0,24800,109759,0,134559
142627700900000,SE 236,RESIDENTIAL,27560,0,27560,105507,0,133067
142627701000000,SE 236,RESIDENTIAL,31040,0,31040,98175,0,129215
142627701100000,SE 236,RESIDENTIAL,28000,0,28000,101399,0,129399
142627701200000,SE 236,RESIDENTIAL,27936,0,27936,94209,0,122145
142627701300000,SE 236,RESIDENTIAL,26240,0,26240,89098,0,115338
142627701400000,SE 236,RESIDENTIAL,28200,0,28200,117756,0,145956
142627701500000,SE 236,RESIDENTIAL,27900,0,27900,91421,0,119321
142627701600000,SE 236,RESIDENTIAL,28800,0,28800,88548,0,117348
142627701700000,SE 236,RESIDENTIAL,30000,0,30000,112528,0,142528
142627701800000,SE 236,RESIDENTIAL,31724,0,31724,95122,0,126846
142627701900000,SE 236,RESIDENTIAL,30430,0,30430,123957,0,154387
142627702000000,SE 236,RESIDENTIAL,31848,0,31848,117538,0,149386
142627702100000,SE 236,RESIDENTIAL,30611,0,30611,115452,0,146063
142627800100000,SE 236,RESIDENTIAL,23184,0,23184,99527,0,122711
142627800200000,SE 236,RESIDENTIAL,27720,0,27720,99015,0,126735
142627800300000,SE 236,RESIDENTIAL,25721,0,25721,94211,0,119932
142627800400000,SE 236,RESIDENTIAL,27720,0,27720,90780,0,118500
142627800500000,SE 236,RESIDENTIAL,26069,0,26069,98028,0,124097
142627800600000,SE 236,RESIDENTIAL,24552,0,24552,113671,0,138223
142627800700000,SE 236,RESIDENTIAL,26320,0,26320,110291,0,136611
142627800800000,SE 236,RESIDENTIAL,30031,0,30031,108479,0,138510
142627800900000,SE 236,RESIDENTIAL,31416,0,31416,95524,0,126940
142627801000000,SE 236,RESIDENTIAL,48125,0,48125,113754,0,161879
142627801100000,SE 236,RESIDENTIAL,30600,0,30600,130642,0,161242
142627801200000,SE 236,RESIDENTIAL,30264,0,30264,102397,0,132661
142627801300000,SE 237,RESIDENTIAL,26280,0,26280,87344,0,113624
142627801400000,SE 236,RESIDENTIAL,28812,0,28812,101167,0,129979
142627801500000,SE 236,RESIDENTIAL,29564,0,29564,104592,0,134156
142627801600000,SE 236,RESIDENTIAL,31952,0,31952,121695,0,153647
142627801700000,SE 236,RESIDENTIAL,36309,0,36309,142476,0,178785
142627801800000,SE 236,RESIDENTIAL,30520,0,30520,101128,0,131648
142627900100000,SE 236,RESIDENTIAL,26320,0,26320,83968,0,110288
142627900200000,SE 236,RESIDENTIAL,26400,0,26400,101496,0,127896
142627900300000,SE 236,RESIDENTIAL,26000,0,26000,102092,0,128092
142627900400000,SE 236,RESIDENTIAL,26067,0,26067,93828,0,119895
142627900500000,SE 236,RESIDENTIAL,26260,0,26260,99168,0,125428
142627900600000,SE 236,RESIDENTIAL,26520,0,26520,103669,0,130189
142627900700000,SE 236,RESIDENTIAL,27733,0,27733,98101,0,125834
142627900800000,SE 236,RESIDENTIAL,26901,0,26901,94084,0,120985
142627900900000,SE 236,RESIDENTIAL,28560,0,28560,80558,0,109118
142627901000000,SE 236,RESIDENTIAL,28280,0,28280,89875,0,118155
142627901100000,SE 236,RESIDENTIAL,27720,0,27720,112806,0,140526
142627901200000,SE 236,RESIDENTIAL,27160,0,27160,92170,0,119330
142627901300000,SE 236,RESIDENTIAL,28500,0,28500,95664,0,124164
142627901400000,SE 236,RESIDENTIAL,29269,0,29269,107945,0,137214
142627901500000,SE 236,RESIDENTIAL,27680,0,27680,111628,0,139308
142627901600000,SE 236,RESIDENTIAL,29779,0,29779,105710,0,135489
142627901700000,SE 236,RESIDENTIAL,34340,0,34340,117167,0,151507
142627901800000,SE 236,RESIDENTIAL,34680,0,34680,139601,0,174281
142627901900000,SE 236,RESIDENTIAL,33503,0,33503,112499,0,146002
142627902000000,SE 236,RESIDENTIAL,29508,0,29508,104092,0,133600
142627902100000,SE 236,RESIDENTIAL,30940,0,30940,94609,0,125549
142627902200000,SE 236,RESIDENTIAL,31061,0,31061,110810,0,141871
142627902300000,SE 236,RESIDENTIAL,29376,0,29376,118836,0,148212
142627902400000,SE 236,RESIDENTIAL,29333,0,29333,90699,0,120032
142627902500000,SE 236,RESIDENTIAL,22072,0,22072,90301,0,112373
142627902600000,SE 236,RESIDENTIAL,24440,0,24440,81976,0,106416
142627902700000,SE 236,RESIDENTIAL,24440,0,24440,75594,0,100034
142628000100000,SE 236,RESIDENTIAL,22344,0,22344,109209,0,131553
142628000200000,SE 236,RESIDENTIAL,24375,0,24375,128904,0,153279
142628000300000,SE 236,RESIDENTIAL,23280,0,23280,84853,0,108133
142628000400000,SE 236,RESIDENTIAL,23280,0,23280,60132,0,83412
142628000500000,SE 236,RESIDENTIAL,23280,0,23280,89662,0,112942
142628000600000,SE 236,RESIDENTIAL,23280,0,23280,123127,0,146407
142628000700000,SE 236,RESIDENTIAL,24942,0,24942,113566,0,138508
142628000800000,SE 236,RESIDENTIAL,24450,0,24450,70812,0,95262
142628000900000,SE 236,RESIDENTIAL,24426,0,24426,103059,0,127485
142628001000000,SE 236,RESIDENTIAL,24426,0,24426,94475,0,118901
142628001100000,SE 236,RESIDENTIAL,23197,0,23197,78526,0,101723
142628001200000,SE 236,RESIDENTIAL,24396,0,24396,87447,0,111843
142628001300000,SE 236,RESIDENTIAL,7975,0,7975,0,0,7975
142628100100000,SE 236,RESIDENTIAL,27984,0,27984,105579,0,133563
142628100200000,SE 236,RESIDENTIAL,25693,0,25693,96096,0,121789
142628100300000,SE 236,RESIDENTIAL,25668,0,25668,101398,0,127066
142628100400000,SE 236,RESIDENTIAL,23432,0,23432,89573,0,113005
142628100500000,SE 236,RESIDENTIAL,23200,0,23200,84117,0,107317
142628100600000,SE 236,RESIDENTIAL,23200,0,23200,92529,0,115729
142628100700000,SE 236,RESIDENTIAL,23200,0,23200,82832,0,106032
142628100800000,SE 236,RESIDENTIAL,24267,0,24267,109646,0,133913
142628100900000,SE 236,RESIDENTIAL,27160,0,27160,97390,0,124550
142628101000000,SE 236,RESIDENTIAL,25802,0,25802,89158,0,114960
142628101100000,SE 236,RESIDENTIAL,26384,0,26384,98026,0,124410
142628101200000,SE 236,RESIDENTIAL,24573,0,24573,94660,0,119233
142628200100000,SE 236,RESIDENTIAL,29100,0,29100,105035,0,134135
142628200200000,SE 236,RESIDENTIAL,30184,0,30184,105285,0,135469
142628200300000,SE 236,RESIDENTIAL,30639,0,30639,91815,0,122454
142628200400000,SE 236,RESIDENTIAL,30042,0,30042,106720,0,136762
142628200500000,SE 236,RESIDENTIAL,30135,0,30135,96537,0,126672
142628200600000,SE 236,RESIDENTIAL,30380,0,30380,91116,0,121496
142628200700000,SE 236,RESIDENTIAL,31518,0,31518,104692,0,136210
142628200800000,SE 236,RESIDENTIAL,31800,0,31800,115438,0,147238
142628200900000,SE 236,RESIDENTIAL,25440,0,25440,97787,0,123227
142628201000000,SE 236,RESIDENTIAL,24720,0,24720,110125,0,134845
142628201100000,SE 236,RESIDENTIAL,23760,0,23760,91798,0,115558
142628201200000,SE 236,RESIDENTIAL,23040,0,23040,86332,0,109372
142628201300000,SE 236,RESIDENTIAL,23437,0,23437,85955,0,109392
142628201400000,SE 236,RESIDENTIAL,23040,0,23040,97865,0,120905
142630100100000,SE 240,RESIDENTIAL,27353,0,27353,104993,0,132346
142630100200000,SE 240,RESIDENTIAL,28560,0,28560,110380,0,138940
142630100300000,SE 240,RESIDENTIAL,28560,0,28560,90143,0,118703
142630100400000,SE 240,RESIDENTIAL,28560,0,28560,88801,0,117361
142630100500000,SE 240,RESIDENTIAL,35476,0,35476,111769,0,147245
142630100600000,SE 240,RESIDENTIAL,48307,0,48307,157735,0,206042
142630200100000,SE 240,RESIDENTIAL,34079,0,34079,92529,0,126608
142630200200000,SE 240,RESIDENTIAL,18857,0,18857,0,0,18857
142630200300000,SE 240,RESIDENTIAL,40950,0,40950,0,0,40950
142630200400000,SE 240,RESIDENTIAL,59325,0,59325,258724,0,318049
142630200500000,SE 240,RESIDENTIAL,22247,0,22247,3565,0,25812
142630200600000,SE 240,RESIDENTIAL,20994,0,20994,4925,0,25919
142630200700000,SE 240,RESIDENTIAL,20570,0,20570,4212,0,24782
142630200800000,SE 240,RESIDENTIAL,37696,0,37696,113432,0,151128
142630200900000,SE 240,RESIDENTIAL,46100,0,46100,0,0,46100
142630201000000,SE 240,RESIDENTIAL,40450,0,40450,136464,0,176914
142630201100000,SE 240,RESIDENTIAL,32544,0,32544,108514,0,141058
142630201200000,SE 240,RESIDENTIAL,42475,0,42475,0,0,42475
142630201300000,SE 240,RESIDENTIAL,42775,0,42775,150076,0,192851
142630201400000,SE 240,RESIDENTIAL,36288,0,36288,110877,0,147165
142630201500000,SE 240,RESIDENTIAL,35243,0,35243,76151,0,111394
142630201600000,SE 240,RESIDENTIAL,35640,0,35640,126865,0,162505
142630201700000,SE 240,RESIDENTIAL,34344,0,34344,101409,0,135753
142630201800000,SE 240,RESIDENTIAL,32724,0,32724,99221,0,131945
142630300100000,SE 240,RESIDENTIAL,43276,0,43276,144438,0,187714
142630300200000,SE 240,RESIDENTIAL,38311,0,38311,77892,0,116203
142630300300000,SE 240,RESIDENTIAL,38111,0,38111,158785,0,196896
142632600100000,SE 240,RESIDENTIAL,67800,0,67800,225080,0,292880
142632600200000,CITY PROPERTY,EXEMPT,0,0,0,0,0,0
142632600300000,SE 240,RESIDENTIAL,39190,0,39190,24518,0,63708
142632601100000,SE 240,RESIDENTIAL,44667,0,44667,115842,0,160509
142632602100000,SE 240,RESIDENTIAL,43701,0,43701,153047,0,196748
142635100100000,SE 242,RESIDENTIAL,10000,0,10000,0,0,10000
142635100200000,SE 242,AG DWELLING,21818,0,21818,51353,3084,76255
142637600100000,SE 240,RESIDENTIAL,33650,0,33650,0,0,33650
142637600200000,SE 240,RESIDENTIAL,40000,0,40000,128861,0,168861
142637700100000,SE 240,RESIDENTIAL,41950,0,41950,62938,0,104888
142637700200000,SE 240,RESIDENTIAL,34650,0,34650,0,0,34650
142637700300000,CITY PROPERTY,EXEMPT,0,0,0,0,0,0
142637700400000,CITY PROPERTY,EXEMPT,0,0,0,0,0,0
142637700500000,SE 240,RESIDENTIAL,45275,0,45275,141563,0,186838
142637700600000,SE 240,RESIDENTIAL,35251,0,35251,83471,0,118722
142637700700000,SE 240,RESIDENTIAL,46525,0,46525,110233,0,156758
142637700800000,SE 240,RESIDENTIAL,42375,0,42375,116293,0,158668
142640100100000,APARTMENT,RESIDENTIAL,80800,0,80800,491467,0,572267
142640100200000,APARTMENT,RESIDENTIAL,73600,0,73600,472910,0,546510
142640100300000,APARTMENT,RESIDENTIAL,239616,0,239616,1346518,0,1586134
142640100400000,SE 239,RESIDENTIAL,37760,0,37760,88285,0,126045
142640100500000,SE 239,RESIDENTIAL,51650,0,51650,138933,0,190583
142640100600000,CHURCH,EXEMPT,0,30537,30537,0,60320,90857
142640100700000,SE 239,RESIDENTIAL,53475,0,53475,77740,0,131215
142640100800000,SE 239,RESIDENTIAL,50724,0,50724,0,0,50724
142640100900000,SE 239,RESIDENTIAL,50724,0,50724,0,0,50724
142640101400000,APARTMENT,RESIDENTIAL,176000,0,176000,862739,0,1038739
142640200100000,SE 239,EXEMPT,0,19852,19852,0,90160,110012
142640200200000,SE 239,RESIDENTIAL,18768,0,18768,100972,0,119740
142640200300000,SE 239,RESIDENTIAL,20424,0,20424,86130,0,106554
142640200400000,SE 239,RESIDENTIAL,20424,0,20424,87449,0,107873
142640200500000,SE 239,RESIDENTIAL,19731,0,19731,90589,0,110320
142640200600000,SE 239,RESIDENTIAL,19425,0,19425,0,0,19425
142640300100000,SE 239,RESIDENTIAL,53175,0,53175,160669,0,213844
142642600100000,SE 239,RESIDENTIAL,50000,0,50000,0,0,50000
142642600200000,SE 239,RESIDENTIAL,60650,0,60650,0,0,60650
142642600300000,SE 239,RESIDENTIAL,65360,0,65360,55864,0,121224
142642600400000,SE 239,RESIDENTIAL,32000,0,32000,63975,0,95975
142642600500000,SE 239,RESIDENTIAL,24400,0,24400,75953,0,100353
142642600600000,SE 239,RESIDENTIAL,7000,0,7000,0,0,7000
142642600700000,SE 239,RESIDENTIAL,53675,0,53675,0,0,53675
142642600800000,SE 239,RESIDENTIAL,14250,0,14250,0,0,14250
142642600900000,SE 240,RESIDENTIAL,56775,0,56775,0,0,56775
142642601000000,SE 240,RESIDENTIAL,48250,0,48250,248245,0,296495
142642601200000,SE 240,RESIDENTIAL,44444,0,44444,157158,0,201602
142642601300000,SE 240,RESIDENTIAL,44441,0,44441,202070,0,246511
142642601400000,SE 240,RESIDENTIAL,44660,0,44660,147044,0,191704
142642601500000,SE 240,RESIDENTIAL,40619,0,40619,173148,0,213767
142642601600000,SE 240,RESIDENTIAL,60729,0,60729,159271,0,220000
142642601700000,SE 240,RESIDENTIAL,53100,0,53100,168892,0,221992
142642601800000,SE 240,RESIDENTIAL,49266,0,49266,138395,0,187661
142642601900000,SE 240,RESIDENTIAL,50225,0,50225,139775,0,190000
142642602000000,SE 240,RESIDENTIAL,44607,0,44607,151776,0,196383
142642700100000,SE 239,RESIDENTIAL,50858,0,50858,134093,0,184951
142642700200000,SE 239,RESIDENTIAL,18958,0,18958,0,0,18958
142645100100000,SE 239,RESIDENTIAL,18000,0,18000,0,0,18000
142645100200000,SE 239,RESIDENTIAL,50000,0,50000,78510,0,128510
142645100300000,SE 240,RESIDENTIAL,55650,0,55650,139603,0,195253
142645100400000,SE 240,RESIDENTIAL,45900,0,45900,117867,0,163767
142645100500000,SE 240,RESIDENTIAL,47325,0,47325,56694,0,104019
142645100600000,SE 240,RESIDENTIAL,52075,0,52075,0,0,52075
142645100700000,SE 240,RESIDENTIAL,52225,0,52225,0,0,52225
142645100800000,SE 240,RESIDENTIAL,36400,0,36400,45254,0,81654
142645100900000,SE 239,RESIDENTIAL,55140,0,55140,240,0,55380
142645101000000,SE 239,RESIDENTIAL,28028,0,28028,47684,0,75712
142645101100000,SE 239,RESIDENTIAL,26565,0,26565,64473,0,91038
142647600100000,SE 239,RESIDENTIAL,66125,0,66125,2216,0,68341
142647600200000,SE 239,RESIDENTIAL,31484,0,31484,80775,0,112259
142647600300000,SE 239,RESIDENTIAL,36452,0,36452,43941,0,80393
142647600400000,SE 239,RESIDENTIAL,72275,0,72275,179935,0,252210
142647600500000,SE 239,RESIDENTIAL,68000,0,68000,48123,0,116123
142647600600000,SE 239,RESIDENTIAL,42375,0,42375,34854,0,77229
142647600700000,SE 239,RESIDENTIAL,53520,0,53520,0,0,53520
142647600800000,COUNTY PROPERTY,EXEMPT,0,0,0,0,0,0
142647600900000,SE 239,RESIDENTIAL,4979,0,4979,0,0,4979
142710100100000,SE 235,RESIDENTIAL,17100,0,17100,47111,0,64211
142710100200000,SE 235,RESIDENTIAL,19237,0,19237,57221,0,76458
142710100300000,SE 235,RESIDENTIAL,23760,0,23760,85443,0,109203
142710100400000,SE 235,RESIDENTIAL,23760,0,23760,68151,0,91911
142710100500000,SE 235,RESIDENTIAL,24717,0,24717,59810,0,84527
142710100600000,SE 235,RESIDENTIAL,20057,0,20057,52389,0,72446
142710100700000,SE 235,RESIDENTIAL,47520,0,47520,116856,0,164376
142710100800000,SE 235,RESIDENTIAL,71280,0,71280,0,0,71280
142710100900000,SE 235,RESIDENTIAL,26928,0,26928,87735,0,114663
142710101000000,SE 235,RESIDENTIAL,25344,0,25344,107474,0,132818
142710101100000,SE 235,RESIDENTIAL,27720,0,27720,56738,0,84458
142710101200000,SE 235,RESIDENTIAL,23760,0,23760,86046,0,109806
142710101300000,SE 235,RESIDENTIAL,23760,0,23760,103026,0,126786
142710101600000,SE 235,RESIDENTIAL,57024,0,57024,89571,0,146595
142710200100000,SE 235,RESIDENTIAL,24057,0,24057,80216,0,104273
142710200200000,SE 235,RESIDENTIAL,14138,0,14138,81826,0,95964
142710200300000,SE 235,RESIDENTIAL,13253,0,13253,69138,0,82391
142710200400000,SE 235,RESIDENTIAL,12672,0,12672,88178,0,100850
142710200500000,SE 235,RESIDENTIAL,20000,0,20000,82507,0,102507
142710200600000,SE 235,RESIDENTIAL,20000,0,20000,81734,0,101734
142710200700000,SE 235,RESIDENTIAL,20000,0,20000,119727,0,139727
142710200800000,SE 235,RESIDENTIAL,20000,0,20000,101006,0,121006
142710200900000,SE 235,RESIDENTIAL,20000,0,20000,76171,0,96171
142710201000000,SE 235,RESIDENTIAL,20000,0,20000,82831,0,102831
142710201100000,SE 235,RESIDENTIAL,20000,0,20000,79348,0,99348
142710201200000,SE 235,RESIDENTIAL,20000,0,20000,88153,0,108153
142710201300000,SE 235,RESIDENTIAL,17573,0,17573,76997,0,94570
142710201400000,SE 235,RESIDENTIAL,15200,0,15200,84417,0,99617
142710201500000,SE 235,RESIDENTIAL,20480,0,20480,69398,0,89878
142710201600000,SE 235,RESIDENTIAL,25344,0,25344,49259,0,74603
142710201700000,SE 235,RESIDENTIAL,17820,0,17820,78356,0,96176
142710201800000,SE 235,RESIDENTIAL,23760,0,23760,114929,0,138689
142710201900000,SE 235,RESIDENTIAL,23760,0,23760,77141,0,100901
142710202000000,SE 235,RESIDENTIAL,23760,0,23760,92497,0,116257
142710202100000,SE 235,RESIDENTIAL,17820,0,17820,58070,0,75890
142710300100000,SE 235,RESIDENTIAL,18899,0,18899,95684,0,114583
142710300200000,SE 235,RESIDENTIAL,19353,0,19353,99752,0,119105
142710300300000,SE 235,RESIDENTIAL,25585,0,25585,111686,0,137271
142710300400000,SE 235,RESIDENTIAL,18900,0,18900,61960,0,80860
142710300500000,SE 235,RESIDENTIAL,10500,0,10500,53050,0,63550
142710300600000,SE 235,RESIDENTIAL,10500,0,10500,50831,0,61331
142710300700000,SE 235,RESIDENTIAL,17262,0,17262,0,0,17262
142710300800000,SMALL RETAIL,COMMERCIAL,0,25487,25487,0,50147,75634
142710300900000,SMALL RETAIL,COMMERCIAL,0,6286,6286,0,27459,33745
142710301000000,SE 235,RESIDENTIAL,18090,0,18090,36211,0,54301
142710301100000,SE 235,RESIDENTIAL,24120,0,24120,30352,0,54472
142710301200000,SE 235,RESIDENTIAL,24000,0,24000,50935,0,74935
142710301300000,SE 235,RESIDENTIAL,27000,0,27000,43799,0,70799
142710301400000,SE 235,RESIDENTIAL,16800,0,16800,57644,0,74444
142710301600000,SE 235,RESIDENTIAL,26343,0,26343,18444,0,44787
142710301700000,SE 235,RESIDENTIAL,26343,0,26343,47762,0,74105
142710301800000,SE 235,RESIDENTIAL,19472,0,19472,51464,0,70936
142710301900000,SE 235,RESIDENTIAL,19472,0,19472,62124,0,81596
142710302000000,SE 235,RESIDENTIAL,19472,0,19472,51751,0,71223
142710302100000,SE 235,RESIDENTIAL,19472,0,19472,33870,0,53342
142710302200000,SE 235,RESIDENTIAL,18720,0,18720,55885,0,74605
142710302300000,SE 235,RESIDENTIAL,19053,0,19053,59598,0,78651
142710302400000,SE 235,RESIDENTIAL,19472,0,19472,42669,0,62141
142710302500000,SE 235,RESIDENTIAL,19472,0,19472,70534,0,90006
142710302600000,SE 235,RESIDENTIAL,16640,0,16640,61018,0,77658
142710302700000,SE 235,RESIDENTIAL,20303,0,20303,90356,0,110659
142710302800000,SE 235,RESIDENTIAL,28143,0,28143,59578,0,87721
142710302900000,SE 235,RESIDENTIAL,28143,0,28143,53164,0,81307
142710303000000,SE 235,RESIDENTIAL,16000,0,16000,70971,0,86971
142710303100000,SE 235,RESIDENTIAL,16000,0,16000,61509,0,77509
142710303200000,SE 235,RESIDENTIAL,18079,0,18079,49534,0,67613
142710303300000,SE 235,RESIDENTIAL,25631,0,25631,100778,0,126409
142710303400000,SE 235,RESIDENTIAL,22533,0,22533,76853,0,99386
142710303500000,SE 235,RESIDENTIAL,20000,0,20000,66564,0,86564
142710303600000,SE 235,RESIDENTIAL,20000,0,20000,60902,0,80902
142710303700000,SE 235,RESIDENTIAL,20000,0,20000,64564,0,84564
142710303800000,SE 235,RESIDENTIAL,20000,0,20000,70070,0,90070
142710303900000,SE 235,RESIDENTIAL,20000,0,20000,74980,0,94980
142710304000000,SE 235,RESIDENTIAL,20000,0,20000,65488,0,85488
142710304100000,SE 235,RESIDENTIAL,20000,0,20000,71043,0,91043
142710304200000,SE 235,RESIDENTIAL,20000,0,20000,103123,0,123123
142710304300000,SE 235,RESIDENTIAL,20000,0,20000,84895,0,104895
142710304400000,SE 235,RESIDENTIAL,20000,0,20000,98785,0,118785
142710304500000,SE 235,RESIDENTIAL,20000,0,20000,101073,0,121073
142710304600000,SE 235,RESIDENTIAL,20000,0,20000,108017,0,128017
142710304700000,SE 235,RESIDENTIAL,20000,0,20000,109832,0,129832
142710304800000,SE 235,RESIDENTIAL,20000,0,20000,29814,0,49814
142710304900000,SE 235,RESIDENTIAL,18750,0,18750,96992,0,115742
142710305000000,SE 235,RESIDENTIAL,5750,0,5750,0,0,5750
142710400100000,VACANT LAND,COMMERCIAL,0,30600,30600,0,0,30600
142710400200000,SE 235,RESIDENTIAL,15232,0,15232,0,0,15232
142710400300000,SE 235,RESIDENTIAL,15150,0,15150,72727,0,87877
142710400400000,SE 235,RESIDENTIAL,28280,0,28280,55473,0,83753
142710400500000,SE 235,RESIDENTIAL,20200,0,20200,59415,0,79615
142710400600000,SE 235,RESIDENTIAL,20200,0,20200,28094,0,48294
142710400700000,CEMETERY,EXEMPT,0,0,0,0,0,0
142710400800000,SE 235,RESIDENTIAL,20200,0,20200,51191,0,71391
142710400900000,SE 235,RESIDENTIAL,20200,0,20200,57056,0,77256
142710401000000,SE 235,RESIDENTIAL,20200,0,20200,19655,0,39855
142710401100000,SE 235,RESIDENTIAL,20200,0,20200,27977,0,48177
142710401200000,SE 235,RESIDENTIAL,25856,0,25856,55476,0,81332
142710401300000,SE 235,RESIDENTIAL,20200,0,20200,55933,0,76133
142710401400000,SE 235,RESIDENTIAL,20200,0,20200,61927,0,82127
142710401500000,SE 235,RESIDENTIAL,20200,0,20200,28254,0,48454
142710401600000,SE 235,RESIDENTIAL,24240,0,24240,63267,0,87507
142710401700000,SE 235,RESIDENTIAL,28280,0,28280,105110,0,133390
142710401800000,SE 235,RESIDENTIAL,20200,0,20200,31429,0,51629
142710401900000,SE 235,RESIDENTIAL,20000,0,20000,71343,0,91343
142710402000000,SE 235,RESIDENTIAL,19439,0,19439,67466,0,86905
142710500100000,SE 235,RESIDENTIAL,21216,0,21216,62691,0,83907
142710500200000,SE 235,RESIDENTIAL,22000,0,22000,87499,0,109499
142710500300000,SE 235,RESIDENTIAL,22000,0,22000,67074,0,89074
142710500400000,SE 235,RESIDENTIAL,23436,0,23436,98048,0,121484
142710500500000,SE 235,RESIDENTIAL,22932,0,22932,86319,0,109251
142710500600000,SE 235,RESIDENTIAL,22572,0,22572,68427,0,90999
142710500700000,SE 235,RESIDENTIAL,23760,0,23760,67928,0,91688
142710500800000,SE 235,RESIDENTIAL,24627,0,24627,64422,0,89049
142710500900000,SE 235,RESIDENTIAL,41151,0,41151,10796,0,51947
142710501000000,SE 235,RESIDENTIAL,31292,0,31292,116460,0,147752
142710501100000,SE 235,RESIDENTIAL,25168,0,25168,50789,0,75957
142710501200000,SE 235,RESIDENTIAL,22464,0,22464,72711,0,95175
142710501300000,SE 235,RESIDENTIAL,24295,0,24295,75625,0,99920
142710501400000,SE 235,RESIDENTIAL,24000,0,24000,69991,0,93991
142710501500000,SE 235,RESIDENTIAL,23200,0,23200,108680,0,131880
142712600100000,CEMETERY,EXEMPT,0,0,0,0,0,0
142712600200000,SE 249,RESIDENTIAL,17338,0,17338,70288,0,87626
142712600300000,SE 249,RESIDENTIAL,17566,0,17566,73201,0,90767
142712600400000,SE 249,RESIDENTIAL,17876,0,17876,73239,0,91115
142712600500000,SE 249,RESIDENTIAL,11794,0,11794,70647,0,82441
142712600600000,SE 249,RESIDENTIAL,16848,0,16848,66894,0,83742
142712600700000,SE 249,RESIDENTIAL,16848,0,16848,84032,0,100880
142712600800000,SE 249,RESIDENTIAL,16848,0,16848,69354,0,86202
142712600900000,SE 249,RESIDENTIAL,11794,0,11794,95384,0,107178
142712601000000,SE 249,RESIDENTIAL,16848,0,16848,74096,0,90944
142712601100000,SE 249,RESIDENTIAL,16848,0,16848,70649,0,87497
142712601200000,SE 249,RESIDENTIAL,16848,0,16848,65236,0,82084
142712601300000,SE 249,RESIDENTIAL,16848,0,16848,68450,0,85298
142712601400000,SE 249,RESIDENTIAL,17781,0,17781,71813,0,89594
142712601500000,SE 249,RESIDENTIAL,17632,0,17632,65740,0,83372
142712601600000,SE 249,RESIDENTIAL,17533,0,17533,70747,0,88280
142712601700000,SE 249,RESIDENTIAL,17544,0,17544,75407,0,92951
142712700100000,SE 249,RESIDENTIAL,17322,0,17322,80427,0,97749
142712700200000,SE 249,RESIDENTIAL,17123,0,17123,71719,0,88842
142712700300000,SE 249,RESIDENTIAL,17123,0,17123,71725,0,88848
142712700400000,SE 249,RESIDENTIAL,17123,0,17123,75260,0,92383
142712700500000,SE 249,RESIDENTIAL,17123,0,17123,68152,0,85275
142712700600000,SE 249,RESIDENTIAL,17123,0,17123,73600,0,90723
142712700700000,SE 249,RESIDENTIAL,17123,0,17123,81285,0,98408
142712700800000,SE 249,RESIDENTIAL,17123,0,17123,63836,0,80959
142712700900000,SE 249,RESIDENTIAL,17316,0,17316,82747,0,100063
142715100100000,CEMETERY,EXEMPT,0,0,0,0,0,0
142715200100000,SE 237,RESIDENTIAL,12000,0,12000,61182,0,73182
142715200200000,SE 237,RESIDENTIAL,10000,0,10000,56322,0,66322
142715200300000,SE 237,RESIDENTIAL,10000,0,10000,49603,0,59603
142715200400000,SE 237,RESIDENTIAL,10000,0,10000,36395,0,46395
142715200500000,SE 237,RESIDENTIAL,10000,0,10000,56483,0,66483
142715200600000,SE 237,RESIDENTIAL,10244,0,10244,967,0,11211
142715200700000,SE 237,RESIDENTIAL,7627,0,7627,29959,0,37586
142715200800000,SE 237,RESIDENTIAL,7200,0,7200,35156,0,42356
142715200900000,SE 237,RESIDENTIAL,9627,0,9627,39099,0,48726
142715201000000,SE 237,RESIDENTIAL,10000,0,10000,82062,0,92062
142715201100000,SE 237,RESIDENTIAL,10000,0,10000,44796,0,54796
142715201200000,SE 237,RESIDENTIAL,10000,0,10000,85695,0,95695
142715201300000,SE 237,RESIDENTIAL,10000,0,10000,72630,0,82630
142715201400000,SE 237,RESIDENTIAL,10000,0,10000,41163,0,51163
142715201500000,SE 237,RESIDENTIAL,10000,0,10000,43798,0,53798
142715201600000,SE 237,RESIDENTIAL,10000,0,10000,26690,0,36690
142715300100000,SE 237,RESIDENTIAL,8000,0,8000,57180,0,65180
142715300200000,SE 237,RESIDENTIAL,8000,0,8000,34970,0,42970
142715300300000,SE 237,RESIDENTIAL,11200,0,11200,30253,0,41453
142715300400000,SE 237,RESIDENTIAL,8000,0,8000,52211,0,60211
142715300500000,SE 237,RESIDENTIAL,10000,0,10000,63591,0,73591
142715300600000,SE 237,RESIDENTIAL,10000,0,10000,68185,0,78185
142715300700000,SE 237,RESIDENTIAL,8000,0,8000,46858,0,54858
142715300800000,SE 237,RESIDENTIAL,10073,0,10073,28665,0,38738
142715300900000,SE 237,RESIDENTIAL,10386,0,10386,44734,0,55120
142715301000000,SE 237,RESIDENTIAL,8000,0,8000,30395,0,38395
142715301100000,SE 237,RESIDENTIAL,8000,0,8000,47737,0,55737
142715301200000,SE 237,RESIDENTIAL,8000,0,8000,27055,0,35055
142715301300000,SE 237,RESIDENTIAL,12000,0,12000,14021,0,26021
142715301400000,SE 237,RESIDENTIAL,12000,0,12000,30781,0,42781
142715400100000,SE 237,RESIDENTIAL,23200,0,23200,55143,0,78343
142715400200000,SE 237,RESIDENTIAL,5400,0,5400,16340,0,21740
142715400300000,OFFICE,EXEMPT,0,14580,14580,0,23553,38133
142715400400000,CHURCH,EXEMPT,0,34020,34020,0,88,34108
142715400500000,SE 237,RESIDENTIAL,19200,0,19200,0,0,19200
142715500100000,SE 237,RESIDENTIAL,8800,0,8800,70355,0,79155
142715500200000,SE 237,RESIDENTIAL,8800,0,8800,78609,0,87409
142715500300000,SE 237,RESIDENTIAL,8800,0,8800,66194,0,74994
142715500400000,SE 237,RESIDENTIAL,10000,0,10000,77360,0,87360
142715500500000,SE 237,RESIDENTIAL,10000,0,10000,77968,0,87968
142715500600000,SE 237,RESIDENTIAL,10000,0,10000,73554,0,83554
142715500700000,SE 237,RESIDENTIAL,12000,0,12000,75960,0,87960
142715500800000,CITY PROPERTY,EXEMPT,0,0,0,0,0,0
142715500900000,SE 237,RESIDENTIAL,10000,0,10000,0,0,10000
142715501000000,SE 237,RESIDENTIAL,10000,0,10000,0,0,10000
142715501100000,SE 237,RESIDENTIAL,10000,0,10000,0,0,10000
142715501200000,CITY PROPERTY,EXEMPT,0,0,0,0,0,0
142715600100000,SE 237,RESIDENTIAL,10000,0,10000,48462,0,58462
142715600200000,SE 237,RESIDENTIAL,10000,0,10000,47364,0,57364
142715600300000,SE 237,RESIDENTIAL,12000,0,12000,33674,0,45674
142715600400000,SE 237,RESIDENTIAL,10000,0,10000,34729,0,44729
142715600500000,SE 237,RESIDENTIAL,10000,0,10000,44475,0,54475
142715600600000,SE 237,RESIDENTIAL,11200,0,11200,38613,0,49813
142715600700000,CITY PROPERTY,EXEMPT,0,0,0,0,0,0
142715700100000,CITY PROPERTY,EXEMPT,0,0,0,0,0,0
142717600100000,CITY PROPERTY,EXEMPT,0,0,0,0,0,0
142720100100000,CITY PROPERTY,EXEMPT,0,0,0,0,0,0
142720100200000,SE 237,RESIDENTIAL,9750,0,9750,0,0,9750
142720100300000,SE 237,RESIDENTIAL,9600,0,9600,63247,0,72847
142720100400000,SE 237,RESIDENTIAL,7842,0,7842,47209,0,55051
142720100500000,SE 237,RESIDENTIAL,10200,0,10200,48894,0,59094
142720100600000,SE 237,RESIDENTIAL,8000,0,8000,76994,0,84994
142720100700000,SE 237,RESIDENTIAL,8000,0,8000,64018,0,72018
142720100800000,CEMETERY,EXEMPT,0,0,0,0,0,0
142720200100000,SE 237,RESIDENTIAL,8000,0,8000,77925,0,85925
142720200200000,SE 237,RESIDENTIAL,8000,0,8000,34132,0,42132
142720200300000,SE 237,RESIDENTIAL,8000,0,8000,68667,0,76667
142720200400000,CITY PROPERTY,EXEMPT,0,0,0,0,0,0
142720200500000,SE 237,RESIDENTIAL,8000,0,8000,0,0,8000
142720200600000,SE 237,RESIDENTIAL,8000,0,8000,37437,0,45437
142720200700000,SE 237,RESIDENTIAL,7920,0,7920,43690,0,51610
142720200800000,SE 237,RESIDENTIAL,9504,0,9504,54657,0,64161
142720200900000,SE 237,RESIDENTIAL,7920,0,7920,54784,0,62704
142720201000000,SE 237,RESIDENTIAL,9052,0,9052,74603,0,83655
142720201100000,SE 237,RESIDENTIAL,7920,0,7920,30690,0,38610
142720201200000,SE 237,RESIDENTIAL,7719,0,7719,68684,0,76403
142720201300000,SE 237,RESIDENTIAL,7920,0,7920,88081,0,96001
142720201400000,SE 237,RESIDENTIAL,8000,0,8000,57686,0,65686
142720201500000,SE 237,RESIDENTIAL,8000,0,8000,57822,0,65822
142720201600000,SE 237,RESIDENTIAL,8000,0,8000,81660,0,89660
142720201700000,SE 237,RESIDENTIAL,8170,0,8170,33213,0,41383
142720201800000,SE 237,RESIDENTIAL,8550,0,8550,66717,0,75267
142720201900000,SE 237,RESIDENTIAL,7000,0,7000,50418,0,57418
142720202000000,SE 237,RESIDENTIAL,8000,0,8000,34768,0,42768
142720202100000,SE 237,RESIDENTIAL,8000,0,8000,61428,0,69428
142720202200000,CITY PROPERTY,EXEMPT,0,0,0,0,0,0
142720202300000,SE 237,RESIDENTIAL,11790,0,11790,37879,0,49669
142720300100000,SCHOOL,EXEMPT,0,47002,47002,0,42070,89072
142720300200000,AUTO REPAIR/SALES,COMMERCIAL,0,71934,71934,0,122245,194179
142720300202000,BILLBOARD(BLL),COMMERCIAL,0,0,0,0,14469,14469
142720300300000,FLAT PARKING,COMMERCIAL,0,95905,95905,0,16328,112233
142720300400000,FLAT PARKING,COMMERCIAL,0,13440,13440,0,3920,17360
142720300500000,FLAT PARKING,COMMERCIAL,0,5508,5508,0,0,5508
142720300600000,SMALL RETAIL,COMMERCIAL,0,24510,24510,0,109598,134108
142720300700000,SE 237,RESIDENTIAL,7600,0,7600,25609,0,33209
142720300800000,HOSPITAL,EXEMPT,0,7448,7448,0,0,7448
142720300900000,HOSPITAL,EXEMPT,0,13608,13608,0,0,13608
142720301000000,HOSPITAL,EXEMPT,0,5880,5880,0,0,5880
142720301100000,HOSPITAL,EXEMPT,0,5880,5880,0,0,5880
142720301200000,HOSPITAL,EXEMPT,0,6174,6174,0,0,6174
142720301300000,HOSPITAL,EXEMPT,0,5586,5586,0,0,5586
142720301400000,HOSPITAL,EXEMPT,0,2352,2352,0,0,2352
142720301500000,SE 237,RESIDENTIAL,13500,0,13500,123838,0,137338
142720301600000,SE 237,RESIDENTIAL,5200,0,5200,43174,0,48374
142720301700000,SE 237,RESIDENTIAL,5200,0,5200,37145,0,42345
142720301800000,SE 237,RESIDENTIAL,4950,0,4950,42158,0,47108
142720301900000,SE 237,RESIDENTIAL,6204,0,6204,41230,0,47434
142720302000000,SE 237,RESIDENTIAL,5800,0,5800,51957,0,57757
142720302100000,CITY PROPERTY,EXEMPT,0,0,0,0,0,0
142720302200000,CITY PROPERTY,EXEMPT,0,0,0,0,0,0
142720302300000,CITY PROPERTY,EXEMPT,0,0,0,0,0,0
142720302400000,SE 237,RESIDENTIAL,5840,0,5840,0,0,5840
142720302500000,SE 237,RESIDENTIAL,8240,0,8240,134566,0,142806
142720302600000,SE 237,RESIDENTIAL,7743,0,7743,0,0,7743
142720302700000,SE 237,RESIDENTIAL,12000,0,12000,133401,0,145401
142720302800000,SE 237,RESIDENTIAL,12000,0,12000,44639,0,56639
142720302900000,SE 237,RESIDENTIAL,6000,0,6000,54135,0,60135
142720303000000,SE 237,RESIDENTIAL,6000,0,6000,50948,0,56948
142720303100000,SE 237,RESIDENTIAL,6000,0,6000,42357,0,48357
142720303200000,SE 237,RESIDENTIAL,6000,0,6000,45149,0,51149
142720303300000,SE 237,RESIDENTIAL,8400,0,8400,0,0,8400
142720303400000,SE 237,RESIDENTIAL,8680,0,8680,0,0,8680
142720303500000,RESTAURANT,COMMERCIAL,0,43520,43520,0,48516,92036
142720400100000,CENTRALLY ASSESSED,OTHER,0,0,0,0,0,0
142720400200000,SE 237,RESIDENTIAL,6000,0,6000,0,0,6000
142720400300000,SE 237,RESIDENTIAL,6000,0,6000,111431,0,117431
142720400400000,SE 237,RESIDENTIAL,6000,0,6000,55591,0,61591
142720400500000,SE 237,RESIDENTIAL,6000,0,6000,57047,0,63047
142720400600000,SE 237,RESIDENTIAL,8000,0,8000,60544,0,68544
142720400700000,DAY CARE CENTER,COMMERCIAL,0,8467,8467,0,58352,66819
142720400800000,SE 237,RESIDENTIAL,8000,0,8000,65517,0,73517
142720400900000,SE 237,RESIDENTIAL,8000,0,8000,51794,0,59794
142720401000000,SE 237,RESIDENTIAL,8000,0,8000,44917,0,52917
142720401100000,SE 237,RESIDENTIAL,8000,0,8000,60529,0,68529
142720401200000,SE 237,RESIDENTIAL,8000,0,8000,61998,0,69998
142720401300000,SE 237,RESIDENTIAL,9600,0,9600,62790,0,72390
142720401400000,SE 237,RESIDENTIAL,7650,0,7650,44562,0,52212
142720401500000,SE 237,RESIDENTIAL,2766,0,2766,0,0,2766
142720401600000,SE 237,RESIDENTIAL,12460,0,12460,86739,0,99199
142720401800000,SE 237,RESIDENTIAL,8000,0,8000,85597,0,93597
142720401900000,SE 237,RESIDENTIAL,8000,0,8000,0,0,8000
142720402000000,SE 237,RESIDENTIAL,7637,0,7637,111473,0,119110
142720402100000,SE 237,RESIDENTIAL,8000,0,8000,55880,0,63880
142720402200000,SE 237,RESIDENTIAL,8071,0,8071,65753,0,73824
142720402300000,SE 237,RESIDENTIAL,8000,0,8000,71454,0,79454
142720402400000,SE 237,RESIDENTIAL,8000,0,8000,48969,0,56969
142720402500000,SE 237,RESIDENTIAL,8000,0,8000,78225,0,86225
142720402600000,CONVERSION,COMMERCIAL,0,9072,9072,0,42387,51459
142720402700000,CITY PROPERTY,EXEMPT,0,0,0,0,0,0
142720500100000,SE 237,RESIDENTIAL,8208,0,8208,111599,0,119807
142720600100000,SE 237,RESIDENTIAL,8400,0,8400,119362,0,127762
142720600200000,SE 237,RESIDENTIAL,8246,0,8246,118548,0,126794
142720600300000,SE 237,RESIDENTIAL,6000,0,6000,74237,0,80237
142720600400000,SE 237,RESIDENTIAL,6000,0,6000,63213,0,69213
142720600500000,SE 237,RESIDENTIAL,8400,0,8400,63030,0,71430
142720600600000,SE 237,RESIDENTIAL,8400,0,8400,53096,0,61496
142720600700000,SE 237,RESIDENTIAL,8400,0,8400,107404,0,115804
142720600800000,SE 237,RESIDENTIAL,8100,0,8100,46813,0,54913
142720600900000,SE 237,RESIDENTIAL,8000,0,8000,79073,0,87073
142720601000000,SE 237,RESIDENTIAL,7000,0,7000,99095,0,106095
142720601100000,SE 237,RESIDENTIAL,6735,0,6735,60234,0,66969
142720601200000,SE 237,RESIDENTIAL,8400,0,8400,72527,0,80927
142720601300000,SE 237,RESIDENTIAL,8000,0,8000,57911,0,65911
142720601400000,SE 237,RESIDENTIAL,8177,0,8177,77198,0,85375
142720601500000,SE 237,RESIDENTIAL,3823,0,3823,30314,0,34137
142720601600000,SMALL RETAIL,COMMERCIAL,0,11978,11978,0,54479,66457
142720601700000,SE 237,RESIDENTIAL,5236,0,5236,18344,0,23580
142720601800000,SE 237,RESIDENTIAL,4200,0,4200,44371,0,48571
142720601900000,SE 237,RESIDENTIAL,5600,0,5600,61058,0,66658
142720602000000,SE 237,RESIDENTIAL,8917,0,8917,71506,0,80423
142720602300000,SE 237,RESIDENTIAL,8000,0,8000,77117,0,85117
142720602400000,SE 237,RESIDENTIAL,7400,0,7400,57965,0,65365
142720602500000,SE 237,RESIDENTIAL,7876,0,7876,54355,0,62231
142720602600000,CITY PROPERTY,EXEMPT,0,0,0,0,0,0
142720602700000,SE 237,RESIDENTIAL,8500,0,8500,0,0,8500
142720602800000,SE 237,RESIDENTIAL,8000,0,8000,63296,0,71296
142720602900000,SE 237,RESIDENTIAL,8000,0,8000,112000,0,120000
142720603000000,SE 237,RESIDENTIAL,6000,0,6000,64420,0,70420
142720603100000,SE 237,RESIDENTIAL,6000,0,6000,69642,0,75642
142720603200000,SE 237,RESIDENTIAL,11520,0,11520,46329,0,57849
142720700100000,SE 237,RESIDENTIAL,6000,0,6000,39467,0,45467
142720700200000,SE 237,RESIDENTIAL,6000,0,6000,49935,0,55935
142720700300000,SE 237,RESIDENTIAL,8000,0,8000,39654,0,47654
142720700400000,SE 237,RESIDENTIAL,8000,0,8000,0,0,8000
142720700500000,SE 237,RESIDENTIAL,8022,0,8022,47752,0,55774
142720700600000,SE 237,RESIDENTIAL,8000,0,8000,60444,0,68444
142720700700000,SE 237,RESIDENTIAL,8256,0,8256,45718,0,53974
142720700800000,SE 237,RESIDENTIAL,6840,0,6840,72229,0,79069
142720700900000,CITY PROPERTY,EXEMPT,0,0,0,0,0,0
142720701000000,SE 237,RESIDENTIAL,11185,0,11185,69858,0,81043
142720701100000,SE 237,RESIDENTIAL,8000,0,8000,58047,0,66047
142720701200000,SE 237,RESIDENTIAL,8000,0,8000,117171,0,125171
142720701300000,SE 237,RESIDENTIAL,8000,0,8000,71133,0,79133
142720701400000,SE 237,RESIDENTIAL,8000,0,8000,121844,0,129844
142720701500000,SE 237,RESIDENTIAL,8000,0,8000,121844,0,129844
142720701600000,SE 237,RESIDENTIAL,8000,0,8000,127053,0,135053
142720701700000,SE 237,RESIDENTIAL,8000,0,8000,117155,0,125155
142720701800000,SE 237,RESIDENTIAL,8000,0,8000,44130,0,52130
142720701900000,SE 237,RESIDENTIAL,8000,0,8000,55739,0,63739
142720702000000,SE 237,RESIDENTIAL,3040,0,3040,0,0,3040
142720702100000,SMALL RETAIL,COMMERCIAL,0,7700,7700,0,21888,29588
142720702200000,SE 237,RESIDENTIAL,7839,0,7839,52919,0,60758
142720702300000,SE 237,RESIDENTIAL,4800,0,4800,0,0,4800
142720702400000,SE 237,RESIDENTIAL,4800,0,4800,67863,0,72663
142720702500000,CITY PROPERTY,EXEMPT,0,0,0,0,0,0
142720702600000,SE 237,RESIDENTIAL,8000,0,8000,62616,0,70616
142720702700000,SE 237,RESIDENTIAL,8000,0,8000,0,0,8000
142720800100000,SE 237,RESIDENTIAL,6300,0,6300,49457,0,55757
142720800200000,SE 237,RESIDENTIAL,6000,0,6000,60836,0,66836
142720801100000,SE 237,RESIDENTIAL,7867,0,7867,100141,0,108008
142720801200000,SE 237,RESIDENTIAL,8000,0,8000,91951,0,99951
142720801300000,SE 237,RESIDENTIAL,8400,0,8400,118333,0,126733
142720801400000,SE 237,RESIDENTIAL,8400,0,8400,99013,0,107413
142720801500000,SE 237,RESIDENTIAL,8400,0,8400,92142,0,100542
142720801600000,SE 237,RESIDENTIAL,8600,0,8600,113686,0,122286
142722700100000,OFFICE; MED; CTRL CR,COMMERCIAL,0,398430,398430,0,1076887,1475317
142722700200000,FLAT PARKING,COMMERCIAL,0,46400,46400,0,2320,48720
142722700300000,OFFICE; MED; CTRL CR,COMMERCIAL,0,326200,326200,0,2114944,2441144
142722900100000,SE 237,RESIDENTIAL,8208,0,8208,40127,0,48335
142722900200000,SE 237,RESIDENTIAL,7440,0,7440,98761,0,106201
142722900300000,SE 237,RESIDENTIAL,6200,0,6200,74744,0,80944
142722900400000,SE 237,RESIDENTIAL,4980,0,4980,47667,0,52647
142722900500000,SE 237,RESIDENTIAL,4980,0,4980,39540,0,44520
142722900600000,VACANT LAND,COMMERCIAL,0,11812,11812,0,0,11812
142722900700000,SE 237,RESIDENTIAL,8000,0,8000,84531,0,92531
142722900800000,SE 237,RESIDENTIAL,7000,0,7000,65528,0,72528
142722900900000,SE 237,RESIDENTIAL,8000,0,8000,113741,0,121741
142722901000000,SE 237,RESIDENTIAL,7221,0,7221,86672,0,93893
142722901100000,CHURCH,EXEMPT,0,2703,2703,0,30141,32844
142722901400000,SE 237,RESIDENTIAL,7440,0,7440,45982,0,53422
142722901500000,SE 237,RESIDENTIAL,6000,0,6000,80673,0,86673
142722901600000,SE 237,RESIDENTIAL,6000,0,6000,54614,0,60614
142722902000000,SE 237,RESIDENTIAL,8200,0,8200,103130,0,111330
142722902100000,SE 237,RESIDENTIAL,8000,0,8000,102147,0,110147
142722902200000,SE 237,RESIDENTIAL,8000,0,8000,94820,0,102820
142722902400000,VACANT LAND,RESIDENTIAL,720,0,720,0,0,720
142722902500000,SE 237,RESIDENTIAL,8208,0,8208,100361,0,108569
142723000100000,FLAT PARKING,COMMERCIAL,0,251640,251640,0,48460,300100
142723000200000,HOSPITAL,EXEMPT,0,230580,230580,0,87671,318251
142723000300000,HOSPITAL,EXEMPT,0,10195,10195,0,4656,14851
142723000400000,HOSPITAL,EXEMPT,0,10195,10195,0,4656,14851
142723000500000,FLAT PARKING,COMMERCIAL,0,40027,40027,0,2700,42727
142723100400000,OFFICE; MED; CTRL CR,COMMERCIAL,0,546000,546000,0,5334595,5880595
142723200100000,SE 237,RESIDENTIAL,6390,0,6390,86529,0,92919
142723200200000,SE 237,RESIDENTIAL,1538,0,1538,0,0,1538
142723200300000,SE 237,RESIDENTIAL,4241,0,4241,0,0,4241
142723200600000,SE 237,RESIDENTIAL,8000,0,8000,105565,0,113565
142723200700000,SE 237,RESIDENTIAL,8000,0,8000,85145,0,93145
142723200800000,SE 237,RESIDENTIAL,6000,0,6000,60073,0,66073
142723200900000,CITY PROPERTY,EXEMPT,0,0,0,0,0,0
142723201000000,SE 237,RESIDENTIAL,6300,0,6300,45378,0,51678
142723201100000,SE 237,RESIDENTIAL,6510,0,6510,91886,0,98396
142723201200000,SE 237,RESIDENTIAL,8009,0,8009,127249,0,135258
142723201300000,SE 237,RESIDENTIAL,10394,0,10394,114251,0,124645
142723201400000,SE 237,RESIDENTIAL,6000,0,6000,67715,0,73715
142723201500000,SE 237,RESIDENTIAL,7000,0,7000,46430,0,53430
142723201800000,SE 237,RESIDENTIAL,8000,0,8000,141803,0,149803
142723202000000,SE 237,RESIDENTIAL,6000,0,6000,118431,0,124431
142723202100000,SE 237,RESIDENTIAL,12015,0,12015,106144,0,118159
142723202200000,SE 237,RESIDENTIAL,6000,0,6000,121431,0,127431
142723300100000,FLAT PARKING,COMMERCIAL,0,180000,180000,0,18000,198000
142723300200000,HOSPITAL,EXEMPT,0,186030,186030,0,531476,717506
142723300300000,HOSPITAL,EXEMPT,0,13608,13608,0,5393,19001
142723300400000,HOSPITAL,EXEMPT,0,54432,54432,0,17490,71922
142723400100000,SE 237,RESIDENTIAL,6000,0,6000,118605,0,124605
142723400200000,SE 237,RESIDENTIAL,6000,0,6000,50981,0,56981
142723500200000,SE 237,RESIDENTIAL,3323,0,3323,0,0,3323
142723500300000,SE 237,RESIDENTIAL,5580,0,5580,52055,0,57635
142723500400000,SE 237,RESIDENTIAL,6840,0,6840,90632,0,97472
142723500500000,SE 237,RESIDENTIAL,8400,0,8400,122767,0,131167
142723500600000,SE 237,RESIDENTIAL,6000,0,6000,50826,0,56826
142723500700000,SE 237,RESIDENTIAL,6000,0,6000,35859,0,41859
142723500800000,SE 237,RESIDENTIAL,6226,0,6226,58879,0,65105
142723500900000,SE 237,RESIDENTIAL,5774,0,5774,66481,0,72255
142723501000000,SE 237,RESIDENTIAL,8400,0,8400,93991,0,102391
142723501100000,SE 237,RESIDENTIAL,8400,0,8400,109047,0,117447
142723501200000,SE 237,RESIDENTIAL,6000,0,6000,44841,0,50841
142723501300000,SE 237,RESIDENTIAL,6000,0,6000,51522,0,57522
142723501400000,SE 237,RESIDENTIAL,8400,0,8400,93615,0,102015
142723501500000,SE 237,RESIDENTIAL,8400,0,8400,66113,0,74513
142723501700000,SE 237,RESIDENTIAL,6480,0,6480,92950,0,99430
142723600800000,SE 237,RESIDENTIAL,5000,0,5000,0,0,5000
142723600900000,SMALL RETAIL,EXEMPT,0,20412,20412,0,215686,236098
142723601300000,SECTION 42,COMMERCIAL,0,130400,130400,0,765483,895883
142723700100000,SMALL RET; CTRL CR,COMMERCIAL,0,156800,156800,0,421396,578196
142723700700000,FLAT PARKING,COMMERCIAL,0,29400,29400,0,4823,34223
142723700800000,HOSPITAL,EXEMPT,0,3836,3836,0,0,3836
142723700900000,FLAT PARKING,COMMERCIAL,0,110700,110700,0,20580,131280
142723701000000,HOSPITAL,EXEMPT,0,11760,11760,0,0,11760
142723701100000,VACANT LAND,EXEMPT,0,0,0,0,0,0
142723701200000,HOSPITAL,EXEMPT,0,4720,4720,0,0,4720
142723800100000,SE 237,RESIDENTIAL,6510,0,6510,54554,0,61064
142723800400000,SE 237,RESIDENTIAL,9000,0,9000,106341,0,115341
142723800500000,SE 237,RESIDENTIAL,8600,0,8600,110709,0,119309
142723800600000,SE 237,RESIDENTIAL,7600,0,7600,115634,0,123234
142723800700000,SE 237,RESIDENTIAL,7800,0,7800,100601,0,108401
142723900100000,OFFICE,EXEMPT,0,34020,34020,0,301433,335453
142723900200000,SE 237,EXEMPT,0,2480,2480,0,0,2480
142723900300000,SMALL RETAIL,COMMERCIAL,0,5400,5400,0,531,5931
142723900400000,SE 237,RESIDENTIAL,4233,0,4233,93948,0,98181
142723900500000,SE 237,RESIDENTIAL,7650,0,7650,115887,0,123537
142723900600000,SE 237,RESIDENTIAL,7650,0,7650,105694,0,113344
142723900900000,SE 237,RESIDENTIAL,7650,0,7650,106073,0,113723
142723901000000,CHURCH,EXEMPT,0,13608,13608,0,27984,41592
142723901100000,SE 237,RESIDENTIAL,6076,0,6076,53975,0,60051
142723901200000,SE 237,RESIDENTIAL,6300,0,6300,63167,0,69467
142723901300000,SE 237,RESIDENTIAL,5800,0,5800,118431,0,124231
142723901400000,SE 237,RESIDENTIAL,6200,0,6200,118431,0,124631
142723901500000,SE 237,RESIDENTIAL,5400,0,5400,0,0,5400
142724000100000,CHURCH,EXEMPT,0,24601,24601,0,212944,237545
142724000200000,SE 237,RESIDENTIAL,6686,0,6686,51743,0,58429
142724000300000,CITY PROPERTY,EXEMPT,0,4842,4842,0,0,4842
142724000400000,CITY PROPERTY,EXEMPT,0,0,0,0,0,0
142724000500000,CITY PROPERTY,EXEMPT,0,0,0,0,0,0
142724000600000,SE 237,RESIDENTIAL,288,0,288,0,0,288
142724000700000,SE 237,RESIDENTIAL,5100,0,5100,45073,0,50173
142724000800000,SE 237,RESIDENTIAL,5100,0,5100,58758,0,63858
142724000900000,SE 237,RESIDENTIAL,4554,0,4554,47452,0,52006
142724001000000,SE 237,RESIDENTIAL,1984,0,1984,0,0,1984
142724001100000,CITY PROPERTY,EXEMPT,0,0,0,0,0,0
142724001200000,SE 237,RESIDENTIAL,7650,0,7650,36523,0,44173
142724001300000,SE 237,RESIDENTIAL,7650,0,7650,0,0,7650
142724001400000,SE 237,RESIDENTIAL,7650,0,7650,0,0,7650
142724001500000,SE 237,RESIDENTIAL,7650,0,7650,36955,0,44605
142724001600000,SE 237,RESIDENTIAL,6770,0,6770,0,0,6770
142724001700000,SE 237,RESIDENTIAL,1840,0,1840,0,0,1840
142724200200000,HOSPITAL,EXEMPT,0,0,0,0,0,0
142725100300000,SE 237,RESIDENTIAL,2700,0,2700,0,0,2700
142725100400000,SE 237,RESIDENTIAL,5000,0,5000,0,0,5000
142725100500000,SE 237,RESIDENTIAL,5440,0,5440,60176,0,65616
142725100600000,SE 237,RESIDENTIAL,7888,0,7888,91046,0,98934
142725100700000,SE 237,RESIDENTIAL,5100,0,5100,51990,0,57090
142725100800000,SE 237,RESIDENTIAL,5100,0,5100,0,0,5100
142725100900000,SE 237,RESIDENTIAL,5100,0,5100,55368,0,60468
142725101000000,SE 237,RESIDENTIAL,5000,0,5000,0,0,5000
142725101100000,SE 237,RESIDENTIAL,1079,0,1079,9079,0,10158
142725101200000,SE 237,RESIDENTIAL,7882,0,7882,85020,0,92902
142725101300000,SE 237,RESIDENTIAL,6637,0,6637,37093,0,43730
142725101400000,SE 237,RESIDENTIAL,5400,0,5400,48468,0,53868
142725101500000,SE 237,RESIDENTIAL,6000,0,6000,52519,0,58519
142725101600000,SE 237,RESIDENTIAL,6000,0,6000,0,0,6000
142725101700000,SE 237,RESIDENTIAL,6000,0,6000,57728,0,63728
142725101800000,SE 237,RESIDENTIAL,6000,0,6000,85635,0,91635
142725101900000,SE 237,RESIDENTIAL,9000,0,9000,111746,0,120746
142725200100000,VACANT LAND,EXEMPT,0,0,0,0,0,0
142725300200000,SE 237,RESIDENTIAL,5000,0,5000,0,0,5000
142725300300000,CITY PROPERTY,EXEMPT,0,0,0,0,0,0
142725300400000,SE 237,RESIDENTIAL,6349,0,6349,70884,0,77233
142725300600000,SECTION 42,COMMERCIAL,0,83200,83200,0,594292,677492
142725400100000,SCHOOL,EXEMPT,0,0,0,0,0,0
142725400200000,SCHOOL,EXEMPT,0,0,0,0,0,0
142725500100000,SE 237,RESIDENTIAL,5355,0,5355,69924,0,75279
142725500400000,SE 237,RESIDENTIAL,5355,0,5355,38020,0,43375
142725501300000,RESTAURANT,COMMERCIAL,0,14400,14400,0,61311,75711
142725501500000,SE 237,RESIDENTIAL,5440,0,5440,45811,0,51251
142725501700000,SE 237,RESIDENTIAL,5100,0,5100,24822,0,29922
142725501800000,SE 237,RESIDENTIAL,7650,0,7650,141321,0,148971
142725502000000,SECTION 42,COMMERCIAL,0,95040,95040,0,857101,952141
142725600100000,OFFICE,COMMERCIAL,0,25200,25200,0,29772,54972
142725600200000,CITY PROPERTY,EXEMPT,0,0,0,0,0,0
142725600300000,CITY PROPERTY,EXEMPT,0,0,0,0,0,0
142725600400000,VACANT LAND,COMMERCIAL,0,53340,53340,0,0,53340
142725600500000,SE 237,RESIDENTIAL,4950,0,4950,66618,0,71568
142725600600000,CITY PROPERTY,EXEMPT,0,5000,5000,0,0,5000
142725600700000,VACANT LAND,COMMERCIAL,0,16800,16800,0,0,16800
142725600800000,FLAT PARKING,COMMERCIAL,0,16800,16800,0,0,16800
142725600900000,SE 237,RESIDENTIAL,6000,0,6000,0,0,6000
142725601000000,SE 237,RESIDENTIAL,6000,0,6000,59628,0,65628
142725601100000,SE 237,RESIDENTIAL,6000,0,6000,31189,0,37189
142725601200000,SE 237,RESIDENTIAL,6000,0,6000,0,0,6000
142725601300000,SE 237,RESIDENTIAL,6000,0,6000,0,0,6000
142725700100000,RESTAURANT,COMMERCIAL,0,8775,8775,0,19315,28090
142725700200000,CITY PROPERTY,EXEMPT,0,0,0,0,0,0
142725700300000,CITY PROPERTY,EXEMPT,0,0,0,0,0,0
142725700500000,CITY PROPERTY,EXEMPT,0,0,0,0,0,0
142725700600000,CITY PROPERTY,EXEMPT,0,0,0,0,0,0
142725800701022,SMALL RETAIL,COMMERCIAL,0,7200,7200,0,80547,87747
142725800701023,SMALL RETAIL,COMMERCIAL,0,7200,7200,0,80547,87747
142725800701024,SMALL RETAIL,COMMERCIAL,0,7200,7200,0,80547,87747
142725800701025,SMALL RETAIL,COMMERCIAL,0,7200,7200,0,80547,87747
142725801000000,CENTRALLY ASSESSED,OTHER,0,0,0,0,0,0
142725900100000,CITY PROPERTY,EXEMPT,0,0,0,0,0,0
142725900200000,CENTRALLY ASSESSED,OTHER,0,0,0,0,0,0
142726000200000,SCHOOL,EXEMPT,0,243000,243000,0,510569,753569
142726000602000,BILLBOARD(BLL),COMMERCIAL,0,0,0,0,10277,10277
142726000800000,CITY PROPERTY,EXEMPT,0,0,0,0,0,0
142726100100000,FLAT PARKING,EXEMPT,0,130950,130950,0,4419,135369
142726100300000,CITY PROPERTY,EXEMPT,0,0,0,0,0,0
142726100400000,SE 237,RESIDENTIAL,2677,0,2677,0,0,2677
142726100500000,CHURCH,EXEMPT,0,22950,22950,0,0,22950
142726100700000,CITY PROPERTY,EXEMPT,0,0,0,0,0,0
142726100800000,CITY PROPERTY,EXEMPT,0,0,0,0,0,0
142726100900000,SE 237,RESIDENTIAL,2295,0,2295,0,0,2295
142726101000000,CITY PROPERTY,EXEMPT,0,0,0,0,0,0
142726101100000,CITY PROPERTY,EXEMPT,0,0,0,0,0,0
142726101200000,CITY PROPERTY,EXEMPT,0,0,0,0,0,0
142726101300000,CITY PROPERTY,EXEMPT,0,0,0,0,0,0
142726101500000,VACANT LAND,COMMERCIAL,0,209250,209250,0,0,209250
142726101600000,VACANT LAND,COMMERCIAL,0,61300,61300,0,0,61300
142726200100000,FLAT PARKING,COMMERCIAL,0,102800,102800,0,58805,161605
142727600100000,APARTMENT,COMMERCIAL,0,128400,128400,0,575158,703558
142727600200000,SE 237,RESIDENTIAL,11000,0,11000,137781,0,148781
142727700100000,APARTMENT,COMMERCIAL,0,441200,441200,0,1921529,2362729
142727700200000,CHURCH,EXEMPT,0,26055,26055,0,148349,174404
142727700300000,FLAT PARKING,EXEMPT,0,145800,145800,0,1762,147562
142727700400000,CITY PROPERTY,EXEMPT,0,0,0,0,0,0
142727700500000,CITY PROPERTY,EXEMPT,0,0,0,0,0,0
142727700600000,SCHOOL,EXEMPT,0,104490,104490,0,1760271,1864761
142727700700000,CITY PROPERTY,EXEMPT,0,0,0,0,0,0
142727700800000,CITY PROPERTY,EXEMPT,0,0,0,0,0,0
142727700900000,APARTMENT,COMMERCIAL,0,71400,71400,0,287572,358972
142727800100000,CITY PROPERTY,EXEMPT,0,0,0,0,0,0
142727900300000,SE 237,RESIDENTIAL,7000,0,7000,103966,0,110966
142727900400000,SE 237,RESIDENTIAL,7000,0,7000,92142,0,99142
142728000100000,SE 237,RESIDENTIAL,9894,0,9894,78726,0,88620
142728000200000,SE 237,RESIDENTIAL,9894,0,9894,86355,0,96249
142728000300000,SE 237,RESIDENTIAL,9894,0,9894,87108,0,97002
142728000400000,SE 237,RESIDENTIAL,9894,0,9894,84671,0,94565
142728000500000,APARTMENT,COMMERCIAL,0,76200,76200,0,282097,358297
142728100100000,FLAT PARKING,INDUSTRIAL,0,4244,4244,0,31830,36074
142728100200000,FLAT PARKING,INDUSTRIAL,0,2236,2236,0,15347,17583
142728100300000,FLAT PARKING,INDUSTRIAL,0,2300,2300,0,15631,17931
142728100400000,WAREHOUSE,INDUSTRIAL,0,58320,58320,0,102773,161093
142728100500000,VACANT LAND,INDUSTRIAL,0,891,891,0,0,891
142728100600000,VACANT LAND,INDUSTRIAL,0,1134,1134,0,0,1134
142728100700000,VACANT LAND,INDUSTRIAL,0,1085,1085,0,0,1085
142728100800000,FLAT PARKING,INDUSTRIAL,0,3127,3127,0,5400,8527
142728100900000,FLAT PARKING,INDUSTRIAL,0,7970,7970,0,48314,56284
142728101000000,FLAT PARKING,INDUSTRIAL,0,13932,13932,0,76440,90372
142728200100000,SE 237,RESIDENTIAL,3808,0,3808,0,0,3808
142728200200000,SE 237,RESIDENTIAL,3467,0,3467,0,0,3467
142728200300000,SE 237,RESIDENTIAL,3232,0,3232,58429,0,61661
142728200400000,SE 237,RESIDENTIAL,3060,0,3060,0,0,3060
142728200500000,SE 237,RESIDENTIAL,7434,0,7434,0,0,7434
142728200600000,SE 237,RESIDENTIAL,3880,0,3880,0,0,3880
142728200700000,SE 237,RESIDENTIAL,2838,0,2838,64769,0,67607
142728200800000,CITY PROPERTY,EXEMPT,0,0,0,0,0,0
142728200900000,SE 237,RESIDENTIAL,5000,0,5000,0,0,5000
142728300100000,VACANT LAND,COMMERCIAL,0,5355,5355,0,0,5355
142728300200000,SE 237,RESIDENTIAL,3000,0,3000,0,0,3000
142728300300000,VACANT LAND,COMMERCIAL,0,10710,10710,0,0,10710
142728300400000,SE 237,RESIDENTIAL,5100,0,5100,0,0,5100
142728300500000,CITY PROPERTY,EXEMPT,0,0,0,0,0,0
142728300600000,SE 237,RESIDENTIAL,5100,0,5100,23892,0,28992
142728300700000,CITY PROPERTY,EXEMPT,0,0,0,0,0,0
142730100200000,FOOD GRADE;INDUST,INDUSTRIAL,0,29970,29970,0,0,29970
142730200100000,FLAT PARKING,INDUSTRIAL,0,1555,1555,0,10515,12070
142730200200000,FLAT PARKING,INDUSTRIAL,0,1555,1555,0,10515,12070
142730200300000,FLAT PARKING,INDUSTRIAL,0,3127,3127,0,21315,24442
142730200400000,FLAT PARKING,INDUSTRIAL,0,3127,3127,0,19894,23021
142730200500000,FLAT PARKING,INDUSTRIAL,0,3127,3127,0,5684,8811
142730200600000,VACANT LAND,INDUSTRIAL,0,3127,3127,0,0,3127
142730300100000,SE 237,RESIDENTIAL,2728,0,2728,0,0,2728
142730300200000,SE 237,RESIDENTIAL,5100,0,5100,0,0,5100
142730300300000,SE 237,RESIDENTIAL,1200,0,1200,0,0,1200
142730300400000,SE 237,RESIDENTIAL,5100,0,5100,0,0,5100
142730300500000,CITY PROPERTY,EXEMPT,0,0,0,0,0,0
142730300600000,CITY PROPERTY,EXEMPT,0,0,0,0,0,0
142730300700000,CITY PROPERTY,EXEMPT,0,0,0,0,0,0
142730300800000,SE 237,RESIDENTIAL,2666,0,2666,0,0,2666
142730300900000,SE 237,RESIDENTIAL,3286,0,3286,0,0,3286
142730301000000,CITY PROPERTY,EXEMPT,0,0,0,0,0,0
142730400100000,SE 237,RESIDENTIAL,4980,0,4980,0,0,4980
142730400200000,SE 237,RESIDENTIAL,5000,0,5000,0,0,5000
142730400300000,CITY PROPERTY,EXEMPT,0,0,0,0,0,0
142730400400000,CITY PROPERTY,EXEMPT,0,0,0,0,0,0
142730400500000,SE 237,RESIDENTIAL,3000,0,3000,0,0,3000
142730400600000,SE 237,RESIDENTIAL,3000,0,3000,0,0,3000
142730400700000,SE 237,RESIDENTIAL,3000,0,3000,0,0,3000
142730400800000,SE 237,RESIDENTIAL,3000,0,3000,0,0,3000
142730400900000,SE 237,RESIDENTIAL,1200,0,1200,0,0,1200
142730401000000,SE 237,RESIDENTIAL,2550,0,2550,0,0,2550
142730401100000,SE 237,RESIDENTIAL,3100,0,3100,0,0,3100
142730500100000,CENTRALLY ASSESSED,OTHER,0,0,0,0,0,0
142730500200000,OFFICE,EXEMPT,0,0,0,0,0,0
142730600600000,FOOD GRADE;INDUST,INDUSTRIAL,0,52974,52974,0,447311,500285
142730700100000,SE 237,RESIDENTIAL,3800,0,3800,0,0,3800
142730700200000,SE 237,RESIDENTIAL,3800,0,3800,0,0,3800
142730700300000,CITY PROPERTY,EXEMPT,0,0,0,0,0,0
142730700400000,SE 237,RESIDENTIAL,5168,0,5168,0,0,5168
142730700500000,SE 237,RESIDENTIAL,2944,0,2944,0,0,2944
142730700600000,SE 237,RESIDENTIAL,2944,0,2944,0,0,2944
142730700700000,SE 237,RESIDENTIAL,3800,0,3800,0,0,3800
142730700800000,SE 237,RESIDENTIAL,1253,0,1253,0,0,1253
142730700900000,SE 237,RESIDENTIAL,2628,0,2628,0,0,2628
142730701000000,VACANT LAND,COMMERCIAL,0,1050,1050,0,0,1050
142732600100000,WAREHOUSE,COMMERCIAL,0,50026,50026,0,64681,114707
142732600200000,FLAT PARKING,COMMERCIAL,0,72030,72030,0,2160,74190
142732700100000,SE 237,RESIDENTIAL,800,0,800,0,0,800
142732700800000,VACANT LAND,COMMERCIAL,0,12600,12600,0,0,12600
142732700900000,WAREHOUSE,COMMERCIAL,0,25200,25200,0,21095,46295
142732701000000,SE 237,RESIDENTIAL,5000,0,5000,0,0,5000
142732701200000,CITY PROPERTY,EXEMPT,0,0,0,0,0,0
142732701300000,CITY PROPERTY,EXEMPT,0,0,0,0,0,0
142732701400000,SE 237,RESIDENTIAL,3500,0,3500,0,0,3500
142732701500000,AUTO REPAIR/SALES,COMMERCIAL,0,25620,25620,0,15702,41322
142732701600000,CITY PROPERTY,EXEMPT,0,0,0,0,0,0
142732701700000,SE 237,RESIDENTIAL,2550,0,2550,0,0,2550
142732701800000,CITY PROPERTY,EXEMPT,0,0,0,0,0,0
142732701900000,SE 237,RESIDENTIAL,3000,0,3000,0,0,3000
142732702000000,SE 237,RESIDENTIAL,1200,0,1200,0,0,1200
142732702100000,SE 237,RESIDENTIAL,1280,0,1280,2611,0,3891
142732702200000,CITY PROPERTY,EXEMPT,0,0,0,0,0,0
142732800100000,CITY PROPERTY,EXEMPT,0,0,0,0,0,0
142732800200000,WAREHOUSE,COMMERCIAL,0,65500,65500,0,134721,200221
142732800600000,CITY PROPERTY,EXEMPT,0,0,0,0,0,0
142732800700000,VACANT LAND,COMMERCIAL,0,22500,22500,0,0,22500
142732800800000,VACANT LAND,COMMERCIAL,0,15938,15938,0,0,15938
142732801000000,CITY PROPERTY,EXEMPT,0,0,0,0,0,0
142732801100000,RESTAURANT,COMMERCIAL,0,44430,44430,0,95495,139925
142732801200000,CITY PROPERTY,EXEMPT,0,0,0,0,0,0
142732900100000,CITY PROPERTY,EXEMPT,0,0,0,0,0,0
142732900200000,CITY PROPERTY,EXEMPT,0,0,0,0,0,0
142732900300000,SE 237,RESIDENTIAL,1360,0,1360,0,0,1360
142732900400000,SE 237,RESIDENTIAL,2600,0,2600,0,0,2600
142732900500000,BARS/LOUNGE,COMMERCIAL,0,21343,21343,0,57995,79338
142732900600000,FLAT PARKING,COMMERCIAL,0,9410,9410,0,2040,11450
142733000100000,OFFICE,COMMERCIAL,0,47580,47580,0,4222,51802
142733000200000,VACANT LAND,COMMERCIAL,0,10300,10300,0,0,10300
142733000300000,WAREHOUSE,COMMERCIAL,0,51653,51653,0,81686,133339
142733000400000,SMALL RETAIL,COMMERCIAL,0,18930,18930,0,83024,101954
142733000500000,FLAT PARKING,COMMERCIAL,0,8228,8228,0,0,8228
142733000600000,BARS/LOUNGE,COMMERCIAL,0,9754,9754,0,25000,34754
142733000700000,SMALL RETAIL,COMMERCIAL,0,12084,12084,0,63350,75434
142733000800000,OFFICE,COMMERCIAL,0,30794,30794,0,31083,61877
142733000900000,VACANT LAND,COMMERCIAL,0,20460,20460,0,0,20460
142733001000000,SE 237,RESIDENTIAL,5202,0,5202,0,0,5202
142733001100000,SE 237,RESIDENTIAL,5000,0,5000,0,0,5000
142733001200000,SE 237,RESIDENTIAL,6242,0,6242,0,0,6242
142733001300000,CITY PROPERTY,EXEMPT,0,0,0,0,0,0
142733001400000,CITY PROPERTY,EXEMPT,0,0,0,0,0,0
142733001500000,SE 237,RESIDENTIAL,1224,0,1224,0,0,1224
142733001600000,CITY PROPERTY,EXEMPT,0,0,0,0,0,0
142733001700000,CITY PROPERTY,EXEMPT,0,0,0,0,0,0
142733001800000,CITY PROPERTY,EXEMPT,0,0,0,0,0,0
142733001900000,CITY PROPERTY,EXEMPT,0,0,0,0,0,0
142733100100000,CITY PROPERTY,EXEMPT,0,0,0,0,0,0
142733100200000,CITY PROPERTY,EXEMPT,0,0,0,0,0,0
142733100300000,CITY PROPERTY,EXEMPT,0,0,0,0,0,0
142733100400000,CITY PROPERTY,EXEMPT,0,0,0,0,0,0
142733100500000,CITY PROPERTY,EXEMPT,0,0,0,0,0,0
142733100600000,CITY PROPERTY,EXEMPT,0,0,0,0,0,0
142733100700000,CITY PROPERTY,EXEMPT,0,0,0,0,0,0
142733100800000,CITY PROPERTY,EXEMPT,0,0,0,0,0,0
142733100900000,CITY PROPERTY,EXEMPT,0,0,0,0,0,0
142733101000000,CITY PROPERTY,EXEMPT,0,0,0,0,0,0
142733101100000,CITY PROPERTY,EXEMPT,0,0,0,0,0,0
142733101200000,CITY PROPERTY,EXEMPT,0,0,0,0,0,0
142733101300000,CITY PROPERTY,EXEMPT,0,0,0,0,0,0
142733101400000,CITY PROPERTY,EXEMPT,0,0,0,0,0,0
142733101500000,CITY PROPERTY,EXEMPT,0,0,0,0,0,0
142733101600000,CITY PROPERTY,EXEMPT,0,0,0,0,0,0
142733101700000,CITY PROPERTY,EXEMPT,0,0,0,0,0,0
142733101800000,FLAT PARKING,INDUSTRIAL,0,5184,5184,0,2640,7824
142733101900000,CITY PROPERTY,EXEMPT,0,0,0,0,0,0
142733102000000,CITY PROPERTY,EXEMPT,0,0,0,0,0,0
142733200100000,CITY PROPERTY,EXEMPT,0,0,0,0,0,0
142735100100000,CITY PROPERTY,EXEMPT,0,0,0,0,0,0
142735200100000,CITY PROPERTY,EXEMPT,0,0,0,0,0,0
142735200200000,WAREHOUSE,COMMERCIAL,0,16497,16497,0,0,16497
142735300100000,WAREHOUSE,COMMERCIAL,0,27610,27610,0,13111,40721
142735300200000,SW 412,RESIDENTIAL,15767,0,15767,0,0,15767
142735300300000,CITY PROPERTY,EXEMPT,0,0,0,0,0,0
142735300400000,CITY PROPERTY,EXEMPT,0,0,0,0,0,0
142735300500000,CITY PROPERTY,EXEMPT,0,0,0,0,0,0
142735300600000,CITY PROPERTY,EXEMPT,0,0,0,0,0,0
142735300700000,CITY PROPERTY,EXEMPT,0,0,0,0,0,0
142735400100000,COUNTY PROPERTY,EXEMPT,0,0,0,0,0,0
142735400200000,CITY PROPERTY,EXEMPT,0,0,0,0,0,0
142735400300000,SW 402,RESIDENTIAL,18375,0,18375,27146,0,45521
142735400400000,CITY PROPERTY,EXEMPT,0,0,0,0,0,0
142735400500000,SW 402,RESIDENTIAL,13125,0,13125,78455,0,91580
142735400600000,CITY PROPERTY,EXEMPT,0,0,0,0,0,0
142735400700000,CITY PROPERTY,EXEMPT,0,0,0,0,0,0
142735400800000,CITY PROPERTY,EXEMPT,0,0,0,0,0,0
142735400900000,CITY PROPERTY,EXEMPT,0,0,0,0,0,0
142735401000000,CITY PROPERTY,EXEMPT,0,0,0,0,0,0
142735401100000,CITY PROPERTY,EXEMPT,0,0,0,0,0,0
142735401200000,CITY PROPERTY,EXEMPT,0,0,0,0,0,0
142735401300000,CITY PROPERTY,EXEMPT,0,0,0,0,0,0
142737600100000,CITY PROPERTY,EXEMPT,0,0,0,0,0,0
142740100100000,CENTRALLY ASSESSED,OTHER,0,0,0,0,0,0
142742600100000,FOOD GRADE;INDUST,INDUSTRIAL,0,386370,386370,0,7856600,8242970
142745100100000,CITY PROPERTY,EXEMPT,0,0,0,0,0,0
142747600100000,CENTRALLY ASSESSED,OTHER,0,0,0,0,0,0
142810100100000,FEDERAL PROPERTY,EXEMPT,0,0,0,0,0,0
142810300100000,CONVERSION,COMMERCIAL,0,15876,15876,0,98390,114266
142810300200000,CONVERSION,COMMERCIAL,0,3402,3402,0,43338,46740
142810300300000,FLAT PARKING,COMMERCIAL,0,96375,96375,0,68516,164891
142810300500000,WAREHOUSE; CTRL CR,COMMERCIAL,0,84375,84375,0,444254,528629
142810300600000,FLAT PARKING,COMMERCIAL,0,12052,12052,0,11861,23913
142810300700000,VACANT LAND,COMMERCIAL,0,24105,24105,0,0,24105
142810400100000,WAREHOUSE; CTRL CR,COMMERCIAL,0,72314,72314,0,167555,239869
142810400200000,WAREHOUSE; CTRL CR,COMMERCIAL,0,186250,186250,0,1035810,1222060
142810500100000,CONVERSION,EXEMPT,0,19157,19157,0,312824,331981
142810500300000,FLAT PARKING,COMMERCIAL,0,36250,36250,0,0,36250
142810500400000,CITY PROPERTY,EXEMPT,0,0,0,0,0,0
142810500500000,FLAT PARKING,COMMERCIAL,0,36250,36250,0,68449,104699
142810500600000,VACANT LAND,COMMERCIAL,0,26250,26250,0,0,26250
142810500700000,VACANT LAND,COMMERCIAL,0,23750,23750,0,0,23750
142810500800000,FLAT PARKING,COMMERCIAL,0,58750,58750,0,42112,100862
142810500900000,VACANT LAND,COMMERCIAL,0,12500,12500,0,0,12500
142810501000000,FLAT PARKING,COMMERCIAL,0,10259,10259,0,3074,13333
142810501100000,CITY PROPERTY,EXEMPT,0,0,0,0,0,0
142810600100000,OFFICE; MED; CTRL CR,COMMERCIAL,0,75600,75600,0,417399,492999
142810600200000,SMALL RET; CTRL CR,COMMERCIAL,0,50400,50400,0,356271,406671
142810600400000,OFFICE; MED; CTRL CR,COMMERCIAL,0,240000,240000,0,1666954,1906954
142810700100000,OFFICE; CTRL CR,COMMERCIAL,0,94375,94375,0,1256555,1350930
142810700200000,WAREHOUSE; CTRL CR,COMMERCIAL,0,118250,118250,0,518034,636284
142810700300000,WAREHOUSE; CTRL CR,COMMERCIAL,0,45914,45914,0,217208,263122
142810800100000,OFFICE; CTRL CR,COMMERCIAL,0,88200,88200,0,278648,366848
142810900100000,FLAT PARKING,COMMERCIAL,0,77150,77150,0,9348,86498
142810900300000,WAREHOUSE; CTRL CR,COMMERCIAL,0,37800,37800,0,127045,164845
142810900400000,WAREHOUSE; CTRL CR,COMMERCIAL,0,37800,37800,0,98301,136101
142810900500000,RESTAURANT; CTRL CR,COMMERCIAL,0,50400,50400,0,76719,127119
142810900600000,VACANT LAND,EXEMPT,0,7666,7666,0,0,7666
142810900700000,FLAT PARKING,EXEMPT,0,93053,93053,0,40624,133677
142810900800000,SE 238,RESIDENTIAL,3952,0,3952,0,0,3952
142810900900000,SE 238,RESIDENTIAL,3458,0,3458,0,0,3458
142810901000000,SE 238,RESIDENTIAL,5270,0,5270,20837,0,26107
142811000100000,WAREHOUSE; CTRL CR,COMMERCIAL,0,120000,120000,0,331393,451393
142811000400000,FLAT PARKING,COMMERCIAL,0,96419,96419,0,7770,104189
142811000402000,BILLBOARD(BLL),COMMERCIAL,0,0,0,0,50452,50452
142811000500000,AUTO REP/SAL;CTRL CR,COMMERCIAL,0,48209,48209,0,42607,90816
142811000600000,AUTO REP/SAL;CTRL CR,COMMERCIAL,0,48209,48209,0,67087,115296
142811000700000,AUTO REP/SAL;CTRL CR,COMMERCIAL,0,24105,24105,0,42662,66767
142811000800000,BARS/LOUNGE; CTRL CR,COMMERCIAL,0,12600,12600,0,82787,95387
142811000900000,CENTRALLY ASSESSED,OTHER,0,0,0,0,0,0
142811100100000,FLAT PARKING,COMMERCIAL,0,39298,39298,0,20176,59474
142811100200000,FLAT PARKING,COMMERCIAL,0,27548,27548,0,13968,41516
142811100300000,WAREHOUSE; CTRL CR,COMMERCIAL,0,50400,50400,0,196272,246672
142811100400000,FLAT PARKING,COMMERCIAL,0,34381,34381,0,17072,51453
142811300100000,SHOP,COMMERCIAL,0,100800,100800,0,200760,301560
142811300200000,OFFICE; CTRL CR,COMMERCIAL,0,151200,151200,0,609440,760640
142811300300000,OFFICE,EXEMPT,0,81648,81648,0,1021183,1102831
142811400300000,WAREHOUSE; CTRL CR,COMMERCIAL,0,16800,16800,0,93203,110003
142811400400000,WAREHOUSE; CTRL CR,COMMERCIAL,0,47520,47520,0,71850,119370
142811400500000,WAREHOUSE; CTRL CR,COMMERCIAL,0,19680,19680,0,77952,97632
142811401100000,OFFICE; CTRL CR,EXEMPT,0,272860,272860,0,5725624,5998484
142811500100000,BARS/LOUNGE; CTRL CR,COMMERCIAL,0,37800,37800,0,20971,58771
142812600400000,CITY PROPERTY,EXEMPT,0,0,0,0,0,0
142812700100000,OFFICE; CTRL CR,COMMERCIAL,0,126000,126000,0,479463,605463
142812700200000,OFFICE; CTRL CR,COMMERCIAL,0,126000,126000,0,1003475,1129475
142812700300000,OFFICE; CTRL CR,COMMERCIAL,0,210000,210000,0,645154,855154
142812700400000,OFFICE,EXEMPT,0,69625,69625,0,578535,648160
142812700500000,BRNCH BK/CR; CTRL CR,COMMERCIAL,0,274920,274920,0,755484,1030404
142812700600000,CITY PROPERTY,EXEMPT,0,0,0,0,0,0
142812800100000,OFFICE; CTRL CR,COMMERCIAL,0,90000,90000,0,691261,781261
142812800200000,OFFICE; CTRL CR,COMMERCIAL,0,168000,168000,0,1222029,1390029
142812800300000,OFFICE; CTRL CR,COMMERCIAL,0,179200,179200,0,1063528,1242728
142812800400000,OFFICE; CTRL CR,COMMERCIAL,0,301000,301000,0,1478932,1779932
142812800402000,MISCELLANEOUS,COMMERCIAL,0,0,0,0,20,20
142812900100000,CITY PROPERTY,EXEMPT,0,0,0,0,0,0
142812900200000,FLAT PARKING,COMMERCIAL,0,241000,241000,0,62040,303040
142812900300000,BARS/LOUNGE; CTRL CR,COMMERCIAL,0,13200,13200,0,51802,65002
142812900400000,FLAT PARKING,COMMERCIAL,0,89200,89200,0,32340,121540
142812900500000,SR/NURSING/ASSTD LIV,COMMERCIAL,0,74307,74307,0,3659675,3733982
142813000100000,OFFICE; CTRL CR,COMMERCIAL,0,546000,546000,0,6661636,7207636
142813000200000,OFFICE; CTRL CR,COMMERCIAL,0,378000,378000,0,3828172,4206172
142813000300000,OFFICE; CTRL CR,COMMERCIAL,0,336000,336000,0,1458586,1794586
142813000400000,OFFICE; CTRL CR,COMMERCIAL,0,162000,162000,0,1127902,1289902
142813000500000,FLAT PARKING,COMMERCIAL,0,27000,27000,0,1020,28020
142813100101000,OFFICE; CTRL CR,COMMERCIAL,0,27350,27350,0,111524,138874
142813100101001,SMALL RET; CTRL CR,COMMERCIAL,0,18250,18250,0,138401,156651
142813100101002,OFFICE; CTRL CR,COMMERCIAL,0,27375,27375,0,295708,323083
142813100101003,OFFICE; CTRL CR,COMMERCIAL,0,29625,29625,0,261171,290796
142813100101004,OFFICE; CTRL CR,COMMERCIAL,0,18250,18250,0,148591,166841
142813100101005,OFFICE; CTRL CR,COMMERCIAL,0,53575,53575,0,506393,559968
142813100101006,OFFICE; CTRL CR,COMMERCIAL,0,53575,53575,0,506393,559968
142813100102000,THEATER,EXEMPT,0,0,0,0,0,0
142813100400000,CITY PROPERTY,EXEMPT,0,0,0,0,0,0
142813100500000,OFFICE; CTRL CR,COMMERCIAL,0,84000,84000,0,248148,332148
142813100600000,OFFICE; CTRL CR,COMMERCIAL,0,84000,84000,0,275935,359935
142813100700000,THEATER,EXEMPT,0,0,0,0,0,0
142813100800000,THEATER,EXEMPT,0,0,0,0,0,0
142813100900000,VACANT LAND,EXEMPT,0,225504,225504,0,0,225504
142813100904000,CITY PROPERTY,EXEMPT,0,0,0,0,0,0
142813101000000,THEATER,EXEMPT,0,0,0,0,0,0
142813101100000,OFFICE; CTRL CR,COMMERCIAL,0,44800,44800,0,214696,259496
142813101200000,CITY PROPERTY,EXEMPT,0,0,0,0,0,0
142813101300000,CITY PROPERTY,EXEMPT,0,0,0,0,0,0
142813101400000,OFFICE; CTRL CR,COMMERCIAL,0,89600,89600,0,665829,755429
142813200100000,FLAT PARKING,COMMERCIAL,0,26250,26250,0,10500,36750
142813200200000,FLAT PARKING,COMMERCIAL,0,28925,28925,0,6720,35645
142813200300000,FLAT PARKING,COMMERCIAL,0,9642,9642,0,2240,11882
142813200400000,SMALL RET; CTRL CR,COMMERCIAL,0,70000,70000,0,457728,527728
142813200500000,PRINTING,INDUSTRIAL,0,27216,27216,0,111819,139035
142813200600000,FLAT PARKING,COMMERCIAL,0,67200,67200,0,10328,77528
142813200700000,OFFICE; CTRL CR,COMMERCIAL,0,144600,144600,0,1525981,1670581
142813300100000,OFFICE; CTRL CR,COMMERCIAL,0,84000,84000,0,2277120,2361120
142813300200000,FLAT PARKING,COMMERCIAL,0,84000,84000,0,27619,111619
142813300300000,OFFICE; CTRL CR,COMMERCIAL,0,84176,84176,0,1061282,1145458
142813300400000,CITY PROPERTY,EXEMPT,0,0,0,0,0,0
142813300500000,CITY PROPERTY,EXEMPT,0,0,0,0,0,0
142813300501001,OFFICE; CTRL CR,COMMERCIAL,0,0,0,0,359779,359779
142813300501002,OFFICE; CTRL CR,COMMERCIAL,0,0,0,0,158597,158597
142813300501003,OFFICE; CTRL CR,COMMERCIAL,0,0,0,0,158597,158597
142813300501004,OFFICE; CTRL CR,COMMERCIAL,0,0,0,0,269794,269794
142813300501005,OFFICE; CTRL CR,COMMERCIAL,0,0,0,0,158597,158597
142813300501006,OFFICE; CTRL CR,COMMERCIAL,0,0,0,0,158597,158597
142813300501007,OFFICE; CTRL CR,COMMERCIAL,0,0,0,0,105731,105731
142813300501008,OFFICE; CTRL CR,COMMERCIAL,0,0,0,0,105731,105731
142813300501009,OFFICE; CTRL CR,COMMERCIAL,0,0,0,0,314761,314761
142813300501010,OFFICE; CTRL CR,COMMERCIAL,0,0,0,0,508188,508188
142813300501011,OFFICE; CTRL CR,COMMERCIAL,0,0,0,0,677586,677586
142813300501012,OFFICE; CTRL CR,COMMERCIAL,0,0,0,0,359727,359727
142813300501013,OFFICE; CTRL CR,COMMERCIAL,0,0,0,0,314761,314761
142813300501014,OFFICE; CTRL CR,COMMERCIAL,0,0,0,0,592887,592887
142813300501015,OFFICE; CTRL CR,COMMERCIAL,0,0,0,0,677586,677586
142813300501016,OFFICE; CTRL CR,COMMERCIAL,0,0,0,0,592887,592887
142813300501017,OFFICE; CTRL CR,COMMERCIAL,0,0,0,0,677586,677586
142813300501018,OFFICE; CTRL CR,COMMERCIAL,0,0,0,0,677586,677586
142813300501019,OFFICE; CTRL CR,COMMERCIAL,0,0,0,0,215335,215335
142813300501020,OFFICE; CTRL CR,COMMERCIAL,0,0,0,0,216714,216714
142813300501063,OFFICE; CTRL CR,COMMERCIAL,0,0,0,0,359727,359727
142813300501065,OFFICE; CTRL CR,COMMERCIAL,0,0,0,0,158597,158597
142813300501066,OFFICE; CTRL CR,COMMERCIAL,0,0,0,0,158597,158597
142813300502002,SCHOOL,EXEMPT,0,0,0,0,1537281,1537281
142813300700000,OFFICE; CTRL CR,COMMERCIAL,0,163200,163200,0,1277889,1441089
142813300800000,SCHOOL,EXEMPT,0,38880,38880,0,124946,163826
142813400100000,OFFICE; CTRL CR,COMMERCIAL,0,404950,404950,0,2702251,3107201
142813400200000,OFFICE; CTRL CR,COMMERCIAL,0,229250,229250,0,1672023,1901273
142813400300000,OFFICE,EXEMPT,0,71747,71747,0,1047391,1119138
142813400400000,OFFICE; CTRL CR,COMMERCIAL,0,415147,415147,0,3348646,3763793
142813400500000,FLAT PARKING,EXEMPT,0,125107,125107,0,53980,179087
142813400600000,FLAT PARKING,COMMERCIAL,0,100632,100632,0,24888,125520
142813500500000,OFFICE; CTRL CR,COMMERCIAL,0,813200,813200,0,5840142,6653342
142813600100000,BARS/LOUNGE; CTRL CR,COMMERCIAL,0,51000,51000,0,334206,385206
142813600200000,OFFICE; CTRL CR,COMMERCIAL,0,65405,65405,0,114866,180271
142813600500000,OFFICE; CTRL CR,COMMERCIAL,0,31430,31430,0,268874,300304
142813600600000,OFFICE; CTRL CR,COMMERCIAL,0,148770,148770,0,98855,247625
142813600700000,VACANT LAND,COMMERCIAL,0,40575,40575,0,0,40575
142813600900000,OFFICE; CTRL CR,COMMERCIAL,0,106519,106519,0,1318393,1424912
142813700100000,FLAT PARKING,COMMERCIAL,0,27548,27548,0,10476,38024
142813700200000,WAREHOUSE; CTRL CR,COMMERCIAL,0,33600,33600,0,36803,70403
142813700300000,OFFICE; CTRL CR,COMMERCIAL,0,33600,33600,0,547106,580706
142813700400000,AUTO REP/SAL;CTRL CR,COMMERCIAL,0,100800,100800,0,159647,260447
142815100200000,FITNESS CENTER,EXEMPT,0,437981,437981,0,7488154,7926135
142815200200000,SMALL RET; CTRL CR,COMMERCIAL,0,102847,102847,0,543236,646083
142815200300000,FLAT PARKING,COMMERCIAL,0,282800,282800,0,56941,339741
142815200500000,CITY PROPERTY,EXEMPT,0,0,0,0,0,0
142815300100000,CITY PROPERTY,EXEMPT,0,0,0,0,0,0
142815300200000,FLAT PARKING,COMMERCIAL,0,406000,406000,0,101745,507745
142815300300000,CITY PROPERTY,EXEMPT,0,0,0,0,0,0
142815300400000,OFFICE; CTRL CR,COMMERCIAL,0,420000,420000,0,14623031,15043031
142815400200000,FEDERAL PROPERTY,EXEMPT,0,0,0,0,0,0
142815600100000,CITY PROPERTY,EXEMPT,0,0,0,0,0,0
142815600300000,CITY PROPERTY,EXEMPT,0,0,0,0,0,0
142815700100000,CITY PROPERTY,EXEMPT,0,0,0,0,0,0
142815800100000,CITY PROPERTY,EXEMPT,0,0,0,0,0,0
142815800200000,CITY PROPERTY,EXEMPT,0,0,0,0,0,0
142816400202000,OFFICE; CTRL CR,COMMERCIAL,0,0,0,0,35853,35853
142816400902000,MISCELLANEOUS,COMMERCIAL,0,0,0,0,20,20
142817600100000,SE 237,RESIDENTIAL,2400,0,2400,0,0,2400
142817600200000,SE 237,RESIDENTIAL,1860,0,1860,0,0,1860
142817600300000,VACANT LAND,COMMERCIAL,0,5232,5232,0,0,5232
142817600400000,CITY PROPERTY,EXEMPT,0,0,0,0,0,0
142817600500000,CITY PROPERTY,EXEMPT,0,0,0,0,0,0
142817600600000,SE 237,RESIDENTIAL,3596,0,3596,0,0,3596
142817600700000,CITY PROPERTY,EXEMPT,0,0,0,0,0,0
142817600800000,SE 237,RESIDENTIAL,4980,0,4980,69463,0,74443
142817700100000,WAREHOUSE; CTRL CR,COMMERCIAL,0,25200,25200,0,127022,152222
142817700200000,WAREHOUSE; CTRL CR,COMMERCIAL,0,25200,25200,0,93045,118245
142817800200000,SMALL RET; CTRL CR,COMMERCIAL,0,63000,63000,0,202435,265435
142817900200000,WAREHOUSE; CTRL CR,COMMERCIAL,0,35568,35568,0,97468,133036
142817900202000,BILLBOARD(BLL),COMMERCIAL,0,0,0,0,12762,12762
142818000300000,CENTRALLY ASSESSED,OTHER,0,0,0,0,0,0
142818000400000,MATERIALS MFG;INDUST,INDUSTRIAL,0,87179,87179,0,390072,477251
142818000500000,VACANT LAND,COMMERCIAL,0,6300,6300,0,0,6300
142818000600000,FLAT PARKING,COMMERCIAL,0,25200,25200,0,2100,27300
142818000700000,FLAT PARKING,COMMERCIAL,0,12600,12600,0,1911,14511
142818000800000,FLAT PARKING,COMMERCIAL,0,12600,12600,0,1706,14306
142818000900000,SE 237,RESIDENTIAL,5000,0,5000,0,0,5000
142818001000000,SE 237,INDUSTRIAL,0,10244,10244,0,4873,15117
142818001100000,SE 237,INDUSTRIAL,0,10244,10244,0,10067,20311
142818001200000,CENTRALLY ASSESSED,OTHER,0,0,0,0,0,0
142818001300000,CENTRALLY ASSESSED,OTHER,0,0,0,0,0,0
142818100100000,WAREHOUSE; CTRL CR,COMMERCIAL,0,29970,29970,0,143585,173555
142818100300000,CENTRALLY ASSESSED,OTHER,0,0,0,0,0,0
142818200100000,SMALL RET; CTRL CR,COMMERCIAL,0,348400,348400,0,622181,970581
142818200300000,CENTRALLY ASSESSED,OTHER,0,0,0,0,0,0
142818300100000,WAREHOUSE; CTRL CR,COMMERCIAL,0,7360,7360,0,11356,18716
142818300200000,WAREHOUSE; CTRL CR,COMMERCIAL,0,48960,48960,0,64981,113941
142818300300000,WAREHOUSE; CTRL CR,COMMERCIAL,0,15360,15360,0,37202,52562
142818300400000,WAREHOUSE; CTRL CR,COMMERCIAL,0,80640,80640,0,57779,138419
142818300500000,VACANT LAND,COMMERCIAL,0,11840,11840,0,0,11840
142818300600000,FLAT PARKING,COMMERCIAL,0,4480,4480,0,840,5320
142818300700000,WAREHOUSE; CTRL CR,COMMERCIAL,0,46240,46240,0,3510,49750
142818300800000,FLAT PARKING,COMMERCIAL,0,103680,103680,0,7764,111444
142818300900000,FLAT PARKING,COMMERCIAL,0,10240,10240,0,0,10240
142818400100000,VACANT LAND,COMMERCIAL,0,110766,110766,0,0,110766
142818400200000,VACANT LAND,COMMERCIAL,0,152228,152228,0,0,152228
142818400300000,CONVENIENCE STORE,COMMERCIAL,0,100800,100800,0,281374,382174
142818400400000,AUTO REP/SAL;CTRL CR,COMMERCIAL,0,154240,154240,0,452948,607188
142818500100000,OFFICE; CTRL CR,COMMERCIAL,0,120500,120500,0,1042482,1162982
142818500200000,FLAT PARKING,COMMERCIAL,0,16800,16800,0,2400,19200
142818500300000,SE 237,RESIDENTIAL,5000,0,5000,0,0,5000
142818500700000,CITY PROPERTY,EXEMPT,0,0,0,0,0,0
142818500800000,CITY PROPERTY,EXEMPT,0,0,0,0,0,0
142818501200000,SMALL RET; CTRL CR,COMMERCIAL,0,24025,24025,0,126851,150876
142818501300000,SMALL RET; CTRL CR,COMMERCIAL,0,25363,25363,0,39733,65096
142818501400000,SMALL RET; CTRL CR,COMMERCIAL,0,19352,19352,0,92601,111953
142818600102000,ANTENNAS/TOWERS(BLL),COMMERCIAL,0,0,0,0,11845,11845
142818600102001,ANTENNAS/TOWERS(BLL),COMMERCIAL,0,0,0,0,8746,8746
142818600201000,OFFICE; CTRL CR,COMMERCIAL,0,17550,17550,0,130350,147900
142818600201001,OFFICE; CTRL CR,COMMERCIAL,0,17550,17550,0,78986,96536
142818600201002,OFFICE; CTRL CR,COMMERCIAL,0,17550,17550,0,136998,154548
142818600201003,OFFICE; CTRL CR,COMMERCIAL,0,17550,17550,0,196581,214131
142818600300000,FLAT PARKING,COMMERCIAL,0,166400,166400,0,52550,218950
142818600400000,FLAT PARKING,COMMERCIAL,0,47200,47200,0,13464,60664
142818700800000,CITY PROPERTY,EXEMPT,0,0,0,0,0,0
142818800100000,SE 237,EXEMPT,0,9312,9312,0,0,9312
142818800200000,SE 237,EXEMPT,0,9984,9984,0,0,9984
142818800300000,SE 237,RESIDENTIAL,25200,0,25200,0,0,25200
142818800400000,CITY PROPERTY,EXEMPT,0,0,0,0,0,0
142818800500000,CITY PROPERTY,EXEMPT,0,0,0,0,0,0
142818800600000,CITY PROPERTY,EXEMPT,0,0,0,0,0,0
142818800700000,CITY PROPERTY,EXEMPT,0,0,0,0,0,0
142818800800000,CITY PROPERTY,EXEMPT,0,0,0,0,0,0
142818800900000,SMALL RET; CTRL CR,COMMERCIAL,0,33600,33600,0,136043,169643
142818801000000,SE 237,RESIDENTIAL,2400,0,2400,0,0,2400
142818801100000,SE 237,RESIDENTIAL,4500,0,4500,0,0,4500
142818801200000,CONVERSION,COMMERCIAL,0,5400,5400,0,0,5400
142818801300000,SE 237,RESIDENTIAL,6000,0,6000,0,0,6000
142818801400000,SE 237,RESIDENTIAL,6000,0,6000,0,0,6000
142818801500000,SE 237,EXEMPT,0,4656,4656,0,0,4656
142818900100000,WAREHOUSE; CTRL CR,COMMERCIAL,0,25200,25200,0,105240,130440
142818900200000,RESTAURANT; CTRL CR,COMMERCIAL,0,25200,25200,0,172843,198043
142819000100000,LITERARY/LIBRARY/ART,COMMERCIAL,0,60480,60480,0,1334861,1395341
142819000200000,LITERARY/LIBRARY/ART,EXEMPT,0,21168,21168,0,79623,100791
142819000300000,SE 237,RESIDENTIAL,5000,0,5000,20492,0,25492
142819100100000,CENTRALLY ASSESSED,OTHER,0,0,0,0,0,0
142820100100000,OFFICE; CTRL CR,COMMERCIAL,0,214800,214800,0,1592651,1807451
142820100200000,OFFICE; CTRL CR,COMMERCIAL,0,96000,96000,0,6445,102445
142820100300000,OFFICE,OTHER,0,0,0,0,0,0
142820100400000,OFFICE; CTRL CR,COMMERCIAL,0,24000,24000,0,103373,127373
142820100500000,OFFICE; CTRL CR,COMMERCIAL,0,180000,180000,0,1197803,1377803
142820100600000,OFFICE; CTRL CR,COMMERCIAL,0,168000,168000,0,972418,1140418
142820100700000,SMALL RET; CTRL CR,COMMERCIAL,0,168000,168000,0,122324,290324
142820100800000,SMALL RET; CTRL CR,COMMERCIAL,0,64800,64800,0,55292,120092
142820200100000,OFFICE; CTRL CR,COMMERCIAL,0,168000,168000,0,0,168000
142820200200000,PARKING STRUCTURE,COMMERCIAL,0,390292,390292,0,2423112,2813404
142820300100000,CITY PROPERTY,EXEMPT,0,0,0,0,0,0
142820400100000,CITY PROPERTY,EXEMPT,0,0,0,0,0,0
142820400107000,MISCELLANEOUS,COMMERCIAL,0,0,0,0,4800232,4800232
142820400107001,MISCELLANEOUS,COMMERCIAL,0,0,0,0,76302,76302
142820400107002,MISCELLANEOUS,COMMERCIAL,0,0,0,0,1219322,1219322
142820400107003,MISCELLANEOUS,COMMERCIAL,0,0,0,0,1523775,1523775
142820400107004,MISCELLANEOUS,COMMERCIAL,0,0,0,0,613237,613237
142820400107005,MISCELLANEOUS,COMMERCIAL,0,0,0,0,21194,21194
142820400107008,MISCELLANEOUS,COMMERCIAL,0,0,0,0,12440,12440
142820400107010,MISCELLANEOUS,COMMERCIAL,0,0,0,0,10597,10597
142820500100000,CITY PROPERTY,EXEMPT,0,0,0,0,0,0
142820600100000,CITY PROPERTY,EXEMPT,0,0,0,0,0,0
142820600200000,CITY PROPERTY,EXEMPT,0,0,0,0,0,0
142820700100000,SMALL RET; CTRL CR,COMMERCIAL,0,437394,437394,0,1960888,2398282
142820800100000,COUNTY PROPERTY,EXEMPT,0,0,0,0,0,0
142820900100000,CITY PROPERTY,EXEMPT,0,0,0,0,0,0
142821000100000,OFFICE; CTRL CR,COMMERCIAL,0,153600,153600,0,1923760,2077360
142822600100000,CITY PROPERTY,EXEMPT,0,0,0,0,0,0
142822700100000,CITY PROPERTY,EXEMPT,0,0,0,0,0,0
142822800100000,CITY PROPERTY,EXEMPT,0,0,0,0,0,0
142822800200000,CITY PROPERTY,EXEMPT,0,0,0,0,0,0
142822800300000,CITY PROPERTY,EXEMPT,0,0,0,0,0,0
142822800500000,CITY PROPERTY,EXEMPT,0,0,0,0,0,0
142822800600000,CITY PROPERTY,EXEMPT,0,0,0,0,0,0
142822800700000,CITY PROPERTY,EXEMPT,0,0,0,0,0,0
142822800800000,CITY PROPERTY,EXEMPT,0,0,0,0,0,0
142822800900000,CITY PROPERTY,EXEMPT,0,0,0,0,0,0
142822801000000,CITY PROPERTY,EXEMPT,0,0,0,0,0,0
142822801100000,CITY PROPERTY,EXEMPT,0,0,0,0,0,0
142822900100000,CITY PROPERTY,EXEMPT,0,0,0,0,0,0
142822900300000,CITY PROPERTY,EXEMPT,0,0,0,0,0,0
142823000100000,CITY PROPERTY,EXEMPT,0,0,0,0,0,0
142823100100000,CITY PROPERTY,EXEMPT,0,0,0,0,0,0
142823100200000,CITY PROPERTY,EXEMPT,0,0,0,0,0,0
142823100300000,CITY PROPERTY,EXEMPT,0,0,0,0,0,0
142823100400000,CITY PROPERTY,EXEMPT,0,0,0,0,0,0
142823100500000,CITY PROPERTY,EXEMPT,0,0,0,0,0,0
142823100600000,CITY PROPERTY,EXEMPT,0,0,0,0,0,0
142823100700000,SW 401,RESIDENTIAL,9000,0,9000,48672,0,57672
142823100800000,WAREHOUSE; CTRL CR,COMMERCIAL,0,11200,11200,0,60140,71340
142823100900000,OFFICE; CTRL CR,COMMERCIAL,0,22400,22400,0,141479,163879
142823101000000,FLAT PARKING,COMMERCIAL,0,16800,16800,0,2811,19611
142823101100000,SW 401,RESIDENTIAL,7481,0,7481,0,0,7481
142823101200000,CITY PROPERTY,EXEMPT,0,0,0,0,0,0
142823200100000,SMALL RET; CTRL CR,COMMERCIAL,0,75852,75852,0,100907,176759
142823200102000,BILLBOARD(BLL),COMMERCIAL,0,0,0,0,42399,42399
142823200200000,CITY PROPERTY,EXEMPT,0,0,0,0,0,0
142823200300000,CITY PROPERTY,EXEMPT,0,0,0,0,0,0
142823200400000,CITY PROPERTY,EXEMPT,0,0,0,0,0,0
142823200500000,VACANT LAND,COMMERCIAL,0,18480,18480,0,0,18480
142823200600000,AUTO REP/SAL;CTRL CR,COMMERCIAL,0,33600,33600,0,46478,80078
142823200800000,CITY PROPERTY,EXEMPT,0,0,0,0,0,0
142823201100000,CITY PROPERTY,EXEMPT,0,0,0,0,0,0
142823300300000,COUNTY PROPERTY,EXEMPT,0,0,0,0,0,0
142823300400000,STATE PROPERTY,EXEMPT,0,0,0,0,0,0
142823300500000,STATE PROPERTY,EXEMPT,0,0,0,0,0,0
142823400100000,BRNCH BK/CR; CTRL CR,COMMERCIAL,0,142750,142750,0,434737,577487
142823400200000,FLAT PARKING,COMMERCIAL,0,50400,50400,0,4284,54684
142823400300000,CITY PROPERTY,EXEMPT,0,0,0,0,0,0
142823400500000,CITY PROPERTY,EXEMPT,0,0,0,0,0,0
142823400700000,SMALL RET; CTRL CR,COMMERCIAL,0,13440,13440,0,74056,87496
142823400800000,OFFICE; CTRL CR,COMMERCIAL,0,10080,10080,0,72375,82455
142823400900000,CITY PROPERTY,EXEMPT,0,0,0,0,0,0
142823401000000,CITY PROPERTY,EXEMPT,0,0,0,0,0,0
142823401100000,CITY PROPERTY,EXEMPT,0,0,0,0,0,0
142823500100000,SMALL RET; CTRL CR,COMMERCIAL,0,33600,33600,0,122657,156257
142823500500000,VACANT LAND,COMMERCIAL,0,18088,18088,0,0,18088
142823500600000,SW 401,RESIDENTIAL,15132,0,15132,64535,0,79667
142823500700000,SW 401,RESIDENTIAL,7208,0,7208,0,0,7208
142823500800000,SW 401,RESIDENTIAL,7752,0,7752,0,0,7752
142823500900000,CITY PROPERTY,EXEMPT,0,0,0,0,0,0
142823501000000,CITY PROPERTY,EXEMPT,0,0,0,0,0,0
142823501100000,CITY PROPERTY,EXEMPT,0,0,0,0,0,0
142823501200000,WAREHOUSE; CTRL CR,COMMERCIAL,0,67200,67200,0,202635,269835
142823700200000,CITY PROPERTY,EXEMPT,0,0,0,0,0,0
142823700300000,SW 401,RESIDENTIAL,5892,0,5892,27429,0,33321
142823900100000,CITY PROPERTY,EXEMPT,0,0,0,0,0,0
142825100400000,BRNCH BK/CR; CTRL CR,COMMERCIAL,0,103040,103040,0,185545,288585
142825100500000,BRNCH BK/CR; CTRL CR,COMMERCIAL,0,144620,144620,0,260000,404620
142825200100000,CITY PROPERTY,EXEMPT,0,0,0,0,0,0
142825300100000,SW 401,RESIDENTIAL,5000,0,5000,0,0,5000
142825300500000,BARS/LOUNGE; CTRL CR,COMMERCIAL,0,67200,67200,0,123366,190566
142825300502000,BILLBOARD(BLL),COMMERCIAL,0,0,0,0,50502,50502
142825400100000,OFFICE; CTRL CR,COMMERCIAL,0,116480,116480,0,70642,187122
142825400200000,SCHOOL,EXEMPT,0,90720,90720,0,158771,249491
142825400300000,CONVERSIONS; NON-APT,COMMERCIAL,0,55748,55748,0,153582,209330
142825500100000,CITY PROPERTY,EXEMPT,0,0,0,0,0,0
142825500200000,OFFICE; CTRL CR,COMMERCIAL,0,11200,11200,0,136021,147221
142825500300000,OFFICE; CTRL CR,COMMERCIAL,0,33600,33600,0,125276,158876
142825500400000,SMALL RET; CTRL CR,COMMERCIAL,0,33600,33600,0,167024,200624
142825500500000,SHOP,COMMERCIAL,0,33600,33600,0,42784,76384
142825500502000,BILLBOARD(BLL),COMMERCIAL,0,0,0,0,18661,18661
142825500600000,WAREHOUSE; CTRL CR,COMMERCIAL,0,65520,65520,0,51067,116587
142825500700000,FLAT PARKING,COMMERCIAL,0,35280,35280,0,4331,39611
142825500800000,SW 401,RESIDENTIAL,4743,0,4743,34903,0,39646
142825500900000,CITY PROPERTY,EXEMPT,0,0,0,0,0,0
142825501000000,OFFICE; CTRL CR,COMMERCIAL,0,14400,14400,0,61219,75619
142825600100000,CITY PROPERTY,EXEMPT,0,0,0,0,0,0
142825600200000,CITY PROPERTY,EXEMPT,0,0,0,0,0,0
142825600300000,SW 401,RESIDENTIAL,12750,0,12750,44229,0,56979
142825600400000,CITY PROPERTY,EXEMPT,0,0,0,0,0,0
142825600500000,CITY PROPERTY,EXEMPT,0,0,0,0,0,0
142825600600000,CITY PROPERTY,EXEMPT,0,0,0,0,0,0
142825600700000,SW 401,RESIDENTIAL,5125,0,5125,47590,0,52715
142825600800000,SW 401,RESIDENTIAL,5692,0,5692,26829,0,32521
142825600900000,CITY PROPERTY,EXEMPT,0,0,0,0,0,0
142825601000000,SW 401,RESIDENTIAL,6324,0,6324,0,0,6324
142825601100000,CONVERSIONS; NON-APT,COMMERCIAL,0,18000,18000,0,53406,71406
142825601200000,CONVERSION,COMMERCIAL,0,10206,10206,0,39722,49928
142825601300000,OFFICE; MED; CTRL CR,COMMERCIAL,0,12600,12600,0,75629,88229
142825601400000,SW 401,RESIDENTIAL,7650,0,7650,40983,0,48633
142825601500000,CITY PROPERTY,EXEMPT,0,0,0,0,0,0
142825601600000,CITY PROPERTY,EXEMPT,0,0,0,0,0,0
142825601700000,CITY PROPERTY,EXEMPT,0,0,0,0,0,0
142825601800000,CITY PROPERTY,EXEMPT,0,0,0,0,0,0
142825601900000,SW 401,RESIDENTIAL,5296,0,5296,43772,0,49068
142825602000000,SW 401,RESIDENTIAL,5375,0,5375,46450,0,51825
142825602100000,SW 401,RESIDENTIAL,5533,0,5533,29362,0,34895
142825700100000,NBHD SHOPPING CENTER,COMMERCIAL,0,56000,56000,0,359833,415833
142825700200000,LAUNDROMAT/CLEANERS,COMMERCIAL,0,28000,28000,0,42772,70772
142825700300000,FLAT PARKING,COMMERCIAL,0,28000,28000,0,6807,34807
142825700400000,FLAT PARKING,COMMERCIAL,0,47567,47567,0,11025,58592
142825700500000,SW 401,RESIDENTIAL,12750,0,12750,73558,0,86308
142825700600000,SW 401,RESIDENTIAL,12750,0,12750,45007,0,57757
142825700700000,SW 401,RESIDENTIAL,5000,0,5000,0,0,5000
142825700800000,CITY PROPERTY,EXEMPT,0,0,0,0,0,0
142825700900000,SW 401,RESIDENTIAL,7650,0,7650,0,0,7650
142825701000000,SW 401,RESIDENTIAL,12495,0,12495,58648,0,71143
142825701100000,FLAT PARKING,COMMERCIAL,0,14700,14700,0,2142,16842
142825800100000,SW 401,RESIDENTIAL,5000,0,5000,0,0,5000
142825800800000,CITY PROPERTY,EXEMPT,0,0,0,0,0,0
142825800900000,SW 401,RESIDENTIAL,5000,0,5000,0,0,5000
142825801000000,SW 401,RESIDENTIAL,9027,0,9027,63737,0,72764
142825801100000,SW 401,RESIDENTIAL,7650,0,7650,39430,0,47080
142825801200000,SW 401,RESIDENTIAL,7650,0,7650,37072,0,44722
142825801300000,CITY PROPERTY,EXEMPT,0,0,0,0,0,0
142825801400000,FRATERNAL,EXEMPT,0,81855,81855,0,221603,303458
142825900100000,SW 401,RESIDENTIAL,8568,0,8568,72039,0,80607
142825900200000,SW 401,RESIDENTIAL,16065,0,16065,81490,0,97555
142825900300000,SW 401,RESIDENTIAL,12750,0,12750,70007,0,82757
142825900400000,SW 401,RESIDENTIAL,12750,0,12750,25407,0,38157
142825900500000,SW 401,RESIDENTIAL,12750,0,12750,58472,0,71222
142825900600000,APARTMENT; CNTRL CR,COMMERCIAL,0,14000,14000,0,132571,146571
142825900700000,CONVERSION,COMMERCIAL,0,8505,8505,0,58299,66804
142825900800000,SW 401,RESIDENTIAL,6885,0,6885,18905,0,25790
142825900900000,SW 401,RESIDENTIAL,9639,0,9639,69304,0,78943
142825901000000,CITY PROPERTY,EXEMPT,0,0,0,0,0,0
142825901100000,CITY PROPERTY,EXEMPT,0,0,0,0,0,0
142825901200000,CITY PROPERTY,EXEMPT,0,0,0,0,0,0
142825901300000,CITY PROPERTY,EXEMPT,0,0,0,0,0,0
142825901400000,CITY PROPERTY,EXEMPT,0,0,0,0,0,0
142825901500000,CITY PROPERTY,EXEMPT,0,0,0,0,0,0
142825901600000,SW 401,RESIDENTIAL,12750,0,12750,45202,0,57952
142825901700000,SW 401,RESIDENTIAL,12750,0,12750,75112,0,87862
142825901800000,SW 401,RESIDENTIAL,12750,0,12750,56730,0,69480
142825901900000,SW 401,RESIDENTIAL,6184,0,6184,36236,0,42420
142825902000000,CITY PROPERTY,EXEMPT,0,0,0,0,0,0
142825902100000,SW 401,RESIDENTIAL,12750,0,12750,50739,0,63489
142825902200000,SW 401,RESIDENTIAL,6375,0,6375,38659,0,45034
142825902300000,SW 401,RESIDENTIAL,6375,0,6375,37608,0,43983
142825902400000,SW 401,RESIDENTIAL,12750,0,12750,0,0,12750
142825902500000,SW 401,RESIDENTIAL,9900,0,9900,0,0,9900
142825902600000,SW 401,RESIDENTIAL,5508,0,5508,24925,0,30433
142825902700000,SW 401,RESIDENTIAL,5375,0,5375,45457,0,50832
142825902800000,SW 401,RESIDENTIAL,8695,0,8695,48020,0,56715
142826000100000,SW 403,RESIDENTIAL,17069,0,17069,50219,0,67288
142826000200000,SW 403,RESIDENTIAL,10041,0,10041,56960,0,67001
142826000300000,SW 403,RESIDENTIAL,9945,0,9945,43232,0,53177
142826000400000,SW 403,RESIDENTIAL,5000,0,5000,0,0,5000
142826000500000,CITY PROPERTY,EXEMPT,0,0,0,0,0,0
142826000600000,CITY PROPERTY,EXEMPT,0,0,0,0,0,0
142826000700000,CITY PROPERTY,EXEMPT,0,0,0,0,0,0
142826100100000,SW 401,RESIDENTIAL,11618,0,11618,91460,0,103078
142827600100000,CITY PROPERTY,EXEMPT,0,0,0,0,0,0
142827600200000,CITY PROPERTY,EXEMPT,0,0,0,0,0,0
142827600300000,CITY PROPERTY,EXEMPT,0,0,0,0,0,0
142827600400000,CITY PROPERTY,EXEMPT,0,0,0,0,0,0
142827700300000,VACANT LAND,COMMERCIAL,0,113256,113256,0,40000,153256
142827800100000,CITY PROPERTY,EXEMPT,0,0,0,0,0,0
142827800200000,CITY PROPERTY,EXEMPT,0,0,0,0,0,0
142827800300000,CITY PROPERTY,EXEMPT,0,0,0,0,0,0
142827800400000,FLAT PARKING,COMMERCIAL,0,52500,52500,0,23341,75841
142827800500000,FLAT PARKING,COMMERCIAL,0,18480,18480,0,0,18480
142827800600000,FLAT PARKING,COMMERCIAL,0,10080,10080,0,0,10080
142827800700000,FLAT PARKING,COMMERCIAL,0,10080,10080,0,0,10080
142827800800000,FLAT PARKING,COMMERCIAL,0,16128,16128,0,0,16128
142827800900000,CITY PROPERTY,EXEMPT,0,0,0,0,0,0
142827801000000,CITY PROPERTY,EXEMPT,0,0,0,0,0,0
142827801100000,CITY PROPERTY,EXEMPT,0,0,0,0,0,0
142827801200000,CITY PROPERTY,EXEMPT,0,0,0,0,0,0
142827801300000,CITY PROPERTY,EXEMPT,0,0,0,0,0,0
142827801400000,CITY PROPERTY,EXEMPT,0,0,0,0,0,0
142827801500000,CITY PROPERTY,EXEMPT,0,0,0,0,0,0
142827900100000,CITY PROPERTY,EXEMPT,0,0,0,0,0,0
142827900200000,CITY PROPERTY,EXEMPT,0,0,0,0,0,0
142827900300000,CITY PROPERTY,EXEMPT,0,0,0,0,0,0
142827900400000,COUNTY PROPERTY,EXEMPT,0,0,0,0,0,0
142827900500000,COUNTY PROPERTY,EXEMPT,0,0,0,0,0,0
142827900600000,COUNTY PROPERTY,EXEMPT,0,0,0,0,0,0
142827900700000,SHOP,COMMERCIAL,0,17820,17820,0,115110,132930
142827900900000,COUNTY PROPERTY,EXEMPT,0,0,0,0,0,0
142827901000000,COUNTY PROPERTY,EXEMPT,0,0,0,0,0,0
142828000100000,SMALL RET; CTRL CR,COMMERCIAL,0,6333,6333,0,0,6333
142828000200000,CITY PROPERTY,EXEMPT,0,0,0,0,0,0
142828000300000,CITY PROPERTY,EXEMPT,0,0,0,0,0,0
142828000400000,SW 401,RESIDENTIAL,5000,0,5000,0,0,5000
142828000500000,SW 401,RESIDENTIAL,6498,0,6498,39536,0,46034
142828000600000,CITY PROPERTY,EXEMPT,0,0,0,0,0,0
142828000700000,SW 401,RESIDENTIAL,5000,0,5000,0,0,5000
142828000800000,CITY PROPERTY,EXEMPT,0,0,0,0,0,0
142828000900000,SW 401,RESIDENTIAL,6300,0,6300,18015,0,24315
142828001000000,SW 401,RESIDENTIAL,7200,0,7200,17453,0,24653
142828001100000,CONVERSION,COMMERCIAL,0,5103,5103,0,29572,34675
142828001200000,SW 401,RESIDENTIAL,10125,0,10125,25555,0,35680
142828001300000,SW 401,RESIDENTIAL,6300,0,6300,39022,0,45322
142828001400000,SW 401,RESIDENTIAL,4725,0,4725,25332,0,30057
142828001500000,OFFICE; CTRL CR,COMMERCIAL,0,117600,117600,0,337403,455003
142828002000000,SW 401,RESIDENTIAL,6750,0,6750,0,0,6750
142828002100000,CITY PROPERTY,EXEMPT,0,0,0,0,0,0
142828100100000,SW 401,RESIDENTIAL,5850,0,5850,51909,0,57759
142828100200000,CITY PROPERTY,EXEMPT,0,0,0,0,0,0
142828100300000,SW 401,RESIDENTIAL,8479,0,8479,70580,0,79059
142828100400000,SW 401,RESIDENTIAL,8479,0,8479,59349,0,67828
142828100500000,CITY PROPERTY,EXEMPT,0,0,0,0,0,0
142828100600000,CITY PROPERTY,EXEMPT,0,0,0,0,0,0
142828100700000,SW 401,RESIDENTIAL,7650,0,7650,22090,0,29740
142828100800000,CONVERSION,COMMERCIAL,0,5433,5433,0,51168,56601
142828100900000,CONVERSION,COMMERCIAL,0,3937,3937,0,32450,36387
142828200100000,CITY PROPERTY,EXEMPT,0,0,0,0,0,0
142828300100000,CONVERSION,COMMERCIAL,0,9720,9720,0,57233,66953
142828300200000,SW 401,RESIDENTIAL,7440,0,7440,47000,0,54440
142828300300000,SW 401,EXEMPT,0,18000,18000,0,85721,103721
142828300700000,OFFICE; CTRL CR,COMMERCIAL,0,94100,94100,0,344630,438730
142828301000000,CONVERSIONS; NON-APT,COMMERCIAL,0,63000,63000,0,72817,135817
142828301200000,SHOP,COMMERCIAL,0,33600,33600,0,51365,84965
142828301300000,CITY PROPERTY,EXEMPT,0,0,0,0,0,0
142828301400000,CITY PROPERTY,EXEMPT,0,0,0,0,0,0
142828400100000,CITY PROPERTY,EXEMPT,0,0,0,0,0,0
142830100100000,SW 401,RESIDENTIAL,7812,0,7812,36209,0,44021
142830100200000,CITY PROPERTY,EXEMPT,0,0,0,0,0,0
142830200100000,AUTO REPAIR/SALES,COMMERCIAL,0,91441,91441,0,161886,253327
142830200200000,CITY PROPERTY,EXEMPT,0,0,0,0,0,0
142830200500000,CITY PROPERTY,EXEMPT,0,0,0,0,0,0
142830200600000,SW 401,RESIDENTIAL,15000,0,15000,62778,0,77778
142830200700000,SW 401,RESIDENTIAL,15000,0,15000,56294,0,71294
142830200800000,SW 401,RESIDENTIAL,15000,0,15000,40108,0,55108
142830200900000,FLAT PARKING,COMMERCIAL,0,18060,18060,0,5418,23478
142830201000000,VACANT LAND,COMMERCIAL,0,1694,1694,0,0,1694
142830201100000,SW 401,RESIDENTIAL,4109,0,4109,28222,0,32331
142830201200000,VACANT LAND,COMMERCIAL,0,1762,1762,0,0,1762
142830201300000,VACANT LAND,COMMERCIAL,0,6345,6345,0,0,6345
142830201400000,VACANT LAND,COMMERCIAL,0,3984,3984,0,0,3984
142830201500000,VACANT LAND,COMMERCIAL,0,27319,27319,0,0,27319
142830300100000,SW 401,RESIDENTIAL,13356,0,13356,66125,0,79481
142830300200000,SW 401,RESIDENTIAL,13536,0,13536,64308,0,77844
142830300300000,CITY PROPERTY,EXEMPT,0,0,0,0,0,0
142830300400000,CITY PROPERTY,EXEMPT,0,0,0,0,0,0
142830300500000,CITY PROPERTY,EXEMPT,0,0,0,0,0,0
142830300600000,SW 401,RESIDENTIAL,6480,0,6480,49367,0,55847
142830300700000,SW 401,RESIDENTIAL,5508,0,5508,18690,0,24198
142830400100000,FOOD GRADE;INDUST,INDUSTRIAL,0,260550,260550,0,662603,923153
142830500100000,RESTAURANT,COMMERCIAL,0,28800,28800,0,53694,82494
142830500500000,CENTRALLY ASSESSED,OTHER,0,0,0,0,0,0
142830500600000,FLAT PARKING,COMMERCIAL,0,2062,2062,0,0,2062
142830500700000,FLAT PARKING,COMMERCIAL,0,21600,21600,0,4826,26426
142830500800000,BRANCH BANK/CU,COMMERCIAL,0,110160,110160,0,537658,647818
142830600100000,SMALL RETAIL,COMMERCIAL,0,3833,3833,0,36457,40290
142830600200000,SW 401,RESIDENTIAL,10306,0,10306,37748,0,48054
142830600300000,SW 401,RESIDENTIAL,7161,0,7161,33296,0,40457
142830600400000,CITY PROPERTY,EXEMPT,0,0,0,0,0,0
142830600500000,CITY PROPERTY,EXEMPT,0,0,0,0,0,0
142830600600000,SW 401,RESIDENTIAL,9486,0,9486,0,0,9486
142830600800000,CITY PROPERTY,EXEMPT,0,0,0,0,0,0
142830600900000,APARTMENT,COMMERCIAL,0,12600,12600,0,133761,146361
142830601000000,SMALL RETAIL,COMMERCIAL,0,5880,5880,0,35704,41584
142830601100000,SW 401,RESIDENTIAL,8640,0,8640,41850,0,50490
142830601200000,SW 401,RESIDENTIAL,13464,0,13464,29874,0,43338
142830601300000,SW 401,RESIDENTIAL,6324,0,6324,27788,0,34112
142830601400000,SW 401,RESIDENTIAL,3348,0,3348,0,0,3348
142830601500000,SW 401,RESIDENTIAL,8370,0,8370,36281,0,44651
142830601600000,SW 401,RESIDENTIAL,9300,0,9300,31771,0,41071
142830601700000,SW 401,RESIDENTIAL,9000,0,9000,47934,0,56934
142830601800000,SW 401,RESIDENTIAL,6750,0,6750,0,0,6750
142830601900000,SW 401,RESIDENTIAL,12000,0,12000,49511,0,61511
142830602000000,SW 401,RESIDENTIAL,12000,0,12000,71626,0,83626
142830602100000,SW 401,RESIDENTIAL,16484,0,16484,48449,0,64933
142830701400000,COUNTY PROPERTY,EXEMPT,0,0,0,0,0,0
142830800100000,FOOD GRADE;INDUST,INDUSTRIAL,0,10724,10724,0,462911,473635
142830800200000,COUNTY PROPERTY,EXEMPT,0,0,0,0,0,0
142830900100000,FLAT PARKING,COMMERCIAL,0,22680,22680,0,0,22680
142830900102000,SMALL RETAIL,COMMERCIAL,0,0,0,0,157783,157783
142830900200000,VACANT LAND,COMMERCIAL,0,16200,16200,0,0,16200
142830900300000,COUNTY PROPERTY,EXEMPT,0,0,0,0,0,0
142830900400000,COUNTY PROPERTY,EXEMPT,0,0,0,0,0,0
142830900500000,COUNTY PROPERTY,EXEMPT,0,0,0,0,0,0
142830900600000,CITY PROPERTY,EXEMPT,0,0,0,0,0,0
142830900700000,COUNTY PROPERTY,EXEMPT,0,0,0,0,0,0
142830900800000,SHOP,COMMERCIAL,0,22680,22680,0,66590,89270
142830900900000,FLAT PARKING,COMMERCIAL,0,18900,18900,0,0,18900
142830901000000,COUNTY PROPERTY,EXEMPT,0,0,0,0,0,0
142830901100000,CITY PROPERTY,EXEMPT,0,0,0,0,0,0
142831000100000,FOOD GRADE;INDUST,INDUSTRIAL,0,15390,15390,0,45990,61380
142831000200000,FOOD GRADE;INDUST,INDUSTRIAL,0,17658,17658,0,59850,77508
142831100100000,CITY PROPERTY,EXEMPT,0,0,0,0,0,0
142831100200000,SW 402,RESIDENTIAL,6324,0,6324,46569,0,52893
142831100300000,CITY PROPERTY,EXEMPT,0,0,0,0,0,0
142831100400000,SW 402,RESIDENTIAL,8398,0,8398,0,0,8398
142831100500000,SW 402,RESIDENTIAL,5235,0,5235,25367,0,30602
142831100600000,CITY PROPERTY,EXEMPT,0,0,0,0,0,0
142831100700000,CITY PROPERTY,EXEMPT,0,0,0,0,0,0
142831100800000,SW 402,RESIDENTIAL,13025,0,13025,53150,0,66175
142831101000000,CITY PROPERTY,EXEMPT,0,0,0,0,0,0
142831101100000,SMALL RETAIL,EXEMPT,0,14580,14580,0,106697,121277
142831101200000,CITY PROPERTY,EXEMPT,0,0,0,0,0,0
142831101300000,CITY PROPERTY,EXEMPT,0,0,0,0,0,0
142831200100000,BARS/LOUNGE,COMMERCIAL,0,25200,25200,0,49858,75058
142831300100000,CENTRALLY ASSESSED,OTHER,0,0,0,0,0,0
142832600100000,STATE PROPERTY,EXEMPT,0,0,0,0,0,0
142832600200000,SW 401,RESIDENTIAL,13119,0,13119,35067,0,48186
142832600300000,CITY PROPERTY,EXEMPT,0,0,0,0,0,0
142832600400000,SW 401,RESIDENTIAL,11291,0,11291,34198,0,45489
142832600500000,STATE PROPERTY,EXEMPT,0,0,0,0,0,0
142832700300000,CONVERSION,COMMERCIAL,0,5103,5103,0,56102,61205
142832700400000,SW 403,RESIDENTIAL,11590,0,11590,73868,0,85458
142832700500000,SW 403,RESIDENTIAL,15067,0,15067,43840,0,58907
142832700600000,SW 403,RESIDENTIAL,5000,0,5000,0,0,5000
142832700700000,CITY PROPERTY,EXEMPT,0,0,0,0,0,0
142832700800000,CITY PROPERTY,EXEMPT,0,0,0,0,0,0
142832700900000,SW 403,RESIDENTIAL,11590,0,11590,0,0,11590
142832701000000,CITY PROPERTY,EXEMPT,0,0,0,0,0,0
142832701100000,AUTO REP/SAL;CTRL CR,COMMERCIAL,0,48780,48780,0,80519,129299
142832701200000,FLAT PARKING,COMMERCIAL,0,13500,13500,0,6058,19558
142832701300000,CONVENIENCE STORE,COMMERCIAL,0,58095,58095,0,185983,244078
142832701400000,SW 403,RESIDENTIAL,19305,0,19305,57951,0,77256
142832800100000,SW 403,RESIDENTIAL,17105,0,17105,47980,0,65085
142832800200000,SW 403,RESIDENTIAL,11590,0,11590,52058,0,63648
142832800300000,SW 403,RESIDENTIAL,5000,0,5000,0,0,5000
142832800400000,SW 403,RESIDENTIAL,15453,0,15453,57765,0,73218
142832800500000,SW 403,RESIDENTIAL,14137,0,14137,59291,0,73428
142832800600000,CONVERSION,COMMERCIAL,0,4406,4406,0,38580,42986
142832800700000,SW 403,RESIDENTIAL,12852,0,12852,46672,0,59524
142832800800000,SW 403,RESIDENTIAL,9371,0,9371,54001,0,63372
142832800900000,CONVERSION,COMMERCIAL,0,6378,6378,0,52268,58646
142832801000000,SW 403,RESIDENTIAL,18697,0,18697,45291,0,63988
142832801100000,CITY PROPERTY,EXEMPT,0,0,0,0,0,0
142832801200000,SW 403,RESIDENTIAL,11590,0,11590,57690,0,69280
142832801300000,SW 403,RESIDENTIAL,5000,0,5000,0,0,5000
142832801400000,SW 403,RESIDENTIAL,11217,0,11217,46121,0,57338
142832801500000,CITY PROPERTY,EXEMPT,0,0,0,0,0,0
142832801600000,SW 403,RESIDENTIAL,5000,0,5000,0,0,5000
142832801700000,CITY PROPERTY,EXEMPT,0,0,0,0,0,0
142832900100000,SW 403,RESIDENTIAL,16971,0,16971,49313,0,66284
142832900200000,SW 403,RESIDENTIAL,11590,0,11590,50477,0,62067
142832900300000,CITY PROPERTY,EXEMPT,0,0,0,0,0,0
142832900400000,SW 403,RESIDENTIAL,16998,0,16998,59036,0,76034
142832900500000,SW 403,RESIDENTIAL,5000,0,5000,0,0,5000
142832900600000,CITY PROPERTY,EXEMPT,0,0,0,0,0,0
142832900700000,CONVERSION,COMMERCIAL,0,9040,9040,0,60887,69927
142832900800000,SW 403,RESIDENTIAL,12362,0,12362,58167,0,70529
142832900900000,SW 403,RESIDENTIAL,24774,0,24774,61620,0,86394
142832901000000,SW 403,RESIDENTIAL,5000,0,5000,0,0,5000
142832901100000,SW 403,RESIDENTIAL,10978,0,10978,49311,0,60289
142833000100000,CITY PROPERTY,EXEMPT,0,0,0,0,0,0
142833000200000,SW 403,RESIDENTIAL,16362,0,16362,0,0,16362
142833000300000,SW 403,RESIDENTIAL,18543,0,18543,67400,0,85943
142833000400000,SW 403,RESIDENTIAL,11590,0,11590,67889,0,79479
142833000500000,CITY PROPERTY,EXEMPT,0,0,0,0,0,0
142833000600000,SW 403,RESIDENTIAL,16186,0,16186,71997,0,88183
142833000700000,VACANT LAND,RESIDENTIAL,11675,0,11675,0,0,11675
142833000800000,SW 403,RESIDENTIAL,11590,0,11590,41504,0,53094
142833000900000,SW 403,RESIDENTIAL,11590,0,11590,38177,0,49767
142833001000000,CONVERSION,COMMERCIAL,0,9040,9040,0,39548,48588
142833001100000,CONVERSION,COMMERCIAL,0,2644,2644,0,32116,34760
142833001200000,SW 403,RESIDENTIAL,11590,0,11590,61073,0,72663
142833001300000,CITY PROPERTY,EXEMPT,0,0,0,0,0,0
142833001400000,CITY PROPERTY,EXEMPT,0,0,0,0,0,0
142833100100000,CITY PROPERTY,EXEMPT,0,0,0,0,0,0
142833100200000,CITY PROPERTY,EXEMPT,0,0,0,0,0,0
142833100300000,SW 403,RESIDENTIAL,18209,0,18209,61884,0,80093
142833100400000,SW 403,RESIDENTIAL,16419,0,16419,60178,0,76597
142833100500000,SW 403,RESIDENTIAL,17384,0,17384,81702,0,99086
142833100600000,SW 403,RESIDENTIAL,16971,0,16971,66783,0,83754
142833100700000,SW 403,RESIDENTIAL,10710,0,10710,51632,0,62342
142833100800000,SW 403,RESIDENTIAL,11573,0,11573,52216,0,63789
142833100900000,CITY PROPERTY,EXEMPT,0,0,0,0,0,0
142833101000000,CITY PROPERTY,EXEMPT,0,0,0,0,0,0
142833101100000,SW 403,RESIDENTIAL,15453,0,15453,41339,0,56792
142833101200000,SW 403,RESIDENTIAL,15453,0,15453,60701,0,76154
142833101300000,SW 403,RESIDENTIAL,15453,0,15453,65098,0,80551
142833101400000,SW 403,RESIDENTIAL,15453,0,15453,56281,0,71734
142833101500000,SW 403,RESIDENTIAL,15269,0,15269,62683,0,77952
142833101600000,CITY PROPERTY,EXEMPT,0,0,0,0,0,0
142833101700000,SW 403,RESIDENTIAL,14344,0,14344,59080,0,73424
142833101800000,SW 403,RESIDENTIAL,19881,0,19881,55318,0,75199
142833101900000,CITY PROPERTY,EXEMPT,0,0,0,0,0,0
142833102000000,SW 403,RESIDENTIAL,18073,0,18073,67804,0,85877
142833102100000,SW 403,RESIDENTIAL,12049,0,12049,27808,0,39857
142833102200000,CITY PROPERTY,EXEMPT,0,0,0,0,0,0
142833200100000,SW 403,RESIDENTIAL,16362,0,16362,71725,0,88087
142833200200000,SW 403,RESIDENTIAL,18543,0,18543,64836,0,83379
142833200300000,CITY PROPERTY,EXEMPT,0,0,0,0,0,0
142833200400000,SW 403,RESIDENTIAL,12749,0,12749,0,0,12749
142833200500000,SW 403,RESIDENTIAL,11590,0,11590,44604,0,56194
142833200600000,CITY PROPERTY,EXEMPT,0,0,0,0,0,0
142833200700000,SW 403,RESIDENTIAL,18543,0,18543,123776,0,142319
142833200800000,CONVERSION,COMMERCIAL,0,8587,8587,0,61326,69913
142833200900000,CITY PROPERTY,EXEMPT,0,0,0,0,0,0
142833201000000,SW 403,RESIDENTIAL,15453,0,15453,65622,0,81075
142833201100000,SW 403,RESIDENTIAL,15453,0,15453,0,0,15453
142833201200000,CITY PROPERTY,EXEMPT,0,0,0,0,0,0
142833201300000,SW 403,RESIDENTIAL,16971,0,16971,53878,0,70849
142833201400000,CITY PROPERTY,EXEMPT,0,0,0,0,0,0
142833201500000,CONVERSION,COMMERCIAL,0,14563,14563,0,59363,73926
142833201600000,SW 403,RESIDENTIAL,9639,0,9639,46823,0,56462
142833201700000,SW 403,RESIDENTIAL,15453,0,15453,54444,0,69897
142833201800000,SW 403,RESIDENTIAL,15453,0,15453,58371,0,73824
142833201900000,SW 403,RESIDENTIAL,15453,0,15453,53910,0,69363
142833202000000,SW 403,RESIDENTIAL,15453,0,15453,45595,0,61048
142833202100000,SW 403,RESIDENTIAL,15453,0,15453,39557,0,55010
142833202200000,SW 403,RESIDENTIAL,17617,0,17617,67470,0,85087
142833202300000,SW 403,RESIDENTIAL,15453,0,15453,48774,0,64227
142833202400000,CITY PROPERTY,EXEMPT,0,0,0,0,0,0
142833202500000,SW 403,RESIDENTIAL,15453,0,15453,42388,0,57841
142833202600000,SW 403,RESIDENTIAL,18543,0,18543,70641,0,89184
142833202700000,CITY PROPERTY,EXEMPT,0,0,0,0,0,0
142833300100000,CHURCH,EXEMPT,0,20412,20412,0,154581,174993
142833300200000,SW 403,RESIDENTIAL,12240,0,12240,61348,0,73588
142833300300000,SW 403,RESIDENTIAL,13923,0,13923,42818,0,56741
142833300400000,CITY PROPERTY,EXEMPT,0,0,0,0,0,0
142833300500000,SW 403,RESIDENTIAL,15912,0,15912,61480,0,77392
142833300600000,CITY PROPERTY,EXEMPT,0,0,0,0,0,0
142833300700000,VACANT LAND,COMMERCIAL,0,19099,19099,0,0,19099
142833300800000,CHURCH,EXEMPT,0,15139,15139,0,3730,18869
142833300900000,CHURCH,EXEMPT,0,15184,15184,0,1906,17090
142833301000000,SW 403,RESIDENTIAL,20884,0,20884,0,0,20884
142833301100000,CHURCH,EXEMPT,0,19505,19505,0,4816,24321
142833400100000,SW 403,RESIDENTIAL,10710,0,10710,53648,0,64358
142833400200000,SW 403,RESIDENTIAL,12485,0,12485,51139,0,63624
142833400300000,SW 403,RESIDENTIAL,15453,0,15453,81122,0,96575
142833400400000,SW 403,RESIDENTIAL,15453,0,15453,17417,0,32870
142833400500000,SW 403,RESIDENTIAL,15453,0,15453,68210,0,83663
142833400600000,SW 403,RESIDENTIAL,15453,0,15453,13565,0,29018
142833400700000,SW 403,RESIDENTIAL,15453,0,15453,54338,0,69791
142833400800000,CITY PROPERTY,EXEMPT,0,0,0,0,0,0
142833400900000,SW 403,RESIDENTIAL,12620,0,12620,62299,0,74919
142833401000000,WAREHOUSE;MINI STORG,COMMERCIAL,0,32383,32383,0,85481,117864
142833401100000,SHOP,COMMERCIAL,0,24738,24738,0,119625,144363
142833401200000,SW 403,RESIDENTIAL,15453,0,15453,52686,0,68139
142833401300000,SW 403,RESIDENTIAL,15453,0,15453,59055,0,74508
142833401400000,SW 403,RESIDENTIAL,15453,0,15453,61658,0,77111
142833401500000,SW 403,RESIDENTIAL,15453,0,15453,55565,0,71018
142833401600000,SW 403,RESIDENTIAL,15453,0,15453,54485,0,69938
142833500100000,SW 403,RESIDENTIAL,20242,0,20242,72606,0,92848
142833500200000,SW 403,RESIDENTIAL,15453,0,15453,55375,0,70828
142833500300000,SW 403,RESIDENTIAL,15453,0,15453,83711,0,99164
142833500400000,SW 403,RESIDENTIAL,15453,0,15453,77050,0,92503
142833500500000,SW 403,RESIDENTIAL,15453,0,15453,55371,0,70824
142833500600000,SW 403,RESIDENTIAL,15453,0,15453,69490,0,84943
142833500700000,SW 403,RESIDENTIAL,15453,0,15453,64677,0,80130
142833500800000,SW 403,RESIDENTIAL,15453,0,15453,49551,0,65004
142833500900000,VACANT LAND,COMMERCIAL,0,8432,8432,0,0,8432
142833501000000,SW 403,RESIDENTIAL,15453,0,15453,58490,0,73943
142833501100000,CITY PROPERTY,EXEMPT,0,0,0,0,0,0
142833501200000,SW 403,RESIDENTIAL,15453,0,15453,64589,0,80042
142833501300000,SW 403,RESIDENTIAL,16226,0,16226,61163,0,77389
142833501400000,SW 403,RESIDENTIAL,16054,0,16054,0,0,16054
142833501500000,SW 403,RESIDENTIAL,16226,0,16226,70806,0,87032
142833501600000,SW 403,RESIDENTIAL,16226,0,16226,33438,0,49664
142833501700000,SW 403,RESIDENTIAL,15453,0,15453,22106,0,37559
142833501800000,SW 403,RESIDENTIAL,5000,0,5000,0,0,5000
142833501900000,SW 403,RESIDENTIAL,15453,0,15453,61496,0,76949
142833502000000,SW 403,RESIDENTIAL,15453,0,15453,72244,0,87697
142833502100000,CITY PROPERTY,EXEMPT,0,0,0,0,0,0
142833502200000,SW 403,RESIDENTIAL,15453,0,15453,43755,0,59208
142833502300000,SW 403,RESIDENTIAL,15453,0,15453,67823,0,83276
142833502400000,SW 403,RESIDENTIAL,15453,0,15453,67033,0,82486
142833502500000,SW 403,RESIDENTIAL,15453,0,15453,78356,0,93809
142833502600000,SW 403,RESIDENTIAL,15453,0,15453,69636,0,85089
142833502700000,SW 403,RESIDENTIAL,15453,0,15453,68859,0,84312
142833502800000,SW 403,RESIDENTIAL,12749,0,12749,58990,0,71739
142833502900000,SW 403,RESIDENTIAL,11590,0,11590,62288,0,73878
142833503000000,SW 403,RESIDENTIAL,12286,0,12286,60279,0,72565
142833600100000,VACANT LAND,COMMERCIAL,0,7604,7604,0,0,7604
142833600200000,SW 403,RESIDENTIAL,13770,0,13770,33347,0,47117
142833600300000,SW 403,RESIDENTIAL,14688,0,14688,71269,0,85957
142833600400000,SW 403,RESIDENTIAL,15231,0,15231,36643,0,51874
142833600500000,CITY PROPERTY,EXEMPT,0,0,0,0,0,0
142833600600000,SW 403,RESIDENTIAL,15453,0,15453,41530,0,56983
142833600700000,SW 403,RESIDENTIAL,15453,0,15453,51295,0,66748
142833600800000,SW 403,RESIDENTIAL,5000,0,5000,0,0,5000
142833600900000,SW 403,RESIDENTIAL,15453,0,15453,65535,0,80988
142833601000000,SW 403,RESIDENTIAL,15453,0,15453,69690,0,85143
142833601100000,SW 403,RESIDENTIAL,15453,0,15453,50447,0,65900
142833601200000,CITY PROPERTY,EXEMPT,0,0,0,0,0,0
142833601300000,CITY PROPERTY,EXEMPT,0,0,0,0,0,0
142833700100000,VACANT LAND,COMMERCIAL,0,169750,169750,0,0,169750
142833700200000,CENTRALLY ASSESSED,OTHER,0,0,0,0,0,0
142833700300000,CENTRALLY ASSESSED,OTHER,0,0,0,0,0,0
142835100100000,VACANT LAND,COMMERCIAL,0,20420,20420,0,0,20420
142835100200000,SW 403,RESIDENTIAL,15606,0,15606,45678,0,61284
142835100300000,SW 403,RESIDENTIAL,9584,0,9584,0,0,9584
142835100400000,SW 403,RESIDENTIAL,18727,0,18727,123363,0,142090
142835100500000,SW 403,RESIDENTIAL,15606,0,15606,53074,0,68680
142835100600000,SW 403,RESIDENTIAL,18727,0,18727,44212,0,62939
142835100700000,CITY PROPERTY,EXEMPT,0,0,0,0,0,0
142835100800000,CITY PROPERTY,EXEMPT,0,0,0,0,0,0
142835100900000,SW 403,RESIDENTIAL,15606,0,15606,62914,0,78520
142835101000000,SW 403,RESIDENTIAL,10406,0,10406,36506,0,46912
142835101100000,SW 403,RESIDENTIAL,5000,0,5000,0,0,5000
142835101200000,SW 403,RESIDENTIAL,18208,0,18208,43387,0,61595
142835101400000,SW 403,RESIDENTIAL,15606,0,15606,35407,0,51013
142835101500000,SW 403,RESIDENTIAL,15606,0,15606,0,0,15606
142835101600000,SW 403,RESIDENTIAL,15606,0,15606,0,0,15606
142835101700000,SW 403,RESIDENTIAL,15606,0,15606,46966,0,62572
142835101800000,VACANT LAND,COMMERCIAL,0,10205,10205,0,0,10205
142835200100000,SW 403,RESIDENTIAL,15453,0,15453,90577,0,106030
142835200200000,SW 403,RESIDENTIAL,5000,0,5000,0,0,5000
142835200300000,CITY PROPERTY,EXEMPT,0,0,0,0,0,0
142835200400000,SW 403,RESIDENTIAL,5000,0,5000,0,0,5000
142835200500000,CITY PROPERTY,EXEMPT,0,0,0,0,0,0
142835200600000,SW 403,RESIDENTIAL,15453,0,15453,50673,0,66126
142835200700000,CITY PROPERTY,EXEMPT,0,0,0,0,0,0
142835200800000,SW 403,RESIDENTIAL,15453,0,15453,51775,0,67228
142835200900000,SW 403,RESIDENTIAL,15453,0,15453,64546,0,79999
142835201000000,SW 403,RESIDENTIAL,15453,0,15453,59953,0,75406
142835201100000,SW 403,RESIDENTIAL,15453,0,15453,0,0,15453
142835201200000,SW 403,RESIDENTIAL,15453,0,15453,0,0,15453
142835201300000,SW 403,RESIDENTIAL,15453,0,15453,36590,0,52043
142835201400000,CITY PROPERTY,EXEMPT,0,0,0,0,0,0
142835201500000,CITY PROPERTY,EXEMPT,0,0,0,0,0,0
142835201600000,SW 403,RESIDENTIAL,15453,0,15453,0,0,15453
142835201700000,SW 403,RESIDENTIAL,15453,0,15453,0,0,15453
142835201800000,SW 403,RESIDENTIAL,15453,0,15453,0,0,15453
142835300100000,CENTRALLY ASSESSED,OTHER,0,0,0,0,0,0
142835301500000,CITY PROPERTY,EXEMPT,0,0,0,0,0,0
142835400100000,VACANT LAND,COMMERCIAL,0,1077,1077,0,0,1077
142835400200000,VACANT LAND,COMMERCIAL,0,89600,89600,0,0,89600
142835400300000,CENTRALLY ASSESSED,OTHER,0,0,0,0,0,0
142835500100000,SW 403,RESIDENTIAL,6065,0,6065,0,0,6065
142835500200000,SW 403,RESIDENTIAL,7700,0,7700,35912,0,43612
142835500300000,CITY PROPERTY,EXEMPT,0,0,0,0,0,0
142835500400000,CITY PROPERTY,EXEMPT,0,0,0,0,0,0
142835500500000,SW 403,RESIDENTIAL,5000,0,5000,0,0,5000
142835500600000,SW 403,RESIDENTIAL,15606,0,15606,52614,0,68220
142835500700000,SW 403,RESIDENTIAL,15606,0,15606,0,0,15606
142835500800000,SW 403,RESIDENTIAL,18298,0,18298,45140,0,63438
142835500900000,SW 403,RESIDENTIAL,15606,0,15606,61059,0,76665
142835501000000,SW 403,RESIDENTIAL,17576,0,17576,50609,0,68185
142835501100000,SW 403,RESIDENTIAL,15606,0,15606,0,0,15606
142835501200000,SW 403,RESIDENTIAL,15606,0,15606,39266,0,54872
142835501300000,SW 403,RESIDENTIAL,15606,0,15606,4675,0,20281
142835501400000,SW 403,RESIDENTIAL,16581,0,16581,23190,0,39771
142835501500000,SW 403,RESIDENTIAL,19507,0,19507,34439,0,53946
142835501600000,SW 403,RESIDENTIAL,15606,0,15606,41431,0,57037
142835501700000,SW 403,RESIDENTIAL,15606,0,15606,44895,0,60501
142835501800000,SW 403,RESIDENTIAL,15606,0,15606,52762,0,68368
142835501900000,SW 403,RESIDENTIAL,5000,0,5000,0,0,5000
142835502000000,SW 403,RESIDENTIAL,18727,0,18727,37134,0,55861
142835502100000,SW 403,RESIDENTIAL,15606,0,15606,58265,0,73871
142835502200000,SW 403,RESIDENTIAL,15606,0,15606,42599,0,58205
142835502300000,SW 403,RESIDENTIAL,15606,0,15606,37542,0,53148
142835502400000,SW 403,RESIDENTIAL,15606,0,15606,56681,0,72287
142835600100000,SW 403,RESIDENTIAL,20861,0,20861,88902,0,109763
142835600200000,SW 403,RESIDENTIAL,20861,0,20861,0,0,20861
142835600300000,SW 403,RESIDENTIAL,15453,0,15453,37323,0,52776
142835600400000,SW 403,RESIDENTIAL,15453,0,15453,43618,0,59071
142835600500000,SW 403,RESIDENTIAL,15453,0,15453,54854,0,70307
142835600600000,SW 403,RESIDENTIAL,15453,0,15453,49979,0,65432
142835600700000,SW 403,RESIDENTIAL,15453,0,15453,53610,0,69063
142835600800000,SW 403,RESIDENTIAL,15453,0,15453,48252,0,63705
142835600900000,SW 403,RESIDENTIAL,15453,0,15453,50377,0,65830
142835601000000,SW 403,RESIDENTIAL,18180,0,18180,0,0,18180
142835601100000,SW 403,RESIDENTIAL,14680,0,14680,11612,0,26292
142835601200000,SW 403,RESIDENTIAL,18080,0,18080,0,0,18080
142835601300000,SW 403,RESIDENTIAL,16419,0,16419,49017,0,65436
142835601400000,SW 403,RESIDENTIAL,15453,0,15453,56422,0,71875
142835601500000,SW 403,RESIDENTIAL,15453,0,15453,33927,0,49380
142835601600000,SW 403,RESIDENTIAL,15453,0,15453,0,0,15453
142835601700000,SW 403,RESIDENTIAL,15453,0,15453,0,0,15453
142835601800000,SW 403,RESIDENTIAL,15453,0,15453,0,0,15453
142835601900000,SW 403,RESIDENTIAL,15453,0,15453,51619,0,67072
142835602000000,SW 403,RESIDENTIAL,15453,0,15453,54125,0,69578
142835602100000,SW 403,RESIDENTIAL,18544,0,18544,112454,0,130998
142835700100000,SW 403,RESIDENTIAL,20655,0,20655,67360,0,88015
142835700200000,CITY PROPERTY,EXEMPT,0,0,0,0,0,0
142835700300000,SW 403,RESIDENTIAL,20655,0,20655,22533,0,43188
142835700400000,SW 403,RESIDENTIAL,17213,0,17213,55497,0,72710
142835700500000,SW 403,RESIDENTIAL,17213,0,17213,59911,0,77124
142835700600000,SW 403,RESIDENTIAL,17213,0,17213,45998,0,63211
142835700700000,SW 403,RESIDENTIAL,17213,0,17213,74689,0,91902
142835700800000,SW 403,RESIDENTIAL,20655,0,20655,44307,0,64962
142835700900000,SW 403,RESIDENTIAL,20655,0,20655,47428,0,68083
142835701000000,SW 403,RESIDENTIAL,18360,0,18360,61394,0,79754
142835701100000,SW 403,RESIDENTIAL,18360,0,18360,43742,0,62102
142835701200000,SW 403,RESIDENTIAL,18360,0,18360,56889,0,75249
142835701300000,SW 403,RESIDENTIAL,18360,0,18360,52631,0,70991
142835701400000,CITY PROPERTY,EXEMPT,0,0,0,0,0,0
142835800100000,SW 403,RESIDENTIAL,17044,0,17044,44842,0,61886
142835800200000,SW 403,RESIDENTIAL,20452,0,20452,82301,0,102753
142835800300000,SW 403,RESIDENTIAL,20452,0,20452,47774,0,68226
142835800400000,SW 403,RESIDENTIAL,20452,0,20452,61489,0,81941
142835800500000,SW 403,RESIDENTIAL,20452,0,20452,57990,0,78442
142835800600000,SW 403,RESIDENTIAL,20452,0,20452,45611,0,66063
142835800700000,SW 403,RESIDENTIAL,20452,0,20452,90848,0,111300
142835800800000,SW 403,RESIDENTIAL,22725,0,22725,72082,0,94807
142835800900000,SW 403,RESIDENTIAL,22725,0,22725,61854,0,84579
142835801000000,CITY PROPERTY,EXEMPT,0,0,0,0,0,0
142835801100000,SW 403,RESIDENTIAL,17044,0,17044,53575,0,70619
142835801200000,CITY PROPERTY,EXEMPT,0,0,0,0,0,0
142835801300000,CITY PROPERTY,EXEMPT,0,0,0,0,0,0
142837600100000,SW 402,RESIDENTIAL,12000,0,12000,57256,0,69256
142837600200000,SW 402,RESIDENTIAL,24000,0,24000,58836,0,82836
142837600300000,SW 402,RESIDENTIAL,12000,0,12000,44496,0,56496
142837600400000,SW 402,RESIDENTIAL,14280,0,14280,34979,0,49259
142837600500000,SW 402,RESIDENTIAL,11067,0,11067,46317,0,57384
142837600600000,SW 402,RESIDENTIAL,10200,0,10200,66834,0,77034
142837600700000,SW 402,RESIDENTIAL,15300,0,15300,50063,0,65363
142837600800000,SW 402,RESIDENTIAL,15300,0,15300,32439,0,47739
142837600900000,SW 402,RESIDENTIAL,20400,0,20400,0,0,20400
142837601000000,SW 402,RESIDENTIAL,10200,0,10200,31045,0,41245
142837601100000,SW 402,RESIDENTIAL,10200,0,10200,24830,0,35030
142837700100000,CITY PROPERTY,EXEMPT,0,0,0,0,0,0
142837700200000,SW 402,RESIDENTIAL,18564,0,18564,34661,0,53225
142837700300000,CONVERSION,COMMERCIAL,0,5400,5400,0,0,5400
142837700400000,SW 402,RESIDENTIAL,9282,0,9282,45546,0,54828
142837700500000,SW 402,RESIDENTIAL,9282,0,9282,0,0,9282
142837700600000,APARTMENT,COMMERCIAL,0,14400,14400,0,142249,156649
142837700700000,CONVERSION,COMMERCIAL,0,5832,5832,0,43122,48954
142837700800000,SW 402,RESIDENTIAL,16864,0,16864,47436,0,64300
142837700900000,CITY PROPERTY,EXEMPT,0,0,0,0,0,0
142837701000000,CITY PROPERTY,EXEMPT,0,0,0,0,0,0
142837701100000,SW 402,RESIDENTIAL,5516,0,5516,27662,0,33178
142837701200000,SW 402,RESIDENTIAL,7590,0,7590,28819,0,36409
142837701500000,CITY PROPERTY,EXEMPT,0,0,0,0,0,0
142837701600000,CITY PROPERTY,EXEMPT,0,0,0,0,0,0
142837701700000,CITY PROPERTY,EXEMPT,0,0,0,0,0,0
142837701800000,SW 402,RESIDENTIAL,13500,0,13500,68714,0,82214
142837800100000,VACANT LAND,COMMERCIAL,0,10847,10847,0,0,10847
142837800200000,SW 402,RESIDENTIAL,15147,0,15147,50606,0,65753
142837800300000,SW 402,RESIDENTIAL,5000,0,5000,0,0,5000
142837800400000,SW 402,RESIDENTIAL,7573,0,7573,27237,0,34810
142837800500000,SW 402,RESIDENTIAL,7573,0,7573,31952,0,39525
142837800600000,APARTMENT,COMMERCIAL,0,16200,16200,0,80114,96314
142837900100000,SW 402,RESIDENTIAL,15980,0,15980,64698,0,80678
142837900200000,SW 402,RESIDENTIAL,5000,0,5000,0,0,5000
142837900300000,SW 402,RESIDENTIAL,13600,0,13600,78776,0,92376
142837900400000,SW 402,RESIDENTIAL,14280,0,14280,32933,0,47213
142838000100000,CITY PROPERTY,EXEMPT,0,0,0,0,0,0
142838000200000,SW 402,RESIDENTIAL,12070,0,12070,50818,0,62888
142838000300000,SW 402,RESIDENTIAL,11424,0,11424,41644,0,53068
142838000400000,SW 402,RESIDENTIAL,12512,0,12512,35438,0,47950
142838000500000,SW 402,RESIDENTIAL,13416,0,13416,38202,0,51618
142838000600000,SW 402,RESIDENTIAL,13600,0,13600,41897,0,55497
142838000700000,SW 402,RESIDENTIAL,10200,0,10200,56464,0,66664
142838000800000,SW 402,RESIDENTIAL,10200,0,10200,0,0,10200
142838000900000,SW 402,RESIDENTIAL,10200,0,10200,44578,0,54778
142838001000000,SW 402,RESIDENTIAL,7650,0,7650,1762,0,9412
142838001100000,SW 402,RESIDENTIAL,8000,0,8000,0,0,8000
142838001200000,SW 402,RESIDENTIAL,20400,0,20400,77486,0,97886
142838001300000,SW 402,RESIDENTIAL,19267,0,19267,65522,0,84789
142838001400000,SW 402,RESIDENTIAL,15484,0,15484,58874,0,74358
142838001500000,SW 402,RESIDENTIAL,8875,0,8875,0,0,8875
142838001600000,SW 402,RESIDENTIAL,10962,0,10962,44558,0,55520
142838100100000,SW 402,RESIDENTIAL,13668,0,13668,50035,0,63703
142838100200000,SW 402,RESIDENTIAL,8432,0,8432,54872,0,63304
142838100300000,SW 402,RESIDENTIAL,7378,0,7378,44107,0,51485
142838100400000,SW 402,RESIDENTIAL,12144,0,12144,77374,0,89518
142838100600000,CITY PROPERTY,EXEMPT,0,0,0,0,0,0
142838100800000,SW 402,RESIDENTIAL,11840,0,11840,0,0,11840
142838100900000,SW 402,RESIDENTIAL,18564,0,18564,52161,0,70725
142838101000000,SW 402,RESIDENTIAL,18564,0,18564,41537,0,60101
142838101100000,SW 402,RESIDENTIAL,20400,0,20400,60985,0,81385
142838101200000,SW 402,RESIDENTIAL,10200,0,10200,32386,0,42586
142838101300000,SW 402,RESIDENTIAL,10200,0,10200,51730,0,61930
142838101400000,SW 402,RESIDENTIAL,20400,0,20400,78834,0,99234
142838101500000,SW 402,RESIDENTIAL,20400,0,20400,60148,0,80548
142838101600000,SW 402,RESIDENTIAL,24476,0,24476,61812,0,86288
142838200100000,CITY PROPERTY,EXEMPT,0,0,0,0,0,0
142838200200000,CITY PROPERTY,EXEMPT,0,0,0,0,0,0
142838200300000,SW 402,RESIDENTIAL,13023,0,13023,49050,0,62073
142838200400000,SW 402,RESIDENTIAL,9149,0,9149,36584,0,45733
142838200500000,SW 402,RESIDENTIAL,8905,0,8905,39275,0,48180
142838200600000,SW 402,RESIDENTIAL,12257,0,12257,56224,0,68481
142838200900000,SW 402,RESIDENTIAL,6739,0,6739,16788,0,23527
142838201000000,SW 402,RESIDENTIAL,10472,0,10472,47428,0,57900
142838201100000,SW 402,RESIDENTIAL,15627,0,15627,0,0,15627
142838300100000,SW 402,RESIDENTIAL,16524,0,16524,68176,0,84700
142838300200000,CITY PROPERTY,EXEMPT,0,0,0,0,0,0
142838300300000,CITY PROPERTY,EXEMPT,0,0,0,0,0,0
142838300400000,SW 402,RESIDENTIAL,7500,0,7500,0,0,7500
142838300500000,SW 402,RESIDENTIAL,11900,0,11900,50314,0,62214
142838300600000,SW 402,RESIDENTIAL,20400,0,20400,55877,0,76277
142838300700000,SW 402,RESIDENTIAL,10880,0,10880,50138,0,61018
142838300800000,CITY PROPERTY,EXEMPT,0,0,0,0,0,0
142838300900000,CITY PROPERTY,EXEMPT,0,0,0,0,0,0
142838301000000,SW 402,RESIDENTIAL,20400,0,20400,27337,0,47737
142838301100000,SW 402,RESIDENTIAL,20808,0,20808,52651,0,73459
142838301200000,SW 402,RESIDENTIAL,10404,0,10404,62587,0,72991
142838301300000,SW 402,RESIDENTIAL,10404,0,10404,56109,0,66513
142838301400000,SW 402,RESIDENTIAL,9982,0,9982,75091,0,85073
142838301500000,SW 402,RESIDENTIAL,10826,0,10826,52521,0,63347
142838301600000,SW 402,RESIDENTIAL,20808,0,20808,68240,0,89048
142838400100000,SW 402,RESIDENTIAL,20400,0,20400,74433,0,94833
142838400200000,SW 402,RESIDENTIAL,12376,0,12376,52658,0,65034
142838400300000,SW 402,RESIDENTIAL,12376,0,12376,48326,0,60702
142838400400000,SW 402,RESIDENTIAL,12376,0,12376,0,0,12376
142838400500000,SW 402,RESIDENTIAL,16422,0,16422,35321,0,51743
142838400600000,SW 402,RESIDENTIAL,2142,0,2142,14600,0,16742
142838400700000,SW 402,RESIDENTIAL,16708,0,16708,55994,0,72702
142838400800000,SW 402,RESIDENTIAL,19046,0,19046,98829,0,117875
142838400900000,SW 402,RESIDENTIAL,6977,0,6977,37422,0,44399
142838401000000,CITY PROPERTY,EXEMPT,0,0,0,0,0,0
142838401100000,SW 402,RESIDENTIAL,17850,0,17850,0,0,17850
142838401200000,SW 402,RESIDENTIAL,20400,0,20400,38593,0,58993
142838500100000,CITY PROPERTY,EXEMPT,0,0,0,0,0,0
142838500200000,SW 402,RESIDENTIAL,11900,0,11900,59699,0,71599
142838500300000,SW 402,RESIDENTIAL,12239,0,12239,64061,0,76300
142838500400000,SW 402,RESIDENTIAL,7021,0,7021,60854,0,67875
142838500500000,SW 402,RESIDENTIAL,10647,0,10647,0,0,10647
142838500600000,CITY PROPERTY,EXEMPT,0,0,0,0,0,0
142838500700000,SW 402,RESIDENTIAL,17280,0,17280,55934,0,73214
142838500800000,SW 402,RESIDENTIAL,17280,0,17280,60461,0,77741
142838500900000,SW 402,RESIDENTIAL,10829,0,10829,50986,0,61815
142838600100000,SW 402,RESIDENTIAL,20808,0,20808,70231,0,91039
142838600200000,CONVERSION,COMMERCIAL,0,10206,10206,0,58239,68445
142838600300000,SW 402,RESIDENTIAL,13600,0,13600,54385,0,67985
142838600400000,SW 402,RESIDENTIAL,13600,0,13600,65722,0,79322
142838600500000,SW 402,RESIDENTIAL,15300,0,15300,57801,0,73101
142838600600000,SW 402,RESIDENTIAL,22542,0,22542,79228,0,101770
142838600700000,SW 402,RESIDENTIAL,20808,0,20808,73143,0,93951
142838700100000,SW 402,RESIDENTIAL,18240,0,18240,71529,0,89769
142838700200000,SW 402,RESIDENTIAL,13020,0,13020,76977,0,89997
142838700300000,SW 402,RESIDENTIAL,12600,0,12600,38247,0,50847
142838700400000,SW 402,RESIDENTIAL,12600,0,12600,56131,0,68731
142838700500000,SW 402,RESIDENTIAL,22680,0,22680,65039,0,87719
142838700600000,SW 402,RESIDENTIAL,14560,0,14560,76593,0,91153
142838700700000,SW 402,RESIDENTIAL,13832,0,13832,54338,0,68170
142838700800000,SW 402,RESIDENTIAL,26000,0,26000,86485,0,112485
142838700900000,SW 402,RESIDENTIAL,24000,0,24000,76167,0,100167
142838800100000,SW 402,RESIDENTIAL,17100,0,17100,73241,0,90341
142838800200000,SW 402,RESIDENTIAL,17100,0,17100,62074,0,79174
142838800300000,SW 402,RESIDENTIAL,17100,0,17100,58043,0,75143
142838800400000,SW 402,RESIDENTIAL,19145,0,19145,118130,0,137275
142840100100000,BARS/LOUNGE,COMMERCIAL,0,115702,115702,0,295641,411343
142840200100000,BARS/LOUNGE; CTRL CR,COMMERCIAL,0,27300,27300,0,197866,225166
142840200200000,SMALL RET; CTRL CR,COMMERCIAL,0,33600,33600,0,191202,224802
142840200300000,SE 237,RESIDENTIAL,5000,0,5000,0,0,5000
142840200400000,LITERARY/LIBRARY/ART,EXEMPT,0,25200,25200,0,0,25200
142840200500000,LITERARY/LIBRARY/ART,EXEMPT,0,12600,12600,0,0,12600
142840200600000,LITERARY/LIBRARY/ART,EXEMPT,0,12600,12600,0,0,12600
142840200700000,VACANT LAND,COMMERCIAL,0,25200,25200,0,0,25200
142840200800000,SE 237,RESIDENTIAL,5000,0,5000,0,0,5000
142840200900000,SMALL RET; CTRL CR,COMMERCIAL,0,8454,8454,0,25000,33454
142840201000000,WAREHOUSE; CTRL CR,COMMERCIAL,0,33600,33600,0,54388,87988
142840201100000,SHOP,COMMERCIAL,0,11722,11722,0,45732,57454
142840300100000,CITY PROPERTY,EXEMPT,0,0,0,0,0,0
142840300200000,CENTRALLY ASSESSED,OTHER,0,0,0,0,0,0
142840400200000,RESTAURANT,COMMERCIAL,0,228651,228651,0,298802,527453
142840400300000,CITY PROPERTY,EXEMPT,0,0,0,0,0,0
142840400400000,SE 237,RESIDENTIAL,3000,0,3000,85526,0,88526
142840400500000,CITY PROPERTY,EXEMPT,0,0,0,0,0,0
142840400600000,FUNERAL HOME,COMMERCIAL,0,22680,22680,0,149527,172207
142840400700000,CARWASH,COMMERCIAL,0,25200,25200,0,17676,42876
142840400800000,WAREHOUSE,COMMERCIAL,0,25200,25200,0,34778,59978
142840500100000,CITY PROPERTY,EXEMPT,0,0,0,0,0,0
142840500200000,VACANT LAND,COMMERCIAL,0,15300,15300,0,4998,20298
142840500300000,VACANT LAND,COMMERCIAL,0,13860,13860,0,0,13860
142840500400000,CITY PROPERTY,EXEMPT,0,0,0,0,0,0
142840500500000,SE 237,RESIDENTIAL,3000,0,3000,0,0,3000
142840500600000,SE 237,RESIDENTIAL,2550,0,2550,0,0,2550
142840500700000,BARS/LOUNGE,COMMERCIAL,0,27720,27720,0,7280,35000
142840600100000,CITY PROPERTY,EXEMPT,0,0,0,0,0,0
142840600200000,CITY PROPERTY,EXEMPT,0,166860,166860,0,0,166860
142840600202000,FRATERNAL,EXEMPT,0,0,0,0,904298,904298
142840600300000,CITY PROPERTY,EXEMPT,0,0,0,0,0,0
142840600400000,CITY PROPERTY,EXEMPT,0,0,0,0,0,0
142840600500000,CITY PROPERTY,EXEMPT,0,0,0,0,0,0
142840600600000,CITY PROPERTY,EXEMPT,0,0,0,0,0,0
142840600700000,CITY PROPERTY,EXEMPT,0,0,0,0,0,0
142840600800000,CITY PROPERTY,EXEMPT,0,0,0,0,0,0
142840600900000,SE 237,RESIDENTIAL,2475,0,2475,92096,0,94571
142840601000000,CITY PROPERTY,EXEMPT,0,0,0,0,0,0
142840601100000,SE 237,RESIDENTIAL,3000,0,3000,0,0,3000
142840601200000,CITY PROPERTY,EXEMPT,0,0,0,0,0,0
142840601300000,CITY PROPERTY,EXEMPT,0,0,0,0,0,0
142840601400000,CITY PROPERTY,EXEMPT,0,0,0,0,0,0
142840601500000,SE 237,RESIDENTIAL,3000,0,3000,0,0,3000
142840601600000,CITY PROPERTY,EXEMPT,0,0,0,0,0,0
142840700100000,CITY PROPERTY,EXEMPT,0,0,0,0,0,0
142840700200000,CITY PROPERTY,EXEMPT,0,0,0,0,0,0
142840700300000,CITY PROPERTY,EXEMPT,0,0,0,0,0,0
142840800100000,CITY PROPERTY,EXEMPT,0,0,0,0,0,0
142842600100000,FOOD GRADE;INDUST,INDUSTRIAL,0,688122,688122,0,9237454,9925576
142842700100000,FOOD GRADE;INDUST,INDUSTRIAL,0,54108,54108,0,1280127,1334235
142842800100000,CENTRALLY ASSESSED,OTHER,0,0,0,0,0,0
142845100200000,FOOD GRADE;INDUST,INDUSTRIAL,0,8764,8764,0,23625,32389
142845100600000,CITY PROPERTY,EXEMPT,0,0,0,0,0,0
142845200100000,SW 402,RESIDENTIAL,24000,0,24000,84653,0,108653
142845200200000,SW 402,RESIDENTIAL,24000,0,24000,71911,0,95911
142845300100000,SW 402,RESIDENTIAL,5000,0,5000,0,0,5000
142845300200000,SW 402,RESIDENTIAL,13080,0,13080,0,0,13080
142845300300000,SW 402,RESIDENTIAL,12720,0,12720,58449,0,71169
142845300400000,SW 402,RESIDENTIAL,15150,0,15150,48998,0,64148
142845300500000,SW 402,RESIDENTIAL,13950,0,13950,57912,0,71862
142845300600000,SW 402,RESIDENTIAL,5000,0,5000,0,0,5000
142845300700000,CITY PROPERTY,EXEMPT,0,0,0,0,0,0
142845300800000,CITY PROPERTY,EXEMPT,0,0,0,0,0,0
142845400100000,SERVICE STATION,COMMERCIAL,0,7875,7875,0,0,7875
142845400200000,SW 402,RESIDENTIAL,10912,0,10912,33725,0,44637
142845400300000,SW 402,RESIDENTIAL,17080,0,17080,30894,0,47974
142845400400000,SW 402,RESIDENTIAL,12408,0,12408,38142,0,50550
142845400500000,SW 402,RESIDENTIAL,14159,0,14159,0,0,14159
142845400600000,SW 402,RESIDENTIAL,14600,0,14600,60213,0,74813
142845400700000,SW 402,RESIDENTIAL,17600,0,17600,50205,0,67805
142845400800000,CITY PROPERTY,EXEMPT,0,0,0,0,0,0
142845400900000,CITY PROPERTY,EXEMPT,0,0,0,0,0,0
142845500100000,SW 402,RESIDENTIAL,22400,0,22400,75009,0,97409
142845500200000,SW 402,RESIDENTIAL,6120,0,6120,5112,0,11232
142845500300000,CITY PROPERTY,EXEMPT,0,0,0,0,0,0
142845500400000,SW 402,RESIDENTIAL,23120,0,23120,98137,0,121257
142845500500000,SW 402,RESIDENTIAL,14880,0,14880,72123,0,87003
142845500600000,SW 402,RESIDENTIAL,9728,0,9728,70676,0,80404
142845500700000,SW 402,RESIDENTIAL,8512,0,8512,59252,0,67764
142845500800000,SW 402,RESIDENTIAL,12000,0,12000,73114,0,85114
142845500900000,SW 402,RESIDENTIAL,12000,0,12000,43622,0,55622
142845501000000,SW 402,RESIDENTIAL,24000,0,24000,99544,0,123544
142845501100000,SW 402,RESIDENTIAL,24320,0,24320,95884,0,120204
142845600200000,SW 402,RESIDENTIAL,22453,0,22453,65380,0,87833
142845600300000,SW 402,RESIDENTIAL,18920,0,18920,102370,0,121290
142845600400000,SW 402,RESIDENTIAL,14740,0,14740,62837,0,77577
142845600500000,OFFICE,COMMERCIAL,0,76080,76080,0,240467,316547
142845600600000,CITY PROPERTY,EXEMPT,0,0,0,0,0,0
142845700100000,SW 402,RESIDENTIAL,10200,0,10200,28094,0,38294
142845700200000,SW 402,RESIDENTIAL,20400,0,20400,63935,0,84335
142845700300000,SW 402,RESIDENTIAL,20400,0,20400,94928,0,115328
142845700400000,APARTMENT,COMMERCIAL,0,11250,11250,0,99241,110491
142845700500000,SW 402,RESIDENTIAL,17600,0,17600,31903,0,49503
142845700600000,SW 402,RESIDENTIAL,17600,0,17600,84157,0,101757
142845700700000,SW 402,RESIDENTIAL,17600,0,17600,46883,0,64483
142845700800000,SW 402,RESIDENTIAL,17600,0,17600,62231,0,79831
142845700900000,SW 402,RESIDENTIAL,12320,0,12320,56141,0,68461
142845701000000,SW 402,RESIDENTIAL,22880,0,22880,55845,0,78725
142845701100000,SW 402,RESIDENTIAL,20400,0,20400,66040,0,86440
142845701200000,SW 402,RESIDENTIAL,20400,0,20400,71353,0,91753
142845701300000,SW 402,RESIDENTIAL,20400,0,20400,60776,0,81176
142845701400000,SW 402,RESIDENTIAL,20400,0,20400,41741,0,62141
142845701500000,CONVERSION,COMMERCIAL,0,13436,13436,0,56636,70072
142845701600000,SW 402,RESIDENTIAL,16120,0,16120,56602,0,72722
142845701700000,SW 402,RESIDENTIAL,16400,0,16400,45750,0,62150
142845701800000,SW 402,RESIDENTIAL,16613,0,16613,42607,0,59220
142845701900000,SW 402,RESIDENTIAL,16720,0,16720,32465,0,49185
142845800100000,SW 402,RESIDENTIAL,14620,0,14620,69410,0,84030
142845800200000,SW 402,RESIDENTIAL,14620,0,14620,82827,0,97447
142845800300000,SW 402,RESIDENTIAL,15079,0,15079,60116,0,75195
142845800400000,CITY PROPERTY,EXEMPT,0,0,0,0,0,0
142845800500000,SW 402,RESIDENTIAL,10710,0,10710,57234,0,67944
142845800600000,SW 402,RESIDENTIAL,13090,0,13090,64210,0,77300
142845800700000,SW 402,RESIDENTIAL,14960,0,14960,59133,0,74093
142845800800000,SW 402,RESIDENTIAL,19584,0,19584,0,0,19584
142845800900000,SW 402,RESIDENTIAL,12648,0,12648,58844,0,71492
142845801000000,SW 402,RESIDENTIAL,16864,0,16864,72245,0,89109
142845801100000,SW 402,RESIDENTIAL,5000,0,5000,0,0,5000
142845801200000,SW 402,RESIDENTIAL,16005,0,16005,55244,0,71249
142845801300000,CONVERSION,COMMERCIAL,0,8420,8420,0,75863,84283
142845801400000,SW 402,RESIDENTIAL,22494,0,22494,66206,0,88700
142845801500000,SW 402,RESIDENTIAL,16213,0,16213,62262,0,78475
142845801600000,SW 402,RESIDENTIAL,8826,0,8826,43853,0,52679
142845801700000,CITY PROPERTY,EXEMPT,0,0,0,0,0,0
142845801800000,SW 402,RESIDENTIAL,10118,0,10118,45276,0,55394
142845801900000,SW 402,RESIDENTIAL,425,0,425,0,0,425
142845900100000,CITY PROPERTY,EXEMPT,0,0,0,0,0,0
142845900200000,CITY PROPERTY,EXEMPT,0,0,0,0,0,0
142845900300000,CITY PROPERTY,EXEMPT,0,0,0,0,0,0
142845900400000,SW 402,RESIDENTIAL,12672,0,12672,0,0,12672
142845900500000,SW 402,RESIDENTIAL,12672,0,12672,0,0,12672
142845900600000,SW 402,RESIDENTIAL,28109,0,28109,79684,0,107793
142845900700000,SW 402,RESIDENTIAL,17440,0,17440,65944,0,83384
142845900800000,SW 402,RESIDENTIAL,15717,0,15717,70364,0,86081
142845900900000,SW 402,RESIDENTIAL,13920,0,13920,57492,0,71412
142845901000000,SW 402,RESIDENTIAL,14080,0,14080,70956,0,85036
142845901100000,CITY PROPERTY,EXEMPT,0,0,0,0,0,0
142845901200000,CITY PROPERTY,EXEMPT,0,0,0,0,0,0
142845901300000,CITY PROPERTY,EXEMPT,0,0,0,0,0,0
142845901400000,SW 402,RESIDENTIAL,24000,0,24000,71157,0,95157
142845901500000,SW 402,RESIDENTIAL,13986,0,13986,7398,0,21384
142845901600000,SW 402,RESIDENTIAL,13986,0,13986,43834,0,57820
142846000100000,SW 402,RESIDENTIAL,14880,0,14880,69692,0,84572
142846000200000,SW 402,RESIDENTIAL,9920,0,9920,72203,0,82123
142846000300000,SW 402,RESIDENTIAL,26600,0,26600,59303,0,85903
142846000400000,SW 402,RESIDENTIAL,15200,0,15200,66584,0,81784
142846000500000,SW 402,RESIDENTIAL,11200,0,11200,71466,0,82666
142846000600000,SW 402,RESIDENTIAL,11200,0,11200,51267,0,62467
142846000700000,SW 402,RESIDENTIAL,15200,0,15200,81564,0,96764
142846000800000,SW 402,RESIDENTIAL,26600,0,26600,114527,0,141127
142846000900000,SW 402,RESIDENTIAL,15200,0,15200,65260,0,80460
142846001000000,SW 402,RESIDENTIAL,22800,0,22800,74477,0,97277
142846001100000,SW 402,RESIDENTIAL,20088,0,20088,67953,0,88041
142846001200000,SW 402,RESIDENTIAL,19920,0,19920,69049,0,88969
142846001300000,SW 402,RESIDENTIAL,25920,0,25920,70520,0,96440
142846001400000,SW 402,RESIDENTIAL,12960,0,12960,59222,0,72182
142846001500000,SW 402,RESIDENTIAL,12880,0,12880,60386,0,73266
142846001600000,SW 402,RESIDENTIAL,8589,0,8589,36555,0,45144
142846001700000,SW 402,RESIDENTIAL,12531,0,12531,43657,0,56188
142846100100000,SW 402,RESIDENTIAL,21658,0,21658,81967,0,103625
142846100200000,SW 402,RESIDENTIAL,18330,0,18330,70681,0,89011
142846100300000,SW 402,RESIDENTIAL,16184,0,16184,32537,0,48721
142846100400000,SW 402,RESIDENTIAL,22807,0,22807,53354,0,76161
142846100500000,SW 402,RESIDENTIAL,16320,0,16320,41354,0,57674
142846100600000,SW 402,RESIDENTIAL,12825,0,12825,0,0,12825
142846100700000,SW 402,RESIDENTIAL,14535,0,14535,45595,0,60130
142846100800000,SW 402,RESIDENTIAL,14535,0,14535,54383,0,68918
142846100900000,SW 402,RESIDENTIAL,13974,0,13974,48299,0,62273
142846101000000,SW 402,RESIDENTIAL,14858,0,14858,55760,0,70618
142846101100000,SW 402,RESIDENTIAL,14858,0,14858,59686,0,74544
142846101200000,SW 402,RESIDENTIAL,15014,0,15014,62813,0,77827
142846101300000,SW 402,RESIDENTIAL,18038,0,18038,46527,0,64565
142846200100000,CITY PROPERTY,EXEMPT,0,0,0,0,0,0
142846200200000,SW 402,RESIDENTIAL,9908,0,9908,58189,0,68097
142846200300000,SW 402,RESIDENTIAL,4743,0,4743,37057,0,41800
142846300100000,SW 402,RESIDENTIAL,22800,0,22800,77692,0,100492
142846300200000,SW 402,RESIDENTIAL,14080,0,14080,53592,0,67672
142846300300000,SW 402,RESIDENTIAL,22528,0,22528,71744,0,94272
142846300400000,SW 402,RESIDENTIAL,12240,0,12240,29001,0,41241
142846300500000,SW 402,RESIDENTIAL,21200,0,21200,42533,0,63733
142846300600000,SW 402,RESIDENTIAL,21200,0,21200,55249,0,76449
142846300700000,SW 402,RESIDENTIAL,21200,0,21200,55011,0,76211
142846300800000,SW 402,RESIDENTIAL,21200,0,21200,59237,0,80437
142846400100000,SW 402,RESIDENTIAL,17765,0,17765,45460,0,63225
142846500100000,SW 402,RESIDENTIAL,16150,0,16150,61116,0,77266
142846500200000,SW 402,RESIDENTIAL,12920,0,12920,20509,0,33429
142846500300000,SW 402,RESIDENTIAL,15497,0,15497,38467,0,53964
142846500400000,SW 402,RESIDENTIAL,20400,0,20400,83007,0,103407
142847600100000,CITY PROPERTY,EXEMPT,0,0,0,0,0,0
142847600200000,CITY PROPERTY,EXEMPT,0,0,0,0,0,0
142847700100000,VACANT LAND,EXEMPT,0,37260,37260,0,0,37260
142847700200000,CITY PROPERTY,EXEMPT,0,0,0,0,0,0
142847700300000,CITY PROPERTY,EXEMPT,0,0,0,0,0,0
142847700400000,CITY PROPERTY,EXEMPT,0,0,0,0,0,0
142847700500000,CITY PROPERTY,EXEMPT,0,0,0,0,0,0
142847800300000,LITERARY/LIBRARY/ART,EXEMPT,0,70502,70502,0,13429,83931
142847800500000,CITY PROPERTY,EXEMPT,0,0,0,0,0,0
142847800600000,CITY PROPERTY,EXEMPT,0,0,0,0,0,0
142847800700000,CITY PROPERTY,EXEMPT,0,0,0,0,0,0
142847800900000,CITY PROPERTY,EXEMPT,0,0,0,0,0,0
142847801000000,CITY PROPERTY,EXEMPT,0,0,0,0,0,0
142847801100000,CITY PROPERTY,EXEMPT,0,0,0,0,0,0
142847801200000,CITY PROPERTY,EXEMPT,0,0,0,0,0,0
142847801300000,CITY PROPERTY,EXEMPT,0,0,0,0,0,0
142847801400000,LITERARY/LIBRARY/ART,EXEMPT,0,0,0,0,0,0
142847801500000,CITY PROPERTY,EXEMPT,0,0,0,0,0,0
142847801700000,CITY PROPERTY,EXEMPT,0,0,0,0,0,0
142847802000000,CITY PROPERTY,EXEMPT,0,0,0,0,0,0
142847802100000,CITY PROPERTY,EXEMPT,0,0,0,0,0,0
142847802200000,CITY PROPERTY,EXEMPT,0,0,0,0,0,0
142847802300000,CITY PROPERTY,EXEMPT,0,0,0,0,0,0
142847900100000,OFFICE,EXEMPT,0,40608,40608,0,48684,89292
142847900200000,SMALL RETAIL,COMMERCIAL,0,32400,32400,0,39425,71825
142847900300000,FLAT PARKING,COMMERCIAL,0,22500,22500,0,4000,26500
142847900500000,SMALL RETAIL,COMMERCIAL,0,15300,15300,0,80246,95546
142847900600000,BARS/LOUNGE,COMMERCIAL,0,14364,14364,0,113270,127634
142847900800000,SMALL RETAIL,COMMERCIAL,0,27000,27000,0,85799,112799
142847900900000,SW 402,EXEMPT,0,11956,11956,0,35713,47669
142847901000000,SMALL RETAIL,COMMERCIAL,0,10395,10395,0,29517,39912
142847901100000,OFFICE,COMMERCIAL,0,22500,22500,0,65586,88086
142847901200000,FRATERNAL,EXEMPT,0,32400,32400,0,534696,567096
142847901300000,RESTAURANT,COMMERCIAL,0,55067,55067,0,82653,137720
142847901400000,SMALL RETAIL,COMMERCIAL,0,16428,16428,0,167665,184093
142847901500000,SW 402,RESIDENTIAL,5000,0,5000,0,0,5000
142847901600000,OFFICE,COMMERCIAL,0,15600,15600,0,124220,139820
142847901800000,CITY PROPERTY,EXEMPT,0,0,0,0,0,0
142847901900000,CITY PROPERTY,EXEMPT,0,0,0,0,0,0
142847902000000,CITY PROPERTY,EXEMPT,0,0,0,0,0,0
142847902100000,CITY PROPERTY,EXEMPT,0,0,0,0,0,0
142847902200000,CITY PROPERTY,EXEMPT,0,0,0,0,0,0
142847902300000,CITY PROPERTY,EXEMPT,0,0,0,0,0,0
142847902400000,CITY PROPERTY,EXEMPT,0,0,0,0,0,0
142847902500000,WAREHOUSE,COMMERCIAL,0,13500,13500,0,8819,22319
142847902600000,SMALL RETAIL,EXEMPT,0,58860,58860,0,107058,165918
142847902700000,BARS/LOUNGE,COMMERCIAL,0,46080,46080,0,105886,151966
142848000100000,CITY PROPERTY,EXEMPT,0,0,0,0,0,0
142848000200000,CITY PROPERTY,EXEMPT,0,0,0,0,0,0
142848000300000,CITY PROPERTY,EXEMPT,0,0,0,0,0,0
142848000400000,CITY PROPERTY,EXEMPT,0,0,0,0,0,0
142848000500000,SHOP,COMMERCIAL,0,13500,13500,0,90975,104475
142848000600000,CITY PROPERTY,EXEMPT,0,0,0,0,0,0
142848000700000,FLAT PARKING,COMMERCIAL,0,5175,5175,0,1610,6785
142848000800000,FLAT PARKING,COMMERCIAL,0,6075,6075,0,1417,7492
142848000900000,CITY PROPERTY,EXEMPT,0,0,0,0,0,0
142848001000000,SMALL RETAIL,COMMERCIAL,0,12000,12000,0,37743,49743
142848001100000,SMALL RETAIL,COMMERCIAL,0,27000,27000,0,125320,152320
142848001200000,SMALL RETAIL,COMMERCIAL,0,21600,21600,0,123372,144972
142848001300000,BARS/LOUNGE,COMMERCIAL,0,10800,10800,0,78145,88945
142848001400000,BARS/LOUNGE,COMMERCIAL,0,16365,16365,0,138452,154817
142848001500000,SMALL RETAIL,COMMERCIAL,0,10943,10943,0,50420,61363
142848001600000,SMALL RETAIL,COMMERCIAL,0,21600,21600,0,71195,92795
142848001700000,SMALL RETAIL,COMMERCIAL,0,27000,27000,0,91784,118784
142848002000000,BARS/LOUNGE,COMMERCIAL,0,78300,78300,0,242701,321001
142848100100000,CITY PROPERTY,EXEMPT,0,0,0,0,0,0
142848100200000,CITY PROPERTY,EXEMPT,0,0,0,0,0,0
142848100300000,CITY PROPERTY,EXEMPT,0,0,0,0,0,0
142848100400000,CITY PROPERTY,EXEMPT,0,0,0,0,0,0
142848100500000,CITY PROPERTY,EXEMPT,0,0,0,0,0,0
142848100600000,CITY PROPERTY,EXEMPT,0,0,0,0,0,0
142848100700000,CITY PROPERTY,EXEMPT,0,0,0,0,0,0
142848100800000,CITY PROPERTY,EXEMPT,0,0,0,0,0,0
142848100900000,CITY PROPERTY,EXEMPT,0,0,0,0,0,0
142848101000000,CITY PROPERTY,EXEMPT,0,0,0,0,0,0
142848200300000,CITY PROPERTY,EXEMPT,0,5174,5174,0,0,5174
142848200400000,CITY PROPERTY,EXEMPT,0,0,0,0,0,0
142848200500000,CITY PROPERTY,EXEMPT,0,0,0,0,0,0
142848200600000,CITY PROPERTY,EXEMPT,0,0,0,0,0,0
142848200700000,SW 402,RESIDENTIAL,5000,0,5000,0,0,5000
142848200800000,CITY PROPERTY,EXEMPT,0,0,0,0,0,0
142848200900000,CITY PROPERTY,EXEMPT,0,0,0,0,0,0
142848201000000,CITY PROPERTY,EXEMPT,0,0,0,0,0,0
142848201100000,CITY PROPERTY,EXEMPT,0,0,0,0,0,0
142848201200000,CITY PROPERTY,EXEMPT,0,0,0,0,0,0
142848201300000,CITY PROPERTY,EXEMPT,0,0,0,0,0,0
142848201400000,CITY PROPERTY,EXEMPT,0,0,0,0,0,0
142848201500000,CITY PROPERTY,EXEMPT,0,0,0,0,0,0
142848201600000,CITY PROPERTY,EXEMPT,0,0,0,0,0,0
142848201700000,SW 402,RESIDENTIAL,4515,0,4515,0,0,4515
142848300100000,CITY PROPERTY,EXEMPT,0,0,0,0,0,0
142848300200000,CITY PROPERTY,EXEMPT,0,0,0,0,0,0
142848300300000,CITY PROPERTY,EXEMPT,0,0,0,0,0,0
142848300400000,CITY PROPERTY,EXEMPT,0,0,0,0,0,0
142848300500000,CITY PROPERTY,EXEMPT,0,0,0,0,0,0
142848300600000,CITY PROPERTY,EXEMPT,0,0,0,0,0,0
142848300700000,CITY PROPERTY,EXEMPT,0,0,0,0,0,0
142848300800000,CITY PROPERTY,EXEMPT,0,0,0,0,0,0
142848300900000,SW 402,RESIDENTIAL,5400,0,5400,44478,0,49878
142848301000000,CITY PROPERTY,EXEMPT,0,0,0,0,0,0
142848301100000,CITY PROPERTY,EXEMPT,0,0,0,0,0,0
142848301200000,SW 402,RESIDENTIAL,5000,0,5000,0,0,5000
142848301300000,CITY PROPERTY,EXEMPT,0,0,0,0,0,0
142848301400000,CITY PROPERTY,EXEMPT,0,0,0,0,0,0
142848301500000,CITY PROPERTY,EXEMPT,0,0,0,0,0,0
142848301600000,CITY PROPERTY,EXEMPT,0,0,0,0,0,0
142848301700000,CITY PROPERTY,EXEMPT,0,0,0,0,0,0
142848400100000,CITY PROPERTY,EXEMPT,0,0,0,0,0,0
142848400200000,CITY PROPERTY,EXEMPT,0,0,0,0,0,0
142848400300000,CITY PROPERTY,EXEMPT,0,0,0,0,0,0
142848400400000,SW 402,RESIDENTIAL,11120,0,11120,0,0,11120
142848400500000,CITY PROPERTY,EXEMPT,0,0,0,0,0,0
142848500100000,CITY PROPERTY,EXEMPT,0,0,0,0,0,0
142848500200000,CITY PROPERTY,EXEMPT,0,0,0,0,0,0
142848500300000,CITY PROPERTY,EXEMPT,0,0,0,0,0,0
142848500400000,CITY PROPERTY,EXEMPT,0,0,0,0,0,0
142848500500000,CITY PROPERTY,EXEMPT,0,0,0,0,0,0
142848500600000,CITY PROPERTY,EXEMPT,0,0,0,0,0,0
142848500700000,SW 402,RESIDENTIAL,13200,0,13200,59705,0,72905
142848500800000,SW 402,RESIDENTIAL,13200,0,13200,67257,0,80457
142848500900000,CITY PROPERTY,EXEMPT,0,0,0,0,0,0
142848501000000,CITY PROPERTY,EXEMPT,0,0,0,0,0,0
142848501100000,CITY PROPERTY,EXEMPT,0,0,0,0,0,0
142848501200000,CITY PROPERTY,EXEMPT,0,0,0,0,0,0
142848600100000,CITY PROPERTY,EXEMPT,0,0,0,0,0,0
142848600200000,CITY PROPERTY,EXEMPT,0,0,0,0,0,0
142848600300000,CITY PROPERTY,EXEMPT,0,0,0,0,0,0
142848600400000,CITY PROPERTY,EXEMPT,0,0,0,0,0,0
142848600500000,CITY PROPERTY,EXEMPT,0,0,0,0,0,0
142848600600000,WAREHOUSE,COMMERCIAL,0,18000,18000,0,75947,93947
142848600700000,CITY PROPERTY,EXEMPT,0,0,0,0,0,0
142848600800000,SW 402,RESIDENTIAL,13200,0,13200,61906,0,75106
142848600900000,CITY PROPERTY,EXEMPT,0,0,0,0,0,0
142848601000000,CITY PROPERTY,EXEMPT,0,0,0,0,0,0
142848601100000,CITY PROPERTY,EXEMPT,0,0,0,0,0,0
142848601200000,SW 402,RESIDENTIAL,13200,0,13200,0,0,13200
142848700100000,AUTO REPAIR/SALES,COMMERCIAL,0,23818,23818,0,23737,47555
142848700200000,CITY PROPERTY,EXEMPT,0,0,0,0,0,0
142848700300000,SW 402,RESIDENTIAL,17000,0,17000,56207,0,73207
142848700400000,SW 402,RESIDENTIAL,18020,0,18020,62824,0,80844
142848700600000,SMALL RETAIL,COMMERCIAL,0,36000,36000,0,41374,77374
142848700700000,SMALL RETAIL,COMMERCIAL,0,99360,99360,0,191105,290465
142848700800000,SW 402,RESIDENTIAL,11288,0,11288,52286,0,63574
142848700900000,SW 402,RESIDENTIAL,21270,0,21270,97275,0,118545
142848701000000,SW 402,RESIDENTIAL,26163,0,26163,0,0,26163
142848701100000,CITY PROPERTY,EXEMPT,0,0,0,0,0,0
142848701200000,VACANT LAND,COMMERCIAL,0,3484,3484,0,0,3484
142848800100000,SMALL RETAIL,COMMERCIAL,0,18900,18900,0,67953,86853
142848800200000,SW 402,RESIDENTIAL,20060,0,20060,43203,0,63263
142848800300000,SW 402,RESIDENTIAL,23460,0,23460,1472,0,24932
142910100100000,CITY PROPERTY,EXEMPT,0,0,0,0,0,0
142910100200000,CITY PROPERTY,EXEMPT,0,0,0,0,0,0
142910100300000,CITY PROPERTY,EXEMPT,0,0,0,0,0,0
142910100400000,CITY PROPERTY,EXEMPT,0,0,0,0,0,0
142910100500000,CITY PROPERTY,EXEMPT,0,0,0,0,0,0
142910100600000,CITY PROPERTY,EXEMPT,0,0,0,0,0,0
142910100700000,CITY PROPERTY,EXEMPT,0,0,0,0,0,0
142910100800000,CITY PROPERTY,EXEMPT,0,0,0,0,0,0
142910100900000,CITY PROPERTY,EXEMPT,0,0,0,0,0,0
142910101000000,CITY PROPERTY,EXEMPT,0,0,0,0,0,0
142910200100000,CITY PROPERTY,EXEMPT,0,0,0,0,0,0
142910200200000,NW 318,RESIDENTIAL,9000,0,9000,34666,0,43666
142910200300000,NW 318,RESIDENTIAL,9000,0,9000,36175,0,45175
142910200400000,CITY PROPERTY,EXEMPT,0,0,0,0,0,0
142910200500000,CITY PROPERTY,EXEMPT,0,0,0,0,0,0
142910200600000,NW 318,RESIDENTIAL,6510,0,6510,49886,0,56396
142910200700000,CITY PROPERTY,EXEMPT,0,0,0,0,0,0
142910200800000,NW 318,RESIDENTIAL,6510,0,6510,43990,0,50500
142910200900000,NW 318,RESIDENTIAL,6510,0,6510,44988,0,51498
142910201000000,NW 318,RESIDENTIAL,18000,0,18000,84004,0,102004
142910201100000,APARTMENT,EXEMPT,0,6804,6804,0,79844,86648
142910201200000,NW 318,RESIDENTIAL,12000,0,12000,78746,0,90746
142910201300000,NW 318,RESIDENTIAL,12000,0,12000,63173,0,75173
142910201400000,NW 318,RESIDENTIAL,18000,0,18000,67257,0,85257
142910201500000,NW 318,RESIDENTIAL,12600,0,12600,46914,0,59514
142910201600000,CITY PROPERTY,EXEMPT,0,0,0,0,0,0
142910201700000,NW 318,RESIDENTIAL,8742,0,8742,46297,0,55039
142910300100000,CITY PROPERTY,EXEMPT,0,0,0,0,0,0
142910400100000,CITY PROPERTY,EXEMPT,0,0,0,0,0,0
142910400200000,CITY PROPERTY,EXEMPT,0,0,0,0,0,0
142910400300000,CITY PROPERTY,EXEMPT,0,0,0,0,0,0
142910400400000,CENTRALLY ASSESSED,OTHER,0,0,0,0,0,0
142910400500000,CITY PROPERTY,EXEMPT,0,0,0,0,0,0
142910400600000,CITY PROPERTY,EXEMPT,0,0,0,0,0,0
142910400700000,NW 318,RESIDENTIAL,7320,0,7320,25081,0,32401
142910400800000,CITY PROPERTY,EXEMPT,0,0,0,0,0,0
142910500300000,CENTRALLY ASSESSED,OTHER,0,0,0,0,0,0
142910600100000,CITY PROPERTY,EXEMPT,0,0,0,0,0,0
142910700100000,NW 318,RESIDENTIAL,3348,0,3348,0,0,3348
142910700200000,CITY PROPERTY,EXEMPT,0,0,0,0,0,0
142910700300000,NW 318,RESIDENTIAL,18000,0,18000,67495,0,85495
142910700400000,NW 318,RESIDENTIAL,18000,0,18000,48556,0,66556
142910700500000,NW 318,RESIDENTIAL,6510,0,6510,50943,0,57453
142910700600000,NW 318,RESIDENTIAL,4882,0,4882,51749,0,56631
142910700700000,NW 318,RESIDENTIAL,7440,0,7440,45602,0,53042
142910700800000,NW 318,RESIDENTIAL,5000,0,5000,0,0,5000
142910700900000,CITY PROPERTY,EXEMPT,0,0,0,0,0,0
142910701000000,CITY PROPERTY,EXEMPT,0,0,0,0,0,0
142910701100000,NW 318,RESIDENTIAL,13680,0,13680,42847,0,56527
142910701200000,NW 318,RESIDENTIAL,12000,0,12000,42008,0,54008
142910701300000,NW 318,RESIDENTIAL,12000,0,12000,46474,0,58474
142910701400000,NW 318,RESIDENTIAL,15000,0,15000,62992,0,77992
142910701500000,NW 318,RESIDENTIAL,15000,0,15000,6928,0,21928
142910701600000,NW 318,RESIDENTIAL,12600,0,12600,55981,0,68581
142910701700000,CITY PROPERTY,EXEMPT,0,0,0,0,0,0
142910701800000,CITY PROPERTY,EXEMPT,0,0,0,0,0,0
142910701900000,CITY PROPERTY,EXEMPT,0,0,0,0,0,0
142910702000000,CITY PROPERTY,EXEMPT,0,0,0,0,0,0
142910702100000,NW 318,RESIDENTIAL,2530,0,2530,0,0,2530
142910800100000,NW 318,RESIDENTIAL,12600,0,12600,50977,0,63577
142910800200000,NW 318,RESIDENTIAL,12000,0,12000,0,0,12000
142910800300000,APARTMENT,RESIDENTIAL,22400,0,22400,245591,0,267991
142910800400000,FLAT PARKING,COMMERCIAL,0,25088,25088,0,2880,27968
142910800500000,CITY PROPERTY,EXEMPT,0,0,0,0,0,0
142910800600000,FLAT PARKING,INDUSTRIAL,0,1336,1336,0,0,1336
142910800700000,SHOP,COMMERCIAL,0,13590,13590,0,69585,83175
142910800800000,NW 318,RESIDENTIAL,18000,0,18000,74523,0,92523
142910800900000,CITY PROPERTY,EXEMPT,0,0,0,0,0,0
142910801000000,NW 318,RESIDENTIAL,12000,0,12000,70505,0,82505
142910801100000,NW 318,RESIDENTIAL,12000,0,12000,52348,0,64348
142910801200000,NW 318,RESIDENTIAL,6570,0,6570,48205,0,54775
142910801300000,NW 318,RESIDENTIAL,11400,0,11400,60459,0,71859
142910801400000,NW 318,RESIDENTIAL,14010,0,14010,51849,0,65859
142910801500000,NW 318,RESIDENTIAL,13020,0,13020,72246,0,85266
142910900100000,CITY PROPERTY,EXEMPT,0,0,0,0,0,0
142910900200000,CITY PROPERTY,EXEMPT,0,0,0,0,0,0
142910900300000,CITY PROPERTY,EXEMPT,0,0,0,0,0,0
142911000100000,CITY PROPERTY,EXEMPT,0,0,0,0,0,0
142911000200000,NW 318,RESIDENTIAL,12132,0,12132,48538,0,60670
142911000300000,NW 318,RESIDENTIAL,12300,0,12300,57143,0,69443
142911000600000,CITY PROPERTY,EXEMPT,0,0,0,0,0,0
142911000700000,CITY PROPERTY,EXEMPT,0,0,0,0,0,0
142911000800000,NW 318,RESIDENTIAL,6480,0,6480,43297,0,49777
142911000900000,NW 318,RESIDENTIAL,5040,0,5040,32663,0,37703
142911001000000,RESTAURANT,COMMERCIAL,0,65016,65016,0,93341,158357
142911001300000,NW 318,RESIDENTIAL,7200,0,7200,27522,0,34722
142911001400000,CITY PROPERTY,EXEMPT,0,0,0,0,0,0
142911001500000,CITY PROPERTY,EXEMPT,0,0,0,0,0,0
142911001600000,NW 318,RESIDENTIAL,5922,0,5922,53689,0,59611
142911001700000,SMALL RETAIL,COMMERCIAL,0,116178,116178,0,277562,393740
142911100100000,NW 318,RESIDENTIAL,6300,0,6300,50735,0,57035
142911100200000,NW 318,RESIDENTIAL,6300,0,6300,50196,0,56496
142911100300000,NW 318,RESIDENTIAL,12000,0,12000,64338,0,76338
142911100400000,NW 318,RESIDENTIAL,12000,0,12000,47180,0,59180
142911100500000,NW 318,RESIDENTIAL,12000,0,12000,61363,0,73363
142911100600000,NW 318,RESIDENTIAL,9000,0,9000,38121,0,47121
142911100700000,CITY PROPERTY,EXEMPT,0,0,0,0,0,0
142911100800000,NW 318,RESIDENTIAL,18000,0,18000,29632,0,47632
142911101100000,CHURCH,EXEMPT,0,341345,341345,0,3038612,3379957
142911101200000,CHURCH,EXEMPT,0,8370,8370,0,2227,10597
142911101400000,NW 318,RESIDENTIAL,12000,0,12000,58979,0,70979
142911101500000,NW 318,RESIDENTIAL,12000,0,12000,56366,0,68366
142911102100000,NW 318,RESIDENTIAL,8400,0,8400,26986,0,35386
142911102200000,NW 318,RESIDENTIAL,11340,0,11340,34555,0,45895
142911102300000,CITY PROPERTY,EXEMPT,0,0,0,0,0,0
142911102400000,NW 318,RESIDENTIAL,5000,0,5000,0,0,5000
142911200100000,CITY PROPERTY,EXEMPT,0,0,0,0,0,0
142911200200000,VACANT LAND,INDUSTRIAL,0,2462,2462,0,0,2462
142911200600000,NW 318,RESIDENTIAL,12000,0,12000,47770,0,59770
142911200700000,NW 318,RESIDENTIAL,12000,0,12000,2168,0,14168
142911200800000,NW 318,RESIDENTIAL,12000,0,12000,42802,0,54802
142911200900000,NW 318,RESIDENTIAL,12000,0,12000,0,0,12000
142911201000000,NW 318,RESIDENTIAL,12000,0,12000,49884,0,61884
142911201100000,CITY PROPERTY,EXEMPT,0,0,0,0,0,0
142911201200000,NW 318,RESIDENTIAL,13848,0,13848,0,0,13848
142911201300000,NW 318,RESIDENTIAL,13680,0,13680,80638,0,94318
142911300100000,EQUIPMENT MFG;INDUST,INDUSTRIAL,0,21773,21773,0,5869,27642
142911400100000,WAREHOUSE; CTRL CR,COMMERCIAL,0,45600,45600,0,101410,147010
142911400200000,SMALL RET; CTRL CR,COMMERCIAL,0,45612,45612,0,220646,266258
142911400300000,BRNCH BK/CR; CTRL CR,COMMERCIAL,0,148239,148239,0,203809,352048
142911400400000,SMALL RET; CTRL CR,COMMERCIAL,0,4860,4860,0,101562,106422
142911500100000,NW 318,RESIDENTIAL,12000,0,12000,45304,0,57304
142911500200000,NW 318,RESIDENTIAL,12000,0,12000,46951,0,58951
142911500300000,NW 318,RESIDENTIAL,12000,0,12000,53222,0,65222
142911500400000,CITY PROPERTY,EXEMPT,0,0,0,0,0,0
142911500500000,NW 318,RESIDENTIAL,11700,0,11700,57180,0,68880
142911500600000,NW 318,RESIDENTIAL,12000,0,12000,51601,0,63601
142911500700000,NW 318,RESIDENTIAL,12000,0,12000,56895,0,68895
142911500800000,CONVERSION,COMMERCIAL,0,6804,6804,0,98014,104818
142911500900000,NW 318,RESIDENTIAL,12000,0,12000,0,0,12000
142911501000000,EQUIPMENT MFG;INDUST,INDUSTRIAL,0,12150,12150,0,0,12150
142911501100000,SMALL RETAIL,COMMERCIAL,0,30240,30240,0,115289,145529
142911501200000,SMALL RETAIL,COMMERCIAL,0,30240,30240,0,78444,108684
142911501300000,NW 318,RESIDENTIAL,12000,0,12000,47896,0,59896
142911501400000,CITY PROPERTY,EXEMPT,0,0,0,0,0,0
142911501500000,NW 318,RESIDENTIAL,7440,0,7440,62462,0,69902
142911501600000,FLAT PARKING,COMMERCIAL,0,9600,9600,0,3840,13440
142911501700000,OFFICE,COMMERCIAL,0,8400,8400,0,58698,67098
142911501800000,NW 318,RESIDENTIAL,9450,0,9450,43266,0,52716
142912700300000,NW 311,RESIDENTIAL,11200,0,11200,0,0,11200
142912700400000,CITY PROPERTY,EXEMPT,0,0,0,0,0,0
142912700500000,NW 311,RESIDENTIAL,16000,0,16000,69872,0,85872
142912700600000,NW 311,RESIDENTIAL,16000,0,16000,65527,0,81527
142912700700000,NW 311,RESIDENTIAL,16000,0,16000,52654,0,68654
142912700800000,NW 311,RESIDENTIAL,11680,0,11680,61737,0,73417
142912700900000,NW 311,RESIDENTIAL,11200,0,11200,46193,0,57393
142912701000000,NW 311,RESIDENTIAL,8959,0,8959,73986,0,82945
142912701100000,NW 311,RESIDENTIAL,9310,0,9310,71532,0,80842
142912701200000,CITY PROPERTY,EXEMPT,0,0,0,0,0,0
142912701300000,NW 311,RESIDENTIAL,9310,0,9310,58016,0,67326
142912701400000,NW 311,RESIDENTIAL,8400,0,8400,74601,0,83001
142912701500000,NW 311,RESIDENTIAL,8400,0,8400,61564,0,69964
142912701600000,NW 311,RESIDENTIAL,12000,0,12000,43802,0,55802
142912701700000,NW 311,RESIDENTIAL,12000,0,12000,78001,0,90001
142912701800000,NW 311,RESIDENTIAL,12000,0,12000,56584,0,68584
142912701900000,NW 311,RESIDENTIAL,12000,0,12000,59465,0,71465
142912702000000,NW 311,RESIDENTIAL,8856,0,8856,50978,0,59834
142912702100000,NW 311,RESIDENTIAL,10824,0,10824,41913,0,52737
142912702200000,NW 311,RESIDENTIAL,11970,0,11970,0,0,11970
142912702300000,NW 311,RESIDENTIAL,7980,0,7980,54664,0,62644
142912702400000,NW 311,RESIDENTIAL,7980,0,7980,55860,0,63840
142912702500000,CITY PROPERTY,EXEMPT,0,0,0,0,0,0
142912800100000,CONVERSION,COMMERCIAL,0,12474,12474,0,86842,99316
142912800200000,NW 311,RESIDENTIAL,22000,0,22000,84221,0,106221
142912800300000,NW 311,RESIDENTIAL,25200,0,25200,87232,0,112432
142912800400000,NW 311,RESIDENTIAL,17560,0,17560,99246,0,116806
142912800500000,NW 311,RESIDENTIAL,12285,0,12285,66205,0,78490
142912800600000,NW 311,RESIDENTIAL,14175,0,14175,68723,0,82898
142912800700000,NW 311,RESIDENTIAL,15000,0,15000,75794,0,90794
142912800800000,NW 311,RESIDENTIAL,15000,0,15000,57652,0,72652
142912800900000,NW 311,RESIDENTIAL,15000,0,15000,110152,0,125152
142912801000000,NW 311,RESIDENTIAL,13500,0,13500,50105,0,63605
142912801100000,NW 311,RESIDENTIAL,6615,0,6615,67683,0,74298
142912900100000,NW 311,RESIDENTIAL,16600,0,16600,53384,0,69984
142912900200000,NW 311,RESIDENTIAL,20000,0,20000,35780,0,55780
142912900300000,NW 311,RESIDENTIAL,20000,0,20000,56736,0,76736
142912900400000,NW 311,RESIDENTIAL,20000,0,20000,48298,0,68298
142912900500000,NW 311,RESIDENTIAL,20000,0,20000,81157,0,101157
142912900600000,NW 311,RESIDENTIAL,20800,0,20800,52044,0,72844
142912900700000,NW 311,RESIDENTIAL,17967,0,17967,77005,0,94972
142912900800000,NW 311,RESIDENTIAL,17500,0,17500,95724,0,113224
142912900900000,NW 311,RESIDENTIAL,17500,0,17500,62837,0,80337
142912901000000,NW 311,RESIDENTIAL,14000,0,14000,53838,0,67838
142912901100000,NW 311,RESIDENTIAL,17500,0,17500,87570,0,105070
142912901200000,NW 311,RESIDENTIAL,21000,0,21000,80702,0,101702
142912901300000,NW 311,RESIDENTIAL,9450,0,9450,74686,0,84136
142913000100000,CENTRALLY ASSESSED,EXEMPT,0,0,0,0,0,0
142913000200000,NW 311,RESIDENTIAL,9450,0,9450,30003,0,39453
142913000300000,NW 311,RESIDENTIAL,8400,0,8400,49614,0,58014
142913000400000,NW 311,RESIDENTIAL,12000,0,12000,61918,0,73918
142913000500000,NW 311,RESIDENTIAL,12000,0,12000,57181,0,69181
142913000600000,NW 311,RESIDENTIAL,8775,0,8775,45706,0,54481
142913000700000,NW 311,RESIDENTIAL,9000,0,9000,53401,0,62401
142913000800000,CITY PROPERTY,EXEMPT,0,0,0,0,0,0
142913100100000,NW 311,RESIDENTIAL,12000,0,12000,69951,0,81951
142913100200000,NW 311,RESIDENTIAL,12000,0,12000,64819,0,76819
142913100300000,NW 311,RESIDENTIAL,12000,0,12000,52382,0,64382
142913100400000,NW 311,RESIDENTIAL,12000,0,12000,0,0,12000
142913100500000,NW 311,RESIDENTIAL,12000,0,12000,47388,0,59388
142913100600000,NW 311,RESIDENTIAL,10500,0,10500,54058,0,64558
142913100700000,NW 311,RESIDENTIAL,12000,0,12000,44326,0,56326
142913100800000,NW 311,RESIDENTIAL,7650,0,7650,50785,0,58435
142913100900000,NW 311,RESIDENTIAL,6900,0,6900,61754,0,68654
142913101000000,NW 311,RESIDENTIAL,6450,0,6450,49785,0,56235
142913101100000,CITY PROPERTY,EXEMPT,0,0,0,0,0,0
142913101200000,NW 311,RESIDENTIAL,9000,0,9000,48227,0,57227
142913101300000,NW 311,RESIDENTIAL,12000,0,12000,68943,0,80943
142913101400000,NW 311,RESIDENTIAL,18000,0,18000,81613,0,99613
142913101500000,NW 311,RESIDENTIAL,18000,0,18000,65539,0,83539
142913101600000,CITY PROPERTY,EXEMPT,0,0,0,0,0,0
142913101700000,CITY PROPERTY,EXEMPT,0,0,0,0,0,0
142913200100000,NW 311,RESIDENTIAL,13500,0,13500,112582,0,126082
142913200200000,NW 311,RESIDENTIAL,15000,0,15000,85988,0,100988
142913200300000,NW 311,RESIDENTIAL,15000,0,15000,66887,0,81887
142913200400000,NW 311,RESIDENTIAL,15000,0,15000,66809,0,81809
142913200500000,NW 311,RESIDENTIAL,8100,0,8100,60308,0,68408
142913200600000,NW 311,RESIDENTIAL,8100,0,8100,37496,0,45596
142913200700000,NW 311,RESIDENTIAL,6480,0,6480,57713,0,64193
142913200800000,NW 311,RESIDENTIAL,15000,0,15000,53185,0,68185
142913200900000,NW 311,RESIDENTIAL,10500,0,10500,47119,0,57619
142913201000000,NW 311,RESIDENTIAL,9450,0,9450,0,0,9450
142913201100000,APARTMENT,COMMERCIAL,0,14000,14000,0,122086,136086
142913201200000,NW 311,RESIDENTIAL,15000,0,15000,78400,0,93400
142913300100000,NW 311,RESIDENTIAL,14580,0,14580,80655,0,95235
142913300200000,NW 311,RESIDENTIAL,15715,0,15715,79510,0,95225
142913300300000,NW 311,RESIDENTIAL,17500,0,17500,65994,0,83494
142913300400000,NW 311,RESIDENTIAL,17500,0,17500,53065,0,70565
142913300500000,NW 311,RESIDENTIAL,15575,0,15575,56904,0,72479
142913300600000,NW 311,RESIDENTIAL,12460,0,12460,29194,0,41654
142913300700000,NW 311,RESIDENTIAL,15575,0,15575,19748,0,35323
142913300800000,FRATERNAL,EXEMPT,0,130545,130545,0,304926,435471
142913300900000,NW 311,RESIDENTIAL,11400,0,11400,87506,0,98906
142913400100000,EQUIPMENT MFG;INDUST,INDUSTRIAL,0,83543,83543,0,742019,825562
142913500100000,NW 311,RESIDENTIAL,9120,0,9120,76729,0,85849
142913500200000,NW 311,RESIDENTIAL,12000,0,12000,67955,0,79955
142913500300000,NW 311,RESIDENTIAL,12000,0,12000,70222,0,82222
142913500400000,NW 311,RESIDENTIAL,18000,0,18000,59056,0,77056
142913500500000,NW 311,RESIDENTIAL,18000,0,18000,64799,0,82799
142913500600000,NW 311,RESIDENTIAL,12000,0,12000,60152,0,72152
142913500700000,NW 311,RESIDENTIAL,12000,0,12000,0,0,12000
142913500800000,NW 311,RESIDENTIAL,11685,0,11685,130591,0,142276
142913500900000,NW 311,RESIDENTIAL,14678,0,14678,55295,0,69973
142913501000000,NW 311,RESIDENTIAL,13538,0,13538,33851,0,47389
142913501100000,OFFICE,COMMERCIAL,0,5000,5000,0,0,5000
142913501200000,NW 311,RESIDENTIAL,8100,0,8100,85679,0,93779
142913600100000,NW 311,RESIDENTIAL,10500,0,10500,63400,0,73900
142913600200000,NW 311,RESIDENTIAL,10800,0,10800,64187,0,74987
142913600300000,NW 311,RESIDENTIAL,12000,0,12000,62792,0,74792
142913600400000,NW 311,RESIDENTIAL,9000,0,9000,74909,0,83909
142913600500000,NW 311,RESIDENTIAL,12000,0,12000,65029,0,77029
142913600600000,NW 311,RESIDENTIAL,13200,0,13200,66494,0,79694
142913600700000,NW 311,RESIDENTIAL,6480,0,6480,62112,0,68592
142913600800000,NW 311,RESIDENTIAL,15000,0,15000,67715,0,82715
142913600900000,NW 311,RESIDENTIAL,15000,0,15000,56475,0,71475
142913601000000,NW 311,RESIDENTIAL,15000,0,15000,72975,0,87975
142913601100000,NW 311,RESIDENTIAL,15000,0,15000,70010,0,85010
142913601200000,NW 311,RESIDENTIAL,15000,0,15000,115268,0,130268
142913601400000,NW 311,RESIDENTIAL,8715,0,8715,64209,0,72924
142913601500000,CITY PROPERTY,EXEMPT,0,0,0,0,0,0
142913700100000,NW 311,RESIDENTIAL,17500,0,17500,71816,0,89316
142913700200000,NW 311,RESIDENTIAL,17500,0,17500,81112,0,98612
142913700300000,NW 311,RESIDENTIAL,17500,0,17500,73671,0,91171
142913700400000,NW 311,RESIDENTIAL,15000,0,15000,63056,0,78056
142913700500000,NW 311,RESIDENTIAL,15750,0,15750,65521,0,81271
142913700600000,NW 311,RESIDENTIAL,16100,0,16100,56504,0,72604
142913700700000,NW 311,RESIDENTIAL,21000,0,21000,48040,0,69040
142913700800000,NW 311,RESIDENTIAL,14000,0,14000,55664,0,69664
142913700900000,NW 311,RESIDENTIAL,14000,0,14000,69567,0,83567
142913701000000,CITY PROPERTY,EXEMPT,0,0,0,0,0,0
142913701100000,NW 311,RESIDENTIAL,9100,0,9100,46036,0,55136
142913701200000,NW 311,RESIDENTIAL,16800,0,16800,52415,0,69215
142913701300000,NW 311,RESIDENTIAL,17500,0,17500,57203,0,74703
142913800100000,WAREHOUSE,COMMERCIAL,0,140000,140000,0,867911,1007911
142913900100000,NW 311,RESIDENTIAL,12408,0,12408,58859,0,71267
142913900200000,NW 311,RESIDENTIAL,15000,0,15000,65228,0,80228
142913900300000,CHURCH,EXEMPT,0,22680,22680,0,306347,329027
142913900400000,NW 311,RESIDENTIAL,12144,0,12144,69759,0,81903
142913900500000,CITY PROPERTY,EXEMPT,0,0,0,0,0,0
142914000100000,DAY CARE CENTER,EXEMPT,0,22453,22453,0,409354,431807
142914000200000,CENTRALLY ASSESSED,OTHER,0,0,0,0,0,0
142914000300000,NW 311,RESIDENTIAL,17500,0,17500,67218,0,84718
142914000400000,NW 311,RESIDENTIAL,14525,0,14525,56909,0,71434
142914000500000,NW 311,RESIDENTIAL,14525,0,14525,63654,0,78179
142914000600000,NW 311,RESIDENTIAL,11620,0,11620,54056,0,65676
142915100100000,EQUIPMENT MFG;INDUST,INDUSTRIAL,0,100165,100165,0,295575,395740
142915100200000,SMALL RETAIL,COMMERCIAL,0,120825,120825,0,129693,250518
142915100300000,WAREHOUSE,COMMERCIAL,0,21000,21000,0,22061,43061
142915100400000,NW 311,RESIDENTIAL,10488,0,10488,55301,0,65789
142915100500000,NW 311,RESIDENTIAL,10944,0,10944,55464,0,66408
142915100600000,NW 311,RESIDENTIAL,10000,0,10000,0,0,10000
142915100700000,NW 311,RESIDENTIAL,15200,0,15200,45989,0,61189
142915100800000,FLAT PARKING,COMMERCIAL,0,26880,26880,0,8820,35700
142915100900000,DAY CARE CENTER,COMMERCIAL,0,50400,50400,0,183330,233730
142915101000000,VACANT LAND,COMMERCIAL,0,10800,10800,0,180,10980
142915101100000,VACANT LAND,COMMERCIAL,0,4000,4000,0,0,4000
142915200100000,VACANT LAND,COMMERCIAL,0,7875,7875,0,0,7875
142915200200000,NW 311,RESIDENTIAL,9324,0,9324,35593,0,44917
142915200300000,NW 311,RESIDENTIAL,9804,0,9804,35632,0,45436
142915200400000,NW 311,RESIDENTIAL,11160,0,11160,50881,0,62041
142915200500000,NW 311,RESIDENTIAL,11760,0,11760,0,0,11760
142915300300000,NW 311,RESIDENTIAL,8645,0,8645,54527,0,63172
142915300400000,CONVERSION,COMMERCIAL,0,6845,6845,0,60482,67327
142915300500000,NW 311,RESIDENTIAL,11025,0,11025,42489,0,53514
142915300600000,NW 311,RESIDENTIAL,9584,0,9584,46005,0,55589
142915300700000,NW 311,RESIDENTIAL,10500,0,10500,43085,0,53585
142915300800000,NW 311,RESIDENTIAL,5000,0,5000,35927,0,40927
142915300900000,NW 311,RESIDENTIAL,7500,0,7500,46129,0,53629
142915301000000,NW 311,RESIDENTIAL,13200,0,13200,58602,0,71802
142915301100000,NW 311,RESIDENTIAL,5000,0,5000,0,0,5000
142915301200000,NW 311,RESIDENTIAL,8400,0,8400,52541,0,60941
142915301300000,NW 311,RESIDENTIAL,7776,0,7776,63286,0,71062
142915301400000,NW 311,RESIDENTIAL,12240,0,12240,73899,0,86139
142915400100000,CHURCH,EXEMPT,0,18978,18978,0,25276,44254
142915400200000,CITY PROPERTY,EXEMPT,0,0,0,0,0,0
142915400300000,NW 311,RESIDENTIAL,9660,0,9660,60697,0,70357
142915400400000,NW 311,RESIDENTIAL,9660,0,9660,43208,0,52868
142915400500000,NW 311,RESIDENTIAL,9660,0,9660,74066,0,83726
142915400600000,NW 311,RESIDENTIAL,9660,0,9660,55811,0,65471
142915400700000,NW 311,RESIDENTIAL,9660,0,9660,50522,0,60182
142915401000000,NW 311,RESIDENTIAL,11620,0,11620,54256,0,65876
142915401100000,NW 311,RESIDENTIAL,15400,0,15400,65785,0,81185
142915401200000,NW 311,RESIDENTIAL,12320,0,12320,47572,0,59892
142915401300000,NW 311,RESIDENTIAL,17500,0,17500,58190,0,75690
142915401400000,NW 311,RESIDENTIAL,17500,0,17500,72458,0,89958
142915401500000,NW 311,RESIDENTIAL,17500,0,17500,68407,0,85907
142915401600000,CHURCH,EXEMPT,0,7128,7128,0,0,7128
142915401700000,NW 311,RESIDENTIAL,13524,0,13524,45925,0,59449
142915500100000,CITY PROPERTY,EXEMPT,0,0,0,0,0,0
142915500200000,NW 311,RESIDENTIAL,8640,0,8640,50952,0,59592
142915500300000,NW 311,RESIDENTIAL,14000,0,14000,61403,0,75403
142915500400000,NW 311,RESIDENTIAL,14000,0,14000,52439,0,66439
142915500500000,NW 311,RESIDENTIAL,12960,0,12960,84715,0,97675
142915500600000,NW 311,RESIDENTIAL,8640,0,8640,55143,0,63783
142915600100000,NW 311,RESIDENTIAL,10050,0,10050,62804,0,72854
142915600200000,NW 311,RESIDENTIAL,15000,0,15000,86079,0,101079
142915600300000,NW 311,RESIDENTIAL,9000,0,9000,54560,0,63560
142915600400000,NW 311,RESIDENTIAL,10500,0,10500,60349,0,70849
142915600500000,NW 311,RESIDENTIAL,10500,0,10500,72113,0,82613
142915600600000,NW 311,RESIDENTIAL,15000,0,15000,54122,0,69122
142915600700000,CITY PROPERTY,EXEMPT,0,0,0,0,0,0
142915600800000,CITY PROPERTY,EXEMPT,0,0,0,0,0,0
142915600900000,BARS/LOUNGE,COMMERCIAL,0,37800,37800,0,137181,174981
142915601000000,SMALL RETAIL,COMMERCIAL,0,54000,54000,0,97800,151800
142915601100000,NW 311,RESIDENTIAL,10560,0,10560,75176,0,85736
142915601200000,NW 311,RESIDENTIAL,5670,0,5670,61257,0,66927
142915601300000,NW 311,RESIDENTIAL,6480,0,6480,57470,0,63950
142915700100000,NW 311,RESIDENTIAL,11340,0,11340,66510,0,77850
142915700200000,NW 311,RESIDENTIAL,14175,0,14175,52593,0,66768
142915700300000,NW 311,RESIDENTIAL,17500,0,17500,75159,0,92659
142915700400000,NW 311,RESIDENTIAL,17500,0,17500,79439,0,96939
142915700500000,NW 311,RESIDENTIAL,14000,0,14000,76933,0,90933
142915700600000,NW 311,RESIDENTIAL,5513,0,5513,44939,0,50452
142915700700000,NW 311,RESIDENTIAL,13230,0,13230,71384,0,84614
142915700800000,NW 311,RESIDENTIAL,20000,0,20000,113894,0,133894
142915700900000,NW 311,RESIDENTIAL,20000,0,20000,0,0,20000
142915701000000,NW 311,RESIDENTIAL,20000,0,20000,0,0,20000
142915701100000,OFFICE,COMMERCIAL,0,13800,13800,0,69481,83281
142915701200000,NW 311,RESIDENTIAL,7776,0,7776,58950,0,66726
142915701300000,NW 311,RESIDENTIAL,11076,0,11076,63775,0,74851
142915701400000,NW 311,RESIDENTIAL,5670,0,5670,46456,0,52126
142915800100000,NW 311,RESIDENTIAL,12128,0,12128,52619,0,64747
142915800200000,NW 311,RESIDENTIAL,10500,0,10500,71800,0,82300
142915800300000,NW 311,RESIDENTIAL,10640,0,10640,57511,0,68151
142915800400000,NW 311,RESIDENTIAL,20000,0,20000,68264,0,88264
142915800500000,NW 311,RESIDENTIAL,400,0,400,0,0,400
142915800600000,NW 311,RESIDENTIAL,20400,0,20400,66302,0,86702
142915800700000,NW 311,RESIDENTIAL,16320,0,16320,53898,0,70218
142915800800000,NW 311,RESIDENTIAL,20400,0,20400,69668,0,90068
142915800900000,NW 311,RESIDENTIAL,20400,0,20400,93378,0,113778
142915801000000,NW 311,RESIDENTIAL,20400,0,20400,83945,0,104345
142915801100000,APARTMENT,RESIDENTIAL,12000,0,12000,100483,0,112483
142915801200000,NW 311,RESIDENTIAL,10850,0,10850,88696,0,99546
142915801300000,NW 311,RESIDENTIAL,11753,0,11753,58297,0,70050
142915801400000,NW 311,RESIDENTIAL,11554,0,11554,59681,0,71235
142915900100000,SMALL RETAIL,COMMERCIAL,0,240750,240750,0,81120,321870
142915900200000,VACANT LAND,COMMERCIAL,0,19810,19810,0,0,19810
142916000100000,AUTO REPAIR/SALES,COMMERCIAL,0,75600,75600,0,90927,166527
142916000102000,BILLBOARD(BLL),COMMERCIAL,0,0,0,0,48748,48748
142916000200000,LG DISCOUNT/RETAIL,COMMERCIAL,0,245250,245250,0,212880,458130
142916000300000,WAREHOUSE,COMMERCIAL,0,136250,136250,0,270462,406712
142916100100000,CONVENIENCE STORE,COMMERCIAL,0,67200,67200,0,193014,260214
142916100200000,NW 311,RESIDENTIAL,8000,0,8000,62582,0,70582
142916100300000,NW 311,RESIDENTIAL,8000,0,8000,691,0,8691
142916100400000,OFFICE,COMMERCIAL,0,67200,67200,0,109919,177119
142916100500000,APARTMENT,COMMERCIAL,0,14000,14000,0,108322,122322
142916100600000,VACANT LAND,COMMERCIAL,0,16800,16800,0,0,16800
142916100700000,BARS/LOUNGE,COMMERCIAL,0,21000,21000,0,66453,87453
142916100800000,NW 311,RESIDENTIAL,15000,0,15000,48256,0,63256
142916100900000,NW 311,RESIDENTIAL,7075,0,7075,45220,0,52295
142916101000000,NW 311,RESIDENTIAL,7209,0,7209,48278,0,55487
142916101100000,NW 311,RESIDENTIAL,8396,0,8396,50971,0,59367
142916200100000,NW 311,RESIDENTIAL,19920,0,19920,95789,0,115709
142916200200000,NW 311,RESIDENTIAL,20000,0,20000,79545,0,99545
142916200300000,NW 311,RESIDENTIAL,20000,0,20000,66045,0,86045
142916200400000,NW 311,RESIDENTIAL,20000,0,20000,82920,0,102920
142916200500000,NW 311,RESIDENTIAL,20000,0,20000,74702,0,94702
142916200600000,NW 311,RESIDENTIAL,16000,0,16000,72899,0,88899
142916200700000,CONVERSION,COMMERCIAL,0,13608,13608,0,101924,115532
142916200800000,NW 311,RESIDENTIAL,7290,0,7290,60557,0,67847
142916200900000,NW 311,RESIDENTIAL,11400,0,11400,53381,0,64781
142916201000000,NW 311,RESIDENTIAL,15132,0,15132,80401,0,95533
142916201100000,NW 311,RESIDENTIAL,15000,0,15000,55254,0,70254
142916201200000,NW 311,RESIDENTIAL,15000,0,15000,53515,0,68515
142916201300000,NW 311,RESIDENTIAL,15000,0,15000,43986,0,58986
142916201400000,NW 311,RESIDENTIAL,15000,0,15000,65052,0,80052
142916201500000,NW 311,RESIDENTIAL,13680,0,13680,42666,0,56346
142916201600000,OFFICE,COMMERCIAL,0,10800,10800,0,92890,103690
142916201700000,NW 311,RESIDENTIAL,9300,0,9300,47598,0,56898
142916300100000,SHOP,COMMERCIAL,0,77850,77850,0,256831,334681
142916300200000,VACANT LAND,COMMERCIAL,0,19278,19278,0,0,19278
142916300300000,SHOP,COMMERCIAL,0,50420,50420,0,175975,226395
142916300400000,SHOP,COMMERCIAL,0,17588,17588,0,31247,48835
142916300500000,CITY PROPERTY,EXEMPT,0,0,0,0,0,0
142916300600000,NW 318,RESIDENTIAL,11550,0,11550,46154,0,57704
142916300700000,NW 318,RESIDENTIAL,11440,0,11440,0,0,11440
142916400100000,VACANT LAND,COMMERCIAL,0,10012,10012,0,0,10012
142916400200000,SHOP,COMMERCIAL,0,57125,57125,0,172907,230032
142916400300000,FLAT PARKING,COMMERCIAL,0,19375,19375,0,4097,23472
142916400400000,FLAT PARKING,COMMERCIAL,0,8750,8750,0,1425,10175
142916400500000,FLAT PARKING,COMMERCIAL,0,10875,10875,0,2100,12975
142916400800000,NW 311,RESIDENTIAL,10050,0,10050,49190,0,59240
142916400900000,NW 311,RESIDENTIAL,7560,0,7560,52237,0,59797
142916401000000,NW 311,RESIDENTIAL,11288,0,11288,49537,0,60825
142916401100000,NW 311,RESIDENTIAL,6222,0,6222,43751,0,49973
142916401200000,NW 311,RESIDENTIAL,8501,0,8501,40497,0,48998
142916401300000,NW 311,RESIDENTIAL,10950,0,10950,49673,0,60623
142916401400000,CITY PROPERTY,EXEMPT,0,0,0,0,0,0
142916401500000,FLAT PARKING,COMMERCIAL,0,14500,14500,0,2880,17380
142916401600000,WAREHOUSE,COMMERCIAL,0,59737,59737,0,198908,258645
142916401700000,VACANT LAND,COMMERCIAL,0,7762,7762,0,0,7762
142916401800000,OFFICE,COMMERCIAL,0,21750,21750,0,271436,293186
142917600100000,OFFICE; CTRL CR,COMMERCIAL,0,120960,120960,0,274598,395558
142917700100000,AUTO REP/SAL;CTRL CR,COMMERCIAL,0,100620,100620,0,35110,135730
142917700200000,SMALL RET; CTRL CR,COMMERCIAL,0,33540,33540,0,90098,123638
142917700202000,BILLBOARD(BLL),COMMERCIAL,0,0,0,0,18457,18457
142917700300000,CITY PROPERTY,EXEMPT,0,0,0,0,0,0
142917700400000,CITY PROPERTY,EXEMPT,0,0,0,0,0,0
142917700500000,AUTO REP/SAL;CTRL CR,COMMERCIAL,0,42000,42000,0,20096,62096
142917700600000,AUTO REP/SAL;CTRL CR,COMMERCIAL,0,30935,30935,0,25336,56271
142917700700000,CITY PROPERTY,EXEMPT,0,0,0,0,0,0
142917700800000,CITY PROPERTY,EXEMPT,0,0,0,0,0,0
142917700900000,CONVERSION,COMMERCIAL,0,7290,7290,0,55322,62612
142917701000000,CONVERSION,COMMERCIAL,0,7290,7290,0,57648,64938
142917701100000,SW 401,RESIDENTIAL,10404,0,10404,0,0,10404
142917800100000,SMALL RETAIL,COMMERCIAL,0,30240,30240,0,37257,67497
142917800200000,CITY PROPERTY,EXEMPT,0,0,0,0,0,0
142917800300000,FLAT PARKING,COMMERCIAL,0,33600,33600,0,4480,38080
142917800400000,RESTAURANT,COMMERCIAL,0,30240,30240,0,120645,150885
142917800500000,FLAT PARKING,COMMERCIAL,0,33600,33600,0,4536,38136
142917800600000,FLAT PARKING,COMMERCIAL,0,33600,33600,0,4536,38136
142917800700000,SMALL RETAIL,COMMERCIAL,0,60480,60480,0,218131,278611
142917800800000,NW 318,RESIDENTIAL,81000,0,81000,79543,0,160543
142917900100000,SW 401,EXEMPT,0,0,0,0,0,0
142917900200000,CHURCH,EXEMPT,0,6750,6750,0,0,6750
142917900300000,CHURCH,EXEMPT,0,6750,6750,0,0,6750
142917900400000,CHURCH,EXEMPT,0,3213,3213,0,0,3213
142917900500000,CHURCH,EXEMPT,0,12960,12960,0,3480,16440
142917900600000,CHURCH,EXEMPT,0,45506,45506,0,330593,376099
142917900700000,CHURCH,EXEMPT,0,18144,18144,0,18886,37030
142917900800000,SCHOOL,EXEMPT,0,18144,18144,0,189568,207712
142917900900000,CHURCH,EXEMPT,0,18144,18144,0,2214,20358
142917901000000,CHURCH,EXEMPT,0,9072,9072,0,0,9072
142917901100000,CITY PROPERTY,EXEMPT,0,0,0,0,0,0
142917901200000,CONVERSION,COMMERCIAL,0,14515,14515,0,57772,72287
142917901300000,CONVERSION,COMMERCIAL,0,3231,3231,0,59856,63087
142917901400000,COUNTY PROPERTY,EXEMPT,0,0,0,0,0,0
142917901500000,SW 401,RESIDENTIAL,10435,0,10435,63960,0,74395
142917901600000,SCHOOL,EXEMPT,0,0,0,0,0,0
142918000100000,NW 318,RESIDENTIAL,9800,0,9800,58436,0,68236
142918000200000,CONVERSION,COMMERCIAL,0,3827,3827,0,70557,74384
142918000300000,OFFICE,COMMERCIAL,0,94080,94080,0,332526,426606
142918000400000,FAST FOOD,COMMERCIAL,0,30240,30240,0,60176,90416
142918000500000,OFFICE,COMMERCIAL,0,31920,31920,0,134950,166870
142918000600000,FLAT PARKING,COMMERCIAL,0,10710,10710,0,3528,14238
142918000700000,FLAT PARKING,COMMERCIAL,0,10710,10710,0,3528,14238
142918000800000,NW 318,RESIDENTIAL,6510,0,6510,46353,0,52863
142918000900000,NW 318,RESIDENTIAL,6510,0,6510,68205,0,74715
142918001000000,NW 318,RESIDENTIAL,12600,0,12600,0,0,12600
142918001100000,CITY PROPERTY,EXEMPT,0,0,0,0,0,0
142918001500000,CITY PROPERTY,EXEMPT,0,0,0,0,0,0
142918001600000,CITY PROPERTY,EXEMPT,0,0,0,0,0,0
142918001700000,NW 318,RESIDENTIAL,7068,0,7068,43184,0,50252
142918001800000,CITY PROPERTY,EXEMPT,0,0,0,0,0,0
142918001900000,CITY PROPERTY,EXEMPT,0,0,0,0,0,0
142918002000000,FLAT PARKING,COMMERCIAL,0,100800,100800,0,24192,124992
142918100100000,FLAT PARKING,COMMERCIAL,0,47250,47250,0,6757,54007
142918100200000,RESTAURANT,COMMERCIAL,0,86850,86850,0,170616,257466
142918100300000,FLAT PARKING,COMMERCIAL,0,32250,32250,0,3360,35610
142918100400000,SMALL RETAIL,COMMERCIAL,0,30240,30240,0,28215,58455
142918100500000,BARS/LOUNGE,COMMERCIAL,0,33600,33600,0,62115,95715
142918100600000,VACANT LAND,COMMERCIAL,0,16728,16728,0,0,16728
142918100700000,NW 318,RESIDENTIAL,12000,0,12000,59881,0,71881
142918100800000,NW 318,RESIDENTIAL,12000,0,12000,46203,0,58203
142918100900000,CITY PROPERTY,EXEMPT,0,0,0,0,0,0
142918101000000,NW 318,RESIDENTIAL,12000,0,12000,50771,0,62771
142918101100000,CITY PROPERTY,EXEMPT,0,0,0,0,0,0
142918101200000,CITY PROPERTY,EXEMPT,0,0,0,0,0,0
142918101300000,CONVERSION,COMMERCIAL,0,6804,6804,0,45901,52705
142918101400000,CONVERSION,COMMERCIAL,0,6804,6804,0,50937,57741
142918101500000,NW 318,RESIDENTIAL,12000,0,12000,45618,0,57618
142918101600000,NW 318,RESIDENTIAL,5000,0,5000,0,0,5000
142918101700000,NW 318,RESIDENTIAL,8100,0,8100,49261,0,57361
142918101800000,FLAT PARKING,COMMERCIAL,0,17760,17760,0,8319,26079
142918200100000,OFFICE; CTRL CR,COMMERCIAL,0,147800,147800,0,394780,542580
142918200300000,FLAT PARKING,COMMERCIAL,0,52709,52709,0,3874,56583
142918200400000,FLAT PARKING,COMMERCIAL,0,24400,24400,0,1795,26195
142918200500000,CITY PROPERTY,EXEMPT,0,0,0,0,0,0
142918300100000,NW 318,RESIDENTIAL,7161,0,7161,69580,0,76741
142918300200000,SMALL RETAIL,COMMERCIAL,0,68040,68040,0,248964,317004
142918300300000,NW 318,RESIDENTIAL,6300,0,6300,27918,0,34218
142918300400000,BARS/LOUNGE,COMMERCIAL,0,5670,5670,0,76689,82359
142918300500000,CITY PROPERTY,EXEMPT,0,0,0,0,0,0
142918300600000,NW 318,RESIDENTIAL,6510,0,6510,56792,0,63302
142918300700000,NW 318,RESIDENTIAL,5952,0,5952,40791,0,46743
142918300800000,NW 318,RESIDENTIAL,8046,0,8046,54667,0,62713
142918300900000,NW 318,RESIDENTIAL,6151,0,6151,53340,0,59491
142918301000000,NW 318,RESIDENTIAL,5909,0,5909,60412,0,66321
142918301300000,FLAT PARKING,COMMERCIAL,0,63000,63000,0,7107,70107
142918301400000,AUTO REPAIR/SALES,COMMERCIAL,0,63000,63000,0,78894,141894
142918301500000,NW 318,RESIDENTIAL,5952,0,5952,33775,0,39727
142918301600000,CITY PROPERTY,EXEMPT,0,0,0,0,0,0
142918301700000,NW 318,RESIDENTIAL,6882,0,6882,42558,0,49440
142918301900000,NW 318,RESIDENTIAL,13500,0,13500,45948,0,59448
142918400100000,NW 318,RESIDENTIAL,9990,0,9990,37185,0,47175
142918400200000,NW 318,RESIDENTIAL,8760,0,8760,25822,0,34582
142918400300000,NW 318,RESIDENTIAL,12000,0,12000,43388,0,55388
142918400400000,NW 318,RESIDENTIAL,5000,0,5000,0,0,5000
142918400500000,NW 318,RESIDENTIAL,12000,0,12000,51384,0,63384
142918400600000,NW 318,RESIDENTIAL,12000,0,12000,44929,0,56929
142918400700000,NW 318,RESIDENTIAL,12000,0,12000,55986,0,67986
142918400800000,NW 318,RESIDENTIAL,8100,0,8100,40196,0,48296
142918400900000,NW 318,RESIDENTIAL,9120,0,9120,36958,0,46078
142918401000000,NW 318,RESIDENTIAL,12000,0,12000,33624,0,45624
142918401200000,NW 318,RESIDENTIAL,24000,0,24000,73123,0,97123
142918401300000,NW 318,RESIDENTIAL,8400,0,8400,45707,0,54107
142918401400000,NW 318,RESIDENTIAL,9600,0,9600,58308,0,67908
142918401500000,NW 318,RESIDENTIAL,5000,0,5000,0,0,5000
142918401600000,NW 318,RESIDENTIAL,7440,0,7440,59757,0,67197
142918401700000,SMALL RETAIL,COMMERCIAL,0,5616,5616,0,48129,53745
142918401800000,NW 318,RESIDENTIAL,9120,0,9120,40439,0,49559
142918500100000,NW 318,RESIDENTIAL,12000,0,12000,0,0,12000
142918500200000,NW 318,RESIDENTIAL,12000,0,12000,48836,0,60836
142918500300000,NW 318,RESIDENTIAL,12000,0,12000,22112,0,34112
142918500400000,NW 318,RESIDENTIAL,12000,0,12000,32116,0,44116
142918500500000,CITY PROPERTY,EXEMPT,0,0,0,0,0,0
142918500600000,SHOP,COMMERCIAL,0,14512,14512,0,124445,138957
142918500700000,CITY PROPERTY,EXEMPT,0,0,0,0,0,0
142918500800000,NW 318,RESIDENTIAL,11969,0,11969,37595,0,49564
142918500900000,CITY PROPERTY,EXEMPT,0,0,0,0,0,0
142918501000000,NW 318,RESIDENTIAL,12000,0,12000,57468,0,69468
142918501100000,CITY PROPERTY,EXEMPT,0,0,0,0,0,0
142918501200000,APARTMENT,COMMERCIAL,0,11200,11200,0,132033,143233
142918501300000,NW 318,RESIDENTIAL,12000,0,12000,38209,0,50209
142918501400000,NW 318,RESIDENTIAL,12000,0,12000,0,0,12000
142918501500000,NW 318,RESIDENTIAL,12000,0,12000,27888,0,39888
142918600100000,NW 318,RESIDENTIAL,10680,0,10680,100886,0,111566
142918600200000,CITY PROPERTY,EXEMPT,0,0,0,0,0,0
142918600300000,NW 318,RESIDENTIAL,15000,0,15000,0,0,15000
142918600400000,VACANT LAND,COMMERCIAL,0,15120,15120,0,0,15120
142918600500000,NW 318,RESIDENTIAL,9000,0,9000,46865,0,55865
142918600600000,CITY PROPERTY,EXEMPT,0,0,0,0,0,0
142918600700000,NW 318,RESIDENTIAL,15000,0,15000,93725,0,108725
142918600800000,NW 318,RESIDENTIAL,7245,0,7245,51830,0,59075
142918600900000,NW 318,RESIDENTIAL,7245,0,7245,40163,0,47408
142918601000000,NW 318,RESIDENTIAL,6528,0,6528,41304,0,47832
142918601100000,NW 318,RESIDENTIAL,7752,0,7752,74601,0,82353
142918601200000,NW 318,RESIDENTIAL,9600,0,9600,49145,0,58745
142918601300000,NW 318,RESIDENTIAL,10200,0,10200,61704,0,71904
142918601400000,NW 318,RESIDENTIAL,10200,0,10200,48611,0,58811
142918601500000,NW 318,RESIDENTIAL,9600,0,9600,36983,0,46583
142918601600000,NW 318,RESIDENTIAL,9000,0,9000,51088,0,60088
142918601700000,NW 318,RESIDENTIAL,7350,0,7350,26767,0,34117
142918601800000,CITY PROPERTY,EXEMPT,0,0,0,0,0,0
142918601900000,CITY PROPERTY,EXEMPT,0,0,0,0,0,0
142918602000000,CITY PROPERTY,EXEMPT,0,0,0,0,0,0
142918602100000,NW 318,RESIDENTIAL,5130,0,5130,51693,0,56823
142918700100000,BARS/LOUNGE,COMMERCIAL,0,18000,18000,0,88069,106069
142918700200000,NW 318,RESIDENTIAL,6156,0,6156,23609,0,29765
142918700300000,CITY PROPERTY,EXEMPT,0,0,0,0,0,0
142918700400000,NW 318,RESIDENTIAL,7254,0,7254,21555,0,28809
142918700500000,NW 318,RESIDENTIAL,7254,0,7254,31146,0,38400
142918700600000,NW 318,RESIDENTIAL,7663,0,7663,26928,0,34591
142918700700000,NW 318,RESIDENTIAL,10137,0,10137,1451,0,11588
142918700800000,NW 318,RESIDENTIAL,7893,0,7893,38286,0,46179
142918700900000,NW 318,RESIDENTIAL,8576,0,8576,51818,0,60394
142918701000000,CITY PROPERTY,EXEMPT,0,0,0,0,0,0
142918701100000,CITY PROPERTY,EXEMPT,0,0,0,0,0,0
142918701200000,NW 318,RESIDENTIAL,10432,0,10432,42323,0,52755
142918701300000,CITY PROPERTY,EXEMPT,0,0,0,0,0,0
142918701400000,NW 318,RESIDENTIAL,8280,0,8280,44063,0,52343
142918701500000,CITY PROPERTY,EXEMPT,0,0,0,0,0,0
142918800100000,NW 318,RESIDENTIAL,12000,0,12000,37696,0,49696
142918800200000,NW 318,RESIDENTIAL,12000,0,12000,87353,0,99353
142918800300000,CITY PROPERTY,EXEMPT,0,0,0,0,0,0
142918800400000,NW 318,RESIDENTIAL,12000,0,12000,45734,0,57734
142918800500000,NW 318,RESIDENTIAL,12000,0,12000,41565,0,53565
142918800600000,NW 318,RESIDENTIAL,12000,0,12000,57871,0,69871
142918800900000,NW 318,RESIDENTIAL,11628,0,11628,40422,0,52050
142918801000000,NW 318,RESIDENTIAL,8400,0,8400,47393,0,55793
142918801100000,NW 318,RESIDENTIAL,9960,0,9960,48578,0,58538
142918801200000,NW 318,RESIDENTIAL,11760,0,11760,37425,0,49185
142918801300000,NW 318,RESIDENTIAL,720,0,720,758,0,1478
142918801400000,CENTRALLY ASSESSED,OTHER,0,0,0,0,0,0
142918801500000,NW 318,RESIDENTIAL,12000,0,12000,60354,0,72354
142918801600000,CITY PROPERTY,EXEMPT,0,0,0,0,0,0
142918801700000,NW 318,RESIDENTIAL,12000,0,12000,93090,0,105090
142918801800000,NW 318,RESIDENTIAL,12000,0,12000,0,0,12000
142918801900000,CITY PROPERTY,EXEMPT,0,0,0,0,0,0
142918900100000,NW 318,RESIDENTIAL,8040,0,8040,34585,0,42625
142918900200000,CITY PROPERTY,EXEMPT,0,0,0,0,0,0
142918900300000,NW 318,RESIDENTIAL,11400,0,11400,86898,0,98298
142918900400000,CITY PROPERTY,EXEMPT,0,0,0,0,0,0
142918900500000,NW 318,RESIDENTIAL,32592,0,32592,0,0,32592
142918900600000,CITY PROPERTY,EXEMPT,0,0,0,0,0,0
142918900700000,VACANT LAND,COMMERCIAL,0,7915,7915,0,0,7915
142918900702000,BILLBOARD(BLL),COMMERCIAL,0,0,0,0,10737,10737
142918900800000,CITY PROPERTY,EXEMPT,0,0,0,0,0,0
142918900900000,NW 318,RESIDENTIAL,9000,0,9000,40560,0,49560
142918901000000,CITY PROPERTY,EXEMPT,0,0,0,0,0,0
142918901100000,NW 318,RESIDENTIAL,11280,0,11280,46345,0,57625
142918901200000,NW 318,RESIDENTIAL,7425,0,7425,29337,0,36762
142920100300000,CONVERSION,COMMERCIAL,0,8932,8932,0,86150,95082
142920100400000,NW 311,RESIDENTIAL,16337,0,16337,65956,0,82293
142920100500000,NW 311,RESIDENTIAL,16000,0,16000,67299,0,83299
142920100600000,NW 311,RESIDENTIAL,16000,0,16000,51089,0,67089
142920100700000,NW 311,RESIDENTIAL,16000,0,16000,62600,0,78600
142920100800000,NW 311,RESIDENTIAL,16000,0,16000,74916,0,90916
142920100900000,NW 311,RESIDENTIAL,16000,0,16000,71773,0,87773
142920101000000,NW 311,RESIDENTIAL,16000,0,16000,67175,0,83175
142920101100000,NW 311,RESIDENTIAL,16000,0,16000,68825,0,84825
142920101200000,NW 311,RESIDENTIAL,16000,0,16000,64942,0,80942
142920101300000,NW 311,RESIDENTIAL,16000,0,16000,65339,0,81339
142920101400000,NW 311,RESIDENTIAL,16000,0,16000,61682,0,77682
142920101500000,NW 311,RESIDENTIAL,16000,0,16000,64098,0,80098
142920101600000,NW 311,RESIDENTIAL,15019,0,15019,59174,0,74193
142920101700000,NW 311,RESIDENTIAL,14047,0,14047,61745,0,75792
142920101800000,NW 311,RESIDENTIAL,9920,0,9920,34218,0,44138
142920101900000,SCHOOL,EXEMPT,0,0,0,0,0,0
142920102100000,COUNTY PROPERTY,EXEMPT,0,0,0,0,0,0
142920200100000,SCHOOL,EXEMPT,0,0,0,0,0,0
142920300100000,NW 311,RESIDENTIAL,11200,0,11200,68316,0,79516
142920300200000,NW 311,RESIDENTIAL,16000,0,16000,66849,0,82849
142920300300000,NW 311,RESIDENTIAL,16000,0,16000,70852,0,86852
142920300400000,CITY PROPERTY,EXEMPT,0,0,0,0,0,0
142920300500000,CITY PROPERTY,EXEMPT,0,0,0,0,0,0
142920300600000,CITY PROPERTY,EXEMPT,0,0,0,0,0,0
142920300700000,NW 311,RESIDENTIAL,16000,0,16000,46747,0,62747
142920300800000,NW 311,RESIDENTIAL,16000,0,16000,40546,0,56546
142920300900000,NW 311,RESIDENTIAL,16000,0,16000,54454,0,70454
142920301000000,NW 311,RESIDENTIAL,16000,0,16000,73160,0,89160
142920301100000,NW 311,RESIDENTIAL,16000,0,16000,66174,0,82174
142920301200000,NW 311,RESIDENTIAL,20800,0,20800,53577,0,74377
142920301300000,NW 311,RESIDENTIAL,14080,0,14080,72413,0,86493
142920301400000,NW 311,RESIDENTIAL,14080,0,14080,87137,0,101217
142920301500000,NW 311,RESIDENTIAL,12160,0,12160,51481,0,63641
142920301600000,NW 311,RESIDENTIAL,16000,0,16000,54731,0,70731
142920301700000,NW 311,RESIDENTIAL,16000,0,16000,55466,0,71466
142920301800000,NW 311,RESIDENTIAL,12600,0,12600,87847,0,100447
142920301900000,NW 311,RESIDENTIAL,12800,0,12800,84756,0,97556
142920302000000,NW 311,RESIDENTIAL,12160,0,12160,79632,0,91792
142920302100000,NW 311,RESIDENTIAL,13440,0,13440,61525,0,74965
142920302200000,NW 311,RESIDENTIAL,13000,0,13000,69230,0,82230
142920302300000,NW 311,RESIDENTIAL,17510,0,17510,61542,0,79052
142920302400000,NW 311,RESIDENTIAL,11400,0,11400,52527,0,63927
142920302500000,NW 311,RESIDENTIAL,16000,0,16000,69500,0,85500
142920302600000,NW 311,RESIDENTIAL,16000,0,16000,43311,0,59311
142920302700000,NW 311,RESIDENTIAL,16000,0,16000,49363,0,65363
142920302800000,NW 311,RESIDENTIAL,16000,0,16000,44768,0,60768
142920302900000,NW 311,RESIDENTIAL,16000,0,16000,51463,0,67463
142920303000000,NW 311,RESIDENTIAL,20800,0,20800,76425,0,97225
142920303100000,NW 311,RESIDENTIAL,11340,0,11340,54536,0,65876
142920400100000,NW 311,RESIDENTIAL,16000,0,16000,71501,0,87501
142920400200000,NW 311,RESIDENTIAL,10800,0,10800,69114,0,79914
142920400300000,NW 311,RESIDENTIAL,11200,0,11200,41282,0,52482
142920400400000,NW 311,RESIDENTIAL,15680,0,15680,83857,0,99537
142920400500000,NW 311,RESIDENTIAL,15680,0,15680,64232,0,79912
142920400600000,NW 311,RESIDENTIAL,15680,0,15680,39057,0,54737
142920400700000,NW 311,RESIDENTIAL,16000,0,16000,54066,0,70066
142920400800000,NW 311,RESIDENTIAL,16000,0,16000,55199,0,71199
142920400900000,NW 311,RESIDENTIAL,16000,0,16000,72997,0,88997
142920500100000,NW 311,RESIDENTIAL,13680,0,13680,64193,0,77873
142920500200000,NW 311,RESIDENTIAL,11160,0,11160,62125,0,73285
142920500300000,NW 311,RESIDENTIAL,14790,0,14790,41484,0,56274
142920500400000,NW 311,RESIDENTIAL,15300,0,15300,70574,0,85874
142920500500000,NW 311,RESIDENTIAL,15045,0,15045,60017,0,75062
142920500600000,NW 311,RESIDENTIAL,16000,0,16000,42608,0,58608
142920500700000,NW 311,RESIDENTIAL,18000,0,18000,51597,0,69597
142920600100000,NW 320,RESIDENTIAL,16800,0,16800,72826,0,89626
142920600200000,NW 320,RESIDENTIAL,16416,0,16416,55593,0,72009
142920600300000,NW 320,RESIDENTIAL,13880,0,13880,76235,0,90115
142920600400000,NW 320,RESIDENTIAL,11400,0,11400,60565,0,71965
142920600500000,NW 320,RESIDENTIAL,16000,0,16000,56608,0,72608
142920600600000,NW 320,RESIDENTIAL,16000,0,16000,64498,0,80498
142920600700000,NW 320,RESIDENTIAL,16000,0,16000,46803,0,62803
142920600800000,NW 320,RESIDENTIAL,16000,0,16000,50802,0,66802
142920600900000,NW 320,RESIDENTIAL,16000,0,16000,47623,0,63623
142920601000000,NW 320,RESIDENTIAL,16000,0,16000,70254,0,86254
142920601100000,NW 320,RESIDENTIAL,16000,0,16000,64878,0,80878
142920601200000,NW 320,RESIDENTIAL,16000,0,16000,74037,0,90037
142920601300000,NW 320,RESIDENTIAL,14000,0,14000,66886,0,80886
142920601400000,NW 320,RESIDENTIAL,16000,0,16000,59303,0,75303
142920601500000,NW 320,RESIDENTIAL,16000,0,16000,48215,0,64215
142920601600000,NW 320,RESIDENTIAL,16000,0,16000,48174,0,64174
142922600100000,NW 320,RESIDENTIAL,25620,0,25620,63144,0,88764
142922600200000,NW 320,RESIDENTIAL,26318,0,26318,66560,0,92878
142922600300000,NW 320,RESIDENTIAL,22491,0,22491,64353,0,86844
142922600400000,NW 320,RESIDENTIAL,29450,0,29450,91723,0,121173
142922600500000,NW 320,RESIDENTIAL,18570,0,18570,73058,0,91628
142922600600000,NW 320,RESIDENTIAL,18207,0,18207,56660,0,74867
142922600700000,NW 320,RESIDENTIAL,17493,0,17493,69449,0,86942
142922600800000,NW 320,RESIDENTIAL,29890,0,29890,0,0,29890
142922600900000,NW 320,RESIDENTIAL,29890,0,29890,76501,0,106391
142922601000000,NW 320,RESIDENTIAL,17325,0,17325,41618,0,58943
142922601100000,NW 320,RESIDENTIAL,18900,0,18900,56565,0,75465
142922601200000,NW 320,RESIDENTIAL,28175,0,28175,109667,0,137842
142922601300000,NW 320,RESIDENTIAL,26215,0,26215,83104,0,109319
142922601400000,NW 320,RESIDENTIAL,27264,0,27264,162678,0,189942
142922601500000,NW 320,RESIDENTIAL,21221,0,21221,88576,0,109797
142922601600000,NW 320,RESIDENTIAL,21168,0,21168,83177,0,104345
142922601700000,NW 320,RESIDENTIAL,21221,0,21221,90681,0,111902
142922601800000,NW 320,RESIDENTIAL,24547,0,24547,74945,0,99492
142922601900000,NW 320,RESIDENTIAL,24723,0,24723,76722,0,101445
142922602000000,NW 320,RESIDENTIAL,25135,0,25135,98387,0,123522
142922602100000,NW 320,RESIDENTIAL,50800,0,50800,128464,0,179264
142922602200000,CITY PROPERTY,EXEMPT,0,0,0,0,0,0
142922602300000,NW 320,RESIDENTIAL,24225,0,24225,83730,0,107955
142922602400000,NW 320,RESIDENTIAL,24939,0,24939,106741,0,131680
142922602500000,NW 320,RESIDENTIAL,25529,0,25529,102114,0,127643
142922602600000,NW 320,RESIDENTIAL,20143,0,20143,69865,0,90008
142922602700000,NW 320,RESIDENTIAL,24200,0,24200,105070,0,129270
142922602800000,NW 320,RESIDENTIAL,24200,0,24200,68979,0,93179
142922602900000,NW 320,RESIDENTIAL,24200,0,24200,90454,0,114654
142922603000000,NW 320,RESIDENTIAL,24200,0,24200,104988,0,129188
142922603100000,NW 320,RESIDENTIAL,51050,0,51050,114748,0,165798
142922603200000,NW 320,RESIDENTIAL,50800,0,50800,111951,0,162751
142922603300000,NW 320,RESIDENTIAL,50000,0,50000,108741,0,158741
142922603400000,NW 320,RESIDENTIAL,26400,0,26400,100049,0,126449
142922603500000,NW 320,RESIDENTIAL,27000,0,27000,118547,0,145547
142922603600000,NW 320,RESIDENTIAL,24600,0,24600,88278,0,112878
142922603700000,NW 320,RESIDENTIAL,31365,0,31365,83109,0,114474
142922603800000,NW 320,RESIDENTIAL,31365,0,31365,78601,0,109966
142922603900000,NW 320,RESIDENTIAL,26840,0,26840,68826,0,95666
142922604000000,NW 320,RESIDENTIAL,51750,0,51750,83726,0,135476
142922604100000,NW 320,RESIDENTIAL,30110,0,30110,63510,0,93620
142922604200000,NW 320,RESIDENTIAL,30110,0,30110,77734,0,107844
142922604300000,NW 320,RESIDENTIAL,30640,0,30640,57526,0,88166
142922700100000,NW 320,RESIDENTIAL,19227,0,19227,68852,0,88079
142922700200000,NW 320,RESIDENTIAL,16000,0,16000,62292,0,78292
142922700300000,NW 320,RESIDENTIAL,16000,0,16000,55118,0,71118
142922700400000,NW 320,RESIDENTIAL,16000,0,16000,47514,0,63514
142922700500000,NW 320,RESIDENTIAL,16000,0,16000,54183,0,70183
142922700600000,NW 320,RESIDENTIAL,18816,0,18816,73964,0,92780
142922700700000,NW 320,RESIDENTIAL,11760,0,11760,66793,0,78553
142922700800000,NW 320,RESIDENTIAL,11620,0,11620,60440,0,72060
142922700900000,NW 320,RESIDENTIAL,11060,0,11060,68595,0,79655
142922701000000,NW 320,RESIDENTIAL,18590,0,18590,80640,0,99230
142922701100000,NW 320,RESIDENTIAL,14800,0,14800,81942,0,96742
142922701200000,NW 320,RESIDENTIAL,15789,0,15789,60410,0,76199
142922701300000,NW 320,RESIDENTIAL,16000,0,16000,78309,0,94309
142922701400000,NW 320,RESIDENTIAL,16000,0,16000,65796,0,81796
142922701500000,NW 320,RESIDENTIAL,16000,0,16000,58506,0,74506
142922701600000,NW 320,RESIDENTIAL,14728,0,14728,61231,0,75959
142922701700000,NW 320,RESIDENTIAL,12000,0,12000,40626,0,52626
142922800100000,NW 320,RESIDENTIAL,21905,0,21905,68300,0,90205
142922800200000,NW 320,RESIDENTIAL,16000,0,16000,65388,0,81388
142922800300000,NW 320,RESIDENTIAL,14000,0,14000,72888,0,86888
142922800400000,NW 320,RESIDENTIAL,16000,0,16000,83021,0,99021
142922800500000,NW 320,RESIDENTIAL,16000,0,16000,78146,0,94146
142922800600000,NW 320,RESIDENTIAL,14000,0,14000,84847,0,98847
142922800700000,NW 320,RESIDENTIAL,16000,0,16000,68098,0,84098
142922800800000,NW 320,RESIDENTIAL,16000,0,16000,71800,0,87800
142922800900000,NW 320,RESIDENTIAL,20240,0,20240,106524,0,126764
142922801000000,NW 320,RESIDENTIAL,21480,0,21480,60266,0,81746
142922801100000,NW 320,RESIDENTIAL,16000,0,16000,41348,0,57348
142922801200000,NW 320,RESIDENTIAL,16000,0,16000,43199,0,59199
142922801300000,NW 320,RESIDENTIAL,14000,0,14000,80538,0,94538
142922801400000,NW 320,RESIDENTIAL,16000,0,16000,80574,0,96574
142922801500000,NW 320,RESIDENTIAL,16000,0,16000,54379,0,70379
142922801600000,NW 320,RESIDENTIAL,14000,0,14000,58918,0,72918
142922801700000,NW 320,RESIDENTIAL,16000,0,16000,72655,0,88655
142922801800000,NW 320,RESIDENTIAL,14080,0,14080,74753,0,88833
142922801900000,NW 320,RESIDENTIAL,18660,0,18660,79314,0,97974
142922802000000,NW 320,RESIDENTIAL,13440,0,13440,67289,0,80729
142922802100000,NW 320,RESIDENTIAL,9240,0,9240,46987,0,56227
142922900100000,NW 320,RESIDENTIAL,21500,0,21500,112242,0,133742
142922900200000,NW 320,RESIDENTIAL,16000,0,16000,69280,0,85280
142922900300000,NW 320,RESIDENTIAL,16000,0,16000,20552,0,36552
142922900400000,NW 320,RESIDENTIAL,16000,0,16000,67800,0,83800
142922900500000,NW 320,RESIDENTIAL,16000,0,16000,95510,0,111510
142922900600000,NW 320,RESIDENTIAL,16000,0,16000,52364,0,68364
142922900700000,NW 320,RESIDENTIAL,16000,0,16000,81589,0,97589
142922900800000,NW 320,RESIDENTIAL,16000,0,16000,65457,0,81457
142922900900000,NW 320,RESIDENTIAL,16000,0,16000,76181,0,92181
142922901000000,NW 320,RESIDENTIAL,21133,0,21133,76668,0,97801
142922901100000,NW 320,RESIDENTIAL,20210,0,20210,44649,0,64859
142922901200000,SMALL RETAIL,COMMERCIAL,0,11443,11443,0,49785,61228
142922901300000,SMALL RETAIL,COMMERCIAL,0,11788,11788,0,37937,49725
142922901400000,NW 320,RESIDENTIAL,16000,0,16000,70954,0,86954
142922901500000,NW 320,RESIDENTIAL,16000,0,16000,76817,0,92817
142922901600000,NW 320,RESIDENTIAL,16000,0,16000,62536,0,78536
142922901700000,NW 320,RESIDENTIAL,16000,0,16000,73200,0,89200
142922901800000,NW 320,RESIDENTIAL,16000,0,16000,46379,0,62379
142922901900000,NW 320,RESIDENTIAL,16000,0,16000,74179,0,90179
142922902000000,NW 320,RESIDENTIAL,16000,0,16000,64718,0,80718
142922902100000,NW 320,RESIDENTIAL,15443,0,15443,58135,0,73578
142922902200000,NW 320,RESIDENTIAL,13440,0,13440,58162,0,71602
142923000100000,NW 320,RESIDENTIAL,19600,0,19600,72613,0,92213
142923000200000,NW 320,RESIDENTIAL,19880,0,19880,57940,0,77820
142923000300000,NW 320,RESIDENTIAL,19320,0,19320,76045,0,95365
142923000400000,NW 320,RESIDENTIAL,19320,0,19320,75711,0,95031
142923000500000,NW 320,RESIDENTIAL,16000,0,16000,73273,0,89273
142923000600000,NW 320,RESIDENTIAL,16000,0,16000,67979,0,83979
142923000700000,NW 320,RESIDENTIAL,16000,0,16000,56542,0,72542
142923000800000,NW 320,RESIDENTIAL,16000,0,16000,71260,0,87260
142923100100000,NW 320,RESIDENTIAL,19727,0,19727,72224,0,91951
142923100200000,NW 320,RESIDENTIAL,19852,0,19852,69818,0,89670
142923100300000,NW 320,RESIDENTIAL,16000,0,16000,82617,0,98617
142923100400000,NW 320,RESIDENTIAL,16000,0,16000,61486,0,77486
142923100500000,NW 320,RESIDENTIAL,15200,0,15200,69976,0,85176
142923100600000,NW 320,RESIDENTIAL,16000,0,16000,84809,0,100809
142923100700000,NW 320,RESIDENTIAL,16000,0,16000,53557,0,69557
142923100800000,NW 320,RESIDENTIAL,15200,0,15200,60529,0,75729
142923100900000,NW 320,RESIDENTIAL,16000,0,16000,75853,0,91853
142923101000000,NW 320,RESIDENTIAL,16000,0,16000,60845,0,76845
142923101100000,NW 320,RESIDENTIAL,15776,0,15776,57759,0,73535
142923101200000,NW 320,RESIDENTIAL,17100,0,17100,64391,0,81491
142923101300000,NW 320,RESIDENTIAL,15660,0,15660,62717,0,78377
142923101400000,NW 320,RESIDENTIAL,20550,0,20550,73558,0,94108
142923101500000,NW 320,RESIDENTIAL,13069,0,13069,58160,0,71229
142923101600000,NW 320,RESIDENTIAL,15008,0,15008,76528,0,91536
142923101700000,NW 320,RESIDENTIAL,17275,0,17275,87354,0,104629
142923101800000,NW 320,RESIDENTIAL,17920,0,17920,99967,0,117887
142923200100000,SMALL RETAIL,COMMERCIAL,0,12810,12810,0,38069,50879
142923200200000,VACANT LAND,COMMERCIAL,0,10675,10675,0,0,10675
142923200300000,SMALL RETAIL,COMMERCIAL,0,10462,10462,0,26672,37134
142923200600000,OFFICE,EXEMPT,0,37824,37824,0,176520,214344
142925100100000,NW 320,RESIDENTIAL,16000,0,16000,62190,0,78190
142925100200000,NW 320,RESIDENTIAL,16000,0,16000,98829,0,114829
142925100300000,NW 320,RESIDENTIAL,16000,0,16000,82078,0,98078
142925100400000,NW 320,RESIDENTIAL,19740,0,19740,90842,0,110582
142925100500000,NW 320,RESIDENTIAL,20160,0,20160,98777,0,118937
142925100600000,NW 320,RESIDENTIAL,19320,0,19320,68789,0,88109
142925100700000,NW 320,RESIDENTIAL,19600,0,19600,79683,0,99283
142925100800000,NW 320,RESIDENTIAL,16000,0,16000,69035,0,85035
142925200100000,NW 320,RESIDENTIAL,19292,0,19292,78495,0,97787
142925200200000,NW 320,RESIDENTIAL,19600,0,19600,107850,0,127450
142925200300000,NW 320,RESIDENTIAL,16000,0,16000,79934,0,95934
142925200400000,NW 320,RESIDENTIAL,16000,0,16000,85412,0,101412
142925200500000,NW 320,RESIDENTIAL,16000,0,16000,80892,0,96892
142925200600000,NW 320,RESIDENTIAL,16000,0,16000,86867,0,102867
142925200700000,NW 320,RESIDENTIAL,16000,0,16000,63987,0,79987
142925200800000,NW 320,RESIDENTIAL,16000,0,16000,80513,0,96513
142925200900000,NW 320,RESIDENTIAL,16000,0,16000,69974,0,85974
142925201000000,NW 320,RESIDENTIAL,16373,0,16373,68356,0,84729
142925201100000,NW 320,RESIDENTIAL,21798,0,21798,98219,0,120017
142925201200000,NW 320,RESIDENTIAL,20242,0,20242,70433,0,90675
142925201300000,NW 320,RESIDENTIAL,18576,0,18576,53796,0,72372
142925300100000,NW 320,RESIDENTIAL,21006,0,21006,70200,0,91206
142925300200000,OFFICE,COMMERCIAL,0,18432,18432,0,67602,86034
142925300300000,NW 320,RESIDENTIAL,20680,0,20680,59370,0,80050
142925300400000,NW 320,RESIDENTIAL,19980,0,19980,79559,0,99539
142925300500000,NW 320,RESIDENTIAL,20513,0,20513,75775,0,96288
142925300600000,NW 320,RESIDENTIAL,19980,0,19980,87987,0,107967
142925300700000,NW 320,RESIDENTIAL,20160,0,20160,82754,0,102914
142925300800000,NW 320,RESIDENTIAL,20160,0,20160,75075,0,95235
142925300900000,NW 320,RESIDENTIAL,20160,0,20160,74227,0,94387
142925301000000,NW 320,RESIDENTIAL,18080,0,18080,82872,0,100952
142925301100000,NW 320,RESIDENTIAL,20340,0,20340,91602,0,111942
142925301200000,NW 320,RESIDENTIAL,20340,0,20340,97921,0,118261
142925301300000,NW 320,RESIDENTIAL,20520,0,20520,66964,0,87484
142925301400000,NW 320,RESIDENTIAL,20520,0,20520,91340,0,111860
142925301500000,NW 320,RESIDENTIAL,20520,0,20520,61839,0,82359
142925301600000,NW 320,RESIDENTIAL,19000,0,19000,65042,0,84042
142925301700000,NW 320,RESIDENTIAL,19206,0,19206,84672,0,103878
142925301800000,NW 320,RESIDENTIAL,21295,0,21295,79205,0,100500
142925301900000,NW 320,RESIDENTIAL,20520,0,20520,96199,0,116719
142925302000000,NW 320,RESIDENTIAL,22942,0,22942,103817,0,126759
142925302100000,NW 320,RESIDENTIAL,42760,0,42760,128116,0,170876
142925302200000,NW 320,RESIDENTIAL,20794,0,20794,139645,0,160439
142925302300000,NW 320,RESIDENTIAL,20700,0,20700,103231,0,123931
142925302400000,NW 320,RESIDENTIAL,21059,0,21059,106988,0,128047
142925302500000,NW 320,RESIDENTIAL,20875,0,20875,110944,0,131819
142925302600000,NW 320,RESIDENTIAL,20689,0,20689,96894,0,117583
142925302700000,NW 320,RESIDENTIAL,20646,0,20646,86039,0,106685
142925302800000,NW 320,RESIDENTIAL,20646,0,20646,94717,0,115363
142925302900000,NW 320,RESIDENTIAL,20274,0,20274,101210,0,121484
142925303000000,NW 320,RESIDENTIAL,20088,0,20088,87849,0,107937
142925303100000,NW 320,RESIDENTIAL,19970,0,19970,94669,0,114639
142925303200000,NW 320,RESIDENTIAL,20216,0,20216,68376,0,88592
142925303300000,NW 320,RESIDENTIAL,20107,0,20107,105844,0,125951
142925303400000,NW 320,RESIDENTIAL,18988,0,18988,70260,0,89248
142925303500000,NW 320,RESIDENTIAL,19072,0,19072,52721,0,71793
142925303600000,NW 320,RESIDENTIAL,20517,0,20517,31528,0,52045
142925400100000,NW 320,RESIDENTIAL,17031,0,17031,55456,0,72487
142925400200000,NW 320,RESIDENTIAL,19379,0,19379,71743,0,91122
142925400300000,NW 320,RESIDENTIAL,18600,0,18600,69977,0,88577
142925400400000,NW 320,RESIDENTIAL,17211,0,17211,72221,0,89432
142925400500000,NW 320,RESIDENTIAL,16640,0,16640,62383,0,79023
142925400600000,NW 320,RESIDENTIAL,13860,0,13860,111306,0,125166
142925400700000,NW 320,RESIDENTIAL,14416,0,14416,68342,0,82758
142925400800000,NW 320,RESIDENTIAL,13860,0,13860,63071,0,76931
142925400900000,NW 320,RESIDENTIAL,18720,0,18720,100024,0,118744
142925401000000,NW 320,RESIDENTIAL,19180,0,19180,79707,0,98887
142925401100000,NW 320,RESIDENTIAL,13872,0,13872,80083,0,93955
142925401200000,NW 320,RESIDENTIAL,13332,0,13332,72909,0,86241
142925401300000,NW 320,RESIDENTIAL,13068,0,13068,77939,0,91007
142925401400000,NW 320,RESIDENTIAL,19025,0,19025,81398,0,100423
142925401500000,NW 320,RESIDENTIAL,11480,0,11480,85859,0,97339
142925401600000,NW 320,RESIDENTIAL,13500,0,13500,79292,0,92792
142925401700000,NW 320,RESIDENTIAL,18848,0,18848,89275,0,108123
142925401800000,NW 320,RESIDENTIAL,19151,0,19151,101102,0,120253
142925401900000,NW 320,RESIDENTIAL,17520,0,17520,89244,0,106764
142925402000000,NW 320,RESIDENTIAL,12221,0,12221,41630,0,53851
142925402100000,NW 320,RESIDENTIAL,12703,0,12703,86595,0,99298
142925402200000,NW 320,RESIDENTIAL,17820,0,17820,95998,0,113818
142925402300000,NW 320,RESIDENTIAL,13350,0,13350,90437,0,103787
142925402400000,NW 320,RESIDENTIAL,13950,0,13950,43956,0,57906
142925402500000,NW 320,RESIDENTIAL,19400,0,19400,84952,0,104352
142925402600000,NW 320,RESIDENTIAL,18176,0,18176,81912,0,100088
142925402700000,NW 320,RESIDENTIAL,18180,0,18180,84732,0,102912
142925402800000,NW 320,RESIDENTIAL,18887,0,18887,77980,0,96867
142925402900000,NW 320,RESIDENTIAL,18000,0,18000,68900,0,86900
142925403000000,NW 320,RESIDENTIAL,18000,0,18000,72385,0,90385
142925403100000,NW 320,RESIDENTIAL,13646,0,13646,74151,0,87797
142925500100000,NW 320,RESIDENTIAL,21294,0,21294,76156,0,97450
142925500200000,NW 320,RESIDENTIAL,19754,0,19754,88985,0,108739
142925500300000,NW 320,RESIDENTIAL,11200,0,11200,70273,0,81473
142925500400000,NW 320,RESIDENTIAL,18880,0,18880,71335,0,90215
142925500500000,NW 320,RESIDENTIAL,15040,0,15040,72240,0,87280
142925500600000,NW 320,RESIDENTIAL,22670,0,22670,86218,0,108888
142925500700000,NW 320,RESIDENTIAL,18744,0,18744,100565,0,119309
142925500800000,NW 320,RESIDENTIAL,19215,0,19215,112056,0,131271
142925500900000,NW 320,RESIDENTIAL,19221,0,19221,108499,0,127720
142925501000000,NW 320,RESIDENTIAL,17709,0,17709,79215,0,96924
142925501100000,NW 320,RESIDENTIAL,19581,0,19581,76283,0,95864
142925501200000,NW 320,RESIDENTIAL,19207,0,19207,93297,0,112504
142925501300000,NW 320,RESIDENTIAL,19094,0,19094,103575,0,122669
142925501400000,NW 320,RESIDENTIAL,21120,0,21120,75936,0,97056
142925501500000,NW 320,RESIDENTIAL,20886,0,20886,67729,0,88615
142925501600000,NW 320,RESIDENTIAL,19669,0,19669,84268,0,103937
142925501700000,NW 320,RESIDENTIAL,19400,0,19400,84460,0,103860
142925501800000,NW 320,RESIDENTIAL,17820,0,17820,77895,0,95715
142925501900000,NW 320,RESIDENTIAL,18000,0,18000,88813,0,106813
142925502000000,NW 320,RESIDENTIAL,18000,0,18000,63784,0,81784
142925502100000,NW 320,RESIDENTIAL,25200,0,25200,111675,0,136875
142925502200000,NW 320,RESIDENTIAL,13320,0,13320,68862,0,82182
142925502300000,NW 320,RESIDENTIAL,13080,0,13080,63014,0,76094
142925502400000,NW 320,RESIDENTIAL,18360,0,18360,96870,0,115230
142925502500000,NW 320,RESIDENTIAL,19080,0,19080,73739,0,92819
142925502600000,NW 320,RESIDENTIAL,16640,0,16640,78230,0,94870
142925502700000,NW 320,RESIDENTIAL,21634,0,21634,111704,0,133338
142925502800000,NW 320,RESIDENTIAL,18727,0,18727,107913,0,126640
142925502900000,NW 320,RESIDENTIAL,18720,0,18720,84701,0,103421
142925503000000,NW 320,RESIDENTIAL,19179,0,19179,103181,0,122360
142925503100000,NW 320,RESIDENTIAL,19360,0,19360,71965,0,91325
142925600100000,CITY PROPERTY,EXEMPT,0,0,0,0,0,0
142925700100000,CHURCH,EXEMPT,0,437400,437400,0,463905,901305
142925700400000,NW 320,RESIDENTIAL,26928,0,26928,122964,0,149892
142925700500000,OFFICE,COMMERCIAL,0,27000,27000,0,103804,130804
142925800100000,NW 320,RESIDENTIAL,18000,0,18000,92337,0,110337
142925800200000,NW 320,RESIDENTIAL,14140,0,14140,83342,0,97482
142925800300000,NW 320,RESIDENTIAL,12240,0,12240,105364,0,117604
142925800400000,NW 320,RESIDENTIAL,14420,0,14420,96250,0,110670
142925800500000,NW 320,RESIDENTIAL,18720,0,18720,116314,0,135034
142925800600000,NW 320,RESIDENTIAL,18720,0,18720,84151,0,102871
142925800700000,NW 320,RESIDENTIAL,18720,0,18720,81321,0,100041
142925800800000,NW 320,RESIDENTIAL,17860,0,17860,82787,0,100647
142925800900000,NW 320,RESIDENTIAL,8640,0,8640,64609,0,73249
142925801000000,NW 320,RESIDENTIAL,17820,0,17820,89926,0,107746
142925801100000,NW 320,RESIDENTIAL,18000,0,18000,94272,0,112272
142925801200000,NW 320,RESIDENTIAL,18000,0,18000,93408,0,111408
142925801300000,NW 320,RESIDENTIAL,18000,0,18000,83002,0,101002
142925801400000,NW 320,RESIDENTIAL,18000,0,18000,77699,0,95699
142925801500000,NW 320,RESIDENTIAL,18000,0,18000,74061,0,92061
142925801600000,NW 320,RESIDENTIAL,18000,0,18000,111402,0,129402
142925900100000,NW 320,RESIDENTIAL,18180,0,18180,74276,0,92456
142925900200000,NW 320,RESIDENTIAL,17820,0,17820,78484,0,96304
142925900300000,NW 320,RESIDENTIAL,17820,0,17820,72008,0,89828
142925900400000,NW 320,RESIDENTIAL,17820,0,17820,65068,0,82888
142925900500000,NW 320,RESIDENTIAL,17820,0,17820,77632,0,95452
142925900600000,NW 320,RESIDENTIAL,17820,0,17820,77439,0,95259
142925900700000,NW 320,RESIDENTIAL,17000,0,17000,60162,0,77162
142925900800000,NW 320,RESIDENTIAL,17719,0,17719,62320,0,80039
142925900900000,NW 320,RESIDENTIAL,14400,0,14400,54877,0,69277
142925901000000,NW 320,RESIDENTIAL,18651,0,18651,105725,0,124376
142925901100000,NW 320,RESIDENTIAL,17820,0,17820,98279,0,116099
142925901200000,NW 320,RESIDENTIAL,17820,0,17820,71492,0,89312
142925901300000,NW 320,RESIDENTIAL,17820,0,17820,72282,0,90102
142925901400000,NW 320,RESIDENTIAL,17820,0,17820,75914,0,93734
142925901500000,NW 320,RESIDENTIAL,17820,0,17820,85916,0,103736
142925901600000,NW 320,RESIDENTIAL,17820,0,17820,67893,0,85713
142925901700000,NW 320,RESIDENTIAL,17755,0,17755,80434,0,98189
142927600100000,NW 311,RESIDENTIAL,15600,0,15600,46885,0,62485
142927600200000,NW 311,RESIDENTIAL,16072,0,16072,72981,0,89053
142927600300000,NW 311,RESIDENTIAL,13720,0,13720,61393,0,75113
142927600400000,NW 311,RESIDENTIAL,19339,0,19339,77929,0,97268
142927600500000,NW 311,RESIDENTIAL,15840,0,15840,79655,0,95495
142927600600000,NW 311,RESIDENTIAL,16000,0,16000,80777,0,96777
142927600700000,NW 311,RESIDENTIAL,16429,0,16429,64313,0,80742
142927600800000,NW 311,RESIDENTIAL,16320,0,16320,52712,0,69032
142927600900000,NW 311,RESIDENTIAL,17996,0,17996,96834,0,114830
142927601000000,NW 311,RESIDENTIAL,17654,0,17654,52747,0,70401
142927601100000,NW 311,RESIDENTIAL,16394,0,16394,49797,0,66191
142927601200000,NW 311,RESIDENTIAL,20000,0,20000,55361,0,75361
142927601300000,NW 311,RESIDENTIAL,20000,0,20000,78440,0,98440
142927601400000,NW 311,RESIDENTIAL,20000,0,20000,51029,0,71029
142927601500000,NW 311,RESIDENTIAL,20000,0,20000,57050,0,77050
142927601600000,NW 311,RESIDENTIAL,16000,0,16000,57975,0,73975
142927601700000,NW 311,RESIDENTIAL,16320,0,16320,63780,0,80100
142927601800000,NW 311,RESIDENTIAL,16320,0,16320,66496,0,82816
142927601900000,NW 311,RESIDENTIAL,16025,0,16025,73702,0,89727
142927602000000,NW 311,RESIDENTIAL,15867,0,15867,80786,0,96653
142927602100000,NW 311,RESIDENTIAL,15840,0,15840,60243,0,76083
142927602200000,NW 311,RESIDENTIAL,16415,0,16415,71261,0,87676
142927602300000,NW 311,RESIDENTIAL,14800,0,14800,62837,0,77637
142927700100000,NW 311,RESIDENTIAL,16400,0,16400,69559,0,85959
142927700200000,NW 311,RESIDENTIAL,15045,0,15045,65142,0,80187
142927700300000,NW 311,RESIDENTIAL,13760,0,13760,74943,0,88703
142927700400000,NW 311,RESIDENTIAL,14400,0,14400,57210,0,71610
142927700500000,NW 311,RESIDENTIAL,15200,0,15200,61813,0,77013
142927700600000,NW 311,RESIDENTIAL,14720,0,14720,77864,0,92584
142927700700000,NW 311,RESIDENTIAL,15520,0,15520,62020,0,77540
142927700800000,NW 311,RESIDENTIAL,15840,0,15840,58644,0,74484
142927700900000,NW 311,RESIDENTIAL,20000,0,20000,62446,0,82446
142927701000000,NW 311,RESIDENTIAL,20000,0,20000,76794,0,96794
142927701100000,NW 311,RESIDENTIAL,20000,0,20000,68268,0,88268
142927701200000,NW 311,RESIDENTIAL,20000,0,20000,77041,0,97041
142927701300000,NW 311,RESIDENTIAL,20450,0,20450,62826,0,83276
142927701400000,SR/NURSING/ASSTD LIV,COMMERCIAL,0,68040,68040,0,1219516,1287556
142927701500000,NW 311,RESIDENTIAL,15667,0,15667,47193,0,62860
142927701600000,NW 311,RESIDENTIAL,12000,0,12000,47595,0,59595
142927701700000,NW 311,RESIDENTIAL,20000,0,20000,69965,0,89965
142927701800000,NW 311,RESIDENTIAL,21600,0,21600,79789,0,101389
142927701900000,NW 311,RESIDENTIAL,18045,0,18045,67215,0,85260
142927702000000,NW 311,RESIDENTIAL,16281,0,16281,57013,0,73294
142927702100000,NW 311,RESIDENTIAL,16281,0,16281,98004,0,114285
142927702200000,NW 311,RESIDENTIAL,16281,0,16281,85526,0,101807
142927702300000,NW 311,RESIDENTIAL,16116,0,16116,66825,0,82941
142927702400000,NW 311,RESIDENTIAL,16116,0,16116,66358,0,82474
142927702500000,NW 311,RESIDENTIAL,14000,0,14000,65346,0,79346
142927800100000,NW 320,RESIDENTIAL,16000,0,16000,73782,0,89782
142927800200000,NW 320,RESIDENTIAL,16000,0,16000,70782,0,86782
142927800300000,NW 320,RESIDENTIAL,16000,0,16000,62385,0,78385
142927800400000,NW 320,RESIDENTIAL,16000,0,16000,39745,0,55745
142927800500000,NW 320,RESIDENTIAL,16000,0,16000,44428,0,60428
142927800600000,NW 320,RESIDENTIAL,16000,0,16000,80774,0,96774
142927800700000,NW 320,RESIDENTIAL,16000,0,16000,51231,0,67231
142927800800000,NW 320,RESIDENTIAL,16000,0,16000,78665,0,94665
142927800900000,NW 320,RESIDENTIAL,16000,0,16000,69573,0,85573
142927801000000,NW 320,RESIDENTIAL,16000,0,16000,53599,0,69599
142927801100000,NW 320,RESIDENTIAL,16000,0,16000,59708,0,75708
142927801200000,NW 320,RESIDENTIAL,14000,0,14000,57249,0,71249
142927801300000,NW 320,RESIDENTIAL,16000,0,16000,56122,0,72122
142927801400000,NW 320,RESIDENTIAL,13552,0,13552,83585,0,97137
142927801500000,NW 320,RESIDENTIAL,15272,0,15272,82218,0,97490
142927801600000,NW 320,RESIDENTIAL,10200,0,10200,59535,0,69735
142927900100000,NW 320,RESIDENTIAL,22400,0,22400,101689,0,124089
142927900200000,NW 320,RESIDENTIAL,16000,0,16000,60049,0,76049
142927900300000,NW 320,RESIDENTIAL,16000,0,16000,55979,0,71979
142927900400000,NW 320,RESIDENTIAL,16000,0,16000,68397,0,84397
142927900500000,NW 320,RESIDENTIAL,16000,0,16000,80947,0,96947
142927900600000,NW 320,RESIDENTIAL,16000,0,16000,70267,0,86267
142927900700000,NW 320,RESIDENTIAL,16000,0,16000,62453,0,78453
142927900800000,NW 320,RESIDENTIAL,16000,0,16000,80871,0,96871
142927900900000,NW 320,RESIDENTIAL,16000,0,16000,67322,0,83322
142927901000000,NW 320,RESIDENTIAL,16000,0,16000,89171,0,105171
142927901100000,NW 320,RESIDENTIAL,15600,0,15600,54354,0,69954
142927901200000,NW 320,RESIDENTIAL,14400,0,14400,57129,0,71529
142927901300000,NW 320,RESIDENTIAL,16000,0,16000,63032,0,79032
142927901400000,NW 320,RESIDENTIAL,11200,0,11200,51648,0,62848
142927901500000,NW 320,RESIDENTIAL,11200,0,11200,60801,0,72001
142927901600000,NW 320,RESIDENTIAL,16000,0,16000,72736,0,88736
142927901700000,NW 320,RESIDENTIAL,16000,0,16000,81281,0,97281
142927901800000,NW 320,RESIDENTIAL,16000,0,16000,78297,0,94297
142927901900000,NW 320,RESIDENTIAL,14000,0,14000,80856,0,94856
142927902000000,NW 320,RESIDENTIAL,16000,0,16000,83540,0,99540
142927902100000,NW 320,RESIDENTIAL,16000,0,16000,83251,0,99251
142927902200000,NW 320,RESIDENTIAL,16000,0,16000,75031,0,91031
142927902300000,NW 320,RESIDENTIAL,16000,0,16000,80141,0,96141
142927902400000,NW 320,RESIDENTIAL,16000,0,16000,86590,0,102590
142927902500000,NW 320,RESIDENTIAL,16000,0,16000,67000,0,83000
142927902600000,NW 320,RESIDENTIAL,16000,0,16000,103999,0,119999
142927902700000,NW 320,RESIDENTIAL,16000,0,16000,42858,0,58858
142927902800000,NW 320,RESIDENTIAL,16000,0,16000,88482,0,104482
142927902900000,NW 320,RESIDENTIAL,16000,0,16000,64026,0,80026
142927903000000,NW 320,RESIDENTIAL,16000,0,16000,93251,0,109251
142928000100000,NW 320,RESIDENTIAL,16649,0,16649,43975,0,60624
142928000200000,NW 320,RESIDENTIAL,18156,0,18156,95276,0,113432
142928000300000,NW 320,RESIDENTIAL,15520,0,15520,80077,0,95597
142928000400000,NW 320,RESIDENTIAL,16000,0,16000,51964,0,67964
142928000500000,NW 320,RESIDENTIAL,16000,0,16000,89641,0,105641
142928000600000,NW 320,RESIDENTIAL,16000,0,16000,107375,0,123375
142928000700000,NW 320,RESIDENTIAL,16000,0,16000,88221,0,104221
142928000800000,NW 320,RESIDENTIAL,16000,0,16000,80379,0,96379
142928000900000,NW 320,RESIDENTIAL,16000,0,16000,59659,0,75659
142928001000000,NW 320,RESIDENTIAL,16000,0,16000,69181,0,85181
142928001100000,NW 320,RESIDENTIAL,22500,0,22500,110851,0,133351
142928001200000,NW 320,RESIDENTIAL,13600,0,13600,56582,0,70182
142928001300000,NW 320,RESIDENTIAL,16920,0,16920,82770,0,99690
142928001400000,NW 320,RESIDENTIAL,14288,0,14288,33695,0,47983
142928001500000,NW 320,RESIDENTIAL,18400,0,18400,103210,0,121610
142928001600000,NW 320,RESIDENTIAL,18000,0,18000,78455,0,96455
142928001700000,NW 320,RESIDENTIAL,18000,0,18000,99884,0,117884
142928001800000,NW 320,RESIDENTIAL,18000,0,18000,102276,0,120276
142928001900000,NW 320,RESIDENTIAL,18000,0,18000,101676,0,119676
142928002000000,NW 320,RESIDENTIAL,13335,0,13335,66543,0,79878
142928002100000,NW 320,RESIDENTIAL,13335,0,13335,78618,0,91953
142928002200000,NW 320,RESIDENTIAL,13335,0,13335,74685,0,88020
142928002300000,NW 320,RESIDENTIAL,16000,0,16000,71053,0,87053
142928002400000,NW 320,RESIDENTIAL,22027,0,22027,92957,0,114984
142928002500000,NW 320,RESIDENTIAL,18000,0,18000,82232,0,100232
142928002600000,NW 320,RESIDENTIAL,18000,0,18000,80204,0,98204
142928002700000,NW 320,RESIDENTIAL,20000,0,20000,128342,0,148342
142928002800000,NW 320,RESIDENTIAL,18000,0,18000,98104,0,116104
142928100100000,NW 311,RESIDENTIAL,20400,0,20400,76444,0,96844
142928100200000,NW 311,RESIDENTIAL,17600,0,17600,57795,0,75395
142928100300000,NW 311,RESIDENTIAL,17600,0,17600,131537,0,149137
142928100400000,NW 311,RESIDENTIAL,17600,0,17600,70732,0,88332
142928100500000,NW 311,RESIDENTIAL,24480,0,24480,129758,0,154238
142928100600000,NW 311,RESIDENTIAL,20400,0,20400,87856,0,108256
142928200100000,NW 311,RESIDENTIAL,17600,0,17600,78997,0,96597
142928200200000,NW 311,RESIDENTIAL,20400,0,20400,69174,0,89574
142928200300000,NW 311,RESIDENTIAL,16000,0,16000,64833,0,80833
142928200400000,NW 311,RESIDENTIAL,12000,0,12000,63539,0,75539
142928200500000,NW 311,RESIDENTIAL,10640,0,10640,57943,0,68583
142928200600000,NW 311,RESIDENTIAL,10640,0,10640,67111,0,77751
142928200700000,NW 311,RESIDENTIAL,21280,0,21280,80333,0,101613
142928200800000,NW 311,RESIDENTIAL,20400,0,20400,132573,0,152973
142928200900000,NW 311,RESIDENTIAL,20400,0,20400,105680,0,126080
142928201000000,NW 311,RESIDENTIAL,20400,0,20400,73773,0,94173
142928201100000,CONVERSION,COMMERCIAL,0,15139,15139,0,101986,117125
142928201200000,NW 311,RESIDENTIAL,16320,0,16320,85555,0,101875
142928201300000,NW 311,RESIDENTIAL,17600,0,17600,79498,0,97098
142928201400000,NW 311,RESIDENTIAL,17600,0,17600,79942,0,97542
142928300100000,NW 320,RESIDENTIAL,24000,0,24000,60246,0,84246
142928300200000,NW 320,RESIDENTIAL,16000,0,16000,75964,0,91964
142928300300000,NW 320,RESIDENTIAL,20000,0,20000,102344,0,122344
142928300400000,NW 320,RESIDENTIAL,20000,0,20000,109078,0,129078
142928300500000,NW 320,RESIDENTIAL,20000,0,20000,96419,0,116419
142928300600000,NW 320,RESIDENTIAL,9240,0,9240,62364,0,71604
142928300700000,NW 320,RESIDENTIAL,10223,0,10223,44001,0,54224
142928300800000,NW 320,RESIDENTIAL,11900,0,11900,49482,0,61382
142928300900000,NW 320,RESIDENTIAL,11760,0,11760,46193,0,57953
142928301000000,NW 320,RESIDENTIAL,6480,0,6480,53129,0,59609
142928301100000,NW 320,RESIDENTIAL,6480,0,6480,45965,0,52445
142928301200000,NW 320,RESIDENTIAL,15200,0,15200,66006,0,81206
142928301300000,NW 320,RESIDENTIAL,27588,0,27588,85136,0,112724
142928301400000,NW 320,RESIDENTIAL,20000,0,20000,95317,0,115317
142928301500000,CONVERSION,COMMERCIAL,0,11340,11340,0,71375,82715
142928301600000,NW 320,RESIDENTIAL,20000,0,20000,105072,0,125072
142928301700000,NW 320,RESIDENTIAL,24800,0,24800,129495,0,154295
142928301800000,CONVERSION,COMMERCIAL,0,14968,14968,0,110437,125405
142928400100000,NW 320,RESIDENTIAL,24000,0,24000,112976,0,136976
142928400200000,NW 320,RESIDENTIAL,18000,0,18000,91303,0,109303
142928400300000,NW 320,RESIDENTIAL,18000,0,18000,75325,0,93325
142928400400000,NW 320,RESIDENTIAL,18000,0,18000,76087,0,94087
142928400500000,NW 320,RESIDENTIAL,18000,0,18000,72490,0,90490
142928400600000,NW 320,RESIDENTIAL,11872,0,11872,71479,0,83351
142928400700000,NW 320,RESIDENTIAL,17792,0,17792,73581,0,91373
142928400800000,NW 320,RESIDENTIAL,10640,0,10640,64675,0,75315
142928401200000,NW 320,RESIDENTIAL,13860,0,13860,67804,0,81664
142928401300000,NW 320,RESIDENTIAL,14000,0,14000,60787,0,74787
142928401400000,NW 320,RESIDENTIAL,18000,0,18000,77519,0,95519
142928401500000,NW 320,RESIDENTIAL,18000,0,18000,68207,0,86207
142928401600000,NW 320,RESIDENTIAL,18000,0,18000,77549,0,95549
142928401700000,NW 320,RESIDENTIAL,16600,0,16600,43702,0,60302
142928401800000,NW 320,RESIDENTIAL,10800,0,10800,57847,0,68647
142928401900000,NW 320,RESIDENTIAL,17388,0,17388,57219,0,74607
142928500100000,NW 311,RESIDENTIAL,20000,0,20000,88623,0,108623
142928500200000,FUNERAL HOME,COMMERCIAL,0,187875,187875,0,391395,579270
142928500300000,CITY PROPERTY,EXEMPT,0,0,0,0,0,0
142930100100000,CHURCH,EXEMPT,0,14580,14580,0,5332,19912
142930100200000,SW 404,RESIDENTIAL,15480,0,15480,60879,0,76359
142930100300000,SW 404,RESIDENTIAL,15790,0,15790,61663,0,77453
142930100400000,CHURCH,EXEMPT,0,22005,22005,0,3900,25905
142930100500000,SW 404,RESIDENTIAL,21038,0,21038,62639,0,83677
142930100600000,SW 404,RESIDENTIAL,18934,0,18934,53710,0,72644
142930100700000,SW 404,RESIDENTIAL,20406,0,20406,61820,0,82226
142930101000000,SW 404,RESIDENTIAL,21879,0,21879,58921,0,80800
142930101100000,SW 404,RESIDENTIAL,22070,0,22070,68823,0,90893
142930101200000,SW 404,RESIDENTIAL,19635,0,19635,56852,0,76487
142930101300000,SW 404,RESIDENTIAL,17850,0,17850,72027,0,89877
142930101400000,SW 404,RESIDENTIAL,18934,0,18934,58300,0,77234
142930101500000,SW 404,RESIDENTIAL,21332,0,21332,73248,0,94580
142930200100000,SW 404,RESIDENTIAL,18176,0,18176,97790,0,115966
142930200200000,SW 404,RESIDENTIAL,17820,0,17820,82430,0,100250
142930200300000,SW 404,RESIDENTIAL,17820,0,17820,107045,0,124865
142930200400000,SW 404,RESIDENTIAL,23364,0,23364,67454,0,90818
142930200500000,SW 404,RESIDENTIAL,18880,0,18880,110817,0,129697
142930200600000,SW 404,RESIDENTIAL,18880,0,18880,106214,0,125094
142930200700000,SW 404,RESIDENTIAL,18880,0,18880,104932,0,123812
142930200900000,SW 404,RESIDENTIAL,20400,0,20400,78614,0,99014
142930201000000,CHURCH,EXEMPT,0,21840,21840,0,0,21840
142930201100000,SW 404,RESIDENTIAL,19763,0,19763,69786,0,89549
142930201200000,SW 404,RESIDENTIAL,23562,0,23562,55137,0,78699
142930201300000,SW 404,RESIDENTIAL,16830,0,16830,62611,0,79441
142930201400000,SW 404,RESIDENTIAL,21038,0,21038,65497,0,86535
142930201500000,CONVERSION,COMMERCIAL,0,15989,15989,0,59955,75944
142930201600000,SW 404,RESIDENTIAL,1758,0,1758,3179,0,4937
142930300100000,CHURCH,EXEMPT,0,3375,3375,0,0,3375
142930300200000,CHURCH,EXEMPT,0,193050,193050,0,867127,1060177
142930300300000,SW 404,RESIDENTIAL,23100,0,23100,108777,0,131877
142930300400000,SW 404,RESIDENTIAL,22620,0,22620,15294,0,37914
142930300600000,SW 404,RESIDENTIAL,18800,0,18800,103704,0,122504
142930300700000,SW 404,RESIDENTIAL,22320,0,22320,99953,0,122273
142930300800000,SW 404,RESIDENTIAL,22491,0,22491,74841,0,97332
142930300900000,SW 404,RESIDENTIAL,22491,0,22491,89312,0,111803
142930301100000,APARTMENT,COMMERCIAL,0,18810,18810,0,119965,138775
142930400100000,SW 404,RESIDENTIAL,20196,0,20196,68954,0,89150
142930400200000,SW 404,RESIDENTIAL,20196,0,20196,72583,0,92779
142930400300000,SW 404,RESIDENTIAL,20196,0,20196,70568,0,90764
142930400400000,SW 404,RESIDENTIAL,20196,0,20196,90234,0,110430
142930400500000,SW 404,RESIDENTIAL,16830,0,16830,62572,0,79402
142930400600000,SW 404,RESIDENTIAL,16830,0,16830,74146,0,90976
142930400700000,CHURCH,EXEMPT,0,87739,87739,0,0,87739
142930500100000,SCHOOL,EXEMPT,0,272592,272592,0,1175415,1448007
142930500200000,SW 404,RESIDENTIAL,26136,0,26136,85472,0,111608
142930500300000,SW 404,RESIDENTIAL,24839,0,24839,125712,0,150551
142930500400000,SW 404,RESIDENTIAL,20304,0,20304,73224,0,93528
142930500500000,SW 404,RESIDENTIAL,20304,0,20304,72488,0,92792
142930500600000,SW 404,RESIDENTIAL,24365,0,24365,83436,0,107801
142930500700000,SW 404,RESIDENTIAL,20304,0,20304,90898,0,111202
142930500800000,SW 404,RESIDENTIAL,26750,0,26750,66352,0,93102
142930500900000,SW 404,RESIDENTIAL,26136,0,26136,108057,0,134193
142930600100000,CITY PROPERTY,EXEMPT,0,0,0,0,0,0
142932600100000,CITY PROPERTY,EXEMPT,0,0,0,0,0,0
142932600200000,SW 405,RESIDENTIAL,20221,0,20221,87340,0,107561
142932600300000,SW 405,RESIDENTIAL,20583,0,20583,115026,0,135609
142932600400000,SW 405,RESIDENTIAL,17928,0,17928,75587,0,93515
142932600500000,SW 405,RESIDENTIAL,17136,0,17136,84702,0,101838
142932600600000,SW 405,RESIDENTIAL,17136,0,17136,83677,0,100813
142932600700000,SW 405,RESIDENTIAL,17136,0,17136,105587,0,122723
142932600800000,SW 405,RESIDENTIAL,17136,0,17136,91525,0,108661
142932600900000,SW 405,RESIDENTIAL,17136,0,17136,69550,0,86686
142932601000000,SW 405,RESIDENTIAL,16320,0,16320,69100,0,85420
142932601100000,SW 405,RESIDENTIAL,16320,0,16320,67245,0,83565
142932601200000,SW 405,RESIDENTIAL,16320,0,16320,71367,0,87687
142932601300000,SW 405,RESIDENTIAL,16320,0,16320,67586,0,83906
142932601400000,SW 405,RESIDENTIAL,16320,0,16320,65064,0,81384
142932601500000,SW 405,RESIDENTIAL,18217,0,18217,121807,0,140024
142932700100000,SW 405,RESIDENTIAL,17503,0,17503,123845,0,141348
142932700200000,SW 405,RESIDENTIAL,19400,0,19400,125563,0,144963
142932700300000,SW 405,RESIDENTIAL,19400,0,19400,67809,0,87209
142932700400000,SW 405,RESIDENTIAL,19400,0,19400,62553,0,81953
142932700500000,SW 405,RESIDENTIAL,19400,0,19400,55867,0,75267
142932700600000,SW 405,RESIDENTIAL,23292,0,23292,98940,0,122232
142932700700000,SW 405,RESIDENTIAL,21347,0,21347,79779,0,101126
142932700800000,SW 405,RESIDENTIAL,20517,0,20517,74824,0,95341
142932700900000,SW 405,RESIDENTIAL,20000,0,20000,71334,0,91334
142932701000000,SW 405,RESIDENTIAL,19600,0,19600,66035,0,85635
142932701100000,SW 405,RESIDENTIAL,19400,0,19400,76377,0,95777
142932701200000,SW 405,RESIDENTIAL,19400,0,19400,83205,0,102605
142932701300000,SW 405,RESIDENTIAL,19400,0,19400,75498,0,94898
142932701400000,SW 405,RESIDENTIAL,19400,0,19400,68945,0,88345
142932701500000,SW 405,RESIDENTIAL,19646,0,19646,80259,0,99905
142932701600000,SW 405,RESIDENTIAL,18217,0,18217,83792,0,102009
142932701700000,SW 405,RESIDENTIAL,16320,0,16320,73614,0,89934
142932701800000,SW 405,RESIDENTIAL,16320,0,16320,73589,0,89909
142932701900000,SW 405,RESIDENTIAL,16320,0,16320,95136,0,111456
142932702000000,SW 405,RESIDENTIAL,16320,0,16320,79709,0,96029
142932702100000,SW 405,RESIDENTIAL,16320,0,16320,107229,0,123549
142932702200000,SW 405,RESIDENTIAL,17136,0,17136,97083,0,114219
142932702300000,SW 405,RESIDENTIAL,17136,0,17136,82891,0,100027
142932702400000,SW 405,RESIDENTIAL,17136,0,17136,62905,0,80041
142932702500000,SW 405,RESIDENTIAL,17136,0,17136,79896,0,97032
142932702600000,SW 405,RESIDENTIAL,17136,0,17136,75973,0,93109
142932702700000,SW 405,RESIDENTIAL,18360,0,18360,91464,0,109824
142932800100000,SW 405,RESIDENTIAL,23598,0,23598,70392,0,93990
142932900100000,SW 405,RESIDENTIAL,20460,0,20460,76066,0,96526
142932900200000,SW 405,RESIDENTIAL,19788,0,19788,97252,0,117040
142932900300000,SW 405,RESIDENTIAL,21248,0,21248,92683,0,113931
142932900400000,SW 405,RESIDENTIAL,19400,0,19400,68976,0,88376
142932900500000,SW 405,RESIDENTIAL,19600,0,19600,84148,0,103748
142932900600000,SW 405,RESIDENTIAL,19352,0,19352,71034,0,90386
142933000100000,SW 405,RESIDENTIAL,26160,0,26160,104782,0,130942
142933000200000,SW 405,RESIDENTIAL,28362,0,28362,128160,0,156522
142933000300000,SW 405,RESIDENTIAL,28499,0,28499,113857,0,142356
142933000400000,SW 405,RESIDENTIAL,25792,0,25792,106405,0,132197
142933000500000,SW 405,RESIDENTIAL,19454,0,19454,92877,0,112331
142933000600000,SW 405,RESIDENTIAL,27851,0,27851,106795,0,134646
142933000700000,SW 405,RESIDENTIAL,17626,0,17626,56442,0,74068
142933000800000,SW 405,RESIDENTIAL,17136,0,17136,78436,0,95572
142933000900000,SW 405,RESIDENTIAL,17136,0,17136,66917,0,84053
142933001000000,SW 405,RESIDENTIAL,23338,0,23338,106233,0,129571
142933001100000,SW 405,RESIDENTIAL,17952,0,17952,75352,0,93304
142933001200000,SW 405,RESIDENTIAL,20680,0,20680,84631,0,105311
142933001300000,SW 405,RESIDENTIAL,21056,0,21056,110428,0,131484
142933001400000,SW 405,RESIDENTIAL,23280,0,23280,92844,0,116124
142933001500000,SW 405,RESIDENTIAL,23280,0,23280,82097,0,105377
142933001600000,SW 405,RESIDENTIAL,21922,0,21922,77899,0,99821
142933001700000,SW 405,RESIDENTIAL,21922,0,21922,92906,0,114828
142933001800000,SW 405,RESIDENTIAL,23280,0,23280,113269,0,136549
142933001900000,SW 405,RESIDENTIAL,20295,0,20295,105107,0,125402
142933002000000,SW 405,RESIDENTIAL,25300,0,25300,103957,0,129257
142933002100000,SW 405,RESIDENTIAL,22320,0,22320,100080,0,122400
142933002200000,SW 405,RESIDENTIAL,23280,0,23280,74597,0,97877
142933002300000,SW 405,RESIDENTIAL,26160,0,26160,93670,0,119830
142933100100000,SW 405,RESIDENTIAL,15136,0,15136,72871,0,88007
142933100200000,SW 405,RESIDENTIAL,17680,0,17680,76930,0,94610
142933100300000,SW 405,RESIDENTIAL,20604,0,20604,68195,0,88799
142933100400000,SW 405,RESIDENTIAL,20604,0,20604,66491,0,87095
142933100500000,SW 405,RESIDENTIAL,20792,0,20792,82648,0,103440
142933100600000,SW 405,RESIDENTIAL,21379,0,21379,94562,0,115941
142933100700000,SW 405,RESIDENTIAL,21379,0,21379,82894,0,104273
142933100800000,SW 405,RESIDENTIAL,21845,0,21845,109705,0,131550
142933100900000,SW 405,RESIDENTIAL,21599,0,21599,94794,0,116393
142933101000000,SW 405,RESIDENTIAL,21820,0,21820,88565,0,110385
142933101100000,SW 405,RESIDENTIAL,21820,0,21820,86124,0,107944
142933101200000,SW 405,RESIDENTIAL,21782,0,21782,101210,0,122992
142933101300000,SW 405,RESIDENTIAL,19440,0,19440,65439,0,84879
142933101500000,SW 405,RESIDENTIAL,23599,0,23599,121457,0,145056
142933101600000,SW 405,RESIDENTIAL,16320,0,16320,65924,0,82244
142933101700000,SW 405,RESIDENTIAL,16320,0,16320,61782,0,78102
142933101800000,SW 405,RESIDENTIAL,17952,0,17952,76558,0,94510
142933101900000,SW 405,RESIDENTIAL,17952,0,17952,78055,0,96007
142933102200000,SW 405,RESIDENTIAL,23338,0,23338,73827,0,97165
142933102300000,SW 405,RESIDENTIAL,17952,0,17952,82206,0,100158
142933102400000,SW 405,RESIDENTIAL,15136,0,15136,71526,0,86662
142933102500000,SW 405,RESIDENTIAL,26928,0,26928,92202,0,119130
142933200100000,SW 405,RESIDENTIAL,22382,0,22382,78162,0,100544
142933200200000,SW 405,RESIDENTIAL,22220,0,22220,89692,0,111912
142933200300000,SW 405,RESIDENTIAL,20533,0,20533,85827,0,106360
142933200400000,SW 405,RESIDENTIAL,21170,0,21170,64564,0,85734
142933300100000,SW 405,RESIDENTIAL,23980,0,23980,92694,0,116674
142933300200000,SW 405,RESIDENTIAL,24128,0,24128,76718,0,100846
142933300300000,SW 405,RESIDENTIAL,24752,0,24752,92080,0,116832
142933300400000,SW 405,RESIDENTIAL,24752,0,24752,100276,0,125028
142933300500000,SW 405,RESIDENTIAL,24960,0,24960,94334,0,119294
142933300600000,SW 405,RESIDENTIAL,24960,0,24960,72811,0,97771
142933300700000,SW 405,RESIDENTIAL,24960,0,24960,80449,0,105409
142933300800000,SW 405,RESIDENTIAL,24150,0,24150,75754,0,99904
142933300900000,SW 405,RESIDENTIAL,12444,0,12444,74251,0,86695
142933301000000,SW 405,RESIDENTIAL,12444,0,12444,62984,0,75428
142933301100000,SW 405,RESIDENTIAL,20502,0,20502,68440,0,88942
142933301200000,SW 405,RESIDENTIAL,16320,0,16320,68759,0,85079
142933301300000,SW 405,RESIDENTIAL,18360,0,18360,109184,0,127544
142933301400000,SW 405,RESIDENTIAL,19421,0,19421,108898,0,128319
142933301500000,SW 405,RESIDENTIAL,19074,0,19074,85658,0,104732
142933301600000,SW 405,RESIDENTIAL,21429,0,21429,93769,0,115198
142933301700000,SW 405,RESIDENTIAL,21216,0,21216,81462,0,102678
142933301800000,SW 405,RESIDENTIAL,21216,0,21216,76929,0,98145
142933301900000,SW 405,RESIDENTIAL,21216,0,21216,73396,0,94612
142933302000000,SW 405,RESIDENTIAL,21216,0,21216,95047,0,116263
142933302100000,SW 405,RESIDENTIAL,21216,0,21216,81929,0,103145
142933302200000,SW 405,RESIDENTIAL,21216,0,21216,90443,0,111659
142933302300000,SW 405,RESIDENTIAL,20700,0,20700,98937,0,119637
142933302400000,SW 405,RESIDENTIAL,24595,0,24595,87129,0,111724
142933302500000,SW 405,RESIDENTIAL,23000,0,23000,99008,0,122008
142933302600000,SW 405,RESIDENTIAL,23980,0,23980,83726,0,107706
142933302700000,SW 405,RESIDENTIAL,21800,0,21800,91935,0,113735
142933400100000,SW 405,RESIDENTIAL,21155,0,21155,81974,0,103129
142933400200000,SW 405,RESIDENTIAL,20776,0,20776,100555,0,121331
142933400300000,SW 405,RESIDENTIAL,20776,0,20776,71932,0,92708
142933400400000,SW 405,RESIDENTIAL,20776,0,20776,88888,0,109664
142933400500000,SW 405,RESIDENTIAL,19592,0,19592,96998,0,116590
142935100100000,SW 405,RESIDENTIAL,21502,0,21502,50134,0,71636
142935100200000,SW 405,RESIDENTIAL,18200,0,18200,57523,0,75723
142935100300000,SW 405,RESIDENTIAL,19292,0,19292,52238,0,71530
142935100400000,SW 405,RESIDENTIAL,18200,0,18200,57943,0,76143
142935100500000,SW 405,RESIDENTIAL,19292,0,19292,60836,0,80128
142935100600000,SW 405,RESIDENTIAL,18200,0,18200,54394,0,72594
142935100700000,SW 405,RESIDENTIAL,19292,0,19292,63949,0,83241
142935100800000,SW 405,RESIDENTIAL,18200,0,18200,63113,0,81313
142935100900000,SW 405,RESIDENTIAL,19292,0,19292,66034,0,85326
142935101000000,SW 405,RESIDENTIAL,19716,0,19716,70809,0,90525
142935101100000,SW 405,RESIDENTIAL,20564,0,20564,57583,0,78147
142935101200000,SW 405,RESIDENTIAL,21412,0,21412,62286,0,83698
142935101300000,SW 405,RESIDENTIAL,19292,0,19292,58840,0,78132
142935101400000,SW 405,RESIDENTIAL,21594,0,21594,68035,0,89629
142935101500000,SW 405,RESIDENTIAL,20275,0,20275,58376,0,78651
142935101600000,SW 405,RESIDENTIAL,21168,0,21168,71491,0,92659
142935101700000,SW 405,RESIDENTIAL,21120,0,21120,76041,0,97161
142935101800000,SW 405,RESIDENTIAL,20434,0,20434,60242,0,80676
142935101900000,SW 405,RESIDENTIAL,19992,0,19992,91071,0,111063
142935102000000,SW 405,RESIDENTIAL,20888,0,20888,87490,0,108378
142935102100000,SW 405,RESIDENTIAL,20642,0,20642,60845,0,81487
142935102200000,SW 405,RESIDENTIAL,20626,0,20626,57390,0,78016
142935102300000,SW 405,RESIDENTIAL,20020,0,20020,58022,0,78042
142935102400000,SW 405,RESIDENTIAL,20020,0,20020,55384,0,75404
142935102500000,SW 405,RESIDENTIAL,20020,0,20020,58437,0,78457
142935102600000,SW 405,RESIDENTIAL,20020,0,20020,62938,0,82958
142935102700000,SW 405,RESIDENTIAL,20020,0,20020,54773,0,74793
142935102800000,SW 405,RESIDENTIAL,20657,0,20657,67115,0,87772
142935200100000,SW 405,RESIDENTIAL,20822,0,20822,72977,0,93799
142935200200000,SW 405,RESIDENTIAL,20680,0,20680,60138,0,80818
142935200300000,SW 405,RESIDENTIAL,20460,0,20460,58475,0,78935
142935200400000,SW 405,RESIDENTIAL,20871,0,20871,70055,0,90926
142935200500000,SW 405,RESIDENTIAL,20460,0,20460,63131,0,83591
142935200600000,SW 405,RESIDENTIAL,20196,0,20196,55739,0,75935
142935200700000,SW 405,RESIDENTIAL,20800,0,20800,56474,0,77274
142935200800000,SW 405,RESIDENTIAL,21186,0,21186,64697,0,85883
142935200900000,SW 405,RESIDENTIAL,20800,0,20800,54279,0,75079
142935201000000,SW 405,RESIDENTIAL,20240,0,20240,60054,0,80294
142935201100000,SW 405,RESIDENTIAL,21354,0,21354,65412,0,86766
142935201200000,SW 405,RESIDENTIAL,19947,0,19947,64475,0,84422
142935201300000,SW 405,RESIDENTIAL,21816,0,21816,54593,0,76409
142935201400000,SW 405,RESIDENTIAL,20489,0,20489,62998,0,83487
142935201500000,SW 405,RESIDENTIAL,23436,0,23436,54497,0,77933
142935201600000,SW 405,RESIDENTIAL,19689,0,19689,57983,0,77672
142935201700000,SW 405,RESIDENTIAL,20160,0,20160,63172,0,83332
142935201800000,SW 405,RESIDENTIAL,19968,0,19968,56283,0,76251
142935201900000,SW 405,RESIDENTIAL,20853,0,20853,60081,0,80934
142935300100000,SW 405,RESIDENTIAL,21082,0,21082,58653,0,79735
142935300200000,SW 405,RESIDENTIAL,19400,0,19400,58284,0,77684
142935300300000,SW 405,RESIDENTIAL,20564,0,20564,62317,0,82881
142935300400000,SW 405,RESIDENTIAL,19400,0,19400,56891,0,76291
142935300500000,SW 405,RESIDENTIAL,20564,0,20564,63284,0,83848
142935300600000,SW 405,RESIDENTIAL,19400,0,19400,59360,0,78760
142935300700000,SW 405,RESIDENTIAL,20564,0,20564,58214,0,78778
142935300800000,SW 405,RESIDENTIAL,19400,0,19400,58095,0,77495
142935300900000,SW 405,RESIDENTIAL,20952,0,20952,56458,0,77410
142935400100000,SW 405,RESIDENTIAL,22146,0,22146,59453,0,81599
142935400200000,SW 405,RESIDENTIAL,21120,0,21120,52492,0,73612
142935400300000,SW 405,RESIDENTIAL,21069,0,21069,57567,0,78636
142935400400000,SW 405,RESIDENTIAL,18800,0,18800,57302,0,76102
142935400500000,SW 405,RESIDENTIAL,19400,0,19400,78700,0,98100
142935400600000,SW 405,RESIDENTIAL,19400,0,19400,57526,0,76926
142935400700000,SW 405,RESIDENTIAL,21340,0,21340,60415,0,81755
142935400800000,SW 405,RESIDENTIAL,19400,0,19400,52467,0,71867
142935400900000,SW 405,RESIDENTIAL,19400,0,19400,59122,0,78522
142935401000000,SW 405,RESIDENTIAL,21340,0,21340,61697,0,83037
142935401100000,SW 405,RESIDENTIAL,19400,0,19400,89532,0,108932
142935401200000,SW 405,RESIDENTIAL,19400,0,19400,55814,0,75214
142935401300000,SW 405,RESIDENTIAL,18920,0,18920,73807,0,92727
142935401400000,SW 405,RESIDENTIAL,20762,0,20762,63585,0,84347
142935401500000,SW 405,RESIDENTIAL,21120,0,21120,58847,0,79967
142935401600000,SW 405,RESIDENTIAL,20515,0,20515,55034,0,75549
142935401700000,SW 405,RESIDENTIAL,18800,0,18800,64611,0,83411
142935401800000,SW 405,RESIDENTIAL,19400,0,19400,57020,0,76420
142935401900000,SW 405,RESIDENTIAL,19400,0,19400,68107,0,87507
142935402000000,SW 405,RESIDENTIAL,21340,0,21340,67630,0,88970
142935402100000,SW 405,RESIDENTIAL,19400,0,19400,59909,0,79309
142935402200000,SW 405,RESIDENTIAL,19400,0,19400,54706,0,74106
142935402300000,SW 405,RESIDENTIAL,21340,0,21340,67005,0,88345
142935402400000,SW 405,RESIDENTIAL,19400,0,19400,64102,0,83502
142935402500000,SW 405,RESIDENTIAL,19400,0,19400,62770,0,82170
142935402600000,SW 405,RESIDENTIAL,18920,0,18920,40382,0,59302
142935500100000,SW 405,RESIDENTIAL,22699,0,22699,64991,0,87690
142935500200000,SW 405,RESIDENTIAL,20400,0,20400,62433,0,82833
142935500300000,SW 405,RESIDENTIAL,19910,0,19910,82205,0,102115
142935500400000,SW 405,RESIDENTIAL,21766,0,21766,77600,0,99366
142935500500000,SW 405,RESIDENTIAL,20577,0,20577,57620,0,78197
142935500600000,SW 405,RESIDENTIAL,20564,0,20564,76387,0,96951
142935500700000,SW 405,RESIDENTIAL,20776,0,20776,76260,0,97036
142935500800000,SW 405,RESIDENTIAL,20792,0,20792,62289,0,83081
142935500900000,SW 405,RESIDENTIAL,21516,0,21516,56728,0,78244
142935501000000,SW 405,RESIDENTIAL,21333,0,21333,63190,0,84523
142935501100000,SW 405,RESIDENTIAL,20907,0,20907,58380,0,79287
142935501200000,SW 405,RESIDENTIAL,20480,0,20480,50576,0,71056
142935501300000,SW 405,RESIDENTIAL,20141,0,20141,52896,0,73037
142935501400000,SW 405,RESIDENTIAL,21120,0,21120,66855,0,87975
142935501500000,SW 405,RESIDENTIAL,18800,0,18800,80449,0,99249
142935501600000,SW 405,RESIDENTIAL,21466,0,21466,74966,0,96432
142935501700000,SW 405,RESIDENTIAL,19372,0,19372,107664,0,127036
142935501800000,SW 405,RESIDENTIAL,20836,0,20836,53166,0,74002
142935501900000,SW 405,RESIDENTIAL,20137,0,20137,62875,0,83012
142935502000000,SW 405,RESIDENTIAL,20045,0,20045,63047,0,83092
142935502100000,SW 405,RESIDENTIAL,20519,0,20519,62035,0,82554
142935502200000,SW 405,RESIDENTIAL,20854,0,20854,57200,0,78054
142935502300000,SW 405,RESIDENTIAL,21560,0,21560,66397,0,87957
142935502400000,SW 405,RESIDENTIAL,21987,0,21987,58672,0,80659
142935502500000,SW 405,RESIDENTIAL,20096,0,20096,61713,0,81809
142935502600000,SW 405,RESIDENTIAL,19988,0,19988,55394,0,75382
142935502700000,SW 405,RESIDENTIAL,21307,0,21307,54889,0,76196
142935502800000,SW 405,RESIDENTIAL,21197,0,21197,76895,0,98092
142935502900000,SW 405,RESIDENTIAL,23840,0,23840,57414,0,81254
142935503000000,SW 405,RESIDENTIAL,20304,0,20304,57226,0,77530
142935600100000,SW 405,RESIDENTIAL,20952,0,20952,88364,0,109316
142935600200000,SW 405,RESIDENTIAL,19400,0,19400,73036,0,92436
142935600300000,SW 405,RESIDENTIAL,20176,0,20176,75024,0,95200
142935600400000,SW 405,RESIDENTIAL,20176,0,20176,70068,0,90244
142935600500000,SW 405,RESIDENTIAL,20176,0,20176,68296,0,88472
142935600600000,SW 405,RESIDENTIAL,20176,0,20176,68943,0,89119
142935600700000,SW 405,RESIDENTIAL,20176,0,20176,76441,0,96617
142935600800000,SW 405,RESIDENTIAL,19400,0,19400,71825,0,91225
142935600900000,SW 405,RESIDENTIAL,20952,0,20952,63552,0,84504
142935700100000,SW 405,RESIDENTIAL,21364,0,21364,71864,0,93228
142935700200000,SW 405,RESIDENTIAL,20651,0,20651,79573,0,100224
142935700300000,SW 405,RESIDENTIAL,20520,0,20520,59026,0,79546
142935700400000,SW 405,RESIDENTIAL,20064,0,20064,58036,0,78100
142935700500000,SW 405,RESIDENTIAL,20686,0,20686,70894,0,91580
142935700600000,SW 405,RESIDENTIAL,20774,0,20774,54771,0,75545
142935700700000,SW 405,RESIDENTIAL,19840,0,19840,49603,0,69443
142935700800000,SW 405,RESIDENTIAL,19220,0,19220,74113,0,93333
142935700900000,SW 405,RESIDENTIAL,18393,0,18393,69570,0,87963
142935701000000,SW 405,RESIDENTIAL,17980,0,17980,80093,0,98073
142935701100000,SW 405,RESIDENTIAL,17773,0,17773,74054,0,91827
142935701200000,SW 405,RESIDENTIAL,18393,0,18393,80573,0,98966
142935701300000,SW 405,RESIDENTIAL,19013,0,19013,77920,0,96933
142935701400000,SW 405,RESIDENTIAL,19840,0,19840,78419,0,98259
142935701500000,SW 405,RESIDENTIAL,22016,0,22016,85084,0,107100
142935701600000,SW 405,RESIDENTIAL,18200,0,18200,80195,0,98395
142935701700000,SW 405,RESIDENTIAL,22016,0,22016,74942,0,96958
142935701800000,SW 405,RESIDENTIAL,21360,0,21360,80558,0,101918
142935701900000,SW 405,RESIDENTIAL,21467,0,21467,75016,0,96483
142935702000000,SW 405,RESIDENTIAL,20767,0,20767,89393,0,110160
142935702100000,SW 405,RESIDENTIAL,20533,0,20533,74131,0,94664
142935702200000,SW 405,RESIDENTIAL,17773,0,17773,79270,0,97043
142935702300000,SW 405,RESIDENTIAL,17980,0,17980,80659,0,98639
142935702400000,SW 405,RESIDENTIAL,18807,0,18807,68895,0,87702
142935702500000,SW 405,RESIDENTIAL,19200,0,19200,69012,0,88212
142935702600000,SW 405,RESIDENTIAL,20000,0,20000,68343,0,88343
142935702700000,SW 405,RESIDENTIAL,20600,0,20600,70520,0,91120
142935702800000,SW 405,RESIDENTIAL,21000,0,21000,80236,0,101236
142935702900000,SW 405,RESIDENTIAL,19600,0,19600,73214,0,92814
142935703000000,SW 405,RESIDENTIAL,21362,0,21362,56710,0,78072
142935703100000,SW 405,RESIDENTIAL,20826,0,20826,82978,0,103804
142935703200000,SW 405,RESIDENTIAL,21000,0,21000,75646,0,96646
142935703300000,SW 405,RESIDENTIAL,19800,0,19800,76359,0,96159
142935703400000,SW 405,RESIDENTIAL,21120,0,21120,70704,0,91824
142935800100000,SW 405,RESIDENTIAL,21097,0,21097,68840,0,89937
142935800200000,SW 405,RESIDENTIAL,18800,0,18800,73136,0,91936
142935800300000,SW 405,RESIDENTIAL,20000,0,20000,69044,0,89044
142935800400000,SW 405,RESIDENTIAL,20000,0,20000,68662,0,88662
142935800500000,SW 405,RESIDENTIAL,20000,0,20000,74110,0,94110
142935800600000,SW 405,RESIDENTIAL,20000,0,20000,85799,0,105799
142935800700000,SW 405,RESIDENTIAL,20000,0,20000,73953,0,93953
142935800800000,SW 405,RESIDENTIAL,20000,0,20000,75847,0,95847
142935800900000,SW 405,RESIDENTIAL,19800,0,19800,68122,0,87922
142935801000000,SW 405,RESIDENTIAL,19800,0,19800,77695,0,97495
142935801100000,SW 405,RESIDENTIAL,19800,0,19800,68485,0,88285
142935801200000,SW 405,RESIDENTIAL,19800,0,19800,73628,0,93428
142935801300000,SW 405,RESIDENTIAL,19800,0,19800,86947,0,106747
142935801400000,SW 405,RESIDENTIAL,20885,0,20885,77323,0,98208
142935801500000,SW 405,RESIDENTIAL,25663,0,25663,83734,0,109397
142935801600000,SW 405,RESIDENTIAL,18200,0,18200,68717,0,86917
142935801700000,SW 405,RESIDENTIAL,21989,0,21989,63222,0,85211
142935801800000,SW 405,RESIDENTIAL,21867,0,21867,75111,0,96978
142935801900000,SW 405,RESIDENTIAL,19800,0,19800,76722,0,96522
142935802000000,SW 405,RESIDENTIAL,19800,0,19800,79808,0,99608
142935802100000,SW 405,RESIDENTIAL,19800,0,19800,68995,0,88795
142935802200000,SW 405,RESIDENTIAL,19800,0,19800,73649,0,93449
142935802300000,SW 405,RESIDENTIAL,19800,0,19800,64231,0,84031
142935802400000,SW 405,RESIDENTIAL,19800,0,19800,68729,0,88529
142935802500000,SW 405,RESIDENTIAL,19800,0,19800,76578,0,96378
142935802600000,SW 405,RESIDENTIAL,19800,0,19800,71337,0,91137
142935802700000,SW 405,RESIDENTIAL,19800,0,19800,69372,0,89172
142935802800000,SW 405,RESIDENTIAL,19800,0,19800,75658,0,95458
142935802900000,SW 405,RESIDENTIAL,19800,0,19800,78116,0,97916
142935803000000,SW 405,RESIDENTIAL,19000,0,19000,69106,0,88106
142935803100000,SW 405,RESIDENTIAL,20862,0,20862,105382,0,126244
142935803200000,SW 405,RESIDENTIAL,18768,0,18768,81282,0,100050
142935803300000,SW 405,RESIDENTIAL,18547,0,18547,72953,0,91500
142935900100000,SW 405,RESIDENTIAL,21922,0,21922,64205,0,86127
142935900200000,SW 405,RESIDENTIAL,20608,0,20608,57599,0,78207
142935900300000,SW 405,RESIDENTIAL,18800,0,18800,74121,0,92921
142935900400000,SW 405,RESIDENTIAL,19200,0,19200,71697,0,90897
142935900500000,SW 405,RESIDENTIAL,19400,0,19400,68333,0,87733
142935900600000,SW 405,RESIDENTIAL,19972,0,19972,63771,0,83743
142935900700000,SW 405,RESIDENTIAL,18800,0,18800,86320,0,105120
142936000100000,SW 405,RESIDENTIAL,20352,0,20352,72488,0,92840
142936000200000,SW 405,RESIDENTIAL,20564,0,20564,71206,0,91770
142936000300000,SW 405,RESIDENTIAL,20564,0,20564,69536,0,90100
142936000400000,SW 405,RESIDENTIAL,19904,0,19904,87440,0,107344
142937600100000,CITY PROPERTY,EXEMPT,0,0,0,0,0,0
142937600200000,SCHOOL,EXEMPT,0,0,0,0,0,0
142937600202000,ANTENNAS/TOWERS(BLL),COMMERCIAL,0,0,0,0,86448,86448
142937600300000,CITY PROPERTY,EXEMPT,0,0,0,0,0,0
142937700100000,WAREHOUSE,COMMERCIAL,0,133750,133750,0,439635,573385
142937700200000,WAREHOUSE,COMMERCIAL,0,113375,113375,0,532909,646284
142937700300000,FLAT PARKING,COMMERCIAL,0,16875,16875,0,10560,27435
142937700400000,SHOP,COMMERCIAL,0,74875,74875,0,469956,544831
142937700500000,FLAT PARKING,COMMERCIAL,0,13085,13085,0,8707,21792
142937700600000,SHOP,COMMERCIAL,0,47520,47520,0,193521,241041
142937700700000,SHOP,COMMERCIAL,0,32235,32235,0,102423,134658
142937800100000,CENTRALLY ASSESSED,OTHER,0,0,0,0,0,0
142940100100000,SCHOOL,EXEMPT,0,0,0,0,0,0
142940100200000,CITY PROPERTY,EXEMPT,0,0,0,0,0,0
142940200100000,SW 404,RESIDENTIAL,15000,0,15000,71812,0,86812
142940200200000,SW 404,RESIDENTIAL,15000,0,15000,0,0,15000
142940200300000,SW 404,RESIDENTIAL,15000,0,15000,55290,0,70290
142940200400000,SW 404,RESIDENTIAL,16200,0,16200,59397,0,75597
142940200500000,SW 404,RESIDENTIAL,12000,0,12000,63201,0,75201
142940200600000,SW 404,RESIDENTIAL,15375,0,15375,0,0,15375
142940200700000,SW 404,RESIDENTIAL,5000,0,5000,0,0,5000
142940200800000,SW 404,RESIDENTIAL,17531,0,17531,75695,0,93226
142940200900000,SW 404,RESIDENTIAL,13125,0,13125,73956,0,87081
142940201000000,SW 404,RESIDENTIAL,11250,0,11250,82091,0,93341
142940201100000,SW 404,RESIDENTIAL,11250,0,11250,50176,0,61426
142940201200000,SW 404,RESIDENTIAL,11250,0,11250,0,0,11250
142940201300000,SW 404,RESIDENTIAL,18000,0,18000,89843,0,107843
142940201400000,SW 404,RESIDENTIAL,12788,0,12788,76911,0,89699
142940201500000,SW 404,RESIDENTIAL,16200,0,16200,75365,0,91565
142940201600000,SW 404,RESIDENTIAL,18000,0,18000,0,0,18000
142940201700000,SW 404,RESIDENTIAL,15000,0,15000,79865,0,94865
142940201800000,SW 404,RESIDENTIAL,15000,0,15000,34722,0,49722
142940201900000,SW 404,RESIDENTIAL,18000,0,18000,74142,0,92142
142940300100000,SW 404,RESIDENTIAL,15300,0,15300,91808,0,107108
142940300200000,SW 404,RESIDENTIAL,15300,0,15300,67426,0,82726
142940300300000,CITY PROPERTY,EXEMPT,0,0,0,0,0,0
142940300400000,SW 404,RESIDENTIAL,16695,0,16695,59547,0,76242
142940300500000,SW 404,RESIDENTIAL,18022,0,18022,129200,0,147222
142940300600000,SW 404,RESIDENTIAL,16906,0,16906,128779,0,145685
142940300700000,SW 404,RESIDENTIAL,16906,0,16906,71766,0,88672
142940300800000,SW 404,RESIDENTIAL,16906,0,16906,74494,0,91400
142940300900000,SW 404,RESIDENTIAL,16906,0,16906,61357,0,78263
142940301000000,CONVERSION,COMMERCIAL,0,10561,10561,0,44215,54776
142940301100000,SW 404,RESIDENTIAL,15803,0,15803,39291,0,55094
142940301200000,SW 404,RESIDENTIAL,16524,0,16524,65109,0,81633
142940301300000,SW 404,RESIDENTIAL,17212,0,17212,64228,0,81440
142940301400000,SW 404,RESIDENTIAL,15876,0,15876,73747,0,89623
142940301500000,SW 404,RESIDENTIAL,16735,0,16735,79550,0,96285
142940400100000,CITY PROPERTY,EXEMPT,0,0,0,0,0,0
142940400200000,SW 404,RESIDENTIAL,9619,0,9619,51589,0,61208
142940400300000,SW 404,RESIDENTIAL,15384,0,15384,94539,0,109923
142940400400000,SW 404,RESIDENTIAL,16894,0,16894,58238,0,75132
142940400500000,SW 404,RESIDENTIAL,14250,0,14250,66101,0,80351
142940400600000,SW 404,RESIDENTIAL,13500,0,13500,31887,0,45387
142940400700000,SW 404,RESIDENTIAL,12750,0,12750,62184,0,74934
142940400800000,SW 404,RESIDENTIAL,13125,0,13125,56114,0,69239
142940400900000,SW 404,RESIDENTIAL,13230,0,13230,81771,0,95001
142940401000000,SMALL RETAIL,COMMERCIAL,0,72150,72150,0,165082,237232
142940401100000,SW 404,RESIDENTIAL,12000,0,12000,78530,0,90530
142940401200000,CITY PROPERTY,EXEMPT,0,0,0,0,0,0
142940401300000,SW 404,RESIDENTIAL,7950,0,7950,0,0,7950
142940500100000,SW 404,RESIDENTIAL,15840,0,15840,70959,0,86799
142940500200000,SW 404,RESIDENTIAL,9300,0,9300,60882,0,70182
142940500300000,SW 404,RESIDENTIAL,16281,0,16281,73156,0,89437
142940500400000,CITY PROPERTY,EXEMPT,0,0,0,0,0,0
142940500500000,SW 404,RESIDENTIAL,15000,0,15000,80100,0,95100
142940500600000,SW 404,RESIDENTIAL,16575,0,16575,85585,0,102160
142940500700000,SW 404,RESIDENTIAL,16894,0,16894,121074,0,137968
142940500800000,SW 404,RESIDENTIAL,12968,0,12968,75910,0,88878
142940500900000,CHURCH,EXEMPT,0,12879,12879,0,20561,33440
142940501000000,SW 404,RESIDENTIAL,18000,0,18000,56647,0,74647
142940501100000,SW 404,RESIDENTIAL,15525,0,15525,68571,0,84096
142940501200000,SW 404,RESIDENTIAL,15319,0,15319,0,0,15319
142940501300000,SW 404,RESIDENTIAL,13500,0,13500,0,0,13500
142940501400000,SW 404,RESIDENTIAL,13335,0,13335,67903,0,81238
142940600100000,SW 404,RESIDENTIAL,15225,0,15225,58780,0,74005
142940600200000,SW 404,RESIDENTIAL,11288,0,11288,61135,0,72423
142940600300000,SW 404,RESIDENTIAL,11288,0,11288,45568,0,56856
142940600400000,SW 404,RESIDENTIAL,8138,0,8138,62547,0,70685
142940600500000,SW 404,RESIDENTIAL,8138,0,8138,60553,0,68691
142940600600000,SW 404,RESIDENTIAL,7875,0,7875,60584,0,68459
142940600700000,SW 404,RESIDENTIAL,7875,0,7875,67269,0,75144
142940600800000,SW 404,RESIDENTIAL,15131,0,15131,50372,0,65503
142940600900000,SW 404,RESIDENTIAL,15750,0,15750,70151,0,85901
142940601000000,SW 404,RESIDENTIAL,15750,0,15750,71609,0,87359
142940601100000,SW 404,RESIDENTIAL,9842,0,9842,51138,0,60980
142940601200000,SW 404,RESIDENTIAL,8778,0,8778,45880,0,54658
142940601300000,SW 404,RESIDENTIAL,8778,0,8778,49314,0,58092
142940601400000,SW 404,RESIDENTIAL,9842,0,9842,49530,0,59372
142940601500000,SW 404,RESIDENTIAL,7595,0,7595,57626,0,65221
142940601600000,SW 404,RESIDENTIAL,5000,0,5000,0,0,5000
142940601700000,SW 404,RESIDENTIAL,7595,0,7595,45453,0,53048
142940601800000,SW 404,RESIDENTIAL,7595,0,7595,61657,0,69252
142940601900000,SW 404,RESIDENTIAL,13875,0,13875,72831,0,86706
142940602000000,SW 404,RESIDENTIAL,13125,0,13125,81786,0,94911
142940602100000,SW 404,RESIDENTIAL,13500,0,13500,86190,0,99690
142940602200000,SW 404,RESIDENTIAL,9975,0,9975,41072,0,51047
142940700500000,CITY PROPERTY,EXEMPT,0,0,0,0,0,0
142940700600000,SW 404,RESIDENTIAL,16200,0,16200,83670,0,99870
142940700700000,SW 404,RESIDENTIAL,13125,0,13125,83640,0,96765
142940701000000,CITY PROPERTY,EXEMPT,0,0,0,0,0,0
142940701100000,SW 404,RESIDENTIAL,12346,0,12346,63337,0,75683
142940701200000,NBHD SHOPPING CENTER,COMMERCIAL,0,142920,142920,0,326043,468963
142940701300000,SW 404,RESIDENTIAL,21375,0,21375,71642,0,93017
142940800100000,SW 404,RESIDENTIAL,18562,0,18562,59853,0,78415
142940800200000,SW 404,RESIDENTIAL,15225,0,15225,48662,0,63887
142940800300000,CITY PROPERTY,EXEMPT,0,0,0,0,0,0
142940800400000,SW 404,RESIDENTIAL,12180,0,12180,62597,0,74777
142940800500000,SW 404,RESIDENTIAL,12375,0,12375,74582,0,86957
142940800600000,SW 404,RESIDENTIAL,3713,0,3713,8086,0,11799
142940800700000,CITY PROPERTY,EXEMPT,0,0,0,0,0,0
142940800800000,CITY PROPERTY,EXEMPT,0,0,0,0,0,0
142940800900000,SW 404,RESIDENTIAL,14438,0,14438,80316,0,94754
142940801000000,SW 404,RESIDENTIAL,11550,0,11550,63515,0,75065
142940801100000,SW 404,RESIDENTIAL,11550,0,11550,79652,0,91202
142940801200000,SW 404,RESIDENTIAL,16894,0,16894,73925,0,90819
142940801300000,SW 404,RESIDENTIAL,16894,0,16894,76212,0,93106
142940801400000,SW 404,RESIDENTIAL,19500,0,19500,77258,0,96758
142940801500000,SW 404,RESIDENTIAL,15000,0,15000,58814,0,73814
142940900100000,SW 404,RESIDENTIAL,16894,0,16894,56026,0,72920
142940900200000,SW 404,RESIDENTIAL,8540,0,8540,55293,0,63833
142940900300000,SW 404,RESIDENTIAL,15988,0,15988,74556,0,90544
142940900400000,SW 404,RESIDENTIAL,12375,0,12375,66235,0,78610
142940900500000,SW 404,RESIDENTIAL,12750,0,12750,66578,0,79328
142940900600000,SW 404,RESIDENTIAL,12750,0,12750,74801,0,87551
142940900700000,SW 404,RESIDENTIAL,16894,0,16894,76902,0,93796
142940900800000,SW 404,RESIDENTIAL,16894,0,16894,53008,0,69902
142940900900000,SW 404,RESIDENTIAL,9619,0,9619,63914,0,73533
142940901000000,SW 404,RESIDENTIAL,8550,0,8550,71572,0,80122
142940901100000,SW 404,RESIDENTIAL,11726,0,11726,67750,0,79476
142940901200000,SW 404,RESIDENTIAL,15000,0,15000,64304,0,79304
142940901300000,SW 404,RESIDENTIAL,16894,0,16894,67605,0,84499
142940901400000,SW 404,RESIDENTIAL,5000,0,5000,0,0,5000
142940901500000,SW 404,RESIDENTIAL,12188,0,12188,75084,0,87272
142941000100000,CITY PROPERTY,EXEMPT,0,0,0,0,0,0
142941000200000,SW 404,RESIDENTIAL,9765,0,9765,58948,0,68713
142941000300000,SW 404,RESIDENTIAL,15835,0,15835,53699,0,69534
142941000400000,SW 404,RESIDENTIAL,16084,0,16084,81837,0,97921
142941000500000,SW 404,RESIDENTIAL,10,0,10,0,0,10
142941000600000,SW 404,RESIDENTIAL,14153,0,14153,80981,0,95134
142941000700000,SW 404,RESIDENTIAL,13770,0,13770,56520,0,70290
142941000800000,SW 404,RESIDENTIAL,15487,0,15487,48354,0,63841
142941000900000,SW 404,RESIDENTIAL,13388,0,13388,72329,0,85717
142941001000000,SW 404,RESIDENTIAL,13388,0,13388,61384,0,74772
142941001100000,SW 404,RESIDENTIAL,13770,0,13770,58482,0,72252
142941001200000,COUNTY PROPERTY,EXEMPT,0,0,0,0,0,0
142941001300000,SW 404,RESIDENTIAL,13388,0,13388,72090,0,85478
142941001400000,SW 404,RESIDENTIAL,13388,0,13388,66837,0,80225
142941001500000,SW 404,RESIDENTIAL,11475,0,11475,60430,0,71905
142941100100000,CITY PROPERTY,EXEMPT,0,0,0,0,0,0
142941100200000,SW 404,RESIDENTIAL,18900,0,18900,0,0,18900
142941100300000,SW 404,RESIDENTIAL,12320,0,12320,64522,0,76842
142941100400000,CITY PROPERTY,EXEMPT,0,0,0,0,0,0
142941100500000,CITY PROPERTY,EXEMPT,0,0,0,0,0,0
142941100600000,SW 404,RESIDENTIAL,12320,0,12320,65229,0,77549
142941100700000,SW 404,RESIDENTIAL,12800,0,12800,84223,0,97023
142941100800000,SW 404,RESIDENTIAL,12800,0,12800,66883,0,79683
142941100900000,SW 404,RESIDENTIAL,11700,0,11700,67463,0,79163
142941101000000,SW 404,RESIDENTIAL,11130,0,11130,61945,0,73075
142941200100000,SW 404,RESIDENTIAL,17952,0,17952,48316,0,66268
142941200200000,SW 404,RESIDENTIAL,9300,0,9300,74444,0,83744
142941200300000,SW 404,RESIDENTIAL,10917,0,10917,62906,0,73823
142941200400000,SW 404,RESIDENTIAL,11236,0,11236,60980,0,72216
142941200500000,SW 404,RESIDENTIAL,11236,0,11236,60993,0,72229
142941200600000,SW 404,RESIDENTIAL,11236,0,11236,58011,0,69247
142941200700000,SW 404,RESIDENTIAL,15000,0,15000,60007,0,75007
142941201000000,SW 404,RESIDENTIAL,17480,0,17480,43212,0,60692
142941201100000,SW 404,RESIDENTIAL,13260,0,13260,97772,0,111032
142941300100000,SW 404,RESIDENTIAL,16894,0,16894,78900,0,95794
142941300200000,SMALL RETAIL,COMMERCIAL,0,15120,15120,0,36351,51471
142941300300000,SW 404,RESIDENTIAL,15675,0,15675,63019,0,78694
142941300400000,SW 404,RESIDENTIAL,15000,0,15000,65785,0,80785
142941300500000,SW 404,RESIDENTIAL,14250,0,14250,64539,0,78789
142941300600000,SW 404,RESIDENTIAL,17550,0,17550,57724,0,75274
142941300700000,SW 404,RESIDENTIAL,15000,0,15000,58363,0,73363
142942600300000,SW 404,RESIDENTIAL,11963,0,11963,48100,0,60063
142942600400000,SW 404,RESIDENTIAL,15000,0,15000,66599,0,81599
142942600500000,SW 404,RESIDENTIAL,16875,0,16875,80385,0,97260
142942600600000,SW 404,RESIDENTIAL,15000,0,15000,69812,0,84812
142942600700000,SW 404,RESIDENTIAL,15000,0,15000,60449,0,75449
142942600800000,APARTMENT,COMMERCIAL,0,11200,11200,0,105936,117136
142942600900000,SW 404,RESIDENTIAL,15000,0,15000,78295,0,93295
142942601000000,SW 404,RESIDENTIAL,15000,0,15000,46562,0,61562
142942601100000,SW 404,RESIDENTIAL,15000,0,15000,71755,0,86755
142942601200000,SW 404,RESIDENTIAL,15000,0,15000,77884,0,92884
142942601300000,SW 404,RESIDENTIAL,15000,0,15000,115061,0,130061
142942601400000,SW 404,RESIDENTIAL,15000,0,15000,69074,0,84074
142942601500000,SW 404,RESIDENTIAL,15000,0,15000,79509,0,94509
142942601600000,SW 404,RESIDENTIAL,15000,0,15000,67842,0,82842
142942601700000,SW 404,RESIDENTIAL,15000,0,15000,62324,0,77324
142942601800000,SW 404,RESIDENTIAL,15000,0,15000,64288,0,79288
142942601900000,SW 404,RESIDENTIAL,15187,0,15187,48274,0,63461
142942602000000,OFFICE,COMMERCIAL,0,37368,37368,0,54414,91782
142942700200000,CENTRALLY ASSESSED,OTHER,0,0,0,0,0,0
142942700300000,VACANT LAND,COMMERCIAL,0,67620,67620,0,0,67620
142942700302000,WAREHOUSE,COMMERCIAL,0,0,0,0,105564,105564
142942700400000,WAREHOUSE,COMMERCIAL,0,108800,108800,0,175769,284569
142942700500000,CENTRALLY ASSESSED,OTHER,0,0,0,0,0,0
142942800100000,SMALL RETAIL,COMMERCIAL,0,111250,111250,0,157865,269115
142942800200000,SW 404,RESIDENTIAL,21168,0,21168,96494,0,117662
142942800300000,SW 404,RESIDENTIAL,16800,0,16800,71551,0,88351
142942800400000,SW 404,RESIDENTIAL,11200,0,11200,73343,0,84543
142942800500000,SW 404,RESIDENTIAL,17638,0,17638,77377,0,95015
142942800600000,SW 404,RESIDENTIAL,14000,0,14000,84331,0,98331
142942800700000,SW 404,RESIDENTIAL,16579,0,16579,78741,0,95320
142942800800000,SW 404,RESIDENTIAL,22233,0,22233,88475,0,110708
142942800900000,SW 404,RESIDENTIAL,22233,0,22233,70150,0,92383
142942801000000,SW 404,RESIDENTIAL,22233,0,22233,49647,0,71880
142942801100000,SW 404,RESIDENTIAL,22233,0,22233,63242,0,85475
142942801200000,SW 404,RESIDENTIAL,22233,0,22233,52918,0,75151
142942801300000,SW 404,RESIDENTIAL,22233,0,22233,60490,0,82723
142942801400000,SW 404,RESIDENTIAL,22233,0,22233,78731,0,100964
142942801500000,SW 404,RESIDENTIAL,22233,0,22233,80984,0,103217
142942801600000,SW 404,RESIDENTIAL,22080,0,22080,25367,0,47447
142942801700000,SW 404,RESIDENTIAL,12730,0,12730,66945,0,79675
142942801800000,SW 404,RESIDENTIAL,13410,0,13410,57994,0,71404
142942801900000,SW 404,RESIDENTIAL,13754,0,13754,0,0,13754
142942802000000,SW 404,RESIDENTIAL,21340,0,21340,56730,0,78070
142942802100000,CITY PROPERTY,EXEMPT,0,0,0,0,0,0
142942802200000,SW 404,RESIDENTIAL,20600,0,20600,0,0,20600
142942900100000,SW 404,RESIDENTIAL,21996,0,21996,64325,0,86321
142942900200000,SW 404,RESIDENTIAL,21996,0,21996,62278,0,84274
142942900300000,SW 404,RESIDENTIAL,21816,0,21816,71576,0,93392
142942900400000,SW 404,RESIDENTIAL,21141,0,21141,91165,0,112306
142942900500000,SW 404,RESIDENTIAL,14663,0,14663,90002,0,104665
142942900600000,SW 404,RESIDENTIAL,21038,0,21038,67164,0,88202
142942900700000,SW 404,RESIDENTIAL,21038,0,21038,58010,0,79048
142942900800000,SW 404,RESIDENTIAL,21038,0,21038,56152,0,77190
142942900900000,SW 404,RESIDENTIAL,21038,0,21038,73239,0,94277
142942901000000,SW 404,RESIDENTIAL,21038,0,21038,63057,0,84095
142942901100000,SW 404,RESIDENTIAL,21038,0,21038,77791,0,98829
142942901200000,SW 404,RESIDENTIAL,21038,0,21038,65648,0,86686
142942901300000,SW 404,RESIDENTIAL,21038,0,21038,69081,0,90119
142942901400000,SW 404,RESIDENTIAL,19565,0,19565,100535,0,120100
142942901500000,SW 404,RESIDENTIAL,25904,0,25904,76023,0,101927
142942901600000,SW 404,RESIDENTIAL,21587,0,21587,50868,0,72455
142942901700000,SW 404,RESIDENTIAL,20825,0,20825,65505,0,86330
142942901800000,SW 404,RESIDENTIAL,20825,0,20825,70830,0,91655
142942901900000,SW 404,RESIDENTIAL,20825,0,20825,64147,0,84972
142942902000000,SW 404,RESIDENTIAL,20825,0,20825,64524,0,85349
142942902100000,SW 404,RESIDENTIAL,23824,0,23824,99101,0,122925
142942902200000,SW 404,RESIDENTIAL,20825,0,20825,66984,0,87809
142943000100000,CHURCH,EXEMPT,0,103275,103275,0,446896,550171
142943000200000,SW 404,RESIDENTIAL,21038,0,21038,51278,0,72316
142943000300000,SW 404,RESIDENTIAL,21038,0,21038,73202,0,94240
142943000400000,SW 404,RESIDENTIAL,21038,0,21038,72365,0,93403
142943000500000,SW 404,RESIDENTIAL,23513,0,23513,68030,0,91543
142943000600000,SW 404,RESIDENTIAL,21038,0,21038,67603,0,88641
142943000700000,SW 404,RESIDENTIAL,21038,0,21038,59822,0,80860
142943000800000,SW 404,RESIDENTIAL,19565,0,19565,70758,0,90323
142943100100000,SW 404,RESIDENTIAL,19350,0,19350,57558,0,76908
142943100200000,SW 404,RESIDENTIAL,15750,0,15750,65873,0,81623
142943100300000,SW 404,RESIDENTIAL,15750,0,15750,58208,0,73958
142943100400000,SW 404,RESIDENTIAL,15750,0,15750,53085,0,68835
142943100500000,SW 404,RESIDENTIAL,15750,0,15750,86655,0,102405
142943100600000,SW 404,RESIDENTIAL,15750,0,15750,92492,0,108242
142943100700000,SW 404,RESIDENTIAL,11813,0,11813,44242,0,56055
142943100800000,SW 404,RESIDENTIAL,11813,0,11813,69527,0,81340
142943100900000,SW 404,RESIDENTIAL,11813,0,11813,49279,0,61092
142943101000000,SW 404,RESIDENTIAL,11813,0,11813,61138,0,72951
142943101100000,SW 404,RESIDENTIAL,15750,0,15750,54996,0,70746
142943200100000,SW 404,RESIDENTIAL,16720,0,16720,58136,0,74856
142943200200000,VACANT LAND,INDUSTRIAL,0,22032,22032,0,0,22032
142943200300000,VACANT LAND,INDUSTRIAL,0,0,0,0,0,0
142943200400000,SW 404,RESIDENTIAL,18700,0,18700,56481,0,75181
142943200500000,SW 404,RESIDENTIAL,16800,0,16800,42402,0,59202
142943200600000,SW 404,RESIDENTIAL,16800,0,16800,62912,0,79712
142943200700000,SW 404,RESIDENTIAL,16800,0,16800,61601,0,78401
142943200800000,SW 404,RESIDENTIAL,16800,0,16800,55151,0,71951
142943200900000,SW 404,RESIDENTIAL,16800,0,16800,75488,0,92288
142943201000000,CITY PROPERTY,EXEMPT,0,0,0,0,0,0
142943201100000,SW 404,RESIDENTIAL,14800,0,14800,0,0,14800
142943201200000,VOID PARCELS,EXEMPT,0,0,0,0,0,0
142943300100000,OFFICE,COMMERCIAL,0,22545,22545,0,82783,105328
142943300200000,SHOP,COMMERCIAL,0,11907,11907,0,49151,61058
142943300300000,SHOP,COMMERCIAL,0,12267,12267,0,26872,39139
142943300400000,SHOP,COMMERCIAL,0,21256,21256,0,102962,124218
142943300500000,WAREHOUSE,COMMERCIAL,0,41400,41400,0,103261,144661
142943300600000,WAREHOUSE,COMMERCIAL,0,48000,48000,0,185308,233308
142943300700000,SW 404,RESIDENTIAL,12840,0,12840,34082,0,46922
142943300800000,SW 404,RESIDENTIAL,12960,0,12960,37782,0,50742
142945100100000,SW 404,RESIDENTIAL,15375,0,15375,45643,0,61018
142945100200000,SW 404,RESIDENTIAL,16125,0,16125,71081,0,87206
142945100300000,SW 404,RESIDENTIAL,15675,0,15675,56110,0,71785
142945200100000,CITY PROPERTY,EXEMPT,0,0,0,0,0,0
142945200200000,VACANT LAND,INDUSTRIAL,0,13219,13219,0,0,13219
142945300100000,FOOD GRADE;INDUST,INDUSTRIAL,0,466668,466668,0,2570264,3036932
142945300102000,BILLBOARD(BLL),COMMERCIAL,0,0,0,0,15953,15953
142945400100000,SW 404,RESIDENTIAL,18360,0,18360,55040,0,73400
142945400200000,BARS/LOUNGE,COMMERCIAL,0,48960,48960,0,109255,158215
142945400300000,OFFICE,COMMERCIAL,0,100000,100000,0,83382,183382
142945400400000,WAREHOUSE,COMMERCIAL,0,183750,183750,0,782652,966402
142945500100000,SW 404,RESIDENTIAL,16000,0,16000,38121,0,54121
142945500200000,SW 404,RESIDENTIAL,16000,0,16000,44890,0,60890
142945500300000,SW 404,RESIDENTIAL,16000,0,16000,41283,0,57283
142945500400000,SW 404,RESIDENTIAL,16000,0,16000,36315,0,52315
142945500500000,SW 404,RESIDENTIAL,16000,0,16000,47428,0,63428
142945500600000,SW 404,RESIDENTIAL,16000,0,16000,53178,0,69178
142945500700000,SW 404,RESIDENTIAL,16000,0,16000,62105,0,78105
142945500800000,SW 404,RESIDENTIAL,16000,0,16000,57414,0,73414
142945500900000,WAREHOUSE,COMMERCIAL,0,16800,16800,0,121035,137835
142945501000000,VACANT LAND,COMMERCIAL,0,16800,16800,0,0,16800
142945501002000,WAREHOUSE,COMMERCIAL,0,0,0,0,115207,115207
142945501100000,VACANT LAND,COMMERCIAL,0,40950,40950,0,0,40950
142945501202000,WAREHOUSE,COMMERCIAL,0,0,0,0,107940,107940
142945600100000,WAREHOUSE,COMMERCIAL,0,16800,16800,0,130045,146845
142945600200000,FOOD GRADE;INDUST,INDUSTRIAL,0,12490,12490,0,20273,32763
142945600300000,WAREHOUSE,COMMERCIAL,0,80375,80375,0,330769,411144
142945600400000,SW 404,RESIDENTIAL,12000,0,12000,56110,0,68110
142945600500000,SW 404,RESIDENTIAL,16000,0,16000,95466,0,111466
142945600600000,SW 404,RESIDENTIAL,16000,0,16000,43407,0,59407
142945600700000,SW 404,RESIDENTIAL,16000,0,16000,43336,0,59336
142945600800000,SW 404,RESIDENTIAL,16000,0,16000,84954,0,100954
142945600900000,SW 404,RESIDENTIAL,12000,0,12000,65687,0,77687
142945601000000,SW 404,RESIDENTIAL,16000,0,16000,84952,0,100952
142945601100000,SW 404,RESIDENTIAL,16000,0,16000,71277,0,87277
142945601200000,SW 404,RESIDENTIAL,16000,0,16000,77729,0,93729
142945601300000,SW 404,RESIDENTIAL,16000,0,16000,70240,0,86240
142945700100000,CENTRALLY ASSESSED,OTHER,0,0,0,0,0,0
142945800100000,FOOD GRADE;INDUST,INDUSTRIAL,0,27864,27864,0,1108238,1136102
142945800200000,VACANT LAND,INDUSTRIAL,0,0,0,0,0,0
142945800300000,FOOD GRADE;INDUST,INDUSTRIAL,0,28836,28836,0,0,28836
142945800400000,CENTRALLY ASSESSED,OTHER,0,0,0,0,0,0
142945900100000,CENTRALLY ASSESSED,OTHER,0,0,0,0,0,0
142945900200000,VACANT LAND,COMMERCIAL,0,50400,50400,0,0,50400
142945900300000,CENTRALLY ASSESSED,OTHER,0,0,0,0,0,0
142945900400000,FLAT PARKING,COMMERCIAL,0,55375,55375,0,0,55375
142946000100000,CENTRALLY ASSESSED,OTHER,0,0,0,0,0,0
142946000200000,CENTRALLY ASSESSED,OTHER,0,0,0,0,0,0
142946000300000,CENTRALLY ASSESSED,OTHER,0,0,0,0,0,0
142946000400000,CENTRALLY ASSESSED,OTHER,0,0,0,0,0,0
142946000500000,VACANT LAND,COMMERCIAL,0,67200,67200,0,0,67200
142946000600000,VACANT LAND,COMMERCIAL,0,33600,33600,0,0,33600
142946000700000,CENTRALLY ASSESSED,OTHER,0,0,0,0,0,0
142946000800000,VACANT LAND,COMMERCIAL,0,16680,16680,0,0,16680
142946100200000,SW 404,RESIDENTIAL,8621,0,8621,36764,0,45385
142946100300000,SHOP,COMMERCIAL,0,23641,23641,0,52177,75818
142946100400000,BARS/LOUNGE,COMMERCIAL,0,18228,18228,0,60580,78808
142946100500000,SW 404,RESIDENTIAL,19123,0,19123,62047,0,81170
142946100600000,SW 404,RESIDENTIAL,16896,0,16896,36058,0,52954
142946100700000,SW 404,RESIDENTIAL,16896,0,16896,72512,0,89408
142946200100000,SW 404,RESIDENTIAL,23040,0,23040,90495,0,113535
142946200200000,SW 404,RESIDENTIAL,15360,0,15360,66244,0,81604
142946200300000,SW 404,RESIDENTIAL,64260,0,64260,0,0,64260
142946200400000,CENTRALLY ASSESSED,OTHER,0,0,0,0,0,0
142947600100000,SW 404,RESIDENTIAL,11700,0,11700,58196,0,69896
142947600200000,CITY PROPERTY,EXEMPT,0,0,0,0,0,0
142947600300000,SW 404,RESIDENTIAL,11400,0,11400,61042,0,72442
142947600400000,SW 404,RESIDENTIAL,10780,0,10780,75255,0,86035
142947600500000,SW 404,RESIDENTIAL,10780,0,10780,60903,0,71683
142947600600000,SW 404,RESIDENTIAL,10780,0,10780,66224,0,77004
142947600700000,SW 404,RESIDENTIAL,10780,0,10780,69149,0,79929
142947700200000,SW 404,RESIDENTIAL,15000,0,15000,50926,0,65926
142947700300000,SW 404,RESIDENTIAL,12855,0,12855,65880,0,78735
142947700400000,SW 404,RESIDENTIAL,15860,0,15860,73417,0,89277
142947700500000,SW 404,RESIDENTIAL,13440,0,13440,51537,0,64977
142947700700000,SW 404,RESIDENTIAL,16000,0,16000,85589,0,101589
142947700800000,SW 404,RESIDENTIAL,15600,0,15600,54772,0,70372
142947700900000,CITY PROPERTY,EXEMPT,0,0,0,0,0,0
142947701000000,CITY PROPERTY,EXEMPT,0,0,0,0,0,0
142947800100000,SW 404,RESIDENTIAL,15000,0,15000,73756,0,88756
142947800200000,SW 404,RESIDENTIAL,17185,0,17185,0,0,17185
142947800300000,SW 404,RESIDENTIAL,10866,0,10866,58277,0,69143
142947800400000,SW 404,RESIDENTIAL,10153,0,10153,64716,0,74869
142947800500000,SW 404,RESIDENTIAL,9619,0,9619,62831,0,72450
142947800600000,SW 404,RESIDENTIAL,14509,0,14509,45326,0,59835
142947800700000,SW 404,RESIDENTIAL,13894,0,13894,45108,0,59002
142947900100000,SW 404,RESIDENTIAL,11475,0,11475,59978,0,71453
142947900200000,SW 404,RESIDENTIAL,16352,0,16352,58105,0,74457
142947900300000,CITY PROPERTY,EXEMPT,0,0,0,0,0,0
142948000400000,VACANT LAND,COMMERCIAL,0,25483,25483,0,0,25483
142948000500000,CENTRALLY ASSESSED,OTHER,0,0,0,0,0,0
142948000600000,CENTRALLY ASSESSED,OTHER,0,0,0,0,0,0
142948000602000,BILLBOARD(BLL),COMMERCIAL,0,0,0,0,10277,10277
142948100100000,SHOP,COMMERCIAL,0,65654,65654,0,86942,152596
142948100200000,SHOP,COMMERCIAL,0,21960,21960,0,80490,102450
142948100300000,SW 404,RESIDENTIAL,17689,0,17689,56648,0,74337
142948100400000,CITY PROPERTY,EXEMPT,0,0,0,0,0,0
142948100500000,SHOP,COMMERCIAL,0,19080,19080,0,77867,96947
142948100600000,VACANT LAND,COMMERCIAL,0,20601,20601,0,0,20601
142948100800000,CENTRALLY ASSESSED,OTHER,0,0,0,0,0,0
142948200100000,SW 404,RESIDENTIAL,16000,0,16000,86898,0,102898
142948200200000,SW 404,RESIDENTIAL,16000,0,16000,91568,0,107568
142948200300000,SW 404,RESIDENTIAL,16000,0,16000,63562,0,79562
142948200400000,SW 404,RESIDENTIAL,16000,0,16000,70904,0,86904
142948200500000,SW 404,RESIDENTIAL,16000,0,16000,56461,0,72461
142948200600000,SW 404,RESIDENTIAL,16000,0,16000,66095,0,82095
142948200700000,SW 404,RESIDENTIAL,16000,0,16000,73634,0,89634
142948201100000,VACANT LAND,COMMERCIAL,0,19278,19278,0,0,19278
142948201200000,VACANT LAND,COMMERCIAL,0,15960,15960,0,0,15960
142948201300000,SW 404,RESIDENTIAL,16000,0,16000,53383,0,69383
142948201400000,SW 404,RESIDENTIAL,16000,0,16000,58767,0,74767
142948201500000,SW 404,RESIDENTIAL,16000,0,16000,53123,0,69123
142948201600000,SW 404,RESIDENTIAL,16000,0,16000,79157,0,95157
142948201700000,CENTRALLY ASSESSED,OTHER,0,0,0,0,0,0
142948201800000,CENTRALLY ASSESSED,OTHER,0,0,0,0,0,0
142948201900000,AUTO REPAIR/SALES,COMMERCIAL,0,38100,38100,0,28882,66982
142948202000000,VACANT LAND,COMMERCIAL,0,7762,7762,0,0,7762
142948300100000,SW 404,RESIDENTIAL,10640,0,10640,60002,0,70642
142948300200000,SW 404,RESIDENTIAL,9975,0,9975,40225,0,50200
142948300300000,SW 404,RESIDENTIAL,9975,0,9975,43833,0,53808
142948300400000,SW 404,RESIDENTIAL,12160,0,12160,42084,0,54244
142948300500000,SW 404,RESIDENTIAL,16320,0,16320,87035,0,103355
142948300600000,SW 404,RESIDENTIAL,16320,0,16320,70438,0,86758
142948300700000,SW 404,RESIDENTIAL,16320,0,16320,72076,0,88396
142948300800000,SW 404,RESIDENTIAL,14280,0,14280,70267,0,84547
142948300900000,SW 404,RESIDENTIAL,14280,0,14280,76625,0,90905
142948301000000,SW 404,RESIDENTIAL,14280,0,14280,71238,0,85518
142948301100000,SW 404,RESIDENTIAL,12495,0,12495,69975,0,82470
142948301200000,CITY PROPERTY,EXEMPT,0,0,0,0,0,0
142948301300000,FLAT PARKING,COMMERCIAL,0,18000,18000,0,0,18000
142948301400000,VACANT LAND,COMMERCIAL,0,20323,20323,0,0,20323
142948400200000,WAREHOUSE,COMMERCIAL,0,179010,179010,0,310669,489679
142948500300000,WAREHOUSE,INDUSTRIAL,0,274536,274536,0,1010028,1284564
142948500500000,WAREHOUSE,COMMERCIAL,0,86125,86125,0,175280,261405
142948500600000,VACANT LAND,COMMERCIAL,0,136800,136800,0,0,136800
142948500602000,WAREHOUSE,COMMERCIAL,0,0,0,0,115013,115013
142948500602001,WAREHOUSE,COMMERCIAL,0,0,0,0,101842,101842
142948500700000,MATERIALS MFG;INDUST,INDUSTRIAL,0,219110,219110,0,445687,664797
142948500800000,CITY PROPERTY,EXEMPT,0,0,0,0,0,0
142948500900000,CITY PROPERTY,EXEMPT,0,0,0,0,0,0
142948501000000,CITY PROPERTY,EXEMPT,0,0,0,0,0,0
142948501200000,VACANT LAND,INDUSTRIAL,0,2592,2592,0,0,2592
142948501400000,CONC/ASPH;INDUSTRIAL,INDUSTRIAL,0,18144,18144,0,11845,29989
142948501600000,VACANT LAND,COMMERCIAL,0,14000,14000,0,0,14000
142948501700000,CENTRALLY ASSESSED,OTHER,0,0,0,0,0,0
142948501800000,OFFICE,COMMERCIAL,0,199000,199000,0,401789,600789
142948501900000,CONC/ASPH;INDUSTRIAL,INDUSTRIAL,0,402193,402193,0,814753,1216946
142948600100000,VACANT LAND,INDUSTRIAL,0,100035,100035,0,0,100035
142948600200000,CENTRALLY ASSESSED,OTHER,0,0,0,0,0,0
142948600300000,WAREHOUSE,COMMERCIAL,0,56000,56000,0,151387,207387
142948600400000,CENTRALLY ASSESSED,OTHER,0,0,0,0,0,0
142948600500000,CENTRALLY ASSESSED,OTHER,0,0,0,0,0,0
142948700600000,OFFICE,COMMERCIAL,0,111075,111075,0,124995,236070
142948800300000,SHOP,COMMERCIAL,0,87500,87500,0,469165,556665
143010100100000,NW 324,RESIDENTIAL,26208,0,26208,120601,0,146809
143010100200000,NW 324,RESIDENTIAL,51100,0,51100,174473,0,225573
143010100300000,NW 324,RESIDENTIAL,18988,0,18988,84335,0,103323
143010100400000,NW 324,RESIDENTIAL,18988,0,18988,62454,0,81442
143010100500000,NW 324,RESIDENTIAL,18899,0,18899,77139,0,96038
143010100600000,NW 324,RESIDENTIAL,20400,0,20400,82486,0,102886
143010100700000,NW 324,RESIDENTIAL,20400,0,20400,89128,0,109528
143010100800000,NW 324,RESIDENTIAL,20400,0,20400,89923,0,110323
143010100900000,NW 324,RESIDENTIAL,20400,0,20400,77672,0,98072
143010101000000,NW 324,RESIDENTIAL,20400,0,20400,83241,0,103641
143010101100000,NW 324,RESIDENTIAL,20400,0,20400,60179,0,80579
143010101200000,NW 324,RESIDENTIAL,20400,0,20400,99137,0,119537
143010101300000,NW 324,RESIDENTIAL,26520,0,26520,145935,0,172455
143010101400000,NW 324,RESIDENTIAL,20400,0,20400,68644,0,89044
143010101500000,NW 324,RESIDENTIAL,20400,0,20400,99672,0,120072
143010101600000,NW 324,RESIDENTIAL,20400,0,20400,86170,0,106570
143010101700000,NW 324,RESIDENTIAL,22950,0,22950,92851,0,115801
143010101800000,NW 324,RESIDENTIAL,22950,0,22950,97794,0,120744
143010101900000,NW 324,RESIDENTIAL,20400,0,20400,69231,0,89631
143010102000000,NW 324,RESIDENTIAL,20400,0,20400,100372,0,120772
143010102100000,NW 324,RESIDENTIAL,20400,0,20400,73167,0,93567
143010102200000,NW 324,RESIDENTIAL,20400,0,20400,120310,0,140710
143010102300000,NW 324,RESIDENTIAL,19676,0,19676,109581,0,129257
143010102400000,NW 324,RESIDENTIAL,19908,0,19908,82214,0,102122
143010102500000,NW 324,RESIDENTIAL,27421,0,27421,80331,0,107752
143010102600000,NW 324,RESIDENTIAL,24840,0,24840,99068,0,123908
143010102700000,NW 324,RESIDENTIAL,26662,0,26662,111011,0,137673
143010102800000,NW 324,RESIDENTIAL,29280,0,29280,116507,0,145787
143010102900000,NW 324,RESIDENTIAL,29280,0,29280,32415,0,61695
143010103000000,NW 324,RESIDENTIAL,32452,0,32452,89854,0,122306
143010103100000,NW 324,RESIDENTIAL,24400,0,24400,110477,0,134877
143010103200000,NW 324,RESIDENTIAL,31378,0,31378,110340,0,141718
143010103300000,NW 324,RESIDENTIAL,29280,0,29280,131056,0,160336
143010103400000,NW 324,RESIDENTIAL,24400,0,24400,107085,0,131485
143010103500000,NW 324,RESIDENTIAL,24400,0,24400,103654,0,128054
143010103600000,NW 324,RESIDENTIAL,29280,0,29280,105685,0,134965
143010103700000,NW 324,RESIDENTIAL,24400,0,24400,101746,0,126146
143010103800000,NW 324,RESIDENTIAL,26840,0,26840,122638,0,149478
143010103900000,NW 324,RESIDENTIAL,27664,0,27664,94282,0,121946
143010104000000,NW 324,RESIDENTIAL,24960,0,24960,85653,0,110613
143010104100000,NW 324,RESIDENTIAL,28035,0,28035,98916,0,126951
143010104200000,NW 324,RESIDENTIAL,27173,0,27173,108096,0,135269
143010200100000,NW 324,RESIDENTIAL,18899,0,18899,85523,0,104422
143010200200000,NW 324,RESIDENTIAL,24684,0,24684,87215,0,111899
143010200300000,CHURCH,EXEMPT,0,379674,379674,0,3635821,4015495
143010200400000,NW 324,RESIDENTIAL,50250,0,50250,129133,0,179383
143010200500000,NW 324,RESIDENTIAL,24240,0,24240,96411,0,120651
143010200600000,NW 324,RESIDENTIAL,24240,0,24240,86685,0,110925
143010200700000,NW 324,RESIDENTIAL,21412,0,21412,92483,0,113895
143010200800000,NW 324,RESIDENTIAL,21412,0,21412,112503,0,133915
143010200900000,NW 324,RESIDENTIAL,21412,0,21412,96334,0,117746
143010201000000,NW 324,RESIDENTIAL,30097,0,30097,139114,0,169211
143010201100000,NW 324,RESIDENTIAL,28080,0,28080,111659,0,139739
143010201200000,NW 324,RESIDENTIAL,24480,0,24480,66347,0,90827
143010201300000,NW 324,RESIDENTIAL,24480,0,24480,89039,0,113519
143010201400000,NW 324,RESIDENTIAL,24480,0,24480,65044,0,89524
143010201500000,NW 324,RESIDENTIAL,24480,0,24480,93162,0,117642
143010201600000,NW 324,RESIDENTIAL,24480,0,24480,68535,0,93015
143010201700000,NW 324,RESIDENTIAL,26936,0,26936,75643,0,102579
143010201800000,NW 324,RESIDENTIAL,26524,0,26524,94135,0,120659
143010201900000,NW 324,RESIDENTIAL,31856,0,31856,56948,0,88804
143010202000000,NW 324,RESIDENTIAL,51700,0,51700,116886,0,168586
143010202100000,NW 324,RESIDENTIAL,30163,0,30163,83243,0,113406
143010202200000,NW 324,RESIDENTIAL,24964,0,24964,87061,0,112025
143010202300000,NW 324,EXEMPT,0,59050,59050,0,100385,159435
143010202400000,NW 324,RESIDENTIAL,20116,0,20116,89370,0,109486
143010202500000,NW 324,RESIDENTIAL,19364,0,19364,87502,0,106866
143010202600000,NW 324,RESIDENTIAL,18760,0,18760,93284,0,112044
143010202700000,NW 324,RESIDENTIAL,20400,0,20400,90222,0,110622
143010202800000,NW 324,RESIDENTIAL,20400,0,20400,86220,0,106620
143010202900000,NW 324,RESIDENTIAL,20400,0,20400,80901,0,101301
143010203000000,NW 324,RESIDENTIAL,22950,0,22950,99350,0,122300
143010203100000,NW 324,RESIDENTIAL,22950,0,22950,122605,0,145555
143010203200000,NW 324,RESIDENTIAL,20400,0,20400,115300,0,135700
143010203300000,NW 324,RESIDENTIAL,20400,0,20400,84887,0,105287
143010203400000,NW 324,RESIDENTIAL,20400,0,20400,111592,0,131992
143010203500000,NW 324,RESIDENTIAL,20400,0,20400,94095,0,114495
143010203600000,NW 324,RESIDENTIAL,20400,0,20400,82989,0,103389
143010203700000,NW 324,RESIDENTIAL,20400,0,20400,72974,0,93374
143010203800000,NW 324,RESIDENTIAL,20400,0,20400,87150,0,107550
143010203900000,NW 324,RESIDENTIAL,20400,0,20400,92790,0,113190
143010204000000,NW 324,RESIDENTIAL,22950,0,22950,107938,0,130888
143010204100000,NW 324,RESIDENTIAL,22950,0,22950,94007,0,116957
143010204200000,NW 324,RESIDENTIAL,20400,0,20400,69175,0,89575
143010204300000,NW 324,RESIDENTIAL,20400,0,20400,89597,0,109997
143010300100000,NW 324,RESIDENTIAL,46008,0,46008,38500,0,84508
143010300200000,NW 324,RESIDENTIAL,22896,0,22896,100093,0,122989
143010300300000,NW 324,RESIDENTIAL,27132,0,27132,101621,0,128753
143010300400000,NW 324,RESIDENTIAL,27360,0,27360,88512,0,115872
143010300500000,NW 324,RESIDENTIAL,27300,0,27300,83588,0,110888
143010300600000,NW 324,RESIDENTIAL,21412,0,21412,86354,0,107766
143010300700000,NW 324,RESIDENTIAL,21412,0,21412,103312,0,124724
143010300800000,NW 324,RESIDENTIAL,24480,0,24480,93847,0,118327
143010300900000,NW 324,RESIDENTIAL,24480,0,24480,75584,0,100064
143010301000000,NW 324,RESIDENTIAL,24480,0,24480,50491,0,74971
143010301100000,NW 324,RESIDENTIAL,24480,0,24480,84403,0,108883
143010301200000,NW 324,RESIDENTIAL,24480,0,24480,72900,0,97380
143010301300000,NW 324,RESIDENTIAL,24480,0,24480,63337,0,87817
143010301400000,NW 324,RESIDENTIAL,31856,0,31856,94878,0,126734
143010301500000,NW 324,RESIDENTIAL,27598,0,27598,82838,0,110436
143010301600000,NW 324,RESIDENTIAL,24864,0,24864,38549,0,63413
143010400100000,CARWASH,COMMERCIAL,0,62016,62016,0,160879,222895
143012600100000,NW 324,RESIDENTIAL,52200,0,52200,112707,0,164907
143012600200000,NW 324,RESIDENTIAL,31683,0,31683,137909,0,169592
143012600300000,NW 324,RESIDENTIAL,24320,0,24320,104307,0,128627
143012600400000,NW 324,RESIDENTIAL,28900,0,28900,144169,0,173069
143012600500000,NW 324,RESIDENTIAL,28900,0,28900,105716,0,134616
143012600600000,NW 324,RESIDENTIAL,24661,0,24661,82750,0,107411
143012600700000,NW 324,RESIDENTIAL,24000,0,24000,104156,0,128156
143012600800000,NW 324,RESIDENTIAL,24000,0,24000,66685,0,90685
143012600900000,NW 324,RESIDENTIAL,24000,0,24000,110786,0,134786
143012601000000,NW 324,RESIDENTIAL,24000,0,24000,103832,0,127832
143012601100000,NW 324,RESIDENTIAL,24000,0,24000,88787,0,112787
143012601200000,NW 324,RESIDENTIAL,24000,0,24000,93735,0,117735
143012601300000,NW 324,RESIDENTIAL,26197,0,26197,118579,0,144776
143012601400000,NW 324,RESIDENTIAL,28004,0,28004,110114,0,138118
143012601500000,NW 324,RESIDENTIAL,24480,0,24480,75497,0,99977
143012700100000,NW 324,RESIDENTIAL,23100,0,23100,105276,0,128376
143012700200000,NW 324,RESIDENTIAL,23485,0,23485,119977,0,143462
143012700300000,NW 324,RESIDENTIAL,30530,0,30530,127853,0,158383
143012700400000,NW 324,RESIDENTIAL,22297,0,22297,103380,0,125677
143012700500000,NW 324,RESIDENTIAL,22560,0,22560,100256,0,122816
143012700600000,NW 324,RESIDENTIAL,22560,0,22560,81542,0,104102
143012700700000,NW 324,RESIDENTIAL,22560,0,22560,82051,0,104611
143012700800000,NW 324,RESIDENTIAL,22560,0,22560,93752,0,116312
143012700900000,NW 324,RESIDENTIAL,22560,0,22560,98658,0,121218
143012701000000,NW 324,RESIDENTIAL,22560,0,22560,97594,0,120154
143012701100000,NW 324,RESIDENTIAL,21780,0,21780,103124,0,124904
143012701200000,NW 324,RESIDENTIAL,21120,0,21120,80354,0,101474
143012701300000,NW 324,RESIDENTIAL,25460,0,25460,87460,0,112920
143012701400000,NW 324,RESIDENTIAL,24817,0,24817,98695,0,123512
143012701500000,NW 324,RESIDENTIAL,21557,0,21557,84965,0,106522
143012701600000,NW 324,RESIDENTIAL,22714,0,22714,101608,0,124322
143012701700000,NW 324,RESIDENTIAL,22560,0,22560,77247,0,99807
143012701800000,NW 324,RESIDENTIAL,22560,0,22560,81246,0,103806
143012701900000,NW 324,RESIDENTIAL,22560,0,22560,98786,0,121346
143012702000000,NW 324,RESIDENTIAL,22560,0,22560,110370,0,132930
143012702100000,NW 324,RESIDENTIAL,22823,0,22823,83729,0,106552
143012702200000,NW 324,RESIDENTIAL,26960,0,26960,125976,0,152936
143012702300000,NW 324,RESIDENTIAL,26355,0,26355,120322,0,146677
143012702400000,NW 324,RESIDENTIAL,22320,0,22320,99293,0,121613
143012702500000,NW 324,RESIDENTIAL,22320,0,22320,101881,0,124201
143012702600000,NW 324,RESIDENTIAL,22320,0,22320,95382,0,117702
143012702700000,NW 324,RESIDENTIAL,22320,0,22320,132318,0,154638
143012702800000,NW 324,RESIDENTIAL,22320,0,22320,83996,0,106316
143012702900000,NW 324,RESIDENTIAL,22320,0,22320,79772,0,102092
143012703000000,NW 324,RESIDENTIAL,22531,0,22531,98616,0,121147
143012703100000,NW 324,RESIDENTIAL,20400,0,20400,97220,0,117620
143012703200000,NW 324,RESIDENTIAL,27826,0,27826,97286,0,125112
143012703300000,NW 324,RESIDENTIAL,25685,0,25685,90155,0,115840
143012703400000,NW 324,RESIDENTIAL,24480,0,24480,105580,0,130060
143012703500000,NW 324,RESIDENTIAL,24480,0,24480,94069,0,118549
143012703600000,NW 324,RESIDENTIAL,24480,0,24480,98642,0,123122
143012703700000,NW 324,RESIDENTIAL,24480,0,24480,76982,0,101462
143012703800000,NW 324,RESIDENTIAL,24480,0,24480,94666,0,119146
143012703900000,NW 324,RESIDENTIAL,24480,0,24480,108863,0,133343
143012704000000,NW 324,RESIDENTIAL,24863,0,24863,88389,0,113252
143012704100000,NW 324,RESIDENTIAL,25704,0,25704,108735,0,134439
143012704200000,NW 324,RESIDENTIAL,26112,0,26112,111896,0,138008
143012704300000,NW 324,RESIDENTIAL,25952,0,25952,111565,0,137517
143012704400000,NW 324,RESIDENTIAL,26320,0,26320,120838,0,147158
143012704500000,NW 324,RESIDENTIAL,22974,0,22974,102302,0,125276
143012704600000,NW 324,RESIDENTIAL,23100,0,23100,128751,0,151851
143012800100000,NW 324,RESIDENTIAL,22823,0,22823,93379,0,116202
143012800200000,NW 324,RESIDENTIAL,23425,0,23425,75286,0,98711
143012800300000,NW 324,RESIDENTIAL,22560,0,22560,114409,0,136969
143012800400000,NW 324,RESIDENTIAL,22560,0,22560,83439,0,105999
143012800500000,NW 324,RESIDENTIAL,22560,0,22560,83878,0,106438
143012800600000,NW 324,RESIDENTIAL,22560,0,22560,77257,0,99817
143012800700000,NW 324,RESIDENTIAL,22560,0,22560,81772,0,104332
143012800800000,NW 324,RESIDENTIAL,22560,0,22560,78878,0,101438
143012800900000,NW 324,RESIDENTIAL,22560,0,22560,83718,0,106278
143012801000000,NW 324,RESIDENTIAL,22560,0,22560,78994,0,101554
143012801100000,NW 324,RESIDENTIAL,22560,0,22560,74473,0,97033
143012801200000,NW 324,RESIDENTIAL,22560,0,22560,80573,0,103133
143012801300000,NW 324,RESIDENTIAL,22560,0,22560,91314,0,113874
143012801400000,NW 324,RESIDENTIAL,22485,0,22485,65800,0,88285
143012801500000,NW 324,RESIDENTIAL,22334,0,22334,91867,0,114201
143012801600000,NW 324,RESIDENTIAL,22560,0,22560,115078,0,137638
143012801700000,NW 324,RESIDENTIAL,22560,0,22560,89086,0,111646
143012801800000,NW 324,RESIDENTIAL,22560,0,22560,106260,0,128820
143012801900000,NW 324,RESIDENTIAL,22560,0,22560,79209,0,101769
143012802000000,NW 324,RESIDENTIAL,22560,0,22560,95722,0,118282
143012802100000,NW 324,RESIDENTIAL,22560,0,22560,99880,0,122440
143012802200000,NW 324,RESIDENTIAL,22560,0,22560,81187,0,103747
143012802300000,NW 324,RESIDENTIAL,22560,0,22560,95712,0,118272
143012802400000,NW 324,RESIDENTIAL,22560,0,22560,91212,0,113772
143012802500000,NW 324,RESIDENTIAL,22560,0,22560,82910,0,105470
143012802600000,NW 324,RESIDENTIAL,22560,0,22560,84065,0,106625
143012900100000,NW 324,RESIDENTIAL,24045,0,24045,93504,0,117549
143012900200000,NW 324,RESIDENTIAL,23688,0,23688,103680,0,127368
143012900300000,NW 324,RESIDENTIAL,23184,0,23184,109059,0,132243
143012900400000,NW 324,RESIDENTIAL,22811,0,22811,123343,0,146154
143012900500000,NW 324,RESIDENTIAL,22560,0,22560,95328,0,117888
143012900600000,NW 324,RESIDENTIAL,22560,0,22560,101878,0,124438
143012900700000,NW 324,RESIDENTIAL,22560,0,22560,89308,0,111868
143012900800000,NW 324,RESIDENTIAL,22560,0,22560,83478,0,106038
143012900900000,NW 324,RESIDENTIAL,22560,0,22560,81843,0,104403
143012901000000,NW 324,RESIDENTIAL,21808,0,21808,82736,0,104544
143012901100000,NW 324,RESIDENTIAL,19351,0,19351,82442,0,101793
143012901200000,NW 324,RESIDENTIAL,22469,0,22469,92895,0,115364
143012901300000,NW 324,RESIDENTIAL,22320,0,22320,84015,0,106335
143012901400000,NW 324,RESIDENTIAL,22320,0,22320,78977,0,101297
143012901500000,NW 324,RESIDENTIAL,22320,0,22320,88825,0,111145
143012901600000,NW 324,RESIDENTIAL,22320,0,22320,98082,0,120402
143012901700000,NW 324,RESIDENTIAL,22320,0,22320,92973,0,115293
143012901800000,NW 324,RESIDENTIAL,22320,0,22320,90342,0,112662
143012901900000,NW 324,RESIDENTIAL,21824,0,21824,97983,0,119807
143013000100000,NW 324,RESIDENTIAL,24465,0,24465,84978,0,109443
143013000200000,NW 324,RESIDENTIAL,22580,0,22580,81572,0,104152
143013000300000,CITY PROPERTY,EXEMPT,0,0,0,0,0,0
143013000400000,NW 324,RESIDENTIAL,24079,0,24079,82825,0,106904
143013000500000,NW 324,RESIDENTIAL,24362,0,24362,82430,0,106792
143013000600000,NW 324,RESIDENTIAL,27960,0,27960,83159,0,111119
143013000700000,NW 324,RESIDENTIAL,27106,0,27106,77209,0,104315
143013000800000,NW 324,RESIDENTIAL,23064,0,23064,87440,0,110504
143013000900000,NW 324,RESIDENTIAL,23436,0,23436,91367,0,114803
143013001000000,NW 324,RESIDENTIAL,23436,0,23436,90284,0,113720
143013001100000,NW 324,RESIDENTIAL,23436,0,23436,84666,0,108102
143013001200000,NW 324,RESIDENTIAL,23436,0,23436,85232,0,108668
143013001300000,NW 324,RESIDENTIAL,23436,0,23436,78813,0,102249
143013001400000,NW 324,RESIDENTIAL,23436,0,23436,78819,0,102255
143013001500000,NW 324,RESIDENTIAL,23064,0,23064,92579,0,115643
143013001600000,NW 324,RESIDENTIAL,22560,0,22560,86350,0,108910
143013001700000,NW 324,RESIDENTIAL,23040,0,23040,88922,0,111962
143013001800000,NW 324,RESIDENTIAL,24240,0,24240,94945,0,119185
143013001900000,NW 324,RESIDENTIAL,25200,0,25200,118976,0,144176
143013002000000,NW 324,RESIDENTIAL,25680,0,25680,83141,0,108821
143013002100000,NW 324,RESIDENTIAL,30510,0,30510,122045,0,152555
143013002200000,NW 324,RESIDENTIAL,32527,0,32527,0,0,32527
143013100100000,NW 324,RESIDENTIAL,23903,0,23903,77507,0,101410
143013100200000,NW 324,RESIDENTIAL,23660,0,23660,78944,0,102604
143013100300000,NW 324,RESIDENTIAL,23660,0,23660,92952,0,116612
143013100400000,NW 324,RESIDENTIAL,23660,0,23660,93984,0,117644
143013100500000,NW 324,RESIDENTIAL,24494,0,24494,100340,0,124834
143013100600000,SCHOOL,EXEMPT,0,62370,62370,0,1073522,1135892
143013100700000,NW 324,RESIDENTIAL,27916,0,27916,82818,0,110734
143013100800000,NW 324,RESIDENTIAL,23808,0,23808,76543,0,100351
143013100900000,NW 324,RESIDENTIAL,23312,0,23312,84039,0,107351
143013101000000,NW 324,RESIDENTIAL,27900,0,27900,134678,0,162578
143013101100000,SMALL RETAIL,COMMERCIAL,0,41600,41600,0,165773,207373
143013101200000,OFFICE; MEDICAL,COMMERCIAL,0,135520,135520,0,268458,403978
143013101300000,SR/NURSING/ASSTD LIV,COMMERCIAL,0,68000,68000,0,1570579,1638579
143013101400000,APARTMENT,COMMERCIAL,0,29939,29939,0,400183,430122
143013101500000,NW 324,RESIDENTIAL,25158,0,25158,99918,0,125076
143015100100000,NW 324,RESIDENTIAL,26327,0,26327,67680,0,94007
143015100200000,NW 324,RESIDENTIAL,26790,0,26790,109842,0,136632
143015100300000,NW 324,RESIDENTIAL,24720,0,24720,92999,0,117719
143015100400000,NW 324,RESIDENTIAL,24844,0,24844,71080,0,95924
143015100500000,NW 324,RESIDENTIAL,21836,0,21836,75443,0,97279
143015100600000,NW 324,RESIDENTIAL,24720,0,24720,88005,0,112725
143015100700000,NW 324,RESIDENTIAL,24720,0,24720,87308,0,112028
143015100800000,NW 324,RESIDENTIAL,24720,0,24720,92327,0,117047
143015100900000,NW 324,RESIDENTIAL,24720,0,24720,63572,0,88292
143015101000000,NW 324,RESIDENTIAL,24720,0,24720,79850,0,104570
143015200100000,NW 324,RESIDENTIAL,28828,0,28828,81017,0,109845
143015200200000,NW 324,RESIDENTIAL,28329,0,28329,80380,0,108709
143015200300000,NW 324,RESIDENTIAL,28846,0,28846,83103,0,111949
143015200400000,NW 324,RESIDENTIAL,29159,0,29159,98179,0,127338
143015200500000,NW 324,RESIDENTIAL,24960,0,24960,113329,0,138289
143015200600000,NW 324,RESIDENTIAL,24960,0,24960,95372,0,120332
143015200700000,NW 324,RESIDENTIAL,25200,0,25200,91270,0,116470
143015200800000,NW 324,RESIDENTIAL,25200,0,25200,95834,0,121034
143015200900000,NW 324,RESIDENTIAL,25200,0,25200,72109,0,97309
143015201000000,NW 324,RESIDENTIAL,25200,0,25200,104800,0,130000
143015201100000,NW 324,RESIDENTIAL,23744,0,23744,75854,0,99598
143015201200000,NW 324,RESIDENTIAL,23044,0,23044,77555,0,100599
143015201300000,NW 324,RESIDENTIAL,37080,0,37080,150615,0,187695
143015201500000,NW 324,RESIDENTIAL,24720,0,24720,68746,0,93466
143015201600000,NW 324,RESIDENTIAL,22248,0,22248,101523,0,123771
143015201700000,NW 324,RESIDENTIAL,30338,0,30338,69658,0,99996
143015201800000,NW 324,RESIDENTIAL,27810,0,27810,137175,0,164985
143015300100000,NW 324,RESIDENTIAL,35704,0,35704,119111,0,154815
143015300200000,NW 324,RESIDENTIAL,24270,0,24270,80098,0,104368
143015300300000,NW 324,RESIDENTIAL,24948,0,24948,98360,0,123308
143015300400000,NW 324,RESIDENTIAL,24948,0,24948,91372,0,116320
143015300500000,NW 324,RESIDENTIAL,24552,0,24552,102838,0,127390
143015300600000,NW 324,RESIDENTIAL,22572,0,22572,77986,0,100558
143015300700000,NW 324,RESIDENTIAL,23760,0,23760,84502,0,108262
143015300800000,NW 324,RESIDENTIAL,23760,0,23760,73876,0,97636
143015300900000,NW 324,RESIDENTIAL,23760,0,23760,89896,0,113656
143015301000000,NW 324,RESIDENTIAL,23760,0,23760,94337,0,118097
143015301100000,NW 324,RESIDENTIAL,21933,0,21933,91194,0,113127
143015301200000,NW 324,RESIDENTIAL,23046,0,23046,102258,0,125304
143015301300000,NW 324,RESIDENTIAL,23296,0,23296,85361,0,108657
143015301400000,NW 324,RESIDENTIAL,24960,0,24960,82737,0,107697
143015301500000,NW 324,RESIDENTIAL,24960,0,24960,84445,0,109405
143015301600000,NW 324,RESIDENTIAL,25200,0,25200,69030,0,94230
143015301700000,NW 324,RESIDENTIAL,25200,0,25200,102822,0,128022
143015301800000,NW 324,RESIDENTIAL,25200,0,25200,97011,0,122211
143015301900000,NW 324,RESIDENTIAL,25200,0,25200,88107,0,113307
143015400100000,NW 324,RESIDENTIAL,25248,0,25248,88388,0,113636
143015400200000,NW 324,RESIDENTIAL,24648,0,24648,115313,0,139961
143015400300000,NW 324,RESIDENTIAL,24948,0,24948,91290,0,116238
143015400400000,NW 324,RESIDENTIAL,25218,0,25218,104537,0,129755
143015400500000,NW 324,RESIDENTIAL,24648,0,24648,111099,0,135747
143015400600000,NW 324,RESIDENTIAL,23760,0,23760,83740,0,107500
143015400700000,NW 324,RESIDENTIAL,23760,0,23760,93775,0,117535
143015400800000,NW 324,RESIDENTIAL,22176,0,22176,88699,0,110875
143015400900000,NW 324,RESIDENTIAL,23760,0,23760,94453,0,118213
143015401000000,NW 324,RESIDENTIAL,24354,0,24354,92975,0,117329
143015401100000,NW 324,RESIDENTIAL,22238,0,22238,121055,0,143293
143015401200000,NW 324,RESIDENTIAL,22233,0,22233,108981,0,131214
143015401300000,NW 324,RESIDENTIAL,23760,0,23760,90705,0,114465
143015401400000,NW 324,RESIDENTIAL,23760,0,23760,95322,0,119082
143015401500000,NW 324,RESIDENTIAL,22176,0,22176,80000,0,102176
143015401600000,NW 324,RESIDENTIAL,23760,0,23760,87722,0,111482
143015401700000,NW 324,RESIDENTIAL,24948,0,24948,90718,0,115666
143015401800000,NW 324,RESIDENTIAL,24060,0,24060,89418,0,113478
143015401900000,NW 324,RESIDENTIAL,26049,0,26049,89787,0,115836
143015402000000,NW 324,RESIDENTIAL,26334,0,26334,94433,0,120767
143015500100000,NW 324,RESIDENTIAL,23819,0,23819,89786,0,113605
143015500200000,NW 324,RESIDENTIAL,23520,0,23520,82655,0,106175
143015500300000,NW 324,RESIDENTIAL,24951,0,24951,92101,0,117052
143015500400000,NW 324,RESIDENTIAL,23520,0,23520,90335,0,113855
143015500500000,NW 324,RESIDENTIAL,23520,0,23520,77160,0,100680
143015500600000,NW 324,RESIDENTIAL,24952,0,24952,85137,0,110089
143015500700000,NW 324,RESIDENTIAL,23520,0,23520,78146,0,101666
143015500800000,NW 324,RESIDENTIAL,21952,0,21952,79065,0,101017
143015500900000,NW 324,RESIDENTIAL,23520,0,23520,97836,0,121356
143015501000000,NW 324,RESIDENTIAL,21952,0,21952,80402,0,102354
143015501100000,NW 324,RESIDENTIAL,21550,0,21550,91632,0,113182
143015501200000,NW 324,RESIDENTIAL,119450,0,119450,250588,0,370038
143015501300000,SCHOOL,EXEMPT,0,0,0,0,0,0
143017600100000,GROCERY STORE,COMMERCIAL,0,554000,554000,0,3302700,3856700
143017600200000,NW 324,RESIDENTIAL,24400,0,24400,91429,0,115829
143017600300000,NW 324,RESIDENTIAL,24400,0,24400,84026,0,108426
143017600400000,NW 324,RESIDENTIAL,33818,0,33818,100287,0,134105
143017600500000,NW 324,RESIDENTIAL,33818,0,33818,91891,0,125709
143017600600000,NW 324,RESIDENTIAL,32940,0,32940,98348,0,131288
143017600700000,NW 324,RESIDENTIAL,29280,0,29280,107225,0,136505
143017600800000,NW 324,RESIDENTIAL,31720,0,31720,97457,0,129177
143017600900000,NW 324,RESIDENTIAL,32448,0,32448,95459,0,127907
143017601000000,NW 324,RESIDENTIAL,21840,0,21840,102241,0,124081
143017601100000,NW 324,RESIDENTIAL,19400,0,19400,45085,0,64485
143017601200000,NW 324,RESIDENTIAL,19400,0,19400,94809,0,114209
143017601300000,NW 324,RESIDENTIAL,22000,0,22000,54705,0,76705
143017601400000,NW 324,RESIDENTIAL,24400,0,24400,74565,0,98965
143017601500000,NW 324,RESIDENTIAL,19968,0,19968,81144,0,101112
143017601600000,NW 324,RESIDENTIAL,28832,0,28832,94384,0,123216
143017601700000,NW 324,RESIDENTIAL,21840,0,21840,91487,0,113327
143017601800000,NW 324,RESIDENTIAL,21840,0,21840,102625,0,124465
143017601900000,NW 324,RESIDENTIAL,21840,0,21840,93255,0,115095
143017602000000,NW 324,RESIDENTIAL,30355,0,30355,87665,0,118020
143017602100000,NW 324,RESIDENTIAL,24400,0,24400,94029,0,118429
143017602200000,NW 324,RESIDENTIAL,24400,0,24400,104436,0,128836
143017602300000,NW 324,RESIDENTIAL,36600,0,36600,132635,0,169235
143017602400000,NW 324,RESIDENTIAL,24400,0,24400,32403,0,56803
143017602500000,NW 324,RESIDENTIAL,24400,0,24400,72517,0,96917
143017602600000,NW 324,RESIDENTIAL,24400,0,24400,70036,0,94436
143017602700000,NW 324,RESIDENTIAL,24400,0,24400,94842,0,119242
143017602800000,NW 324,RESIDENTIAL,33818,0,33818,110939,0,144757
143017602900000,NW 324,RESIDENTIAL,33818,0,33818,103484,0,137302
143017603000000,NW 324,RESIDENTIAL,36600,0,36600,64160,0,100760
143017603100000,NW 324,RESIDENTIAL,36600,0,36600,101821,0,138421
143017603200000,NW 324,RESIDENTIAL,24400,0,24400,71946,0,96346
143017700100000,NW 324,RESIDENTIAL,24797,0,24797,72206,0,97003
143017700200000,NW 324,RESIDENTIAL,21400,0,21400,62635,0,84035
143017700300000,NW 324,RESIDENTIAL,22657,0,22657,79162,0,101819
143017700400000,NW 324,RESIDENTIAL,27720,0,27720,84542,0,112262
143017700500000,NW 324,RESIDENTIAL,26208,0,26208,86197,0,112405
143017700600000,NW 324,RESIDENTIAL,29232,0,29232,68797,0,98029
143017700700000,NW 324,RESIDENTIAL,29367,0,29367,76953,0,106320
143017700800000,NW 324,RESIDENTIAL,24349,0,24349,82173,0,106522
143017700900000,NW 324,RESIDENTIAL,23256,0,23256,83745,0,107001
143017701000000,NW 324,RESIDENTIAL,24720,0,24720,56961,0,81681
143017701100000,NW 324,RESIDENTIAL,24720,0,24720,77956,0,102676
143017701200000,NW 324,RESIDENTIAL,24720,0,24720,95028,0,119748
143017701300000,NW 324,RESIDENTIAL,24720,0,24720,100696,0,125416
143017701400000,NW 324,RESIDENTIAL,24720,0,24720,97530,0,122250
143017701500000,NW 324,RESIDENTIAL,24720,0,24720,47861,0,72581
143017701600000,NW 324,RESIDENTIAL,24173,0,24173,49989,0,74162
143017701700000,NW 324,RESIDENTIAL,27357,0,27357,99544,0,126901
143017701800000,NW 324,RESIDENTIAL,27357,0,27357,88320,0,115677
143017701900000,NW 324,RESIDENTIAL,25936,0,25936,67946,0,93882
143017702000000,NW 324,RESIDENTIAL,26513,0,26513,50021,0,76534
143017702100000,NW 324,RESIDENTIAL,33211,0,33211,47429,0,80640
143017702200000,NW 324,RESIDENTIAL,23458,0,23458,62911,0,86369
143017702300000,NW 324,RESIDENTIAL,25440,0,25440,78079,0,103519
143017702400000,NW 324,RESIDENTIAL,25440,0,25440,96676,0,122116
143017702500000,NW 324,RESIDENTIAL,22560,0,22560,107420,0,129980
143017702600000,NW 324,RESIDENTIAL,11360,0,11360,37967,0,49327
143017800100000,NW 324,RESIDENTIAL,24720,0,24720,80697,0,105417
143017800200000,NW 324,RESIDENTIAL,24854,0,24854,87329,0,112183
143017800300000,NW 324,RESIDENTIAL,23520,0,23520,73940,0,97460
143017800400000,NW 324,RESIDENTIAL,23520,0,23520,82768,0,106288
143017800500000,NW 324,RESIDENTIAL,23520,0,23520,81682,0,105202
143017800600000,NW 324,RESIDENTIAL,23520,0,23520,75342,0,98862
143017800700000,NW 324,RESIDENTIAL,23520,0,23520,74135,0,97655
143017800800000,NW 324,RESIDENTIAL,23520,0,23520,84155,0,107675
143017800900000,NW 324,RESIDENTIAL,23520,0,23520,89299,0,112819
143017801000000,NW 324,RESIDENTIAL,23334,0,23334,57656,0,80990
143017900100000,NW 324,RESIDENTIAL,28080,0,28080,96691,0,124771
143017900200000,NW 324,RESIDENTIAL,27336,0,27336,102063,0,129399
143017900300000,NW 324,RESIDENTIAL,26532,0,26532,96399,0,122931
143017900400000,NW 324,RESIDENTIAL,26532,0,26532,85767,0,112299
143017900500000,NW 324,RESIDENTIAL,26136,0,26136,75748,0,101884
143017900600000,NW 324,RESIDENTIAL,29964,0,29964,101553,0,131517
143017900700000,NW 324,RESIDENTIAL,26400,0,26400,124815,0,151215
143017900800000,NW 324,RESIDENTIAL,26800,0,26800,85250,0,112050
143017900900000,NW 324,RESIDENTIAL,26800,0,26800,70191,0,96991
143017901000000,NW 324,RESIDENTIAL,26800,0,26800,98028,0,124828
143017901100000,NW 324,RESIDENTIAL,24240,0,24240,116309,0,140549
143017901200000,NW 324,RESIDENTIAL,24240,0,24240,91583,0,115823
143017901300000,NW 324,RESIDENTIAL,26260,0,26260,100758,0,127018
143017901400000,NW 324,RESIDENTIAL,28159,0,28159,112529,0,140688
143017901500000,CHURCH,EXEMPT,0,278424,278424,0,512175,790599
143017901600000,NW 324,RESIDENTIAL,24570,0,24570,64309,0,88879
143017901700000,NW 324,RESIDENTIAL,18096,0,18096,90851,0,108947
143017901800000,NW 324,RESIDENTIAL,18600,0,18600,60018,0,78618
143017901900000,NW 324,RESIDENTIAL,23200,0,23200,99726,0,122926
143017902000000,NW 324,RESIDENTIAL,36600,0,36600,73362,0,109962
143017902100000,NW 324,RESIDENTIAL,21200,0,21200,35268,0,56468
143017902200000,NW 324,RESIDENTIAL,21200,0,21200,113834,0,135034
143017902300000,NW 324,RESIDENTIAL,25440,0,25440,101323,0,126763
143017902400000,NW 324,RESIDENTIAL,25440,0,25440,107109,0,132549
143017902500000,NW 324,RESIDENTIAL,29062,0,29062,97899,0,126961
143020100100000,NW 324,RESIDENTIAL,24786,0,24786,91062,0,115848
143020100200000,NW 324,RESIDENTIAL,25220,0,25220,100491,0,125711
143020100300000,NW 324,RESIDENTIAL,26000,0,26000,93700,0,119700
143020100400000,NW 324,RESIDENTIAL,24480,0,24480,87637,0,112117
143020100500000,NW 324,RESIDENTIAL,24960,0,24960,92617,0,117577
143020100600000,NW 324,RESIDENTIAL,29172,0,29172,74847,0,104019
143020100700000,NW 324,RESIDENTIAL,29172,0,29172,122017,0,151189
143020100800000,NW 324,RESIDENTIAL,25251,0,25251,75477,0,100728
143020100900000,NW 324,RESIDENTIAL,25792,0,25792,78978,0,104770
143020101000000,NW 324,RESIDENTIAL,25792,0,25792,77043,0,102835
143020101100000,NW 324,RESIDENTIAL,26582,0,26582,100078,0,126660
143020101200000,NW 324,RESIDENTIAL,26250,0,26250,79165,0,105415
143020101300000,NW 324,RESIDENTIAL,25792,0,25792,85976,0,111768
143020101400000,NW 324,RESIDENTIAL,25792,0,25792,84979,0,110771
143020101500000,NW 324,RESIDENTIAL,26416,0,26416,86843,0,113259
143020101600000,NW 324,RESIDENTIAL,29172,0,29172,101653,0,130825
143020101700000,NW 324,RESIDENTIAL,28891,0,28891,105386,0,134277
143020101800000,NW 324,RESIDENTIAL,24077,0,24077,92364,0,116441
143020101900000,NW 324,RESIDENTIAL,23866,0,23866,99328,0,123194
143020102000000,NW 324,RESIDENTIAL,24478,0,24478,85860,0,110338
143020102100000,NW 324,RESIDENTIAL,29866,0,29866,118456,0,148322
143020102200000,NW 324,RESIDENTIAL,27174,0,27174,103272,0,130446
143020102300000,NW 324,RESIDENTIAL,27463,0,27463,93052,0,120515
143020102400000,NW 324,RESIDENTIAL,24644,0,24644,82145,0,106789
143020102500000,NW 324,RESIDENTIAL,24644,0,24644,86764,0,111408
143020102600000,NW 324,RESIDENTIAL,24644,0,24644,84230,0,108874
143020102700000,NW 324,RESIDENTIAL,24644,0,24644,88866,0,113510
143020102800000,NW 324,RESIDENTIAL,24644,0,24644,91205,0,115849
143020102900000,NW 324,RESIDENTIAL,24644,0,24644,105746,0,130390
143020103000000,NW 324,RESIDENTIAL,24644,0,24644,103040,0,127684
143020103100000,NW 324,RESIDENTIAL,24644,0,24644,95275,0,119919
143020103200000,NW 324,RESIDENTIAL,24644,0,24644,103808,0,128452
143020103300000,NW 324,RESIDENTIAL,24644,0,24644,97488,0,122132
143020103400000,NW 324,RESIDENTIAL,24967,0,24967,85212,0,110179
143020103500000,NW 324,RESIDENTIAL,24240,0,24240,82268,0,106508
143020103600000,NW 324,RESIDENTIAL,31512,0,31512,85466,0,116978
143020200100000,NW 324,RESIDENTIAL,25851,0,25851,135649,0,161500
143020200200000,NW 324,RESIDENTIAL,23312,0,23312,73580,0,96892
143020200300000,NW 324,RESIDENTIAL,23312,0,23312,88546,0,111858
143020200400000,NW 324,RESIDENTIAL,23312,0,23312,109707,0,133019
143020200500000,NW 324,RESIDENTIAL,23312,0,23312,84290,0,107602
143020200600000,NW 324,RESIDENTIAL,23312,0,23312,89313,0,112625
143020200700000,NW 324,RESIDENTIAL,23312,0,23312,118202,0,141514
143020200800000,NW 324,RESIDENTIAL,23312,0,23312,99316,0,122628
143020200900000,NW 324,RESIDENTIAL,23312,0,23312,119678,0,142990
143020201000000,NW 324,RESIDENTIAL,23312,0,23312,102734,0,126046
143020201100000,NW 324,RESIDENTIAL,23312,0,23312,99332,0,122644
143020201200000,NW 324,RESIDENTIAL,23312,0,23312,75128,0,98440
143020201300000,NW 324,RESIDENTIAL,25115,0,25115,92097,0,117212
143020201400000,APARTMENT,COMMERCIAL,0,45815,45815,0,132375,178190
143020201500000,NW 324,RESIDENTIAL,28440,0,28440,98427,0,126867
143020201600000,NW 324,RESIDENTIAL,26880,0,26880,105077,0,131957
143020201700000,NW 324,RESIDENTIAL,25600,0,25600,107652,0,133252
143020201800000,NW 324,RESIDENTIAL,25088,0,25088,89692,0,114780
143020201900000,NW 324,RESIDENTIAL,24832,0,24832,108286,0,133118
143020202000000,NW 324,RESIDENTIAL,24832,0,24832,85930,0,110762
143020202100000,NW 324,RESIDENTIAL,24832,0,24832,112274,0,137106
143020202200000,NW 324,RESIDENTIAL,24832,0,24832,122177,0,147009
143020202300000,NW 324,RESIDENTIAL,24832,0,24832,120450,0,145282
143020202400000,NW 324,RESIDENTIAL,24832,0,24832,100370,0,125202
143020202500000,NW 324,RESIDENTIAL,24848,0,24848,104996,0,129844
143020300100000,CITY PROPERTY,EXEMPT,0,0,0,0,0,0
143020300200000,NW 324,RESIDENTIAL,11600,0,11600,0,0,11600
143020300300000,NW 324,RESIDENTIAL,22861,0,22861,123345,0,146206
143020300400000,NW 324,RESIDENTIAL,22861,0,22861,101971,0,124832
143020300500000,NW 324,RESIDENTIAL,22560,0,22560,102994,0,125554
143020300600000,NW 324,RESIDENTIAL,22560,0,22560,96420,0,118980
143020300700000,NW 324,RESIDENTIAL,22560,0,22560,79396,0,101956
143020300800000,NW 324,RESIDENTIAL,22560,0,22560,94337,0,116897
143020300900000,NW 324,RESIDENTIAL,22560,0,22560,95493,0,118053
143020301000000,NW 324,RESIDENTIAL,24487,0,24487,121435,0,145922
143020301100000,NW 324,RESIDENTIAL,24904,0,24904,85843,0,110747
143020301200000,NW 324,RESIDENTIAL,22560,0,22560,92380,0,114940
143020301300000,NW 324,RESIDENTIAL,22560,0,22560,97090,0,119650
143020301400000,NW 324,RESIDENTIAL,22560,0,22560,91068,0,113628
143020301500000,NW 324,RESIDENTIAL,22560,0,22560,84323,0,106883
143020301600000,NW 324,RESIDENTIAL,22560,0,22560,91834,0,114394
143020301700000,NW 324,RESIDENTIAL,22861,0,22861,83502,0,106363
143020301800000,NW 324,RESIDENTIAL,22861,0,22861,99023,0,121884
143020400100000,NW 324,RESIDENTIAL,26098,0,26098,81971,0,108069
143020400200000,CITY PROPERTY,EXEMPT,0,0,0,0,0,0
143020400300000,CITY PROPERTY,EXEMPT,0,0,0,0,0,0
143020400400000,NW 324,RESIDENTIAL,25738,0,25738,101321,0,127059
143020400500000,NW 324,RESIDENTIAL,24832,0,24832,97402,0,122234
143020400600000,NW 324,RESIDENTIAL,24832,0,24832,98046,0,122878
143020400700000,NW 324,RESIDENTIAL,24832,0,24832,111406,0,136238
143020400800000,NW 324,RESIDENTIAL,24832,0,24832,106969,0,131801
143020400900000,NW 324,RESIDENTIAL,24832,0,24832,112198,0,137030
143020401000000,NW 324,RESIDENTIAL,24832,0,24832,93476,0,118308
143020401100000,NW 324,RESIDENTIAL,24832,0,24832,111730,0,136562
143020401200000,NW 324,RESIDENTIAL,24832,0,24832,105635,0,130467
143020401300000,NW 324,RESIDENTIAL,23808,0,23808,130450,0,154258
143020401500000,NW 324,RESIDENTIAL,24311,0,24311,62612,0,86923
143020401600000,NW 324,RESIDENTIAL,31504,0,31504,68326,0,99830
143020401700000,NW 324,RESIDENTIAL,23280,0,23280,83442,0,106722
143020401800000,NW 324,RESIDENTIAL,26190,0,26190,86955,0,113145
143020401900000,NW 324,RESIDENTIAL,25048,0,25048,81896,0,106944
143020402000000,NW 324,RESIDENTIAL,24886,0,24886,92461,0,117347
143020402100000,NW 324,RESIDENTIAL,24240,0,24240,101415,0,125655
143020402200000,NW 324,RESIDENTIAL,24240,0,24240,100274,0,124514
143020402300000,NW 324,RESIDENTIAL,24240,0,24240,90078,0,114318
143020402400000,NW 324,RESIDENTIAL,24240,0,24240,101363,0,125603
143020402500000,NW 324,RESIDENTIAL,24240,0,24240,102973,0,127213
143020402600000,NW 324,RESIDENTIAL,24240,0,24240,109866,0,134106
143020402700000,NW 324,RESIDENTIAL,24644,0,24644,84543,0,109187
143020402800000,NW 324,RESIDENTIAL,24644,0,24644,111017,0,135661
143020402900000,NW 324,RESIDENTIAL,24644,0,24644,93231,0,117875
143020403000000,NW 324,RESIDENTIAL,24644,0,24644,128805,0,153449
143020500100000,NW 324,RESIDENTIAL,23508,0,23508,91903,0,115411
143020500200000,NW 324,RESIDENTIAL,22264,0,22264,113362,0,135626
143020500300000,NW 324,RESIDENTIAL,22568,0,22568,101024,0,123592
143020500400000,NW 324,RESIDENTIAL,22568,0,22568,79819,0,102387
143020500500000,NW 324,RESIDENTIAL,22568,0,22568,81972,0,104540
143020500600000,NW 324,RESIDENTIAL,22725,0,22725,78736,0,101461
143022600100000,NW 324,RESIDENTIAL,22618,0,22618,96302,0,118920
143022600200000,NW 324,RESIDENTIAL,22618,0,22618,111978,0,134596
143022600300000,NW 324,RESIDENTIAL,22618,0,22618,114104,0,136722
143022600400000,NW 324,RESIDENTIAL,22320,0,22320,96021,0,118341
143022600500000,NW 324,RESIDENTIAL,22320,0,22320,80385,0,102705
143022600600000,NW 324,RESIDENTIAL,22320,0,22320,93549,0,115869
143022600700000,NW 324,RESIDENTIAL,22320,0,22320,99151,0,121471
143022600800000,NW 324,RESIDENTIAL,22320,0,22320,96965,0,119285
143022600900000,NW 324,RESIDENTIAL,22320,0,22320,95364,0,117684
143022601000000,NW 324,RESIDENTIAL,21840,0,21840,93951,0,115791
143022601100000,NW 324,RESIDENTIAL,22037,0,22037,101141,0,123178
143022601200000,NW 324,RESIDENTIAL,11232,0,11232,0,0,11232
143022601300000,NW 324,RESIDENTIAL,31824,0,31824,92504,0,124328
143022601400000,NW 324,RESIDENTIAL,22926,0,22926,91160,0,114086
143022601500000,NW 324,RESIDENTIAL,22568,0,22568,122802,0,145370
143022601600000,NW 324,RESIDENTIAL,23515,0,23515,78548,0,102063
143022601700000,NW 324,RESIDENTIAL,22704,0,22704,84855,0,107559
143022601800000,NW 324,RESIDENTIAL,22320,0,22320,91839,0,114159
143022601900000,NW 324,RESIDENTIAL,22320,0,22320,91592,0,113912
143022602000000,NW 324,RESIDENTIAL,22320,0,22320,99952,0,122272
143022602100000,NW 324,RESIDENTIAL,22320,0,22320,85240,0,107560
143022602200000,NW 324,RESIDENTIAL,22320,0,22320,98330,0,120650
143022602300000,NW 324,RESIDENTIAL,22320,0,22320,88644,0,110964
143022602400000,NW 324,RESIDENTIAL,22618,0,22618,93216,0,115834
143022700100000,CENTRALLY ASSESSED,OTHER,0,0,0,0,0,0
143022700200000,NW 324,RESIDENTIAL,26512,0,26512,92011,0,118523
143022700300000,NW 324,RESIDENTIAL,26664,0,26664,88283,0,114947
143022700400000,NW 324,RESIDENTIAL,27472,0,27472,113084,0,140556
143022700500000,NW 324,RESIDENTIAL,25856,0,25856,97330,0,123186
143022700600000,NW 324,RESIDENTIAL,28381,0,28381,94049,0,122430
143022700700000,NW 324,RESIDENTIAL,28280,0,28280,107236,0,135516
143022700800000,NW 324,RESIDENTIAL,29088,0,29088,102145,0,131233
143022700900000,NW 324,RESIDENTIAL,34325,0,34325,93694,0,128019
143022701000000,NW 324,RESIDENTIAL,23038,0,23038,97060,0,120098
143022701100000,NW 324,RESIDENTIAL,22800,0,22800,117787,0,140587
143022701200000,NW 324,RESIDENTIAL,22800,0,22800,94129,0,116929
143022701300000,NW 324,RESIDENTIAL,22800,0,22800,98693,0,121493
143022701400000,NW 324,RESIDENTIAL,22800,0,22800,80958,0,103758
143022701500000,NW 324,RESIDENTIAL,22800,0,22800,109578,0,132378
143022701600000,NW 324,RESIDENTIAL,22800,0,22800,96875,0,119675
143022701700000,NW 324,RESIDENTIAL,22800,0,22800,91445,0,114245
143022701800000,NW 324,RESIDENTIAL,22800,0,22800,116993,0,139793
143022701900000,NW 324,RESIDENTIAL,22800,0,22800,96561,0,119361
143022702000000,NW 324,RESIDENTIAL,22800,0,22800,86735,0,109535
143022702100000,NW 324,RESIDENTIAL,22800,0,22800,116605,0,139405
143022702200000,NW 324,RESIDENTIAL,22800,0,22800,85521,0,108321
143022800100000,FLAT PARKING,COMMERCIAL,0,51340,51340,0,2080,53420
143022800200000,FAST FOOD,COMMERCIAL,0,140000,140000,0,231921,371921
143022800300000,NW 324,RESIDENTIAL,17,0,17,0,0,17
143022800400000,NBHD SHOPPING CENTER,COMMERCIAL,0,961000,961000,0,2468663,3429663
143022800500000,NBHD SHOPPING CENTER,COMMERCIAL,0,582350,582350,0,946533,1528883
143022800600000,CARWASH,COMMERCIAL,0,194400,194400,0,165377,359777
143022800900000,LAUNDROMAT/CLEANERS,COMMERCIAL,0,39598,39598,0,167175,206773
143022801000000,SMALL RETAIL,COMMERCIAL,0,151905,151905,0,113688,265593
143022801100000,SMALL RETAIL,COMMERCIAL,0,154980,154980,0,111927,266907
143022801200000,RESTAURANT,COMMERCIAL,0,51935,51935,0,173626,225561
143022801300000,SMALL RETAIL,COMMERCIAL,0,49005,49005,0,85175,134180
143022801400000,NW 324,RESIDENTIAL,27720,0,27720,63483,0,91203
143022801500000,NW 324,RESIDENTIAL,22325,0,22325,91998,0,114323
143022801600000,NW 324,RESIDENTIAL,28280,0,28280,97732,0,126012
143022801700000,NW 324,RESIDENTIAL,29088,0,29088,105436,0,134524
143022801800000,NW 324,RESIDENTIAL,28280,0,28280,87926,0,116206
143022801900000,NW 324,RESIDENTIAL,26260,0,26260,87700,0,113960
143022802000000,NW 324,RESIDENTIAL,25856,0,25856,101657,0,127513
143022802100000,NW 324,RESIDENTIAL,25856,0,25856,86337,0,112193
143022802200000,NW 324,RESIDENTIAL,27068,0,27068,103119,0,130187
143022802300000,NW 324,RESIDENTIAL,26057,0,26057,148603,0,174660
143022802400000,VACANT LAND,COMMERCIAL,0,2979,2979,0,0,2979
143022802500000,VACANT LAND,COMMERCIAL,0,37303,37303,0,0,37303
143022802600000,VACANT LAND,COMMERCIAL,0,18419,18419,0,0,18419
143022802700000,VACANT LAND,COMMERCIAL,0,18419,18419,0,0,18419
143022802800000,VACANT LAND,COMMERCIAL,0,20429,20429,0,0,20429
143022802900000,VACANT LAND,COMMERCIAL,0,20160,20160,0,0,20160
143022803000000,VACANT LAND,COMMERCIAL,0,17374,17374,0,0,17374
143022900700000,FLAT PARKING,COMMERCIAL,0,204,204,0,0,204
143022900800000,FLAT PARKING,COMMERCIAL,0,20,20,0,0,20
143025100100000,OFFICE,COMMERCIAL,0,114240,114240,0,176197,290437
143025100200000,OFFICE,COMMERCIAL,0,109152,109152,0,165131,274283
143025100500000,APARTMENT,COMMERCIAL,0,14980,14980,0,119195,134175
143025100600000,APARTMENT,COMMERCIAL,0,16380,16380,0,110745,127125
143025100700000,APARTMENT,COMMERCIAL,0,16560,16560,0,119392,135952
143025100800000,NW 333,RESIDENTIAL,28587,0,28587,93565,0,122152
143025100900000,NW 333,RESIDENTIAL,36012,0,36012,131302,0,167314
143025101000000,NW 333,RESIDENTIAL,44779,0,44779,150898,0,195677
143025101100000,NW 333,RESIDENTIAL,33046,0,33046,121472,0,154518
143025101200000,NW 333,RESIDENTIAL,33228,0,33228,96981,0,130209
143025101300000,NW 333,RESIDENTIAL,35100,0,35100,106474,0,141574
143025101400000,NW 333,RESIDENTIAL,35100,0,35100,92384,0,127484
143025101500000,NW 333,RESIDENTIAL,35100,0,35100,115184,0,150284
143025101600000,NW 333,RESIDENTIAL,35100,0,35100,90223,0,125323
143025101700000,NW 333,RESIDENTIAL,35802,0,35802,129458,0,165260
143025101800000,NW 333,RESIDENTIAL,32760,0,32760,104252,0,137012
143025101900000,NW 333,RESIDENTIAL,31200,0,31200,96293,0,127493
143025102000000,NW 333,RESIDENTIAL,31853,0,31853,95852,0,127705
143025102100000,NW 333,RESIDENTIAL,31200,0,31200,132515,0,163715
143025102200000,NW 333,RESIDENTIAL,31800,0,31800,176348,0,208148
143025102300000,NW 333,RESIDENTIAL,31800,0,31800,166856,0,198656
143025102400000,NW 333,RESIDENTIAL,30952,0,30952,174491,0,205443
143025102500000,NW 333,RESIDENTIAL,55080,0,55080,371895,0,426975
143025102600000,NW 324,RESIDENTIAL,57900,0,57900,0,0,57900
143025200100000,APARTMENT,COMMERCIAL,0,18000,18000,0,126726,144726
143025200200000,APARTMENT,COMMERCIAL,0,18000,18000,0,116706,134706
143025200300000,VACANT LAND,COMMERCIAL,0,404500,404500,0,0,404500
143025200400000,NW 333,RESIDENTIAL,31393,0,31393,131334,0,162727
143025200500000,NW 333,RESIDENTIAL,37183,0,37183,134159,0,171342
143025200600000,NW 333,RESIDENTIAL,36032,0,36032,102761,0,138793
143025200700000,NW 333,RESIDENTIAL,30528,0,30528,118723,0,149251
143025200800000,NW 333,RESIDENTIAL,30528,0,30528,87044,0,117572
143025200900000,NW 333,RESIDENTIAL,30528,0,30528,80531,0,111059
143025201000000,NW 333,RESIDENTIAL,30528,0,30528,102550,0,133078
143025201100000,NW 333,RESIDENTIAL,30528,0,30528,84862,0,115390
143025201200000,NW 333,RESIDENTIAL,30782,0,30782,111379,0,142161
143025201300000,NW 333,RESIDENTIAL,29962,0,29962,89964,0,119926
143025201400000,NW 333,RESIDENTIAL,29680,0,29680,90240,0,119920
143025201500000,NW 333,RESIDENTIAL,29680,0,29680,86260,0,115940
143025201600000,NW 333,RESIDENTIAL,30210,0,30210,116552,0,146762
143025201700000,NW 333,RESIDENTIAL,30210,0,30210,100375,0,130585
143025201800000,NW 333,RESIDENTIAL,30210,0,30210,112554,0,142764
143025201900000,NW 333,RESIDENTIAL,29680,0,29680,97521,0,127201
143025202000000,NW 333,RESIDENTIAL,29991,0,29991,116830,0,146821
143025202100000,NW 333,RESIDENTIAL,29640,0,29640,112705,0,142345
143025202200000,NW 333,RESIDENTIAL,29120,0,29120,105581,0,134701
143025202300000,NW 333,RESIDENTIAL,29952,0,29952,101191,0,131143
143025202400000,NW 333,RESIDENTIAL,27040,0,27040,111884,0,138924
143025202500000,NW 333,RESIDENTIAL,29640,0,29640,120330,0,149970
143025202600000,NW 333,RESIDENTIAL,29528,0,29528,103597,0,133125
143025202700000,NW 333,RESIDENTIAL,29120,0,29120,113435,0,142555
143025202800000,APARTMENT,RESIDENTIAL,17920,0,17920,137628,0,155548
143025300200000,CONVENIENCE STORE,COMMERCIAL,0,637000,637000,0,605478,1242478
143025300300000,NBHD SHOPPING CENTER,COMMERCIAL,0,294800,294800,0,215917,510717
143025300400000,NW 333,RESIDENTIAL,29037,0,29037,72230,0,101267
143025300500000,NW 333,RESIDENTIAL,29120,0,29120,78324,0,107444
143025300600000,NW 333,RESIDENTIAL,29120,0,29120,90262,0,119382
143025300700000,NW 333,RESIDENTIAL,29120,0,29120,92626,0,121746
143025300800000,NW 333,RESIDENTIAL,29065,0,29065,77408,0,106473
143025300900000,NW 333,RESIDENTIAL,30727,0,30727,85051,0,115778
143025301000000,NW 333,RESIDENTIAL,29120,0,29120,83384,0,112504
143025301100000,NW 333,RESIDENTIAL,29120,0,29120,77759,0,106879
143025301200000,NW 333,RESIDENTIAL,29120,0,29120,68533,0,97653
143025301300000,NW 333,RESIDENTIAL,29120,0,29120,91472,0,120592
143025301400000,NW 333,RESIDENTIAL,30257,0,30257,88043,0,118300
143025400100000,NW 333,RESIDENTIAL,29646,0,29646,115411,0,145057
143025400200000,NW 333,RESIDENTIAL,30097,0,30097,105785,0,135882
143025400300000,NW 333,RESIDENTIAL,29680,0,29680,96632,0,126312
143025400400000,NW 333,RESIDENTIAL,30210,0,30210,98010,0,128220
143025400500000,NW 333,RESIDENTIAL,29680,0,29680,81336,0,111016
143025400600000,NW 333,RESIDENTIAL,30210,0,30210,116551,0,146761
143025400700000,NW 333,RESIDENTIAL,29680,0,29680,103463,0,133143
143025400800000,NW 333,RESIDENTIAL,30210,0,30210,95398,0,125608
143025400900000,NW 333,RESIDENTIAL,29680,0,29680,92117,0,121797
143025401000000,NW 333,RESIDENTIAL,28408,0,28408,111082,0,139490
143025401100000,NW 333,RESIDENTIAL,31418,0,31418,123113,0,154531
143025401200000,NW 333,RESIDENTIAL,30210,0,30210,89348,0,119558
143025401300000,NW 333,RESIDENTIAL,29680,0,29680,86975,0,116655
143025401400000,NW 333,RESIDENTIAL,30438,0,30438,99927,0,130365
143025401500000,NW 333,RESIDENTIAL,31811,0,31811,110217,0,142028
143025401600000,NW 333,RESIDENTIAL,29960,0,29960,94728,0,124688
143025401700000,NW 333,RESIDENTIAL,30210,0,30210,132041,0,162251
143025401800000,NW 333,RESIDENTIAL,29680,0,29680,121235,0,150915
143025401900000,NW 333,RESIDENTIAL,30210,0,30210,94611,0,124821
143025402000000,NW 333,RESIDENTIAL,29680,0,29680,144777,0,174457
143025402100000,NW 333,RESIDENTIAL,30210,0,30210,156458,0,186668
143025402200000,NW 333,RESIDENTIAL,29680,0,29680,119952,0,149632
143025402300000,NW 333,RESIDENTIAL,30210,0,30210,98471,0,128681
143025402400000,NW 333,RESIDENTIAL,29680,0,29680,118789,0,148469
143025402500000,NW 333,RESIDENTIAL,30210,0,30210,126322,0,156532
143025402600000,NW 333,RESIDENTIAL,29680,0,29680,117653,0,147333
143025500100000,NW 333,RESIDENTIAL,29120,0,29120,81368,0,110488
143025500200000,NW 333,RESIDENTIAL,29120,0,29120,107456,0,136576
143025500300000,NW 333,RESIDENTIAL,29120,0,29120,120255,0,149375
143025500400000,NW 333,RESIDENTIAL,29120,0,29120,80154,0,109274
143025500500000,NW 333,RESIDENTIAL,28160,0,28160,69655,0,97815
143025500600000,NW 333,RESIDENTIAL,28160,0,28160,102207,0,130367
143025500700000,NW 333,RESIDENTIAL,28087,0,28087,89047,0,117134
143025500800000,NW 333,RESIDENTIAL,29231,0,29231,112439,0,141670
143025500900000,NW 333,RESIDENTIAL,28160,0,28160,71765,0,99925
143025501000000,NW 333,RESIDENTIAL,28160,0,28160,109414,0,137574
143025600100000,NW 333,RESIDENTIAL,33300,0,33300,170901,0,204201
143025600200000,NW 333,RESIDENTIAL,33300,0,33300,170769,0,204069
143025600300000,NW 333,RESIDENTIAL,30932,0,30932,102543,0,133475
143025600400000,NW 333,RESIDENTIAL,28812,0,28812,133481,0,162293
143025600500000,NW 333,RESIDENTIAL,28000,0,28000,123708,0,151708
143027600100000,NW 324,RESIDENTIAL,33758,0,33758,97174,0,130932
143027600200000,NW 324,RESIDENTIAL,24240,0,24240,82818,0,107058
143027600300000,NW 324,RESIDENTIAL,24240,0,24240,65362,0,89602
143027600400000,NW 324,RESIDENTIAL,24240,0,24240,81190,0,105430
143027600500000,NW 324,RESIDENTIAL,24240,0,24240,71628,0,95868
143027600600000,NW 324,RESIDENTIAL,24240,0,24240,88796,0,113036
143027600700000,NW 324,RESIDENTIAL,28280,0,28280,79921,0,108201
143027600800000,NW 324,RESIDENTIAL,28280,0,28280,159306,0,187586
143027600900000,NW 324,RESIDENTIAL,29088,0,29088,91575,0,120663
143027601000000,NW 324,RESIDENTIAL,28280,0,28280,116153,0,144433
143027601100000,NW 324,RESIDENTIAL,28280,0,28280,90165,0,118445
143027601200000,NW 324,RESIDENTIAL,28280,0,28280,85025,0,113305
143027601300000,NW 324,RESIDENTIAL,28280,0,28280,84438,0,112718
143027601400000,NW 324,RESIDENTIAL,30300,0,30300,141174,0,171474
143027700200000,NW 324,RESIDENTIAL,24696,0,24696,79828,0,104524
143027700300000,NW 324,RESIDENTIAL,18397,0,18397,46312,0,64709
143027700400000,NW 324,RESIDENTIAL,18393,0,18393,100743,0,119136
143027700500000,NW 324,RESIDENTIAL,18393,0,18393,68247,0,86640
143027700600000,NW 324,RESIDENTIAL,24240,0,24240,0,0,24240
143027700700000,NW 324,RESIDENTIAL,24240,0,24240,66007,0,90247
143027700800000,NW 324,RESIDENTIAL,24240,0,24240,30777,0,55017
143027700900000,NW 324,RESIDENTIAL,45350,0,45350,156153,0,201503
143027701000000,NW 324,RESIDENTIAL,30906,0,30906,76330,0,107236
143027701100000,NW 324,RESIDENTIAL,31129,0,31129,82362,0,113491
143027701200000,NW 324,RESIDENTIAL,40226,0,40226,99763,0,139989
143027701300000,NW 324,RESIDENTIAL,30300,0,30300,162073,0,192373
143027701400000,NW 324,RESIDENTIAL,30300,0,30300,85274,0,115574
143027701500000,NW 324,RESIDENTIAL,29088,0,29088,84617,0,113705
143027701600000,NW 324,RESIDENTIAL,29088,0,29088,97117,0,126205
143027701700000,NW 324,RESIDENTIAL,24240,0,24240,75728,0,99968
143027701800000,NW 324,RESIDENTIAL,24240,0,24240,88350,0,112590
143027701900000,NW 324,RESIDENTIAL,20200,0,20200,86280,0,106480
143027702000000,NW 324,RESIDENTIAL,28280,0,28280,108976,0,137256
143027702100000,NW 324,RESIDENTIAL,24240,0,24240,95398,0,119638
143027702200000,NW 324,RESIDENTIAL,24240,0,24240,99265,0,123505
143027702300000,NW 324,RESIDENTIAL,24240,0,24240,66805,0,91045
143027702400000,NW 324,RESIDENTIAL,24240,0,24240,71529,0,95769
143027702600000,NW 324,RESIDENTIAL,34000,0,34000,0,0,34000
143027702800000,NW 324,RESIDENTIAL,26600,0,26600,66890,0,93490
143027703000000,NW 324,RESIDENTIAL,96,0,96,0,0,96
143027703100000,NW 324,RESIDENTIAL,30704,0,30704,92256,0,122960
143027800100000,NW 324,RESIDENTIAL,18397,0,18397,115022,0,133419
143027800200000,NW 324,RESIDENTIAL,18393,0,18393,67896,0,86289
143027800300000,NW 324,RESIDENTIAL,18393,0,18393,72235,0,90628
143027800400000,AUTO REPAIR/SALES,COMMERCIAL,0,116000,116000,0,100146,216146
143027800402000,CARWASH,COMMERCIAL,0,0,0,0,41661,41661
143027800500000,FAST FOOD,COMMERCIAL,0,102880,102880,0,178599,281479
143027800600000,OFFICE,COMMERCIAL,0,101440,101440,0,161908,263348
143027800700000,MFG HOME PARK,COMMERCIAL,0,326000,326000,0,265723,591723
143027800800000,NW 333,RESIDENTIAL,30952,0,30952,154536,0,185488
143027800900000,NW 333,RESIDENTIAL,31800,0,31800,157043,0,188843
143027801000000,NW 333,RESIDENTIAL,31800,0,31800,173305,0,205105
143027801100000,NW 324,RESIDENTIAL,57500,0,57500,80534,0,138034
143027801200000,NW 324,RESIDENTIAL,5000,0,5000,0,0,5000
143027801300000,NW 324,RESIDENTIAL,31162,0,31162,85596,0,116758
143027801400000,NW 324,RESIDENTIAL,23054,0,23054,81948,0,105002
143027801500000,NW 324,RESIDENTIAL,28473,0,28473,82714,0,111187
143027801600000,NW 324,RESIDENTIAL,28168,0,28168,89054,0,117222
143027801700000,NW 324,RESIDENTIAL,930,0,930,0,0,930
143027801800000,APARTMENT,COMMERCIAL,0,70880,70880,0,198854,269734
143027801900000,NW 324,RESIDENTIAL,9520,0,9520,0,0,9520
143027802000000,NW 324,RESIDENTIAL,24240,0,24240,32315,0,56555
143027802100000,NW 324,RESIDENTIAL,24240,0,24240,82760,0,107000
143027802200000,NW 324,RESIDENTIAL,24240,0,24240,33140,0,57380
143027802400000,NW 333,RESIDENTIAL,30952,0,30952,152268,0,183220
143027802500000,NW 333,RESIDENTIAL,30952,0,30952,145758,0,176710
143027802600000,NW 333,RESIDENTIAL,30952,0,30952,151986,0,182938
143027802700000,NW 333,RESIDENTIAL,30952,0,30952,147250,0,178202
143027900100000,NW 324,RESIDENTIAL,36741,0,36741,102196,0,138937
143027900200000,NW 324,RESIDENTIAL,36630,0,36630,105639,0,142269
143027900300000,NW 324,RESIDENTIAL,36630,0,36630,93883,0,130513
143027900400000,NW 324,RESIDENTIAL,36741,0,36741,112311,0,149052
143027900500000,NW 324,RESIDENTIAL,23320,0,23320,145060,0,168380
143028000100000,NW 333,RESIDENTIAL,33824,0,33824,187165,0,220989
143028000200000,NW 333,RESIDENTIAL,33600,0,33600,173337,0,206937
143028000300000,NW 333,RESIDENTIAL,30694,0,30694,149387,0,180081
143028000400000,NW 333,RESIDENTIAL,28840,0,28840,167314,0,196154
143028000500000,NW 333,RESIDENTIAL,28840,0,28840,168414,0,197254
143028000600000,CITY PROPERTY,EXEMPT,0,0,0,0,0,0
143028100100000,NW 333,RESIDENTIAL,20,0,20,0,0,20
143030100100000,CHURCH,EXEMPT,0,396576,396576,0,864100,1260676
143030100200000,NW 333,RESIDENTIAL,25913,0,25913,110095,0,136008
143030100300000,NW 333,RESIDENTIAL,25860,0,25860,127355,0,153215
143030100400000,NW 333,RESIDENTIAL,26014,0,26014,110698,0,136712
143030100500000,NW 333,RESIDENTIAL,26220,0,26220,107093,0,133313
143030100600000,NW 333,RESIDENTIAL,26220,0,26220,123395,0,149615
143030100700000,NW 333,RESIDENTIAL,26220,0,26220,130234,0,156454
143030100800000,NW 333,RESIDENTIAL,33579,0,33579,141132,0,174711
143030100900000,NW 333,RESIDENTIAL,28280,0,28280,96106,0,124386
143030101000000,CITY PROPERTY,EXEMPT,0,0,0,0,0,0
143030101100000,NW 333,RESIDENTIAL,32123,0,32123,122587,0,154710
143030101200000,NW 333,RESIDENTIAL,29220,0,29220,144369,0,173589
143030101300000,NW 333,RESIDENTIAL,27537,0,27537,90698,0,118235
143030101400000,NW 333,RESIDENTIAL,24240,0,24240,88870,0,113110
143030101500000,NW 333,RESIDENTIAL,27472,0,27472,110608,0,138080
143030200100000,NW 333,RESIDENTIAL,25993,0,25993,106978,0,132971
143030200200000,NW 333,RESIDENTIAL,25280,0,25280,91160,0,116440
143030200300000,NW 333,RESIDENTIAL,24800,0,24800,83126,0,107926
143030200400000,NW 333,RESIDENTIAL,26684,0,26684,91446,0,118130
143030200500000,NW 333,RESIDENTIAL,28896,0,28896,88903,0,117799
143030200600000,NW 333,RESIDENTIAL,39179,0,39179,111969,0,151148
143030300100000,NW 333,RESIDENTIAL,28955,0,28955,138112,0,167067
143030300200000,NW 333,RESIDENTIAL,30562,0,30562,119438,0,150000
143030300300000,NW 333,RESIDENTIAL,33320,0,33320,133829,0,167149
143030300400000,NW 333,RESIDENTIAL,32944,0,32944,123248,0,156192
143030300500000,NW 333,RESIDENTIAL,28920,0,28920,139058,0,167978
143030300600000,NW 333,RESIDENTIAL,29058,0,29058,126660,0,155718
143030300700000,NW 333,RESIDENTIAL,26574,0,26574,89878,0,116452
143030300800000,NW 333,RESIDENTIAL,26574,0,26574,95872,0,122446
143030300900000,NW 333,RESIDENTIAL,26574,0,26574,98322,0,124896
143030301000000,NW 333,RESIDENTIAL,26574,0,26574,87638,0,114212
143030301100000,NW 333,RESIDENTIAL,26574,0,26574,86558,0,113132
143030301200000,NW 333,RESIDENTIAL,26574,0,26574,83453,0,110027
143030301300000,NW 333,RESIDENTIAL,27724,0,27724,88713,0,116437
143030301400000,NW 333,RESIDENTIAL,27520,0,27520,94281,0,121801
143030301500000,NW 333,RESIDENTIAL,56300,0,56300,156701,0,213001
143030301600000,NW 333,RESIDENTIAL,39942,0,39942,102760,0,142702
143030301700000,NW 333,RESIDENTIAL,32096,0,32096,151595,0,183691
143030301800000,NW 333,RESIDENTIAL,31459,0,31459,75840,0,107299
143030301900000,NW 333,RESIDENTIAL,28000,0,28000,126841,0,154841
143030302000000,NW 333,RESIDENTIAL,26477,0,26477,103958,0,130435
143030302100000,NW 333,RESIDENTIAL,29539,0,29539,135274,0,164813
143030302200000,NW 333,RESIDENTIAL,26577,0,26577,117837,0,144414
143030400100000,SW 406,RESIDENTIAL,56650,0,56650,756,0,57406
143030400200000,SW 406,RESIDENTIAL,35986,0,35986,155406,0,191392
143030400300000,SW 406,RESIDENTIAL,29520,0,29520,107457,0,136977
143030400400000,SW 406,RESIDENTIAL,27077,0,27077,146445,0,173522
143030400500000,SW 406,RESIDENTIAL,26965,0,26965,140291,0,167256
143030400600000,SW 406,RESIDENTIAL,23718,0,23718,98273,0,121991
143030400700000,SW 406,RESIDENTIAL,48300,0,48300,90299,0,138599
143030400800000,SW 406,RESIDENTIAL,22680,0,22680,98917,0,121597
143030400900000,SW 406,RESIDENTIAL,27300,0,27300,117031,0,144331
143030401000000,SW 427,RESIDENTIAL,51200,0,51200,207353,0,258553
143030401100000,SW 427,RESIDENTIAL,57350,0,57350,193984,0,251334
143030401200000,SW 427,RESIDENTIAL,28903,0,28903,137226,0,166129
143030401300000,SW 427,RESIDENTIAL,29159,0,29159,136524,0,165683
143030401400000,SW 427,RESIDENTIAL,28463,0,28463,135652,0,164115
143030401500000,SW 427,RESIDENTIAL,28018,0,28018,129421,0,157439
143030401600000,SW 427,RESIDENTIAL,28425,0,28425,97854,0,126279
143030500200000,FRATERNAL,EXEMPT,0,192186,192186,0,1182541,1374727
143030500300000,SW 406,RESIDENTIAL,34272,0,34272,99404,0,133676
143030500400000,SW 406,RESIDENTIAL,59200,0,59200,335502,0,394702
143030500500000,SW 406,RESIDENTIAL,28350,0,28350,65302,0,93652
143030500600000,SW 406,RESIDENTIAL,24111,0,24111,69932,0,94043
143030500700000,SW 406,RESIDENTIAL,32544,0,32544,102590,0,135134
143030500800000,SW 406,RESIDENTIAL,21840,0,21840,91356,0,113196
143032600100000,NW 333,RESIDENTIAL,29169,0,29169,130487,0,159656
143032600200000,NW 333,RESIDENTIAL,27744,0,27744,111196,0,138940
143032600300000,NW 333,RESIDENTIAL,27744,0,27744,114963,0,142707
143032600400000,NW 333,RESIDENTIAL,27744,0,27744,103995,0,131739
143032700100000,NW 333,RESIDENTIAL,24720,0,24720,95185,0,119905
143032700200000,NW 333,RESIDENTIAL,26154,0,26154,88701,0,114855
143032700300000,NW 333,RESIDENTIAL,25956,0,25956,94394,0,120350
143032700400000,NW 333,RESIDENTIAL,28170,0,28170,122767,0,150937
143032800100000,NW 333,RESIDENTIAL,31623,0,31623,103276,0,134899
143032800200000,NW 333,RESIDENTIAL,29120,0,29120,91759,0,120879
143032800300000,NW 333,RESIDENTIAL,29357,0,29357,105899,0,135256
143032900100000,NW 333,RESIDENTIAL,28883,0,28883,114173,0,143056
143032900200000,NW 333,RESIDENTIAL,29120,0,29120,116381,0,145501
143032900300000,NW 333,RESIDENTIAL,29120,0,29120,95309,0,124429
143032900400000,NW 333,RESIDENTIAL,29357,0,29357,89873,0,119230
143033000100000,NW 333,RESIDENTIAL,29376,0,29376,104317,0,133693
143033000200000,NW 333,RESIDENTIAL,26112,0,26112,100142,0,126254
143033000300000,NW 333,RESIDENTIAL,26357,0,26357,106690,0,133047
143033000400000,NW 333,RESIDENTIAL,27744,0,27744,111651,0,139395
143033000500000,NW 333,RESIDENTIAL,26177,0,26177,87760,0,113937
143033000600000,NW 333,RESIDENTIAL,27744,0,27744,107298,0,135042
143033000700000,NW 333,RESIDENTIAL,27744,0,27744,91240,0,118984
143033000800000,NW 333,RESIDENTIAL,29552,0,29552,122613,0,152165
143033000900000,NW 333,RESIDENTIAL,29955,0,29955,83742,0,113697
143033001000000,NW 333,RESIDENTIAL,29952,0,29952,87319,0,117271
143033001100000,NW 333,RESIDENTIAL,29952,0,29952,89509,0,119461
143033001200000,NW 333,RESIDENTIAL,29120,0,29120,102187,0,131307
143033001300000,NW 333,RESIDENTIAL,29952,0,29952,82249,0,112201
143033001400000,NW 333,RESIDENTIAL,29952,0,29952,82986,0,112938
143033001500000,NW 333,RESIDENTIAL,29952,0,29952,84148,0,114100
143033001600000,NW 333,RESIDENTIAL,29952,0,29952,83694,0,113646
143033001700000,NW 333,RESIDENTIAL,29952,0,29952,84508,0,114460
143033001800000,NW 333,RESIDENTIAL,29711,0,29711,84150,0,113861
143033001900000,NW 333,RESIDENTIAL,25772,0,25772,82871,0,108643
143033002000000,NW 333,RESIDENTIAL,25544,0,25544,70278,0,95822
143033002100000,NW 333,RESIDENTIAL,25544,0,25544,101818,0,127362
143033002200000,NW 333,RESIDENTIAL,25544,0,25544,82163,0,107707
143033002300000,NW 333,RESIDENTIAL,25544,0,25544,87289,0,112833
143033002400000,NW 333,RESIDENTIAL,25544,0,25544,88085,0,113629
143033002500000,NW 333,RESIDENTIAL,24682,0,24682,83976,0,108658
143033002600000,NW 333,RESIDENTIAL,28815,0,28815,109966,0,138781
143033002700000,NW 333,RESIDENTIAL,28620,0,28620,117477,0,146097
143033002800000,NW 333,RESIDENTIAL,26005,0,26005,114912,0,140917
143033002900000,NW 333,RESIDENTIAL,25368,0,25368,70465,0,95833
143033003000000,NW 333,RESIDENTIAL,29842,0,29842,97087,0,126929
143033003100000,NW 333,RESIDENTIAL,28016,0,28016,90943,0,118959
143033003200000,NW 333,RESIDENTIAL,28016,0,28016,79663,0,107679
143033003300000,NW 333,RESIDENTIAL,26434,0,26434,101411,0,127845
143033003400000,NW 333,RESIDENTIAL,28016,0,28016,94433,0,122449
143033003500000,NW 333,RESIDENTIAL,28016,0,28016,82926,0,110942
143033003600000,NW 333,RESIDENTIAL,28016,0,28016,107350,0,135366
143033003700000,NW 333,RESIDENTIAL,28016,0,28016,109164,0,137180
143033100100000,NW 333,RESIDENTIAL,28016,0,28016,84579,0,112595
143033100200000,NW 333,RESIDENTIAL,28016,0,28016,96207,0,124223
143033100300000,NW 333,RESIDENTIAL,28016,0,28016,101175,0,129191
143033100400000,NW 333,RESIDENTIAL,28016,0,28016,132749,0,160765
143033100500000,NW 333,RESIDENTIAL,26434,0,26434,87884,0,114318
143033100600000,NW 333,RESIDENTIAL,28016,0,28016,90001,0,118017
143033100700000,NW 333,RESIDENTIAL,28016,0,28016,108898,0,136914
143033100800000,NW 333,RESIDENTIAL,29842,0,29842,92611,0,122453
143033100900000,NW 333,RESIDENTIAL,29422,0,29422,97743,0,127165
143033101000000,NW 333,RESIDENTIAL,29845,0,29845,99616,0,129461
143033101100000,NW 333,RESIDENTIAL,29661,0,29661,110170,0,139831
143033101200000,NW 333,RESIDENTIAL,24720,0,24720,90748,0,115468
143033101300000,NW 333,RESIDENTIAL,25137,0,25137,80556,0,105693
143033101400000,NW 333,RESIDENTIAL,25544,0,25544,80040,0,105584
143033101500000,NW 333,RESIDENTIAL,25544,0,25544,103753,0,129297
143033101600000,NW 333,RESIDENTIAL,25544,0,25544,105466,0,131010
143033101700000,NW 333,RESIDENTIAL,25544,0,25544,84211,0,109755
143033101800000,NW 333,RESIDENTIAL,25544,0,25544,80360,0,105904
143033101900000,NW 333,RESIDENTIAL,25316,0,25316,98122,0,123438
143033102000000,NW 333,RESIDENTIAL,25772,0,25772,81695,0,107467
143033102100000,NW 333,RESIDENTIAL,25544,0,25544,90080,0,115624
143033102200000,NW 333,RESIDENTIAL,25544,0,25544,86712,0,112256
143033102300000,NW 333,RESIDENTIAL,25544,0,25544,97856,0,123400
143033102400000,NW 333,RESIDENTIAL,25544,0,25544,87009,0,112553
143033102500000,NW 333,RESIDENTIAL,24720,0,24720,93291,0,118011
143033102600000,NW 333,RESIDENTIAL,28612,0,28612,107443,0,136055
143033102700000,NW 333,RESIDENTIAL,28824,0,28824,97121,0,125945
143033102800000,NW 333,RESIDENTIAL,26780,0,26780,108600,0,135380
143033102900000,NW 333,RESIDENTIAL,25928,0,25928,83359,0,109287
143033103000000,NW 333,RESIDENTIAL,28560,0,28560,104942,0,133502
143033103100000,NW 333,RESIDENTIAL,29664,0,29664,108873,0,138537
143033103200000,NW 333,RESIDENTIAL,29664,0,29664,117302,0,146966
143033103300000,NW 333,RESIDENTIAL,29862,0,29862,108068,0,137930
143033103400000,NW 333,RESIDENTIAL,29746,0,29746,114873,0,144619
143033103500000,NW 333,RESIDENTIAL,30996,0,30996,131796,0,162792
143033103600000,NW 333,RESIDENTIAL,28922,0,28922,122106,0,151028
143033103700000,NW 333,RESIDENTIAL,25800,0,25800,118036,0,143836
143033103800000,NW 333,RESIDENTIAL,27276,0,27276,88882,0,116158
143033103900000,NW 333,RESIDENTIAL,28500,0,28500,113207,0,141707
143033104000000,NW 333,RESIDENTIAL,28500,0,28500,103544,0,132044
143033104100000,NW 333,RESIDENTIAL,31007,0,31007,96882,0,127889
143033200100000,NW 333,RESIDENTIAL,31188,0,31188,97304,0,128492
143033200200000,NW 333,RESIDENTIAL,29862,0,29862,94900,0,124762
143033200300000,NW 333,RESIDENTIAL,29664,0,29664,91352,0,121016
143033200400000,NW 333,RESIDENTIAL,29664,0,29664,107999,0,137663
143033200500000,NW 333,RESIDENTIAL,30400,0,30400,127411,0,157811
143033200600000,NW 333,RESIDENTIAL,32565,0,32565,113501,0,146066
143033200700000,NW 333,RESIDENTIAL,28520,0,28520,115519,0,144039
143033200800000,NW 333,RESIDENTIAL,28494,0,28494,110731,0,139225
143033200900000,NW 333,RESIDENTIAL,31128,0,31128,93398,0,124526
143033201000000,NW 333,RESIDENTIAL,28840,0,28840,112264,0,141104
143033201100000,NW 333,RESIDENTIAL,28840,0,28840,94134,0,122974
143033201200000,NW 333,RESIDENTIAL,34718,0,34718,124895,0,159613
143033201300000,NW 333,RESIDENTIAL,30138,0,30138,100354,0,130492
143033201400000,NW 333,RESIDENTIAL,24682,0,24682,95683,0,120365
143033201500000,NW 333,RESIDENTIAL,25180,0,25180,74983,0,100163
143033201600000,NW 333,RESIDENTIAL,28491,0,28491,82917,0,111408
143033201700000,NW 333,RESIDENTIAL,25440,0,25440,94318,0,119758
143033201800000,NW 333,RESIDENTIAL,25228,0,25228,72422,0,97650
143033201900000,NW 333,RESIDENTIAL,23256,0,23256,50027,0,73283
143033202000000,NW 333,RESIDENTIAL,26984,0,26984,85191,0,112175
143033202100000,NW 333,RESIDENTIAL,21420,0,21420,0,0,21420
143033202200000,NW 333,RESIDENTIAL,16957,0,16957,75727,0,92684
143033202400000,NW 333,RESIDENTIAL,28373,0,28373,83326,0,111699
143033202500000,NW 333,RESIDENTIAL,27720,0,27720,97697,0,125417
143033202600000,NW 333,RESIDENTIAL,28169,0,28169,93719,0,121888
143033202700000,NW 333,RESIDENTIAL,34658,0,34658,58660,0,93318
143033202800000,NW 333,RESIDENTIAL,33966,0,33966,109398,0,143364
143033202900000,NW 333,RESIDENTIAL,34200,0,34200,90060,0,124260
143033203000000,NW 333,RESIDENTIAL,30348,0,30348,125776,0,156124
143033203100000,NW 333,RESIDENTIAL,28800,0,28800,97785,0,126585
143033203200000,NW 333,RESIDENTIAL,40180,0,40180,176150,0,216330
143033203300000,NW 333,RESIDENTIAL,41210,0,41210,79752,0,120962
143033300100000,SW 406,RESIDENTIAL,32742,0,32742,87779,0,120521
143033300200000,SW 406,RESIDENTIAL,30548,0,30548,99297,0,129845
143033300300000,SW 406,RESIDENTIAL,36225,0,36225,160753,0,196978
143033300400000,SW 406,RESIDENTIAL,36225,0,36225,134342,0,170567
143033300500000,SW 406,RESIDENTIAL,36225,0,36225,117130,0,153355
143033300600000,SW 406,RESIDENTIAL,36070,0,36070,135683,0,171753
143033400100000,SW 406,RESIDENTIAL,29376,0,29376,95353,0,124729
143033400200000,SW 406,RESIDENTIAL,27968,0,27968,89621,0,117589
143033400300000,SW 406,RESIDENTIAL,33201,0,33201,129565,0,162766
143033400400000,SW 406,RESIDENTIAL,33048,0,33048,118696,0,151744
143033400500000,SW 406,RESIDENTIAL,32130,0,32130,116528,0,148658
143033400600000,CHURCH,EXEMPT,0,224640,224640,0,716376,941016
143033400700000,SW 406,RESIDENTIAL,45050,0,45050,93680,0,138730
143033400800000,SW 406,RESIDENTIAL,37834,0,37834,127478,0,165312
143033400900000,SW 406,RESIDENTIAL,37584,0,37584,110821,0,148405
143033401000000,SW 406,RESIDENTIAL,4296,0,4296,0,0,4296
143033500100000,SW 406,RESIDENTIAL,29382,0,29382,99509,0,128891
143035100100000,SW 406,RESIDENTIAL,35190,0,35190,117183,0,152373
143035100200000,SW 406,RESIDENTIAL,34155,0,34155,103160,0,137315
143035100300000,SW 406,RESIDENTIAL,32775,0,32775,94574,0,127349
143035100400000,SW 406,RESIDENTIAL,31104,0,31104,116767,0,147871
143035100500000,SW 406,RESIDENTIAL,27360,0,27360,93354,0,120714
143035200100000,SW 406,RESIDENTIAL,27936,0,27936,116805,0,144741
143035200200000,SW 406,RESIDENTIAL,27936,0,27936,92043,0,119979
143035200300000,SW 406,RESIDENTIAL,25105,0,25105,78929,0,104034
143035200400000,SW 406,RESIDENTIAL,25488,0,25488,94280,0,119768
143035200500000,SW 406,RESIDENTIAL,26550,0,26550,72694,0,99244
143035200600000,SW 406,RESIDENTIAL,27776,0,27776,90362,0,118138
143035200700000,SW 406,RESIDENTIAL,28811,0,28811,89564,0,118375
143035200800000,SW 406,RESIDENTIAL,28888,0,28888,93432,0,122320
143035300100000,SW 406,RESIDENTIAL,27284,0,27284,95134,0,122418
143035300200000,SW 406,RESIDENTIAL,42476,0,42476,144008,0,186484
143035300300000,SW 406,RESIDENTIAL,33048,0,33048,114092,0,147140
143035300400000,SW 406,RESIDENTIAL,19398,0,19398,93739,0,113137
143035300500000,SW 406,RESIDENTIAL,22567,0,22567,97698,0,120265
143035300600000,SW 406,RESIDENTIAL,22567,0,22567,80125,0,102692
143035300700000,DAY CARE CENTER,COMMERCIAL,0,97571,97571,0,90953,188524
143035300800000,SR/NURSING/ASSTD LIV,COMMERCIAL,0,52880,52880,0,649408,702288
143035300900000,SW 406,RESIDENTIAL,25461,0,25461,74341,0,99802
143035301000000,SW 406,RESIDENTIAL,25461,0,25461,60636,0,86097
143035301100000,SW 406,RESIDENTIAL,28711,0,28711,94362,0,123073
143035301200000,SW 406,RESIDENTIAL,27284,0,27284,95984,0,123268
143035301300000,SW 406,RESIDENTIAL,27284,0,27284,84652,0,111936
143035301400000,SW 406,RESIDENTIAL,27284,0,27284,91425,0,118709
143035301500000,SW 406,RESIDENTIAL,27284,0,27284,88053,0,115337
143035301600000,SW 406,RESIDENTIAL,27284,0,27284,92057,0,119341
143035301700000,SW 406,RESIDENTIAL,27284,0,27284,83991,0,111275
143035301800000,SW 406,RESIDENTIAL,27284,0,27284,99987,0,127271
143035301900000,SW 406,RESIDENTIAL,27284,0,27284,89553,0,116837
143035400100000,SW 406,RESIDENTIAL,27936,0,27936,95411,0,123347
143035400200000,SW 406,RESIDENTIAL,27936,0,27936,91154,0,119090
143035400300000,SW 406,EXEMPT,0,56450,56450,0,166317,222767
143035400400000,SW 406,RESIDENTIAL,27776,0,27776,83175,0,110951
143035400500000,SW 406,RESIDENTIAL,27081,0,27081,92707,0,119788
143035400600000,SW 406,RESIDENTIAL,26019,0,26019,81909,0,107928
143035400700000,SW 406,RESIDENTIAL,25105,0,25105,96701,0,121806
143035400800000,SW 406,RESIDENTIAL,30033,0,30033,100508,0,130541
143035400900000,SW 406,RESIDENTIAL,27284,0,27284,96712,0,123996
143035401000000,SW 406,RESIDENTIAL,27284,0,27284,69863,0,97147
143035401100000,SW 406,RESIDENTIAL,27284,0,27284,102541,0,129825
143035401200000,SW 406,RESIDENTIAL,27284,0,27284,100702,0,127986
143035401300000,SW 406,RESIDENTIAL,28590,0,28590,92270,0,120860
143035401400000,SW 406,RESIDENTIAL,32308,0,32308,110927,0,143235
143035401500000,SW 406,RESIDENTIAL,30110,0,30110,94148,0,124258
143035401600000,SW 406,RESIDENTIAL,23094,0,23094,85327,0,108421
143035401700000,SW 406,RESIDENTIAL,22950,0,22950,104628,0,127578
143035401800000,SW 406,RESIDENTIAL,29376,0,29376,93802,0,123178
143035401900000,SW 406,RESIDENTIAL,29376,0,29376,88918,0,118294
143035402000000,SW 406,RESIDENTIAL,29376,0,29376,92439,0,121815
143035402100000,SW 406,RESIDENTIAL,29376,0,29376,94199,0,123575
143035500100000,SW 406,RESIDENTIAL,28512,0,28512,77324,0,105836
143035500200000,SW 406,RESIDENTIAL,28512,0,28512,93366,0,121878
143035500300000,SW 406,RESIDENTIAL,33048,0,33048,101098,0,134146
143035500400000,SW 406,RESIDENTIAL,33121,0,33121,89542,0,122663
143035600100000,OFFICE,EXEMPT,0,96660,96660,0,473636,570296
143035600200000,SW 406,RESIDENTIAL,28800,0,28800,138538,0,167338
143035600300000,SW 406,RESIDENTIAL,28800,0,28800,59221,0,88021
143035600400000,SW 406,RESIDENTIAL,27799,0,27799,117980,0,145779
143035600500000,SW 406,RESIDENTIAL,32185,0,32185,106625,0,138810
143035600600000,SW 406,RESIDENTIAL,28560,0,28560,116697,0,145257
143035600700000,SW 406,RESIDENTIAL,25704,0,25704,92681,0,118385
143035600800000,SW 406,RESIDENTIAL,26033,0,26033,0,0,26033
143035600900000,OFFICE,COMMERCIAL,0,185250,185250,0,271340,456590
143035601000000,BRANCH BANK/CU,COMMERCIAL,0,286400,286400,0,258636,545036
143035601100000,FAST FOOD,COMMERCIAL,0,370800,370800,0,456634,827434
143035601200000,STATE PROPERTY,EXEMPT,0,0,0,0,0,0
143035601300000,CONVENIENCE STORE,COMMERCIAL,0,291437,291437,0,211857,503294
143035601400000,BARS/LOUNGE,COMMERCIAL,0,89672,89672,0,81227,170899
143035601500000,NBHD SHOPPING CENTER,COMMERCIAL,0,421800,421800,0,832217,1254017
143035601600000,SMALL RETAIL,COMMERCIAL,0,160775,160775,0,333318,494093
143035601602000,BILLBOARD(BLL),COMMERCIAL,0,0,0,0,21373,21373
143035601700000,RESTAURANT,COMMERCIAL,0,226000,226000,0,230152,456152
143035601800000,FLAT PARKING,COMMERCIAL,0,53910,53910,0,0,53910
143035601900000,HOTEL,COMMERCIAL,0,495000,495000,0,673973,1168973
143037600100000,SW 427,RESIDENTIAL,28840,0,28840,105788,0,134628
143037600200000,SW 427,RESIDENTIAL,28560,0,28560,101062,0,129622
143037600300000,SW 427,RESIDENTIAL,28280,0,28280,113491,0,141771
143037600400000,SW 427,RESIDENTIAL,28528,0,28528,119922,0,148450
143037600500000,SW 427,RESIDENTIAL,27809,0,27809,127291,0,155100
143037600600000,SW 427,RESIDENTIAL,28158,0,28158,105534,0,133692
143037600700000,SW 427,RESIDENTIAL,28272,0,28272,101664,0,129936
143037600800000,SW 427,RESIDENTIAL,27952,0,27952,111693,0,139645
143037600900000,SW 427,RESIDENTIAL,27160,0,27160,118906,0,146066
143037601000000,SW 427,RESIDENTIAL,27160,0,27160,107582,0,134742
143037601100000,SW 427,RESIDENTIAL,27975,0,27975,108074,0,136049
143037700100000,CITY PROPERTY,EXEMPT,0,0,0,0,0,0
143037700200000,SW 406,RESIDENTIAL,28350,0,28350,99916,0,128266
143037700300000,SW 406,RESIDENTIAL,30240,0,30240,138491,0,168731
143037700400000,SW 406,RESIDENTIAL,22444,0,22444,0,0,22444
143037700500000,SW 406,RESIDENTIAL,22444,0,22444,86404,0,108848
143037700600000,SW 406,RESIDENTIAL,23256,0,23256,70696,0,93952
143037700700000,SW 406,RESIDENTIAL,23256,0,23256,90068,0,113324
143037700800000,SW 406,RESIDENTIAL,24826,0,24826,137403,0,162229
143037700900000,SW 406,RESIDENTIAL,21060,0,21060,84051,0,105111
143037701000000,SW 406,RESIDENTIAL,24403,0,24403,141863,0,166266
143037701100000,SW 406,RESIDENTIAL,24480,0,24480,143241,0,167721
143037701300000,SW 406,RESIDENTIAL,29788,0,29788,92389,0,122177
143037701400000,SW 427,RESIDENTIAL,28032,0,28032,110104,0,138136
143037701500000,SW 427,RESIDENTIAL,28032,0,28032,141149,0,169181
143037701600000,SW 427,RESIDENTIAL,29290,0,29290,125701,0,154991
143037701700000,SW 427,RESIDENTIAL,29492,0,29492,105899,0,135391
143037701800000,SW 427,RESIDENTIAL,29258,0,29258,117302,0,146560
143037701900000,SW 427,RESIDENTIAL,29793,0,29793,120871,0,150664
143037702000000,SW 427,RESIDENTIAL,28534,0,28534,116837,0,145371
143037702100000,SW 427,RESIDENTIAL,31117,0,31117,109197,0,140314
143037702200000,SW 427,RESIDENTIAL,27862,0,27862,130434,0,158296
143037702300000,SW 427,RESIDENTIAL,27997,0,27997,103524,0,131521
143037800100000,SW 406,RESIDENTIAL,23310,0,23310,140858,0,164168
143037800200000,SW 406,RESIDENTIAL,55750,0,55750,250947,0,306697
143037800300000,SW 406,RESIDENTIAL,28889,0,28889,90052,0,118941
143037900100000,SW 406,RESIDENTIAL,24309,0,24309,93829,0,118138
143037900200000,SW 406,RESIDENTIAL,29755,0,29755,90775,0,120530
143037900300000,SW 406,RESIDENTIAL,24509,0,24509,81348,0,105857
143037900400000,SW 406,RESIDENTIAL,21060,0,21060,75408,0,96468
143037900500000,SW 406,RESIDENTIAL,27378,0,27378,65397,0,92775
143037900600000,SW 406,RESIDENTIAL,25272,0,25272,75295,0,100567
143037900700000,SW 406,RESIDENTIAL,25272,0,25272,129959,0,155231
143037900800000,SW 406,RESIDENTIAL,24633,0,24633,105395,0,130028
143037900900000,SW 406,RESIDENTIAL,24480,0,24480,77673,0,102153
143037901000000,SW 406,RESIDENTIAL,24309,0,24309,86966,0,111275
143038000100000,AUTO REPAIR/SALES,COMMERCIAL,0,110000,110000,0,72663,182663
143038000200000,SW 406,RESIDENTIAL,24401,0,24401,48339,0,72740
143038000300000,SW 406,RESIDENTIAL,24948,0,24948,80589,0,105537
143038000500000,SW 406,RESIDENTIAL,30937,0,30937,95102,0,126039
143038000600000,SW 406,RESIDENTIAL,26649,0,26649,52044,0,78693
143038000700000,SW 406,RESIDENTIAL,25875,0,25875,127977,0,153852
143038000800000,SW 406,RESIDENTIAL,43500,0,43500,80048,0,123548
143038000802000,BILLBOARD(BLL),COMMERCIAL,0,0,0,0,23967,23967
143038001000000,SMALL RETAIL,COMMERCIAL,0,180000,180000,0,575002,755002
143038001100000,VACANT LAND,COMMERCIAL,0,172500,172500,0,0,172500
143038001200000,AUTO REPAIR/SALES,COMMERCIAL,0,117025,117025,0,228060,345085
143038001300000,SMALL RETAIL,COMMERCIAL,0,53023,53023,0,92662,145685
143038001400000,SECTION 42,COMMERCIAL,0,10000,10000,0,18536,28536
143038001500000,RESTAURANT,COMMERCIAL,0,268460,268460,0,117118,385578
143038001600000,VACANT LAND,COMMERCIAL,0,5550,5550,0,0,5550
143038100100000,CONVENIENCE STORE,COMMERCIAL,0,114188,114188,0,257220,371408
143038100300000,FLAT PARKING,COMMERCIAL,0,5290,5290,0,1128,6418
143038100400000,FAST FOOD,COMMERCIAL,0,222000,222000,0,719567,941567
143040100100000,SW 405,RESIDENTIAL,20580,0,20580,89471,0,110051
143040100200000,SW 405,RESIDENTIAL,19861,0,19861,79770,0,99631
143040100300000,SW 405,RESIDENTIAL,19861,0,19861,71699,0,91560
143040100400000,SW 405,RESIDENTIAL,19861,0,19861,63515,0,83376
143040100500000,SW 405,RESIDENTIAL,19861,0,19861,85865,0,105726
143040100600000,SW 405,RESIDENTIAL,19861,0,19861,76859,0,96720
143040100700000,SW 405,RESIDENTIAL,19861,0,19861,66112,0,85973
143040100800000,SW 405,RESIDENTIAL,19861,0,19861,69811,0,89672
143040100900000,SW 405,RESIDENTIAL,19861,0,19861,75853,0,95714
143040101000000,SW 405,RESIDENTIAL,19861,0,19861,64796,0,84657
143040101100000,SW 405,RESIDENTIAL,20207,0,20207,75707,0,95914
143040101200000,SW 405,RESIDENTIAL,19861,0,19861,69032,0,88893
143040101300000,SW 405,RESIDENTIAL,19861,0,19861,79048,0,98909
143040101400000,SW 405,RESIDENTIAL,19861,0,19861,77448,0,97309
143040101500000,SW 405,RESIDENTIAL,19861,0,19861,107519,0,127380
143040101600000,SW 405,RESIDENTIAL,19861,0,19861,58907,0,78768
143040101700000,SW 405,RESIDENTIAL,19600,0,19600,69422,0,89022
143040101800000,SW 405,RESIDENTIAL,19600,0,19600,84500,0,104100
143040101900000,SW 405,RESIDENTIAL,19600,0,19600,73374,0,92974
143040102000000,SW 405,RESIDENTIAL,24234,0,24234,65222,0,89456
143040102100000,SW 405,RESIDENTIAL,21036,0,21036,101223,0,122259
143040102200000,SW 405,RESIDENTIAL,20047,0,20047,70203,0,90250
143040102300000,SW 405,RESIDENTIAL,20047,0,20047,79028,0,99075
143040102400000,SW 405,RESIDENTIAL,20047,0,20047,69478,0,89525
143040102500000,SW 405,RESIDENTIAL,20047,0,20047,77119,0,97166
143040102600000,SW 405,RESIDENTIAL,20047,0,20047,72816,0,92863
143040102700000,SW 405,RESIDENTIAL,20047,0,20047,62420,0,82467
143040102800000,SW 405,RESIDENTIAL,20047,0,20047,91461,0,111508
143040102900000,SW 405,RESIDENTIAL,20047,0,20047,81062,0,101109
143040103000000,SW 405,RESIDENTIAL,20047,0,20047,79532,0,99579
143040103100000,SW 405,RESIDENTIAL,20047,0,20047,67294,0,87341
143040103200000,SW 405,RESIDENTIAL,20047,0,20047,100816,0,120863
143040103300000,SW 405,RESIDENTIAL,20047,0,20047,73393,0,93440
143040103400000,SW 405,RESIDENTIAL,20047,0,20047,56925,0,76972
143040103500000,SW 405,RESIDENTIAL,20047,0,20047,75413,0,95460
143040200100000,SW 405,RESIDENTIAL,22230,0,22230,77736,0,99966
143040200200000,SW 405,RESIDENTIAL,24225,0,24225,80419,0,104644
143040200300000,SW 405,RESIDENTIAL,21634,0,21634,68850,0,90484
143040200400000,SW 405,RESIDENTIAL,20680,0,20680,61806,0,82486
143040200500000,SW 405,RESIDENTIAL,20800,0,20800,75745,0,96545
143040200600000,SW 405,RESIDENTIAL,21424,0,21424,81430,0,102854
143040200700000,SW 405,RESIDENTIAL,20592,0,20592,80127,0,100719
143040200800000,SW 405,RESIDENTIAL,21923,0,21923,105198,0,127121
143040200900000,SW 405,RESIDENTIAL,27581,0,27581,56119,0,83700
143040201000000,SW 405,RESIDENTIAL,36180,0,36180,136148,0,172328
143040201100000,SW 405,RESIDENTIAL,32906,0,32906,120218,0,153124
143040201200000,SW 405,RESIDENTIAL,24294,0,24294,107790,0,132084
143040201300000,SW 405,RESIDENTIAL,26180,0,26180,114484,0,140664
143040201400000,SW 405,RESIDENTIAL,26400,0,26400,82373,0,108773
143040201500000,SW 405,RESIDENTIAL,24720,0,24720,96864,0,121584
143040201600000,SW 405,RESIDENTIAL,24905,0,24905,92563,0,117468
143040201700000,SW 405,RESIDENTIAL,24128,0,24128,72822,0,96950
143040201800000,SW 405,RESIDENTIAL,21539,0,21539,98918,0,120457
143040201900000,SW 405,RESIDENTIAL,21384,0,21384,94741,0,116125
143040202000000,SW 405,RESIDENTIAL,22938,0,22938,82984,0,105922
143040202100000,SW 405,RESIDENTIAL,22624,0,22624,64989,0,87613
143040202200000,SW 405,RESIDENTIAL,23028,0,23028,74386,0,97414
143040202300000,SW 405,RESIDENTIAL,22440,0,22440,63977,0,86417
143040202400000,SW 405,RESIDENTIAL,22440,0,22440,103540,0,125980
143040202500000,SW 405,RESIDENTIAL,23484,0,23484,84285,0,107769
143040202600000,SW 405,RESIDENTIAL,22180,0,22180,92340,0,114520
143040202700000,SW 405,RESIDENTIAL,22394,0,22394,86153,0,108547
143040202800000,SW 405,RESIDENTIAL,22394,0,22394,75544,0,97938
143040202900000,SW 405,RESIDENTIAL,21780,0,21780,81965,0,103745
143040203000000,SW 405,RESIDENTIAL,23187,0,23187,61719,0,84906
143040203100000,SW 405,RESIDENTIAL,21466,0,21466,87787,0,109253
143040300100000,SW 405,RESIDENTIAL,20570,0,20570,70125,0,90695
143040300200000,SW 405,RESIDENTIAL,20736,0,20736,78025,0,98761
143040300300000,SW 405,RESIDENTIAL,21056,0,21056,84059,0,105115
143040300400000,SW 405,RESIDENTIAL,20743,0,20743,82503,0,103246
143040300500000,SW 405,RESIDENTIAL,21120,0,21120,70642,0,91762
143040300600000,SW 405,RESIDENTIAL,20825,0,20825,68342,0,89167
143040300700000,SW 405,RESIDENTIAL,20088,0,20088,70613,0,90701
143040300800000,SW 405,RESIDENTIAL,21050,0,21050,73647,0,94697
143040300900000,SW 405,RESIDENTIAL,20930,0,20930,70841,0,91771
143040301000000,SW 405,RESIDENTIAL,20330,0,20330,73450,0,93780
143040301100000,SW 405,RESIDENTIAL,20423,0,20423,86352,0,106775
143040301200000,SW 405,RESIDENTIAL,20564,0,20564,77153,0,97717
143040301300000,SW 405,RESIDENTIAL,20000,0,20000,75156,0,95156
143040301400000,SW 405,RESIDENTIAL,21216,0,21216,86205,0,107421
143040400100000,SW 405,RESIDENTIAL,22220,0,22220,81279,0,103499
143040400200000,SW 405,RESIDENTIAL,22220,0,22220,70121,0,92341
143040400300000,SW 405,RESIDENTIAL,22220,0,22220,73990,0,96210
143040400400000,SW 405,RESIDENTIAL,22220,0,22220,114182,0,136402
143040400500000,SW 405,RESIDENTIAL,22220,0,22220,73472,0,95692
143040400600000,SW 405,RESIDENTIAL,22220,0,22220,75210,0,97430
143040400700000,SW 405,RESIDENTIAL,22220,0,22220,78682,0,100902
143040400800000,SW 405,RESIDENTIAL,22220,0,22220,63840,0,86060
143040400900000,SW 405,RESIDENTIAL,22904,0,22904,86650,0,109554
143040401000000,SW 405,RESIDENTIAL,22395,0,22395,101099,0,123494
143040401100000,SW 405,RESIDENTIAL,21937,0,21937,95062,0,116999
143040401200000,SW 405,RESIDENTIAL,22097,0,22097,57767,0,79864
143040401300000,SW 405,RESIDENTIAL,22800,0,22800,107527,0,130327
143040401400000,SW 405,RESIDENTIAL,22410,0,22410,80226,0,102636
143040401500000,SW 405,RESIDENTIAL,23100,0,23100,76332,0,99432
143040401600000,SW 405,RESIDENTIAL,21651,0,21651,108590,0,130241
143040401700000,SW 405,RESIDENTIAL,20680,0,20680,72886,0,93566
143040401800000,SW 405,RESIDENTIAL,21173,0,21173,79334,0,100507
143040401900000,SW 405,RESIDENTIAL,22220,0,22220,121612,0,143832
143040402000000,SW 405,RESIDENTIAL,22220,0,22220,92022,0,114242
143040402100000,SW 405,RESIDENTIAL,22220,0,22220,122623,0,144843
143040402200000,SW 405,RESIDENTIAL,22220,0,22220,82653,0,104873
143040402300000,SW 405,RESIDENTIAL,22220,0,22220,110685,0,132905
143040402400000,SW 405,RESIDENTIAL,22220,0,22220,90634,0,112854
143040402500000,SW 405,RESIDENTIAL,22220,0,22220,101283,0,123503
143040402600000,SW 405,RESIDENTIAL,22220,0,22220,95449,0,117669
143040402700000,SW 405,RESIDENTIAL,22220,0,22220,98221,0,120441
143040402800000,SW 405,RESIDENTIAL,21001,0,21001,90477,0,111478
143040500100000,SW 405,RESIDENTIAL,23971,0,23971,98965,0,122936
143040500200000,SW 405,RESIDENTIAL,23236,0,23236,67784,0,91020
143040500300000,SW 405,RESIDENTIAL,21077,0,21077,58344,0,79421
143040500400000,SW 405,RESIDENTIAL,23520,0,23520,55995,0,79515
143040500500000,SW 405,RESIDENTIAL,21168,0,21168,67005,0,88173
143040500600000,SW 405,RESIDENTIAL,23520,0,23520,67728,0,91248
143040500700000,SW 405,RESIDENTIAL,23520,0,23520,76025,0,99545
143040500800000,SW 405,RESIDENTIAL,23128,0,23128,82709,0,105837
143040500900000,SW 405,RESIDENTIAL,23128,0,23128,84406,0,107534
143040501000000,SW 405,RESIDENTIAL,23128,0,23128,77568,0,100696
143040501100000,SW 405,RESIDENTIAL,21747,0,21747,63803,0,85550
143040501200000,SW 405,RESIDENTIAL,21747,0,21747,67803,0,89550
143040501300000,SW 405,RESIDENTIAL,21747,0,21747,72980,0,94727
143040501400000,SW 405,RESIDENTIAL,21747,0,21747,74450,0,96197
143040501500000,SW 405,RESIDENTIAL,21747,0,21747,74070,0,95817
143040501600000,SW 405,RESIDENTIAL,22116,0,22116,70284,0,92400
143040501700000,SW 405,RESIDENTIAL,21340,0,21340,83927,0,105267
143040501800000,SW 405,RESIDENTIAL,21340,0,21340,97105,0,118445
143040501900000,SW 405,RESIDENTIAL,21340,0,21340,73263,0,94603
143040502000000,SW 405,RESIDENTIAL,21340,0,21340,84055,0,105395
143040502100000,SW 405,RESIDENTIAL,21340,0,21340,81072,0,102412
143040502200000,SW 405,RESIDENTIAL,21340,0,21340,77060,0,98400
143040600100000,CITY PROPERTY,EXEMPT,0,0,0,0,0,0
143040700100000,SW 405,RESIDENTIAL,21030,0,21030,73449,0,94479
143040700200000,SW 405,RESIDENTIAL,21340,0,21340,84860,0,106200
143040700300000,SW 405,RESIDENTIAL,21340,0,21340,101994,0,123334
143040700400000,SW 405,RESIDENTIAL,21340,0,21340,90950,0,112290
143040700500000,SW 405,RESIDENTIAL,21340,0,21340,83500,0,104840
143040700600000,SW 405,RESIDENTIAL,21340,0,21340,120069,0,141409
143040700700000,SW 405,RESIDENTIAL,21340,0,21340,81798,0,103138
143040700800000,SW 405,RESIDENTIAL,21340,0,21340,106506,0,127846
143040700900000,SW 405,RESIDENTIAL,21340,0,21340,109445,0,130785
143040701000000,SW 405,RESIDENTIAL,19400,0,19400,85480,0,104880
143040701100000,SW 405,RESIDENTIAL,20952,0,20952,75407,0,96359
143040701200000,SW 405,RESIDENTIAL,21340,0,21340,109040,0,130380
143040701300000,SW 405,RESIDENTIAL,20952,0,20952,93455,0,114407
143040701400000,SW 405,RESIDENTIAL,21600,0,21600,123361,0,144961
143040701500000,SW 405,RESIDENTIAL,20952,0,20952,114099,0,135051
143040701600000,SW 405,RESIDENTIAL,20777,0,20777,74166,0,94943
143040701700000,SW 405,RESIDENTIAL,23285,0,23285,81408,0,104693
143040701800000,SW 405,RESIDENTIAL,24064,0,24064,71964,0,96028
143040701900000,SW 405,RESIDENTIAL,24480,0,24480,80994,0,105474
143040702000000,SW 405,RESIDENTIAL,26960,0,26960,68607,0,95567
143042600100000,SW 405,RESIDENTIAL,22504,0,22504,91052,0,113556
143042600200000,SW 405,RESIDENTIAL,24000,0,24000,71858,0,95858
143042600300000,SW 405,RESIDENTIAL,24700,0,24700,79440,0,104140
143042600400000,SW 405,RESIDENTIAL,24700,0,24700,101107,0,125807
143042600500000,SW 405,RESIDENTIAL,24700,0,24700,80240,0,104940
143042600600000,SW 405,RESIDENTIAL,24700,0,24700,68583,0,93283
143042600700000,SW 405,RESIDENTIAL,24700,0,24700,100486,0,125186
143042600800000,SW 405,EXEMPT,0,24700,24700,0,115758,140458
143042600900000,SW 405,RESIDENTIAL,20900,0,20900,67496,0,88396
143042601000000,SW 405,RESIDENTIAL,20900,0,20900,70167,0,91067
143042601100000,SW 405,RESIDENTIAL,21600,0,21600,76558,0,98158
143042601200000,SW 405,RESIDENTIAL,21600,0,21600,67305,0,88905
143042601300000,SW 405,RESIDENTIAL,21600,0,21600,65367,0,86967
143042601400000,SW 405,RESIDENTIAL,22400,0,22400,109915,0,132315
143042601500000,SW 405,RESIDENTIAL,21600,0,21600,88296,0,109896
143042601600000,SW 405,RESIDENTIAL,21600,0,21600,93505,0,115105
143042601700000,SW 405,RESIDENTIAL,22504,0,22504,80298,0,102802
143042601800000,SW 405,RESIDENTIAL,22504,0,22504,118320,0,140824
143042601900000,SW 405,RESIDENTIAL,22504,0,22504,77914,0,100418
143042602000000,SW 405,RESIDENTIAL,22504,0,22504,99843,0,122347
143042700100000,SW 405,RESIDENTIAL,25581,0,25581,109690,0,135271
143042700200000,SW 405,RESIDENTIAL,21632,0,21632,59570,0,81202
143042700300000,SW 405,RESIDENTIAL,21888,0,21888,70876,0,92764
143042700400000,SW 405,RESIDENTIAL,23040,0,23040,81138,0,104178
143042700500000,SW 405,RESIDENTIAL,23040,0,23040,125216,0,148256
143042700600000,SW 405,RESIDENTIAL,27648,0,27648,96101,0,123749
143042700700000,SW 405,RESIDENTIAL,23040,0,23040,87110,0,110150
143042700800000,SW 405,RESIDENTIAL,23040,0,23040,39006,0,62046
143042700900000,SW 405,RESIDENTIAL,23040,0,23040,69270,0,92310
143042701000000,SW 405,RESIDENTIAL,22948,0,22948,34738,0,57686
143042701100000,SW 405,RESIDENTIAL,22760,0,22760,90072,0,112832
143042701200000,SW 405,RESIDENTIAL,20469,0,20469,55572,0,76041
143042701300000,SW 405,RESIDENTIAL,20634,0,20634,61307,0,81941
143042701400000,SW 405,RESIDENTIAL,19400,0,19400,55970,0,75370
143042701500000,SW 405,RESIDENTIAL,22080,0,22080,54573,0,76653
143042701600000,SW 405,RESIDENTIAL,24000,0,24000,62212,0,86212
143042701700000,SW 405,RESIDENTIAL,21307,0,21307,77914,0,99221
143042701800000,SW 405,RESIDENTIAL,20627,0,20627,58078,0,78705
143042701900000,SW 405,RESIDENTIAL,21840,0,21840,56641,0,78481
143042702000000,SW 405,RESIDENTIAL,21840,0,21840,58571,0,80411
143042702100000,SW 405,RESIDENTIAL,21840,0,21840,62967,0,84807
143042702200000,SW 405,RESIDENTIAL,21840,0,21840,56455,0,78295
143042702300000,SW 405,RESIDENTIAL,22338,0,22338,61542,0,83880
143042702400000,SW 405,RESIDENTIAL,22528,0,22528,47954,0,70482
143042800100000,NW 333,RESIDENTIAL,45700,0,45700,82328,0,128028
143042800200000,NW 333,RESIDENTIAL,43680,0,43680,128693,0,172373
143042900100000,SW 405,RESIDENTIAL,23280,0,23280,82450,0,105730
143042900200000,SW 405,RESIDENTIAL,19400,0,19400,57974,0,77374
143042900300000,SW 405,RESIDENTIAL,19400,0,19400,57539,0,76939
143042900400000,SW 405,RESIDENTIAL,19400,0,19400,60646,0,80046
143042900500000,SW 405,RESIDENTIAL,19400,0,19400,68342,0,87742
143042900600000,SW 405,RESIDENTIAL,19400,0,19400,61444,0,80844
143042900700000,SW 405,RESIDENTIAL,19400,0,19400,55435,0,74835
143042900800000,SW 405,RESIDENTIAL,20952,0,20952,79442,0,100394
143042900900000,SW 405,RESIDENTIAL,20642,0,20642,61994,0,82636
143042901000000,SW 405,RESIDENTIAL,21107,0,21107,64143,0,85250
143042901100000,SW 405,RESIDENTIAL,21107,0,21107,59088,0,80195
143042901200000,SW 405,RESIDENTIAL,20176,0,20176,66051,0,86227
143042901300000,SW 405,RESIDENTIAL,20176,0,20176,72824,0,93000
143042901400000,SW 405,RESIDENTIAL,20176,0,20176,58286,0,78462
143042901500000,SW 405,RESIDENTIAL,20176,0,20176,53050,0,73226
143042901600000,SW 405,RESIDENTIAL,20176,0,20176,55954,0,76130
143042901700000,SW 405,RESIDENTIAL,20176,0,20176,50676,0,70852
143042901800000,SW 405,RESIDENTIAL,20176,0,20176,78990,0,99166
143042901900000,SW 405,RESIDENTIAL,20176,0,20176,59290,0,79466
143042902000000,SW 405,RESIDENTIAL,23280,0,23280,64877,0,88157
143042902100000,SW 405,RESIDENTIAL,23280,0,23280,74121,0,97401
143042902200000,SW 405,RESIDENTIAL,23280,0,23280,52456,0,75736
143043000100000,SW 405,RESIDENTIAL,23923,0,23923,60615,0,84538
143043000200000,SW 405,RESIDENTIAL,23773,0,23773,63768,0,87541
143043000300000,SW 405,RESIDENTIAL,24435,0,24435,66688,0,91123
143043000400000,SW 405,RESIDENTIAL,23571,0,23571,50957,0,74528
143043000500000,SW 405,RESIDENTIAL,24206,0,24206,60811,0,85017
143043000600000,SW 405,RESIDENTIAL,23443,0,23443,69295,0,92738
143043000700000,SW 405,RESIDENTIAL,24012,0,24012,62155,0,86167
143043000800000,SW 405,RESIDENTIAL,21808,0,21808,57409,0,79217
143043000900000,SW 405,RESIDENTIAL,24480,0,24480,68095,0,92575
143043001000000,SW 405,RESIDENTIAL,23856,0,23856,55807,0,79663
143043100100000,SW 405,RESIDENTIAL,22050,0,22050,82327,0,104377
143043100200000,SW 405,RESIDENTIAL,23332,0,23332,104534,0,127866
143043100300000,SW 405,RESIDENTIAL,23392,0,23392,58149,0,81541
143043100400000,SW 405,RESIDENTIAL,22385,0,22385,65798,0,88183
143043100500000,SW 405,RESIDENTIAL,24119,0,24119,62370,0,86489
143043100600000,SW 405,RESIDENTIAL,23561,0,23561,55106,0,78667
143043100700000,SW 405,RESIDENTIAL,23563,0,23563,69057,0,92620
143043100800000,SW 405,RESIDENTIAL,23640,0,23640,54152,0,77792
143043100900000,SW 405,RESIDENTIAL,23389,0,23389,78494,0,101883
143043101000000,SW 405,RESIDENTIAL,20693,0,20693,50035,0,70728
143043101100000,SW 405,RESIDENTIAL,24240,0,24240,94112,0,118352
143043101200000,SW 405,RESIDENTIAL,25640,0,25640,88605,0,114245
143043101300000,SW 405,RESIDENTIAL,25060,0,25060,109665,0,134725
143043101400000,SW 405,RESIDENTIAL,24966,0,24966,157428,0,182394
143043101500000,SW 405,RESIDENTIAL,24000,0,24000,70403,0,94403
143043101600000,SW 405,RESIDENTIAL,24000,0,24000,115728,0,139728
143043101700000,SW 405,RESIDENTIAL,24000,0,24000,84719,0,108719
143043101800000,SW 405,RESIDENTIAL,24000,0,24000,70736,0,94736
143043101900000,SW 405,RESIDENTIAL,24000,0,24000,100559,0,124559
143043102000000,SW 405,RESIDENTIAL,24750,0,24750,104045,0,128795
143043102100000,SW 405,RESIDENTIAL,25899,0,25899,74723,0,100622
143043200100000,SW 405,RESIDENTIAL,22320,0,22320,60992,0,83312
143043200200000,SW 405,RESIDENTIAL,23392,0,23392,57825,0,81217
143043200300000,SW 405,RESIDENTIAL,23941,0,23941,58779,0,82720
143043200400000,SW 405,RESIDENTIAL,25480,0,25480,77281,0,102761
143043200500000,SW 405,RESIDENTIAL,26118,0,26118,63846,0,89964
143043200600000,SW 405,RESIDENTIAL,22990,0,22990,59636,0,82626
143043300100000,SW 405,RESIDENTIAL,20840,0,20840,77132,0,97972
143043300200000,SW 405,RESIDENTIAL,20600,0,20600,63725,0,84325
143043300300000,SW 405,RESIDENTIAL,20600,0,20600,60506,0,81106
143043300400000,SW 405,RESIDENTIAL,20600,0,20600,57569,0,78169
143043300500000,SW 405,RESIDENTIAL,20600,0,20600,67775,0,88375
143043300600000,SW 405,RESIDENTIAL,20600,0,20600,52787,0,73387
143043300700000,SW 405,RESIDENTIAL,20600,0,20600,61166,0,81766
143043300800000,SW 405,RESIDENTIAL,20600,0,20600,56904,0,77504
143043300900000,SW 405,RESIDENTIAL,20600,0,20600,66654,0,87254
143043301000000,SW 405,RESIDENTIAL,20600,0,20600,71203,0,91803
143043301100000,SW 405,RESIDENTIAL,20600,0,20600,62747,0,83347
143043301200000,SW 405,RESIDENTIAL,20600,0,20600,73385,0,93985
143043301300000,SW 405,RESIDENTIAL,20689,0,20689,62219,0,82908
143043301400000,SW 405,RESIDENTIAL,21006,0,21006,61369,0,82375
143043301500000,SW 405,RESIDENTIAL,20000,0,20000,59447,0,79447
143043301600000,SW 405,RESIDENTIAL,20000,0,20000,51833,0,71833
143043301700000,SW 405,RESIDENTIAL,20000,0,20000,56211,0,76211
143043301800000,SW 405,RESIDENTIAL,20000,0,20000,56894,0,76894
143043301900000,SW 405,RESIDENTIAL,20000,0,20000,57206,0,77206
143043302000000,SW 405,RESIDENTIAL,20000,0,20000,71587,0,91587
143043302100000,SW 405,RESIDENTIAL,20000,0,20000,56233,0,76233
143043302200000,SW 405,RESIDENTIAL,20000,0,20000,50984,0,70984
143043302300000,SW 405,RESIDENTIAL,20000,0,20000,55175,0,75175
143043302400000,SW 405,RESIDENTIAL,20000,0,20000,68929,0,88929
143043302500000,SW 405,RESIDENTIAL,20000,0,20000,59767,0,79767
143043302600000,SW 405,RESIDENTIAL,19773,0,19773,62815,0,82588
143043400100000,SW 405,RESIDENTIAL,23128,0,23128,67568,0,90696
143043400200000,SW 405,RESIDENTIAL,23128,0,23128,67468,0,90596
143043400300000,SW 405,RESIDENTIAL,20900,0,20900,66776,0,87676
143043400400000,SW 405,RESIDENTIAL,20900,0,20900,69768,0,90668
143043400500000,SW 405,RESIDENTIAL,26173,0,26173,78117,0,104290
143043400600000,SW 405,RESIDENTIAL,24989,0,24989,100671,0,125660
143043500100000,SW 405,RESIDENTIAL,19607,0,19607,55364,0,74971
143043500200000,SW 405,RESIDENTIAL,19400,0,19400,60532,0,79932
143043500300000,SW 405,RESIDENTIAL,19400,0,19400,59445,0,78845
143043500400000,SW 405,RESIDENTIAL,19400,0,19400,71262,0,90662
143043500500000,SW 405,RESIDENTIAL,19400,0,19400,69068,0,88468
143043500600000,SW 405,RESIDENTIAL,19400,0,19400,62143,0,81543
143043500700000,SW 405,RESIDENTIAL,19400,0,19400,69176,0,88576
143043500800000,SW 405,RESIDENTIAL,19400,0,19400,58534,0,77934
143043500900000,SW 405,RESIDENTIAL,19400,0,19400,64273,0,83673
143043501000000,SW 405,RESIDENTIAL,19400,0,19400,63445,0,82845
143043501100000,SW 405,RESIDENTIAL,19400,0,19400,64495,0,83895
143043501200000,SW 405,RESIDENTIAL,19400,0,19400,62627,0,82027
143043501300000,SW 405,RESIDENTIAL,20644,0,20644,71040,0,91684
143043501400000,SW 427,RESIDENTIAL,28365,0,28365,97989,0,126354
143043501500000,SW 427,RESIDENTIAL,28401,0,28401,128075,0,156476
143043501600000,SW 427,RESIDENTIAL,33227,0,33227,169071,0,202298
143043501700000,SW 427,RESIDENTIAL,28863,0,28863,128228,0,157091
143043501800000,SW 405,RESIDENTIAL,24240,0,24240,68156,0,92396
143043501900000,SW 405,RESIDENTIAL,24240,0,24240,82965,0,107205
143043502000000,SW 405,RESIDENTIAL,24240,0,24240,80878,0,105118
143043502100000,SW 405,RESIDENTIAL,24240,0,24240,73848,0,98088
143043502200000,SW 405,RESIDENTIAL,24240,0,24240,94250,0,118490
143045100100000,SW 405,RESIDENTIAL,24000,0,24000,62757,0,86757
143045200100000,SW 405,RESIDENTIAL,26384,0,26384,103509,0,129893
143045200200000,SW 405,RESIDENTIAL,25797,0,25797,90042,0,115839
143045200300000,SW 405,RESIDENTIAL,23520,0,23520,81577,0,105097
143045200400000,SW 405,RESIDENTIAL,23520,0,23520,85438,0,108958
143045200500000,SW 405,RESIDENTIAL,23520,0,23520,94060,0,117580
143045200600000,SW 405,RESIDENTIAL,23520,0,23520,82831,0,106351
143045200700000,SW 405,RESIDENTIAL,23520,0,23520,86760,0,110280
143045200800000,SW 405,RESIDENTIAL,26251,0,26251,105014,0,131265
143045200900000,SW 406,RESIDENTIAL,30888,0,30888,252579,0,283467
143045201000000,SW 406,RESIDENTIAL,57150,0,57150,123650,0,180800
143045201100000,WAREHOUSE;MINI STORG,COMMERCIAL,0,55809,55809,0,31267,87076
143045201200000,SERVICE STATION,COMMERCIAL,0,81707,81707,0,58643,140350
143045201300000,FLAT PARKING,COMMERCIAL,0,476400,476400,0,0,476400
143045201400000,SHOP,COMMERCIAL,0,302250,302250,0,635902,938152
143045201500000,SW 405,RESIDENTIAL,25930,0,25930,87058,0,112988
143045201600000,SW 405,RESIDENTIAL,25252,0,25252,68641,0,93893
143045201700000,SW 405,RESIDENTIAL,24888,0,24888,134813,0,159701
143045201800000,SW 405,RESIDENTIAL,25488,0,25488,88413,0,113901
143045201900000,SW 405,RESIDENTIAL,23976,0,23976,73749,0,97725
143045202000000,SW 405,RESIDENTIAL,24720,0,24720,78678,0,103398
143045202100000,SW 405,RESIDENTIAL,24480,0,24480,72966,0,97446
143045202200000,SW 405,RESIDENTIAL,24480,0,24480,90940,0,115420
143045202300000,SW 405,RESIDENTIAL,24480,0,24480,75961,0,100441
143045202400000,SW 405,RESIDENTIAL,24480,0,24480,75862,0,100342
143045202500000,CITY PROPERTY,EXEMPT,0,0,0,0,0,0
143045202600000,CITY PROPERTY,EXEMPT,0,0,0,0,0,0
143045202700000,SW 405,RESIDENTIAL,26048,0,26048,74696,0,100744
143045202800000,SW 405,RESIDENTIAL,25379,0,25379,82343,0,107722
143045202900000,SW 405,RESIDENTIAL,25608,0,25608,76422,0,102030
143045203000000,SW 405,RESIDENTIAL,24768,0,24768,105888,0,130656
143045203100000,SW 405,RESIDENTIAL,24593,0,24593,83152,0,107745
143045203200000,SW 405,RESIDENTIAL,24315,0,24315,82379,0,106694
143045203300000,SW 405,RESIDENTIAL,23280,0,23280,78662,0,101942
143045203400000,SW 405,RESIDENTIAL,23280,0,23280,68316,0,91596
143045203500000,SW 405,RESIDENTIAL,23280,0,23280,85569,0,108849
143045203600000,SW 405,RESIDENTIAL,23280,0,23280,77754,0,101034
143045203700000,SW 405,EXEMPT,0,23280,23280,0,76408,99688
143045203800000,SW 405,RESIDENTIAL,23280,0,23280,75725,0,99005
143045203900000,SW 405,RESIDENTIAL,20952,0,20952,86586,0,107538
143045300100000,SW 406,RESIDENTIAL,23956,0,23956,74079,0,98035
143045300200000,SW 406,RESIDENTIAL,28294,0,28294,84425,0,112719
143045300300000,SW 406,RESIDENTIAL,28350,0,28350,81414,0,109764
143045300400000,SW 406,RESIDENTIAL,28350,0,28350,123060,0,151410
143045300500000,SW 406,RESIDENTIAL,28350,0,28350,87910,0,116260
143045300700000,SW 427,RESIDENTIAL,27824,0,27824,103561,0,131385
143045300800000,SW 427,RESIDENTIAL,27824,0,27824,100167,0,127991
143045300900000,SW 427,RESIDENTIAL,25994,0,25994,109683,0,135677
143045301000000,SW 427,RESIDENTIAL,29057,0,29057,122782,0,151839
143045301100000,SW 406,RESIDENTIAL,35519,0,35519,108659,0,144178
143045301200000,SW 427,RESIDENTIAL,28000,0,28000,109024,0,137024
143045301300000,SW 427,RESIDENTIAL,27160,0,27160,125102,0,152262
143045301600000,SW 406,RESIDENTIAL,23669,0,23669,129057,0,152726
143045301700000,SW 406,RESIDENTIAL,26733,0,26733,110097,0,136830
143045301800000,SW 406,RESIDENTIAL,23192,0,23192,115592,0,138784
143045302000000,SW 406,RESIDENTIAL,29484,0,29484,729,0,30213
143045302100000,SW 406,RESIDENTIAL,23973,0,23973,92860,0,116833
143045400100000,SW 427,RESIDENTIAL,29100,0,29100,99181,0,128281
143045400200000,SW 427,RESIDENTIAL,28984,0,28984,103696,0,132680
143045400300000,SW 427,RESIDENTIAL,28168,0,28168,118656,0,146824
143045500100000,SW 405,RESIDENTIAL,24066,0,24066,68054,0,92120
143045500200000,SW 405,RESIDENTIAL,24133,0,24133,65436,0,89569
143045500300000,SW 405,RESIDENTIAL,24133,0,24133,68140,0,92273
143045500400000,SW 405,RESIDENTIAL,24133,0,24133,74322,0,98455
143045500500000,SW 405,RESIDENTIAL,24667,0,24667,84187,0,108854
143045500600000,SW 405,RESIDENTIAL,24000,0,24000,86982,0,110982
143045500700000,SW 405,RESIDENTIAL,24000,0,24000,92480,0,116480
143045600800000,SW 405,RESIDENTIAL,26558,0,26558,106437,0,132995
143045600900000,SW 405,RESIDENTIAL,23985,0,23985,90861,0,114846
143045601000000,SW 405,RESIDENTIAL,24433,0,24433,86266,0,110699
143045601100000,SW 405,RESIDENTIAL,26228,0,26228,108257,0,134485
143045601200000,SW 405,RESIDENTIAL,24480,0,24480,100674,0,125154
143045601300000,SW 405,RESIDENTIAL,24240,0,24240,95575,0,119815
143045601400000,SW 405,RESIDENTIAL,24240,0,24240,95599,0,119839
143045601500000,SW 405,RESIDENTIAL,24240,0,24240,74377,0,98617
143045601600000,SW 405,RESIDENTIAL,24240,0,24240,84073,0,108313
143045601700000,SW 405,RESIDENTIAL,24240,0,24240,76017,0,100257
143045601800000,SW 405,RESIDENTIAL,24240,0,24240,101037,0,125277
143045601900000,SW 405,RESIDENTIAL,24240,0,24240,85047,0,109287
143045602000000,SW 405,RESIDENTIAL,23971,0,23971,94920,0,118891
143045602100000,SW 405,RESIDENTIAL,23760,0,23760,86237,0,109997
143045602200000,SW 405,RESIDENTIAL,23760,0,23760,90044,0,113804
143045602300000,SW 405,RESIDENTIAL,23760,0,23760,101440,0,125200
143045602400000,SW 405,RESIDENTIAL,23760,0,23760,90770,0,114530
143045602500000,SW 405,RESIDENTIAL,23760,0,23760,88240,0,112000
143045602600000,SW 405,RESIDENTIAL,24796,0,24796,90530,0,115326
143045602700000,SW 405,RESIDENTIAL,24472,0,24472,113600,0,138072
143045700100000,VACANT LAND,COMMERCIAL,0,10890,10890,0,0,10890
143047600100000,SCHOOL,EXEMPT,0,0,0,0,0,0
143047600200000,CONVERSION,COMMERCIAL,0,9309,9309,0,96143,105452
143047600300000,SW 405,RESIDENTIAL,25200,0,25200,76466,0,101666
143047600400000,SW 405,RESIDENTIAL,24000,0,24000,102072,0,126072
143047600500000,SW 405,RESIDENTIAL,24000,0,24000,86386,0,110386
143047600600000,SW 405,RESIDENTIAL,24000,0,24000,78840,0,102840
143047600700000,SW 405,RESIDENTIAL,24000,0,24000,109039,0,133039
143047600800000,SW 405,RESIDENTIAL,24320,0,24320,92377,0,116697
143047600900000,SW 405,RESIDENTIAL,24320,0,24320,97910,0,122230
143047601000000,SW 405,RESIDENTIAL,24320,0,24320,94552,0,118872
143047601100000,SW 405,RESIDENTIAL,24320,0,24320,82193,0,106513
143047601200000,SW 405,RESIDENTIAL,24320,0,24320,77447,0,101767
143047601300000,SW 405,RESIDENTIAL,24092,0,24092,67501,0,91593
143047700100000,SW 405,RESIDENTIAL,25946,0,25946,58981,0,84927
143047700200000,SW 405,RESIDENTIAL,24480,0,24480,75492,0,99972
143047700300000,SW 405,RESIDENTIAL,24192,0,24192,72535,0,96727
143047700400000,SW 405,RESIDENTIAL,23760,0,23760,82497,0,106257
143047700500000,SW 405,RESIDENTIAL,23760,0,23760,70789,0,94549
143047700600000,SW 405,RESIDENTIAL,23760,0,23760,86804,0,110564
143047700700000,SW 405,RESIDENTIAL,24644,0,24644,119528,0,144172
143047700800000,SW 405,RESIDENTIAL,25687,0,25687,94087,0,119774
143047700900000,SW 405,RESIDENTIAL,25200,0,25200,96775,0,121975
143047800100000,SW 405,RESIDENTIAL,24738,0,24738,86204,0,110942
143047800200000,SW 405,RESIDENTIAL,24316,0,24316,84673,0,108989
143047800300000,SW 405,RESIDENTIAL,23320,0,23320,77317,0,100637
143047800400000,SW 405,RESIDENTIAL,24953,0,24953,110571,0,135524
143047800500000,SW 405,RESIDENTIAL,24644,0,24644,76817,0,101461
143047800600000,SW 405,RESIDENTIAL,23760,0,23760,76116,0,99876
143047800700000,SW 405,RESIDENTIAL,24817,0,24817,87994,0,112811
143047800800000,SW 405,RESIDENTIAL,24854,0,24854,68443,0,93297
143110100100000,WAREHOUSE,COMMERCIAL,0,111250,111250,0,249914,361164
143110100200000,CENTRALLY ASSESSED,OTHER,0,0,0,0,0,0
143110100300000,WAREHOUSE,COMMERCIAL,0,178500,178500,0,67377,245877
143110100400000,OFFICE,COMMERCIAL,0,288000,288000,0,264266,552266
143110100500000,SHOP,COMMERCIAL,0,324750,324750,0,136035,460785
143110200100000,FLAT PARKING,COMMERCIAL,0,138000,138000,0,27600,165600
143110200200000,LG DISCOUNT/RETAIL,COMMERCIAL,0,344000,344000,0,559325,903325
143110300100000,SHOP,COMMERCIAL,0,238000,238000,0,256376,494376
143110300200000,VETERINARY CLINIC,COMMERCIAL,0,130000,130000,0,279800,409800
143110300300000,OFFICE,COMMERCIAL,0,75000,75000,0,117961,192961
143110300400000,FRATERNAL,COMMERCIAL,0,48600,48600,0,70224,118824
143110300402000,BILLBOARD(BLL),COMMERCIAL,0,0,0,0,12762,12762
143110300500000,WAREHOUSE,COMMERCIAL,0,192800,192800,0,297991,490791
143110300600000,SHOP,COMMERCIAL,0,110000,110000,0,127264,237264
143110300700000,VACANT LAND,COMMERCIAL,0,27600,27600,0,0,27600
143110300800000,AUTO REPAIR/SALES,COMMERCIAL,0,206000,206000,0,363412,569412
143110300900000,RESTAURANT,COMMERCIAL,0,136340,136340,0,118695,255035
143110301000000,SMALL RETAIL,COMMERCIAL,0,49295,49295,0,191706,241001
143110301100000,AUTO REPAIR/SALES,COMMERCIAL,0,173520,173520,0,203788,377308
143110301700000,FLAT PARKING,COMMERCIAL,0,276000,276000,0,53696,329696
143110301702000,BILLBOARD(BLL),COMMERCIAL,0,0,0,0,30737,30737
143110301800000,SW 420,RESIDENTIAL,552750,0,552750,0,0,552750
143112600100000,WAREHOUSE,COMMERCIAL,0,186000,186000,0,463461,649461
143112600200000,AUTO REPAIR/SALES,COMMERCIAL,0,128600,128600,0,81743,210343
143112600300000,RESTAURANT,COMMERCIAL,0,132000,132000,0,91022,223022
143112600400000,RESTAURANT,COMMERCIAL,0,123405,123405,0,166419,289824
143112601000000,VETERINARY CLINIC,COMMERCIAL,0,244530,244530,0,726722,971252
143112601100000,WAREHOUSE,COMMERCIAL,0,225020,225020,0,465532,690552
143112700100000,AUTO REPAIR/SALES,COMMERCIAL,0,109080,109080,0,210491,319571
143112700200000,RESTAURANT,COMMERCIAL,0,180960,180960,0,148826,329786
143112700300000,SMALL RETAIL,COMMERCIAL,0,216900,216900,0,385811,602711
143112700400000,SW 420,RESIDENTIAL,6724,0,6724,0,0,6724
143112700500000,SW 420,RESIDENTIAL,41200,0,41200,136407,0,177607
143112700600000,SW 420,RESIDENTIAL,41600,0,41600,136407,0,178007
143112700700000,SW 420,RESIDENTIAL,40109,0,40109,154873,0,194982
143112700800000,SW 420,RESIDENTIAL,39576,0,39576,130244,0,169820
143112700900000,SW 420,RESIDENTIAL,33950,0,33950,133200,0,167150
143112800100000,CHURCH,COMMERCIAL,0,139455,139455,0,227454,366909
143112800200000,SHOP,COMMERCIAL,0,248000,248000,0,246989,494989
143112800300000,SHOP,COMMERCIAL,0,292800,292800,0,189051,481851
143112800400000,AUTO REPAIR/SALES,COMMERCIAL,0,307200,307200,0,153112,460312
143112800402000,BILLBOARD(BLL),COMMERCIAL,0,0,0,0,30737,30737
143112800500000,WAREHOUSE,COMMERCIAL,0,172900,172900,0,91520,264420
143112800600000,SW 420,RESIDENTIAL,39442,0,39442,152126,0,191568
143112800700000,SW 420,RESIDENTIAL,39200,0,39200,151530,0,190730
143112800800000,SW 420,RESIDENTIAL,39200,0,39200,134510,0,173710
143112800900000,SW 420,RESIDENTIAL,38634,0,38634,126142,0,164776
143112801000000,SW 420,RESIDENTIAL,41233,0,41233,131919,0,173152
143112801100000,SW 420,RESIDENTIAL,40853,0,40853,157216,0,198069
143112801200000,SW 420,RESIDENTIAL,41990,0,41990,148369,0,190359
143112801300000,SW 420,RESIDENTIAL,39024,0,39024,129674,0,168698
143112801400000,SW 420,RESIDENTIAL,36734,0,36734,129674,0,166408
143112801500000,SW 420,RESIDENTIAL,36734,0,36734,137039,0,173773
143112801600000,SW 420,RESIDENTIAL,36734,0,36734,132958,0,169692
143112801900000,SW 420,RESIDENTIAL,27775,0,27775,120080,0,147855
143112802000000,SW 420,RESIDENTIAL,27775,0,27775,120590,0,148365
143112802100000,SW 420,RESIDENTIAL,27775,0,27775,122621,0,150396
143112802200000,SW 420,RESIDENTIAL,27775,0,27775,124171,0,151946
143112802300000,SW 420,RESIDENTIAL,27775,0,27775,123787,0,151562
143112802400000,SW 420,RESIDENTIAL,29925,0,29925,138049,0,167974
143112802500000,SW 420,RESIDENTIAL,41344,0,41344,157636,0,198980
143112802600000,SW 420,RESIDENTIAL,46469,0,46469,142826,0,189295
143112802700000,SW 420,RESIDENTIAL,38819,0,38819,156704,0,195523
143112802800000,SW 420,RESIDENTIAL,30240,0,30240,148138,0,178378
143112802900000,SW 420,RESIDENTIAL,27775,0,27775,128068,0,155843
143112803000000,SW 420,RESIDENTIAL,27775,0,27775,119907,0,147682
143112803100000,SW 420,RESIDENTIAL,27775,0,27775,118206,0,145981
143112803200000,SW 420,RESIDENTIAL,27775,0,27775,118193,0,145968
143112803300000,SW 420,RESIDENTIAL,27775,0,27775,118061,0,145836
143112900100000,SW 420,RESIDENTIAL,37461,0,37461,133690,0,171151
143112900200000,SW 420,RESIDENTIAL,37875,0,37875,131306,0,169181
143112900300000,SW 420,RESIDENTIAL,41814,0,41814,129674,0,171488
143112900400000,SW 420,RESIDENTIAL,41328,0,41328,133853,0,175181
143112900500000,SW 420,RESIDENTIAL,40698,0,40698,147332,0,188030
143112900600000,SW 420,RESIDENTIAL,39860,0,39860,134269,0,174129
143115100400000,SW 420,RESIDENTIAL,25440,0,25440,102887,0,128327
143115100500000,SW 420,RESIDENTIAL,25440,0,25440,74317,0,99757
143115100600000,SW 420,RESIDENTIAL,25440,0,25440,113568,0,139008
143115100700000,SW 420,RESIDENTIAL,25440,0,25440,103161,0,128601
143115100800000,SW 420,RESIDENTIAL,25440,0,25440,112486,0,137926
143115100900000,SW 420,RESIDENTIAL,25440,0,25440,83259,0,108699
143115101000000,SW 420,RESIDENTIAL,25160,0,25160,60661,0,85821
143115101100000,SW 420,RESIDENTIAL,29507,0,29507,96820,0,126327
143115101200000,SW 420,RESIDENTIAL,25735,0,25735,61887,0,87622
143115101300000,SW 420,RESIDENTIAL,40163,0,40163,90844,0,131007
143115101400000,SW 420,RESIDENTIAL,40163,0,40163,109339,0,149502
143115101500000,SW 420,RESIDENTIAL,40163,0,40163,158390,0,198553
143115101600000,SW 420,RESIDENTIAL,42350,0,42350,3214,0,45564
143115101800000,SW 420,RESIDENTIAL,48332,0,48332,234446,0,282778
143115101900000,SW 420,RESIDENTIAL,44449,0,44449,215289,0,259738
143115102000000,SW 420,RESIDENTIAL,42101,0,42101,0,0,42101
143115102200000,SW 420,RESIDENTIAL,65401,0,65401,297583,0,362984
143115102300000,SW 420,RESIDENTIAL,46186,0,46186,177792,0,223978
143115102400000,SW 420,RESIDENTIAL,45000,0,45000,196058,0,241058
143115102500000,SW 420,RESIDENTIAL,45000,0,45000,207293,0,252293
143115102600000,SW 420,RESIDENTIAL,45000,0,45000,161914,0,206914
143115102700000,SW 420,RESIDENTIAL,40000,0,40000,200706,0,240706
143115102800000,SW 420,RESIDENTIAL,39125,0,39125,162701,0,201826
143115200200000,SW 420,RESIDENTIAL,31000,0,31000,125597,0,156597
143115200300000,SW 420,RESIDENTIAL,30110,0,30110,134721,0,164831
143115200400000,SW 420,RESIDENTIAL,30600,0,30600,115888,0,146488
143115200500000,SW 420,RESIDENTIAL,30600,0,30600,131276,0,161876
143115200600000,SW 420,RESIDENTIAL,30600,0,30600,92751,0,123351
143115200700000,SW 420,RESIDENTIAL,30600,0,30600,94852,0,125452
143115200800000,SW 420,RESIDENTIAL,30600,0,30600,101878,0,132478
143115200900000,SW 420,RESIDENTIAL,30600,0,30600,107601,0,138201
143115201000000,SW 420,RESIDENTIAL,30600,0,30600,162542,0,193142
143115201100000,SW 420,RESIDENTIAL,32640,0,32640,123410,0,156050
143115201200000,SW 420,RESIDENTIAL,43369,0,43369,176903,0,220272
143115201300000,SW 420,RESIDENTIAL,40800,0,40800,0,0,40800
143115201400000,SW 420,RESIDENTIAL,40800,0,40800,169235,0,210035
143115201500000,SW 420,RESIDENTIAL,45818,0,45818,189488,0,235306
143115201600000,SW 420,RESIDENTIAL,54810,0,54810,213658,0,268468
143115201700000,SW 420,RESIDENTIAL,45450,0,45450,251386,0,296836
143115201800000,SW 420,RESIDENTIAL,45450,0,45450,180877,0,226327
143115201900000,SW 420,RESIDENTIAL,45584,0,45584,203270,0,248854
143115202000000,SW 420,RESIDENTIAL,30300,0,30300,142774,0,173074
143115202100000,SW 420,RESIDENTIAL,30300,0,30300,138515,0,168815
143115202200000,SW 420,RESIDENTIAL,30300,0,30300,167521,0,197821
143115202300000,SW 420,RESIDENTIAL,30300,0,30300,137486,0,167786
143115202400000,SW 420,RESIDENTIAL,30300,0,30300,174021,0,204321
143115202500000,SW 420,RESIDENTIAL,30300,0,30300,136200,0,166500
143115202600000,SW 420,RESIDENTIAL,30300,0,30300,152293,0,182593
143115202700000,SW 420,RESIDENTIAL,30300,0,30300,152256,0,182556
143115202800000,SW 420,RESIDENTIAL,32825,0,32825,157175,0,190000
143115202900000,CITY PROPERTY,EXEMPT,0,0,0,0,0,0
143115203000000,SW 420,RESIDENTIAL,32825,0,32825,182224,0,215049
143115203100000,SW 420,RESIDENTIAL,32825,0,32825,181333,0,214158
143115203200000,SW 420,RESIDENTIAL,32825,0,32825,175520,0,208345
143115203300000,SW 420,RESIDENTIAL,32148,0,32148,147319,0,179467
143115203400000,SW 420,RESIDENTIAL,30300,0,30300,181516,0,211816
143115203500000,SW 420,RESIDENTIAL,30300,0,30300,151661,0,181961
143115203600000,SW 420,RESIDENTIAL,30300,0,30300,133525,0,163825
143115203700000,SW 420,RESIDENTIAL,30300,0,30300,134112,0,164412
143115203800000,SW 420,RESIDENTIAL,35628,0,35628,130051,0,165679
143115203900000,SW 420,RESIDENTIAL,35628,0,35628,182839,0,218467
143115204000000,SW 420,RESIDENTIAL,32825,0,32825,140211,0,173036
143115204100000,SW 420,RESIDENTIAL,32825,0,32825,146409,0,179234
143115204200000,SW 420,RESIDENTIAL,32825,0,32825,139354,0,172179
143115204300000,SW 420,RESIDENTIAL,32825,0,32825,182618,0,215443
143115204500000,SW 420,RESIDENTIAL,39869,0,39869,146204,0,186073
143115204700000,SW 420,RESIDENTIAL,30300,0,30300,140778,0,171078
143115204800000,SW 420,RESIDENTIAL,30300,0,30300,141407,0,171707
143115204900000,SW 420,RESIDENTIAL,30300,0,30300,135219,0,165519
143115205000000,SW 420,RESIDENTIAL,30300,0,30300,135423,0,165723
143115205100000,SW 420,RESIDENTIAL,30300,0,30300,139686,0,169986
143115205200000,SW 420,RESIDENTIAL,30300,0,30300,137942,0,168242
143115205300000,SW 420,RESIDENTIAL,30300,0,30300,131127,0,161427
143115205400000,SW 420,RESIDENTIAL,30300,0,30300,130509,0,160809
143115205500000,SW 420,RESIDENTIAL,30300,0,30300,142962,0,173262
143115205600000,SW 420,RESIDENTIAL,30300,0,30300,142728,0,173028
143115205700000,SW 420,RESIDENTIAL,30300,0,30300,141081,0,171381
143115205800000,SW 420,RESIDENTIAL,42624,0,42624,143629,0,186253
143115205900000,SW 420,RESIDENTIAL,33840,0,33840,138652,0,172492
143115206000000,SW 420,RESIDENTIAL,30300,0,30300,138278,0,168578
143115206100000,SW 420,RESIDENTIAL,30300,0,30300,138517,0,168817
143115206200000,SW 420,RESIDENTIAL,30300,0,30300,132436,0,162736
143115206300000,SW 420,RESIDENTIAL,30300,0,30300,128914,0,159214
143115206400000,SW 420,RESIDENTIAL,30300,0,30300,146224,0,176524
143115206500000,SW 420,RESIDENTIAL,30300,0,30300,142922,0,173222
143115206600000,SW 420,RESIDENTIAL,30300,0,30300,138976,0,169276
143115206700000,SW 420,RESIDENTIAL,30300,0,30300,147143,0,177443
143115206800000,SW 420,RESIDENTIAL,32825,0,32825,143543,0,176368
143115300900000,SW 420,RESIDENTIAL,43194,0,43194,233339,0,276533
143115400100000,SW 420,RESIDENTIAL,45004,0,45004,196511,0,241515
143115400200000,SW 420,RESIDENTIAL,42005,0,42005,177750,0,219755
143115400300000,SW 420,RESIDENTIAL,45004,0,45004,187348,0,232352
143115500100000,SW 420,RESIDENTIAL,34723,0,34723,146855,0,181578
143115500200000,SW 420,RESIDENTIAL,30048,0,30048,135856,0,165904
143115500300000,SW 420,RESIDENTIAL,32194,0,32194,165704,0,197898
143115500400000,SW 420,RESIDENTIAL,31013,0,31013,123366,0,154379
143115500500000,SW 420,RESIDENTIAL,31013,0,31013,155376,0,186389
143115500600000,SW 420,RESIDENTIAL,30048,0,30048,131273,0,161321
143115500700000,SW 420,RESIDENTIAL,30048,0,30048,183700,0,213748
143115500800000,SW 420,RESIDENTIAL,30048,0,30048,158124,0,188172
143115500900000,SW 420,RESIDENTIAL,30048,0,30048,158663,0,188711
143115501000000,SW 420,RESIDENTIAL,30048,0,30048,141889,0,171937
143115501100000,SW 420,RESIDENTIAL,29588,0,29588,144412,0,174000
143115600100000,SW 420,RESIDENTIAL,36304,0,36304,175062,0,211366
143115600200000,SW 420,RESIDENTIAL,36304,0,36304,167365,0,203669
143115600300000,SW 420,RESIDENTIAL,35779,0,35779,130244,0,166023
143115600400000,SW 420,RESIDENTIAL,27775,0,27775,121360,0,149135
143115700100000,SW 420,RESIDENTIAL,35350,0,35350,131141,0,166491
143115700200000,SW 420,RESIDENTIAL,27775,0,27775,119361,0,147136
143115800100000,SW 420,RESIDENTIAL,38134,0,38134,128526,0,166660
143115800200000,SW 420,RESIDENTIAL,35365,0,35365,131187,0,166552
143115800300000,SW 420,RESIDENTIAL,37617,0,37617,137478,0,175095
143117600200000,SW 420,RESIDENTIAL,25740,0,25740,80320,0,106060
143117600300000,SW 420,RESIDENTIAL,25740,0,25740,61927,0,87667
143117600400000,SW 420,RESIDENTIAL,23760,0,23760,93856,0,117616
143117600500000,SW 420,RESIDENTIAL,31680,0,31680,61495,0,93175
143117600600000,SW 420,RESIDENTIAL,25740,0,25740,103183,0,128923
143117600700000,SW 420,RESIDENTIAL,27720,0,27720,63274,0,90994
143117600800000,SW 420,RESIDENTIAL,25740,0,25740,85888,0,111628
143117600900000,SW 420,RESIDENTIAL,20244,0,20244,47731,0,67975
143117601000000,SW 420,RESIDENTIAL,37926,0,37926,78246,0,116172
143117601100000,SW 420,RESIDENTIAL,23175,0,23175,31902,0,55077
143117601300000,SW 420,RESIDENTIAL,32111,0,32111,0,0,32111
143117601400000,SW 420,RESIDENTIAL,32320,0,32320,192192,0,224512
143117601500000,SW 420,RESIDENTIAL,32320,0,32320,172911,0,205231
143117601600000,SW 420,RESIDENTIAL,32640,0,32640,177336,0,209976
143117601700000,SW 420,RESIDENTIAL,38520,0,38520,162847,0,201367
143117601800000,SW 420,RESIDENTIAL,31212,0,31212,152272,0,183484
143117601900000,SW 420,RESIDENTIAL,29478,0,29478,180189,0,209667
143117602000000,SW 420,RESIDENTIAL,29867,0,29867,239839,0,269706
143117602100000,SW 420,RESIDENTIAL,38078,0,38078,156604,0,194682
143117602300000,SW 420,RESIDENTIAL,1140,0,1140,0,0,1140
143117602400000,SW 420,RESIDENTIAL,36203,0,36203,233803,0,270006
143117602500000,SW 420,RESIDENTIAL,28701,0,28701,188956,0,217657
143117602600000,SW 420,RESIDENTIAL,28620,0,28620,161349,0,189969
143117602700000,SW 420,RESIDENTIAL,29440,0,29440,174492,0,203932
143117602800000,SW 420,RESIDENTIAL,29440,0,29440,160187,0,189627
143117602900000,SW 420,RESIDENTIAL,30400,0,30400,190584,0,220984
143117603000000,SW 420,RESIDENTIAL,32000,0,32000,160307,0,192307
143117603100000,SW 420,RESIDENTIAL,32320,0,32320,180105,0,212425
143117603200000,SW 420,RESIDENTIAL,32320,0,32320,192846,0,225166
143117603300000,SW 420,RESIDENTIAL,32331,0,32331,177774,0,210105
143117603400000,SW 420,RESIDENTIAL,30478,0,30478,150907,0,181385
143117603500000,SW 420,RESIDENTIAL,30906,0,30906,136496,0,167402
143117603600000,SW 420,RESIDENTIAL,30300,0,30300,81875,0,112175
143117603700000,SW 420,RESIDENTIAL,30300,0,30300,103656,0,133956
143117603800000,SW 420,RESIDENTIAL,30300,0,30300,105601,0,135901
143117603900000,SW 420,RESIDENTIAL,30704,0,30704,148664,0,179368
143117604000000,SW 420,RESIDENTIAL,31088,0,31088,106220,0,137308
143117604100000,SW 420,RESIDENTIAL,31108,0,31108,125732,0,156840
143117604200000,SW 420,RESIDENTIAL,31815,0,31815,153164,0,184979
143117604300000,SW 420,RESIDENTIAL,32623,0,32623,170741,0,203364
143117604400000,SW 420,RESIDENTIAL,30219,0,30219,144651,0,174870
143117604500000,SW 420,RESIDENTIAL,31270,0,31270,178211,0,209481
143117604600000,SW 420,RESIDENTIAL,31557,0,31557,149474,0,181031
143117604800000,CITY PROPERTY,EXEMPT,0,0,0,0,0,0
143117604900000,CITY PROPERTY,EXEMPT,0,0,0,0,0,0
143117605000000,CITY PROPERTY,EXEMPT,0,0,0,0,0,0
143117605100000,SW 420,RESIDENTIAL,25480,0,25480,146525,0,172005
143117605200000,SW 420,RESIDENTIAL,25480,0,25480,132040,0,157520
143117605300000,SW 420,RESIDENTIAL,25480,0,25480,147741,0,173221
143117605400000,SW 420,RESIDENTIAL,25141,0,25141,180053,0,205194
143117605600000,SW 420,RESIDENTIAL,58255,0,58255,222692,0,280947
143117605700000,CITY PROPERTY,EXEMPT,0,0,0,0,0,0
143117605800000,CITY PROPERTY,EXEMPT,0,0,0,0,0,0
143117605900000,SW 420,RESIDENTIAL,62400,0,62400,63885,0,126285
143117606200000,SW 420,RESIDENTIAL,42178,0,42178,182995,0,225173
143117700100000,SW 420,RESIDENTIAL,34340,0,34340,214677,0,249017
143117700300000,SW 420,RESIDENTIAL,68150,0,68150,127288,0,195438
143117700500000,SW 420,RESIDENTIAL,33769,0,33769,221849,0,255618
143117700600000,SW 420,RESIDENTIAL,30300,0,30300,134673,0,164973
143117700700000,SW 420,RESIDENTIAL,27270,0,27270,107773,0,135043
143117700800000,SW 420,RESIDENTIAL,30300,0,30300,114715,0,145015
143117700900000,SW 420,RESIDENTIAL,30300,0,30300,0,0,30300
143117701000000,SW 420,RESIDENTIAL,30300,0,30300,123315,0,153615
143117701100000,SW 420,RESIDENTIAL,30381,0,30381,169662,0,200043
143117701200000,SW 420,RESIDENTIAL,30300,0,30300,107883,0,138183
143117701300000,SW 420,RESIDENTIAL,36360,0,36360,172461,0,208821
143117701400000,SW 420,RESIDENTIAL,540,0,540,0,0,540
143117701500000,SW 420,RESIDENTIAL,32623,0,32623,210730,0,243353
143117701600000,SW 420,RESIDENTIAL,32280,0,32280,192325,0,224605
143117701700000,SW 420,RESIDENTIAL,46027,0,46027,238444,0,284471
143117701800000,SW 420,RESIDENTIAL,40668,0,40668,195640,0,236308
143117701900000,SW 420,RESIDENTIAL,80350,0,80350,0,0,80350
143117800100000,SW 420,RESIDENTIAL,37356,0,37356,157647,0,195003
143117800200000,SW 420,RESIDENTIAL,34340,0,34340,190546,0,224886
143117800300000,SW 420,RESIDENTIAL,34340,0,34340,196617,0,230957
143117800400000,SW 420,RESIDENTIAL,36360,0,36360,190096,0,226456
143117800500000,SW 420,RESIDENTIAL,36360,0,36360,204638,0,240998
143117800600000,SW 420,RESIDENTIAL,38380,0,38380,189632,0,228012
143117900100000,SW 420,RESIDENTIAL,45904,0,45904,165660,0,211564
143117900200000,SW 420,RESIDENTIAL,42845,0,42845,201824,0,244669
143117900300000,SW 420,RESIDENTIAL,45454,0,45454,195740,0,241194
143120100400000,CONVENIENCE STORE,COMMERCIAL,0,480600,480600,0,1092438,1573038
143120200100000,AUTO REPAIR/SALES,COMMERCIAL,0,360600,360600,0,258760,619360
143120200300000,RESTAURANT,COMMERCIAL,0,131838,131838,0,227856,359694
143120200600000,LG DISCOUNT/RETAIL,COMMERCIAL,0,1822500,1822500,0,782140,2604640
143120200700000,RESTAURANT,COMMERCIAL,0,155000,155000,0,218712,373712
143120200800000,SMALL RETAIL,COMMERCIAL,0,563750,563750,0,600449,1164199
143122600200000,BRANCH BANK/CU,COMMERCIAL,0,468000,468000,0,497348,965348
143122600300000,LG DISCOUNT/RETAIL,COMMERCIAL,0,776500,776500,0,2370045,3146545
143122600400000,AUTO REPAIR/SALES,COMMERCIAL,0,534600,534600,0,333058,867658
143122700100000,AUTO REPAIR/SALES,COMMERCIAL,0,275400,275400,0,290958,566358
143122700200000,FLAT PARKING,COMMERCIAL,0,131400,131400,0,0,131400
143122700300000,SMALL RETAIL,COMMERCIAL,0,120800,120800,0,244751,365551
143122700400000,WAREHOUSE,COMMERCIAL,0,45120,45120,0,111467,156587
143122700500000,LG DISCOUNT/RETAIL,COMMERCIAL,0,815000,815000,0,934386,1749386
143122700600000,SHOP,COMMERCIAL,0,253920,253920,0,172887,426807
143122700900000,FLAT PARKING,COMMERCIAL,0,70430,70430,0,20400,90830
143122701100000,FLAT PARKING,COMMERCIAL,0,158370,158370,0,5927,164297
143122701102000,ANTENNAS/TOWERS(BLL),COMMERCIAL,0,0,0,0,105194,105194
143122701200000,AUTO REPAIR/SALES,COMMERCIAL,0,254800,254800,0,344381,599181
143122701300000,BOWLING ALLEY,COMMERCIAL,0,211250,211250,0,518050,729300
143122701400000,VACANT LAND,COMMERCIAL,0,240100,240100,0,0,240100
143122701500000,WAREHOUSE,COMMERCIAL,0,526000,526000,0,1668439,2194439
143122701502000,BILLBOARD(BLL),COMMERCIAL,0,0,0,0,24145,24145
143122701700000,VACANT LAND,COMMERCIAL,0,18294,18294,0,0,18294
143122701702000,ANTENNAS/TOWERS(BLL),COMMERCIAL,0,0,0,0,126459,126459
143122701800000,OFFICE; MEDICAL,COMMERCIAL,0,906000,906000,0,932418,1838418
143125100100000,VACANT LAND,COMMERCIAL,0,20,20,0,0,20
143125100300000,RESTAURANT,COMMERCIAL,0,882936,882936,0,799847,1682783
143125100700000,APARTMENT,RESIDENTIAL,48829,0,48829,449492,0,498321
143125100800000,APARTMENT,RESIDENTIAL,49436,0,49436,449154,0,498590
143125100900000,APARTMENT,RESIDENTIAL,38397,0,38397,200573,0,238970
143125101000000,VACANT LAND,COMMERCIAL,0,2160,2160,0,0,2160
143125101100000,NBHD SHOPPING CENTER,COMMERCIAL,0,725000,725000,0,2310068,3035068
143125101200000,VACANT LAND,COMMERCIAL,0,35788,35788,0,0,35788
143125101300000,VACANT LAND,COMMERCIAL,0,323000,323000,0,0,323000
143125101400000,NBHD SHOPPING CENTER,COMMERCIAL,0,375000,375000,0,469980,844980
143125101500000,OFFICE; MEDICAL,COMMERCIAL,0,216000,216000,0,284075,500075
143125101600000,VACANT LAND,COMMERCIAL,0,72961,72961,0,0,72961
143125101700000,FAST FOOD,COMMERCIAL,0,324000,324000,0,672184,996184
143125101702000,BILLBOARD(BLL),COMMERCIAL,0,0,0,0,41065,41065
143125101800000,BRANCH BANK/CU,COMMERCIAL,0,488000,488000,0,1141178,1629178
143125102000000,VACANT LAND,COMMERCIAL,0,186400,186400,0,0,186400
143125102002000,BILLBOARD(BLL),COMMERCIAL,0,0,0,0,82475,82475
143125102100000,OFFICE,COMMERCIAL,0,318000,318000,0,722892,1040892
143125200100000,WAREHOUSE,COMMERCIAL,0,794200,794200,0,475449,1269649
143125300100000,SW 420,RESIDENTIAL,31904,0,31904,63222,0,95126
143125300200000,SW 420,RESIDENTIAL,35280,0,35280,98220,0,133500
143125300300000,SW 420,RESIDENTIAL,36096,0,36096,49056,0,85152
143125300400000,SW 420,RESIDENTIAL,36531,0,36531,44306,0,80837
143125300500000,APARTMENT,RESIDENTIAL,20828,0,20828,88381,0,109209
143125300600000,APARTMENT,COMMERCIAL,0,39786,39786,0,327586,367372
143127600100000,SW 420,RESIDENTIAL,26725,0,26725,83979,0,110704
143127600200000,SW 420,RESIDENTIAL,26866,0,26866,98152,0,125018
143127600300000,SW 420,RESIDENTIAL,26866,0,26866,87082,0,113948
143127600400000,SW 420,RESIDENTIAL,26058,0,26058,114713,0,140771
143127600500000,SW 420,RESIDENTIAL,26058,0,26058,96754,0,122812
143127600600000,SW 420,RESIDENTIAL,26058,0,26058,90733,0,116791
143127600700000,SW 420,RESIDENTIAL,26058,0,26058,80403,0,106461
143127600800000,SW 420,RESIDENTIAL,26058,0,26058,91830,0,117888
143127600900000,SW 420,RESIDENTIAL,27654,0,27654,70101,0,97755
143127601000000,SW 420,RESIDENTIAL,29157,0,29157,93900,0,123057
143127601400000,CHURCH,EXEMPT,0,35381,35381,0,99605,134986
143127601500000,SW 420,RESIDENTIAL,33328,0,33328,69050,0,102378
143127601600000,SW 420,RESIDENTIAL,24000,0,24000,81905,0,105905
143127601700000,SW 420,RESIDENTIAL,24000,0,24000,115012,0,139012
143127601800000,SW 420,RESIDENTIAL,27171,0,27171,113186,0,140357
143127601900000,SW 420,RESIDENTIAL,27273,0,27273,101865,0,129138
143127602000000,SW 420,RESIDENTIAL,28576,0,28576,84537,0,113113
143127602100000,SW 420,RESIDENTIAL,26076,0,26076,84164,0,110240
143127602200000,SW 420,RESIDENTIAL,26790,0,26790,85139,0,111929
143127602300000,SW 420,RESIDENTIAL,26538,0,26538,104174,0,130712
143127602400000,SW 420,RESIDENTIAL,28814,0,28814,95194,0,124008
143127602500000,SW 420,RESIDENTIAL,23688,0,23688,106204,0,129892
143127602600000,SW 420,RESIDENTIAL,24252,0,24252,86854,0,111106
143127602700000,SW 420,RESIDENTIAL,24410,0,24410,83484,0,107894
143127602800000,SW 420,RESIDENTIAL,26204,0,26204,84008,0,110212
143127602900000,SW 420,RESIDENTIAL,28787,0,28787,99455,0,128242
143127603000000,SECTION 42,COMMERCIAL,0,619200,619200,0,1604151,2223351
143127700100000,SW 420,RESIDENTIAL,26007,0,26007,82857,0,108864
143127700200000,SW 420,RESIDENTIAL,26320,0,26320,97801,0,124121
143127700300000,SW 420,RESIDENTIAL,26320,0,26320,87544,0,113864
143127700400000,SW 420,RESIDENTIAL,26320,0,26320,91036,0,117356
143127700500000,SW 420,RESIDENTIAL,24252,0,24252,82740,0,106992
143127700600000,SW 420,RESIDENTIAL,24252,0,24252,93946,0,118198
143127700700000,SW 420,RESIDENTIAL,24252,0,24252,95849,0,120101
143127700800000,SW 420,RESIDENTIAL,24252,0,24252,96662,0,120914
143127700900000,SW 420,RESIDENTIAL,26050,0,26050,99962,0,126012
143127701000000,SW 420,RESIDENTIAL,24839,0,24839,87637,0,112476
143127701100000,SW 420,RESIDENTIAL,24252,0,24252,85845,0,110097
143127701200000,SW 420,RESIDENTIAL,22560,0,22560,91066,0,113626
143127701300000,SW 420,RESIDENTIAL,26611,0,26611,93388,0,119999
143127701400000,SW 420,RESIDENTIAL,26320,0,26320,92801,0,119121
143127701500000,SW 420,RESIDENTIAL,26320,0,26320,112637,0,138957
143127701600000,SW 420,RESIDENTIAL,26320,0,26320,85162,0,111482
143127701700000,SW 420,RESIDENTIAL,26320,0,26320,94237,0,120557
143127701800000,SW 420,RESIDENTIAL,26633,0,26633,85023,0,111656
143127800100000,SW 420,RESIDENTIAL,30631,0,30631,92827,0,123458
143127800200000,SW 420,RESIDENTIAL,30912,0,30912,83141,0,114053
143127800300000,SW 420,RESIDENTIAL,30912,0,30912,101742,0,132654
143127800400000,SW 420,RESIDENTIAL,30912,0,30912,81805,0,112717
143127800500000,SW 420,RESIDENTIAL,30912,0,30912,88652,0,119564
143127800600000,SW 420,RESIDENTIAL,31248,0,31248,82115,0,113363
143127800700000,SW 420,RESIDENTIAL,29760,0,29760,86511,0,116271
143127800800000,SW 420,RESIDENTIAL,25568,0,25568,91150,0,116718
143127800900000,SW 420,RESIDENTIAL,28200,0,28200,81614,0,109814
143127801000000,SW 420,RESIDENTIAL,28200,0,28200,113047,0,141247
143127900100000,SW 420,RESIDENTIAL,26938,0,26938,93581,0,120519
143127900200000,SW 420,RESIDENTIAL,27744,0,27744,109431,0,137175
143127900300000,SW 420,RESIDENTIAL,27000,0,27000,92849,0,119849
143127900400000,SW 420,RESIDENTIAL,27270,0,27270,90557,0,117827
143127900500000,SW 420,RESIDENTIAL,27315,0,27315,106244,0,133559
143127900600000,SW 420,RESIDENTIAL,30527,0,30527,93189,0,123716
143127900700000,SW 420,RESIDENTIAL,30400,0,30400,79429,0,109829
143127900800000,SW 420,RESIDENTIAL,31059,0,31059,96976,0,128035
143127900900000,SW 420,RESIDENTIAL,31137,0,31137,113192,0,144329
143127901000000,SW 420,RESIDENTIAL,29184,0,29184,91756,0,120940
143127901100000,SW 420,RESIDENTIAL,28453,0,28453,77396,0,105849
143127901200000,SW 420,RESIDENTIAL,30380,0,30380,77495,0,107875
143127901300000,SW 420,RESIDENTIAL,31040,0,31040,97744,0,128784
143127901400000,SW 420,RESIDENTIAL,30780,0,30780,79773,0,110553
143127901500000,SW 420,RESIDENTIAL,26880,0,26880,85912,0,112792
143128000100000,SW 420,RESIDENTIAL,30888,0,30888,83105,0,113993
143128000200000,SW 420,RESIDENTIAL,26741,0,26741,98652,0,125393
143128000300000,SW 420,RESIDENTIAL,27664,0,27664,99197,0,126861
143128000400000,SW 420,RESIDENTIAL,25480,0,25480,113095,0,138575
143128000500000,SW 420,RESIDENTIAL,29563,0,29563,93369,0,122932
143128000600000,SW 420,RESIDENTIAL,28200,0,28200,88289,0,116489
143128000700000,SW 420,RESIDENTIAL,28200,0,28200,87748,0,115948
143128000800000,SW 420,RESIDENTIAL,28200,0,28200,100513,0,128713
143128000900000,SW 420,RESIDENTIAL,30080,0,30080,86697,0,116777
143128001000000,SW 420,RESIDENTIAL,30080,0,30080,101097,0,131177
143128001100000,SW 420,RESIDENTIAL,30080,0,30080,86492,0,116572
143128001200000,SW 420,RESIDENTIAL,30080,0,30080,92876,0,122956
143128001300000,SW 420,RESIDENTIAL,27232,0,27232,95769,0,123001
143128001400000,SW 420,RESIDENTIAL,30053,0,30053,95674,0,125727
143128001500000,SW 420,RESIDENTIAL,30464,0,30464,103031,0,133495
143128001600000,SW 420,RESIDENTIAL,32760,0,32760,95817,0,128577
143128001700000,SW 420,RESIDENTIAL,32760,0,32760,112697,0,145457
143128001800000,SW 420,RESIDENTIAL,32760,0,32760,91119,0,123879
143128001900000,SW 420,RESIDENTIAL,30950,0,30950,106606,0,137556
143128100100000,SW 420,RESIDENTIAL,29120,0,29120,103003,0,132123
143128100200000,SW 420,RESIDENTIAL,31305,0,31305,81768,0,113073
143128100300000,SW 420,RESIDENTIAL,29328,0,29328,96626,0,125954
143128100400000,SW 420,RESIDENTIAL,29328,0,29328,114379,0,143707
143128100500000,SW 420,RESIDENTIAL,29328,0,29328,104655,0,133983
143128100600000,SW 420,RESIDENTIAL,30264,0,30264,112002,0,142266
143128100700000,SW 420,RESIDENTIAL,28288,0,28288,85531,0,113819
143128100800000,SW 420,RESIDENTIAL,28203,0,28203,120366,0,148569
143128100900000,SW 420,RESIDENTIAL,27200,0,27200,105481,0,132681
143128101000000,SW 420,RESIDENTIAL,28160,0,28160,117230,0,145390
143128101100000,SW 420,RESIDENTIAL,31741,0,31741,119489,0,151230
143128101200000,SW 420,RESIDENTIAL,29958,0,29958,101515,0,131473
143130100100000,SW 420,RESIDENTIAL,33759,0,33759,126448,0,160207
143130100200000,SW 420,RESIDENTIAL,33759,0,33759,91441,0,125200
143130100300000,SW 420,RESIDENTIAL,32329,0,32329,116808,0,149137
143130100400000,SW 420,RESIDENTIAL,35921,0,35921,82455,0,118376
143130100500000,SW 420,RESIDENTIAL,33075,0,33075,100827,0,133902
143130100600000,SW 420,RESIDENTIAL,33075,0,33075,152786,0,185861
143130100700000,SW 420,RESIDENTIAL,49815,0,49815,117639,0,167454
143130100800000,SW 420,RESIDENTIAL,53900,0,53900,88949,0,142849
143130100900000,SW 420,RESIDENTIAL,2350,0,2350,0,0,2350
143130101000000,SW 420,RESIDENTIAL,54400,0,54400,235935,0,290335
143130101100000,SW 420,RESIDENTIAL,46800,0,46800,122899,0,169699
143130101200000,SW 420,RESIDENTIAL,37800,0,37800,125046,0,162846
143130200100000,SW 420,RESIDENTIAL,26144,0,26144,60865,0,87009
143130200200000,SW 420,RESIDENTIAL,43575,0,43575,77915,0,121490
143130200300000,SW 420,RESIDENTIAL,39040,0,39040,136056,0,175096
143130200400000,SW 420,RESIDENTIAL,39040,0,39040,97644,0,136684
143130200500000,SW 420,RESIDENTIAL,31040,0,31040,82491,0,113531
143130200600000,SW 420,RESIDENTIAL,33330,0,33330,48592,0,81922
143130200700000,SW 420,RESIDENTIAL,33220,0,33220,75049,0,108269
143130200800000,SW 420,RESIDENTIAL,24396,0,24396,71507,0,95903
143130200900000,SW 420,RESIDENTIAL,25308,0,25308,65040,0,90348
143130201000000,SW 420,RESIDENTIAL,32206,0,32206,41341,0,73547
143130201100000,SW 420,RESIDENTIAL,48314,0,48314,59800,0,108114
143130201200000,SW 420,RESIDENTIAL,60850,0,60850,99171,0,160021
143130201300000,SCHOOL,EXEMPT,0,0,0,0,0,0
143130201500000,SW 420,RESIDENTIAL,48708,0,48708,87344,0,136052
143130201600000,SW 420,RESIDENTIAL,39803,0,39803,107042,0,146845
143130201700000,SW 420,RESIDENTIAL,39803,0,39803,148030,0,187833
143130201800000,SW 420,RESIDENTIAL,41513,0,41513,131071,0,172584
143130201900000,SW 420,RESIDENTIAL,27863,0,27863,124134,0,151997
143130202000000,SW 420,EXEMPT,0,27864,27864,0,130246,158110
143130202100000,SW 420,RESIDENTIAL,66250,0,66250,140440,0,206690
143130202200000,SW 420,RESIDENTIAL,66930,0,66930,186704,0,253634
143130300100000,SW 420,RESIDENTIAL,23203,0,23203,71859,0,95062
143130300200000,SW 420,RESIDENTIAL,39406,0,39406,69609,0,109015
143130300300000,SW 420,RESIDENTIAL,35136,0,35136,86316,0,121452
143130300400000,SW 420,RESIDENTIAL,31040,0,31040,150988,0,182028
143130300500000,SW 420,RESIDENTIAL,29100,0,29100,171709,0,200809
143130300600000,SW 420,RESIDENTIAL,29100,0,29100,124898,0,153998
143130300700000,SW 420,RESIDENTIAL,29232,0,29232,142563,0,171795
143130300800000,SW 420,RESIDENTIAL,21941,0,21941,67169,0,89110
143130300900000,SW 420,RESIDENTIAL,23760,0,23760,91165,0,114925
143130301000000,SW 420,RESIDENTIAL,22176,0,22176,75942,0,98118
143130301100000,SW 420,RESIDENTIAL,23760,0,23760,79840,0,103600
143130400100000,SW 420,RESIDENTIAL,32076,0,32076,135742,0,167818
143130400200000,SW 420,RESIDENTIAL,32436,0,32436,167506,0,199942
143130400300000,SW 420,RESIDENTIAL,33183,0,33183,145436,0,178619
143130400400000,SW 420,RESIDENTIAL,31040,0,31040,109734,0,140774
143130400500000,SW 420,RESIDENTIAL,31040,0,31040,111670,0,142710
143130400600000,SW 420,RESIDENTIAL,32766,0,32766,131214,0,163980
143130400700000,SW 420,RESIDENTIAL,31564,0,31564,130917,0,162481
143130500100000,SW 420,RESIDENTIAL,32332,0,32332,105895,0,138227
143130500200000,SW 420,RESIDENTIAL,29100,0,29100,119449,0,148549
143130500300000,SW 420,RESIDENTIAL,28409,0,28409,81534,0,109943
143130500400000,SW 420,RESIDENTIAL,30814,0,30814,100792,0,131606
143130500500000,SW 420,RESIDENTIAL,30000,0,30000,104849,0,134849
143130500600000,SW 420,RESIDENTIAL,30000,0,30000,110382,0,140382
143130500700000,SW 420,RESIDENTIAL,30000,0,30000,100943,0,130943
143130500800000,SW 420,RESIDENTIAL,30414,0,30414,101763,0,132177
143132600100000,SW 420,RESIDENTIAL,36234,0,36234,99206,0,135440
143132600200000,SW 420,RESIDENTIAL,36234,0,36234,112177,0,148411
143132600300000,SW 420,RESIDENTIAL,31258,0,31258,98625,0,129883
143132600400000,SW 420,RESIDENTIAL,24960,0,24960,127694,0,152654
143132600500000,SW 420,RESIDENTIAL,31916,0,31916,138047,0,169963
143132600600000,SW 420,RESIDENTIAL,32724,0,32724,110065,0,142789
143132600700000,SW 420,RESIDENTIAL,32724,0,32724,120885,0,153609
143132600800000,SW 420,RESIDENTIAL,54,0,54,0,0,54
143132600900000,SW 420,RESIDENTIAL,30400,0,30400,133353,0,163753
143132601000000,SW 420,RESIDENTIAL,30720,0,30720,125518,0,156238
143132700100000,SW 420,RESIDENTIAL,25680,0,25680,0,0,25680
143132700200000,SW 420,RESIDENTIAL,32164,0,32164,88625,0,120789
143132700300000,SW 420,EXEMPT,0,50126,50126,0,170857,220983
143132700400000,SW 420,RESIDENTIAL,32738,0,32738,137262,0,170000
143132700500000,SW 420,RESIDENTIAL,36000,0,36000,147873,0,183873
143132700600000,SW 420,RESIDENTIAL,36720,0,36720,156417,0,193137
143132700700000,SW 420,RESIDENTIAL,36720,0,36720,178644,0,215364
143132700800000,SW 420,RESIDENTIAL,35640,0,35640,145530,0,181170
143132700900000,SW 420,RESIDENTIAL,39954,0,39954,154588,0,194542
143132701000000,SW 420,RESIDENTIAL,41071,0,41071,153097,0,194168
143132701100000,SW 420,RESIDENTIAL,35640,0,35640,148660,0,184300
143132701200000,SW 420,RESIDENTIAL,37269,0,37269,155883,0,193152
143132701300000,SW 420,RESIDENTIAL,36701,0,36701,156554,0,193255
143132701400000,SW 420,RESIDENTIAL,36720,0,36720,0,0,36720
143132701500000,SW 420,RESIDENTIAL,31680,0,31680,88942,0,120622
143132701600000,SW 420,RESIDENTIAL,31696,0,31696,78543,0,110239
143132701700000,SW 420,RESIDENTIAL,31878,0,31878,76816,0,108694
143132702700000,THEATER,COMMERCIAL,0,1542020,1542020,0,4801125,6343145
143132702800000,FAST FOOD,COMMERCIAL,0,406800,406800,0,722125,1128925
143132702900000,RESTAURANT,COMMERCIAL,0,420000,420000,0,700706,1120706
143132703000000,SW 420,RESIDENTIAL,41310,0,41310,167573,0,208883
143132703100000,SW 420,RESIDENTIAL,40920,0,40920,245917,0,286837
143132703200000,SW 420,RESIDENTIAL,36720,0,36720,203552,0,240272
143132703300000,SW 420,RESIDENTIAL,39015,0,39015,183977,0,222992
143132703400000,SW 420,RESIDENTIAL,36720,0,36720,146845,0,183565
143132703500000,SW 420,RESIDENTIAL,39015,0,39015,212140,0,251155
143132703600000,SW 420,RESIDENTIAL,36995,0,36995,260121,0,297116
143132703700000,SW 420,RESIDENTIAL,28526,0,28526,166070,0,194596
143132703800000,SW 420,RESIDENTIAL,29100,0,29100,129014,0,158114
143132703900000,SW 420,RESIDENTIAL,31736,0,31736,104869,0,136605
143132704000000,SW 420,RESIDENTIAL,31512,0,31512,151275,0,182787
143132704100000,SW 420,RESIDENTIAL,32320,0,32320,121362,0,153682
143132704200000,SW 420,RESIDENTIAL,32320,0,32320,129280,0,161600
143132704300000,SW 420,RESIDENTIAL,30300,0,30300,114712,0,145012
143132704400000,SW 420,RESIDENTIAL,26220,0,26220,156961,0,183181
143132704500000,OFFICE; MEDICAL,COMMERCIAL,0,1288320,1288320,0,3227631,4515951
143132800100000,SW 420,RESIDENTIAL,33833,0,33833,165010,0,198843
143132800200000,SW 420,RESIDENTIAL,32400,0,32400,156777,0,189177
143132800300000,SW 420,RESIDENTIAL,34247,0,34247,195384,0,229631
143132800400000,SW 420,RESIDENTIAL,28948,0,28948,0,0,28948
143132800500000,SW 420,RESIDENTIAL,28215,0,28215,110985,0,139200
143132800600000,SW 420,RESIDENTIAL,29876,0,29876,103027,0,132903
143132800700000,SW 420,RESIDENTIAL,29100,0,29100,108435,0,137535
143132800800000,SW 420,RESIDENTIAL,29100,0,29100,116235,0,145335
143132900100000,SW 420,RESIDENTIAL,29100,0,29100,111231,0,140331
143132900200000,SW 420,RESIDENTIAL,34542,0,34542,108236,0,142778
143132900300000,SW 420,RESIDENTIAL,38250,0,38250,117247,0,155497
143132900400000,SW 420,RESIDENTIAL,35451,0,35451,108744,0,144195
143133000100000,SW 420,RESIDENTIAL,31331,0,31331,139767,0,171098
143133000200000,SW 420,RESIDENTIAL,31040,0,31040,112362,0,143402
143133000300000,SW 420,RESIDENTIAL,31331,0,31331,124560,0,155891
143133000400000,SW 420,RESIDENTIAL,35640,0,35640,183742,0,219382
143133000500000,SW 420,RESIDENTIAL,37868,0,37868,165116,0,202984
143133000600000,SW 420,RESIDENTIAL,37868,0,37868,169133,0,207001
143133000700000,SW 420,RESIDENTIAL,37868,0,37868,128795,0,166663
143133000800000,SW 420,RESIDENTIAL,37868,0,37868,157798,0,195666
143133000900000,SW 420,RESIDENTIAL,31680,0,31680,106162,0,137842
143133001000000,SW 420,RESIDENTIAL,29700,0,29700,109198,0,138898
143133001100000,SW 420,RESIDENTIAL,30397,0,30397,110713,0,141110
143133100600000,SW 420,RESIDENTIAL,40905,0,40905,111664,0,152569
143135100100000,SW 420,RESIDENTIAL,39774,0,39774,134984,0,174758
143135100200000,SW 420,RESIDENTIAL,36323,0,36323,138174,0,174497
143135200100000,SW 420,RESIDENTIAL,37873,0,37873,168449,0,206322
143135200200000,SW 420,RESIDENTIAL,34554,0,34554,156207,0,190761
143135200300000,SW 420,RESIDENTIAL,34104,0,34104,165424,0,199528
143135200400000,SW 420,RESIDENTIAL,34455,0,34455,184810,0,219265
143135200500000,SW 420,RESIDENTIAL,36865,0,36865,175495,0,212360
143135200600000,SW 420,RESIDENTIAL,37868,0,37868,149963,0,187831
143135200700000,SW 420,RESIDENTIAL,38411,0,38411,164495,0,202906
143135200800000,SW 420,RESIDENTIAL,39541,0,39541,177593,0,217134
143135200900000,SW 420,RESIDENTIAL,38111,0,38111,183795,0,221906
143135201000000,SW 420,RESIDENTIAL,37868,0,37868,206151,0,244019
143135201100000,SW 420,RESIDENTIAL,38120,0,38120,212198,0,250318
143135201200000,SW 420,RESIDENTIAL,38091,0,38091,153862,0,191953
143135201300000,SW 420,RESIDENTIAL,37868,0,37868,177611,0,215479
143135201400000,SW 420,RESIDENTIAL,35640,0,35640,178282,0,213922
143135201500000,SW 420,RESIDENTIAL,39214,0,39214,161813,0,201027
143135201600000,SW 420,RESIDENTIAL,37957,0,37957,199880,0,237837
143135201700000,SW 420,RESIDENTIAL,35640,0,35640,181069,0,216709
143135201800000,SW 420,RESIDENTIAL,37868,0,37868,136482,0,174350
143135201900000,SW 420,RESIDENTIAL,37308,0,37308,181659,0,218967
143135202000000,SW 420,RESIDENTIAL,40243,0,40243,193472,0,233715
143135300100000,SW 420,RESIDENTIAL,39708,0,39708,173862,0,213570
143135300200000,RESTAURANT,COMMERCIAL,0,580000,580000,0,880414,1460414
143135300400000,SW 420,RESIDENTIAL,46859,0,46859,287790,0,334649
143135300500000,SW 420,RESIDENTIAL,44753,0,44753,208355,0,253108
143135300600000,SW 420,RESIDENTIAL,41153,0,41153,228445,0,269598
143135300700000,SW 420,RESIDENTIAL,38628,0,38628,204944,0,243572
143135300800000,SW 420,RESIDENTIAL,43092,0,43092,204356,0,247448
143135300900000,SW 420,RESIDENTIAL,44145,0,44145,240967,0,285112
143135301000000,SW 420,RESIDENTIAL,41368,0,41368,216907,0,258275
143135301100000,SW 420,RESIDENTIAL,43680,0,43680,212105,0,255785
143135301200000,NBHD SHOPPING CENTER,COMMERCIAL,0,601480,601480,0,1086432,1687912
143135301300000,VACANT LAND,COMMERCIAL,0,20,20,0,0,20
143135301400000,RESTAURANT,COMMERCIAL,0,563200,563200,0,940133,1503333
143135301500000,RESTAURANT,COMMERCIAL,0,504000,504000,0,679720,1183720
143135301600000,FAST FOOD,COMMERCIAL,0,376280,376280,0,532694,908974
143135301700000,BRANCH BANK/CU,COMMERCIAL,0,360280,360280,0,1753887,2114167
143135301800000,OFFICE; MEDICAL,COMMERCIAL,0,800000,800000,0,1448000,2248000
143135302100000,SCHOOL,COMMERCIAL,0,895500,895500,0,1704500,2600000
143135302200000,VACANT LAND,COMMERCIAL,0,3660,3660,0,0,3660
143135302300000,FAST FOOD,COMMERCIAL,0,301820,301820,0,277485,579305
143135302400000,BRANCH BANK/CU,COMMERCIAL,0,402600,402600,0,1289811,1692411
143135302600000,SW 420,RESIDENTIAL,29440,0,29440,167358,0,196798
143135302700000,SW 420,RESIDENTIAL,33649,0,33649,185061,0,218710
143135302800000,SW 420,RESIDENTIAL,28520,0,28520,160590,0,189110
143135302900000,SW 420,RESIDENTIAL,33723,0,33723,163338,0,197061
143135303000000,SW 420,RESIDENTIAL,39934,0,39934,158849,0,198783
143135303100000,SW 420,RESIDENTIAL,32085,0,32085,168993,0,201078
143135303200000,SW 420,RESIDENTIAL,31102,0,31102,162596,0,193698
143135303300000,SW 420,RESIDENTIAL,32085,0,32085,147031,0,179116
143137600100000,CITY PROPERTY,EXEMPT,0,0,0,0,0,0
143137700100000,SW 420,RESIDENTIAL,62450,0,62450,87672,0,150122
143137700200000,SW 420,RESIDENTIAL,29787,0,29787,141139,0,170926
143137700300000,SW 420,RESIDENTIAL,30000,0,30000,135065,0,165065
143137700400000,SW 420,RESIDENTIAL,30000,0,30000,0,0,30000
143137700500000,SW 420,RESIDENTIAL,32000,0,32000,136215,0,168215
143137700600000,SW 420,RESIDENTIAL,37445,0,37445,193082,0,230527
143137700700000,SW 420,RESIDENTIAL,26190,0,26190,134804,0,160994
143137700800000,SW 420,RESIDENTIAL,26609,0,26609,118377,0,144986
143137700900000,SW 420,RESIDENTIAL,25181,0,25181,132287,0,157468
143137701000000,SW 420,RESIDENTIAL,24978,0,24978,137196,0,162174
143137701200000,CITY PROPERTY,EXEMPT,0,0,0,0,0,0
143137701300000,SW 420,RESIDENTIAL,30768,0,30768,143618,0,174386
143137701400000,SW 420,RESIDENTIAL,30941,0,30941,126604,0,157545
143137701500000,SW 420,RESIDENTIAL,31185,0,31185,122716,0,153901
143137701600000,SW 420,RESIDENTIAL,31185,0,31185,115609,0,146794
143137701700000,SW 420,RESIDENTIAL,31185,0,31185,100653,0,131838
143137701800000,SW 420,RESIDENTIAL,31429,0,31429,102287,0,133716
143137701900000,SW 420,RESIDENTIAL,31185,0,31185,88677,0,119862
143137702000000,CITY PROPERTY,EXEMPT,0,0,0,0,0,0
143137702100000,CITY PROPERTY,EXEMPT,0,0,0,0,0,0
143137800100000,SW 420,RESIDENTIAL,32128,0,32128,98336,0,130464
143137800200000,SW 420,RESIDENTIAL,38475,0,38475,180047,0,218522
143137800300000,SW 420,RESIDENTIAL,36337,0,36337,162780,0,199117
143137800400000,SW 420,RESIDENTIAL,37402,0,37402,162114,0,199516
143137800500000,SW 420,RESIDENTIAL,38333,0,38333,178377,0,216710
143137800600000,SW 420,RESIDENTIAL,38475,0,38475,196914,0,235389
143137800700000,SW 420,RESIDENTIAL,38475,0,38475,190761,0,229236
143137800800000,SW 420,RESIDENTIAL,42795,0,42795,144353,0,187148
143137800900000,SW 420,RESIDENTIAL,29067,0,29067,114754,0,143821
143137801000000,SW 420,RESIDENTIAL,30000,0,30000,143038,0,173038
143137801100000,SW 420,RESIDENTIAL,30000,0,30000,141115,0,171115
143137801200000,SW 420,RESIDENTIAL,30000,0,30000,128354,0,158354
143137801300000,SW 420,RESIDENTIAL,32000,0,32000,120602,0,152602
143137801400000,SW 420,EXEMPT,0,33536,33536,0,117765,151301
143137801500000,SW 420,RESIDENTIAL,65,0,65,0,0,65
143137801600000,SW 420,RESIDENTIAL,30000,0,30000,109917,0,139917
143137801700000,SW 420,RESIDENTIAL,30000,0,30000,116391,0,146391
143137801800000,SW 420,RESIDENTIAL,30000,0,30000,90421,0,120421
143137900400000,SW 420,RESIDENTIAL,33614,0,33614,174870,0,208484
143137900500000,SW 420,RESIDENTIAL,33649,0,33649,205422,0,239071
143137900600000,SW 420,RESIDENTIAL,28520,0,28520,181901,0,210421
143137900700000,SW 420,RESIDENTIAL,33649,0,33649,161721,0,195370
143137900800000,SW 420,RESIDENTIAL,32660,0,32660,143118,0,175778
143137900900000,SW 420,RESIDENTIAL,33120,0,33120,213196,0,246316
143137901000000,SW 420,RESIDENTIAL,33649,0,33649,160474,0,194123
143137901100000,SW 420,RESIDENTIAL,33649,0,33649,176902,0,210551
143137901200000,SW 420,RESIDENTIAL,32660,0,32660,170400,0,203060
143137901300000,SW 420,RESIDENTIAL,33649,0,33649,181491,0,215140
143137901400000,SW 420,RESIDENTIAL,35420,0,35420,182789,0,218209
143137901500000,SW 420,RESIDENTIAL,33649,0,33649,151482,0,185131
143137901600000,SW 420,RESIDENTIAL,34500,0,34500,185965,0,220465
143137901700000,SW 420,RESIDENTIAL,33638,0,33638,167045,0,200683
143137901800000,SW 420,RESIDENTIAL,35708,0,35708,152858,0,188566
143137901900000,SW 420,RESIDENTIAL,31619,0,31619,168254,0,199873
143137902000000,SW 420,RESIDENTIAL,32085,0,32085,147931,0,180016
143137902100000,SW 420,RESIDENTIAL,37260,0,37260,179551,0,216811
143137902200000,SW 420,RESIDENTIAL,37260,0,37260,161142,0,198402
143137902300000,SW 420,RESIDENTIAL,33638,0,33638,182970,0,216608
143137902400000,SW 420,RESIDENTIAL,35708,0,35708,176597,0,212305
143137902500000,SW 420,RESIDENTIAL,32085,0,32085,200207,0,232292
143137902600000,SW 420,RESIDENTIAL,33638,0,33638,0,0,33638
143137902700000,SW 420,RESIDENTIAL,34673,0,34673,164327,0,199000
143137902800000,SW 420,RESIDENTIAL,35708,0,35708,185835,0,221543
143137902900000,SW 420,RESIDENTIAL,30584,0,30584,172421,0,203005
143137903000000,SW 420,RESIDENTIAL,35436,0,35436,184778,0,220214
143140100100000,SW 419,RESIDENTIAL,19775,0,19775,65215,0,84990
143140100200000,SW 419,RESIDENTIAL,31442,0,31442,34918,0,66360
143140100300000,SW 419,RESIDENTIAL,20650,0,20650,131843,0,152493
143140100400000,SW 419,RESIDENTIAL,20650,0,20650,51258,0,71908
143140100500000,SW 419,RESIDENTIAL,20650,0,20650,109689,0,130339
143140100600000,SW 419,RESIDENTIAL,20650,0,20650,58033,0,78683
143140100700000,SW 419,RESIDENTIAL,30975,0,30975,95175,0,126150
143140100800000,SW 419,RESIDENTIAL,30975,0,30975,71013,0,101988
143140100900000,SW 419,RESIDENTIAL,30975,0,30975,76376,0,107351
143140101000000,SW 419,RESIDENTIAL,30665,0,30665,87683,0,118348
143140101100000,SW 419,RESIDENTIAL,30665,0,30665,49052,0,79717
143140101200000,SW 419,RESIDENTIAL,27258,0,27258,94165,0,121423
143140101300000,SW 419,RESIDENTIAL,25606,0,25606,49730,0,75336
143140101400000,SW 419,RESIDENTIAL,28910,0,28910,90500,0,119410
143140101500000,SW 419,RESIDENTIAL,27258,0,27258,51522,0,78780
143140101600000,SW 419,RESIDENTIAL,27258,0,27258,109068,0,136326
143140101700000,SW 419,RESIDENTIAL,38161,0,38161,46812,0,84973
143140101800000,SW 419,RESIDENTIAL,68350,0,68350,126414,0,194764
143140101900000,SW 419,AG LAND,37081,0,37081,0,0,37081
143140102000000,SW 419,AG DWELLING,6763,0,6763,180949,5690,193402
143140102100000,SW 419,RESIDENTIAL,46300,0,46300,111400,0,157700
143140102200000,SW 419,RESIDENTIAL,40000,0,40000,88733,0,128733
143140102300000,SW 419,RESIDENTIAL,2453,0,2453,0,0,2453
143142600100000,SW 420,RESIDENTIAL,33075,0,33075,117771,0,150846
143142600200000,SW 420,RESIDENTIAL,29376,0,29376,101024,0,130400
143142600300000,SW 420,RESIDENTIAL,25839,0,25839,105497,0,131336
143142600400000,SW 420,RESIDENTIAL,30740,0,30740,91318,0,122058
143142600500000,SW 420,RESIDENTIAL,33413,0,33413,100131,0,133544
143142600600000,SW 420,RESIDENTIAL,33413,0,33413,84194,0,117607
143142600700000,SW 420,RESIDENTIAL,33413,0,33413,91455,0,124868
143142600800000,SW 420,RESIDENTIAL,33413,0,33413,88545,0,121958
143142600900000,SW 420,RESIDENTIAL,33413,0,33413,105177,0,138590
143142601000000,SW 420,RESIDENTIAL,33413,0,33413,98835,0,132248
143142601100000,SW 420,RESIDENTIAL,33413,0,33413,89086,0,122499
143142601200000,SW 420,RESIDENTIAL,33413,0,33413,98257,0,131670
143142601300000,SW 420,RESIDENTIAL,33413,0,33413,93044,0,126457
143142601400000,SW 420,RESIDENTIAL,33413,0,33413,103946,0,137359
143142601500000,SW 420,RESIDENTIAL,33413,0,33413,101294,0,134707
143142700100000,SW 420,RESIDENTIAL,26918,0,26918,123207,0,150125
143142700200000,SMALL RETAIL,COMMERCIAL,0,115920,115920,0,98763,214683
143142700300000,SW 420,AG DWELLING,19796,0,19796,9905,11531,41232
143142700400000,SW 420,RESIDENTIAL,25973,0,25973,92866,0,118839
143142700500000,SW 420,RESIDENTIAL,24240,0,24240,97404,0,121644
143142700600000,SW 420,RESIDENTIAL,24240,0,24240,80290,0,104530
143142700700000,SW 420,RESIDENTIAL,24240,0,24240,87622,0,111862
143142700800000,SW 420,RESIDENTIAL,24240,0,24240,92663,0,116903
143142700900000,SW 420,RESIDENTIAL,24240,0,24240,95126,0,119366
143142701000000,SW 420,RESIDENTIAL,24240,0,24240,106715,0,130955
143142701100000,SW 420,RESIDENTIAL,24240,0,24240,91251,0,115491
143142701200000,SW 420,RESIDENTIAL,24240,0,24240,107035,0,131275
143142701300000,SW 420,RESIDENTIAL,24240,0,24240,111271,0,135511
143142701400000,SW 420,RESIDENTIAL,25856,0,25856,137142,0,162998
143142701500000,SW 420,RESIDENTIAL,25856,0,25856,101420,0,127276
143142701600000,SW 420,RESIDENTIAL,25856,0,25856,110030,0,135886
143142701700000,SW 420,RESIDENTIAL,25856,0,25856,87210,0,113066
143142701800000,SW 420,RESIDENTIAL,25856,0,25856,102180,0,128036
143142701900000,SW 420,RESIDENTIAL,25856,0,25856,95996,0,121852
143142702000000,SW 420,RESIDENTIAL,25856,0,25856,99667,0,125523
143142702100000,SW 420,RESIDENTIAL,25856,0,25856,96755,0,122611
143142702200000,SW 420,RESIDENTIAL,25856,0,25856,132153,0,158009
143142702300000,SW 420,RESIDENTIAL,26188,0,26188,115610,0,141798
143142702400000,SW 420,RESIDENTIAL,34088,0,34088,101234,0,135322
143142702500000,SW 420,RESIDENTIAL,34088,0,34088,85841,0,119929
143142702600000,SW 420,RESIDENTIAL,34088,0,34088,98605,0,132693
143142702700000,SW 420,RESIDENTIAL,34088,0,34088,110205,0,144293
143142702800000,SW 420,RESIDENTIAL,33750,0,33750,115144,0,148894
143142702900000,SW 420,RESIDENTIAL,33750,0,33750,114887,0,148637
143142703000000,SW 420,RESIDENTIAL,33750,0,33750,108809,0,142559
143142703100000,SW 420,RESIDENTIAL,33580,0,33580,110852,0,144432
143142703200000,SW 420,RESIDENTIAL,33580,0,33580,15355,0,48935
143142703300000,SW 420,RESIDENTIAL,31500,0,31500,0,0,31500
143142703400000,SW 420,RESIDENTIAL,31500,0,31500,116939,0,148439
143142703500000,SW 420,RESIDENTIAL,33413,0,33413,128668,0,162081
143142703600000,SW 420,RESIDENTIAL,29988,0,29988,123929,0,153917
143142703700000,SW 420,RESIDENTIAL,26190,0,26190,115432,0,141622
143142800100000,SW 420,RESIDENTIAL,29013,0,29013,94859,0,123872
143142800200000,SW 420,RESIDENTIAL,26910,0,26910,75477,0,102387
143142800300000,SW 420,RESIDENTIAL,25073,0,25073,146467,0,171540
143142800400000,SW 420,RESIDENTIAL,30294,0,30294,0,0,30294
143142800500000,SW 420,RESIDENTIAL,33763,0,33763,108155,0,141918
143142800600000,SW 420,RESIDENTIAL,34088,0,34088,121520,0,155608
143142800700000,SW 420,RESIDENTIAL,33633,0,33633,117886,0,151519
143142800800000,SW 420,RESIDENTIAL,33633,0,33633,105247,0,138880
143142800900000,SW 420,RESIDENTIAL,34088,0,34088,120454,0,154542
143142801000000,SW 420,RESIDENTIAL,34088,0,34088,143641,0,177729
143142801100000,SW 420,RESIDENTIAL,34088,0,34088,143485,0,177573
143142801200000,SW 420,RESIDENTIAL,53850,0,53850,0,0,53850
143142801300000,SW 420,RESIDENTIAL,26969,0,26969,110644,0,137613
143142801400000,SW 420,RESIDENTIAL,24644,0,24644,118791,0,143435
143142801500000,SW 420,RESIDENTIAL,24644,0,24644,106127,0,130771
143142801600000,SW 420,RESIDENTIAL,24644,0,24644,98501,0,123145
143142801700000,SW 420,RESIDENTIAL,24644,0,24644,96794,0,121438
143142801800000,SW 420,RESIDENTIAL,26442,0,26442,113101,0,139543
143142801900000,SW 420,RESIDENTIAL,28280,0,28280,104035,0,132315
143142802000000,SW 420,RESIDENTIAL,27270,0,27270,108134,0,135404
143142802100000,SW 420,RESIDENTIAL,25856,0,25856,103930,0,129786
143142802200000,SW 420,RESIDENTIAL,26906,0,26906,111023,0,137929
143142802300000,SW 420,RESIDENTIAL,24240,0,24240,71042,0,95282
143142802400000,SW 420,RESIDENTIAL,24240,0,24240,82158,0,106398
143142802500000,SW 420,RESIDENTIAL,24240,0,24240,90604,0,114844
143142802600000,SW 420,RESIDENTIAL,24240,0,24240,89297,0,113537
143142802700000,SW 420,RESIDENTIAL,24240,0,24240,97551,0,121791
143142802800000,SW 420,RESIDENTIAL,24240,0,24240,130836,0,155076
143142802900000,SW 420,RESIDENTIAL,24240,0,24240,84803,0,109043
143142803000000,SW 420,RESIDENTIAL,24240,0,24240,81423,0,105663
143142900100000,SW 420,RESIDENTIAL,32360,0,32360,107451,0,139811
143142900200000,SW 420,RESIDENTIAL,30208,0,30208,108760,0,138968
143142900300000,SW 420,RESIDENTIAL,32597,0,32597,115755,0,148352
143142900400000,SW 420,RESIDENTIAL,32270,0,32270,105829,0,138099
143142900500000,SW 420,RESIDENTIAL,32270,0,32270,113029,0,145299
143142900600000,SW 420,RESIDENTIAL,32270,0,32270,117452,0,149722
143142900700000,SW 420,RESIDENTIAL,33633,0,33633,132827,0,166460
143143000100000,SW 420,RESIDENTIAL,24498,0,24498,0,0,24498
143145100100000,SW 420,AG LAND,68831,0,68831,0,0,68831
143145100200000,SW 455,AG DWELLING,22670,0,22670,73085,0,95755
143145100300000,SW 455,RESIDENTIAL,32500,0,32500,31501,0,64001
143145100400000,SW 455,AG LAND,7357,0,7357,0,0,7357
143147600100000,SW 455,AG LAND,44669,0,44669,0,10131,54800
143147600200000,SW 455,AG DWELLING,1767,0,1767,91813,0,93580
143147600400000,SW 455,AG DWELLING,25627,0,25627,109274,13499,148400
143147600500000,SW 455,AG DWELLING,3426,0,3426,75930,0,79356
143147600600000,SW 455,AG LAND,24233,0,24233,0,2413,26646
143210100100000,RESTAURANT,COMMERCIAL,0,28560,28560,0,78310,106870
143210100200000,FLAT PARKING,COMMERCIAL,0,24990,24990,0,3808,28798
143210100300000,SW 404,RESIDENTIAL,16031,0,16031,51511,0,67542
143210100400000,SW 404,RESIDENTIAL,15000,0,15000,66865,0,81865
143210100500000,SW 404,RESIDENTIAL,15000,0,15000,44192,0,59192
143210100600000,SW 404,RESIDENTIAL,15000,0,15000,63399,0,78399
143210100700000,SW 404,RESIDENTIAL,15000,0,15000,84058,0,99058
143210100800000,SW 404,RESIDENTIAL,15000,0,15000,58916,0,73916
143210100900000,SW 404,RESIDENTIAL,15000,0,15000,59410,0,74410
143210101000000,SW 404,RESIDENTIAL,15000,0,15000,55067,0,70067
143210101100000,SW 404,RESIDENTIAL,15000,0,15000,55225,0,70225
143210101200000,SW 404,RESIDENTIAL,15000,0,15000,70097,0,85097
143210101300000,SW 404,RESIDENTIAL,15000,0,15000,71129,0,86129
143210101400000,SW 404,RESIDENTIAL,15000,0,15000,58267,0,73267
143210101500000,SW 404,RESIDENTIAL,15000,0,15000,62828,0,77828
143210101600000,SW 404,RESIDENTIAL,15000,0,15000,77528,0,92528
143210200500000,SW 404,RESIDENTIAL,15000,0,15000,85217,0,100217
143210200600000,APARTMENT,COMMERCIAL,0,23520,23520,0,232313,255833
143210200700000,APARTMENT,RESIDENTIAL,52560,0,52560,675660,0,728220
143210300100000,SW 404,RESIDENTIAL,17100,0,17100,52673,0,69773
143210300200000,SW 404,RESIDENTIAL,15000,0,15000,57610,0,72610
143210300300000,SW 404,RESIDENTIAL,17100,0,17100,76342,0,93442
143210300400000,SW 404,RESIDENTIAL,17100,0,17100,0,0,17100
143210400100000,LG DISCOUNT/RETAIL,COMMERCIAL,0,498300,498300,0,1459992,1958292
143210400600000,SW 404,RESIDENTIAL,18000,0,18000,68695,0,86695
143210400700000,SW 404,RESIDENTIAL,18000,0,18000,69556,0,87556
143210400800000,SW 404,RESIDENTIAL,15000,0,15000,57195,0,72195
143210400900000,SW 404,RESIDENTIAL,15000,0,15000,45440,0,60440
143210401000000,SW 404,RESIDENTIAL,15000,0,15000,55207,0,70207
143210401100000,SW 404,RESIDENTIAL,15675,0,15675,51778,0,67453
143210401200000,SW 404,RESIDENTIAL,19140,0,19140,97692,0,116832
143210401300000,SW 404,RESIDENTIAL,17595,0,17595,43089,0,60684
143210401400000,SW 404,RESIDENTIAL,17802,0,17802,77133,0,94935
143210401500000,SW 404,RESIDENTIAL,15000,0,15000,35714,0,50714
143210401600000,APARTMENT,COMMERCIAL,0,33600,33600,0,402783,436383
143210401700000,SW 404,RESIDENTIAL,15000,0,15000,75212,0,90212
143210401800000,CONVERSION,COMMERCIAL,0,9072,9072,0,77203,86275
143210500100000,SW 404,RESIDENTIAL,15871,0,15871,72503,0,88374
143210500200000,SW 404,RESIDENTIAL,15781,0,15781,64906,0,80687
143210500300000,SW 404,RESIDENTIAL,16875,0,16875,81172,0,98047
143210500400000,SW 404,RESIDENTIAL,16875,0,16875,76951,0,93826
143210500500000,SW 404,RESIDENTIAL,15781,0,15781,58156,0,73937
143210500600000,SW 404,RESIDENTIAL,14892,0,14892,59353,0,74245
143210500700000,SW 404,RESIDENTIAL,14430,0,14430,64838,0,79268
143210500800000,SW 404,RESIDENTIAL,14430,0,14430,59203,0,73633
143210500900000,SW 404,RESIDENTIAL,19280,0,19280,93883,0,113163
143210501000000,SW 404,RESIDENTIAL,16875,0,16875,56816,0,73691
143210501100000,SW 404,RESIDENTIAL,16875,0,16875,76456,0,93331
143210501200000,SW 404,RESIDENTIAL,15781,0,15781,80360,0,96141
143210501300000,SW 404,RESIDENTIAL,15029,0,15029,74312,0,89341
143210501400000,SW 404,RESIDENTIAL,14625,0,14625,75272,0,89897
143210501500000,SW 404,RESIDENTIAL,14430,0,14430,66959,0,81389
143210600100000,SW 404,RESIDENTIAL,7417,0,7417,0,0,7417
143210600200000,SW 404,RESIDENTIAL,18000,0,18000,76316,0,94316
143210600300000,SW 404,RESIDENTIAL,15000,0,15000,51990,0,66990
143210600400000,SW 404,RESIDENTIAL,14835,0,14835,54381,0,69216
143210600500000,SW 404,RESIDENTIAL,17802,0,17802,64118,0,81920
143210600600000,SW 404,RESIDENTIAL,14662,0,14662,152322,0,166984
143210600700000,SW 404,RESIDENTIAL,7417,0,7417,4913,0,12330
143210700300000,FLAT PARKING,COMMERCIAL,0,20800,20800,0,2964,23764
143210700400000,SW 404,RESIDENTIAL,15000,0,15000,56900,0,71900
143210700500000,SW 404,RESIDENTIAL,15000,0,15000,55100,0,70100
143210700600000,SW 404,RESIDENTIAL,15000,0,15000,65479,0,80479
143210700700000,SW 404,RESIDENTIAL,15000,0,15000,52168,0,67168
143210700800000,SW 404,RESIDENTIAL,15000,0,15000,47571,0,62571
143210700900000,VACANT LAND,RESIDENTIAL,17640,0,17640,52289,0,69929
143210701000000,VACANT LAND,RESIDENTIAL,17640,0,17640,0,0,17640
143210701100000,SW 404,RESIDENTIAL,15000,0,15000,63862,0,78862
143210701200000,SW 404,RESIDENTIAL,11400,0,11400,78688,0,90088
143210701300000,SW 404,RESIDENTIAL,10125,0,10125,84295,0,94420
143210701400000,SW 404,RESIDENTIAL,20400,0,20400,76193,0,96593
143210701500000,SW 404,RESIDENTIAL,19125,0,19125,70588,0,89713
143210701600000,SW 404,RESIDENTIAL,21037,0,21037,107161,0,128198
143210701700000,SW 404,RESIDENTIAL,17000,0,17000,86279,0,103279
143210701800000,SW 404,RESIDENTIAL,17000,0,17000,55262,0,72262
143210701900000,SW 404,RESIDENTIAL,17000,0,17000,54874,0,71874
143210702000000,SW 404,RESIDENTIAL,17000,0,17000,60448,0,77448
143210702100000,SW 404,RESIDENTIAL,17000,0,17000,53614,0,70614
143210702200000,SW 404,RESIDENTIAL,17000,0,17000,45483,0,62483
143210702300000,SW 404,RESIDENTIAL,20400,0,20400,61005,0,81405
143210702400000,SW 404,RESIDENTIAL,20017,0,20017,53029,0,73046
143210702500000,BARS/LOUNGE,COMMERCIAL,0,10800,10800,0,110639,121439
143210702600000,FLAT PARKING,COMMERCIAL,0,38333,38333,0,4800,43133
143210702700000,AUTO REPAIR/SALES,COMMERCIAL,0,88862,88862,0,130693,219555
143210800100000,SW 404,RESIDENTIAL,15675,0,15675,88558,0,104233
143210800200000,SW 404,RESIDENTIAL,15000,0,15000,60328,0,75328
143210800300000,SW 404,RESIDENTIAL,18000,0,18000,76975,0,94975
143210800500000,SW 404,RESIDENTIAL,15000,0,15000,43604,0,58604
143210800600000,SW 404,RESIDENTIAL,15000,0,15000,38473,0,53473
143210800700000,SW 404,RESIDENTIAL,15000,0,15000,0,0,15000
143210800800000,SW 404,RESIDENTIAL,15000,0,15000,101339,0,116339
143210800900000,SW 404,RESIDENTIAL,8262,0,8262,42050,0,50312
143210801000000,SW 404,RESIDENTIAL,7803,0,7803,42334,0,50137
143210801300000,SW 404,RESIDENTIAL,17000,0,17000,48593,0,65593
143210801400000,SW 404,RESIDENTIAL,17000,0,17000,45258,0,62258
143210801500000,SW 404,RESIDENTIAL,17000,0,17000,92890,0,109890
143210801600000,SW 404,RESIDENTIAL,17000,0,17000,39429,0,56429
143210801700000,SW 404,RESIDENTIAL,17000,0,17000,77087,0,94087
143210801800000,SW 404,RESIDENTIAL,17765,0,17765,54580,0,72345
143210801900000,APARTMENT,COMMERCIAL,0,16345,16345,0,115062,131407
143210900100000,SCHOOL,EXEMPT,0,0,0,0,0,0
143210900200000,SCHOOL,EXEMPT,0,0,0,0,0,0
143211000100000,RESTAURANT,COMMERCIAL,0,100800,100800,0,129377,230177
143211000200000,SW 404,RESIDENTIAL,17000,0,17000,37018,0,54018
143211000300000,SW 404,RESIDENTIAL,17000,0,17000,55657,0,72657
143211000400000,SW 404,RESIDENTIAL,17000,0,17000,47477,0,64477
143211000500000,SW 404,RESIDENTIAL,20400,0,20400,46704,0,67104
143211000600000,SW 404,RESIDENTIAL,20400,0,20400,72628,0,93028
143211000700000,SW 404,RESIDENTIAL,17000,0,17000,68625,0,85625
143211000800000,SW 404,RESIDENTIAL,17000,0,17000,71262,0,88262
143211000900000,SW 404,RESIDENTIAL,20400,0,20400,78071,0,98471
143211001000000,SW 404,RESIDENTIAL,20400,0,20400,70594,0,90994
143211001100000,SW 404,RESIDENTIAL,17000,0,17000,82978,0,99978
143211001200000,SW 404,RESIDENTIAL,17000,0,17000,60243,0,77243
143211001300000,SW 404,RESIDENTIAL,17000,0,17000,75560,0,92560
143211001400000,SW 404,RESIDENTIAL,17000,0,17000,62271,0,79271
143211001500000,SW 404,RESIDENTIAL,17000,0,17000,54552,0,71552
143211001600000,SW 404,RESIDENTIAL,17000,0,17000,94109,0,111109
143211001700000,SW 404,RESIDENTIAL,17000,0,17000,95284,0,112284
143211001800000,SW 404,RESIDENTIAL,17000,0,17000,0,0,17000
143211001900000,SW 404,RESIDENTIAL,17000,0,17000,49110,0,66110
143211002000000,SW 404,RESIDENTIAL,17000,0,17000,61022,0,78022
143211002100000,SW 404,RESIDENTIAL,17000,0,17000,67587,0,84587
143211002200000,SW 404,RESIDENTIAL,17000,0,17000,66297,0,83297
143211002300000,AUTO REPAIR/SALES,COMMERCIAL,0,100800,100800,0,66329,167129
143211100100000,CHURCH,EXEMPT,0,21546,21546,0,5940,27486
143211100200000,SW 404,EXEMPT,0,20400,20400,0,124669,145069
143211100300000,CHURCH,EXEMPT,0,20844,20844,0,360030,380874
143211100400000,SW 404,RESIDENTIAL,14212,0,14212,65153,0,79365
143211100500000,SW 404,RESIDENTIAL,20188,0,20188,78873,0,99061
143211100600000,SW 404,RESIDENTIAL,17000,0,17000,70869,0,87869
143211100700000,SW 404,RESIDENTIAL,20400,0,20400,121813,0,142213
143211100800000,SW 404,RESIDENTIAL,20400,0,20400,114869,0,135269
143211100900000,SW 404,RESIDENTIAL,17000,0,17000,88684,0,105684
143211101000000,SW 404,RESIDENTIAL,17765,0,17765,79395,0,97160
143211200100000,SW 404,RESIDENTIAL,18088,0,18088,66283,0,84371
143211200200000,SW 404,RESIDENTIAL,20400,0,20400,80226,0,100626
143211200300000,SW 404,RESIDENTIAL,20400,0,20400,101390,0,121790
143211200400000,SW 404,RESIDENTIAL,17000,0,17000,78897,0,95897
143211200500000,SW 404,RESIDENTIAL,18564,0,18564,70043,0,88607
143211200600000,SW 404,RESIDENTIAL,15504,0,15504,60492,0,75996
143211200700000,SW 404,RESIDENTIAL,18088,0,18088,70926,0,89014
143212600100000,SW 404,RESIDENTIAL,15000,0,15000,55658,0,70658
143212600200000,SW 404,RESIDENTIAL,15000,0,15000,79631,0,94631
143212600300000,SW 404,RESIDENTIAL,15000,0,15000,54758,0,69758
143212600400000,SW 404,RESIDENTIAL,15000,0,15000,53189,0,68189
143212600500000,SW 404,RESIDENTIAL,15000,0,15000,64461,0,79461
143212600600000,SW 404,RESIDENTIAL,22500,0,22500,72888,0,95388
143212600700000,SW 404,RESIDENTIAL,19500,0,19500,89164,0,108664
143212700100000,SW 404,RESIDENTIAL,16575,0,16575,75833,0,92408
143212700200000,SW 404,RESIDENTIAL,10500,0,10500,43452,0,53952
143212700300000,SW 404,RESIDENTIAL,15000,0,15000,45939,0,60939
143212700400000,SW 404,RESIDENTIAL,15000,0,15000,68891,0,83891
143212700500000,SW 404,RESIDENTIAL,15000,0,15000,43634,0,58634
143212700600000,SW 404,RESIDENTIAL,15000,0,15000,25170,0,40170
143212700700000,SW 404,RESIDENTIAL,15000,0,15000,84964,0,99964
143212700800000,SW 404,RESIDENTIAL,15000,0,15000,44492,0,59492
143212700900000,VACANT LAND,COMMERCIAL,0,15120,15120,0,0,15120
143212701000000,VACANT LAND,COMMERCIAL,0,15120,15120,0,0,15120
143212701100000,SW 404,RESIDENTIAL,15000,0,15000,101112,0,116112
143212701200000,SW 404,RESIDENTIAL,15000,0,15000,85983,0,100983
143212701300000,SW 404,RESIDENTIAL,15000,0,15000,80562,0,95562
143212800200000,SERVICE STATION,COMMERCIAL,0,41468,41468,0,35894,77362
143212800300000,CENTRALLY ASSESSED,OTHER,0,0,0,0,0,0
143212900100000,SW 404,RESIDENTIAL,18000,0,18000,74312,0,92312
143212900200000,SW 404,RESIDENTIAL,15000,0,15000,51033,0,66033
143212900300000,SW 404,RESIDENTIAL,15000,0,15000,47730,0,62730
143212900400000,SW 404,RESIDENTIAL,15000,0,15000,51951,0,66951
143212900500000,SW 404,RESIDENTIAL,15000,0,15000,49558,0,64558
143212900800000,SW 404,RESIDENTIAL,15000,0,15000,60557,0,75557
143212900900000,SW 404,RESIDENTIAL,15000,0,15000,44468,0,59468
143212901000000,SW 404,RESIDENTIAL,15000,0,15000,44878,0,59878
143212901100000,SW 404,RESIDENTIAL,15000,0,15000,44305,0,59305
143212901200000,SW 404,RESIDENTIAL,15000,0,15000,24491,0,39491
143212901300000,SW 404,RESIDENTIAL,15000,0,15000,43999,0,58999
143212901400000,SW 404,RESIDENTIAL,15000,0,15000,46205,0,61205
143212901500000,SW 404,RESIDENTIAL,15000,0,15000,79755,0,94755
143212901600000,SW 404,RESIDENTIAL,9000,0,9000,0,0,9000
143212901700000,SW 404,RESIDENTIAL,9000,0,9000,82714,0,91714
143212901800000,SW 404,RESIDENTIAL,15000,0,15000,64569,0,79569
143212901900000,SW 404,RESIDENTIAL,18000,0,18000,110460,0,128460
143213000100000,SW 404,RESIDENTIAL,15000,0,15000,75029,0,90029
143213000200000,SW 404,RESIDENTIAL,15000,0,15000,89404,0,104404
143213000300000,SW 404,RESIDENTIAL,9000,0,9000,63183,0,72183
143213000400000,SW 404,RESIDENTIAL,9000,0,9000,0,0,9000
143213000500000,SW 404,RESIDENTIAL,15000,0,15000,76501,0,91501
143213000600000,SW 404,RESIDENTIAL,18000,0,18000,46405,0,64405
143213000700000,SW 404,RESIDENTIAL,18000,0,18000,45313,0,63313
143213000800000,SW 404,RESIDENTIAL,15000,0,15000,0,0,15000
143213000900000,SW 404,RESIDENTIAL,15000,0,15000,38791,0,53791
143213001000000,SW 404,RESIDENTIAL,15000,0,15000,12540,0,27540
143213001100000,SW 404,RESIDENTIAL,15000,0,15000,24814,0,39814
143213001200000,SW 404,RESIDENTIAL,15000,0,15000,53560,0,68560
143213001300000,SW 404,RESIDENTIAL,15000,0,15000,63206,0,78206
143213001400000,SW 404,RESIDENTIAL,15000,0,15000,56139,0,71139
143213001500000,VACANT LAND,COMMERCIAL,0,16800,16800,0,0,16800
143213001600000,SW 404,RESIDENTIAL,18000,0,18000,99388,0,117388
143213001700000,SW 404,RESIDENTIAL,15000,0,15000,64465,0,79465
143213001800000,SW 404,RESIDENTIAL,18000,0,18000,66095,0,84095
143213001900000,SW 404,RESIDENTIAL,18000,0,18000,72515,0,90515
143213002000000,SW 404,RESIDENTIAL,15000,0,15000,26292,0,41292
143213002100000,SW 404,RESIDENTIAL,15000,0,15000,35399,0,50399
143213002200000,SW 404,RESIDENTIAL,17719,0,17719,56620,0,74339
143213100100000,VACANT LAND,COMMERCIAL,0,6919,6919,0,0,6919
143213100200000,SMALL RETAIL,COMMERCIAL,0,142000,142000,0,477646,619646
143213100300000,VACANT LAND,COMMERCIAL,0,12000,12000,0,0,12000
143213200100000,SW 404,RESIDENTIAL,15000,0,15000,41138,0,56138
143213200200000,SW 404,RESIDENTIAL,15000,0,15000,0,0,15000
143213200300000,SW 404,RESIDENTIAL,15000,0,15000,62937,0,77937
143213200400000,SW 404,RESIDENTIAL,15000,0,15000,56205,0,71205
143213200500000,SW 404,RESIDENTIAL,15000,0,15000,73672,0,88672
143213200600000,SW 404,RESIDENTIAL,15000,0,15000,0,0,15000
143213200700000,SW 404,RESIDENTIAL,15000,0,15000,53539,0,68539
143213200800000,SW 404,RESIDENTIAL,15000,0,15000,63728,0,78728
143213200900000,SW 404,RESIDENTIAL,17000,0,17000,75655,0,92655
143213201000000,SW 404,RESIDENTIAL,17000,0,17000,65832,0,82832
143213201100000,SW 404,RESIDENTIAL,17000,0,17000,72816,0,89816
143213201200000,SW 404,RESIDENTIAL,17000,0,17000,71579,0,88579
143213201300000,SW 404,RESIDENTIAL,17000,0,17000,46151,0,63151
143213201400000,SCHOOL,EXEMPT,0,0,0,0,0,0
143213201500000,VACANT LAND,EXEMPT,0,0,0,0,0,0
143213300100000,SW 404,RESIDENTIAL,15000,0,15000,72027,0,87027
143213300200000,SW 404,RESIDENTIAL,15000,0,15000,49157,0,64157
143213300300000,SW 404,RESIDENTIAL,15000,0,15000,49954,0,64954
143213300400000,SW 404,RESIDENTIAL,15000,0,15000,36559,0,51559
143213300500000,SW 404,RESIDENTIAL,15000,0,15000,60943,0,75943
143213300600000,SW 404,RESIDENTIAL,15000,0,15000,70040,0,85040
143213300700000,SW 404,RESIDENTIAL,15000,0,15000,83976,0,98976
143213300800000,SW 404,RESIDENTIAL,15000,0,15000,56324,0,71324
143213300900000,WAREHOUSE;MINI STORG,COMMERCIAL,0,104000,104000,0,188986,292986
143213301000000,SW 404,RESIDENTIAL,17000,0,17000,8866,0,25866
143213301100000,SW 404,RESIDENTIAL,17000,0,17000,89154,0,106154
143213301200000,SW 404,RESIDENTIAL,17000,0,17000,89589,0,106589
143213301300000,SW 404,RESIDENTIAL,17000,0,17000,51740,0,68740
143213301400000,SW 404,RESIDENTIAL,17000,0,17000,48818,0,65818
143213301500000,SW 404,RESIDENTIAL,17000,0,17000,73396,0,90396
143213301600000,SW 404,RESIDENTIAL,17000,0,17000,41098,0,58098
143213301700000,SW 404,RESIDENTIAL,17000,0,17000,40264,0,57264
143213301800000,SW 404,RESIDENTIAL,17000,0,17000,55024,0,72024
143213301900000,SW 404,RESIDENTIAL,20400,0,20400,73352,0,93752
143213302000000,SW 404,RESIDENTIAL,17000,0,17000,51248,0,68248
143213302100000,SW 404,RESIDENTIAL,17000,0,17000,44374,0,61374
143213400100000,SW 404,RESIDENTIAL,17000,0,17000,39358,0,56358
143213400200000,SW 404,RESIDENTIAL,25500,0,25500,85387,0,110887
143213400300000,SW 404,RESIDENTIAL,17000,0,17000,51529,0,68529
143213400400000,SW 404,RESIDENTIAL,19507,0,19507,49063,0,68570
143213400500000,SW 404,RESIDENTIAL,19507,0,19507,76386,0,95893
143213400600000,SW 404,RESIDENTIAL,17000,0,17000,20524,0,37524
143213400700000,SW 404,RESIDENTIAL,17000,0,17000,27376,0,44376
143213400800000,SW 404,RESIDENTIAL,19720,0,19720,76454,0,96174
143213400900000,SW 404,RESIDENTIAL,21080,0,21080,79684,0,100764
143213500100000,SW 404,RESIDENTIAL,17000,0,17000,47549,0,64549
143213500200000,SW 404,RESIDENTIAL,17212,0,17212,92844,0,110056
143213500300000,SW 404,RESIDENTIAL,14875,0,14875,51497,0,66372
143213500400000,SW 404,RESIDENTIAL,20400,0,20400,82196,0,102596
143213500500000,SW 404,RESIDENTIAL,20400,0,20400,127537,0,147937
143213500600000,SW 404,RESIDENTIAL,17000,0,17000,59908,0,76908
143213500700000,SW 404,RESIDENTIAL,17000,0,17000,61103,0,78103
143213500800000,SW 404,RESIDENTIAL,17000,0,17000,83191,0,100191
143213500900000,SW 404,RESIDENTIAL,14960,0,14960,48120,0,63080
143213501000000,SW 404,RESIDENTIAL,11900,0,11900,63813,0,75713
143213501100000,SW 404,RESIDENTIAL,15470,0,15470,55364,0,70834
143213501200000,SW 404,RESIDENTIAL,17000,0,17000,54403,0,71403
143213501300000,SW 404,RESIDENTIAL,17000,0,17000,45730,0,62730
143213501400000,SW 404,RESIDENTIAL,17000,0,17000,60516,0,77516
143213501500000,SW 404,RESIDENTIAL,17000,0,17000,49046,0,66046
143213501600000,SW 404,RESIDENTIAL,17000,0,17000,64203,0,81203
143213501700000,SW 404,RESIDENTIAL,17000,0,17000,91637,0,108637
143213501800000,SW 404,RESIDENTIAL,17000,0,17000,65435,0,82435
143213600100000,SW 404,RESIDENTIAL,20400,0,20400,55513,0,75913
143213600200000,SW 404,RESIDENTIAL,17000,0,17000,124627,0,141627
143213600300000,SW 404,RESIDENTIAL,17000,0,17000,72791,0,89791
143213600400000,SW 404,RESIDENTIAL,17000,0,17000,58434,0,75434
143213600500000,SW 404,RESIDENTIAL,17000,0,17000,61288,0,78288
143213600600000,SW 404,RESIDENTIAL,17212,0,17212,79063,0,96275
143213600700000,SW 404,RESIDENTIAL,19125,0,19125,95839,0,114964
143213600800000,SW 404,RESIDENTIAL,17000,0,17000,60189,0,77189
143213600900000,SW 404,RESIDENTIAL,17000,0,17000,57690,0,74690
143213601000000,SW 404,RESIDENTIAL,17000,0,17000,63172,0,80172
143213601100000,SW 404,RESIDENTIAL,17000,0,17000,57532,0,74532
143213601200000,SW 404,RESIDENTIAL,17000,0,17000,65931,0,82931
143213601300000,SW 404,RESIDENTIAL,17000,0,17000,58136,0,75136
143213601400000,SW 404,RESIDENTIAL,17000,0,17000,65707,0,82707
143213601500000,SW 404,RESIDENTIAL,17000,0,17000,101436,0,118436
143213601600000,SW 404,RESIDENTIAL,17000,0,17000,14394,0,31394
143213601700000,SW 404,RESIDENTIAL,17000,0,17000,53426,0,70426
143213601800000,SW 404,RESIDENTIAL,17000,0,17000,47130,0,64130
143213601900000,SW 404,RESIDENTIAL,17000,0,17000,52048,0,69048
143213602000000,SW 404,RESIDENTIAL,17000,0,17000,47651,0,64651
143213602100000,SW 404,RESIDENTIAL,17000,0,17000,45590,0,62590
143213602200000,SW 404,RESIDENTIAL,20400,0,20400,46288,0,66688
143213602300000,SW 404,RESIDENTIAL,17000,0,17000,86103,0,103103
143213700100000,SW 404,RESIDENTIAL,17000,0,17000,60691,0,77691
143213700200000,SW 404,RESIDENTIAL,17000,0,17000,30673,0,47673
143213700300000,SW 404,RESIDENTIAL,17000,0,17000,78140,0,95140
143213700400000,SW 404,RESIDENTIAL,17000,0,17000,46625,0,63625
143213700500000,SW 404,RESIDENTIAL,17000,0,17000,85456,0,102456
143213700600000,SW 404,RESIDENTIAL,19507,0,19507,50495,0,70002
143213700700000,SW 404,RESIDENTIAL,19507,0,19507,62425,0,81932
143213700800000,SW 404,RESIDENTIAL,17000,0,17000,93804,0,110804
143213700900000,SW 404,RESIDENTIAL,17000,0,17000,38523,0,55523
143213701000000,SW 404,RESIDENTIAL,17000,0,17000,53377,0,70377
143213701100000,SW 404,RESIDENTIAL,17000,0,17000,58381,0,75381
143213701200000,SW 404,RESIDENTIAL,17000,0,17000,49826,0,66826
143215100100000,SW 404,RESIDENTIAL,20400,0,20400,65811,0,86211
143215100200000,SW 404,RESIDENTIAL,20400,0,20400,84410,0,104810
143215100300000,SW 404,RESIDENTIAL,17000,0,17000,18048,0,35048
143215100400000,SW 404,RESIDENTIAL,17000,0,17000,20115,0,37115
143215100500000,SW 404,RESIDENTIAL,17000,0,17000,59223,0,76223
143215100600000,SW 404,RESIDENTIAL,17000,0,17000,56771,0,73771
143215100700000,SW 404,RESIDENTIAL,17000,0,17000,51273,0,68273
143215100800000,SW 404,RESIDENTIAL,17000,0,17000,59713,0,76713
143215100900000,SW 404,RESIDENTIAL,17000,0,17000,56625,0,73625
143215101000000,SW 404,RESIDENTIAL,17000,0,17000,64674,0,81674
143215101100000,SW 404,RESIDENTIAL,17000,0,17000,57414,0,74414
143215101200000,SW 404,RESIDENTIAL,17000,0,17000,53336,0,70336
143215101300000,SW 404,RESIDENTIAL,17000,0,17000,55311,0,72311
143215101400000,SW 404,RESIDENTIAL,17000,0,17000,49435,0,66435
143215101500000,SW 404,RESIDENTIAL,17000,0,17000,62673,0,79673
143215101600000,SW 404,RESIDENTIAL,20400,0,20400,72327,0,92727
143215101700000,SW 404,RESIDENTIAL,20400,0,20400,51444,0,71844
143215200100000,SW 404,RESIDENTIAL,17000,0,17000,33198,0,50198
143215200200000,SW 404,RESIDENTIAL,17000,0,17000,62849,0,79849
143215200300000,SW 404,RESIDENTIAL,17000,0,17000,66074,0,83074
143215200400000,SW 404,RESIDENTIAL,17000,0,17000,58725,0,75725
143215200500000,SW 404,RESIDENTIAL,17000,0,17000,44631,0,61631
143215200600000,SW 404,RESIDENTIAL,20400,0,20400,71285,0,91685
143215200700000,SW 404,RESIDENTIAL,17000,0,17000,44932,0,61932
143215200800000,SW 404,RESIDENTIAL,17000,0,17000,84918,0,101918
143215200900000,SW 404,RESIDENTIAL,17000,0,17000,50555,0,67555
143215201000000,SW 404,RESIDENTIAL,17000,0,17000,60417,0,77417
143215201100000,SW 404,RESIDENTIAL,17000,0,17000,59345,0,76345
143215201200000,SW 404,RESIDENTIAL,17000,0,17000,41116,0,58116
143215201300000,SW 404,RESIDENTIAL,17000,0,17000,77641,0,94641
143215201400000,SW 404,RESIDENTIAL,17000,0,17000,69052,0,86052
143215201500000,SW 404,RESIDENTIAL,17000,0,17000,73777,0,90777
143215201600000,SW 404,RESIDENTIAL,17000,0,17000,107991,0,124991
143215201700000,SW 404,RESIDENTIAL,17000,0,17000,118660,0,135660
143215201800000,SW 404,RESIDENTIAL,20400,0,20400,83343,0,103743
143215201900000,SW 404,RESIDENTIAL,17000,0,17000,77025,0,94025
143215202000000,SW 404,RESIDENTIAL,17000,0,17000,43004,0,60004
143215202100000,SW 404,RESIDENTIAL,17000,0,17000,29923,0,46923
143215202200000,SW 404,RESIDENTIAL,17000,0,17000,67458,0,84458
143215202300000,SW 404,RESIDENTIAL,20400,0,20400,17928,0,38328
143215300100000,SW 404,RESIDENTIAL,17000,0,17000,76110,0,93110
143215300200000,SW 404,RESIDENTIAL,17000,0,17000,52570,0,69570
143215300300000,SW 404,RESIDENTIAL,17000,0,17000,39804,0,56804
143215300400000,SW 404,RESIDENTIAL,17000,0,17000,46488,0,63488
143215300500000,SW 404,RESIDENTIAL,17000,0,17000,44174,0,61174
143215300600000,SW 404,RESIDENTIAL,19507,0,19507,71466,0,90973
143215300700000,SW 404,RESIDENTIAL,15776,0,15776,52962,0,68738
143215300800000,SW 404,RESIDENTIAL,17000,0,17000,40947,0,57947
143215300900000,SW 404,RESIDENTIAL,17000,0,17000,52677,0,69677
143215301000000,SW 404,RESIDENTIAL,17000,0,17000,47388,0,64388
143215301100000,SW 404,RESIDENTIAL,17000,0,17000,59245,0,76245
143215400100000,SW 404,RESIDENTIAL,20400,0,20400,58558,0,78958
143215400200000,SW 404,RESIDENTIAL,17000,0,17000,38026,0,55026
143215400300000,SW 404,RESIDENTIAL,20400,0,20400,61462,0,81862
143215400400000,SW 404,RESIDENTIAL,20400,0,20400,64448,0,84848
143215400500000,SW 404,RESIDENTIAL,17000,0,17000,51425,0,68425
143215400600000,SW 404,RESIDENTIAL,20400,0,20400,114226,0,134626
143215400700000,SW 404,RESIDENTIAL,20400,0,20400,104004,0,124404
143215400800000,SW 404,RESIDENTIAL,17000,0,17000,45418,0,62418
143215400900000,SW 404,RESIDENTIAL,17000,0,17000,102423,0,119423
143215401000000,SW 404,RESIDENTIAL,17000,0,17000,39395,0,56395
143215401100000,SW 404,RESIDENTIAL,20400,0,20400,85088,0,105488
143215401200000,SW 404,RESIDENTIAL,17000,0,17000,75665,0,92665
143215401300000,SW 404,RESIDENTIAL,17000,0,17000,67491,0,84491
143215401400000,SW 404,RESIDENTIAL,20400,0,20400,62728,0,83128
143215500100000,SW 404,RESIDENTIAL,17000,0,17000,81046,0,98046
143215500200000,SW 404,RESIDENTIAL,20400,0,20400,0,0,20400
143215500300000,SW 404,RESIDENTIAL,20400,0,20400,85682,0,106082
143215500400000,SW 404,RESIDENTIAL,17000,0,17000,48714,0,65714
143215500500000,SW 404,RESIDENTIAL,17000,0,17000,86507,0,103507
143215500600000,SW 404,RESIDENTIAL,17000,0,17000,76885,0,93885
143215500700000,SW 404,RESIDENTIAL,17000,0,17000,51196,0,68196
143215500800000,SW 404,RESIDENTIAL,17000,0,17000,48282,0,65282
143215500900000,SW 404,RESIDENTIAL,17000,0,17000,52759,0,69759
143215501000000,SW 404,RESIDENTIAL,20400,0,20400,58888,0,79288
143215501100000,SW 404,RESIDENTIAL,25500,0,25500,85539,0,111039
143215501200000,SW 404,RESIDENTIAL,10200,0,10200,0,0,10200
143215501300000,SW 404,RESIDENTIAL,10200,0,10200,48245,0,58445
143215501400000,SW 404,RESIDENTIAL,20400,0,20400,48318,0,68718
143215501500000,SW 404,RESIDENTIAL,17000,0,17000,67781,0,84781
143215501600000,SW 404,RESIDENTIAL,20400,0,20400,44726,0,65126
143215501700000,SW 404,RESIDENTIAL,17000,0,17000,74578,0,91578
143215501800000,SW 404,RESIDENTIAL,17000,0,17000,54919,0,71919
143215501900000,SW 404,RESIDENTIAL,17000,0,17000,73793,0,90793
143215600100000,SW 404,RESIDENTIAL,17000,0,17000,38389,0,55389
143215600200000,SW 404,RESIDENTIAL,17000,0,17000,32728,0,49728
143215600300000,SW 404,RESIDENTIAL,20400,0,20400,36370,0,56770
143215600400000,SW 404,RESIDENTIAL,17000,0,17000,43039,0,60039
143215600500000,SW 404,RESIDENTIAL,18966,0,18966,77988,0,96954
143215600600000,SW 404,RESIDENTIAL,19623,0,19623,108108,0,127731
143215600700000,SW 404,RESIDENTIAL,20400,0,20400,20225,0,40625
143215600800000,SW 404,RESIDENTIAL,17000,0,17000,45733,0,62733
143215600900000,SW 404,RESIDENTIAL,17000,0,17000,51457,0,68457
143215601000000,SW 404,RESIDENTIAL,17000,0,17000,52851,0,69851
143215700100000,SW 404,RESIDENTIAL,20400,0,20400,49444,0,69844
143215700200000,SW 404,RESIDENTIAL,17000,0,17000,83655,0,100655
143215700300000,SW 404,RESIDENTIAL,17000,0,17000,51819,0,68819
143215700400000,SW 404,RESIDENTIAL,17000,0,17000,51449,0,68449
143215700500000,SW 404,RESIDENTIAL,17000,0,17000,31483,0,48483
143215700600000,SW 404,RESIDENTIAL,17000,0,17000,42845,0,59845
143215700700000,SW 404,RESIDENTIAL,16957,0,16957,63888,0,80845
143215700800000,SW 404,RESIDENTIAL,16957,0,16957,67052,0,84009
143215700900000,SW 404,RESIDENTIAL,15000,0,15000,46311,0,61311
143215701000000,SW 404,RESIDENTIAL,22500,0,22500,62015,0,84515
143215701100000,SW 404,RESIDENTIAL,15000,0,15000,52348,0,67348
143215701200000,SW 404,RESIDENTIAL,15000,0,15000,99976,0,114976
143215701300000,SW 404,RESIDENTIAL,15000,0,15000,63802,0,78802
143215701400000,SW 404,RESIDENTIAL,15000,0,15000,89579,0,104579
143215701500000,SW 404,RESIDENTIAL,15000,0,15000,77683,0,92683
143215800100000,SW 404,RESIDENTIAL,17000,0,17000,60196,0,77196
143215800200000,SW 404,RESIDENTIAL,20400,0,20400,64448,0,84848
143215800300000,SW 404,RESIDENTIAL,19337,0,19337,76059,0,95396
143215800400000,SW 404,RESIDENTIAL,19337,0,19337,113590,0,132927
143215800500000,SW 404,RESIDENTIAL,17000,0,17000,84143,0,101143
143215800600000,SW 404,RESIDENTIAL,17000,0,17000,79625,0,96625
143215800700000,SW 404,RESIDENTIAL,17000,0,17000,91555,0,108555
143215800800000,SW 404,RESIDENTIAL,17000,0,17000,34390,0,51390
143215800900000,SW 404,RESIDENTIAL,17000,0,17000,44508,0,61508
143215801000000,SW 404,RESIDENTIAL,17000,0,17000,39924,0,56924
143215801100000,SW 404,RESIDENTIAL,17000,0,17000,64957,0,81957
143215801200000,SW 404,RESIDENTIAL,15000,0,15000,59967,0,74967
143215801300000,SW 404,RESIDENTIAL,15000,0,15000,47887,0,62887
143215801400000,SW 404,RESIDENTIAL,18000,0,18000,55873,0,73873
143215801600000,SW 404,RESIDENTIAL,18000,0,18000,92360,0,110360
143215801700000,SW 404,RESIDENTIAL,15000,0,15000,69889,0,84889
143215801800000,SW 404,RESIDENTIAL,15000,0,15000,37671,0,52671
143215802100000,SW 404,RESIDENTIAL,15000,0,15000,60779,0,75779
143215802200000,SW 404,RESIDENTIAL,15000,0,15000,71115,0,86115
143215802300000,SW 404,RESIDENTIAL,15000,0,15000,49026,0,64026
143215802400000,SW 404,RESIDENTIAL,18000,0,18000,71679,0,89679
143215900100000,SW 404,RESIDENTIAL,20400,0,20400,74855,0,95255
143215900200000,SW 404,RESIDENTIAL,17000,0,17000,51754,0,68754
143215900300000,SW 404,RESIDENTIAL,20400,0,20400,49739,0,70139
143215900400000,SW 404,RESIDENTIAL,19507,0,19507,82094,0,101601
143215900500000,SW 404,RESIDENTIAL,16807,0,16807,79875,0,96682
143215900600000,SW 404,RESIDENTIAL,15000,0,15000,55171,0,70171
143215900700000,SW 404,RESIDENTIAL,18000,0,18000,89209,0,107209
143215900800000,SW 404,RESIDENTIAL,18000,0,18000,107955,0,125955
143216000100000,SW 404,RESIDENTIAL,18816,0,18816,3680,0,22496
143216000200000,SW 404,RESIDENTIAL,17640,0,17640,56255,0,73895
143216000300000,SW 404,RESIDENTIAL,14700,0,14700,65512,0,80212
143216000400000,SW 404,RESIDENTIAL,14700,0,14700,29739,0,44439
143216000500000,SW 404,RESIDENTIAL,17640,0,17640,62914,0,80554
143216000600000,SW 404,RESIDENTIAL,14700,0,14700,100230,0,114930
143216000700000,SW 404,RESIDENTIAL,17640,0,17640,46127,0,63767
143216100100000,SW 404,RESIDENTIAL,14700,0,14700,44164,0,58864
143216100200000,SW 404,RESIDENTIAL,14700,0,14700,77145,0,91845
143216100300000,SW 404,RESIDENTIAL,17640,0,17640,86523,0,104163
143216100500000,SW 404,RESIDENTIAL,17640,0,17640,97342,0,114982
143216100600000,SW 404,RESIDENTIAL,18816,0,18816,62422,0,81238
143216100700000,SW 404,RESIDENTIAL,15680,0,15680,73580,0,89260
143216100800000,SW 404,RESIDENTIAL,14700,0,14700,29520,0,44220
143216100900000,SW 404,RESIDENTIAL,14700,0,14700,40414,0,55114
143216101000000,SW 404,RESIDENTIAL,18816,0,18816,65657,0,84473
143216200100000,SW 404,RESIDENTIAL,17685,0,17685,41477,0,59162
143216200200000,SW 404,RESIDENTIAL,15680,0,15680,50958,0,66638
143216200300000,SW 404,RESIDENTIAL,14700,0,14700,68570,0,83270
143216200400000,SW 404,RESIDENTIAL,18816,0,18816,75751,0,94567
143216200500000,SW 404,RESIDENTIAL,17346,0,17346,113625,0,130971
143217600100000,OFFICE,COMMERCIAL,0,100800,100800,0,149958,250758
143217600200000,SW 404,RESIDENTIAL,17000,0,17000,60808,0,77808
143217600300000,SW 404,RESIDENTIAL,17000,0,17000,83151,0,100151
143217600400000,SW 404,RESIDENTIAL,17000,0,17000,58780,0,75780
143217600500000,SW 404,RESIDENTIAL,17000,0,17000,63022,0,80022
143217600600000,SW 404,RESIDENTIAL,17000,0,17000,99572,0,116572
143217600700000,SW 404,RESIDENTIAL,20400,0,20400,94121,0,114521
143217600800000,SW 404,RESIDENTIAL,17000,0,17000,97400,0,114400
143217600900000,SW 404,RESIDENTIAL,17000,0,17000,48439,0,65439
143217601000000,SW 404,RESIDENTIAL,17000,0,17000,63380,0,80380
143217601100000,SW 404,RESIDENTIAL,12920,0,12920,76195,0,89115
143217601200000,SW 404,RESIDENTIAL,11475,0,11475,45515,0,56990
143217601300000,SW 404,RESIDENTIAL,14110,0,14110,64832,0,78942
143217601400000,SW 404,RESIDENTIAL,16150,0,16150,49640,0,65790
143217601500000,SW 404,RESIDENTIAL,14110,0,14110,55872,0,69982
143217601600000,SW 404,RESIDENTIAL,17000,0,17000,57286,0,74286
143217601700000,SW 404,RESIDENTIAL,17000,0,17000,128549,0,145549
143217601800000,SW 404,RESIDENTIAL,17000,0,17000,47109,0,64109
143217601900000,SW 404,RESIDENTIAL,17000,0,17000,65551,0,82551
143217602000000,SW 404,RESIDENTIAL,17000,0,17000,17231,0,34231
143217602100000,SW 404,RESIDENTIAL,20400,0,20400,59471,0,79871
143217602200000,SW 404,RESIDENTIAL,17000,0,17000,66843,0,83843
143217602300000,SW 404,RESIDENTIAL,17000,0,17000,41219,0,58219
143217602400000,SW 404,RESIDENTIAL,17000,0,17000,57540,0,74540
143217602500000,AUTO REPAIR/SALES,COMMERCIAL,0,100800,100800,0,102863,203663
143217700100000,SW 404,RESIDENTIAL,17765,0,17765,73547,0,91312
143217700200000,SW 404,RESIDENTIAL,17000,0,17000,55378,0,72378
143217700300000,SW 404,RESIDENTIAL,17000,0,17000,52982,0,69982
143217700400000,SW 404,RESIDENTIAL,17000,0,17000,58850,0,75850
143217700500000,SW 404,RESIDENTIAL,17000,0,17000,72037,0,89037
143217700600000,SW 404,RESIDENTIAL,17000,0,17000,45344,0,62344
143217700700000,SW 404,RESIDENTIAL,17000,0,17000,63647,0,80647
143217700800000,SW 404,RESIDENTIAL,17765,0,17765,99061,0,116826
143217700900000,SW 404,RESIDENTIAL,17627,0,17627,68626,0,86253
143217701000000,SW 404,RESIDENTIAL,17627,0,17627,101702,0,119329
143217701100000,SW 404,RESIDENTIAL,17000,0,17000,31073,0,48073
143217701200000,SW 404,RESIDENTIAL,17000,0,17000,63803,0,80803
143217701300000,SW 404,RESIDENTIAL,17000,0,17000,53457,0,70457
143217701400000,SW 404,RESIDENTIAL,20400,0,20400,102115,0,122515
143217701500000,SW 404,RESIDENTIAL,17765,0,17765,74277,0,92042
143217800100000,SW 404,RESIDENTIAL,21037,0,21037,68075,0,89112
143217800200000,SW 404,RESIDENTIAL,17000,0,17000,76297,0,93297
143217800300000,SW 404,RESIDENTIAL,17000,0,17000,77244,0,94244
143217800400000,SW 404,RESIDENTIAL,17000,0,17000,83347,0,100347
143217800500000,SW 404,RESIDENTIAL,17000,0,17000,75763,0,92763
143217800600000,SW 404,RESIDENTIAL,19125,0,19125,46683,0,65808
143217900100000,BRANCH BANK/CU,COMMERCIAL,0,134400,134400,0,212015,346415
143217900200000,FLAT PARKING,COMMERCIAL,0,33600,33600,0,1869,35469
143217900300000,SW 404,RESIDENTIAL,25500,0,25500,60650,0,86150
143217900400000,SW 404,RESIDENTIAL,20400,0,20400,68339,0,88739
143217900500000,SW 404,RESIDENTIAL,17000,0,17000,87676,0,104676
143217900600000,SW 404,RESIDENTIAL,17000,0,17000,80343,0,97343
143217900700000,SW 404,RESIDENTIAL,17000,0,17000,90427,0,107427
143217900800000,SW 404,RESIDENTIAL,17000,0,17000,87258,0,104258
143217900900000,SW 404,RESIDENTIAL,17000,0,17000,77729,0,94729
143217901000000,SW 404,RESIDENTIAL,20400,0,20400,72835,0,93235
143217901100000,SW 404,RESIDENTIAL,17000,0,17000,68693,0,85693
143217901200000,SW 404,RESIDENTIAL,17000,0,17000,73145,0,90145
143217901300000,SW 404,RESIDENTIAL,17000,0,17000,72687,0,89687
143217901400000,SW 404,RESIDENTIAL,17000,0,17000,74205,0,91205
143217901500000,SW 404,RESIDENTIAL,17000,0,17000,61362,0,78362
143217901600000,SW 404,RESIDENTIAL,17000,0,17000,51928,0,68928
143217901700000,SW 404,RESIDENTIAL,17000,0,17000,58659,0,75659
143217901800000,SW 404,RESIDENTIAL,17000,0,17000,53054,0,70054
143217901900000,SW 404,RESIDENTIAL,17000,0,17000,74978,0,91978
143217902000000,SW 404,RESIDENTIAL,17000,0,17000,37703,0,54703
143217902100000,SW 404,RESIDENTIAL,17000,0,17000,64687,0,81687
143217902200000,SW 404,RESIDENTIAL,34000,0,34000,68496,0,102496
143217902300000,SMALL RETAIL,COMMERCIAL,0,67200,67200,0,78338,145538
143218000100000,SW 404,RESIDENTIAL,13651,0,13651,69902,0,83553
143218000200000,SW 404,RESIDENTIAL,17000,0,17000,62895,0,79895
143218000300000,SW 404,RESIDENTIAL,17000,0,17000,49701,0,66701
143218000400000,SW 404,RESIDENTIAL,17000,0,17000,86668,0,103668
143218000500000,SW 404,RESIDENTIAL,17000,0,17000,65491,0,82491
143218000600000,SW 404,RESIDENTIAL,17000,0,17000,48957,0,65957
143218000700000,SW 404,RESIDENTIAL,17000,0,17000,107947,0,124947
143218000800000,SW 404,RESIDENTIAL,17765,0,17765,111613,0,129378
143218000900000,SW 404,RESIDENTIAL,17765,0,17765,59991,0,77756
143218001000000,SW 404,RESIDENTIAL,17000,0,17000,56136,0,73136
143218001100000,SW 404,RESIDENTIAL,17000,0,17000,43905,0,60905
143218001200000,SW 404,RESIDENTIAL,17000,0,17000,74591,0,91591
143218001300000,SW 404,RESIDENTIAL,20400,0,20400,72087,0,92487
143218001400000,SW 404,RESIDENTIAL,21420,0,21420,94739,0,116159
143218001500000,SW 404,RESIDENTIAL,13260,0,13260,40869,0,54129
143218100100000,SW 404,RESIDENTIAL,19125,0,19125,80532,0,99657
143218100300000,SW 404,RESIDENTIAL,17000,0,17000,90985,0,107985
143218100400000,SW 404,RESIDENTIAL,21037,0,21037,55622,0,76659
143218100500000,SW 404,RESIDENTIAL,17000,0,17000,81094,0,98094
143218100600000,SW 404,RESIDENTIAL,17000,0,17000,83134,0,100134
143218100700000,SW 404,RESIDENTIAL,20400,0,20400,107591,0,127991
143218200100000,FAST FOOD,COMMERCIAL,0,28000,28000,0,168063,196063
143218200200000,SW 404,RESIDENTIAL,17000,0,17000,40478,0,57478
143218200300000,SW 404,RESIDENTIAL,17000,0,17000,52882,0,69882
143218200400000,SW 404,RESIDENTIAL,17000,0,17000,50502,0,67502
143218200500000,SW 404,RESIDENTIAL,17000,0,17000,33505,0,50505
143218200600000,SW 404,RESIDENTIAL,17000,0,17000,51141,0,68141
143218200700000,SW 404,RESIDENTIAL,17000,0,17000,63873,0,80873
143218200800000,SW 404,RESIDENTIAL,17000,0,17000,43293,0,60293
143218200900000,SW 404,RESIDENTIAL,17000,0,17000,45934,0,62934
143218201000000,SW 404,RESIDENTIAL,17000,0,17000,75897,0,92897
143218201100000,SW 404,RESIDENTIAL,17000,0,17000,48484,0,65484
143218201200000,SW 404,RESIDENTIAL,17000,0,17000,29422,0,46422
143218201300000,SW 404,RESIDENTIAL,17000,0,17000,56023,0,73023
143218201400000,SW 404,RESIDENTIAL,17000,0,17000,64987,0,81987
143218201500000,SW 404,RESIDENTIAL,17000,0,17000,41796,0,58796
143218201600000,SW 404,RESIDENTIAL,16279,0,16279,40693,0,56972
143218201700000,SW 404,RESIDENTIAL,17410,0,17410,73350,0,90760
143218201800000,SW 404,RESIDENTIAL,17000,0,17000,73006,0,90006
143218201900000,SW 404,RESIDENTIAL,17000,0,17000,58474,0,75474
143218202000000,SW 404,RESIDENTIAL,17000,0,17000,42542,0,59542
143218202100000,SW 404,RESIDENTIAL,17000,0,17000,77886,0,94886
143218202200000,SW 404,RESIDENTIAL,17000,0,17000,78724,0,95724
143218202300000,SW 404,RESIDENTIAL,17000,0,17000,66593,0,83593
143218202400000,SW 404,RESIDENTIAL,17000,0,17000,62507,0,79507
143218202500000,SW 404,RESIDENTIAL,17000,0,17000,52452,0,69452
143218202600000,SW 404,RESIDENTIAL,17000,0,17000,51141,0,68141
143218202700000,SW 404,RESIDENTIAL,17000,0,17000,40368,0,57368
143218202800000,SW 404,RESIDENTIAL,17000,0,17000,103163,0,120163
143218202900000,SERVICE STATION,COMMERCIAL,0,67200,67200,0,72658,139858
143218300100000,SW 404,RESIDENTIAL,17765,0,17765,44043,0,61808
143218300200000,SW 404,RESIDENTIAL,17000,0,17000,70599,0,87599
143218300300000,SW 404,RESIDENTIAL,17000,0,17000,45864,0,62864
143218300400000,SW 404,RESIDENTIAL,17000,0,17000,63474,0,80474
143218300500000,SW 404,RESIDENTIAL,17000,0,17000,41478,0,58478
143218300600000,SW 404,RESIDENTIAL,17000,0,17000,64772,0,81772
143218300700000,SW 404,RESIDENTIAL,17000,0,17000,49843,0,66843
143218300800000,SW 404,RESIDENTIAL,13090,0,13090,72539,0,85629
143218300900000,SW 404,RESIDENTIAL,14280,0,14280,57767,0,72047
143218301000000,SW 404,RESIDENTIAL,20400,0,20400,67534,0,87934
143218301100000,SW 404,RESIDENTIAL,20400,0,20400,73452,0,93852
143218301200000,SW 404,RESIDENTIAL,17000,0,17000,84344,0,101344
143218301300000,SW 404,RESIDENTIAL,20400,0,20400,68454,0,88854
143218301400000,SW 404,RESIDENTIAL,17000,0,17000,71181,0,88181
143218301500000,SW 404,RESIDENTIAL,17765,0,17765,62910,0,80675
143218400100000,SW 404,RESIDENTIAL,19125,0,19125,48273,0,67398
143218400200000,SW 404,RESIDENTIAL,17000,0,17000,49633,0,66633
143218400300000,SW 404,RESIDENTIAL,15000,0,15000,47940,0,62940
143218400400000,SW 404,RESIDENTIAL,19125,0,19125,56158,0,75283
143218400500000,SW 404,RESIDENTIAL,17000,0,17000,50633,0,67633
143218400600000,SW 404,RESIDENTIAL,17000,0,17000,57517,0,74517
143218400700000,SW 404,RESIDENTIAL,20400,0,20400,89395,0,109795
143218400800000,SW 404,RESIDENTIAL,17000,0,17000,61129,0,78129
143218500100000,CENTRALLY ASSESSED,OTHER,0,0,0,0,0,0
143218500200000,CITY PROPERTY,EXEMPT,0,0,0,0,0,0
143218500300000,SW 404,RESIDENTIAL,15680,0,15680,55544,0,71224
143218500400000,SW 404,RESIDENTIAL,18346,0,18346,47155,0,65501
143218500500000,SW 404,RESIDENTIAL,16934,0,16934,101719,0,118653
143218500600000,SW 404,RESIDENTIAL,16660,0,16660,85852,0,102512
143218500700000,SW 404,RESIDENTIAL,15680,0,15680,55819,0,71499
143218500800000,SW 404,RESIDENTIAL,16660,0,16660,30900,0,47560
143218500900000,SW 404,RESIDENTIAL,15680,0,15680,49953,0,65633
143218501000000,SW 404,RESIDENTIAL,15680,0,15680,68079,0,83759
143218501100000,SW 404,RESIDENTIAL,15520,0,15520,67074,0,82594
143218501200000,SW 404,RESIDENTIAL,15520,0,15520,49230,0,64750
143218501300000,SW 404,RESIDENTIAL,16538,0,16538,62526,0,79064
143218501400000,SW 404,RESIDENTIAL,15565,0,15565,111571,0,127136
143218600100000,OFFICE,COMMERCIAL,0,83232,83232,0,174578,257810
143218600200000,SW 404,RESIDENTIAL,15520,0,15520,82917,0,98437
143218600300000,SW 404,RESIDENTIAL,15520,0,15520,21211,0,36731
143218600400000,SW 404,RESIDENTIAL,19555,0,19555,39605,0,59160
143218700100000,SW 404,RESIDENTIAL,21216,0,21216,60110,0,81326
143218700200000,SW 404,RESIDENTIAL,16848,0,16848,87070,0,103918
143220100100000,SW 404,RESIDENTIAL,19954,0,19954,56180,0,76134
143220200100000,VACANT LAND,COMMERCIAL,0,720,720,0,0,720
143220200200000,VACANT LAND,COMMERCIAL,0,28845,28845,0,0,28845
143220300200000,SHOP,COMMERCIAL,0,112500,112500,0,267778,380278
143220300300000,WAREHOUSE;MINI STORG,COMMERCIAL,0,468000,468000,0,779027,1247027
143220300400000,STATE PROPERTY,EXEMPT,0,0,0,0,0,0
143220400100000,SW 404,RESIDENTIAL,17000,0,17000,55247,0,72247
143220400200000,SW 404,RESIDENTIAL,17000,0,17000,50397,0,67397
143220400300000,SW 404,RESIDENTIAL,20400,0,20400,59911,0,80311
143220400400000,SW 404,RESIDENTIAL,17000,0,17000,60660,0,77660
143220400500000,SW 404,RESIDENTIAL,17000,0,17000,33250,0,50250
143220400600000,SW 404,RESIDENTIAL,17000,0,17000,78941,0,95941
143220400700000,SW 404,RESIDENTIAL,17000,0,17000,54377,0,71377
143220400800000,SW 404,RESIDENTIAL,13600,0,13600,75931,0,89531
143220400900000,SW 404,RESIDENTIAL,10200,0,10200,0,0,10200
143220401000000,SW 404,RESIDENTIAL,17000,0,17000,42107,0,59107
143220401100000,SW 404,RESIDENTIAL,17000,0,17000,52637,0,69637
143220401200000,SW 404,RESIDENTIAL,17000,0,17000,81627,0,98627
143220401300000,SW 404,RESIDENTIAL,17000,0,17000,88531,0,105531
143220401400000,SW 404,RESIDENTIAL,17000,0,17000,59484,0,76484
143220401500000,SW 404,RESIDENTIAL,17000,0,17000,79372,0,96372
143220401600000,SW 404,RESIDENTIAL,17000,0,17000,61490,0,78490
143220401700000,SW 404,RESIDENTIAL,17000,0,17000,38927,0,55927
143220401800000,SW 404,RESIDENTIAL,17000,0,17000,57635,0,74635
143220401900000,SW 404,RESIDENTIAL,17000,0,17000,64346,0,81346
143220402000000,SW 404,RESIDENTIAL,20400,0,20400,54663,0,75063
143220402100000,SW 404,RESIDENTIAL,20400,0,20400,44024,0,64424
143220500100000,STATE PROPERTY,EXEMPT,0,0,0,0,0,0
143220500200000,SW 404,RESIDENTIAL,26845,0,26845,76680,0,103525
143220500202000,BILLBOARD(BLL),COMMERCIAL,0,0,0,0,31657,31657
143220500300000,SW 404,RESIDENTIAL,19623,0,19623,47280,0,66903
143220500400000,SW 404,RESIDENTIAL,20373,0,20373,60055,0,80428
143220500500000,SW 404,RESIDENTIAL,17000,0,17000,79154,0,96154
143220500800000,SW 404,RESIDENTIAL,20400,0,20400,40208,0,60608
143220500900000,SW 404,RESIDENTIAL,17000,0,17000,66568,0,83568
143220501000000,SW 404,RESIDENTIAL,13728,0,13728,47016,0,60744
143220501100000,SW 404,RESIDENTIAL,14131,0,14131,43606,0,57737
143220501200000,SW 404,RESIDENTIAL,13728,0,13728,46498,0,60226
143220501300000,SW 404,RESIDENTIAL,19507,0,19507,75527,0,95034
143220501400000,SW 404,RESIDENTIAL,22525,0,22525,86198,0,108723
143220600100000,SW 404,RESIDENTIAL,20400,0,20400,52173,0,72573
143220600200000,SW 404,RESIDENTIAL,17000,0,17000,62904,0,79904
143220600300000,SW 404,RESIDENTIAL,20400,0,20400,21468,0,41868
143220600400000,SW 404,RESIDENTIAL,20400,0,20400,81465,0,101865
143220600500000,SW 404,RESIDENTIAL,17000,0,17000,56751,0,73751
143220600600000,SW 404,RESIDENTIAL,20400,0,20400,40305,0,60705
143220600700000,SW 404,RESIDENTIAL,17000,0,17000,82911,0,99911
143220600800000,SW 404,RESIDENTIAL,17000,0,17000,44145,0,61145
143220600900000,SW 404,RESIDENTIAL,20400,0,20400,86735,0,107135
143220601000000,SW 404,RESIDENTIAL,17000,0,17000,57740,0,74740
143220601100000,SW 404,RESIDENTIAL,17000,0,17000,99524,0,116524
143220601200000,SW 404,RESIDENTIAL,20400,0,20400,58840,0,79240
143220601300000,SW 404,RESIDENTIAL,17000,0,17000,61085,0,78085
143220601400000,SW 404,RESIDENTIAL,17000,0,17000,75175,0,92175
143220601500000,SW 404,RESIDENTIAL,17000,0,17000,109747,0,126747
143220601600000,SW 404,RESIDENTIAL,17000,0,17000,59073,0,76073
143220601700000,SW 404,RESIDENTIAL,17000,0,17000,49381,0,66381
143220601800000,SW 404,RESIDENTIAL,17000,0,17000,100200,0,117200
143220700100000,SW 404,RESIDENTIAL,17000,0,17000,65384,0,82384
143220700200000,SW 404,RESIDENTIAL,17000,0,17000,53200,0,70200
143220700300000,SW 404,RESIDENTIAL,17000,0,17000,42229,0,59229
143220700400000,SW 404,RESIDENTIAL,20400,0,20400,90295,0,110695
143220700500000,SW 404,RESIDENTIAL,17000,0,17000,81973,0,98973
143220700600000,SW 404,RESIDENTIAL,17000,0,17000,58948,0,75948
143220700700000,SW 404,RESIDENTIAL,20400,0,20400,11823,0,32223
143220700800000,SW 404,RESIDENTIAL,17000,0,17000,50592,0,67592
143220700900000,SW 404,RESIDENTIAL,20400,0,20400,56727,0,77127
143220701000000,SW 404,RESIDENTIAL,17000,0,17000,58913,0,75913
143220701100000,SW 404,RESIDENTIAL,22206,0,22206,94824,0,117030
143220701200000,SW 404,RESIDENTIAL,24834,0,24834,86867,0,111701
143220701300000,SW 404,RESIDENTIAL,17000,0,17000,0,0,17000
143220701400000,SW 404,RESIDENTIAL,25500,0,25500,90158,0,115658
143220701500000,SW 404,RESIDENTIAL,20400,0,20400,47405,0,67805
143220701600000,SW 404,RESIDENTIAL,20400,0,20400,62457,0,82857
143220701700000,SW 404,RESIDENTIAL,17000,0,17000,65477,0,82477
143220701800000,SW 404,RESIDENTIAL,17000,0,17000,55712,0,72712
143220701900000,SW 404,RESIDENTIAL,19869,0,19869,67382,0,87251
143220702000000,SW 404,RESIDENTIAL,20719,0,20719,66052,0,86771
143220702100000,SW 404,RESIDENTIAL,17000,0,17000,65496,0,82496
143220702200000,SW 404,RESIDENTIAL,20400,0,20400,66130,0,86530
143220800100000,FLAT PARKING,COMMERCIAL,0,5226,5226,0,3654,8880
143220800200000,VACANT LAND,COMMERCIAL,0,16250,16250,0,0,16250
143222600100000,SW 405,RESIDENTIAL,18400,0,18400,76387,0,94787
143222600200000,SW 405,RESIDENTIAL,18600,0,18600,79332,0,97932
143222600300000,SW 405,RESIDENTIAL,18800,0,18800,61852,0,80652
143222600400000,SW 405,RESIDENTIAL,19200,0,19200,81171,0,100371
143222600500000,SW 405,RESIDENTIAL,19400,0,19400,58800,0,78200
143222600600000,SW 405,RESIDENTIAL,19400,0,19400,83548,0,102948
143222600700000,SW 405,RESIDENTIAL,19200,0,19200,61332,0,80532
143222600800000,SW 405,RESIDENTIAL,19200,0,19200,64697,0,83897
143222600900000,SW 405,RESIDENTIAL,19000,0,19000,58228,0,77228
143222601000000,SW 405,RESIDENTIAL,18800,0,18800,52453,0,71253
143222601100000,SW 405,RESIDENTIAL,18600,0,18600,62188,0,80788
143222601200000,SW 405,RESIDENTIAL,18400,0,18400,54295,0,72695
143222601300000,SW 405,RESIDENTIAL,18200,0,18200,54394,0,72594
143222601400000,SW 405,RESIDENTIAL,18000,0,18000,75233,0,93233
143222601500000,SW 405,RESIDENTIAL,20664,0,20664,57957,0,78621
143222601600000,SW 405,RESIDENTIAL,20304,0,20304,58407,0,78711
143222601700000,SW 405,RESIDENTIAL,22614,0,22614,86418,0,109032
143222601800000,SW 405,RESIDENTIAL,21709,0,21709,65009,0,86718
143222601900000,SW 405,RESIDENTIAL,19817,0,19817,58181,0,77998
143222602000000,SW 405,RESIDENTIAL,20491,0,20491,63894,0,84385
143222602100000,BARS/LOUNGE,COMMERCIAL,0,61983,61983,0,147555,209538
143222602200000,RESTAURANT,COMMERCIAL,0,127500,127500,0,224003,351503
143222602300000,FLAT PARKING,COMMERCIAL,0,46488,46488,0,10312,56800
143222602400000,AUTO REPAIR/SALES,COMMERCIAL,0,150000,150000,0,196264,346264
143222602500000,CARWASH,COMMERCIAL,0,125874,125874,0,83094,208968
143222602502000,BILLBOARD(BLL),COMMERCIAL,0,0,0,0,58020,58020
143222602600000,FLAT PARKING,COMMERCIAL,0,33300,33300,0,1200,34500
143222602700000,STATE PROPERTY,EXEMPT,0,0,0,0,0,0
143222700100000,SW 405,RESIDENTIAL,19400,0,19400,84504,0,103904
143222700200000,SW 405,RESIDENTIAL,19969,0,19969,69601,0,89570
143222700300000,VACANT LAND,COMMERCIAL,0,41400,41400,0,0,41400
143222700400000,AUTO REPAIR/SALES,COMMERCIAL,0,140300,140300,0,126766,267066
143222800100000,SMALL RETAIL,COMMERCIAL,0,213800,213800,0,429080,642880
143222800200000,VACANT LAND,COMMERCIAL,0,74320,74320,0,0,74320
143222800300000,APARTMENT,COMMERCIAL,0,157025,157025,0,137819,294844
143222800400000,SW 405,AG LAND,12615,0,12615,0,0,12615
143222800500000,SW 405,AG DWELLING,18594,0,18594,30545,2626,51765
143225100100000,WAREHOUSE,COMMERCIAL,0,347840,347840,0,46727,394567
143225100102001,BILLBOARD(BLL),COMMERCIAL,0,0,0,0,16079,16079
143225200300000,SW 405,RESIDENTIAL,38976,0,38976,91450,0,130426
143225200400000,SW 405,RESIDENTIAL,24860,0,24860,77038,0,101898
143225200500000,SW 405,RESIDENTIAL,22600,0,22600,67172,0,89772
143225200600000,SW 405,RESIDENTIAL,24640,0,24640,79489,0,104129
143225200700000,SW 405,RESIDENTIAL,28726,0,28726,58128,0,86854
143225300300000,SW 405,RESIDENTIAL,49199,0,49199,140851,0,190050
143225300400000,SW 405,RESIDENTIAL,32179,0,32179,0,0,32179
143225300500000,SW 405,RESIDENTIAL,35670,0,35670,124118,0,159788
143225300600000,SW 405,RESIDENTIAL,24548,0,24548,100868,0,125416
143225300700000,SW 405,RESIDENTIAL,23660,0,23660,102830,0,126490
143225300800000,SW 405,RESIDENTIAL,23660,0,23660,95152,0,118812
143225300900000,SW 405,RESIDENTIAL,27587,0,27587,61569,0,89156
143225301000000,SW 405,RESIDENTIAL,22400,0,22400,73184,0,95584
143225301100000,SW 405,RESIDENTIAL,22400,0,22400,0,0,22400
143225301200000,SW 405,RESIDENTIAL,22400,0,22400,123028,0,145428
143225301300000,SW 405,RESIDENTIAL,52667,0,52667,98811,0,151478
143225301600000,WAREHOUSE,COMMERCIAL,0,70000,70000,0,89005,159005
143225301700000,SW 405,RESIDENTIAL,48358,0,48358,67171,0,115529
143225301800000,SW 405,RESIDENTIAL,46129,0,46129,73216,0,119345
143227600100000,SW 404,RESIDENTIAL,17000,0,17000,0,0,17000
143227600200000,SW 404,RESIDENTIAL,17000,0,17000,33368,0,50368
143227600300000,SW 404,RESIDENTIAL,20400,0,20400,97889,0,118289
143227600400000,SW 404,RESIDENTIAL,10200,0,10200,0,0,10200
143227600500000,SW 404,RESIDENTIAL,10200,0,10200,64532,0,74732
143227600600000,SW 404,RESIDENTIAL,17000,0,17000,49801,0,66801
143227600700000,SW 404,RESIDENTIAL,17000,0,17000,66537,0,83537
143227600800000,SW 404,RESIDENTIAL,20400,0,20400,73136,0,93536
143227600900000,SW 404,RESIDENTIAL,18411,0,18411,57874,0,76285
143227601000000,SW 404,RESIDENTIAL,12920,0,12920,58386,0,71306
143227601100000,SW 404,RESIDENTIAL,12920,0,12920,52376,0,65296
143227601200000,SW 404,RESIDENTIAL,17000,0,17000,60635,0,77635
143227601400000,SW 404,RESIDENTIAL,20400,0,20400,85434,0,105834
143227601500000,SW 404,RESIDENTIAL,20400,0,20400,54834,0,75234
143227601600000,SW 404,RESIDENTIAL,17000,0,17000,74204,0,91204
143227601700000,SW 404,RESIDENTIAL,17000,0,17000,49789,0,66789
143227601800000,SW 404,RESIDENTIAL,17000,0,17000,53344,0,70344
143227601900000,CITY PROPERTY,EXEMPT,0,0,0,0,0,0
143227602000000,SW 404,RESIDENTIAL,2125,0,2125,0,0,2125
143227602100000,SW 404,RESIDENTIAL,17000,0,17000,59995,0,76995
143227602200000,SW 404,RESIDENTIAL,17000,0,17000,0,0,17000
143227700100000,SW 404,RESIDENTIAL,20400,0,20400,58196,0,78596
143227700200000,SW 404,RESIDENTIAL,17000,0,17000,69776,0,86776
143227700300000,SW 404,RESIDENTIAL,20400,0,20400,73972,0,94372
143227700400000,SW 404,RESIDENTIAL,17000,0,17000,69371,0,86371
143227700500000,SW 404,RESIDENTIAL,17000,0,17000,88456,0,105456
143227700600000,SW 404,RESIDENTIAL,17000,0,17000,59993,0,76993
143227700700000,SW 404,RESIDENTIAL,17000,0,17000,49434,0,66434
143227700800000,SW 404,RESIDENTIAL,20400,0,20400,105816,0,126216
143227700900000,SW 404,RESIDENTIAL,21250,0,21250,56587,0,77837
143227701000000,SW 404,RESIDENTIAL,21250,0,21250,65702,0,86952
143227701100000,SW 404,RESIDENTIAL,21250,0,21250,17604,0,38854
143227701200000,SW 404,RESIDENTIAL,20952,0,20952,47001,0,67953
143227701300000,SW 404,RESIDENTIAL,20400,0,20400,85966,0,106366
143227701400000,SW 404,RESIDENTIAL,20400,0,20400,78378,0,98778
143227701500000,SW 404,RESIDENTIAL,20400,0,20400,77826,0,98226
143227701600000,SW 404,RESIDENTIAL,17000,0,17000,85380,0,102380
143227701700000,SW 404,RESIDENTIAL,20400,0,20400,89474,0,109874
143227701800000,SW 404,RESIDENTIAL,17000,0,17000,17404,0,34404
143227701900000,SW 404,RESIDENTIAL,8500,0,8500,0,0,8500
143227702000000,SW 404,RESIDENTIAL,17000,0,17000,100953,0,117953
143227702100000,SW 404,RESIDENTIAL,19125,0,19125,110829,0,129954
143227702200000,SW 404,RESIDENTIAL,18169,0,18169,100215,0,118384
143227800100000,SW 404,RESIDENTIAL,17000,0,17000,36789,0,53789
143227800200000,SW 404,RESIDENTIAL,20400,0,20400,36500,0,56900
143227800300000,CITY PROPERTY,EXEMPT,0,0,0,0,0,0
143227800400000,SW 404,RESIDENTIAL,20400,0,20400,76435,0,96835
143227800500000,SW 404,RESIDENTIAL,20400,0,20400,37191,0,57591
143227800600000,SW 404,RESIDENTIAL,20400,0,20400,62448,0,82848
143227800700000,SW 404,RESIDENTIAL,10200,0,10200,1045,0,11245
143227800800000,SW 404,RESIDENTIAL,10200,0,10200,76790,0,86990
143227800900000,SW 404,RESIDENTIAL,20400,0,20400,83947,0,104347
143227801000000,SW 404,RESIDENTIAL,17000,0,17000,81460,0,98460
143227801100000,SW 404,RESIDENTIAL,20400,0,20400,94784,0,115184
143227801200000,CITY PROPERTY,EXEMPT,0,0,0,0,0,0
143227801300000,SW 404,RESIDENTIAL,17000,0,17000,37904,0,54904
143227801400000,SW 404,RESIDENTIAL,20400,0,20400,55576,0,75976
143227801500000,SW 404,RESIDENTIAL,20400,0,20400,0,0,20400
143227801600000,SW 404,RESIDENTIAL,17000,0,17000,82068,0,99068
143227900100000,SW 404,RESIDENTIAL,17000,0,17000,71631,0,88631
143227900200000,SW 404,RESIDENTIAL,17000,0,17000,80451,0,97451
143227900300000,SW 404,RESIDENTIAL,17000,0,17000,31458,0,48458
143227900400000,SW 404,RESIDENTIAL,17000,0,17000,38993,0,55993
143227900500000,SW 404,RESIDENTIAL,17000,0,17000,28478,0,45478
143227900600000,SW 404,RESIDENTIAL,17000,0,17000,60706,0,77706
143227900700000,SW 404,RESIDENTIAL,17000,0,17000,56243,0,73243
143227900800000,SW 404,RESIDENTIAL,17000,0,17000,92080,0,109080
143227900900000,SW 404,RESIDENTIAL,17000,0,17000,74282,0,91282
143227901000000,SW 404,RESIDENTIAL,17000,0,17000,96652,0,113652
143227901100000,SW 404,RESIDENTIAL,23800,0,23800,124903,0,148703
143227901200000,SW 404,RESIDENTIAL,17000,0,17000,64868,0,81868
143227901300000,SW 404,RESIDENTIAL,17000,0,17000,81924,0,98924
143227901400000,SW 404,RESIDENTIAL,17000,0,17000,74982,0,91982
143227901700000,SW 404,RESIDENTIAL,19714,0,19714,49295,0,69009
143227901800000,SW 404,RESIDENTIAL,19386,0,19386,59575,0,78961
143227901900000,SW 404,RESIDENTIAL,20400,0,20400,65016,0,85416
143227902000000,SW 404,RESIDENTIAL,23375,0,23375,119368,0,142743
143227902100000,SW 404,RESIDENTIAL,17000,0,17000,64392,0,81392
143227902200000,SW 404,RESIDENTIAL,17000,0,17000,65083,0,82083
143227902300000,SW 404,RESIDENTIAL,17000,0,17000,70898,0,87898
143227902400000,SW 404,RESIDENTIAL,17000,0,17000,73424,0,90424
143227902500000,SW 404,RESIDENTIAL,17000,0,17000,35045,0,52045
143227902600000,SW 404,RESIDENTIAL,20400,0,20400,43630,0,64030
143227902700000,SW 404,RESIDENTIAL,17000,0,17000,72599,0,89599
143227902800000,SW 404,RESIDENTIAL,22100,0,22100,71583,0,93683
143227902900000,SW 404,RESIDENTIAL,17000,0,17000,76440,0,93440
143227903000000,SW 404,RESIDENTIAL,17000,0,17000,69039,0,86039
143227903100000,SW 404,RESIDENTIAL,17000,0,17000,50561,0,67561
143227903200000,SW 404,RESIDENTIAL,25500,0,25500,84815,0,110315
143228000100000,CITY PROPERTY,EXEMPT,0,0,0,0,0,0
143228000200000,SW 404,RESIDENTIAL,17000,0,17000,62201,0,79201
143228000300000,SW 404,RESIDENTIAL,25500,0,25500,35170,0,60670
143228000400000,SW 404,RESIDENTIAL,17000,0,17000,75764,0,92764
143228000500000,SW 404,RESIDENTIAL,15000,0,15000,76710,0,91710
143228000600000,SW 404,RESIDENTIAL,15000,0,15000,56529,0,71529
143228000700000,SW 404,RESIDENTIAL,15000,0,15000,74347,0,89347
143228000800000,SW 404,RESIDENTIAL,15000,0,15000,29816,0,44816
143228000900000,SW 404,RESIDENTIAL,15000,0,15000,62869,0,77869
143228001000000,SW 404,RESIDENTIAL,15000,0,15000,0,0,15000
143228100100000,SW 404,RESIDENTIAL,17000,0,17000,73248,0,90248
143228100200000,SW 404,RESIDENTIAL,17000,0,17000,83573,0,100573
143228100300000,SW 404,RESIDENTIAL,17000,0,17000,74144,0,91144
143228100400000,SW 404,RESIDENTIAL,22100,0,22100,75302,0,97402
143228100500000,SW 404,RESIDENTIAL,17000,0,17000,90435,0,107435
143228100600000,SW 404,RESIDENTIAL,17000,0,17000,99423,0,116423
143228100700000,SW 404,RESIDENTIAL,17000,0,17000,36969,0,53969
143228100800000,SW 404,RESIDENTIAL,17000,0,17000,43068,0,60068
143228100900000,SW 404,RESIDENTIAL,17000,0,17000,23902,0,40902
143228101000000,SW 404,RESIDENTIAL,17000,0,17000,97754,0,114754
143228101100000,SW 404,RESIDENTIAL,17000,0,17000,58919,0,75919
143228101200000,SW 404,RESIDENTIAL,17000,0,17000,42720,0,59720
143228101300000,SW 404,RESIDENTIAL,20400,0,20400,95345,0,115745
143228101400000,SW 404,RESIDENTIAL,20400,0,20400,92053,0,112453
143228101700000,SW 404,RESIDENTIAL,17600,0,17600,39165,0,56765
143228101800000,SW 404,RESIDENTIAL,19500,0,19500,75020,0,94520
143228101900000,SW 404,RESIDENTIAL,15000,0,15000,69811,0,84811
143228102000000,SW 404,RESIDENTIAL,15000,0,15000,59564,0,74564
143228102100000,SW 404,RESIDENTIAL,15000,0,15000,77454,0,92454
143228102200000,SW 404,RESIDENTIAL,15000,0,15000,69706,0,84706
143228102300000,SW 404,RESIDENTIAL,15000,0,15000,54309,0,69309
143228102400000,SW 404,RESIDENTIAL,15000,0,15000,30444,0,45444
143228102500000,SW 404,RESIDENTIAL,15000,0,15000,52785,0,67785
143228102600000,SW 404,RESIDENTIAL,15000,0,15000,74176,0,89176
143228102700000,SW 404,RESIDENTIAL,19500,0,19500,63075,0,82575
143228102800000,SW 404,RESIDENTIAL,15000,0,15000,41644,0,56644
143228102900000,SW 404,RESIDENTIAL,15000,0,15000,48245,0,63245
143228103000000,SW 404,RESIDENTIAL,15000,0,15000,54126,0,69126
143228103100000,SW 404,RESIDENTIAL,19500,0,19500,32412,0,51912
143228103200000,SW 404,RESIDENTIAL,22482,0,22482,94142,0,116624
143228200100000,CITY PROPERTY,EXEMPT,0,0,0,0,0,0
143228200200000,SW 404,RESIDENTIAL,15680,0,15680,57948,0,73628
143228200300000,SW 404,RESIDENTIAL,15680,0,15680,37842,0,53522
143228200400000,SW 404,RESIDENTIAL,15680,0,15680,74239,0,89919
143228200500000,SW 404,RESIDENTIAL,14700,0,14700,62886,0,77586
143228200600000,SW 404,RESIDENTIAL,15680,0,15680,64592,0,80272
143228200700000,SW 404,RESIDENTIAL,15680,0,15680,56286,0,71966
143228200800000,SW 404,RESIDENTIAL,14700,0,14700,29343,0,44043
143228200900000,SW 404,RESIDENTIAL,15680,0,15680,51275,0,66955
143228201200000,OFFICE,EXEMPT,0,49781,49781,0,148986,198767
143228300100000,SW 404,RESIDENTIAL,14700,0,14700,89763,0,104463
143228300200000,SW 404,RESIDENTIAL,14700,0,14700,73115,0,87815
143228300300000,SW 404,RESIDENTIAL,14700,0,14700,81932,0,96632
143228300400000,SW 404,RESIDENTIAL,10050,0,10050,35144,0,45194
143228300500000,SW 404,RESIDENTIAL,10720,0,10720,32396,0,43116
143228300600000,SW 404,RESIDENTIAL,10050,0,10050,36417,0,46467
143228300700000,SW 404,RESIDENTIAL,10720,0,10720,33956,0,44676
143228300900000,SW 404,RESIDENTIAL,20384,0,20384,94743,0,115127
143228301000000,SW 404,RESIDENTIAL,19800,0,19800,48915,0,68715
143228301100000,SW 404,RESIDENTIAL,10050,0,10050,34892,0,44942
143228301200000,SW 404,RESIDENTIAL,10050,0,10050,30722,0,40772
143228301300000,SW 404,RESIDENTIAL,10720,0,10720,37593,0,48313
143228301400000,SW 404,RESIDENTIAL,23520,0,23520,75090,0,98610
143228301500000,SW 404,RESIDENTIAL,19296,0,19296,42357,0,61653
143228301600000,SW 404,RESIDENTIAL,17085,0,17085,31887,0,48972
143228301700000,SW 404,RESIDENTIAL,21168,0,21168,80690,0,101858
143228301800000,SW 404,RESIDENTIAL,17339,0,17339,45837,0,63176
143230100100000,CENTRALLY ASSESSED,OTHER,0,0,0,0,0,0
143230100300000,VACANT LAND,COMMERCIAL,0,2291,2291,0,0,2291
143230100500000,WAREHOUSE,COMMERCIAL,0,415000,415000,0,1986455,2401455
143230100600000,COUNTY PROPERTY,EXEMPT,0,0,0,0,0,0
143230100700000,VACANT LAND,COMMERCIAL,0,676625,676625,0,0,676625
143232600100000,SMALL RETAIL,COMMERCIAL,0,155080,155080,0,267424,422504
143232600200000,SW 455,RESIDENTIAL,36920,0,36920,0,0,36920
143232600300000,SW 455,RESIDENTIAL,38588,0,38588,56117,0,94705
143232600400000,SW 455,RESIDENTIAL,30700,0,30700,35643,0,66343
143232700100000,CENTRALLY ASSESSED,OTHER,0,0,0,0,0,0
143232800100000,SW 455,RESIDENTIAL,25736,0,25736,30164,0,55900
143232800200000,SW 455,RESIDENTIAL,20081,0,20081,32939,0,53020
143232800300000,SW 455,RESIDENTIAL,17850,0,17850,64685,0,82535
143232800400000,SW 455,RESIDENTIAL,17850,0,17850,80136,0,97986
143232800500000,SW 455,RESIDENTIAL,17850,0,17850,71632,0,89482
143232800600000,SW 455,RESIDENTIAL,20400,0,20400,70790,0,91190
143232800700000,SW 455,RESIDENTIAL,30345,0,30345,92895,0,123240
143232800800000,SW 455,RESIDENTIAL,17850,0,17850,96282,0,114132
143232800900000,SW 455,RESIDENTIAL,12320,0,12320,54420,0,66740
143232801000000,SW 455,RESIDENTIAL,19342,0,19342,56860,0,76202
143232801100000,SW 455,RESIDENTIAL,29704,0,29704,29633,0,59337
143232801200000,SW 455,RESIDENTIAL,225,0,225,0,0,225
143232801300000,SW 455,RESIDENTIAL,24500,0,24500,62738,0,87238
143232801400000,SW 455,RESIDENTIAL,21309,0,21309,44808,0,66117
143232801500000,SW 455,RESIDENTIAL,16000,0,16000,79454,0,95454
143232801600000,SHOP,COMMERCIAL,0,561100,561100,0,803269,1364369
143232801700000,SW 455,RESIDENTIAL,35450,0,35450,1208,0,36658
143232801800000,SW 455,RESIDENTIAL,16000,0,16000,38006,0,54006
143235100100000,SW 418,AG LAND,49880,0,49880,0,0,49880
143235100300000,CENTRALLY ASSESSED,OTHER,0,0,0,0,0,0
143235200100000,SW 418,AG DWELLING,22030,0,22030,106210,0,128240
143235200200000,CENTRALLY ASSESSED,OTHER,0,0,0,0,0,0
143237600200000,WAREHOUSE,COMMERCIAL,0,315050,315050,0,860512,1175562
143237600500000,VACANT LAND,INDUSTRIAL,0,160920,160920,0,0,160920
143237600600000,VACANT LAND,COMMERCIAL,0,3437,3437,0,0,3437
143237600700000,WAREHOUSE,EXEMPT,0,275563,275563,0,906156,1181719
143237600900000,VACANT LAND,COMMERCIAL,0,115000,115000,0,0,115000
143240100100000,EQUIPMENT MFG;INDUST,INDUSTRIAL,0,491136,491136,0,3508864,4000000
143242600100000,EQUIPMENT MFG;INDUST,INDUSTRIAL,0,422376,422376,0,1903257,2325633
143242600200000,CENTRALLY ASSESSED,OTHER,0,0,0,0,0,0
143242600300000,VACANT LAND,INDUSTRIAL,0,59000,59000,0,0,59000
143242600400000,VACANT LAND,INDUSTRIAL,0,150000,150000,0,0,150000
143242600500000,CENTRALLY ASSESSED,OTHER,0,0,0,0,0,0
143242600600000,WAREHOUSE,COMMERCIAL,0,55000,55000,0,45508,100508
143242600700000,OFFICE,COMMERCIAL,0,127000,127000,0,300493,427493
143242600900000,ANTENNAS/TOWERS(BLL),COMMERCIAL,0,182725,182725,0,359531,542256
143245100100000,WAREHOUSE,COMMERCIAL,0,658350,658350,0,1411889,2070239
143245100200000,WAREHOUSE,COMMERCIAL,0,200000,200000,0,253878,453878
143245100300000,OFFICE,COMMERCIAL,0,49050,49050,0,117077,166127
143245100400000,VACANT LAND,COMMERCIAL,0,35900,35900,0,0,35900
143245100500000,WAREHOUSE,COMMERCIAL,0,28700,28700,0,66578,95278
143245200100000,WAREHOUSE,COMMERCIAL,0,92800,92800,0,434267,527067
143245200200000,ANTENNAS/TOWERS(BLL),COMMERCIAL,0,83100,83100,0,463716,546816
143245200300000,WAREHOUSE,COMMERCIAL,0,99600,99600,0,350952,450552
143245200400000,WAREHOUSE,COMMERCIAL,0,66000,66000,0,326201,392201
143245200500000,FLAT PARKING,COMMERCIAL,0,28700,28700,0,1840,30540
143245200600000,SHOP,COMMERCIAL,0,117100,117100,0,304933,422033
143245200700000,OFFICE,COMMERCIAL,0,75760,75760,0,63511,139271
143245300100000,WAREHOUSE,COMMERCIAL,0,559500,559500,0,1336255,1895755
143245300200000,OFFICE,COMMERCIAL,0,219000,219000,0,537388,756388
143245400100000,WAREHOUSE,COMMERCIAL,0,252600,252600,0,254426,507026
143245400400000,WAREHOUSE,COMMERCIAL,0,50000,50000,0,156286,206286
143245400500000,AUTO REPAIR/SALES,COMMERCIAL,0,42200,42200,0,106854,149054
143245400600000,WAREHOUSE,COMMERCIAL,0,287000,287000,0,270400,557400
143245400700000,WAREHOUSE,COMMERCIAL,0,142000,142000,0,299650,441650
143245400800000,WAREHOUSE,COMMERCIAL,0,92000,92000,0,324251,416251
143247600100000,WAREHOUSE,COMMERCIAL,0,932825,932825,0,3001868,3934693
143247600200000,VACANT LAND,COMMERCIAL,0,288325,288325,0,0,288325
143247600300000,SHOP,COMMERCIAL,0,327000,327000,0,991236,1318236
143247700100000,AUTO REPAIR/SALES,COMMERCIAL,0,138600,138600,0,40914,179514
143247700200000,AUTO REPAIR/SALES,COMMERCIAL,0,107260,107260,0,494407,601667
143247700300000,VACANT LAND,COMMERCIAL,0,65800,65800,0,0,65800
143247700400000,AUTO REPAIR/SALES,COMMERCIAL,0,618750,618750,0,828551,1447301
143247700500000,WAREHOUSE,COMMERCIAL,0,93000,93000,0,389471,482471
143247700600000,WAREHOUSE,COMMERCIAL,0,92600,92600,0,103592,196192
143247700700000,FLAT PARKING,COMMERCIAL,0,83062,83062,0,15098,98160
143247800100000,SHOP,COMMERCIAL,0,103000,103000,0,346039,449039
143247800200000,WAREHOUSE,COMMERCIAL,0,103000,103000,0,49916,152916
143247800300000,VACANT LAND,COMMERCIAL,0,55973,55973,0,0,55973
143247800400000,SHOP,COMMERCIAL,0,40380,40380,0,74331,114711
143247800500000,FLAT PARKING,COMMERCIAL,0,123025,123025,0,0,123025
143247800600000,VACANT LAND,COMMERCIAL,0,120000,120000,0,0,120000
143247800700000,FLAT PARKING,COMMERCIAL,0,69000,69000,0,2657,71657
143247800800000,AUTO REPAIR/SALES,COMMERCIAL,0,405000,405000,0,846879,1251879
143310100100000,CITY PROPERTY,EXEMPT,0,0,0,0,0,0
143310100200000,CITY PROPERTY,EXEMPT,0,0,0,0,0,0
143310100300000,CITY PROPERTY,EXEMPT,0,0,0,0,0,0
143310100400000,CITY PROPERTY,EXEMPT,0,0,0,0,0,0
143310100500000,CITY PROPERTY,EXEMPT,0,0,0,0,0,0
143310100600000,CITY PROPERTY,EXEMPT,0,0,0,0,0,0
143310100700000,SW 402,RESIDENTIAL,17000,0,17000,0,0,17000
143310200100000,CITY PROPERTY,EXEMPT,0,0,0,0,0,0
143310200200000,CITY PROPERTY,EXEMPT,0,0,0,0,0,0
143310200300000,CITY PROPERTY,EXEMPT,0,0,0,0,0,0
143310200400000,CITY PROPERTY,EXEMPT,0,14450,14450,0,0,14450
143310200500000,CITY PROPERTY,EXEMPT,0,0,0,0,0,0
143310200600000,CITY PROPERTY,EXEMPT,0,0,0,0,0,0
143310300100000,SW 412,RESIDENTIAL,16362,0,16362,111680,0,128042
143310300200000,SW 412,RESIDENTIAL,16362,0,16362,39209,0,55571
143310300300000,SW 412,RESIDENTIAL,16362,0,16362,126965,0,143327
143310300400000,SW 412,RESIDENTIAL,16362,0,16362,55457,0,71819
143310300500000,SW 412,RESIDENTIAL,16362,0,16362,55457,0,71819
143310300600000,SW 412,RESIDENTIAL,16362,0,16362,0,0,16362
143310300700000,SW 412,RESIDENTIAL,6000,0,6000,0,0,6000
143310300800000,SW 412,RESIDENTIAL,8181,0,8181,40368,0,48549
143310300900000,SW 412,RESIDENTIAL,18700,0,18700,61488,0,80188
143310301000000,SW 412,RESIDENTIAL,23375,0,23375,53858,0,77233
143310301100000,SW 412,RESIDENTIAL,14875,0,14875,85982,0,100857
143310301200000,SW 412,RESIDENTIAL,14875,0,14875,87231,0,102106
143310301300000,SW 412,RESIDENTIAL,17000,0,17000,116474,0,133474
143310301400000,SW 412,RESIDENTIAL,23375,0,23375,68510,0,91885
143310301500000,SW 412,RESIDENTIAL,23375,0,23375,73147,0,96522
143310301600000,SW 412,RESIDENTIAL,23375,0,23375,73864,0,97239
143310301700000,SW 412,RESIDENTIAL,23375,0,23375,86656,0,110031
143310301800000,SW 412,RESIDENTIAL,23375,0,23375,108099,0,131474
143310400100000,SW 402,RESIDENTIAL,14650,0,14650,64363,0,79013
143310400200000,SW 402,RESIDENTIAL,11857,0,11857,25058,0,36915
143310400300000,SW 402,RESIDENTIAL,21165,0,21165,53170,0,74335
143310400400000,SW 402,RESIDENTIAL,25500,0,25500,65949,0,91449
143310400500000,SW 402,RESIDENTIAL,24769,0,24769,52969,0,77738
143310400600000,SW 402,RESIDENTIAL,10965,0,10965,48882,0,59847
143310400700000,SW 402,RESIDENTIAL,9945,0,9945,52243,0,62188
143310500100000,FLAT PARKING,COMMERCIAL,0,39339,39339,0,5512,44851
143310500200000,SW 412,RESIDENTIAL,20910,0,20910,62758,0,83668
143310500300000,BRANCH BANK/CU,COMMERCIAL,0,45440,45440,0,38988,84428
143310600100000,SW 412,RESIDENTIAL,15546,0,15546,79979,0,95525
143310600200000,SW 412,RESIDENTIAL,12403,0,12403,86022,0,98425
143310600300000,SW 412,RESIDENTIAL,11900,0,11900,76334,0,88234
143310600400000,SW 412,RESIDENTIAL,11900,0,11900,90730,0,102630
143310600500000,SW 412,RESIDENTIAL,11900,0,11900,83208,0,95108
143310600600000,SW 412,RESIDENTIAL,11900,0,11900,82965,0,94865
143310600700000,SW 412,RESIDENTIAL,11900,0,11900,96370,0,108270
143310600800000,SW 412,RESIDENTIAL,11900,0,11900,87996,0,99896
143310600900000,SW 412,RESIDENTIAL,11900,0,11900,77736,0,89636
143310601000000,SW 412,RESIDENTIAL,16912,0,16912,79226,0,96138
143310601100000,SW 412,RESIDENTIAL,14386,0,14386,60814,0,75200
143310601200000,SW 412,RESIDENTIAL,14450,0,14450,75157,0,89607
143310601300000,SW 412,RESIDENTIAL,14450,0,14450,64801,0,79251
143310601400000,SW 412,RESIDENTIAL,14450,0,14450,68195,0,82645
143310601500000,SW 412,RESIDENTIAL,14450,0,14450,61345,0,75795
143310601600000,SW 412,RESIDENTIAL,14450,0,14450,67490,0,81940
143310601700000,SW 412,RESIDENTIAL,14450,0,14450,53686,0,68136
143310601800000,SW 412,RESIDENTIAL,17000,0,17000,67120,0,84120
143310601900000,CITY PROPERTY,EXEMPT,0,0,0,0,0,0
143310602000000,SW 412,RESIDENTIAL,14016,0,14016,57704,0,71720
143310602100000,SW 412,RESIDENTIAL,16353,0,16353,80460,0,96813
143310700100000,SCHOOL,EXEMPT,0,325728,325728,0,613535,939263
143310700200000,CONVERSION,COMMERCIAL,0,5533,5533,0,62189,67722
143310700300000,SW 412,RESIDENTIAL,14734,0,14734,33472,0,48206
143310700400000,SW 412,RESIDENTIAL,12745,0,12745,38908,0,51653
143310700500000,SW 412,RESIDENTIAL,15636,0,15636,47514,0,63150
143310700600000,SW 412,RESIDENTIAL,17701,0,17701,115336,0,133037
143310700700000,SW 412,RESIDENTIAL,17701,0,17701,45961,0,63662
143310700800000,SW 412,RESIDENTIAL,17701,0,17701,66506,0,84207
143310700900000,SW 412,RESIDENTIAL,17701,0,17701,49342,0,67043
143310701000000,SW 412,RESIDENTIAL,17701,0,17701,77618,0,95319
143310701100000,SW 412,RESIDENTIAL,17701,0,17701,116904,0,134605
143310800100000,SW 412,RESIDENTIAL,19825,0,19825,62901,0,82726
143310800200000,SW 412,RESIDENTIAL,19825,0,19825,94625,0,114450
143310800300000,SW 412,RESIDENTIAL,17701,0,17701,63597,0,81298
143310800400000,SW 412,RESIDENTIAL,14161,0,14161,77072,0,91233
143310800500000,SW 412,RESIDENTIAL,19291,0,19291,43952,0,63243
143310800600000,SW 412,RESIDENTIAL,18062,0,18062,54852,0,72914
143310800700000,SW 412,RESIDENTIAL,18062,0,18062,70887,0,88949
143310800800000,SW 412,RESIDENTIAL,18062,0,18062,80497,0,98559
143310800900000,SW 412,RESIDENTIAL,18062,0,18062,93702,0,111764
143310801000000,SW 412,RESIDENTIAL,18062,0,18062,59808,0,77870
143310801100000,SW 412,RESIDENTIAL,18062,0,18062,70555,0,88617
143310801200000,SW 412,RESIDENTIAL,17701,0,17701,77674,0,95375
143310801300000,SW 412,RESIDENTIAL,17701,0,17701,67428,0,85129
143310801400000,SW 412,RESIDENTIAL,17701,0,17701,79006,0,96707
143310801500000,SW 412,RESIDENTIAL,8075,0,8075,73393,0,81468
143310801600000,SW 412,RESIDENTIAL,17701,0,17701,96512,0,114213
143310801700000,SW 412,RESIDENTIAL,15223,0,15223,64441,0,79664
143310801800000,SW 412,RESIDENTIAL,13099,0,13099,0,0,13099
143310801900000,CITY PROPERTY,EXEMPT,0,0,0,0,0,0
143310900100000,SW 412,RESIDENTIAL,14132,0,14132,98245,0,112377
143310900200000,SW 412,RESIDENTIAL,14270,0,14270,83418,0,97688
143310900300000,SW 412,RESIDENTIAL,14450,0,14450,85157,0,99607
143310900400000,SW 412,RESIDENTIAL,10000,0,10000,0,0,10000
143310900500000,SW 412,RESIDENTIAL,14450,0,14450,86435,0,100885
143310900600000,SW 412,RESIDENTIAL,14450,0,14450,71520,0,85970
143310900700000,SW 412,RESIDENTIAL,21241,0,21241,80893,0,102134
143310900800000,SW 412,RESIDENTIAL,18508,0,18508,65514,0,84022
143310900900000,SW 412,RESIDENTIAL,14883,0,14883,52496,0,67379
143310901000000,SW 412,RESIDENTIAL,14883,0,14883,76481,0,91364
143310901100000,SW 412,RESIDENTIAL,14883,0,14883,51541,0,66424
143310901200000,SW 412,RESIDENTIAL,14883,0,14883,72444,0,87327
143310901300000,SW 412,RESIDENTIAL,14883,0,14883,81467,0,96350
143310901400000,SW 412,RESIDENTIAL,14883,0,14883,83702,0,98585
143310901500000,SW 412,RESIDENTIAL,22513,0,22513,65509,0,88022
143310901600000,SW 412,RESIDENTIAL,19768,0,19768,83129,0,102897
143310901700000,SW 412,RESIDENTIAL,12257,0,12257,54125,0,66382
143310901800000,SW 412,RESIDENTIAL,12257,0,12257,26098,0,38355
143310901900000,SW 412,RESIDENTIAL,12257,0,12257,77184,0,89441
143310902000000,SW 412,RESIDENTIAL,12257,0,12257,66164,0,78421
143310902100000,SW 412,RESIDENTIAL,12257,0,12257,79333,0,91590
143310902200000,SW 412,RESIDENTIAL,12257,0,12257,86115,0,98372
143310902300000,SW 412,RESIDENTIAL,12257,0,12257,73631,0,85888
143310902400000,SW 412,RESIDENTIAL,12257,0,12257,78956,0,91213
143311000100000,CITY PROPERTY,EXEMPT,0,0,0,0,0,0
143311000200000,SW 412,RESIDENTIAL,19472,0,19472,54667,0,74139
143311000300000,SW 412,RESIDENTIAL,22907,0,22907,0,0,22907
143311000400000,SW 412,RESIDENTIAL,19472,0,19472,55513,0,74985
143311000500000,SW 412,RESIDENTIAL,19472,0,19472,82139,0,101611
143311000600000,SW 412,RESIDENTIAL,19472,0,19472,84436,0,103908
143311000700000,SW 412,RESIDENTIAL,19472,0,19472,97505,0,116977
143311000800000,SW 412,RESIDENTIAL,19472,0,19472,63379,0,82851
143311000900000,SW 412,RESIDENTIAL,19472,0,19472,69707,0,89179
143311001000000,SW 412,RESIDENTIAL,18764,0,18764,66553,0,85317
143311100100000,SW 412,RESIDENTIAL,19472,0,19472,61201,0,80673
143311100200000,SW 412,RESIDENTIAL,18062,0,18062,87135,0,105197
143311100300000,SW 412,RESIDENTIAL,18062,0,18062,70026,0,88088
143311100400000,SW 412,RESIDENTIAL,18062,0,18062,62241,0,80303
143311100500000,SW 412,RESIDENTIAL,18062,0,18062,54995,0,73057
143311100600000,SW 412,RESIDENTIAL,18062,0,18062,91789,0,109851
143311100700000,SW 412,RESIDENTIAL,18062,0,18062,68719,0,86781
143311100800000,SW 412,RESIDENTIAL,18062,0,18062,65201,0,83263
143311100900000,SW 412,RESIDENTIAL,18062,0,18062,82237,0,100299
143311101000000,SW 412,RESIDENTIAL,18062,0,18062,63068,0,81130
143311101100000,SW 412,RESIDENTIAL,15365,0,15365,81532,0,96897
143311101400000,SW 412,RESIDENTIAL,19472,0,19472,68664,0,88136
143311101500000,SW 412,RESIDENTIAL,19472,0,19472,65375,0,84847
143311101600000,SW 412,RESIDENTIAL,19472,0,19472,88213,0,107685
143311101700000,SW 412,RESIDENTIAL,19472,0,19472,79651,0,99123
143311101800000,SW 412,RESIDENTIAL,19472,0,19472,59519,0,78991
143311101900000,SW 412,RESIDENTIAL,19472,0,19472,70292,0,89764
143311102000000,SW 412,RESIDENTIAL,28676,0,28676,85811,0,114487
143312600100000,BRANCH BANK/CU,COMMERCIAL,0,34711,34711,0,364242,398953
143312700100000,CITY PROPERTY,EXEMPT,0,0,0,0,0,0
143312700200000,CITY PROPERTY,EXEMPT,0,0,0,0,0,0
143312700500000,SW 402,RESIDENTIAL,21200,0,21200,46894,0,68094
143312700600000,SW 402,RESIDENTIAL,20213,0,20213,83051,0,103264
143312700700000,SW 402,RESIDENTIAL,17147,0,17147,71330,0,88477
143312700800000,SW 402,RESIDENTIAL,19080,0,19080,86085,0,105165
143312800100000,SW 402,RESIDENTIAL,14280,0,14280,63244,0,77524
143312800200000,SW 402,RESIDENTIAL,14756,0,14756,27073,0,41829
143312800300000,SW 402,RESIDENTIAL,17765,0,17765,54405,0,72170
143312800400000,SW 402,RESIDENTIAL,18411,0,18411,34711,0,53122
143312800500000,SW 402,RESIDENTIAL,16065,0,16065,49425,0,65490
143312800600000,SW 402,RESIDENTIAL,10710,0,10710,48132,0,58842
143312800700000,SW 402,RESIDENTIAL,9595,0,9595,43672,0,53267
143312800800000,SW 402,RESIDENTIAL,9595,0,9595,50898,0,60493
143312800900000,SW 402,RESIDENTIAL,15027,0,15027,127478,0,142505
143312801000000,SW 402,RESIDENTIAL,7902,0,7902,36340,0,44242
143312801100000,SW 402,RESIDENTIAL,20400,0,20400,61826,0,82226
143312801200000,SW 402,RESIDENTIAL,20400,0,20400,79301,0,99701
143312801300000,SW 402,RESIDENTIAL,20400,0,20400,43151,0,63551
143312801400000,SW 402,RESIDENTIAL,20400,0,20400,51890,0,72290
143312900100000,SW 402,RESIDENTIAL,20400,0,20400,74795,0,95195
143312900200000,SW 402,RESIDENTIAL,20400,0,20400,51032,0,71432
143312900300000,CHURCH,EXEMPT,0,13608,13608,0,45902,59510
143312900500000,SW 402,RESIDENTIAL,10914,0,10914,0,0,10914
143312900600000,CITY PROPERTY,EXEMPT,0,0,0,0,0,0
143312900700000,SW 402,RESIDENTIAL,10812,0,10812,0,0,10812
143312900800000,SW 402,RESIDENTIAL,15867,0,15867,0,0,15867
143312901100000,SW 402,RESIDENTIAL,20400,0,20400,72525,0,92925
143312901200000,SW 402,RESIDENTIAL,10200,0,10200,54848,0,65048
143312901300000,SW 402,RESIDENTIAL,10200,0,10200,61066,0,71266
143312901400000,SW 402,RESIDENTIAL,20400,0,20400,60423,0,80823
143312901500000,RESTAURANT,COMMERCIAL,0,98288,98288,0,151459,249747
143313000100000,SW 402,RESIDENTIAL,13600,0,13600,125609,0,139209
143313000200000,SW 402,RESIDENTIAL,13668,0,13668,59702,0,73370
143313000300000,SW 402,RESIDENTIAL,5974,0,5974,0,0,5974
143313000400000,SW 402,RESIDENTIAL,25093,0,25093,0,0,25093
143313100100000,FLAT PARKING,COMMERCIAL,0,25200,25200,0,3600,28800
143313100200000,FLAT PARKING,COMMERCIAL,0,25200,25200,0,6044,31244
143313100300000,SW 412,RESIDENTIAL,17850,0,17850,65995,0,83845
143313100400000,SW 412,RESIDENTIAL,17850,0,17850,110707,0,128557
143313100500000,SW 412,RESIDENTIAL,17850,0,17850,63940,0,81790
143313100600000,SW 412,RESIDENTIAL,18062,0,18062,67008,0,85070
143313100700000,SW 412,RESIDENTIAL,18062,0,18062,46869,0,64931
143313100800000,SW 412,RESIDENTIAL,18062,0,18062,59873,0,77935
143313100900000,SW 412,RESIDENTIAL,18062,0,18062,72541,0,90603
143313101000000,SW 412,RESIDENTIAL,18062,0,18062,48522,0,66584
143313101100000,SW 412,RESIDENTIAL,18062,0,18062,82446,0,100508
143313200100000,APARTMENT,COMMERCIAL,0,12150,12150,0,133500,145650
143313200200000,APARTMENT,COMMERCIAL,0,12150,12150,0,134209,146359
143313200300000,SW 412,RESIDENTIAL,5000,0,5000,0,0,5000
143313200400000,WAREHOUSE,COMMERCIAL,0,12600,12600,0,59195,71795
143313200500000,SW 412,RESIDENTIAL,13387,0,13387,57049,0,70436
143313200600000,SW 412,RESIDENTIAL,14280,0,14280,39967,0,54247
143313200700000,SW 412,RESIDENTIAL,10145,0,10145,46590,0,56735
143313200800000,CITY PROPERTY,EXEMPT,0,0,0,0,0,0
143313200900000,SW 412,RESIDENTIAL,7687,0,7687,29213,0,36900
143313201000000,SW 412,RESIDENTIAL,9624,0,9624,53845,0,63469
143313201100000,SW 412,RESIDENTIAL,11184,0,11184,54427,0,65611
143313201400000,SW 412,RESIDENTIAL,14450,0,14450,76161,0,90611
143313201500000,SW 412,RESIDENTIAL,14450,0,14450,73898,0,88348
143313201600000,SW 412,RESIDENTIAL,18424,0,18424,86853,0,105277
143313201700000,SW 412,RESIDENTIAL,20230,0,20230,135287,0,155517
143313300100000,SW 412,RESIDENTIAL,17850,0,17850,72682,0,90532
143313300200000,SW 412,RESIDENTIAL,17850,0,17850,65582,0,83432
143313300300000,SW 412,RESIDENTIAL,17850,0,17850,85897,0,103747
143313300400000,SW 412,RESIDENTIAL,17850,0,17850,72571,0,90421
143313300500000,SW 412,RESIDENTIAL,17850,0,17850,85911,0,103761
143313300600000,BARS/LOUNGE,COMMERCIAL,0,30800,30800,0,168770,199570
143313300700000,FLAT PARKING,COMMERCIAL,0,25069,25069,0,7644,32713
143313300800000,FLAT PARKING,COMMERCIAL,0,33595,33595,0,8370,41965
143313300900000,GROCERY STORE,COMMERCIAL,0,135792,135792,0,447623,583415
143313301000000,SW 412,RESIDENTIAL,10000,0,10000,0,0,10000
143313301100000,SW 412,RESIDENTIAL,20230,0,20230,22409,0,42639
143313301200000,SW 412,RESIDENTIAL,14450,0,14450,71562,0,86012
143313301300000,SW 412,RESIDENTIAL,14450,0,14450,37370,0,51820
143313301400000,SW 412,RESIDENTIAL,14450,0,14450,73598,0,88048
143313400100000,SW 412,RESIDENTIAL,19884,0,19884,75815,0,95699
143313400200000,SW 412,RESIDENTIAL,16799,0,16799,60296,0,77095
143313400300000,SW 412,RESIDENTIAL,19548,0,19548,81416,0,100964
143313400400000,SW 412,RESIDENTIAL,14875,0,14875,72191,0,87066
143313400500000,SW 412,RESIDENTIAL,14875,0,14875,53710,0,68585
143313400600000,SW 412,RESIDENTIAL,18062,0,18062,53734,0,71796
143313400700000,SW 412,RESIDENTIAL,18062,0,18062,56784,0,74846
143313400800000,SW 412,RESIDENTIAL,18062,0,18062,82017,0,100079
143313400900000,SW 412,RESIDENTIAL,18062,0,18062,120495,0,138557
143313500100000,SW 412,RESIDENTIAL,17002,0,17002,86915,0,103917
143313500200000,SW 412,RESIDENTIAL,14868,0,14868,87636,0,102504
143313600100000,SW 412,RESIDENTIAL,15602,0,15602,68997,0,84599
143313600200000,SW 412,RESIDENTIAL,11186,0,11186,121251,0,132437
143313600300000,SW 412,RESIDENTIAL,10353,0,10353,67577,0,77930
143313600400000,SW 412,RESIDENTIAL,18893,0,18893,70018,0,88911
143313700100000,SW 412,RESIDENTIAL,14956,0,14956,85383,0,100339
143313700200000,SW 412,RESIDENTIAL,5000,0,5000,0,0,5000
143313700300000,SW 412,RESIDENTIAL,7840,0,7840,58654,0,66494
143313700400000,SW 412,RESIDENTIAL,9754,0,9754,48614,0,58368
143313700500000,SW 412,RESIDENTIAL,14992,0,14992,75785,0,90777
143313700600000,SW 412,RESIDENTIAL,18062,0,18062,115632,0,133694
143313700700000,SW 412,RESIDENTIAL,18062,0,18062,72110,0,90172
143313700800000,SW 412,RESIDENTIAL,18062,0,18062,78061,0,96123
143313700900000,SW 412,RESIDENTIAL,18062,0,18062,87939,0,106001
143313701000000,SW 412,RESIDENTIAL,18062,0,18062,71885,0,89947
143313701100000,SW 412,RESIDENTIAL,18062,0,18062,60613,0,78675
143313701200000,SW 412,RESIDENTIAL,16736,0,16736,64787,0,81523
143313701300000,SW 412,RESIDENTIAL,16741,0,16741,66953,0,83694
143313701400000,SW 412,RESIDENTIAL,16736,0,16736,74946,0,91682
143313701500000,SW 412,RESIDENTIAL,15088,0,15088,60333,0,75421
143313701600000,SW 412,RESIDENTIAL,18062,0,18062,90129,0,108191
143313701700000,SW 412,RESIDENTIAL,18062,0,18062,59199,0,77261
143313701800000,SW 412,RESIDENTIAL,18062,0,18062,67280,0,85342
143313701900000,SW 412,RESIDENTIAL,21250,0,21250,68483,0,89733
143313702000000,SW 412,RESIDENTIAL,18062,0,18062,74644,0,92706
143313702100000,CITY PROPERTY,EXEMPT,0,0,0,0,0,0
143313702200000,SW 412,RESIDENTIAL,18062,0,18062,54708,0,72770
143313702300000,SW 412,RESIDENTIAL,14450,0,14450,74658,0,89108
143313800100000,SW 412,RESIDENTIAL,11900,0,11900,105409,0,117309
143313800200000,SW 412,RESIDENTIAL,11900,0,11900,77713,0,89613
143313800300000,SW 412,RESIDENTIAL,14700,0,14700,0,0,14700
143313900100000,SW 412,RESIDENTIAL,14450,0,14450,80942,0,95392
143313900200000,SW 412,RESIDENTIAL,14450,0,14450,83688,0,98138
143313900300000,SW 412,RESIDENTIAL,14450,0,14450,66842,0,81292
143313900400000,SW 412,RESIDENTIAL,14450,0,14450,85745,0,100195
143313900500000,SW 412,RESIDENTIAL,18062,0,18062,64323,0,82385
143313900600000,SW 412,RESIDENTIAL,18062,0,18062,65876,0,83938
143313900700000,SW 412,RESIDENTIAL,21675,0,21675,83355,0,105030
143314000100000,SW 412,RESIDENTIAL,18987,0,18987,63809,0,82796
143314000200000,SW 412,RESIDENTIAL,17846,0,17846,89402,0,107248
143314000300000,SW 412,RESIDENTIAL,14450,0,14450,52212,0,66662
143314000400000,SW 412,RESIDENTIAL,14450,0,14450,58162,0,72612
143314000500000,SW 412,RESIDENTIAL,14450,0,14450,65263,0,79713
143314000600000,SW 412,RESIDENTIAL,14450,0,14450,68051,0,82501
143314000700000,SW 412,RESIDENTIAL,14450,0,14450,0,0,14450
143314000800000,SW 412,RESIDENTIAL,14450,0,14450,45639,0,60089
143314000900000,SW 412,RESIDENTIAL,14450,0,14450,61744,0,76194
143314001000000,SW 412,RESIDENTIAL,14450,0,14450,61519,0,75969
143314001100000,SW 412,RESIDENTIAL,14450,0,14450,76842,0,91292
143314001200000,SW 412,RESIDENTIAL,14450,0,14450,79199,0,93649
143314001300000,SW 412,RESIDENTIAL,14450,0,14450,32728,0,47178
143314001400000,SW 412,RESIDENTIAL,14450,0,14450,74859,0,89309
143314001500000,SW 412,RESIDENTIAL,17000,0,17000,23990,0,40990
143314001600000,SW 412,RESIDENTIAL,14450,0,14450,81121,0,95571
143314100100000,SW 412,RESIDENTIAL,19125,0,19125,79237,0,98362
143314100200000,SW 412,RESIDENTIAL,17000,0,17000,89918,0,106918
143314100300000,SW 412,RESIDENTIAL,17000,0,17000,66664,0,83664
143314100400000,SW 412,RESIDENTIAL,17000,0,17000,71523,0,88523
143314100500000,SW 412,RESIDENTIAL,34000,0,34000,42381,0,76381
143314100600000,SW 412,RESIDENTIAL,17000,0,17000,99964,0,116964
143314100700000,SW 412,RESIDENTIAL,17000,0,17000,81833,0,98833
143314100800000,WAREHOUSE,COMMERCIAL,0,11200,11200,0,77693,88893
143314100900000,SW 412,RESIDENTIAL,17000,0,17000,111335,0,128335
143314101000000,SW 412,RESIDENTIAL,17000,0,17000,77374,0,94374
143314101100000,SW 412,RESIDENTIAL,17000,0,17000,76759,0,93759
143314101200000,SW 412,RESIDENTIAL,17000,0,17000,55656,0,72656
143314101300000,SW 412,RESIDENTIAL,17000,0,17000,7840,0,24840
143314101400000,SW 412,RESIDENTIAL,17000,0,17000,98313,0,115313
143314101500000,SW 412,RESIDENTIAL,14875,0,14875,84941,0,99816
143315100100000,SW 412,RESIDENTIAL,16531,0,16531,70895,0,87426
143315100200000,SW 412,RESIDENTIAL,15895,0,15895,65645,0,81540
143315100300000,SW 412,RESIDENTIAL,24796,0,24796,80287,0,105083
143315100400000,SW 412,RESIDENTIAL,24796,0,24796,56583,0,81379
143315100500000,SW 412,RESIDENTIAL,25035,0,25035,87967,0,113002
143315100600000,SW 412,RESIDENTIAL,25035,0,25035,81149,0,106184
143315100700000,SW 412,RESIDENTIAL,24081,0,24081,84578,0,108659
143315100800000,SW 412,RESIDENTIAL,24081,0,24081,69825,0,93906
143315100900000,SW 412,RESIDENTIAL,22908,0,22908,92841,0,115749
143315101000000,SW 412,RESIDENTIAL,22908,0,22908,74800,0,97708
143315101100000,SW 412,RESIDENTIAL,31238,0,31238,112488,0,143726
143315101200000,SW 412,RESIDENTIAL,23793,0,23793,70453,0,94246
143315101300000,SW 412,RESIDENTIAL,23793,0,23793,60569,0,84362
143315101400000,SW 412,RESIDENTIAL,24024,0,24024,63999,0,88023
143315101500000,SW 412,RESIDENTIAL,24024,0,24024,85093,0,109117
143315101600000,SW 412,RESIDENTIAL,22695,0,22695,99947,0,122642
143315101700000,SW 412,RESIDENTIAL,22695,0,22695,103891,0,126586
143315101800000,SW 412,RESIDENTIAL,20425,0,20425,116841,0,137266
143315101900000,SW 412,RESIDENTIAL,12860,0,12860,54126,0,66986
143315200100000,SW 412,RESIDENTIAL,20825,0,20825,84067,0,104892
143315200200000,SW 412,RESIDENTIAL,20409,0,20409,83559,0,103968
143315200300000,SW 412,RESIDENTIAL,28892,0,28892,67916,0,96808
143315200400000,SW 412,RESIDENTIAL,28892,0,28892,85785,0,114677
143315200500000,SW 412,RESIDENTIAL,30799,0,30799,98499,0,129298
143315200600000,SW 412,RESIDENTIAL,30799,0,30799,99187,0,129986
143315200700000,SW 412,RESIDENTIAL,45275,0,45275,97409,0,142684
143315200800000,SW 412,RESIDENTIAL,25755,0,25755,102566,0,128321
143315200900000,SW 412,RESIDENTIAL,23180,0,23180,111032,0,134212
143315201000000,SW 412,RESIDENTIAL,21463,0,21463,82356,0,103819
143315201100000,SW 412,RESIDENTIAL,21463,0,21463,72036,0,93499
143315201200000,SW 412,RESIDENTIAL,21463,0,21463,102176,0,123639
143315201300000,SW 412,RESIDENTIAL,30799,0,30799,79276,0,110075
143315201400000,SW 412,RESIDENTIAL,30799,0,30799,73858,0,104657
143315201500000,SW 412,RESIDENTIAL,30799,0,30799,44961,0,75760
143315201600000,SW 412,RESIDENTIAL,29284,0,29284,90224,0,119508
143315201700000,SW 412,RESIDENTIAL,29474,0,29474,80225,0,109699
143315201800000,SW 412,RESIDENTIAL,16218,0,16218,57422,0,73640
143315201900000,SW 412,RESIDENTIAL,23562,0,23562,75813,0,99375
143315202000000,SW 412,RESIDENTIAL,30600,0,30600,120314,0,150914
143315202100000,SW 412,RESIDENTIAL,28459,0,28459,84410,0,112869
143315202200000,SW 412,RESIDENTIAL,24863,0,24863,91193,0,116056
143315202300000,SW 412,RESIDENTIAL,24863,0,24863,89780,0,114643
143315202400000,SW 412,RESIDENTIAL,24650,0,24650,75571,0,100221
143315202500000,SW 412,RESIDENTIAL,32566,0,32566,72679,0,105245
143315202600000,SW 412,RESIDENTIAL,21250,0,21250,64916,0,86166
143315202700000,SW 412,RESIDENTIAL,21250,0,21250,40117,0,61367
143315202800000,SW 412,RESIDENTIAL,21250,0,21250,70599,0,91849
143315202900000,SW 412,RESIDENTIAL,192,0,192,0,0,192
143315203000000,SW 412,RESIDENTIAL,6368,0,6368,0,0,6368
143315203100000,SW 412,RESIDENTIAL,11249,0,11249,0,0,11249
143315203300000,SW 412,RESIDENTIAL,22440,0,22440,101268,0,123708
143315203400000,SW 412,RESIDENTIAL,22440,0,22440,79207,0,101647
143315203500000,SW 412,RESIDENTIAL,22440,0,22440,78852,0,101292
143315300100000,SW 412,RESIDENTIAL,21250,0,21250,78219,0,99469
143315300200000,SW 412,RESIDENTIAL,19964,0,19964,79103,0,99067
143315300300000,SW 412,RESIDENTIAL,21049,0,21049,101356,0,122405
143315300400000,SW 412,RESIDENTIAL,20515,0,20515,81505,0,102020
143315300500000,SW 412,RESIDENTIAL,21250,0,21250,79872,0,101122
143315300600000,SW 412,RESIDENTIAL,21250,0,21250,65718,0,86968
143315300700000,SW 412,RESIDENTIAL,21250,0,21250,107403,0,128653
143315300800000,SW 412,RESIDENTIAL,21250,0,21250,90889,0,112139
143315300900000,SW 412,RESIDENTIAL,22157,0,22157,79045,0,101202
143315301000000,SW 412,RESIDENTIAL,26145,0,26145,87518,0,113663
143315301100000,SW 412,RESIDENTIAL,25560,0,25560,98636,0,124196
143315301200000,SW 412,RESIDENTIAL,26350,0,26350,106906,0,133256
143315301300000,SW 412,RESIDENTIAL,22695,0,22695,77091,0,99786
143315301400000,SW 412,RESIDENTIAL,30260,0,30260,100759,0,131019
143315301500000,SW 412,RESIDENTIAL,21250,0,21250,108143,0,129393
143315301600000,SW 412,RESIDENTIAL,21250,0,21250,72501,0,93751
143315400100000,SW 412,RESIDENTIAL,14822,0,14822,26159,0,40981
143315400200000,SW 412,RESIDENTIAL,19763,0,19763,71611,0,91374
143315400300000,SW 412,RESIDENTIAL,18577,0,18577,87285,0,105862
143315400400000,SW 412,RESIDENTIAL,19763,0,19763,84564,0,104327
143315400500000,SW 412,RESIDENTIAL,20948,0,20948,83001,0,103949
143315400600000,SW 412,RESIDENTIAL,20948,0,20948,75632,0,96580
143315400700000,SW 412,RESIDENTIAL,19763,0,19763,89331,0,109094
143315400800000,SW 412,RESIDENTIAL,18577,0,18577,85675,0,104252
143315400900000,SW 412,RESIDENTIAL,19763,0,19763,90872,0,110635
143315401000000,SW 412,RESIDENTIAL,19565,0,19565,108961,0,128526
143315401100000,SW 412,RESIDENTIAL,20158,0,20158,76128,0,96286
143315401200000,SW 412,RESIDENTIAL,19763,0,19763,74763,0,94526
143315401300000,SW 412,RESIDENTIAL,19763,0,19763,75856,0,95619
143315401400000,SW 412,RESIDENTIAL,19763,0,19763,72724,0,92487
143315401500000,SW 412,RESIDENTIAL,19763,0,19763,89984,0,109747
143315401600000,SW 412,RESIDENTIAL,19763,0,19763,106183,0,125946
143315401700000,SW 412,RESIDENTIAL,19763,0,19763,65125,0,84888
143315401800000,SW 412,RESIDENTIAL,19763,0,19763,59917,0,79680
143315401900000,SW 412,RESIDENTIAL,19763,0,19763,74691,0,94454
143315402000000,SW 412,RESIDENTIAL,19499,0,19499,86952,0,106451
143315500100000,SCHOOL,EXEMPT,0,307260,307260,0,3480701,3787961
143315500200000,SW 412,EXEMPT,0,33000,33000,0,114393,147393
143315500300000,SW 412,RESIDENTIAL,21250,0,21250,76120,0,97370
143315500400000,SW 412,RESIDENTIAL,21250,0,21250,52432,0,73682
143315500500000,SW 412,RESIDENTIAL,21250,0,21250,84101,0,105351
143315500600000,SW 412,RESIDENTIAL,21250,0,21250,98522,0,119772
143315500700000,SW 412,RESIDENTIAL,21250,0,21250,103624,0,124874
143315500800000,SW 412,RESIDENTIAL,21647,0,21647,78417,0,100064
143315500900000,SW 412,RESIDENTIAL,30716,0,30716,72099,0,102815
143315501000000,SW 412,RESIDENTIAL,16926,0,16926,120645,0,137571
143315501100000,SW 412,RESIDENTIAL,16948,0,16948,98575,0,115523
143315501200000,SW 412,RESIDENTIAL,17093,0,17093,100211,0,117304
143315501300000,SW 412,RESIDENTIAL,17093,0,17093,99937,0,117030
143315501400000,SW 412,RESIDENTIAL,17093,0,17093,94921,0,112014
143315501500000,SW 412,RESIDENTIAL,17093,0,17093,61194,0,78287
143315501600000,SW 412,RESIDENTIAL,24255,0,24255,68843,0,93098
143315501700000,SW 412,RESIDENTIAL,29920,0,29920,78129,0,108049
143315501800000,SW 412,RESIDENTIAL,18700,0,18700,61426,0,80126
143315501900000,SW 412,RESIDENTIAL,31790,0,31790,93826,0,125616
143315502000000,SW 412,RESIDENTIAL,34525,0,34525,124775,0,159300
143315502100000,CHURCH,EXEMPT,0,278,278,0,0,278
143315600100000,SW 412,RESIDENTIAL,21675,0,21675,120721,0,142396
143315600200000,SW 412,RESIDENTIAL,21675,0,21675,70488,0,92163
143315600300000,SW 412,RESIDENTIAL,21675,0,21675,75953,0,97628
143315600400000,SW 412,RESIDENTIAL,21675,0,21675,92509,0,114184
143315600500000,SW 412,RESIDENTIAL,21675,0,21675,76542,0,98217
143315600600000,SW 412,RESIDENTIAL,21675,0,21675,86290,0,107965
143315600700000,SW 412,RESIDENTIAL,28611,0,28611,97537,0,126148
143315600800000,SW 412,RESIDENTIAL,31862,0,31862,106802,0,138664
143315600900000,SW 412,RESIDENTIAL,18743,0,18743,48808,0,67551
143315601000000,SW 412,RESIDENTIAL,16660,0,16660,77129,0,93789
143315601100000,SW 412,RESIDENTIAL,17701,0,17701,86942,0,104643
143315601200000,SW 412,RESIDENTIAL,30925,0,30925,80468,0,111393
143315601300000,SW 412,RESIDENTIAL,23562,0,23562,78966,0,102528
143315601400000,SW 412,RESIDENTIAL,24990,0,24990,22466,0,47456
143315601500000,SW 412,RESIDENTIAL,21420,0,21420,63028,0,84448
143315601600000,SW 412,RESIDENTIAL,24990,0,24990,86606,0,111596
143315601700000,SW 412,RESIDENTIAL,19635,0,19635,83733,0,103368
143315601800000,SW 412,RESIDENTIAL,16065,0,16065,83031,0,99096
143316500500000,SW 402,RESIDENTIAL,10642,0,10642,52564,0,63206
143316500600000,CITY PROPERTY,EXEMPT,0,0,0,0,0,0
143317600100000,SW 412,RESIDENTIAL,15546,0,15546,54135,0,69681
143317600200000,SW 412,RESIDENTIAL,18692,0,18692,56596,0,75288
143317600300000,SW 412,RESIDENTIAL,21666,0,21666,67958,0,89624
143317600400000,SW 412,RESIDENTIAL,21666,0,21666,68961,0,90627
143317600500000,SW 412,RESIDENTIAL,21666,0,21666,63331,0,84997
143317600600000,SW 412,RESIDENTIAL,22108,0,22108,98252,0,120360
143317600700000,SW 412,RESIDENTIAL,22108,0,22108,70345,0,92453
143317600800000,SW 412,RESIDENTIAL,23158,0,23158,82807,0,105965
143317600900000,SW 412,RESIDENTIAL,21478,0,21478,74288,0,95766
143317601000000,SW 412,RESIDENTIAL,20459,0,20459,67327,0,87786
143317601100000,SW 412,RESIDENTIAL,21464,0,21464,80691,0,102155
143317601200000,SW 412,RESIDENTIAL,20461,0,20461,77699,0,98160
143317601300000,SW 412,RESIDENTIAL,22137,0,22137,71793,0,93930
143317601400000,SW 412,RESIDENTIAL,22137,0,22137,87645,0,109782
143317601500000,SW 412,RESIDENTIAL,20808,0,20808,80558,0,101366
143317601600000,SW 412,RESIDENTIAL,23984,0,23984,92613,0,116597
143317601700000,SW 412,RESIDENTIAL,24915,0,24915,68348,0,93263
143317601800000,SW 412,RESIDENTIAL,24677,0,24677,90948,0,115625
143317601900000,SW 412,RESIDENTIAL,24677,0,24677,92033,0,116710
143317602000000,SW 412,RESIDENTIAL,24677,0,24677,94628,0,119305
143317602100000,SW 412,RESIDENTIAL,24677,0,24677,82986,0,107663
143317602200000,SW 412,RESIDENTIAL,23247,0,23247,82416,0,105663
143317602300000,SW 412,RESIDENTIAL,22054,0,22054,100975,0,123029
143317602400000,SW 412,RESIDENTIAL,21351,0,21351,99829,0,121180
143317602500000,SW 412,RESIDENTIAL,24677,0,24677,68733,0,93410
143317602600000,SW 412,RESIDENTIAL,24677,0,24677,80661,0,105338
143317602700000,SW 412,RESIDENTIAL,24677,0,24677,69003,0,93680
143317602800000,SW 412,RESIDENTIAL,24677,0,24677,64766,0,89443
143317602900000,SW 412,RESIDENTIAL,24677,0,24677,78783,0,103460
143317603000000,SW 412,RESIDENTIAL,29032,0,29032,109921,0,138953
143317603100000,SW 412,RESIDENTIAL,29453,0,29453,126298,0,155751
143317603200000,SW 412,RESIDENTIAL,25441,0,25441,84613,0,110054
143317603300000,SW 413,RESIDENTIAL,25468,0,25468,123345,0,148813
143317603400000,SW 413,RESIDENTIAL,23908,0,23908,119733,0,143641
143317603500000,SW 413,RESIDENTIAL,25869,0,25869,86617,0,112486
143317603600000,SW 413,RESIDENTIAL,20370,0,20370,86345,0,106715
143317603700000,APARTMENT,COMMERCIAL,0,20278,20278,0,104712,124990
143317603800000,APARTMENT,RESIDENTIAL,22800,0,22800,181410,0,204210
143317604000000,APARTMENT,COMMERCIAL,0,22320,22320,0,118137,140457
143317604100000,APARTMENT,RESIDENTIAL,23220,0,23220,126378,0,149598
143317604200000,APARTMENT,RESIDENTIAL,48380,0,48380,306616,0,354996
143317604300000,APARTMENT,COMMERCIAL,0,48146,48146,0,311086,359232
143317700100000,SW 412,RESIDENTIAL,21241,0,21241,48145,0,69386
143317700200000,SW 412,RESIDENTIAL,14161,0,14161,86707,0,100868
143317700300000,SW 412,RESIDENTIAL,16660,0,16660,53773,0,70433
143317700400000,SW 412,RESIDENTIAL,16660,0,16660,68939,0,85599
143317700500000,SW 412,RESIDENTIAL,16660,0,16660,40685,0,57345
143317700600000,SW 412,RESIDENTIAL,16660,0,16660,87478,0,104138
143317700700000,SW 412,RESIDENTIAL,24990,0,24990,52713,0,77703
143317700800000,SW 412,RESIDENTIAL,24990,0,24990,75576,0,100566
143317700900000,SW 412,RESIDENTIAL,16660,0,16660,57650,0,74310
143317701000000,SW 412,RESIDENTIAL,16660,0,16660,69189,0,85849
143317701100000,SW 412,RESIDENTIAL,16660,0,16660,54645,0,71305
143317701200000,SW 412,RESIDENTIAL,16660,0,16660,74598,0,91258
143317701300000,SW 412,RESIDENTIAL,16660,0,16660,76849,0,93509
143317701400000,SW 412,RESIDENTIAL,29932,0,29932,60890,0,90822
143317701500000,SW 412,RESIDENTIAL,30212,0,30212,71334,0,101546
143317701600000,SW 412,RESIDENTIAL,16660,0,16660,70748,0,87408
143317701700000,SW 412,RESIDENTIAL,16660,0,16660,58291,0,74951
143317701800000,SW 412,RESIDENTIAL,16660,0,16660,69320,0,85980
143317701900000,SW 412,RESIDENTIAL,16660,0,16660,97538,0,114198
143317702000000,SW 412,RESIDENTIAL,16660,0,16660,68594,0,85254
143317702100000,SW 412,RESIDENTIAL,16660,0,16660,61443,0,78103
143317702200000,SW 412,RESIDENTIAL,16660,0,16660,71951,0,88611
143317702300000,SW 412,RESIDENTIAL,16660,0,16660,64537,0,81197
143317702400000,SW 412,RESIDENTIAL,16660,0,16660,34806,0,51466
143317702500000,SW 412,RESIDENTIAL,16660,0,16660,81133,0,97793
143317702600000,SW 412,RESIDENTIAL,24990,0,24990,80715,0,105705
143317800200000,SW 413,RESIDENTIAL,22726,0,22726,99274,0,122000
143317800300000,SW 413,RESIDENTIAL,24602,0,24602,102708,0,127310
143317800400000,SW 413,RESIDENTIAL,22523,0,22523,73124,0,95647
143317800500000,SW 413,RESIDENTIAL,24689,0,24689,85138,0,109827
143317800600000,SW 413,RESIDENTIAL,22523,0,22523,83753,0,106276
143317800700000,SW 413,RESIDENTIAL,22523,0,22523,80846,0,103369
143317800800000,SW 413,RESIDENTIAL,24521,0,24521,88028,0,112549
143317800900000,SW 413,RESIDENTIAL,26017,0,26017,83674,0,109691
143317801000000,SW 413,RESIDENTIAL,21609,0,21609,71499,0,93108
143317801100000,GROCERY STORE,COMMERCIAL,0,709300,709300,0,4441800,5151100
143317900100000,SW 413,RESIDENTIAL,25577,0,25577,87155,0,112732
143317900200000,SW 413,RESIDENTIAL,23331,0,23331,95557,0,118888
143317900300000,SW 413,RESIDENTIAL,23331,0,23331,99287,0,122618
143317900400000,SW 413,RESIDENTIAL,22978,0,22978,77930,0,100908
143317900500000,SW 413,RESIDENTIAL,24745,0,24745,132823,0,157568
143317900600000,SW 413,RESIDENTIAL,25187,0,25187,121587,0,146774
143317900700000,SW 413,RESIDENTIAL,20150,0,20150,68430,0,88580
143317900800000,SW 413,RESIDENTIAL,20198,0,20198,88191,0,108389
143317900900000,SW 413,RESIDENTIAL,21564,0,21564,66681,0,88245
143317901000000,SW 413,RESIDENTIAL,20750,0,20750,69096,0,89846
143317901100000,SW 413,RESIDENTIAL,23765,0,23765,95746,0,119511
143317901200000,SW 413,RESIDENTIAL,22531,0,22531,92904,0,115435
143317901300000,SW 413,RESIDENTIAL,20422,0,20422,79729,0,100151
143317901400000,SW 413,RESIDENTIAL,21417,0,21417,115769,0,137186
143317901500000,SW 413,RESIDENTIAL,25704,0,25704,72070,0,97774
143317901600000,SW 413,RESIDENTIAL,22491,0,22491,81174,0,103665
143317901700000,SW 413,RESIDENTIAL,24276,0,24276,95759,0,120035
143317901800000,SW 413,RESIDENTIAL,21420,0,21420,78107,0,99527
143317904700000,APARTMENT,COMMERCIAL,0,29655,29655,0,212392,242047
143317904800000,APARTMENT,COMMERCIAL,0,16200,16200,0,123084,139284
143317904900000,APARTMENT,RESIDENTIAL,48070,0,48070,354203,0,402273
143317905000000,APARTMENT,RESIDENTIAL,47093,0,47093,352549,0,399642
143318000100000,SW 412,RESIDENTIAL,34884,0,34884,95069,0,129953
143318000200000,SW 412,RESIDENTIAL,20853,0,20853,118072,0,138925
143318000300000,SW 412,RESIDENTIAL,19125,0,19125,76607,0,95732
143318000400000,SW 412,RESIDENTIAL,19125,0,19125,116603,0,135728
143318000500000,SW 412,RESIDENTIAL,19125,0,19125,72315,0,91440
143318000600000,SW 412,RESIDENTIAL,21250,0,21250,56005,0,77255
143318000700000,SW 412,RESIDENTIAL,21250,0,21250,68511,0,89761
143318000800000,SW 412,RESIDENTIAL,21250,0,21250,101854,0,123104
143318000900000,SW 412,RESIDENTIAL,21250,0,21250,73996,0,95246
143318001000000,SW 412,RESIDENTIAL,21250,0,21250,73391,0,94641
143318001100000,SW 412,RESIDENTIAL,20400,0,20400,73426,0,93826
143318001200000,SW 412,RESIDENTIAL,21916,0,21916,80499,0,102415
143318001300000,SW 412,RESIDENTIAL,25500,0,25500,99625,0,125125
143318001400000,SW 412,RESIDENTIAL,25500,0,25500,92303,0,117803
143318001500000,SW 412,RESIDENTIAL,22879,0,22879,110448,0,133327
143318001600000,SW 412,RESIDENTIAL,21250,0,21250,57987,0,79237
143318001700000,SW 412,RESIDENTIAL,21250,0,21250,68703,0,89953
143318001800000,SW 412,RESIDENTIAL,21250,0,21250,104822,0,126072
143318001900000,SW 412,RESIDENTIAL,21250,0,21250,86366,0,107616
143318002000000,SW 412,RESIDENTIAL,21250,0,21250,87508,0,108758
143318002100000,SW 412,RESIDENTIAL,32300,0,32300,118468,0,150768
143320100100000,SW 402,RESIDENTIAL,17340,0,17340,39756,0,57096
143320100200000,SW 402,RESIDENTIAL,17000,0,17000,58079,0,75079
143320100300000,SW 402,RESIDENTIAL,17000,0,17000,54215,0,71215
143320100400000,SW 402,RESIDENTIAL,17000,0,17000,60283,0,77283
143320100500000,SW 402,RESIDENTIAL,17000,0,17000,62690,0,79690
143320100600000,SW 402,RESIDENTIAL,17340,0,17340,44610,0,61950
143320100700000,SW 402,RESIDENTIAL,17340,0,17340,58167,0,75507
143320100800000,SW 402,RESIDENTIAL,20400,0,20400,85280,0,105680
143320200100000,SW 402,RESIDENTIAL,20000,0,20000,66525,0,86525
143320200200000,SW 402,RESIDENTIAL,12740,0,12740,63782,0,76522
143320200300000,SW 402,RESIDENTIAL,12012,0,12012,55826,0,67838
143320200400000,SW 402,RESIDENTIAL,12376,0,12376,55585,0,67961
143320200500000,SW 402,RESIDENTIAL,13300,0,13300,52504,0,65804
143320200600000,SW 402,RESIDENTIAL,13300,0,13300,58345,0,71645
143320200700000,SW 402,RESIDENTIAL,25344,0,25344,65983,0,91327
143320200800000,SW 402,RESIDENTIAL,20000,0,20000,39916,0,59916
143320200900000,SW 402,RESIDENTIAL,20000,0,20000,76415,0,96415
143320201000000,SW 402,RESIDENTIAL,20000,0,20000,60493,0,80493
143320300100000,SW 402,RESIDENTIAL,15907,0,15907,70766,0,86673
143320300200000,SW 402,RESIDENTIAL,15907,0,15907,86536,0,102443
143320300300000,SW 402,RESIDENTIAL,15907,0,15907,44705,0,60612
143320300400000,OFFICE,COMMERCIAL,0,21750,21750,0,74008,95758
143320400100000,CITY PROPERTY,EXEMPT,0,0,0,0,0,0
143320400200000,SW 402,RESIDENTIAL,20000,0,20000,44605,0,64605
143320400300000,SW 402,RESIDENTIAL,20000,0,20000,50921,0,70921
143320400400000,SW 402,RESIDENTIAL,20000,0,20000,59230,0,79230
143320400500000,SW 402,RESIDENTIAL,20000,0,20000,62137,0,82137
143320400600000,CITY PROPERTY,EXEMPT,0,0,0,0,0,0
143320400700000,SW 402,RESIDENTIAL,20000,0,20000,33772,0,53772
143320400800000,CONVENIENCE STORE,COMMERCIAL,0,60000,60000,0,275922,335922
143320400900000,FLAT PARKING,COMMERCIAL,0,30000,30000,0,12197,42197
143320401000000,CITY PROPERTY,EXEMPT,0,0,0,0,0,0
143320401100000,SW 402,RESIDENTIAL,18360,0,18360,104984,0,123344
143320500100000,SW 402,RESIDENTIAL,20000,0,20000,64621,0,84621
143320500200000,SW 402,RESIDENTIAL,18200,0,18200,33629,0,51829
143320500300000,SW 402,RESIDENTIAL,18200,0,18200,55622,0,73822
143320500400000,SW 402,RESIDENTIAL,18200,0,18200,64968,0,83168
143320500500000,SW 402,RESIDENTIAL,18200,0,18200,86912,0,105112
143320500600000,SW 402,RESIDENTIAL,21840,0,21840,73268,0,95108
143320500700000,SW 402,RESIDENTIAL,14560,0,14560,43468,0,58028
143320500800000,SW 402,RESIDENTIAL,20000,0,20000,96949,0,116949
143320500900000,CITY PROPERTY,EXEMPT,0,0,0,0,0,0
143320501000000,SW 402,RESIDENTIAL,20000,0,20000,56054,0,76054
143320501100000,SW 402,RESIDENTIAL,20000,0,20000,48407,0,68407
143320501200000,SW 402,RESIDENTIAL,20000,0,20000,29878,0,49878
143320600100000,SW 402,RESIDENTIAL,12250,0,12250,39879,0,52129
143320600200000,CITY PROPERTY,EXEMPT,0,0,0,0,0,0
143320600300000,SW 403,RESIDENTIAL,19080,0,19080,125261,0,144341
143320600400000,SW 402,RESIDENTIAL,14400,0,14400,51595,0,65995
143320600500000,SW 402,RESIDENTIAL,12600,0,12600,48403,0,61003
143320600600000,SW 402,RESIDENTIAL,5000,0,5000,0,0,5000
143320600700000,SW 402,RESIDENTIAL,15907,0,15907,57890,0,73797
143320600800000,SW 402,RESIDENTIAL,15907,0,15907,50685,0,66592
143320700100000,FUNERAL HOME,COMMERCIAL,0,33000,33000,0,238637,271637
143320700200000,FLAT PARKING,COMMERCIAL,0,16000,16000,0,7285,23285
143320700300000,SW 402,RESIDENTIAL,18360,0,18360,0,0,18360
143320700400000,SW 402,RESIDENTIAL,20000,0,20000,74192,0,94192
143320700500000,SW 402,RESIDENTIAL,20000,0,20000,54571,0,74571
143320700600000,SW 402,RESIDENTIAL,20000,0,20000,63393,0,83393
143320700700000,SW 402,RESIDENTIAL,20000,0,20000,94028,0,114028
143320700800000,SW 402,RESIDENTIAL,16200,0,16200,42197,0,58397
143320700900000,SW 402,RESIDENTIAL,20750,0,20750,74194,0,94944
143320701000000,SW 402,RESIDENTIAL,25500,0,25500,83730,0,109230
143320701100000,SW 402,RESIDENTIAL,25500,0,25500,41868,0,67368
143320701200000,SW 402,RESIDENTIAL,25500,0,25500,47414,0,72914
143320800100000,SW 402,RESIDENTIAL,10000,0,10000,0,0,10000
143320800200000,SW 402,RESIDENTIAL,23400,0,23400,43444,0,66844
143320800300000,SW 402,RESIDENTIAL,23400,0,23400,53774,0,77174
143320800400000,SW 402,RESIDENTIAL,23400,0,23400,33375,0,56775
143320800500000,CITY PROPERTY,EXEMPT,0,0,0,0,0,0
143320800600000,SW 402,RESIDENTIAL,23400,0,23400,58429,0,81829
143320800700000,SW 402,RESIDENTIAL,23400,0,23400,59531,0,82931
143320800800000,SW 402,RESIDENTIAL,20000,0,20000,75972,0,95972
143320800900000,SW 402,RESIDENTIAL,20000,0,20000,75350,0,95350
143320801000000,SW 402,RESIDENTIAL,20000,0,20000,62080,0,82080
143320801100000,SW 402,RESIDENTIAL,20000,0,20000,102142,0,122142
143320801200000,SW 402,RESIDENTIAL,20000,0,20000,73911,0,93911
143320900100000,SW 402,RESIDENTIAL,14630,0,14630,65471,0,80101
143320900200000,SW 402,RESIDENTIAL,15840,0,15840,54183,0,70023
143320900300000,SW 402,RESIDENTIAL,14630,0,14630,74305,0,88935
143320900400000,SW 402,RESIDENTIAL,15907,0,15907,60710,0,76617
143320900500000,SW 402,RESIDENTIAL,15907,0,15907,45495,0,61402
143320900600000,APARTMENT,COMMERCIAL,0,28000,28000,0,182069,210069
143321000100000,SW 402,RESIDENTIAL,25500,0,25500,89807,0,115307
143321000200000,SW 402,RESIDENTIAL,30000,0,30000,55514,0,85514
143321000300000,SW 402,RESIDENTIAL,30000,0,30000,66722,0,96722
143321000400000,SW 402,RESIDENTIAL,16000,0,16000,61179,0,77179
143321000500000,SW 402,RESIDENTIAL,16000,0,16000,0,0,16000
143321000600000,SW 402,RESIDENTIAL,25000,0,25000,82082,0,107082
143321000700000,SW 402,RESIDENTIAL,25000,0,25000,62789,0,87789
143321000800000,SW 402,RESIDENTIAL,17500,0,17500,61695,0,79195
143321000900000,SW 402,RESIDENTIAL,18900,0,18900,55661,0,74561
143321001000000,SW 402,RESIDENTIAL,25500,0,25500,45016,0,70516
143321001100000,SW 402,RESIDENTIAL,25500,0,25500,51384,0,76884
143321001200000,SW 402,RESIDENTIAL,25500,0,25500,69942,0,95442
143321001300000,SW 402,RESIDENTIAL,25500,0,25500,69196,0,94696
143321001400000,SW 402,RESIDENTIAL,25500,0,25500,69488,0,94988
143321001500000,SW 402,RESIDENTIAL,25500,0,25500,97509,0,123009
143321100100000,SW 402,RESIDENTIAL,25000,0,25000,108905,0,133905
143321100200000,SW 402,RESIDENTIAL,15840,0,15840,38537,0,54377
143321100300000,SW 402,RESIDENTIAL,15840,0,15840,28466,0,44306
143321100400000,SW 402,RESIDENTIAL,15840,0,15840,38673,0,54513
143321100500000,SW 402,RESIDENTIAL,15840,0,15840,41955,0,57795
143321100600000,SW 402,RESIDENTIAL,23400,0,23400,95027,0,118427
143321100700000,SW 402,RESIDENTIAL,23400,0,23400,66282,0,89682
143321100800000,SW 402,RESIDENTIAL,23400,0,23400,20898,0,44298
143321100900000,SW 402,RESIDENTIAL,23400,0,23400,33232,0,56632
143321101000000,SW 402,RESIDENTIAL,23400,0,23400,89146,0,112546
143321101100000,SW 402,RESIDENTIAL,25000,0,25000,70555,0,95555
143321101200000,SW 402,RESIDENTIAL,25000,0,25000,47769,0,72769
143321101300000,SW 402,RESIDENTIAL,25000,0,25000,73927,0,98927
143321101400000,SW 402,RESIDENTIAL,25000,0,25000,68863,0,93863
143321101500000,SW 402,RESIDENTIAL,25000,0,25000,67144,0,92144
143321101600000,SW 402,RESIDENTIAL,25000,0,25000,61166,0,86166
143321200100000,SW 402,RESIDENTIAL,15907,0,15907,50708,0,66615
143321200200000,SW 402,RESIDENTIAL,17675,0,17675,69052,0,86727
143321200300000,SW 402,RESIDENTIAL,17675,0,17675,68230,0,85905
143321200400000,SW 402,RESIDENTIAL,15907,0,15907,73203,0,89110
143322600100000,SW 403,RESIDENTIAL,20655,0,20655,39031,0,59686
143322600200000,SW 403,RESIDENTIAL,15147,0,15147,51426,0,66573
143322600300000,SW 403,RESIDENTIAL,19989,0,19989,88528,0,108517
143322600400000,SW 403,RESIDENTIAL,20655,0,20655,62907,0,83562
143322600500000,SW 403,RESIDENTIAL,20655,0,20655,66383,0,87038
143322600600000,SW 403,RESIDENTIAL,19035,0,19035,59900,0,78935
143322600700000,SW 403,RESIDENTIAL,21171,0,21171,43435,0,64606
143322600800000,SW 403,RESIDENTIAL,20655,0,20655,57201,0,77856
143322700100000,SW 403,RESIDENTIAL,18180,0,18180,67869,0,86049
143322700200000,SW 403,RESIDENTIAL,18180,0,18180,65549,0,83729
143322700300000,SW 403,RESIDENTIAL,18180,0,18180,59404,0,77584
143322700400000,SW 403,RESIDENTIAL,18180,0,18180,58543,0,76723
143322700500000,SW 403,RESIDENTIAL,18180,0,18180,72810,0,90990
143322700600000,SW 403,RESIDENTIAL,18180,0,18180,54600,0,72780
143322700700000,SW 403,RESIDENTIAL,18180,0,18180,51406,0,69586
143322700800000,SW 403,RESIDENTIAL,18180,0,18180,65466,0,83646
143322700900000,SW 403,RESIDENTIAL,18180,0,18180,53330,0,71510
143322701000000,SW 403,RESIDENTIAL,18180,0,18180,52425,0,70605
143322900100000,SW 403,RESIDENTIAL,25245,0,25245,79989,0,105234
143322900200000,SW 403,RESIDENTIAL,21256,0,21256,37435,0,58691
143322900300000,SW 403,RESIDENTIAL,20304,0,20304,44520,0,64824
143322900400000,SW 403,RESIDENTIAL,20655,0,20655,62375,0,83030
143322900500000,SW 403,RESIDENTIAL,20655,0,20655,87267,0,107922
143322900600000,SW 403,RESIDENTIAL,20655,0,20655,71790,0,92445
143322900700000,SW 403,RESIDENTIAL,20655,0,20655,65698,0,86353
143322900800000,SW 403,RESIDENTIAL,20655,0,20655,68467,0,89122
143322900900000,SW 403,RESIDENTIAL,20655,0,20655,55937,0,76592
143322901000000,SW 403,RESIDENTIAL,20655,0,20655,102310,0,122965
143322901100000,SW 403,RESIDENTIAL,20655,0,20655,51908,0,72563
143323000100000,CITY PROPERTY,EXEMPT,0,0,0,0,0,0
143323000200000,SW 403,RESIDENTIAL,18900,0,18900,40660,0,59560
143323000300000,SW 403,RESIDENTIAL,18900,0,18900,75913,0,94813
143323000400000,SW 403,RESIDENTIAL,18900,0,18900,57300,0,76200
143323000500000,CITY PROPERTY,EXEMPT,0,0,0,0,0,0
143323000600000,SW 403,RESIDENTIAL,18900,0,18900,62879,0,81779
143323000700000,SW 403,RESIDENTIAL,18900,0,18900,60215,0,79115
143323000800000,SW 403,RESIDENTIAL,22680,0,22680,61046,0,83726
143323000900000,SW 403,RESIDENTIAL,16380,0,16380,45639,0,62019
143323001000000,SW 403,RESIDENTIAL,18612,0,18612,53714,0,72326
143323001100000,SW 403,RESIDENTIAL,18612,0,18612,44125,0,62737
143323001200000,SW 403,RESIDENTIAL,15908,0,15908,49817,0,65725
143323001300000,SW 403,RESIDENTIAL,19089,0,19089,76409,0,95498
143323001400000,SW 403,RESIDENTIAL,19544,0,19544,75433,0,94977
143323100100000,SW 403,RESIDENTIAL,20884,0,20884,104505,0,125389
143323100200000,STATE PROPERTY,EXEMPT,0,0,0,0,0,0
143323100300000,SW 403,RESIDENTIAL,20884,0,20884,76222,0,97106
143323100400000,FAST FOOD,COMMERCIAL,0,102000,102000,0,514175,616175
143323100500000,FLAT PARKING,COMMERCIAL,0,70750,70750,0,9307,80057
143323100600000,SW 403,RESIDENTIAL,18036,0,18036,61849,0,79885
143323100700000,SW 403,RESIDENTIAL,18360,0,18360,59952,0,78312
143323100800000,SW 403,RESIDENTIAL,17548,0,17548,65448,0,82996
143323100900000,SW 403,RESIDENTIAL,17548,0,17548,37659,0,55207
143323101000000,SW 403,RESIDENTIAL,18360,0,18360,64451,0,82811
143323101100000,SW 403,RESIDENTIAL,18537,0,18537,49853,0,68390
143323200100000,SW 403,RESIDENTIAL,20655,0,20655,65489,0,86144
143323200200000,SW 403,RESIDENTIAL,20655,0,20655,60117,0,80772
143323200300000,SW 403,RESIDENTIAL,20655,0,20655,72731,0,93386
143323200400000,SW 403,RESIDENTIAL,20655,0,20655,92280,0,112935
143323200500000,SW 403,RESIDENTIAL,20655,0,20655,54161,0,74816
143323200600000,SW 403,RESIDENTIAL,18360,0,18360,60373,0,78733
143323200700000,SW 403,RESIDENTIAL,22032,0,22032,67854,0,89886
143323200800000,SW 403,RESIDENTIAL,20655,0,20655,63224,0,83879
143323200900000,SW 403,RESIDENTIAL,20655,0,20655,50096,0,70751
143323201000000,SW 403,RESIDENTIAL,20655,0,20655,65398,0,86053
143323201100000,SW 403,RESIDENTIAL,20655,0,20655,54881,0,75536
143323201200000,SW 403,RESIDENTIAL,20655,0,20655,50585,0,71240
143323300100000,SW 403,RESIDENTIAL,20655,0,20655,42897,0,63552
143323300200000,SW 403,RESIDENTIAL,20655,0,20655,28327,0,48982
143323300300000,SW 403,RESIDENTIAL,22950,0,22950,57026,0,79976
143323300400000,SW 403,RESIDENTIAL,20655,0,20655,41779,0,62434
143323300500000,SW 403,RESIDENTIAL,730,0,730,0,0,730
143323300600000,SW 403,RESIDENTIAL,20655,0,20655,43187,0,63842
143323300700000,SW 403,RESIDENTIAL,20655,0,20655,57081,0,77736
143323300800000,SW 403,RESIDENTIAL,23452,0,23452,71243,0,94695
143323300900000,SW 403,RESIDENTIAL,19430,0,19430,61689,0,81119
143323301000000,SW 403,RESIDENTIAL,18180,0,18180,90534,0,108714
143323301100000,SW 403,RESIDENTIAL,19544,0,19544,67166,0,86710
143323301200000,SW 403,RESIDENTIAL,23452,0,23452,88738,0,112190
143323301300000,SW 403,RESIDENTIAL,22680,0,22680,56897,0,79577
143323301400000,SW 403,RESIDENTIAL,2520,0,2520,0,0,2520
143323301500000,SW 403,RESIDENTIAL,2520,0,2520,0,0,2520
143323301600000,SW 403,RESIDENTIAL,18900,0,18900,47737,0,66637
143323301700000,SW 403,RESIDENTIAL,18900,0,18900,50462,0,69362
143323301800000,SW 403,RESIDENTIAL,18900,0,18900,49212,0,68112
143323301900000,SW 403,RESIDENTIAL,18900,0,18900,40800,0,59700
143323302000000,SW 403,RESIDENTIAL,17905,0,17905,46435,0,64340
143323302100000,SW 403,RESIDENTIAL,17640,0,17640,46520,0,64160
143323302200000,SW 403,RESIDENTIAL,21168,0,21168,62908,0,84076
143323302300000,SW 403,RESIDENTIAL,21168,0,21168,58843,0,80011
143323302400000,SW 403,RESIDENTIAL,20014,0,20014,55180,0,75194
143323302500000,SW 403,RESIDENTIAL,17640,0,17640,63950,0,81590
143323302600000,SW 403,RESIDENTIAL,24410,0,24410,139252,0,163662
143323302700000,SW 403,RESIDENTIAL,20617,0,20617,65824,0,86441
143323302800000,SW 403,RESIDENTIAL,17640,0,17640,0,0,17640
143323303100000,SMALL RETAIL,COMMERCIAL,0,59880,59880,0,118688,178568
143325100100000,CITY PROPERTY,EXEMPT,0,0,0,0,0,0
143325100200000,CONVENIENCE STORE,COMMERCIAL,0,399000,399000,0,344036,743036
143325100300000,FUNERAL HOME,COMMERCIAL,0,219200,219200,0,715827,935027
143325100400000,FLAT PARKING,COMMERCIAL,0,131200,131200,0,50078,181278
143325100500000,SW 403,RESIDENTIAL,24327,0,24327,85488,0,109815
143325100600000,SW 403,RESIDENTIAL,23513,0,23513,67071,0,90584
143325100700000,SW 403,RESIDENTIAL,23513,0,23513,40241,0,63754
143325100800000,SW 403,RESIDENTIAL,23571,0,23571,66760,0,90331
143325100900000,SW 403,RESIDENTIAL,23571,0,23571,85208,0,108779
143325101000000,SW 403,RESIDENTIAL,25700,0,25700,65669,0,91369
143325101100000,SW 403,RESIDENTIAL,24109,0,24109,39863,0,63972
143325101200000,SW 403,RESIDENTIAL,23436,0,23436,46518,0,69954
143325101300000,SW 403,RESIDENTIAL,23436,0,23436,59903,0,83339
143325101400000,SW 403,RESIDENTIAL,23436,0,23436,65475,0,88911
143325101500000,SW 403,RESIDENTIAL,23436,0,23436,90758,0,114194
143325200100000,SW 403,RESIDENTIAL,18450,0,18450,63311,0,81761
143325200200000,SW 403,RESIDENTIAL,19710,0,19710,62942,0,82652
143325200300000,SW 403,RESIDENTIAL,22140,0,22140,37038,0,59178
143325200400000,SW 403,RESIDENTIAL,22140,0,22140,55545,0,77685
143325200500000,SW 403,RESIDENTIAL,22783,0,22783,58126,0,80909
143325200600000,SW 403,RESIDENTIAL,22771,0,22771,51588,0,74359
143325200700000,SW 403,RESIDENTIAL,22140,0,22140,53542,0,75682
143325200800000,SW 403,RESIDENTIAL,22140,0,22140,64000,0,86140
143325200900000,SW 403,RESIDENTIAL,24300,0,24300,74580,0,98880
143325201000000,SW 403,RESIDENTIAL,18450,0,18450,63481,0,81931
143327600100000,SW 412,RESIDENTIAL,22109,0,22109,82588,0,104697
143327600200000,SW 412,RESIDENTIAL,11900,0,11900,33144,0,45044
143327600300000,SW 412,RESIDENTIAL,17990,0,17990,62571,0,80561
143327600400000,SW 412,RESIDENTIAL,17000,0,17000,69879,0,86879
143327600500000,SW 412,RESIDENTIAL,17000,0,17000,103432,0,120432
143327600600000,SW 412,RESIDENTIAL,17000,0,17000,53820,0,70820
143327600700000,SW 412,RESIDENTIAL,17000,0,17000,65207,0,82207
143327600800000,SW 412,RESIDENTIAL,17000,0,17000,86866,0,103866
143327600900000,SW 412,RESIDENTIAL,21675,0,21675,80969,0,102644
143327601000000,SW 412,RESIDENTIAL,22109,0,22109,113721,0,135830
143327601100000,SW 412,RESIDENTIAL,17340,0,17340,80983,0,98323
143327601200000,SW 412,RESIDENTIAL,17340,0,17340,112581,0,129921
143327601300000,SW 412,RESIDENTIAL,17340,0,17340,77489,0,94829
143327601400000,SW 412,RESIDENTIAL,17340,0,17340,48788,0,66128
143327601500000,SW 412,RESIDENTIAL,17340,0,17340,106568,0,123908
143327700100000,SW 412,RESIDENTIAL,21675,0,21675,77166,0,98841
143327700200000,SW 412,RESIDENTIAL,17850,0,17850,72490,0,90340
143327700300000,SW 412,RESIDENTIAL,19665,0,19665,87385,0,107050
143327700400000,SW 412,RESIDENTIAL,18009,0,18009,67383,0,85392
143327700500000,SW 412,RESIDENTIAL,18720,0,18720,80587,0,99307
143327700600000,SW 412,RESIDENTIAL,18720,0,18720,89271,0,107991
143327700700000,SW 412,RESIDENTIAL,18720,0,18720,79570,0,98290
143327700800000,SW 412,RESIDENTIAL,18720,0,18720,92525,0,111245
143327700900000,SW 412,RESIDENTIAL,23868,0,23868,43273,0,67141
143327701000000,SW 412,RESIDENTIAL,21675,0,21675,109297,0,130972
143327701100000,SW 412,RESIDENTIAL,17000,0,17000,85048,0,102048
143327701200000,SW 412,RESIDENTIAL,17000,0,17000,65920,0,82920
143327701300000,SW 412,RESIDENTIAL,17000,0,17000,85323,0,102323
143327701400000,SW 412,RESIDENTIAL,17000,0,17000,91653,0,108653
143327701500000,SW 412,RESIDENTIAL,17000,0,17000,80514,0,97514
143327800100000,SW 412,RESIDENTIAL,26010,0,26010,57262,0,83272
143327800200000,SW 412,RESIDENTIAL,28384,0,28384,50929,0,79313
143327800300000,SW 412,RESIDENTIAL,26648,0,26648,123318,0,149966
143327800400000,SW 412,RESIDENTIAL,25500,0,25500,48507,0,74007
143327800500000,SW 412,RESIDENTIAL,25500,0,25500,106110,0,131610
143327800600000,SW 412,RESIDENTIAL,25500,0,25500,83653,0,109153
143327800700000,SW 412,RESIDENTIAL,17340,0,17340,103125,0,120465
143327800800000,SW 412,RESIDENTIAL,17340,0,17340,76422,0,93762
143327800900000,SW 412,RESIDENTIAL,17340,0,17340,39668,0,57008
143327801000000,SW 412,RESIDENTIAL,26010,0,26010,14841,0,40851
143327801100000,SW 412,RESIDENTIAL,26010,0,26010,71225,0,97235
143327900100000,SW 412,RESIDENTIAL,23205,0,23205,60834,0,84039
143327900200000,SW 412,RESIDENTIAL,9207,0,9207,21843,0,31050
143327900300000,SW 412,RESIDENTIAL,28080,0,28080,34938,0,63018
143327900400000,SW 412,RESIDENTIAL,28080,0,28080,80542,0,108622
143327900500000,SW 412,RESIDENTIAL,28080,0,28080,32429,0,60509
143327900600000,SW 412,RESIDENTIAL,18720,0,18720,63067,0,81787
143327900700000,SW 412,RESIDENTIAL,18720,0,18720,64596,0,83316
143327900800000,SW 412,RESIDENTIAL,18720,0,18720,49179,0,67899
143327900900000,SW 412,RESIDENTIAL,25500,0,25500,97163,0,122663
143327901000000,SW 412,RESIDENTIAL,30600,0,30600,56231,0,86831
143327901100000,SW 412,RESIDENTIAL,12750,0,12750,48042,0,60792
143327901200000,SW 412,RESIDENTIAL,12750,0,12750,65909,0,78659
143327901300000,SW 412,RESIDENTIAL,12750,0,12750,58225,0,70975
143328000100000,SW 412,RESIDENTIAL,20790,0,20790,72068,0,92858
143328000200000,SW 412,RESIDENTIAL,20790,0,20790,86327,0,107117
143328000300000,SW 412,RESIDENTIAL,21829,0,21829,107317,0,129146
143328000400000,SW 412,RESIDENTIAL,20790,0,20790,95098,0,115888
143328000500000,SW 412,RESIDENTIAL,20790,0,20790,74296,0,95086
143328000600000,SW 412,RESIDENTIAL,22523,0,22523,49943,0,72466
143328000700000,SW 412,RESIDENTIAL,19058,0,19058,71552,0,90610
143328000800000,SW 412,RESIDENTIAL,20790,0,20790,47058,0,67848
143328000900000,SW 412,RESIDENTIAL,23562,0,23562,151718,0,175280
143328100100000,SW 412,RESIDENTIAL,28177,0,28177,104581,0,132758
143328100200000,SW 412,RESIDENTIAL,17000,0,17000,53682,0,70682
143328100300000,SW 412,RESIDENTIAL,27200,0,27200,92099,0,119299
143328100500000,SW 412,RESIDENTIAL,20188,0,20188,84306,0,104494
143328100600000,SW 412,RESIDENTIAL,22440,0,22440,92161,0,114601
143328100700000,SW 412,RESIDENTIAL,22440,0,22440,92183,0,114623
143328100800000,SW 412,RESIDENTIAL,13872,0,13872,0,0,13872
143328100900000,SW 412,RESIDENTIAL,13872,0,13872,94406,0,108278
143328101000000,SW 412,RESIDENTIAL,22950,0,22950,96125,0,119075
143328101100000,SW 412,RESIDENTIAL,25075,0,25075,7840,0,32915
143328101200000,SW 412,RESIDENTIAL,25075,0,25075,71315,0,96390
143328200100000,SW 412,RESIDENTIAL,22950,0,22950,118691,0,141641
143328200200000,SW 412,RESIDENTIAL,25272,0,25272,78328,0,103600
143328200300000,SW 412,RESIDENTIAL,25272,0,25272,73364,0,98636
143328200400000,SW 412,RESIDENTIAL,25272,0,25272,83308,0,108580
143328200500000,SW 412,RESIDENTIAL,25840,0,25840,47154,0,72994
143328200600000,SW 412,RESIDENTIAL,25840,0,25840,75901,0,101741
143328200700000,SW 412,RESIDENTIAL,22950,0,22950,122575,0,145525
143328200800000,SW 412,RESIDENTIAL,22950,0,22950,68172,0,91122
143328200900000,SW 412,RESIDENTIAL,22950,0,22950,97367,0,120317
143328201000000,SW 412,RESIDENTIAL,22950,0,22950,67838,0,90788
143328300100000,SW 412,RESIDENTIAL,15173,0,15173,79259,0,94432
143328300200000,SW 412,RESIDENTIAL,22610,0,22610,102793,0,125403
143328300300000,SW 412,RESIDENTIAL,19380,0,19380,77529,0,96909
143328300400000,SW 412,RESIDENTIAL,19380,0,19380,83191,0,102571
143328300500000,SW 412,RESIDENTIAL,16150,0,16150,90719,0,106869
143328300600000,SW 412,RESIDENTIAL,16150,0,16150,67208,0,83358
143328300700000,SW 412,RESIDENTIAL,16150,0,16150,90434,0,106584
143328300800000,SW 412,RESIDENTIAL,16150,0,16150,71487,0,87637
143328300900000,SW 412,RESIDENTIAL,23256,0,23256,84324,0,107580
143328301000000,SW 412,RESIDENTIAL,22253,0,22253,93109,0,115362
143328301100000,SW 412,RESIDENTIAL,19168,0,19168,75821,0,94989
143328301200000,SW 412,RESIDENTIAL,19152,0,19152,113543,0,132695
143328301300000,SW 412,RESIDENTIAL,13300,0,13300,74760,0,88060
143328301400000,SW 412,RESIDENTIAL,13300,0,13300,96372,0,109672
143328301500000,SW 412,RESIDENTIAL,14630,0,14630,85416,0,100046
143328301600000,SW 412,RESIDENTIAL,14630,0,14630,87370,0,102000
143328301700000,SW 412,RESIDENTIAL,14630,0,14630,78849,0,93479
143328301800000,SW 412,RESIDENTIAL,14630,0,14630,77300,0,91930
143328301900000,SW 412,RESIDENTIAL,15960,0,15960,91682,0,107642
143328302000000,SW 412,RESIDENTIAL,16660,0,16660,70617,0,87277
143328302100000,SW 412,RESIDENTIAL,16456,0,16456,53419,0,69875
143328302200000,SW 412,RESIDENTIAL,12566,0,12566,0,0,12566
143328302300000,SW 412,RESIDENTIAL,17340,0,17340,85941,0,103281
143328400100000,SW 412,RESIDENTIAL,21418,0,21418,86476,0,107894
143328400200000,SW 412,RESIDENTIAL,23644,0,23644,118032,0,141676
143330100100000,SW 416,RESIDENTIAL,50129,0,50129,140920,0,191049
143330100200000,SW 416,RESIDENTIAL,22470,0,22470,105054,0,127524
143330100300000,SW 416,RESIDENTIAL,27776,0,27776,70861,0,98637
143330100400000,SW 416,RESIDENTIAL,2730,0,2730,42878,0,45608
143330100500000,SW 416,RESIDENTIAL,14980,0,14980,85130,0,100110
143330100600000,SW 416,RESIDENTIAL,18725,0,18725,72136,0,90861
143330100700000,SW 416,RESIDENTIAL,18725,0,18725,99719,0,118444
143330100800000,SW 416,RESIDENTIAL,22470,0,22470,82091,0,104561
143330100900000,SW 416,RESIDENTIAL,26215,0,26215,107490,0,133705
143330101000000,SW 416,RESIDENTIAL,25970,0,25970,63690,0,89660
143330101100000,SW 416,RESIDENTIAL,29680,0,29680,67177,0,96857
143330101200000,SW 416,RESIDENTIAL,18550,0,18550,90545,0,109095
143330101300000,SW 416,RESIDENTIAL,26434,0,26434,41195,0,67629
143330101400000,SW 416,RESIDENTIAL,26434,0,26434,82168,0,108602
143330101500000,SW 416,RESIDENTIAL,18550,0,18550,76713,0,95263
143330101600000,SW 416,RESIDENTIAL,18550,0,18550,95584,0,114134
143330101700000,SW 416,RESIDENTIAL,18550,0,18550,114611,0,133161
143330101800000,SW 416,RESIDENTIAL,18550,0,18550,99392,0,117942
143330101900000,SW 416,RESIDENTIAL,15330,0,15330,75949,0,91279
143330102000000,SW 416,RESIDENTIAL,26068,0,26068,79616,0,105684
143330102100000,SW 416,RESIDENTIAL,26705,0,26705,95258,0,121963
143330102200000,SW 416,RESIDENTIAL,26705,0,26705,99294,0,125999
143330200100000,SW 417,RESIDENTIAL,28058,0,28058,80577,0,108635
143330200200000,SW 417,RESIDENTIAL,20160,0,20160,94806,0,114966
143330200300000,SW 417,RESIDENTIAL,21470,0,21470,128253,0,149723
143330300100000,SW 416,RESIDENTIAL,19744,0,19744,130147,0,149891
143330300200000,SW 416,RESIDENTIAL,22260,0,22260,108115,0,130375
143330300300000,SW 416,RESIDENTIAL,18550,0,18550,77563,0,96113
143330300400000,SW 416,RESIDENTIAL,18550,0,18550,101131,0,119681
143330300500000,SW 416,RESIDENTIAL,18550,0,18550,86375,0,104925
143330300600000,SW 416,RESIDENTIAL,18550,0,18550,97916,0,116466
143330300700000,SW 416,RESIDENTIAL,27825,0,27825,98901,0,126726
143330300800000,SW 416,RESIDENTIAL,18550,0,18550,81754,0,100304
143330300900000,SW 416,RESIDENTIAL,15400,0,15400,81428,0,96828
143330301000000,SW 416,RESIDENTIAL,26180,0,26180,86437,0,112617
143330301100000,SW 416,RESIDENTIAL,26075,0,26075,106079,0,132154
143330301200000,SW 416,RESIDENTIAL,20370,0,20370,81516,0,101886
143330301300000,SW 416,RESIDENTIAL,20370,0,20370,88083,0,108453
143330301400000,SW 416,RESIDENTIAL,20370,0,20370,110259,0,130629
143330301500000,SW 416,RESIDENTIAL,20370,0,20370,75927,0,96297
143330301600000,SW 416,RESIDENTIAL,20370,0,20370,88601,0,108971
143330301700000,SW 416,RESIDENTIAL,20370,0,20370,97657,0,118027
143330301800000,SW 416,RESIDENTIAL,20370,0,20370,74390,0,94760
143330301900000,SW 416,RESIDENTIAL,20370,0,20370,87257,0,107627
143330302000000,SW 416,RESIDENTIAL,20370,0,20370,109771,0,130141
143330302100000,SW 416,RESIDENTIAL,21210,0,21210,77010,0,98220
143330302200000,SW 416,RESIDENTIAL,26424,0,26424,88427,0,114851
143330302300000,SW 416,RESIDENTIAL,23765,0,23765,83898,0,107663
143330302400000,SW 416,RESIDENTIAL,18333,0,18333,57503,0,75836
143330400100000,SW 417,RESIDENTIAL,21840,0,21840,114212,0,136052
143330400200000,SW 417,RESIDENTIAL,19456,0,19456,116366,0,135822
143330400300000,SW 417,RESIDENTIAL,18720,0,18720,69973,0,88693
143330500100000,SW 416,RESIDENTIAL,23765,0,23765,89272,0,113037
143330500200000,SW 416,RESIDENTIAL,26277,0,26277,81292,0,107569
143330500300000,SW 416,RESIDENTIAL,20370,0,20370,54219,0,74589
143330500400000,SW 416,RESIDENTIAL,27160,0,27160,107130,0,134290
143330500500000,SW 416,RESIDENTIAL,24103,0,24103,81646,0,105749
143330500600000,SW 416,RESIDENTIAL,22750,0,22750,91272,0,114022
143330500700000,SW 416,RESIDENTIAL,24500,0,24500,104947,0,129447
143330500800000,SW 416,RESIDENTIAL,21000,0,21000,78372,0,99372
143330500900000,SW 416,RESIDENTIAL,24500,0,24500,113666,0,138166
143330501000000,SW 416,RESIDENTIAL,29584,0,29584,91218,0,120802
143330501100000,SW 416,RESIDENTIAL,26294,0,26294,97513,0,123807
143330501200000,SW 416,RESIDENTIAL,32248,0,32248,139858,0,172106
143330600100000,SW 416,RESIDENTIAL,25802,0,25802,88020,0,113822
143330600200000,SW 416,RESIDENTIAL,20370,0,20370,89087,0,109457
143330600300000,SW 416,RESIDENTIAL,20370,0,20370,106212,0,126582
143330600400000,SW 416,RESIDENTIAL,20370,0,20370,85400,0,105770
143330600500000,SW 416,RESIDENTIAL,20370,0,20370,86971,0,107341
143330600600000,SW 416,RESIDENTIAL,23180,0,23180,556,0,23736
143330600700000,SW 416,RESIDENTIAL,22848,0,22848,99097,0,121945
143330600800000,SW 416,RESIDENTIAL,22848,0,22848,157538,0,180386
143330600900000,SW 416,RESIDENTIAL,22848,0,22848,115733,0,138581
143330601000000,SW 416,RESIDENTIAL,26887,0,26887,127686,0,154573
143330601100000,SW 416,RESIDENTIAL,31020,0,31020,312573,0,343593
143330601200000,SW 416,RESIDENTIAL,21210,0,21210,8308,0,29518
143330601300000,SW 416,RESIDENTIAL,24745,0,24745,85323,0,110068
143330601400000,SW 416,RESIDENTIAL,24098,0,24098,86961,0,111059
143330700100000,SW 417,RESIDENTIAL,18720,0,18720,97060,0,115780
143330700200000,SW 417,RESIDENTIAL,19501,0,19501,131938,0,151439
143330700300000,SW 417,RESIDENTIAL,33051,0,33051,113940,0,146991
143330700400000,SW 417,RESIDENTIAL,29769,0,29769,100594,0,130363
143330700500000,SW 417,RESIDENTIAL,27495,0,27495,86939,0,114434
143332600100000,SW 417,RESIDENTIAL,20446,0,20446,77440,0,97886
143332600200000,SW 417,RESIDENTIAL,19729,0,19729,88410,0,108139
143332600300000,SW 417,RESIDENTIAL,23052,0,23052,98894,0,121946
143332600400000,SW 417,RESIDENTIAL,22035,0,22035,114036,0,136071
143332600500000,SW 417,RESIDENTIAL,16920,0,16920,63982,0,80902
143332600600000,SW 417,RESIDENTIAL,20785,0,20785,55837,0,76622
143332600700000,SW 417,RESIDENTIAL,17100,0,17100,51434,0,68534
143332600800000,SW 417,RESIDENTIAL,19620,0,19620,58345,0,77965
143332600900000,SW 417,RESIDENTIAL,20748,0,20748,57198,0,77946
143332601000000,SW 417,RESIDENTIAL,19553,0,19553,53923,0,73476
143332601100000,SW 417,RESIDENTIAL,18360,0,18360,66465,0,84825
143332700100000,SW 417,RESIDENTIAL,18360,0,18360,70708,0,89068
143332700200000,SW 417,RESIDENTIAL,18360,0,18360,64390,0,82750
143332700300000,SW 417,RESIDENTIAL,18360,0,18360,74108,0,92468
143332700400000,SW 417,RESIDENTIAL,18360,0,18360,95700,0,114060
143332700500000,SW 417,RESIDENTIAL,18360,0,18360,75014,0,93374
143332800100000,SW 417,RESIDENTIAL,18720,0,18720,94707,0,113427
143332800200000,SW 417,RESIDENTIAL,19918,0,19918,60630,0,80548
143332800300000,CITY PROPERTY,EXEMPT,0,0,0,0,0,0
143332800400000,SW 417,RESIDENTIAL,20880,0,20880,95782,0,116662
143332800500000,SERVICE STATION,COMMERCIAL,0,135225,135225,0,51888,187113
143332800600000,SW 417,RESIDENTIAL,17380,0,17380,54767,0,72147
143332800700000,SW 417,RESIDENTIAL,17856,0,17856,73313,0,91169
143332800800000,SW 417,RESIDENTIAL,18711,0,18711,51890,0,70601
143332800900000,SW 417,RESIDENTIAL,16929,0,16929,55693,0,72622
143332801000000,SW 417,RESIDENTIAL,16929,0,16929,82403,0,99332
143332801100000,SW 417,RESIDENTIAL,16929,0,16929,106618,0,123547
143332801200000,SW 417,RESIDENTIAL,16929,0,16929,53864,0,70793
143332801300000,SW 417,RESIDENTIAL,17694,0,17694,60284,0,77978
143332801400000,SW 417,RESIDENTIAL,17784,0,17784,55964,0,73748
143332801500000,SW 417,RESIDENTIAL,18720,0,18720,49770,0,68490
143332900100000,SW 417,RESIDENTIAL,19594,0,19594,84091,0,103685
143332900200000,SW 417,RESIDENTIAL,17460,0,17460,78250,0,95710
143332900300000,SW 417,RESIDENTIAL,17460,0,17460,67697,0,85157
143332900400000,SW 417,RESIDENTIAL,17460,0,17460,63244,0,80704
143332900500000,SW 417,RESIDENTIAL,19061,0,19061,76643,0,95704
143333000100000,SW 417,RESIDENTIAL,19186,0,19186,66586,0,85772
143333000200000,SW 417,RESIDENTIAL,19285,0,19285,56682,0,75967
143333000300000,SW 417,RESIDENTIAL,19190,0,19190,67558,0,86748
143333000400000,SW 417,RESIDENTIAL,19800,0,19800,62275,0,82075
143333000500000,SW 417,RESIDENTIAL,20273,0,20273,61406,0,81679
143333000600000,SW 417,RESIDENTIAL,16920,0,16920,59218,0,76138
143333000700000,SW 417,RESIDENTIAL,16920,0,16920,62453,0,79373
143333000800000,SW 417,RESIDENTIAL,16920,0,16920,55440,0,72360
143333000900000,SW 417,RESIDENTIAL,16920,0,16920,52480,0,69400
143333001000000,SW 417,RESIDENTIAL,19494,0,19494,60244,0,79738
143333001100000,SW 417,RESIDENTIAL,20880,0,20880,85424,0,106304
143333001200000,SW 417,RESIDENTIAL,19902,0,19902,67702,0,87604
143333001300000,SW 417,RESIDENTIAL,20088,0,20088,63304,0,83392
143333001400000,SW 417,RESIDENTIAL,16920,0,16920,66863,0,83783
143333001500000,SW 417,RESIDENTIAL,16920,0,16920,66721,0,83641
143333001600000,SW 417,RESIDENTIAL,17912,0,17912,71145,0,89057
143333001700000,SW 417,RESIDENTIAL,19156,0,19156,69311,0,88467
143333001800000,SW 417,RESIDENTIAL,19843,0,19843,73033,0,92876
143333001900000,SW 417,RESIDENTIAL,20790,0,20790,62966,0,83756
143333002000000,SW 417,RESIDENTIAL,19725,0,19725,75106,0,94831
143333002100000,SW 417,RESIDENTIAL,19129,0,19129,67487,0,86616
143333002200000,SW 417,RESIDENTIAL,16920,0,16920,61947,0,78867
143333002300000,SW 417,RESIDENTIAL,16920,0,16920,72307,0,89227
143333002400000,SW 417,RESIDENTIAL,16920,0,16920,64813,0,81733
143333002500000,SW 417,RESIDENTIAL,19525,0,19525,85393,0,104918
143333002600000,SW 417,RESIDENTIAL,19458,0,19458,51376,0,70834
143333002700000,SW 417,RESIDENTIAL,20530,0,20530,81996,0,102526
143333002800000,SW 417,RESIDENTIAL,19966,0,19966,56695,0,76661
143333002900000,SW 417,RESIDENTIAL,16920,0,16920,63522,0,80442
143333003000000,SW 417,RESIDENTIAL,16920,0,16920,55189,0,72109
143333003100000,SW 417,RESIDENTIAL,16920,0,16920,63764,0,80684
143333003200000,SW 417,RESIDENTIAL,16920,0,16920,61723,0,78643
143333003300000,SW 417,RESIDENTIAL,16920,0,16920,72807,0,89727
143333003400000,SW 417,RESIDENTIAL,19104,0,19104,53460,0,72564
143333100100000,SW 417,RESIDENTIAL,21055,0,21055,85875,0,106930
143333100200000,SW 417,RESIDENTIAL,19944,0,19944,77012,0,96956
143333100300000,SW 417,RESIDENTIAL,18895,0,18895,46610,0,65505
143333100400000,SW 417,RESIDENTIAL,18360,0,18360,80455,0,98815
143333100500000,SW 417,RESIDENTIAL,18360,0,18360,56603,0,74963
143333100600000,SW 417,RESIDENTIAL,19845,0,19845,53271,0,73116
143333100700000,SW 417,RESIDENTIAL,19536,0,19536,58051,0,77587
143333100800000,SW 417,RESIDENTIAL,20104,0,20104,64427,0,84531
143333100900000,SW 417,RESIDENTIAL,16125,0,16125,94106,0,110231
143333101000000,SW 417,RESIDENTIAL,17776,0,17776,67966,0,85742
143333101100000,SW 417,RESIDENTIAL,19908,0,19908,77274,0,97182
143333101200000,SW 417,RESIDENTIAL,19421,0,19421,74231,0,93652
143333101300000,SW 417,RESIDENTIAL,19110,0,19110,65391,0,84501
143333101400000,SW 417,RESIDENTIAL,19364,0,19364,59799,0,79163
143333101500000,SW 417,RESIDENTIAL,19785,0,19785,52995,0,72780
143333101600000,SW 417,RESIDENTIAL,18315,0,18315,56362,0,74677
143333101700000,SW 417,RESIDENTIAL,17820,0,17820,59175,0,76995
143333101800000,SW 417,RESIDENTIAL,18899,0,18899,62827,0,81726
143333101900000,SW 417,RESIDENTIAL,20235,0,20235,74212,0,94447
143333102000000,SW 417,RESIDENTIAL,18190,0,18190,95497,0,113687
143333102100000,SW 417,RESIDENTIAL,20360,0,20360,69282,0,89642
143333102200000,SW 417,RESIDENTIAL,20748,0,20748,59048,0,79796
143333102300000,SW 417,RESIDENTIAL,19500,0,19500,49956,0,69456
143333200100000,SW 417,RESIDENTIAL,17256,0,17256,60096,0,77352
143333200200000,SW 417,RESIDENTIAL,17460,0,17460,57565,0,75025
143333200300000,SW 417,RESIDENTIAL,17460,0,17460,58800,0,76260
143333200400000,SW 417,RESIDENTIAL,17460,0,17460,74078,0,91538
143333200500000,SW 417,RESIDENTIAL,17460,0,17460,52640,0,70100
143333200600000,SW 417,RESIDENTIAL,18333,0,18333,60476,0,78809
143333200700000,SW 417,RESIDENTIAL,18572,0,18572,61195,0,79767
143333300100000,SW 417,RESIDENTIAL,17964,0,17964,54205,0,72169
143333300200000,SW 417,RESIDENTIAL,19156,0,19156,57876,0,77032
143333300300000,SW 417,RESIDENTIAL,22144,0,22144,68825,0,90969
143333300400000,SW 417,RESIDENTIAL,19957,0,19957,56031,0,75988
143333300500000,SW 417,RESIDENTIAL,18414,0,18414,79354,0,97768
143333300600000,SW 417,RESIDENTIAL,19646,0,19646,64447,0,84093
143333300700000,SW 417,RESIDENTIAL,20981,0,20981,63348,0,84329
143333300800000,SW 417,RESIDENTIAL,19085,0,19085,59796,0,78881
143333300900000,SW 417,RESIDENTIAL,19204,0,19204,82085,0,101289
143333301000000,SW 417,RESIDENTIAL,18952,0,18952,62194,0,81146
143333301100000,SW 417,RESIDENTIAL,19051,0,19051,98764,0,117815
143333301200000,SW 417,RESIDENTIAL,17604,0,17604,66939,0,84543
143333301300000,SW 417,RESIDENTIAL,19152,0,19152,59126,0,78278
143333301400000,SW 417,RESIDENTIAL,18894,0,18894,61072,0,79966
143333301500000,SW 417,RESIDENTIAL,18330,0,18330,61794,0,80124
143333301600000,SW 417,RESIDENTIAL,18330,0,18330,68171,0,86501
143333301700000,SW 417,RESIDENTIAL,18360,0,18360,55833,0,74193
143333301800000,SW 417,RESIDENTIAL,18720,0,18720,56032,0,74752
143333301900000,SW 417,RESIDENTIAL,19380,0,19380,55810,0,75190
143333302000000,SW 417,RESIDENTIAL,18720,0,18720,84839,0,103559
143333400100000,SW 417,RESIDENTIAL,19000,0,19000,56573,0,75573
143333400200000,SW 417,RESIDENTIAL,18915,0,18915,64399,0,83314
143333400300000,SW 417,RESIDENTIAL,17820,0,17820,61359,0,79179
143333400400000,SW 417,RESIDENTIAL,17000,0,17000,70281,0,87281
143333400500000,SW 417,RESIDENTIAL,17800,0,17800,57890,0,75690
143333400600000,SW 417,RESIDENTIAL,19375,0,19375,65252,0,84627
143333400700000,SW 417,RESIDENTIAL,19652,0,19652,58538,0,78190
143333400800000,SW 417,RESIDENTIAL,19576,0,19576,68767,0,88343
143333400900000,SW 417,RESIDENTIAL,19845,0,19845,54282,0,74127
143333401000000,SW 417,RESIDENTIAL,20159,0,20159,73409,0,93568
143333401100000,SW 417,RESIDENTIAL,20674,0,20674,102707,0,123381
143333401200000,SW 417,RESIDENTIAL,19513,0,19513,58518,0,78031
143333401300000,SW 417,RESIDENTIAL,17655,0,17655,66823,0,84478
143333401400000,SW 417,RESIDENTIAL,18312,0,18312,57675,0,75987
143333401500000,SW 417,RESIDENTIAL,19332,0,19332,75994,0,95326
143333401600000,SW 417,RESIDENTIAL,19184,0,19184,79532,0,98716
143333401700000,SW 417,RESIDENTIAL,17440,0,17440,78002,0,95442
143333401800000,SW 417,RESIDENTIAL,19425,0,19425,65178,0,84603
143333401900000,SW 417,RESIDENTIAL,19110,0,19110,68048,0,87158
143333402000000,SW 417,RESIDENTIAL,17280,0,17280,90540,0,107820
143333500100000,SW 417,RESIDENTIAL,18616,0,18616,77330,0,95946
143333500200000,SW 417,RESIDENTIAL,18375,0,18375,53820,0,72195
143333500300000,SW 417,RESIDENTIAL,19620,0,19620,63442,0,83062
143333500400000,SW 417,RESIDENTIAL,20611,0,20611,49211,0,69822
143333500500000,SW 417,RESIDENTIAL,19722,0,19722,54335,0,74057
143333500600000,SW 417,RESIDENTIAL,20007,0,20007,84971,0,104978
143333500700000,SW 417,RESIDENTIAL,23320,0,23320,62964,0,86284
143335100200000,SW 417,RESIDENTIAL,18360,0,18360,59473,0,77833
143335100300000,SW 417,RESIDENTIAL,18360,0,18360,54686,0,73046
143335100400000,SW 417,RESIDENTIAL,18360,0,18360,75287,0,93647
143335100500000,SW 417,RESIDENTIAL,18360,0,18360,53616,0,71976
143335100600000,SW 417,RESIDENTIAL,18360,0,18360,43695,0,62055
143335100800000,SW 417,RESIDENTIAL,18360,0,18360,86992,0,105352
143335100900000,SW 417,RESIDENTIAL,18360,0,18360,65007,0,83367
143335101000000,SW 417,RESIDENTIAL,18360,0,18360,56319,0,74679
143335101100000,SW 417,RESIDENTIAL,18360,0,18360,50578,0,68938
143335101200000,SW 417,RESIDENTIAL,18360,0,18360,65158,0,83518
143335200100000,SW 417,RESIDENTIAL,19632,0,19632,134638,0,154270
143335200200000,SW 417,RESIDENTIAL,16050,0,16050,77501,0,93551
143335200300000,SW 417,RESIDENTIAL,22140,0,22140,101189,0,123329
143335200400000,SW 417,RESIDENTIAL,22140,0,22140,72256,0,94396
143335200500000,SW 417,RESIDENTIAL,22140,0,22140,105768,0,127908
143335200600000,SW 417,RESIDENTIAL,22140,0,22140,65986,0,88126
143335200700000,SW 417,RESIDENTIAL,22140,0,22140,88880,0,111020
143335200800000,SW 417,RESIDENTIAL,22140,0,22140,92665,0,114805
143335200900000,SW 417,RESIDENTIAL,22140,0,22140,118308,0,140448
143335201000000,SW 417,RESIDENTIAL,22140,0,22140,105460,0,127600
143335201100000,SW 417,RESIDENTIAL,22140,0,22140,52477,0,74617
143335201200000,SW 417,RESIDENTIAL,20865,0,20865,96759,0,117624
143335201300000,SW 417,RESIDENTIAL,18144,0,18144,60135,0,78279
143335201400000,OFFICE; MEDICAL,COMMERCIAL,0,118260,118260,0,200427,318687
143335201500000,RESTAURANT,COMMERCIAL,0,177975,177975,0,132372,310347
143335201600000,VETERINARY CLINIC,COMMERCIAL,0,153300,153300,0,163337,316637
143335201700000,CARWASH,COMMERCIAL,0,281250,281250,0,148464,429714
143335201800000,SW 417,RESIDENTIAL,22140,0,22140,110925,0,133065
143335201900000,SW 417,RESIDENTIAL,21586,0,21586,3391,0,24977
143335202000000,SW 417,RESIDENTIAL,18819,0,18819,86690,0,105509
143335202100000,SW 417,RESIDENTIAL,18450,0,18450,69070,0,87520
143335202200000,SW 417,RESIDENTIAL,18450,0,18450,39062,0,57512
143335202300000,SW 417,RESIDENTIAL,18450,0,18450,40717,0,59167
143335202400000,SW 417,RESIDENTIAL,18450,0,18450,117271,0,135721
143335202500000,SW 417,RESIDENTIAL,18450,0,18450,100351,0,118801
143335202600000,SW 417,RESIDENTIAL,22140,0,22140,96766,0,118906
143335202700000,SW 417,RESIDENTIAL,22140,0,22140,79779,0,101919
143335202800000,SW 417,RESIDENTIAL,22140,0,22140,137988,0,160128
143335202900000,SW 417,RESIDENTIAL,18450,0,18450,87652,0,106102
143335203000000,SW 417,RESIDENTIAL,18450,0,18450,125493,0,143943
143335203100000,SW 417,RESIDENTIAL,24354,0,24354,95388,0,119742
143335300100000,SW 417,RESIDENTIAL,16050,0,16050,72386,0,88436
143335300200000,SW 417,RESIDENTIAL,2400,0,2400,0,0,2400
143335300300000,SW 417,RESIDENTIAL,18450,0,18450,91524,0,109974
143335300400000,SW 417,RESIDENTIAL,16050,0,16050,107529,0,123579
143335300500000,SW 417,RESIDENTIAL,18765,0,18765,89782,0,108547
143335300700000,SW 417,RESIDENTIAL,22140,0,22140,99719,0,121859
143335300800000,SW 417,RESIDENTIAL,22140,0,22140,39632,0,61772
143335300900000,SW 417,RESIDENTIAL,15300,0,15300,71245,0,86545
143335301000000,SW 417,RESIDENTIAL,15300,0,15300,53329,0,68629
143335301100000,SW 417,RESIDENTIAL,6300,0,6300,0,0,6300
143335301200000,SW 417,RESIDENTIAL,18450,0,18450,53790,0,72240
143335301300000,SW 417,RESIDENTIAL,18450,0,18450,55305,0,73755
143335301400000,SW 417,RESIDENTIAL,18450,0,18450,85967,0,104417
143335301800000,APARTMENT,COMMERCIAL,0,17953,17953,0,123358,141311
143335301900000,FLAT PARKING,COMMERCIAL,0,51208,51208,0,4506,55714
143335302000000,FLAT PARKING,COMMERCIAL,0,51653,51653,0,5226,56879
143335302300000,RESTAURANT,COMMERCIAL,0,172250,172250,0,147399,319649
143335302400000,OFFICE,COMMERCIAL,0,166500,166500,0,381528,548028
143335302500000,STATE PROPERTY,EXEMPT,0,0,0,0,0,0
143335302600000,SW 417,RESIDENTIAL,19170,0,19170,60422,0,79592
143335302700000,SW 417,RESIDENTIAL,15600,0,15600,60395,0,75995
143335400100000,CHURCH,EXEMPT,0,76680,76680,0,338702,415382
143335400700000,SW 417,RESIDENTIAL,21840,0,21840,94870,0,116710
143335401300000,SW 417,RESIDENTIAL,20981,0,20981,81127,0,102108
143335401400000,SW 417,RESIDENTIAL,21094,0,21094,111359,0,132453
143335401500000,SW 417,RESIDENTIAL,18750,0,18750,74729,0,93479
143335401600000,SW 417,RESIDENTIAL,18750,0,18750,68341,0,87091
143335401700000,SW 417,RESIDENTIAL,4050,0,4050,0,0,4050
143335401800000,VACANT LAND,COMMERCIAL,0,38822,38822,0,0,38822
143335401900000,SW 417,RESIDENTIAL,14550,0,14550,100568,0,115118
143335402000000,SW 417,RESIDENTIAL,21840,0,21840,129649,0,151489
143335402100000,SW 417,RESIDENTIAL,21840,0,21840,136610,0,158450
143335402200000,SW 417,RESIDENTIAL,21840,0,21840,103160,0,125000
143335402300000,SW 417,RESIDENTIAL,21420,0,21420,85615,0,107035
143335402400000,SW 417,RESIDENTIAL,21645,0,21645,56329,0,77974
143335402500000,APARTMENT,EXEMPT,0,41904,41904,0,461525,503429
143337600100000,SW 416,RESIDENTIAL,27622,0,27622,74120,0,101742
143337600200000,SW 416,RESIDENTIAL,26465,0,26465,88766,0,115231
143337600300000,SW 416,RESIDENTIAL,45475,0,45475,73578,0,119053
143337600400000,SW 416,RESIDENTIAL,22377,0,22377,111912,0,134289
143337600500000,SW 416,RESIDENTIAL,22050,0,22050,109435,0,131485
143337600600000,SW 416,RESIDENTIAL,22050,0,22050,78615,0,100665
143337600700000,SW 416,RESIDENTIAL,22050,0,22050,82721,0,104771
143337600800000,SW 416,RESIDENTIAL,22600,0,22600,85983,0,108583
143337600900000,SW 416,RESIDENTIAL,23841,0,23841,110821,0,134662
143337601000000,SW 416,RESIDENTIAL,23634,0,23634,96105,0,119739
143337601100000,SW 416,RESIDENTIAL,28768,0,28768,112369,0,141137
143337601200000,SW 416,RESIDENTIAL,26145,0,26145,72692,0,98837
143337601300000,SW 416,RESIDENTIAL,25830,0,25830,83259,0,109089
143337601400000,SW 416,RESIDENTIAL,29232,0,29232,49725,0,78957
143337700100000,SW 417,RESIDENTIAL,25542,0,25542,114596,0,140138
143337700200000,SW 417,EXEMPT,0,22485,22485,0,129180,151665
143337800100000,SW 416,RESIDENTIAL,20720,0,20720,70170,0,90890
143337800200000,SW 416,RESIDENTIAL,20650,0,20650,70362,0,91012
143337800300000,SW 416,RESIDENTIAL,20650,0,20650,75999,0,96649
143337800400000,SW 416,RESIDENTIAL,20650,0,20650,84655,0,105305
143337800500000,SW 416,RESIDENTIAL,20650,0,20650,92323,0,112973
143337800600000,SW 416,RESIDENTIAL,26845,0,26845,64019,0,90864
143337800700000,SW 416,RESIDENTIAL,15487,0,15487,90199,0,105686
143337800900000,SW 416,RESIDENTIAL,23231,0,23231,110459,0,133690
143337801000000,SW 416,RESIDENTIAL,20650,0,20650,127257,0,147907
143337801100000,SW 416,RESIDENTIAL,20650,0,20650,91946,0,112596
143337801200000,SW 416,RESIDENTIAL,22978,0,22978,62313,0,85291
143337801300000,SW 416,RESIDENTIAL,26577,0,26577,78535,0,105112
143337801400000,SW 416,RESIDENTIAL,21579,0,21579,89552,0,111131
143337801500000,SW 416,RESIDENTIAL,26845,0,26845,97289,0,124134
143337801600000,SW 416,RESIDENTIAL,26845,0,26845,81624,0,108469
143337801700000,SW 416,RESIDENTIAL,26845,0,26845,73965,0,100810
143337801800000,SW 416,RESIDENTIAL,26845,0,26845,119857,0,146702
143337801900000,SW 416,RESIDENTIAL,26845,0,26845,44555,0,71400
143337802000000,SW 416,RESIDENTIAL,28350,0,28350,71876,0,100226
143337802200000,SW 416,RESIDENTIAL,19425,0,19425,71335,0,90760
143337802300000,SW 416,RESIDENTIAL,19425,0,19425,67908,0,87333
143337802400000,SW 416,RESIDENTIAL,25900,0,25900,99974,0,125874
143337802500000,SW 416,RESIDENTIAL,26418,0,26418,56793,0,83211
143337802600000,SW 416,RESIDENTIAL,7744,0,7744,0,0,7744
143337900100000,SW 417,RESIDENTIAL,24354,0,24354,62554,0,86908
143337900200000,SW 417,RESIDENTIAL,22951,0,22951,0,0,22951
143337900300000,SW 417,RESIDENTIAL,22951,0,22951,85580,0,108531
143338000100000,SW 416,RESIDENTIAL,25460,0,25460,64515,0,89975
143338000200000,SW 416,RESIDENTIAL,17500,0,17500,66416,0,83916
143338000300000,SW 416,EXEMPT,0,30719,30719,0,247128,277847
143338000400000,SW 416,RESIDENTIAL,20650,0,20650,28891,0,49541
143338000500000,SW 416,RESIDENTIAL,20650,0,20650,97145,0,117795
143338000600000,SW 416,RESIDENTIAL,26845,0,26845,40449,0,67294
143338000700000,SW 416,RESIDENTIAL,17500,0,17500,61355,0,78855
143338000800000,SW 416,RESIDENTIAL,21420,0,21420,89851,0,111271
143338000900000,SW 416,RESIDENTIAL,26845,0,26845,70582,0,97427
143338001000000,SW 416,RESIDENTIAL,26845,0,26845,105903,0,132748
143338001100000,SW 416,RESIDENTIAL,24522,0,24522,123690,0,148212
143338001200000,SW 416,RESIDENTIAL,9270,0,9270,0,0,9270
143338100100000,SW 417,RESIDENTIAL,18819,0,18819,73212,0,92031
143340100100000,SERVICE STATION,COMMERCIAL,0,59500,59500,0,87731,147231
143340100200000,FLAT PARKING,COMMERCIAL,0,33900,33900,0,10000,43900
143340100700000,SW 414,RESIDENTIAL,22220,0,22220,59147,0,81367
143340100800000,SW 414,RESIDENTIAL,22220,0,22220,75466,0,97686
143340100900000,SW 414,RESIDENTIAL,22220,0,22220,55194,0,77414
143340101000000,SW 414,RESIDENTIAL,24240,0,24240,49983,0,74223
143340101100000,SW 414,RESIDENTIAL,24240,0,24240,80177,0,104417
143340101200000,SW 414,RESIDENTIAL,38784,0,38784,80437,0,119221
143340101300000,SW 414,RESIDENTIAL,22220,0,22220,59099,0,81319
143340101400000,SW 414,RESIDENTIAL,37774,0,37774,94656,0,132430
143340101600000,SW 414,RESIDENTIAL,38896,0,38896,134586,0,173482
143340101700000,SMALL RETAIL,COMMERCIAL,0,58520,58520,0,119911,178431
143340200100000,SW 414,RESIDENTIAL,30001,0,30001,77719,0,107720
143340200200000,SW 414,RESIDENTIAL,30492,0,30492,85564,0,116056
143340200300000,SW 414,RESIDENTIAL,29700,0,29700,102935,0,132635
143340200400000,SW 414,RESIDENTIAL,29399,0,29399,118789,0,148188
143340200500000,SW 414,RESIDENTIAL,17820,0,17820,125618,0,143438
143340200600000,SW 414,RESIDENTIAL,32640,0,32640,107347,0,139987
143340200700000,SW 414,RESIDENTIAL,32640,0,32640,101013,0,133653
143340200800000,SW 414,RESIDENTIAL,22220,0,22220,100896,0,123116
143340200900000,SW 414,RESIDENTIAL,23028,0,23028,75226,0,98254
143340201000000,SW 414,RESIDENTIAL,13120,0,13120,65557,0,78677
143340201100000,SW 414,RESIDENTIAL,26320,0,26320,85107,0,111427
143340201200000,SW 414,RESIDENTIAL,30410,0,30410,95261,0,125671
143340201300000,SW 414,RESIDENTIAL,29700,0,29700,77418,0,107118
143340201400000,SW 414,RESIDENTIAL,29700,0,29700,107677,0,137377
143340201500000,SW 414,RESIDENTIAL,30114,0,30114,76309,0,106423
143340201600000,SW 414,RESIDENTIAL,24313,0,24313,92327,0,116640
143340201700000,SW 414,RESIDENTIAL,24000,0,24000,98216,0,122216
143340201800000,SW 414,RESIDENTIAL,24000,0,24000,87514,0,111514
143340201900000,SW 414,RESIDENTIAL,24000,0,24000,74158,0,98158
143340202000000,SW 414,RESIDENTIAL,24501,0,24501,79899,0,104400
143340202100000,SW 414,RESIDENTIAL,34263,0,34263,88538,0,122801
143340300100000,SW 414,RESIDENTIAL,27750,0,27750,66940,0,94690
143340300200000,SW 414,RESIDENTIAL,36630,0,36630,50148,0,86778
143340300300000,SW 414,RESIDENTIAL,35200,0,35200,121821,0,157021
143340300400000,SW 414,RESIDENTIAL,38085,0,38085,65715,0,103800
143340300500000,SW 414,RESIDENTIAL,24500,0,24500,143850,0,168350
143340300600000,SW 414,RESIDENTIAL,29256,0,29256,145558,0,174814
143340300700000,SW 414,RESIDENTIAL,23316,0,23316,116964,0,140280
143340300800000,SW 414,RESIDENTIAL,23563,0,23563,107262,0,130825
143340300900000,SW 414,RESIDENTIAL,29854,0,29854,170529,0,200383
143340301000000,SW 414,RESIDENTIAL,29639,0,29639,156106,0,185745
143340301100000,CITY PROPERTY,EXEMPT,0,0,0,0,0,0
143340301200000,SW 414,RESIDENTIAL,32438,0,32438,127722,0,160160
143340301300000,SW 414,RESIDENTIAL,29645,0,29645,130692,0,160337
143340301400000,SW 414,RESIDENTIAL,27440,0,27440,138131,0,165571
143340301500000,SW 414,RESIDENTIAL,27440,0,27440,136136,0,163576
143340301600000,SW 414,RESIDENTIAL,29700,0,29700,129675,0,159375
143340301700000,SW 414,RESIDENTIAL,31441,0,31441,79180,0,110621
143340301800000,SW 414,RESIDENTIAL,27904,0,27904,86397,0,114301
143340301900000,SW 414,RESIDENTIAL,28560,0,28560,111423,0,139983
143340302000000,SW 414,RESIDENTIAL,29245,0,29245,103952,0,133197
143340302100000,SW 414,RESIDENTIAL,29120,0,29120,94754,0,123874
143340302200000,SW 414,RESIDENTIAL,29120,0,29120,116268,0,145388
143340302300000,SW 414,RESIDENTIAL,29536,0,29536,98408,0,127944
143340302400000,SW 414,RESIDENTIAL,29536,0,29536,92576,0,122112
143340302500000,SW 414,RESIDENTIAL,26624,0,26624,88417,0,115041
143340302600000,SW 414,RESIDENTIAL,26624,0,26624,79731,0,106355
143340302700000,SW 414,RESIDENTIAL,28343,0,28343,100314,0,128657
143340302800000,SW 414,RESIDENTIAL,25326,0,25326,88253,0,113579
143340302900000,SW 414,RESIDENTIAL,24960,0,24960,125266,0,150226
143340303000000,SW 414,RESIDENTIAL,29623,0,29623,112821,0,142444
143340303100000,SW 414,RESIDENTIAL,24594,0,24594,103126,0,127720
143340303200000,SW 414,RESIDENTIAL,29083,0,29083,108537,0,137620
143340400100000,SW 414,RESIDENTIAL,27528,0,27528,86223,0,113751
143340400200000,SW 414,RESIDENTIAL,27200,0,27200,110869,0,138069
143340400300000,SW 414,RESIDENTIAL,27200,0,27200,115439,0,142639
143340400400000,SW 414,RESIDENTIAL,26889,0,26889,126461,0,153350
143340400500000,SW 414,RESIDENTIAL,30457,0,30457,119389,0,149846
143340400600000,SW 414,RESIDENTIAL,26624,0,26624,116481,0,143105
143340400700000,SW 414,RESIDENTIAL,26624,0,26624,109542,0,136166
143340400800000,SW 414,RESIDENTIAL,25376,0,25376,85526,0,110902
143340400900000,SW 414,RESIDENTIAL,23560,0,23560,89420,0,112980
143340401000000,SW 414,RESIDENTIAL,28500,0,28500,100103,0,128603
143340401100000,SW 414,RESIDENTIAL,27260,0,27260,99560,0,126820
143340401200000,SW 414,RESIDENTIAL,23365,0,23365,88289,0,111654
143340401300000,SW 414,RESIDENTIAL,21216,0,21216,105858,0,127074
143340401400000,SW 414,RESIDENTIAL,24544,0,24544,123027,0,147571
143340401500000,SW 414,RESIDENTIAL,26912,0,26912,119938,0,146850
143340401600000,SW 414,RESIDENTIAL,32573,0,32573,88942,0,121515
143340500100000,SW 414,RESIDENTIAL,27512,0,27512,96050,0,123562
143340500200000,SW 414,RESIDENTIAL,27200,0,27200,85303,0,112503
143340500300000,SW 414,RESIDENTIAL,27200,0,27200,85309,0,112509
143340500400000,SW 414,RESIDENTIAL,27300,0,27300,89822,0,117122
143340500500000,SW 414,RESIDENTIAL,29856,0,29856,112126,0,141982
143340500600000,SW 414,RESIDENTIAL,31500,0,31500,94880,0,126380
143340500700000,SW 414,RESIDENTIAL,31500,0,31500,99356,0,130856
143340500800000,SW 414,RESIDENTIAL,31500,0,31500,83756,0,115256
143340500900000,SW 414,RESIDENTIAL,31676,0,31676,97082,0,128758
143340501000000,SW 414,RESIDENTIAL,31408,0,31408,111818,0,143226
143340501100000,SW 414,RESIDENTIAL,30231,0,30231,128530,0,158761
143340501200000,SW 414,RESIDENTIAL,30023,0,30023,114361,0,144384
143340501300000,SW 414,RESIDENTIAL,31616,0,31616,88955,0,120571
143340501400000,SW 414,RESIDENTIAL,29884,0,29884,104103,0,133987
143340600100000,SW 414,RESIDENTIAL,32320,0,32320,86589,0,118909
143340600200000,SW 414,RESIDENTIAL,32320,0,32320,103623,0,135943
143340600300000,SW 414,RESIDENTIAL,24244,0,24244,124630,0,148874
143340600400000,SW 414,RESIDENTIAL,24279,0,24279,77737,0,102016
143340600500000,SW 414,RESIDENTIAL,25096,0,25096,82566,0,107662
143340600600000,SW 414,RESIDENTIAL,26004,0,26004,77764,0,103768
143340700100000,SW 414,RESIDENTIAL,26532,0,26532,113640,0,140172
143340700200000,SW 414,RESIDENTIAL,25344,0,25344,92186,0,117530
143340700300000,SW 414,RESIDENTIAL,25044,0,25044,93508,0,118552
143340700400000,SW 414,RESIDENTIAL,22639,0,22639,95031,0,117670
143340700500000,SW 414,RESIDENTIAL,22007,0,22007,95234,0,117241
143340700600000,SW 414,RESIDENTIAL,23066,0,23066,96773,0,119839
143340700700000,SW 414,RESIDENTIAL,22272,0,22272,84004,0,106276
143340700800000,SW 414,RESIDENTIAL,28200,0,28200,101119,0,129319
143340800100000,SW 414,RESIDENTIAL,22902,0,22902,92456,0,115358
143340800200000,SW 414,RESIDENTIAL,28800,0,28800,97120,0,125920
143340800300000,SW 414,RESIDENTIAL,26880,0,26880,100351,0,127231
143340800400000,SW 414,RESIDENTIAL,25728,0,25728,93469,0,119197
143340800500000,SW 414,RESIDENTIAL,25192,0,25192,95557,0,120749
143340800600000,SW 414,RESIDENTIAL,27648,0,27648,102084,0,129732
143340800700000,SW 414,RESIDENTIAL,27840,0,27840,110401,0,138241
143340800800000,SW 414,RESIDENTIAL,23094,0,23094,108660,0,131754
143340900100000,SW 414,RESIDENTIAL,26112,0,26112,83869,0,109981
143340900200000,SW 414,RESIDENTIAL,29184,0,29184,96278,0,125462
143340900300000,SW 414,RESIDENTIAL,31280,0,31280,89736,0,121016
143340900400000,SW 414,RESIDENTIAL,28996,0,28996,96388,0,125384
143340900500000,SW 414,RESIDENTIAL,26624,0,26624,86997,0,113621
143340900600000,SW 414,RESIDENTIAL,27252,0,27252,83337,0,110589
143340900700000,SW 414,RESIDENTIAL,24576,0,24576,87480,0,112056
143340900800000,SW 414,RESIDENTIAL,27648,0,27648,75349,0,102997
143340900900000,SW 414,RESIDENTIAL,25344,0,25344,109325,0,134669
143340901000000,SW 414,RESIDENTIAL,26112,0,26112,81197,0,107309
143340901100000,SW 414,RESIDENTIAL,25344,0,25344,95033,0,120377
143340901200000,SW 414,RESIDENTIAL,25608,0,25608,108723,0,134331
143340901300000,SW 414,RESIDENTIAL,25840,0,25840,82372,0,108212
143341000100000,SW 414,RESIDENTIAL,32623,0,32623,99550,0,132173
143341000200000,SW 414,RESIDENTIAL,25542,0,25542,100832,0,126374
143341000300000,SW 414,RESIDENTIAL,25415,0,25415,120620,0,146035
143341000400000,SW 414,RESIDENTIAL,24933,0,24933,127044,0,151977
143341000500000,SW 414,RESIDENTIAL,28616,0,28616,93898,0,122514
143341000600000,SW 414,RESIDENTIAL,26264,0,26264,104665,0,130929
143342600100000,SW 416,RESIDENTIAL,30240,0,30240,109008,0,139248
143342600200000,SW 416,RESIDENTIAL,25200,0,25200,84783,0,109983
143342600300000,SW 416,RESIDENTIAL,23426,0,23426,64716,0,88142
143342600400000,SW 416,RESIDENTIAL,23426,0,23426,99806,0,123232
143342600500000,SW 416,RESIDENTIAL,23793,0,23793,80138,0,103931
143342600600000,SW 416,RESIDENTIAL,23793,0,23793,65539,0,89332
143342600700000,SW 416,RESIDENTIAL,23793,0,23793,94623,0,118416
143342600800000,SW 416,RESIDENTIAL,22638,0,22638,110702,0,133340
143342600900000,SW 416,RESIDENTIAL,29704,0,29704,96236,0,125940
143342601000000,SW 416,RESIDENTIAL,18865,0,18865,127626,0,146491
143342601100000,SW 416,RESIDENTIAL,13034,0,13034,41521,0,54555
143342601200000,SW 416,RESIDENTIAL,13034,0,13034,59135,0,72169
143342601300000,SW 416,RESIDENTIAL,13034,0,13034,44448,0,57482
143342601400000,SW 416,RESIDENTIAL,13034,0,13034,77952,0,90986
143342601500000,SW 416,RESIDENTIAL,13034,0,13034,106403,0,119437
143342601600000,SW 416,RESIDENTIAL,24717,0,24717,74208,0,98925
143342601700000,SW 416,RESIDENTIAL,23793,0,23793,114047,0,137840
143342601800000,SW 416,RESIDENTIAL,23793,0,23793,76668,0,100461
143342601900000,SW 416,RESIDENTIAL,23793,0,23793,65940,0,89733
143342602000000,SW 416,RESIDENTIAL,22624,0,22624,0,0,22624
143342602100000,SW 416,RESIDENTIAL,24229,0,24229,159268,0,183497
143342700100000,SCHOOL,EXEMPT,0,0,0,0,0,0
143342700102000,ANTENNAS/TOWERS(BLL),COMMERCIAL,0,0,0,0,5511,5511
143342700200000,SW 416,RESIDENTIAL,24010,0,24010,96260,0,120270
143342700300000,SW 416,RESIDENTIAL,15435,0,15435,64564,0,79999
143342700400000,SW 416,RESIDENTIAL,13720,0,13720,57356,0,71076
143342700500000,SW 416,RESIDENTIAL,20580,0,20580,67780,0,88360
143342700600000,SW 416,RESIDENTIAL,20580,0,20580,63944,0,84524
143342700700000,SW 416,RESIDENTIAL,13720,0,13720,48193,0,61913
143342700800000,SW 416,RESIDENTIAL,28812,0,28812,79244,0,108056
143342700900000,SW 416,RESIDENTIAL,13720,0,13720,82727,0,96447
143342701000000,SW 416,RESIDENTIAL,13720,0,13720,95135,0,108855
143342701100000,SW 416,RESIDENTIAL,13720,0,13720,59573,0,73293
143342701200000,SW 416,RESIDENTIAL,13720,0,13720,66067,0,79787
143342701300000,SW 416,RESIDENTIAL,13720,0,13720,72159,0,85879
143342701400000,SW 416,RESIDENTIAL,13720,0,13720,72772,0,86492
143342701500000,SW 416,RESIDENTIAL,27440,0,27440,61777,0,89217
143342701600000,SW 416,RESIDENTIAL,27440,0,27440,89223,0,116663
143342701700000,SW 416,RESIDENTIAL,13720,0,13720,73252,0,86972
143342800100000,SW 414,RESIDENTIAL,31406,0,31406,182989,0,214395
143342800200000,SW 416,RESIDENTIAL,20437,0,20437,100279,0,120716
143342800300000,SW 416,RESIDENTIAL,20703,0,20703,77486,0,98189
143342800400000,SW 416,RESIDENTIAL,20703,0,20703,77885,0,98588
143342800500000,SW 416,RESIDENTIAL,22295,0,22295,104172,0,126467
143342800600000,SW 416,RESIDENTIAL,22295,0,22295,79265,0,101560
143342800700000,SW 416,RESIDENTIAL,20703,0,20703,79794,0,100497
143342800800000,SW 416,RESIDENTIAL,20475,0,20475,76939,0,97414
143342800900000,SW 416,RESIDENTIAL,20475,0,20475,119816,0,140291
143342801000000,SW 416,RESIDENTIAL,20475,0,20475,98774,0,119249
143342801100000,SW 416,RESIDENTIAL,20475,0,20475,108786,0,129261
143342801200000,SW 416,RESIDENTIAL,20475,0,20475,108174,0,128649
143342801300000,SW 416,RESIDENTIAL,19163,0,19163,95609,0,114772
143342801400000,SW 416,RESIDENTIAL,33576,0,33576,194355,0,227931
143342801600000,SW 414,RESIDENTIAL,28200,0,28200,153839,0,182039
143342801700000,SW 414,RESIDENTIAL,25220,0,25220,149264,0,174484
143342801800000,SW 414,RESIDENTIAL,25221,0,25221,143231,0,168452
143342801900000,SW 414,RESIDENTIAL,27432,0,27432,112950,0,140382
143342802000000,SW 414,RESIDENTIAL,32127,0,32127,181576,0,213703
143342900100000,SW 416,RESIDENTIAL,24835,0,24835,87453,0,112288
143342900200000,SW 416,RESIDENTIAL,17885,0,17885,77360,0,95245
143342900300000,SW 416,RESIDENTIAL,15330,0,15330,49115,0,64445
143342900400000,SW 416,RESIDENTIAL,12880,0,12880,60259,0,73139
143342900500000,SW 416,RESIDENTIAL,12880,0,12880,54868,0,67748
143342900600000,SW 416,RESIDENTIAL,13727,0,13727,67130,0,80857
143342900700000,SW 416,RESIDENTIAL,15953,0,15953,59881,0,75834
143342900800000,SW 416,RESIDENTIAL,14840,0,14840,111659,0,126499
143342900900000,SW 416,RESIDENTIAL,14840,0,14840,80293,0,95133
143342901000000,SW 416,RESIDENTIAL,14840,0,14840,89183,0,104023
143342901100000,SW 416,RESIDENTIAL,14840,0,14840,88739,0,103579
143342901200000,SW 416,RESIDENTIAL,22260,0,22260,91825,0,114085
143342901300000,SW 416,RESIDENTIAL,22260,0,22260,168240,0,190500
143342901400000,SW 416,RESIDENTIAL,14840,0,14840,77342,0,92182
143342901500000,SW 416,RESIDENTIAL,22260,0,22260,73613,0,95873
143342901600000,SW 416,RESIDENTIAL,22260,0,22260,96908,0,119168
143342901700000,SW 416,RESIDENTIAL,14840,0,14840,83712,0,98552
143342901800000,SW 416,RESIDENTIAL,14840,0,14840,58392,0,73232
143342901900000,SW 416,RESIDENTIAL,22260,0,22260,84887,0,107147
143342902000000,SW 416,RESIDENTIAL,18550,0,18550,100285,0,118835
143342902100000,SW 416,RESIDENTIAL,18550,0,18550,71636,0,90186
143342902200000,SW 416,RESIDENTIAL,23923,0,23923,87331,0,111254
143342902300000,SW 416,RESIDENTIAL,17136,0,17136,23466,0,40602
143342902400000,SW 416,RESIDENTIAL,21092,0,21092,67046,0,88138
143342902500000,SW 416,RESIDENTIAL,20698,0,20698,89308,0,110006
143342902600000,SW 416,RESIDENTIAL,26712,0,26712,75811,0,102523
143342902700000,SW 416,RESIDENTIAL,26712,0,26712,93638,0,120350
143342902800000,SW 416,RESIDENTIAL,26712,0,26712,92270,0,118982
143342902900000,SW 416,RESIDENTIAL,26712,0,26712,70334,0,97046
143342903000000,SW 416,RESIDENTIAL,14840,0,14840,34050,0,48890
143342903100000,SW 416,RESIDENTIAL,14840,0,14840,79065,0,93905
143342903200000,SW 416,RESIDENTIAL,26712,0,26712,82798,0,109510
143342903300000,SW 416,RESIDENTIAL,14840,0,14840,87711,0,102551
143342903400000,SW 416,RESIDENTIAL,14840,0,14840,37912,0,52752
143342903500000,SW 416,RESIDENTIAL,14840,0,14840,34038,0,48878
143342903600000,SW 416,RESIDENTIAL,14840,0,14840,69445,0,84285
143342903900000,SW 416,RESIDENTIAL,14840,0,14840,52450,0,67290
143342904000000,SW 416,RESIDENTIAL,22260,0,22260,93333,0,115593
143345100100000,SW 416,RESIDENTIAL,18200,0,18200,78867,0,97067
143345100200000,SW 416,RESIDENTIAL,23660,0,23660,77320,0,100980
143345100300000,SW 416,RESIDENTIAL,21968,0,21968,70844,0,92812
143345100400000,SW 416,RESIDENTIAL,25674,0,25674,153352,0,179026
143345100500000,SW 416,RESIDENTIAL,21638,0,21638,86723,0,108361
143345100600000,SW 416,RESIDENTIAL,18725,0,18725,64338,0,83063
143345100700000,SW 416,RESIDENTIAL,19075,0,19075,52813,0,71888
143345100800000,SW 416,RESIDENTIAL,19425,0,19425,71292,0,90717
143345200100000,SW 416,RESIDENTIAL,26489,0,26489,118533,0,145022
143345200200000,SW 416,RESIDENTIAL,26088,0,26088,101562,0,127650
143345200400000,SW 416,RESIDENTIAL,22372,0,22372,54164,0,76536
143345200500000,SW 416,RESIDENTIAL,16121,0,16121,63590,0,79711
143345200600000,SW 416,RESIDENTIAL,17029,0,17029,67504,0,84533
143345200700000,SW 416,RESIDENTIAL,17010,0,17010,91854,0,108864
143345200800000,SW 416,RESIDENTIAL,17010,0,17010,138411,0,155421
143345200900000,SW 416,RESIDENTIAL,19990,0,19990,87345,0,107335
143345201000000,SW 416,RESIDENTIAL,17199,0,17199,92262,0,109461
143345201100000,SW 416,RESIDENTIAL,22869,0,22869,102827,0,125696
143345201200000,SW 416,RESIDENTIAL,18737,0,18737,88290,0,107027
143345201300000,SW 416,RESIDENTIAL,25451,0,25451,73729,0,99180
143345201400000,SW 416,RESIDENTIAL,4606,0,4606,988,0,5594
143345300100000,SW 416,RESIDENTIAL,21052,0,21052,107550,0,128602
143345300200000,SW 416,RESIDENTIAL,27598,0,27598,71091,0,98689
143345300300000,SW 416,RESIDENTIAL,24500,0,24500,43886,0,68386
143345300400000,SW 416,RESIDENTIAL,23800,0,23800,84549,0,108349
143345300500000,SW 416,RESIDENTIAL,45875,0,45875,145314,0,191189
143345300600000,SW 416,RESIDENTIAL,45925,0,45925,0,0,45925
143345300700000,SCHOOL,EXEMPT,0,0,0,0,0,0
143345300800000,SW 416,RESIDENTIAL,25816,0,25816,68282,0,94098
143345300900000,SW 416,RESIDENTIAL,17150,0,17150,93083,0,110233
143345301000000,SW 416,RESIDENTIAL,20580,0,20580,88298,0,108878
143345301100000,SW 416,RESIDENTIAL,20580,0,20580,69284,0,89864
143345301200000,SW 416,RESIDENTIAL,22295,0,22295,104551,0,126846
143345301300000,SW 416,RESIDENTIAL,18865,0,18865,83349,0,102214
143345301400000,SW 416,RESIDENTIAL,20580,0,20580,63627,0,84207
143345301500000,SW 416,RESIDENTIAL,25725,0,25725,69185,0,94910
143345301600000,SW 416,RESIDENTIAL,29841,0,29841,102402,0,132243
143345301700000,SW 416,RESIDENTIAL,27132,0,27132,57021,0,84153
143345301800000,SW 416,RESIDENTIAL,28846,0,28846,95883,0,124729
143345301900000,SW 416,RESIDENTIAL,29097,0,29097,88236,0,117333
143345302000000,SW 416,RESIDENTIAL,30713,0,30713,83738,0,114451
143345302100000,SW 416,RESIDENTIAL,31127,0,31127,77797,0,108924
143345302200000,SW 416,RESIDENTIAL,31059,0,31059,97279,0,128338
143345302300000,SW 416,RESIDENTIAL,24570,0,24570,85566,0,110136
143345302400000,SW 416,RESIDENTIAL,28624,0,28624,46591,0,75215
143345302500000,SW 416,RESIDENTIAL,34430,0,34430,83637,0,118067
143345302600000,SW 416,RESIDENTIAL,36998,0,36998,79928,0,116926
143345302700000,SW 416,RESIDENTIAL,17675,0,17675,69986,0,87661
143345302800000,SW 416,RESIDENTIAL,18408,0,18408,36774,0,55182
143345400100000,SW 416,RESIDENTIAL,25711,0,25711,56350,0,82061
143345400200000,SW 416,RESIDENTIAL,28980,0,28980,88651,0,117631
143345400300000,SW 416,RESIDENTIAL,31067,0,31067,58735,0,89802
143345400400000,SW 416,RESIDENTIAL,30925,0,30925,106192,0,137117
143345400500000,SW 416,RESIDENTIAL,32103,0,32103,45560,0,77663
143345400600000,SW 416,RESIDENTIAL,25123,0,25123,58315,0,83438
143345400700000,SW 416,RESIDENTIAL,21493,0,21493,78667,0,100160
143345400800000,SW 416,RESIDENTIAL,22084,0,22084,96002,0,118086
143345400900000,SW 416,RESIDENTIAL,19488,0,19488,35201,0,54689
143345401000000,SW 416,RESIDENTIAL,24955,0,24955,69462,0,94417
143345401100000,SW 416,RESIDENTIAL,22078,0,22078,78039,0,100117
143345401200000,SW 416,RESIDENTIAL,24126,0,24126,91756,0,115882
143345401300000,SW 416,RESIDENTIAL,19110,0,19110,57929,0,77039
143345401400000,SW 416,RESIDENTIAL,19110,0,19110,65039,0,84149
143345401500000,SW 416,RESIDENTIAL,19488,0,19488,49778,0,69266
143345401600000,SW 416,RESIDENTIAL,19555,0,19555,57867,0,77422
143345401700000,SW 416,RESIDENTIAL,20125,0,20125,72460,0,92585
143345401800000,SW 416,RESIDENTIAL,20125,0,20125,60537,0,80662
143345401900000,SW 416,RESIDENTIAL,20125,0,20125,85665,0,105790
143345402000000,SW 416,RESIDENTIAL,20125,0,20125,81638,0,101763
143345402100000,SW 416,RESIDENTIAL,20125,0,20125,101620,0,121745
143345402200000,SW 416,RESIDENTIAL,16800,0,16800,58841,0,75641
143345402300000,SW 416,RESIDENTIAL,24640,0,24640,64718,0,89358
143345402400000,SW 416,RESIDENTIAL,23695,0,23695,104926,0,128621
143345402500000,SW 416,RESIDENTIAL,24850,0,24850,87446,0,112296
143345402600000,SW 416,RESIDENTIAL,20650,0,20650,106441,0,127091
143345402700000,SW 416,RESIDENTIAL,20475,0,20475,79497,0,99972
143345402800000,SW 416,RESIDENTIAL,30450,0,30450,53549,0,83999
143345402900000,SW 416,RESIDENTIAL,28476,0,28476,134847,0,163323
143345403000000,SW 416,RESIDENTIAL,26950,0,26950,88071,0,115021
143345403100000,SW 416,RESIDENTIAL,28088,0,28088,89662,0,117750
143345403200000,SW 416,RESIDENTIAL,27300,0,27300,114235,0,141535
143345403300000,SW 416,RESIDENTIAL,24143,0,24143,85354,0,109497
143345403400000,SW 416,RESIDENTIAL,22470,0,22470,76938,0,99408
143345403500000,SW 416,RESIDENTIAL,22260,0,22260,97945,0,120205
143345403600000,SW 416,RESIDENTIAL,28665,0,28665,106574,0,135239
143347600100000,SW 414,RESIDENTIAL,31654,0,31654,99690,0,131344
143347600200000,SW 414,RESIDENTIAL,25542,0,25542,95056,0,120598
143347600300000,SW 414,RESIDENTIAL,31783,0,31783,131076,0,162859
143347600400000,SW 414,RESIDENTIAL,25939,0,25939,135199,0,161138
143347600500000,SW 414,RESIDENTIAL,27472,0,27472,91764,0,119236
143347600600000,SW 414,RESIDENTIAL,29088,0,29088,116851,0,145939
143347700100000,SW 414,RESIDENTIAL,26624,0,26624,105936,0,132560
143347700200000,SW 414,RESIDENTIAL,29000,0,29000,102898,0,131898
143347700300000,SW 414,RESIDENTIAL,29000,0,29000,113800,0,142800
143347700400000,SW 414,RESIDENTIAL,32148,0,32148,71812,0,103960
143347700500000,SW 414,RESIDENTIAL,28800,0,28800,89551,0,118351
143347700600000,SW 414,RESIDENTIAL,33733,0,33733,74855,0,108588
143347700700000,SW 414,RESIDENTIAL,33048,0,33048,152232,0,185280
143347700800000,SW 414,RESIDENTIAL,37440,0,37440,162780,0,200220
143347700900000,SW 414,RESIDENTIAL,28800,0,28800,103982,0,132782
143347701000000,SW 414,RESIDENTIAL,36000,0,36000,103128,0,139128
143347701100000,SW 414,RESIDENTIAL,36000,0,36000,131831,0,167831
143347701200000,SW 414,RESIDENTIAL,24000,0,24000,92476,0,116476
143347701300000,SW 414,RESIDENTIAL,36000,0,36000,120437,0,156437
143347701400000,SW 414,RESIDENTIAL,32400,0,32400,68452,0,100852
143347701500000,SW 414,RESIDENTIAL,32400,0,32400,124764,0,157164
143347701600000,SW 414,RESIDENTIAL,32980,0,32980,122780,0,155760
143347701700000,SW 414,RESIDENTIAL,32980,0,32980,50792,0,83772
143347701800000,SW 414,RESIDENTIAL,32200,0,32200,92558,0,124758
143347701900000,SW 414,RESIDENTIAL,24150,0,24150,156423,0,180573
143347702000000,SW 414,RESIDENTIAL,32769,0,32769,158843,0,191612
143347702100000,SW 414,RESIDENTIAL,24644,0,24644,81530,0,106174
143347702200000,SW 414,RESIDENTIAL,24644,0,24644,85627,0,110271
143347702300000,SW 414,RESIDENTIAL,24644,0,24644,101892,0,126536
143347702400000,SW 414,RESIDENTIAL,23901,0,23901,92507,0,116408
143347702500000,SW 414,RESIDENTIAL,34374,0,34374,97683,0,132057
143347702600000,SW 414,RESIDENTIAL,34066,0,34066,110684,0,144750
143347702700000,SW 414,RESIDENTIAL,33262,0,33262,114023,0,147285
143347702800000,SW 414,RESIDENTIAL,31616,0,31616,100733,0,132349
143347702900000,SW 414,RESIDENTIAL,31616,0,31616,110982,0,142598
143347703000000,SW 414,RESIDENTIAL,31616,0,31616,119998,0,151614
143347703100000,SW 414,RESIDENTIAL,31200,0,31200,94416,0,125616
143347703200000,SW 414,RESIDENTIAL,31200,0,31200,108798,0,139998
143347703300000,SW 414,RESIDENTIAL,26000,0,26000,134257,0,160257
143347703400000,SW 414,RESIDENTIAL,32240,0,32240,103150,0,135390
143347703500000,SW 414,RESIDENTIAL,29744,0,29744,112748,0,142492
143347703600000,SW 414,RESIDENTIAL,30160,0,30160,95919,0,126079
143347703700000,SW 414,RESIDENTIAL,29952,0,29952,92772,0,122724
143347703800000,SW 414,RESIDENTIAL,29120,0,29120,94652,0,123772
143347800200000,SW 416,RESIDENTIAL,20300,0,20300,63061,0,83361
143347800300000,SW 416,RESIDENTIAL,20300,0,20300,37947,0,58247
143347800400000,SW 416,RESIDENTIAL,20300,0,20300,101438,0,121738
143347800500000,SW 416,RESIDENTIAL,18200,0,18200,57468,0,75668
143347800600000,SW 416,RESIDENTIAL,19775,0,19775,67501,0,87276
143347800700000,SW 416,RESIDENTIAL,33705,0,33705,113397,0,147102
143347800800000,SW 416,RESIDENTIAL,26239,0,26239,87634,0,113873
143347800900000,SW 416,RESIDENTIAL,24570,0,24570,94039,0,118609
143347801000000,SW 416,RESIDENTIAL,21000,0,21000,94081,0,115081
143347801100000,SW 416,RESIDENTIAL,21000,0,21000,27830,0,48830
143347801200000,SW 416,RESIDENTIAL,17500,0,17500,71413,0,88913
143347801300000,SW 416,RESIDENTIAL,17500,0,17500,95586,0,113086
143347801400000,SW 416,RESIDENTIAL,24990,0,24990,174706,0,199696
143347801500000,SW 416,RESIDENTIAL,26775,0,26775,164547,0,191322
143347900100000,SW 414,RESIDENTIAL,32970,0,32970,97940,0,130910
143347900200000,SW 414,RESIDENTIAL,30244,0,30244,122945,0,153189
143347900300000,SW 414,RESIDENTIAL,31508,0,31508,101730,0,133238
143347900400000,SW 414,RESIDENTIAL,26222,0,26222,90313,0,116535
143347900500000,SW 414,RESIDENTIAL,28280,0,28280,104814,0,133094
143347900600000,SW 414,RESIDENTIAL,28280,0,28280,97993,0,126273
143347900700000,SW 414,RESIDENTIAL,30724,0,30724,113012,0,143736
143347900800000,SW 414,RESIDENTIAL,30520,0,30520,112611,0,143131
143347900900000,SW 414,RESIDENTIAL,33136,0,33136,127478,0,160614
143347901000000,SW 414,RESIDENTIAL,27904,0,27904,104798,0,132702
143347901100000,SW 414,RESIDENTIAL,31392,0,31392,90250,0,121642
143347901200000,SW 414,RESIDENTIAL,29648,0,29648,109743,0,139391
143347901300000,SW 414,RESIDENTIAL,27904,0,27904,115626,0,143530
143347901400000,SW 414,RESIDENTIAL,27904,0,27904,105316,0,133220
143347901500000,SW 414,RESIDENTIAL,31186,0,31186,124310,0,155496
143347901600000,SW 414,RESIDENTIAL,28389,0,28389,127281,0,155670
143347901700000,SW 414,RESIDENTIAL,33660,0,33660,114731,0,148391
143347901800000,SW 414,RESIDENTIAL,33858,0,33858,71052,0,104910
143347901900000,SW 414,RESIDENTIAL,21840,0,21840,102063,0,123903
143347902000000,SW 414,RESIDENTIAL,21840,0,21840,0,0,21840
143347902100000,CHURCH,EXEMPT,0,187380,187380,0,985654,1173034
143347902200000,DAY CARE CENTER,COMMERCIAL,0,69520,69520,0,233729,303249
143348000100000,SW 416,RESIDENTIAL,19740,0,19740,31208,0,50948
143348000200000,SW 416,RESIDENTIAL,25620,0,25620,74647,0,100267
143348000300000,SW 416,RESIDENTIAL,26005,0,26005,95179,0,121184
143348000400000,SW 416,RESIDENTIAL,26773,0,26773,54858,0,81631
143348000500000,SW 416,RESIDENTIAL,27594,0,27594,116566,0,144160
143348000600000,SW 416,RESIDENTIAL,25018,0,25018,76024,0,101042
143348000700000,CHURCH,EXEMPT,0,37206,37206,0,0,37206
143348000800000,SW 416,RESIDENTIAL,33040,0,33040,68078,0,101118
143348000900000,SW 416,RESIDENTIAL,17325,0,17325,83648,0,100973
143348001000000,CHURCH,EXEMPT,0,73980,73980,0,685135,759115
143410100100000,SE 242,RESIDENTIAL,20952,0,20952,42130,0,63082
143415100100000,CITY PROPERTY,EXEMPT,0,0,0,0,0,0
143415100200000,OFFICE,EXEMPT,0,1138320,1138320,0,4084763,5223083
143415100300000,CENTRALLY ASSESSED,OTHER,0,0,0,0,0,0
143417700200000,CITY PROPERTY,EXEMPT,0,0,0,0,0,0
143420100100000,CITY PROPERTY,EXEMPT,0,0,0,0,0,0
143420100200000,CITY PROPERTY,EXEMPT,0,0,0,0,0,0
143422600100000,CITY PROPERTY,EXEMPT,0,0,0,0,0,0
143422600200000,CITY PROPERTY,EXEMPT,0,0,0,0,0,0
143422600300000,CITY PROPERTY,EXEMPT,0,0,0,0,0,0
143422600400000,CITY PROPERTY,EXEMPT,0,0,0,0,0,0
143422600500000,SW 412,RESIDENTIAL,12495,0,12495,61016,0,73511
143422600600000,SW 412,RESIDENTIAL,5000,0,5000,0,0,5000
143422600700000,CITY PROPERTY,EXEMPT,0,0,0,0,0,0
143422600800000,CITY PROPERTY,EXEMPT,0,0,0,0,0,0
143422600900000,CITY PROPERTY,EXEMPT,0,0,0,0,0,0
143422601000000,CITY PROPERTY,EXEMPT,0,0,0,0,0,0
143422601100000,CITY PROPERTY,EXEMPT,0,0,0,0,0,0
143422601200000,SW 412,RESIDENTIAL,12495,0,12495,69526,0,82021
143422601300000,SW 412,RESIDENTIAL,12495,0,12495,53928,0,66423
143422601400000,SW 412,RESIDENTIAL,12495,0,12495,87499,0,99994
143422601500000,SW 412,RESIDENTIAL,20196,0,20196,63730,0,83926
143422601600000,SW 412,RESIDENTIAL,20323,0,20323,97117,0,117440
143422601700000,CITY PROPERTY,EXEMPT,0,0,0,0,0,0
143422601800000,CITY PROPERTY,EXEMPT,0,0,0,0,0,0
143422700100000,CITY PROPERTY,EXEMPT,0,0,0,0,0,0
143422700200000,CITY PROPERTY,EXEMPT,0,9996,9996,0,0,9996
143422700300000,CITY PROPERTY,EXEMPT,0,0,0,0,0,0
143422700400000,CITY PROPERTY,EXEMPT,0,0,0,0,0,0
143422700500000,CITY PROPERTY,EXEMPT,0,0,0,0,0,0
143422700600000,SW 412,RESIDENTIAL,15937,0,15937,67474,0,83411
143422700700000,SW 412,RESIDENTIAL,14344,0,14344,0,0,14344
143422700800000,CITY PROPERTY,EXEMPT,0,0,0,0,0,0
143422700900000,CITY PROPERTY,EXEMPT,0,0,0,0,0,0
143422701000000,CITY PROPERTY,EXEMPT,0,0,0,0,0,0
143422701100000,CITY PROPERTY,EXEMPT,0,0,0,0,0,0
143422701200000,CITY PROPERTY,EXEMPT,0,0,0,0,0,0
143422701300000,CITY PROPERTY,EXEMPT,0,0,0,0,0,0
143422701400000,CITY PROPERTY,EXEMPT,0,0,0,0,0,0
143422701500000,APARTMENT,COMMERCIAL,0,7800,7800,0,58954,66754
143422701600000,CITY PROPERTY,EXEMPT,0,0,0,0,0,0
143422701700000,SW 412,RESIDENTIAL,5000,0,5000,0,0,5000
143422701800000,SW 412,RESIDENTIAL,12495,0,12495,41932,0,54427
143422701900000,SW 412,RESIDENTIAL,12495,0,12495,60221,0,72716
143422702000000,CITY PROPERTY,EXEMPT,0,0,0,0,0,0
143422702100000,CITY PROPERTY,EXEMPT,0,0,0,0,0,0
143422702200000,CITY PROPERTY,EXEMPT,0,0,0,0,0,0
143422702300000,CITY PROPERTY,EXEMPT,0,0,0,0,0,0
143422702400000,CITY PROPERTY,EXEMPT,0,0,0,0,0,0
143422702500000,CITY PROPERTY,EXEMPT,0,0,0,0,0,0
143422800100000,CITY PROPERTY,EXEMPT,0,0,0,0,0,0
143422900100000,CITY PROPERTY,EXEMPT,0,0,0,0,0,0
143422900200000,CITY PROPERTY,EXEMPT,0,0,0,0,0,0
143422900300000,CITY PROPERTY,EXEMPT,0,0,0,0,0,0
143422900400000,CITY PROPERTY,EXEMPT,0,0,0,0,0,0
143423000100000,SW 412,RESIDENTIAL,16867,0,16867,69199,0,86066
143423000200000,SW 412,RESIDENTIAL,18354,0,18354,96144,0,114498
143423000400000,SW 412,RESIDENTIAL,17640,0,17640,99498,0,117138
143423000500000,SW 412,RESIDENTIAL,19320,0,19320,116443,0,135763
143423000600000,SW 412,RESIDENTIAL,20580,0,20580,87887,0,108467
143423000700000,SW 412,RESIDENTIAL,21420,0,21420,72553,0,93973
143423000800000,SW 412,RESIDENTIAL,22260,0,22260,74132,0,96392
143423000900000,SW 412,RESIDENTIAL,22890,0,22890,76111,0,99001
143423001000000,SW 412,RESIDENTIAL,19339,0,19339,91784,0,111123
143423001100000,SW 412,RESIDENTIAL,17325,0,17325,66810,0,84135
143423001200000,SW 412,RESIDENTIAL,20790,0,20790,101668,0,122458
143423001300000,SW 412,RESIDENTIAL,12370,0,12370,65322,0,77692
143423001400000,SW 412,RESIDENTIAL,23716,0,23716,114749,0,138465
143423001500000,SW 412,RESIDENTIAL,19869,0,19869,83247,0,103116
143423001600000,SW 412,RESIDENTIAL,19869,0,19869,94913,0,114782
143423001700000,SW 412,RESIDENTIAL,19869,0,19869,96625,0,116494
143423001800000,APARTMENT,COMMERCIAL,0,21568,21568,0,129380,150948
143423001900000,SW 412,RESIDENTIAL,23302,0,23302,93702,0,117004
143423002000000,SW 412,RESIDENTIAL,24993,0,24993,89238,0,114231
143423002100000,SW 412,RESIDENTIAL,24778,0,24778,88643,0,113421
143423002200000,SW 412,RESIDENTIAL,23520,0,23520,111667,0,135187
143423002300000,SW 412,RESIDENTIAL,24990,0,24990,82433,0,107423
143423002400000,SW 412,RESIDENTIAL,20580,0,20580,81731,0,102311
143423002500000,SW 412,RESIDENTIAL,19320,0,19320,60691,0,80011
143423002600000,SW 412,RESIDENTIAL,17640,0,17640,78312,0,95952
143423002700000,SW 412,RESIDENTIAL,15372,0,15372,69992,0,85364
143423002800000,SW 412,RESIDENTIAL,15372,0,15372,5975,0,21347
143423100100000,SW 412,RESIDENTIAL,11900,0,11900,103404,0,115304
143423100200000,SW 412,RESIDENTIAL,11900,0,11900,53429,0,65329
143423100300000,SW 412,RESIDENTIAL,11900,0,11900,56968,0,68868
143423100400000,SW 412,RESIDENTIAL,11900,0,11900,61429,0,73329
143423100500000,SW 412,RESIDENTIAL,11900,0,11900,47198,0,59098
143423100600000,SW 412,RESIDENTIAL,11900,0,11900,70241,0,82141
143423100700000,SW 412,RESIDENTIAL,11900,0,11900,63065,0,74965
143423100800000,SW 412,RESIDENTIAL,11900,0,11900,0,0,11900
143423100900000,CITY PROPERTY,EXEMPT,0,0,0,0,0,0
143423101000000,CITY PROPERTY,EXEMPT,0,0,0,0,0,0
143423101100000,CITY PROPERTY,EXEMPT,0,0,0,0,0,0
143423101200000,CITY PROPERTY,EXEMPT,0,0,0,0,0,0
143423101300000,SW 412,RESIDENTIAL,22759,0,22759,49058,0,71817
143423101400000,SW 412,RESIDENTIAL,14450,0,14450,78667,0,93117
143423101500000,SW 412,RESIDENTIAL,14450,0,14450,80777,0,95227
143423101600000,SW 412,RESIDENTIAL,14450,0,14450,122537,0,136987
143423101700000,SW 412,RESIDENTIAL,14450,0,14450,115387,0,129837
143423101800000,SW 412,RESIDENTIAL,14450,0,14450,59978,0,74428
143423101900000,SW 412,RESIDENTIAL,14450,0,14450,70662,0,85112
143423102000000,SW 412,RESIDENTIAL,14450,0,14450,64424,0,78874
143423200100000,SW 412,RESIDENTIAL,14450,0,14450,101155,0,115605
143423200200000,SW 412,RESIDENTIAL,14450,0,14450,58698,0,73148
143423200300000,SW 412,RESIDENTIAL,14450,0,14450,78021,0,92471
143423200400000,SW 412,RESIDENTIAL,14450,0,14450,75379,0,89829
143423200500000,SW 412,RESIDENTIAL,16507,0,16507,84156,0,100663
143423200600000,SW 412,RESIDENTIAL,16992,0,16992,39011,0,56003
143423200700000,SW 412,RESIDENTIAL,14726,0,14726,63515,0,78241
143425100200000,CEMETERY,EXEMPT,0,0,0,0,0,0
143425100400000,SECTION 42,COMMERCIAL,0,26929,26929,0,156881,183810
143425100500000,SECTION 42,COMMERCIAL,0,26929,26929,0,156881,183810
143425100600000,SW 413,EXEMPT,0,33137,33137,0,207269,240406
143425100800000,SECTION 42,COMMERCIAL,0,28441,28441,0,156882,185323
143425100900000,SECTION 42,COMMERCIAL,0,28441,28441,0,156882,185323
143425101500000,CEMETERY,EXEMPT,0,0,0,0,0,0
143425101600000,FUNERAL HOME,COMMERCIAL,0,318400,318400,0,859496,1177896
143425101700000,CEMETERY,EXEMPT,0,0,0,0,0,0
143427600100000,APARTMENT,EXEMPT,0,498312,498312,0,5995988,6494300
143427600200000,SW 410,RESIDENTIAL,22548,0,22548,123005,0,145553
143427600300000,SW 410,RESIDENTIAL,22050,0,22050,119878,0,141928
143427600600000,VACANT LAND,COMMERCIAL,0,23690,23690,0,0,23690
143427600700000,APARTMENT,EXEMPT,0,56106,56106,0,1118623,1174729
143427600900000,APARTMENT,COMMERCIAL,0,25012,25012,0,148913,173925
143427700100000,SW 410,RESIDENTIAL,27745,0,27745,74511,0,102256
143427800100000,SW 410,RESIDENTIAL,11785,0,11785,39653,0,51438
143427800200000,SW 410,RESIDENTIAL,23871,0,23871,0,0,23871
143427800300000,SW 410,RESIDENTIAL,22634,0,22634,106964,0,129598
143427800400000,SW 410,RESIDENTIAL,21210,0,21210,94052,0,115262
143427800500000,SW 430,RESIDENTIAL,29952,0,29952,97808,0,127760
143427800600000,SW 430,RESIDENTIAL,29700,0,29700,103649,0,133349
143427800700000,SW 430,RESIDENTIAL,27029,0,27029,101681,0,128710
143427800800000,SW 430,RESIDENTIAL,28024,0,28024,103450,0,131474
143427800900000,SW 430,RESIDENTIAL,28024,0,28024,95103,0,123127
143427801000000,SW 430,RESIDENTIAL,28024,0,28024,100575,0,128599
143427801100000,SW 430,RESIDENTIAL,28024,0,28024,96218,0,124242
143427801200000,SW 430,RESIDENTIAL,24056,0,24056,91198,0,115254
143427801300000,SW 430,RESIDENTIAL,27781,0,27781,100869,0,128650
143427801400000,SW 430,RESIDENTIAL,30742,0,30742,83538,0,114280
143427801500000,SW 410,RESIDENTIAL,25134,0,25134,80831,0,105965
143427801600000,SW 410,RESIDENTIAL,14981,0,14981,67127,0,82108
143427801700000,SW 410,RESIDENTIAL,23990,0,23990,64970,0,88960
143427801800000,SW 410,RESIDENTIAL,13800,0,13800,75512,0,89312
143427801900000,SW 410,RESIDENTIAL,13800,0,13800,47188,0,60988
143427802000000,SW 410,RESIDENTIAL,11730,0,11730,0,0,11730
143427900100000,SW 430,RESIDENTIAL,30957,0,30957,93404,0,124361
143427900200000,SW 430,RESIDENTIAL,30133,0,30133,81691,0,111824
143427900300000,SW 430,RESIDENTIAL,29848,0,29848,110950,0,140798
143427900400000,SW 430,RESIDENTIAL,26624,0,26624,83025,0,109649
143427900500000,SW 430,RESIDENTIAL,27048,0,27048,107011,0,134059
143427900600000,SW 430,RESIDENTIAL,28090,0,28090,80979,0,109069
143427900700000,SW 430,RESIDENTIAL,24800,0,24800,84811,0,109611
143427900800000,SW 430,RESIDENTIAL,24800,0,24800,106059,0,130859
143427900900000,SW 430,RESIDENTIAL,24800,0,24800,88378,0,113178
143427901000000,SW 430,RESIDENTIAL,24800,0,24800,91546,0,116346
143427901100000,SW 430,RESIDENTIAL,24800,0,24800,85437,0,110237
143427901200000,SW 430,RESIDENTIAL,24800,0,24800,91082,0,115882
143427901300000,SW 430,RESIDENTIAL,24800,0,24800,86767,0,111567
143427901400000,SW 430,RESIDENTIAL,24800,0,24800,89499,0,114299
143427901500000,SW 430,RESIDENTIAL,24800,0,24800,93109,0,117909
143427901600000,SW 430,RESIDENTIAL,24800,0,24800,108010,0,132810
143427901700000,SW 430,RESIDENTIAL,28667,0,28667,99350,0,128017
143427901800000,SW 430,RESIDENTIAL,27733,0,27733,100572,0,128305
143427901900000,SW 430,RESIDENTIAL,24800,0,24800,90341,0,115141
143427902000000,SW 430,RESIDENTIAL,24800,0,24800,77998,0,102798
143427902100000,SW 430,RESIDENTIAL,24800,0,24800,84775,0,109575
143427902200000,SW 430,RESIDENTIAL,24800,0,24800,102632,0,127432
143427902300000,SW 430,RESIDENTIAL,24800,0,24800,91454,0,116254
143427902400000,SW 430,RESIDENTIAL,24800,0,24800,93879,0,118679
143427902500000,SW 430,RESIDENTIAL,28953,0,28953,96801,0,125754
143427902600000,SW 430,RESIDENTIAL,28819,0,28819,78653,0,107472
143427902700000,SW 430,RESIDENTIAL,26664,0,26664,82016,0,108680
143428000100000,SW 430,RESIDENTIAL,27963,0,27963,93564,0,121527
143428000200000,SW 430,RESIDENTIAL,28340,0,28340,92577,0,120917
143428000300000,SW 430,RESIDENTIAL,26880,0,26880,107970,0,134850
143428000400000,SW 430,RESIDENTIAL,24717,0,24717,78070,0,102787
143428000500000,SW 430,RESIDENTIAL,27136,0,27136,84259,0,111395
143428000600000,SW 430,RESIDENTIAL,24684,0,24684,81423,0,106107
143428000700000,SW 430,RESIDENTIAL,23061,0,23061,86357,0,109418
143428000800000,SW 430,RESIDENTIAL,23312,0,23312,106019,0,129331
143428000900000,SW 430,RESIDENTIAL,23312,0,23312,81730,0,105042
143428001000000,SW 430,RESIDENTIAL,23312,0,23312,83996,0,107308
143428001100000,SW 430,RESIDENTIAL,23312,0,23312,116387,0,139699
143428001200000,SW 430,RESIDENTIAL,23312,0,23312,94251,0,117563
143428001300000,SW 430,RESIDENTIAL,23312,0,23312,90215,0,113527
143428001400000,SW 430,RESIDENTIAL,23312,0,23312,89156,0,112468
143428001500000,SW 430,RESIDENTIAL,23312,0,23312,82712,0,106024
143428001600000,SW 430,RESIDENTIAL,23312,0,23312,81609,0,104921
143428001700000,SW 430,RESIDENTIAL,23312,0,23312,82592,0,105904
143428001800000,SW 430,RESIDENTIAL,26119,0,26119,104673,0,130792
143430100100000,SW 410,RESIDENTIAL,20056,0,20056,68877,0,88933
143430100200000,SW 410,RESIDENTIAL,16950,0,16950,95986,0,112936
143430100300000,SW 410,RESIDENTIAL,16950,0,16950,63360,0,80310
143430100400000,SW 410,RESIDENTIAL,15000,0,15000,85102,0,100102
143430100500000,SW 410,RESIDENTIAL,14848,0,14848,112215,0,127063
143430100600000,SW 410,RESIDENTIAL,14848,0,14848,52710,0,67558
143430100700000,SW 410,RESIDENTIAL,19200,0,19200,119198,0,138398
143430100800000,SW 410,RESIDENTIAL,18000,0,18000,74832,0,92832
143430100900000,SW 410,RESIDENTIAL,18000,0,18000,53765,0,71765
143430101000000,SW 410,RESIDENTIAL,18000,0,18000,0,0,18000
143430101100000,SW 410,RESIDENTIAL,18000,0,18000,87802,0,105802
143430101200000,SW 410,RESIDENTIAL,18000,0,18000,81788,0,99788
143430101300000,SW 410,RESIDENTIAL,18000,0,18000,45868,0,63868
143430101400000,SW 410,RESIDENTIAL,18000,0,18000,60105,0,78105
143430101500000,SW 410,RESIDENTIAL,18000,0,18000,110897,0,128897
143430101600000,SW 410,RESIDENTIAL,18000,0,18000,55648,0,73648
143430101700000,SW 410,RESIDENTIAL,18000,0,18000,46195,0,64195
143430101800000,SW 410,RESIDENTIAL,18000,0,18000,50389,0,68389
143430101900000,SW 410,RESIDENTIAL,18000,0,18000,86354,0,104354
143430102000000,SW 410,RESIDENTIAL,18000,0,18000,86772,0,104772
143430102100000,SW 410,RESIDENTIAL,18000,0,18000,62722,0,80722
143430102200000,SW 410,RESIDENTIAL,18000,0,18000,97169,0,115169
143430102300000,SW 410,RESIDENTIAL,18000,0,18000,76345,0,94345
143430102400000,SW 410,RESIDENTIAL,18000,0,18000,73051,0,91051
143430102500000,SW 410,RESIDENTIAL,18000,0,18000,55718,0,73718
143430102600000,SW 410,RESIDENTIAL,18000,0,18000,46706,0,64706
143430102700000,SW 410,RESIDENTIAL,18000,0,18000,18765,0,36765
143430102800000,SW 410,RESIDENTIAL,17850,0,17850,47205,0,65055
143430200100000,SW 410,RESIDENTIAL,19206,0,19206,0,0,19206
143430200200000,SW 410,RESIDENTIAL,17100,0,17100,80004,0,97104
143430200300000,SW 410,RESIDENTIAL,21888,0,21888,48653,0,70541
143430200400000,SW 410,RESIDENTIAL,20349,0,20349,93953,0,114302
143430200500000,SW 410,RESIDENTIAL,17100,0,17100,79755,0,96855
143430200600000,SW 430,RESIDENTIAL,27350,0,27350,70965,0,98315
143430200700000,SW 430,RESIDENTIAL,24024,0,24024,88972,0,112996
143430200800000,SW 430,RESIDENTIAL,24480,0,24480,96423,0,120903
143430200900000,SW 430,RESIDENTIAL,24480,0,24480,79740,0,104220
143430201000000,SW 430,RESIDENTIAL,24480,0,24480,77555,0,102035
143430201100000,SW 430,RESIDENTIAL,24480,0,24480,90984,0,115464
143430201200000,SW 430,RESIDENTIAL,24480,0,24480,78489,0,102969
143430201300000,SW 430,RESIDENTIAL,24480,0,24480,87935,0,112415
143430201400000,SW 430,RESIDENTIAL,24480,0,24480,79815,0,104295
143430201500000,SW 430,RESIDENTIAL,24480,0,24480,101758,0,126238
143430201600000,SW 430,RESIDENTIAL,24480,0,24480,103698,0,128178
143430201700000,SW 430,RESIDENTIAL,26520,0,26520,105890,0,132410
143430201800000,SW 430,RESIDENTIAL,24480,0,24480,86183,0,110663
143430201900000,SW 430,RESIDENTIAL,26928,0,26928,83874,0,110802
143430202000000,SW 430,RESIDENTIAL,24072,0,24072,95744,0,119816
143430202100000,SW 430,RESIDENTIAL,25500,0,25500,79148,0,104648
143430202200000,SW 430,RESIDENTIAL,25500,0,25500,82118,0,107618
143430202300000,SW 430,RESIDENTIAL,26044,0,26044,101960,0,128004
143430202400000,SW 430,RESIDENTIAL,25970,0,25970,89533,0,115503
143430202500000,SW 430,RESIDENTIAL,28673,0,28673,76338,0,105011
143430202600000,SW 430,RESIDENTIAL,31105,0,31105,87907,0,119012
143430202700000,SW 410,RESIDENTIAL,18000,0,18000,80064,0,98064
143430202800000,SW 410,RESIDENTIAL,27000,0,27000,37637,0,64637
143430202900000,SW 410,RESIDENTIAL,18000,0,18000,31930,0,49930
143430203000000,SW 410,RESIDENTIAL,18000,0,18000,100862,0,118862
143430203100000,SW 410,RESIDENTIAL,18000,0,18000,67562,0,85562
143430203200000,SW 410,RESIDENTIAL,18000,0,18000,94065,0,112065
143430203300000,SW 410,RESIDENTIAL,18000,0,18000,117252,0,135252
143430203400000,SW 410,RESIDENTIAL,18000,0,18000,72600,0,90600
143430203500000,SW 410,RESIDENTIAL,18000,0,18000,107095,0,125095
143430203600000,SW 410,RESIDENTIAL,18000,0,18000,60450,0,78450
143430203700000,SW 410,RESIDENTIAL,18000,0,18000,51947,0,69947
143430203800000,SW 410,RESIDENTIAL,18000,0,18000,48625,0,66625
143430203900000,SW 410,RESIDENTIAL,18000,0,18000,119956,0,137956
143430204000000,SW 410,RESIDENTIAL,18000,0,18000,52975,0,70975
143430204100000,SW 410,RESIDENTIAL,18000,0,18000,52628,0,70628
143430204200000,SW 410,RESIDENTIAL,18000,0,18000,67437,0,85437
143430204300000,SW 410,RESIDENTIAL,18000,0,18000,46079,0,64079
143430204400000,SW 410,RESIDENTIAL,18000,0,18000,72399,0,90399
143430204500000,SW 410,RESIDENTIAL,18000,0,18000,92991,0,110991
143430204600000,SW 410,RESIDENTIAL,18000,0,18000,47686,0,65686
143430204700000,SW 410,RESIDENTIAL,11400,0,11400,49386,0,60786
143430204800000,SW 410,RESIDENTIAL,11400,0,11400,46865,0,58265
143430300100000,SW 430,RESIDENTIAL,24024,0,24024,107258,0,131282
143430300200000,SW 430,RESIDENTIAL,24000,0,24000,79847,0,103847
143430300300000,SW 430,RESIDENTIAL,24000,0,24000,81744,0,105744
143430300400000,SW 430,RESIDENTIAL,23733,0,23733,99803,0,123536
143430300500000,SW 430,RESIDENTIAL,24000,0,24000,92662,0,116662
143430300600000,SW 430,RESIDENTIAL,24000,0,24000,83568,0,107568
143430300700000,SW 430,RESIDENTIAL,24000,0,24000,77472,0,101472
143430300800000,SW 430,RESIDENTIAL,24000,0,24000,94514,0,118514
143430300900000,SW 430,RESIDENTIAL,24000,0,24000,109710,0,133710
143430301000000,SW 430,RESIDENTIAL,24000,0,24000,89971,0,113971
143430301100000,SW 430,RESIDENTIAL,24000,0,24000,104173,0,128173
143430301200000,SW 430,RESIDENTIAL,24000,0,24000,91578,0,115578
143430301300000,SW 430,RESIDENTIAL,24000,0,24000,93692,0,117692
143430301400000,SW 430,RESIDENTIAL,25000,0,25000,88145,0,113145
143430301500000,SW 430,RESIDENTIAL,25000,0,25000,85195,0,110195
143430301600000,SW 430,RESIDENTIAL,25920,0,25920,86391,0,112311
143430301700000,SW 430,RESIDENTIAL,21200,0,21200,100851,0,122051
143430301800000,SW 430,RESIDENTIAL,25000,0,25000,88705,0,113705
143430301900000,SW 430,RESIDENTIAL,25000,0,25000,105162,0,130162
143430302000000,SW 430,RESIDENTIAL,25500,0,25500,81237,0,106737
143430302100000,SW 430,RESIDENTIAL,25920,0,25920,108552,0,134472
143430302200000,SW 430,RESIDENTIAL,26790,0,26790,127786,0,154576
143430302300000,SW 430,RESIDENTIAL,25320,0,25320,80402,0,105722
143430302400000,SW 430,RESIDENTIAL,26000,0,26000,88022,0,114022
143430302500000,SW 430,RESIDENTIAL,24000,0,24000,116294,0,140294
143430302600000,SW 430,RESIDENTIAL,25000,0,25000,94435,0,119435
143430302700000,SW 430,RESIDENTIAL,25000,0,25000,85851,0,110851
143430302800000,SW 430,RESIDENTIAL,22800,0,22800,110942,0,133742
143430302900000,SW 430,RESIDENTIAL,27200,0,27200,77337,0,104537
143430303000000,SW 430,RESIDENTIAL,24000,0,24000,86760,0,110760
143430303100000,SW 430,RESIDENTIAL,24000,0,24000,81211,0,105211
143430303200000,SW 430,RESIDENTIAL,24000,0,24000,89076,0,113076
143430303300000,SW 430,RESIDENTIAL,24000,0,24000,95332,0,119332
143430303400000,SW 430,RESIDENTIAL,24000,0,24000,85251,0,109251
143430303500000,SW 430,RESIDENTIAL,24000,0,24000,80525,0,104525
143430303600000,SW 430,RESIDENTIAL,24000,0,24000,92100,0,116100
143430303700000,SW 430,RESIDENTIAL,24000,0,24000,84514,0,108514
143430303800000,SW 430,RESIDENTIAL,24000,0,24000,93854,0,117854
143430400100000,SW 430,RESIDENTIAL,24267,0,24267,87341,0,111608
143430400200000,SW 430,RESIDENTIAL,23971,0,23971,79414,0,103385
143430400300000,SW 430,RESIDENTIAL,24000,0,24000,80406,0,104406
143430400400000,SW 430,RESIDENTIAL,24000,0,24000,80724,0,104724
143430400500000,SW 430,RESIDENTIAL,24000,0,24000,88756,0,112756
143430400600000,SW 430,RESIDENTIAL,24000,0,24000,85753,0,109753
143430400700000,SW 430,RESIDENTIAL,24000,0,24000,121947,0,145947
143430400800000,SW 430,RESIDENTIAL,26600,0,26600,153681,0,180281
143430400900000,SW 430,RESIDENTIAL,20000,0,20000,86740,0,106740
143430401000000,SW 430,RESIDENTIAL,24000,0,24000,90323,0,114323
143430401100000,SW 430,RESIDENTIAL,24000,0,24000,81334,0,105334
143430401200000,SW 430,RESIDENTIAL,26600,0,26600,117054,0,143654
143430401300000,SW 430,RESIDENTIAL,22000,0,22000,130333,0,152333
143430401400000,SW 430,RESIDENTIAL,25000,0,25000,84558,0,109558
143430401500000,SW 430,RESIDENTIAL,25000,0,25000,100066,0,125066
143430401600000,SW 430,RESIDENTIAL,30000,0,30000,110216,0,140216
143430401700000,SW 430,RESIDENTIAL,30160,0,30160,116389,0,146549
143430401800000,SW 430,RESIDENTIAL,26429,0,26429,81341,0,107770
143430401900000,SW 430,RESIDENTIAL,32976,0,32976,96697,0,129673
143432600100000,CITY PROPERTY,EXEMPT,0,0,0,0,0,0
143432600200000,SW 414,RESIDENTIAL,21800,0,21800,55499,0,77299
143432600300000,SW 414,RESIDENTIAL,33792,0,33792,111997,0,145789
143432600400000,SW 414,RESIDENTIAL,25692,0,25692,94985,0,120677
143432600500000,SW 414,RESIDENTIAL,26624,0,26624,86678,0,113302
143432600600000,SW 414,RESIDENTIAL,26624,0,26624,82225,0,108849
143432600700000,SW 414,RESIDENTIAL,26624,0,26624,78511,0,105135
143432600800000,SW 414,RESIDENTIAL,26624,0,26624,82167,0,108791
143432600900000,SW 414,RESIDENTIAL,26624,0,26624,106434,0,133058
143432601000000,SW 414,RESIDENTIAL,26624,0,26624,100781,0,127405
143432601100000,SW 414,RESIDENTIAL,26624,0,26624,94126,0,120750
143432601200000,SW 414,RESIDENTIAL,26624,0,26624,96141,0,122765
143432601300000,SW 414,RESIDENTIAL,26624,0,26624,80419,0,107043
143432601400000,SW 414,RESIDENTIAL,26624,0,26624,89697,0,116321
143432601500000,SW 414,RESIDENTIAL,29952,0,29952,100801,0,130753
143432601600000,SW 414,RESIDENTIAL,26624,0,26624,113597,0,140221
143432601700000,SW 414,RESIDENTIAL,30784,0,30784,121931,0,152715
143432601800000,SW 414,RESIDENTIAL,31200,0,31200,98753,0,129953
143432601900000,SW 414,RESIDENTIAL,24480,0,24480,96149,0,120629
143432602000000,SW 414,RESIDENTIAL,31132,0,31132,113947,0,145079
143432700100000,SW 414,RESIDENTIAL,25440,0,25440,85145,0,110585
143432700200000,SW 414,RESIDENTIAL,31800,0,31800,91808,0,123608
143432700300000,SW 414,RESIDENTIAL,32301,0,32301,99907,0,132208
143432700400000,SW 414,RESIDENTIAL,34339,0,34339,92703,0,127042
143432700500000,SW 414,RESIDENTIAL,31887,0,31887,89424,0,121311
143432700600000,SW 414,RESIDENTIAL,22697,0,22697,108261,0,130958
143432700700000,SW 414,RESIDENTIAL,28812,0,28812,93168,0,121980
143432700800000,SW 414,RESIDENTIAL,22697,0,22697,107298,0,129995
143432700900000,SW 414,RESIDENTIAL,30184,0,30184,101815,0,131999
143432701000000,SW 414,RESIDENTIAL,29792,0,29792,87573,0,117365
143432701100000,SW 414,RESIDENTIAL,28812,0,28812,115463,0,144275
143432701200000,SW 414,RESIDENTIAL,23520,0,23520,82248,0,105768
143432701300000,SW 414,RESIDENTIAL,28812,0,28812,84865,0,113677
143432701400000,SW 414,RESIDENTIAL,23520,0,23520,85300,0,108820
143432701500000,SW 414,RESIDENTIAL,23912,0,23912,83278,0,107190
143432701600000,SW 414,RESIDENTIAL,25441,0,25441,99167,0,124608
143432701700000,SW 414,RESIDENTIAL,27440,0,27440,102921,0,130361
143432701800000,SW 414,RESIDENTIAL,22046,0,22046,92408,0,114454
143432701900000,SW 414,RESIDENTIAL,26394,0,26394,90469,0,116863
143432702000000,SW 414,RESIDENTIAL,30784,0,30784,92297,0,123081
143432702100000,SW 414,RESIDENTIAL,26624,0,26624,98462,0,125086
143432702200000,SW 414,RESIDENTIAL,29952,0,29952,97987,0,127939
143432702300000,SW 414,RESIDENTIAL,27872,0,27872,88844,0,116716
143432702400000,SW 414,RESIDENTIAL,26624,0,26624,84553,0,111177
143432702500000,SW 414,RESIDENTIAL,26208,0,26208,85649,0,111857
143432702600000,SW 414,RESIDENTIAL,26208,0,26208,78129,0,104337
143432702700000,SW 414,RESIDENTIAL,25792,0,25792,71696,0,97488
143432702800000,SW 414,RESIDENTIAL,26624,0,26624,76903,0,103527
143432702900000,SW 414,RESIDENTIAL,26208,0,26208,102986,0,129194
143432703000000,SW 414,RESIDENTIAL,26208,0,26208,88062,0,114270
143432703100000,SW 414,RESIDENTIAL,26208,0,26208,81924,0,108132
143432703200000,SW 414,RESIDENTIAL,26208,0,26208,72704,0,98912
143432703300000,SW 414,RESIDENTIAL,26415,0,26415,84687,0,111102
143432800100000,FAST FOOD,COMMERCIAL,0,84165,84165,0,135013,219178
143432800200000,SW 414,RESIDENTIAL,33221,0,33221,96673,0,129894
143432800300000,SW 414,RESIDENTIAL,25181,0,25181,84446,0,109627
143432800400000,SW 414,RESIDENTIAL,24056,0,24056,81013,0,105069
143432800500000,SW 414,RESIDENTIAL,29876,0,29876,105599,0,135475
143432800600000,SW 414,RESIDENTIAL,28518,0,28518,96753,0,125271
143432800700000,SW 414,RESIDENTIAL,28324,0,28324,102860,0,131184
143432800800000,SW 414,RESIDENTIAL,27548,0,27548,84544,0,112092
143432800900000,SW 414,RESIDENTIAL,28518,0,28518,115416,0,143934
143432801000000,SW 414,RESIDENTIAL,24250,0,24250,75490,0,99740
143432801100000,SW 414,RESIDENTIAL,25181,0,25181,86334,0,111515
143432801200000,SW 414,RESIDENTIAL,23668,0,23668,80101,0,103769
143432801300000,SW 414,RESIDENTIAL,24952,0,24952,108754,0,133706
143432801400000,SW 414,RESIDENTIAL,25181,0,25181,81913,0,107094
143432801500000,SW 414,RESIDENTIAL,23254,0,23254,96815,0,120069
143432900100000,SW 414,RESIDENTIAL,28879,0,28879,79599,0,108478
143432900200000,SW 414,RESIDENTIAL,27472,0,27472,89602,0,117074
143432900300000,SW 414,RESIDENTIAL,29980,0,29980,102159,0,132139
143432900400000,SW 414,RESIDENTIAL,23261,0,23261,118960,0,142221
143432900500000,SW 414,RESIDENTIAL,23879,0,23879,121023,0,144902
143432900600000,SW 414,RESIDENTIAL,33949,0,33949,118125,0,152074
143435100100000,SW 414,RESIDENTIAL,24740,0,24740,74376,0,99116
143435100200000,SW 414,RESIDENTIAL,25200,0,25200,83837,0,109037
143435100300000,SW 414,RESIDENTIAL,25200,0,25200,88413,0,113613
143435100400000,SW 414,RESIDENTIAL,25200,0,25200,99754,0,124954
143435100500000,SW 414,RESIDENTIAL,24800,0,24800,99248,0,124048
143435100600000,SW 414,RESIDENTIAL,24800,0,24800,95034,0,119834
143435100700000,SW 414,RESIDENTIAL,32000,0,32000,112674,0,144674
143435100800000,SW 414,RESIDENTIAL,27572,0,27572,138782,0,166354
143435100900000,SW 414,RESIDENTIAL,27200,0,27200,140889,0,168089
143435101000000,SW 414,RESIDENTIAL,32000,0,32000,98778,0,130778
143435101100000,SW 414,RESIDENTIAL,26571,0,26571,109089,0,135660
143435101200000,SW 414,RESIDENTIAL,32000,0,32000,119553,0,151553
143435101300000,SW 414,RESIDENTIAL,32000,0,32000,89597,0,121597
143435101400000,SW 414,RESIDENTIAL,32000,0,32000,99214,0,131214
143435101500000,SW 414,RESIDENTIAL,32000,0,32000,117371,0,149371
143435101600000,SW 414,RESIDENTIAL,32000,0,32000,117121,0,149121
143435101700000,SW 414,RESIDENTIAL,32000,0,32000,97829,0,129829
143435101800000,SW 414,RESIDENTIAL,32284,0,32284,99288,0,131572
143435200100000,SW 414,RESIDENTIAL,25413,0,25413,87327,0,112740
143435200200000,SW 414,RESIDENTIAL,24000,0,24000,77065,0,101065
143435200300000,SW 414,RESIDENTIAL,24000,0,24000,75892,0,99892
143435200400000,SW 414,RESIDENTIAL,24000,0,24000,71691,0,95691
143435200500000,SW 414,RESIDENTIAL,24000,0,24000,80779,0,104779
143435200600000,SW 414,RESIDENTIAL,25600,0,25600,90709,0,116309
143435200700000,SW 414,RESIDENTIAL,25069,0,25069,75793,0,100862
143435300100000,SW 414,RESIDENTIAL,24460,0,24460,77564,0,102024
143435300200000,SW 414,RESIDENTIAL,24250,0,24250,79879,0,104129
143435300300000,SW 414,RESIDENTIAL,24250,0,24250,81945,0,106195
143435300400000,SW 414,RESIDENTIAL,24040,0,24040,80957,0,104997
143435300500000,SW 414,RESIDENTIAL,26311,0,26311,89817,0,116128
143435300600000,SW 414,RESIDENTIAL,25856,0,25856,100153,0,126009
143435300700000,SW 414,RESIDENTIAL,28280,0,28280,114365,0,142645
143435300800000,SW 414,RESIDENTIAL,25856,0,25856,77813,0,103669
143435300900000,SW 414,RESIDENTIAL,25856,0,25856,87876,0,113732
143435301000000,SW 414,RESIDENTIAL,29128,0,29128,91242,0,120370
143435301100000,SW 414,RESIDENTIAL,28819,0,28819,86157,0,114976
143435301200000,SW 414,RESIDENTIAL,30888,0,30888,108829,0,139717
143435301300000,SW 414,RESIDENTIAL,27936,0,27936,95877,0,123813
143435301400000,SW 414,RESIDENTIAL,32587,0,32587,120027,0,152614
143435301500000,SW 414,RESIDENTIAL,30400,0,30400,146702,0,177102
143435301600000,SW 414,RESIDENTIAL,29799,0,29799,97866,0,127665
143435301700000,SW 414,RESIDENTIAL,26656,0,26656,106133,0,132789
143435301800000,SW 414,RESIDENTIAL,32139,0,32139,99454,0,131593
143435301900000,SW 414,RESIDENTIAL,31512,0,31512,100643,0,132155
143435302000000,SW 414,RESIDENTIAL,27744,0,27744,101615,0,129359
143435302100000,SW 414,RESIDENTIAL,26112,0,26112,92377,0,118489
143435302200000,SW 414,RESIDENTIAL,26112,0,26112,90403,0,116515
143435302300000,SW 414,RESIDENTIAL,26112,0,26112,85155,0,111267
143435302400000,SW 414,RESIDENTIAL,25549,0,25549,103536,0,129085
143435400100000,SW 414,RESIDENTIAL,25889,0,25889,82702,0,108591
143435400200000,SW 414,RESIDENTIAL,25600,0,25600,106431,0,132031
143435400300000,SW 414,RESIDENTIAL,24000,0,24000,82273,0,106273
143435400400000,SW 414,RESIDENTIAL,27200,0,27200,82049,0,109249
143435400500000,SW 414,RESIDENTIAL,28000,0,28000,87522,0,115522
143435400600000,SW 414,RESIDENTIAL,28000,0,28000,84689,0,112689
143435400700000,SW 414,RESIDENTIAL,27720,0,27720,95390,0,123110
143435400800000,SW 414,RESIDENTIAL,31548,0,31548,96973,0,128521
143435400900000,SW 414,RESIDENTIAL,28512,0,28512,85166,0,113678
143435401000000,SW 414,RESIDENTIAL,25480,0,25480,87929,0,113409
143435401100000,SW 414,RESIDENTIAL,24960,0,24960,100062,0,125022
143435401200000,SW 414,RESIDENTIAL,28243,0,28243,93435,0,121678
143435401300000,SW 414,RESIDENTIAL,29700,0,29700,110945,0,140645
143435401400000,SW 414,RESIDENTIAL,34300,0,34300,98213,0,132513
143435401500000,SW 414,RESIDENTIAL,25644,0,25644,104571,0,130215
143435401600000,SW 414,RESIDENTIAL,25600,0,25600,107366,0,132966
143435401700000,SW 414,RESIDENTIAL,25380,0,25380,137303,0,162683
143435401800000,SW 414,RESIDENTIAL,26516,0,26516,86275,0,112791
143435401900000,SW 414,RESIDENTIAL,25600,0,25600,96655,0,122255
143435402000000,SW 414,RESIDENTIAL,25600,0,25600,81481,0,107081
143435402100000,SW 414,RESIDENTIAL,25600,0,25600,101707,0,127307
143435402200000,SW 414,RESIDENTIAL,28045,0,28045,101844,0,129889
143437600100000,SW 410,RESIDENTIAL,17850,0,17850,123416,0,141266
143437600200000,SW 410,RESIDENTIAL,17644,0,17644,83741,0,101385
143437600300000,SW 410,RESIDENTIAL,17850,0,17850,58799,0,76649
143437600400000,SW 410,RESIDENTIAL,17850,0,17850,69778,0,87628
143437600500000,SW 410,RESIDENTIAL,17850,0,17850,127122,0,144972
143437600600000,SW 410,RESIDENTIAL,21420,0,21420,39574,0,60994
143437600700000,SW 410,RESIDENTIAL,21420,0,21420,83387,0,104807
143437600800000,SW 410,RESIDENTIAL,21420,0,21420,0,0,21420
143437600900000,SW 410,RESIDENTIAL,17850,0,17850,68500,0,86350
143437601000000,SW 410,RESIDENTIAL,17850,0,17850,63352,0,81202
143437601100000,SW 410,RESIDENTIAL,17850,0,17850,93694,0,111544
143437601200000,SW 410,RESIDENTIAL,21420,0,21420,52980,0,74400
143437601300000,SW 410,RESIDENTIAL,17850,0,17850,50406,0,68256
143437601400000,SW 410,RESIDENTIAL,17850,0,17850,69150,0,87000
143437601500000,SW 410,RESIDENTIAL,17850,0,17850,42484,0,60334
143437601600000,SW 410,RESIDENTIAL,17850,0,17850,72482,0,90332
143437601700000,SW 410,RESIDENTIAL,17850,0,17850,44655,0,62505
143437601800000,SW 410,RESIDENTIAL,17850,0,17850,107938,0,125788
143437601900000,SW 410,RESIDENTIAL,17850,0,17850,134137,0,151987
143437602000000,SW 410,RESIDENTIAL,17850,0,17850,65519,0,83369
143437602100000,SW 410,RESIDENTIAL,17850,0,17850,136903,0,154753
143437602200000,CITY PROPERTY,EXEMPT,0,0,0,0,0,0
143437700100000,SW 410,RESIDENTIAL,17850,0,17850,70319,0,88169
143437700200000,CITY PROPERTY,EXEMPT,0,0,0,0,0,0
143437700300000,SW 410,RESIDENTIAL,20849,0,20849,75717,0,96566
143437700400000,SW 410,RESIDENTIAL,17850,0,17850,96159,0,114009
143437700500000,SW 410,RESIDENTIAL,17850,0,17850,40340,0,58190
143437700600000,SW 410,RESIDENTIAL,17850,0,17850,58659,0,76509
143437700700000,SW 410,RESIDENTIAL,17850,0,17850,57984,0,75834
143437700800000,SW 410,RESIDENTIAL,17850,0,17850,0,0,17850
143437700900000,SW 410,RESIDENTIAL,21420,0,21420,117914,0,139334
143437701000000,SW 410,RESIDENTIAL,21420,0,21420,61421,0,82841
143437701100000,SW 410,RESIDENTIAL,17850,0,17850,66302,0,84152
143437701200000,SW 410,RESIDENTIAL,21420,0,21420,41562,0,62982
143437701300000,SW 410,RESIDENTIAL,21420,0,21420,44181,0,65601
143437701400000,SW 410,RESIDENTIAL,17850,0,17850,58474,0,76324
143437701500000,SW 410,RESIDENTIAL,17850,0,17850,42558,0,60408
143437701600000,SW 410,RESIDENTIAL,17850,0,17850,73339,0,91189
143437701700000,SW 410,RESIDENTIAL,17850,0,17850,65594,0,83444
143437701800000,SW 410,RESIDENTIAL,17850,0,17850,102865,0,120715
143437701900000,SW 410,RESIDENTIAL,17850,0,17850,68769,0,86619
143437702000000,SW 410,RESIDENTIAL,17850,0,17850,80108,0,97958
143437702100000,SW 410,RESIDENTIAL,17850,0,17850,72353,0,90203
143437702200000,SW 410,RESIDENTIAL,17850,0,17850,86924,0,104774
143437702300000,SW 410,RESIDENTIAL,17850,0,17850,79362,0,97212
143440100100000,CITY PROPERTY,EXEMPT,0,0,0,0,0,0
143440200100000,SW 411,RESIDENTIAL,53125,0,53125,102589,0,155714
143440300100000,SW 411,RESIDENTIAL,5000,0,5000,1380,0,6380
143440300200000,SW 411,RESIDENTIAL,11750,0,11750,0,0,11750
143442600300000,SW 411,RESIDENTIAL,33495,0,33495,74199,0,107694
143442600400000,SW 411,RESIDENTIAL,33495,0,33495,59368,0,92863
143442600500000,SW 411,RESIDENTIAL,33495,0,33495,49344,0,82839
143442600600000,SW 411,RESIDENTIAL,33495,0,33495,70890,0,104385
143442600700000,VACANT LAND,EXEMPT,0,27000,27000,0,0,27000
143442600800000,SW 411,EXEMPT,0,35284,35284,0,116345,151629
143442600900000,SW 411,EXEMPT,0,33495,33495,0,90964,124459
143442601000000,VACANT LAND,EXEMPT,0,54000,54000,0,0,54000
143442601100000,VACANT LAND,EXEMPT,0,49302,49302,0,432,49734
143442601200000,VACANT LAND,EXEMPT,0,27815,27815,0,0,27815
143442601300000,VACANT LAND,EXEMPT,0,24057,24057,0,0,24057
143442601400000,SW 411,RESIDENTIAL,50743,0,50743,170806,0,221549
143442700300000,SW 431,RESIDENTIAL,43492,0,43492,145956,0,189448
143442700400000,SW 431,RESIDENTIAL,40800,0,40800,141199,0,181999
143442700500000,SW 431,RESIDENTIAL,29750,0,29750,145547,0,175297
143442700600000,SW 431,RESIDENTIAL,36947,0,36947,135500,0,172447
143442700700000,SW 431,RESIDENTIAL,39053,0,39053,169717,0,208770
143442700800000,SW 431,RESIDENTIAL,36795,0,36795,169279,0,206074
143442700900000,SW 411,RESIDENTIAL,41752,0,41752,64108,0,105860
143442701000000,SW 411,RESIDENTIAL,34090,0,34090,0,0,34090
143442701100000,SW 431,RESIDENTIAL,35704,0,35704,146455,0,182159
143442701200000,SW 431,RESIDENTIAL,32145,0,32145,0,0,32145
143442701300000,SW 411,RESIDENTIAL,50000,0,50000,0,0,50000
143442701400000,SW 411,RESIDENTIAL,45800,0,45800,103686,0,149486
143442800100000,SW 411,RESIDENTIAL,20790,0,20790,87146,0,107936
143442800200000,SW 411,RESIDENTIAL,20790,0,20790,0,0,20790
143442800300000,SW 411,RESIDENTIAL,20790,0,20790,0,0,20790
143442800400000,SW 411,RESIDENTIAL,27720,0,27720,79694,0,107414
143442800500000,SW 411,RESIDENTIAL,27720,0,27720,86893,0,114613
143442800600000,SW 411,RESIDENTIAL,27720,0,27720,87692,0,115412
143442800700000,SW 411,RESIDENTIAL,28298,0,28298,81648,0,109946
143442800800000,SW 411,RESIDENTIAL,31474,0,31474,136939,0,168413
143442800900000,SW 411,RESIDENTIAL,26775,0,26775,131632,0,158407
143442801000000,SW 411,RESIDENTIAL,33916,0,33916,124925,0,158841
143442801100000,SW 411,RESIDENTIAL,32680,0,32680,126323,0,159003
143442801200000,SW 411,RESIDENTIAL,26136,0,26136,40715,0,66851
143442801300000,SW 411,RESIDENTIAL,27143,0,27143,117703,0,144846
143442801400000,SW 411,RESIDENTIAL,27720,0,27720,98831,0,126551
143442801500000,SW 411,RESIDENTIAL,27720,0,27720,86540,0,114260
143442801600000,SW 411,RESIDENTIAL,27720,0,27720,92851,0,120571
143442801700000,SW 411,RESIDENTIAL,37422,0,37422,38546,0,75968
143442900100000,SW 411,RESIDENTIAL,33495,0,33495,152325,0,185820
143442900200000,SW 411,RESIDENTIAL,33495,0,33495,155931,0,189426
143442900300000,SW 411,RESIDENTIAL,33495,0,33495,121922,0,155417
143442900400000,SW 411,RESIDENTIAL,35496,0,35496,83632,0,119128
143442900500000,SW 411,RESIDENTIAL,38592,0,38592,93495,0,132087
143442900600000,SW 411,RESIDENTIAL,53750,0,53750,225384,0,279134
143442900700000,SW 411,RESIDENTIAL,45075,0,45075,80788,0,125863
143442900800000,SW 411,RESIDENTIAL,33495,0,33495,100059,0,133554
143443000100000,SW 411,RESIDENTIAL,22176,0,22176,42062,0,64238
143443000200000,SW 411,RESIDENTIAL,24552,0,24552,46024,0,70576
143443000300000,SW 411,RESIDENTIAL,47425,0,47425,63239,0,110664
143443000500000,SW 411,RESIDENTIAL,28613,0,28613,0,0,28613
143443000600000,SW 411,RESIDENTIAL,29952,0,29952,0,0,29952
143443000700000,SW 411,RESIDENTIAL,29952,0,29952,0,0,29952
143443000800000,SW 411,RESIDENTIAL,29952,0,29952,166702,0,196654
143443000900000,SW 431,RESIDENTIAL,36530,0,36530,119157,0,155687
143443001000000,SW 431,RESIDENTIAL,41300,0,41300,144552,0,185852
143443001100000,SW 431,RESIDENTIAL,39550,0,39550,137842,0,177392
143443001200000,SW 431,RESIDENTIAL,36400,0,36400,129642,0,166042
143443001300000,SW 431,RESIDENTIAL,44335,0,44335,202818,0,247153
143443001400000,SW 431,RESIDENTIAL,46856,0,46856,186432,0,233288
143443001500000,SW 411,RESIDENTIAL,28351,0,28351,53712,0,82063
143443001700000,SW 431,RESIDENTIAL,35788,0,35788,161999,0,197787
143443001800000,SW 431,RESIDENTIAL,41168,0,41168,187862,0,229030
143445100100000,SW 411,RESIDENTIAL,42591,0,42591,97568,0,140159
143445100300000,CITY PROPERTY,EXEMPT,0,0,0,0,0,0
143445100400000,SW 411,RESIDENTIAL,59250,0,59250,172045,0,231295
143445100500000,SW 411,RESIDENTIAL,45900,0,45900,92805,0,138705
143445100700000,SW 431,RESIDENTIAL,39017,0,39017,161492,0,200509
143445100800000,SW 431,RESIDENTIAL,38250,0,38250,166467,0,204717
143445101100000,SW 431,RESIDENTIAL,850,0,850,0,0,850
143445101200000,SW 431,RESIDENTIAL,48025,0,48025,194798,0,242823
143445101300000,SW 431,RESIDENTIAL,54288,0,54288,161245,0,215533
143445101400000,SW 431,RESIDENTIAL,71630,0,71630,262545,0,334175
143445101500000,SW 431,RESIDENTIAL,53480,0,53480,218159,0,271639
143445101600000,CITY PROPERTY,EXEMPT,0,0,0,0,0,0
143445101700000,SW 431,RESIDENTIAL,35600,0,35600,149632,0,185232
143445101800000,SW 431,RESIDENTIAL,1100,0,1100,0,0,1100
143445200100000,SW 431,RESIDENTIAL,32200,0,32200,156310,0,188510
143445200200000,SW 431,RESIDENTIAL,42064,0,42064,153955,0,196019
143445200300000,SW 431,RESIDENTIAL,44959,0,44959,259947,0,304906
143445200400000,SW 431,RESIDENTIAL,35727,0,35727,156529,0,192256
143445200500000,SW 431,RESIDENTIAL,36800,0,36800,175991,0,212791
143447600100000,SW 411,RESIDENTIAL,47750,0,47750,62704,0,110454
143447600200000,SW 411,RESIDENTIAL,46875,0,46875,33861,0,80736
143447600300000,SW 411,RESIDENTIAL,49775,0,49775,18251,0,68026
143510100100000,SE 239,RESIDENTIAL,48718,0,48718,165693,0,214411
143510100200000,SE 239,RESIDENTIAL,86600,0,86600,109971,0,196571
143510100300000,SE 239,RESIDENTIAL,20,0,20,0,0,20
143510100400000,CITY PROPERTY,EXEMPT,0,0,0,0,0,0
143510100500000,SE 239,RESIDENTIAL,45500,0,45500,93094,0,138594
143510100600000,SE 239,RESIDENTIAL,47980,0,47980,81777,0,129757
143512600100000,SE 239,RESIDENTIAL,83100,0,83100,56996,0,140096
143515100100000,SE 239,AG DWELLING,37480,0,37480,136190,6265,179935
143515100200000,SE 239,RESIDENTIAL,24476,0,24476,74754,0,99230
143515100300000,SE 239,RESIDENTIAL,30625,0,30625,129957,0,160582
143515100400000,SE 239,AG LAND,18190,0,18190,0,0,18190
143515100500000,SE 239,AG DWELLING,11218,0,11218,109708,6712,127638
143517600100000,SE 239,AG LAND,34492,0,34492,0,0,34492
143520100100000,SE 242,RESIDENTIAL,55760,0,55760,622,0,56382
143520100200000,SE 242,AG LAND,19924,0,19924,0,0,19924
143520100300000,SE 242,RESIDENTIAL,21000,0,21000,65400,0,86400
143520200100000,SE 242,RESIDENTIAL,35496,0,35496,96367,0,131863
143520200200000,CITY PROPERTY,EXEMPT,0,0,0,0,0,0
143520200400000,SE 242,RESIDENTIAL,24453,0,24453,92447,0,116900
143520200700000,SE 242,RESIDENTIAL,35632,0,35632,92407,0,128039
143520200800000,SE 242,RESIDENTIAL,37500,0,37500,82012,0,119512
143520200900000,SE 242,RESIDENTIAL,5025,0,5025,0,0,5025
143520201000000,SE 242,RESIDENTIAL,42425,0,42425,203200,0,245625
143520201100000,SE 242,RESIDENTIAL,31977,0,31977,44379,0,76356
143520201200000,SE 242,RESIDENTIAL,36924,0,36924,163810,0,200734
143520201300000,SE 242,RESIDENTIAL,39513,0,39513,139164,0,178677
143520201400000,SE 242,RESIDENTIAL,18693,0,18693,0,0,18693
143520201500000,SE 242,RESIDENTIAL,18693,0,18693,135081,0,153774
143520201600000,SE 242,RESIDENTIAL,26705,0,26705,177145,0,203850
143520201700000,SE 242,RESIDENTIAL,34713,0,34713,77857,0,112570
143522600100000,SE 242,RESIDENTIAL,23000,0,23000,132434,0,155434
143522600200000,SE 242,RESIDENTIAL,23000,0,23000,81255,0,104255
143522600300000,SE 242,RESIDENTIAL,25875,0,25875,143994,0,169869
143522600400000,SE 242,RESIDENTIAL,26860,0,26860,88134,0,114994
143522600500000,SE 242,RESIDENTIAL,23426,0,23426,170981,0,194407
143522600600000,SE 242,RESIDENTIAL,15680,0,15680,116672,0,132352
143522600700000,SE 242,RESIDENTIAL,20052,0,20052,81860,0,101912
143522600800000,SE 242,RESIDENTIAL,13860,0,13860,96433,0,110293
143522700100000,SE 242,RESIDENTIAL,12980,0,12980,123013,0,135993
143522700200000,SE 242,RESIDENTIAL,19470,0,19470,76381,0,95851
143522700300000,SE 242,RESIDENTIAL,19470,0,19470,0,0,19470
143522700400000,SE 242,RESIDENTIAL,23364,0,23364,64284,0,87648
143522700500000,SE 242,RESIDENTIAL,12980,0,12980,2920,0,15900
143522800100000,SE 242,RESIDENTIAL,28500,0,28500,43779,0,72279
143522800200000,SE 242,RESIDENTIAL,7750,0,7750,0,0,7750
143522800300000,SE 242,RESIDENTIAL,17142,0,17142,49743,0,66885
143522800400000,SE 242,RESIDENTIAL,26904,0,26904,121355,0,148259
143522800500000,SE 242,RESIDENTIAL,26550,0,26550,149552,0,176102
143522800600000,SE 242,RESIDENTIAL,17700,0,17700,0,0,17700
143522800900000,SE 242,RESIDENTIAL,29628,0,29628,204446,0,234074
143522801000000,SE 242,RESIDENTIAL,29250,0,29250,196761,0,226011
143522801100000,SE 242,RESIDENTIAL,28500,0,28500,130376,0,158876
143522801200000,SE 242,RESIDENTIAL,28500,0,28500,117478,0,145978
143522801300000,SE 242,RESIDENTIAL,44250,0,44250,189769,0,234019
143522801400000,SE 242,AG LAND,482,0,482,0,0,482
143522900100000,SE 242,RESIDENTIAL,27568,0,27568,57728,0,85296
143522900200000,SE 242,RESIDENTIAL,13712,0,13712,0,0,13712
143522900300000,SE 242,RESIDENTIAL,4460,0,4460,2394,0,6854
143522900400000,SE 242,RESIDENTIAL,9086,0,9086,63095,0,72181
143522900500000,SE 242,RESIDENTIAL,12980,0,12980,139744,0,152724
143522900600000,SE 242,RESIDENTIAL,27472,0,27472,122856,0,150328
143522900700000,SE 242,RESIDENTIAL,2900,0,2900,3668,0,6568
143522900800000,SE 242,RESIDENTIAL,20944,0,20944,118646,0,139590
143522900900000,SE 242,RESIDENTIAL,22517,0,22517,53390,0,75907
143522901000000,SE 242,RESIDENTIAL,22738,0,22738,2416,0,25154
143522901100000,SE 242,RESIDENTIAL,11700,0,11700,88425,0,100125
143522901200000,SE 242,RESIDENTIAL,11700,0,11700,118429,0,130129
143522901300000,SE 242,RESIDENTIAL,17708,0,17708,0,0,17708
143522901400000,SE 242,RESIDENTIAL,13024,0,13024,131614,0,144638
143522901500000,SE 242,RESIDENTIAL,14040,0,14040,153543,0,167583
143525100100000,SE 242,RESIDENTIAL,12870,0,12870,0,0,12870
143525100200000,SE 242,RESIDENTIAL,14610,0,14610,92490,0,107100
143525100300000,SE 242,RESIDENTIAL,10500,0,10500,92987,0,103487
143525100400000,SE 242,RESIDENTIAL,10500,0,10500,93904,0,104404
143525200100000,SE 242,RESIDENTIAL,19997,0,19997,93055,0,113052
143525300100000,SE 242,RESIDENTIAL,9000,0,9000,29171,0,38171
143525400100000,SE 242,RESIDENTIAL,33925,0,33925,152302,0,186227
143525400400000,SE 242,RESIDENTIAL,3982,0,3982,0,0,3982
143525400500000,SE 242,RESIDENTIAL,5974,0,5974,92556,0,98530
143525400600000,SE 242,RESIDENTIAL,5974,0,5974,2163,0,8137
143525401000000,SE 242,RESIDENTIAL,8850,0,8850,84474,0,93324
143525401100000,SE 242,RESIDENTIAL,8850,0,8850,58136,0,66986
143525401200000,SE 242,RESIDENTIAL,8850,0,8850,70554,0,79404
143525401300000,SE 242,RESIDENTIAL,8850,0,8850,50674,0,59524
143525401400000,SE 242,RESIDENTIAL,13748,0,13748,0,0,13748
143525401600000,SE 242,RESIDENTIAL,13275,0,13275,83188,0,96463
143525401800000,SE 242,AG LAND,12408,0,12408,0,0,12408
143525401900000,SE 242,AG DWELLING,3588,0,3588,32967,2830,39385
143525402000000,SE 242,AG LAND,28584,0,28584,0,0,28584
143527600100000,SE 242,AG LAND,5515,0,5515,0,0,5515
143527600200000,SE 242,AG LAND,12158,0,12158,0,0,12158
143527700100000,SE 242,RESIDENTIAL,14926,0,14926,126960,0,141886
143527700200000,SE 242,RESIDENTIAL,23600,0,23600,181523,0,205123
143527700300000,SE 242,RESIDENTIAL,20800,0,20800,104115,0,124915
143527700400000,SE 242,RESIDENTIAL,21800,0,21800,46225,0,68025
143527700500000,SE 242,RESIDENTIAL,13560,0,13560,77160,0,90720
143527700600000,SE 242,RESIDENTIAL,13920,0,13920,0,0,13920
143527700700000,SE 242,RESIDENTIAL,30200,0,30200,211387,0,241587
143527700800000,SE 242,RESIDENTIAL,31025,0,31025,144434,0,175459
143527700900000,SE 242,RESIDENTIAL,31625,0,31625,120453,0,152078
143527701000000,SE 242,RESIDENTIAL,15262,0,15262,0,0,15262
143527701100000,CITY PROPERTY,EXEMPT,0,0,0,0,0,0
143527701200000,SE 242,RESIDENTIAL,10620,0,10620,68758,0,79378
143527701300000,SE 242,RESIDENTIAL,8850,0,8850,0,0,8850
143527701400000,SE 242,RESIDENTIAL,9562,0,9562,125430,0,134992
143527701500000,SE 242,RESIDENTIAL,10800,0,10800,131620,0,142420
143527701600000,SE 242,RESIDENTIAL,21600,0,21600,37245,0,58845
143527701700000,SE 242,RESIDENTIAL,10737,0,10737,84988,0,95725
143527701800000,SE 242,RESIDENTIAL,21060,0,21060,77026,0,98086
143527701900000,SE 242,RESIDENTIAL,9990,0,9990,94028,0,104018
143527702000000,SE 242,RESIDENTIAL,16050,0,16050,38069,0,54119
143530100100000,SE 242,RESIDENTIAL,21999,0,21999,93292,0,115291
143530100200000,SE 242,RESIDENTIAL,15930,0,15930,190849,0,206779
143530100300000,SE 242,RESIDENTIAL,9270,0,9270,69830,0,79100
143530100400000,SE 242,RESIDENTIAL,8820,0,8820,87119,0,95939
143530100500000,SE 242,RESIDENTIAL,9103,0,9103,59499,0,68602
143530100600000,CITY PROPERTY,EXEMPT,0,0,0,0,0,0
143530100700000,CITY PROPERTY,EXEMPT,0,0,0,0,0,0
143530100800000,SE 242,RESIDENTIAL,8258,0,8258,86613,0,94871
143530100900000,SE 242,RESIDENTIAL,8518,0,8518,120085,0,128603
143530200100000,SE 242,RESIDENTIAL,8950,0,8950,73022,0,81972
143530200200000,SE 242,RESIDENTIAL,6184,0,6184,56472,0,62656
143530200300000,SE 242,RESIDENTIAL,6184,0,6184,47535,0,53719
143530200400000,SE 242,RESIDENTIAL,6184,0,6184,45596,0,51780
143530200500000,SE 242,RESIDENTIAL,9562,0,9562,0,0,9562
143530200600000,SE 242,RESIDENTIAL,7459,0,7459,45596,0,53055
143530200700000,SE 242,RESIDENTIAL,7459,0,7459,68197,0,75656
143530200800000,SE 242,RESIDENTIAL,7459,0,7459,58362,0,65821
143530200900000,SE 242,RESIDENTIAL,6375,0,6375,54720,0,61095
143530201000000,SE 242,RESIDENTIAL,1275,0,1275,0,0,1275
143530201100000,SE 242,RESIDENTIAL,6375,0,6375,59215,0,65590
143530201200000,SE 242,RESIDENTIAL,1275,0,1275,0,0,1275
143530201300000,SE 242,RESIDENTIAL,6375,0,6375,45933,0,52308
143530201400000,SE 242,RESIDENTIAL,1275,0,1275,0,0,1275
143530201500000,CITY PROPERTY,EXEMPT,0,0,0,0,0,0
143530201600000,SE 242,RESIDENTIAL,1275,0,1275,0,0,1275
143530201700000,SE 242,RESIDENTIAL,6375,0,6375,46857,0,53232
143530201800000,SE 242,RESIDENTIAL,1275,0,1275,0,0,1275
143530201900000,SE 242,RESIDENTIAL,10530,0,10530,1976,0,12506
143530202100000,SE 242,RESIDENTIAL,6581,0,6581,88815,0,95396
143530202200000,SE 242,RESIDENTIAL,6581,0,6581,0,0,6581
143530202300000,SE 242,RESIDENTIAL,6581,0,6581,0,0,6581
143530202400000,SE 242,RESIDENTIAL,5000,0,5000,0,0,5000
143530202500000,SE 242,RESIDENTIAL,6581,0,6581,0,0,6581
143530202600000,SE 242,RESIDENTIAL,7897,0,7897,25788,0,33685
143530202700000,CITY PROPERTY,EXEMPT,0,0,0,0,0,0
143530202800000,SE 242,RESIDENTIAL,6581,0,6581,23049,0,29630
143530202900000,SE 242,RESIDENTIAL,7897,0,7897,28131,0,36028
143530203000000,SE 242,RESIDENTIAL,8950,0,8950,18295,0,27245
143530203100000,SE 242,RESIDENTIAL,11188,0,11188,70122,0,81310
143530203200000,SE 242,RESIDENTIAL,8950,0,8950,47669,0,56619
143530203300000,SE 242,RESIDENTIAL,7459,0,7459,39329,0,46788
143530203400000,SE 242,RESIDENTIAL,7459,0,7459,26074,0,33533
143530203500000,SE 242,RESIDENTIAL,7459,0,7459,59013,0,66472
143530203600000,SE 242,RESIDENTIAL,7459,0,7459,65281,0,72740
143530300100000,SE 242,RESIDENTIAL,17442,0,17442,152250,0,169692
143530300300000,SE 242,RESIDENTIAL,13081,0,13081,0,0,13081
143530300400000,CITY PROPERTY,EXEMPT,0,0,0,0,0,0
143530300500000,SE 242,RESIDENTIAL,7267,0,7267,35759,0,43026
143530300600000,CITY PROPERTY,EXEMPT,0,0,0,0,0,0
143530300700000,CITY PROPERTY,EXEMPT,0,0,0,0,0,0
143530300800000,CITY PROPERTY,EXEMPT,0,0,0,0,0,0
143530300900000,CITY PROPERTY,EXEMPT,0,0,0,0,0,0
143530301000000,SE 242,RESIDENTIAL,6412,0,6412,57258,0,63670
143530301100000,CITY PROPERTY,EXEMPT,0,0,0,0,0,0
143530301200000,CITY PROPERTY,EXEMPT,0,0,0,0,0,0
143530301500000,CITY PROPERTY,EXEMPT,0,0,0,0,0,0
143530301600000,SE 242,RESIDENTIAL,7695,0,7695,75216,0,82911
143530301700000,CITY PROPERTY,EXEMPT,0,0,0,0,0,0
143530301800000,SE 242,RESIDENTIAL,11542,0,11542,149278,0,160820
143530301900000,CITY PROPERTY,EXEMPT,0,0,0,0,0,0
143530302000000,SE 242,RESIDENTIAL,7267,0,7267,29463,0,36730
143530302100000,SE 242,RESIDENTIAL,7267,0,7267,52209,0,59476
143530302200000,CITY PROPERTY,EXEMPT,0,0,0,0,0,0
143530302300000,SE 242,RESIDENTIAL,10901,0,10901,0,0,10901
143530302400000,SE 242,RESIDENTIAL,10901,0,10901,0,0,10901
143530302500000,SE 242,RESIDENTIAL,5130,0,5130,1693,0,6823
143530400100000,SE 242,RESIDENTIAL,6356,0,6356,46934,0,53290
143530400200000,CITY PROPERTY,EXEMPT,0,0,0,0,0,0
143530400300000,CITY PROPERTY,EXEMPT,0,0,0,0,0,0
143530400400000,SE 242,RESIDENTIAL,6356,0,6356,29672,0,36028
143530400500000,SE 242,RESIDENTIAL,7627,0,7627,47455,0,55082
143530400600000,SE 242,RESIDENTIAL,7627,0,7627,78168,0,85795
143530400700000,SE 242,RESIDENTIAL,6356,0,6356,49055,0,55411
143530400800000,SE 242,RESIDENTIAL,9534,0,9534,0,0,9534
143530400900000,CITY PROPERTY,EXEMPT,0,0,0,0,0,0
143530401000000,CITY PROPERTY,EXEMPT,0,0,0,0,0,0
143530401100000,CITY PROPERTY,EXEMPT,0,0,0,0,0,0
143530401200000,CITY PROPERTY,EXEMPT,0,0,0,0,0,0
143530401300000,SE 242,RESIDENTIAL,6298,0,6298,0,0,6298
143530401400000,SE 242,RESIDENTIAL,8398,0,8398,95802,0,104200
143530401500000,SE 242,RESIDENTIAL,6356,0,6356,0,0,6356
143532600100000,SE 242,RESIDENTIAL,7522,0,7522,69081,0,76603
143532600200000,SE 242,RESIDENTIAL,7522,0,7522,67223,0,74745
143532600300000,SE 242,RESIDENTIAL,7522,0,7522,118606,0,126128
143532600400000,SE 242,RESIDENTIAL,7522,0,7522,67974,0,75496
143532600500000,SE 242,RESIDENTIAL,11283,0,11283,74410,0,85693
143532600600000,SE 242,RESIDENTIAL,7522,0,7522,33141,0,40663
143532600900000,CITY PROPERTY,EXEMPT,0,0,0,0,0,0
143532601000000,CITY PROPERTY,EXEMPT,0,0,0,0,0,0
143532601100000,SE 242,RESIDENTIAL,6244,0,6244,40139,0,46383
143532601200000,SE 242,RESIDENTIAL,10026,0,10026,54644,0,64670
143532601300000,SE 242,RESIDENTIAL,9027,0,9027,77858,0,86885
143532700100000,CITY PROPERTY,EXEMPT,0,0,0,0,0,0
143532700200000,CITY PROPERTY,EXEMPT,0,0,0,0,0,0
143532700300000,CENTRALLY ASSESSED,OTHER,0,0,0,0,0,0
143535100100000,CITY PROPERTY,EXEMPT,0,0,0,0,0,0
143537700100000,CITY PROPERTY,EXEMPT,0,0,0,0,0,0
143540100100000,SE 242,AG DWELLING,57133,0,57133,94364,3956,155453
143540100200000,SE 242,RESIDENTIAL,37050,0,37050,77278,0,114328
143540100300000,SE 242,RESIDENTIAL,22800,0,22800,173683,0,196483
143540100400000,SE 242,RESIDENTIAL,1243,0,1243,0,0,1243
143542600100000,SE 242,AG DWELLING,20356,0,20356,102884,0,123240
143542700100000,SE 242,RESIDENTIAL,17460,0,17460,0,0,17460
143542700200000,SE 242,RESIDENTIAL,14232,0,14232,81619,0,95851
143542700300000,SE 242,RESIDENTIAL,14007,0,14007,90993,0,105000
143542700400000,SE 242,RESIDENTIAL,12544,0,12544,94684,0,107228
143542700500000,CITY PROPERTY,EXEMPT,0,0,0,0,0,0
143542700600000,CITY PROPERTY,EXEMPT,0,0,0,0,0,0
143542700800000,SE 242,RESIDENTIAL,19501,0,19501,0,0,19501
143542700900000,SE 242,RESIDENTIAL,21800,0,21800,71162,0,92962
143542701000000,SE 242,RESIDENTIAL,21800,0,21800,136492,0,158292
143542701100000,SE 242,RESIDENTIAL,17440,0,17440,0,0,17440
143542701200000,SE 242,RESIDENTIAL,12208,0,12208,0,0,12208
143542701300000,SE 242,RESIDENTIAL,12208,0,12208,103417,0,115625
143542701400000,SE 242,RESIDENTIAL,17440,0,17440,103057,0,120497
143542701500000,SE 242,RESIDENTIAL,21840,0,21840,65206,0,87046
143542701600000,SE 242,RESIDENTIAL,24619,0,24619,0,0,24619
143542701700000,SE 242,RESIDENTIAL,20411,0,20411,0,0,20411
143542701800000,SE 242,RESIDENTIAL,30500,0,30500,85349,0,115849
143542701900000,SE 242,RESIDENTIAL,27000,0,27000,209002,0,236002
143542702000000,CITY PROPERTY,EXEMPT,0,0,0,0,0,0
143542702100000,SE 242,RESIDENTIAL,15043,0,15043,148667,0,163710
143542702200000,SE 242,RESIDENTIAL,14216,0,14216,0,0,14216
143542702300000,SE 242,RESIDENTIAL,15618,0,15618,151741,0,167359
143542702400000,SE 242,RESIDENTIAL,15752,0,15752,112911,0,128663
143542702500000,SE 242,RESIDENTIAL,14216,0,14216,0,0,14216
143542702600000,CITY PROPERTY,EXEMPT,0,0,0,0,0,0
143542702700000,CITY PROPERTY,EXEMPT,0,0,0,0,0,0
143545100100000,CITY PROPERTY,EXEMPT,0,0,0,0,0,0
143545200100000,CITY PROPERTY,EXEMPT,0,0,0,0,0,0
143547600100000,SE 242,AG DWELLING,56155,0,56155,102928,8090,167173
143547700100000,CITY PROPERTY,EXEMPT,0,0,0,0,0,0
143547700200000,CENTRALLY ASSESSED,OTHER,0,0,0,0,0,0
143640200100000,CITY PROPERTY,EXEMPT,0,0,0,0,0,0
143647600200000,FLAT PARKING,COMMERCIAL,0,38810,38810,0,61166,99976
143647600300000,VACANT LAND,COMMERCIAL,0,32490,32490,0,0,32490
143647700100000,CITY PROPERTY,EXEMPT,0,0,0,0,0,0
151815100400000,SE 244,RESIDENTIAL,11030,0,11030,0,0,11030
151815100500000,SE 244,RESIDENTIAL,11521,0,11521,0,0,11521
151815100600000,SE 244,RESIDENTIAL,16507,0,16507,0,0,16507
151815100700000,SE 244,RESIDENTIAL,13889,0,13889,0,0,13889
151815100800000,SE 244,RESIDENTIAL,294000,0,294000,667052,0,961052
151815100900000,SE 244,RESIDENTIAL,121500,0,121500,664451,0,785951
151822600900000,SE 244,RESIDENTIAL,70000,0,70000,300847,0,370847
151822601000000,SE 244,RESIDENTIAL,94050,0,94050,265891,0,359941
151822601100000,SE 244,RESIDENTIAL,102805,0,102805,455549,0,558354
151822601200000,VACANT LAND,COMMERCIAL,0,61400,61400,0,0,61400
151822601202000,ANTENNAS/TOWERS(BLL),COMMERCIAL,0,0,0,0,220155,220155
151822601300000,SE 244,RESIDENTIAL,479,0,479,0,0,479
151822601400000,SE 244,RESIDENTIAL,85957,0,85957,438479,0,524436
151822601500000,SE 244,RESIDENTIAL,86982,0,86982,372414,0,459396
151822601600000,SE 244,RESIDENTIAL,85495,0,85495,468707,0,554202
151822700100000,SE 244,RESIDENTIAL,359,0,359,0,0,359
151822700400000,SE 244,RESIDENTIAL,542,0,542,0,0,542
151822700500000,SE 244,RESIDENTIAL,80080,0,80080,429280,0,509360
151822700600000,SE 244,RESIDENTIAL,82538,0,82538,351889,0,434427
151822700700000,SE 244,RESIDENTIAL,81717,0,81717,434560,0,516277
151822700800000,SE 244,RESIDENTIAL,81703,0,81703,469209,0,550912
151822700900000,SE 244,RESIDENTIAL,78663,0,78663,460660,0,539323
151822701000000,SE 244,RESIDENTIAL,168939,0,168939,1033490,0,1202429
151825100500000,SE 244,RESIDENTIAL,81180,0,81180,271133,0,352313
151825100600000,SE 244,RESIDENTIAL,151850,0,151850,498774,0,650624
151825100700000,SE 244,RESIDENTIAL,86487,0,86487,463303,0,549790
151825100800000,SE 244,RESIDENTIAL,5220,0,5220,0,0,5220
151827600200000,SE 244,RESIDENTIAL,396,0,396,0,0,396
151827600300000,SE 244,RESIDENTIAL,112000,0,112000,458176,0,570176
151827600400000,SE 244,RESIDENTIAL,621,0,621,0,0,621
151827600500000,SE 244,RESIDENTIAL,534,0,534,0,0,534
151827600800000,SE 244,RESIDENTIAL,161250,0,161250,420377,0,581627
151827600900000,SE 205,RESIDENTIAL,451,0,451,0,0,451
151827601000000,SE 244,RESIDENTIAL,160000,0,160000,627888,0,787888
151827601100000,SE 244,RESIDENTIAL,160000,0,160000,522458,0,682458
151827601200000,SE 244,RESIDENTIAL,0,0,0,0,0,0
151827700100000,SE 244,RESIDENTIAL,162,0,162,0,0,162
151827700200000,SE 244,RESIDENTIAL,88000,0,88000,497884,0,585884
151827700300000,SE 244,RESIDENTIAL,111,0,111,0,0,111
151827700400000,SE 244,RESIDENTIAL,106200,0,106200,506973,0,613173
151827700500000,SE 244,RESIDENTIAL,114,0,114,0,0,114
151827700600000,SE 244,RESIDENTIAL,138,0,138,0,0,138
151827700800000,SE 244,RESIDENTIAL,2705,0,2705,0,0,2705
151827700900000,SE 244,RESIDENTIAL,5993,0,5993,0,0,5993
151827701000000,SE 244,RESIDENTIAL,6291,0,6291,0,0,6291
151827701100000,SE 244,RESIDENTIAL,5904,0,5904,0,0,5904
151827701200000,SE 244,RESIDENTIAL,159300,0,159300,544470,0,703770
151827800100000,SE 244,RESIDENTIAL,91000,0,91000,415465,0,506465
151827800200000,SE 244,RESIDENTIAL,169,0,169,0,0,169
151827800300000,SE 244,RESIDENTIAL,96000,0,96000,489500,0,585500
151827800400000,SE 244,RESIDENTIAL,182,0,182,0,0,182
151827800500000,SE 244,RESIDENTIAL,152,0,152,0,0,152
151827800600000,SE 244,RESIDENTIAL,182400,0,182400,630015,0,812415
151827800800000,SE 244,RESIDENTIAL,168000,0,168000,681416,0,849416
151827800900000,SE 244,RESIDENTIAL,409,0,409,0,0,409
151827900100000,SE 244,RESIDENTIAL,2456,0,2456,0,0,2456
151827900200000,SE 244,RESIDENTIAL,2340,0,2340,0,0,2340
151827900300000,SE 244,RESIDENTIAL,2258,0,2258,0,0,2258
151827900400000,SE 244,RESIDENTIAL,2986,0,2986,0,0,2986
151830100300000,SE 205,RESIDENTIAL,7560,0,7560,0,0,7560
151830100500000,SE 244,RESIDENTIAL,106200,0,106200,518071,0,624271
151830100600000,SE 244,RESIDENTIAL,106200,0,106200,499772,0,605972
151830100700000,SE 244,RESIDENTIAL,187,0,187,0,0,187
151830100800000,SE 244,RESIDENTIAL,119700,0,119700,618101,0,737801
151830100900000,SE 244,RESIDENTIAL,112500,0,112500,497685,0,610185
151830101000000,SE 244,RESIDENTIAL,208050,0,208050,667950,0,876000
151830101100000,SE 244,RESIDENTIAL,279,0,279,0,0,279
151830101200000,SE 244,RESIDENTIAL,287,0,287,0,0,287
151830101300000,SE 244,RESIDENTIAL,94500,0,94500,0,0,94500
151830101400000,SE 205,RESIDENTIAL,0,0,0,0,0,0
151830101500000,SE 244,RESIDENTIAL,190000,0,190000,877699,0,1067699
151830101600000,SE 244,RESIDENTIAL,180000,0,180000,841513,0,1021513
151830101700000,SE 244,RESIDENTIAL,10522,0,10522,0,0,10522
151830101800000,SE 244,RESIDENTIAL,3599,0,3599,0,0,3599
151830101900000,SE 244,RESIDENTIAL,155000,0,155000,430666,0,585666
151830102000000,SE 244,RESIDENTIAL,9637,0,9637,0,0,9637
151830102100000,SE 244,RESIDENTIAL,7897,0,7897,0,0,7897
151830200100000,SE 244,RESIDENTIAL,469,0,469,0,0,469
151830200200000,SE 244,RESIDENTIAL,144000,0,144000,641015,0,785015
151830200300000,SE 244,RESIDENTIAL,158684,0,158684,491316,0,650000
151830200400000,SE 244,RESIDENTIAL,347,0,347,0,0,347
151830300100000,SE 244,RESIDENTIAL,239,0,239,0,0,239
151830300200000,SE 244,RESIDENTIAL,63000,0,63000,848523,0,911523
151830300300000,SE 244,RESIDENTIAL,269,0,269,0,0,269
151830400100000,SE 244,RESIDENTIAL,204225,0,204225,681270,0,885495
151832600400000,SE 244,RESIDENTIAL,301,0,301,0,0,301
151832600500000,SE 244,RESIDENTIAL,351,0,351,0,0,351
151832600600000,SE 244,RESIDENTIAL,389,0,389,0,0,389
151832600700000,SE 244,RESIDENTIAL,492,0,492,0,0,492
151832600800000,SE 205,RESIDENTIAL,20550,0,20550,0,0,20550
151835100300000,SE 244,RESIDENTIAL,383,0,383,0,0,383
151837600200000,SE 244,RESIDENTIAL,485,0,485,0,0,485
151837600300000,SE 244,RESIDENTIAL,848,0,848,0,0,848
151837600400000,SE 244,RESIDENTIAL,694,0,694,0,0,694
151842600400000,SE 244,RESIDENTIAL,2120,0,2120,0,0,2120
151842600500000,SE 244,RESIDENTIAL,22610,0,22610,0,0,22610
151842600700000,SE 244,RESIDENTIAL,144000,0,144000,843399,0,987399
151842600800000,SE 244,RESIDENTIAL,153000,0,153000,661544,0,814544
151842600900000,SE 244,RESIDENTIAL,160000,0,160000,542427,0,702427
151842601000000,SE 244,RESIDENTIAL,7808,0,7808,0,0,7808
151842601100000,SE 244,RESIDENTIAL,180000,0,180000,626324,0,806324
151842601200000,SE 244,RESIDENTIAL,14337,0,14337,0,0,14337
151842601300000,SE 244,RESIDENTIAL,237000,0,237000,603251,0,840251
151842601400000,SE 244,RESIDENTIAL,12557,0,12557,0,0,12557
151842601500000,SE 244,RESIDENTIAL,9353,0,9353,0,0,9353
151842601600000,SE 244,RESIDENTIAL,10629,0,10629,0,0,10629
151842601700000,SE 244,RESIDENTIAL,150000,0,150000,488406,0,638406
151842601800000,SE 244,RESIDENTIAL,0,0,0,0,0,0
151930300500000,SE 220,RESIDENTIAL,32264,0,32264,159943,0,192207
151930300600000,SE 220,RESIDENTIAL,31080,0,31080,200866,0,231946
151930300700000,SE 220,RESIDENTIAL,33156,0,33156,161741,0,194897
151930300800000,SE 220,RESIDENTIAL,32461,0,32461,0,0,32461
151930300900000,SE 220,RESIDENTIAL,33557,0,33557,223444,0,257001
151930301000000,SE 220,RESIDENTIAL,34962,0,34962,231214,0,266176
151930301100000,SE 220,RESIDENTIAL,33454,0,33454,183296,0,216750
151930301200000,SE 220,RESIDENTIAL,34189,0,34189,194905,0,229094
151930301300000,SE 220,RESIDENTIAL,36269,0,36269,186982,0,223251
151930301400000,SE 220,RESIDENTIAL,34306,0,34306,225694,0,260000
151930301500000,SE 220,RESIDENTIAL,27922,0,27922,89044,0,116966
151930400700000,SE 220,RESIDENTIAL,61750,0,61750,106013,0,167763
151932600100000,SE 220,RESIDENTIAL,37080,0,37080,142526,0,179606
151932600200000,SE 220,RESIDENTIAL,32960,0,32960,145887,0,178847
151932600300000,SE 220,RESIDENTIAL,41200,0,41200,204774,0,245974
151932600400000,SE 220,RESIDENTIAL,37080,0,37080,173956,0,211036
151932600500000,SE 220,RESIDENTIAL,37217,0,37217,218179,0,255396
151932600600000,SE 220,RESIDENTIAL,40491,0,40491,179894,0,220385
151932600700000,SE 220,RESIDENTIAL,35490,0,35490,205405,0,240895
151932600800000,SE 220,RESIDENTIAL,37080,0,37080,181863,0,218943
151932600900000,SE 220,RESIDENTIAL,37080,0,37080,214501,0,251581
151932601000000,SE 220,RESIDENTIAL,37080,0,37080,137138,0,174218
151932601100000,SE 220,RESIDENTIAL,41369,0,41369,166289,0,207658
151932601300000,SE 220,RESIDENTIAL,426,0,426,0,0,426
151932601600000,SE 220,RESIDENTIAL,249,0,249,0,0,249
151932601700000,SE 220,RESIDENTIAL,37858,0,37858,158929,0,196787
151932601800000,SE 220,RESIDENTIAL,35280,0,35280,179266,0,214546
151932601900000,SE 220,RESIDENTIAL,35280,0,35280,147284,0,182564
151932602000000,SE 220,RESIDENTIAL,35280,0,35280,148205,0,183485
151932602100000,SE 220,RESIDENTIAL,34920,0,34920,165255,0,200175
151932602200000,SE 220,RESIDENTIAL,30468,0,30468,207549,0,238017
151932602300000,SE 220,RESIDENTIAL,33840,0,33840,152220,0,186060
151932602400000,SE 220,RESIDENTIAL,33840,0,33840,144644,0,178484
151932602500000,SE 220,RESIDENTIAL,33840,0,33840,130003,0,163843
151932602600000,SE 220,RESIDENTIAL,33840,0,33840,125725,0,159565
151932602700000,SE 220,RESIDENTIAL,35600,0,35600,218441,0,254041
151932602800000,SE 220,RESIDENTIAL,38963,0,38963,185266,0,224229
151932602900000,SE 220,RESIDENTIAL,41485,0,41485,180956,0,222441
151932603000000,SE 220,RESIDENTIAL,34855,0,34855,172165,0,207020
151932603100000,SE 220,RESIDENTIAL,35640,0,35640,177114,0,212754
151932603200000,SE 220,RESIDENTIAL,35640,0,35640,210679,0,246319
151932603300000,SE 220,RESIDENTIAL,38333,0,38333,231741,0,270074
151932603400000,SE 220,RESIDENTIAL,52879,0,52879,225253,0,278132
151932603700000,SE 220,RESIDENTIAL,71350,0,71350,428019,0,499369
151932603800000,SE 220,RESIDENTIAL,37240,0,37240,148205,0,185445
151932603900000,SE 220,RESIDENTIAL,36040,0,36040,153945,0,189985
151932604000000,SE 220,RESIDENTIAL,34561,0,34561,143490,0,178051
151932604100000,SE 220,RESIDENTIAL,36380,0,36380,155953,0,192333
151932604200000,SE 220,RESIDENTIAL,36720,0,36720,169736,0,206456
151932604300000,SE 220,RESIDENTIAL,37060,0,37060,120626,0,157686
151932604400000,SE 220,RESIDENTIAL,39265,0,39265,190820,0,230085
151932604500000,SE 220,RESIDENTIAL,39900,0,39900,249202,0,289102
151932604600000,SE 220,RESIDENTIAL,34497,0,34497,150152,0,184649
151932604700000,SE 220,RESIDENTIAL,32049,0,32049,165076,0,197125
151932604800000,SE 220,RESIDENTIAL,32724,0,32724,148326,0,181050
151932604900000,SE 220,RESIDENTIAL,32400,0,32400,136983,0,169383
151932605000000,SE 220,RESIDENTIAL,32400,0,32400,230734,0,263134
151932605100000,SE 220,RESIDENTIAL,32400,0,32400,139736,0,172136
151932605200000,SE 220,RESIDENTIAL,39027,0,39027,162080,0,201107
151932605300000,SE 220,RESIDENTIAL,33721,0,33721,146158,0,179879
151932605400000,SE 220,RESIDENTIAL,32761,0,32761,118028,0,150789
151932605500000,SE 220,RESIDENTIAL,28501,0,28501,162432,0,190933
151932605600000,SE 220,RESIDENTIAL,5050,0,5050,0,0,5050
151932605700000,SE 220,RESIDENTIAL,21750,0,21750,0,0,21750
151935100400000,SE 220,RESIDENTIAL,48350,0,48350,165312,0,213662
151935100500000,SE 220,RESIDENTIAL,39300,0,39300,248721,0,288021
151935100600000,SE 220,RESIDENTIAL,45240,0,45240,244593,0,289833
151935100700000,SE 220,RESIDENTIAL,47810,0,47810,228823,0,276633
151935100800000,SE 220,RESIDENTIAL,46710,0,46710,259227,0,305937
151935100900000,SE 220,RESIDENTIAL,46340,0,46340,266088,0,312428
151935101000000,SE 220,RESIDENTIAL,47070,0,47070,275161,0,322231
151935101100000,SE 220,RESIDENTIAL,31560,0,31560,0,0,31560
151935101200000,SE 220,RESIDENTIAL,45710,0,45710,224595,0,270305
151935101300000,SE 220,RESIDENTIAL,62400,0,62400,296476,0,358876
151935101400000,SE 220,RESIDENTIAL,51300,0,51300,235946,0,287246
151935101500000,SE 220,RESIDENTIAL,51200,0,51200,256711,0,307911
151935101600000,SE 220,RESIDENTIAL,51000,0,51000,273458,0,324458
151935101700000,SE 220,RESIDENTIAL,47810,0,47810,0,0,47810
151935101800000,SE 220,RESIDENTIAL,53200,0,53200,310977,0,364177
151935101900000,SHOP,COMMERCIAL,0,43033,43033,0,90125,133158
151935103000000,SE 220,RESIDENTIAL,2840,0,2840,0,0,2840
152935100200000,CITY PROPERTY,EXEMPT,0,0,0,0,0,0
153032600200000,SE 246,RESIDENTIAL,161420,0,161420,249492,0,410912
153032600300000,SE 246,RESIDENTIAL,192100,0,192100,868049,0,1060149
153032600400000,SE 246,RESIDENTIAL,130000,0,130000,222498,0,352498
153040300100000,CITY PROPERTY,EXEMPT,0,0,0,0,0,0
153210200100000,CITY PROPERTY,EXEMPT,0,0,0,0,0,0
153212600200000,CENTRALLY ASSESSED,OTHER,0,0,0,0,0,0
153222600100000,CITY PROPERTY,EXEMPT,0,0,0,0,0,0
153322700100000,CENTRALLY ASSESSED,OTHER,0,0,0,0,0,0
153322700102000,ANTENNAS/TOWERS(BLL),EXEMPT,0,0,0,0,0,0
153325100100000,CITY PROPERTY,EXEMPT,0,0,0,0,0,0
153330100100000,CITY PROPERTY,EXEMPT,0,0,0,0,0,0
153332600100000,CITY PROPERTY,EXEMPT,0,0,0,0,0,0
153335100100000,CITY PROPERTY,EXEMPT,0,0,0,0,0,0
153337700100000,CITY PROPERTY,EXEMPT,0,0,0,0,0,0
180622600100000,SW 422,RESIDENTIAL,383800,0,383800,0,0,383800
180625100100000,SW 422,RESIDENTIAL,411500,0,411500,0,0,411500
180632600200000,SW 422,RESIDENTIAL,200000,0,200000,0,0,200000
180635100200000,SW 422,RESIDENTIAL,15000,0,15000,0,0,15000
180715100200000,SW 448,RESIDENTIAL,943,0,943,0,0,943
180715200100000,SW 448,RESIDENTIAL,834,0,834,0,0,834
180715200200000,SW 448,RESIDENTIAL,758,0,758,0,0,758
180715200300000,SW 448,RESIDENTIAL,1410,0,1410,0,0,1410
180715200400000,SW 448,RESIDENTIAL,1046,0,1046,0,0,1046
180715200500000,SW 448,RESIDENTIAL,146800,0,146800,360855,0,507655
180715200600000,SW 448,RESIDENTIAL,916,0,916,0,0,916
180715200700000,SW 448,RESIDENTIAL,987,0,987,0,0,987
180715200800000,SW 448,RESIDENTIAL,1682,0,1682,0,0,1682
180715200900000,SW 448,RESIDENTIAL,1494,0,1494,0,0,1494
180715201000000,SW 448,RESIDENTIAL,1251,0,1251,0,0,1251
180715201100000,SW 448,RESIDENTIAL,1450,0,1450,0,0,1450
180715201200000,SW 448,RESIDENTIAL,139000,0,139000,101327,0,240327
180720100900000,SW 448,RESIDENTIAL,979,0,979,0,0,979
180720101000000,SW 448,RESIDENTIAL,974,0,974,0,0,974
180720101100000,SW 448,RESIDENTIAL,2079,0,2079,0,0,2079
180720101200000,SW 448,RESIDENTIAL,1092,0,1092,0,0,1092
180720200100000,SW 448,RESIDENTIAL,983,0,983,0,0,983
180720200200000,SW 448,RESIDENTIAL,1104,0,1104,0,0,1104
180727700100000,SW 448,RESIDENTIAL,1205,0,1205,0,0,1205
180727700200000,SW 448,RESIDENTIAL,1278,0,1278,0,0,1278
180727700300000,SW 448,RESIDENTIAL,1079,0,1079,0,0,1079
180727700400000,SW 448,RESIDENTIAL,1628,0,1628,0,0,1628
180727700500000,SW 448,RESIDENTIAL,1501,0,1501,0,0,1501
180727700600000,SW 448,RESIDENTIAL,1305,0,1305,0,0,1305
180727700700000,SW 448,RESIDENTIAL,1147,0,1147,0,0,1147
180727700800000,SW 448,RESIDENTIAL,924,0,924,0,0,924
180727800100000,SW 448,RESIDENTIAL,160387,0,160387,710104,0,870491
180727800200000,SW 448,RESIDENTIAL,115569,0,115569,773126,0,888695
180727800300000,SW 448,RESIDENTIAL,132100,0,132100,835733,0,967833
180727900100000,SW 448,RESIDENTIAL,1075,0,1075,0,0,1075
190110100100000,VACANT LAND,COMMERCIAL,0,112450,112450,0,0,112450
190115100100000,VACANT LAND,COMMERCIAL,0,174210,174210,0,0,174210
190117600100000,SW 422,RESIDENTIAL,400000,0,400000,0,0,400000
190140100100000,SW 422,RESIDENTIAL,400000,0,400000,0,0,400000
190142600100000,SW 422,RESIDENTIAL,400000,0,400000,0,0,400000
190145100100000,SW 422,RESIDENTIAL,400000,0,400000,0,0,400000
190147600100000,SW 422,RESIDENTIAL,400000,0,400000,0,0,400000
190210100100000,CITY PROPERTY,EXEMPT,0,0,0,0,0,0
190210100300000,SW 422,AG LAND,50379,0,50379,0,0,50379
190212600100000,CITY PROPERTY,EXEMPT,0,0,0,0,0,0
190215100100000,CITY PROPERTY,EXEMPT,0,0,0,0,0,0
190215200100000,SW 422,RESIDENTIAL,43435,0,43435,220266,0,263701
190215200200000,SW 422,AG LAND,4100,0,4100,0,0,4100
190215200400000,SW 422,AG LAND,9615,0,9615,0,0,9615
190217600100000,CITY PROPERTY,EXEMPT,0,0,0,0,0,0
190217700100000,SW 422,RESIDENTIAL,21900,0,21900,0,0,21900
190217700200000,SW 422,RESIDENTIAL,4885,0,4885,8191,0,13076
190217700300000,SW 422,RESIDENTIAL,9200,0,9200,0,0,9200
190217800100000,SW 422,RESIDENTIAL,60250,0,60250,148392,0,208642
190217800300000,SW 422,RESIDENTIAL,77300,0,77300,122493,0,199793
190220100100000,CITY PROPERTY,EXEMPT,0,0,0,0,0,0
190220200100000,CENTRALLY ASSESSED,OTHER,0,0,0,0,0,0
190222600100000,CITY PROPERTY,EXEMPT,0,0,0,0,0,0
190222700100000,SHOP,COMMERCIAL,0,41550,41550,0,86195,127745
190222700200000,SW 422,RESIDENTIAL,28414,0,28414,117439,0,145853
190222800100000,CENTRALLY ASSESSED,OTHER,0,0,0,0,0,0
190225100100000,CENTRALLY ASSESSED,OTHER,0,0,0,0,0,0
190225100200000,CENTRALLY ASSESSED,EXEMPT,0,0,0,0,0,0
190225200100000,VACANT LAND,COMMERCIAL,0,25000,25000,0,0,25000
190225200200000,CENTRALLY ASSESSED,EXEMPT,0,0,0,0,0,0
190225300100000,SW 422,RESIDENTIAL,44837,0,44837,213224,0,258061
190225300200000,SW 422,RESIDENTIAL,53762,0,53762,21455,0,75217
190225300300000,ANTENNAS/TOWERS(BLL),COMMERCIAL,0,27525,27525,0,238198,265723
190225400100000,CENTRALLY ASSESSED,EXEMPT,0,0,0,0,0,0
190225400200000,CENTRALLY ASSESSED,EXEMPT,0,0,0,0,0,0
190227600100000,CENTRALLY ASSESSED,EXEMPT,0,0,0,0,0,0
190227600200000,CITY PROPERTY,EXEMPT,0,0,0,0,0,0
190227700100000,SHOP,COMMERCIAL,0,170425,170425,0,293075,463500
190227700200000,SW 422,RESIDENTIAL,86250,0,86250,0,0,86250
190227700300000,SHOP,RESIDENTIAL,59900,0,59900,0,0,59900
190227700600000,ANTENNAS/TOWERS(BLL),COMMERCIAL,0,90850,90850,0,102849,193699
190227700800000,BARS/LOUNGE,COMMERCIAL,0,7050,7050,0,76048,83098
190227700900000,VACANT LAND,COMMERCIAL,0,48800,48800,0,0,48800
190227701000000,SHOP,COMMERCIAL,0,65300,65300,0,70179,135479
190230100100000,SW 422,AG LAND,6368,0,6368,0,0,6368
190230100200000,SW 422,AG LAND,79187,0,79187,0,0,79187
190232600100000,SW 422,RESIDENTIAL,53850,0,53850,88785,0,142635
190232600200000,CEMETERY,EXEMPT,0,104976,104976,0,448,105424
190232700100000,SW 422,AG LAND,21360,0,21360,0,0,21360
190232800100000,VACANT LAND,COMMERCIAL,0,32075,32075,0,0,32075
190232800200000,VACANT LAND,COMMERCIAL,0,101750,101750,0,0,101750
190235100100000,SW 422,RESIDENTIAL,40120,0,40120,100777,0,140897
190235200100000,SW 422,AG LAND,1534,0,1534,0,0,1534
190235300100000,VACANT LAND,COMMERCIAL,0,1140,1140,0,0,1140
190235300200000,EQUIPMENT MFG;INDUST,INDUSTRIAL,0,348274,348274,0,4456041,4804315
190235300300000,VACANT LAND,COMMERCIAL,0,91150,91150,0,0,91150
190235300400000,MISCELLANEOUS,COMMERCIAL,0,7862,7862,0,25740,33602
190237600100000,SW 422,RESIDENTIAL,50000,0,50000,122331,0,172331
190237600200000,SW 422,AG DWELLING,42170,0,42170,149441,17163,208774
190237600300000,SW 422,RESIDENTIAL,51570,0,51570,98842,0,150412
190237600400000,SW 422,RESIDENTIAL,29760,0,29760,128883,0,158643
190237600500000,SW 422,RESIDENTIAL,51093,0,51093,136332,0,187425
190237600600000,SW 422,RESIDENTIAL,28340,0,28340,64131,0,92471
190237600700000,SW 422,RESIDENTIAL,12700,0,12700,0,0,12700
190237600800000,SW 422,RESIDENTIAL,69000,0,69000,79163,0,148163
190240100100000,SW 422,RESIDENTIAL,70000,0,70000,0,0,70000
190240100300000,SW 422,AG LAND,38065,0,38065,0,0,38065
190242600200000,SW 422,RESIDENTIAL,71650,0,71650,55687,0,127337
190242600300000,SW 422,AG DWELLING,62736,0,62736,21116,391,84243
190245100100000,SW 422,AG LAND,74382,0,74382,0,0,74382
190245100200000,SW 422,RESIDENTIAL,11400,0,11400,0,0,11400
190247600100000,SW 422,AG LAND,62498,0,62498,0,2948,65446
190247600200000,SW 422,RESIDENTIAL,50750,0,50750,127315,0,178065
190310100100000,CITY PROPERTY,EXEMPT,0,0,0,0,0,0
190310100200000,CENTRALLY ASSESSED,EXEMPT,0,0,0,0,0,0
190315100100000,VACANT LAND,INDUSTRIAL,0,129600,129600,0,0,129600
190317600100000,CENTRALLY ASSESSED,OTHER,0,0,0,0,0,0
190317600200000,CENTRALLY ASSESSED,OTHER,0,0,0,0,0,0
190317600300000,VACANT LAND,INDUSTRIAL,0,342576,342576,0,0,342576
190317600400000,VACANT LAND,INDUSTRIAL,0,193752,193752,0,0,193752
190320100100000,CITY PROPERTY,EXEMPT,0,0,0,0,0,0
190322600300000,SW 415,RESIDENTIAL,40579,0,40579,83866,0,124445
190322600400000,SW 415,RESIDENTIAL,23497,0,23497,83668,0,107165
190322600500000,SW 415,RESIDENTIAL,25026,0,25026,90810,0,115836
190322600600000,SW 415,RESIDENTIAL,21632,0,21632,91685,0,113317
190322600700000,SW 415,RESIDENTIAL,21857,0,21857,100211,0,122068
190322600800000,VACANT LAND,COMMERCIAL,0,12450,12450,0,0,12450
190322600900000,SW 415,RESIDENTIAL,22484,0,22484,100709,0,123193
190322601000000,SW 415,RESIDENTIAL,29067,0,29067,124796,0,153863
190322601100000,SW 415,RESIDENTIAL,24186,0,24186,81944,0,106130
190322601200000,SW 415,RESIDENTIAL,21420,0,21420,84576,0,105996
190322601300000,SW 415,RESIDENTIAL,22315,0,22315,89198,0,111513
190322601400000,SW 415,RESIDENTIAL,19877,0,19877,109062,0,128939
190322601500000,SW 415,RESIDENTIAL,21210,0,21210,105120,0,126330
190322601600000,SW 415,RESIDENTIAL,21210,0,21210,91104,0,112314
190322601700000,SW 415,RESIDENTIAL,21210,0,21210,96893,0,118103
190322601800000,SW 415,RESIDENTIAL,30300,0,30300,111433,0,141733
190322601900000,SW 415,RESIDENTIAL,30300,0,30300,105478,0,135778
190322602000000,SW 415,RESIDENTIAL,31499,0,31499,96668,0,128167
190322602100000,SW 415,RESIDENTIAL,31464,0,31464,106223,0,137687
190322700100000,SW 415,RESIDENTIAL,21000,0,21000,91809,0,112809
190322700200000,SW 415,RESIDENTIAL,21000,0,21000,91512,0,112512
190322700300000,SW 415,RESIDENTIAL,21280,0,21280,104124,0,125404
190322700400000,SW 415,RESIDENTIAL,24198,0,24198,111773,0,135971
190322700500000,SW 415,RESIDENTIAL,20591,0,20591,143685,0,164276
190322700600000,SW 415,RESIDENTIAL,21877,0,21877,145136,0,167013
190322700700000,SW 415,RESIDENTIAL,22274,0,22274,116143,0,138417
190322700800000,SW 415,RESIDENTIAL,21552,0,21552,110461,0,132013
190322700900000,SW 415,RESIDENTIAL,5478,0,5478,0,0,5478
190322701000000,SW 415,RESIDENTIAL,26081,0,26081,96086,0,122167
190322701100000,SW 415,RESIDENTIAL,28977,0,28977,80510,0,109487
190322701200000,SW 415,RESIDENTIAL,29400,0,29400,112749,0,142149
190322701300000,SW 415,RESIDENTIAL,24412,0,24412,87725,0,112137
190322701400000,SW 415,RESIDENTIAL,22807,0,22807,101965,0,124772
190322701500000,SW 415,RESIDENTIAL,21630,0,21630,99240,0,120870
190322701600000,SW 415,RESIDENTIAL,19828,0,19828,95659,0,115487
190322701700000,SW 415,RESIDENTIAL,19828,0,19828,99163,0,118991
190322701800000,SW 415,RESIDENTIAL,19828,0,19828,109038,0,128866
190322701900000,SW 415,RESIDENTIAL,21294,0,21294,99523,0,120817
190322800100000,SW 415,RESIDENTIAL,21540,0,21540,93809,0,115349
190322800200000,SW 415,RESIDENTIAL,21011,0,21011,91642,0,112653
190322800300000,SW 415,RESIDENTIAL,22050,0,22050,97105,0,119155
190322800400000,SW 415,RESIDENTIAL,22050,0,22050,100600,0,122650
190322800500000,SW 415,RESIDENTIAL,22743,0,22743,120353,0,143096
190322800600000,SW 415,RESIDENTIAL,21479,0,21479,100409,0,121888
190322800700000,SW 415,RESIDENTIAL,22491,0,22491,101384,0,123875
190322800800000,SW 415,RESIDENTIAL,22491,0,22491,105366,0,127857
190325100100000,SW 415,RESIDENTIAL,36585,0,36585,141399,0,177984
190325100200000,SW 415,RESIDENTIAL,30608,0,30608,113002,0,143610
190325100300000,SW 415,RESIDENTIAL,31184,0,31184,108583,0,139767
190325100400000,SW 415,RESIDENTIAL,30000,0,30000,97533,0,127533
190325100500000,SW 415,RESIDENTIAL,30198,0,30198,110026,0,140224
190325100600000,SW 415,RESIDENTIAL,21387,0,21387,97805,0,119192
190325100700000,SW 415,RESIDENTIAL,30624,0,30624,107201,0,137825
190327600100000,CITY PROPERTY,EXEMPT,0,0,0,0,0,0
190327600200000,CEMETERY,OTHER,0,0,0,0,0,0
190327600300000,CENTRALLY ASSESSED,OTHER,0,0,0,0,0,0
190327600400000,CITY PROPERTY,EXEMPT,0,0,0,0,0,0
190327600500000,CENTRALLY ASSESSED,OTHER,0,0,0,0,0,0
190330100100000,MFG HOME PARK,COMMERCIAL,0,211775,211775,0,89107,300882
190330100200000,CENTRALLY ASSESSED,OTHER,0,0,0,0,0,0
190330100300000,WAREHOUSE,COMMERCIAL,0,230500,230500,0,266565,497065
190330100500000,CENTRALLY ASSESSED,OTHER,0,0,0,0,0,0
190330200100000,SW 422,RESIDENTIAL,17650,0,17650,0,0,17650
190330200200000,CENTRALLY ASSESSED,OTHER,0,0,0,0,0,0
190332600100000,SW 422,RESIDENTIAL,40250,0,40250,0,0,40250
190332600200000,CENTRALLY ASSESSED,OTHER,0,0,0,0,0,0
190332600300000,CITY PROPERTY,EXEMPT,0,0,0,0,0,0
190332600400000,CITY PROPERTY,EXEMPT,0,0,0,0,0,0
190332600500000,CENTRALLY ASSESSED,OTHER,0,0,0,0,0,0
190332700300000,SHOP,COMMERCIAL,0,91000,91000,0,229249,320249
190332700400000,SMALL RETAIL,COMMERCIAL,0,91185,91185,0,432077,523262
190332700500000,CONVENIENCE STORE,COMMERCIAL,0,162325,162325,0,347634,509959
190332700600000,WAREHOUSE,COMMERCIAL,0,103750,103750,0,113001,216751
190332700700000,WAREHOUSE,COMMERCIAL,0,595000,595000,0,668391,1263391
190335100100000,FLAT PARKING,COMMERCIAL,0,222500,222500,0,31740,254240
190335100200000,EQUIPMENT MFG;INDUST,INDUSTRIAL,0,1393416,1393416,0,3999670,5393086
190337600200000,SHOP,INDUSTRIAL,0,496800,496800,0,2303200,2800000
190337600300000,SHOP,INDUSTRIAL,0,270972,270972,0,1603624,1874596
190337600400000,WAREHOUSE,COMMERCIAL,0,176000,176000,0,924427,1100427
190337600500000,CARWASH,COMMERCIAL,0,357000,357000,0,511378,868378
190337600600000,SHOP,COMMERCIAL,0,181000,181000,0,468625,649625
190337600700000,FLAT PARKING,COMMERCIAL,0,19000,19000,0,7917,26917
190337601000000,WAREHOUSE,INDUSTRIAL,0,243648,243648,0,1255582,1499230
190340100100000,FOOD GRADE;INDUST,INDUSTRIAL,0,711774,711774,0,12124242,12836016
190342600100000,VACANT LAND,INDUSTRIAL,0,315414,315414,0,0,315414
190345100200000,WAREHOUSE,COMMERCIAL,0,628506,628506,0,7356575,7985081
190345100300000,FOOD GRADE;INDUST,INDUSTRIAL,0,783475,783475,0,12815106,13598581
190347600200000,OFFICE,COMMERCIAL,0,468020,468020,0,1196465,1664485
190347600300000,OFFICE,COMMERCIAL,0,350400,350400,0,1090862,1441262
190410100100000,SW 428,RESIDENTIAL,24840,0,24840,164224,0,189064
190410100200000,SW 428,RESIDENTIAL,31968,0,31968,49773,0,81741
190410100300000,SW 428,RESIDENTIAL,31166,0,31166,105410,0,136576
190410100400000,SW 428,RESIDENTIAL,31036,0,31036,128076,0,159112
190410100500000,SW 428,RESIDENTIAL,24607,0,24607,46549,0,71156
190410100600000,SW 428,RESIDENTIAL,19980,0,19980,104541,0,124521
190410100700000,SW 428,RESIDENTIAL,19980,0,19980,117366,0,137346
190410100800000,SW 428,RESIDENTIAL,20626,0,20626,117879,0,138505
190410100900000,SW 428,RESIDENTIAL,24975,0,24975,102827,0,127802
190410101000000,SW 428,RESIDENTIAL,24975,0,24975,87818,0,112793
190410101100000,SW 428,RESIDENTIAL,24975,0,24975,127362,0,152337
190410101200000,SW 428,RESIDENTIAL,24975,0,24975,178775,0,203750
190410101300000,SW 428,RESIDENTIAL,24975,0,24975,95525,0,120500
190410101400000,SW 428,RESIDENTIAL,24975,0,24975,113215,0,138190
190410101500000,SW 428,RESIDENTIAL,25011,0,25011,54689,0,79700
190410101600000,SW 428,RESIDENTIAL,24975,0,24975,58415,0,83390
190410101700000,SW 428,RESIDENTIAL,26019,0,26019,90811,0,116830
190410101800000,SW 428,RESIDENTIAL,23990,0,23990,60462,0,84452
190410101900000,SW 428,RESIDENTIAL,21168,0,21168,70992,0,92160
190410102000000,SW 428,RESIDENTIAL,18291,0,18291,145320,0,163611
190410102100000,SW 428,RESIDENTIAL,19929,0,19929,114533,0,134462
190410102200000,SW 428,RESIDENTIAL,24300,0,24300,73050,0,97350
190410102300000,SW 428,RESIDENTIAL,24300,0,24300,90782,0,115082
190410102400000,SW 428,RESIDENTIAL,24300,0,24300,82249,0,106549
190410102500000,SW 428,RESIDENTIAL,23850,0,23850,82989,0,106839
190410102600000,SW 428,RESIDENTIAL,23850,0,23850,91039,0,114889
190410102700000,SW 428,RESIDENTIAL,23850,0,23850,133737,0,157587
190410102800000,SW 428,RESIDENTIAL,24525,0,24525,80433,0,104958
190410102900000,SW 428,RESIDENTIAL,22072,0,22072,103988,0,126060
190410103000000,SW 428,RESIDENTIAL,21255,0,21255,90775,0,112030
190410103100000,SW 428,RESIDENTIAL,21000,0,21000,83913,0,104913
190410103200000,SW 428,RESIDENTIAL,22287,0,22287,0,0,22287
190410200100000,SW 428,RESIDENTIAL,25819,0,25819,51290,0,77109
190410200200000,SW 428,RESIDENTIAL,25819,0,25819,75994,0,101813
190410200300000,SW 428,RESIDENTIAL,34965,0,34965,50802,0,85767
190410200400000,SW 428,RESIDENTIAL,34965,0,34965,102726,0,137691
190410200500000,SW 428,RESIDENTIAL,30600,0,30600,39115,0,69715
190410200600000,SW 428,RESIDENTIAL,24480,0,24480,71386,0,95866
190410200700000,SW 428,RESIDENTIAL,24975,0,24975,90377,0,115352
190410200800000,SW 428,RESIDENTIAL,24975,0,24975,75345,0,100320
190410200900000,SW 428,RESIDENTIAL,25308,0,25308,83048,0,108356
190410201000000,SW 428,RESIDENTIAL,19980,0,19980,109734,0,129714
190410201100000,SW 428,RESIDENTIAL,18315,0,18315,90504,0,108819
190410201200000,SW 428,RESIDENTIAL,23976,0,23976,100676,0,124652
190410201300000,SW 428,RESIDENTIAL,24975,0,24975,98445,0,123420
190410201400000,SW 428,RESIDENTIAL,24975,0,24975,75334,0,100309
190410201500000,SW 428,RESIDENTIAL,16650,0,16650,85298,0,101948
190410201600000,SW 428,RESIDENTIAL,16650,0,16650,67800,0,84450
190410201700000,SW 428,RESIDENTIAL,50780,0,50780,44085,0,94865
190410201800000,SW 428,RESIDENTIAL,18720,0,18720,99477,0,118197
190410201900000,SW 428,RESIDENTIAL,18720,0,18720,0,0,18720
190410202000000,SW 428,RESIDENTIAL,20454,0,20454,73193,0,93647
190410202100000,SW 428,RESIDENTIAL,21802,0,21802,121416,0,143218
190410202200000,SW 428,RESIDENTIAL,19980,0,19980,114422,0,134402
190410202300000,SW 428,RESIDENTIAL,25974,0,25974,101765,0,127739
190410202400000,SW 428,RESIDENTIAL,20979,0,20979,82829,0,103808
190410202500000,SW 428,RESIDENTIAL,24975,0,24975,100905,0,125880
190410202600000,SW 428,RESIDENTIAL,24975,0,24975,57184,0,82159
190410202700000,SW 428,RESIDENTIAL,24975,0,24975,92321,0,117296
190410202800000,SW 428,RESIDENTIAL,24975,0,24975,78891,0,103866
190410202900000,SW 428,RESIDENTIAL,24975,0,24975,88192,0,113167
190410203000000,SW 428,RESIDENTIAL,24975,0,24975,77038,0,102013
190410203100000,SW 428,RESIDENTIAL,17364,0,17364,83304,0,100668
190410203200000,SW 428,RESIDENTIAL,17460,0,17460,104548,0,122008
190410300100000,SW 428,RESIDENTIAL,23460,0,23460,80117,0,103577
190410300200000,SW 428,RESIDENTIAL,24975,0,24975,91047,0,116022
190410300300000,SW 428,RESIDENTIAL,24975,0,24975,104098,0,129073
190410300400000,SW 428,RESIDENTIAL,15600,0,15600,77507,0,93107
190410300500000,SW 428,RESIDENTIAL,14850,0,14850,86343,0,101193
190410300600000,SW 415,RESIDENTIAL,23310,0,23310,91548,0,114858
190410300700000,SW 415,RESIDENTIAL,23380,0,23380,103517,0,126897
190410300800000,SW 428,RESIDENTIAL,28080,0,28080,122571,0,150651
190410300900000,SW 415,RESIDENTIAL,18550,0,18550,112572,0,131122
190410301000000,SW 415,RESIDENTIAL,18550,0,18550,73553,0,92103
190410301100000,SW 428,RESIDENTIAL,21955,0,21955,0,0,21955
190410301200000,SW 428,RESIDENTIAL,22847,0,22847,58647,0,81494
190410301300000,SW 428,RESIDENTIAL,21600,0,21600,104623,0,126223
190410301400000,SW 415,RESIDENTIAL,19250,0,19250,76363,0,95613
190410301500000,SW 428,RESIDENTIAL,22235,0,22235,91647,0,113882
190410301600000,SW 428,RESIDENTIAL,16650,0,16650,122435,0,139085
190410301700000,SW 428,RESIDENTIAL,16650,0,16650,85291,0,101941
190410301800000,SW 428,RESIDENTIAL,24975,0,24975,48755,0,73730
190410301900000,SW 428,RESIDENTIAL,24975,0,24975,75787,0,100762
190410302000000,SW 428,RESIDENTIAL,16650,0,16650,95318,0,111968
190410302100000,SW 428,RESIDENTIAL,16650,0,16650,94699,0,111349
190410302200000,SW 428,RESIDENTIAL,21675,0,21675,81262,0,102937
190410400100000,SW 415,RESIDENTIAL,23252,0,23252,99301,0,122553
190410500100000,SW 415,RESIDENTIAL,28170,0,28170,110340,0,138510
190410500200000,SW 415,RESIDENTIAL,31185,0,31185,107422,0,138607
190410500300000,SW 415,RESIDENTIAL,23651,0,23651,89947,0,113598
190410500400000,SW 415,RESIDENTIAL,22400,0,22400,88880,0,111280
190410500500000,SW 415,RESIDENTIAL,22400,0,22400,90302,0,112702
190410500600000,SW 415,RESIDENTIAL,22400,0,22400,98215,0,120615
190412600100000,SW 416,RESIDENTIAL,20706,0,20706,115388,0,136094
190412600200000,SW 416,RESIDENTIAL,20706,0,20706,117520,0,138226
190412600300000,SW 416,RESIDENTIAL,17661,0,17661,100804,0,118465
190412600400000,SW 416,RESIDENTIAL,16554,0,16554,105574,0,122128
190412600500000,SW 416,RESIDENTIAL,17942,0,17942,121008,0,138950
190412600600000,SW 416,RESIDENTIAL,24521,0,24521,70703,0,95224
190412600700000,SW 428,RESIDENTIAL,26550,0,26550,117437,0,143987
190412600800000,SW 428,RESIDENTIAL,25875,0,25875,70289,0,96164
190412600900000,SW 428,RESIDENTIAL,24750,0,24750,111261,0,136011
190412700100000,SW 416,RESIDENTIAL,17966,0,17966,86854,0,104820
190412700200000,SW 416,RESIDENTIAL,18270,0,18270,75301,0,93571
190412700300000,SW 416,RESIDENTIAL,22260,0,22260,85902,0,108162
190412700400000,SW 416,RESIDENTIAL,22470,0,22470,79053,0,101523
190412700500000,DAY CARE CENTER,COMMERCIAL,0,106200,106200,0,396467,502667
190412700600000,SW 415,RESIDENTIAL,36044,0,36044,151881,0,187925
190412700700000,SW 415,RESIDENTIAL,30978,0,30978,166152,0,197130
190412700800000,SW 415,RESIDENTIAL,27961,0,27961,105364,0,133325
190412700900000,SW 415,RESIDENTIAL,24515,0,24515,99112,0,123627
190412701000000,SW 415,RESIDENTIAL,25549,0,25549,87437,0,112986
190412701100000,SW 415,RESIDENTIAL,25235,0,25235,97631,0,122866
190412701200000,SW 415,RESIDENTIAL,24115,0,24115,97659,0,121774
190412701300000,SW 415,RESIDENTIAL,24115,0,24115,103625,0,127740
190412701400000,SW 415,RESIDENTIAL,24634,0,24634,108618,0,133252
190412701500000,SW 415,RESIDENTIAL,24882,0,24882,122764,0,147646
190412701600000,SW 415,RESIDENTIAL,24783,0,24783,89820,0,114603
190412701700000,SW 415,RESIDENTIAL,25463,0,25463,96013,0,121476
190412701800000,SW 415,RESIDENTIAL,24514,0,24514,84291,0,108805
190412701900000,SW 415,RESIDENTIAL,25127,0,25127,75465,0,100592
190412702000000,SW 428,RESIDENTIAL,23052,0,23052,76116,0,99168
190412702100000,SW 428,RESIDENTIAL,54800,0,54800,74286,0,129086
190412702200000,SW 428,RESIDENTIAL,21828,0,21828,89765,0,111593
190412702300000,SW 428,RESIDENTIAL,23192,0,23192,107530,0,130722
190412702400000,SW 416,RESIDENTIAL,25163,0,25163,97940,0,123103
190412702500000,SW 416,RESIDENTIAL,20715,0,20715,74257,0,94972
190412800300000,SW 416,RESIDENTIAL,21630,0,21630,135972,0,157602
190412800400000,SW 416,RESIDENTIAL,21236,0,21236,93338,0,114574
190412800500000,SW 428,RESIDENTIAL,51850,0,51850,61155,0,113005
190412800600000,SW 428,RESIDENTIAL,21994,0,21994,85104,0,107098
190412800700000,SW 428,RESIDENTIAL,20948,0,20948,149941,0,170889
190412800800000,SW 428,RESIDENTIAL,57250,0,57250,98420,0,155670
190412800900000,SW 428,RESIDENTIAL,63950,0,63950,76593,0,140543
190412801000000,SW 415,RESIDENTIAL,25017,0,25017,96904,0,121921
190412801100000,SW 415,RESIDENTIAL,24765,0,24765,101287,0,126052
190412801200000,SW 415,RESIDENTIAL,23310,0,23310,89752,0,113062
190412801300000,SW 415,RESIDENTIAL,23660,0,23660,92926,0,116586
190412801400000,SW 415,RESIDENTIAL,24500,0,24500,89315,0,113815
190412801500000,SW 415,RESIDENTIAL,24500,0,24500,92160,0,116660
190412801600000,SW 415,RESIDENTIAL,24993,0,24993,106734,0,131727
190412801700000,SW 415,RESIDENTIAL,24538,0,24538,111602,0,136140
190412801800000,SW 415,RESIDENTIAL,25116,0,25116,90842,0,115958
190412802000000,SW 416,RESIDENTIAL,44813,0,44813,110421,0,155234
190412802100000,SW 416,RESIDENTIAL,32130,0,32130,129799,0,161929
190412900100000,SW 416,RESIDENTIAL,25391,0,25391,89317,0,114708
190412900200000,SW 416,RESIDENTIAL,22610,0,22610,122069,0,144679
190412900300000,SW 416,RESIDENTIAL,21917,0,21917,98850,0,120767
190412900400000,SW 416,RESIDENTIAL,21385,0,21385,86342,0,107727
190412900500000,SW 416,RESIDENTIAL,24274,0,24274,132472,0,156746
190412900600000,SW 428,RESIDENTIAL,14400,0,14400,64475,0,78875
190412900900000,SW 428,RESIDENTIAL,15782,0,15782,84240,0,100022
190412901000000,SW 428,RESIDENTIAL,15660,0,15660,75139,0,90799
190412901100000,SW 428,RESIDENTIAL,15480,0,15480,74854,0,90334
190412901200000,SW 428,RESIDENTIAL,15282,0,15282,89092,0,104374
190412901300000,SW 428,RESIDENTIAL,16502,0,16502,75483,0,91985
190412901400000,SW 428,RESIDENTIAL,15082,0,15082,79127,0,94209
190412901500000,SW 428,RESIDENTIAL,18912,0,18912,101430,0,120342
190412901600000,SW 428,RESIDENTIAL,23700,0,23700,122949,0,146649
190412901700000,SW 428,RESIDENTIAL,22019,0,22019,64445,0,86464
190412901800000,SW 428,RESIDENTIAL,9437,0,9437,0,0,9437
190412901900000,SW 428,RESIDENTIAL,9641,0,9641,0,0,9641
190412902000000,SW 428,RESIDENTIAL,60200,0,60200,0,0,60200
190412902100000,SW 428,RESIDENTIAL,7388,0,7388,0,0,7388
190412902200000,SW 428,RESIDENTIAL,9620,0,9620,0,0,9620
190412902300000,SW 428,RESIDENTIAL,9620,0,9620,0,0,9620
190412902400000,SW 428,RESIDENTIAL,9066,0,9066,0,0,9066
190412902500000,SW 428,RESIDENTIAL,19381,0,19381,91026,0,110407
190412902600000,SW 428,RESIDENTIAL,23004,0,23004,44972,0,67976
190412902700000,SW 428,RESIDENTIAL,16549,0,16549,96859,0,113408
190412902800000,SW 428,RESIDENTIAL,17164,0,17164,67225,0,84389
190412902900000,SW 428,RESIDENTIAL,21678,0,21678,80728,0,102406
190412903000000,SW 428,RESIDENTIAL,21375,0,21375,80292,0,101667
190412903100000,SW 428,RESIDENTIAL,21375,0,21375,80292,0,101667
190412903200000,SW 428,RESIDENTIAL,21861,0,21861,0,0,21861
190412903300000,SW 428,RESIDENTIAL,25245,0,25245,99229,0,124474
190412903400000,SW 428,RESIDENTIAL,24288,0,24288,80240,0,104528
190413000100000,SW 415,RESIDENTIAL,22575,0,22575,96809,0,119384
190413000200000,SW 415,RESIDENTIAL,22575,0,22575,89712,0,112287
190413000300000,SW 415,RESIDENTIAL,22983,0,22983,90947,0,113930
190413000400000,SW 415,RESIDENTIAL,25470,0,25470,109354,0,134824
190413000500000,SW 415,RESIDENTIAL,25024,0,25024,125837,0,150861
190413000600000,SW 415,RESIDENTIAL,21840,0,21840,96974,0,118814
190413000700000,SW 415,RESIDENTIAL,21840,0,21840,98766,0,120606
190413000800000,SW 415,RESIDENTIAL,23797,0,23797,89952,0,113749
190413000900000,SW 415,RESIDENTIAL,25349,0,25349,106541,0,131890
190413100100000,SW 415,RESIDENTIAL,24497,0,24497,48235,0,72732
190413100200000,SW 415,RESIDENTIAL,22400,0,22400,90628,0,113028
190413100300000,SW 415,RESIDENTIAL,22400,0,22400,109916,0,132316
190413100400000,SW 415,RESIDENTIAL,22400,0,22400,93043,0,115443
190413100500000,SW 415,RESIDENTIAL,22400,0,22400,105001,0,127401
190413100600000,SW 415,RESIDENTIAL,22400,0,22400,89238,0,111638
190413100700000,SW 415,RESIDENTIAL,22050,0,22050,97598,0,119648
190413100800000,SW 415,RESIDENTIAL,22400,0,22400,118459,0,140859
190413100900000,SW 415,RESIDENTIAL,23450,0,23450,96545,0,119995
190413101000000,SW 415,RESIDENTIAL,23450,0,23450,105886,0,129336
190413101100000,SW 415,RESIDENTIAL,23450,0,23450,98821,0,122271
190413101200000,SW 415,RESIDENTIAL,23450,0,23450,94922,0,118372
190413101300000,SW 415,RESIDENTIAL,23450,0,23450,91701,0,115151
190413101400000,SW 415,RESIDENTIAL,31001,0,31001,104158,0,135159
190413101500000,SW 415,RESIDENTIAL,28077,0,28077,90419,0,118496
190413101600000,SW 415,RESIDENTIAL,22050,0,22050,92815,0,114865
190413101700000,SW 415,RESIDENTIAL,22050,0,22050,92790,0,114840
190413101800000,SW 415,RESIDENTIAL,22400,0,22400,92077,0,114477
190413101900000,SW 415,RESIDENTIAL,22400,0,22400,95908,0,118308
190413102000000,SW 415,RESIDENTIAL,22400,0,22400,91246,0,113646
190413102100000,SW 415,RESIDENTIAL,22400,0,22400,85932,0,108332
190413102200000,SW 415,RESIDENTIAL,22400,0,22400,92532,0,114932
190413102300000,SW 415,RESIDENTIAL,22400,0,22400,89561,0,111961
190413102400000,SW 415,RESIDENTIAL,22400,0,22400,86772,0,109172
190413102500000,SW 415,RESIDENTIAL,22400,0,22400,86537,0,108937
190413102600000,SW 415,RESIDENTIAL,22400,0,22400,101195,0,123595
190413102700000,SW 415,RESIDENTIAL,22400,0,22400,98213,0,120613
190413102800000,SW 415,RESIDENTIAL,22400,0,22400,94087,0,116487
190413102900000,SW 415,RESIDENTIAL,22400,0,22400,90595,0,112995
190415100100000,SW 428,RESIDENTIAL,26325,0,26325,121673,0,147998
190415100200000,SW 428,RESIDENTIAL,26325,0,26325,91881,0,118206
190415100300000,SW 428,RESIDENTIAL,26325,0,26325,98214,0,124539
190415100400000,SW 428,RESIDENTIAL,26325,0,26325,69309,0,95634
190415100500000,SW 415,RESIDENTIAL,24671,0,24671,89208,0,113879
190415100600000,SW 415,RESIDENTIAL,24671,0,24671,99593,0,124264
190415100700000,SW 415,RESIDENTIAL,24671,0,24671,88303,0,112974
190415100800000,SW 415,RESIDENTIAL,25235,0,25235,96940,0,122175
190415100900000,SW 415,RESIDENTIAL,24935,0,24935,99101,0,124036
190415101000000,SW 415,RESIDENTIAL,23930,0,23930,93175,0,117105
190415101100000,SW 415,RESIDENTIAL,23930,0,23930,82927,0,106857
190415101200000,SW 415,RESIDENTIAL,23930,0,23930,91106,0,115036
190415101300000,SW 415,RESIDENTIAL,23252,0,23252,90493,0,113745
190415101400000,SW 415,RESIDENTIAL,32083,0,32083,77945,0,110028
190415101500000,SW 428,RESIDENTIAL,45150,0,45150,131153,0,176303
190415101600000,SW 428,RESIDENTIAL,37800,0,37800,63054,0,100854
190415101700000,SW 428,RESIDENTIAL,19110,0,19110,113432,0,132542
190415101800000,SW 428,RESIDENTIAL,20880,0,20880,130106,0,150986
190415101900000,SW 428,RESIDENTIAL,42040,0,42040,0,0,42040
190415200100000,SW 415,RESIDENTIAL,24671,0,24671,85470,0,110141
190415200300000,APARTMENT,COMMERCIAL,0,34425,34425,0,9870,44295
190415200400000,CONVENIENCE STORE,COMMERCIAL,0,134250,134250,0,267407,401657
190415200500000,VACANT LAND,COMMERCIAL,0,36000,36000,0,0,36000
190415200600000,VACANT LAND,COMMERCIAL,0,38000,38000,0,0,38000
190415200700000,SMALL RETAIL,COMMERCIAL,0,99540,99540,0,377928,477468
190415200800000,VACANT LAND,COMMERCIAL,0,2675,2675,0,0,2675
190415201000000,WAREHOUSE,COMMERCIAL,0,60000,60000,0,159862,219862
190415201100000,WAREHOUSE,COMMERCIAL,0,81024,81024,0,216321,297345
190415201200000,CENTRALLY ASSESSED,OTHER,0,0,0,0,0,0
190415201300000,SR/NURSING/ASSTD LIV,COMMERCIAL,0,268800,268800,0,1903221,2172021
190415201400000,SW 415,RESIDENTIAL,20429,0,20429,85883,0,106312
190415201500000,SW 415,RESIDENTIAL,20426,0,20426,67411,0,87837
190415201600000,SW 415,RESIDENTIAL,18886,0,18886,47430,0,66316
190415201700000,SW 415,RESIDENTIAL,25011,0,25011,83967,0,108978
190415201800000,SW 415,RESIDENTIAL,25024,0,25024,93773,0,118797
190415201900000,SW 415,RESIDENTIAL,25024,0,25024,95927,0,120951
190415202000000,SW 415,RESIDENTIAL,25024,0,25024,107192,0,132216
190415202100000,SW 415,RESIDENTIAL,25024,0,25024,93168,0,118192
190415202200000,SW 415,RESIDENTIAL,24560,0,24560,97939,0,122499
190415202300000,SW 415,RESIDENTIAL,24671,0,24671,95162,0,119833
190415202400000,SW 415,RESIDENTIAL,24671,0,24671,99190,0,123861
190415300100000,SW 428,RESIDENTIAL,28320,0,28320,67966,0,96286
190415300200000,SW 428,RESIDENTIAL,28320,0,28320,82670,0,110990
190415300300000,SW 428,RESIDENTIAL,28320,0,28320,99853,0,128173
190415300400000,SW 428,RESIDENTIAL,28320,0,28320,95704,0,124024
190415300500000,SW 428,RESIDENTIAL,28320,0,28320,109154,0,137474
190415300600000,SW 428,RESIDENTIAL,28320,0,28320,66043,0,94363
190415300700000,SW 428,RESIDENTIAL,15000,0,15000,0,0,15000
190415300800000,SW 428,RESIDENTIAL,28820,0,28820,44138,0,72958
190415300900000,SW 428,RESIDENTIAL,28320,0,28320,83514,0,111834
190415301000000,SW 428,RESIDENTIAL,28320,0,28320,84313,0,112633
190415301100000,SW 428,RESIDENTIAL,22302,0,22302,5058,0,27360
190415301200000,SHOP,COMMERCIAL,0,102528,102528,0,166602,269130
190415301300000,SHOP,COMMERCIAL,0,74040,74040,0,185350,259390
190417600100000,SW 428,RESIDENTIAL,19340,0,19340,67435,0,86775
190417600200000,SW 428,RESIDENTIAL,15120,0,15120,96185,0,111305
190417600300000,SW 428,RESIDENTIAL,15300,0,15300,82940,0,98240
190417600400000,SW 428,RESIDENTIAL,16185,0,16185,79334,0,95519
190417600500000,SW 428,RESIDENTIAL,24756,0,24756,58238,0,82994
190417600600000,SW 428,RESIDENTIAL,29970,0,29970,101349,0,131319
190417600700000,SW 428,RESIDENTIAL,30510,0,30510,90365,0,120875
190417600800000,SW 428,RESIDENTIAL,30780,0,30780,57293,0,88073
190417600900000,SW 428,RESIDENTIAL,18038,0,18038,114260,0,132298
190417601000000,SW 428,RESIDENTIAL,21000,0,21000,51432,0,72432
190417601100000,SW 428,RESIDENTIAL,21130,0,21130,102533,0,123663
190417601200000,SW 428,RESIDENTIAL,25201,0,25201,65987,0,91188
190417601300000,SW 428,RESIDENTIAL,16950,0,16950,81180,0,98130
190417601400000,SW 428,RESIDENTIAL,16950,0,16950,64655,0,81605
190417601500000,SW 428,RESIDENTIAL,16950,0,16950,87170,0,104120
190417601600000,SW 428,RESIDENTIAL,16950,0,16950,79317,0,96267
190417700100000,SW 428,RESIDENTIAL,27005,0,27005,126952,0,153957
190417700200000,SW 428,RESIDENTIAL,26325,0,26325,207039,0,233364
190417700300000,SW 428,RESIDENTIAL,26325,0,26325,85373,0,111698
190417700400000,SW 415,RESIDENTIAL,18550,0,18550,84044,0,102594
190417700500000,SW 415,RESIDENTIAL,27133,0,27133,13077,0,40210
190417700600000,SW 415,RESIDENTIAL,27132,0,27132,0,0,27132
190417700700000,SW 415,RESIDENTIAL,24947,0,24947,102768,0,127715
190417700800000,SW 415,RESIDENTIAL,18550,0,18550,94652,0,113202
190417700900000,SW 415,RESIDENTIAL,18550,0,18550,107440,0,125990
190417701000000,SW 415,RESIDENTIAL,18900,0,18900,91045,0,109945
190417701100000,SW 415,RESIDENTIAL,18900,0,18900,87330,0,106230
190417701200000,SW 428,RESIDENTIAL,1605,0,1605,0,0,1605
190417701300000,SW 428,RESIDENTIAL,1605,0,1605,0,0,1605
190417701400000,SW 428,RESIDENTIAL,24120,0,24120,154844,0,178964
190417701500000,SW 428,RESIDENTIAL,35640,0,35640,48379,0,84019
190417701600000,SW 428,RESIDENTIAL,33915,0,33915,72421,0,106336
190417701700000,SW 428,RESIDENTIAL,54600,0,54600,74318,0,128918
190417701800000,SW 428,RESIDENTIAL,31320,0,31320,89443,0,120763
190417701900000,SW 428,RESIDENTIAL,29325,0,29325,67339,0,96664
190417702000000,SW 428,RESIDENTIAL,19125,0,19125,99889,0,119014
190417702100000,SW 428,RESIDENTIAL,26400,0,26400,100367,0,126767
190417800100000,SW 428,RESIDENTIAL,27876,0,27876,138862,0,166738
190417800200000,SW 428,RESIDENTIAL,26550,0,26550,96675,0,123225
190417800300000,SW 428,RESIDENTIAL,17700,0,17700,62796,0,80496
190417800400000,SW 428,RESIDENTIAL,17700,0,17700,62528,0,80228
190417800500000,SW 428,RESIDENTIAL,17700,0,17700,74369,0,92069
190417800600000,SR/NURSING/ASSTD LIV,COMMERCIAL,0,84000,84000,0,275816,359816
190417800700000,SW 428,RESIDENTIAL,25488,0,25488,81282,0,106770
190417800800000,SW 428,RESIDENTIAL,29736,0,29736,104554,0,134290
190417800900000,SW 428,RESIDENTIAL,28320,0,28320,132912,0,161232
190417801000000,SW 428,RESIDENTIAL,28320,0,28320,75848,0,104168
190417801100000,SW 428,RESIDENTIAL,24072,0,24072,80638,0,104710
190417801200000,SW 428,RESIDENTIAL,29736,0,29736,75055,0,104791
190417801300000,SW 428,RESIDENTIAL,26550,0,26550,72639,0,99189
190417801400000,SW 428,RESIDENTIAL,28320,0,28320,88096,0,116416
190417900100000,COUNTY PROPERTY,EXEMPT,0,0,0,0,0,0
190417900200000,CITY PROPERTY,EXEMPT,0,0,0,0,0,0
190417900300000,VACANT LAND,INDUSTRIAL,0,31104,31104,0,0,31104
190417900400000,CENTRALLY ASSESSED,OTHER,0,0,0,0,0,0
190420100100000,APARTMENT,EXEMPT,0,737000,737000,0,8287041,9024041
190420100200000,WAREHOUSE,COMMERCIAL,0,510420,510420,0,1454308,1964728
190422600100000,APARTMENT,COMMERCIAL,0,837000,837000,0,9312109,10149109
190422600200000,VACANT LAND,COMMERCIAL,0,40375,40375,0,0,40375
190422600300000,BOWLING ALLEY,COMMERCIAL,0,484312,484312,0,298898,783210
190422600400000,VACANT LAND,COMMERCIAL,0,490000,490000,0,35832,525832
190422600500000,SMALL RETAIL,COMMERCIAL,0,283442,283442,0,256749,540191
190422600600000,FAST FOOD,COMMERCIAL,0,101729,101729,0,339015,440744
190422600700000,FLAT PARKING,COMMERCIAL,0,44740,44740,0,4320,49060
190422600800000,OFFICE,COMMERCIAL,0,59503,59503,0,24245,83748
190422600900000,FRATERNAL,COMMERCIAL,0,133229,133229,0,228198,361427
190422601000000,HOTEL,COMMERCIAL,0,241500,241500,0,745432,986932
190422601100000,HOTEL,COMMERCIAL,0,512500,512500,0,1487500,2000000
190422601200000,CONVENIENCE STORE,COMMERCIAL,0,251100,251100,0,341671,592771
190422601300000,FAST FOOD,COMMERCIAL,0,338800,338800,0,594736,933536
190422700100000,HOTEL,COMMERCIAL,0,184750,184750,0,780643,965393
190422701400000,VACANT LAND,COMMERCIAL,0,20,20,0,0,20
190425100100000,RESTAURANT,COMMERCIAL,0,345200,345200,0,250317,595517
190425100200000,FAST FOOD,COMMERCIAL,0,231200,231200,0,569281,800481
190425100300000,FLAT PARKING,COMMERCIAL,0,174000,174000,0,8520,182520
190425100400000,HOTEL,COMMERCIAL,0,571250,571250,0,1428750,2000000
190425100500000,HOTEL,COMMERCIAL,0,533750,533750,0,1251391,1785141
190425200100000,HOTEL,COMMERCIAL,0,254400,254400,0,790443,1044843
190425200200000,HOTEL,COMMERCIAL,0,306000,306000,0,921674,1227674
190425200300000,OFFICE,COMMERCIAL,0,240020,240020,0,403604,643624
190425200400000,HOTEL,COMMERCIAL,0,538270,538270,0,2515783,3054053
190425200500000,RESTAURANT,COMMERCIAL,0,337520,337520,0,604999,942519
190425200600000,FAST FOOD,COMMERCIAL,0,388500,388500,0,355314,743814
190425200700000,BRANCH BANK/CU,COMMERCIAL,0,390020,390020,0,601807,991827
190425200800000,VACANT LAND,COMMERCIAL,0,123380,123380,0,0,123380
190425200900000,RESTAURANT,COMMERCIAL,0,339000,339000,0,419724,758724
190425300100000,RESTAURANT,COMMERCIAL,0,482400,482400,0,607621,1090021
190425300200000,HOTEL,COMMERCIAL,0,332520,332520,0,2405802,2738322
190425300300000,OFFICE,COMMERCIAL,0,363300,363300,0,924752,1288052
190425300400000,HOTEL,COMMERCIAL,0,814800,814800,0,5122604,5937404
190425300500000,FAST FOOD,COMMERCIAL,0,362600,362600,0,727829,1090429
190425300600000,WAREHOUSE;MINI STORG,COMMERCIAL,0,483750,483750,0,622400,1106150
190425300700000,OFFICE,COMMERCIAL,0,88126,88126,0,335874,424000
190425400600000,OFFICE,COMMERCIAL,0,101850,101850,0,395652,497502
190425400700000,OFFICE,COMMERCIAL,0,101850,101850,0,394789,496639
190425400800000,WAREHOUSE,COMMERCIAL,0,146250,146250,0,386823,533073
190427600100000,SHOP,COMMERCIAL,0,280000,280000,0,588961,868961
190427600200000,SHOP,COMMERCIAL,0,216250,216250,0,652144,868394
190427600300000,SHOP,COMMERCIAL,0,149500,149500,0,455473,604973
190427600400000,SMALL RETAIL,COMMERCIAL,0,59708,59708,0,127909,187617
190427600500000,SHOP,COMMERCIAL,0,59705,59705,0,318113,377818
190427600700000,WAREHOUSE,COMMERCIAL,0,146420,146420,0,723376,869796
190427600800000,AUTO REPAIR/SALES,COMMERCIAL,0,187860,187860,0,638474,826334
190427600900000,SHOP,COMMERCIAL,0,121145,121145,0,324941,446086
190427601000000,WAREHOUSE,COMMERCIAL,0,378000,378000,0,1033478,1411478
190427601100000,SMALL RETAIL,COMMERCIAL,0,88140,88140,0,246958,335098
190427601102000,BILLBOARD(BLL),COMMERCIAL,0,0,0,0,10203,10203
190427601200000,OFFICE,COMMERCIAL,0,113620,113620,0,375139,488759
190427601300000,SHOP,COMMERCIAL,0,95270,95270,0,295557,390827
190427601400000,SHOP,COMMERCIAL,0,114395,114395,0,464192,578587
190427601500000,FRATERNAL,COMMERCIAL,0,97148,97148,0,205174,302322
190427601600000,SMALL RETAIL,COMMERCIAL,0,53500,53500,0,350896,404396
190430100100000,WAREHOUSE,COMMERCIAL,0,317500,317500,0,1462830,1780330
190430200100000,CONC/ASPH;INDUSTRIAL,INDUSTRIAL,0,245862,245862,0,179626,425488
190430200102000,BILLBOARD(BLL),COMMERCIAL,0,0,0,0,44063,44063
190430200200000,SHOP,COMMERCIAL,0,95200,95200,0,181983,277183
190430200300000,FLAT PARKING,COMMERCIAL,0,20960,20960,0,1400,22360
190430200400000,SHOP,COMMERCIAL,0,77700,77700,0,266507,344207
190430200500000,VACANT LAND,COMMERCIAL,0,367900,367900,0,0,367900
190430200502000,BILLBOARD(BLL),COMMERCIAL,0,0,0,0,50672,50672
190432600100000,WAREHOUSE,COMMERCIAL,0,418500,418500,0,1675928,2094428
190432600200000,FLAT PARKING,COMMERCIAL,0,172200,172200,0,68854,241054
190435100200000,WAREHOUSE,COMMERCIAL,0,154500,154500,0,148033,302533
190435100300000,WAREHOUSE,COMMERCIAL,0,2000500,2000500,0,33963057,35963557
190435100302000,BILLBOARD(BLL),COMMERCIAL,0,0,0,0,51517,51517
190435200100000,SHOP,COMMERCIAL,0,137256,137256,0,79092,216348
190435200200000,STATE PROPERTY,EXEMPT,0,0,0,0,0,0
190435300100000,WAREHOUSE,COMMERCIAL,0,103680,103680,0,320259,423939
190435300200000,CENTRALLY ASSESSED,OTHER,0,0,0,0,0,0
190435300300000,COUNTY PROPERTY,EXEMPT,0,0,0,0,0,0
190435300400000,SCHOOL,EXEMPT,0,0,0,0,0,0
190435300500000,VACANT LAND,COMMERCIAL,0,57000,57000,0,3240,60240
190437600100000,CENTRALLY ASSESSED,OTHER,0,0,0,0,0,0
190437600200000,CENTRALLY ASSESSED,OTHER,0,0,0,0,0,0
190437700100000,BILLBOARD(BLL),COMMERCIAL,0,31500,31500,0,0,31500
190437700102000,BILLBOARD(BLL),COMMERCIAL,0,0,0,0,47396,47396
190440100100000,CITY PROPERTY,EXEMPT,0,0,0,0,0,0
190440100200000,CITY PROPERTY,EXEMPT,0,0,0,0,0,0
190440100300000,CITY PROPERTY,EXEMPT,0,0,0,0,0,0
190440100400000,CENTRALLY ASSESSED,OTHER,0,0,0,0,0,0
190440200200000,DAY CARE CENTER,EXEMPT,0,420098,420098,0,2083418,2503516
190440200300000,SHOP,COMMERCIAL,0,260000,260000,0,79379,339379
190440200400000,SW 422,RESIDENTIAL,77250,0,77250,55887,0,133137
190442600100000,CONC/ASPH;INDUSTRIAL,INDUSTRIAL,0,206874,206874,0,322694,529568
190442600200000,VACANT LAND,INDUSTRIAL,0,273726,273726,0,0,273726
190442600300000,WAREHOUSE,COMMERCIAL,0,208740,208740,0,95579,304319
190442600400000,SHOP,COMMERCIAL,0,466000,466000,0,411640,877640
190442600500000,CITY PROPERTY,EXEMPT,0,0,0,0,0,0
190442600600000,CENTRALLY ASSESSED,OTHER,0,0,0,0,0,0
190445100100000,CENTRALLY ASSESSED,OTHER,0,0,0,0,0,0
190445100200000,CENTRALLY ASSESSED,OTHER,0,0,0,0,0,0
190445100300000,CITY PROPERTY,EXEMPT,0,0,0,0,0,0
190445100400000,SW 422,RESIDENTIAL,187150,0,187150,111422,0,298572
190447600100000,SMALL RETAIL,COMMERCIAL,0,106000,106000,0,129103,235103
190447600200000,SW 422,RESIDENTIAL,66400,0,66400,59487,0,125887
190447600300000,WAREHOUSE,COMMERCIAL,0,63731,63731,0,87408,151139
190447600400000,WAREHOUSE,COMMERCIAL,0,137600,137600,0,241186,378786
190447600500000,SW 422,RESIDENTIAL,29700,0,29700,0,0,29700
190447600600000,SW 422,RESIDENTIAL,23222,0,23222,0,0,23222
190447600700000,SW 422,RESIDENTIAL,23178,0,23178,0,0,23178
190447600800000,SW 422,RESIDENTIAL,42800,0,42800,61990,0,104790
190447700100000,FEED/ADDITIVE;INDUST,INDUSTRIAL,0,279234,279234,0,1599902,1879136
190447700200000,WAREHOUSE,COMMERCIAL,0,379080,379080,0,397181,776261
190447700300000,CENTRALLY ASSESSED,OTHER,0,0,0,0,0,0
190447700400000,MFG HOME PARK,COMMERCIAL,0,512000,512000,0,465999,977999
190510100100000,WAREHOUSE,COMMERCIAL,0,360000,360000,0,245712,605712
190510100200000,VACANT LAND,COMMERCIAL,0,138000,138000,0,0,138000
190510100300000,WAREHOUSE,COMMERCIAL,0,456000,456000,0,312517,768517
190510100400000,AUTO REPAIR/SALES,COMMERCIAL,0,105000,105000,0,298914,403914
190510100500000,VACANT LAND,COMMERCIAL,0,27181,27181,0,0,27181
190510100600000,VACANT LAND,COMMERCIAL,0,136000,136000,0,0,136000
190510100700000,WAREHOUSE,COMMERCIAL,0,175000,175000,0,393311,568311
190510100800000,VACANT LAND,COMMERCIAL,0,71000,71000,0,0,71000
190510100900000,WAREHOUSE,COMMERCIAL,0,82000,82000,0,242692,324692
190510101000000,WAREHOUSE,COMMERCIAL,0,185250,185250,0,278801,464051
190510101100000,BARS/LOUNGE,COMMERCIAL,0,156750,156750,0,175308,332058
190510101200000,VACANT LAND,COMMERCIAL,0,205000,205000,0,0,205000
190510101300000,WAREHOUSE,COMMERCIAL,0,115250,115250,0,263166,378416
190510200100000,RESTAURANT,COMMERCIAL,0,135158,135158,0,92036,227194
190510200200000,COUNTY PROPERTY,EXEMPT,0,0,0,0,0,0
190510200300000,WAREHOUSE;MINI STORG,COMMERCIAL,0,116550,116550,0,268651,385201
190510200400000,FLAT PARKING,COMMERCIAL,0,79075,79075,0,2214,81289
190510200500000,WAREHOUSE,COMMERCIAL,0,57250,57250,0,163333,220583
190510201300000,WAREHOUSE,COMMERCIAL,0,61400,61400,0,131344,192744
190510201400000,OFFICE,EXEMPT,0,130464,130464,0,674603,805067
190510201402001,BILLBOARD(BLL),COMMERCIAL,0,0,0,0,12298,12298
190510201500000,OFFICE,COMMERCIAL,0,255000,255000,0,681872,936872
190510201700000,BARS/LOUNGE,COMMERCIAL,0,132320,132320,0,159043,291363
190510201800000,SHOP,COMMERCIAL,0,58275,58275,0,199349,257624
190510201900000,OFFICE,COMMERCIAL,0,504775,504775,0,3089249,3594024
190510202000000,SECTION 42,COMMERCIAL,0,161800,161800,0,209704,371504
190512600500000,STATE PROPERTY,EXEMPT,0,0,0,0,0,0
190512700100000,WAREHOUSE,COMMERCIAL,0,376000,376000,0,347225,723225
190512700200000,EQUIPMENT MFG;INDUST,INDUSTRIAL,0,149256,149256,0,612308,761564
190512700400000,OFFICE,COMMERCIAL,0,68900,68900,0,135825,204725
190512700500000,OFFICE,COMMERCIAL,0,66600,66600,0,118437,185037
190512700600000,WAREHOUSE,COMMERCIAL,0,162000,162000,0,353220,515220
190512700700000,SHOP,COMMERCIAL,0,68400,68400,0,245730,314130
190512700800000,OFFICE,COMMERCIAL,0,70400,70400,0,241879,312279
190512700900000,WAREHOUSE,COMMERCIAL,0,203000,203000,0,525242,728242
190512701000000,WAREHOUSE,COMMERCIAL,0,40600,40600,0,89614,130214
190512701100000,WAREHOUSE,COMMERCIAL,0,65700,65700,0,92810,158510
190515100101000,WAREHOUSE,COMMERCIAL,0,148201,148201,0,764773,912974
190515100101001,MATERIALS MFG;INDUST,INDUSTRIAL,0,227286,227286,0,1944858,2172144
190515100101002,SCHOOL,EXEMPT,0,0,0,0,0,0
190515100101003,SCHOOL,EXEMPT,0,0,0,0,0,0
190515100101004,MATERIALS MFG;INDUST,INDUSTRIAL,0,15658,15658,0,174887,190545
190515100101005,MATERIALS MFG;INDUST,INDUSTRIAL,0,149027,149027,0,1364641,1513668
190515200100000,WAREHOUSE,COMMERCIAL,0,509800,509800,0,1648681,2158481
190515200200000,WAREHOUSE,COMMERCIAL,0,461000,461000,0,1662179,2123179
190515200300000,WAREHOUSE,COMMERCIAL,0,463000,463000,0,2306118,2769118
190515300100000,WAREHOUSE,COMMERCIAL,0,299000,299000,0,1028147,1327147
190515300200000,WAREHOUSE,COMMERCIAL,0,291000,291000,0,1075390,1366390
190517600200000,OFFICE,COMMERCIAL,0,61420,61420,0,433239,494659
190517600300000,OFFICE,COMMERCIAL,0,99020,99020,0,490496,589516
190517600600000,AUTO REPAIR/SALES,COMMERCIAL,0,513750,513750,0,422379,936129
190517600700000,VACANT LAND,COMMERCIAL,0,152950,152950,0,0,152950
190517600800000,VACANT LAND,COMMERCIAL,0,386200,386200,0,0,386200
190517600900000,HOTEL,COMMERCIAL,0,317500,317500,0,1298694,1616194
190517601000000,HOTEL,COMMERCIAL,0,247770,247770,0,753619,1001389
190517601100000,HOTEL,COMMERCIAL,0,387770,387770,0,1037598,1425368
190517601200000,FAST FOOD,COMMERCIAL,0,402500,402500,0,789173,1191673
190517601300000,MATERIALS MFG;INDUST,INDUSTRIAL,0,77639,77639,0,336482,414121
190517601500000,WAREHOUSE,COMMERCIAL,0,761500,761500,0,4293429,5054929
190517601600000,HOTEL,COMMERCIAL,0,480000,480000,0,3133969,3613969
190517700300000,AUTO REPAIR/SALES,COMMERCIAL,0,241500,241500,0,598751,840251
190517700400000,FLAT PARKING,COMMERCIAL,0,189000,189000,0,21900,210900
190517700500000,WAREHOUSE,COMMERCIAL,0,326000,326000,0,730012,1056012
190517700600000,WAREHOUSE,COMMERCIAL,0,310500,310500,0,276282,586782
190517700700000,WAREHOUSE,COMMERCIAL,0,96400,96400,0,299917,396317
190517700800000,WAREHOUSE,COMMERCIAL,0,331850,331850,0,585045,916895
190517800100000,FRATERNAL,COMMERCIAL,0,160920,160920,0,358498,519418
190517800200000,OFFICE,COMMERCIAL,0,149000,149000,0,863671,1012671
190520100300000,VACANT LAND,INDUSTRIAL,0,1080,1080,0,0,1080
190520100400000,MISCELLANEOUS,COMMERCIAL,0,26100,26100,0,39411,65511
190520100600000,MISCELLANEOUS,COMMERCIAL,0,39330,39330,0,49680,89010
190520100700000,SHOP,COMMERCIAL,0,595350,595350,0,2764721,3360071
190520100800000,WAREHOUSE,COMMERCIAL,0,114500,114500,0,854811,969311
190520100900000,VACANT LAND,COMMERCIAL,0,315920,315920,0,0,315920
190520200100000,SW 455,AG LAND,23379,0,23379,0,0,23379
190522600100000,SW 418,AG LAND,30627,0,30627,0,0,30627
190522600200000,CENTRALLY ASSESSED,OTHER,0,0,0,0,0,0
190522700200000,CITY PROPERTY,EXEMPT,0,0,0,0,0,0
190522700600000,SW 425,RESIDENTIAL,24008,0,24008,129343,0,153351
190522700700000,SW 425,RESIDENTIAL,25850,0,25850,124935,0,150785
190522700800000,SW 425,RESIDENTIAL,1140,0,1140,0,0,1140
190522700900000,SW 425,RESIDENTIAL,27835,0,27835,125962,0,153797
190522701000000,SW 425,RESIDENTIAL,26136,0,26136,124306,0,150442
190522701100000,SW 425,RESIDENTIAL,26136,0,26136,129895,0,156031
190522701200000,SW 425,RESIDENTIAL,26136,0,26136,120868,0,147004
190522701300000,SW 425,RESIDENTIAL,22687,0,22687,89596,0,112283
190522701400000,SW 425,RESIDENTIAL,22961,0,22961,89596,0,112557
190522701500000,SW 425,RESIDENTIAL,26730,0,26730,89596,0,116326
190522701600000,SW 425,RESIDENTIAL,24447,0,24447,92658,0,117105
190522701700000,SW 425,RESIDENTIAL,23716,0,23716,93269,0,116985
190522701800000,SW 425,RESIDENTIAL,25608,0,25608,87892,0,113500
190522701900000,SW 425,RESIDENTIAL,23474,0,23474,91554,0,115028
190522702000000,SW 425,RESIDENTIAL,23474,0,23474,89858,0,113332
190522702100000,SW 425,RESIDENTIAL,23474,0,23474,94006,0,117480
190522702200000,SW 425,RESIDENTIAL,23357,0,23357,90280,0,113637
190522702700000,SW 425,RESIDENTIAL,23474,0,23474,134701,0,158175
190522702800000,SW 425,RESIDENTIAL,43560,0,43560,139858,0,183418
190522800100000,SW 425,RESIDENTIAL,32384,0,32384,142820,0,175204
190522800200000,SW 425,RESIDENTIAL,27209,0,27209,139099,0,166308
190522800300000,SW 425,RESIDENTIAL,26444,0,26444,107115,0,133559
190522800400000,SW 425,RESIDENTIAL,24926,0,24926,108341,0,133267
190522800500000,SW 425,RESIDENTIAL,30215,0,30215,92516,0,122731
190522800600000,SW 425,RESIDENTIAL,28331,0,28331,94074,0,122405
190522800700000,SW 425,RESIDENTIAL,33183,0,33183,125929,0,159112
190522800800000,SW 425,RESIDENTIAL,26411,0,26411,121944,0,148355
190522800900000,SW 425,RESIDENTIAL,25872,0,25872,124008,0,149880
190522801000000,SW 425,RESIDENTIAL,29779,0,29779,129761,0,159540
190525100100000,SW 455,AG LAND,42620,0,42620,0,0,42620
190525200100000,CITY PROPERTY,EXEMPT,0,0,0,0,0,0
190525200200000,CITY PROPERTY,EXEMPT,0,0,0,0,0,0
190525200300000,SW 455,RESIDENTIAL,36250,0,36250,0,0,36250
190527600100000,MISCELLANEOUS,COMMERCIAL,0,52520,52520,0,109796,162316
190527600200000,MISCELLANEOUS,COMMERCIAL,0,47362,47362,0,255090,302452
190527700100000,SW 455,AG LAND,14567,0,14567,0,0,14567
190527800100000,SW 455,AG LAND,27096,0,27096,0,0,27096
190530100100000,SW 455,AG LAND,63656,0,63656,0,0,63656
190532600100000,SW 455,AG LAND,75931,0,75931,0,0,75931
190535100100000,CITY PROPERTY,EXEMPT,0,0,0,0,0,0
190535200100000,CENTRALLY ASSESSED,INDUSTRIAL,0,37390,37390,0,0,37390
190537600100000,VACANT LAND,COMMERCIAL,0,174619,174619,0,0,174619
190537600200000,CITY PROPERTY,EXEMPT,0,0,0,0,0,0
190537700100000,CENTRALLY ASSESSED,OTHER,0,0,0,0,0,0
190540100200000,EQUIPMENT MFG;INDUST,INDUSTRIAL,0,655398,655398,0,4666250,5321648
190540200100000,WAREHOUSE,COMMERCIAL,0,118800,118800,0,64494,183294
190540200200000,WAREHOUSE,COMMERCIAL,0,772600,772600,0,240097,1012697
190540200300000,VACANT LAND,COMMERCIAL,0,141100,141100,0,0,141100
190540200400000,VACANT LAND,COMMERCIAL,0,30500,30500,0,0,30500
190540200500000,VACANT LAND,COMMERCIAL,0,30250,30250,0,200,30450
190540200600000,WAREHOUSE,COMMERCIAL,0,59250,59250,0,63126,122376
190542600200000,CENTRALLY ASSESSED,OTHER,0,0,0,0,0,0
190542600300000,SW 418,AG LAND,713,0,713,0,0,713
190542600400000,SW 418,AG LAND,37153,0,37153,0,0,37153
190545100100000,SHOP,COMMERCIAL,0,252000,252000,0,73151,325151
190545100200000,VACANT LAND,COMMERCIAL,0,33500,33500,0,0,33500
190545200100000,OFFICE,COMMERCIAL,0,128819,128819,0,144461,273280
190545200200000,WAREHOUSE,COMMERCIAL,0,74750,74750,0,227727,302477
190545200400000,CENTRALLY ASSESSED,OTHER,0,0,0,0,0,0
190545300200000,SW 455,RESIDENTIAL,53450,0,53450,37554,0,91004
190545300300000,SW 455,RESIDENTIAL,53100,0,53100,88270,0,141370
190547600100000,WAREHOUSE,COMMERCIAL,0,120750,120750,0,7290,128040
190547700100000,WAREHOUSE,COMMERCIAL,0,351250,351250,0,126080,477330
190547700102000,BILLBOARD(BLL),COMMERCIAL,0,0,0,0,42909,42909
190547700200000,CONC/ASPH;INDUSTRIAL,INDUSTRIAL,0,75897,75897,0,186820,262717
190547700300000,WAREHOUSE,COMMERCIAL,0,116750,116750,0,231351,348101
190547700600000,WAREHOUSE,COMMERCIAL,0,547420,547420,0,2471646,3019066
190610100500000,SW 457,RESIDENTIAL,48195,0,48195,169897,0,218092
190610100600000,SW 457,RESIDENTIAL,285,0,285,0,0,285
190610100700000,SW 457,RESIDENTIAL,50400,0,50400,191902,0,242302
190610100800000,SW 457,RESIDENTIAL,53810,0,53810,178133,0,231943
190610100900000,SW 457,RESIDENTIAL,53686,0,53686,224745,0,278431
190610101000000,SW 457,RESIDENTIAL,49896,0,49896,160034,0,209930
190610101100000,SW 457,RESIDENTIAL,57688,0,57688,184598,0,242286
190610101200000,SW 457,RESIDENTIAL,49248,0,49248,149197,0,198445
190610101300000,SW 457,RESIDENTIAL,53881,0,53881,177753,0,231634
190610101400000,SW 457,RESIDENTIAL,59954,0,59954,219437,0,279391
190610101500000,CITY PROPERTY,EXEMPT,0,0,0,0,0,0
190610101600000,SW 457,RESIDENTIAL,54994,0,54994,214498,0,269492
190610101700000,SW 457,RESIDENTIAL,33384,0,33384,249089,0,282473
190610101800000,SW 457,RESIDENTIAL,48212,0,48212,187408,0,235620
190610101900000,SW 457,RESIDENTIAL,45955,0,45955,190253,0,236208
190610102100000,SW 457,RESIDENTIAL,49692,0,49692,189503,0,239195
190610102200000,SW 457,RESIDENTIAL,43430,0,43430,216955,0,260385
190610102300000,SW 457,RESIDENTIAL,46258,0,46258,175473,0,221731
190610102400000,SW 457,RESIDENTIAL,46258,0,46258,186168,0,232426
190610102600000,SW 457,RESIDENTIAL,10,0,10,0,0,10
190610102700000,SW 457,RESIDENTIAL,44642,0,44642,147017,0,191659
190610102800000,SW 457,RESIDENTIAL,225,0,225,0,0,225
190610102900000,SW 457,RESIDENTIAL,216,0,216,0,0,216
190610103000000,SW 457,RESIDENTIAL,41814,0,41814,169242,0,211056
190610103100000,SW 457,RESIDENTIAL,6601,0,6601,0,0,6601
190610103200000,SW 420,AG LAND,21753,0,21753,0,0,21753
190610200100000,SW 457,RESIDENTIAL,44676,0,44676,163005,0,207681
190610200200000,SW 457,RESIDENTIAL,46512,0,46512,143500,0,190012
190610200300000,SW 457,RESIDENTIAL,50094,0,50094,194862,0,244956
190610200400000,SW 457,RESIDENTIAL,59449,0,59449,196538,0,255987
190610200500000,SW 457,RESIDENTIAL,214,0,214,0,0,214
190610200600000,SW 457,RESIDENTIAL,49128,0,49128,159078,0,208206
190610200700000,SW 457,RESIDENTIAL,44496,0,44496,7520,0,52016
190610200800000,SW 457,RESIDENTIAL,49572,0,49572,215934,0,265506
190610300100000,SW 457,RESIDENTIAL,51948,0,51948,199683,0,251631
190610300200000,SW 457,RESIDENTIAL,198,0,198,0,0,198
190610400100000,SW 425,RESIDENTIAL,34027,0,34027,92938,0,126965
190610400200000,SW 425,RESIDENTIAL,30855,0,30855,93799,0,124654
190610500100000,SW 425,RESIDENTIAL,23958,0,23958,90250,0,114208
190610500200000,SW 425,RESIDENTIAL,28331,0,28331,92010,0,120341
190612600400000,CITY PROPERTY,EXEMPT,0,0,0,0,0,0
190612600700000,SW 457,RESIDENTIAL,51940,0,51940,208268,0,260208
190612600800000,SW 457,RESIDENTIAL,52644,0,52644,159658,0,212302
190612600900000,SW 457,RESIDENTIAL,55744,0,55744,191045,0,246789
190612601000000,SW 457,RESIDENTIAL,57960,0,57960,179740,0,237700
190612601100000,SW 457,RESIDENTIAL,50470,0,50470,245597,0,296067
190612601200000,SW 457,RESIDENTIAL,46812,0,46812,236724,0,283536
190612601300000,SW 457,RESIDENTIAL,51480,0,51480,213740,0,265220
190612601400000,SW 457,RESIDENTIAL,55650,0,55650,203206,0,258856
190612601500000,SW 457,RESIDENTIAL,45800,0,45800,247352,0,293152
190612601600000,SW 457,RESIDENTIAL,43260,0,43260,216262,0,259522
190612601700000,SW 457,RESIDENTIAL,49296,0,49296,218425,0,267721
190612601800000,SW 457,RESIDENTIAL,49440,0,49440,205567,0,255007
190612601900000,SW 457,RESIDENTIAL,48616,0,48616,200486,0,249102
190612602300000,SW 457,RESIDENTIAL,49440,0,49440,217226,0,266666
190612602400000,SW 457,RESIDENTIAL,49560,0,49560,227286,0,276846
190612602500000,SW 457,RESIDENTIAL,49392,0,49392,179538,0,228930
190612602600000,SW 457,RESIDENTIAL,42642,0,42642,153654,0,196296
190612602700000,SW 457,RESIDENTIAL,46512,0,46512,173460,0,219972
190612602800000,SW 457,RESIDENTIAL,44064,0,44064,186211,0,230275
190612602900000,SW 457,RESIDENTIAL,48960,0,48960,192495,0,241455
190612603000000,SW 457,RESIDENTIAL,46512,0,46512,214051,0,260563
190612603100000,SW 457,RESIDENTIAL,44064,0,44064,166068,0,210132
190612603200000,SW 457,RESIDENTIAL,47586,0,47586,167478,0,215064
190612603300000,SW 457,RESIDENTIAL,39552,0,39552,176503,0,216055
190612603400000,SW 457,RESIDENTIAL,46512,0,46512,175082,0,221594
190612603500000,SW 457,RESIDENTIAL,339,0,339,0,0,339
190612603600000,SW 457,RESIDENTIAL,49572,0,49572,273578,0,323150
190612603700000,SW 457,RESIDENTIAL,47124,0,47124,230090,0,277214
190612603800000,SW 457,RESIDENTIAL,47586,0,47586,228851,0,276437
190612603900000,SW 457,RESIDENTIAL,55970,0,55970,194877,0,250847
190612604000000,SW 457,RESIDENTIAL,49376,0,49376,230551,0,279927
190612604100000,SW 457,RESIDENTIAL,48600,0,48600,254449,0,303049
190612604200000,SW 457,RESIDENTIAL,53972,0,53972,192811,0,246783
190612700100000,SW 457,RESIDENTIAL,49800,0,49800,242572,0,292372
190612700200000,SW 457,RESIDENTIAL,48412,0,48412,164257,0,212669
190612700300000,SW 457,RESIDENTIAL,46080,0,46080,209030,0,255110
190612700400000,SW 457,RESIDENTIAL,58410,0,58410,210911,0,269321
190612700500000,SW 457,RESIDENTIAL,52208,0,52208,202170,0,254378
190612700600000,SW 457,RESIDENTIAL,48960,0,48960,206595,0,255555
190612700700000,SW 457,RESIDENTIAL,42840,0,42840,180143,0,222983
190612700800000,SW 457,RESIDENTIAL,46512,0,46512,198600,0,245112
190612701200000,SW 457,RESIDENTIAL,53729,0,53729,158476,0,212205
190612701300000,SW 457,RESIDENTIAL,51330,0,51330,171488,0,222818
190612701400000,SW 457,RESIDENTIAL,52731,0,52731,165367,0,218098
190612701500000,SW 457,RESIDENTIAL,44064,0,44064,175644,0,219708
190612701700000,SW 457,RESIDENTIAL,48792,0,48792,189677,0,238469
190612701800000,SW 457,RESIDENTIAL,46512,0,46512,186988,0,233500
190612800100000,SW 457,RESIDENTIAL,39060,0,39060,184758,0,223818
190612800200000,SW 457,RESIDENTIAL,47880,0,47880,165020,0,212900
190612800300000,SW 457,RESIDENTIAL,39060,0,39060,177010,0,216070
190612800400000,SW 457,RESIDENTIAL,58590,0,58590,159112,0,217702
190612800500000,SW 457,RESIDENTIAL,42840,0,42840,164519,0,207359
190612900100000,SW 457,RESIDENTIAL,254,0,254,0,0,254
190612900200000,SW 457,RESIDENTIAL,293,0,293,0,0,293
190612900300000,SW 457,RESIDENTIAL,48000,0,48000,175584,0,223584
190612900400000,SW 457,RESIDENTIAL,42600,0,42600,167440,0,210040
190612900500000,SW 457,RESIDENTIAL,290,0,290,0,0,290
190612900600000,SW 457,RESIDENTIAL,28800,0,28800,183048,0,211848
190612900700000,SW 457,RESIDENTIAL,48800,0,48800,181001,0,229801
190612900800000,SW 420,AG LAND,13519,0,13519,0,0,13519
190615100100000,SW 455,RESIDENTIAL,86700,0,86700,80813,0,167513
190615100200000,SW 455,RESIDENTIAL,69350,0,69350,0,0,69350
190615100300000,SW 455,RESIDENTIAL,77900,0,77900,88173,0,166073
190615100400000,SW 455,RESIDENTIAL,76500,0,76500,74136,0,150636
190615100500000,SW 455,RESIDENTIAL,78750,0,78750,101853,0,180603
190615100600000,SW 455,RESIDENTIAL,78750,0,78750,90756,0,169506
190615100700000,SW 455,RESIDENTIAL,77750,0,77750,3506,0,81256
190615100800000,SW 455,RESIDENTIAL,66800,0,66800,147510,0,214310
190617600100000,SW 432,RESIDENTIAL,33050,0,33050,0,0,33050
190617600400000,SW 461,RESIDENTIAL,33074,0,33074,145748,0,178822
190617600500000,SW 461,RESIDENTIAL,35040,0,35040,154734,0,189774
190617600600000,SW 461,RESIDENTIAL,35040,0,35040,146336,0,181376
190617600700000,SW 461,RESIDENTIAL,35040,0,35040,130943,0,165983
190617600800000,SW 461,RESIDENTIAL,35040,0,35040,142987,0,178027
190617600900000,SW 461,RESIDENTIAL,35040,0,35040,146763,0,181803
190617601000000,SW 461,RESIDENTIAL,35040,0,35040,137245,0,172285
190617601100000,SW 461,RESIDENTIAL,35040,0,35040,144149,0,179189
190617601200000,SW 461,RESIDENTIAL,35040,0,35040,142355,0,177395
190617601300000,SW 461,RESIDENTIAL,35040,0,35040,148768,0,183808
190617601400000,SW 461,RESIDENTIAL,35040,0,35040,142471,0,177511
190617601500000,SW 461,RESIDENTIAL,35040,0,35040,137805,0,172845
190617601600000,SW 461,RESIDENTIAL,35112,0,35112,137917,0,173029
190617601700000,SW 461,RESIDENTIAL,38569,0,38569,128529,0,167098
190617601800000,SW 461,RESIDENTIAL,45375,0,45375,162239,0,207614
190617601900000,SW 461,RESIDENTIAL,38569,0,38569,176418,0,214987
190617602000000,SW 461,RESIDENTIAL,38624,0,38624,163717,0,202341
190617602100000,SW 461,RESIDENTIAL,39135,0,39135,171290,0,210425
190617602200000,SW 461,RESIDENTIAL,39055,0,39055,160939,0,199994
190617602300000,SW 461,RESIDENTIAL,39055,0,39055,158637,0,197692
190617602400000,SW 461,RESIDENTIAL,39055,0,39055,163275,0,202330
190617602500000,SW 461,RESIDENTIAL,39055,0,39055,161695,0,200750
190617602600000,SW 461,RESIDENTIAL,39055,0,39055,200467,0,239522
190617602700000,SW 461,RESIDENTIAL,39055,0,39055,158069,0,197124
190617602800000,SW 461,RESIDENTIAL,39055,0,39055,159051,0,198106
190617602900000,SW 461,RESIDENTIAL,39055,0,39055,143976,0,183031
190617603000000,SW 461,RESIDENTIAL,39055,0,39055,176148,0,215203
190617603100000,SW 461,RESIDENTIAL,39055,0,39055,142122,0,181177
190617603200000,SW 461,RESIDENTIAL,33705,0,33705,171533,0,205238
190617603300000,SW 461,RESIDENTIAL,39778,0,39778,182162,0,221940
190617603400000,SW 432,RESIDENTIAL,1520,0,1520,0,0,1520
190617700100000,SW 461,RESIDENTIAL,31616,0,31616,155675,0,187291
190617700200000,SW 461,RESIDENTIAL,36000,0,36000,184249,0,220249
190617700300000,SW 461,RESIDENTIAL,35040,0,35040,129367,0,164407
190617700400000,SW 461,RESIDENTIAL,35040,0,35040,138355,0,173395
190617700500000,SW 461,RESIDENTIAL,35568,0,35568,151391,0,186959
190617700600000,SW 455,AG DWELLING,24807,0,24807,55626,15269,95702
190617700700000,SW 461,RESIDENTIAL,32640,0,32640,131437,0,164077
190617700800000,SW 461,RESIDENTIAL,35040,0,35040,139932,0,174972
190617700900000,SW 461,RESIDENTIAL,35040,0,35040,138100,0,173140
190617701000000,SW 461,RESIDENTIAL,35040,0,35040,139256,0,174296
190617701100000,SW 461,RESIDENTIAL,35040,0,35040,147451,0,182491
190617701200000,SW 461,RESIDENTIAL,35040,0,35040,137433,0,172473
190617701300000,SW 461,RESIDENTIAL,35040,0,35040,141889,0,176929
190617701400000,SW 461,RESIDENTIAL,35113,0,35113,150212,0,185325
190617800200000,SW 461,RESIDENTIAL,78670,0,78670,206215,0,284885
190617800400000,SW 461,RESIDENTIAL,44530,0,44530,185125,0,229655
190617800500000,SW 461,RESIDENTIAL,44530,0,44530,168714,0,213244
190617800600000,SW 461,RESIDENTIAL,44530,0,44530,201773,0,246303
190617800700000,SW 461,RESIDENTIAL,44530,0,44530,179019,0,223549
190617800800000,SW 461,RESIDENTIAL,44530,0,44530,166677,0,211207
190617800900000,SW 461,RESIDENTIAL,44530,0,44530,159928,0,204458
190617801000000,SW 461,RESIDENTIAL,44895,0,44895,185423,0,230318
190617801100000,SW 461,RESIDENTIAL,44895,0,44895,162569,0,207464
190617801200000,SW 461,RESIDENTIAL,40590,0,40590,149828,0,190418
190617801300000,SW 461,RESIDENTIAL,45539,0,45539,166584,0,212123
190617801400000,SW 461,RESIDENTIAL,49912,0,49912,157214,0,207126
190617801500000,SW 461,RESIDENTIAL,43452,0,43452,166032,0,209484
190617801600000,SW 461,RESIDENTIAL,38556,0,38556,151918,0,190474
190620100200000,SW 421,RESIDENTIAL,27409,0,27409,107767,0,135176
190620100300000,SW 421,RESIDENTIAL,24480,0,24480,101276,0,125756
190620100400000,SW 421,RESIDENTIAL,22674,0,22674,95439,0,118113
190620100500000,SW 421,RESIDENTIAL,22674,0,22674,96935,0,119609
190620100600000,SW 421,RESIDENTIAL,22674,0,22674,97159,0,119833
190620100700000,SW 421,RESIDENTIAL,22908,0,22908,93721,0,116629
190620100800000,SW 421,RESIDENTIAL,22908,0,22908,96880,0,119788
190620100900000,SW 421,RESIDENTIAL,22908,0,22908,93371,0,116279
190620101000000,SW 421,RESIDENTIAL,22908,0,22908,97730,0,120638
190620101100000,SW 421,RESIDENTIAL,22908,0,22908,94177,0,117085
190620101200000,SW 421,RESIDENTIAL,22908,0,22908,94282,0,117190
190620101300000,SW 421,RESIDENTIAL,23141,0,23141,86860,0,110001
190620101400000,SW 421,RESIDENTIAL,23141,0,23141,97425,0,120566
190620101500000,SW 421,RESIDENTIAL,23141,0,23141,87441,0,110582
190620101600000,SW 421,RESIDENTIAL,23141,0,23141,93943,0,117084
190620101700000,SW 421,RESIDENTIAL,25119,0,25119,104111,0,129230
190620101800000,SW 421,RESIDENTIAL,28109,0,28109,90238,0,118347
190620101900000,SW 421,RESIDENTIAL,25109,0,25109,98758,0,123867
190620102000000,SW 421,RESIDENTIAL,24310,0,24310,65074,0,89384
190620102100000,SW 421,RESIDENTIAL,24310,0,24310,89028,0,113338
190620102200000,SW 421,RESIDENTIAL,22100,0,22100,108187,0,130287
190620102300000,SW 421,RESIDENTIAL,26520,0,26520,102018,0,128538
190620102400000,SW 421,RESIDENTIAL,27100,0,27100,95305,0,122405
190620102500000,SW 421,RESIDENTIAL,25213,0,25213,95903,0,121116
190620102600000,SW 421,RESIDENTIAL,23375,0,23375,82617,0,105992
190620102700000,SW 421,RESIDENTIAL,23375,0,23375,84702,0,108077
190620102800000,SW 421,RESIDENTIAL,23375,0,23375,103457,0,126832
190620102900000,SW 421,RESIDENTIAL,23375,0,23375,89143,0,112518
190620103000000,SW 421,RESIDENTIAL,23375,0,23375,88827,0,112202
190620103100000,SW 421,RESIDENTIAL,23375,0,23375,99723,0,123098
190620103200000,SW 421,RESIDENTIAL,23375,0,23375,97349,0,120724
190620103300000,SW 421,RESIDENTIAL,23375,0,23375,90187,0,113562
190620103400000,SW 421,RESIDENTIAL,23375,0,23375,75606,0,98981
190620103500000,SW 421,RESIDENTIAL,23375,0,23375,94277,0,117652
190620103600000,SW 421,RESIDENTIAL,23375,0,23375,85005,0,108380
190620103700000,SW 421,RESIDENTIAL,25500,0,25500,96219,0,121719
190620103800000,SW 421,RESIDENTIAL,25500,0,25500,103337,0,128837
190620103900000,SW 421,RESIDENTIAL,24225,0,24225,90589,0,114814
190620104000000,SW 421,RESIDENTIAL,26958,0,26958,97942,0,124900
190620104100000,SW 421,RESIDENTIAL,26834,0,26834,93463,0,120297
190620104200000,SW 421,RESIDENTIAL,24225,0,24225,87361,0,111586
190620104300000,SW 421,RESIDENTIAL,24225,0,24225,94449,0,118674
190620104400000,SW 421,RESIDENTIAL,24225,0,24225,98704,0,122929
190620104500000,SW 421,RESIDENTIAL,23375,0,23375,84953,0,108328
190620104600000,SW 421,RESIDENTIAL,23375,0,23375,83193,0,106568
190620104700000,SW 421,RESIDENTIAL,23375,0,23375,81521,0,104896
190620104800000,SW 421,RESIDENTIAL,23375,0,23375,87737,0,111112
190620104900000,SW 421,RESIDENTIAL,23375,0,23375,89732,0,113107
190620105000000,SW 421,RESIDENTIAL,23375,0,23375,97958,0,121333
190620105100000,SW 421,RESIDENTIAL,23375,0,23375,105138,0,128513
190620105200000,SW 421,RESIDENTIAL,23375,0,23375,84894,0,108269
190620105300000,SW 421,RESIDENTIAL,23375,0,23375,97700,0,121075
190620105400000,SW 421,RESIDENTIAL,23375,0,23375,89590,0,112965
190620105500000,SW 421,RESIDENTIAL,23375,0,23375,97177,0,120552
190620105600000,SW 421,RESIDENTIAL,23375,0,23375,94126,0,117501
190620105700000,SW 421,RESIDENTIAL,23375,0,23375,88611,0,111986
190620105800000,SW 421,RESIDENTIAL,23375,0,23375,94240,0,117615
190620105900000,SW 421,RESIDENTIAL,23375,0,23375,93243,0,116618
190620106000000,SW 421,RESIDENTIAL,23375,0,23375,91275,0,114650
190620106100000,SW 421,RESIDENTIAL,25982,0,25982,112833,0,138815
190620106200000,SW 421,RESIDENTIAL,22732,0,22732,93797,0,116529
190620106300000,SW 421,RESIDENTIAL,21412,0,21412,95338,0,116750
190620106400000,SW 421,RESIDENTIAL,23028,0,23028,101589,0,124617
190620106500000,SW 421,RESIDENTIAL,26422,0,26422,106039,0,132461
190620106600000,SW 421,RESIDENTIAL,27472,0,27472,115240,0,142712
190620106700000,SW 421,RESIDENTIAL,28280,0,28280,103755,0,132035
190620106800000,SW 421,RESIDENTIAL,28280,0,28280,102110,0,130390
190620106900000,SW 421,RESIDENTIAL,28000,0,28000,93820,0,121820
190620107000000,SW 421,RESIDENTIAL,27093,0,27093,93630,0,120723
190620107100000,DAY CARE CENTER,EXEMPT,0,70470,70470,0,83127,153597
190620107200000,SW 457,RESIDENTIAL,7150,0,7150,0,0,7150
190620107300000,SW 457,RESIDENTIAL,45424,0,45424,190144,0,235568
190620107400000,SW 457,RESIDENTIAL,41976,0,41976,186864,0,228840
190620107500000,SW 457,RESIDENTIAL,42962,0,42962,168625,0,211587
190620107600000,SW 457,RESIDENTIAL,41134,0,41134,170390,0,211524
190620107700000,SW 457,RESIDENTIAL,38514,0,38514,186074,0,224588
190620107800000,SW 457,RESIDENTIAL,31973,0,31973,177802,0,209775
190620107900000,SW 457,RESIDENTIAL,41160,0,41160,165572,0,206732
190620108000000,SW 457,RESIDENTIAL,43155,0,43155,222408,0,265563
190620108100000,SW 457,RESIDENTIAL,43228,0,43228,153901,0,197129
190620108200000,SW 457,RESIDENTIAL,48838,0,48838,171439,0,220277
190620108300000,SW 457,RESIDENTIAL,45658,0,45658,159914,0,205572
190620108400000,SW 457,RESIDENTIAL,44289,0,44289,192897,0,237186
190620108500000,SW 457,RESIDENTIAL,46740,0,46740,203473,0,250213
190620108600000,SW 457,RESIDENTIAL,45786,0,45786,184837,0,230623
190620108700000,SW 457,RESIDENTIAL,44800,0,44800,139362,0,184162
190620108800000,SW 457,RESIDENTIAL,50675,0,50675,229794,0,280469
190620108900000,SW 457,RESIDENTIAL,48501,0,48501,203636,0,252137
190620109000000,SW 457,RESIDENTIAL,49254,0,49254,179946,0,229200
190620109100000,SW 457,RESIDENTIAL,49595,0,49595,157616,0,207211
190620109200000,SW 457,RESIDENTIAL,42420,0,42420,161393,0,203813
190620109300000,SW 457,RESIDENTIAL,46648,0,46648,169447,0,216095
190620109400000,SW 457,RESIDENTIAL,49936,0,49936,232302,0,282238
190620109500000,SW 457,RESIDENTIAL,44238,0,44238,197021,0,241259
190620109600000,SW 457,RESIDENTIAL,45540,0,45540,183939,0,229479
190620109700000,SW 457,RESIDENTIAL,51792,0,51792,194146,0,245938
190620200100000,SW 421,RESIDENTIAL,25161,0,25161,111515,0,136676
190620200200000,SW 421,RESIDENTIAL,26843,0,26843,98431,0,125274
190620200300000,SW 421,RESIDENTIAL,24225,0,24225,92418,0,116643
190620200400000,SW 421,RESIDENTIAL,24225,0,24225,82307,0,106532
190620200500000,SW 421,RESIDENTIAL,24225,0,24225,102221,0,126446
190620200600000,SW 421,RESIDENTIAL,25500,0,25500,82242,0,107742
190620200700000,SW 421,RESIDENTIAL,24225,0,24225,89904,0,114129
190620200800000,SW 421,RESIDENTIAL,24225,0,24225,99384,0,123609
190620200900000,SW 421,RESIDENTIAL,24225,0,24225,98314,0,122539
190620201000000,SW 421,RESIDENTIAL,25500,0,25500,66901,0,92401
190620201100000,SW 421,RESIDENTIAL,23375,0,23375,85773,0,109148
190620201200000,SW 421,RESIDENTIAL,23375,0,23375,84538,0,107913
190620201300000,SW 421,RESIDENTIAL,23375,0,23375,91889,0,115264
190620201400000,SW 421,RESIDENTIAL,23375,0,23375,90343,0,113718
190620201500000,SW 421,RESIDENTIAL,23375,0,23375,79428,0,102803
190620201600000,SW 421,RESIDENTIAL,25035,0,25035,81631,0,106666
190620201700000,SW 421,RESIDENTIAL,24782,0,24782,98820,0,123602
190620201800000,SW 421,RESIDENTIAL,23141,0,23141,95555,0,118696
190620201900000,SW 421,RESIDENTIAL,23141,0,23141,99330,0,122471
190620202000000,SW 421,RESIDENTIAL,23141,0,23141,89281,0,112422
190620202100000,SW 421,RESIDENTIAL,23141,0,23141,92559,0,115700
190620202200000,SW 421,RESIDENTIAL,23141,0,23141,84884,0,108025
190620202300000,SW 421,RESIDENTIAL,23983,0,23983,97539,0,121522
190620202400000,SW 421,RESIDENTIAL,23983,0,23983,97780,0,121763
190620202500000,SW 421,RESIDENTIAL,23983,0,23983,96722,0,120705
190620202600000,SW 421,RESIDENTIAL,23983,0,23983,97995,0,121978
190620202700000,SW 421,RESIDENTIAL,23983,0,23983,95516,0,119499
190620202800000,SW 421,RESIDENTIAL,25245,0,25245,99828,0,125073
190620202900000,SW 421,RESIDENTIAL,23983,0,23983,94155,0,118138
190620203000000,SW 421,RESIDENTIAL,23983,0,23983,103477,0,127460
190620300100000,CITY PROPERTY,EXEMPT,0,0,0,0,0,0
190620300200000,SW 457,RESIDENTIAL,45199,0,45199,198443,0,243642
190620300300000,SW 457,RESIDENTIAL,40219,0,40219,224891,0,265110
190620300400000,SW 457,RESIDENTIAL,41983,0,41983,208636,0,250619
190620300500000,SW 457,RESIDENTIAL,42336,0,42336,210314,0,252650
190620300600000,SW 457,RESIDENTIAL,41483,0,41483,260858,0,302341
190620300700000,SW 457,RESIDENTIAL,43737,0,43737,189009,0,232746
190620300800000,SW 457,RESIDENTIAL,43157,0,43157,163525,0,206682
190620300900000,SW 457,RESIDENTIAL,44006,0,44006,186499,0,230505
190620301000000,SW 457,RESIDENTIAL,47785,0,47785,185059,0,232844
190620301100000,SW 457,RESIDENTIAL,49795,0,49795,160006,0,209801
190620301200000,SW 457,RESIDENTIAL,45556,0,45556,161342,0,206898
190620301300000,SW 457,RESIDENTIAL,46904,0,46904,182563,0,229467
190620301400000,SW 457,RESIDENTIAL,42768,0,42768,186774,0,229542
190620301500000,SW 457,RESIDENTIAL,41958,0,41958,173042,0,215000
190620301600000,SW 457,RESIDENTIAL,39600,0,39600,182425,0,222025
190620301700000,SW 457,RESIDENTIAL,41580,0,41580,159659,0,201239
190620301800000,SW 457,RESIDENTIAL,40630,0,40630,162480,0,203110
190620301900000,SW 457,RESIDENTIAL,39204,0,39204,171588,0,210792
190620302000000,SW 457,RESIDENTIAL,41580,0,41580,180215,0,221795
190620302100000,SW 457,RESIDENTIAL,41580,0,41580,206485,0,248065
190620302200000,SW 457,RESIDENTIAL,42768,0,42768,233853,0,276621
190620302300000,SW 457,RESIDENTIAL,45754,0,45754,198321,0,244075
190620302400000,SW 457,RESIDENTIAL,39204,0,39204,163056,0,202260
190620302500000,SW 457,RESIDENTIAL,41580,0,41580,196063,0,237643
190620302600000,SW 457,RESIDENTIAL,41580,0,41580,174443,0,216023
190620302700000,SW 457,RESIDENTIAL,48906,0,48906,232349,0,281255
190620302800000,SW 457,RESIDENTIAL,50600,0,50600,200725,0,251325
190622600100000,SW 421,RESIDENTIAL,25380,0,25380,98561,0,123941
190622600200000,SW 421,RESIDENTIAL,23257,0,23257,84489,0,107746
190622600300000,SW 421,RESIDENTIAL,22184,0,22184,71550,0,93734
190622600400000,SW 421,RESIDENTIAL,22936,0,22936,93137,0,116073
190622600500000,SW 421,RESIDENTIAL,22560,0,22560,87217,0,109777
190622600600000,SW 421,RESIDENTIAL,22560,0,22560,91575,0,114135
190622600700000,SW 421,RESIDENTIAL,23876,0,23876,103678,0,127554
190622600800000,SW 421,RESIDENTIAL,23876,0,23876,84502,0,108378
190622600900000,SW 421,RESIDENTIAL,22560,0,22560,95272,0,117832
190622601000000,SW 421,RESIDENTIAL,22560,0,22560,104687,0,127247
190622601100000,SW 421,RESIDENTIAL,22560,0,22560,90514,0,113074
190622601200000,SW 421,RESIDENTIAL,22560,0,22560,99408,0,121968
190622601300000,SW 421,RESIDENTIAL,23876,0,23876,100166,0,124042
190622601400000,SW 421,RESIDENTIAL,23876,0,23876,88339,0,112215
190622601500000,SW 421,RESIDENTIAL,22560,0,22560,104300,0,126860
190622601600000,SW 421,RESIDENTIAL,22560,0,22560,84842,0,107402
190622601700000,SW 421,RESIDENTIAL,22560,0,22560,102972,0,125532
190622601800000,SW 421,RESIDENTIAL,25568,0,25568,99637,0,125205
190622601900000,SW 421,RESIDENTIAL,27166,0,27166,86392,0,113558
190622602000000,SW 421,RESIDENTIAL,23970,0,23970,106359,0,130329
190622602100000,SW 421,RESIDENTIAL,23970,0,23970,78183,0,102153
190622602200000,SW 421,RESIDENTIAL,23970,0,23970,85504,0,109474
190622602300000,SW 421,RESIDENTIAL,25368,0,25368,82344,0,107712
190622602400000,SW 421,RESIDENTIAL,25368,0,25368,95093,0,120461
190622602500000,SW 421,RESIDENTIAL,23970,0,23970,84144,0,108114
190622602600000,SW 421,RESIDENTIAL,23970,0,23970,89277,0,113247
190622602700000,SW 421,RESIDENTIAL,23970,0,23970,87572,0,111542
190622602800000,SW 421,RESIDENTIAL,23970,0,23970,93731,0,117701
190622602900000,SW 421,RESIDENTIAL,25368,0,25368,85226,0,110594
190622603000000,SW 421,RESIDENTIAL,25368,0,25368,76751,0,102119
190622603100000,SW 421,RESIDENTIAL,23970,0,23970,92728,0,116698
190622603200000,SW 421,RESIDENTIAL,23970,0,23970,84571,0,108541
190622603300000,SW 421,RESIDENTIAL,23970,0,23970,90227,0,114197
190622603400000,SW 421,RESIDENTIAL,23970,0,23970,81764,0,105734
190622603500000,SW 421,RESIDENTIAL,26122,0,26122,102054,0,128176
190622603600000,SW 421,RESIDENTIAL,26967,0,26967,97635,0,124602
190622700100000,SW 421,RESIDENTIAL,19907,0,19907,95576,0,115483
190622700200000,SW 421,RESIDENTIAL,19907,0,19907,93384,0,113291
190622700300000,SW 421,RESIDENTIAL,25542,0,25542,85853,0,111395
190622700400000,SW 421,RESIDENTIAL,23520,0,23520,72104,0,95624
190622700500000,SW 421,RESIDENTIAL,23520,0,23520,72371,0,95891
190622700600000,SW 421,RESIDENTIAL,23520,0,23520,78328,0,101848
190622700700000,SW 421,RESIDENTIAL,23086,0,23086,71269,0,94355
190622700800000,SW 421,RESIDENTIAL,22848,0,22848,90130,0,112978
190622700900000,SW 421,RESIDENTIAL,22848,0,22848,75373,0,98221
190622701000000,SW 421,RESIDENTIAL,22610,0,22610,99714,0,122324
190622701100000,SW 421,RESIDENTIAL,22610,0,22610,91683,0,114293
190622701200000,SW 421,RESIDENTIAL,26320,0,26320,83363,0,109683
190622800100000,SW 421,RESIDENTIAL,26967,0,26967,103604,0,130571
190622800200000,SW 421,RESIDENTIAL,27359,0,27359,85223,0,112582
190622800300000,SW 421,RESIDENTIAL,23970,0,23970,92203,0,116173
190622800400000,SW 421,RESIDENTIAL,23970,0,23970,91688,0,115658
190622800500000,SW 421,RESIDENTIAL,23970,0,23970,100463,0,124433
190622800600000,SW 421,RESIDENTIAL,23970,0,23970,98055,0,122025
190622800700000,SW 421,RESIDENTIAL,25368,0,25368,91548,0,116916
190622800800000,SW 421,RESIDENTIAL,25368,0,25368,81164,0,106532
190622800900000,SW 421,RESIDENTIAL,23970,0,23970,90829,0,114799
190622801000000,SW 421,RESIDENTIAL,23970,0,23970,91814,0,115784
190622801100000,SW 421,RESIDENTIAL,23970,0,23970,90002,0,113972
190622801200000,SW 421,RESIDENTIAL,23970,0,23970,95930,0,119900
190622801300000,SW 421,RESIDENTIAL,25368,0,25368,99199,0,124567
190622801400000,SW 421,RESIDENTIAL,25368,0,25368,89267,0,114635
190622801500000,SW 421,RESIDENTIAL,23970,0,23970,92283,0,116253
190622801600000,SW 421,RESIDENTIAL,23970,0,23970,87232,0,111202
190622801700000,SW 421,RESIDENTIAL,23970,0,23970,102040,0,126010
190622801800000,SW 421,RESIDENTIAL,25808,0,25808,98127,0,123935
190622801900000,SW 421,RESIDENTIAL,25808,0,25808,92066,0,117874
190622802000000,SW 421,RESIDENTIAL,23970,0,23970,100915,0,124885
190622802100000,SW 421,RESIDENTIAL,23970,0,23970,86132,0,110102
190622802200000,SW 421,RESIDENTIAL,23970,0,23970,88471,0,112441
190622802300000,SW 421,RESIDENTIAL,25368,0,25368,96274,0,121642
190622802400000,SW 421,RESIDENTIAL,25368,0,25368,86196,0,111564
190622802500000,SW 421,RESIDENTIAL,23970,0,23970,94353,0,118323
190622802600000,SW 421,RESIDENTIAL,23970,0,23970,99169,0,123139
190622802700000,SW 421,RESIDENTIAL,23970,0,23970,86658,0,110628
190622802800000,SW 421,RESIDENTIAL,23970,0,23970,106230,0,130200
190622802900000,SW 421,RESIDENTIAL,25368,0,25368,92893,0,118261
190622803000000,SW 421,RESIDENTIAL,25368,0,25368,91168,0,116536
190622803100000,SW 421,RESIDENTIAL,23970,0,23970,102197,0,126167
190622803200000,SW 421,RESIDENTIAL,23970,0,23970,95118,0,119088
190622803300000,SW 421,RESIDENTIAL,23970,0,23970,92760,0,116730
190622803400000,SW 421,RESIDENTIAL,23970,0,23970,89780,0,113750
190622803500000,SW 421,RESIDENTIAL,28771,0,28771,75021,0,103792
190622803600000,SW 421,RESIDENTIAL,26967,0,26967,86834,0,113801
190622900100000,SW 421,RESIDENTIAL,26010,0,26010,99241,0,125251
190622900200000,SW 421,RESIDENTIAL,24735,0,24735,95408,0,120143
190622900300000,SW 421,RESIDENTIAL,25456,0,25456,81929,0,107385
190622900400000,SW 421,RESIDENTIAL,25003,0,25003,96224,0,121227
190622900500000,SW 421,RESIDENTIAL,23970,0,23970,85529,0,109499
190622900600000,SW 421,RESIDENTIAL,23970,0,23970,91927,0,115897
190622900700000,SW 421,RESIDENTIAL,23970,0,23970,94896,0,118866
190622900800000,SW 421,RESIDENTIAL,23970,0,23970,97448,0,121418
190622900900000,SW 421,RESIDENTIAL,23970,0,23970,88707,0,112677
190622901000000,SW 421,RESIDENTIAL,23970,0,23970,70667,0,94637
190622901100000,SW 421,RESIDENTIAL,23970,0,23970,90144,0,114114
190622901200000,SW 421,RESIDENTIAL,23970,0,23970,80814,0,104784
190622901300000,SW 421,RESIDENTIAL,23499,0,23499,89046,0,112545
190622901400000,SW 421,RESIDENTIAL,23588,0,23588,84652,0,108240
190622901500000,SW 421,RESIDENTIAL,23970,0,23970,84742,0,108712
190622901600000,SW 421,RESIDENTIAL,23970,0,23970,88843,0,112813
190622901700000,SW 421,RESIDENTIAL,23970,0,23970,86153,0,110123
190622901800000,SW 421,RESIDENTIAL,23970,0,23970,89055,0,113025
190622901900000,SW 421,RESIDENTIAL,23970,0,23970,100004,0,123974
190622902000000,SW 421,RESIDENTIAL,23970,0,23970,85044,0,109014
190622902100000,SW 421,RESIDENTIAL,23970,0,23970,83142,0,107112
190622902200000,SW 421,RESIDENTIAL,23970,0,23970,104774,0,128744
190622902300000,SW 421,RESIDENTIAL,24242,0,24242,79370,0,103612
190623000100000,SW 421,RESIDENTIAL,25456,0,25456,88485,0,113941
190623000200000,SW 421,RESIDENTIAL,24396,0,24396,86232,0,110628
190623000300000,SW 421,RESIDENTIAL,24735,0,24735,75779,0,100514
190623000400000,SW 421,RESIDENTIAL,24735,0,24735,88079,0,112814
190623000500000,SW 421,RESIDENTIAL,24735,0,24735,86128,0,110863
190623000600000,SW 421,RESIDENTIAL,23086,0,23086,98868,0,121954
190623000700000,SW 421,RESIDENTIAL,23086,0,23086,89303,0,112389
190623000800000,SW 421,RESIDENTIAL,23086,0,23086,95399,0,118485
190623000900000,SW 421,RESIDENTIAL,23911,0,23911,100073,0,123984
190623001000000,SW 421,RESIDENTIAL,23911,0,23911,90084,0,113995
190623001100000,SW 421,RESIDENTIAL,23086,0,23086,83397,0,106483
190623001200000,SW 421,RESIDENTIAL,23086,0,23086,101335,0,124421
190623001300000,SW 421,RESIDENTIAL,23086,0,23086,87350,0,110436
190623001400000,SW 421,RESIDENTIAL,23086,0,23086,79452,0,102538
190623001500000,SW 421,RESIDENTIAL,25972,0,25972,100474,0,126446
190623001600000,SW 421,RESIDENTIAL,25972,0,25972,102082,0,128054
190623001700000,SW 421,RESIDENTIAL,23086,0,23086,94879,0,117965
190623001800000,SW 421,RESIDENTIAL,23086,0,23086,85420,0,108506
190623001900000,SW 421,RESIDENTIAL,23086,0,23086,92306,0,115392
190623002000000,SW 421,RESIDENTIAL,23086,0,23086,96357,0,119443
190623002100000,SW 421,RESIDENTIAL,23911,0,23911,87380,0,111291
190623002200000,SW 421,RESIDENTIAL,23911,0,23911,90843,0,114754
190623002300000,SW 421,RESIDENTIAL,23086,0,23086,86699,0,109785
190623002400000,SW 421,RESIDENTIAL,23086,0,23086,96391,0,119477
190623002500000,SW 421,RESIDENTIAL,23086,0,23086,99484,0,122570
190623002600000,SW 421,RESIDENTIAL,24735,0,24735,96499,0,121234
190623002700000,SW 421,RESIDENTIAL,24735,0,24735,85061,0,109796
190623002800000,SW 421,RESIDENTIAL,24735,0,24735,97842,0,122577
190623002900000,SW 421,RESIDENTIAL,25984,0,25984,89582,0,115566
190623003000000,SW 421,RESIDENTIAL,26796,0,26796,100351,0,127147
190623100100000,SW 421,RESIDENTIAL,25968,0,25968,101695,0,127663
190623100200000,SW 421,RESIDENTIAL,24343,0,24343,92206,0,116549
190623100300000,SW 421,RESIDENTIAL,23970,0,23970,86268,0,110238
190623100400000,SW 421,RESIDENTIAL,23970,0,23970,86545,0,110515
190623100500000,SW 421,RESIDENTIAL,23970,0,23970,93854,0,117824
190623100600000,SW 421,RESIDENTIAL,23970,0,23970,85575,0,109545
190623100700000,SW 421,RESIDENTIAL,23970,0,23970,105928,0,129898
190623100800000,SW 421,RESIDENTIAL,23970,0,23970,83590,0,107560
190623100900000,SW 421,RESIDENTIAL,23970,0,23970,85980,0,109950
190623101000000,SW 421,RESIDENTIAL,24396,0,24396,81513,0,105909
190623101100000,SW 421,RESIDENTIAL,24247,0,24247,92337,0,116584
190623101200000,SW 421,RESIDENTIAL,23970,0,23970,77897,0,101867
190623101300000,SW 421,RESIDENTIAL,23970,0,23970,80546,0,104516
190623101400000,SW 421,RESIDENTIAL,23970,0,23970,96673,0,120643
190623101500000,SW 421,RESIDENTIAL,23970,0,23970,100544,0,124514
190623101600000,SW 421,RESIDENTIAL,23970,0,23970,80312,0,104282
190623101700000,SW 421,RESIDENTIAL,23970,0,23970,100226,0,124196
190623101800000,SW 421,RESIDENTIAL,23970,0,23970,100970,0,124940
190623101900000,SW 421,RESIDENTIAL,24396,0,24396,93583,0,117979
190623102000000,SW 421,RESIDENTIAL,25968,0,25968,85784,0,111752
190623200100000,SW 421,RESIDENTIAL,25504,0,25504,92601,0,118105
190623200200000,SW 421,RESIDENTIAL,23970,0,23970,88073,0,112043
190623200300000,SW 421,RESIDENTIAL,23970,0,23970,89975,0,113945
190623200400000,SW 421,RESIDENTIAL,23970,0,23970,72581,0,96551
190623200500000,SW 421,RESIDENTIAL,22560,0,22560,88158,0,110718
190623200600000,SW 421,RESIDENTIAL,24671,0,24671,81487,0,106158
190623200700000,CHURCH,EXEMPT,0,56500,56500,0,325978,382478
190623200800000,SW 421,RESIDENTIAL,31392,0,31392,145503,0,176895
190623200900000,SW 421,RESIDENTIAL,28666,0,28666,98559,0,127225
190623201000000,SW 421,RESIDENTIAL,23970,0,23970,107238,0,131208
190623201100000,SW 421,RESIDENTIAL,24480,0,24480,106888,0,131368
190623201200000,SW 421,RESIDENTIAL,23735,0,23735,101817,0,125552
190623201300000,SW 421,RESIDENTIAL,25968,0,25968,107856,0,133824
190623201400000,SW 421,RESIDENTIAL,25968,0,25968,91337,0,117305
190623201500000,SW 421,RESIDENTIAL,25968,0,25968,85600,0,111568
190623201600000,SW 421,RESIDENTIAL,24964,0,24964,96193,0,121157
190623300100000,SW 421,RESIDENTIAL,25968,0,25968,90100,0,116068
190623300200000,SW 421,RESIDENTIAL,24343,0,24343,85636,0,109979
190623300300000,SW 421,RESIDENTIAL,23970,0,23970,89649,0,113619
190623300400000,SW 421,RESIDENTIAL,23970,0,23970,91370,0,115340
190623300500000,SW 421,RESIDENTIAL,23970,0,23970,93421,0,117391
190623300600000,SW 421,RESIDENTIAL,23970,0,23970,89344,0,113314
190623300700000,SW 421,RESIDENTIAL,23970,0,23970,97710,0,121680
190623300800000,SW 421,RESIDENTIAL,23970,0,23970,92179,0,116149
190623300900000,SW 421,RESIDENTIAL,23970,0,23970,88879,0,112849
190623301000000,SW 421,RESIDENTIAL,24396,0,24396,102359,0,126755
190623301100000,SW 421,RESIDENTIAL,23043,0,23043,101360,0,124403
190623301200000,SW 421,RESIDENTIAL,22309,0,22309,98172,0,120481
190623301300000,SW 421,RESIDENTIAL,22320,0,22320,85475,0,107795
190623301400000,SW 421,RESIDENTIAL,22320,0,22320,87399,0,109719
190623301500000,SW 421,RESIDENTIAL,22320,0,22320,91986,0,114306
190623301600000,SW 421,RESIDENTIAL,22080,0,22080,85779,0,107859
190623301700000,SW 421,RESIDENTIAL,22080,0,22080,92283,0,114363
190623301800000,SW 421,RESIDENTIAL,21840,0,21840,104776,0,126616
190623301900000,SW 421,RESIDENTIAL,22095,0,22095,87956,0,110051
190623302000000,SW 421,RESIDENTIAL,23660,0,23660,97834,0,121494
190625100100000,SW 421,RESIDENTIAL,22944,0,22944,95079,0,118023
190625100200000,SW 421,RESIDENTIAL,22905,0,22905,104696,0,127601
190625100300000,SW 421,RESIDENTIAL,23307,0,23307,104697,0,128004
190625100400000,SW 421,RESIDENTIAL,23659,0,23659,102396,0,126055
190625100500000,SW 421,RESIDENTIAL,23712,0,23712,108832,0,132544
190625100600000,SW 421,RESIDENTIAL,24779,0,24779,99356,0,124135
190625100700000,SW 421,RESIDENTIAL,24420,0,24420,107406,0,131826
190625100800000,SW 421,RESIDENTIAL,23927,0,23927,100524,0,124451
190625100900000,SW 421,RESIDENTIAL,24448,0,24448,90045,0,114493
190625101000000,SW 421,RESIDENTIAL,24448,0,24448,104881,0,129329
190625101100000,SW 421,RESIDENTIAL,22784,0,22784,101078,0,123862
190625101200000,SW 421,RESIDENTIAL,23389,0,23389,97517,0,120906
190625101300000,SW 421,RESIDENTIAL,23232,0,23232,104426,0,127658
190625101400000,SW 421,RESIDENTIAL,22220,0,22220,94597,0,116817
190625101500000,SW 421,RESIDENTIAL,28340,0,28340,99246,0,127586
190625101600000,SW 421,RESIDENTIAL,26058,0,26058,98248,0,124306
190625101700000,SW 421,RESIDENTIAL,22219,0,22219,96190,0,118409
190625101800000,SW 421,RESIDENTIAL,21340,0,21340,89032,0,110372
190625101900000,SW 421,RESIDENTIAL,21340,0,21340,106830,0,128170
190625102000000,SW 421,RESIDENTIAL,24202,0,24202,100120,0,124322
190625102100000,SW 421,RESIDENTIAL,26500,0,26500,100473,0,126973
190625102200000,SW 421,RESIDENTIAL,24019,0,24019,93172,0,117191
190625102300000,SW 421,RESIDENTIAL,23552,0,23552,91479,0,115031
190625102400000,SW 421,RESIDENTIAL,23638,0,23638,94999,0,118637
190625102500000,SW 421,RESIDENTIAL,23522,0,23522,99561,0,123083
190625102600000,SW 421,RESIDENTIAL,23866,0,23866,96934,0,120800
190625102700000,SW 421,RESIDENTIAL,25129,0,25129,97074,0,122203
190625102800000,SW 421,RESIDENTIAL,23151,0,23151,104353,0,127504
190625102900000,SW 421,RESIDENTIAL,23688,0,23688,100438,0,124126
190625103000000,SW 421,RESIDENTIAL,25245,0,25245,104881,0,130126
190625103100000,SW 421,RESIDENTIAL,23573,0,23573,110863,0,134436
190625103200000,SW 421,RESIDENTIAL,24832,0,24832,106854,0,131686
190625103300000,SW 421,RESIDENTIAL,23040,0,23040,97544,0,120584
190625103400000,SW 421,RESIDENTIAL,24624,0,24624,97581,0,122205
190625103500000,SW 421,RESIDENTIAL,23433,0,23433,82984,0,106417
190625103600000,SW 421,RESIDENTIAL,22980,0,22980,96782,0,119762
190625103700000,SW 421,RESIDENTIAL,23808,0,23808,108136,0,131944
190625103800000,SW 421,RESIDENTIAL,23760,0,23760,100876,0,124636
190625103900000,SW 421,RESIDENTIAL,23796,0,23796,103625,0,127421
190625104000000,SW 421,RESIDENTIAL,23981,0,23981,99669,0,123650
190625104100000,SW 429,RESIDENTIAL,29756,0,29756,141481,0,171237
190625104200000,SW 429,RESIDENTIAL,30900,0,30900,104876,0,135776
190625104300000,SW 429,RESIDENTIAL,30900,0,30900,124179,0,155079
190625104400000,SW 429,RESIDENTIAL,30900,0,30900,123593,0,154493
190625105500000,SW 429,RESIDENTIAL,30900,0,30900,131885,0,162785
190625105600000,SW 429,RESIDENTIAL,30900,0,30900,140136,0,171036
190625105700000,SW 429,RESIDENTIAL,30900,0,30900,126507,0,157407
190625105800000,SW 429,RESIDENTIAL,30600,0,30600,119581,0,150181
190625105900000,SW 429,RESIDENTIAL,30600,0,30600,117344,0,147944
190625106000000,SW 429,RESIDENTIAL,31791,0,31791,149183,0,180974
190625106100000,SW 429,RESIDENTIAL,44350,0,44350,137085,0,181435
190625106300000,SW 429,RESIDENTIAL,35139,0,35139,140285,0,175424
190625106400000,SW 429,RESIDENTIAL,36932,0,36932,136117,0,173049
190625106500000,SW 429,RESIDENTIAL,41253,0,41253,137651,0,178904
190625106600000,SW 429,RESIDENTIAL,35804,0,35804,142027,0,177831
190625106700000,SW 429,RESIDENTIAL,32512,0,32512,126859,0,159371
190625106800000,SW 429,RESIDENTIAL,34425,0,34425,142901,0,177326
190625106900000,SW 429,RESIDENTIAL,36155,0,36155,126873,0,163028
190625107000000,SW 429,RESIDENTIAL,35212,0,35212,142552,0,177764
190625107100000,SW 429,RESIDENTIAL,34303,0,34303,130064,0,164367
190625107200000,SW 429,RESIDENTIAL,35980,0,35980,152015,0,187995
190625107300000,SW 429,RESIDENTIAL,35070,0,35070,114534,0,149604
190625107400000,SW 429,RESIDENTIAL,34087,0,34087,145816,0,179903
190625200100000,SW 421,RESIDENTIAL,25409,0,25409,88195,0,113604
190625200200000,SW 421,RESIDENTIAL,23389,0,23389,98335,0,121724
190625200300000,SW 421,RESIDENTIAL,24225,0,24225,104812,0,129037
190625200400000,SW 421,RESIDENTIAL,23628,0,23628,97722,0,121350
190625200500000,SW 421,RESIDENTIAL,23575,0,23575,91794,0,115369
190625200600000,SW 421,RESIDENTIAL,23951,0,23951,114676,0,138627
190625200700000,SW 421,RESIDENTIAL,23684,0,23684,107881,0,131565
190625200800000,SW 421,RESIDENTIAL,23520,0,23520,109223,0,132743
190625200900000,SW 421,RESIDENTIAL,25568,0,25568,92386,0,117954
190625201000000,SW 421,RESIDENTIAL,23944,0,23944,95545,0,119489
190625201100000,SW 421,RESIDENTIAL,25568,0,25568,107311,0,132879
190625201200000,SW 421,RESIDENTIAL,24328,0,24328,99817,0,124145
190625201300000,SW 421,RESIDENTIAL,24133,0,24133,99957,0,124090
190625201400000,SW 421,RESIDENTIAL,24093,0,24093,107231,0,131324
190625201500000,SW 421,RESIDENTIAL,24093,0,24093,111295,0,135388
190625201600000,SW 421,RESIDENTIAL,24093,0,24093,106922,0,131015
190625201700000,SW 421,RESIDENTIAL,24827,0,24827,94440,0,119267
190625300100000,SW 429,RESIDENTIAL,30524,0,30524,133870,0,164394
190625300200000,SW 429,RESIDENTIAL,24725,0,24725,124388,0,149113
190625300300000,SW 429,RESIDENTIAL,24970,0,24970,107696,0,132666
190625300400000,SW 429,RESIDENTIAL,26538,0,26538,136416,0,162954
190625301400000,SW 429,RESIDENTIAL,30900,0,30900,126034,0,156934
190625301500000,SW 429,RESIDENTIAL,30900,0,30900,122826,0,153726
190625301600000,SW 429,RESIDENTIAL,30900,0,30900,112836,0,143736
190625301700000,SW 429,RESIDENTIAL,30900,0,30900,116527,0,147427
190625301800000,SW 429,RESIDENTIAL,32843,0,32843,139786,0,172629
190625301900000,SW 429,RESIDENTIAL,30900,0,30900,133506,0,164406
190625302000000,SW 429,RESIDENTIAL,30900,0,30900,139533,0,170433
190625302100000,SW 429,RESIDENTIAL,30900,0,30900,123348,0,154248
190625302200000,SW 429,RESIDENTIAL,30900,0,30900,129943,0,160843
190625302300000,SW 429,RESIDENTIAL,33635,0,33635,120908,0,154543
190625302400000,SW 429,RESIDENTIAL,30900,0,30900,128882,0,159782
190625302500000,SW 429,RESIDENTIAL,33640,0,33640,109263,0,142903
190625302600000,SW 429,RESIDENTIAL,30900,0,30900,138309,0,169209
190625302700000,SW 429,RESIDENTIAL,30900,0,30900,117993,0,148893
190625302800000,SW 429,RESIDENTIAL,30900,0,30900,136486,0,167386
190625302900000,SW 429,RESIDENTIAL,30900,0,30900,134508,0,165408
190625303000000,SW 429,RESIDENTIAL,30900,0,30900,135144,0,166044
190625303100000,SW 429,RESIDENTIAL,30900,0,30900,150506,0,181406
190625303200000,SW 429,RESIDENTIAL,30900,0,30900,127006,0,157906
190625304500000,SW 429,RESIDENTIAL,30900,0,30900,137534,0,168434
190625304600000,SW 429,RESIDENTIAL,30900,0,30900,135445,0,166345
190625304700000,SW 429,RESIDENTIAL,30900,0,30900,130468,0,161368
190625304800000,SW 429,RESIDENTIAL,30900,0,30900,162847,0,193747
190625304900000,SW 429,RESIDENTIAL,30900,0,30900,124713,0,155613
190625305000000,SW 429,RESIDENTIAL,33758,0,33758,132303,0,166061
190625305100000,SW 429,RESIDENTIAL,33753,0,33753,127139,0,160892
190625305200000,SW 429,RESIDENTIAL,30900,0,30900,147779,0,178679
190625305300000,SW 429,RESIDENTIAL,30900,0,30900,128610,0,159510
190625305400000,SW 429,RESIDENTIAL,30900,0,30900,137549,0,168449
190625400100000,SW 429,RESIDENTIAL,24763,0,24763,118476,0,143239
190625400200000,SW 421,RESIDENTIAL,36166,0,36166,94926,0,131092
190625400300000,SECTION 42,COMMERCIAL,0,282000,282000,0,1554724,1836724
190625400400000,VACANT LAND,COMMERCIAL,0,310000,310000,0,0,310000
190625400500000,CONVENIENCE STORE,COMMERCIAL,0,348840,348840,0,499903,848743
190625400600000,OFFICE,COMMERCIAL,0,114600,114600,0,374411,489011
190627600100000,SW 455,RESIDENTIAL,66550,0,66550,101282,0,167832
190627600200000,SW 455,RESIDENTIAL,66550,0,66550,57086,0,123636
190627600300000,SW 455,RESIDENTIAL,35640,0,35640,107529,0,143169
190627600400000,SW 455,RESIDENTIAL,46900,0,46900,88376,0,135276
190627600500000,SW 455,RESIDENTIAL,46350,0,46350,44262,0,90612
190627600600000,SW 421,RESIDENTIAL,25380,0,25380,47753,0,73133
190627600900000,SW 421,RESIDENTIAL,45747,0,45747,169577,0,215324
190627601000000,SW 421,RESIDENTIAL,40680,0,40680,99633,0,140313
190627601100000,SW 418,AG DWELLING,9421,0,9421,85380,9855,104656
190627601200000,SW 455,RESIDENTIAL,73450,0,73450,232084,0,305534
190627601300000,SW 455,RESIDENTIAL,60000,0,60000,113045,0,173045
190627601400000,SW 455,RESIDENTIAL,73500,0,73500,164033,0,237533
190627601500000,SW 429,RESIDENTIAL,76200,0,76200,104683,0,180883
190627601600000,SW 429,RESIDENTIAL,42000,0,42000,142518,0,184518
190627601700000,SW 429,RESIDENTIAL,46500,0,46500,237349,0,283849
190627601800000,CITY PROPERTY,EXEMPT,0,0,0,0,0,0
190627601900000,SW 429,RESIDENTIAL,38150,0,38150,159200,0,197350
190627602000000,SW 429,RESIDENTIAL,41965,0,41965,181966,0,223931
190627602100000,SW 429,RESIDENTIAL,41965,0,41965,226634,0,268599
190627602200000,SW 429,RESIDENTIAL,46500,0,46500,216650,0,263150
190627602300000,SW 429,RESIDENTIAL,46500,0,46500,241205,0,287705
190627602400000,SW 429,RESIDENTIAL,46500,0,46500,249787,0,296287
190627602500000,SW 429,RESIDENTIAL,42238,0,42238,261310,0,303548
190627602600000,SW 429,RESIDENTIAL,42238,0,42238,214069,0,256307
190627602700000,SW 429,RESIDENTIAL,41850,0,41850,276186,0,318036
190627602800000,CITY PROPERTY,EXEMPT,0,0,0,0,0,0
190627602900000,SW 429,RESIDENTIAL,40600,0,40600,227931,0,268531
190627603000000,SW 429,RESIDENTIAL,71928,0,71928,244428,0,316356
190627700100000,SW 429,RESIDENTIAL,47385,0,47385,194817,0,242202
190627700200000,SW 429,RESIDENTIAL,44923,0,44923,154880,0,199803
190627700300000,SW 429,RESIDENTIAL,44923,0,44923,215639,0,260562
190627700400000,SW 429,RESIDENTIAL,44923,0,44923,218221,0,263144
190627700500000,SW 429,RESIDENTIAL,44923,0,44923,213267,0,258190
190627700600000,SW 429,RESIDENTIAL,44923,0,44923,236961,0,281884
190627700700000,SW 429,RESIDENTIAL,44923,0,44923,163340,0,208263
190627700800000,SW 429,RESIDENTIAL,175,0,175,0,0,175
190627700900000,CITY PROPERTY,EXEMPT,0,0,0,0,0,0
190627800100000,SW 429,RESIDENTIAL,160,0,160,0,0,160
190627800200000,SW 429,RESIDENTIAL,40365,0,40365,154934,0,195299
190627800300000,SW 429,RESIDENTIAL,149,0,149,0,0,149
190627800600000,SW 429,RESIDENTIAL,242,0,242,0,0,242
190627800700000,SW 429,RESIDENTIAL,69793,0,69793,285858,0,355651
190630100100000,SW 455,RESIDENTIAL,43820,0,43820,106091,0,149911
190630100400000,SW 455,RESIDENTIAL,79350,0,79350,209410,0,288760
190630100500000,SW 455,RESIDENTIAL,72450,0,72450,225070,0,297520
190630100600000,SW 429,RESIDENTIAL,37022,0,37022,144203,0,181225
190630100700000,SW 429,RESIDENTIAL,34020,0,34020,135890,0,169910
190630100800000,SW 429,RESIDENTIAL,34020,0,34020,126313,0,160333
190630100900000,SW 429,RESIDENTIAL,34020,0,34020,136963,0,170983
190630101000000,SW 429,RESIDENTIAL,34020,0,34020,145567,0,179587
190630101100000,SW 429,RESIDENTIAL,34020,0,34020,135754,0,169774
190630101200000,SW 429,RESIDENTIAL,37057,0,37057,148228,0,185285
190630101300000,SW 429,RESIDENTIAL,37154,0,37154,141078,0,178232
190630101400000,SW 429,RESIDENTIAL,34020,0,34020,126522,0,160542
190630101500000,SW 429,RESIDENTIAL,34020,0,34020,142305,0,176325
190630101600000,SW 429,RESIDENTIAL,34020,0,34020,142163,0,176183
190630101700000,SW 429,RESIDENTIAL,34020,0,34020,139659,0,173679
190630101800000,SW 429,RESIDENTIAL,34020,0,34020,154061,0,188081
190630101900000,SW 429,RESIDENTIAL,36889,0,36889,125750,0,162639
190630200100000,CITY PROPERTY,EXEMPT,0,0,0,0,0,0
190630200200000,SW 429,RESIDENTIAL,33920,0,33920,131219,0,165139
190630200300000,SW 429,RESIDENTIAL,34872,0,34872,156269,0,191141
190630200400000,SW 429,RESIDENTIAL,34980,0,34980,130130,0,165110
190630200500000,SW 429,RESIDENTIAL,34980,0,34980,147376,0,182356
190630200600000,SW 429,RESIDENTIAL,34980,0,34980,146369,0,181349
190630200700000,SW 429,RESIDENTIAL,38808,0,38808,139796,0,178604
190630200800000,SW 429,RESIDENTIAL,34980,0,34980,139808,0,174788
190630300100000,SW 429,RESIDENTIAL,37763,0,37763,131455,0,169218
190630300200000,SW 429,RESIDENTIAL,34335,0,34335,142051,0,176386
190630300300000,SW 429,RESIDENTIAL,34020,0,34020,128978,0,162998
190630300400000,SW 429,RESIDENTIAL,34020,0,34020,136031,0,170051
190630300500000,SW 429,RESIDENTIAL,34020,0,34020,133569,0,167589
190630300600000,SW 429,RESIDENTIAL,34020,0,34020,140774,0,174794
190630300700000,SW 429,RESIDENTIAL,36709,0,36709,133271,0,169980
190630400100000,SW 429,RESIDENTIAL,38549,0,38549,221286,0,259835
190630400200000,SW 429,RESIDENTIAL,33480,0,33480,147424,0,180904
190630400300000,SW 429,RESIDENTIAL,33480,0,33480,156520,0,190000
190630400400000,SW 429,RESIDENTIAL,33480,0,33480,130352,0,163832
190630400500000,SW 429,RESIDENTIAL,33480,0,33480,119970,0,153450
190630400600000,SW 429,RESIDENTIAL,33480,0,33480,145177,0,178657
190630400700000,SW 429,RESIDENTIAL,33480,0,33480,121414,0,154894
190630400800000,SW 429,RESIDENTIAL,33480,0,33480,153857,0,187337
190630400900000,SW 429,RESIDENTIAL,33480,0,33480,150864,0,184344
190630401000000,SW 429,RESIDENTIAL,34942,0,34942,157538,0,192480
190632600100000,SW 429,RESIDENTIAL,34743,0,34743,134473,0,169216
190632600200000,SW 429,RESIDENTIAL,34648,0,34648,129728,0,164376
190632600300000,SW 429,RESIDENTIAL,32130,0,32130,144383,0,176513
190632600400000,SW 429,RESIDENTIAL,32130,0,32130,132316,0,164446
190632600500000,SW 429,RESIDENTIAL,32130,0,32130,130689,0,162819
190632600600000,SW 429,RESIDENTIAL,32130,0,32130,135348,0,167478
190632600700000,SW 429,RESIDENTIAL,32130,0,32130,132814,0,164944
190632600800000,SW 429,RESIDENTIAL,34680,0,34680,141553,0,176233
190632600900000,SW 429,RESIDENTIAL,34680,0,34680,144111,0,178791
190632601000000,SW 429,RESIDENTIAL,32130,0,32130,127585,0,159715
190632601100000,SW 429,RESIDENTIAL,32130,0,32130,129914,0,162044
190632601200000,SW 429,RESIDENTIAL,32130,0,32130,143552,0,175682
190632601300000,SW 429,RESIDENTIAL,32130,0,32130,124583,0,156713
190632601400000,SW 429,RESIDENTIAL,32130,0,32130,141068,0,173198
190632700100000,SW 429,RESIDENTIAL,34559,0,34559,134009,0,168568
190632700200000,SW 429,RESIDENTIAL,34464,0,34464,142293,0,176757
190632700300000,SW 429,RESIDENTIAL,32130,0,32130,124957,0,157087
190632700400000,SW 429,RESIDENTIAL,32130,0,32130,130391,0,162521
190632700500000,SW 429,RESIDENTIAL,32130,0,32130,136084,0,168214
190632700600000,SW 429,RESIDENTIAL,32130,0,32130,153025,0,185155
190632700700000,SW 429,RESIDENTIAL,32130,0,32130,114552,0,146682
190632700800000,SW 429,RESIDENTIAL,34680,0,34680,150792,0,185472
190632700900000,SW 429,RESIDENTIAL,34680,0,34680,132465,0,167145
190632701000000,SW 429,RESIDENTIAL,32130,0,32130,129772,0,161902
190632701100000,SW 429,RESIDENTIAL,32130,0,32130,127239,0,159369
190632701200000,SW 429,RESIDENTIAL,32130,0,32130,124095,0,156225
190632701300000,SW 429,RESIDENTIAL,32130,0,32130,145740,0,177870
190632701400000,SW 429,RESIDENTIAL,32130,0,32130,129965,0,162095
190632800200000,OFFICE,COMMERCIAL,0,1253000,1253000,0,2806599,4059599
190632800300000,OFFICE,COMMERCIAL,0,477852,477852,0,697028,1174880
190632900100000,SW 429,RESIDENTIAL,38160,0,38160,118225,0,156385
190632900200000,SW 429,RESIDENTIAL,38160,0,38160,140258,0,178418
190632900300000,SW 429,RESIDENTIAL,33920,0,33920,138601,0,172521
190632900400000,SW 429,RESIDENTIAL,33920,0,33920,134025,0,167945
190632900500000,SW 429,RESIDENTIAL,33920,0,33920,148121,0,182041
190632900600000,SW 429,RESIDENTIAL,33920,0,33920,132048,0,165968
190632900700000,SW 429,RESIDENTIAL,33920,0,33920,128044,0,161964
190632900800000,SW 429,RESIDENTIAL,33920,0,33920,123016,0,156936
190632900900000,SW 429,RESIDENTIAL,34344,0,34344,145949,0,180293
190632901000000,SW 429,RESIDENTIAL,33920,0,33920,147958,0,181878
190633000100000,SW 429,RESIDENTIAL,37273,0,37273,151809,0,189082
190633000200000,SW 429,RESIDENTIAL,34335,0,34335,134650,0,168985
190633000300000,SW 429,RESIDENTIAL,34335,0,34335,148665,0,183000
190633000400000,SW 429,RESIDENTIAL,34335,0,34335,128818,0,163153
190633000500000,SW 429,RESIDENTIAL,34335,0,34335,129064,0,163399
190633000600000,SW 429,RESIDENTIAL,34335,0,34335,131300,0,165635
190633000700000,SW 429,RESIDENTIAL,37060,0,37060,141255,0,178315
190635100100000,WAREHOUSE,COMMERCIAL,0,578000,578000,0,2986151,3564151
190635100300000,VACANT LAND,COMMERCIAL,0,712200,712200,0,0,712200
190637600200000,WAREHOUSE,COMMERCIAL,0,239000,239000,0,254512,493512
190637600202000,ANTENNAS/TOWERS(BLL),COMMERCIAL,0,0,0,0,76955,76955
190637600300000,AUTO REPAIR/SALES,COMMERCIAL,0,652625,652625,0,1538744,2191369
190637600400000,VACANT LAND,COMMERCIAL,0,300100,300100,0,0,300100
190640100100000,SW 455,AG DWELLING,38332,0,38332,210490,1750,250572
190640100200000,CITY PROPERTY,EXEMPT,0,0,0,0,0,0
190640100300000,CENTRALLY ASSESSED,OTHER,0,0,0,0,0,0
190640200100000,SW 455,RESIDENTIAL,35200,0,35200,140459,0,175659
190642600200000,CITY PROPERTY,EXEMPT,0,0,0,0,0,0
190642600300000,SW 455,RESIDENTIAL,48576,0,48576,76773,0,125349
190642600400000,SW 455,RESIDENTIAL,35407,0,35407,48314,0,83721
190642600500000,SW 455,RESIDENTIAL,31444,0,31444,76510,0,107954
190642600600000,SW 455,RESIDENTIAL,63700,0,63700,930,0,64630
190645100100000,CITY PROPERTY,EXEMPT,0,0,0,0,0,0
190645200100000,CENTRALLY ASSESSED,INDUSTRIAL,0,6853,6853,0,0,6853
190647600100000,CITY PROPERTY,EXEMPT,0,0,0,0,0,0
190647600200000,CENTRALLY ASSESSED,OTHER,0,0,0,0,0,0
190647700100000,CENTRALLY ASSESSED,INDUSTRIAL,0,28318,28318,0,0,28318
190647700102000,BILLBOARD(BLL),COMMERCIAL,0,0,0,0,52363,52363
190710100100000,VACANT LAND,INDUSTRIAL,0,10951,10951,0,0,10951
190710200100000,CENTRALLY ASSESSED,OTHER,0,0,0,0,0,0
190710200102000,BILLBOARD(BLL),COMMERCIAL,0,0,0,0,35565,35565
190712600100000,CENTRALLY ASSESSED,OTHER,0,0,0,0,0,0
190712600200000,SW 418,AG LAND,46847,0,46847,0,0,46847
190715100100000,SW 418,AG LAND,54591,0,54591,0,0,54591
190720100100000,CENTRALLY ASSESSED,OTHER,0,0,0,0,0,0
190720200100000,CITY PROPERTY,EXEMPT,0,0,0,0,0,0
190720200200000,VACANT LAND,COMMERCIAL,0,160,160,0,0,160
190722600100000,VACANT LAND,COMMERCIAL,0,1534900,1534900,0,0,1534900
190722600200000,CITY PROPERTY,EXEMPT,0,0,0,0,0,0
190722700100000,CITY PROPERTY,EXEMPT,0,0,0,0,0,0
190722700200000,CENTRALLY ASSESSED,OTHER,0,0,0,0,0,0
190727600100000,SW 418,AG LAND,3988,0,3988,0,0,3988
190727700100000,WAREHOUSE,COMMERCIAL,0,233790,233790,0,54045,287835
190730100100000,VACANT LAND,COMMERCIAL,0,186850,186850,0,0,186850
190732600300000,SHOP,COMMERCIAL,0,151940,151940,0,16577,168517
190732600400000,SW 418,RESIDENTIAL,60000,0,60000,128584,0,188584
190735100100000,MATERIALS MFG;INDUST,INDUSTRIAL,0,856200,856200,0,284271,1140471
190735100200000,CENTRALLY ASSESSED,OTHER,0,0,0,0,0,0
190737600100000,VACANT LAND,COMMERCIAL,0,193500,193500,0,0,193500
190742600100000,SW 418,AG LAND,86539,0,86539,0,0,86539
190745100100000,VACANT LAND,AG LAND,124859,0,124859,0,0,124859
190747600100000,SW 418,AG LAND,31861,0,31861,0,0,31861
190810100100000,HOTEL,EXEMPT,0,1608908,1608908,0,2217829,3826737
190812600100000,MISCELLANEOUS,COMMERCIAL,0,48000,48000,0,66000,114000
190812700100000,SW 418,RESIDENTIAL,49250,0,49250,0,0,49250
190812700200000,SW 455,RESIDENTIAL,71250,0,71250,101840,0,173090
190812700300000,CITY PROPERTY,EXEMPT,0,0,0,0,0,0
190815100100000,EQUIPMENT MFG;INDUST,INDUSTRIAL,0,218160,218160,0,1236415,1454575
190820100100000,VACANT LAND,INDUSTRIAL,0,41893,41893,0,0,41893
190820200100000,CENTRALLY ASSESSED,OTHER,0,0,0,0,0,0
190820200200000,CENTRALLY ASSESSED,OTHER,0,0,0,0,0,0
190822600100000,VACANT LAND,INDUSTRIAL,0,13203,13203,0,0,13203
190822600102000,BILLBOARD(BLL),COMMERCIAL,0,0,0,0,14098,14098
190822700100000,CENTRALLY ASSESSED,OTHER,0,0,0,0,0,0
190825100100000,CENTRALLY ASSESSED,OTHER,0,0,0,0,0,0
190825200100000,METAL;INDUSTRIAL,INDUSTRIAL,0,2619114,2619114,0,7380886,10000000
190827600400000,FOOD GRADE;INDUST,INDUSTRIAL,0,1504386,1504386,0,30787402,32291788
190830100300000,SHOP,COMMERCIAL,0,251575,251575,0,463839,715414
190830100400000,FLAT PARKING,COMMERCIAL,0,151800,151800,0,23040,174840
190830100500000,CITY PROPERTY,EXEMPT,0,0,0,0,0,0
190830100600000,SHOP,COMMERCIAL,0,106000,106000,0,297345,403345
190830100700000,VACANT LAND,INDUSTRIAL,0,162000,162000,0,0,162000
190830100800000,WAREHOUSE,COMMERCIAL,0,77500,77500,0,247025,324525
190830100900000,OFFICE,COMMERCIAL,0,51653,51653,0,100034,151687
190830101000000,WAREHOUSE,COMMERCIAL,0,80900,80900,0,271966,352866
190830101100000,CITY PROPERTY,EXEMPT,0,0,0,0,0,0
190830101200000,MATERIALS MFG;INDUST,INDUSTRIAL,0,201420,201420,0,398955,600375
190830101300000,CENTRALLY ASSESSED,OTHER,0,0,0,0,0,0
190835100100000,SW 418,AG LAND,65701,0,65701,0,0,65701
190837600200000,WAREHOUSE,COMMERCIAL,0,341250,341250,0,816277,1157527
190837600300000,SHOP,COMMERCIAL,0,342225,342225,0,416036,758261
190837600400000,SHOP,COMMERCIAL,0,345360,345360,0,373787,719147
190837600500000,SHOP,COMMERCIAL,0,320000,320000,0,423123,743123
190840100100000,SHOP,INDUSTRIAL,0,193592,193592,0,430078,623670
190840100200000,VACANT LAND,INDUSTRIAL,0,10714,10714,0,0,10714
190840100300000,VACANT LAND,INDUSTRIAL,0,19500,19500,0,0,19500
190840100400000,SHOP,COMMERCIAL,0,72075,72075,0,251580,323655
190840100500000,FOOD GRADE;INDUST,INDUSTRIAL,0,242611,242611,0,327409,570020
190840100600000,VACANT LAND,COMMERCIAL,0,4375,4375,0,0,4375
190840100700000,SHOP,INDUSTRIAL,0,52042,52042,0,89815,141857
190840100800000,APARTMENT,EXEMPT,0,288630,288630,0,2734855,3023485
190840100900000,SHOP,INDUSTRIAL,0,240745,240745,0,1493576,1734321
190842600100000,VACANT LAND,INDUSTRIAL,0,43000,43000,0,0,43000
190842600200000,VACANT LAND,INDUSTRIAL,0,31279,31279,0,0,31279
190842700400000,FOOD GRADE;INDUST,INDUSTRIAL,0,475362,475362,0,4072653,4548015
190845100500000,SHOP,INDUSTRIAL,0,122148,122148,0,111084,233232
190845100600000,SHOP,INDUSTRIAL,0,93852,93852,0,378708,472560
190845100700000,CENTRALLY ASSESSED,OTHER,0,0,0,0,0,0
190845101000000,FOOD GRADE;INDUST,INDUSTRIAL,0,80190,80190,0,244715,324905
190845101800000,FOOD GRADE;INDUST,INDUSTRIAL,0,494802,494802,0,2274074,2768876
190845102000000,VACANT LAND,INDUSTRIAL,0,972,972,0,0,972
190845102100000,FOOD GRADE;INDUST,INDUSTRIAL,0,552312,552312,0,15944884,16497196
190847600200000,SHOP,COMMERCIAL,0,427453,427453,0,247275,674728
190847600300000,MATERIALS MFG;INDUST,INDUSTRIAL,0,205200,205200,0,505412,710612
190847600400000,WAREHOUSE,COMMERCIAL,0,144000,144000,0,524639,668639
190847600500000,SHOP,COMMERCIAL,0,83900,83900,0,175351,259251
190847600600000,SHOP,COMMERCIAL,0,83900,83900,0,150469,234369
190847600700000,WAREHOUSE,COMMERCIAL,0,40293,40293,0,99675,139968
190847600800000,WAREHOUSE,COMMERCIAL,0,40785,40785,0,80228,121013
190847600900000,VACANT LAND,COMMERCIAL,0,900,900,0,0,900
190847601000000,WAREHOUSE,INDUSTRIAL,0,165402,165402,0,679864,845266
190847601100000,VACANT LAND,COMMERCIAL,0,65000,65000,0,0,65000
190847601200000,WAREHOUSE,COMMERCIAL,0,187000,187000,0,199488,386488
190847601300000,WAREHOUSE,COMMERCIAL,0,83900,83900,0,246509,330409
190847601400000,WAREHOUSE,COMMERCIAL,0,83900,83900,0,91895,175795
190847601500000,SMALL RETAIL,COMMERCIAL,0,107250,107250,0,154212,261462
190847601600000,OFFICE,COMMERCIAL,0,211250,211250,0,514995,726245
190847601700000,AUTO REPAIR/SALES,COMMERCIAL,0,111875,111875,0,378009,489884
190847601800000,FLAT PARKING,COMMERCIAL,0,76625,76625,0,17069,93694
190847601900000,WAREHOUSE,COMMERCIAL,0,80625,80625,0,71681,152306
190847602000000,WAREHOUSE,COMMERCIAL,0,45474,45474,0,122759,168233
190847602100000,SHOP,COMMERCIAL,0,103600,103600,0,98588,202188
190847602200000,VACANT LAND,INDUSTRIAL,0,82818,82818,0,0,82818
190847602300000,VACANT LAND,INDUSTRIAL,0,22356,22356,0,0,22356
190910100100000,VACANT LAND,COMMERCIAL,0,881200,881200,0,0,881200
190910100200000,PRINTING,INDUSTRIAL,0,833857,833857,0,3737676,4571533
190912600100000,VACANT LAND,INDUSTRIAL,0,94122,94122,0,0,94122
190912600200000,COUNTY PROPERTY,EXEMPT,0,0,0,0,0,0
190912600400000,CENTRALLY ASSESSED,OTHER,0,0,0,0,0,0
190912600500000,VACANT LAND,COMMERCIAL,0,19300,19300,0,0,19300
190912600700000,BARS/LOUNGE,COMMERCIAL,0,56700,56700,0,97601,154301
190912600702000,BILLBOARD(BLL),COMMERCIAL,0,0,0,0,20405,20405
190912600800000,OFFICE,COMMERCIAL,0,54000,54000,0,81089,135089
190912600900000,OFFICE,COMMERCIAL,0,45900,45900,0,175600,221500
190912601000000,BARS/LOUNGE,COMMERCIAL,0,60120,60120,0,247715,307835
190912601100000,SW 422,RESIDENTIAL,28381,0,28381,124823,0,153204
190912601200000,SW 422,RESIDENTIAL,31535,0,31535,0,0,31535
190912601300000,SW 422,RESIDENTIAL,28381,0,28381,100821,0,129202
190912601400000,OFFICE,COMMERCIAL,0,40500,40500,0,297350,337850
190912601600000,SHOP,COMMERCIAL,0,191250,191250,0,283830,475080
190912601700000,WAREHOUSE,COMMERCIAL,0,110250,110250,0,444086,554336
190912601900000,WAREHOUSE,COMMERCIAL,0,98100,98100,0,466724,564824
190912602000000,WAREHOUSE,COMMERCIAL,0,157400,157400,0,841754,999154
190912602100000,VACANT LAND,COMMERCIAL,0,55725,55725,0,0,55725
190912602200000,SHOP,COMMERCIAL,0,105600,105600,0,12072,117672
190912602300000,WAREHOUSE,COMMERCIAL,0,186000,186000,0,242616,428616
190912602400000,WAREHOUSE,COMMERCIAL,0,188850,188850,0,108570,297420
190912602500000,VACANT LAND,COMMERCIAL,0,55800,55800,0,0,55800
190915100100000,WAREHOUSE,COMMERCIAL,0,675000,675000,0,3169775,3844775
190915100200000,CENTRALLY ASSESSED,OTHER,0,0,0,0,0,0
190915100300000,VACANT LAND,COMMERCIAL,0,25680,25680,0,0,25680
190915200100000,WAREHOUSE,COMMERCIAL,0,485550,485550,0,695895,1181445
190915200200000,COUNTY PROPERTY,EXEMPT,0,0,0,0,0,0
190915200300000,SHOP,COMMERCIAL,0,81000,81000,0,219939,300939
190915200400000,SHOP,COMMERCIAL,0,352500,352500,0,496248,848748
190915200500000,WAREHOUSE,COMMERCIAL,0,203000,203000,0,1045241,1248241
190915200600000,SCHOOL,EXEMPT,0,196992,196992,0,1392969,1589961
190917600100000,EDUCATIONAL/COLLEGE,EXEMPT,0,0,0,0,0,0
190920100100000,WAREHOUSE,COMMERCIAL,0,72000,72000,0,117115,189115
190920100200000,SHOP,COMMERCIAL,0,264000,264000,0,438631,702631
190920100300000,PRINTING,INDUSTRIAL,0,79272,79272,0,161562,240834
190920100400000,SHOP,COMMERCIAL,0,367000,367000,0,437670,804670
190920100500000,WAREHOUSE,COMMERCIAL,0,288000,288000,0,895546,1183546
190920100600000,WAREHOUSE,COMMERCIAL,0,426087,426087,0,612655,1038742
190920100700000,VACANT LAND,COMMERCIAL,0,68800,68800,0,0,68800
190920100800000,WAREHOUSE,COMMERCIAL,0,184000,184000,0,266039,450039
190920200100000,CITY PROPERTY,EXEMPT,0,0,0,0,0,0
190922600100000,CITY PROPERTY,EXEMPT,0,0,0,0,0,0
190922600200000,WAREHOUSE,COMMERCIAL,0,381036,381036,0,1487012,1868048
190922600300000,SERVICE STATION,COMMERCIAL,0,56250,56250,0,81000,137250
190922600400000,WAREHOUSE,COMMERCIAL,0,338728,338728,0,824389,1163117
190922700100000,WAREHOUSE,COMMERCIAL,0,184500,184500,0,663795,848295
190925100100000,CITY PROPERTY,EXEMPT,0,0,0,0,0,0
190925100200000,SHOP,COMMERCIAL,0,104000,104000,0,296829,400829
190925100300000,VACANT LAND,COMMERCIAL,0,37900,37900,0,0,37900
190925100400000,FLAT PARKING,COMMERCIAL,0,19100,19100,0,11655,30755
190925100500000,CONC/ASPH;INDUSTRIAL,INDUSTRIAL,0,244404,244404,0,390971,635375
190925100600000,FLAT PARKING,COMMERCIAL,0,477375,477375,0,18399,495774
190925200100000,SHOP,COMMERCIAL,0,76009,76009,0,462648,538657
190925200200000,SHOP,COMMERCIAL,0,55692,55692,0,244826,300518
190925200300000,OFFICE,COMMERCIAL,0,53550,53550,0,204897,258447
190925200400000,WAREHOUSE,COMMERCIAL,0,384375,384375,0,305749,690124
190927600100000,FRATERNAL,COMMERCIAL,0,339000,339000,0,1388199,1727199
190927600200000,SW 422,RESIDENTIAL,35652,0,35652,61511,0,97163
190927600300000,SW 422,RESIDENTIAL,29106,0,29106,120503,0,149609
190927600400000,OFFICE,COMMERCIAL,0,32165,32165,0,145803,177968
190930100100000,WAREHOUSE;MINI STORG,COMMERCIAL,0,180565,180565,0,625942,806507
190930100200000,CITY PROPERTY,EXEMPT,0,0,0,0,0,0
190930100300000,SW 426,RESIDENTIAL,18900,0,18900,63891,0,82791
190930100400000,SW 426,RESIDENTIAL,19800,0,19800,61636,0,81436
190930100500000,SW 426,RESIDENTIAL,19800,0,19800,64138,0,83938
190930100600000,SW 426,RESIDENTIAL,19800,0,19800,63373,0,83173
190930100700000,SW 426,RESIDENTIAL,19800,0,19800,47624,0,67424
190930100800000,SW 426,RESIDENTIAL,19800,0,19800,69543,0,89343
190930100900000,SW 426,RESIDENTIAL,19800,0,19800,62106,0,81906
190930101000000,SW 426,RESIDENTIAL,19800,0,19800,61712,0,81512
190930200100000,SW 426,RESIDENTIAL,21399,0,21399,67797,0,89196
190930200200000,SW 426,RESIDENTIAL,20926,0,20926,77757,0,98683
190930200300000,SW 426,RESIDENTIAL,20926,0,20926,90592,0,111518
190930200400000,SW 426,RESIDENTIAL,21627,0,21627,81412,0,103039
190930200500000,SW 426,RESIDENTIAL,20844,0,20844,91799,0,112643
190930200600000,SW 426,RESIDENTIAL,20844,0,20844,64809,0,85653
190930300100000,SW 426,RESIDENTIAL,20988,0,20988,114285,0,135273
190930300200000,SW 426,RESIDENTIAL,21735,0,21735,75425,0,97160
190930300300000,SW 426,RESIDENTIAL,21012,0,21012,64313,0,85325
190932600100000,SHOP,COMMERCIAL,0,200000,200000,0,405820,605820
190932600200000,SHOP,COMMERCIAL,0,227000,227000,0,71826,298826
190932600300000,SHOP,COMMERCIAL,0,87480,87480,0,480330,567810
190932600400000,WAREHOUSE,COMMERCIAL,0,114000,114000,0,223130,337130
190932600500000,VACANT LAND,COMMERCIAL,0,127000,127000,0,0,127000
190932600600000,WAREHOUSE,COMMERCIAL,0,339000,339000,0,1265397,1604397
190932600800000,SHOP,COMMERCIAL,0,490200,490200,0,457227,947427
190932600900000,MFG HOME PARK,COMMERCIAL,0,196800,196800,0,154928,351728
190932601000000,SHOP,COMMERCIAL,0,202500,202500,0,678023,880523
190932601100000,SHOP,COMMERCIAL,0,363375,363375,0,353146,716521
190932601200000,VACANT LAND,COMMERCIAL,0,460350,460350,0,0,460350
190935100100000,SHOP,COMMERCIAL,0,190820,190820,0,549205,740025
190935100500000,WAREHOUSE,COMMERCIAL,0,181000,181000,0,936797,1117797
190935100700000,VACANT LAND,COMMERCIAL,0,215817,215817,0,0,215817
190935100701000,SHOP,COMMERCIAL,0,10277,10277,0,91554,101831
190935100701001,SHOP,COMMERCIAL,0,10277,10277,0,96374,106651
190935100701002,SHOP,COMMERCIAL,0,10277,10277,0,65326,75603
190935100701003,SHOP,COMMERCIAL,0,10277,10277,0,56754,67031
190935100701004,SHOP,COMMERCIAL,0,10277,10277,0,56922,67199
190935100701005,SHOP,COMMERCIAL,0,10277,10277,0,82996,93273
190935100701006,SHOP,COMMERCIAL,0,10277,10277,0,102190,112467
190935100701007,SHOP,COMMERCIAL,0,10277,10277,0,56871,67148
190935100701008,SHOP,COMMERCIAL,0,10277,10277,0,56299,66576
190935100701009,SHOP,COMMERCIAL,0,10277,10277,0,56871,67148
190935100701010,SHOP,COMMERCIAL,0,10277,10277,0,58990,69267
190935100701011,SHOP,COMMERCIAL,0,10277,10277,0,58243,68520
190935100701012,SHOP,COMMERCIAL,0,10277,10277,0,55941,66218
190935100701013,SHOP,COMMERCIAL,0,10277,10277,0,61827,72104
190935100701014,SHOP,COMMERCIAL,0,10277,10277,0,111866,122143
190935100701015,SHOP,COMMERCIAL,0,10277,10277,0,101048,111325
190935100701016,SHOP,COMMERCIAL,0,10277,10277,0,159524,169801
190935100701017,SHOP,COMMERCIAL,0,10277,10277,0,54772,65049
190935100701018,SHOP,COMMERCIAL,0,10277,10277,0,52674,62951
190935100701019,SHOP,COMMERCIAL,0,10277,10277,0,51909,62186
190935100701020,SHOP,COMMERCIAL,0,10277,10277,0,57554,67831
190935100701021,SHOP,COMMERCIAL,0,10277,10277,0,119653,129930
190935100702000,BILLBOARD(BLL),COMMERCIAL,0,0,0,0,72415,72415
190935200300000,WAREHOUSE,COMMERCIAL,0,253800,253800,0,35100,288900
190935200400000,WAREHOUSE,COMMERCIAL,0,179000,179000,0,534192,713192
190935200500000,SHOP,COMMERCIAL,0,128000,128000,0,250414,378414
190935200700000,VACANT LAND,COMMERCIAL,0,99000,99000,0,0,99000
190935200800000,WAREHOUSE,COMMERCIAL,0,271125,271125,0,135339,406464
190935201000000,SHOP,INDUSTRIAL,0,235062,235062,0,777813,1012875
190935201100000,WAREHOUSE,COMMERCIAL,0,182400,182400,0,932724,1115124
190935201200000,WAREHOUSE,COMMERCIAL,0,94400,94400,0,393989,488389
190935300100000,SHOP,COMMERCIAL,0,117000,117000,0,282678,399678
190935300200000,FLAT PARKING,COMMERCIAL,0,73400,73400,0,55512,128912
190935300300000,WAREHOUSE,COMMERCIAL,0,81800,81800,0,165123,246923
190935300400000,SHOP,COMMERCIAL,0,163750,163750,0,505104,668854
190935300600000,SW 418,RESIDENTIAL,99700,0,99700,157779,0,257479
190935301001000,SHOP,COMMERCIAL,0,20013,20013,0,169019,189032
190935301001001,SHOP,COMMERCIAL,0,20013,20013,0,51845,71858
190935301001002,SHOP,COMMERCIAL,0,20013,20013,0,47845,67858
190935301001003,SHOP,COMMERCIAL,0,20013,20013,0,47845,67858
190935301001004,SHOP,COMMERCIAL,0,20013,20013,0,47845,67858
190935301100000,SW 418,RESIDENTIAL,149400,0,149400,0,0,149400
190935301200000,BARS/LOUNGE,COMMERCIAL,0,248000,248000,0,746398,994398
190937600100000,SW 426,RESIDENTIAL,20817,0,20817,84662,0,105479
190937600200000,SW 426,RESIDENTIAL,20817,0,20817,67602,0,88419
190937600300000,SW 426,RESIDENTIAL,20817,0,20817,104998,0,125815
190937600400000,SW 426,RESIDENTIAL,20817,0,20817,73903,0,94720
190937600500000,SW 426,RESIDENTIAL,20790,0,20790,58903,0,79693
190937600600000,SW 426,RESIDENTIAL,20790,0,20790,69993,0,90783
190937600700000,SW 426,RESIDENTIAL,20790,0,20790,114413,0,135203
190937600800000,SW 426,RESIDENTIAL,20790,0,20790,84459,0,105249
190937600900000,SW 426,RESIDENTIAL,20790,0,20790,70177,0,90967
190937601000000,SW 426,RESIDENTIAL,20817,0,20817,82835,0,103652
190937601100000,SW 426,RESIDENTIAL,20817,0,20817,78186,0,99003
190937601200000,SW 426,RESIDENTIAL,20817,0,20817,70111,0,90928
190937601300000,SW 426,RESIDENTIAL,20844,0,20844,68828,0,89672
190937601400000,SW 426,RESIDENTIAL,21627,0,21627,60609,0,82236
190937601500000,SW 426,RESIDENTIAL,20926,0,20926,86871,0,107797
190937601600000,SW 426,RESIDENTIAL,20926,0,20926,89807,0,110733
190937601700000,SW 426,RESIDENTIAL,21399,0,21399,68602,0,90001
190937601800000,SW 426,RESIDENTIAL,20844,0,20844,65036,0,85880
190937601900000,SW 426,RESIDENTIAL,20817,0,20817,76698,0,97515
190937602000000,SW 426,RESIDENTIAL,20817,0,20817,104845,0,125662
190937602100000,SW 426,RESIDENTIAL,20817,0,20817,68403,0,89220
190937602200000,SW 426,RESIDENTIAL,20790,0,20790,107570,0,128360
190937602300000,SW 426,RESIDENTIAL,20790,0,20790,118334,0,139124
190937602400000,SW 426,RESIDENTIAL,20790,0,20790,64435,0,85225
190937602500000,SW 426,RESIDENTIAL,20790,0,20790,79879,0,100669
190937602600000,SW 426,RESIDENTIAL,20790,0,20790,85463,0,106253
190937602700000,SW 426,RESIDENTIAL,20817,0,20817,67595,0,88412
190937602800000,SW 426,RESIDENTIAL,20817,0,20817,66315,0,87132
190937700100000,SW 426,RESIDENTIAL,21892,0,21892,66120,0,88012
190937700200000,SW 418,AG LAND,13974,0,13974,0,0,13974
190937700300000,SW 426,RESIDENTIAL,21553,0,21553,63278,0,84831
190937700400000,SW 426,RESIDENTIAL,21450,0,21450,77878,0,99328
190937700500000,SW 426,RESIDENTIAL,21892,0,21892,64024,0,85916
190937700600000,SW 426,RESIDENTIAL,22312,0,22312,94647,0,116959
190937700700000,SW 426,RESIDENTIAL,22511,0,22511,106061,0,128572
190937700800000,SW 426,RESIDENTIAL,22720,0,22720,62603,0,85323
190937700900000,SW 426,RESIDENTIAL,26730,0,26730,63277,0,90007
190937701000000,SW 426,RESIDENTIAL,22737,0,22737,81374,0,104111
190937701100000,SW 426,RESIDENTIAL,22321,0,22321,82754,0,105075
190937900100000,SW 426,RESIDENTIAL,20268,0,20268,79441,0,99709
190937900200000,SW 426,RESIDENTIAL,21060,0,21060,66403,0,87463
190937900300000,SW 426,RESIDENTIAL,21060,0,21060,92610,0,113670
190937900400000,SW 426,RESIDENTIAL,21060,0,21060,102154,0,123214
190937900500000,SW 426,RESIDENTIAL,19944,0,19944,70762,0,90706
190938000100000,SW 426,RESIDENTIAL,22056,0,22056,94587,0,116643
190938000200000,SW 426,RESIDENTIAL,21449,0,21449,70893,0,92342
190940100100000,CONVENIENCE STORE,COMMERCIAL,0,159000,159000,0,357350,516350
190940100200000,FLAT PARKING,COMMERCIAL,0,41700,41700,0,5141,46841
190940100300000,BARS/LOUNGE,COMMERCIAL,0,122525,122525,0,113481,236006
190940100700000,APARTMENT,COMMERCIAL,0,51360,51360,0,245362,296722
190940100800000,APARTMENT,COMMERCIAL,0,95200,95200,0,505739,600939
190940200100000,FAST FOOD,COMMERCIAL,0,384000,384000,0,553928,937928
190940200400000,VACANT LAND,EXEMPT,0,585000,585000,0,0,585000
190940200500000,CONVENIENCE STORE,COMMERCIAL,0,320000,320000,0,892241,1212241
190940200502000,BILLBOARD(BLL),COMMERCIAL,0,0,0,0,12652,12652
190942600100000,SW 426,RESIDENTIAL,22275,0,22275,69040,0,91315
190942600200000,SW 426,RESIDENTIAL,22275,0,22275,76520,0,98795
190942700100000,WAREHOUSE;MINI STORG,COMMERCIAL,0,450000,450000,0,1880646,2330646
190942700200000,SW 426,RESIDENTIAL,19800,0,19800,59077,0,78877
190942700300000,SW 426,RESIDENTIAL,19800,0,19800,89346,0,109146
190942700400000,SW 426,RESIDENTIAL,19800,0,19800,106393,0,126193
190942700500000,SW 426,RESIDENTIAL,19800,0,19800,73184,0,92984
190942700600000,SW 426,RESIDENTIAL,19800,0,19800,88953,0,108753
190942700700000,SW 426,RESIDENTIAL,22699,0,22699,81570,0,104269
190942700800000,SW 426,RESIDENTIAL,21400,0,21400,78449,0,99849
190942700900000,SW 426,RESIDENTIAL,21400,0,21400,98354,0,119754
190942701000000,SW 426,RESIDENTIAL,21400,0,21400,110574,0,131974
190942701100000,SW 426,RESIDENTIAL,21400,0,21400,66484,0,87884
190942701200000,SW 426,RESIDENTIAL,22699,0,22699,95043,0,117742
190942701300000,SW 426,RESIDENTIAL,21237,0,21237,126047,0,147284
190942701400000,SW 426,RESIDENTIAL,20625,0,20625,74681,0,95306
190942701500000,SW 426,RESIDENTIAL,20165,0,20165,67204,0,87369
190942800100000,SW 426,RESIDENTIAL,16250,0,16250,105499,0,121749
190942800200000,SW 426,RESIDENTIAL,21800,0,21800,3888,0,25688
190942800300000,SW 426,RESIDENTIAL,24375,0,24375,117344,0,141719
190942800400000,SW 426,RESIDENTIAL,13888,0,13888,81435,0,95323
190942800500000,SW 426,RESIDENTIAL,22965,0,22965,98734,0,121699
190942900100000,SW 426,RESIDENTIAL,21889,0,21889,105600,0,127489
190942900200000,SW 426,RESIDENTIAL,20752,0,20752,77245,0,97997
190942900300000,SW 426,RESIDENTIAL,21250,0,21250,77593,0,98843
190942900400000,SW 426,RESIDENTIAL,21250,0,21250,67178,0,88428
190942900500000,SW 426,RESIDENTIAL,21250,0,21250,100367,0,121617
190942900600000,SW 426,RESIDENTIAL,20711,0,20711,94424,0,115135
190942900700000,SW 426,RESIDENTIAL,20711,0,20711,116381,0,137092
190942900800000,SW 426,RESIDENTIAL,20711,0,20711,91656,0,112367
190942900900000,SW 426,RESIDENTIAL,20711,0,20711,88895,0,109606
190942901000000,SW 426,RESIDENTIAL,20711,0,20711,70755,0,91466
190943000100000,SW 426,RESIDENTIAL,21598,0,21598,93425,0,115023
190943000200000,SW 426,RESIDENTIAL,21314,0,21314,82074,0,103388
190943000300000,SW 426,RESIDENTIAL,22012,0,22012,88865,0,110877
190943000400000,SW 426,RESIDENTIAL,21012,0,21012,70319,0,91331
190943000500000,SW 426,RESIDENTIAL,21250,0,21250,69100,0,90350
190943000600000,SW 426,RESIDENTIAL,22482,0,22482,59160,0,81642
190943100100000,SW 426,RESIDENTIAL,21791,0,21791,74640,0,96431
190943100200000,SW 426,RESIDENTIAL,21462,0,21462,76922,0,98384
190943100300000,SW 426,RESIDENTIAL,20933,0,20933,61686,0,82619
190943100400000,SW 426,RESIDENTIAL,21314,0,21314,65319,0,86633
190943100500000,SW 426,RESIDENTIAL,21314,0,21314,70974,0,92288
190945100100000,SW 426,RESIDENTIAL,22321,0,22321,72115,0,94436
190945100200000,SW 426,RESIDENTIAL,21892,0,21892,78335,0,100227
190945100300000,SW 426,RESIDENTIAL,21241,0,21241,102837,0,124078
190945100400000,SW 426,RESIDENTIAL,21802,0,21802,80419,0,102221
190945100500000,SW 426,RESIDENTIAL,21668,0,21668,74327,0,95995
190945100600000,SW 426,RESIDENTIAL,21668,0,21668,68556,0,90224
190945100700000,SW 426,RESIDENTIAL,21668,0,21668,80437,0,102105
190945100800000,SW 426,RESIDENTIAL,21879,0,21879,102839,0,124718
190945100900000,SW 426,RESIDENTIAL,20663,0,20663,77419,0,98082
190945200100000,SW 426,RESIDENTIAL,20711,0,20711,100031,0,120742
190945200200000,SW 426,RESIDENTIAL,21250,0,21250,72903,0,94153
190945200300000,SW 426,RESIDENTIAL,21250,0,21250,73041,0,94291
190945200400000,SW 426,RESIDENTIAL,21250,0,21250,64271,0,85521
190945200500000,SW 426,RESIDENTIAL,20959,0,20959,99708,0,120667
190945200600000,SW 426,RESIDENTIAL,21572,0,21572,110943,0,132515
190945200700000,SW 426,RESIDENTIAL,21386,0,21386,67512,0,88898
190945200800000,SW 426,RESIDENTIAL,22313,0,22313,73559,0,95872
190945200900000,SW 426,RESIDENTIAL,21527,0,21527,68993,0,90520
190945201000000,SW 426,RESIDENTIAL,22409,0,22409,92763,0,115172
190945201100000,SW 426,RESIDENTIAL,22984,0,22984,102314,0,125298
190945201200000,SW 426,RESIDENTIAL,22277,0,22277,69396,0,91673
190945201300000,SW 426,RESIDENTIAL,23664,0,23664,82404,0,106068
190945201400000,SW 426,RESIDENTIAL,21250,0,21250,85208,0,106458
190945201500000,SW 426,RESIDENTIAL,21668,0,21668,77285,0,98953
190945201600000,SW 426,RESIDENTIAL,21400,0,21400,70609,0,92009
190945201700000,SW 426,RESIDENTIAL,21400,0,21400,86599,0,107999
190945201800000,SW 426,RESIDENTIAL,24022,0,24022,109296,0,133318
190945201900000,SW 426,RESIDENTIAL,20754,0,20754,100744,0,121498
190945202000000,SW 426,RESIDENTIAL,20711,0,20711,102829,0,123540
190945202100000,SW 426,RESIDENTIAL,20711,0,20711,119723,0,140434
190945202200000,SW 426,RESIDENTIAL,20711,0,20711,71888,0,92599
190945202300000,SW 426,RESIDENTIAL,21801,0,21801,83136,0,104937
190945202400000,SW 426,RESIDENTIAL,20711,0,20711,70156,0,90867
190945202500000,SW 426,RESIDENTIAL,20711,0,20711,67796,0,88507
190945202600000,SW 426,RESIDENTIAL,20711,0,20711,73949,0,94660
190945202700000,SW 426,RESIDENTIAL,20711,0,20711,96452,0,117163
190945300100000,SW 426,RESIDENTIAL,21250,0,21250,92506,0,113756
190945300200000,SW 426,RESIDENTIAL,21528,0,21528,69316,0,90844
190945300300000,SW 426,RESIDENTIAL,21465,0,21465,93036,0,114501
190945300400000,SW 426,RESIDENTIAL,20988,0,20988,72830,0,93818
190945300500000,SW 426,RESIDENTIAL,21465,0,21465,95476,0,116941
190945300600000,SW 426,RESIDENTIAL,22134,0,22134,66900,0,89034
190945300700000,SW 426,RESIDENTIAL,22200,0,22200,71525,0,93725
190945300800000,SW 426,RESIDENTIAL,22400,0,22400,96698,0,119098
190945300900000,SW 426,RESIDENTIAL,22400,0,22400,81356,0,103756
190945301000000,SW 426,RESIDENTIAL,23100,0,23100,76243,0,99343
190945301100000,SW 426,RESIDENTIAL,21250,0,21250,62949,0,84199
190945400100000,SW 426,RESIDENTIAL,21271,0,21271,88594,0,109865
190945400200000,SW 426,RESIDENTIAL,21271,0,21271,64753,0,86024
190945400300000,SW 426,RESIDENTIAL,21271,0,21271,77573,0,98844
190945400400000,SW 426,RESIDENTIAL,21250,0,21250,89877,0,111127
190945400500000,SW 426,RESIDENTIAL,21250,0,21250,114783,0,136033
190945400600000,SW 426,RESIDENTIAL,21250,0,21250,59525,0,80775
190945400700000,SW 426,RESIDENTIAL,21250,0,21250,70924,0,92174
190945400800000,SW 426,RESIDENTIAL,21271,0,21271,92748,0,114019
190945400900000,SW 426,RESIDENTIAL,21271,0,21271,82382,0,103653
190945401000000,SW 426,RESIDENTIAL,21314,0,21314,65217,0,86531
190945401100000,SW 426,RESIDENTIAL,20954,0,20954,105125,0,126079
190945401200000,SW 426,RESIDENTIAL,21462,0,21462,96522,0,117984
190945401300000,SW 426,RESIDENTIAL,21670,0,21670,94194,0,115864
190945401400000,SW 426,RESIDENTIAL,21314,0,21314,73046,0,94360
190945401500000,SW 426,RESIDENTIAL,21271,0,21271,78968,0,100239
190945401600000,SW 426,RESIDENTIAL,21271,0,21271,66208,0,87479
190945401700000,SW 426,RESIDENTIAL,21250,0,21250,92623,0,113873
190945401800000,SW 426,RESIDENTIAL,21250,0,21250,74401,0,95651
190945401900000,SW 426,RESIDENTIAL,21250,0,21250,75504,0,96754
190945402000000,SW 426,RESIDENTIAL,21250,0,21250,61215,0,82465
190945402100000,SW 426,RESIDENTIAL,21271,0,21271,80527,0,101798
190945500100000,SW 426,RESIDENTIAL,22343,0,22343,108007,0,130350
190945500200000,SW 426,RESIDENTIAL,20862,0,20862,72244,0,93106
190945500300000,SW 426,RESIDENTIAL,20862,0,20862,75413,0,96275
190945500400000,SW 426,RESIDENTIAL,20862,0,20862,85088,0,105950
190945600100000,SW 426,RESIDENTIAL,23424,0,23424,81193,0,104617
190945600200000,SW 426,RESIDENTIAL,2075,0,2075,0,0,2075
190945600300000,SW 426,RESIDENTIAL,21240,0,21240,86978,0,108218
190945600400000,SW 426,RESIDENTIAL,21172,0,21172,73498,0,94670
190945600500000,SW 426,RESIDENTIAL,21060,0,21060,103963,0,125023
190945600600000,SW 426,RESIDENTIAL,21462,0,21462,86276,0,107738
190945600700000,SW 426,RESIDENTIAL,21462,0,21462,80098,0,101560
190945600800000,SW 426,RESIDENTIAL,21250,0,21250,82986,0,104236
190945700100000,SW 426,RESIDENTIAL,25530,0,25530,110033,0,135563
190945700200000,SW 426,RESIDENTIAL,22454,0,22454,79936,0,102390
190945700300000,SW 426,RESIDENTIAL,20864,0,20864,79858,0,100722
190945700400000,SW 426,RESIDENTIAL,22090,0,22090,69841,0,91931
190945800100000,SW 426,RESIDENTIAL,20655,0,20655,70454,0,91109
190945800200000,SW 426,RESIDENTIAL,21250,0,21250,97269,0,118519
190945800300000,SW 426,RESIDENTIAL,21576,0,21576,81148,0,102724
190945800400000,SW 426,RESIDENTIAL,21519,0,21519,71030,0,92549
190945800500000,SW 426,RESIDENTIAL,20981,0,20981,83575,0,104556
190947600200000,APARTMENT,COMMERCIAL,0,378400,378400,0,2656024,3034424
190947600300000,CENTRALLY ASSESSED,OTHER,0,0,0,0,0,0
190947600500000,SECTION 42,COMMERCIAL,0,41000,41000,0,106559,147559
190947600600000,REG SHOPPING CENTER,COMMERCIAL,0,447500,447500,0,108768,556268
190947600700000,DAY CARE CENTER,EXEMPT,0,690642,690642,0,4482504,5173146
191010100100000,PAPER; INDUSTRIAL,INDUSTRIAL,0,2245100,2245100,0,33954900,36200000
191020100100000,CENTRALLY ASSESSED,OTHER,0,0,0,0,0,0
191020100500000,WAREHOUSE,COMMERCIAL,0,780500,780500,0,6340553,7121053
191020100700000,VACANT LAND,COMMERCIAL,0,712500,712500,0,0,712500
191020100800000,SW 422,AG LAND,11298,0,11298,0,0,11298
191020200100000,WAREHOUSE,COMMERCIAL,0,500300,500300,0,1530950,2031250
191020200200000,SHOP,COMMERCIAL,0,249700,249700,0,705603,955303
191022600200000,VACANT LAND,INDUSTRIAL,0,48600,48600,0,0,48600
191022600300000,MATERIALS MFG;INDUST,INDUSTRIAL,0,334800,334800,0,3563502,3898302
191022600400000,WAREHOUSE,INDUSTRIAL,0,144176,144176,0,991484,1135660
191022700200000,VACANT LAND,COMMERCIAL,0,211000,211000,0,0,211000
191022700300000,EQUIPMENT MFG;INDUST,INDUSTRIAL,0,263358,263358,0,3460333,3723691
191022700400000,OFFICE,COMMERCIAL,0,400000,400000,0,908716,1308716
191025100100000,WAREHOUSE,COMMERCIAL,0,240000,240000,0,566763,806763
191025100200000,WAREHOUSE,COMMERCIAL,0,300000,300000,0,1167022,1467022
191025100300000,WAREHOUSE,COMMERCIAL,0,232000,232000,0,545947,777947
191025100400000,VACANT LAND,COMMERCIAL,0,308300,308300,0,0,308300
191025200100000,CONC/ASPH;INDUSTRIAL,INDUSTRIAL,0,393169,393169,0,1385941,1779110
191025200200000,OFFICE,COMMERCIAL,0,387200,387200,0,1585200,1972400
191027600100000,WAREHOUSE,COMMERCIAL,0,518000,518000,0,967939,1485939
191027600200000,WAREHOUSE,COMMERCIAL,0,340000,340000,0,1055153,1395153
191027700200000,WAREHOUSE,COMMERCIAL,0,804750,804750,0,1521224,2325974
191027700300000,VACANT LAND,COMMERCIAL,0,4612,4612,0,0,4612
191032600200000,SW 456,AG LAND,36428,0,36428,0,0,36428
191035100100000,STATE PROPERTY,EXEMPT,0,0,0,0,0,0
191035100600000,NBHD SHOPPING CENTER,COMMERCIAL,0,214000,214000,0,529396,743396
191035101100000,OFFICE,COMMERCIAL,0,33104,33104,0,85922,119026
191035101200000,CARWASH,COMMERCIAL,0,108000,108000,0,204289,312289
191037600100000,MFG HOME PARK,COMMERCIAL,0,3889000,3889000,0,3127363,7016363
191040100200000,VACANT LAND,AG LAND,6875,0,6875,0,0,6875
191040100300000,VACANT LAND,AG LAND,11768,0,11768,0,0,11768
191040100400000,OFFICE,COMMERCIAL,0,639000,639000,0,7986038,8625038
191040200100000,VACANT LAND,AG LAND,6875,0,6875,0,0,6875
191040300100000,VACANT LAND,COMMERCIAL,0,1650,1650,0,0,1650
191042600100000,VACANT LAND,AG LAND,6929,0,6929,0,0,6929
191042600200000,VACANT LAND,AG LAND,9042,0,9042,0,0,9042
191042600300000,SCHOOL,EXEMPT,0,457272,457272,0,1207917,1665189
191042600400000,VACANT LAND,AG LAND,13430,0,13430,0,0,13430
191042600500000,VACANT LAND,AG LAND,13269,0,13269,0,0,13269
191042600600000,VACANT LAND,AG LAND,10541,0,10541,0,0,10541
191042600700000,VACANT LAND,AG LAND,9524,0,9524,0,0,9524
191042600800000,VACANT LAND,AG LAND,8641,0,8641,0,0,8641
191045100200000,DAY CARE CENTER,COMMERCIAL,0,30500,30500,0,2168851,2199351
191045100300000,SW 422,AG LAND,10113,0,10113,0,0,10113
191047600200000,FLAT PARKING,COMMERCIAL,0,41500,41500,0,74830,116330
191047600300000,SW 456,AG LAND,93035,0,93035,0,3007,96042
191110100100000,SW 422,AG LAND,43758,0,43758,0,0,43758
191110100200000,SW 422,AG LAND,22609,0,22609,0,0,22609
191112600100000,SW 423,RESIDENTIAL,36300,0,36300,258516,0,294816
191112600200000,SW 423,RESIDENTIAL,36300,0,36300,125670,0,161970
191112600300000,SW 423,RESIDENTIAL,36600,0,36600,169722,0,206322
191112700100000,SW 423,AG LAND,52134,0,52134,0,0,52134
191112700200000,CITY PROPERTY,EXEMPT,0,0,0,0,0,0
191112700300000,SW 423,RESIDENTIAL,45450,0,45450,51533,0,96983
191112700400000,SW 423,RESIDENTIAL,45150,0,45150,164330,0,209480
191112700500000,SW 423,RESIDENTIAL,37500,0,37500,50442,0,87942
191112700600000,SW 423,RESIDENTIAL,36900,0,36900,104198,0,141098
191112700700000,SW 423,RESIDENTIAL,11520,0,11520,0,0,11520
191112700800000,SW 423,RESIDENTIAL,36720,0,36720,77849,0,114569
191112700900000,SW 423,RESIDENTIAL,34200,0,34200,84841,0,119041
191112701100000,SW 423,RESIDENTIAL,34200,0,34200,148723,0,182923
191112701200000,SW 423,RESIDENTIAL,35190,0,35190,54239,0,89429
191115100100000,SW 423,RESIDENTIAL,36600,0,36600,157513,0,194113
191115100200000,SW 423,RESIDENTIAL,36600,0,36600,67250,0,103850
191115100300000,SW 423,RESIDENTIAL,36600,0,36600,120346,0,156946
191115100400000,SW 423,RESIDENTIAL,36600,0,36600,114031,0,150631
191115100500000,SW 423,RESIDENTIAL,36600,0,36600,76315,0,112915
191115100600000,SW 423,RESIDENTIAL,36600,0,36600,80172,0,116772
191115100700000,SW 423,RESIDENTIAL,36900,0,36900,112146,0,149046
191115100800000,SW 423,RESIDENTIAL,57950,0,57950,72179,0,130129
191115200100000,SW 423,RESIDENTIAL,33150,0,33150,80292,0,113442
191115200200000,SW 423,RESIDENTIAL,49650,0,49650,70864,0,120514
191115200300000,SW 423,RESIDENTIAL,40162,0,40162,0,0,40162
191115200400000,SW 423,RESIDENTIAL,39487,0,39487,58806,0,98293
191115200500000,SW 423,RESIDENTIAL,43605,0,43605,35596,0,79201
191115200600000,SW 423,RESIDENTIAL,39600,0,39600,36610,0,76210
191115200700000,SW 423,RESIDENTIAL,32940,0,32940,33286,0,66226
191115200800000,SW 423,RESIDENTIAL,14285,0,14285,110973,0,125258
191115200900000,SW 423,RESIDENTIAL,22125,0,22125,59412,0,81537
191115201000000,SW 423,RESIDENTIAL,21938,0,21938,46789,0,68727
191115201100000,SW 423,RESIDENTIAL,37294,0,37294,55186,0,92480
191115201200000,SW 423,RESIDENTIAL,36965,0,36965,60547,0,97512
191115201300000,SW 423,RESIDENTIAL,36975,0,36975,62788,0,99763
191115201400000,SW 423,RESIDENTIAL,29848,0,29848,115822,0,145670
191115201500000,SW 423,RESIDENTIAL,11761,0,11761,58089,0,69850
191115300100000,SW 423,RESIDENTIAL,44505,0,44505,49997,0,94502
191115300200000,SW 423,RESIDENTIAL,47900,0,47900,76685,0,124585
191115300300000,SW 423,RESIDENTIAL,46800,0,46800,43720,0,90520
191115300400000,SW 423,RESIDENTIAL,15302,0,15302,0,0,15302
191115300500000,SW 423,RESIDENTIAL,37584,0,37584,131720,0,169304
191117600100000,SW 422,AG LAND,70899,0,70899,0,0,70899
191117800100000,SW 423,RESIDENTIAL,58750,0,58750,118742,0,177492
191120100200000,SW 423,RESIDENTIAL,33210,0,33210,90159,0,123369
191120100300000,SW 423,RESIDENTIAL,33300,0,33300,96626,0,129926
191120100400000,SW 423,RESIDENTIAL,45630,0,45630,64407,0,110037
191120100500000,SW 423,RESIDENTIAL,35400,0,35400,29489,0,64889
191120100600000,SW 423,RESIDENTIAL,35400,0,35400,146188,0,181588
191120100700000,SW 423,RESIDENTIAL,35400,0,35400,109176,0,144576
191120100800000,SW 423,RESIDENTIAL,35400,0,35400,111709,0,147109
191120100900000,SW 423,RESIDENTIAL,35700,0,35700,0,0,35700
191120101000000,SW 423,RESIDENTIAL,48900,0,48900,171426,0,220326
191120101100000,SW 423,RESIDENTIAL,45250,0,45250,56914,0,102164
191120101200000,SW 423,RESIDENTIAL,45550,0,45550,20979,0,66529
191120101300000,SW 458,RESIDENTIAL,40789,0,40789,172074,0,212863
191120101400000,SW 458,RESIDENTIAL,38800,0,38800,149460,0,188260
191120101500000,SW 458,RESIDENTIAL,33950,0,33950,125951,0,159901
191120101600000,SW 458,RESIDENTIAL,38800,0,38800,145462,0,184262
191120101700000,SW 458,RESIDENTIAL,36375,0,36375,142585,0,178960
191120101800000,SW 458,RESIDENTIAL,33950,0,33950,132821,0,166771
191120101900000,SW 458,RESIDENTIAL,36375,0,36375,172226,0,208601
191120102000000,SW 458,RESIDENTIAL,38800,0,38800,132029,0,170829
191120102100000,SW 458,RESIDENTIAL,33950,0,33950,138636,0,172586
191120102200000,SW 458,RESIDENTIAL,38800,0,38800,159874,0,198674
191120102300000,SW 458,RESIDENTIAL,38800,0,38800,145386,0,184186
191120102400000,SW 458,RESIDENTIAL,36375,0,36375,126267,0,162642
191120102500000,SW 458,RESIDENTIAL,33950,0,33950,128690,0,162640
191120102600000,SW 458,RESIDENTIAL,31525,0,31525,0,0,31525
191120102700000,SW 458,RESIDENTIAL,33950,0,33950,120209,0,154159
191120102800000,SW 458,RESIDENTIAL,31525,0,31525,138619,0,170144
191120102900000,SW 458,RESIDENTIAL,33950,0,33950,0,0,33950
191120103000000,SW 458,RESIDENTIAL,41159,0,41159,0,0,41159
191120200100000,SW 458,RESIDENTIAL,38950,0,38950,173006,0,211956
191120200200000,SW 458,RESIDENTIAL,41280,0,41280,178710,0,219990
191120200300000,SW 458,RESIDENTIAL,41040,0,41040,175896,0,216936
191120200400000,SW 458,RESIDENTIAL,39060,0,39060,199276,0,238336
191120200500000,SW 458,RESIDENTIAL,39480,0,39480,201660,0,241140
191120200600000,SW 458,RESIDENTIAL,39480,0,39480,216594,0,256074
191120200700000,SW 422,RESIDENTIAL,41850,0,41850,165931,0,207781
191120300100000,SW 458,RESIDENTIAL,41467,0,41467,174580,0,216047
191120300200000,SW 458,RESIDENTIAL,35890,0,35890,139076,0,174966
191120300300000,SW 458,RESIDENTIAL,33950,0,33950,144781,0,178731
191120300400000,SW 458,RESIDENTIAL,38500,0,38500,157702,0,196202
191120300500000,SW 458,RESIDENTIAL,33950,0,33950,149259,0,183209
191120300600000,SW 458,RESIDENTIAL,35890,0,35890,169049,0,204939
191120300700000,SW 458,RESIDENTIAL,33950,0,33950,140009,0,173959
191120300800000,SW 458,RESIDENTIAL,39770,0,39770,164361,0,204131
191120300900000,SW 458,RESIDENTIAL,33950,0,33950,0,0,33950
191120301000000,SW 458,RESIDENTIAL,37364,0,37364,150620,0,187984
191120301100000,SW 458,RESIDENTIAL,41467,0,41467,112760,0,154227
191120301200000,SW 458,RESIDENTIAL,43650,0,43650,150320,0,193970
191120301300000,SW 458,RESIDENTIAL,37364,0,37364,142595,0,179959
191120301400000,SW 458,RESIDENTIAL,33950,0,33950,154403,0,188353
191120301500000,SW 458,RESIDENTIAL,39770,0,39770,157335,0,197105
191120301600000,SW 458,RESIDENTIAL,33950,0,33950,144933,0,178883
191120301700000,SW 458,RESIDENTIAL,35890,0,35890,139690,0,175580
191120301800000,SW 458,RESIDENTIAL,33950,0,33950,146379,0,180329
191120301900000,SW 458,RESIDENTIAL,39770,0,39770,141177,0,180947
191120302000000,SW 458,RESIDENTIAL,33950,0,33950,140278,0,174228
191120302100000,SW 458,RESIDENTIAL,35890,0,35890,138351,0,174241
191120302200000,SW 458,RESIDENTIAL,43650,0,43650,170586,0,214236
191120400100000,SW 458,RESIDENTIAL,41400,0,41400,0,0,41400
191120400200000,SW 458,RESIDENTIAL,37803,0,37803,132541,0,170344
191120400300000,SW 458,RESIDENTIAL,38182,0,38182,157364,0,195546
191120400400000,CITY PROPERTY,EXEMPT,0,0,0,0,0,0
191120400500000,SW 458,RESIDENTIAL,34500,0,34500,154820,0,189320
191120400600000,SW 458,RESIDENTIAL,34500,0,34500,158775,0,193275
191120400700000,SW 458,RESIDENTIAL,32200,0,32200,147018,0,179218
191120400800000,SW 458,RESIDENTIAL,32200,0,32200,156376,0,188576
191120400900000,SW 458,RESIDENTIAL,32200,0,32200,142972,0,175172
191120401000000,SW 458,RESIDENTIAL,9919,0,9919,0,0,9919
191120401100000,SW 458,RESIDENTIAL,11700,0,11700,0,0,11700
191120500100000,SW 458,RESIDENTIAL,43650,0,43650,177083,0,220733
191120500200000,SW 458,RESIDENTIAL,35890,0,35890,133897,0,169787
191120500300000,SW 458,RESIDENTIAL,33950,0,33950,151815,0,185765
191120500400000,SW 458,RESIDENTIAL,39770,0,39770,164581,0,204351
191120500500000,SW 458,RESIDENTIAL,33950,0,33950,129837,0,163787
191120500600000,SW 458,RESIDENTIAL,35890,0,35890,189424,0,225314
191120500700000,SW 458,RESIDENTIAL,33950,0,33950,153610,0,187560
191120500800000,SW 458,RESIDENTIAL,39770,0,39770,171473,0,211243
191120500900000,SW 458,RESIDENTIAL,33950,0,33950,130880,0,164830
191120501000000,SW 458,RESIDENTIAL,37364,0,37364,176791,0,214155
191120501100000,SW 458,RESIDENTIAL,43650,0,43650,147151,0,190801
191120501200000,SW 458,RESIDENTIAL,7122,0,7122,0,0,7122
191120501300000,SW 458,RESIDENTIAL,6104,0,6104,0,0,6104
191120501400000,SW 458,RESIDENTIAL,33950,0,33950,126307,0,160257
191120501500000,SW 458,RESIDENTIAL,6359,0,6359,0,0,6359
191120501600000,SW 458,RESIDENTIAL,33950,0,33950,152646,0,186596
191120501700000,SW 458,RESIDENTIAL,5850,0,5850,0,0,5850
191120501800000,SW 458,RESIDENTIAL,33950,0,33950,130682,0,164632
191120501900000,SW 458,RESIDENTIAL,39770,0,39770,166893,0,206663
191120502000000,SW 458,RESIDENTIAL,33950,0,33950,128794,0,162744
191120502100000,SW 458,RESIDENTIAL,35890,0,35890,159359,0,195249
191120502200000,SW 458,RESIDENTIAL,43650,0,43650,160834,0,204484
191120600100000,SW 458,RESIDENTIAL,37830,0,37830,144681,0,182511
191120600200000,SW 458,RESIDENTIAL,33950,0,33950,130481,0,164431
191120600300000,SW 458,RESIDENTIAL,33950,0,33950,145202,0,179152
191120600400000,SW 458,RESIDENTIAL,36375,0,36375,146874,0,183249
191120600500000,SW 458,RESIDENTIAL,5596,0,5596,0,0,5596
191120600600000,SW 458,RESIDENTIAL,33950,0,33950,162557,0,196507
191120600700000,SW 458,RESIDENTIAL,38800,0,38800,149106,0,187906
191120600800000,SW 458,RESIDENTIAL,36375,0,36375,193641,0,230016
191120600900000,SW 458,RESIDENTIAL,33950,0,33950,126737,0,160687
191120601000000,SW 458,RESIDENTIAL,33950,0,33950,147963,0,181913
191120601100000,SW 458,RESIDENTIAL,37345,0,37345,165761,0,203106
191120601200000,SW 458,RESIDENTIAL,33950,0,33950,145631,0,179581
191120601300000,SW 458,RESIDENTIAL,36375,0,36375,155965,0,192340
191120601400000,SW 458,RESIDENTIAL,6359,0,6359,0,0,6359
191120601500000,SW 458,RESIDENTIAL,33950,0,33950,125291,0,159241
191120601600000,SW 458,RESIDENTIAL,33950,0,33950,126143,0,160093
191120601700000,SW 458,RESIDENTIAL,5596,0,5596,0,0,5596
191120601800000,SW 458,RESIDENTIAL,14236,0,14236,0,0,14236
191122600100000,SW 422,AG LAND,3904,0,3904,0,0,3904
191122700100000,MISCELLANEOUS,COMMERCIAL,0,20375,20375,0,51480,71855
191122700102000,BILLBOARD(BLL),COMMERCIAL,0,0,0,0,11893,11893
191122700200000,FOOD GRADE;INDUST,INDUSTRIAL,0,506196,506196,0,6233912,6740108
191122700300000,CENTRALLY ASSESSED,OTHER,0,0,0,0,0,0
191122700700000,FOOD GRADE;INDUST,INDUSTRIAL,0,328320,328320,0,3552107,3880427
191125100100000,VACANT LAND,INDUSTRIAL,0,359154,359154,0,0,359154
191127600200000,SW 423,RESIDENTIAL,45150,0,45150,50925,0,96075
191127600300000,SW 423,RESIDENTIAL,38247,0,38247,81233,0,119480
191127600400000,SW 423,RESIDENTIAL,12465,0,12465,3979,0,16444
191127600500000,SW 423,RESIDENTIAL,7515,0,7515,33353,0,40868
191127600600000,SW 423,RESIDENTIAL,24525,0,24525,0,0,24525
191127600700000,SW 423,RESIDENTIAL,2740,0,2740,0,0,2740
191127600800000,SW 423,RESIDENTIAL,5620,0,5620,0,0,5620
191127600900000,SW 423,RESIDENTIAL,41265,0,41265,70663,0,111928
191127601000000,SW 423,RESIDENTIAL,40800,0,40800,221389,0,262189
191127601100000,SW 423,RESIDENTIAL,37471,0,37471,61827,0,99298
191127601200000,SW 423,RESIDENTIAL,35635,0,35635,55611,0,91246
191127601300000,SW 423,RESIDENTIAL,41625,0,41625,123395,0,165020
191127601400000,SW 423,RESIDENTIAL,37584,0,37584,103248,0,140832
191127601500000,SW 423,RESIDENTIAL,34749,0,34749,39576,0,74325
191127601600000,SW 423,RESIDENTIAL,35343,0,35343,43842,0,79185
191127601700000,SW 423,RESIDENTIAL,35700,0,35700,69211,0,104911
191127601800000,SW 423,RESIDENTIAL,45900,0,45900,58114,0,104014
191127601900000,SW 423,RESIDENTIAL,40650,0,40650,1065,0,41715
191127602000000,SW 423,RESIDENTIAL,24945,0,24945,75425,0,100370
191127602100000,SW 423,RESIDENTIAL,25847,0,25847,153892,0,179739
191127602300000,SW 423,RESIDENTIAL,37296,0,37296,168629,0,205925
191127602400000,SW 423,RESIDENTIAL,32046,0,32046,0,0,32046
191127602500000,SW 423,RESIDENTIAL,46154,0,46154,145167,0,191321
191127700100000,SW 422,RESIDENTIAL,49400,0,49400,149133,0,198533
191127700200000,SW 422,RESIDENTIAL,50302,0,50302,85300,0,135602
191127700300000,SW 422,RESIDENTIAL,46700,0,46700,99111,0,145811
191127900100000,SW 423,RESIDENTIAL,31987,0,31987,94436,0,126423
191127900200000,SW 423,RESIDENTIAL,32825,0,32825,127385,0,160210
191127900300000,SW 423,RESIDENTIAL,48500,0,48500,135319,0,183819
191127900400000,SW 423,RESIDENTIAL,2315,0,2315,0,0,2315
191127900500000,SW 423,RESIDENTIAL,31473,0,31473,83792,0,115265
191132600100000,WAREHOUSE,COMMERCIAL,0,1095750,1095750,0,7374667,8470417
191135100200000,SW 450,RESIDENTIAL,35646,0,35646,102497,0,138143
191135100300000,SW 450,RESIDENTIAL,35750,0,35750,114342,0,150092
191135100400000,SW 450,RESIDENTIAL,35937,0,35937,169132,0,205069
191135100500000,SW 450,RESIDENTIAL,36850,0,36850,132233,0,169083
191135100600000,SW 450,RESIDENTIAL,35750,0,35750,170643,0,206393
191135100700000,SW 450,RESIDENTIAL,35456,0,35456,148522,0,183978
191135100800000,SW 450,RESIDENTIAL,35750,0,35750,133455,0,169205
191135100900000,SW 450,RESIDENTIAL,35750,0,35750,166072,0,201822
191135101000000,SW 450,RESIDENTIAL,35750,0,35750,128876,0,164626
191135101100000,SW 450,RESIDENTIAL,35750,0,35750,132721,0,168471
191135101200000,SW 450,RESIDENTIAL,36108,0,36108,162465,0,198573
191135101300000,SW 450,RESIDENTIAL,35039,0,35039,102943,0,137982
191135101600000,SW 450,RESIDENTIAL,32942,0,32942,102497,0,135439
191135101700000,SW 450,RESIDENTIAL,29520,0,29520,102928,0,132448
191135101900000,SW 450,RESIDENTIAL,38057,0,38057,135952,0,174009
191135102000000,SW 450,RESIDENTIAL,42928,0,42928,145137,0,188065
191135102100000,SW 450,RESIDENTIAL,43313,0,43313,119796,0,163109
191135102200000,SW 450,RESIDENTIAL,38500,0,38500,145082,0,183582
191135102300000,SW 450,RESIDENTIAL,51749,0,51749,150038,0,201787
191135200100000,SW 450,RESIDENTIAL,36000,0,36000,137935,0,173935
191135200200000,SW 450,RESIDENTIAL,33948,0,33948,151572,0,185520
191135300100000,SW 450,RESIDENTIAL,35572,0,35572,135963,0,171535
191135300200000,SW 450,RESIDENTIAL,38142,0,38142,147379,0,185521
191135300300000,SW 450,RESIDENTIAL,35750,0,35750,151101,0,186851
191135300400000,SW 450,RESIDENTIAL,37033,0,37033,149165,0,186198
191135400100000,SW 450,RESIDENTIAL,35748,0,35748,143670,0,179418
191135400200000,SW 450,RESIDENTIAL,35750,0,35750,157667,0,193417
191135400300000,SW 450,RESIDENTIAL,35750,0,35750,126972,0,162722
191135400400000,SW 450,RESIDENTIAL,44468,0,44468,143636,0,188104
191135400500000,SW 450,RESIDENTIAL,37583,0,37583,156636,0,194219
191135400600000,SW 450,RESIDENTIAL,37583,0,37583,160215,0,197798
191135400700000,SW 450,RESIDENTIAL,37033,0,37033,157205,0,194238
191135400800000,SW 450,RESIDENTIAL,35750,0,35750,158475,0,194225
191135500200000,CARWASH,COMMERCIAL,0,182200,182200,0,231286,413486
191135500300000,NBHD SHOPPING CENTER,COMMERCIAL,0,528640,528640,0,1513240,2041880
191135500400000,VACANT LAND,COMMERCIAL,0,175520,175520,0,0,175520
191135500500000,CONVENIENCE STORE,COMMERCIAL,0,387000,387000,0,763634,1150634
191135600100000,DAY CARE CENTER,COMMERCIAL,0,264000,264000,0,656828,920828
191135700100000,SW 450,RESIDENTIAL,36227,0,36227,177704,0,213931
191135700200000,SW 450,RESIDENTIAL,33433,0,33433,161930,0,195363
191137700200000,CITY PROPERTY,EXEMPT,0,0,0,0,0,0
191137701200000,SW 450,RESIDENTIAL,36504,0,36504,131833,0,168337
191137701300000,SW 450,RESIDENTIAL,37142,0,37142,152615,0,189757
191137701400000,SW 450,RESIDENTIAL,36185,0,36185,147571,0,183756
191137701500000,SW 450,RESIDENTIAL,37511,0,37511,157315,0,194826
191137701600000,CITY PROPERTY,EXEMPT,0,0,0,0,0,0
191137701700000,SW 450,RESIDENTIAL,37583,0,37583,128310,0,165893
191137701800000,SW 450,RESIDENTIAL,37207,0,37207,157131,0,194338
191137701900000,SW 450,RESIDENTIAL,37570,0,37570,187381,0,224951
191137702000000,SW 450,RESIDENTIAL,38329,0,38329,163494,0,201823
191137702100000,SW 450,RESIDENTIAL,37959,0,37959,137875,0,175834
191137702200000,SW 450,RESIDENTIAL,36663,0,36663,172106,0,208769
191137702300000,SW 450,RESIDENTIAL,36663,0,36663,150648,0,187311
191137702400000,SW 450,RESIDENTIAL,36385,0,36385,160832,0,197217
191137702500000,SW 450,RESIDENTIAL,36385,0,36385,176237,0,212622
191137702600000,SW 450,RESIDENTIAL,36107,0,36107,176574,0,212681
191137702700000,SW 450,RESIDENTIAL,41107,0,41107,152124,0,193231
191137702800000,SW 450,RESIDENTIAL,38187,0,38187,183469,0,221656
191137702900000,SW 450,RESIDENTIAL,41717,0,41717,139288,0,181005
191137703000000,SW 450,RESIDENTIAL,56895,0,56895,130683,0,187578
191137703100000,SW 450,RESIDENTIAL,47285,0,47285,167877,0,215162
191137703200000,SW 450,RESIDENTIAL,38317,0,38317,139800,0,178117
191137703300000,SW 450,RESIDENTIAL,35750,0,35750,158631,0,194381
191137703400000,SW 450,RESIDENTIAL,33183,0,33183,149290,0,182473
191137800100000,SW 450,RESIDENTIAL,45045,0,45045,138922,0,183967
191137800200000,SW 450,RESIDENTIAL,38500,0,38500,156042,0,194542
191137800300000,SW 450,RESIDENTIAL,38885,0,38885,146773,0,185658
191137800400000,SW 450,RESIDENTIAL,39270,0,39270,152978,0,192248
191137800500000,SW 450,RESIDENTIAL,39270,0,39270,154298,0,193568
191137800600000,SW 450,RESIDENTIAL,40993,0,40993,154671,0,195664
191137800700000,SW 450,RESIDENTIAL,37114,0,37114,166784,0,203898
191137800800000,SW 450,RESIDENTIAL,35393,0,35393,153581,0,188974
191137800900000,SW 450,RESIDENTIAL,35750,0,35750,162030,0,197780
191137801000000,SW 450,RESIDENTIAL,35665,0,35665,149485,0,185150
191222600300000,SW 447,RESIDENTIAL,50400,0,50400,203798,0,254198
191222600400000,SW 447,RESIDENTIAL,81089,0,81089,206731,0,287820
191222600500000,SW 446,RESIDENTIAL,2124,0,2124,0,0,2124
191222600600000,SW 446,RESIDENTIAL,61740,0,61740,317696,0,379436
191222600700000,SW 446,RESIDENTIAL,64890,0,64890,8880,0,73770
191222600800000,SW 446,RESIDENTIAL,71969,0,71969,253877,0,325846
191222600900000,SW 446,RESIDENTIAL,2791,0,2791,0,0,2791
191222601000000,SW 446,RESIDENTIAL,64185,0,64185,265286,0,329471
191222601100000,SW 446,RESIDENTIAL,56927,0,56927,254992,0,311919
191222601200000,SW 446,RESIDENTIAL,66281,0,66281,324717,0,390998
191222601300000,SW 446,RESIDENTIAL,66587,0,66587,328793,0,395380
191222601400000,SW 446,RESIDENTIAL,84966,0,84966,359276,0,444242
191222601500000,SW 446,RESIDENTIAL,71752,0,71752,343193,0,414945
191222601600000,SW 446,RESIDENTIAL,73663,0,73663,304000,0,377663
191222601700000,SW 446,RESIDENTIAL,77385,0,77385,292204,0,369589
191222601800000,SW 446,RESIDENTIAL,63665,0,63665,324438,0,388103
191222601900000,SW 446,RESIDENTIAL,63665,0,63665,269950,0,333615
191222602000000,SW 446,RESIDENTIAL,63665,0,63665,319205,0,382870
191222602100000,SW 446,RESIDENTIAL,67410,0,67410,306030,0,373440
191222602200000,SW 446,RESIDENTIAL,67410,0,67410,267826,0,335236
191222602400000,SW 446,RESIDENTIAL,67519,0,67519,0,0,67519
191222602500000,SW 446,RESIDENTIAL,59920,0,59920,298408,0,358328
191222602600000,SW 446,RESIDENTIAL,59920,0,59920,279915,0,339835
191222602700000,SW 446,RESIDENTIAL,59920,0,59920,297476,0,357396
191222602800000,SW 446,RESIDENTIAL,2386,0,2386,0,0,2386
191222602900000,SW 446,RESIDENTIAL,4913,0,4913,0,0,4913
191222603000000,SW 446,RESIDENTIAL,86263,0,86263,298586,0,384849
191222603100000,SW 446,RESIDENTIAL,3860,0,3860,0,0,3860
191222603200000,SW 446,RESIDENTIAL,65112,0,65112,294198,0,359310
191222603300000,SW 446,RESIDENTIAL,63812,0,63812,297760,0,361572
191222603400000,SW 446,RESIDENTIAL,60669,0,60669,326694,0,387363
191222603500000,SW 446,RESIDENTIAL,60669,0,60669,314559,0,375228
191222603600000,SW 446,RESIDENTIAL,60095,0,60095,344750,0,404845
191222603700000,SW 447,RESIDENTIAL,113350,0,113350,0,0,113350
191222700100000,SW 447,RESIDENTIAL,25,0,25,0,0,25
191225200100000,SW 447,RESIDENTIAL,855,0,855,0,0,855
191225200200000,SW 447,RESIDENTIAL,40031,0,40031,193967,0,233998
191225200300000,SW 447,RESIDENTIAL,51494,0,51494,136547,0,188041
191225200400000,SW 447,RESIDENTIAL,51450,0,51450,165601,0,217051
191225200500000,SW 447,RESIDENTIAL,51473,0,51473,157973,0,209446
191225200600000,SW 447,RESIDENTIAL,58653,0,58653,160402,0,219055
191225200700000,SW 447,RESIDENTIAL,52283,0,52283,164604,0,216887
191225200800000,SW 447,RESIDENTIAL,59087,0,59087,166128,0,225215
191225200900000,SW 447,RESIDENTIAL,53176,0,53176,172301,0,225477
191225201000000,SW 447,RESIDENTIAL,49000,0,49000,159267,0,208267
191225201100000,SW 447,RESIDENTIAL,49280,0,49280,154104,0,203384
191225201200000,SW 447,RESIDENTIAL,56,0,56,0,0,56
191225201300000,SW 447,RESIDENTIAL,42374,0,42374,136326,0,178700
191225201400000,SW 447,RESIDENTIAL,48351,0,48351,147458,0,195809
191225201500000,SW 447,RESIDENTIAL,53018,0,53018,191593,0,244611
191225201600000,SW 447,RESIDENTIAL,52500,0,52500,205729,0,258229
191225201700000,SW 447,RESIDENTIAL,50400,0,50400,241642,0,292042
191225201800000,SW 447,RESIDENTIAL,52500,0,52500,200778,0,253278
191225201900000,SW 447,RESIDENTIAL,54600,0,54600,157342,0,211942
191225202000000,SW 447,RESIDENTIAL,54600,0,54600,206684,0,261284
191225202100000,SW 447,RESIDENTIAL,50400,0,50400,224529,0,274929
191225202200000,SW 447,RESIDENTIAL,53494,0,53494,214573,0,268067
191225202300000,SW 447,RESIDENTIAL,1231,0,1231,0,0,1231
191225300100000,SW 447,RESIDENTIAL,54600,0,54600,183496,0,238096
191225300200000,SW 447,RESIDENTIAL,56000,0,56000,182757,0,238757
191225300300000,SW 447,RESIDENTIAL,52500,0,52500,208590,0,261090
191225300400000,SW 447,RESIDENTIAL,52500,0,52500,200930,0,253430
191225300500000,SW 447,RESIDENTIAL,56000,0,56000,200953,0,256953
191225300600000,SW 447,RESIDENTIAL,52500,0,52500,159777,0,212277
191225300700000,SW 447,RESIDENTIAL,50400,0,50400,205870,0,256270
191225300800000,SW 447,RESIDENTIAL,54600,0,54600,197626,0,252226
191225300900000,SW 447,RESIDENTIAL,48881,0,48881,196248,0,245129
191225301000000,SW 447,RESIDENTIAL,44,0,44,0,0,44
191225301100000,SW 446,RESIDENTIAL,145,0,145,0,0,145
191225301200000,SW 446,RESIDENTIAL,42000,0,42000,189795,0,231795
191225301500000,SW 446,RESIDENTIAL,54880,0,54880,309704,0,364584
191225301600000,SW 446,RESIDENTIAL,218,0,218,0,0,218
191225301700000,SW 446,RESIDENTIAL,57120,0,57120,240471,0,297591
191225301800000,SW 446,RESIDENTIAL,1011,0,1011,0,0,1011
191225301900000,SW 446,RESIDENTIAL,58977,0,58977,218566,0,277543
191225302100000,SW 446,RESIDENTIAL,59271,0,59271,297759,0,357030
191225400100000,SW 447,RESIDENTIAL,618,0,618,0,0,618
191225400200000,SW 447,RESIDENTIAL,74235,0,74235,231780,0,306015
191225400300000,SW 447,RESIDENTIAL,75684,0,75684,233297,0,308981
191225400400000,SW 447,RESIDENTIAL,60576,0,60576,209978,0,270554
191225400500000,SW 447,RESIDENTIAL,57426,0,57426,256886,0,314312
191225400600000,SW 447,RESIDENTIAL,54974,0,54974,167331,0,222305
191225400700000,SW 447,RESIDENTIAL,54974,0,54974,200675,0,255649
191225400800000,SW 447,RESIDENTIAL,54974,0,54974,201770,0,256744
191225400900000,SW 447,RESIDENTIAL,54974,0,54974,156915,0,211889
191225401000000,SW 447,RESIDENTIAL,43490,0,43490,183675,0,227165
191225401100000,SW 447,RESIDENTIAL,2973,0,2973,0,0,2973
191225401200000,SW 447,RESIDENTIAL,73440,0,73440,247984,0,321424
191225401300000,SW 447,RESIDENTIAL,78030,0,78030,176561,0,254591
191225401400000,SW 447,RESIDENTIAL,82107,0,82107,204521,0,286628
191225401500000,SW 447,RESIDENTIAL,79560,0,79560,242741,0,322301
191225401600000,SW 447,RESIDENTIAL,81806,0,81806,177603,0,259409
191225401700000,SW 447,RESIDENTIAL,92448,0,92448,186458,0,278906
191225500100000,SW 446,RESIDENTIAL,66204,0,66204,256433,0,322637
191225500200000,SW 446,RESIDENTIAL,65674,0,65674,272700,0,338374
191225500300000,SW 446,RESIDENTIAL,67410,0,67410,256882,0,324292
191225500400000,SW 446,RESIDENTIAL,67410,0,67410,268153,0,335563
191225500500000,SW 446,RESIDENTIAL,71635,0,71635,271011,0,342646
191225600100000,SW 447,RESIDENTIAL,61803,0,61803,193620,0,255423
191225600200000,SW 447,RESIDENTIAL,62566,0,62566,146298,0,208864
191225600300000,SW 447,RESIDENTIAL,70705,0,70705,194479,0,265184
191225600400000,SW 447,RESIDENTIAL,562,0,562,0,0,562
191225600500000,SW 447,RESIDENTIAL,82996,0,82996,261285,0,344281
191225700100000,SW 446,RESIDENTIAL,574,0,574,0,0,574
191412700200000,SW 449,RESIDENTIAL,6652,0,6652,0,0,6652
191412700300000,SW 449,RESIDENTIAL,6972,0,6972,0,0,6972
191412700400000,SW 449,RESIDENTIAL,7131,0,7131,0,0,7131
191412700500000,SW 449,RESIDENTIAL,7290,0,7290,0,0,7290
191412700600000,SW 449,RESIDENTIAL,7449,0,7449,0,0,7449
191412700700000,SW 449,RESIDENTIAL,7608,0,7608,0,0,7608
191412700800000,SW 449,RESIDENTIAL,7743,0,7743,0,0,7743
191412700900000,SW 449,RESIDENTIAL,7687,0,7687,0,0,7687
191412800100000,SW 449,RESIDENTIAL,6320,0,6320,0,0,6320
191412800200000,SW 449,RESIDENTIAL,6109,0,6109,0,0,6109
191412800300000,SW 449,RESIDENTIAL,6166,0,6166,0,0,6166
191412800400000,SW 449,RESIDENTIAL,6160,0,6160,0,0,6160
191412800500000,SW 449,RESIDENTIAL,50666,0,50666,148126,0,198792
191412800600000,SW 449,RESIDENTIAL,11288,0,11288,0,0,11288
191412800700000,SW 449,RESIDENTIAL,47097,0,47097,191700,0,238797
191412900100000,SW 449,RESIDENTIAL,6787,0,6787,0,0,6787
191412900200000,SW 449,RESIDENTIAL,52250,0,52250,169414,0,221664
191412900300000,SW 449,RESIDENTIAL,52250,0,52250,214126,0,266376
191412900400000,SW 449,RESIDENTIAL,53592,0,53592,212120,0,265712
191412900500000,SW 449,RESIDENTIAL,52250,0,52250,191806,0,244056
191412900600000,SW 449,RESIDENTIAL,51700,0,51700,197182,0,248882
191412900700000,SW 449,RESIDENTIAL,53975,0,53975,180955,0,234930
191412900800000,SW 449,RESIDENTIAL,6424,0,6424,0,0,6424
191412900900000,SW 449,RESIDENTIAL,48510,0,48510,191609,0,240119
191412901000000,SW 449,RESIDENTIAL,53900,0,53900,229548,0,283448
191412901100000,SW 449,RESIDENTIAL,47520,0,47520,226712,0,274232
191412901200000,SW 449,RESIDENTIAL,7975,0,7975,0,0,7975
191412901300000,SW 449,RESIDENTIAL,61383,0,61383,258777,0,320160
191412901400000,SW 449,RESIDENTIAL,58144,0,58144,269936,0,328080
191412901500000,SW 449,RESIDENTIAL,52272,0,52272,246557,0,298829
191412901600000,SW 449,RESIDENTIAL,6688,0,6688,0,0,6688
191412901700000,SW 449,RESIDENTIAL,6656,0,6656,0,0,6656
191412901800000,SW 449,RESIDENTIAL,6741,0,6741,0,0,6741
191412901900000,SW 449,RESIDENTIAL,7070,0,7070,0,0,7070
191412902000000,SW 449,RESIDENTIAL,6888,0,6888,0,0,6888
191413000100000,SW 449,RESIDENTIAL,53656,0,53656,216668,0,270324
191413000200000,SW 449,RESIDENTIAL,54313,0,54313,220909,0,275222
191413000300000,SW 449,RESIDENTIAL,56508,0,56508,190076,0,246584
191413000400000,SW 449,RESIDENTIAL,48015,0,48015,237758,0,285773
191413000500000,SW 449,RESIDENTIAL,45980,0,45980,195301,0,241281
191413000600000,SW 449,RESIDENTIAL,52250,0,52250,234063,0,286313
191413000700000,SW 449,RESIDENTIAL,52773,0,52773,178970,0,231743
191413000800000,SW 449,RESIDENTIAL,6946,0,6946,0,0,6946
191413000900000,SW 449,RESIDENTIAL,52250,0,52250,196771,0,249021
191413001000000,SW 449,RESIDENTIAL,52250,0,52250,233068,0,285318
191413001100000,SW 449,RESIDENTIAL,52250,0,52250,225155,0,277405
191413100100000,SW 449,RESIDENTIAL,45980,0,45980,170513,0,216493
191413100200000,SW 449,RESIDENTIAL,7124,0,7124,0,0,7124
191413100300000,SW 449,RESIDENTIAL,5896,0,5896,0,0,5896
191415200200000,SW 422,AG LAND,3909,0,3909,0,0,3909
191415300100000,SW 449,RESIDENTIAL,43560,0,43560,193122,0,236682
191415300200000,SW 449,RESIDENTIAL,246,0,246,0,0,246
191415400100000,SW 449,RESIDENTIAL,45980,0,45980,190446,0,236426
191415400200000,SW 449,RESIDENTIAL,45980,0,45980,8849,0,54829
191415400300000,SW 449,RESIDENTIAL,227,0,227,0,0,227
191415400400000,SW 449,RESIDENTIAL,52250,0,52250,244898,0,297148
191415400500000,SW 449,RESIDENTIAL,52250,0,52250,191967,0,244217
191415400600000,SW 449,RESIDENTIAL,52250,0,52250,222008,0,274258
191415400700000,SW 449,RESIDENTIAL,52800,0,52800,225716,0,278516
191415400800000,SW 449,RESIDENTIAL,67300,0,67300,251630,0,318930
191415400900000,SW 449,RESIDENTIAL,259,0,259,0,0,259
191415401000000,SW 449,RESIDENTIAL,52250,0,52250,164573,0,216823
191415401100000,SW 449,RESIDENTIAL,52250,0,52250,179056,0,231306
191415401200000,SW 449,RESIDENTIAL,47819,0,47819,281115,0,328934
191415401300000,SW 449,RESIDENTIAL,235,0,235,0,0,235
191415401400000,SW 449,RESIDENTIAL,227,0,227,0,0,227
191415401500000,SW 449,RESIDENTIAL,45980,0,45980,3793,0,49773
191415401600000,SW 449,RESIDENTIAL,45980,0,45980,239508,0,285488
191415401700000,SW 449,RESIDENTIAL,52250,0,52250,225168,0,277418
191415401800000,SW 449,RESIDENTIAL,52250,0,52250,223587,0,275837
191415401900000,SW 449,RESIDENTIAL,54450,0,54450,170670,0,225120
191415402000000,SW 449,RESIDENTIAL,53900,0,53900,236447,0,290347
191415402100000,SW 449,RESIDENTIAL,54450,0,54450,255350,0,309800
191415402200000,SW 449,RESIDENTIAL,55128,0,55128,161158,0,216286
191415402300000,SW 449,RESIDENTIAL,404,0,404,0,0,404
191415402400000,SW 449,RESIDENTIAL,53519,0,53519,347284,0,400803
191415402500000,SW 449,RESIDENTIAL,54554,0,54554,166624,0,221178
191415402600000,SW 449,RESIDENTIAL,55907,0,55907,226031,0,281938
191415402700000,SW 449,RESIDENTIAL,55349,0,55349,182390,0,237739
191415402800000,SW 449,RESIDENTIAL,534,0,534,0,0,534
191415402900000,SW 449,RESIDENTIAL,45302,0,45302,6742,0,52044
191415403000000,SW 449,RESIDENTIAL,52978,0,52978,213085,0,266063
191415403100000,SW 449,RESIDENTIAL,38812,0,38812,176290,0,215102
191415403200000,SW 449,RESIDENTIAL,425,0,425,0,0,425
191415403300000,SW 449,RESIDENTIAL,396,0,396,0,0,396
191415403400000,SW 449,RESIDENTIAL,54262,0,54262,173720,0,227982
191415403500000,SW 449,RESIDENTIAL,452,0,452,0,0,452
191415403600000,SW 449,RESIDENTIAL,389,0,389,0,0,389
191415500100000,SW 449,RESIDENTIAL,52250,0,52250,221049,0,273299
191415500200000,SW 449,RESIDENTIAL,50149,0,50149,236864,0,287013
191415500300000,SW 449,RESIDENTIAL,52772,0,52772,266762,0,319534
191415500400000,SW 449,RESIDENTIAL,51080,0,51080,197742,0,248822
191415500500000,SW 449,RESIDENTIAL,52191,0,52191,217459,0,269650
191415500600000,SW 449,RESIDENTIAL,57299,0,57299,250681,0,307980
191415500700000,SW 449,RESIDENTIAL,51568,0,51568,178079,0,229647
191415500800000,SW 449,RESIDENTIAL,48576,0,48576,233193,0,281769
191415500900000,SW 449,RESIDENTIAL,48576,0,48576,199587,0,248163
191415501000000,SW 449,RESIDENTIAL,48576,0,48576,219735,0,268311
191415501100000,SW 449,RESIDENTIAL,48576,0,48576,185911,0,234487
191415501200000,SW 449,RESIDENTIAL,48576,0,48576,193922,0,242498
191415501300000,SW 449,RESIDENTIAL,48070,0,48070,198868,0,246938
191415501400000,SW 449,RESIDENTIAL,51700,0,51700,166986,0,218686
191415600100000,SW 449,RESIDENTIAL,215,0,215,0,0,215
191415600200000,SW 449,RESIDENTIAL,203,0,203,0,0,203
191415600300000,SW 449,RESIDENTIAL,49500,0,49500,241532,0,291032
191415600400000,SW 449,RESIDENTIAL,50600,0,50600,235523,0,286123
191415600500000,SW 449,RESIDENTIAL,52250,0,52250,225577,0,277827
191415600600000,SW 449,RESIDENTIAL,53900,0,53900,204630,0,258530
191415600700000,SW 449,RESIDENTIAL,54450,0,54450,190720,0,245170
191415600800000,SW 449,RESIDENTIAL,54450,0,54450,211290,0,265740
191415600900000,SW 449,RESIDENTIAL,50967,0,50967,302186,0,353153
191415601000000,SW 449,RESIDENTIAL,48091,0,48091,241872,0,289963
191415601100000,SW 449,RESIDENTIAL,46460,0,46460,202949,0,249409
191415601200000,SW 449,RESIDENTIAL,53519,0,53519,237722,0,291241
191415601300000,SW 449,RESIDENTIAL,48884,0,48884,209129,0,258013
191415601400000,SW 449,RESIDENTIAL,417,0,417,0,0,417
191415601500000,SW 449,RESIDENTIAL,400,0,400,0,0,400
191415601600000,SW 449,RESIDENTIAL,383,0,383,0,0,383
191415601700000,SW 449,RESIDENTIAL,389,0,389,0,0,389
191415601800000,SW 449,RESIDENTIAL,377,0,377,0,0,377
191415700100000,SW 449,RESIDENTIAL,517,0,517,0,0,517
191415700200000,SW 449,RESIDENTIAL,55427,0,55427,208739,0,264166
191415700300000,SW 449,RESIDENTIAL,52250,0,52250,227084,0,279334
191415700400000,SW 449,RESIDENTIAL,318,0,318,0,0,318
191415700500000,SW 449,RESIDENTIAL,52283,0,52283,230919,0,283202
191415700600000,SW 449,RESIDENTIAL,319,0,319,0,0,319
191415700700000,SW 449,RESIDENTIAL,53288,0,53288,227585,0,280873
191415700800000,SW 449,RESIDENTIAL,49500,0,49500,170694,0,220194
191415700900000,CITY PROPERTY,EXEMPT,0,0,0,0,0,0
191415800100000,SW 449,RESIDENTIAL,48070,0,48070,225675,0,273745
191415800200000,SW 449,RESIDENTIAL,48593,0,48593,204068,0,252661
191415800300000,SW 449,RESIDENTIAL,48593,0,48593,253753,0,302346
191415800400000,SW 449,RESIDENTIAL,48593,0,48593,213280,0,261873
191415800500000,SW 449,RESIDENTIAL,48593,0,48593,219496,0,268089
191415800600000,SW 449,RESIDENTIAL,49115,0,49115,197343,0,246458
191415800700000,CITY PROPERTY,EXEMPT,0,0,0,0,0,0
191415800800000,CITY PROPERTY,EXEMPT,0,0,0,0,0,0
191415800900000,CITY PROPERTY,EXEMPT,0,0,0,0,0,0
191415801000000,CITY PROPERTY,EXEMPT,0,0,0,0,0,0
191417700200000,SW 449,RESIDENTIAL,50527,0,50527,197564,0,248091
191417700300000,SW 449,RESIDENTIAL,44861,0,44861,262275,0,307136
191417700400000,SW 449,RESIDENTIAL,454,0,454,0,0,454
191417700500000,SW 449,RESIDENTIAL,411,0,411,0,0,411
191417700600000,SW 449,RESIDENTIAL,38609,0,38609,226169,0,264778
191417700700000,SW 449,RESIDENTIAL,530,0,530,0,0,530
191417800100000,SW 449,RESIDENTIAL,49148,0,49148,197933,0,247081
191417800200000,SW 449,RESIDENTIAL,494,0,494,0,0,494
191417800300000,SW 449,RESIDENTIAL,468,0,468,0,0,468
191417800400000,SW 449,RESIDENTIAL,428,0,428,0,0,428
191417900100000,SW 449,RESIDENTIAL,652,0,652,0,0,652
191417900200000,SW 449,RESIDENTIAL,35441,0,35441,215570,0,251011
191417900300000,SW 449,RESIDENTIAL,363,0,363,0,0,363
191417900400000,CITY PROPERTY,EXEMPT,0,0,0,0,0,0
191418000100000,SW 449,RESIDENTIAL,41842,0,41842,174520,0,216362
191418000200000,SW 449,RESIDENTIAL,48070,0,48070,195552,0,243622
191418000300000,SW 449,RESIDENTIAL,48070,0,48070,213213,0,261283
191420100200000,CITY PROPERTY,EXEMPT,0,35000,35000,0,0,35000
191420100300000,SW 449,RESIDENTIAL,47770,0,47770,246718,0,294488
191420100400000,SW 449,RESIDENTIAL,46948,0,46948,157977,0,204925
191420100500000,SW 449,RESIDENTIAL,53350,0,53350,194223,0,247573
191420100600000,SW 449,RESIDENTIAL,52800,0,52800,206300,0,259100
191420100700000,SW 449,RESIDENTIAL,54789,0,54789,234329,0,289118
191420100800000,SW 449,RESIDENTIAL,63595,0,63595,203298,0,266893
191420100900000,SW 449,RESIDENTIAL,57596,0,57596,270159,0,327755
191420101000000,SW 449,RESIDENTIAL,65814,0,65814,269969,0,335783
191420101100000,SW 449,RESIDENTIAL,60977,0,60977,204726,0,265703
191420101200000,SW 449,RESIDENTIAL,53955,0,53955,196655,0,250610
191420101300000,SW 449,RESIDENTIAL,53817,0,53817,182607,0,236424
191420101400000,SW 449,RESIDENTIAL,52250,0,52250,199127,0,251377
191420101500000,SW 449,RESIDENTIAL,54355,0,54355,178248,0,232603
191420101600000,SW 449,RESIDENTIAL,55385,0,55385,210676,0,266061
191420101700000,SW 449,RESIDENTIAL,63692,0,63692,274977,0,338669
191420101800000,SW 449,RESIDENTIAL,53906,0,53906,211618,0,265524
191420101900000,SW 449,RESIDENTIAL,54450,0,54450,218717,0,273167
191420102000000,SW 449,RESIDENTIAL,53900,0,53900,250146,0,304046
191420102100000,SW 449,RESIDENTIAL,53900,0,53900,260659,0,314559
191420102200000,SW 449,RESIDENTIAL,58551,0,58551,211885,0,270436
191420102300000,SW 449,RESIDENTIAL,59717,0,59717,214198,0,273915
191420102400000,SW 449,RESIDENTIAL,56907,0,56907,204976,0,261883
191420102900000,SW 450,RESIDENTIAL,360000,0,360000,0,0,360000
191420200100000,SW 449,RESIDENTIAL,54340,0,54340,236550,0,290890
191420200200000,SW 449,RESIDENTIAL,55000,0,55000,234397,0,289397
191420200300000,SW 449,RESIDENTIAL,55678,0,55678,185859,0,241537
191420200400000,SW 449,RESIDENTIAL,52250,0,52250,196041,0,248291
191420200500000,SW 449,RESIDENTIAL,6984,0,6984,0,0,6984
191420200600000,SW 449,RESIDENTIAL,7438,0,7438,0,0,7438
191420200700000,SW 449,RESIDENTIAL,6749,0,6749,0,0,6749
191420200800000,SW 449,RESIDENTIAL,6749,0,6749,0,0,6749
191420200900000,SW 449,RESIDENTIAL,6511,0,6511,0,0,6511
191420201000000,SW 449,RESIDENTIAL,6856,0,6856,0,0,6856
191420300100000,SW 450,RESIDENTIAL,283,0,283,0,0,283
191420300200000,SW 450,RESIDENTIAL,814,0,814,0,0,814
191420300300000,SW 450,RESIDENTIAL,831,0,831,0,0,831
191420300400000,SW 450,RESIDENTIAL,416,0,416,0,0,416
191420300500000,SW 450,AG LAND,7989,0,7989,0,0,7989
191422600100000,SW 456,AG DWELLING,51020,0,51020,58785,6435,116240
191422600200000,SW 456,RESIDENTIAL,66000,0,66000,85256,0,151256
191422700100000,SW 450,RESIDENTIAL,40013,0,40013,142606,0,182619
191422700200000,SW 450,RESIDENTIAL,40013,0,40013,149159,0,189172
191422700300000,SW 450,RESIDENTIAL,35211,0,35211,3915,0,39126
191422700400000,SW 450,RESIDENTIAL,266,0,266,0,0,266
191422800100000,SW 450,RESIDENTIAL,40013,0,40013,139941,0,179954
191422800200000,SW 450,RESIDENTIAL,34678,0,34678,140030,0,174708
191422800300000,SW 450,RESIDENTIAL,37612,0,37612,146947,0,184559
191422800400000,SW 450,RESIDENTIAL,37612,0,37612,151290,0,188902
191422800500000,SW 450,RESIDENTIAL,35211,0,35211,153401,0,188612
191422800600000,SW 450,RESIDENTIAL,35211,0,35211,154244,0,189455
191422800700000,SW 450,RESIDENTIAL,35211,0,35211,155959,0,191170
191422800800000,SW 450,RESIDENTIAL,35211,0,35211,154659,0,189870
191422800900000,SW 450,RESIDENTIAL,39746,0,39746,144680,0,184426
191422801000000,SW 450,RESIDENTIAL,40013,0,40013,154831,0,194844
191422801100000,SW 450,RESIDENTIAL,35211,0,35211,162571,0,197782
191422801200000,SW 450,RESIDENTIAL,35211,0,35211,140307,0,175518
191422801300000,SW 450,RESIDENTIAL,35211,0,35211,146646,0,181857
191422801400000,SW 450,RESIDENTIAL,35211,0,35211,149360,0,184571
191422801500000,SW 450,RESIDENTIAL,37879,0,37879,146895,0,184774
191422801600000,SW 450,RESIDENTIAL,37879,0,37879,103705,0,141584
191422801700000,SW 450,RESIDENTIAL,266,0,266,0,0,266
191422801800000,SW 450,RESIDENTIAL,316,0,316,0,0,316
191422900100000,SW 450,RESIDENTIAL,35035,0,35035,144198,0,179233
191422900300000,SW 450,RESIDENTIAL,35393,0,35393,151138,0,186531
191422900400000,SW 450,RESIDENTIAL,35393,0,35393,149590,0,184983
191422900500000,SW 450,RESIDENTIAL,700,0,700,0,0,700
191423000100000,SW 450,RESIDENTIAL,43120,0,43120,147634,0,190754
191423000200000,SW 450,RESIDENTIAL,40838,0,40838,203787,0,244625
191423000300000,SW 450,RESIDENTIAL,38850,0,38850,146015,0,184865
191423000400000,SW 450,RESIDENTIAL,35937,0,35937,151362,0,187299
191423000500000,SW 450,RESIDENTIAL,36264,0,36264,150627,0,186891
191423000600000,SW 450,RESIDENTIAL,38115,0,38115,148680,0,186795
191423000700000,SW 450,RESIDENTIAL,40838,0,40838,147102,0,187940
191423000800000,SW 450,RESIDENTIAL,910,0,910,0,0,910
191423200100000,SW 450,RESIDENTIAL,5917,0,5917,0,0,5917
191425100300000,SW 456,AG LAND,54884,0,54884,0,0,54884
191425100400000,SW 456,AG LAND,22393,0,22393,0,0,22393
191427600300000,SW 449,RESIDENTIAL,5380,0,5380,0,0,5380
191427600500000,SW 456,AG LAND,88962,0,88962,0,0,88962
191427700100000,SW 450,RESIDENTIAL,282,0,282,0,0,282
191427700200000,SW 450,RESIDENTIAL,316,0,316,0,0,316
191510100200000,OFFICE,COMMERCIAL,0,3553800,3553800,0,21451058,25004858
191510100300000,OFFICE,COMMERCIAL,0,1066500,1066500,0,15065072,16131572
191520100100000,EDUCATIONAL/COLLEGE,EXEMPT,0,0,0,0,0,0
191525100100000,EDUCATIONAL/COLLEGE,EXEMPT,0,0,0,0,0,0
191530100101000,WAREHOUSE,COMMERCIAL,0,30267,30267,0,473606,503873
191530100101001,EDUCATIONAL/COLLEGE,EXEMPT,0,0,0,0,0,0
191530100101002,EDUCATIONAL/COLLEGE,EXEMPT,0,0,0,0,0,0
191530100101003,WAREHOUSE,COMMERCIAL,0,5151,5151,0,28921,34072
191530100102000,ANTENNAS/TOWERS(BLL),COMMERCIAL,0,0,0,0,7554,7554
191530100102001,ANTENNAS/TOWERS(BLL),COMMERCIAL,0,0,0,0,2651,2651
191530100102002,ANTENNAS/TOWERS(BLL),COMMERCIAL,0,0,0,0,3552,3552
191530100102003,ANTENNAS/TOWERS(BLL),COMMERCIAL,0,0,0,0,5303,5303
191530100102004,ANTENNAS/TOWERS(BLL),COMMERCIAL,0,0,0,0,2786,2786
191530100200000,CITY PROPERTY,EXEMPT,0,0,0,0,0,0
191530100300000,EDUCATIONAL/COLLEGE,EXEMPT,0,0,0,0,0,0
191532600100000,OFFICE,COMMERCIAL,0,315400,315400,0,3878497,4193897
191535100100000,CITY PROPERTY,EXEMPT,0,0,0,0,0,0
191540100300000,EDUCATIONAL/COLLEGE,EXEMPT,0,26521,26521,0,0,26521
191540200100000,SW 456,AG LAND,72939,0,72939,0,0,72939
191540200201237,NBHD SHOPPING CENTER,COMMERCIAL,0,4216,4216,0,38620,42836
191540200201238,NBHD SHOPPING CENTER,COMMERCIAL,0,4216,4216,0,38620,42836
191547600100000,EDUCATIONAL/COLLEGE,EXEMPT,0,56767,56767,0,0,56767
191547600300000,CITY PROPERTY,EXEMPT,0,0,0,0,0,0
191610100100000,SW 426,RESIDENTIAL,26054,0,26054,100532,0,126586
191610100200000,SW 426,RESIDENTIAL,25380,0,25380,89097,0,114477
191610100300000,SW 426,RESIDENTIAL,25380,0,25380,101009,0,126389
191610100400000,SW 426,RESIDENTIAL,25380,0,25380,87766,0,113146
191610100500000,SW 426,RESIDENTIAL,25380,0,25380,107455,0,132835
191610100600000,SW 426,RESIDENTIAL,25380,0,25380,95356,0,120736
191610100700000,SW 426,RESIDENTIAL,25028,0,25028,74658,0,99686
191610100800000,SW 426,RESIDENTIAL,25028,0,25028,107136,0,132164
191610100900000,SW 426,RESIDENTIAL,25028,0,25028,97551,0,122579
191610101000000,SW 426,RESIDENTIAL,25028,0,25028,97687,0,122715
191610101100000,SW 426,RESIDENTIAL,25028,0,25028,108012,0,133040
191610101200000,SW 426,RESIDENTIAL,25028,0,25028,86026,0,111054
191610101300000,SW 426,RESIDENTIAL,25028,0,25028,89148,0,114176
191610101400000,SW 426,RESIDENTIAL,25028,0,25028,79550,0,104578
191610101500000,SW 426,RESIDENTIAL,27990,0,27990,79833,0,107823
191610101600000,SW 426,RESIDENTIAL,27930,0,27930,106182,0,134112
191610101700000,SW 426,RESIDENTIAL,27664,0,27664,144974,0,172638
191610101800000,SW 426,RESIDENTIAL,26502,0,26502,70551,0,97053
191610101900000,SW 426,RESIDENTIAL,24675,0,24675,108748,0,133423
191610102000000,SW 426,RESIDENTIAL,24675,0,24675,89465,0,114140
191610102100000,SW 426,RESIDENTIAL,24675,0,24675,60925,0,85600
191610102200000,SW 426,RESIDENTIAL,24675,0,24675,96766,0,121441
191610102300000,SW 426,RESIDENTIAL,24675,0,24675,85248,0,109923
191610102400000,SW 426,RESIDENTIAL,24691,0,24691,66697,0,91388
191610200100000,SW 426,RESIDENTIAL,24307,0,24307,98040,0,122347
191610200200000,SW 426,RESIDENTIAL,23970,0,23970,103365,0,127335
191610200300000,SW 426,RESIDENTIAL,23970,0,23970,61018,0,84988
191610200400000,SW 426,RESIDENTIAL,23970,0,23970,95340,0,119310
191610200500000,SW 426,RESIDENTIAL,23970,0,23970,83691,0,107661
191610200600000,SW 426,RESIDENTIAL,24338,0,24338,102641,0,126979
191610200700000,SW 426,RESIDENTIAL,19575,0,19575,102868,0,122443
191610200800000,SW 426,RESIDENTIAL,19575,0,19575,105169,0,124744
191610200900000,SW 426,RESIDENTIAL,19575,0,19575,117326,0,136901
191610201000000,SW 426,RESIDENTIAL,20719,0,20719,115469,0,136188
191610201100000,SW 426,RESIDENTIAL,17750,0,17750,107148,0,124898
191610201200000,SW 426,RESIDENTIAL,21631,0,21631,123645,0,145276
191610201300000,SW 426,RESIDENTIAL,20403,0,20403,118379,0,138782
191610201400000,SW 426,RESIDENTIAL,18212,0,18212,105771,0,123983
191610201500000,SW 426,RESIDENTIAL,17827,0,17827,109235,0,127062
191610201600000,SW 426,RESIDENTIAL,19572,0,19572,108054,0,127626
191610201700000,SW 426,RESIDENTIAL,19350,0,19350,104581,0,123931
191610201800000,SW 426,RESIDENTIAL,19125,0,19125,107812,0,126937
191610201900000,SW 426,RESIDENTIAL,19125,0,19125,107067,0,126192
191610202000000,SW 426,RESIDENTIAL,20280,0,20280,126078,0,146358
191610202100000,SW 426,RESIDENTIAL,21450,0,21450,105306,0,126756
191610202200000,SW 426,RESIDENTIAL,21450,0,21450,131526,0,152976
191610202300000,SW 426,RESIDENTIAL,21450,0,21450,115756,0,137206
191610202400000,SW 426,RESIDENTIAL,21385,0,21385,129880,0,151265
191610202500000,SW 426,RESIDENTIAL,27255,0,27255,90699,0,117954
191610202600000,SW 426,RESIDENTIAL,26551,0,26551,116586,0,143137
191610202700000,SW 426,RESIDENTIAL,25979,0,25979,100316,0,126295
191610202800000,SW 426,RESIDENTIAL,21827,0,21827,85520,0,107347
191610202900000,SW 426,RESIDENTIAL,20057,0,20057,66205,0,86262
191610203000000,SW 426,RESIDENTIAL,21190,0,21190,76406,0,97596
191610203100000,SW 426,RESIDENTIAL,21527,0,21527,73070,0,94597
191610203200000,CITY PROPERTY,EXEMPT,0,0,0,0,0,0
191610203300000,SW 426,RESIDENTIAL,59660,0,59660,80469,0,140129
191610300100000,SW 426,RESIDENTIAL,25842,0,25842,86578,0,112420
191610300200000,SW 426,RESIDENTIAL,25463,0,25463,80334,0,105797
191610300300000,SW 426,RESIDENTIAL,25137,0,25137,96342,0,121479
191610300400000,SW 426,RESIDENTIAL,25083,0,25083,107186,0,132269
191610300500000,SW 426,RESIDENTIAL,26982,0,26982,65943,0,92925
191610300600000,SW 426,RESIDENTIAL,26460,0,26460,39462,0,65922
191610300700000,SW 426,RESIDENTIAL,26460,0,26460,76490,0,102950
191610300800000,SW 426,RESIDENTIAL,26460,0,26460,74282,0,100742
191610300900000,SW 426,RESIDENTIAL,25650,0,25650,72947,0,98597
191610301000000,SW 426,RESIDENTIAL,27906,0,27906,83609,0,111515
191610301100000,SW 426,RESIDENTIAL,26717,0,26717,84104,0,110821
191610301200000,SW 426,RESIDENTIAL,24413,0,24413,83218,0,107631
191610301300000,SW 426,RESIDENTIAL,31317,0,31317,97524,0,128841
191610301400000,SW 426,RESIDENTIAL,24158,0,24158,108972,0,133130
191610301500000,SW 426,RESIDENTIAL,20093,0,20093,105391,0,125484
191610301600000,SW 426,RESIDENTIAL,20213,0,20213,104404,0,124617
191610301700000,SW 426,RESIDENTIAL,20213,0,20213,105950,0,126163
191610301800000,SW 426,RESIDENTIAL,20213,0,20213,100268,0,120481
191610301900000,SW 426,RESIDENTIAL,20213,0,20213,103067,0,123280
191610302000000,SW 426,RESIDENTIAL,20213,0,20213,132654,0,152867
191610302100000,SW 426,RESIDENTIAL,1045,0,1045,0,0,1045
191610400100000,SW 426,RESIDENTIAL,26278,0,26278,80112,0,106390
191610400200000,SW 426,RESIDENTIAL,25463,0,25463,107119,0,132582
191610400300000,SW 426,RESIDENTIAL,25463,0,25463,90441,0,115904
191610400400000,SW 426,RESIDENTIAL,26606,0,26606,89640,0,116246
191610400500000,SW 426,RESIDENTIAL,25407,0,25407,101866,0,127273
191610400600000,SW 426,RESIDENTIAL,26250,0,26250,66256,0,92506
191610400700000,SW 426,RESIDENTIAL,26250,0,26250,65981,0,92231
191610400800000,SW 426,RESIDENTIAL,26250,0,26250,70325,0,96575
191610400900000,SW 426,RESIDENTIAL,26763,0,26763,70948,0,97711
191610401000000,SW 426,RESIDENTIAL,30489,0,30489,59776,0,90265
191610401100000,SW 426,RESIDENTIAL,17062,0,17062,0,0,17062
191610401200000,SW 426,RESIDENTIAL,17062,0,17062,79779,0,96841
191610401300000,SW 426,RESIDENTIAL,26250,0,26250,76737,0,102987
191610401400000,SW 426,RESIDENTIAL,26645,0,26645,103933,0,130578
191610500100000,SW 426,RESIDENTIAL,25746,0,25746,77187,0,102933
191610500200000,SW 426,RESIDENTIAL,25746,0,25746,125468,0,151214
191610500300000,SW 426,RESIDENTIAL,25746,0,25746,80679,0,106425
191610500400000,SW 426,RESIDENTIAL,25746,0,25746,67843,0,93589
191610500500000,SW 426,RESIDENTIAL,25746,0,25746,104522,0,130268
191610500600000,SW 426,RESIDENTIAL,25746,0,25746,75329,0,101075
191610500700000,SW 426,RESIDENTIAL,25746,0,25746,65723,0,91469
191610500800000,SW 426,RESIDENTIAL,26506,0,26506,81418,0,107924
191610500900000,SW 426,RESIDENTIAL,25557,0,25557,67751,0,93308
191610501000000,SW 426,RESIDENTIAL,26775,0,26775,79462,0,106237
191610501100000,SW 426,RESIDENTIAL,23996,0,23996,68795,0,92791
191610501200000,SW 426,RESIDENTIAL,24131,0,24131,81088,0,105219
191610501300000,SW 426,RESIDENTIAL,24829,0,24829,82449,0,107278
191610501500000,SW 426,RESIDENTIAL,25717,0,25717,109407,0,135124
191610501600000,SW 426,RESIDENTIAL,24201,0,24201,109407,0,133608
191610501700000,SW 426,RESIDENTIAL,26989,0,26989,109407,0,136396
191610501800000,SW 426,RESIDENTIAL,24639,0,24639,105781,0,130420
191610501900000,SW 426,RESIDENTIAL,21474,0,21474,105781,0,127255
191610502000000,SW 426,RESIDENTIAL,27232,0,27232,109407,0,136639
191610502100000,SW 426,RESIDENTIAL,27540,0,27540,140699,0,168239
191610502200000,SW 426,RESIDENTIAL,26772,0,26772,140699,0,167471
191610502300000,SW 426,RESIDENTIAL,24555,0,24555,108760,0,133315
191610502400000,SW 426,RESIDENTIAL,26791,0,26791,140699,0,167490
191610502500000,SW 426,RESIDENTIAL,23490,0,23490,112485,0,135975
191610502600000,SW 426,RESIDENTIAL,27622,0,27622,112485,0,140107
191610502700000,SW 426,RESIDENTIAL,26655,0,26655,112485,0,139140
191610502800000,SW 426,RESIDENTIAL,23607,0,23607,112485,0,136092
191610600100000,SW 426,RESIDENTIAL,23954,0,23954,86983,0,110937
191610600200000,SW 426,RESIDENTIAL,23970,0,23970,65432,0,89402
191610600300000,SW 426,RESIDENTIAL,23970,0,23970,79088,0,103058
191610600400000,SW 426,RESIDENTIAL,25800,0,25800,112485,0,138285
191610600500000,CITY PROPERTY,EXEMPT,0,0,0,0,0,0
191612600100000,SW 426,RESIDENTIAL,20918,0,20918,75155,0,96073
191612600200000,SW 426,RESIDENTIAL,21061,0,21061,78724,0,99785
191612600300000,SW 426,RESIDENTIAL,21061,0,21061,63711,0,84772
191612600400000,SW 426,RESIDENTIAL,21061,0,21061,82005,0,103066
191612600500000,SW 426,RESIDENTIAL,21061,0,21061,72384,0,93445
191612600600000,SW 426,RESIDENTIAL,21061,0,21061,102396,0,123457
191612600700000,SW 426,RESIDENTIAL,21061,0,21061,83568,0,104629
191612600800000,SW 426,RESIDENTIAL,19869,0,19869,87781,0,107650
191612600900000,SW 426,RESIDENTIAL,24614,0,24614,120536,0,145150
191612700100000,SW 426,RESIDENTIAL,21250,0,21250,63121,0,84371
191612700200000,SW 426,RESIDENTIAL,21060,0,21060,70341,0,91401
191612700300000,SW 426,RESIDENTIAL,21060,0,21060,84565,0,105625
191612700400000,SW 426,RESIDENTIAL,21060,0,21060,83760,0,104820
191612700500000,SW 426,RESIDENTIAL,21060,0,21060,92687,0,113747
191612700600000,SW 426,RESIDENTIAL,21060,0,21060,87710,0,108770
191612700700000,SW 426,RESIDENTIAL,21060,0,21060,85703,0,106763
191612700800000,SW 426,RESIDENTIAL,21060,0,21060,68084,0,89144
191612700900000,SW 426,RESIDENTIAL,20995,0,20995,81170,0,102165
191612701000000,SW 426,RESIDENTIAL,21250,0,21250,91281,0,112531
191612701100000,CITY PROPERTY,EXEMPT,0,0,0,0,0,0
191612701200000,CITY PROPERTY,EXEMPT,0,0,0,0,0,0
191612701300000,SW 426,RESIDENTIAL,21250,0,21250,120763,0,142013
191612701400000,SW 426,RESIDENTIAL,21250,0,21250,70407,0,91657
191612701500000,SW 426,RESIDENTIAL,21250,0,21250,74001,0,95251
191612800100000,SW 426,RESIDENTIAL,21250,0,21250,71517,0,92767
191612800200000,SW 426,RESIDENTIAL,21250,0,21250,76821,0,98071
191612800300000,SW 426,RESIDENTIAL,21250,0,21250,67269,0,88519
191612800400000,SW 426,RESIDENTIAL,21250,0,21250,77513,0,98763
191612800500000,SW 426,RESIDENTIAL,21250,0,21250,88076,0,109326
191612800600000,SW 426,RESIDENTIAL,21250,0,21250,96529,0,117779
191612800700000,SW 426,RESIDENTIAL,24300,0,24300,79430,0,103730
191612800800000,SW 426,RESIDENTIAL,21784,0,21784,75766,0,97550
191612800900000,SW 426,RESIDENTIAL,21180,0,21180,103787,0,124967
191612801000000,SW 426,RESIDENTIAL,21250,0,21250,81953,0,103203
191612801100000,SW 426,RESIDENTIAL,21250,0,21250,93989,0,115239
191612801200000,SW 426,RESIDENTIAL,21250,0,21250,75519,0,96769
191612801300000,SW 426,RESIDENTIAL,21250,0,21250,80148,0,101398
191612900100000,SW 426,RESIDENTIAL,21250,0,21250,88896,0,110146
191612900200000,SW 426,RESIDENTIAL,21250,0,21250,75019,0,96269
191612900300000,SW 426,RESIDENTIAL,21250,0,21250,76992,0,98242
191612900400000,SW 426,RESIDENTIAL,21250,0,21250,65266,0,86516
191612900500000,SW 426,RESIDENTIAL,21250,0,21250,71456,0,92706
191612900600000,SW 426,RESIDENTIAL,21250,0,21250,120740,0,141990
191612900700000,SW 426,RESIDENTIAL,21250,0,21250,80772,0,102022
191612900800000,SW 426,RESIDENTIAL,21250,0,21250,86999,0,108249
191612900900000,SW 426,RESIDENTIAL,21250,0,21250,80868,0,102118
191612901000000,SW 426,RESIDENTIAL,21250,0,21250,131973,0,153223
191612901100000,SW 426,RESIDENTIAL,21250,0,21250,96945,0,118195
191613000100000,SW 426,RESIDENTIAL,22056,0,22056,79248,0,101304
191613000200000,SW 426,RESIDENTIAL,21037,0,21037,81458,0,102495
191613000300000,SW 426,RESIDENTIAL,1725,0,1725,0,0,1725
191613000400000,SW 426,RESIDENTIAL,1725,0,1725,0,0,1725
191613000500000,SW 426,RESIDENTIAL,22100,0,22100,100631,0,122731
191613000600000,SW 426,RESIDENTIAL,21250,0,21250,86873,0,108123
191613000700000,SW 426,RESIDENTIAL,21250,0,21250,76271,0,97521
191613000800000,SW 426,RESIDENTIAL,21037,0,21037,72356,0,93393
191613000900000,SW 426,RESIDENTIAL,1725,0,1725,0,0,1725
191613001000000,SW 426,RESIDENTIAL,21037,0,21037,83071,0,104108
191613001100000,SW 426,RESIDENTIAL,22093,0,22093,106472,0,128565
191613100100000,SW 426,RESIDENTIAL,20727,0,20727,91629,0,112356
191613100200000,SW 426,RESIDENTIAL,21210,0,21210,75674,0,96884
191613100300000,SW 426,RESIDENTIAL,22356,0,22356,108132,0,130488
191613100400000,SW 426,RESIDENTIAL,21462,0,21462,87518,0,108980
191613100500000,SW 426,RESIDENTIAL,21250,0,21250,88063,0,109313
191613100600000,SW 426,RESIDENTIAL,21250,0,21250,86540,0,107790
191613100700000,SW 426,RESIDENTIAL,21250,0,21250,96482,0,117732
191613100800000,SW 426,RESIDENTIAL,13358,0,13358,85370,0,98728
191613100900000,SW 426,RESIDENTIAL,14000,0,14000,88678,0,102678
191613101000000,SW 426,RESIDENTIAL,21444,0,21444,92422,0,113866
191613101100000,SW 426,RESIDENTIAL,21250,0,21250,101344,0,122594
191613101200000,SW 426,RESIDENTIAL,21250,0,21250,91074,0,112324
191613101300000,SW 426,RESIDENTIAL,21250,0,21250,87725,0,108975
191613200100000,SW 426,RESIDENTIAL,21250,0,21250,74927,0,96177
191613200200000,SW 426,RESIDENTIAL,21250,0,21250,64735,0,85985
191613200300000,SW 426,RESIDENTIAL,21250,0,21250,83574,0,104824
191613200400000,SW 426,RESIDENTIAL,21250,0,21250,84833,0,106083
191613200500000,SW 426,RESIDENTIAL,21250,0,21250,75853,0,97103
191613200600000,SW 426,RESIDENTIAL,21250,0,21250,78060,0,99310
191613200700000,SW 426,RESIDENTIAL,21250,0,21250,87670,0,108920
191613200800000,SW 426,RESIDENTIAL,21363,0,21363,90253,0,111616
191613200900000,SW 426,RESIDENTIAL,21106,0,21106,85302,0,106408
191613201000000,SW 426,RESIDENTIAL,21250,0,21250,93773,0,115023
191613201100000,SW 426,RESIDENTIAL,21250,0,21250,96053,0,117303
191613201200000,SW 426,RESIDENTIAL,21250,0,21250,80354,0,101604
191613201300000,SW 426,RESIDENTIAL,21250,0,21250,81754,0,103004
191613300100000,SW 426,RESIDENTIAL,21713,0,21713,81858,0,103571
191613300200000,SW 426,RESIDENTIAL,1850,0,1850,0,0,1850
191613300300000,SW 426,RESIDENTIAL,1830,0,1830,0,0,1830
191613300400000,SW 426,RESIDENTIAL,21499,0,21499,78535,0,100034
191613300500000,SW 426,RESIDENTIAL,21294,0,21294,97593,0,118887
191613300600000,SW 426,RESIDENTIAL,21294,0,21294,90186,0,111480
191615200100000,SW 451,RESIDENTIAL,37787,0,37787,171279,0,209066
191615200200000,CITY PROPERTY,EXEMPT,0,0,0,0,0,0
191615200300000,SW 451,RESIDENTIAL,32100,0,32100,121010,0,153110
191615200400000,SW 451,RESIDENTIAL,34200,0,34200,123861,0,158061
191615200500000,SW 451,RESIDENTIAL,30576,0,30576,135095,0,165671
191615200600000,SW 451,RESIDENTIAL,29440,0,29440,133378,0,162818
191615200700000,SW 451,RESIDENTIAL,27270,0,27270,114189,0,141459
191615200800000,SW 451,RESIDENTIAL,24240,0,24240,110465,0,134705
191615200900000,SW 451,RESIDENTIAL,32000,0,32000,125255,0,157255
191615201000000,SW 451,RESIDENTIAL,31680,0,31680,135316,0,166996
191615201100000,SW 451,RESIDENTIAL,24800,0,24800,135471,0,160271
191615201200000,SW 451,RESIDENTIAL,25296,0,25296,108947,0,134243
191615201300000,SW 451,RESIDENTIAL,25296,0,25296,108947,0,134243
191615201400000,SW 451,RESIDENTIAL,25296,0,25296,109012,0,134308
191615201500000,SW 451,RESIDENTIAL,27200,0,27200,107378,0,134578
191615300100000,SW 451,RESIDENTIAL,29160,0,29160,117220,0,146380
191615300200000,SW 451,RESIDENTIAL,24800,0,24800,132429,0,157229
191615300300000,SW 451,RESIDENTIAL,24800,0,24800,128931,0,153731
191615300400000,SW 451,RESIDENTIAL,24800,0,24800,136067,0,160867
191615300500000,SW 451,RESIDENTIAL,24800,0,24800,133360,0,158160
191615300600000,SW 451,RESIDENTIAL,24800,0,24800,139376,0,164176
191615300700000,SW 451,RESIDENTIAL,24800,0,24800,148354,0,173154
191615300800000,SW 451,RESIDENTIAL,24800,0,24800,139401,0,164201
191615300900000,SW 451,RESIDENTIAL,24800,0,24800,114086,0,138886
191615301000000,SW 451,RESIDENTIAL,32000,0,32000,124898,0,156898
191615301100000,SW 451,RESIDENTIAL,32400,0,32400,94594,0,126994
191615301200000,SW 451,RESIDENTIAL,24800,0,24800,103988,0,128788
191615301300000,SW 451,RESIDENTIAL,24800,0,24800,94594,0,119394
191615301400000,SW 451,RESIDENTIAL,24800,0,24800,94594,0,119394
191615301500000,SW 451,RESIDENTIAL,24800,0,24800,94594,0,119394
191615301600000,SW 451,RESIDENTIAL,24800,0,24800,102401,0,127201
191615301700000,SW 451,RESIDENTIAL,24800,0,24800,94594,0,119394
191615301800000,SW 451,RESIDENTIAL,24800,0,24800,98936,0,123736
191615301900000,SW 451,RESIDENTIAL,24800,0,24800,131354,0,156154
191615302000000,SW 451,RESIDENTIAL,4567,0,4567,0,0,4567
191615400100000,SW 451,RESIDENTIAL,8850,0,8850,0,0,8850
191615400200000,SW 451,RESIDENTIAL,26000,0,26000,131005,0,157005
191615400300000,SW 451,RESIDENTIAL,32400,0,32400,133509,0,165909
191615400400000,SW 451,RESIDENTIAL,24800,0,24800,124869,0,149669
191615400500000,SW 451,RESIDENTIAL,24800,0,24800,124513,0,149313
191615400600000,SW 451,RESIDENTIAL,24800,0,24800,116024,0,140824
191615400700000,SW 451,RESIDENTIAL,24800,0,24800,126007,0,150807
191615400800000,SW 451,RESIDENTIAL,24800,0,24800,126691,0,151491
191615400900000,SW 451,RESIDENTIAL,24800,0,24800,113393,0,138193
191615401000000,SW 451,RESIDENTIAL,24800,0,24800,119128,0,143928
191615401100000,SW 451,RESIDENTIAL,24800,0,24800,120998,0,145798
191615401200000,SW 451,RESIDENTIAL,30400,0,30400,121177,0,151577
191615401300000,SW 451,RESIDENTIAL,33264,0,33264,126831,0,160095
191615401400000,SW 451,RESIDENTIAL,31762,0,31762,120841,0,152603
191615401500000,SW 451,RESIDENTIAL,34153,0,34153,103841,0,137994
191615401600000,SW 451,RESIDENTIAL,31973,0,31973,148702,0,180675
191615401700000,SW 451,RESIDENTIAL,29970,0,29970,126282,0,156252
191615401800000,SW 451,RESIDENTIAL,26069,0,26069,110465,0,136534
191615401900000,SW 451,RESIDENTIAL,25856,0,25856,134557,0,160413
191615402000000,SW 451,RESIDENTIAL,25600,0,25600,116273,0,141873
191615402100000,SW 451,RESIDENTIAL,25600,0,25600,127168,0,152768
191615402200000,SW 451,RESIDENTIAL,25600,0,25600,118689,0,144289
191615402300000,SW 451,RESIDENTIAL,3671,0,3671,0,0,3671
191615402400000,SW 451,RESIDENTIAL,3670,0,3670,0,0,3670
191615402500000,SW 451,RESIDENTIAL,4184,0,4184,0,0,4184
191615500100000,SW 451,RESIDENTIAL,31008,0,31008,117324,0,148332
191615500200000,SW 451,RESIDENTIAL,25792,0,25792,109327,0,135119
191615500300000,SW 451,RESIDENTIAL,26040,0,26040,125859,0,151899
191615500400000,SW 451,RESIDENTIAL,25296,0,25296,135178,0,160474
191615500500000,SW 451,RESIDENTIAL,25048,0,25048,132833,0,157881
191615500600000,SW 451,RESIDENTIAL,30400,0,30400,120076,0,150476
191615500700000,CITY PROPERTY,EXEMPT,0,0,0,0,0,0
191615500900000,SW 451,RESIDENTIAL,29784,0,29784,129290,0,159074
191615501000000,SW 451,RESIDENTIAL,34997,0,34997,113798,0,148795
191615501100000,SW 451,RESIDENTIAL,30400,0,30400,115490,0,145890
191615600100000,SW 451,RESIDENTIAL,32440,0,32440,147883,0,180323
191615600200000,SW 451,RESIDENTIAL,24800,0,24800,94594,0,119394
191615600300000,SW 451,RESIDENTIAL,24800,0,24800,146592,0,171392
191615600400000,SW 451,RESIDENTIAL,24800,0,24800,131869,0,156669
191615600500000,SW 451,RESIDENTIAL,24800,0,24800,135768,0,160568
191615600600000,SW 451,RESIDENTIAL,24800,0,24800,144204,0,169004
191615600700000,SW 451,RESIDENTIAL,24800,0,24800,129795,0,154595
191615600800000,SW 451,RESIDENTIAL,24800,0,24800,146174,0,170974
191615600900000,SW 451,RESIDENTIAL,24800,0,24800,136583,0,161383
191615601000000,SW 451,RESIDENTIAL,4567,0,4567,0,0,4567
191615601100000,SW 451,RESIDENTIAL,4567,0,4567,0,0,4567
191615601200000,SW 451,RESIDENTIAL,3539,0,3539,0,0,3539
191615601300000,SW 451,RESIDENTIAL,3539,0,3539,0,0,3539
191615601400000,SW 451,RESIDENTIAL,24800,0,24800,126498,0,151298
191615601500000,SW 451,RESIDENTIAL,24800,0,24800,125328,0,150128
191615601600000,SW 451,RESIDENTIAL,24800,0,24800,128747,0,153547
191615601700000,SW 451,RESIDENTIAL,24800,0,24800,3645,0,28445
191615601800000,SW 451,RESIDENTIAL,3539,0,3539,0,0,3539
191615601900000,SW 451,RESIDENTIAL,3539,0,3539,0,0,3539
191615602000000,SW 451,RESIDENTIAL,32400,0,32400,128175,0,160575
191615700100000,SW 451,RESIDENTIAL,4225,0,4225,0,0,4225
191615700200000,SW 451,RESIDENTIAL,3663,0,3663,0,0,3663
191615700300000,SW 451,RESIDENTIAL,3719,0,3719,0,0,3719
191615700400000,SW 451,RESIDENTIAL,3660,0,3660,0,0,3660
191615700500000,SW 451,RESIDENTIAL,3715,0,3715,0,0,3715
191615700600000,SW 451,RESIDENTIAL,3657,0,3657,0,0,3657
191615700700000,SW 451,RESIDENTIAL,4141,0,4141,0,0,4141
191615700800000,SW 451,RESIDENTIAL,4219,0,4219,0,0,4219
191615800100000,CITY PROPERTY,EXEMPT,0,0,0,0,0,0
191615800200000,SW 451,RESIDENTIAL,5629,0,5629,0,0,5629
191615800300000,SW 451,RESIDENTIAL,4443,0,4443,0,0,4443
191615800400000,SW 451,RESIDENTIAL,4130,0,4130,0,0,4130
191615800500000,SW 451,RESIDENTIAL,4087,0,4087,0,0,4087
191615800600000,SW 451,RESIDENTIAL,4044,0,4044,0,0,4044
191615800700000,SW 451,RESIDENTIAL,4504,0,4504,0,0,4504
191615800800000,SW 451,RESIDENTIAL,3996,0,3996,0,0,3996
191615800900000,SW 451,RESIDENTIAL,3595,0,3595,0,0,3595
191615801000000,SW 451,RESIDENTIAL,3877,0,3877,0,0,3877
191615801100000,SW 451,RESIDENTIAL,4214,0,4214,0,0,4214
191615801200000,SW 451,RESIDENTIAL,4533,0,4533,0,0,4533
191615900100000,SW 451,RESIDENTIAL,4635,0,4635,0,0,4635
191615900200000,SW 451,RESIDENTIAL,5087,0,5087,0,0,5087
191615900300000,SW 451,RESIDENTIAL,3842,0,3842,0,0,3842
191615900400000,SW 451,RESIDENTIAL,3799,0,3799,0,0,3799
191615900500000,SW 451,RESIDENTIAL,3756,0,3756,0,0,3756
191615900600000,SW 451,RESIDENTIAL,3714,0,3714,0,0,3714
191615900700000,SW 451,RESIDENTIAL,3671,0,3671,0,0,3671
191615900800000,SW 451,RESIDENTIAL,3628,0,3628,0,0,3628
191615900900000,SW 451,RESIDENTIAL,3585,0,3585,0,0,3585
191615901000000,SW 451,RESIDENTIAL,3542,0,3542,0,0,3542
191615901100000,SW 451,RESIDENTIAL,4508,0,4508,0,0,4508
191615901200000,SW 451,RESIDENTIAL,4567,0,4567,0,0,4567
191615901300000,SW 451,RESIDENTIAL,3539,0,3539,0,0,3539
191615901400000,SW 451,RESIDENTIAL,24800,0,24800,137227,0,162027
191615901500000,SW 451,RESIDENTIAL,3539,0,3539,0,0,3539
191615901600000,SW 451,RESIDENTIAL,3539,0,3539,0,0,3539
191615901700000,SW 451,RESIDENTIAL,24800,0,24800,86322,0,111122
191615901800000,SW 451,RESIDENTIAL,3539,0,3539,0,0,3539
191615901900000,SW 451,RESIDENTIAL,3539,0,3539,0,0,3539
191615902000000,SW 451,RESIDENTIAL,3539,0,3539,0,0,3539
191617600100000,SW 426,RESIDENTIAL,21500,0,21500,93395,0,114895
191617600200000,APARTMENT,RESIDENTIAL,116000,0,116000,1317027,0,1433027
191617600300000,SW 426,RESIDENTIAL,25361,0,25361,88820,0,114181
191617600500000,SW 426,RESIDENTIAL,26324,0,26324,81498,0,107822
191617600600000,SW 426,RESIDENTIAL,25746,0,25746,71638,0,97384
191617600900000,APARTMENT,COMMERCIAL,0,36458,36458,0,199729,236187
191617601000000,APARTMENT,COMMERCIAL,0,33708,33708,0,199176,232884
191617700100000,EDUCATIONAL/COLLEGE,EXEMPT,0,86521,86521,0,0,86521
191617700500000,VACANT LAND,COMMERCIAL,0,22700,22700,0,0,22700
191617700700000,VACANT LAND,COMMERCIAL,0,5500,5500,0,0,5500
191620100100000,CITY PROPERTY,EXEMPT,0,0,0,0,0,0
191620100200000,CITY PROPERTY,EXEMPT,0,0,0,0,0,0
191622600100000,SW 418,RESIDENTIAL,203400,0,203400,0,0,203400
191622600200000,SW 418,RESIDENTIAL,103200,0,103200,0,0,103200
191622600300000,WAREHOUSE,COMMERCIAL,0,438750,438750,0,486166,924916
191622600400000,SW 418,AG DWELLING,34370,0,34370,57379,5709,97458
191622600500000,WAREHOUSE,COMMERCIAL,0,346590,346590,0,928889,1275479
191625100200000,WAREHOUSE,COMMERCIAL,0,126850,126850,0,433630,560480
191625100202000,BILLBOARD(BLL),COMMERCIAL,0,0,0,0,80110,80110
191625100300000,WAREHOUSE,COMMERCIAL,0,207350,207350,0,668098,875448
191625100400000,SMALL RETAIL,COMMERCIAL,0,206610,206610,0,273898,480508
191625100500000,WAREHOUSE,COMMERCIAL,0,643850,643850,0,1398802,2042652
191625100800000,WAREHOUSE,COMMERCIAL,0,844360,844360,0,2120292,2964652
191625200100000,SHOP,INDUSTRIAL,0,118260,118260,0,820172,938432
191625200200000,SHOP,EXEMPT,0,269460,269460,0,657576,927036
191625200300000,SHOP,COMMERCIAL,0,140160,140160,0,385340,525500
191625200400000,SHOP,COMMERCIAL,0,86280,86280,0,474819,561099
191627600300000,SW 426,RESIDENTIAL,51000,0,51000,146131,0,197131
191627600400000,SW 426,RESIDENTIAL,260300,0,260300,0,0,260300
191630100100000,SW 422,AG LAND,77791,0,77791,0,0,77791
191632600100000,SW 418,AG LAND,57412,0,57412,0,0,57412
191632600200000,WAREHOUSE,COMMERCIAL,0,172500,172500,0,101323,273823
191632600300000,SW 418,RESIDENTIAL,35329,0,35329,106383,0,141712
191635100100000,SW 418,AG DWELLING,74320,0,74320,102063,10900,187283
191637600100000,SW 456,AG DWELLING,91445,0,91445,79796,7753,178994
191640100400000,CITY PROPERTY,EXEMPT,0,0,0,0,0,0
191640100402000,ANTENNAS/TOWERS(BLL),COMMERCIAL,0,0,0,0,41860,41860
191640100500000,CITY PROPERTY,EXEMPT,0,0,0,0,0,0
191640100600000,SW 433,RESIDENTIAL,44748,0,44748,189401,0,234149
191640100700000,SW 433,RESIDENTIAL,45664,0,45664,148408,0,194072
191640100800000,SW 433,RESIDENTIAL,46099,0,46099,183675,0,229774
191640100900000,SW 433,RESIDENTIAL,44726,0,44726,165848,0,210574
191640101000000,SW 433,RESIDENTIAL,45562,0,45562,213560,0,259122
191640101100000,SW 433,RESIDENTIAL,43655,0,43655,166354,0,210009
191640101200000,SW 433,RESIDENTIAL,48602,0,48602,209788,0,258390
191640101300000,SW 433,RESIDENTIAL,47025,0,47025,213235,0,260260
191640101400000,SW 433,RESIDENTIAL,36918,0,36918,191985,0,228903
191640101500000,SW 433,RESIDENTIAL,42471,0,42471,201063,0,243534
191640101600000,SW 433,RESIDENTIAL,42827,0,42827,214743,0,257570
191640101700000,SW 433,RESIDENTIAL,39433,0,39433,180171,0,219604
191640101800000,SW 433,RESIDENTIAL,44880,0,44880,205577,0,250457
191640101900000,SW 433,RESIDENTIAL,43120,0,43120,217147,0,260267
191640102000000,SW 433,RESIDENTIAL,44462,0,44462,176857,0,221319
191640102300000,SW 433,RESIDENTIAL,46640,0,46640,194992,0,241632
191640102400000,SW 433,RESIDENTIAL,40810,0,40810,175166,0,215976
191640102500000,SW 433,RESIDENTIAL,6214,0,6214,0,0,6214
191640102600000,SW 433,RESIDENTIAL,7886,0,7886,0,0,7886
191640102700000,SW 433,RESIDENTIAL,46881,0,46881,189623,0,236504
191640102800000,SW 433,RESIDENTIAL,46198,0,46198,187284,0,233482
191640102900000,SW 433,RESIDENTIAL,43908,0,43908,191466,0,235374
191640103000000,SW 433,RESIDENTIAL,39486,0,39486,226907,0,266393
191640103100000,SW 433,RESIDENTIAL,6093,0,6093,0,0,6093
191640103200000,SW 433,RESIDENTIAL,41853,0,41853,29914,0,71767
191640103300000,SW 433,RESIDENTIAL,39479,0,39479,56614,0,96093
191640103400000,SW 433,RESIDENTIAL,32818,0,32818,154182,0,187000
191640103500000,SW 433,RESIDENTIAL,50050,0,50050,183341,0,233391
191640103600000,SW 433,RESIDENTIAL,36685,0,36685,169189,0,205874
191640200100000,SW 433,RESIDENTIAL,37950,0,37950,163077,0,201027
191640200200000,SW 433,RESIDENTIAL,37950,0,37950,163606,0,201556
191640200300000,SW 433,RESIDENTIAL,32220,0,32220,155806,0,188026
191640200400000,SW 433,RESIDENTIAL,37950,0,37950,174491,0,212441
191640200500000,SW 433,RESIDENTIAL,37950,0,37950,160264,0,198214
191640200600000,SW 433,RESIDENTIAL,32890,0,32890,178107,0,210997
191640200700000,SW 433,RESIDENTIAL,32890,0,32890,165408,0,198298
191640200800000,SW 433,RESIDENTIAL,32890,0,32890,168154,0,201044
191640200900000,SW 433,RESIDENTIAL,32890,0,32890,136473,0,169363
191640201000000,SW 433,RESIDENTIAL,32890,0,32890,150232,0,183122
191640201100000,SW 433,RESIDENTIAL,32890,0,32890,154951,0,187841
191640300100000,SW 433,RESIDENTIAL,41151,0,41151,199850,0,241001
191640300200000,SW 433,RESIDENTIAL,38239,0,38239,183834,0,222073
191640300300000,SW 433,RESIDENTIAL,37620,0,37620,202598,0,240218
191640300400000,SW 433,RESIDENTIAL,38280,0,38280,213045,0,251325
191640300500000,SW 433,RESIDENTIAL,38610,0,38610,202609,0,241219
191640300600000,SW 433,RESIDENTIAL,39270,0,39270,184543,0,223813
191640300700000,SW 433,RESIDENTIAL,39600,0,39600,182173,0,221773
191640300800000,SW 433,RESIDENTIAL,40392,0,40392,220168,0,260560
191640300900000,SW 433,RESIDENTIAL,41071,0,41071,211426,0,252497
191640301000000,SW 433,RESIDENTIAL,39560,0,39560,172872,0,212432
191640301100000,SW 433,RESIDENTIAL,40630,0,40630,197897,0,238527
191640301200000,SW 433,RESIDENTIAL,41194,0,41194,180236,0,221430
191640301300000,SW 433,RESIDENTIAL,40154,0,40154,177683,0,217837
191640301400000,SW 433,RESIDENTIAL,40498,0,40498,204403,0,244901
191640301500000,SW 433,RESIDENTIAL,41184,0,41184,209669,0,250853
191640301600000,SW 433,RESIDENTIAL,41870,0,41870,176879,0,218749
191640301700000,SW 433,RESIDENTIAL,41184,0,41184,180542,0,221726
191640301800000,SW 433,RESIDENTIAL,41215,0,41215,221713,0,262928
191640301900000,SW 433,RESIDENTIAL,36754,0,36754,154581,0,191335
191640400100000,SW 433,RESIDENTIAL,29879,0,29879,152014,0,181893
191640400200000,SW 433,RESIDENTIAL,33333,0,33333,149877,0,183210
191640400300000,SW 433,RESIDENTIAL,32609,0,32609,145377,0,177986
191640400400000,SW 433,RESIDENTIAL,33291,0,33291,150215,0,183506
191640400500000,SW 433,RESIDENTIAL,34054,0,34054,155081,0,189135
191640400600000,SW 433,RESIDENTIAL,35135,0,35135,171821,0,206956
191640400700000,SW 433,RESIDENTIAL,35675,0,35675,171418,0,207093
191640400800000,SW 433,RESIDENTIAL,33264,0,33264,151948,0,185212
191640400900000,SW 433,RESIDENTIAL,31965,0,31965,162255,0,194220
191640401000000,SW 433,RESIDENTIAL,32463,0,32463,142556,0,175019
191640401100000,SW 433,RESIDENTIAL,31185,0,31185,148307,0,179492
191640401200000,SW 433,RESIDENTIAL,29452,0,29452,154644,0,184096
191640401300000,SW 433,RESIDENTIAL,30030,0,30030,166402,0,196432
191642600100000,SW 422,AG LAND,100734,0,100734,0,0,100734
191645100100000,SW 456,AG DWELLING,95496,0,95496,69142,6199,170837
191647600200000,SCHOOL,EXEMPT,0,0,0,0,0,0
191647600300000,SW 422,RESIDENTIAL,41170,0,41170,8978,0,50148
191647600400000,SW 422,RESIDENTIAL,23160,0,23160,110811,0,133971
191647600500000,SW 433,RESIDENTIAL,33485,0,33485,147743,0,181228
191647600600000,SW 433,RESIDENTIAL,32384,0,32384,134122,0,166506
191647600700000,SW 433,RESIDENTIAL,32890,0,32890,154032,0,186922
191647600800000,SW 433,RESIDENTIAL,32890,0,32890,153971,0,186861
191647600900000,SW 433,RESIDENTIAL,32890,0,32890,158828,0,191718
191647601000000,SW 433,RESIDENTIAL,30562,0,30562,154365,0,184927
191647601100000,SW 433,RESIDENTIAL,34938,0,34938,114531,0,149469
191647601200000,SW 433,RESIDENTIAL,40981,0,40981,140348,0,181329
191647601300000,SW 433,RESIDENTIAL,38776,0,38776,182822,0,221598
191647601400000,SW 433,RESIDENTIAL,37975,0,37975,131344,0,169319
191647601500000,SW 433,RESIDENTIAL,39082,0,39082,105130,0,144212
191647601600000,SW 433,RESIDENTIAL,33381,0,33381,135825,0,169206
191647601700000,SW 433,RESIDENTIAL,34642,0,34642,127343,0,161985
191647601800000,SW 433,RESIDENTIAL,34678,0,34678,166090,0,200768
191647601900000,SW 433,RESIDENTIAL,34619,0,34619,0,0,34619
191647602000000,SW 433,RESIDENTIAL,43306,0,43306,190187,0,233493
191647602100000,SW 433,RESIDENTIAL,43177,0,43177,203272,0,246449
191647602200000,SW 433,RESIDENTIAL,47779,0,47779,216337,0,264116
191647602300000,SW 433,RESIDENTIAL,44660,0,44660,178142,0,222802
191647602400000,SW 433,RESIDENTIAL,44748,0,44748,205589,0,250337
191647602500000,SW 433,RESIDENTIAL,46492,0,46492,231692,0,278184
191647602600000,SW 433,RESIDENTIAL,43375,0,43375,186146,0,229521
191647602700000,SW 433,RESIDENTIAL,39270,0,39270,174861,0,214131
191647602800000,SW 433,RESIDENTIAL,46919,0,46919,200628,0,247547
191647602900000,SW 433,RESIDENTIAL,47998,0,47998,173948,0,221946
191647603000000,SW 433,RESIDENTIAL,42240,0,42240,171770,0,214010
191647603100000,SW 433,RESIDENTIAL,33801,0,33801,156616,0,190417
191647603200000,SW 433,RESIDENTIAL,33072,0,33072,123456,0,156528
191647603300000,SW 433,RESIDENTIAL,32258,0,32258,152335,0,184593
191647603400000,SW 433,RESIDENTIAL,37416,0,37416,167650,0,205066
191647603500000,SW 433,RESIDENTIAL,37283,0,37283,199601,0,236884
191647603600000,SW 433,RESIDENTIAL,30492,0,30492,166943,0,197435
191647700100000,SW 433,RESIDENTIAL,41195,0,41195,173810,0,215005
191647700200000,SW 433,RESIDENTIAL,41931,0,41931,182272,0,224203
191647700300000,CITY PROPERTY,EXEMPT,0,0,0,0,0,0
191647700400000,SW 433,RESIDENTIAL,42372,0,42372,202514,0,244886
191647700500000,SW 433,RESIDENTIAL,38968,0,38968,167388,0,206356
191647700600000,SW 433,RESIDENTIAL,39683,0,39683,143563,0,183246
191647700700000,SW 433,RESIDENTIAL,38038,0,38038,144308,0,182346
191647700800000,SW 433,RESIDENTIAL,40743,0,40743,165918,0,206661
191647700900000,SW 433,RESIDENTIAL,41748,0,41748,154161,0,195909
191647701000000,SW 433,RESIDENTIAL,46816,0,46816,156068,0,202884
191647701100000,SW 433,RESIDENTIAL,42246,0,42246,160843,0,203089
191647701200000,SW 433,RESIDENTIAL,34678,0,34678,162871,0,197549
191647701300000,SW 433,RESIDENTIAL,34678,0,34678,141579,0,176257
191647701400000,SW 433,RESIDENTIAL,34327,0,34327,126129,0,160456
191647701500000,SW 433,RESIDENTIAL,32890,0,32890,148353,0,181243
191647701600000,SW 433,RESIDENTIAL,32890,0,32890,157782,0,190672
191647701700000,SW 433,RESIDENTIAL,32890,0,32890,146448,0,179338
191647701800000,SW 433,RESIDENTIAL,34320,0,34320,166646,0,200966
191647701900000,SW 433,RESIDENTIAL,32533,0,32533,153383,0,185916
191647702000000,SW 433,RESIDENTIAL,36318,0,36318,195217,0,231535
191647702100000,SW 433,RESIDENTIAL,36451,0,36451,186328,0,222779
191647702200000,SW 433,RESIDENTIAL,39347,0,39347,197160,0,236507
191647702300000,SW 433,RESIDENTIAL,35374,0,35374,192658,0,228032
191647702400000,SW 433,RESIDENTIAL,36052,0,36052,150668,0,186720
191647702500000,SW 433,RESIDENTIAL,36960,0,36960,179577,0,216537
191647702600000,SW 433,RESIDENTIAL,36960,0,36960,177805,0,214765
191647702700000,SW 433,RESIDENTIAL,37881,0,37881,171660,0,209541
191647702800000,SW 433,RESIDENTIAL,37483,0,37483,107522,0,145005
191647702900000,SW 433,RESIDENTIAL,35306,0,35306,153633,0,188939
191647800100000,SW 433,RESIDENTIAL,32890,0,32890,144925,0,177815
191647800200000,SW 433,RESIDENTIAL,32890,0,32890,144041,0,176931
191647800300000,SW 433,RESIDENTIAL,32890,0,32890,131410,0,164300
191647800400000,SW 433,RESIDENTIAL,32890,0,32890,159559,0,192449
191647800500000,SW 433,RESIDENTIAL,32890,0,32890,139306,0,172196
191647800600000,SW 433,RESIDENTIAL,32890,0,32890,125780,0,158670
191647800700000,SW 433,RESIDENTIAL,32890,0,32890,145851,0,178741
191710100100000,VACANT LAND,INDUSTRIAL,0,93960,93960,0,0,93960
191710100300000,SHOP,COMMERCIAL,0,196250,196250,0,548765,745015
191710100400000,SHOP,COMMERCIAL,0,55000,55000,0,160092,215092
191710100500000,SHOP,COMMERCIAL,0,48000,48000,0,182577,230577
191710200100000,VETERINARY CLINIC,COMMERCIAL,0,61650,61650,0,122808,184458
191710200200000,SW 418,RESIDENTIAL,54600,0,54600,87254,0,141854
191710200300000,FLAT PARKING,COMMERCIAL,0,192450,192450,0,62496,254946
191710200700000,VACANT LAND,INDUSTRIAL,0,101614,101614,0,0,101614
191710200800000,WAREHOUSE,COMMERCIAL,0,162260,162260,0,553043,715303
191710201401000,SHOP,COMMERCIAL,0,272012,272012,0,1094050,1366062
191710201401001,WAREHOUSE,COMMERCIAL,0,164895,164895,0,575253,740148
191710201500000,WAREHOUSE,COMMERCIAL,0,285000,285000,0,562000,847000
191710201700000,WAREHOUSE,COMMERCIAL,0,73625,73625,0,221935,295560
191710201800000,WAREHOUSE,COMMERCIAL,0,58692,58692,0,240602,299294
191710202000000,CONC/ASPH;INDUSTRIAL,INDUSTRIAL,0,250992,250992,0,436144,687136
191710202100000,VACANT LAND,INDUSTRIAL,0,112347,112347,0,0,112347
191710202200000,WAREHOUSE,COMMERCIAL,0,141625,141625,0,455125,596750
191710202301000,SHOP,COMMERCIAL,0,54963,54963,0,312643,367606
191710202301001,SHOP,COMMERCIAL,0,22903,22903,0,165270,188173
191710202301002,SHOP,COMMERCIAL,0,11452,11452,0,70389,81841
191710202301003,SHOP,COMMERCIAL,0,11452,11452,0,70389,81841
191710202301004,SHOP,COMMERCIAL,0,27469,27469,0,128202,155671
191712600100000,WAREHOUSE,COMMERCIAL,0,35800,35800,0,158786,194586
191712600200000,SW 418,RESIDENTIAL,67500,0,67500,100581,0,168081
191712600300000,WAREHOUSE,COMMERCIAL,0,45500,45500,0,190453,235953
191712600400000,CITY PROPERTY,EXEMPT,0,0,0,0,0,0
191712600500000,WAREHOUSE,COMMERCIAL,0,221000,221000,0,374335,595335
191712600600000,WAREHOUSE,COMMERCIAL,0,533225,533225,0,366478,899703
191712600700000,EQUIPMENT MFG;INDUST,INDUSTRIAL,0,285822,285822,0,1385560,1671382
191712600800000,WAREHOUSE,COMMERCIAL,0,450000,450000,0,611454,1061454
191712600900000,CENTRALLY ASSESSED,OTHER,0,0,0,0,0,0
191712700100000,WAREHOUSE,COMMERCIAL,0,310000,310000,0,1217774,1527774
191712700200000,SHOP,COMMERCIAL,0,114345,114345,0,386621,500966
191712700300000,SHOP,COMMERCIAL,0,132640,132640,0,40502,173142
191712700400000,VACANT LAND,COMMERCIAL,0,202000,202000,0,0,202000
191712700500000,WAREHOUSE,COMMERCIAL,0,171000,171000,0,293765,464765
191715100100000,FOOD GRADE;INDUST,INDUSTRIAL,0,250441,250441,0,152091,402532
191715200100000,VACANT LAND,COMMERCIAL,0,326000,326000,0,0,326000
191715200200000,FLAT PARKING,COMMERCIAL,0,318000,318000,0,43874,361874
191715200300000,WAREHOUSE,COMMERCIAL,0,124000,124000,0,312425,436425
191715200400000,WAREHOUSE,COMMERCIAL,0,190800,190800,0,302778,493578
191715300100000,WAREHOUSE,COMMERCIAL,0,413000,413000,0,478516,891516
191715300200000,FLAT PARKING,COMMERCIAL,0,41300,41300,0,31387,72687
191715300300000,FLAT PARKING,COMMERCIAL,0,217650,217650,0,67704,285354
191715400100000,SHOP,COMMERCIAL,0,295200,295200,0,619003,914203
191717600100000,WAREHOUSE,COMMERCIAL,0,225990,225990,0,309910,535900
191717600200000,WAR VETERANS,COMMERCIAL,0,145750,145750,0,401291,547041
191717600300000,VACANT LAND,COMMERCIAL,0,71600,71600,0,0,71600
191717600400000,SHOP,INDUSTRIAL,0,210643,210643,0,1748350,1958993
191717600500000,WAREHOUSE,COMMERCIAL,0,60300,60300,0,138865,199165
191717600600000,WAREHOUSE,COMMERCIAL,0,72200,72200,0,215811,288011
191717600700000,SMALL RETAIL,COMMERCIAL,0,27875,27875,0,98658,126533
191717600800000,WAREHOUSE,COMMERCIAL,0,48750,48750,0,106267,155017
191717600900000,VETERINARY CLINIC,EXEMPT,0,57894,57894,0,83370,141264
191717601000000,VACANT LAND,EXEMPT,0,48608,48608,0,0,48608
191717601002000,BILLBOARD(BLL),COMMERCIAL,0,0,0,0,12500,12500
191717700100000,LG DISCOUNT/RETAIL,COMMERCIAL,0,187520,187520,0,291366,478886
191717700200000,WAREHOUSE,COMMERCIAL,0,84300,84300,0,120491,204791
191717700300000,WAREHOUSE,COMMERCIAL,0,77500,77500,0,231065,308565
191717700400000,WAREHOUSE,COMMERCIAL,0,75000,75000,0,90765,165765
191717700500000,WAREHOUSE,COMMERCIAL,0,380020,380020,0,785851,1165871
191717700600000,WAREHOUSE,COMMERCIAL,0,59534,59534,0,130709,190243
191717700700000,SHOP,COMMERCIAL,0,158000,158000,0,379258,537258
191717800100000,EQUIPMENT MFG;INDUST,INDUSTRIAL,0,98820,98820,0,217666,316486
191717800200000,WAREHOUSE,COMMERCIAL,0,431650,431650,0,1463068,1894718
191717800400000,WAREHOUSE,COMMERCIAL,0,144950,144950,0,153997,298947
191717800500000,WAREHOUSE,COMMERCIAL,0,140675,140675,0,274242,414917
191722600100000,SW 418,AG LAND,51160,0,51160,0,0,51160
191725100100000,SW 418,AG LAND,62285,0,62285,0,0,62285
191727600100000,FOOD GRADE;INDUST,INDUSTRIAL,0,2632797,2632797,0,70098180,72730977
191732600100000,SW 418,AG LAND,64844,0,64844,0,0,64844
191735100100000,SW 418,AG LAND,60482,0,60482,0,0,60482
191737600300000,VACANT LAND,COMMERCIAL,0,143500,143500,0,0,143500
191737600500000,VACANT LAND,INDUSTRIAL,0,264514,264514,0,0,264514
191737600600000,WAREHOUSE,COMMERCIAL,0,619000,619000,0,3369488,3988488
191737700100000,EQUIPMENT MFG;INDUST,INDUSTRIAL,0,374112,374112,0,5326127,5700239
191740100100000,SW 418,AG DWELLING,89731,0,89731,104816,9412,203959
191742600100000,SW 418,AG LAND,82482,0,82482,0,0,82482
191745100100000,SW 418,AG LAND,98845,0,98845,0,0,98845
191747600100000,SW 418,AG LAND,80144,0,80144,0,0,80144
191810100100000,SW 418,AG DWELLING,76386,0,76386,82151,13838,172375
191812600200000,FOOD GRADE;INDUST,INDUSTRIAL,0,415584,415584,0,5784017,6199601
191812600300000,VACANT LAND,AG LAND,48638,0,48638,0,0,48638
191815100100000,SW 418,AG LAND,96893,0,96893,0,0,96893
191817600100000,SW 418,AG LAND,94884,0,94884,0,0,94884
191820100100000,WAREHOUSE,COMMERCIAL,0,296931,296931,0,75000,371931
191820100200000,SW 418,RESIDENTIAL,82375,0,82375,87965,0,170340
191822600100000,SW 418,AG LAND,89897,0,89897,0,0,89897
191825100100000,SW 418,AG LAND,93488,0,93488,0,1340,94828
191825100200000,SW 418,RESIDENTIAL,95100,0,95100,126180,0,221280
191827600100000,SW 418,AG LAND,91956,0,91956,0,0,91956
191830100100000,SW 418,AG LAND,91383,0,91383,0,0,91383
191832600100000,SW 418,AG LAND,95493,0,95493,0,0,95493
191835100100000,SW 418,AG LAND,93111,0,93111,0,0,93111
191837600100000,SW 418,AG DWELLING,95518,0,95518,53098,4519,153135
191840100100000,SW 418,AG LAND,97414,0,97414,0,0,97414
191842600100000,SW 418,AG LAND,97046,0,97046,0,0,97046
191845100100000,SW 418,AG LAND,95523,0,95523,0,0,95523
191847600300000,SW 418,AG LAND,92021,0,92021,0,0,92021
191910100100000,WAREHOUSE,COMMERCIAL,0,913086,913086,0,22203666,23116752
191917600100000,CITY PROPERTY,EXEMPT,0,0,0,0,0,0
191920100100000,CITY PROPERTY,EXEMPT,0,0,0,0,0,0
191947600400000,EDUCATIONAL/COLLEGE,EXEMPT,0,0,0,0,0,0
192010100100000,SW 418,AG DWELLING,95192,0,95192,112502,4773,212467
192012600100000,SW 418,AG LAND,95506,0,95506,0,0,95506
192015100100000,SW 422,AG LAND,97662,0,97662,0,0,97662
192017600100000,WAREHOUSE,COMMERCIAL,0,1602900,1602900,0,3340226,4943126
192020100100000,EQUIPMENT MFG;INDUST,INDUSTRIAL,0,617274,617274,0,5030355,5647629
192020100200000,OFFICE,COMMERCIAL,0,402000,402000,0,324717,726717
192020100300000,SW 418,AG LAND,15234,0,15234,0,0,15234
192022600100000,CITY PROPERTY,EXEMPT,0,0,0,0,0,0
192022600200000,SW 418,AG LAND,44887,0,44887,0,0,44887
192025100100000,SW 418,AG DWELLING,85528,0,85528,100943,1890,188361
192027600100000,SW 418,AG LAND,97589,0,97589,0,0,97589
192030100300000,CITY PROPERTY,EXEMPT,0,0,0,0,0,0
192032600100000,CITY PROPERTY,EXEMPT,0,0,0,0,0,0
192037600200000,CITY PROPERTY,EXEMPT,0,0,0,0,0,0
192037600400000,CITY PROPERTY,EXEMPT,0,0,0,0,0,0
192037600500000,CITY PROPERTY,EXEMPT,0,0,0,0,0,0
192040100100000,SW 418,AG LAND,98874,0,98874,0,11498,110372
192040100102000,BILLBOARD(BLL),COMMERCIAL,0,0,0,0,16422,16422
192042600100000,SW 418,AG LAND,97308,0,97308,0,0,97308
192045100100000,SW 418,AG LAND,79082,0,79082,0,0,79082
192045200100000,SW 418,AG LAND,35814,0,35814,0,0,35814
192045200102000,BILLBOARD(BLL),COMMERCIAL,0,0,0,0,18302,18302
192047600100000,VACANT LAND,COMMERCIAL,0,962920,962920,0,0,962920
192047600200000,VACANT LAND,COMMERCIAL,0,20,20,0,0,20
192047600300000,FLAT PARKING,COMMERCIAL,0,194020,194020,0,7666,201686
192047600400000,CONVENIENCE STORE,COMMERCIAL,0,214020,214020,0,580549,794569
192047700100000,HOTEL,COMMERCIAL,0,430000,430000,0,2074864,2504864
192047800100000,VACANT LAND,COMMERCIAL,0,370075,370075,0,0,370075
192047800200000,HOTEL,COMMERCIAL,0,415000,415000,0,1646246,2061246
192110100100000,SCHOOL,EXEMPT,0,0,0,0,0,0
192112600100000,SCHOOL,EXEMPT,0,0,0,0,0,0
192115100200000,SCHOOL,EXEMPT,0,0,0,0,0,0
192117600100000,SCHOOL,EXEMPT,0,0,0,0,0,0
192122600100000,SW 418,AG LAND,68036,0,68036,0,0,68036
192125100100000,SW 418,AG DWELLING,82692,0,82692,78409,8296,169397
192125100102000,BILLBOARD(BLL),COMMERCIAL,0,0,0,0,30596,30596
192130100100000,SW 456,AG LAND,83988,0,83988,0,0,83988
192132600100000,AUTO REPAIR/SALES,COMMERCIAL,0,1063275,1063275,0,3157339,4220614
192132600300000,VACANT LAND,COMMERCIAL,0,309223,309223,0,0,309223
192132700100000,VACANT LAND,COMMERCIAL,0,315254,315254,0,0,315254
192135100500000,FAST FOOD,COMMERCIAL,0,408000,408000,0,758094,1166094
192135100600000,VACANT LAND,COMMERCIAL,0,319820,319820,0,0,319820
192135100700000,VACANT LAND,COMMERCIAL,0,275260,275260,0,0,275260
192135100800000,VACANT LAND,COMMERCIAL,0,251319,251319,0,0,251319
192135100900000,VACANT LAND,COMMERCIAL,0,135109,135109,0,0,135109
192135200100000,VACANT LAND,COMMERCIAL,0,37396,37396,0,0,37396
192135200200000,VACANT LAND,COMMERCIAL,0,248102,248102,0,0,248102
192135200300000,VACANT LAND,COMMERCIAL,0,34581,34581,0,0,34581
192135200400000,VACANT LAND,COMMERCIAL,0,400,400,0,0,400
192137600100000,SW 456,AG LAND,60228,0,60228,0,0,60228
192140100200000,SW 452,RESIDENTIAL,21162,0,21162,113200,0,134362
192140100300000,SW 452,RESIDENTIAL,21162,0,21162,111691,0,132853
192140100400000,SW 452,RESIDENTIAL,21038,0,21038,111557,0,132595
192140100500000,SW 452,RESIDENTIAL,21038,0,21038,111557,0,132595
192140100600000,SW 452,RESIDENTIAL,21038,0,21038,111557,0,132595
192140100700000,SW 452,RESIDENTIAL,21038,0,21038,111557,0,132595
192140100800000,SW 452,RESIDENTIAL,21038,0,21038,111557,0,132595
192140100900000,SW 452,RESIDENTIAL,21038,0,21038,111557,0,132595
192140101000000,SW 452,RESIDENTIAL,23549,0,23549,111557,0,135106
192140101100000,SW 452,RESIDENTIAL,22938,0,22938,111557,0,134495
192140101200000,SW 452,RESIDENTIAL,23609,0,23609,109957,0,133566
192140101300000,SW 452,RESIDENTIAL,27625,0,27625,111208,0,138833
192140101400000,SW 452,RESIDENTIAL,28987,0,28987,124650,0,153637
192140101500000,SW 452,RESIDENTIAL,24709,0,24709,130065,0,154774
192140101600000,SW 452,RESIDENTIAL,23241,0,23241,116488,0,139729
192140101700000,SW 452,RESIDENTIAL,24442,0,24442,133207,0,157649
192140101800000,SW 452,RESIDENTIAL,24194,0,24194,124590,0,148784
192140101900000,SW 452,RESIDENTIAL,24194,0,24194,116100,0,140294
192140102000000,SW 452,RESIDENTIAL,24194,0,24194,135272,0,159466
192140102100000,SW 452,RESIDENTIAL,24194,0,24194,127908,0,152102
192140102200000,SW 452,RESIDENTIAL,23760,0,23760,122480,0,146240
192140102300000,SW 452,RESIDENTIAL,23890,0,23890,124066,0,147956
192140102400000,SW 452,RESIDENTIAL,7013,0,7013,0,0,7013
192140102500000,SW 452,RESIDENTIAL,63595,0,63595,140507,0,204102
192140102600000,SW 452,RESIDENTIAL,36213,0,36213,150157,0,186370
192140102700000,SW 452,RESIDENTIAL,34650,0,34650,172174,0,206824
192140102800000,SW 452,RESIDENTIAL,34650,0,34650,144213,0,178863
192140102900000,SW 452,RESIDENTIAL,34650,0,34650,137709,0,172359
192140103000000,SW 452,RESIDENTIAL,34650,0,34650,161717,0,196367
192140103100000,SW 452,RESIDENTIAL,40931,0,40931,173396,0,214327
192140103200000,SW 452,RESIDENTIAL,41846,0,41846,152104,0,193950
192140103300000,SW 452,RESIDENTIAL,37385,0,37385,184613,0,221998
192140103400000,SW 452,RESIDENTIAL,38393,0,38393,182734,0,221127
192140103500000,SW 452,RESIDENTIAL,47040,0,47040,159540,0,206580
192140103600000,SW 452,RESIDENTIAL,41253,0,41253,142295,0,183548
192140103700000,SW 452,RESIDENTIAL,37450,0,37450,153696,0,191146
192140103800000,SW 452,RESIDENTIAL,52189,0,52189,141735,0,193924
192140103900000,SW 452,RESIDENTIAL,48314,0,48314,145271,0,193585
192140104000000,SW 452,RESIDENTIAL,47861,0,47861,149024,0,196885
192140104100000,SW 452,RESIDENTIAL,53937,0,53937,138804,0,192741
192140104200000,SW 452,RESIDENTIAL,51623,0,51623,147481,0,199104
192140104300000,SW 452,RESIDENTIAL,42966,0,42966,149923,0,192889
192140104400000,SW 452,RESIDENTIAL,42385,0,42385,152563,0,194948
192140104500000,SW 452,RESIDENTIAL,35467,0,35467,135296,0,170763
192140104600000,SW 452,RESIDENTIAL,61110,0,61110,185152,0,246262
192140104700000,SW 452,RESIDENTIAL,46529,0,46529,130994,0,177523
192140104800000,SW 452,RESIDENTIAL,45050,0,45050,159386,0,204436
192140104900000,SW 452,RESIDENTIAL,44650,0,44650,135830,0,180480
192140105000000,SW 452,RESIDENTIAL,332,0,332,0,0,332
192140105800000,SW 452,RESIDENTIAL,39293,0,39293,150594,0,189887
192140105900000,SW 452,RESIDENTIAL,44896,0,44896,148838,0,193734
192140106000000,SW 452,RESIDENTIAL,46202,0,46202,133986,0,180188
192140106100000,SW 452,RESIDENTIAL,267,0,267,0,0,267
192140106200000,SW 452,RESIDENTIAL,281,0,281,0,0,281
192140106300000,SW 452,RESIDENTIAL,281,0,281,0,0,281
192140106400000,SW 452,RESIDENTIAL,281,0,281,0,0,281
192140106500000,SW 452,RESIDENTIAL,281,0,281,0,0,281
192140106600000,SW 452,RESIDENTIAL,290,0,290,0,0,290
192140200100000,SW 452,RESIDENTIAL,47101,0,47101,140205,0,187306
192140200200000,SW 452,RESIDENTIAL,36346,0,36346,148789,0,185135
192140200300000,SW 452,RESIDENTIAL,38115,0,38115,160864,0,198979
192140200400000,SW 452,RESIDENTIAL,38115,0,38115,133538,0,171653
192140200500000,SW 452,RESIDENTIAL,38115,0,38115,141129,0,179244
192140200600000,SW 452,RESIDENTIAL,30194,0,30194,132616,0,162810
192140200700000,SW 452,RESIDENTIAL,37884,0,37884,128596,0,166480
192140200800000,SW 452,RESIDENTIAL,37884,0,37884,131833,0,169717
192140200900000,SW 452,RESIDENTIAL,37884,0,37884,122947,0,160831
192140201000000,SW 452,RESIDENTIAL,37884,0,37884,134384,0,172268
192140201100000,SW 452,RESIDENTIAL,37884,0,37884,127886,0,165770
192140201200000,SW 452,RESIDENTIAL,42405,0,42405,165624,0,208029
192140201300000,SW 452,RESIDENTIAL,38115,0,38115,146658,0,184773
192140201400000,SW 452,RESIDENTIAL,38115,0,38115,161607,0,199722
192140201500000,SW 452,RESIDENTIAL,38115,0,38115,136657,0,174772
192140201600000,SW 452,RESIDENTIAL,45187,0,45187,146226,0,191413
192140300100000,SW 452,RESIDENTIAL,40045,0,40045,127025,0,167070
192140300200000,SW 452,RESIDENTIAL,39872,0,39872,137477,0,177349
192140300300000,SW 452,RESIDENTIAL,38164,0,38164,145339,0,183503
192140300400000,SW 452,RESIDENTIAL,38164,0,38164,130975,0,169139
192140300500000,SW 452,RESIDENTIAL,38164,0,38164,129636,0,167800
192140300600000,SW 452,RESIDENTIAL,44086,0,44086,137085,0,181171
192140301100000,SW 452,RESIDENTIAL,40737,0,40737,133113,0,173850
192140301500000,SW 452,RESIDENTIAL,260,0,260,0,0,260
192140301600000,SW 452,RESIDENTIAL,295,0,295,0,0,295
192140301700000,SW 452,RESIDENTIAL,44408,0,44408,138981,0,183389
192140301800000,SW 452,RESIDENTIAL,31605,0,31605,153404,0,185009
192140301900000,SW 452,RESIDENTIAL,279,0,279,0,0,279
192140302000000,SW 452,RESIDENTIAL,346,0,346,0,0,346
192140302100000,SW 452,RESIDENTIAL,323,0,323,0,0,323
192140302200000,SW 452,RESIDENTIAL,343,0,343,0,0,343
192140302300000,SW 452,RESIDENTIAL,371,0,371,0,0,371
192140302400000,SW 452,RESIDENTIAL,380,0,380,0,0,380
192140302500000,SW 452,RESIDENTIAL,387,0,387,0,0,387
192140400200000,SW 452,RESIDENTIAL,237,0,237,0,0,237
192140400300000,SW 452,RESIDENTIAL,237,0,237,0,0,237
192140400400000,SW 452,RESIDENTIAL,237,0,237,0,0,237
192140400500000,SW 452,RESIDENTIAL,274,0,274,0,0,274
192140400600000,SW 452,RESIDENTIAL,413,0,413,0,0,413
192140400700000,SW 452,RESIDENTIAL,239,0,239,0,0,239
192142600100000,SW 456,AG LAND,99539,0,99539,0,0,99539
192145100200000,SW 456,AG LAND,11137,0,11137,0,0,11137
192145100300000,OFFICE,COMMERCIAL,0,512000,512000,0,2177275,2689275
192145100500000,SW 456,AG LAND,5578,0,5578,0,0,5578
192145100600000,SW 456,AG LAND,5609,0,5609,0,0,5609
192145200100000,OFFICE,COMMERCIAL,0,551680,551680,0,3725460,4277140
192145200200000,SW 456,AG LAND,35078,0,35078,0,0,35078
192145200300000,SW 456,AG LAND,6547,0,6547,0,0,6547
192147600300000,SW 418,AG LAND,85483,0,85483,0,0,85483
192147600400000,SW 452,RESIDENTIAL,251,0,251,0,0,251
192147600500000,SW 452,RESIDENTIAL,39900,0,39900,136095,0,175995
192147600600000,SW 452,RESIDENTIAL,262,0,262,0,0,262
192147600700000,SW 452,RESIDENTIAL,320,0,320,0,0,320
192147600800000,SW 452,RESIDENTIAL,49093,0,49093,201831,0,250924
192147601000000,SW 452,RESIDENTIAL,280,0,280,0,0,280
192222600300000,EDUCATIONAL/COLLEGE,EXEMPT,0,0,0,0,0,0
192225100300000,SCHOOL,EXEMPT,0,0,0,0,0,0
192820100100000,VACANT LAND,COMMERCIAL,0,577000,577000,0,0,577000
192820100200000,WAREHOUSE,COMMERCIAL,0,1398000,1398000,0,7702000,9100000
192822600500000,WAREHOUSE,COMMERCIAL,0,411900,411900,0,519085,930985
192822600700000,AUTO REPAIR/SALES,COMMERCIAL,0,402120,402120,0,1007060,1409180
192822601000000,VACANT LAND,COMMERCIAL,0,877000,877000,0,0,877000
192822601200000,CONVENIENCE STORE,COMMERCIAL,0,937788,937788,0,2645265,3583053
192825100100000,SW 422,AG LAND,23828,0,23828,0,0,23828
192825100200000,WAREHOUSE,COMMERCIAL,0,807400,807400,0,3624033,4431433
192825100300000,SW 422,AG LAND,38178,0,38178,0,0,38178
192825100302000,ANTENNAS/TOWERS(BLL),COMMERCIAL,0,0,0,0,106058,106058
192832600200000,SE 218,AG LAND,164404,0,164404,0,0,164404
192835100400000,WAREHOUSE,COMMERCIAL,0,788960,788960,0,3689503,4478463
192910100100000,VACANT LAND,AG LAND,31527,0,31527,0,0,31527
192910100200000,OFFICE; MEDICAL,COMMERCIAL,0,580000,580000,0,1270320,1850320
192910200100000,OFFICE,COMMERCIAL,0,403020,403020,0,1427954,1830974
192910200200000,WAREHOUSE,COMMERCIAL,0,317443,317443,0,1256560,1574003
192910200201000,WAREHOUSE,COMMERCIAL,0,58229,58229,0,284616,342845
192910200300000,WAREHOUSE,COMMERCIAL,0,375560,375560,0,1482778,1858338
192910300100000,VACANT LAND,COMMERCIAL,0,162900,162900,0,0,162900
192910300200000,WAREHOUSE,COMMERCIAL,0,266100,266100,0,483625,749725
192910300300000,VETERINARY CLINIC,COMMERCIAL,0,180000,180000,0,759398,939398
192912600300000,SW 418,RESIDENTIAL,41039,0,41039,108278,0,149317
192912600400000,SW 418,RESIDENTIAL,32436,0,32436,127204,0,159640
192912600500000,SW 418,RESIDENTIAL,24000,0,24000,104605,0,128605
192912600600000,SW 418,RESIDENTIAL,24000,0,24000,90172,0,114172
192912600700000,CITY PROPERTY,EXEMPT,0,0,0,0,0,0
192912600800000,CITY PROPERTY,EXEMPT,0,0,0,0,0,0
192912600900000,SW 418,RESIDENTIAL,27576,0,27576,123647,0,151223
192912601100000,SW 418,RESIDENTIAL,37122,0,37122,121425,0,158547
192912601200000,SW 422,AG LAND,31231,0,31231,0,18744,49975
192912601400000,WAREHOUSE,COMMERCIAL,0,285000,285000,0,799574,1084574
192912601500000,SW 418,AG LAND,168,0,168,0,0,168
192912601600000,VACANT LAND,COMMERCIAL,0,57000,57000,0,0,57000
192912601700000,SW 418,AG LAND,44329,0,44329,0,0,44329
192915100200000,WAREHOUSE,COMMERCIAL,0,747200,747200,0,2152800,2900000
192915100300000,SW 418,AG LAND,86253,0,86253,0,0,86253
192915100400000,SW 418,AG LAND,84,0,84,0,0,84
192917600100000,SW 418,AG LAND,66031,0,66031,0,0,66031
192917600200000,SW 418,RESIDENTIAL,101500,0,101500,159574,0,261074
192917600300000,SW 418,RESIDENTIAL,1045,0,1045,0,0,1045
192917600400000,CENTRALLY ASSESSED,OTHER,0,0,0,0,0,0
192917700100000,OFFICE,COMMERCIAL,0,475750,475750,0,1878713,2354463
192917700200000,SW 416,AG LAND,6831,0,6831,0,0,6831
192920100200000,SW 418,AG LAND,5272,0,5272,0,8556,13828
192920100300000,SW 418,AG LAND,36983,0,36983,0,0,36983
192920100400000,CITY PROPERTY,EXEMPT,0,0,0,0,0,0
192920100500000,SW 418,RESIDENTIAL,52300,0,52300,118471,0,170771
192920100600000,SW 418,RESIDENTIAL,51150,0,51150,97879,0,149029
192920100700000,SW 418,AG LAND,2067,0,2067,0,0,2067
192920100800000,SW 418,AG LAND,670,0,670,0,0,670
192922600100000,SW 418,RESIDENTIAL,760,0,760,0,0,760
192922600300000,SW 418,RESIDENTIAL,31120,0,31120,99060,0,130180
192922600500000,SW 418,RESIDENTIAL,30943,0,30943,119247,0,150190
192922600600000,SW 418,RESIDENTIAL,30943,0,30943,167016,0,197959
192922600700000,SW 418,RESIDENTIAL,33263,0,33263,94297,0,127560
192922600800000,VACANT LAND,AG LAND,10966,0,10966,0,0,10966
192922600900000,VACANT LAND,AG LAND,13180,0,13180,0,0,13180
192922601000000,WAREHOUSE,COMMERCIAL,0,37400,37400,0,31145,68545
192922601200000,SW 418,RESIDENTIAL,47324,0,47324,112645,0,159969
192922601300000,SW 418,RESIDENTIAL,30765,0,30765,92316,0,123081
192922601400000,SW 418,RESIDENTIAL,760,0,760,0,0,760
192922601500000,WAREHOUSE,COMMERCIAL,0,138000,138000,0,353540,491540
192922601600000,SHOP,COMMERCIAL,0,162000,162000,0,0,162000
192922601800000,WAREHOUSE,COMMERCIAL,0,370000,370000,0,830652,1200652
192922601900000,WAREHOUSE,COMMERCIAL,0,329000,329000,0,1445231,1774231
192922700100000,SW 418,RESIDENTIAL,760,0,760,0,0,760
192922700200000,SW 418,RESIDENTIAL,760,0,760,0,0,760
192922700300000,SW 418,RESIDENTIAL,32185,0,32185,106797,0,138982
192922700400000,SW 418,RESIDENTIAL,35520,0,35520,94863,0,130383
192922700500000,SW 418,RESIDENTIAL,35017,0,35017,85731,0,120748
192922700600000,SW 418,RESIDENTIAL,36097,0,36097,123709,0,159806
192922700700000,SW 418,RESIDENTIAL,35520,0,35520,118982,0,154502
192922700800000,SW 418,RESIDENTIAL,30765,0,30765,82829,0,113594
192922800100000,VACANT LAND,COMMERCIAL,0,27850,27850,0,0,27850
192922800200000,CITY PROPERTY,EXEMPT,0,0,0,0,0,0
192922800300000,SW 418,RESIDENTIAL,12644,0,12644,45385,0,58029
192940100100000,SW 418,RESIDENTIAL,62700,0,62700,122808,0,185508
192940100200000,SW 418,AG LAND,96008,0,96008,0,0,96008
192942600100000,SW 418,AG LAND,106523,0,106523,0,0,106523
192947600100000,WAREHOUSE-TRANSIT,COMMERCIAL,0,625000,625000,0,433679,1058679
192947600300000,WAREHOUSE,COMMERCIAL,0,628000,628000,0,2919640,3547640
192947600400000,VACANT LAND,COMMERCIAL,0,99604,99604,0,0,99604
192947600500000,VACANT LAND,COMMERCIAL,0,100284,100284,0,0,100284
192947700100000,WAREHOUSE-TRANSIT,COMMERCIAL,0,588750,588750,0,281714,870464
193010100100000,CITY PROPERTY,EXEMPT,0,0,0,0,0,0
193020100100000,VACANT LAND,COMMERCIAL,0,72800,72800,0,0,72800
193020100200000,WAREHOUSE,COMMERCIAL,0,527000,527000,0,1300107,1827107
193020100300000,WAREHOUSE,COMMERCIAL,0,55441,55441,0,319777,375218
193020100400000,WAREHOUSE,COMMERCIAL,0,110850,110850,0,190111,300961
193020100500000,CITY PROPERTY,EXEMPT,0,0,0,0,0,0
193037600100000,CITY PROPERTY,EXEMPT,0,0,0,0,0,0
193047600100000,STATE PROPERTY,EXEMPT,0,0,0,0,0,0
193110100100000,CITY PROPERTY,EXEMPT,0,0,0,0,0,0
193222600100000,CITY PROPERTY,EXEMPT,0,0,0,0,0,0
193240100200000,SW 418,AG DWELLING,12464,0,12464,173045,14080,199589
193242600200000,SW 418,AG LAND,193188,0,193188,0,0,193188
193322601200000,WAREHOUSE,COMMERCIAL,0,722800,722800,0,3937206,4660006
193322601300000,SW 418,AG LAND,15674,0,15674,0,0,15674
193322601400000,SW 418,AG LAND,11431,0,11431,0,0,11431
193322601500000,VACANT LAND,COMMERCIAL,0,7960,7960,0,0,7960
193325100300000,WAREHOUSE,COMMERCIAL,0,923980,923980,0,3872773,4796753
193325100600000,SW 422,AG LAND,26590,0,26590,0,0,26590
193325100700000,SW 422,AG LAND,7683,0,7683,0,0,7683
193325100800000,SW 422,AG LAND,22556,0,22556,0,0,22556
193325101100000,FLAT PARKING,COMMERCIAL,0,717000,717000,0,661500,1378500
193332600100000,SW 422,AG LAND,81420,0,81420,0,0,81420
193335100200000,SW 418,RESIDENTIAL,38400,0,38400,95423,0,133823
193335100300000,SW 418,RESIDENTIAL,33600,0,33600,70387,0,103987
193335100400000,SW 418,RESIDENTIAL,61850,0,61850,76229,0,138079
193335100500000,SW 418,AG LAND,22531,0,22531,0,0,22531
193335100600000,SW 418,AG LAND,91577,0,91577,0,0,91577
200110100200000,LG DISCOUNT/RETAIL,COMMERCIAL,0,2709780,2709780,0,9859784,12569564
200110100300000,FAST FOOD,COMMERCIAL,0,276600,276600,0,699654,976254
200110100400000,NBHD SHOPPING CENTER,COMMERCIAL,0,764400,764400,0,2334758,3099158
200110100500000,NBHD SHOPPING CENTER,COMMERCIAL,0,335000,335000,0,745947,1080947
200110100700000,SERVICE STATION,COMMERCIAL,0,394800,394800,0,191142,585942
200110100900000,FAST FOOD,COMMERCIAL,0,368000,368000,0,499115,867115
200110101000000,CARWASH,COMMERCIAL,0,408000,408000,0,256357,664357
200110300100000,CHURCH,EXEMPT,0,1296,1296,0,0,1296
200112600200000,BRANCH BANK/CU,COMMERCIAL,0,497500,497500,0,1216568,1714068
200112600500000,AUTO REPAIR/SALES,COMMERCIAL,0,684190,684190,0,637409,1321599
200112701000000,VACANT LAND,COMMERCIAL,0,20,20,0,0,20
200112701001000,VACANT LAND,COMMERCIAL,0,257244,257244,0,0,257244
200112701001001,LG DISCOUNT/RETAIL,COMMERCIAL,0,789472,789472,0,2831787,3621259
200112701001002,VACANT LAND,COMMERCIAL,0,557210,557210,0,85064,642274
200112701001003,VACANT LAND,COMMERCIAL,0,206374,206374,0,0,206374
200115100100000,SW 407,AG LAND,11424,0,11424,0,0,11424
200115100200000,SW 431,RESIDENTIAL,32200,0,32200,188657,0,220857
200115100300000,SW 431,RESIDENTIAL,32200,0,32200,166800,0,199000
200115100500000,SW 431,RESIDENTIAL,32200,0,32200,221619,0,253819
200115100600000,SW 431,RESIDENTIAL,32200,0,32200,183284,0,215484
200115100700000,SW 431,RESIDENTIAL,32200,0,32200,172130,0,204330
200115100800000,SW 431,RESIDENTIAL,32200,0,32200,169225,0,201425
200115100900000,SW 431,RESIDENTIAL,32200,0,32200,154684,0,186884
200115101000000,SW 431,RESIDENTIAL,32395,0,32395,158960,0,191355
200115101100000,SW 431,RESIDENTIAL,32200,0,32200,152828,0,185028
200115101200000,SW 431,RESIDENTIAL,32200,0,32200,161621,0,193821
200115101300000,SW 431,RESIDENTIAL,34500,0,34500,152512,0,187012
200115200300000,SW 431,RESIDENTIAL,39376,0,39376,176335,0,215711
200115200400000,SW 431,RESIDENTIAL,36800,0,36800,170378,0,207178
200115200500000,SW 431,RESIDENTIAL,36800,0,36800,208839,0,245639
200115200600000,SW 431,RESIDENTIAL,36800,0,36800,192600,0,229400
200115200700000,SW 431,RESIDENTIAL,39376,0,39376,210004,0,249380
200115200900000,SW 431,RESIDENTIAL,38019,0,38019,177194,0,215213
200115201000000,SW 431,RESIDENTIAL,36800,0,36800,179992,0,216792
200115201100000,SW 431,RESIDENTIAL,36800,0,36800,165811,0,202611
200115201200000,SW 431,RESIDENTIAL,36800,0,36800,165576,0,202376
200115201300000,SW 431,RESIDENTIAL,39450,0,39450,155864,0,195314
200115300100000,SW 431,RESIDENTIAL,35221,0,35221,163953,0,199174
200115300200000,SW 431,RESIDENTIAL,36800,0,36800,168653,0,205453
200115300300000,SW 431,RESIDENTIAL,36800,0,36800,176704,0,213504
200115300400000,SW 431,RESIDENTIAL,36800,0,36800,162042,0,198842
200115300500000,SW 431,RESIDENTIAL,37180,0,37180,180706,0,217886
200115400100000,SW 431,RESIDENTIAL,32200,0,32200,168863,0,201063
200115400200000,SW 431,RESIDENTIAL,32200,0,32200,172343,0,204543
200115400300000,SW 431,RESIDENTIAL,32200,0,32200,162587,0,194787
200115400400000,SW 431,RESIDENTIAL,31892,0,31892,153751,0,185643
200115400500000,SW 431,RESIDENTIAL,32200,0,32200,158630,0,190830
200115400600000,SW 431,RESIDENTIAL,36800,0,36800,173366,0,210166
200115500100000,SW 431,RESIDENTIAL,38988,0,38988,171820,0,210808
200115500200000,SW 431,RESIDENTIAL,38400,0,38400,175150,0,213550
200115500300000,SW 431,RESIDENTIAL,38400,0,38400,159024,0,197424
200115500400000,SW 431,RESIDENTIAL,38400,0,38400,163922,0,202322
200115500500000,SW 431,RESIDENTIAL,37994,0,37994,172541,0,210535
200115500600000,SW 431,RESIDENTIAL,44175,0,44175,150414,0,194589
200115500700000,SW 431,RESIDENTIAL,33920,0,33920,154739,0,188659
200115500800000,SW 431,RESIDENTIAL,34560,0,34560,140248,0,174808
200115500900000,SW 431,RESIDENTIAL,34560,0,34560,193897,0,228457
200115501000000,SW 431,RESIDENTIAL,37440,0,37440,168307,0,205747
200115600100000,SW 431,RESIDENTIAL,36800,0,36800,155081,0,191881
200115600200000,SW 431,RESIDENTIAL,32658,0,32658,147444,0,180102
200115600300000,SW 431,RESIDENTIAL,37600,0,37600,172408,0,210008
200115600400000,SW 431,RESIDENTIAL,44400,0,44400,192817,0,237217
200115600500000,SW 431,RESIDENTIAL,47915,0,47915,203656,0,251571
200115600600000,SW 431,RESIDENTIAL,40800,0,40800,151142,0,191942
200115600700000,SW 431,RESIDENTIAL,35607,0,35607,176476,0,212083
200115600800000,SW 431,RESIDENTIAL,35145,0,35145,167161,0,202306
200115600900000,SW 431,RESIDENTIAL,35145,0,35145,189793,0,224938
200115601000000,SW 431,RESIDENTIAL,35500,0,35500,184230,0,219730
200115601100000,SW 431,RESIDENTIAL,35500,0,35500,186915,0,222415
200115601200000,SW 431,RESIDENTIAL,35500,0,35500,176048,0,211548
200115601300000,SW 431,RESIDENTIAL,37500,0,37500,195511,0,233011
200115601500000,CITY PROPERTY,EXEMPT,0,0,0,0,0,0
200115700200000,CITY PROPERTY,EXEMPT,0,0,0,0,0,0
200117600200000,LG DISCOUNT/RETAIL,COMMERCIAL,0,2350441,2350441,0,5730597,8081038
200117600300000,NBHD SHOPPING CENTER,COMMERCIAL,0,728000,728000,0,1411313,2139313
200117700100000,CHURCH,EXEMPT,0,882684,882684,0,381013,1263697
200117700200000,SW 431,RESIDENTIAL,32900,0,32900,187230,0,220130
200117700300000,SW 431,RESIDENTIAL,37946,0,37946,217560,0,255506
200117700400000,SW 431,RESIDENTIAL,39077,0,39077,156181,0,195258
200117700500000,SW 431,RESIDENTIAL,37456,0,37456,154249,0,191705
200117700600000,SW 431,RESIDENTIAL,37075,0,37075,142283,0,179358
200117700700000,SW 431,RESIDENTIAL,38325,0,38325,153468,0,191793
200117800100000,SW 431,RESIDENTIAL,36720,0,36720,150701,0,187421
200117800200000,SW 431,RESIDENTIAL,37636,0,37636,135925,0,173561
200117800300000,SW 431,RESIDENTIAL,38012,0,38012,174946,0,212958
200117800400000,SW 431,RESIDENTIAL,37080,0,37080,231145,0,268225
200117800500000,SW 431,RESIDENTIAL,38675,0,38675,208541,0,247216
200117800600000,SW 431,RESIDENTIAL,34125,0,34125,201682,0,235807
200117800700000,SW 431,RESIDENTIAL,34804,0,34804,154518,0,189322
200117800800000,SW 431,RESIDENTIAL,38150,0,38150,166673,0,204823
200117800900000,SW 431,RESIDENTIAL,37060,0,37060,164291,0,201351
200117801000000,SW 431,RESIDENTIAL,50774,0,50774,219292,0,270066
200117801100000,SW 431,RESIDENTIAL,38966,0,38966,165476,0,204442
200117900100000,SW 431,RESIDENTIAL,45267,0,45267,181552,0,226819
200117900200000,SW 431,RESIDENTIAL,34875,0,34875,180056,0,214931
200117900300000,SW 431,RESIDENTIAL,34500,0,34500,200077,0,234577
200117900400000,SW 431,RESIDENTIAL,34500,0,34500,146362,0,180862
200117900500000,SW 431,RESIDENTIAL,35346,0,35346,156090,0,191436
200118000100000,SW 431,RESIDENTIAL,39440,0,39440,169698,0,209138
200118000200000,SW 431,RESIDENTIAL,37714,0,37714,197911,0,235625
200118000300000,SW 431,RESIDENTIAL,36040,0,36040,163783,0,199823
200118000400000,SW 431,RESIDENTIAL,35449,0,35449,178706,0,214155
200118000500000,SW 431,RESIDENTIAL,34974,0,34974,180103,0,215077
200118000600000,SW 431,RESIDENTIAL,32200,0,32200,163998,0,196198
200118000700000,SW 431,RESIDENTIAL,32200,0,32200,151476,0,183676
200118100100000,SW 431,RESIDENTIAL,32200,0,32200,176031,0,208231
200118100200000,SW 431,RESIDENTIAL,32200,0,32200,145967,0,178167
200120101000000,SW 407,AG LAND,15031,0,15031,0,0,15031
200120101200000,SW 407,RESIDENTIAL,172350,0,172350,466612,0,638962
200120200700000,SW 407,RESIDENTIAL,11321,0,11321,0,0,11321
200120200800000,SW 407,RESIDENTIAL,19613,0,19613,0,0,19613
200120300400000,SW 407,RESIDENTIAL,20405,0,20405,0,0,20405
200122700200000,SW 407,AG LAND,9352,0,9352,0,0,9352
200132600100000,SW 418,AG LAND,76161,0,76161,0,0,76161
200132600200000,SW 460,RESIDENTIAL,53950,0,53950,207177,0,261127
200132600300000,SW 460,RESIDENTIAL,102000,0,102000,265455,0,367455
200137600300000,SW 460,RESIDENTIAL,25979,0,25979,0,0,25979
200137600400000,SCHOOL,EXEMPT,0,0,0,0,0,0
200137600500000,SW 460,RESIDENTIAL,12983,0,12983,0,0,12983
200137600600000,SW 460,RESIDENTIAL,12916,0,12916,0,0,12916
200137600700000,SW 460,RESIDENTIAL,13049,0,13049,4890,0,17939
200137600800000,SW 460,RESIDENTIAL,62573,0,62573,82979,0,145552
200137600900000,SW 460,RESIDENTIAL,46659,0,46659,83857,0,130516
200137601000000,SW 460,RESIDENTIAL,8808,0,8808,0,0,8808
200137601100000,SW 460,RESIDENTIAL,62069,0,62069,0,0,62069
200140100500000,BRANCH BANK/CU,COMMERCIAL,0,480620,480620,0,890961,1371581
200140100600000,VACANT LAND,COMMERCIAL,0,341350,341350,0,0,341350
200142900300000,CITY PROPERTY,EXEMPT,0,0,0,0,0,0
200145100300000,WAREHOUSE,COMMERCIAL,0,925000,925000,0,5825920,6750920
200145100500000,WAREHOUSE,COMMERCIAL,0,833250,833250,0,3666750,4500000
200145200100000,WAREHOUSE,COMMERCIAL,0,251000,251000,0,824710,1075710
200145200200000,WAREHOUSE,COMMERCIAL,0,328750,328750,0,321196,649946
200147600100000,VACANT LAND,COMMERCIAL,0,588450,588450,0,0,588450
200210100400000,SW 453,AG LAND,52053,0,52053,0,0,52053
200210300100000,SW 459,RESIDENTIAL,1549,0,1549,0,0,1549
200210300200000,SW 459,RESIDENTIAL,1663,0,1663,0,0,1663
200210300300000,SW 459,RESIDENTIAL,1588,0,1588,0,0,1588
200210300400000,SW 459,RESIDENTIAL,1614,0,1614,0,0,1614
200210300500000,SW 459,RESIDENTIAL,1603,0,1603,0,0,1603
200210300600000,SW 459,RESIDENTIAL,1956,0,1956,0,0,1956
200210400100000,SW 459,RESIDENTIAL,1408,0,1408,0,0,1408
200210400200000,SW 459,RESIDENTIAL,1408,0,1408,0,0,1408
200210400300000,SW 459,RESIDENTIAL,1418,0,1418,0,0,1418
200210400400000,SW 459,RESIDENTIAL,1578,0,1578,0,0,1578
200210400500000,SW 459,RESIDENTIAL,1471,0,1471,0,0,1471
200210400600000,SW 459,RESIDENTIAL,2991,0,2991,0,0,2991
200212600300000,SW 453,RESIDENTIAL,44533,0,44533,166120,0,210653
200212600400000,SW 453,RESIDENTIAL,40552,0,40552,175608,0,216160
200212600500000,SW 453,RESIDENTIAL,40552,0,40552,158432,0,198984
200212600600000,SW 453,RESIDENTIAL,40552,0,40552,155803,0,196355
200212600700000,SW 453,RESIDENTIAL,40552,0,40552,159304,0,199856
200212600800000,SW 453,RESIDENTIAL,40552,0,40552,155342,0,195894
200212600900000,SW 453,RESIDENTIAL,40552,0,40552,164185,0,204737
200212601000000,SW 453,RESIDENTIAL,40552,0,40552,176936,0,217488
200212601100000,SW 453,RESIDENTIAL,40552,0,40552,146701,0,187253
200212601200000,SW 453,RESIDENTIAL,40552,0,40552,169061,0,209613
200212601300000,SW 453,RESIDENTIAL,40552,0,40552,200041,0,240593
200212601400000,SW 453,RESIDENTIAL,40552,0,40552,188190,0,228742
200212601500000,SW 453,RESIDENTIAL,40552,0,40552,163704,0,204256
200212601600000,SW 453,RESIDENTIAL,40552,0,40552,152968,0,193520
200212601700000,SW 453,RESIDENTIAL,40552,0,40552,176316,0,216868
200212601800000,SW 453,RESIDENTIAL,40953,0,40953,168691,0,209644
200212602000000,CITY PROPERTY,EXEMPT,0,0,0,0,0,0
200212602100000,SW 453,RESIDENTIAL,40552,0,40552,144055,0,184607
200212602200000,SW 453,RESIDENTIAL,41076,0,41076,136069,0,177145
200212602300000,SW 453,RESIDENTIAL,40953,0,40953,127536,0,168489
200212602400000,SW 453,RESIDENTIAL,40953,0,40953,139697,0,180650
200212602500000,SW 453,RESIDENTIAL,40552,0,40552,144382,0,184934
200212602600000,SW 453,RESIDENTIAL,40552,0,40552,142317,0,182869
200212602700000,SW 453,RESIDENTIAL,40552,0,40552,154002,0,194554
200212602800000,SW 453,RESIDENTIAL,40552,0,40552,172362,0,212914
200212602900000,SW 453,RESIDENTIAL,40552,0,40552,135779,0,176331
200212603000000,SW 453,RESIDENTIAL,40552,0,40552,143923,0,184475
200212603100000,SW 453,RESIDENTIAL,40552,0,40552,146018,0,186570
200212603200000,SW 453,RESIDENTIAL,40552,0,40552,151009,0,191561
200212603300000,SW 453,RESIDENTIAL,40552,0,40552,136965,0,177517
200212603400000,SW 453,RESIDENTIAL,40552,0,40552,140470,0,181022
200212603500000,SW 453,RESIDENTIAL,40552,0,40552,159958,0,200510
200212603600000,SW 453,RESIDENTIAL,243,0,243,0,0,243
200212700100000,SW 453,RESIDENTIAL,44990,0,44990,179094,0,224084
200212700200000,SW 453,RESIDENTIAL,39600,0,39600,156070,0,195670
200212700300000,SW 453,RESIDENTIAL,39600,0,39600,156559,0,196159
200212700400000,SW 453,RESIDENTIAL,39600,0,39600,164043,0,203643
200212700500000,SW 453,RESIDENTIAL,39600,0,39600,157552,0,197152
200212700600000,SW 453,RESIDENTIAL,39600,0,39600,175168,0,214768
200212700700000,SW 453,RESIDENTIAL,43800,0,43800,179575,0,223375
200212700800000,SW 453,RESIDENTIAL,41250,0,41250,153733,0,194983
200212700900000,SW 453,RESIDENTIAL,41250,0,41250,168853,0,210103
200212701000000,SW 453,RESIDENTIAL,41250,0,41250,180883,0,222133
200212701100000,SW 453,RESIDENTIAL,40700,0,40700,166456,0,207156
200212701200000,SW 453,RESIDENTIAL,40700,0,40700,164847,0,205547
200212701300000,SW 453,RESIDENTIAL,41107,0,41107,143282,0,184389
200212701400000,SW 453,RESIDENTIAL,41107,0,41107,135705,0,176812
200212701500000,SW 453,RESIDENTIAL,41514,0,41514,154036,0,195550
200212701600000,SW 453,RESIDENTIAL,41107,0,41107,168224,0,209331
200212701800000,SW 453,RESIDENTIAL,2952,0,2952,0,0,2952
200212701900000,SW 459,RESIDENTIAL,34747,0,34747,124267,0,159014
200212702000000,SW 459,RESIDENTIAL,22220,0,22220,128682,0,150902
200212702100000,SW 459,RESIDENTIAL,20554,0,20554,122467,0,143021
200212702200000,SW 459,RESIDENTIAL,22440,0,22440,122467,0,144907
200212702300000,SW 459,RESIDENTIAL,25806,0,25806,122508,0,148314
200212702400000,SW 459,RESIDENTIAL,20757,0,20757,122508,0,143265
200212702500000,SW 459,RESIDENTIAL,20757,0,20757,122508,0,143265
200212702600000,SW 459,RESIDENTIAL,20554,0,20554,122508,0,143062
200212702700000,SW 459,RESIDENTIAL,20368,0,20368,122508,0,142876
200212702800000,SW 459,RESIDENTIAL,20350,0,20350,122508,0,142858
200212702900000,SW 459,RESIDENTIAL,19965,0,19965,122508,0,142473
200212703000000,SW 459,RESIDENTIAL,20147,0,20147,122508,0,142655
200212703100000,SW 459,RESIDENTIAL,20147,0,20147,126543,0,146690
200212703200000,SW 459,RESIDENTIAL,20147,0,20147,126350,0,146497
200212703300000,SW 459,RESIDENTIAL,20147,0,20147,125621,0,145768
200212703400000,SW 459,RESIDENTIAL,20147,0,20147,126536,0,146683
200212703500000,SW 459,RESIDENTIAL,20147,0,20147,129462,0,149609
200212703600000,SW 459,RESIDENTIAL,29403,0,29403,129462,0,158865
200212703700000,SW 459,RESIDENTIAL,1603,0,1603,0,0,1603
200212703800000,SW 459,RESIDENTIAL,1603,0,1603,0,0,1603
200212703900000,SW 459,RESIDENTIAL,1603,0,1603,0,0,1603
200212704000000,SW 459,RESIDENTIAL,1603,0,1603,0,0,1603
200212704100000,SW 459,RESIDENTIAL,20147,0,20147,125819,0,145966
200212704200000,SW 459,RESIDENTIAL,20147,0,20147,125621,0,145768
200212704300000,SW 459,RESIDENTIAL,1603,0,1603,0,0,1603
200212704400000,SW 459,RESIDENTIAL,1603,0,1603,0,0,1603
200212704500000,SW 459,RESIDENTIAL,1603,0,1603,0,0,1603
200212704600000,SW 459,RESIDENTIAL,1603,0,1603,0,0,1603
200212704700000,SW 459,RESIDENTIAL,1603,0,1603,0,0,1603
200212704800000,SW 459,RESIDENTIAL,1603,0,1603,0,0,1603
200212704900000,SW 459,RESIDENTIAL,1603,0,1603,0,0,1603
200212705000000,SW 459,RESIDENTIAL,1954,0,1954,0,0,1954
200212800100000,SW 453,RESIDENTIAL,44000,0,44000,136377,0,180377
200212800200000,SW 453,RESIDENTIAL,40150,0,40150,135474,0,175624
200212800300000,SW 453,RESIDENTIAL,40150,0,40150,144487,0,184637
200212800400000,SW 453,RESIDENTIAL,40150,0,40150,185499,0,225649
200212800500000,SW 453,RESIDENTIAL,41250,0,41250,90501,0,131751
200212800600000,SW 453,RESIDENTIAL,41250,0,41250,155622,0,196872
200212800700000,SW 453,RESIDENTIAL,40150,0,40150,136264,0,176414
200212800800000,SW 453,RESIDENTIAL,40150,0,40150,149198,0,189348
200212800900000,SW 453,RESIDENTIAL,40150,0,40150,127417,0,167567
200212801000000,SW 453,RESIDENTIAL,41525,0,41525,136846,0,178371
200212801100000,SW 453,RESIDENTIAL,41525,0,41525,36489,0,78014
200212801200000,SW 453,RESIDENTIAL,41250,0,41250,23082,0,64332
200212801300000,SW 453,RESIDENTIAL,233,0,233,0,0,233
200212801400000,SW 453,RESIDENTIAL,243,0,243,0,0,243
200212801500000,SW 453,RESIDENTIAL,243,0,243,0,0,243
200212801600000,SW 453,RESIDENTIAL,243,0,243,0,0,243
200212801700000,SW 453,RESIDENTIAL,254,0,254,0,0,254
200212801800000,SW 453,RESIDENTIAL,254,0,254,0,0,254
200212900100000,SW 459,RESIDENTIAL,3470,0,3470,0,0,3470
200212900200000,SW 459,RESIDENTIAL,1602,0,1602,0,0,1602
200212900300000,SW 459,RESIDENTIAL,1639,0,1639,0,0,1639
200212900400000,SW 459,RESIDENTIAL,1664,0,1664,0,0,1664
200212900500000,SW 459,RESIDENTIAL,1689,0,1689,0,0,1689
200212900600000,SW 459,RESIDENTIAL,1715,0,1715,0,0,1715
200212900700000,SW 459,RESIDENTIAL,1740,0,1740,0,0,1740
200212900800000,SW 459,RESIDENTIAL,1766,0,1766,0,0,1766
200212900900000,SW 459,RESIDENTIAL,1792,0,1792,0,0,1792
200212901000000,SW 459,RESIDENTIAL,1817,0,1817,0,0,1817
200212901100000,SW 459,RESIDENTIAL,1842,0,1842,0,0,1842
200212901200000,SW 459,RESIDENTIAL,1868,0,1868,0,0,1868
200212901300000,SW 459,RESIDENTIAL,1893,0,1893,0,0,1893
200212901400000,SW 459,RESIDENTIAL,1919,0,1919,0,0,1919
200212901500000,SW 459,RESIDENTIAL,1944,0,1944,0,0,1944
200212901600000,SW 459,RESIDENTIAL,1970,0,1970,0,0,1970
200212901700000,SW 459,RESIDENTIAL,1995,0,1995,0,0,1995
200212901800000,SW 459,RESIDENTIAL,2020,0,2020,0,0,2020
200212901900000,SW 459,RESIDENTIAL,21571,0,21571,129957,0,151528
200212902000000,SW 459,RESIDENTIAL,21775,0,21775,129957,0,151732
200212902100000,SW 459,RESIDENTIAL,21775,0,21775,126350,0,148125
200212902200000,SW 459,RESIDENTIAL,21775,0,21775,126350,0,148125
200212902300000,CITY PROPERTY,EXEMPT,0,0,0,0,0,0
200215100100000,SW 432,AG LAND,47861,0,47861,0,14753,62614
200220100100000,SW 407,AG LAND,43300,0,43300,0,0,43300
200222600100000,SW 453,AG LAND,8219,0,8219,0,0,8219
200222600200000,SW 453,RESIDENTIAL,1300,0,1300,0,0,1300
200225100200000,SW 432,RESIDENTIAL,73200,0,73200,112945,0,186145
200225100300000,SW 432,RESIDENTIAL,93000,0,93000,137617,0,230617
200225100400000,SW 432,RESIDENTIAL,62350,0,62350,116074,0,178424
200225100700000,SW 432,RESIDENTIAL,2013,0,2013,0,0,2013
200227600400000,CONVENIENCE STORE,COMMERCIAL,0,525000,525000,0,946482,1471482
200227600500000,VACANT LAND,COMMERCIAL,0,1189680,1189680,0,0,1189680
200227800100000,SW 432,AG DWELLING,4922,0,4922,197562,17619,220103
200230200100000,SW 432,RESIDENTIAL,55800,0,55800,80772,0,136572
200232800200000,SW 432,RESIDENTIAL,38760,0,38760,165276,0,204036
200232800300000,SW 432,RESIDENTIAL,39375,0,39375,178653,0,218028
200232800400000,SW 432,RESIDENTIAL,36860,0,36860,186533,0,223393
200232800500000,SW 432,RESIDENTIAL,32430,0,32430,159636,0,192066
200232800600000,SW 432,RESIDENTIAL,31825,0,31825,177375,0,209200
200232800700000,SW 432,RESIDENTIAL,33165,0,33165,161487,0,194652
200232800800000,SW 432,RESIDENTIAL,35640,0,35640,159951,0,195591
200232800900000,SW 432,RESIDENTIAL,44583,0,44583,170946,0,215529
200232801000000,SW 432,RESIDENTIAL,42400,0,42400,221423,0,263823
200232801100000,SW 432,RESIDENTIAL,35000,0,35000,166088,0,201088
200232801200000,SW 432,RESIDENTIAL,35000,0,35000,170335,0,205335
200232801300000,SW 432,RESIDENTIAL,31200,0,31200,158503,0,189703
200232801400000,SW 432,RESIDENTIAL,36015,0,36015,159651,0,195666
200232801500000,SW 432,RESIDENTIAL,40950,0,40950,196848,0,237798
200232801600000,SW 432,RESIDENTIAL,51603,0,51603,199599,0,251202
200232801700000,SW 432,RESIDENTIAL,41382,0,41382,181273,0,222655
200232801800000,SW 432,RESIDENTIAL,35845,0,35845,161420,0,197265
200232801900000,SW 432,RESIDENTIAL,35845,0,35845,206603,0,242448
200232802000000,SW 432,RESIDENTIAL,35845,0,35845,165599,0,201444
200232802100000,SW 432,RESIDENTIAL,44640,0,44640,185320,0,229960
200232802200000,SW 432,RESIDENTIAL,48213,0,48213,183793,0,232006
200232802300000,SW 432,RESIDENTIAL,42952,0,42952,180959,0,223911
200232802400000,SW 432,RESIDENTIAL,42157,0,42157,181932,0,224089
200232802500000,SW 432,RESIDENTIAL,4140,0,4140,0,0,4140
200232802600000,SW 432,RESIDENTIAL,5300,0,5300,0,0,5300
200232900100000,SW 432,RESIDENTIAL,35000,0,35000,167349,0,202349
200232900200000,SW 432,RESIDENTIAL,43600,0,43600,190368,0,233968
200232900300000,SW 432,RESIDENTIAL,33600,0,33600,188892,0,222492
200232900400000,SW 432,RESIDENTIAL,31167,0,31167,144247,0,175414
200232900500000,SW 432,RESIDENTIAL,31960,0,31960,143554,0,175514
200232900600000,SW 432,RESIDENTIAL,30680,0,30680,171950,0,202630
200232900700000,SW 432,RESIDENTIAL,33800,0,33800,183384,0,217184
200232900800000,SW 432,RESIDENTIAL,40400,0,40400,248291,0,288691
200232900900000,SW 432,RESIDENTIAL,34300,0,34300,154705,0,189005
200240100200000,SW 422,AG LAND,64304,0,64304,0,0,64304
200245100600000,SW 422,AG DWELLING,5801,0,5801,94897,2936,103634
200247600100000,SW 460,RESIDENTIAL,37967,0,37967,165378,0,203345
200247600200000,SW 460,RESIDENTIAL,38232,0,38232,125641,0,163873
200247600300000,SW 460,RESIDENTIAL,38232,0,38232,100132,0,138364
200247600400000,SW 460,RESIDENTIAL,38232,0,38232,110588,0,148820
200247600500000,SW 460,RESIDENTIAL,38232,0,38232,149350,0,187582
200247600600000,SW 460,RESIDENTIAL,38232,0,38232,96489,0,134721
200247600700000,SW 460,RESIDENTIAL,46463,0,46463,151490,0,197953
200247600800000,SW 460,RESIDENTIAL,39825,0,39825,130430,0,170255
200247600900000,SW 460,RESIDENTIAL,34515,0,34515,104656,0,139171
200247601000000,SW 460,RESIDENTIAL,78273,0,78273,9374,0,87647
200247601100000,SW 460,RESIDENTIAL,46058,0,46058,141007,0,187065
200247601300000,SW 422,AG LAND,13252,0,13252,0,0,13252
200247601400000,SW 422,AG LAND,37690,0,37690,0,0,37690
200247601500000,SW 460,RESIDENTIAL,82010,0,82010,137834,0,219844
200310100200000,SW 432,RESIDENTIAL,36125,0,36125,267124,0,303249
200310100300000,SW 432,RESIDENTIAL,36414,0,36414,186078,0,222492
200310100400000,SW 432,RESIDENTIAL,36486,0,36486,218411,0,254897
200310100500000,SW 432,RESIDENTIAL,33482,0,33482,190162,0,223644
200310100600000,SW 432,RESIDENTIAL,34884,0,34884,166595,0,201479
200310100700000,SW 432,RESIDENTIAL,34738,0,34738,195470,0,230208
200310100800000,SW 432,RESIDENTIAL,35794,0,35794,217434,0,253228
200310100900000,SW 432,RESIDENTIAL,39102,0,39102,205782,0,244884
200310101000000,SW 432,RESIDENTIAL,37951,0,37951,0,0,37951
200310101100000,SW 432,RESIDENTIAL,36432,0,36432,159669,0,196101
200310101200000,SW 432,RESIDENTIAL,35044,0,35044,206357,0,241401
200310101300000,SW 432,RESIDENTIAL,34744,0,34744,182756,0,217500
200310101400000,SW 432,RESIDENTIAL,38150,0,38150,177733,0,215883
200310101500000,SW 432,RESIDENTIAL,39584,0,39584,133013,0,172597
200310101600000,SW 432,RESIDENTIAL,38813,0,38813,137356,0,176169
200310101700000,SW 432,RESIDENTIAL,37800,0,37800,133013,0,170813
200310101800000,SW 432,RESIDENTIAL,37800,0,37800,141003,0,178803
200310101900000,SW 432,RESIDENTIAL,38973,0,38973,0,0,38973
200310102000000,SW 432,RESIDENTIAL,37900,0,37900,0,0,37900
200310102100000,SW 432,RESIDENTIAL,38000,0,38000,0,0,38000
200310102200000,SW 432,RESIDENTIAL,1980,0,1980,0,0,1980
200310200100000,SW 432,RESIDENTIAL,31500,0,31500,175003,0,206503
200310200200000,SW 432,RESIDENTIAL,33469,0,33469,192207,0,225676
200310300200000,SW 432,RESIDENTIAL,37762,0,37762,173887,0,211649
200310300300000,SW 432,RESIDENTIAL,34510,0,34510,210619,0,245129
200310300400000,SW 432,RESIDENTIAL,34435,0,34435,199429,0,233864
200310300500000,SW 432,RESIDENTIAL,37232,0,37232,191415,0,228647
200310300600000,SW 432,RESIDENTIAL,35700,0,35700,160680,0,196380
200310300700000,SW 432,RESIDENTIAL,31324,0,31324,151374,0,182698
200310300800000,SW 432,RESIDENTIAL,31500,0,31500,178760,0,210260
200310400100000,SW 432,RESIDENTIAL,34776,0,34776,158441,0,193217
200310400200000,SW 432,RESIDENTIAL,34020,0,34020,134121,0,168141
200310400300000,SW 432,RESIDENTIAL,31500,0,31500,131369,0,162869
200310400400000,SW 432,RESIDENTIAL,31500,0,31500,160102,0,191602
200310500100000,SW 432,RESIDENTIAL,35150,0,35150,136801,0,171951
200310500200000,SW 432,RESIDENTIAL,36200,0,36200,223213,0,259413
200310500300000,SW 432,RESIDENTIAL,37125,0,37125,186713,0,223838
200310500400000,SW 432,RESIDENTIAL,36816,0,36816,149033,0,185849
200310500500000,SW 432,RESIDENTIAL,35380,0,35380,212921,0,248301
200310500600000,SW 432,RESIDENTIAL,59238,0,59238,224007,0,283245
200310500700000,SW 432,RESIDENTIAL,37170,0,37170,182681,0,219851
200310500800000,SW 432,RESIDENTIAL,39780,0,39780,211421,0,251201
200310500900000,SW 432,RESIDENTIAL,36855,0,36855,0,0,36855
200310501000000,SW 432,RESIDENTIAL,39780,0,39780,241277,0,281057
200310501100000,SW 432,RESIDENTIAL,36855,0,36855,204178,0,241033
200310501200000,SW 432,RESIDENTIAL,37966,0,37966,0,0,37966
200310501300000,SW 432,RESIDENTIAL,40162,0,40162,0,0,40162
200310501400000,SW 432,RESIDENTIAL,37199,0,37199,0,0,37199
200310501500000,SW 432,RESIDENTIAL,38122,0,38122,0,0,38122
200310501600000,SW 432,RESIDENTIAL,48504,0,48504,206535,0,255039
200310501700000,SW 432,RESIDENTIAL,37639,0,37639,236165,0,273804
200310501800000,SW 432,RESIDENTIAL,32302,0,32302,40971,0,73273
200310501900000,SW 432,RESIDENTIAL,35725,0,35725,0,0,35725
200310502000000,SW 432,RESIDENTIAL,39508,0,39508,215606,0,255114
200310502100000,SW 432,RESIDENTIAL,41357,0,41357,0,0,41357
200310502200000,SW 432,RESIDENTIAL,38749,0,38749,233406,0,272155
200310502300000,SW 432,RESIDENTIAL,40244,0,40244,0,0,40244
200310502400000,SW 432,RESIDENTIAL,34650,0,34650,0,0,34650
200310502500000,SW 432,RESIDENTIAL,40400,0,40400,261606,0,302006
200310502600000,SW 432,RESIDENTIAL,35350,0,35350,0,0,35350
200310502700000,SW 432,RESIDENTIAL,38764,0,38764,0,0,38764
200310502800000,SW 432,RESIDENTIAL,36986,0,36986,238764,0,275750
200310502900000,SW 432,RESIDENTIAL,38215,0,38215,184185,0,222400
200310503000000,SW 432,RESIDENTIAL,38160,0,38160,247255,0,285415
200310503100000,SW 432,RESIDENTIAL,37800,0,37800,190448,0,228248
200310503200000,SW 432,RESIDENTIAL,36750,0,36750,261029,0,297779
200310503300000,SW 432,RESIDENTIAL,37905,0,37905,179894,0,217799
200310503400000,STATE PROPERTY,OTHER,0,0,0,0,0,0
200317600200000,SW 432,RESIDENTIAL,36448,0,36448,214168,0,250616
200317600300000,SW 432,RESIDENTIAL,42050,0,42050,253714,0,295764
200317600400000,SW 432,RESIDENTIAL,37182,0,37182,228004,0,265186
200317600500000,SW 432,RESIDENTIAL,38220,0,38220,0,0,38220
200317600600000,SW 432,RESIDENTIAL,36176,0,36176,204673,0,240849
200317600700000,SW 432,RESIDENTIAL,35350,0,35350,214596,0,249946
200317600800000,SW 432,RESIDENTIAL,34996,0,34996,206736,0,241732
200317600900000,SW 432,RESIDENTIAL,37271,0,37271,174999,0,212270
200317601100000,SW 432,RESIDENTIAL,32300,0,32300,156313,0,188613
200317601200000,SW 432,RESIDENTIAL,32300,0,32300,138714,0,171014
200317601300000,SW 432,RESIDENTIAL,32181,0,32181,168649,0,200830
200317601400000,SW 432,RESIDENTIAL,34294,0,34294,160780,0,195074
200317601500000,SW 432,RESIDENTIAL,31176,0,31176,157219,0,188395
200317601600000,SW 432,RESIDENTIAL,39105,0,39105,174099,0,213204
200317601700000,SW 432,RESIDENTIAL,35235,0,35235,175404,0,210639
200317601800000,SW 432,RESIDENTIAL,33620,0,33620,112109,0,145729
200317601900000,SW 432,RESIDENTIAL,31959,0,31959,135917,0,167876
200317602000000,SW 432,RESIDENTIAL,31800,0,31800,127898,0,159698
200317602100000,SW 432,RESIDENTIAL,31800,0,31800,132983,0,164783
200317602200000,SW 432,RESIDENTIAL,31800,0,31800,132497,0,164297
200317602300000,SW 432,RESIDENTIAL,31800,0,31800,130805,0,162605
200317602500000,SW 432,RESIDENTIAL,31800,0,31800,142361,0,174161
200317602600000,SW 432,RESIDENTIAL,31800,0,31800,133019,0,164819
200317602700000,SW 432,RESIDENTIAL,35207,0,35207,192211,0,227418
200317602800000,SW 432,RESIDENTIAL,36448,0,36448,149542,0,185990
200317602900000,SW 432,RESIDENTIAL,35872,0,35872,164567,0,200439
200317603000000,SW 432,RESIDENTIAL,35698,0,35698,144743,0,180441
200317603100000,SW 432,RESIDENTIAL,35990,0,35990,165900,0,201890
200317603200000,SW 432,RESIDENTIAL,35506,0,35506,182376,0,217882
200317603300000,SW 432,RESIDENTIAL,34807,0,34807,150964,0,185771
200317603400000,SW 432,RESIDENTIAL,49029,0,49029,248062,0,297091
200317700100000,SW 432,RESIDENTIAL,34020,0,34020,155258,0,189278
200317700200000,SW 432,RESIDENTIAL,31500,0,31500,156290,0,187790
200317700300000,SW 432,RESIDENTIAL,31500,0,31500,147551,0,179051
200317700400000,SW 432,RESIDENTIAL,34020,0,34020,144831,0,178851
200317700500000,SW 432,RESIDENTIAL,31500,0,31500,138277,0,169777
200317700600000,SW 432,RESIDENTIAL,31500,0,31500,142620,0,174120
200317700700000,SW 432,RESIDENTIAL,34020,0,34020,165216,0,199236
200317700800000,SW 432,RESIDENTIAL,31500,0,31500,141957,0,173457
200317700900000,SW 432,RESIDENTIAL,31500,0,31500,128732,0,160232
200317701000000,SW 432,RESIDENTIAL,34020,0,34020,157931,0,191951
200317701100000,SW 432,RESIDENTIAL,31500,0,31500,141477,0,172977
200317701200000,SW 432,RESIDENTIAL,31500,0,31500,148202,0,179702
200317701300000,SW 432,RESIDENTIAL,34020,0,34020,114275,0,148295
200317701400000,SW 432,RESIDENTIAL,31500,0,31500,143609,0,175109
200317701500000,SW 432,RESIDENTIAL,31500,0,31500,146101,0,177601
200317701600000,SW 432,RESIDENTIAL,34430,0,34430,160512,0,194942
200317800100000,SW 432,RESIDENTIAL,35300,0,35300,137434,0,172734
200317800200000,SW 432,RESIDENTIAL,33741,0,33741,159779,0,193520
200317800300000,SW 432,RESIDENTIAL,33403,0,33403,140791,0,174194
200317800400000,SW 432,RESIDENTIAL,34914,0,34914,147863,0,182777
200317800500000,SW 432,RESIDENTIAL,32271,0,32271,182483,0,214754
200317800600000,SW 432,RESIDENTIAL,35580,0,35580,128315,0,163895
200317800700000,SW 432,RESIDENTIAL,32100,0,32100,134191,0,166291
200317800800000,SW 432,RESIDENTIAL,32100,0,32100,116755,0,148855
200317800900000,SW 432,RESIDENTIAL,32100,0,32100,134179,0,166279
200317801000000,SW 432,RESIDENTIAL,32100,0,32100,119765,0,151865
200317801100000,SW 432,RESIDENTIAL,32889,0,32889,137119,0,170008
200317801200000,SW 432,RESIDENTIAL,33022,0,33022,139221,0,172243
200317801300000,SW 432,RESIDENTIAL,35831,0,35831,128646,0,164477
200317801400000,SW 432,RESIDENTIAL,36450,0,36450,175964,0,212414
200317801500000,SW 432,RESIDENTIAL,32958,0,32958,165646,0,198604
200317801600000,SW 432,RESIDENTIAL,32100,0,32100,148730,0,180830
200317801700000,SW 432,RESIDENTIAL,32100,0,32100,139069,0,171169
200317900100000,SW 432,RESIDENTIAL,35179,0,35179,150003,0,185182
200317900200000,SW 432,RESIDENTIAL,31806,0,31806,129125,0,160931
200317900300000,SW 432,RESIDENTIAL,31806,0,31806,147587,0,179393
200317900400000,SW 432,RESIDENTIAL,31806,0,31806,131512,0,163318
200317900500000,SW 432,RESIDENTIAL,31806,0,31806,145590,0,177396
200317900600000,SW 432,RESIDENTIAL,31806,0,31806,134474,0,166280
200317900700000,SW 432,RESIDENTIAL,31806,0,31806,154863,0,186669
200317900800000,SW 432,RESIDENTIAL,31806,0,31806,145797,0,177603
200317900900000,SW 432,RESIDENTIAL,31806,0,31806,140273,0,172079
200317901000000,SW 432,RESIDENTIAL,31806,0,31806,133296,0,165102
200317901100000,SW 432,RESIDENTIAL,33402,0,33402,166433,0,199835
200317901200000,SW 432,RESIDENTIAL,33412,0,33412,151253,0,184665
200317901300000,SW 432,RESIDENTIAL,33750,0,33750,140230,0,173980
200317901400000,SW 432,RESIDENTIAL,34065,0,34065,151789,0,185854
200317901500000,SW 432,RESIDENTIAL,33696,0,33696,199581,0,233277
200317901600000,SW 432,RESIDENTIAL,31500,0,31500,137622,0,169122
200317901700000,SW 432,RESIDENTIAL,32362,0,32362,128133,0,160495
200317901800000,SW 432,RESIDENTIAL,32076,0,32076,135870,0,167946
200317901900000,SW 432,RESIDENTIAL,32076,0,32076,151376,0,183452
200317902000000,SW 432,RESIDENTIAL,32076,0,32076,158041,0,190117
200317902100000,SW 432,RESIDENTIAL,32076,0,32076,192884,0,224960
200317902200000,SW 432,RESIDENTIAL,32076,0,32076,154736,0,186812
200317902300000,SW 432,RESIDENTIAL,35856,0,35856,171568,0,207424
200318000100000,SW 432,RESIDENTIAL,49280,0,49280,146688,0,195968
200318000200000,SW 432,RESIDENTIAL,35700,0,35700,150919,0,186619
200318000300000,SW 432,RESIDENTIAL,35700,0,35700,136592,0,172292
200318000400000,SW 432,RESIDENTIAL,35700,0,35700,111999,0,147699
200318000500000,SW 432,RESIDENTIAL,35700,0,35700,129513,0,165213
200318000600000,SW 432,RESIDENTIAL,35700,0,35700,139128,0,174828
200318000700000,SW 432,RESIDENTIAL,35700,0,35700,124782,0,160482
200318000800000,SW 432,RESIDENTIAL,36138,0,36138,145071,0,181209
200318100100000,SW 432,RESIDENTIAL,35065,0,35065,141102,0,176167
200318100200000,SW 432,RESIDENTIAL,31920,0,31920,173708,0,205628
200318100300000,SW 432,RESIDENTIAL,31920,0,31920,138171,0,170091
200318100400000,SW 432,RESIDENTIAL,31920,0,31920,158239,0,190159
200318100500000,SW 432,RESIDENTIAL,31920,0,31920,137707,0,169627
200318100600000,SW 432,RESIDENTIAL,31920,0,31920,148939,0,180859
200318100700000,SW 432,RESIDENTIAL,31920,0,31920,131288,0,163208
200318100800000,SW 432,RESIDENTIAL,33675,0,33675,168783,0,202458
200340100200000,SW 432,RESIDENTIAL,38053,0,38053,174028,0,212081
200340100300000,SW 432,RESIDENTIAL,30600,0,30600,164885,0,195485
200340100400000,SW 432,RESIDENTIAL,30600,0,30600,165089,0,195689
200340100500000,SW 432,RESIDENTIAL,30600,0,30600,160359,0,190959
200340100600000,SW 432,RESIDENTIAL,30600,0,30600,133401,0,164001
200340100700000,SW 432,RESIDENTIAL,30600,0,30600,188647,0,219247
200340100800000,SW 432,RESIDENTIAL,30600,0,30600,150143,0,180743
200340100900000,SW 432,RESIDENTIAL,30600,0,30600,184957,0,215557
200340101000000,SW 432,RESIDENTIAL,30600,0,30600,158084,0,188684
200340101100000,SW 432,RESIDENTIAL,30600,0,30600,167255,0,197855
200340101300000,SW 432,RESIDENTIAL,20,0,20,0,0,20
200340101500000,SW 432,RESIDENTIAL,6338,0,6338,0,0,6338
200340101600000,SW 432,RESIDENTIAL,19035,0,19035,1837,0,20872
200340102500000,SW 432,RESIDENTIAL,58250,0,58250,0,0,58250
200342600400000,SW 432,RESIDENTIAL,20,0,20,0,0,20
200342600500000,SW 432,RESIDENTIAL,20,0,20,0,0,20
201110100100000,SW 422,AG LAND,92108,0,92108,0,0,92108
201112600300000,SW 422,AG LAND,104670,0,104670,0,0,104670
201212600100000,FOOD GRADE;INDUST,INDUSTRIAL,0,1417372,1417372,0,22538449,23955821
201232600500000,SW 418,AG LAND,69463,0,69463,0,0,69463
201237700100000,SW 418,AG LAND,1346,0,1346,0,0,1346
201240100100000,SW 418,AG LAND,29032,0,29032,0,0,29032
201240100200000,CENTRALLY ASSESSED,OTHER,0,0,0,0,0,0
201245100100000,SW 418,AG LAND,56786,0,56786,0,0,56786
201247600100000,SW 418,AG LAND,94822,0,94822,0,0,94822
202410100100000,CITY PROPERTY,EXEMPT,0,0,0,0,0,0
202525100100000,CITY PROPERTY,EXEMPT,0,0,0,0,0,0
202610100100000,CITY PROPERTY,EXEMPT,0,0,0,0,0,0
202612600100000,CITY PROPERTY,EXEMPT,0,0,0,0,0,0
