GIS_Number_valuations,Map_Name_valuations,Class_valuations,2016 Land Res,2016 Land Comm,2016 Land Total,2016 Dwlg,2016 Improv,2016 Total
112235302100000,NE 175,AG LAND,23100,0,23100,0,0,23100
112625100100000,CHURCH,EXEMPT,0,480000,480000,0,477800,957800
112625100200000,CHURCH,EXEMPT,0,629400,629400,0,8591700,9221100
112630300100000,NE 160,RESIDENTIAL,50700,0,50700,164400,0,215100
112630300200000,NE 160,RESIDENTIAL,48800,0,48800,190800,0,239600
112630300300000,NE 160,RESIDENTIAL,47800,0,47800,190000,0,237800
112630400100000,NE 160,RESIDENTIAL,49900,0,49900,254000,0,303900
112630400200000,NE 160,RESIDENTIAL,46900,0,46900,194400,0,241300
112630400300000,NE 160,RESIDENTIAL,47100,0,47100,192800,0,239900
112630400400000,NE 160,RESIDENTIAL,49300,0,49300,199200,0,248500
112630400500000,NE 160,RESIDENTIAL,47400,0,47400,200400,0,247800
112630400600000,NE 160,RESIDENTIAL,47200,0,47200,194500,0,241700
112630400700000,NE 160,RESIDENTIAL,43700,0,43700,183300,0,227000
112630400800000,NE 160,RESIDENTIAL,46000,0,46000,189500,0,235500
112630400900000,NE 160,RESIDENTIAL,48500,0,48500,211600,0,260100
112630401000000,NE 160,RESIDENTIAL,47900,0,47900,219000,0,266900
112630401100000,NE 160,RESIDENTIAL,49900,0,49900,162900,0,212800
112630401200000,NE 160,RESIDENTIAL,50300,0,50300,155900,0,206200
112630500100000,NE 160,RESIDENTIAL,50200,0,50200,237900,0,288100
112630500200000,NE 160,RESIDENTIAL,47100,0,47100,189300,0,236400
112630500300000,NE 160,RESIDENTIAL,47500,0,47500,188700,0,236200
112630500400000,NE 160,RESIDENTIAL,49300,0,49300,217700,0,267000
112630500500000,NE 160,RESIDENTIAL,46900,0,46900,187800,0,234700
112630500600000,NE 160,RESIDENTIAL,46900,0,46900,186300,0,233200
112630500700000,NE 160,RESIDENTIAL,53900,0,53900,184600,0,238500
112630600100000,NE 160,RESIDENTIAL,48300,0,48300,193800,0,242100
112630600200000,NE 160,RESIDENTIAL,48400,0,48400,213000,0,261400
112630600300000,NE 160,RESIDENTIAL,47800,0,47800,191100,0,238900
112630600400000,NE 160,RESIDENTIAL,49800,0,49800,243400,0,293200
112630600500000,NE 160,RESIDENTIAL,49300,0,49300,184200,0,233500
112630600600000,NE 160,RESIDENTIAL,43300,0,43300,190200,0,233500
112630600700000,NE 160,RESIDENTIAL,46900,0,46900,234300,0,281200
112630600800000,NE 160,RESIDENTIAL,45800,0,45800,227000,0,272800
112630600900000,NE 160,RESIDENTIAL,48300,0,48300,200200,0,248500
112630601000000,NE 160,RESIDENTIAL,43700,0,43700,199800,0,243500
112630601100000,NE 160,RESIDENTIAL,48300,0,48300,246000,0,294300
112630601200000,NE 160,RESIDENTIAL,46000,0,46000,214500,0,260500
112630601300000,NE 160,RESIDENTIAL,43700,0,43700,216800,0,260500
112630601400000,NE 160,RESIDENTIAL,47700,0,47700,229700,0,277400
112630601500000,NE 160,RESIDENTIAL,45500,0,45500,205600,0,251100
112630601600000,NE 160,RESIDENTIAL,48400,0,48400,204200,0,252600
112630601700000,NE 160,RESIDENTIAL,44000,0,44000,193800,0,237800
112630601800000,NE 160,RESIDENTIAL,45600,0,45600,226300,0,271900
112630601900000,NE 160,RESIDENTIAL,49400,0,49400,185500,0,234900
112630700100000,NE 160,RESIDENTIAL,50800,0,50800,179600,0,230400
112632700100000,NE 160,RESIDENTIAL,48900,0,48900,215400,0,264300
112632700200000,NE 160,RESIDENTIAL,51700,0,51700,229300,0,281000
112632700300000,NE 160,RESIDENTIAL,52400,0,52400,217700,0,270100
112632700400000,NE 160,RESIDENTIAL,45300,0,45300,202000,0,247300
112632700500000,NE 160,RESIDENTIAL,47400,0,47400,200000,0,247400
112632700600000,NE 160,RESIDENTIAL,47600,0,47600,201400,0,249000
112632700700000,NE 160,RESIDENTIAL,45900,0,45900,164900,0,210800
112632700800000,NE 160,RESIDENTIAL,48800,0,48800,185300,0,234100
112632700900000,NE 160,RESIDENTIAL,48600,0,48600,190300,0,238900
112632701000000,NE 160,RESIDENTIAL,47800,0,47800,163500,0,211300
112632701100000,NE 160,RESIDENTIAL,45700,0,45700,181200,0,226900
112632701200000,NE 160,RESIDENTIAL,47600,0,47600,209100,0,256700
112632701300000,NE 160,RESIDENTIAL,47600,0,47600,193100,0,240700
112632701400000,NE 160,RESIDENTIAL,50200,0,50200,188800,0,239000
112632701500000,NE 160,RESIDENTIAL,46900,0,46900,201200,0,248100
112632701600000,NE 160,RESIDENTIAL,48500,0,48500,197000,0,245500
112632701700000,NE 160,RESIDENTIAL,47600,0,47600,256300,0,303900
112632701800000,NE 160,RESIDENTIAL,42800,0,42800,211500,0,254300
112632701900000,NE 160,RESIDENTIAL,48100,0,48100,259400,0,307500
112632702000000,NE 160,RESIDENTIAL,47200,0,47200,189400,0,236600
112632702100000,NE 160,RESIDENTIAL,47500,0,47500,242500,0,290000
112632702200000,NE 160,RESIDENTIAL,44100,0,44100,178900,0,223000
112632702300000,NE 160,RESIDENTIAL,48800,0,48800,202200,0,251000
112632702400000,NE 160,RESIDENTIAL,49000,0,49000,251200,0,300200
112632800100000,NE 160,RESIDENTIAL,49700,0,49700,214800,0,264500
112632800200000,CHURCH,EXEMPT,0,525300,525300,0,375500,900800
112632800300000,NE 160,RESIDENTIAL,77500,0,77500,302600,0,380100
112632800400000,NE 160,RESIDENTIAL,74800,0,74800,173700,0,248500
112632800500000,NE 160,RESIDENTIAL,50300,0,50300,181100,0,231400
112632800600000,NE 160,RESIDENTIAL,49500,0,49500,230300,0,279800
112632800700000,NE 160,RESIDENTIAL,46900,0,46900,189600,0,236500
112632800800000,NE 160,RESIDENTIAL,49900,0,49900,202200,0,252100
112632800900000,NE 160,RESIDENTIAL,49000,0,49000,209100,0,258100
112632801000000,NE 160,RESIDENTIAL,53400,0,53400,218100,0,271500
112632801100000,NE 160,RESIDENTIAL,49900,0,49900,217400,0,267300
112632801200000,NE 160,RESIDENTIAL,49200,0,49200,216200,0,265400
112632801300000,NE 160,RESIDENTIAL,50500,0,50500,226900,0,277400
112632801400000,NE 160,RESIDENTIAL,48900,0,48900,248000,0,296900
112632801500000,NE 160,RESIDENTIAL,48800,0,48800,178300,0,227100
112632801600000,NE 160,RESIDENTIAL,47100,0,47100,197600,0,244700
112632801700000,NE 160,RESIDENTIAL,48700,0,48700,189800,0,238500
112632801800000,NE 160,RESIDENTIAL,47000,0,47000,192300,0,239300
112632801900000,NE 160,RESIDENTIAL,48400,0,48400,174000,0,222400
112632802000000,NE 160,RESIDENTIAL,49500,0,49500,192700,0,242200
112632802100000,NE 160,RESIDENTIAL,46900,0,46900,196400,0,243300
112632802200000,NE 160,RESIDENTIAL,47900,0,47900,157700,0,205600
112632802300000,NE 160,RESIDENTIAL,45700,0,45700,199600,0,245300
112632802400000,NE 160,RESIDENTIAL,49300,0,49300,195900,0,245200
112632802500000,NE 160,RESIDENTIAL,46900,0,46900,197100,0,244000
112632900100000,NE 160,RESIDENTIAL,50800,0,50800,215200,0,266000
112632900200000,NE 160,RESIDENTIAL,47000,0,47000,206900,0,253900
112632900300000,NE 160,RESIDENTIAL,45000,0,45000,190000,0,235000
112632900400000,NE 160,RESIDENTIAL,47700,0,47700,179300,0,227000
112632900500000,NE 160,RESIDENTIAL,48000,0,48000,210000,0,258000
112632900600000,NE 160,RESIDENTIAL,45300,0,45300,236100,0,281400
112632900700000,NE 160,RESIDENTIAL,48300,0,48300,219900,0,268200
112632900800000,NE 160,RESIDENTIAL,44600,0,44600,202900,0,247500
112632900900000,NE 160,RESIDENTIAL,46900,0,46900,209200,0,256100
112632901000000,NE 160,RESIDENTIAL,49300,0,49300,232400,0,281700
112632901100000,NE 160,RESIDENTIAL,46200,0,46200,183800,0,230000
112632901200000,NE 160,RESIDENTIAL,47300,0,47300,194700,0,242000
112632901300000,NE 160,RESIDENTIAL,47800,0,47800,200700,0,248500
112635100100000,NE 160,RESIDENTIAL,49900,0,49900,216400,0,266300
112635100200000,NE 160,RESIDENTIAL,47000,0,47000,199700,0,246700
112635100300000,NE 160,RESIDENTIAL,49000,0,49000,199900,0,248900
112635100400000,NE 160,RESIDENTIAL,46200,0,46200,209600,0,255800
112635100500000,NE 160,RESIDENTIAL,51100,0,51100,245800,0,296900
112635100600000,NE 160,RESIDENTIAL,50400,0,50400,242000,0,292400
112635100700000,NE 160,RESIDENTIAL,47000,0,47000,183100,0,230100
112635100800000,NE 160,RESIDENTIAL,48900,0,48900,188200,0,237100
112635200100000,NE 160,RESIDENTIAL,47100,0,47100,178900,0,226000
112635200200000,NE 160,RESIDENTIAL,50700,0,50700,196500,0,247200
112635200300000,NE 160,RESIDENTIAL,47800,0,47800,189900,0,237700
112635200400000,NE 160,RESIDENTIAL,49900,0,49900,211400,0,261300
112635300100000,NE 160,RESIDENTIAL,49600,0,49600,187000,0,236600
112635300200000,NE 160,RESIDENTIAL,46900,0,46900,181700,0,228600
112635300300000,NE 160,RESIDENTIAL,49800,0,49800,167200,0,217000
112635300400000,NE 160,RESIDENTIAL,46900,0,46900,174200,0,221100
112635300500000,NE 160,RESIDENTIAL,46900,0,46900,212100,0,259000
112635300600000,NE 160,RESIDENTIAL,47400,0,47400,203000,0,250400
112635300700000,NE 160,RESIDENTIAL,47400,0,47400,190800,0,238200
112635300800000,NE 160,RESIDENTIAL,48000,0,48000,189800,0,237800
112635300900000,NE 160,RESIDENTIAL,46900,0,46900,190800,0,237700
112635301000000,NE 160,RESIDENTIAL,46900,0,46900,173900,0,220800
112635301100000,NE 160,RESIDENTIAL,46900,0,46900,163800,0,210700
112635301200000,NE 160,RESIDENTIAL,46300,0,46300,206400,0,252700
112635301300000,NE 160,RESIDENTIAL,49200,0,49200,187800,0,237000
112635301400000,NE 160,RESIDENTIAL,49800,0,49800,173800,0,223600
112635301500000,NE 160,RESIDENTIAL,49200,0,49200,195100,0,244300
112635301600000,NE 160,RESIDENTIAL,49800,0,49800,193200,0,243000
112635301700000,NE 160,RESIDENTIAL,46900,0,46900,205000,0,251900
112635301800000,NE 160,RESIDENTIAL,49300,0,49300,219100,0,268400
112635301900000,NE 160,RESIDENTIAL,44600,0,44600,182700,0,227300
112635302000000,NE 160,RESIDENTIAL,48400,0,48400,240300,0,288700
112635302100000,NE 160,RESIDENTIAL,49100,0,49100,197300,0,246400
112635302200000,NE 160,RESIDENTIAL,49100,0,49100,230300,0,279400
112635302300000,NE 160,RESIDENTIAL,48000,0,48000,201000,0,249000
112635302400000,NE 160,RESIDENTIAL,47400,0,47400,193800,0,241200
112635302500000,NE 160,RESIDENTIAL,47800,0,47800,182800,0,230600
112635302600000,NE 160,RESIDENTIAL,50500,0,50500,177500,0,228000
112635302700000,NE 160,RESIDENTIAL,51600,0,51600,193800,0,245400
112635302800000,NE 160,RESIDENTIAL,48300,0,48300,197400,0,245700
112635400100000,NE 160,RESIDENTIAL,46500,0,46500,176500,0,223000
112635400200000,NE 160,RESIDENTIAL,46900,0,46900,195100,0,242000
112635400300000,NE 160,RESIDENTIAL,48400,0,48400,194500,0,242900
112635400400000,NE 160,RESIDENTIAL,49200,0,49200,201500,0,250700
112635400500000,NE 160,RESIDENTIAL,49900,0,49900,205300,0,255200
112635400600000,NE 160,RESIDENTIAL,54200,0,54200,179100,0,233300
112635400700000,NE 160,RESIDENTIAL,53300,0,53300,217200,0,270500
112635400800000,NE 160,RESIDENTIAL,49200,0,49200,201400,0,250600
112635400900000,NE 160,RESIDENTIAL,48300,0,48300,256300,0,304600
112635401000000,NE 160,RESIDENTIAL,48100,0,48100,210600,0,258700
112635401100000,NE 160,RESIDENTIAL,47400,0,47400,205800,0,253200
112635401200000,NE 160,RESIDENTIAL,48600,0,48600,186300,0,234900
112635401300000,NE 160,RESIDENTIAL,49000,0,49000,205100,0,254100
112635401400000,NE 160,RESIDENTIAL,50000,0,50000,235700,0,285700
112635401500000,NE 160,RESIDENTIAL,50200,0,50200,211700,0,261900
112635401600000,NE 160,RESIDENTIAL,50400,0,50400,227900,0,278300
112635401700000,NE 160,RESIDENTIAL,70800,0,70800,265100,0,335900
112635401800000,NE 160,RESIDENTIAL,51900,0,51900,244400,0,296300
112635401900000,NE 160,RESIDENTIAL,50100,0,50100,225600,0,275700
112635402000000,NE 160,RESIDENTIAL,50100,0,50100,205800,0,255900
112635402100000,NE 160,RESIDENTIAL,50400,0,50400,225700,0,276100
112635402200000,NE 160,RESIDENTIAL,47900,0,47900,203400,0,251300
112635402300000,NE 160,RESIDENTIAL,50600,0,50600,215300,0,265900
112635402400000,NE 160,RESIDENTIAL,48000,0,48000,189300,0,237300
112635402500000,NE 160,RESIDENTIAL,46000,0,46000,233500,0,279500
112635402600000,NE 160,RESIDENTIAL,48900,0,48900,202500,0,251400
112635402700000,NE 160,RESIDENTIAL,48900,0,48900,180600,0,229500
112635402800000,NE 160,RESIDENTIAL,48900,0,48900,215400,0,264300
112635402900000,NE 160,RESIDENTIAL,48300,0,48300,191000,0,239300
112635403000000,NE 160,RESIDENTIAL,47000,0,47000,176900,0,223900
112635403100000,NE 160,RESIDENTIAL,48800,0,48800,175400,0,224200
112635403200000,NE 160,RESIDENTIAL,49600,0,49600,236400,0,286000
112635403300000,NE 160,RESIDENTIAL,49700,0,49700,210600,0,260300
112635403400000,NE 160,RESIDENTIAL,48500,0,48500,160100,0,208600
112635403500000,NE 160,RESIDENTIAL,47600,0,47600,205700,0,253300
112635403600000,NE 160,RESIDENTIAL,49400,0,49400,196900,0,246300
112635403700000,NE 160,RESIDENTIAL,51100,0,51100,202100,0,253200
112635403800000,NE 160,RESIDENTIAL,49400,0,49400,222100,0,271500
112635403900000,NE 160,RESIDENTIAL,47800,0,47800,209800,0,257600
112635404000000,NE 160,RESIDENTIAL,50600,0,50600,169600,0,220200
112635404100000,NE 160,RESIDENTIAL,47000,0,47000,213300,0,260300
112635404200000,NE 160,RESIDENTIAL,48200,0,48200,190500,0,238700
112635500100000,NE 160,RESIDENTIAL,50000,0,50000,171000,0,221000
112635600100000,NE 160,RESIDENTIAL,51100,0,51100,181600,0,232700
112635700100000,NE 160,RESIDENTIAL,54000,0,54000,286700,0,340700
112635700300000,NE 160,RESIDENTIAL,48600,0,48600,204800,0,253400
112635700400000,NE 160,RESIDENTIAL,48300,0,48300,206800,0,255100
112635700500000,NE 160,RESIDENTIAL,46900,0,46900,208900,0,255800
112637600100000,NE 160,RESIDENTIAL,47500,0,47500,188200,0,235700
112637600200000,NE 160,RESIDENTIAL,48400,0,48400,195200,0,243600
112637600300000,NE 160,RESIDENTIAL,48400,0,48400,154100,0,202500
112637600400000,NE 160,RESIDENTIAL,48800,0,48800,166200,0,215000
112637600500000,NE 160,RESIDENTIAL,48800,0,48800,186500,0,235300
112637600600000,NE 160,RESIDENTIAL,47300,0,47300,210700,0,258000
112637600700000,NE 160,RESIDENTIAL,49000,0,49000,162100,0,211100
112637600800000,NE 160,RESIDENTIAL,48200,0,48200,211500,0,259700
112637600900000,NE 160,RESIDENTIAL,43800,0,43800,166900,0,210700
112637601000000,NE 160,RESIDENTIAL,49200,0,49200,206700,0,255900
112637700100000,NE 160,RESIDENTIAL,47500,0,47500,186300,0,233800
112637700200000,NE 160,RESIDENTIAL,44100,0,44100,194100,0,238200
112637700300000,NE 160,RESIDENTIAL,48000,0,48000,210400,0,258400
112637700400000,NE 160,RESIDENTIAL,48700,0,48700,179200,0,227900
112637700500000,NE 160,RESIDENTIAL,48800,0,48800,206600,0,255400
112637700600000,NE 160,RESIDENTIAL,45600,0,45600,173500,0,219100
112637700700000,NE 160,RESIDENTIAL,48100,0,48100,193700,0,241800
112637700800000,NE 160,RESIDENTIAL,43400,0,43400,199700,0,243100
112637700900000,NE 160,RESIDENTIAL,45900,0,45900,181400,0,227300
112637701000000,NE 160,RESIDENTIAL,44300,0,44300,192500,0,236800
112637701100000,NE 160,RESIDENTIAL,49300,0,49300,180500,0,229800
112637701200000,NE 160,RESIDENTIAL,48800,0,48800,212700,0,261500
112637701300000,NE 160,RESIDENTIAL,48300,0,48300,225000,0,273300
112637701400000,NE 160,RESIDENTIAL,46800,0,46800,151300,0,198100
112637701500000,NE 160,RESIDENTIAL,50400,0,50400,206500,0,256900
112637701600000,NE 160,RESIDENTIAL,50500,0,50500,192100,0,242600
112637701700000,NE 160,RESIDENTIAL,47700,0,47700,168700,0,216400
112637701800000,NE 160,RESIDENTIAL,47900,0,47900,169500,0,217400
112637701900000,NE 160,RESIDENTIAL,48100,0,48100,183400,0,231500
112637702000000,NE 160,RESIDENTIAL,45500,0,45500,194200,0,239700
112637702100000,NE 160,RESIDENTIAL,45500,0,45500,204300,0,249800
112637702200000,NE 160,RESIDENTIAL,48300,0,48300,179800,0,228100
112637702300000,NE 160,RESIDENTIAL,46600,0,46600,182300,0,228900
112637702400000,NE 160,RESIDENTIAL,47900,0,47900,172300,0,220200
112637702500000,NE 160,RESIDENTIAL,47600,0,47600,214800,0,262400
112637702600000,NE 160,RESIDENTIAL,49800,0,49800,184900,0,234700
112637702700000,NE 160,RESIDENTIAL,47600,0,47600,193800,0,241400
112637800100000,NE 160,RESIDENTIAL,46900,0,46900,198500,0,245400
112637800200000,NE 160,RESIDENTIAL,44600,0,44600,204600,0,249200
112637800300000,NE 160,RESIDENTIAL,48700,0,48700,210100,0,258800
112637800400000,NE 160,RESIDENTIAL,47700,0,47700,231200,0,278900
112637800500000,NE 160,RESIDENTIAL,47100,0,47100,225900,0,273000
112637800600000,NE 160,RESIDENTIAL,48300,0,48300,200100,0,248400
112637800700000,NE 160,RESIDENTIAL,46400,0,46400,201000,0,247400
112637800800000,NE 160,RESIDENTIAL,46100,0,46100,184900,0,231000
112637800900000,NE 160,RESIDENTIAL,47200,0,47200,200800,0,248000
112637801000000,NE 160,RESIDENTIAL,48000,0,48000,185900,0,233900
112637801100000,NE 160,RESIDENTIAL,49900,0,49900,202600,0,252500
112637801200000,NE 160,RESIDENTIAL,47000,0,47000,188600,0,235600
112637801300000,NE 160,RESIDENTIAL,46600,0,46600,198200,0,244800
112637801400000,NE 160,RESIDENTIAL,46000,0,46000,211000,0,257000
112637801500000,NE 160,RESIDENTIAL,46000,0,46000,188000,0,234000
112637801600000,NE 160,RESIDENTIAL,44300,0,44300,213800,0,258100
112637801700000,NE 160,RESIDENTIAL,47400,0,47400,183100,0,230500
112637801800000,NE 160,RESIDENTIAL,47500,0,47500,189400,0,236900
112637801900000,NE 160,RESIDENTIAL,49000,0,49000,177900,0,226900
112637802000000,NE 160,RESIDENTIAL,46900,0,46900,150300,0,197200
112637900100000,NE 160,RESIDENTIAL,49400,0,49400,217900,0,267300
112637900200000,NE 160,RESIDENTIAL,46900,0,46900,196600,0,243500
112637900300000,NE 160,RESIDENTIAL,47700,0,47700,207100,0,254800
112637900400000,NE 160,RESIDENTIAL,46000,0,46000,179500,0,225500
112637900500000,NE 160,RESIDENTIAL,48100,0,48100,183200,0,231300
112637900600000,NE 160,RESIDENTIAL,49800,0,49800,167800,0,217600
112637900700000,NE 160,RESIDENTIAL,47600,0,47600,183800,0,231400
112637900800000,NE 160,RESIDENTIAL,46500,0,46500,193700,0,240200
112637900900000,NE 160,RESIDENTIAL,51700,0,51700,237700,0,289400
112637901000000,NE 160,RESIDENTIAL,48700,0,48700,245800,0,294500
112638000100000,NE 160,RESIDENTIAL,49200,0,49200,186900,0,236100
112638000200000,NE 160,RESIDENTIAL,43700,0,43700,207100,0,250800
112638000300000,NE 160,RESIDENTIAL,48300,0,48300,190000,0,238300
112638000400000,NE 160,RESIDENTIAL,46000,0,46000,194500,0,240500
112638000500000,NE 160,RESIDENTIAL,46000,0,46000,177500,0,223500
112638100100000,NE 160,RESIDENTIAL,51600,0,51600,174500,0,226100
112638100200000,NE 160,RESIDENTIAL,49200,0,49200,151400,0,200600
112638100300000,NE 160,RESIDENTIAL,48600,0,48600,164200,0,212800
112638100400000,NE 160,RESIDENTIAL,30000,0,30000,188000,0,218000
112638100500000,NE 160,RESIDENTIAL,46300,0,46300,198500,0,244800
112638100600000,NE 160,RESIDENTIAL,44600,0,44600,188300,0,232900
112638100700000,NE 160,RESIDENTIAL,46900,0,46900,191700,0,238600
112638100800000,NE 160,RESIDENTIAL,46800,0,46800,172500,0,219300
112638100900000,NE 160,RESIDENTIAL,44700,0,44700,155000,0,199700
112638101000000,NE 160,RESIDENTIAL,46900,0,46900,166300,0,213200
112638101100000,NE 160,RESIDENTIAL,46900,0,46900,178800,0,225700
112638101200000,NE 160,RESIDENTIAL,44600,0,44600,204500,0,249100
112638101300000,NE 160,RESIDENTIAL,49300,0,49300,196500,0,245800
112638101400000,NE 160,RESIDENTIAL,46900,0,46900,189200,0,236100
112638101500000,NE 160,RESIDENTIAL,46900,0,46900,188800,0,235700
112638101600000,NE 160,RESIDENTIAL,45500,0,45500,192700,0,238200
112638101700000,NE 160,RESIDENTIAL,49300,0,49300,143100,0,192400
112638200100000,NE 160,RESIDENTIAL,50100,0,50100,181800,0,231900
112638200200000,NE 160,RESIDENTIAL,41200,0,41200,162700,0,203900
112638200300000,NE 160,RESIDENTIAL,48100,0,48100,195300,0,243400
112638200400000,NE 160,RESIDENTIAL,50000,0,50000,161700,0,211700
112638200500000,NE 160,RESIDENTIAL,48400,0,48400,187700,0,236100
112638200600000,NE 160,RESIDENTIAL,48500,0,48500,164700,0,213200
112638200700000,NE 160,RESIDENTIAL,49300,0,49300,175700,0,225000
112638200800000,NE 160,RESIDENTIAL,44600,0,44600,168600,0,213200
112638200900000,NE 160,RESIDENTIAL,44600,0,44600,177600,0,222200
112638201000000,NE 160,RESIDENTIAL,49300,0,49300,192700,0,242000
112638201100000,NE 160,RESIDENTIAL,51100,0,51100,226700,0,277800
112638201200000,NE 160,RESIDENTIAL,49300,0,49300,203300,0,252600
112638201300000,NE 160,RESIDENTIAL,46300,0,46300,201300,0,247600
112638201400000,NE 160,RESIDENTIAL,42800,0,42800,163500,0,206300
112638201500000,NE 160,RESIDENTIAL,49300,0,49300,171700,0,221000
112638201600000,NE 160,RESIDENTIAL,44600,0,44600,187700,0,232300
112638201700000,NE 160,RESIDENTIAL,47700,0,47700,184500,0,232200
112638201800000,NE 160,RESIDENTIAL,50900,0,50900,178000,0,228900
112638201900000,NE 160,RESIDENTIAL,51700,0,51700,210300,0,262000
112638202000000,NE 160,RESIDENTIAL,46900,0,46900,151500,0,198400
112638202100000,NE 160,RESIDENTIAL,46900,0,46900,143200,0,190100
112638202200000,NE 160,RESIDENTIAL,46900,0,46900,190500,0,237400
112638202300000,NE 160,RESIDENTIAL,50000,0,50000,202000,0,252000
112638300100000,NE 160,RESIDENTIAL,48900,0,48900,189700,0,238600
112638300200000,NE 160,RESIDENTIAL,48900,0,48900,182000,0,230900
112712600400000,NE 173,RESIDENTIAL,69400,0,69400,252600,0,322000
112712600500000,NE 173,RESIDENTIAL,72500,0,72500,169900,0,242400
112712600600000,NE 173,RESIDENTIAL,75300,0,75300,300000,0,375300
112712700200000,NE 173,RESIDENTIAL,54700,0,54700,179000,0,233700
112712700300000,NE 173,RESIDENTIAL,52600,0,52600,239300,0,291900
112712700400000,NE 173,RESIDENTIAL,52600,0,52600,234000,0,286600
112712700500000,NE 173,RESIDENTIAL,52600,0,52600,236500,0,289100
112712800100000,NE 173,RESIDENTIAL,55300,0,55300,209400,0,264700
112715200100000,NE 101,AG LAND,28600,0,28600,0,0,28600
112715200200000,NE 173,RESIDENTIAL,61200,0,61200,261600,0,322800
112715200300000,NE 173,RESIDENTIAL,56600,0,56600,284100,0,340700
112715200400000,NE 173,RESIDENTIAL,72700,0,72700,307600,0,380300
112715200500000,NE 173,RESIDENTIAL,53700,0,53700,190700,0,244400
112715200600000,NE 173,RESIDENTIAL,55300,0,55300,235600,0,290900
112715200700000,NE 173,RESIDENTIAL,57600,0,57600,247000,0,304600
112715200800000,NE 173,RESIDENTIAL,52000,0,52000,228100,0,280100
112715200900000,NE 173,RESIDENTIAL,52000,0,52000,253500,0,305500
112715201000000,NE 173,RESIDENTIAL,52000,0,52000,253200,0,305200
112715201100000,NE 173,RESIDENTIAL,52000,0,52000,266300,0,318300
112715201200000,NE 173,RESIDENTIAL,52000,0,52000,238200,0,290200
112715201300000,NE 173,RESIDENTIAL,52000,0,52000,256400,0,308400
112715201400000,NE 173,RESIDENTIAL,54500,0,54500,267700,0,322200
112715201500000,NE 173,RESIDENTIAL,62900,0,62900,276900,0,339800
112715201600000,NE 173,RESIDENTIAL,60200,0,60200,255900,0,316100
112715201700000,NE 173,RESIDENTIAL,56800,0,56800,0,0,56800
112715201800000,NE 173,RESIDENTIAL,64200,0,64200,273200,0,337400
112715201900000,NE 173,RESIDENTIAL,61500,0,61500,281500,0,343000
112715202000000,NE 173,RESIDENTIAL,55300,0,55300,272100,0,327400
112715202100000,NE 173,RESIDENTIAL,52400,0,52400,264700,0,317100
112715202200000,NE 173,RESIDENTIAL,62800,0,62800,283200,0,346000
112715202300000,NE 173,RESIDENTIAL,77000,0,77000,289700,0,366700
112715202400000,NE 173,RESIDENTIAL,60600,0,60600,275300,0,335900
112715202500000,NE 173,RESIDENTIAL,53700,0,53700,296200,0,349900
112715202600000,NE 173,RESIDENTIAL,63700,0,63700,0,0,63700
112715300100000,NE 173,RESIDENTIAL,55600,0,55600,247300,0,302900
112715300200000,NE 173,RESIDENTIAL,52500,0,52500,220600,0,273100
112715300300000,NE 173,RESIDENTIAL,52000,0,52000,247600,0,299600
112715300400000,NE 173,RESIDENTIAL,51500,0,51500,269900,0,321400
112715300500000,NE 173,RESIDENTIAL,51500,0,51500,299500,0,351000
112715300600000,NE 173,RESIDENTIAL,51500,0,51500,280700,0,332200
112715300700000,NE 173,RESIDENTIAL,51500,0,51500,245800,0,297300
112715300800000,NE 173,RESIDENTIAL,51000,0,51000,252300,0,303300
112715300900000,NE 173,RESIDENTIAL,51000,0,51000,248100,0,299100
112715301000000,NE 173,RESIDENTIAL,58300,0,58300,255100,0,313400
112715301100000,NE 173,RESIDENTIAL,58500,0,58500,256000,0,314500
112715301200000,NE 173,RESIDENTIAL,59900,0,59900,235100,0,295000
112715301300000,NE 173,RESIDENTIAL,61600,0,61600,243300,0,304900
112715400100000,NE 173,RESIDENTIAL,51600,0,51600,0,0,51600
112715400200000,NE 173,RESIDENTIAL,51300,0,51300,0,0,51300
112715400300000,NE 173,RESIDENTIAL,50500,0,50500,0,0,50500
112715400400000,NE 173,RESIDENTIAL,47800,0,47800,241700,0,289500
112715400500000,NE 173,RESIDENTIAL,47800,0,47800,239300,0,287100
112715400600000,NE 173,RESIDENTIAL,47800,0,47800,268000,0,315800
112715400700000,NE 173,RESIDENTIAL,47800,0,47800,245600,0,293400
112715400800000,NE 173,RESIDENTIAL,47800,0,47800,262600,0,310400
112715400900000,NE 173,RESIDENTIAL,47800,0,47800,224700,0,272500
112715401000000,NE 173,RESIDENTIAL,47800,0,47800,245300,0,293100
112715401100000,NE 173,RESIDENTIAL,47800,0,47800,210500,0,258300
112715401200000,NE 173,RESIDENTIAL,47800,0,47800,212600,0,260400
112715401300000,NE 173,RESIDENTIAL,51700,0,51700,206100,0,257800
112717700100000,NE 101,AG LAND,22400,0,22400,0,0,22400
112720401600000,SCHOOL,EXEMPT,0,0,0,0,0,0
112720401800000,SCHOOL,EXEMPT,0,0,0,0,0,0
112720402000000,NE 101,AG LAND,10500,0,10500,0,0,10500
112722700100000,NE 175,RESIDENTIAL,38600,0,38600,154500,0,193100
112722700200000,NE 175,RESIDENTIAL,37100,0,37100,146100,0,183200
112722700300000,NE 175,RESIDENTIAL,36700,0,36700,166200,0,202900
112722700400000,NE 175,RESIDENTIAL,34100,0,34100,146800,0,180900
112722701000000,NE 175,RESIDENTIAL,42000,0,42000,173000,0,215000
112722701100000,NE 175,RESIDENTIAL,42000,0,42000,188500,0,230500
112722701200000,NE 175,EXEMPT,0,0,0,0,0,0
112722701300000,NE 175,RESIDENTIAL,45300,0,45300,170500,0,215800
112722800100000,NE 175,RESIDENTIAL,200,0,200,0,0,200
112722800200000,NE 175,RESIDENTIAL,200,0,200,0,0,200
112722900100000,NE 175,RESIDENTIAL,34400,0,34400,177100,0,211500
112722900200000,NE 175,RESIDENTIAL,34400,0,34400,187500,0,221900
112722900300000,NE 175,RESIDENTIAL,34400,0,34400,165000,0,199400
112722900400000,NE 175,RESIDENTIAL,34400,0,34400,176400,0,210800
112722900500000,NE 175,RESIDENTIAL,34400,0,34400,133700,0,168100
112722900600000,NE 175,RESIDENTIAL,34400,0,34400,133700,0,168100
112722900700000,NE 175,RESIDENTIAL,34400,0,34400,171200,0,205600
112722900800000,NE 175,RESIDENTIAL,34400,0,34400,7500,0,41900
112722900900000,NE 175,RESIDENTIAL,34400,0,34400,200000,0,234400
112722901000000,NE 175,RESIDENTIAL,34400,0,34400,146400,0,180800
112723000100000,NE 175,RESIDENTIAL,34300,0,34300,124500,0,158800
112723000200000,NE 175,RESIDENTIAL,37700,0,37700,146500,0,184200
112723000300000,NE 175,RESIDENTIAL,31800,0,31800,129600,0,161400
112723000400000,NE 175,RESIDENTIAL,31800,0,31800,133000,0,164800
112723000500000,NE 175,RESIDENTIAL,31800,0,31800,119200,0,151000
112723000600000,NE 175,RESIDENTIAL,31800,0,31800,133100,0,164900
112723000700000,NE 175,RESIDENTIAL,34300,0,34300,118300,0,152600
112723000800000,NE 175,RESIDENTIAL,34300,0,34300,125800,0,160100
112723000900000,NE 175,RESIDENTIAL,31800,0,31800,153200,0,185000
112723001000000,NE 175,RESIDENTIAL,31800,0,31800,124500,0,156300
112723001100000,NE 175,RESIDENTIAL,31800,0,31800,124500,0,156300
112723001200000,NE 175,RESIDENTIAL,31800,0,31800,134200,0,166000
112723100100000,NE 175,RESIDENTIAL,38200,0,38200,156100,0,194300
112723100900000,NE 175,RESIDENTIAL,56700,0,56700,96200,0,152900
112723101000000,NE 175,RESIDENTIAL,31800,0,31800,133700,0,165500
112723101100000,NE 175,RESIDENTIAL,31800,0,31800,128100,0,159900
112723101200000,NE 175,RESIDENTIAL,31800,0,31800,121400,0,153200
112723101300000,NE 175,RESIDENTIAL,31800,0,31800,118300,0,150100
112723101400000,NE 175,RESIDENTIAL,31800,0,31800,119200,0,151000
112723101500000,NE 175,RESIDENTIAL,32900,0,32900,118900,0,151800
112723101600000,NE 175,RESIDENTIAL,200,0,200,0,0,200
112723101700000,NE 175,RESIDENTIAL,46100,0,46100,168300,0,214400
112723101800000,NE 175,RESIDENTIAL,43100,0,43100,178500,0,221600
112723101900000,NE 175,RESIDENTIAL,43100,0,43100,177300,0,220400
112723102000000,NE 175,RESIDENTIAL,40700,0,40700,178900,0,219600
112723102100000,NE 175,RESIDENTIAL,200,0,200,0,0,200
112723102200000,NE 175,EXEMPT,0,0,0,0,0,0
112723102300000,NE 175,RESIDENTIAL,36100,0,36100,7500,0,43600
112723102400000,NE 175,RESIDENTIAL,35000,0,35000,7500,0,42500
112723102500000,NE 175,RESIDENTIAL,34800,0,34800,7500,0,42300
112723102600000,NE 175,RESIDENTIAL,36600,0,36600,7500,0,44100
112723102700000,NE 175,RESIDENTIAL,43300,0,43300,7500,0,50800
112723102800000,NE 175,RESIDENTIAL,45000,0,45000,7500,0,52500
112723102900000,NE 175,RESIDENTIAL,8000,0,8000,0,0,8000
112723103000000,NE 175,RESIDENTIAL,4900,0,4900,0,0,4900
112723103100000,NE 175,RESIDENTIAL,4100,0,4100,0,0,4100
112723103200000,NE 175,RESIDENTIAL,3900,0,3900,0,0,3900
112723103300000,NE 175,RESIDENTIAL,3700,0,3700,0,0,3700
112723200100000,NE 175,RESIDENTIAL,29500,0,29500,145100,0,174600
112723200200000,NE 175,RESIDENTIAL,34800,0,34800,7500,0,42300
112723200300000,NE 175,RESIDENTIAL,34800,0,34800,7500,0,42300
112723200400000,NE 175,RESIDENTIAL,34800,0,34800,7500,0,42300
112723200500000,NE 175,RESIDENTIAL,3300,0,3300,0,0,3300
112723200600000,NE 175,RESIDENTIAL,37500,0,37500,4200,0,41700
112723200700000,NE 175,RESIDENTIAL,36400,0,36400,30000,0,66400
112723200800000,NE 175,RESIDENTIAL,36600,0,36600,74200,0,110800
112723200900000,NE 175,RESIDENTIAL,37600,0,37600,30000,0,67600
112723201000000,NE 175,RESIDENTIAL,40100,0,40100,74200,0,114300
112723201100000,NE 175,RESIDENTIAL,40100,0,40100,33200,0,73300
112723300100000,NE 175,RESIDENTIAL,200,0,200,0,0,200
112723300200000,NE 175,RESIDENTIAL,200,0,200,0,0,200
112723300300000,NE 175,RESIDENTIAL,37800,0,37800,7500,0,45300
112723300400000,NE 175,RESIDENTIAL,34100,0,34100,7500,0,41600
112723300500000,NE 175,RESIDENTIAL,34100,0,34100,9900,0,44000
112723300600000,NE 175,RESIDENTIAL,35300,0,35300,74200,0,109500
112723300700000,NE 175,RESIDENTIAL,36800,0,36800,74200,0,111000
112723300800000,NE 175,RESIDENTIAL,3900,0,3900,0,0,3900
112723300900000,NE 175,RESIDENTIAL,43000,0,43000,4200,0,47200
112723301000000,NE 175,RESIDENTIAL,3900,0,3900,0,0,3900
112723301100000,NE 175,RESIDENTIAL,3100,0,3100,0,0,3100
112723400100000,NE 175,RESIDENTIAL,34200,0,34200,119600,0,153800
112723400200000,NE 175,RESIDENTIAL,30900,0,30900,115100,0,146000
112723400300000,NE 175,RESIDENTIAL,30900,0,30900,138000,0,168900
112723400400000,NE 175,RESIDENTIAL,30900,0,30900,114600,0,145500
112723400500000,NE 175,RESIDENTIAL,30900,0,30900,127900,0,158800
112723400600000,NE 175,RESIDENTIAL,30900,0,30900,127200,0,158100
112723400700000,NE 175,RESIDENTIAL,30600,0,30600,113900,0,144500
112723400800000,NE 175,RESIDENTIAL,30200,0,30200,127900,0,158100
112723400900000,NE 175,RESIDENTIAL,30200,0,30200,112400,0,142600
112723401000000,NE 175,RESIDENTIAL,30900,0,30900,128600,0,159500
112723401100000,NE 175,RESIDENTIAL,31500,0,31500,106000,0,137500
112723401200000,NE 175,RESIDENTIAL,31800,0,31800,123900,0,155700
112723401300000,NE 175,RESIDENTIAL,32100,0,32100,106700,0,138800
112723401400000,NE 175,RESIDENTIAL,34800,0,34800,131000,0,165800
112723500100000,NE 175,RESIDENTIAL,35500,0,35500,115900,0,151400
112723500200000,NE 175,RESIDENTIAL,35500,0,35500,114200,0,149700
112723500300000,NE 175,RESIDENTIAL,36500,0,36500,105800,0,142300
112723500400000,COUNTY PROPERTY,EXEMPT,0,0,0,0,0,0
112725100500000,NE 175,AG LAND,39600,0,39600,0,0,39600
112725100600000,NE 101,AG DWELLING,18700,0,18700,317900,0,336600
112725100700000,NE 101,AG LAND,38500,0,38500,0,0,38500
112727600200000,NE 173,RESIDENTIAL,52000,0,52000,257100,0,309100
112727600300000,NE 173,RESIDENTIAL,52600,0,52600,239000,0,291600
112727600400000,NE 173,RESIDENTIAL,52600,0,52600,262200,0,314800
112727600500000,NE 173,RESIDENTIAL,52600,0,52600,236100,0,288700
112727600600000,NE 173,RESIDENTIAL,52900,0,52900,233700,0,286600
112727700100000,NE 173,RESIDENTIAL,56400,0,56400,295100,0,351500
112727700200000,NE 173,RESIDENTIAL,53800,0,53800,242300,0,296100
112727700300000,NE 173,RESIDENTIAL,53800,0,53800,258200,0,312000
112727700400000,NE 173,RESIDENTIAL,53800,0,53800,246900,0,300700
112727700500000,NE 173,AG LAND,40200,0,40200,0,0,40200
112727800100000,NE 173,RESIDENTIAL,62100,0,62100,247900,0,310000
112727800200000,NE 173,RESIDENTIAL,59000,0,59000,248700,0,307700
112727800300000,NE 173,RESIDENTIAL,60400,0,60400,257300,0,317700
112727800400000,NE 173,RESIDENTIAL,58000,0,58000,261600,0,319600
112727900100000,NE 173,RESIDENTIAL,51700,0,51700,242900,0,294600
112727900200000,NE 173,RESIDENTIAL,51700,0,51700,264900,0,316600
112727900300000,NE 173,RESIDENTIAL,50000,0,50000,283000,0,333000
112727900400000,NE 173,RESIDENTIAL,50000,0,50000,242500,0,292500
112727900500000,NE 173,RESIDENTIAL,49600,0,49600,233300,0,282900
112727900600000,NE 173,RESIDENTIAL,49000,0,49000,256400,0,305400
112727900700000,NE 173,RESIDENTIAL,48100,0,48100,258200,0,306300
112727900800000,NE 173,RESIDENTIAL,47400,0,47400,238300,0,285700
112727900900000,NE 173,RESIDENTIAL,52700,0,52700,208100,0,260800
112727901000000,NE 173,RESIDENTIAL,53000,0,53000,242100,0,295100
112727901100000,NE 173,RESIDENTIAL,59900,0,59900,305700,0,365600
112727901200000,NE 173,RESIDENTIAL,58200,0,58200,323900,0,382100
112727901300000,NE 173,RESIDENTIAL,57100,0,57100,256100,0,313200
112727901400000,NE 173,RESIDENTIAL,56000,0,56000,260000,0,316000
112727901500000,NE 173,RESIDENTIAL,56000,0,56000,260400,0,316400
112727901600000,NE 173,RESIDENTIAL,56000,0,56000,260800,0,316800
112727901700000,NE 173,RESIDENTIAL,56000,0,56000,257900,0,313900
112728100100000,NE 173,RESIDENTIAL,52800,0,52800,254000,0,306800
112728100300000,NE 173,RESIDENTIAL,56000,0,56000,266000,0,322000
112728100400000,NE 173,RESIDENTIAL,56000,0,56000,293500,0,349500
112728100500000,NE 173,RESIDENTIAL,56000,0,56000,289400,0,345400
112728100600000,NE 173,RESIDENTIAL,56600,0,56600,273900,0,330500
112728100700000,NE 173,RESIDENTIAL,57100,0,57100,245600,0,302700
112728100800000,NE 173,RESIDENTIAL,58200,0,58200,248100,0,306300
112728100900000,NE 173,RESIDENTIAL,4300,0,4300,0,0,4300
112728200100000,NE 173,RESIDENTIAL,52800,0,52800,220800,0,273600
112728200200000,NE 173,RESIDENTIAL,52800,0,52800,233300,0,286100
112728200300000,NE 173,RESIDENTIAL,56000,0,56000,258600,0,314600
112728200400000,NE 173,RESIDENTIAL,56000,0,56000,260300,0,316300
112728200500000,NE 173,RESIDENTIAL,56600,0,56600,261200,0,317800
112728200600000,NE 173,RESIDENTIAL,56600,0,56600,275900,0,332500
112728200700000,NE 173,RESIDENTIAL,56600,0,56600,247900,0,304500
112728200800000,NE 173,RESIDENTIAL,56600,0,56600,303000,0,359600
112728200900000,NE 173,RESIDENTIAL,56000,0,56000,299600,0,355600
112728201000000,NE 173,RESIDENTIAL,56600,0,56600,317700,0,374300
112728201100000,NE 173,RESIDENTIAL,56000,0,56000,245500,0,301500
112728201200000,NE 173,RESIDENTIAL,56700,0,56700,298100,0,354800
112728201300000,NE 173,RESIDENTIAL,56000,0,56000,308100,0,364100
112728201400000,NE 173,RESIDENTIAL,56600,0,56600,295400,0,352000
112728201500000,NE 173,RESIDENTIAL,56600,0,56600,278700,0,335300
112728201600000,NE 173,RESIDENTIAL,56600,0,56600,245100,0,301700
112730100100000,NE 101,AG LAND,25400,0,25400,0,0,25400
112730100300000,NE 163,RESIDENTIAL,39700,0,39700,125400,0,165100
112730100400000,NE 163,RESIDENTIAL,35400,0,35400,136500,0,171900
112730100500000,NE 163,RESIDENTIAL,35400,0,35400,152000,0,187400
112730100600000,NE 163,RESIDENTIAL,35400,0,35400,147800,0,183200
112730100700000,NE 163,RESIDENTIAL,35400,0,35400,150800,0,186200
112730100800000,NE 163,RESIDENTIAL,35400,0,35400,134700,0,170100
112730100900000,NE 163,RESIDENTIAL,35400,0,35400,134700,0,170100
112730101000000,NE 163,RESIDENTIAL,35400,0,35400,162900,0,198300
112730101100000,NE 163,RESIDENTIAL,35400,0,35400,129500,0,164900
112730101200000,NE 163,RESIDENTIAL,35400,0,35400,150500,0,185900
112730101300000,NE 163,RESIDENTIAL,35400,0,35400,132500,0,167900
112730101400000,NE 163,RESIDENTIAL,35400,0,35400,107900,0,143300
112730101500000,NE 163,RESIDENTIAL,35400,0,35400,131700,0,167100
112730101600000,NE 163,RESIDENTIAL,35400,0,35400,134900,0,170300
112730101700000,NE 163,RESIDENTIAL,35400,0,35400,146000,0,181400
112730101800000,NE 163,RESIDENTIAL,35400,0,35400,129300,0,164700
112730101900000,NE 163,RESIDENTIAL,39400,0,39400,171200,0,210600
112730102000000,NE 163,RESIDENTIAL,39400,0,39400,156400,0,195800
112730102100000,NE 163,RESIDENTIAL,35400,0,35400,137600,0,173000
112730102200000,NE 163,RESIDENTIAL,35400,0,35400,155900,0,191300
112730102300000,NE 163,RESIDENTIAL,35400,0,35400,148000,0,183400
112730102400000,NE 163,RESIDENTIAL,35400,0,35400,160300,0,195700
112730102500000,NE 163,RESIDENTIAL,35400,0,35400,149400,0,184800
112730102600000,NE 163,RESIDENTIAL,35400,0,35400,154500,0,189900
112730102700000,NE 163,RESIDENTIAL,35400,0,35400,161800,0,197200
112730102800000,NE 163,RESIDENTIAL,35400,0,35400,149500,0,184900
112730102900000,NE 163,RESIDENTIAL,35400,0,35400,133700,0,169100
112730103000000,NE 163,RESIDENTIAL,35400,0,35400,132700,0,168100
112730103100000,NE 163,RESIDENTIAL,35400,0,35400,170500,0,205900
112730103200000,NE 163,RESIDENTIAL,35400,0,35400,170100,0,205500
112730103300000,NE 163,RESIDENTIAL,35400,0,35400,160100,0,195500
112730103400000,NE 163,RESIDENTIAL,35400,0,35400,173300,0,208700
112730103500000,NE 163,RESIDENTIAL,35400,0,35400,149300,0,184700
112730103600000,NE 163,RESIDENTIAL,41100,0,41100,146400,0,187500
112730200100000,NE 163,RESIDENTIAL,34100,0,34100,144900,0,179000
112730200200000,NE 163,RESIDENTIAL,41400,0,41400,143600,0,185000
112730200300000,NE 163,RESIDENTIAL,37600,0,37600,160400,0,198000
112730200400000,NE 163,RESIDENTIAL,37600,0,37600,161300,0,198900
112730200500000,NE 163,RESIDENTIAL,37600,0,37600,168600,0,206200
112730200600000,NE 163,RESIDENTIAL,40200,0,40200,185900,0,226100
112730200700000,NE 163,RESIDENTIAL,43300,0,43300,160000,0,203300
112730200800000,NE 163,RESIDENTIAL,42000,0,42000,167400,0,209400
112730200900000,NE 163,RESIDENTIAL,40700,0,40700,178000,0,218700
112730201000000,NE 163,RESIDENTIAL,1300,0,1300,0,0,1300
112730201100000,NE 163,RESIDENTIAL,1300,0,1300,0,0,1300
112730300100000,NE 163,RESIDENTIAL,39400,0,39400,141000,0,180400
112730300200000,NE 163,RESIDENTIAL,400,0,400,0,0,400
112730300300000,NE 163,RESIDENTIAL,400,0,400,0,0,400
112730300400000,NE 163,RESIDENTIAL,400,0,400,0,0,400
112730300500000,NE 163,RESIDENTIAL,34700,0,34700,148500,0,183200
112730300600000,NE 163,RESIDENTIAL,34700,0,34700,153200,0,187900
112730300700000,NE 163,RESIDENTIAL,34700,0,34700,144100,0,178800
112730300800000,NE 163,RESIDENTIAL,34700,0,34700,143500,0,178200
112730300900000,NE 163,RESIDENTIAL,34700,0,34700,124800,0,159500
112730301000000,NE 163,RESIDENTIAL,34700,0,34700,150500,0,185200
112730301100000,NE 163,RESIDENTIAL,34700,0,34700,123900,0,158600
112730301200000,NE 163,RESIDENTIAL,34700,0,34700,153800,0,188500
112730301300000,NE 163,RESIDENTIAL,34700,0,34700,141200,0,175900
112730301400000,NE 163,RESIDENTIAL,34700,0,34700,137800,0,172500
112730301500000,NE 163,RESIDENTIAL,34700,0,34700,146900,0,181600
112730301600000,NE 163,RESIDENTIAL,34700,0,34700,138500,0,173200
112730301700000,NE 163,RESIDENTIAL,34700,0,34700,139500,0,174200
112730301800000,NE 163,RESIDENTIAL,34700,0,34700,131800,0,166500
112730301900000,NE 163,RESIDENTIAL,34700,0,34700,139000,0,173700
112730302000000,NE 163,RESIDENTIAL,35600,0,35600,127500,0,163100
112730400100000,NE 163,RESIDENTIAL,41000,0,41000,167800,0,208800
112730400200000,NE 163,RESIDENTIAL,35400,0,35400,141800,0,177200
112730400300000,NE 163,RESIDENTIAL,35400,0,35400,161500,0,196900
112730400400000,NE 163,RESIDENTIAL,35400,0,35400,126600,0,162000
112730400500000,NE 163,RESIDENTIAL,35400,0,35400,147500,0,182900
112730400600000,NE 163,RESIDENTIAL,35400,0,35400,131600,0,167000
112730400700000,NE 163,RESIDENTIAL,35400,0,35400,158300,0,193700
112730400800000,NE 163,RESIDENTIAL,35400,0,35400,134300,0,169700
112730400900000,NE 163,RESIDENTIAL,35400,0,35400,168800,0,204200
112730401000000,NE 163,RESIDENTIAL,35400,0,35400,167100,0,202500
112730401100000,NE 163,RESIDENTIAL,35400,0,35400,138600,0,174000
112730401200000,NE 163,RESIDENTIAL,35400,0,35400,150200,0,185600
112730401300000,NE 163,RESIDENTIAL,35400,0,35400,150100,0,185500
112730401400000,NE 163,RESIDENTIAL,35400,0,35400,164600,0,200000
112730401500000,NE 163,RESIDENTIAL,35400,0,35400,147600,0,183000
112730401600000,NE 163,RESIDENTIAL,35400,0,35400,165400,0,200800
112730401700000,NE 163,RESIDENTIAL,40800,0,40800,159100,0,199900
112730401800000,NE 101,RESIDENTIAL,100,0,100,0,0,100
112730401900000,NE 163,RESIDENTIAL,42200,0,42200,159200,0,201400
112730402000000,NE 163,RESIDENTIAL,35400,0,35400,128800,0,164200
112730402100000,NE 163,RESIDENTIAL,35400,0,35400,156000,0,191400
112730402200000,NE 163,RESIDENTIAL,35400,0,35400,149300,0,184700
112730402300000,NE 163,RESIDENTIAL,35400,0,35400,153500,0,188900
112730402400000,NE 163,RESIDENTIAL,35400,0,35400,147600,0,183000
112730402500000,NE 163,RESIDENTIAL,35400,0,35400,152600,0,188000
112730402600000,NE 163,RESIDENTIAL,35400,0,35400,152900,0,188300
112730402700000,NE 163,RESIDENTIAL,35400,0,35400,167800,0,203200
112730402800000,NE 163,RESIDENTIAL,35400,0,35400,152500,0,187900
112730402900000,NE 163,RESIDENTIAL,35400,0,35400,170000,0,205400
112730403000000,NE 163,RESIDENTIAL,35400,0,35400,144500,0,179900
112730403100000,NE 163,RESIDENTIAL,35400,0,35400,139200,0,174600
112730403200000,NE 163,RESIDENTIAL,35400,0,35400,163600,0,199000
112730403300000,NE 163,RESIDENTIAL,35400,0,35400,165300,0,200700
112730403400000,NE 163,RESIDENTIAL,35400,0,35400,150300,0,185700
112730403500000,NE 163,RESIDENTIAL,41000,0,41000,146400,0,187400
112730500100000,NE 163,RESIDENTIAL,39400,0,39400,135100,0,174500
112730500200000,NE 163,RESIDENTIAL,34300,0,34300,164000,0,198300
112730500300000,NE 163,RESIDENTIAL,34300,0,34300,170500,0,204800
112730500400000,NE 163,RESIDENTIAL,34300,0,34300,133000,0,167300
112730500500000,NE 163,RESIDENTIAL,34300,0,34300,159700,0,194000
112730500600000,NE 163,RESIDENTIAL,34300,0,34300,153900,0,188200
112730500700000,NE 163,RESIDENTIAL,34300,0,34300,162700,0,197000
112730500800000,NE 163,RESIDENTIAL,34300,0,34300,137200,0,171500
112730500900000,NE 163,RESIDENTIAL,34300,0,34300,157000,0,191300
112730501000000,NE 163,RESIDENTIAL,34300,0,34300,165200,0,199500
112730501100000,NE 163,RESIDENTIAL,34300,0,34300,162000,0,196300
112730501200000,NE 163,RESIDENTIAL,34300,0,34300,168300,0,202600
112730501300000,NE 163,RESIDENTIAL,34300,0,34300,168800,0,203100
112730501400000,NE 163,RESIDENTIAL,34300,0,34300,151000,0,185300
112730501500000,NE 163,RESIDENTIAL,34300,0,34300,172300,0,206600
112730501600000,NE 163,RESIDENTIAL,34300,0,34300,167300,0,201600
112730501700000,NE 163,RESIDENTIAL,39700,0,39700,165400,0,205100
112732600200000,NE 162,RESIDENTIAL,42500,0,42500,208400,0,250900
112732600300000,NE 162,RESIDENTIAL,49200,0,49200,189300,0,238500
112732600400000,NE 162,RESIDENTIAL,45700,0,45700,182000,0,227700
112732600500000,CITY PROPERTY,EXEMPT,0,0,0,0,0,0
112732600600000,NE 162,RESIDENTIAL,45300,0,45300,150300,0,195600
112732600700000,NE 162,RESIDENTIAL,43600,0,43600,156700,0,200300
112732600800000,NE 162,RESIDENTIAL,43500,0,43500,157800,0,201300
112732600900000,NE 162,RESIDENTIAL,44200,0,44200,198400,0,242600
112732601000000,NE 162,RESIDENTIAL,45500,0,45500,170400,0,215900
112732601100000,NE 162,RESIDENTIAL,48200,0,48200,175600,0,223800
112732601200000,NE 162,RESIDENTIAL,43000,0,43000,166200,0,209200
112732601300000,NE 162,RESIDENTIAL,42100,0,42100,150600,0,192700
112732601400000,NE 162,RESIDENTIAL,46100,0,46100,176700,0,222800
112732601500000,CITY PROPERTY,EXEMPT,0,0,0,0,0,0
112732601600000,NE 162,RESIDENTIAL,44500,0,44500,144300,0,188800
112732601700000,NE 162,RESIDENTIAL,45500,0,45500,173100,0,218600
112732601800000,NE 162,RESIDENTIAL,46000,0,46000,155100,0,201100
112732601900000,NE 162,RESIDENTIAL,43000,0,43000,156200,0,199200
112732602000000,NE 162,RESIDENTIAL,41900,0,41900,163100,0,205000
112732602100000,NE 162,RESIDENTIAL,43900,0,43900,153600,0,197500
112732700100000,NE 162,RESIDENTIAL,39200,0,39200,169400,0,208600
112732700200000,NE 162,RESIDENTIAL,42100,0,42100,157200,0,199300
112732800100000,NE 173,RESIDENTIAL,3400,0,3400,0,0,3400
112732800200000,NE 173,RESIDENTIAL,55400,0,55400,262700,0,318100
112732800300000,NE 173,RESIDENTIAL,47100,0,47100,222100,0,269200
112732800400000,NE 173,RESIDENTIAL,47100,0,47100,269600,0,316700
112732800500000,NE 173,RESIDENTIAL,55400,0,55400,277300,0,332700
112732800600000,NE 173,RESIDENTIAL,55400,0,55400,326800,0,382200
112732800800000,NE 173,RESIDENTIAL,600,0,600,0,0,600
112732800900000,NE 173,RESIDENTIAL,600,0,600,0,0,600
112732801000000,NE 173,RESIDENTIAL,500,0,500,0,0,500
112732801100000,NE 173,RESIDENTIAL,500,0,500,0,0,500
112732801200000,NE 173,RESIDENTIAL,500,0,500,0,0,500
112732801300000,NE 173,RESIDENTIAL,500,0,500,0,0,500
112732801400000,NE 173,RESIDENTIAL,500,0,500,0,0,500
112732801500000,NE 173,RESIDENTIAL,500,0,500,0,0,500
112732801600000,NE 173,RESIDENTIAL,500,0,500,0,0,500
112732801700000,NE 173,RESIDENTIAL,800,0,800,0,0,800
112732801800000,NE 173,RESIDENTIAL,600,0,600,0,0,600
112732801900000,NE 173,RESIDENTIAL,700,0,700,0,0,700
112732802000000,NE 173,RESIDENTIAL,400,0,400,0,0,400
112732802100000,NE 173,RESIDENTIAL,46900,0,46900,61500,0,108400
112732802200000,NE 173,RESIDENTIAL,500,0,500,0,0,500
112732802300000,NE 173,RESIDENTIAL,500,0,500,0,0,500
112732802400000,CITY PROPERTY,EXEMPT,0,0,0,0,0,0
112732802500000,NE 173,RESIDENTIAL,8300,0,8300,0,0,8300
112732900100000,NE 173,RESIDENTIAL,52100,0,52100,221700,0,273800
112732900200000,NE 173,RESIDENTIAL,49500,0,49500,278800,0,328300
112732900300000,NE 173,RESIDENTIAL,48800,0,48800,292800,0,341600
112732900400000,NE 173,RESIDENTIAL,2500,0,2500,0,0,2500
112732900500000,NE 173,RESIDENTIAL,2800,0,2800,0,0,2800
112732900600000,NE 173,RESIDENTIAL,2800,0,2800,0,0,2800
112732900700000,NE 173,RESIDENTIAL,500,0,500,0,0,500
112732900800000,NE 173,RESIDENTIAL,500,0,500,0,0,500
112732900900000,NE 173,RESIDENTIAL,500,0,500,0,0,500
112732901000000,NE 173,RESIDENTIAL,500,0,500,0,0,500
112735100100000,NE 162,RESIDENTIAL,39600,0,39600,156600,0,196200
112735100200000,NE 162,RESIDENTIAL,40000,0,40000,186700,0,226700
112735100300000,NE 162,RESIDENTIAL,40000,0,40000,159300,0,199300
112735100400000,NE 162,RESIDENTIAL,40000,0,40000,133200,0,173200
112735100500000,NE 162,RESIDENTIAL,40500,0,40500,156600,0,197100
112735100600000,NE 162,RESIDENTIAL,42800,0,42800,171900,0,214700
112735100700000,NE 162,RESIDENTIAL,36600,0,36600,154900,0,191500
112735200100000,NE 162,RESIDENTIAL,37000,0,37000,150800,0,187800
112735200200000,NE 162,RESIDENTIAL,42400,0,42400,179600,0,222000
112735200300000,NE 162,RESIDENTIAL,37800,0,37800,159700,0,197500
112735200400000,NE 162,RESIDENTIAL,40900,0,40900,147400,0,188300
112735200500000,NE 162,RESIDENTIAL,40000,0,40000,154900,0,194900
112735200600000,NE 162,RESIDENTIAL,37800,0,37800,157100,0,194900
112735200700000,NE 162,RESIDENTIAL,40000,0,40000,156200,0,196200
112735200800000,NE 162,RESIDENTIAL,40600,0,40600,144500,0,185100
112735200900000,NE 162,RESIDENTIAL,40600,0,40600,178300,0,218900
112735201000000,NE 162,RESIDENTIAL,40000,0,40000,152300,0,192300
112735201100000,NE 162,RESIDENTIAL,37800,0,37800,175400,0,213200
112735201200000,NE 162,RESIDENTIAL,40000,0,40000,174400,0,214400
112735201300000,NE 162,RESIDENTIAL,40000,0,40000,160200,0,200200
112735201400000,NE 162,RESIDENTIAL,42900,0,42900,161400,0,204300
112735201500000,NE 162,RESIDENTIAL,43500,0,43500,160400,0,203900
112735300100000,NE 162,RESIDENTIAL,41900,0,41900,155400,0,197300
112735300200000,NE 162,RESIDENTIAL,39300,0,39300,166500,0,205800
112735300300000,NE 162,RESIDENTIAL,39300,0,39300,131000,0,170300
112735300400000,NE 162,RESIDENTIAL,37000,0,37000,154700,0,191700
112735300500000,NE 162,RESIDENTIAL,39300,0,39300,152000,0,191300
112735300600000,NE 162,RESIDENTIAL,39300,0,39300,162000,0,201300
112735300700000,NE 162,RESIDENTIAL,37000,0,37000,158500,0,195500
112735300800000,NE 162,RESIDENTIAL,39300,0,39300,118700,0,158000
112735300900000,NE 162,RESIDENTIAL,39300,0,39300,160100,0,199400
112735301000000,NE 162,RESIDENTIAL,37000,0,37000,149900,0,186900
112735301100000,NE 162,RESIDENTIAL,39300,0,39300,163100,0,202400
112735301200000,NE 162,RESIDENTIAL,39300,0,39300,149100,0,188400
112735301300000,NE 162,RESIDENTIAL,37000,0,37000,127800,0,164800
112735301400000,NE 162,RESIDENTIAL,39700,0,39700,151900,0,191600
112735301500000,NE 162,RESIDENTIAL,45300,0,45300,182700,0,228000
112735301600000,NE 162,RESIDENTIAL,43300,0,43300,160100,0,203400
112735301700000,NE 162,RESIDENTIAL,39300,0,39300,171200,0,210500
112735301800000,NE 162,RESIDENTIAL,37000,0,37000,161400,0,198400
112735301900000,NE 162,RESIDENTIAL,39300,0,39300,172200,0,211500
112735302000000,NE 162,RESIDENTIAL,39300,0,39300,166700,0,206000
112735302100000,NE 162,RESIDENTIAL,37000,0,37000,173700,0,210700
112735302200000,NE 162,RESIDENTIAL,39300,0,39300,194200,0,233500
112735302300000,NE 162,RESIDENTIAL,39300,0,39300,162700,0,202000
112735302400000,NE 162,RESIDENTIAL,37000,0,37000,155400,0,192400
112735302500000,NE 162,RESIDENTIAL,39300,0,39300,174300,0,213600
112735302600000,NE 162,RESIDENTIAL,39300,0,39300,159300,0,198600
112735302700000,NE 162,RESIDENTIAL,38700,0,38700,166100,0,204800
112735302800000,NE 162,RESIDENTIAL,37000,0,37000,151300,0,188300
112735302900000,NE 162,RESIDENTIAL,39300,0,39300,149900,0,189200
112735303000000,NE 162,RESIDENTIAL,42600,0,42600,147900,0,190500
112735400100000,NE 162,RESIDENTIAL,37400,0,37400,130700,0,168100
112735400200000,NE 162,RESIDENTIAL,39300,0,39300,165800,0,205100
112735400300000,NE 162,RESIDENTIAL,39300,0,39300,158100,0,197400
112735400400000,NE 162,RESIDENTIAL,41500,0,41500,158800,0,200300
112735400500000,NE 162,RESIDENTIAL,41500,0,41500,171900,0,213400
112735400600000,NE 162,RESIDENTIAL,37000,0,37000,149800,0,186800
112735400700000,NE 162,RESIDENTIAL,39300,0,39300,151500,0,190800
112735400800000,NE 162,RESIDENTIAL,41500,0,41500,164800,0,206300
112735400900000,NE 162,RESIDENTIAL,37800,0,37800,151900,0,189700
112735401000000,NE 162,RESIDENTIAL,37900,0,37900,181600,0,219500
112735401100000,NE 162,RESIDENTIAL,41500,0,41500,161300,0,202800
112735401200000,NE 162,RESIDENTIAL,39300,0,39300,174100,0,213400
112735401300000,NE 162,RESIDENTIAL,37000,0,37000,161400,0,198400
112735401400000,NE 162,RESIDENTIAL,41500,0,41500,158500,0,200000
112735401500000,NE 162,RESIDENTIAL,41500,0,41500,170300,0,211800
112735401600000,NE 162,RESIDENTIAL,39300,0,39300,171300,0,210600
112735401700000,NE 162,RESIDENTIAL,37000,0,37000,169000,0,206000
112735401800000,NE 162,RESIDENTIAL,42500,0,42500,151800,0,194300
112735402100000,NE 162,RESIDENTIAL,42100,0,42100,172100,0,214200
112735402200000,NE 162,RESIDENTIAL,41900,0,41900,170700,0,212600
112735402300000,NE 162,RESIDENTIAL,41300,0,41300,201900,0,243200
112735402400000,NE 162,RESIDENTIAL,41600,0,41600,196800,0,238400
112735402500000,NE 162,RESIDENTIAL,41000,0,41000,216800,0,257800
112735402600000,NE 162,RESIDENTIAL,43000,0,43000,159800,0,202800
112735402700000,NE 162,RESIDENTIAL,45200,0,45200,179600,0,224800
112735402800000,NE 162,RESIDENTIAL,42300,0,42300,205400,0,247700
112735402900000,NE 162,RESIDENTIAL,45300,0,45300,201100,0,246400
112735403000000,NE 162,RESIDENTIAL,41500,0,41500,173300,0,214800
112735403100000,NE 162,RESIDENTIAL,41000,0,41000,193500,0,234500
112735403200000,NE 162,RESIDENTIAL,44900,0,44900,197700,0,242600
112735403300000,NE 162,RESIDENTIAL,45900,0,45900,192100,0,238000
112735403400000,NE 162,RESIDENTIAL,47100,0,47100,188800,0,235900
112735403500000,NE 162,RESIDENTIAL,46500,0,46500,156800,0,203300
112735403600000,NE 162,RESIDENTIAL,44600,0,44600,175600,0,220200
112735403700000,NE 162,RESIDENTIAL,43900,0,43900,156200,0,200100
112735403800000,NE 162,RESIDENTIAL,41200,0,41200,165000,0,206200
112735403900000,NE 162,RESIDENTIAL,42800,0,42800,215200,0,258000
112735404000000,NE 174,RESIDENTIAL,65600,0,65600,146400,0,212000
112735404100000,CITY PROPERTY,EXEMPT,0,0,0,0,0,0
112737700100000,NE 174,RESIDENTIAL,33400,0,33400,153000,0,186400
112737700200000,NE 174,RESIDENTIAL,33400,0,33400,168900,0,202300
112737700300000,NE 174,RESIDENTIAL,33400,0,33400,157300,0,190700
112737700400000,NE 174,RESIDENTIAL,33400,0,33400,150100,0,183500
112737700500000,NE 174,RESIDENTIAL,33400,0,33400,153400,0,186800
112737700600000,NE 174,RESIDENTIAL,33400,0,33400,156400,0,189800
112737700700000,NE 174,RESIDENTIAL,33400,0,33400,151800,0,185200
112737700800000,NE 174,RESIDENTIAL,33400,0,33400,174400,0,207800
112737700900000,NE 174,RESIDENTIAL,33400,0,33400,147000,0,180400
112737701000000,NE 174,RESIDENTIAL,33200,0,33200,167700,0,200900
112737701100000,NE 174,RESIDENTIAL,35700,0,35700,153100,0,188800
112737701200000,NE 174,RESIDENTIAL,38600,0,38600,161600,0,200200
112737701300000,NE 174,RESIDENTIAL,41200,0,41200,182000,0,223200
112737701400000,NE 174,RESIDENTIAL,37200,0,37200,151900,0,189100
112737701500000,NE 174,RESIDENTIAL,35900,0,35900,158500,0,194400
112737701600000,NE 174,RESIDENTIAL,33700,0,33700,164500,0,198200
112737701700000,NE 174,RESIDENTIAL,33400,0,33400,154500,0,187900
112737701800000,NE 174,RESIDENTIAL,33900,0,33900,147300,0,181200
112737701900000,NE 174,RESIDENTIAL,3800,0,3800,0,0,3800
112737702000000,NE 174,RESIDENTIAL,4000,0,4000,0,0,4000
112737702100000,NE 174,RESIDENTIAL,4700,0,4700,0,0,4700
112737702200000,NE 174,RESIDENTIAL,3400,0,3400,0,0,3400
112737702300000,NE 174,RESIDENTIAL,3400,0,3400,0,0,3400
112737702400000,NE 174,RESIDENTIAL,3400,0,3400,0,0,3400
112737800100000,NE 174,RESIDENTIAL,200,0,200,0,0,200
112737800200000,NE 174,RESIDENTIAL,200,0,200,0,0,200
112737800300000,NE 174,RESIDENTIAL,200,0,200,0,0,200
112737800400000,NE 174,RESIDENTIAL,26500,0,26500,7800,0,34300
112737800500000,NE 174,RESIDENTIAL,26500,0,26500,159800,0,186300
112737800600000,NE 174,RESIDENTIAL,200,0,200,0,0,200
112737800700000,NE 174,RESIDENTIAL,26500,0,26500,156200,0,182700
112737800800000,NE 174,RESIDENTIAL,26500,0,26500,157900,0,184400
112737800900000,NE 174,RESIDENTIAL,26500,0,26500,168200,0,194700
112737801000000,NE 174,RESIDENTIAL,26500,0,26500,148800,0,175300
112737801100000,NE 174,RESIDENTIAL,26500,0,26500,142900,0,169400
112737801200000,NE 174,RESIDENTIAL,26500,0,26500,140600,0,167100
112737801300000,NE 174,RESIDENTIAL,27900,0,27900,161000,0,188900
112737801400000,NE 174,RESIDENTIAL,27200,0,27200,144800,0,172000
112737801500000,NE 174,RESIDENTIAL,200,0,200,0,0,200
112737801600000,NE 174,RESIDENTIAL,31800,0,31800,152900,0,184700
112737804700000,NE 174,RESIDENTIAL,3400,0,3400,0,0,3400
112737804800000,NE 174,RESIDENTIAL,3400,0,3400,0,0,3400
112737804900000,NE 174,RESIDENTIAL,3400,0,3400,0,0,3400
112737805000000,NE 174,RESIDENTIAL,4400,0,4400,0,0,4400
112737805100000,NE 174,RESIDENTIAL,4200,0,4200,0,0,4200
112737805200000,NE 174,RESIDENTIAL,4600,0,4600,0,0,4600
112737805300000,NE 174,RESIDENTIAL,5000,0,5000,0,0,5000
112737805400000,NE 174,RESIDENTIAL,5300,0,5300,0,0,5300
112737900100000,NE 174,RESIDENTIAL,7400,0,7400,0,0,7400
112737901000000,NE 174,RESIDENTIAL,41900,0,41900,177100,0,219000
112737901100000,NE 174,RESIDENTIAL,38200,0,38200,178300,0,216500
112737901200000,NE 174,RESIDENTIAL,200,0,200,0,0,200
112737901300000,NE 174,RESIDENTIAL,38200,0,38200,166800,0,205000
112737901400000,NE 174,RESIDENTIAL,41700,0,41700,166200,0,207900
112737901500000,NE 174,RESIDENTIAL,300,0,300,0,0,300
112737901600000,NE 174,RESIDENTIAL,200,0,200,0,0,200
112737901700000,NE 174,RESIDENTIAL,200,0,200,0,0,200
112737901800000,NE 174,RESIDENTIAL,38600,0,38600,166800,0,205400
112737901900000,NE 174,RESIDENTIAL,42400,0,42400,167400,0,209800
112737902000000,NE 174,RESIDENTIAL,42400,0,42400,186300,0,228700
112737902100000,NE 174,RESIDENTIAL,42400,0,42400,184300,0,226700
112737902200000,NE 174,RESIDENTIAL,46700,0,46700,190200,0,236900
112737902300000,NE 174,RESIDENTIAL,2800,0,2800,0,0,2800
112740100200000,NE 101,AG LAND,24200,0,24200,0,0,24200
112740100300000,NE 101,AG LAND,23100,0,23100,0,0,23100
112740200100000,NE 163,RESIDENTIAL,39600,0,39600,144900,0,184500
112740200200000,NE 163,RESIDENTIAL,35900,0,35900,142100,0,178000
112740200300000,NE 163,RESIDENTIAL,35900,0,35900,127800,0,163700
112740200400000,NE 163,RESIDENTIAL,35900,0,35900,156200,0,192100
112740200500000,CITY PROPERTY,EXEMPT,0,0,0,0,0,0
112740200600000,NE 163,RESIDENTIAL,38100,0,38100,161500,0,199600
112740200700000,NE 163,RESIDENTIAL,37000,0,37000,137500,0,174500
112740200800000,NE 163,RESIDENTIAL,37600,0,37600,158400,0,196000
112740200900000,NE 163,RESIDENTIAL,37600,0,37600,140700,0,178300
112740201000000,NE 163,RESIDENTIAL,37600,0,37600,174100,0,211700
112740201100000,NE 163,RESIDENTIAL,33600,0,33600,136400,0,170000
112740300100000,NE 163,RESIDENTIAL,41100,0,41100,140300,0,181400
112740300200000,NE 163,RESIDENTIAL,33900,0,33900,141800,0,175700
112740300300000,NE 163,RESIDENTIAL,33900,0,33900,131400,0,165300
112740300400000,NE 163,RESIDENTIAL,33900,0,33900,142500,0,176400
112740300500000,NE 163,RESIDENTIAL,33900,0,33900,147000,0,180900
112740300600000,NE 163,RESIDENTIAL,33900,0,33900,133800,0,167700
112740300700000,NE 163,RESIDENTIAL,39400,0,39400,132900,0,172300
112740300800000,NE 163,RESIDENTIAL,33900,0,33900,133100,0,167000
112740300900000,NE 163,RESIDENTIAL,33900,0,33900,137000,0,170900
112740301000000,NE 163,RESIDENTIAL,33900,0,33900,126500,0,160400
112740301100000,NE 163,RESIDENTIAL,33900,0,33900,137100,0,171000
112740301200000,NE 163,RESIDENTIAL,33900,0,33900,148400,0,182300
112740301300000,NE 163,RESIDENTIAL,33900,0,33900,139100,0,173000
112740301400000,NE 163,RESIDENTIAL,33900,0,33900,110300,0,144200
112740301500000,NE 163,RESIDENTIAL,33900,0,33900,137500,0,171400
112740301600000,NE 163,RESIDENTIAL,33900,0,33900,121400,0,155300
112740301700000,NE 163,RESIDENTIAL,41500,0,41500,139500,0,181000
112740301800000,NE 163,RESIDENTIAL,33900,0,33900,156700,0,190600
112740301900000,NE 163,RESIDENTIAL,33900,0,33900,154400,0,188300
112740302000000,NE 163,RESIDENTIAL,33900,0,33900,135100,0,169000
112740302100000,NE 163,RESIDENTIAL,33900,0,33900,166500,0,200400
112740302200000,NE 163,RESIDENTIAL,39400,0,39400,169400,0,208800
112740400100000,NE 163,RESIDENTIAL,41100,0,41100,139800,0,180900
112740400200000,NE 163,RESIDENTIAL,34600,0,34600,125600,0,160200
112740400300000,NE 163,RESIDENTIAL,34600,0,34600,139400,0,174000
112740400400000,NE 163,RESIDENTIAL,34600,0,34600,144800,0,179400
112740400500000,NE 163,RESIDENTIAL,34600,0,34600,121100,0,155700
112740400600000,NE 163,RESIDENTIAL,34600,0,34600,126300,0,160900
112740400700000,NE 163,RESIDENTIAL,34600,0,34600,135600,0,170200
112740400800000,NE 163,RESIDENTIAL,34600,0,34600,117500,0,152100
112740400900000,NE 163,RESIDENTIAL,34600,0,34600,138700,0,173300
112740401000000,NE 163,RESIDENTIAL,34600,0,34600,125100,0,159700
112740401100000,NE 163,RESIDENTIAL,34600,0,34600,152400,0,187000
112742600100000,NE 101,AG LAND,24300,0,24300,0,0,24300
112742800800000,NE 163,RESIDENTIAL,39400,0,39400,136100,0,175500
112742800900000,NE 163,RESIDENTIAL,33600,0,33600,120400,0,154000
112742801000000,NE 163,RESIDENTIAL,33600,0,33600,133300,0,166900
112742801100000,NE 163,RESIDENTIAL,33600,0,33600,137600,0,171200
112742801200000,NE 163,RESIDENTIAL,33600,0,33600,132800,0,166400
112742801300000,NE 163,RESIDENTIAL,33600,0,33600,121500,0,155100
112742801400000,NE 163,RESIDENTIAL,33600,0,33600,137800,0,171400
112742801500000,NE 163,RESIDENTIAL,33600,0,33600,135300,0,168900
112742801600000,NE 163,RESIDENTIAL,33600,0,33600,143800,0,177400
112742801700000,NE 163,RESIDENTIAL,33600,0,33600,134800,0,168400
112742801800000,NE 163,RESIDENTIAL,33600,0,33600,136800,0,170400
112742801900000,NE 163,RESIDENTIAL,33600,0,33600,142200,0,175800
112742802000000,NE 163,RESIDENTIAL,33600,0,33600,140900,0,174500
112742802100000,NE 163,RESIDENTIAL,39400,0,39400,138200,0,177600
112742900300000,NE 163,RESIDENTIAL,39900,0,39900,161200,0,201100
112742900400000,NE 163,RESIDENTIAL,39900,0,39900,153800,0,193700
112742900500000,NE 163,RESIDENTIAL,39900,0,39900,158400,0,198300
112742900600000,NE 163,RESIDENTIAL,35000,0,35000,154000,0,189000
112742900700000,NE 163,RESIDENTIAL,35000,0,35000,167100,0,202100
112742900800000,NE 163,RESIDENTIAL,35000,0,35000,161600,0,196600
112742900900000,NE 163,RESIDENTIAL,35000,0,35000,165500,0,200500
112742901000000,NE 163,RESIDENTIAL,35000,0,35000,141200,0,176200
112742901100000,NE 163,RESIDENTIAL,35000,0,35000,137200,0,172200
112742901200000,NE 163,RESIDENTIAL,35000,0,35000,174100,0,209100
112742901300000,NE 163,RESIDENTIAL,35000,0,35000,149900,0,184900
112742901400000,NE 163,RESIDENTIAL,34900,0,34900,147500,0,182400
112743000100000,NE 163,RESIDENTIAL,34600,0,34600,121800,0,156400
112743000200000,NE 163,RESIDENTIAL,39400,0,39400,141300,0,180700
112743100100000,NE 163,RESIDENTIAL,39400,0,39400,140400,0,179800
112743100200000,NE 163,RESIDENTIAL,35200,0,35200,119900,0,155100
112743100300000,NE 163,RESIDENTIAL,35200,0,35200,120300,0,155500
112743100400000,NE 163,RESIDENTIAL,35200,0,35200,116600,0,151800
112743100500000,NE 163,RESIDENTIAL,35200,0,35200,135000,0,170200
112743100600000,NE 163,RESIDENTIAL,35200,0,35200,164000,0,199200
112743100700000,NE 163,RESIDENTIAL,35200,0,35200,152200,0,187400
112743100800000,NE 163,RESIDENTIAL,35200,0,35200,128800,0,164000
112743100900000,NE 163,RESIDENTIAL,35200,0,35200,131000,0,166200
112743101000000,NE 163,RESIDENTIAL,35200,0,35200,148200,0,183400
112743101100000,NE 163,RESIDENTIAL,35200,0,35200,127100,0,162300
112743101200000,NE 163,RESIDENTIAL,35200,0,35200,144200,0,179400
112743101300000,NE 163,RESIDENTIAL,35200,0,35200,148500,0,183700
112743101400000,NE 163,RESIDENTIAL,35200,0,35200,133400,0,168600
112743101500000,NE 163,RESIDENTIAL,35200,0,35200,124700,0,159900
112743101600000,NE 163,RESIDENTIAL,39400,0,39400,139000,0,178400
112743200100000,NE 163,RESIDENTIAL,26000,0,26000,0,0,26000
112745100200000,NE 174,RESIDENTIAL,63500,0,63500,196800,0,260300
112745100600000,NE 174,AG LAND,47300,0,47300,0,0,47300
112745200100000,NE 174,RESIDENTIAL,3400,0,3400,0,0,3400
112745200200000,NE 174,RESIDENTIAL,3900,0,3900,0,0,3900
112745300100000,NE 174,RESIDENTIAL,3700,0,3700,0,0,3700
112745300200000,NE 174,RESIDENTIAL,3700,0,3700,0,0,3700
112745300300000,NE 174,RESIDENTIAL,3600,0,3600,0,0,3600
112745300400000,NE 174,RESIDENTIAL,3600,0,3600,0,0,3600
112745300500000,NE 174,RESIDENTIAL,5100,0,5100,0,0,5100
112745300600000,NE 174,RESIDENTIAL,4800,0,4800,0,0,4800
112745300700000,NE 174,RESIDENTIAL,6000,0,6000,0,0,6000
112745300800000,NE 174,RESIDENTIAL,7100,0,7100,0,0,7100
112745400100000,NE 174,RESIDENTIAL,7400,0,7400,0,0,7400
112745400200000,NE 174,RESIDENTIAL,4900,0,4900,0,0,4900
112745400300000,NE 174,RESIDENTIAL,3300,0,3300,0,0,3300
112745400400000,NE 174,RESIDENTIAL,3300,0,3300,0,0,3300
112745400500000,NE 174,RESIDENTIAL,3200,0,3200,0,0,3200
112745400600000,NE 174,RESIDENTIAL,42400,0,42400,168600,0,211000
112745400700000,NE 174,RESIDENTIAL,5800,0,5800,0,0,5800
112745500100000,NE 174,RESIDENTIAL,3200,0,3200,0,0,3200
112745500200000,NE 174,RESIDENTIAL,3200,0,3200,0,0,3200
112745500300000,NE 174,RESIDENTIAL,3000,0,3000,0,0,3000
112745500400000,NE 174,RESIDENTIAL,3300,0,3300,0,0,3300
112745500500000,NE 174,RESIDENTIAL,3300,0,3300,0,0,3300
112745500600000,NE 174,RESIDENTIAL,3200,0,3200,0,0,3200
112745500700000,NE 174,RESIDENTIAL,3200,0,3200,0,0,3200
112745500800000,NE 174,RESIDENTIAL,3200,0,3200,0,0,3200
112745500900000,NE 174,RESIDENTIAL,3300,0,3300,0,0,3300
112745501000000,NE 174,RESIDENTIAL,3400,0,3400,0,0,3400
112745501100000,NE 174,RESIDENTIAL,3200,0,3200,0,0,3200
112745501200000,NE 174,RESIDENTIAL,3700,0,3700,0,0,3700
112745501300000,NE 174,RESIDENTIAL,44100,0,44100,176800,0,220900
112745501400000,NE 174,RESIDENTIAL,3400,0,3400,0,0,3400
112747600100000,CITY PROPERTY,EXEMPT,0,0,0,0,0,0
112747600200000,NE 163,RESIDENTIAL,34000,0,34000,126000,0,160000
112747600300000,NE 163,RESIDENTIAL,34100,0,34100,140700,0,174800
112747600400000,NE 163,RESIDENTIAL,36800,0,36800,153200,0,190000
112747600500000,NE 163,RESIDENTIAL,36800,0,36800,140000,0,176800
112747600600000,NE 163,RESIDENTIAL,34100,0,34100,136000,0,170100
112747600700000,NE 163,RESIDENTIAL,34100,0,34100,137000,0,171100
112747600800000,NE 163,RESIDENTIAL,34100,0,34100,143100,0,177200
112747600900000,NE 163,RESIDENTIAL,34100,0,34100,125300,0,159400
112747601000000,NE 163,RESIDENTIAL,34100,0,34100,125900,0,160000
112747601100000,NE 163,RESIDENTIAL,39800,0,39800,143400,0,183200
112747601200000,NE 163,RESIDENTIAL,40100,0,40100,139100,0,179200
112747601300000,NE 163,RESIDENTIAL,40400,0,40400,158100,0,198500
112747601400000,NE 163,RESIDENTIAL,39900,0,39900,133000,0,172900
112747601500000,NE 163,RESIDENTIAL,39900,0,39900,129700,0,169600
112747601600000,NE 163,RESIDENTIAL,40600,0,40600,138300,0,178900
112747700100000,NE 163,RESIDENTIAL,41600,0,41600,133000,0,174600
112747700200000,NE 163,RESIDENTIAL,37000,0,37000,136900,0,173900
112747700300000,NE 163,RESIDENTIAL,37000,0,37000,128000,0,165000
112747700400000,NE 163,RESIDENTIAL,37000,0,37000,138000,0,175000
112747700500000,NE 163,RESIDENTIAL,37000,0,37000,170600,0,207600
112747700600000,NE 163,RESIDENTIAL,37000,0,37000,139100,0,176100
112747700700000,NE 163,RESIDENTIAL,37000,0,37000,137700,0,174700
112747700800000,NE 163,RESIDENTIAL,37000,0,37000,129100,0,166100
112747700900000,NE 163,RESIDENTIAL,37000,0,37000,156500,0,193500
112747701000000,NE 163,RESIDENTIAL,37000,0,37000,145700,0,182700
112747701100000,NE 163,RESIDENTIAL,39400,0,39400,138000,0,177400
112747800100000,NE 163,RESIDENTIAL,41300,0,41300,159500,0,200800
112747800200000,NE 163,RESIDENTIAL,34500,0,34500,144400,0,178900
112747800300000,NE 163,RESIDENTIAL,34500,0,34500,144100,0,178600
112747800400000,NE 163,RESIDENTIAL,34500,0,34500,139400,0,173900
112747800500000,NE 163,RESIDENTIAL,34500,0,34500,141600,0,176100
112747800600000,NE 163,RESIDENTIAL,34500,0,34500,137900,0,172400
112747800700000,NE 163,RESIDENTIAL,34500,0,34500,162400,0,196900
112747800800000,NE 163,RESIDENTIAL,40100,0,40100,154900,0,195000
112747800900000,NE 163,RESIDENTIAL,35200,0,35200,121400,0,156600
112747801000000,NE 163,RESIDENTIAL,34500,0,34500,136200,0,170700
112747801100000,NE 163,RESIDENTIAL,34500,0,34500,156400,0,190900
112747801200000,NE 163,RESIDENTIAL,34500,0,34500,134500,0,169000
112747801300000,NE 163,RESIDENTIAL,34800,0,34800,137600,0,172400
112747801400000,NE 163,RESIDENTIAL,40200,0,40200,149600,0,189800
112747801500000,NE 163,RESIDENTIAL,34100,0,34100,133300,0,167400
112747801600000,NE 163,RESIDENTIAL,34100,0,34100,126800,0,160900
112747801700000,NE 163,RESIDENTIAL,34100,0,34100,138800,0,172900
112747801800000,NE 163,RESIDENTIAL,34100,0,34100,137300,0,171400
112747801900000,NE 163,RESIDENTIAL,34100,0,34100,137900,0,172000
112747802000000,NE 163,RESIDENTIAL,35900,0,35900,144900,0,180800
112747802100000,NE 163,RESIDENTIAL,38600,0,38600,138200,0,176800
112747802200000,NE 163,RESIDENTIAL,41300,0,41300,154400,0,195700
112747802300000,NE 163,RESIDENTIAL,40600,0,40600,138900,0,179500
112747802400000,NE 163,RESIDENTIAL,37200,0,37200,151700,0,188900
112747802500000,NE 163,RESIDENTIAL,37200,0,37200,153600,0,190800
112747802600000,NE 163,RESIDENTIAL,37100,0,37100,134300,0,171400
112747802700000,NE 163,RESIDENTIAL,32000,0,32000,150400,0,182400
112747802800000,NE 163,RESIDENTIAL,39400,0,39400,159400,0,198800
112747802900000,NE 163,RESIDENTIAL,37800,0,37800,158100,0,195900
112747803000000,NE 163,RESIDENTIAL,38300,0,38300,129800,0,168100
112747803100000,NE 163,RESIDENTIAL,41100,0,41100,162000,0,203100
112747803200000,NE 163,RESIDENTIAL,33900,0,33900,138300,0,172200
112747803300000,NE 163,RESIDENTIAL,35800,0,35800,168900,0,204700
112747803400000,NE 163,RESIDENTIAL,35800,0,35800,134300,0,170100
112747803500000,NE 163,RESIDENTIAL,33800,0,33800,159700,0,193500
112747803600000,NE 163,RESIDENTIAL,39500,0,39500,133400,0,172900
112747803700000,NE 163,RESIDENTIAL,37000,0,37000,143900,0,180900
112747900100000,NE 163,RESIDENTIAL,41000,0,41000,142800,0,183800
112747900200000,NE 163,RESIDENTIAL,35800,0,35800,157200,0,193000
112747900300000,NE 163,RESIDENTIAL,35800,0,35800,144500,0,180300
112747900400000,NE 163,RESIDENTIAL,35800,0,35800,132400,0,168200
112747900500000,NE 163,RESIDENTIAL,35800,0,35800,144700,0,180500
112747900600000,NE 163,RESIDENTIAL,35800,0,35800,128200,0,164000
112747900700000,NE 163,RESIDENTIAL,35300,0,35300,137600,0,172900
112747900800000,NE 163,RESIDENTIAL,37000,0,37000,159800,0,196800
112747900900000,NE 163,RESIDENTIAL,37000,0,37000,148200,0,185200
112747901000000,NE 163,RESIDENTIAL,35300,0,35300,136200,0,171500
112747901100000,NE 163,RESIDENTIAL,35300,0,35300,137200,0,172500
112747901200000,NE 163,RESIDENTIAL,35300,0,35300,120100,0,155400
112747901300000,NE 163,RESIDENTIAL,35300,0,35300,131500,0,166800
112747901400000,NE 163,RESIDENTIAL,35300,0,35300,151800,0,187100
112747901500000,NE 163,RESIDENTIAL,35300,0,35300,143800,0,179100
112747901600000,NE 163,RESIDENTIAL,40400,0,40400,140400,0,180800
112748000100000,NE 163,RESIDENTIAL,40500,0,40500,134500,0,175000
112748000200000,NE 163,RESIDENTIAL,35800,0,35800,119600,0,155400
112748000300000,NE 163,RESIDENTIAL,39700,0,39700,128100,0,167800
112748000400000,NE 163,RESIDENTIAL,40100,0,40100,141200,0,181300
112748000500000,NE 163,RESIDENTIAL,42300,0,42300,144500,0,186800
112748000600000,NE 163,RESIDENTIAL,40500,0,40500,125500,0,166000
112748000700000,NE 163,RESIDENTIAL,40000,0,40000,144400,0,184400
112748000800000,NE 163,RESIDENTIAL,38300,0,38300,131800,0,170100
112748000900000,NE 163,RESIDENTIAL,40000,0,40000,136800,0,176800
112748001000000,NE 163,RESIDENTIAL,40400,0,40400,169200,0,209600
112748001100000,NE 163,RESIDENTIAL,40100,0,40100,130600,0,170700
112748001200000,NE 163,RESIDENTIAL,37200,0,37200,153300,0,190500
112748001300000,NE 163,RESIDENTIAL,35000,0,35000,153300,0,188300
112748001400000,NE 163,RESIDENTIAL,34100,0,34100,135800,0,169900
112748001500000,NE 163,RESIDENTIAL,34100,0,34100,133300,0,167400
112748001600000,NE 163,RESIDENTIAL,40100,0,40100,140400,0,180500
112748100100000,NE 163,RESIDENTIAL,40300,0,40300,128400,0,168700
112748100200000,NE 163,RESIDENTIAL,34100,0,34100,148500,0,182600
112748100300000,NE 163,RESIDENTIAL,34100,0,34100,122200,0,156300
112748100400000,NE 163,RESIDENTIAL,34600,0,34600,149300,0,183900
112748100500000,NE 163,RESIDENTIAL,35800,0,35800,123700,0,159500
112748100600000,NE 163,RESIDENTIAL,40300,0,40300,123000,0,163300
112748100700000,NE 163,RESIDENTIAL,40600,0,40600,132000,0,172600
112748100800000,NE 163,RESIDENTIAL,41700,0,41700,157700,0,199400
112748100900000,NE 163,RESIDENTIAL,34100,0,34100,116500,0,150600
112748101000000,NE 163,RESIDENTIAL,34800,0,34800,156500,0,191300
112748101100000,NE 163,RESIDENTIAL,41300,0,41300,139600,0,180900
112748101200000,NE 163,RESIDENTIAL,42300,0,42300,127700,0,170000
112748101300000,NE 163,RESIDENTIAL,41200,0,41200,146400,0,187600
112748101400000,NE 163,RESIDENTIAL,42800,0,42800,145600,0,188400
112748101500000,NE 163,RESIDENTIAL,39600,0,39600,140800,0,180400
112748101600000,NE 163,RESIDENTIAL,38800,0,38800,130900,0,169700
112748101700000,NE 163,RESIDENTIAL,34800,0,34800,155400,0,190200
112748101800000,NE 163,RESIDENTIAL,34100,0,34100,140100,0,174200
112748101900000,NE 163,RESIDENTIAL,40600,0,40600,146300,0,186900
112748102000000,NE 163,RESIDENTIAL,34500,0,34500,138100,0,172600
112748102100000,NE 163,RESIDENTIAL,40300,0,40300,159100,0,199400
112748102200000,NE 163,RESIDENTIAL,35800,0,35800,131300,0,167100
112748102300000,NE 163,RESIDENTIAL,34500,0,34500,128000,0,162500
112748102400000,NE 163,RESIDENTIAL,34100,0,34100,129200,0,163300
112748102500000,NE 163,RESIDENTIAL,34100,0,34100,132400,0,166500
112748102600000,NE 163,RESIDENTIAL,40200,0,40200,124300,0,164500
112817600100000,CENTRALLY ASSESSED,OTHER,0,0,0,0,0,0
112817600200000,NE 162,AG DWELLING,67000,0,67000,81200,11400,159600
112840100100000,NE 162,AG LAND,36800,0,36800,0,0,36800
112840100200000,NE 162,RESIDENTIAL,55700,0,55700,299900,0,355600
112840100300000,NE 162,RESIDENTIAL,55600,0,55600,214900,0,270500
112840100400000,NE 162,RESIDENTIAL,55600,0,55600,229300,0,284900
112840100500000,NE 162,RESIDENTIAL,55600,0,55600,231300,0,286900
112840100600000,NE 162,RESIDENTIAL,55600,0,55600,220800,0,276400
112840100700000,NE 162,RESIDENTIAL,55600,0,55600,230600,0,286200
112840100800000,NE 162,RESIDENTIAL,55600,0,55600,238100,0,293700
112840100900000,NE 162,RESIDENTIAL,55600,0,55600,195700,0,251300
112840101000000,NE 162,RESIDENTIAL,55600,0,55600,221500,0,277100
112840101100000,NE 162,RESIDENTIAL,55600,0,55600,233400,0,289000
112840101200000,NE 162,RESIDENTIAL,55600,0,55600,205900,0,261500
112840101300000,NE 162,RESIDENTIAL,40500,0,40500,151800,0,192300
112840200100000,NE 162,RESIDENTIAL,27100,0,27100,328500,0,355600
112840200200000,NE 162,RESIDENTIAL,41700,0,41700,183900,0,225600
112840200300000,NE 162,RESIDENTIAL,55600,0,55600,228300,0,283900
112840200400000,NE 162,RESIDENTIAL,55600,0,55600,204200,0,259800
112840200500000,NE 162,RESIDENTIAL,55600,0,55600,221400,0,277000
112840200600000,NE 162,RESIDENTIAL,55600,0,55600,202800,0,258400
112840200700000,NE 162,RESIDENTIAL,58100,0,58100,223200,0,281300
112840200800000,NE 162,RESIDENTIAL,58100,0,58100,300500,0,358600
112840200900000,NE 162,RESIDENTIAL,58100,0,58100,199300,0,257400
112840201000000,NE 162,RESIDENTIAL,56700,0,56700,207300,0,264000
112840201100000,NE 162,RESIDENTIAL,71000,0,71000,166100,0,237100
112840201200000,NE 162,RESIDENTIAL,40000,0,40000,79100,0,119100
112842600100000,NE 162,RESIDENTIAL,47800,0,47800,210500,0,258300
112842600200000,NE 162,RESIDENTIAL,42600,0,42600,196200,0,238800
112842600300000,NE 162,RESIDENTIAL,42600,0,42600,197300,0,239900
112842600400000,NE 162,RESIDENTIAL,42600,0,42600,242900,0,285500
112842600500000,NE 162,RESIDENTIAL,44900,0,44900,194900,0,239800
112842600600000,NE 162,RESIDENTIAL,44900,0,44900,201000,0,245900
112842600700000,NE 162,RESIDENTIAL,47100,0,47100,192300,0,239400
112842600800000,NE 162,RESIDENTIAL,47100,0,47100,208600,0,255700
112842600900000,NE 162,RESIDENTIAL,51500,0,51500,169900,0,221400
112842700100000,NE 162,RESIDENTIAL,51500,0,51500,209700,0,261200
112842700200000,NE 162,RESIDENTIAL,45800,0,45800,226700,0,272500
112842700300000,NE 162,RESIDENTIAL,45800,0,45800,196500,0,242300
112842700400000,NE 162,RESIDENTIAL,41600,0,41600,196900,0,238500
112842700500000,NE 162,RESIDENTIAL,46200,0,46200,217400,0,263600
112842700600000,NE 162,RESIDENTIAL,53300,0,53300,229700,0,283000
112842700700000,NE 162,RESIDENTIAL,52100,0,52100,215200,0,267300
112842700800000,NE 162,RESIDENTIAL,42600,0,42600,204800,0,247400
112842700900000,NE 162,RESIDENTIAL,44900,0,44900,212700,0,257600
112842701000000,NE 162,RESIDENTIAL,44900,0,44900,273300,0,318200
112842701100000,NE 162,RESIDENTIAL,40400,0,40400,147600,0,188000
112842701200000,NE 162,RESIDENTIAL,44900,0,44900,223200,0,268100
112842701300000,NE 162,RESIDENTIAL,44900,0,44900,224300,0,269200
112842701400000,NE 162,RESIDENTIAL,42600,0,42600,179900,0,222500
112842701500000,NE 162,RESIDENTIAL,44900,0,44900,201900,0,246800
112842701600000,NE 162,RESIDENTIAL,41500,0,41500,178600,0,220100
112842701700000,NE 162,RESIDENTIAL,44900,0,44900,181400,0,226300
112842701800000,NE 162,RESIDENTIAL,45400,0,45400,182100,0,227500
112842701900000,NE 162,RESIDENTIAL,49500,0,49500,222500,0,272000
112842702000000,NE 162,RESIDENTIAL,61600,0,61600,202400,0,264000
112842702100000,NE 162,RESIDENTIAL,52300,0,52300,223100,0,275400
112842702200000,NE 162,RESIDENTIAL,50700,0,50700,212000,0,262700
112842800200000,CENTRALLY ASSESSED,OTHER,0,0,0,0,0,0
112842900100000,NE 162,RESIDENTIAL,50500,0,50500,176600,0,227100
112842900200000,NE 162,RESIDENTIAL,42100,0,42100,198100,0,240200
112842900300000,NE 162,RESIDENTIAL,43800,0,43800,223700,0,267500
112842900400000,NE 162,RESIDENTIAL,42000,0,42000,177400,0,219400
112842900500000,NE 162,RESIDENTIAL,59600,0,59600,188800,0,248400
112842900600000,NE 162,RESIDENTIAL,44300,0,44300,182600,0,226900
112842900700000,NE 162,RESIDENTIAL,44900,0,44900,229700,0,274600
112842900800000,NE 162,RESIDENTIAL,40400,0,40400,178300,0,218700
112842900900000,NE 162,RESIDENTIAL,42600,0,42600,224200,0,266800
112842901000000,NE 162,RESIDENTIAL,44900,0,44900,171800,0,216700
112842901100000,NE 162,RESIDENTIAL,40400,0,40400,160000,0,200400
112842901200000,NE 162,RESIDENTIAL,42600,0,42600,214800,0,257400
112842901300000,NE 162,RESIDENTIAL,40400,0,40400,149600,0,190000
112842901400000,NE 162,RESIDENTIAL,44900,0,44900,208900,0,253800
112842901500000,NE 162,RESIDENTIAL,39800,0,39800,178200,0,218000
112842901600000,NE 162,RESIDENTIAL,55000,0,55000,199100,0,254100
112842901700000,NE 162,RESIDENTIAL,50900,0,50900,178600,0,229500
112842901800000,NE 162,RESIDENTIAL,52600,0,52600,209700,0,262300
112842901900000,NE 162,RESIDENTIAL,43100,0,43100,159600,0,202700
112842902000000,NE 162,RESIDENTIAL,47000,0,47000,194200,0,241200
112842902100000,NE 162,RESIDENTIAL,41000,0,41000,190900,0,231900
112842902200000,NE 162,RESIDENTIAL,44900,0,44900,215400,0,260300
112842902300000,NE 162,RESIDENTIAL,40400,0,40400,198800,0,239200
112842902400000,NE 162,RESIDENTIAL,47100,0,47100,220600,0,267700
112842902500000,NE 162,RESIDENTIAL,43100,0,43100,190800,0,233900
112842902600000,NE 162,RESIDENTIAL,50100,0,50100,235200,0,285300
112842902700000,NE 162,RESIDENTIAL,47200,0,47200,197900,0,245100
112842902800000,NE 162,RESIDENTIAL,42100,0,42100,170000,0,212100
112842902900000,NE 162,RESIDENTIAL,50500,0,50500,211800,0,262300
112843000100000,NE 162,RESIDENTIAL,53400,0,53400,263400,0,316800
112843000200000,NE 162,RESIDENTIAL,59100,0,59100,214400,0,273500
112843000300000,NE 162,RESIDENTIAL,39600,0,39600,169100,0,208700
112843000400000,NE 162,RESIDENTIAL,45400,0,45400,198100,0,243500
112843000500000,NE 162,RESIDENTIAL,38100,0,38100,174900,0,213000
112843000600000,NE 162,RESIDENTIAL,40400,0,40400,188200,0,228600
112843000700000,NE 162,RESIDENTIAL,40600,0,40600,214200,0,254800
112843000800000,NE 162,RESIDENTIAL,40600,0,40600,164500,0,205100
112843000900000,NE 162,RESIDENTIAL,50900,0,50900,202700,0,253600
112843001000000,NE 162,RESIDENTIAL,39700,0,39700,223100,0,262800
112843001100000,NE 162,RESIDENTIAL,52400,0,52400,193100,0,245500
112843001200000,NE 162,RESIDENTIAL,41300,0,41300,193500,0,234800
112843001300000,NE 162,RESIDENTIAL,40500,0,40500,169800,0,210300
112843001400000,NE 162,RESIDENTIAL,43900,0,43900,178600,0,222500
112843001500000,NE 162,RESIDENTIAL,42600,0,42600,166900,0,209500
112843001600000,NE 162,RESIDENTIAL,41600,0,41600,175100,0,216700
112843100100000,NE 162,RESIDENTIAL,53600,0,53600,212100,0,265700
112843100200000,NE 162,RESIDENTIAL,44300,0,44300,235200,0,279500
112843100300000,NE 162,RESIDENTIAL,51100,0,51100,212900,0,264000
112843100400000,NE 162,RESIDENTIAL,49000,0,49000,218900,0,267900
112843100500000,NE 162,RESIDENTIAL,43000,0,43000,202600,0,245600
112843100600000,NE 162,RESIDENTIAL,54800,0,54800,215400,0,270200
112845100100000,NE 162,RESIDENTIAL,60500,0,60500,233600,0,294100
112845100200000,NE 162,RESIDENTIAL,43800,0,43800,226300,0,270100
112845100300000,NE 162,RESIDENTIAL,48600,0,48600,180600,0,229200
112845100400000,NE 162,RESIDENTIAL,50300,0,50300,172300,0,222600
112845100500000,NE 162,RESIDENTIAL,46000,0,46000,209600,0,255600
112845100600000,NE 162,RESIDENTIAL,46200,0,46200,188900,0,235100
112845100700000,NE 162,RESIDENTIAL,46800,0,46800,209800,0,256600
112845100800000,NE 162,RESIDENTIAL,51100,0,51100,250600,0,301700
112845100900000,NE 162,RESIDENTIAL,49700,0,49700,218600,0,268300
112845101000000,NE 162,RESIDENTIAL,53500,0,53500,215000,0,268500
112845101100000,NE 162,RESIDENTIAL,52600,0,52600,244800,0,297400
112845101200000,CITY PROPERTY,EXEMPT,0,0,0,0,0,0
112845101400000,CITY PROPERTY,EXEMPT,0,0,0,0,0,0
112845101500000,CITY PROPERTY,EXEMPT,0,0,0,0,0,0
112847600100000,NE 162,RESIDENTIAL,47300,0,47300,154900,0,202200
112847600200000,NE 162,RESIDENTIAL,34700,0,34700,145200,0,179900
112847600300000,NE 162,RESIDENTIAL,37300,0,37300,174200,0,211500
112847600400000,NE 162,RESIDENTIAL,34700,0,34700,145600,0,180300
112847600500000,NE 162,RESIDENTIAL,37300,0,37300,172800,0,210100
112847600600000,NE 162,RESIDENTIAL,34700,0,34700,160300,0,195000
112847600700000,NE 162,RESIDENTIAL,37300,0,37300,176300,0,213600
112847600800000,NE 162,RESIDENTIAL,34700,0,34700,160100,0,194800
112847600900000,NE 162,RESIDENTIAL,40000,0,40000,179100,0,219100
112847601000000,NE 162,RESIDENTIAL,34700,0,34700,150200,0,184900
112847601100000,NE 162,RESIDENTIAL,40000,0,40000,165500,0,205500
112847601200000,NE 162,RESIDENTIAL,40000,0,40000,169900,0,209900
112847601300000,NE 162,RESIDENTIAL,42700,0,42700,169300,0,212000
112847601400000,NE 162,RESIDENTIAL,49600,0,49600,262500,0,312100
112847601500000,CITY PROPERTY,EXEMPT,0,0,0,0,0,0
112847700100000,NE 162,RESIDENTIAL,47800,0,47800,200800,0,248600
112847700200000,NE 162,RESIDENTIAL,34800,0,34800,162600,0,197400
112847700300000,NE 162,RESIDENTIAL,39600,0,39600,167600,0,207200
112847700400000,NE 162,RESIDENTIAL,34800,0,34800,162000,0,196800
112847700500000,NE 162,RESIDENTIAL,39600,0,39600,147100,0,186700
112847700600000,NE 162,RESIDENTIAL,34800,0,34800,182600,0,217400
112847700700000,NE 162,RESIDENTIAL,39600,0,39600,172400,0,212000
112847700800000,NE 162,RESIDENTIAL,34800,0,34800,149400,0,184200
112847700900000,NE 162,RESIDENTIAL,39600,0,39600,167400,0,207000
112847701000000,NE 162,RESIDENTIAL,34800,0,34800,171200,0,206000
112847701100000,NE 162,RESIDENTIAL,39600,0,39600,147100,0,186700
112847701200000,NE 162,RESIDENTIAL,42200,0,42200,175500,0,217700
112847701300000,NE 162,RESIDENTIAL,42200,0,42200,177100,0,219300
112847701400000,NE 162,RESIDENTIAL,51400,0,51400,179100,0,230500
112847701500000,CITY PROPERTY,EXEMPT,0,0,0,0,0,0
112847701600000,WAREHOUSE;MINI STORG,COMMERCIAL,58086,80214,138300,97300,36500,272100
112847701700000,NE 162,RESIDENTIAL,7400,0,7400,0,0,7400
112847701800000,NE 103,RESIDENTIAL,29100,0,29100,123100,0,152200
112847701900000,NE 103,RESIDENTIAL,34600,0,34600,114400,0,149000
112847702000000,NE 103,RESIDENTIAL,34600,0,34600,128500,0,163100
112847702100000,NE 103,RESIDENTIAL,34600,0,34600,128500,0,163100
112847702200000,NE 103,RESIDENTIAL,35100,0,35100,127900,0,163000
112847702300000,NE 103,RESIDENTIAL,34900,0,34900,132000,0,166900
112847702400000,NE 102,RESIDENTIAL,35300,0,35300,181600,0,216900
112847702500000,NE 102,RESIDENTIAL,35300,0,35300,135000,0,170300
112847702600000,NE 102,RESIDENTIAL,34400,0,34400,135400,0,169800
112847702700000,NE 102,RESIDENTIAL,37100,0,37100,171700,0,208800
112847702800000,NE 102,RESIDENTIAL,37200,0,37200,201500,0,238700
112847702900000,NE 102,RESIDENTIAL,38200,0,38200,176200,0,214400
112847703000000,NE 102,RESIDENTIAL,32900,0,32900,181000,0,213900
112847703100000,NE 102,RESIDENTIAL,35700,0,35700,163800,0,199500
112847703200000,NE 102,RESIDENTIAL,32000,0,32000,148800,0,180800
112847703300000,NE 102,RESIDENTIAL,36700,0,36700,153000,0,189700
112847703400000,NE 102,RESIDENTIAL,32900,0,32900,153000,0,185900
112847703500000,NE 102,RESIDENTIAL,41500,0,41500,137300,0,178800
112847800100000,NE 102,RESIDENTIAL,37200,0,37200,125500,0,162700
112847800200000,NE 102,RESIDENTIAL,35700,0,35700,137900,0,173600
112847800300000,NE 102,RESIDENTIAL,31000,0,31000,156800,0,187800
112847800400000,NE 102,RESIDENTIAL,35700,0,35700,150700,0,186400
112847800500000,NE 102,RESIDENTIAL,30700,0,30700,149800,0,180500
112847800600000,NE 102,RESIDENTIAL,30100,0,30100,161400,0,191500
112847800700000,NE 102,RESIDENTIAL,37700,0,37700,149600,0,187300
112847800800000,NE 102,RESIDENTIAL,42400,0,42400,182200,0,224600
112847800900000,NE 102,RESIDENTIAL,28200,0,28200,107400,0,135600
112847801000000,NE 102,RESIDENTIAL,32800,0,32800,167700,0,200500
112847801100000,NE 102,RESIDENTIAL,28900,0,28900,141300,0,170200
112847801200000,NE 102,RESIDENTIAL,34900,0,34900,149400,0,184300
112847801300000,NE 102,RESIDENTIAL,36600,0,36600,150900,0,187500
112847801400000,NE 102,RESIDENTIAL,34100,0,34100,126900,0,161000
112847801500000,NE 102,RESIDENTIAL,32900,0,32900,153900,0,186800
112847801600000,NE 103,RESIDENTIAL,32900,0,32900,139000,0,171900
112847900100000,NE 102,RESIDENTIAL,35400,0,35400,134300,0,169700
112847900200000,NE 102,RESIDENTIAL,28900,0,28900,140300,0,169200
112847900300000,NE 102,RESIDENTIAL,32100,0,32100,155400,0,187500
112847900400000,NE 102,RESIDENTIAL,31000,0,31000,138500,0,169500
112847900500000,NE 102,RESIDENTIAL,34800,0,34800,129000,0,163800
112847900600000,NE 103,RESIDENTIAL,35100,0,35100,139000,0,174100
112847900700000,NE 103,RESIDENTIAL,32700,0,32700,154100,0,186800
112847900800000,NE 103,RESIDENTIAL,34600,0,34600,137000,0,171600
112847900900000,NE 103,RESIDENTIAL,28300,0,28300,120900,0,149200
112847901000000,NE 103,RESIDENTIAL,31800,0,31800,130300,0,162100
112847901100000,NE 103,RESIDENTIAL,35400,0,35400,119700,0,155100
112848000100000,NE 103,RESIDENTIAL,35300,0,35300,149400,0,184700
113015100100000,NE 168,AG LAND,62500,0,62500,0,1200,63700
113017600100000,NE 168,AG LAND,50200,0,50200,0,0,50200
113025200100000,NE 168,AG LAND,1100,0,1100,0,0,1100
113025200700000,NE 168,AG LAND,24200,0,24200,0,0,24200
113027700100000,NE 168,AG LAND,17500,0,17500,0,0,17500
113030100100000,NE 168,AG LAND,91100,0,91100,0,0,91100
113030100200000,NE 168,RESIDENTIAL,36600,0,36600,0,0,36600
113032600100000,NE 168,AG LAND,97100,0,97100,0,0,97100
113035100100000,NE 169,RESIDENTIAL,75800,0,75800,280100,0,355900
113035100200000,NE 169,RESIDENTIAL,75600,0,75600,317900,0,393500
113035100300000,NE 168,RESIDENTIAL,400,0,400,0,0,400
113035100400000,NE 169,RESIDENTIAL,76000,0,76000,327800,0,403800
113035100500000,NE 169,RESIDENTIAL,76000,0,76000,307800,0,383800
113035100600000,NE 169,RESIDENTIAL,76000,0,76000,275000,0,351000
113035100700000,NE 169,RESIDENTIAL,75600,0,75600,292200,0,367800
113035100800000,NE 169,RESIDENTIAL,75600,0,75600,279900,0,355500
113035100900000,NE 168,RESIDENTIAL,900,0,900,0,0,900
113035200100000,NE 169,RESIDENTIAL,75000,0,75000,342900,0,417900
113035200200000,NE 169,RESIDENTIAL,75800,0,75800,380500,0,456300
113035200300000,NE 168,AG LAND,40900,0,40900,0,0,40900
113035300100000,NE 169,RESIDENTIAL,77100,0,77100,328700,0,405800
113035300200000,NE 169,RESIDENTIAL,77100,0,77100,269300,0,346400
113035300300000,NE 169,RESIDENTIAL,75000,0,75000,296400,0,371400
113035300400000,NE 169,RESIDENTIAL,75000,0,75000,304400,0,379400
113037600100000,NE 168,AG LAND,107300,0,107300,0,0,107300
113042600100000,NE 168,RESIDENTIAL,106600,0,106600,115400,0,222000
113042600200000,NE 168,AG LAND,19800,0,19800,0,0,19800
113042600300000,FITNESS CENTER,COMMERCIAL,0,379100,379100,0,1074200,1453300
113042600400000,NE 168,AG DWELLING,19300,0,19300,159100,0,178400
113045100200000,NE 168,RESIDENTIAL,5100,0,5100,0,0,5100
113045100300000,NE 168,RESIDENTIAL,58600,0,58600,52600,0,111200
113045100400000,NE 168,AG LAND,73700,0,73700,0,0,73700
113112600100000,NE 168,AG LAND,14900,0,14900,0,0,14900
113112600200000,NE 168,AG LAND,83300,0,83300,0,0,83300
113120100100000,NE 168,AG LAND,93700,0,93700,0,25500,119200
113122600100000,NE 168,RESIDENTIAL,12200,0,12200,0,0,12200
113122600200000,NE 168,AG LAND,62100,0,62100,0,0,62100
113125100100000,NE 168,RESIDENTIAL,50200,0,50200,161300,0,211500
113125100200000,NE 168,RESIDENTIAL,50200,0,50200,167200,0,217400
113125100300000,NE 168,RESIDENTIAL,50200,0,50200,195600,0,245800
113125100400000,NE 168,RESIDENTIAL,50300,0,50300,215900,0,266200
113125200100000,NE 168,RESIDENTIAL,50300,0,50300,0,0,50300
113125200200000,NE 168,RESIDENTIAL,50400,0,50400,0,0,50400
113125300100000,NE 168,RESIDENTIAL,50100,0,50100,171000,0,221100
113125300200000,NE 168,RESIDENTIAL,50100,0,50100,256600,0,306700
113125300300000,NE 168,RESIDENTIAL,50100,0,50100,363400,0,413500
113125300400000,NE 168,RESIDENTIAL,50100,0,50100,0,0,50100
113125300600000,NE 168,AG LAND,38700,0,38700,0,0,38700
113125300700000,NE 168,AG LAND,4900,0,4900,0,0,4900
113125400100000,NE 168,RESIDENTIAL,50300,0,50300,202200,0,252500
113125400200000,NE 168,RESIDENTIAL,50500,0,50500,181900,0,232400
113130100100000,NE 168,RESIDENTIAL,50000,0,50000,202600,0,252600
113130100200000,NE 168,RESIDENTIAL,50300,0,50300,274100,0,324400
113130100300000,NE 168,RESIDENTIAL,50300,0,50300,199000,0,249300
113130100400000,NE 168,RESIDENTIAL,50300,0,50300,258600,0,308900
113130100500000,NE 172,RESIDENTIAL,59500,0,59500,177200,0,236700
113130100600000,NE 172,RESIDENTIAL,62400,0,62400,179300,0,241700
113130100700000,NE 172,RESIDENTIAL,64400,0,64400,159900,0,224300
113130100800000,NE 172,RESIDENTIAL,62500,0,62500,201600,0,264100
113130200100000,NE 172,RESIDENTIAL,60600,0,60600,200800,0,261400
113130200200000,NE 172,RESIDENTIAL,63300,0,63300,195400,0,258700
113130200300000,NE 172,RESIDENTIAL,54300,0,54300,293300,0,347600
113130300100000,NE 168,RESIDENTIAL,50200,0,50200,145700,0,195900
113130300200000,NE 168,RESIDENTIAL,50200,0,50200,198700,0,248900
113130300300000,NE 168,RESIDENTIAL,50200,0,50200,318200,0,368400
113130300400000,NE 168,RESIDENTIAL,50200,0,50200,294300,0,344500
113130300500000,NE 168,RESIDENTIAL,50200,0,50200,219400,0,269600
113130300600000,NE 172,RESIDENTIAL,59500,0,59500,163600,0,223100
113130300700000,NE 172,RESIDENTIAL,61800,0,61800,208500,0,270300
113130300800000,NE 172,RESIDENTIAL,63300,0,63300,210100,0,273400
113130300900000,NE 172,RESIDENTIAL,62700,0,62700,163900,0,226600
113130301300000,NE 168,RESIDENTIAL,50100,0,50100,147400,0,197500
113130301400000,NE 168,RESIDENTIAL,50100,0,50100,180600,0,230700
113130301500000,NE 168,RESIDENTIAL,50100,0,50100,196600,0,246700
113130301600000,NE 168,RESIDENTIAL,50100,0,50100,221200,0,271300
113130301700000,NE 168,RESIDENTIAL,50100,0,50100,254300,0,304400
113130400100000,NE 168,RESIDENTIAL,50200,0,50200,165200,0,215400
113130400200000,NE 168,RESIDENTIAL,50200,0,50200,268500,0,318700
113130400300000,NE 168,RESIDENTIAL,50200,0,50200,290100,0,340300
113130400400000,NE 168,RESIDENTIAL,50200,0,50200,158300,0,208500
113130401200000,NE 172,RESIDENTIAL,60500,0,60500,173700,0,234200
113130401300000,NE 172,RESIDENTIAL,60500,0,60500,173900,0,234400
113130401400000,NE 172,RESIDENTIAL,60300,0,60300,227100,0,287400
113132600200000,COUNTY PROPERTY,EXEMPT,0,0,0,0,0,0
113132600300000,NE 168,RESIDENTIAL,32600,0,32600,0,0,32600
113132600400000,NE 168,RESIDENTIAL,100,0,100,0,0,100
113132700100000,CITY PROPERTY,EXEMPT,0,0,0,0,0,0
113132700200000,NE 172,RESIDENTIAL,46200,0,46200,197700,0,243900
113132700300000,NE 172,RESIDENTIAL,44400,0,44400,226500,0,270900
113132700400000,NE 172,RESIDENTIAL,44400,0,44400,207200,0,251600
113132700500000,NE 172,RESIDENTIAL,44400,0,44400,234700,0,279100
113132700600000,NE 172,RESIDENTIAL,45600,0,45600,229200,0,274800
113132700700000,NE 172,RESIDENTIAL,44000,0,44000,263100,0,307100
113132700800000,NE 172,RESIDENTIAL,46000,0,46000,289000,0,335000
113132700900000,NE 172,RESIDENTIAL,50400,0,50400,240800,0,291200
113132701000000,CITY PROPERTY,EXEMPT,0,0,0,0,0,0
113132800100000,NE 172,RESIDENTIAL,48800,0,48800,274600,0,323400
113132800200000,NE 172,RESIDENTIAL,48500,0,48500,222400,0,270900
113132800300000,NE 172,RESIDENTIAL,48500,0,48500,225800,0,274300
113132800400000,NE 172,RESIDENTIAL,48500,0,48500,192900,0,241400
113132800500000,NE 172,RESIDENTIAL,48500,0,48500,199800,0,248300
113132800600000,NE 172,RESIDENTIAL,48500,0,48500,226700,0,275200
113132800700000,NE 172,RESIDENTIAL,46300,0,46300,231500,0,277800
113132800800000,NE 172,RESIDENTIAL,46600,0,46600,226500,0,273100
113132800900000,NE 172,RESIDENTIAL,48700,0,48700,220400,0,269100
113132801000000,NE 172,RESIDENTIAL,48200,0,48200,242600,0,290800
113132801100000,NE 172,RESIDENTIAL,47300,0,47300,220200,0,267500
113132801200000,NE 172,RESIDENTIAL,49000,0,49000,198800,0,247800
113132801300000,NE 172,RESIDENTIAL,49000,0,49000,228400,0,277400
113132801400000,NE 172,RESIDENTIAL,48600,0,48600,223700,0,272300
113132801500000,NE 172,RESIDENTIAL,56200,0,56200,232100,0,288300
113132801600000,NE 172,RESIDENTIAL,52700,0,52700,0,0,52700
113132801700000,NE 172,RESIDENTIAL,51900,0,51900,0,0,51900
113132801800000,NE 172,RESIDENTIAL,55400,0,55400,237800,0,293200
113132801900000,NE 172,RESIDENTIAL,54400,0,54400,240100,0,294500
113132802000000,NE 172,RESIDENTIAL,50500,0,50500,258700,0,309200
113132802100000,NE 172,RESIDENTIAL,64800,0,64800,252000,0,316800
113132802200000,NE 172,RESIDENTIAL,64500,0,64500,270500,0,335000
113132802300000,NE 172,RESIDENTIAL,50700,0,50700,245300,0,296000
113132802400000,NE 172,RESIDENTIAL,50600,0,50600,217700,0,268300
113132802500000,NE 172,RESIDENTIAL,51400,0,51400,230700,0,282100
113132802600000,NE 172,RESIDENTIAL,69300,0,69300,279800,0,349100
113132802700000,NE 172,RESIDENTIAL,69100,0,69100,236400,0,305500
113132802800000,NE 172,RESIDENTIAL,55200,0,55200,254300,0,309500
113132802900000,NE 172,RESIDENTIAL,55100,0,55100,299300,0,354400
113132803000000,NE 172,RESIDENTIAL,60500,0,60500,257600,0,318100
113132803100000,NE 172,RESIDENTIAL,63900,0,63900,297000,0,360900
113132803200000,NE 172,RESIDENTIAL,54500,0,54500,250900,0,305400
113132900100000,NE 172,RESIDENTIAL,52200,0,52200,215200,0,267400
113132900200000,NE 172,RESIDENTIAL,48500,0,48500,198000,0,246500
113132900300000,NE 172,RESIDENTIAL,48500,0,48500,215200,0,263700
113132900400000,NE 172,RESIDENTIAL,48500,0,48500,238300,0,286800
113132900500000,NE 172,RESIDENTIAL,48500,0,48500,193300,0,241800
113132900600000,NE 172,RESIDENTIAL,48500,0,48500,216900,0,265400
113132900700000,NE 172,RESIDENTIAL,56700,0,56700,301100,0,357800
113132900800000,NE 172,RESIDENTIAL,52700,0,52700,257900,0,310600
113132900900000,NE 172,RESIDENTIAL,48500,0,48500,243700,0,292200
113132901000000,NE 172,RESIDENTIAL,48500,0,48500,229700,0,278200
113132901100000,NE 172,RESIDENTIAL,48500,0,48500,204000,0,252500
113132901200000,NE 172,RESIDENTIAL,48500,0,48500,183200,0,231700
113132901300000,NE 172,RESIDENTIAL,48500,0,48500,190500,0,239000
113132901400000,NE 172,RESIDENTIAL,51000,0,51000,200200,0,251200
113133000100000,NE 172,RESIDENTIAL,59700,0,59700,279100,0,338800
113133000200000,NE 172,RESIDENTIAL,59800,0,59800,304200,0,364000
113133000300000,NE 172,RESIDENTIAL,48600,0,48600,237300,0,285900
113133000400000,NE 172,RESIDENTIAL,48500,0,48500,225200,0,273700
113133000500000,NE 172,RESIDENTIAL,40000,0,40000,279900,0,319900
113133100100000,NE 172,RESIDENTIAL,51200,0,51200,249700,0,300900
113133100200000,NE 172,RESIDENTIAL,50500,0,50500,245300,0,295800
113133100300000,NE 172,RESIDENTIAL,50500,0,50500,227500,0,278000
113133100400000,NE 172,RESIDENTIAL,56900,0,56900,266200,0,323100
113133100500000,NE 172,RESIDENTIAL,52900,0,52900,243900,0,296800
113133100600000,NE 172,RESIDENTIAL,50500,0,50500,286700,0,337200
113133200100000,NE 172,RESIDENTIAL,48000,0,48000,252400,0,300400
113133200200000,NE 172,RESIDENTIAL,51000,0,51000,285100,0,336100
113133200300000,NE 172,RESIDENTIAL,48000,0,48000,226400,0,274400
113133200400000,NE 172,RESIDENTIAL,48000,0,48000,241700,0,289700
113133200500000,NE 172,RESIDENTIAL,48000,0,48000,254100,0,302100
113133200600000,NE 172,RESIDENTIAL,48000,0,48000,231600,0,279600
113133200700000,NE 172,RESIDENTIAL,47000,0,47000,0,0,47000
113133200800000,NE 172,RESIDENTIAL,58100,0,58100,224200,0,282300
113133200900000,NE 172,RESIDENTIAL,51000,0,51000,250800,0,301800
113133201000000,NE 172,RESIDENTIAL,51000,0,51000,249100,0,300100
113133201100000,NE 172,RESIDENTIAL,48000,0,48000,250200,0,298200
113133201200000,NE 172,RESIDENTIAL,48000,0,48000,252800,0,300800
113135100300000,SCHOOL,EXEMPT,0,0,0,0,0,0
113135100500000,NE 172,RESIDENTIAL,42300,0,42300,170100,0,212400
113135100600000,NE 172,RESIDENTIAL,41600,0,41600,165000,0,206600
113135100700000,NE 172,RESIDENTIAL,39800,0,39800,190100,0,229900
113135100800000,NE 172,RESIDENTIAL,38400,0,38400,163900,0,202300
113135100900000,NE 172,RESIDENTIAL,46700,0,46700,146800,0,193500
113135101000000,NE 172,RESIDENTIAL,44500,0,44500,181800,0,226300
113135101100000,NE 172,RESIDENTIAL,43500,0,43500,191800,0,235300
113135101200000,NE 172,RESIDENTIAL,45400,0,45400,177500,0,222900
113135101300000,NE 172,RESIDENTIAL,44000,0,44000,171600,0,215600
113135101400000,NE 172,RESIDENTIAL,45900,0,45900,200500,0,246400
113135101500000,NE 172,RESIDENTIAL,43500,0,43500,171500,0,215000
113135101600000,NE 172,RESIDENTIAL,36700,0,36700,167100,0,203800
113135101700000,NE 172,RESIDENTIAL,39900,0,39900,174500,0,214400
113135101800000,NE 172,RESIDENTIAL,38600,0,38600,155200,0,193800
113135101900000,NE 172,RESIDENTIAL,38800,0,38800,170900,0,209700
113135102000000,NE 172,RESIDENTIAL,43900,0,43900,178400,0,222300
113135102100000,NE 172,RESIDENTIAL,46600,0,46600,183500,0,230100
113135102200000,NE 172,RESIDENTIAL,47200,0,47200,148100,0,195300
113135102300000,NE 172,RESIDENTIAL,41600,0,41600,205800,0,247400
113135102400000,NE 172,RESIDENTIAL,44000,0,44000,171900,0,215900
113135102500000,NE 172,RESIDENTIAL,43300,0,43300,212000,0,255300
113135102600000,NE 172,RESIDENTIAL,40000,0,40000,176700,0,216700
113135102700000,NE 172,RESIDENTIAL,44000,0,44000,188400,0,232400
113135102800000,NE 172,RESIDENTIAL,39000,0,39000,184200,0,223200
113135102900000,NE 172,RESIDENTIAL,38100,0,38100,178500,0,216600
113135103000000,NE 172,RESIDENTIAL,42800,0,42800,181000,0,223800
113135103100000,NE 172,RESIDENTIAL,38800,0,38800,174700,0,213500
113135103200000,NE 172,RESIDENTIAL,46800,0,46800,243800,0,290600
113135103300000,NE 172,RESIDENTIAL,48000,0,48000,209700,0,257700
113135103400000,NE 172,RESIDENTIAL,48000,0,48000,249300,0,297300
113135103500000,NE 172,RESIDENTIAL,48000,0,48000,259100,0,307100
113135103600000,NE 172,RESIDENTIAL,48000,0,48000,249800,0,297800
113135103700000,NE 172,RESIDENTIAL,48000,0,48000,241600,0,289600
113135103800000,NE 172,RESIDENTIAL,49800,0,49800,221000,0,270800
113135200100000,NE 172,RESIDENTIAL,48000,0,48000,345900,0,393900
113135200200000,NE 172,RESIDENTIAL,48000,0,48000,195700,0,243700
113135200300000,NE 172,RESIDENTIAL,48000,0,48000,296700,0,344700
113135200400000,NE 172,RESIDENTIAL,48000,0,48000,268600,0,316600
113135200500000,NE 172,RESIDENTIAL,48000,0,48000,248500,0,296500
113135200600000,NE 172,RESIDENTIAL,48000,0,48000,279500,0,327500
113135200700000,NE 172,RESIDENTIAL,48000,0,48000,246000,0,294000
113135200800000,NE 172,RESIDENTIAL,48000,0,48000,259100,0,307100
113135200900000,NE 172,RESIDENTIAL,48000,0,48000,189900,0,237900
113135201000000,NE 172,RESIDENTIAL,48000,0,48000,240100,0,288100
113135201100000,NE 172,RESIDENTIAL,42000,0,42000,159900,0,201900
113135201200000,NE 172,RESIDENTIAL,0,0,0,0,0,0
113135201300000,NE 172,RESIDENTIAL,48000,0,48000,281100,0,329100
113135201400000,NE 172,RESIDENTIAL,40700,0,40700,0,0,40700
113135201500000,NE 172,RESIDENTIAL,500,0,500,0,0,500
113135201600000,NE 172,RESIDENTIAL,600,0,600,0,0,600
113135201700000,NE 172,RESIDENTIAL,48000,0,48000,214500,0,262500
113135300100000,NE 172,RESIDENTIAL,44700,0,44700,179400,0,224100
113135300200000,NE 172,RESIDENTIAL,42500,0,42500,147200,0,189700
113142600100000,NE 168,RESIDENTIAL,50800,0,50800,202600,0,253400
113142600200000,NE 168,RESIDENTIAL,50000,0,50000,148900,0,198900
113142600300000,NE 168,RESIDENTIAL,50100,0,50100,155053,0,205153
113142600400000,NE 168,RESIDENTIAL,50100,0,50100,151300,0,201400
113142600500000,NE 168,RESIDENTIAL,50000,0,50000,168600,0,218600
113142700100000,NE 168,RESIDENTIAL,50500,0,50500,175400,0,225900
113142700200000,NE 168,RESIDENTIAL,50400,0,50400,229300,0,279700
113142700300000,NE 168,RESIDENTIAL,50600,0,50600,214000,0,264600
113142700400000,NE 168,RESIDENTIAL,51100,0,51100,201000,0,252100
113142700500000,NE 168,RESIDENTIAL,50000,0,50000,235800,0,285800
113142700600000,NE 168,RESIDENTIAL,50000,0,50000,176200,0,226200
113142700700000,NE 168,RESIDENTIAL,50000,0,50000,213100,0,263100
113142700800000,NE 168,RESIDENTIAL,77900,0,77900,297100,0,375000
113142700900000,NE 168,RESIDENTIAL,58600,0,58600,264500,0,323100
113142800100000,NE 168,RESIDENTIAL,50300,0,50300,166700,0,217000
113142800200000,NE 168,RESIDENTIAL,50200,0,50200,217600,0,267800
113142800300000,NE 168,RESIDENTIAL,50200,0,50200,182300,0,232500
113142800400000,NE 168,RESIDENTIAL,50300,0,50300,193900,0,244200
113143000100000,NE 168,RESIDENTIAL,50300,0,50300,221600,0,271900
113143000200000,NE 168,RESIDENTIAL,50200,0,50200,248000,0,298200
113143000300000,NE 168,RESIDENTIAL,50200,0,50200,249300,0,299500
113143000400000,NE 168,RESIDENTIAL,50200,0,50200,230800,0,281000
113143000500000,NE 168,RESIDENTIAL,50200,0,50200,157700,0,207900
113310100100000,NE 103,RESIDENTIAL,33500,0,33500,134500,0,168000
113310100200000,NE 103,RESIDENTIAL,36600,0,36600,168000,0,204600
113310100300000,NE 103,RESIDENTIAL,28800,0,28800,140400,0,169200
113310100400000,NE 103,RESIDENTIAL,32000,0,32000,128400,0,160400
113310100500000,NE 103,RESIDENTIAL,27700,0,27700,118700,0,146400
113310100600000,NE 103,RESIDENTIAL,33800,0,33800,124300,0,158100
113310100700000,NE 103,RESIDENTIAL,28600,0,28600,130800,0,159400
113310100800000,NE 103,RESIDENTIAL,32600,0,32600,130100,0,162700
113310100900000,NE 103,RESIDENTIAL,31300,0,31300,108100,0,139400
113310101000000,NE 103,RESIDENTIAL,36300,0,36300,142100,0,178400
113310101100000,NE 103,RESIDENTIAL,28000,0,28000,100700,0,128700
113310101200000,NE 103,RESIDENTIAL,26600,0,26600,140800,0,167400
113310101300000,NE 103,RESIDENTIAL,26600,0,26600,133400,0,160000
113310101400000,NE 103,RESIDENTIAL,32000,0,32000,129600,0,161600
113310101500000,NE 103,RESIDENTIAL,33500,0,33500,118800,0,152300
113310101600000,NE 103,RESIDENTIAL,32900,0,32900,120200,0,153100
113310101700000,NE 103,RESIDENTIAL,32000,0,32000,133600,0,165600
113310101800000,NE 103,RESIDENTIAL,31900,0,31900,130800,0,162700
113310101900000,NE 103,RESIDENTIAL,35400,0,35400,118700,0,154100
113310102000000,NE 103,RESIDENTIAL,34800,0,34800,147400,0,182200
113310102100000,NE 103,RESIDENTIAL,34400,0,34400,114400,0,148800
113310102200000,NE 103,RESIDENTIAL,27800,0,27800,142100,0,169900
113310102300000,NE 103,RESIDENTIAL,34800,0,34800,124400,0,159200
113310102400000,NE 103,RESIDENTIAL,33200,0,33200,128400,0,161600
113310102500000,NE 103,RESIDENTIAL,35600,0,35600,124300,0,159900
113310102600000,NE 103,RESIDENTIAL,31400,0,31400,105200,0,136600
113310102700000,NE 103,RESIDENTIAL,30300,0,30300,120300,0,150600
113310102800000,NE 103,RESIDENTIAL,33800,0,33800,126800,0,160600
113310102900000,NE 103,RESIDENTIAL,35700,0,35700,121000,0,156700
113310103000000,NE 103,RESIDENTIAL,31600,0,31600,139000,0,170600
113310103100000,NE 103,RESIDENTIAL,31600,0,31600,128900,0,160500
113310103200000,NE 103,RESIDENTIAL,33700,0,33700,121200,0,154900
113310103300000,NE 103,RESIDENTIAL,33200,0,33200,135900,0,169100
113310200100000,NE 103,RESIDENTIAL,35500,0,35500,139400,0,174900
113310200200000,NE 103,RESIDENTIAL,32000,0,32000,117700,0,149700
113310200300000,NE 103,RESIDENTIAL,32000,0,32000,141200,0,173200
113310200400000,NE 103,RESIDENTIAL,29600,0,29600,132400,0,162000
113310200500000,NE 103,RESIDENTIAL,34200,0,34200,137700,0,171900
113310200600000,NE 103,RESIDENTIAL,32600,0,32600,140800,0,173400
113310200700000,NE 103,RESIDENTIAL,33800,0,33800,131100,0,164900
113310200800000,NE 103,RESIDENTIAL,24700,0,24700,100500,0,125200
113310200900000,NE 103,RESIDENTIAL,32200,0,32200,119700,0,151900
113310201000000,NE 103,RESIDENTIAL,31300,0,31300,144800,0,176100
113310201100000,NE 103,RESIDENTIAL,30200,0,30200,142100,0,172300
113310201200000,NE 103,RESIDENTIAL,24300,0,24300,100200,0,124500
113310201300000,NE 103,RESIDENTIAL,25100,0,25100,107000,0,132100
113310201400000,NE 103,RESIDENTIAL,25200,0,25200,127300,0,152500
113310201500000,NE 103,RESIDENTIAL,32000,0,32000,129600,0,161600
113310201600000,NE 103,RESIDENTIAL,29500,0,29500,126200,0,155700
113310201700000,NE 103,RESIDENTIAL,33600,0,33600,105900,0,139500
113310300100000,NE 103,RESIDENTIAL,34400,0,34400,134800,0,169200
113310300200000,NE 103,RESIDENTIAL,29800,0,29800,116500,0,146300
113310300300000,NE 103,RESIDENTIAL,27600,0,27600,138400,0,166000
113310300400000,NE 103,RESIDENTIAL,30000,0,30000,124100,0,154100
113310300500000,NE 103,RESIDENTIAL,25200,0,25200,133700,0,158900
113310300600000,NE 103,RESIDENTIAL,31100,0,31100,121500,0,152600
113310300700000,NE 103,RESIDENTIAL,30200,0,30200,128100,0,158300
113310300800000,NE 103,RESIDENTIAL,34600,0,34600,131600,0,166200
113310300900000,NE 103,RESIDENTIAL,32100,0,32100,142900,0,175000
113310301000000,NE 103,RESIDENTIAL,27400,0,27400,125700,0,153100
113310301100000,NE 103,RESIDENTIAL,35200,0,35200,150100,0,185300
113310301200000,NE 103,RESIDENTIAL,35800,0,35800,126400,0,162200
113310301300000,NE 103,RESIDENTIAL,34300,0,34300,128000,0,162300
113310301400000,NE 103,RESIDENTIAL,34000,0,34000,125800,0,159800
113310301500000,NE 103,RESIDENTIAL,34300,0,34300,122500,0,156800
113310301600000,NE 103,RESIDENTIAL,34100,0,34100,133400,0,167500
113310301700000,NE 103,RESIDENTIAL,34200,0,34200,116400,0,150600
113310301800000,NE 103,RESIDENTIAL,35100,0,35100,120100,0,155200
113310301900000,NE 103,RESIDENTIAL,30900,0,30900,106900,0,137800
113310302000000,NE 103,RESIDENTIAL,28600,0,28600,130900,0,159500
113310302100000,NE 103,RESIDENTIAL,27300,0,27300,135000,0,162300
113310302200000,NE 103,RESIDENTIAL,27300,0,27300,128000,0,155300
113310302300000,NE 103,RESIDENTIAL,29700,0,29700,106600,0,136300
113310302400000,NE 103,RESIDENTIAL,31300,0,31300,106800,0,138100
113310302500000,NE 103,RESIDENTIAL,30100,0,30100,125800,0,155900
113310302600000,NE 103,RESIDENTIAL,36600,0,36600,142800,0,179400
113310400100000,NE 103,RESIDENTIAL,37000,0,37000,120800,0,157800
113310400200000,NE 103,RESIDENTIAL,32400,0,32400,128000,0,160400
113310400300000,NE 103,RESIDENTIAL,45300,0,45300,117700,0,163000
113310400400000,NE 103,RESIDENTIAL,37500,0,37500,127400,0,164900
113310400500000,NE 103,RESIDENTIAL,35200,0,35200,131200,0,166400
113310400600000,NE 103,RESIDENTIAL,34900,0,34900,126000,0,160900
113310400700000,NE 103,RESIDENTIAL,41300,0,41300,140700,0,182000
113310400800000,NE 103,RESIDENTIAL,33300,0,33300,114800,0,148100
113310500100000,NE 103,RESIDENTIAL,33200,0,33200,130800,0,164000
113310500200000,NE 103,RESIDENTIAL,27900,0,27900,113200,0,141100
113310500300000,NE 103,RESIDENTIAL,30700,0,30700,112800,0,143500
113310500400000,NE 103,RESIDENTIAL,33400,0,33400,133300,0,166700
113310500500000,NE 103,RESIDENTIAL,33300,0,33300,124600,0,157900
113310500600000,NE 103,RESIDENTIAL,26300,0,26300,129000,0,155300
113310500700000,NE 103,RESIDENTIAL,24700,0,24700,123000,0,147700
113310500800000,NE 103,RESIDENTIAL,24700,0,24700,129900,0,154600
113310500900000,NE 103,RESIDENTIAL,27500,0,27500,127400,0,154900
113310501000000,NE 103,RESIDENTIAL,33900,0,33900,130100,0,164000
113310501100000,NE 103,RESIDENTIAL,29400,0,29400,129500,0,158900
113310501200000,NE 103,RESIDENTIAL,25800,0,25800,106700,0,132500
113310501300000,NE 103,RESIDENTIAL,24000,0,24000,113100,0,137100
113310501400000,NE 103,RESIDENTIAL,30700,0,30700,120800,0,151500
113310501500000,NE 103,RESIDENTIAL,30000,0,30000,115500,0,145500
113310501600000,NE 103,RESIDENTIAL,29900,0,29900,126300,0,156200
113310501700000,NE 103,RESIDENTIAL,29500,0,29500,124300,0,153800
113310501800000,NE 103,RESIDENTIAL,27700,0,27700,115000,0,142700
113310501900000,NE 103,RESIDENTIAL,29800,0,29800,104800,0,134600
113310502000000,NE 103,RESIDENTIAL,26400,0,26400,100300,0,126700
113310502100000,NE 103,RESIDENTIAL,26700,0,26700,130100,0,156800
113310502200000,NE 103,RESIDENTIAL,25500,0,25500,131800,0,157300
113310502300000,NE 103,RESIDENTIAL,26600,0,26600,126500,0,153100
113310502400000,NE 103,RESIDENTIAL,36300,0,36300,119500,0,155800
113310502500000,CHURCH,EXEMPT,0,465000,465000,0,1106000,1571000
113310502600000,NE 103,RESIDENTIAL,33600,0,33600,159600,0,193200
113310502700000,NE 103,RESIDENTIAL,33400,0,33400,137100,0,170500
113310502800000,NE 103,RESIDENTIAL,34800,0,34800,137000,0,171800
113310502900000,NE 103,RESIDENTIAL,33600,0,33600,151100,0,184700
113310503000000,NE 103,RESIDENTIAL,33100,0,33100,163500,0,196600
113310503100000,NE 103,RESIDENTIAL,33200,0,33200,121700,0,154900
113310600100000,NE 103,RESIDENTIAL,36100,0,36100,127200,0,163300
113310600200000,NE 103,RESIDENTIAL,34800,0,34800,109900,0,144700
113310600300000,NE 103,RESIDENTIAL,27700,0,27700,111100,0,138800
113310600400000,NE 103,RESIDENTIAL,34000,0,34000,111100,0,145100
113310600500000,NE 103,RESIDENTIAL,35700,0,35700,128900,0,164600
113310600600000,NE 103,RESIDENTIAL,28600,0,28600,128700,0,157300
113312600100000,VACANT LAND,EXEMPT,0,798600,798600,0,0,798600
113312600200000,NE 108,EXEMPT,0,152300,152300,0,298900,451200
113312600300000,NE 108,RESIDENTIAL,40100,0,40100,127000,0,167100
113315100100000,NE 108,RESIDENTIAL,26500,0,26500,137500,0,164000
113315100200000,NE 108,RESIDENTIAL,25500,0,25500,110800,0,136300
113315100300000,NE 108,RESIDENTIAL,26500,0,26500,107000,0,133500
113315100400000,NE 108,RESIDENTIAL,26500,0,26500,106600,0,133100
113315100500000,NE 108,RESIDENTIAL,26500,0,26500,127300,0,153800
113315100600000,NE 108,RESIDENTIAL,25300,0,25300,97200,0,122500
113315100700000,NE 108,RESIDENTIAL,26900,0,26900,106100,0,133000
113315100800000,NE 108,RESIDENTIAL,27200,0,27200,109200,0,136400
113315100900000,NE 108,RESIDENTIAL,24500,0,24500,68800,0,93300
113315101000000,NE 108,RESIDENTIAL,25300,0,25300,114600,0,139900
113315101100000,NE 108,RESIDENTIAL,25300,0,25300,111900,0,137200
113315101200000,NE 108,RESIDENTIAL,25300,0,25300,111200,0,136500
113315101300000,NE 108,RESIDENTIAL,26500,0,26500,119400,0,145900
113315101400000,NE 108,RESIDENTIAL,26500,0,26500,115300,0,141800
113315101500000,NE 108,RESIDENTIAL,24100,0,24100,112200,0,136300
113315101600000,NE 108,RESIDENTIAL,26100,0,26100,100100,0,126200
113315101700000,NE 108,RESIDENTIAL,23700,0,23700,109600,0,133300
113315101800000,NE 108,RESIDENTIAL,23700,0,23700,96000,0,119700
113315101900000,NE 108,RESIDENTIAL,23700,0,23700,134600,0,158300
113315102000000,NE 108,RESIDENTIAL,24500,0,24500,102100,0,126600
113315102100000,NE 108,RESIDENTIAL,27600,0,27600,126500,0,154100
113315102200000,NE 108,RESIDENTIAL,26300,0,26300,100100,0,126400
113315102300000,NE 108,RESIDENTIAL,24500,0,24500,86600,0,111100
113315102400000,NE 108,RESIDENTIAL,24500,0,24500,102300,0,126800
113315102500000,NE 108,RESIDENTIAL,22600,0,22600,167100,0,189700
113315102600000,NE 108,RESIDENTIAL,22600,0,22600,102500,0,125100
113315102700000,NE 108,RESIDENTIAL,23000,0,23000,112600,0,135600
113315102800000,NE 108,RESIDENTIAL,26500,0,26500,92400,0,118900
113315102900000,NE 108,RESIDENTIAL,25700,0,25700,97200,0,122900
113315103000000,NE 108,RESIDENTIAL,26700,0,26700,104400,0,131100
113315103100000,NE 108,RESIDENTIAL,25300,0,25300,91100,0,116400
113315103200000,NE 108,RESIDENTIAL,27400,0,27400,108700,0,136100
113315103300000,NE 108,RESIDENTIAL,27500,0,27500,134900,0,162400
113315103400000,NE 108,RESIDENTIAL,25500,0,25500,89300,0,114800
113315103500000,NE 108,RESIDENTIAL,25600,0,25600,107300,0,132900
113315103600000,NE 108,RESIDENTIAL,26100,0,26100,114300,0,140400
113315103700000,NE 108,RESIDENTIAL,25500,0,25500,98500,0,124000
113315103800000,NE 108,RESIDENTIAL,26900,0,26900,98700,0,125600
113315103900000,CITY PROPERTY,EXEMPT,0,0,0,0,0,0
113315104000000,CITY PROPERTY,EXEMPT,0,0,0,0,0,0
113315200100000,NE 108,RESIDENTIAL,26500,0,26500,121900,0,148400
113315200200000,NE 108,RESIDENTIAL,24300,0,24300,108700,0,133000
113315200300000,NE 108,RESIDENTIAL,26500,0,26500,97500,0,124000
113315200400000,NE 108,RESIDENTIAL,25900,0,25900,116400,0,142300
113315200500000,NE 108,RESIDENTIAL,24800,0,24800,105200,0,130000
113315200600000,NE 108,RESIDENTIAL,24800,0,24800,112200,0,137000
113315200700000,NE 108,RESIDENTIAL,24700,0,24700,103600,0,128300
113315200800000,NE 108,RESIDENTIAL,26400,0,26400,107400,0,133800
113315200900000,NE 108,RESIDENTIAL,24800,0,24800,94200,0,119000
113315201000000,NE 108,RESIDENTIAL,23200,0,23200,98300,0,121500
113315201100000,NE 108,RESIDENTIAL,23200,0,23200,98200,0,121400
113315201200000,NE 108,RESIDENTIAL,23200,0,23200,86800,0,110000
113315201300000,NE 108,RESIDENTIAL,25000,0,25000,96400,0,121400
113315201400000,NE 108,RESIDENTIAL,24400,0,24400,92300,0,116700
113315201500000,NE 108,RESIDENTIAL,23200,0,23200,87700,0,110900
113315201600000,NE 108,RESIDENTIAL,23200,0,23200,86400,0,109600
113315201700000,NE 108,RESIDENTIAL,23200,0,23200,91800,0,115000
113315201800000,NE 108,RESIDENTIAL,24800,0,24800,104400,0,129200
113315201900000,NE 108,RESIDENTIAL,26000,0,26000,113600,0,139600
113315202000000,NE 108,RESIDENTIAL,24700,0,24700,104900,0,129600
113315202100000,NE 108,RESIDENTIAL,24800,0,24800,110800,0,135600
113315202200000,NE 108,RESIDENTIAL,24800,0,24800,78300,0,103100
113315202300000,NE 108,RESIDENTIAL,25900,0,25900,91700,0,117600
113315300100000,NE 108,RESIDENTIAL,26500,0,26500,129700,0,156200
113315300200000,NE 108,RESIDENTIAL,24300,0,24300,102700,0,127000
113315300300000,NE 108,RESIDENTIAL,25900,0,25900,89100,0,115000
113315300400000,NE 108,RESIDENTIAL,22200,0,22200,101900,0,124100
113315300500000,NE 108,RESIDENTIAL,22300,0,22300,103500,0,125800
113315300600000,NE 108,RESIDENTIAL,22300,0,22300,110900,0,133200
113315300700000,NE 108,RESIDENTIAL,22300,0,22300,96900,0,119200
113315300800000,NE 108,RESIDENTIAL,22300,0,22300,101300,0,123600
113315300900000,NE 108,RESIDENTIAL,21800,0,21800,100800,0,122600
113315301000000,NE 108,RESIDENTIAL,25900,0,25900,105300,0,131200
113315301100000,NE 108,RESIDENTIAL,21900,0,21900,104500,0,126400
113315301200000,NE 108,RESIDENTIAL,21900,0,21900,96300,0,118200
113315301300000,NE 108,RESIDENTIAL,21900,0,21900,91000,0,112900
113315301400000,NE 108,RESIDENTIAL,24400,0,24400,125200,0,149600
113315301500000,NE 108,RESIDENTIAL,25000,0,25000,93200,0,118200
113315301600000,NE 108,RESIDENTIAL,21900,0,21900,100500,0,122400
113315301700000,NE 108,RESIDENTIAL,21900,0,21900,114300,0,136200
113315301800000,NE 108,RESIDENTIAL,21900,0,21900,94400,0,116300
113315301900000,NE 108,RESIDENTIAL,25900,0,25900,101800,0,127700
113315302000000,NE 108,RESIDENTIAL,26000,0,26000,115700,0,141700
113315302100000,NE 108,RESIDENTIAL,24800,0,24800,105800,0,130600
113315302200000,NE 108,RESIDENTIAL,24800,0,24800,102700,0,127500
113315302300000,NE 108,RESIDENTIAL,24800,0,24800,127300,0,152100
113315302400000,NE 108,RESIDENTIAL,26500,0,26500,130900,0,157400
113315400100000,NE 108,RESIDENTIAL,24900,0,24900,123500,0,148400
113315400200000,NE 108,RESIDENTIAL,25100,0,25100,99400,0,124500
113315500100000,NE 108,RESIDENTIAL,25700,0,25700,101500,0,127200
113315500200000,NE 108,RESIDENTIAL,25700,0,25700,92900,0,118600
113315600100000,NE 108,RESIDENTIAL,25700,0,25700,104100,0,129800
113315600200000,NE 108,RESIDENTIAL,25700,0,25700,94100,0,119800
113317600100000,CHURCH,EXEMPT,0,422400,422400,0,398500,820900
113317600200000,NE 103,RESIDENTIAL,17500,0,17500,70600,0,88100
113317600300000,NE 103,RESIDENTIAL,16000,0,16000,70800,0,86800
113317600400000,NE 103,RESIDENTIAL,16800,0,16800,67800,0,84600
113317600500000,NE 103,RESIDENTIAL,17700,0,17700,67900,0,85600
113317600600000,NE 103,RESIDENTIAL,33800,0,33800,130100,0,163900
113317700100000,NE 103,RESIDENTIAL,34800,0,34800,163100,0,197900
113317700200000,NE 103,RESIDENTIAL,19900,0,19900,67800,0,87700
113317700300000,NE 103,RESIDENTIAL,24900,0,24900,70900,0,95800
113317800100000,NE 108,RESIDENTIAL,23300,0,23300,128500,0,151800
113317800200000,NE 108,RESIDENTIAL,25200,0,25200,97900,0,123100
113317800300000,NE 108,RESIDENTIAL,23800,0,23800,101000,0,124800
113317800400000,NE 108,RESIDENTIAL,23000,0,23000,97500,0,120500
113317800500000,NE 108,RESIDENTIAL,22300,0,22300,92600,0,114900
113317800600000,NE 108,RESIDENTIAL,23800,0,23800,95900,0,119700
113317800700000,NE 108,RESIDENTIAL,22300,0,22300,93400,0,115700
113317800800000,NE 108,RESIDENTIAL,23800,0,23800,109400,0,133200
113317800900000,NE 108,RESIDENTIAL,23000,0,23000,97100,0,120100
113317801000000,NE 108,RESIDENTIAL,23800,0,23800,102000,0,125800
113317801100000,NE 108,RESIDENTIAL,25200,0,25200,94900,0,120100
113317801200000,NE 108,RESIDENTIAL,27000,0,27000,106200,0,133200
113317801300000,NE 108,RESIDENTIAL,25100,0,25100,107800,0,132900
113317801400000,NE 108,RESIDENTIAL,25500,0,25500,100700,0,126200
113317801500000,NE 108,RESIDENTIAL,25500,0,25500,88600,0,114100
113317801600000,NE 108,RESIDENTIAL,25200,0,25200,107100,0,132300
113317801700000,NE 108,RESIDENTIAL,27100,0,27100,97400,0,124500
113317801800000,NE 108,RESIDENTIAL,24100,0,24100,112700,0,136800
113317801900000,NE 108,RESIDENTIAL,23800,0,23800,97900,0,121700
113317802000000,NE 108,RESIDENTIAL,23000,0,23000,107500,0,130500
113317802100000,NE 108,RESIDENTIAL,23800,0,23800,103700,0,127500
113317802200000,NE 108,RESIDENTIAL,23800,0,23800,108500,0,132300
113317802300000,NE 108,RESIDENTIAL,22300,0,22300,106200,0,128500
113317802400000,NE 108,RESIDENTIAL,22300,0,22300,92300,0,114600
113317802500000,NE 108,RESIDENTIAL,23000,0,23000,94200,0,117200
113317802600000,NE 108,RESIDENTIAL,23800,0,23800,110500,0,134300
113317802700000,NE 108,RESIDENTIAL,24600,0,24600,99600,0,124200
113317802800000,NE 108,RESIDENTIAL,25000,0,25000,98800,0,123800
113317802900000,NE 108,RESIDENTIAL,23800,0,23800,91400,0,115200
113317803000000,NE 108,RESIDENTIAL,23000,0,23000,90800,0,113800
113317803100000,NE 108,RESIDENTIAL,22300,0,22300,89200,0,111500
113317803200000,NE 108,RESIDENTIAL,22300,0,22300,101200,0,123500
113317803300000,NE 108,RESIDENTIAL,23800,0,23800,93600,0,117400
113317803400000,NE 108,RESIDENTIAL,23800,0,23800,135400,0,159200
113317803500000,NE 108,RESIDENTIAL,23000,0,23000,109800,0,132800
113317803600000,NE 108,RESIDENTIAL,23800,0,23800,101600,0,125400
113317803700000,NE 108,RESIDENTIAL,25100,0,25100,93800,0,118900
113317803800000,NE 108,RESIDENTIAL,26400,0,26400,98500,0,124900
113317803900000,NE 108,RESIDENTIAL,25100,0,25100,104600,0,129700
113317804000000,NE 108,RESIDENTIAL,25500,0,25500,95200,0,120700
113317804100000,NE 108,RESIDENTIAL,25500,0,25500,89500,0,115000
113317804200000,NE 108,RESIDENTIAL,25600,0,25600,109900,0,135500
113317804300000,NE 108,RESIDENTIAL,29300,0,29300,116400,0,145700
113317804400000,NE 108,RESIDENTIAL,24600,0,24600,112400,0,137000
113317804500000,NE 108,RESIDENTIAL,23000,0,23000,90100,0,113100
113317804600000,NE 108,RESIDENTIAL,23000,0,23000,99400,0,122400
113317804700000,NE 108,RESIDENTIAL,25900,0,25900,100700,0,126600
113317804800000,NE 108,RESIDENTIAL,25800,0,25800,118800,0,144600
113317804900000,NE 108,RESIDENTIAL,23000,0,23000,107100,0,130100
113317805000000,NE 108,RESIDENTIAL,22800,0,22800,97000,0,119800
113317805100000,NE 108,RESIDENTIAL,23100,0,23100,104400,0,127500
113317805200000,NE 108,RESIDENTIAL,25600,0,25600,107800,0,133400
113317805300000,NE 108,RESIDENTIAL,25400,0,25400,117200,0,142600
113317805400000,NE 108,RESIDENTIAL,26500,0,26500,113200,0,139700
113317805500000,NE 108,RESIDENTIAL,25600,0,25600,97100,0,122700
113317805600000,NE 108,RESIDENTIAL,25000,0,25000,109700,0,134700
113317805700000,NE 108,RESIDENTIAL,27100,0,27100,115300,0,142400
113317805800000,NE 108,RESIDENTIAL,26300,0,26300,111500,0,137800
113317805900000,NE 108,RESIDENTIAL,25600,0,25600,89300,0,114900
113317806000000,NE 108,RESIDENTIAL,25500,0,25500,82200,0,107700
113317806100000,NE 108,RESIDENTIAL,26200,0,26200,110000,0,136200
113317806200000,NE 108,RESIDENTIAL,26500,0,26500,83700,0,110200
113317806300000,NE 108,RESIDENTIAL,25900,0,25900,95400,0,121300
113317806400000,NE 108,RESIDENTIAL,26600,0,26600,105400,0,132000
113317806500000,NE 108,RESIDENTIAL,28100,0,28100,119100,0,147200
113317806600000,NE 108,RESIDENTIAL,26300,0,26300,95700,0,122000
113317806700000,NE 108,RESIDENTIAL,25600,0,25600,101000,0,126600
113317806800000,NE 108,RESIDENTIAL,25500,0,25500,106000,0,131500
113317806900000,NE 108,RESIDENTIAL,25400,0,25400,109700,0,135100
113317807000000,NE 108,RESIDENTIAL,26500,0,26500,96700,0,123200
113317807100000,NE 108,RESIDENTIAL,26000,0,26000,97400,0,123400
113317807200000,NE 108,RESIDENTIAL,27100,0,27100,95300,0,122400
113317807300000,NE 108,RESIDENTIAL,27100,0,27100,107400,0,134500
113317807400000,NE 108,RESIDENTIAL,26300,0,26300,100600,0,126900
113317807500000,NE 108,RESIDENTIAL,24500,0,24500,125800,0,150300
113317807600000,NE 108,RESIDENTIAL,22200,0,22200,112400,0,134600
113317807700000,NE 108,RESIDENTIAL,24200,0,24200,88600,0,112800
113317807800000,NE 108,RESIDENTIAL,24300,0,24300,106000,0,130300
113317807900000,NE 108,RESIDENTIAL,23800,0,23800,104000,0,127800
113317808000000,NE 108,RESIDENTIAL,24300,0,24300,97100,0,121400
113317808100000,NE 108,RESIDENTIAL,25000,0,25000,121200,0,146200
113317808200000,NE 108,RESIDENTIAL,24900,0,24900,106200,0,131100
113317808300000,NE 108,RESIDENTIAL,24600,0,24600,122300,0,146900
113317808400000,NE 108,RESIDENTIAL,25300,0,25300,125200,0,150500
113317900100000,NE 108,RESIDENTIAL,25400,0,25400,91100,0,116500
113317900200000,NE 108,RESIDENTIAL,25100,0,25100,113200,0,138300
113317900300000,NE 108,RESIDENTIAL,23000,0,23000,82300,0,105300
113317900400000,NE 108,RESIDENTIAL,21100,0,21100,94000,0,115100
113317900500000,NE 108,RESIDENTIAL,21100,0,21100,94300,0,115400
113317900600000,NE 108,RESIDENTIAL,22300,0,22300,101200,0,123500
113317900700000,NE 108,RESIDENTIAL,23000,0,23000,92500,0,115500
113317900800000,NE 108,RESIDENTIAL,23000,0,23000,98300,0,121300
113317900900000,NE 108,RESIDENTIAL,21100,0,21100,111400,0,132500
113317901000000,NE 108,RESIDENTIAL,23000,0,23000,100000,0,123000
113317901100000,NE 108,RESIDENTIAL,24400,0,24400,98500,0,122900
113317901200000,NE 108,RESIDENTIAL,24400,0,24400,95600,0,120000
113317901300000,NE 108,RESIDENTIAL,23000,0,23000,117900,0,140900
113317901400000,NE 108,RESIDENTIAL,21100,0,21100,74500,0,95600
113317901500000,NE 108,RESIDENTIAL,23000,0,23000,79500,0,102500
113317901600000,NE 108,RESIDENTIAL,23000,0,23000,103800,0,126800
113317901700000,NE 108,RESIDENTIAL,22300,0,22300,103800,0,126100
113317901800000,NE 108,RESIDENTIAL,21100,0,21100,95500,0,116600
113317901900000,NE 108,RESIDENTIAL,21100,0,21100,101500,0,122600
113317902000000,NE 108,RESIDENTIAL,23000,0,23000,103600,0,126600
113318000100000,NE 108,RESIDENTIAL,30800,0,30800,110900,0,141700
113318000200000,NE 108,RESIDENTIAL,24800,0,24800,90000,0,114800
113318000300000,NE 108,RESIDENTIAL,24800,0,24800,97000,0,121800
113318000400000,NE 108,RESIDENTIAL,23000,0,23000,96100,0,119100
113318000500000,NE 108,RESIDENTIAL,24800,0,24800,94100,0,118900
113318000600000,NE 108,RESIDENTIAL,25500,0,25500,113400,0,138900
113318000700000,NE 108,RESIDENTIAL,24800,0,24800,89400,0,114200
113318000800000,NE 108,RESIDENTIAL,23000,0,23000,102300,0,125300
113318000900000,NE 108,RESIDENTIAL,23000,0,23000,155300,0,178300
113318001000000,NE 108,RESIDENTIAL,23000,0,23000,96700,0,119700
113318001100000,NE 108,RESIDENTIAL,24400,0,24400,112300,0,136700
113318001200000,NE 108,RESIDENTIAL,24400,0,24400,100400,0,124800
113318001300000,NE 108,RESIDENTIAL,23000,0,23000,113400,0,136400
113318001400000,NE 108,RESIDENTIAL,23000,0,23000,109200,0,132200
113318001500000,NE 108,RESIDENTIAL,23000,0,23000,96400,0,119400
113318001600000,NE 108,RESIDENTIAL,24800,0,24800,94500,0,119300
113318001700000,NE 108,RESIDENTIAL,25500,0,25500,108900,0,134400
113318001800000,NE 108,RESIDENTIAL,24800,0,24800,98700,0,123500
113318001900000,NE 108,RESIDENTIAL,23000,0,23000,110400,0,133400
113318002000000,NE 108,RESIDENTIAL,24800,0,24800,98900,0,123700
113318002100000,NE 108,RESIDENTIAL,25200,0,25200,103700,0,128900
113318100100000,NE 108,RESIDENTIAL,27000,0,27000,115500,0,142500
113318100200000,NE 108,RESIDENTIAL,26100,0,26100,102800,0,128900
113318100300000,NE 108,RESIDENTIAL,27300,0,27300,103900,0,131200
113318100400000,NE 108,RESIDENTIAL,24800,0,24800,97200,0,122000
113318100500000,NE 108,RESIDENTIAL,24800,0,24800,102400,0,127200
113318100600000,NE 108,RESIDENTIAL,25500,0,25500,96200,0,121700
113318100700000,NE 108,RESIDENTIAL,26100,0,26100,113900,0,140000
113318100800000,NE 108,RESIDENTIAL,24600,0,24600,103500,0,128100
113318100900000,NE 108,RESIDENTIAL,23000,0,23000,103500,0,126500
113318101000000,NE 108,RESIDENTIAL,23000,0,23000,100600,0,123600
113318101100000,NE 108,RESIDENTIAL,25500,0,25500,104800,0,130300
113318101200000,NE 108,RESIDENTIAL,25900,0,25900,99100,0,125000
113318101300000,NE 108,RESIDENTIAL,24800,0,24800,92800,0,117600
113318101400000,NE 108,RESIDENTIAL,23800,0,23800,105700,0,129500
113318101500000,NE 108,RESIDENTIAL,24800,0,24800,96200,0,121000
113318101600000,NE 108,RESIDENTIAL,24600,0,24600,102300,0,126900
113318101700000,NE 108,RESIDENTIAL,24900,0,24900,131100,0,156000
113318101800000,NE 108,RESIDENTIAL,22400,0,22400,102300,0,124700
113318200100000,NE 108,RESIDENTIAL,25700,0,25700,85100,0,110800
113318200200000,NE 108,RESIDENTIAL,25700,0,25700,100400,0,126100
113318300100000,NE 108,RESIDENTIAL,25700,0,25700,112800,0,138500
113318300200000,NE 108,RESIDENTIAL,25700,0,25700,109100,0,134800
113340100100000,NE 108,RESIDENTIAL,25500,0,25500,87400,0,112900
113340100200000,NE 108,RESIDENTIAL,24800,0,24800,97400,0,122200
113340100300000,NE 108,RESIDENTIAL,26300,0,26300,113300,0,139600
113340100400000,NE 108,RESIDENTIAL,24800,0,24800,96100,0,120900
113340100500000,NE 108,RESIDENTIAL,25500,0,25500,83400,0,108900
113340100600000,NE 108,RESIDENTIAL,26300,0,26300,111500,0,137800
113340100700000,NE 108,RESIDENTIAL,25900,0,25900,115900,0,141800
113340100800000,NE 108,RESIDENTIAL,26500,0,26500,102800,0,129300
113340100900000,NE 108,RESIDENTIAL,26800,0,26800,92600,0,119400
113340101000000,NE 108,RESIDENTIAL,26100,0,26100,115500,0,141600
113340101100000,NE 108,RESIDENTIAL,25300,0,25300,95000,0,120300
113340101200000,NE 108,RESIDENTIAL,26800,0,26800,88800,0,115600
113340200100000,NE 108,RESIDENTIAL,25500,0,25500,101500,0,127000
113340200200000,NE 108,RESIDENTIAL,25500,0,25500,101900,0,127400
113340200300000,NE 108,RESIDENTIAL,24800,0,24800,93700,0,118500
113340200400000,NE 108,RESIDENTIAL,24600,0,24600,104100,0,128700
113340200500000,NE 108,RESIDENTIAL,24800,0,24800,81300,0,106100
113340200600000,NE 108,RESIDENTIAL,25500,0,25500,111300,0,136800
113340200700000,NE 108,RESIDENTIAL,25900,0,25900,99000,0,124900
113340200800000,NE 108,RESIDENTIAL,25900,0,25900,97000,0,122900
113340200900000,NE 108,RESIDENTIAL,25500,0,25500,106400,0,131900
113340201000000,NE 108,RESIDENTIAL,24800,0,24800,95200,0,120000
113340201100000,NE 108,RESIDENTIAL,24600,0,24600,96600,0,121200
113340201200000,NE 108,RESIDENTIAL,24800,0,24800,93600,0,118400
113340300100000,NE 108,RESIDENTIAL,25500,0,25500,110600,0,136100
113340300200000,NE 108,RESIDENTIAL,25500,0,25500,98700,0,124200
113340300300000,NE 108,RESIDENTIAL,24800,0,24800,94000,0,118800
113340300400000,NE 108,RESIDENTIAL,24600,0,24600,87500,0,112100
113340300500000,NE 108,RESIDENTIAL,24800,0,24800,95100,0,119900
113340300600000,NE 108,RESIDENTIAL,25500,0,25500,123400,0,148900
113340300700000,NE 108,RESIDENTIAL,25900,0,25900,97700,0,123600
113340300800000,NE 108,RESIDENTIAL,25900,0,25900,108100,0,134000
113340300900000,NE 108,RESIDENTIAL,25500,0,25500,67900,0,93400
113340301000000,NE 108,RESIDENTIAL,24800,0,24800,102000,0,126800
113340301100000,NE 108,RESIDENTIAL,24600,0,24600,95300,0,119900
113340301200000,NE 108,RESIDENTIAL,24800,0,24800,95800,0,120600
113340400100000,NE 108,RESIDENTIAL,25500,0,25500,104000,0,129500
113340400200000,NE 108,RESIDENTIAL,25500,0,25500,106100,0,131600
113340400300000,NE 108,RESIDENTIAL,24800,0,24800,115500,0,140300
113340400400000,NE 108,RESIDENTIAL,24600,0,24600,109700,0,134300
113340400500000,NE 108,RESIDENTIAL,24800,0,24800,97900,0,122700
113340400600000,NE 108,RESIDENTIAL,25500,0,25500,69600,0,95100
113340400700000,NE 108,RESIDENTIAL,25900,0,25900,106300,0,132200
113340400800000,NE 108,RESIDENTIAL,25900,0,25900,95800,0,121700
113340400900000,NE 108,RESIDENTIAL,25500,0,25500,99200,0,124700
113340401000000,NE 108,RESIDENTIAL,24800,0,24800,105300,0,130100
113340401100000,NE 108,RESIDENTIAL,24600,0,24600,99600,0,124200
113340401200000,NE 108,RESIDENTIAL,24800,0,24800,77800,0,102600
113340500100000,NE 108,RESIDENTIAL,25500,0,25500,97600,0,123100
113340500200000,NE 108,RESIDENTIAL,22700,0,22700,97700,0,120400
113340500300000,NE 108,RESIDENTIAL,23000,0,23000,90200,0,113200
113340500400000,NE 108,RESIDENTIAL,24800,0,24800,95500,0,120300
113340500500000,NE 108,RESIDENTIAL,24600,0,24600,97900,0,122500
113340500600000,NE 108,RESIDENTIAL,24800,0,24800,101600,0,126400
113340500700000,NE 108,RESIDENTIAL,25500,0,25500,109100,0,134600
113340500800000,NE 108,RESIDENTIAL,25900,0,25900,101700,0,127600
113340500900000,NE 108,RESIDENTIAL,25900,0,25900,104000,0,129900
113340501000000,NE 108,RESIDENTIAL,25500,0,25500,113900,0,139400
113340501100000,NE 108,RESIDENTIAL,24800,0,24800,102100,0,126900
113340501200000,NE 108,RESIDENTIAL,24600,0,24600,103500,0,128100
113340501300000,NE 108,RESIDENTIAL,24800,0,24800,76300,0,101100
113340600100000,NE 108,RESIDENTIAL,26900,0,26900,120300,0,147200
113340600200000,NE 108,RESIDENTIAL,27800,0,27800,111500,0,139300
113340600300000,NE 108,RESIDENTIAL,27400,0,27400,112600,0,140000
113340600400000,NE 108,RESIDENTIAL,26200,0,26200,100800,0,127000
113340600500000,NE 108,RESIDENTIAL,26200,0,26200,100800,0,127000
113340600600000,NE 108,RESIDENTIAL,26200,0,26200,115600,0,141800
113340600700000,NE 108,RESIDENTIAL,26200,0,26200,119200,0,145400
113340600800000,NE 108,RESIDENTIAL,26200,0,26200,106700,0,132900
113340600900000,NE 108,RESIDENTIAL,26200,0,26200,107300,0,133500
113340601000000,NE 108,RESIDENTIAL,26200,0,26200,121400,0,147600
113340601100000,NE 108,RESIDENTIAL,26200,0,26200,108800,0,135000
113340601200000,NE 108,RESIDENTIAL,26200,0,26200,105000,0,131200
113340601300000,NE 108,RESIDENTIAL,26200,0,26200,108500,0,134700
113340601400000,NE 108,RESIDENTIAL,26200,0,26200,120500,0,146700
113340601500000,NE 108,RESIDENTIAL,26200,0,26200,110500,0,136700
113340601600000,NE 108,RESIDENTIAL,26200,0,26200,111000,0,137200
113340601700000,NE 108,RESIDENTIAL,26200,0,26200,110600,0,136800
113340601800000,NE 108,RESIDENTIAL,29000,0,29000,125400,0,154400
113340601900000,NE 108,RESIDENTIAL,30100,0,30100,120500,0,150600
113340602000000,NE 108,RESIDENTIAL,26200,0,26200,93700,0,119900
113340602200000,NE 108,RESIDENTIAL,26900,0,26900,80100,0,107000
113342600100000,NE 108,RESIDENTIAL,25500,0,25500,96000,0,121500
113342600200000,NE 108,RESIDENTIAL,24800,0,24800,96100,0,120900
113342600300000,NE 108,RESIDENTIAL,25500,0,25500,98600,0,124100
113342600400000,NE 108,RESIDENTIAL,24600,0,24600,90200,0,114800
113342600500000,NE 108,RESIDENTIAL,24800,0,24800,109000,0,133800
113342600600000,NE 108,RESIDENTIAL,25500,0,25500,105600,0,131100
113342600700000,NE 108,RESIDENTIAL,25900,0,25900,106400,0,132300
113342600800000,NE 108,RESIDENTIAL,25900,0,25900,101000,0,126900
113342600900000,NE 108,RESIDENTIAL,25500,0,25500,101800,0,127300
113342601000000,NE 108,RESIDENTIAL,24800,0,24800,103800,0,128600
113342601100000,NE 108,RESIDENTIAL,24600,0,24600,93500,0,118100
113342601200000,NE 108,RESIDENTIAL,24800,0,24800,106600,0,131400
113342700100000,NE 108,RESIDENTIAL,22900,0,22900,96200,0,119100
113342700200000,NE 108,RESIDENTIAL,24800,0,24800,97800,0,122600
113342700300000,NE 108,RESIDENTIAL,25500,0,25500,104100,0,129600
113342700400000,NE 108,RESIDENTIAL,24600,0,24600,130500,0,155100
113342700500000,NE 108,RESIDENTIAL,24800,0,24800,102800,0,127600
113342700600000,NE 108,RESIDENTIAL,25500,0,25500,112100,0,137600
113342700700000,NE 108,RESIDENTIAL,25900,0,25900,90700,0,116600
113342700800000,NE 108,RESIDENTIAL,25900,0,25900,76500,0,102400
113342700900000,NE 108,RESIDENTIAL,25500,0,25500,105400,0,130900
113342701000000,NE 108,RESIDENTIAL,24800,0,24800,108300,0,133100
113342701100000,NE 108,RESIDENTIAL,24600,0,24600,84300,0,108900
113342701200000,NE 108,RESIDENTIAL,24800,0,24800,88400,0,113200
113342701300000,NE 108,RESIDENTIAL,23000,0,23000,99600,0,122600
113342800100000,NE 108,RESIDENTIAL,24800,0,24800,106400,0,131200
113342800200000,NE 108,RESIDENTIAL,24800,0,24800,96500,0,121300
113342800300000,NE 108,RESIDENTIAL,25500,0,25500,81300,0,106800
113342800400000,NE 108,RESIDENTIAL,24600,0,24600,103000,0,127600
113342800500000,NE 108,RESIDENTIAL,24800,0,24800,83300,0,108100
113342800600000,NE 108,RESIDENTIAL,25500,0,25500,96100,0,121600
113342800700000,NE 108,RESIDENTIAL,25900,0,25900,101100,0,127000
113342800800000,NE 108,RESIDENTIAL,25900,0,25900,105500,0,131400
113342800900000,NE 108,RESIDENTIAL,25500,0,25500,102300,0,127800
113342801000000,NE 108,RESIDENTIAL,24800,0,24800,97000,0,121800
113342801100000,NE 108,RESIDENTIAL,24600,0,24600,87800,0,112400
113342801200000,NE 108,RESIDENTIAL,25500,0,25500,100100,0,125600
113342900100000,NE 108,RESIDENTIAL,26100,0,26100,117300,0,143400
113342900200000,NE 108,RESIDENTIAL,25300,0,25300,100300,0,125600
113342900300000,NE 108,RESIDENTIAL,25100,0,25100,92500,0,117600
113342900400000,NE 108,RESIDENTIAL,25300,0,25300,97000,0,122300
113342900500000,NE 108,RESIDENTIAL,26100,0,26100,96400,0,122500
113342900600000,NE 108,RESIDENTIAL,26500,0,26500,101200,0,127700
113343000100000,NE 108,RESIDENTIAL,28200,0,28200,121600,0,149800
113343000200000,NE 108,RESIDENTIAL,28200,0,28200,108800,0,137000
113343000300000,NE 108,RESIDENTIAL,26200,0,26200,99900,0,126100
113343000400000,NE 108,RESIDENTIAL,26200,0,26200,100600,0,126800
113343000500000,NE 108,RESIDENTIAL,27000,0,27000,87200,0,114200
113343000600000,NE 108,RESIDENTIAL,27000,0,27000,103100,0,130100
113343000700000,NE 108,RESIDENTIAL,27000,0,27000,89700,0,116700
113343000800000,NE 108,RESIDENTIAL,26200,0,26200,106900,0,133100
113343000900000,NE 108,RESIDENTIAL,26200,0,26200,114300,0,140500
113343001000000,NE 108,RESIDENTIAL,26200,0,26200,102400,0,128600
113343001100000,NE 108,RESIDENTIAL,26200,0,26200,113500,0,139700
113343001200000,NE 108,RESIDENTIAL,26200,0,26200,99000,0,125200
113343001300000,NE 108,RESIDENTIAL,26200,0,26200,111400,0,137600
113343001400000,NE 108,RESIDENTIAL,29200,0,29200,51400,0,80600
113343100100000,NE 108,RESIDENTIAL,28600,0,28600,124400,0,153000
113343100200000,NE 108,RESIDENTIAL,28600,0,28600,139600,0,168200
113347600100000,GOLF COURSE,COMMERCIAL,0,677200,677200,0,758400,1435600
113347700100000,OFFICE; MEDICAL,COMMERCIAL,0,286000,286000,0,960500,1246500
113347700300000,VACANT LAND,COMMERCIAL,0,4500,4500,0,0,4500
113347700400000,OFFICE,COMMERCIAL,0,284000,284000,0,1189900,1473900
113410100100000,NE 163,RESIDENTIAL,40200,0,40200,60700,0,100900
113410100200000,CHURCH,EXEMPT,0,577600,577600,0,1191000,1768600
113410100300000,NE 163,RESIDENTIAL,36100,0,36100,137200,0,173300
113410100400000,NE 163,RESIDENTIAL,31800,0,31800,147700,0,179500
113410100500000,NE 163,RESIDENTIAL,31800,0,31800,136200,0,168000
113410100600000,NE 163,RESIDENTIAL,35600,0,35600,145300,0,180900
113410100700000,NE 163,RESIDENTIAL,35600,0,35600,139500,0,175100
113410100800000,NE 163,RESIDENTIAL,38000,0,38000,132500,0,170500
113410100900000,NE 163,RESIDENTIAL,34700,0,34700,124800,0,159500
113410101000000,NE 163,RESIDENTIAL,39500,0,39500,138500,0,178000
113410101100000,NE 163,RESIDENTIAL,37700,0,37700,145900,0,183600
113410101200000,NE 163,RESIDENTIAL,35600,0,35600,144900,0,180500
113410101300000,NE 163,RESIDENTIAL,35600,0,35600,129600,0,165200
113410101400000,NE 163,RESIDENTIAL,38600,0,38600,151400,0,190000
113410101500000,NE 163,RESIDENTIAL,33100,0,33100,148300,0,181400
113410101600000,NE 163,RESIDENTIAL,39100,0,39100,150400,0,189500
113410200100000,NE 163,RESIDENTIAL,37500,0,37500,165900,0,203400
113410200200000,NE 163,RESIDENTIAL,35500,0,35500,137300,0,172800
113410200300000,NE 163,RESIDENTIAL,35500,0,35500,139100,0,174600
113410200400000,NE 163,RESIDENTIAL,39400,0,39400,135700,0,175100
113410300100000,NE 163,RESIDENTIAL,44400,0,44400,151000,0,195400
113410300200000,NE 163,RESIDENTIAL,32100,0,32100,154000,0,186100
113410300300000,NE 163,RESIDENTIAL,33700,0,33700,167600,0,201300
113410300400000,NE 163,RESIDENTIAL,32700,0,32700,147300,0,180000
113410300500000,NE 163,RESIDENTIAL,37300,0,37300,144700,0,182000
113410400200000,CITY PROPERTY,EXEMPT,0,0,0,0,0,0
113410400300000,NE 163,RESIDENTIAL,40300,0,40300,145600,0,185900
113410400400000,NE 163,RESIDENTIAL,37700,0,37700,151900,0,189600
113410400500000,OFFICE; MEDICAL,COMMERCIAL,0,250000,250000,0,678500,928500
113410400701000,NBHD SHOPPING CENTER,COMMERCIAL,0,52200,52200,0,162200,214400
113410400701001,NBHD SHOPPING CENTER,COMMERCIAL,0,52200,52200,0,129700,181900
113410400701002,NBHD SHOPPING CENTER,COMMERCIAL,0,30300,30300,0,98400,128700
113410400701003,NBHD SHOPPING CENTER,COMMERCIAL,0,39000,39000,0,127000,166000
113410400701004,NBHD SHOPPING CENTER,COMMERCIAL,0,43200,43200,0,140500,183700
113410400701005,NBHD SHOPPING CENTER,COMMERCIAL,0,57400,57400,0,186600,244000
113410400701007,VACANT LAND,COMMERCIAL,0,40500,40500,0,0,40500
113410400701008,VACANT LAND,COMMERCIAL,0,40500,40500,0,0,40500
113410400701009,VACANT LAND,COMMERCIAL,0,40500,40500,0,0,40500
113410400701010,VACANT LAND,COMMERCIAL,0,40500,40500,0,0,40500
113410400701011,NBHD SHOPPING CENTER,COMMERCIAL,0,40500,40500,0,127300,167800
113410400701012,NBHD SHOPPING CENTER,COMMERCIAL,0,35800,35800,0,112400,148200
113410400701013,NBHD SHOPPING CENTER,COMMERCIAL,0,85800,85800,0,270000,355800
113410400701014,NBHD SHOPPING CENTER,COMMERCIAL,0,18000,18000,0,58500,76500
113410400701015,NBHD SHOPPING CENTER,COMMERCIAL,0,56100,56100,0,182500,238600
113410401000000,VACANT LAND,COMMERCIAL,0,152500,152500,0,0,152500
113410401101000,NBHD SHOPPING CENTER,COMMERCIAL,0,310700,310700,0,1349200,1659900
113410401101001,NBHD SHOPPING CENTER,COMMERCIAL,0,260100,260100,0,1020100,1280200
113410401101002,NBHD SHOPPING CENTER,COMMERCIAL,0,260100,260100,0,1292900,1553000
113410401101003,NBHD SHOPPING CENTER,COMMERCIAL,0,104100,104100,0,494000,598100
113410401200000,BRANCH BANK/CU,COMMERCIAL,0,307500,307500,0,750600,1058100
113410401300000,NBHD SHOPPING CENTER,COMMERCIAL,0,134000,134000,0,443500,577500
113410500100000,NE 163,RESIDENTIAL,39000,0,39000,133700,0,172700
113410500200000,NE 163,RESIDENTIAL,33900,0,33900,152100,0,186000
113410500300000,NE 163,RESIDENTIAL,33900,0,33900,145100,0,179000
113410500400000,NE 163,RESIDENTIAL,35100,0,35100,138500,0,173600
113410500500000,NE 163,RESIDENTIAL,35100,0,35100,134200,0,169300
113410500600000,NE 163,RESIDENTIAL,39000,0,39000,117200,0,156200
113412600100000,NE 163,RESIDENTIAL,35300,0,35300,137200,0,172500
113412600200000,NE 163,RESIDENTIAL,35300,0,35300,127700,0,163000
113412600300000,NE 163,RESIDENTIAL,35300,0,35300,148700,0,184000
113412600400000,NE 163,RESIDENTIAL,35300,0,35300,129300,0,164600
113412600500000,NE 163,RESIDENTIAL,35300,0,35300,143300,0,178600
113412600600000,NE 163,RESIDENTIAL,35300,0,35300,127100,0,162400
113412600700000,NE 163,RESIDENTIAL,35300,0,35300,143000,0,178300
113412600800000,NE 163,RESIDENTIAL,37500,0,37500,128200,0,165700
113412600900000,NE 163,RESIDENTIAL,40300,0,40300,130500,0,170800
113412601000000,NE 163,RESIDENTIAL,35500,0,35500,128400,0,163900
113412601100000,NE 163,RESIDENTIAL,35500,0,35500,131000,0,166500
113412601200000,NE 163,RESIDENTIAL,35500,0,35500,119200,0,154700
113412601300000,NE 163,RESIDENTIAL,35500,0,35500,132300,0,167800
113412601400000,NE 163,RESIDENTIAL,35500,0,35500,143800,0,179300
113412601500000,NE 163,RESIDENTIAL,35500,0,35500,155300,0,190800
113412601600000,NE 163,RESIDENTIAL,35500,0,35500,151600,0,187100
113412700100000,NE 163,RESIDENTIAL,39800,0,39800,147200,0,187000
113412700200000,NE 163,RESIDENTIAL,37500,0,37500,149000,0,186500
113412700300000,NE 163,RESIDENTIAL,37100,0,37100,155000,0,192100
113412700500000,NE 163,RESIDENTIAL,33100,0,33100,143700,0,176800
113412700600000,NE 163,RESIDENTIAL,32100,0,32100,137500,0,169600
113412700700000,NE 163,RESIDENTIAL,33700,0,33700,147700,0,181400
113412700800000,NE 163,RESIDENTIAL,37500,0,37500,144800,0,182300
113412700900000,NE 163,RESIDENTIAL,40900,0,40900,162100,0,203000
113412701000000,NE 163,RESIDENTIAL,40200,0,40200,139600,0,179800
113412701100000,NE 163,RESIDENTIAL,38000,0,38000,150300,0,188300
113412701200000,NE 163,RESIDENTIAL,36800,0,36800,142300,0,179100
113412701300000,NE 163,RESIDENTIAL,32800,0,32800,130600,0,163400
113412701400000,NE 163,RESIDENTIAL,32800,0,32800,131300,0,164100
113412701500000,NE 163,RESIDENTIAL,32800,0,32800,143800,0,176600
113412701600000,NE 163,RESIDENTIAL,32800,0,32800,142600,0,175400
113412701700000,NE 163,RESIDENTIAL,36800,0,36800,146300,0,183100
113412701800000,NE 163,RESIDENTIAL,39900,0,39900,164000,0,203900
113412701900000,NE 163,RESIDENTIAL,39800,0,39800,164700,0,204500
113412702000000,NE 163,RESIDENTIAL,39300,0,39300,174600,0,213900
113412702100000,NE 163,EXEMPT,0,36500,36500,0,143000,179500
113412702200000,NE 163,RESIDENTIAL,36900,0,36900,167200,0,204100
113412800200000,NE 163,RESIDENTIAL,38800,0,38800,163900,0,202700
113412800300000,NE 163,RESIDENTIAL,37500,0,37500,158600,0,196100
113412800400000,NE 163,RESIDENTIAL,31000,0,31000,156500,0,187500
113412800500000,NE 163,RESIDENTIAL,34300,0,34300,151700,0,186000
113412800600000,NE 163,RESIDENTIAL,32600,0,32600,150300,0,182900
113412800700000,NE 163,RESIDENTIAL,32100,0,32100,155100,0,187200
113412800800000,NE 163,RESIDENTIAL,33600,0,33600,160100,0,193700
113412800900000,NE 163,RESIDENTIAL,32100,0,32100,136800,0,168900
113412801000000,NE 163,RESIDENTIAL,32600,0,32600,155600,0,188200
113412801100000,NE 163,RESIDENTIAL,32600,0,32600,151800,0,184400
113412801200000,NE 163,RESIDENTIAL,31500,0,31500,156400,0,187900
113412801300000,NE 163,RESIDENTIAL,32100,0,32100,142200,0,174300
113412801400000,NE 163,RESIDENTIAL,32100,0,32100,159600,0,191700
113412801500000,NE 163,RESIDENTIAL,32100,0,32100,157000,0,189100
113412801600000,NE 163,RESIDENTIAL,32100,0,32100,127100,0,159200
113412801700000,NE 163,RESIDENTIAL,34800,0,34800,159300,0,194100
113412801800000,NE 163,RESIDENTIAL,29500,0,29500,125800,0,155300
113412801900000,NE 163,RESIDENTIAL,32100,0,32100,148700,0,180800
113412802000000,NE 163,RESIDENTIAL,32100,0,32100,130300,0,162400
113412802100000,NE 163,RESIDENTIAL,32100,0,32100,145300,0,177400
113412900100000,NE 163,RESIDENTIAL,33900,0,33900,138600,0,172500
113412900200000,NE 163,RESIDENTIAL,33900,0,33900,126300,0,160200
113412900300000,NE 163,RESIDENTIAL,33900,0,33900,138600,0,172500
113412900400000,NE 163,RESIDENTIAL,33900,0,33900,141500,0,175400
113412900500000,NE 163,RESIDENTIAL,33900,0,33900,139900,0,173800
113412900600000,NE 163,RESIDENTIAL,33900,0,33900,148700,0,182600
113412900700000,NE 163,RESIDENTIAL,33900,0,33900,158900,0,192800
113412900800000,NE 163,RESIDENTIAL,33900,0,33900,144400,0,178300
113412900900000,NE 163,RESIDENTIAL,33900,0,33900,130900,0,164800
113412901000000,NE 163,RESIDENTIAL,39000,0,39000,157700,0,196700
113412901100000,NE 163,RESIDENTIAL,39000,0,39000,146600,0,185600
113412901200000,NE 163,RESIDENTIAL,35100,0,35100,140100,0,175200
113412901300000,NE 163,RESIDENTIAL,35100,0,35100,161600,0,196700
113412901400000,NE 163,RESIDENTIAL,35100,0,35100,142900,0,178000
113412901500000,NE 163,RESIDENTIAL,35100,0,35100,140400,0,175500
113412901600000,NE 163,RESIDENTIAL,35100,0,35100,158000,0,193100
113412901700000,NE 163,RESIDENTIAL,35100,0,35100,143100,0,178200
113412901800000,NE 163,RESIDENTIAL,35100,0,35100,139200,0,174300
113412901900000,NE 163,RESIDENTIAL,35100,0,35100,170800,0,205900
113413000100000,NE 163,RESIDENTIAL,33100,0,33100,146700,0,179800
113413000200000,NE 163,RESIDENTIAL,33100,0,33100,167400,0,200500
113413000300000,NE 163,RESIDENTIAL,34600,0,34600,160700,0,195300
113413000400000,NE 163,RESIDENTIAL,34700,0,34700,177700,0,212400
113413000500000,NE 163,RESIDENTIAL,34700,0,34700,146400,0,181100
113413000600000,NE 163,RESIDENTIAL,34700,0,34700,172100,0,206800
113413000700000,NE 163,RESIDENTIAL,34700,0,34700,169500,0,204200
113413000800000,NE 163,RESIDENTIAL,34700,0,34700,163200,0,197900
113413000900000,NE 163,RESIDENTIAL,34700,0,34700,174200,0,208900
113413001000000,NE 163,RESIDENTIAL,40800,0,40800,144000,0,184800
113413001100000,NE 163,RESIDENTIAL,41200,0,41200,208400,0,249600
113413001200000,NE 163,RESIDENTIAL,41200,0,41200,184500,0,225700
113413001300000,NE 163,RESIDENTIAL,41400,0,41400,169400,0,210800
113413001400000,NE 163,RESIDENTIAL,41300,0,41300,154700,0,196000
113413001500000,NE 163,RESIDENTIAL,42400,0,42400,159800,0,202200
113413001600000,NE 163,RESIDENTIAL,43100,0,43100,162400,0,205500
113413001700000,NE 163,RESIDENTIAL,42600,0,42600,172000,0,214600
113413001800000,NE 163,RESIDENTIAL,43400,0,43400,153500,0,196900
113413001900000,NE 163,RESIDENTIAL,37200,0,37200,144200,0,181400
113413002000000,NE 163,RESIDENTIAL,37300,0,37300,151200,0,188500
113413002100000,NE 163,RESIDENTIAL,40600,0,40600,131000,0,171600
113413002200000,CITY PROPERTY,EXEMPT,0,0,0,0,0,0
113413002300000,NE 163,RESIDENTIAL,43600,0,43600,164600,0,208200
113413002400000,NE 163,RESIDENTIAL,42400,0,42400,146200,0,188600
113413002500000,NE 163,RESIDENTIAL,39300,0,39300,137600,0,176900
113413002600000,NE 163,RESIDENTIAL,32500,0,32500,138700,0,171200
113415100100000,CHURCH,EXEMPT,0,539400,539400,0,841800,1381200
113415100300000,NE 163,RESIDENTIAL,42100,0,42100,286700,0,328800
113415100400000,NE 163,RESIDENTIAL,40700,0,40700,270000,0,310700
113415100500000,NE 163,RESIDENTIAL,28000,0,28000,299400,0,327400
113415100600000,NE 163,RESIDENTIAL,31600,0,31600,0,0,31600
113415200300000,VACANT LAND,COMMERCIAL,0,289800,289800,0,0,289800
113415200400000,ANTENNAS/TOWERS(BLL),COMMERCIAL,0,312400,312400,0,593700,906100
113415200500000,VACANT LAND,COMMERCIAL,0,326600,326600,0,0,326600
113417600500000,SMALL RETAIL,COMMERCIAL,0,448000,448000,0,699400,1147400
113417600600000,NBHD SHOPPING CENTER,COMMERCIAL,0,145100,145100,0,413800,558900
113417600700000,VACANT LAND,COMMERCIAL,0,187000,187000,0,0,187000
113417600800000,BRANCH BANK/CU,COMMERCIAL,0,338500,338500,0,1770300,2108800
113417600900000,CARWASH,COMMERCIAL,0,35000,35000,0,151600,186600
113417700100000,LG DISCOUNT/RETAIL,COMMERCIAL,0,506000,506000,0,633100,1139100
113417700300000,CITY PROPERTY,EXEMPT,0,0,0,0,0,0
113417700400000,CHURCH,EXEMPT,0,424600,424600,0,397600,822200
113420100800000,NE 159,RESIDENTIAL,34600,0,34600,175900,0,210500
113420100900000,NE 159,RESIDENTIAL,34600,0,34600,177900,0,212500
113420101000000,NE 159,RESIDENTIAL,34600,0,34600,201600,0,236200
113420101100000,NE 159,RESIDENTIAL,34600,0,34600,189200,0,223800
113420101200000,NE 159,RESIDENTIAL,35600,0,35600,204700,0,240300
113420101300000,NE 159,RESIDENTIAL,37600,0,37600,191900,0,229500
113420101400000,NE 159,RESIDENTIAL,40100,0,40100,194300,0,234400
113420101500000,NE 159,RESIDENTIAL,42700,0,42700,186400,0,229100
113420101600000,NE 159,RESIDENTIAL,38900,0,38900,182100,0,221000
113420101700000,NE 159,RESIDENTIAL,41900,0,41900,213600,0,255500
113420101800000,NE 159,RESIDENTIAL,36800,0,36800,201800,0,238600
113420101900000,NE 159,RESIDENTIAL,39400,0,39400,183300,0,222700
113420102000000,NE 159,RESIDENTIAL,41200,0,41200,158500,0,199700
113420102100000,NE 159,RESIDENTIAL,43700,0,43700,175900,0,219600
113420102200000,NE 159,RESIDENTIAL,42400,0,42400,161400,0,203800
113420102300000,NE 159,RESIDENTIAL,42700,0,42700,194000,0,236700
113420102400000,NE 159,RESIDENTIAL,40800,0,40800,200300,0,241100
113420102500000,NE 159,RESIDENTIAL,40800,0,40800,171400,0,212200
113420102600000,NE 159,RESIDENTIAL,36300,0,36300,174800,0,211100
113420102700000,NE 159,RESIDENTIAL,37500,0,37500,181900,0,219400
113420102800000,NE 159,RESIDENTIAL,43000,0,43000,171700,0,214700
113420102900000,NE 159,RESIDENTIAL,43000,0,43000,178500,0,221500
113420103000000,NE 159,RESIDENTIAL,44400,0,44400,185300,0,229700
113420103100000,NE 159,RESIDENTIAL,42600,0,42600,208600,0,251200
113420103200000,NE 159,RESIDENTIAL,43700,0,43700,189600,0,233300
113420103300000,NE 159,RESIDENTIAL,41900,0,41900,235000,0,276900
113420103400000,NE 159,RESIDENTIAL,37100,0,37100,175500,0,212600
113420103500000,NE 159,RESIDENTIAL,37100,0,37100,187800,0,224900
113420103600000,NE 159,RESIDENTIAL,37100,0,37100,171100,0,208200
113420103700000,NE 159,RESIDENTIAL,42700,0,42700,176000,0,218700
113420200200000,NE 159,RESIDENTIAL,45400,0,45400,187200,0,232600
113420200300000,NE 159,RESIDENTIAL,44100,0,44100,183200,0,227300
113420200400000,NE 159,RESIDENTIAL,42500,0,42500,153400,0,195900
113420200500000,NE 159,RESIDENTIAL,44700,0,44700,176000,0,220700
113420200600000,NE 159,RESIDENTIAL,49100,0,49100,174700,0,223800
113420200700000,NE 159,RESIDENTIAL,49400,0,49400,185900,0,235300
113420200800000,NE 159,RESIDENTIAL,44900,0,44900,192500,0,237400
113420200900000,NE 159,RESIDENTIAL,40700,0,40700,185000,0,225700
113420201000000,NE 159,RESIDENTIAL,38400,0,38400,178700,0,217100
113420201100000,NE 159,RESIDENTIAL,41500,0,41500,175300,0,216800
113420201200000,NE 159,RESIDENTIAL,41100,0,41100,193200,0,234300
113420201300000,NE 159,RESIDENTIAL,42200,0,42200,193000,0,235200
113420201400000,NE 159,RESIDENTIAL,38100,0,38100,184700,0,222800
113420201500000,NE 159,RESIDENTIAL,42200,0,42200,188800,0,231000
113420201600000,NE 159,RESIDENTIAL,36800,0,36800,172200,0,209000
113420300100000,NE 159,RESIDENTIAL,36700,0,36700,178900,0,215600
113420300200000,NE 159,RESIDENTIAL,36700,0,36700,172000,0,208700
113420300300000,NE 159,RESIDENTIAL,38200,0,38200,150800,0,189000
113420300400000,NE 159,RESIDENTIAL,46700,0,46700,204000,0,250700
113420300500000,NE 159,RESIDENTIAL,44400,0,44400,218600,0,263000
113420300600000,NE 159,RESIDENTIAL,45800,0,45800,183100,0,228900
113420300700000,NE 159,RESIDENTIAL,44700,0,44700,183200,0,227900
113420400100000,NE 159,RESIDENTIAL,45900,0,45900,187600,0,233500
113420400200000,NE 159,RESIDENTIAL,42700,0,42700,176500,0,219200
113420400300000,NE 159,RESIDENTIAL,41700,0,41700,170100,0,211800
113420400400000,NE 159,RESIDENTIAL,39900,0,39900,181200,0,221100
113420400500000,NE 159,RESIDENTIAL,44100,0,44100,172600,0,216700
113420400600000,NE 159,RESIDENTIAL,38700,0,38700,186500,0,225200
113420400700000,NE 159,RESIDENTIAL,38200,0,38200,177300,0,215500
113420400800000,NE 159,RESIDENTIAL,44200,0,44200,161600,0,205800
113420400900000,NE 159,RESIDENTIAL,43700,0,43700,186500,0,230200
113420500100000,NE 159,RESIDENTIAL,45600,0,45600,174100,0,219700
113420500200000,NE 159,RESIDENTIAL,60800,0,60800,192600,0,253400
113420500300000,NE 159,RESIDENTIAL,45200,0,45200,191200,0,236400
113420500400000,NE 159,RESIDENTIAL,48800,0,48800,227000,0,275800
113420500500000,NE 159,RESIDENTIAL,49700,0,49700,184300,0,234000
113420500600000,NE 159,RESIDENTIAL,43900,0,43900,190200,0,234100
113420500700000,NE 159,RESIDENTIAL,40300,0,40300,200100,0,240400
113420500800000,NE 159,RESIDENTIAL,41700,0,41700,188900,0,230600
113420500900000,NE 159,RESIDENTIAL,48000,0,48000,240300,0,288300
113420501000000,NE 159,RESIDENTIAL,44500,0,44500,193600,0,238100
113420501100000,NE 159,RESIDENTIAL,45100,0,45100,220400,0,265500
113420501200000,NE 159,RESIDENTIAL,48900,0,48900,238500,0,287400
113422600100000,NE 159,RESIDENTIAL,43100,0,43100,197300,0,240400
113422600200000,NE 159,RESIDENTIAL,39100,0,39100,192800,0,231900
113422600300000,NE 159,RESIDENTIAL,34100,0,34100,184500,0,218600
113422600400000,NE 159,RESIDENTIAL,32000,0,32000,176000,0,208000
113422600500000,NE 159,RESIDENTIAL,36200,0,36200,209100,0,245300
113422600600000,NE 159,RESIDENTIAL,36100,0,36100,174900,0,211000
113422600700000,NE 159,RESIDENTIAL,40300,0,40300,166700,0,207000
113422600800000,NE 159,RESIDENTIAL,39100,0,39100,168000,0,207100
113422600900000,NE 159,RESIDENTIAL,37600,0,37600,164800,0,202400
113422601000000,NE 159,RESIDENTIAL,37100,0,37100,179000,0,216100
113422601100000,NE 159,RESIDENTIAL,42100,0,42100,206600,0,248700
113422601200000,NE 159,RESIDENTIAL,41200,0,41200,175200,0,216400
113422601300000,NE 159,RESIDENTIAL,43000,0,43000,208000,0,251000
113422601400000,NE 159,RESIDENTIAL,41100,0,41100,190700,0,231800
113422601500000,NE 159,RESIDENTIAL,40300,0,40300,177000,0,217300
113422601600000,NE 159,RESIDENTIAL,37600,0,37600,175200,0,212800
113422601700000,NE 159,RESIDENTIAL,35600,0,35600,165400,0,201000
113422601800000,NE 159,RESIDENTIAL,42800,0,42800,177800,0,220600
113422601900000,NE 159,RESIDENTIAL,43100,0,43100,206600,0,249700
113422602000000,NE 159,RESIDENTIAL,35600,0,35600,194900,0,230500
113422602100000,NE 159,RESIDENTIAL,35600,0,35600,187900,0,223500
113422700100000,NE 159,RESIDENTIAL,43100,0,43100,177700,0,220800
113422700200000,NE 159,RESIDENTIAL,41100,0,41100,187700,0,228800
113422700300000,NE 159,RESIDENTIAL,35600,0,35600,179900,0,215500
113422700400000,NE 159,RESIDENTIAL,35600,0,35600,179200,0,214800
113422700500000,NE 159,RESIDENTIAL,35600,0,35600,176500,0,212100
113422700600000,NE 159,RESIDENTIAL,41200,0,41200,181400,0,222600
113422700700000,NE 159,RESIDENTIAL,41500,0,41500,175500,0,217000
113422700800000,NE 159,RESIDENTIAL,35600,0,35600,194700,0,230300
113422700900000,NE 159,RESIDENTIAL,35600,0,35600,178400,0,214000
113422701000000,NE 159,RESIDENTIAL,35600,0,35600,178400,0,214000
113422701100000,NE 159,RESIDENTIAL,35600,0,35600,175900,0,211500
113422701200000,NE 159,RESIDENTIAL,38700,0,38700,179700,0,218400
113422701300000,NE 159,RESIDENTIAL,40200,0,40200,181100,0,221300
113422701400000,NE 159,RESIDENTIAL,39100,0,39100,166300,0,205400
113422800100000,NE 162,RESIDENTIAL,41400,0,41400,151000,0,192400
113422800200000,NE 159,RESIDENTIAL,36000,0,36000,95000,0,131000
113422800300000,NE 159,RESIDENTIAL,34800,0,34800,251700,0,286500
113422800400000,NE 159,RESIDENTIAL,30000,0,30000,160400,0,190400
113422800500000,NE 159,RESIDENTIAL,30000,0,30000,142500,0,172500
113422800600000,NE 159,RESIDENTIAL,25200,0,25200,116300,0,141500
113422800700000,NE 159,RESIDENTIAL,30400,0,30400,146700,0,177100
113422800800000,NE 159,RESIDENTIAL,41200,0,41200,148800,0,190000
113422800900000,NE 159,RESIDENTIAL,41200,0,41200,168100,0,209300
113422801000000,NE 159,RESIDENTIAL,41200,0,41200,155500,0,196700
113422801100000,NE 159,RESIDENTIAL,40800,0,40800,159900,0,200700
113422801200000,NE 159,RESIDENTIAL,40800,0,40800,149700,0,190500
113422801300000,NE 159,RESIDENTIAL,40800,0,40800,160400,0,201200
113422801400000,NE 159,RESIDENTIAL,42800,0,42800,164500,0,207300
113422801500000,NE 159,RESIDENTIAL,41400,0,41400,183600,0,225000
113422801600000,NE 159,RESIDENTIAL,41400,0,41400,163200,0,204600
113422801700000,NE 159,RESIDENTIAL,41400,0,41400,161300,0,202700
113422801800000,NE 159,RESIDENTIAL,41400,0,41400,187000,0,228400
113422801900000,NE 159,RESIDENTIAL,41000,0,41000,186500,0,227500
113422802000000,NE 159,RESIDENTIAL,41000,0,41000,169400,0,210400
113422802100000,NE 159,RESIDENTIAL,41000,0,41000,193100,0,234100
113422802200000,NE 159,RESIDENTIAL,41000,0,41000,173300,0,214300
113422802300000,NE 159,RESIDENTIAL,42600,0,42600,129200,0,171800
113422900100000,NE 159,RESIDENTIAL,44200,0,44200,170000,0,214200
113422900200000,NE 159,RESIDENTIAL,42600,0,42600,177900,0,220500
113422900300000,NE 159,RESIDENTIAL,42200,0,42200,185200,0,227400
113422900400000,NE 159,RESIDENTIAL,42500,0,42500,163300,0,205800
113422900500000,NE 159,RESIDENTIAL,44400,0,44400,204100,0,248500
113422900600000,NE 159,RESIDENTIAL,42900,0,42900,171800,0,214700
113422900700000,NE 159,RESIDENTIAL,41700,0,41700,175500,0,217200
113422900800000,NE 159,RESIDENTIAL,43700,0,43700,187000,0,230700
113422900900000,NE 159,RESIDENTIAL,39600,0,39600,163700,0,203300
113422901000000,NE 159,RESIDENTIAL,41100,0,41100,171800,0,212900
113422901100000,NE 159,RESIDENTIAL,42500,0,42500,144200,0,186700
113422901200000,NE 159,RESIDENTIAL,40000,0,40000,156800,0,196800
113422901300000,NE 159,RESIDENTIAL,38200,0,38200,141900,0,180100
113422901400000,NE 159,RESIDENTIAL,38200,0,38200,166400,0,204600
113422901500000,NE 159,RESIDENTIAL,38200,0,38200,152800,0,191000
113422901600000,NE 159,RESIDENTIAL,38200,0,38200,163300,0,201500
113422901700000,NE 159,RESIDENTIAL,37500,0,37500,148100,0,185600
113422901800000,NE 159,RESIDENTIAL,43200,0,43200,177300,0,220500
113422901900000,NE 159,RESIDENTIAL,37500,0,37500,170900,0,208400
113422902000000,NE 159,RESIDENTIAL,42600,0,42600,173200,0,215800
113422902100000,NE 159,RESIDENTIAL,40000,0,40000,183500,0,223500
113422902200000,NE 159,RESIDENTIAL,37800,0,37800,171600,0,209400
113422902300000,NE 159,RESIDENTIAL,34100,0,34100,158000,0,192100
113422902400000,NE 159,RESIDENTIAL,34100,0,34100,160500,0,194600
113423000100000,NE 159,RESIDENTIAL,42200,0,42200,168800,0,211000
113423000200000,NE 159,RESIDENTIAL,42600,0,42600,151700,0,194300
113423000300000,NE 159,RESIDENTIAL,43400,0,43400,172100,0,215500
113423000400000,NE 159,RESIDENTIAL,44500,0,44500,181200,0,225700
113423000500000,NE 159,RESIDENTIAL,45300,0,45300,176600,0,221900
113423000600000,NE 159,RESIDENTIAL,41900,0,41900,189400,0,231300
113423100100000,NE 159,RESIDENTIAL,41100,0,41100,197600,0,238700
113423100200000,NE 159,RESIDENTIAL,38000,0,38000,168200,0,206200
113423100300000,NE 159,RESIDENTIAL,40600,0,40600,161100,0,201700
113423100400000,NE 159,RESIDENTIAL,39000,0,39000,191300,0,230300
113423100500000,NE 159,RESIDENTIAL,34100,0,34100,154000,0,188100
113423100600000,NE 159,RESIDENTIAL,34100,0,34100,163100,0,197200
113423100700000,NE 159,RESIDENTIAL,34100,0,34100,164400,0,198500
113423100800000,NE 159,RESIDENTIAL,34100,0,34100,178200,0,212300
113423100900000,NE 159,RESIDENTIAL,34100,0,34100,138100,0,172200
113423101000000,NE 159,RESIDENTIAL,42700,0,42700,172800,0,215500
113423101100000,NE 159,RESIDENTIAL,40500,0,40500,159200,0,199700
113423101200000,NE 159,RESIDENTIAL,40100,0,40100,174900,0,215000
113423200100000,NE 159,RESIDENTIAL,43300,0,43300,225500,0,268800
113423200200000,NE 159,RESIDENTIAL,42600,0,42600,157600,0,200200
113423200300000,NE 159,RESIDENTIAL,35600,0,35600,164400,0,200000
113423200400000,NE 159,RESIDENTIAL,43700,0,43700,182700,0,226400
113423200500000,NE 159,RESIDENTIAL,43000,0,43000,184800,0,227800
113423200600000,NE 159,RESIDENTIAL,43000,0,43000,185700,0,228700
113423200700000,NE 159,RESIDENTIAL,42900,0,42900,195200,0,238100
113423200800000,NE 159,RESIDENTIAL,34600,0,34600,172100,0,206700
113423200900000,NE 159,RESIDENTIAL,400,0,400,0,0,400
113423300200000,NE 159,RESIDENTIAL,39400,0,39400,175500,0,214900
113425100100000,CITY PROPERTY,EXEMPT,0,0,0,0,0,0
113425200100000,NE 159,RESIDENTIAL,38500,0,38500,147000,0,185500
113425200200000,NE 159,RESIDENTIAL,46900,0,46900,167000,0,213900
113425200300000,NE 159,RESIDENTIAL,44900,0,44900,150500,0,195400
113425300100000,NE 159,RESIDENTIAL,41300,0,41300,160200,0,201500
113425300200000,NE 159,RESIDENTIAL,39400,0,39400,153900,0,193300
113425400100000,NE 159,RESIDENTIAL,41200,0,41200,167400,0,208600
113425400200000,NE 159,RESIDENTIAL,30400,0,30400,137600,0,168000
113425400300000,NE 159,RESIDENTIAL,10100,0,10100,0,0,10100
113425400400000,NE 159,RESIDENTIAL,43000,0,43000,165700,0,208700
113425400500000,NE 159,RESIDENTIAL,41200,0,41200,166400,0,207600
113425400600000,NE 159,RESIDENTIAL,41200,0,41200,157600,0,198800
113425500100000,NE 159,RESIDENTIAL,42000,0,42000,149300,0,191300
113425500200000,NE 159,RESIDENTIAL,36800,0,36800,147200,0,184000
113425500300000,NE 159,RESIDENTIAL,36800,0,36800,155600,0,192400
113425500400000,NE 159,RESIDENTIAL,36800,0,36800,174700,0,211500
113425500500000,NE 159,RESIDENTIAL,36800,0,36800,160600,0,197400
113425500600000,NE 159,RESIDENTIAL,36800,0,36800,169300,0,206100
113425500700000,NE 159,RESIDENTIAL,36800,0,36800,158400,0,195200
113425500800000,NE 159,RESIDENTIAL,36800,0,36800,164700,0,201500
113425500900000,NE 159,RESIDENTIAL,42000,0,42000,168800,0,210800
113425600200000,DAY CARE CENTER,COMMERCIAL,0,70500,70500,0,139300,209800
113425700101000,DAY CARE CENTER,COMMERCIAL,0,83800,83800,0,342500,426300
113425700101001,OFFICE,COMMERCIAL,0,83800,83800,0,395800,479600
113425700200000,VACANT LAND,COMMERCIAL,0,136300,136300,0,0,136300
113425700300000,VACANT LAND,COMMERCIAL,0,161500,161500,0,0,161500
113425800100000,CITY PROPERTY,EXEMPT,0,0,0,0,0,0
113425900100000,CITY PROPERTY,EXEMPT,0,0,0,0,0,0
113427600501000,NE 159,RESIDENTIAL,3300,0,3300,120000,0,123300
113427600501001,NE 159,RESIDENTIAL,3300,0,3300,115500,0,118800
113427600501002,NE 159,RESIDENTIAL,3300,0,3300,113300,0,116600
113427600501003,NE 159,RESIDENTIAL,3300,0,3300,115500,0,118800
113427600501004,NE 159,RESIDENTIAL,3300,0,3300,122600,0,125900
113427600501005,NE 159,RESIDENTIAL,3300,0,3300,120000,0,123300
113427600501006,NE 159,RESIDENTIAL,3300,0,3300,115500,0,118800
113427600501007,NE 159,RESIDENTIAL,3300,0,3300,113300,0,116600
113427600501008,NE 159,RESIDENTIAL,3300,0,3300,115500,0,118800
113427600501009,NE 159,RESIDENTIAL,3300,0,3300,122600,0,125900
113427600501010,NE 159,RESIDENTIAL,3300,0,3300,36000,0,39300
113427600501011,NE 159,RESIDENTIAL,3300,0,3300,34600,0,37900
113427600501012,NE 159,RESIDENTIAL,3300,0,3300,34000,0,37300
113427600501013,NE 159,RESIDENTIAL,3300,0,3300,34600,0,37900
113427600501014,NE 159,RESIDENTIAL,3300,0,3300,36800,0,40100
113427600501015,NE 159,RESIDENTIAL,3300,0,3300,36000,0,39300
113427600501016,NE 159,RESIDENTIAL,3300,0,3300,34600,0,37900
113427600501017,NE 159,RESIDENTIAL,3300,0,3300,34000,0,37300
113427600501018,NE 159,RESIDENTIAL,3300,0,3300,34600,0,37900
113427600501019,NE 159,RESIDENTIAL,3300,0,3300,36800,0,40100
113427700300000,NE 159,RESIDENTIAL,0,0,0,0,0,0
113427800200000,NE 159,RESIDENTIAL,44900,0,44900,73300,0,118200
113427800300000,NE 159,RESIDENTIAL,44900,0,44900,68900,0,113800
113427800400000,NE 159,RESIDENTIAL,39300,0,39300,129600,0,168900
113427800500000,NE 159,RESIDENTIAL,35500,0,35500,147700,0,183200
113427800600000,NE 159,RESIDENTIAL,35500,0,35500,179300,0,214800
113427800700000,NE 159,RESIDENTIAL,35500,0,35500,181500,0,217000
113427800800000,NE 159,RESIDENTIAL,34800,0,34800,176300,0,211100
113427800900000,NE 159,RESIDENTIAL,35400,0,35400,165500,0,200900
113427801000000,NE 159,RESIDENTIAL,36800,0,36800,181400,0,218200
113427801100000,NE 159,RESIDENTIAL,36700,0,36700,147100,0,183800
113427801200000,NE 159,RESIDENTIAL,36700,0,36700,154100,0,190800
113427801300000,NE 159,RESIDENTIAL,36700,0,36700,119200,0,155900
113427801400000,NE 159,RESIDENTIAL,38900,0,38900,162000,0,200900
113427801500000,NE 159,RESIDENTIAL,44500,0,44500,198100,0,242600
113427801600000,NE 159,RESIDENTIAL,37900,0,37900,138400,0,176300
113427801700000,NE 159,RESIDENTIAL,36700,0,36700,173300,0,210000
113427801800000,NE 159,RESIDENTIAL,35800,0,35800,162800,0,198600
113427801900000,NE 159,RESIDENTIAL,33800,0,33800,136000,0,169800
113427802000000,NE 159,RESIDENTIAL,38200,0,38200,169800,0,208000
113427802100000,NE 159,RESIDENTIAL,42600,0,42600,162500,0,205100
113427802200000,NE 159,RESIDENTIAL,43600,0,43600,156600,0,200200
113427802300000,NE 159,RESIDENTIAL,42400,0,42400,151200,0,193600
113427802400000,NE 159,RESIDENTIAL,39000,0,39000,169100,0,208100
113427802500000,NE 159,RESIDENTIAL,42000,0,42000,148800,0,190800
113427802600000,NE 159,RESIDENTIAL,34100,0,34100,147000,0,181100
113427802700000,NE 159,RESIDENTIAL,36500,0,36500,138300,0,174800
113427802800000,NE 159,RESIDENTIAL,36500,0,36500,166600,0,203100
113427802900000,NE 159,RESIDENTIAL,36500,0,36500,179700,0,216200
113427803000000,NE 159,RESIDENTIAL,36000,0,36000,166500,0,202500
113427803100000,NE 159,RESIDENTIAL,34800,0,34800,134000,0,168800
113427803200000,NE 159,RESIDENTIAL,34800,0,34800,123400,0,158200
113427803300000,NE 159,RESIDENTIAL,34800,0,34800,164200,0,199000
113427803400000,NE 159,RESIDENTIAL,34800,0,34800,142100,0,176900
113427803500000,APARTMENT,RESIDENTIAL,376000,0,376000,7351100,0,7727100
113427900100000,NE 159,RESIDENTIAL,52600,0,52600,137900,0,190500
113427900200000,NE 159,RESIDENTIAL,42700,0,42700,180300,0,223000
113427900300000,NE 159,RESIDENTIAL,42700,0,42700,166800,0,209500
113427900400000,NE 159,RESIDENTIAL,42300,0,42300,186800,0,229100
113427900500000,NE 159,RESIDENTIAL,48700,0,48700,186400,0,235100
113427900600000,NE 159,RESIDENTIAL,47900,0,47900,180800,0,228700
113427900700000,NE 159,RESIDENTIAL,52400,0,52400,186300,0,238700
113427900800000,NE 159,RESIDENTIAL,52700,0,52700,171400,0,224100
113427900900000,NE 159,RESIDENTIAL,53500,0,53500,202400,0,255900
113427901000000,NE 159,RESIDENTIAL,50700,0,50700,209700,0,260400
113427901100000,NE 159,RESIDENTIAL,50100,0,50100,217600,0,267700
113427901200000,NE 159,RESIDENTIAL,51200,0,51200,220800,0,272000
113427901300000,NE 159,RESIDENTIAL,52500,0,52500,214800,0,267300
113427901400000,NE 159,RESIDENTIAL,50200,0,50200,201900,0,252100
113427901500000,NE 159,RESIDENTIAL,50200,0,50200,191600,0,241800
113427901600000,NE 159,RESIDENTIAL,50200,0,50200,182700,0,232900
113427901700000,NE 159,RESIDENTIAL,50200,0,50200,185000,0,235200
113427901800000,NE 159,RESIDENTIAL,50200,0,50200,211400,0,261600
113427901900000,NE 159,RESIDENTIAL,38200,0,38200,221800,0,260000
113427902000000,NE 159,RESIDENTIAL,50200,0,50200,182400,0,232600
113427902100000,NE 159,RESIDENTIAL,50200,0,50200,228600,0,278800
113427902200000,NE 159,RESIDENTIAL,51200,0,51200,195000,0,246200
113428000100000,NE 159,RESIDENTIAL,41600,0,41600,176600,0,218200
113428000200000,NE 159,RESIDENTIAL,34100,0,34100,181300,0,215400
113428000300000,NE 159,RESIDENTIAL,34100,0,34100,147800,0,181900
113428000400000,NE 159,RESIDENTIAL,34100,0,34100,163400,0,197500
113428000500000,NE 159,RESIDENTIAL,34100,0,34100,145300,0,179400
113428000600000,NE 159,RESIDENTIAL,34100,0,34100,136400,0,170500
113428000700000,NE 159,RESIDENTIAL,34100,0,34100,150700,0,184800
113428000800000,NE 159,RESIDENTIAL,34100,0,34100,164900,0,199000
113428000900000,NE 159,RESIDENTIAL,34100,0,34100,122600,0,156700
113428001000000,NE 159,RESIDENTIAL,34200,0,34200,149400,0,183600
113428001100000,NE 159,RESIDENTIAL,34500,0,34500,145700,0,180200
113428001200000,NE 159,RESIDENTIAL,34000,0,34000,171500,0,205500
113428001300000,NE 159,RESIDENTIAL,33800,0,33800,180800,0,214600
113428001400000,NE 159,RESIDENTIAL,34100,0,34100,178400,0,212500
113428001500000,NE 159,RESIDENTIAL,34100,0,34100,166900,0,201000
113428001600000,NE 159,RESIDENTIAL,34100,0,34100,160100,0,194200
113428001700000,NE 159,RESIDENTIAL,34100,0,34100,137300,0,171400
113428001800000,NE 159,RESIDENTIAL,34100,0,34100,137600,0,171700
113428001900000,NE 159,RESIDENTIAL,34100,0,34100,179800,0,213900
113428002000000,NE 159,RESIDENTIAL,34100,0,34100,190900,0,225000
113428002100000,NE 159,RESIDENTIAL,34100,0,34100,159400,0,193500
113428002200000,NE 159,RESIDENTIAL,41600,0,41600,184400,0,226000
113430100100000,VACANT LAND,COMMERCIAL,0,308800,308800,0,122700,431500
113430100200000,OFFICE,EXEMPT,0,354300,354300,0,2092900,2447200
113430100300000,VACANT LAND,COMMERCIAL,0,2400,2400,0,0,2400
113430200100000,VACANT LAND,COMMERCIAL,0,417500,417500,0,0,417500
113430200200000,SR/NURSING/ASSTD LIV,MULTI-RES,311000,0,311000,5033800,0,5344800
113432700200000,NE 101,RESIDENTIAL,92700,0,92700,0,0,92700
113432700300000,NE 108,RESIDENTIAL,22300,0,22300,70400,0,92700
113432800200000,NE 101,RESIDENTIAL,51100,0,51100,0,0,51100
113432800400000,SR/NURSING/ASSTD LIV,MULTI-RES,310000,0,310000,2391200,0,2701200
113432800600000,SECTION 42,COMMERCIAL,0,403000,403000,0,918600,1321600
113432900200000,OFFICE,COMMERCIAL,0,595000,595000,0,1872500,2467500
113432900300000,GOLF COURSE,COMMERCIAL,0,40500,40500,0,59900,100400
113435100100000,OFFICE,COMMERCIAL,0,399600,399600,0,1041700,1441300
113435100200000,OFFICE,COMMERCIAL,0,263400,263400,0,1284000,1547400
113435100300000,GOLF COURSE,COMMERCIAL,0,33900,33900,0,56500,90400
113435100400000,FEDERAL PROPERTY,EXEMPT,0,0,0,0,0,0
113435100500000,SHOP,COMMERCIAL,0,288000,288000,0,583300,871300
113435100600000,MATERIALS MFG;INDUST,INDUSTRIAL,0,486500,486500,0,2332000,2818500
113435100700000,MATERIALS MFG;INDUST,INDUSTRIAL,0,241300,241300,0,1412400,1653700
113435100900000,SHOP,COMMERCIAL,0,82600,82600,0,300400,383000
113435200100000,OFFICE,COMMERCIAL,0,253500,253500,0,557500,811000
113435200200000,OFFICE,COMMERCIAL,0,523000,523000,0,3477000,4000000
113435200300000,OFFICE,COMMERCIAL,0,135500,135500,0,370500,506000
113437600100000,OFFICE,COMMERCIAL,0,154500,154500,0,790100,944600
113437600300000,OFFICE,COMMERCIAL,0,202500,202500,0,616000,818500
113437600400000,OFFICE,COMMERCIAL,0,157500,157500,0,762500,920000
113437600600000,HIGH TECH/RESEARCH,INDUSTRIAL,0,658500,658500,0,4707800,5366300
113437700100000,OFFICE,COMMERCIAL,0,130200,130200,0,332000,462200
113437700200000,OFFICE,COMMERCIAL,0,133400,133400,0,287400,420800
113437700300000,VACANT LAND,COMMERCIAL,0,189600,189600,0,0,189600
113437700400000,VACANT LAND,COMMERCIAL,0,256800,256800,0,0,256800
113437800300000,SMALL RETAIL,COMMERCIAL,0,44400,44400,0,158800,203200
113437900100000,VACANT LAND,COMMERCIAL,0,5400,5400,0,0,5400
113437900200000,CENTRALLY ASSESSED,OTHER,0,0,0,0,0,0
113437900300000,VACANT LAND,COMMERCIAL,0,415300,415300,0,0,415300
113440100100000,NE 110,EXEMPT,0,44900,44900,0,164100,209000
113440100300000,NE 110,RESIDENTIAL,36400,0,36400,149500,0,185900
113440100400000,NE 110,RESIDENTIAL,36400,0,36400,165000,0,201400
113440100500000,NE 110,RESIDENTIAL,36400,0,36400,148900,0,185300
113440100600000,NE 110,RESIDENTIAL,37800,0,37800,119800,0,157600
113440200100000,NE 110,RESIDENTIAL,20000,0,20000,99400,0,119400
113440200200000,NE 110,RESIDENTIAL,19900,0,19900,108700,0,128600
113440200300000,NE 110,RESIDENTIAL,19900,0,19900,105400,0,125300
113440200400000,NE 110,RESIDENTIAL,19900,0,19900,108500,0,128400
113440200500000,NE 110,RESIDENTIAL,19900,0,19900,117200,0,137100
113440200600000,NE 110,RESIDENTIAL,19900,0,19900,113500,0,133400
113440200700000,NE 110,RESIDENTIAL,19900,0,19900,120200,0,140100
113440200800000,NE 110,RESIDENTIAL,19900,0,19900,103200,0,123100
113440200900000,NE 110,RESIDENTIAL,19900,0,19900,113400,0,133300
113440201000000,NE 110,RESIDENTIAL,19900,0,19900,115100,0,135000
113440300100000,CITY PROPERTY,EXEMPT,0,0,0,0,0,0
113440300200000,APARTMENT,MULTI-RES,588000,0,588000,3658100,0,4246100
113440300301000,OFFICE; MEDICAL,COMMERCIAL,0,87100,87100,0,472200,559300
113440300301001,OFFICE; MEDICAL,COMMERCIAL,0,55200,55200,0,288500,343700
113440400100000,NE 110,RESIDENTIAL,25000,0,25000,108200,0,133200
113440400200000,NE 110,RESIDENTIAL,19700,0,19700,105800,0,125500
113440400300000,NE 110,RESIDENTIAL,19700,0,19700,95300,0,115000
113440400400000,NE 110,RESIDENTIAL,19700,0,19700,95300,0,115000
113440400500000,NE 110,RESIDENTIAL,19700,0,19700,96700,0,116400
113440400600000,NE 110,RESIDENTIAL,19700,0,19700,110800,0,130500
113440400700000,NE 110,RESIDENTIAL,19700,0,19700,126200,0,145900
113440400800000,NE 110,RESIDENTIAL,19700,0,19700,129600,0,149300
113440400900000,NE 110,RESIDENTIAL,19700,0,19700,120500,0,140200
113440401000000,NE 110,RESIDENTIAL,19700,0,19700,123700,0,143400
113440401100000,SECTION 42,RESIDENTIAL,523000,0,523000,1628100,0,2151100
113440401200000,SECTION 42,RESIDENTIAL,540500,0,540500,1001800,0,1542300
113442600100000,APARTMENT,MULTI-RES,948000,0,948000,6321400,0,7269400
113445100100000,NE 110,RESIDENTIAL,30500,0,30500,94800,0,125300
113445100200000,NE 110,RESIDENTIAL,30600,0,30600,135700,0,166300
113445100300000,NE 110,RESIDENTIAL,30600,0,30600,118800,0,149400
113445100400000,NE 110,RESIDENTIAL,30600,0,30600,134900,0,165500
113445100500000,NE 110,RESIDENTIAL,30600,0,30600,146200,0,176800
113445100600000,NE 110,RESIDENTIAL,30600,0,30600,131100,0,161700
113445100700000,NE 110,RESIDENTIAL,30600,0,30600,127700,0,158300
113445100800000,NE 110,RESIDENTIAL,30600,0,30600,121000,0,151600
113445100900000,NE 110,RESIDENTIAL,30600,0,30600,111500,0,142100
113445101000000,NE 110,RESIDENTIAL,30600,0,30600,154100,0,184700
113445101100000,NE 110,RESIDENTIAL,31200,0,31200,152300,0,183500
113445101200000,NE 110,RESIDENTIAL,32100,0,32100,169800,0,201900
113445101300000,NE 110,RESIDENTIAL,30500,0,30500,111800,0,142300
113445101400000,NE 110,RESIDENTIAL,36400,0,36400,108500,0,144900
113445101500000,NE 110,RESIDENTIAL,36400,0,36400,130000,0,166400
113445101600000,NE 110,RESIDENTIAL,38700,0,38700,137300,0,176000
113445200100000,NE 110,RESIDENTIAL,30800,0,30800,115800,0,146600
113445200200000,NE 110,RESIDENTIAL,28800,0,28800,114400,0,143200
113445200300000,NE 110,RESIDENTIAL,28800,0,28800,89000,0,117800
113445200400000,NE 110,RESIDENTIAL,28800,0,28800,102300,0,131100
113445200500000,NE 110,RESIDENTIAL,28800,0,28800,108900,0,137700
113445200600000,NE 110,RESIDENTIAL,28800,0,28800,123000,0,151800
113445200700000,NE 110,RESIDENTIAL,28800,0,28800,86800,0,115600
113445200800000,NE 110,RESIDENTIAL,28800,0,28800,97200,0,126000
113445200900000,NE 110,RESIDENTIAL,28800,0,28800,124900,0,153700
113445201000000,NE 110,RESIDENTIAL,46700,0,46700,147200,0,193900
113445300100000,NE 110,RESIDENTIAL,32700,0,32700,135700,0,168400
113445300200000,NE 110,RESIDENTIAL,32600,0,32600,138300,0,170900
113445300300000,NE 110,RESIDENTIAL,32600,0,32600,95500,0,128100
113445300400000,NE 110,RESIDENTIAL,32600,0,32600,89000,0,121600
113445300500000,NE 110,RESIDENTIAL,32600,0,32600,148100,0,180700
113445300600000,NE 110,RESIDENTIAL,32600,0,32600,126100,0,158700
113445300700000,NE 110,RESIDENTIAL,32600,0,32600,110100,0,142700
113445300800000,NE 110,RESIDENTIAL,32800,0,32800,141600,0,174400
113445300900000,NE 110,RESIDENTIAL,32700,0,32700,146300,0,179000
113445301000000,NE 110,RESIDENTIAL,32600,0,32600,135900,0,168500
113445301100000,NE 110,RESIDENTIAL,32600,0,32600,123300,0,155900
113445301200000,NE 110,RESIDENTIAL,32600,0,32600,133500,0,166100
113445301300000,NE 110,RESIDENTIAL,32600,0,32600,139600,0,172200
113445301400000,NE 110,RESIDENTIAL,32600,0,32600,147200,0,179800
113445301500000,NE 110,RESIDENTIAL,32600,0,32600,110200,0,142800
113445301600000,NE 110,RESIDENTIAL,32900,0,32900,134500,0,167400
113445301800000,SR/NURSING/ASSTD LIV,MULTI-RES,500300,0,500300,7180800,0,7681100
113445301900000,NE 110,RESIDENTIAL,33500,0,33500,193300,0,226800
113445302000000,NE 110,RESIDENTIAL,35600,0,35600,149400,0,185000
113445302100000,NE 110,RESIDENTIAL,35600,0,35600,154400,0,190000
113445302200000,NE 110,RESIDENTIAL,35600,0,35600,166800,0,202400
113445302300000,NE 110,RESIDENTIAL,37400,0,37400,153700,0,191100
113445302400000,NE 110,RESIDENTIAL,42100,0,42100,179000,0,221100
113445400100000,NE 110,RESIDENTIAL,33600,0,33600,134600,0,168200
113445400200000,NE 110,RESIDENTIAL,32600,0,32600,125300,0,157900
113445400300000,NE 110,RESIDENTIAL,32600,0,32600,110100,0,142700
113445400400000,NE 110,RESIDENTIAL,32600,0,32600,108800,0,141400
113445400500000,NE 110,RESIDENTIAL,32600,0,32600,106600,0,139200
113445400600000,NE 110,RESIDENTIAL,32600,0,32600,83300,0,115900
113445400700000,NE 110,RESIDENTIAL,32600,0,32600,124100,0,156700
113445400800000,NE 110,RESIDENTIAL,32700,0,32700,127300,0,160000
113445401000000,NE 110,RESIDENTIAL,33000,0,33000,91500,0,124500
113445401100000,NE 110,RESIDENTIAL,31800,0,31800,104200,0,136000
113445401200000,NE 110,RESIDENTIAL,31800,0,31800,102900,0,134700
113445401300000,NE 110,RESIDENTIAL,31800,0,31800,95000,0,126800
113445401400000,NE 110,RESIDENTIAL,31800,0,31800,150900,0,182700
113445401500000,NE 110,RESIDENTIAL,31800,0,31800,111800,0,143600
113445401600000,NE 110,RESIDENTIAL,31800,0,31800,128800,0,160600
113445401700000,NE 110,RESIDENTIAL,37200,0,37200,114000,0,151200
113445500100000,NE 110,RESIDENTIAL,35300,0,35300,123900,0,159200
113445500200000,NE 110,RESIDENTIAL,30800,0,30800,115300,0,146100
113445500300000,NE 110,RESIDENTIAL,30800,0,30800,119300,0,150100
113445500400000,NE 110,RESIDENTIAL,30800,0,30800,111900,0,142700
113445500500000,NE 110,RESIDENTIAL,30800,0,30800,76800,0,107600
113445500600000,NE 110,RESIDENTIAL,30800,0,30800,111500,0,142300
113445500700000,NE 110,RESIDENTIAL,30800,0,30800,102600,0,133400
113445500800000,NE 110,RESIDENTIAL,30800,0,30800,127000,0,157800
113445500900000,NE 110,RESIDENTIAL,24900,0,24900,98200,0,123100
113445501000000,NE 110,RESIDENTIAL,24900,0,24900,92400,0,117300
113445501100000,NE 110,RESIDENTIAL,24900,0,24900,75600,0,100500
113445501200000,NE 110,RESIDENTIAL,24900,0,24900,82700,0,107600
113445501300000,NE 110,RESIDENTIAL,24900,0,24900,120800,0,145700
113445501400000,NE 110,RESIDENTIAL,20100,0,20100,236300,0,256400
113445501500000,NE 110,RESIDENTIAL,27500,0,27500,211500,0,239000
113445502000000,VACANT LAND,COMMERCIAL,0,341300,341300,0,0,341300
113445502100000,OFFICE; MEDICAL,COMMERCIAL,0,362100,362100,0,2471400,2833500
113445600100000,NE 110,RESIDENTIAL,29500,0,29500,96500,0,126000
113445700100000,NE 110,RESIDENTIAL,24900,0,24900,124100,0,149000
113445700200000,NE 110,RESIDENTIAL,24900,0,24900,88600,0,113500
113445700300000,NE 110,RESIDENTIAL,24900,0,24900,91500,0,116400
113445700400000,NE 110,RESIDENTIAL,24900,0,24900,105700,0,130600
113445700500000,NE 110,RESIDENTIAL,24900,0,24900,79100,0,104000
113445700700000,NE 110,RESIDENTIAL,51500,0,51500,192200,0,243700
113445700800000,NE 110,EXEMPT,0,56400,56400,0,145000,201400
113445800100000,NE 110,RESIDENTIAL,40500,0,40500,45300,0,85800
113447600100000,CITY PROPERTY,EXEMPT,0,0,0,0,0,0
113447600400000,NE 110,RESIDENTIAL,35100,0,35100,148500,0,183600
113447600500000,NE 110,RESIDENTIAL,33100,0,33100,148200,0,181300
113447600600000,NE 110,RESIDENTIAL,36900,0,36900,141600,0,178500
113447600700000,NE 110,RESIDENTIAL,34900,0,34900,150800,0,185700
113447600800000,NE 110,RESIDENTIAL,34900,0,34900,139400,0,174300
113447600900000,NE 110,RESIDENTIAL,34900,0,34900,116700,0,151600
113447601000000,CITY PROPERTY,EXEMPT,0,0,0,0,0,0
113447601100000,NE 110,RESIDENTIAL,34900,0,34900,133700,0,168600
113447601200000,NE 110,RESIDENTIAL,34900,0,34900,144400,0,179300
113447601300000,NE 110,RESIDENTIAL,34900,0,34900,159000,0,193900
113447601400000,NE 110,RESIDENTIAL,34900,0,34900,145300,0,180200
113447601500000,NE 110,RESIDENTIAL,34900,0,34900,130100,0,165000
113447601600000,NE 110,RESIDENTIAL,34900,0,34900,137900,0,172800
113447601700000,NE 110,RESIDENTIAL,39500,0,39500,169400,0,208900
113447601900000,CITY PROPERTY,EXEMPT,0,0,0,0,0,0
113447602000000,NE 110,RESIDENTIAL,45000,0,45000,129100,0,174100
113447602100000,NE 110,RESIDENTIAL,38300,0,38300,139400,0,177700
113447602200000,NE 110,RESIDENTIAL,33600,0,33600,165100,0,198700
113447602300000,NE 110,RESIDENTIAL,39400,0,39400,107100,0,146500
113447602400000,NE 110,RESIDENTIAL,41300,0,41300,199500,0,240800
113447602500000,NE 110,RESIDENTIAL,36700,0,36700,109800,0,146500
113447602600000,NE 110,RESIDENTIAL,36700,0,36700,137900,0,174600
113447602700000,NE 110,RESIDENTIAL,36700,0,36700,151700,0,188400
113447602800000,NE 110,RESIDENTIAL,36700,0,36700,142900,0,179600
113447602900000,NE 110,RESIDENTIAL,36700,0,36700,161900,0,198600
113447603000000,NE 110,RESIDENTIAL,37000,0,37000,159700,0,196700
113447603100000,NE 110,RESIDENTIAL,33600,0,33600,123000,0,156600
113447603200000,NE 110,RESIDENTIAL,33500,0,33500,143400,0,176900
113447700100000,NE 110,RESIDENTIAL,37800,0,37800,152200,0,190000
113447700200000,NE 110,RESIDENTIAL,33200,0,33200,134000,0,167200
113447700300000,NE 110,RESIDENTIAL,37900,0,37900,168200,0,206100
113447700400000,NE 110,RESIDENTIAL,38500,0,38500,136700,0,175200
113447700500000,NE 110,RESIDENTIAL,38400,0,38400,143300,0,181700
113447700600000,NE 110,RESIDENTIAL,35200,0,35200,153600,0,188800
113447700700000,NE 110,RESIDENTIAL,34900,0,34900,176600,0,211500
113447700800000,NE 110,RESIDENTIAL,34900,0,34900,124700,0,159600
113447700900000,NE 110,RESIDENTIAL,34900,0,34900,138000,0,172900
113447701000000,NE 110,RESIDENTIAL,34900,0,34900,150300,0,185200
113447701100000,NE 110,RESIDENTIAL,34900,0,34900,145200,0,180100
113447701200000,NE 110,RESIDENTIAL,34900,0,34900,123100,0,158000
113447701300000,NE 110,RESIDENTIAL,34900,0,34900,143000,0,177900
113447701400000,NE 110,RESIDENTIAL,34900,0,34900,137200,0,172100
113447701500000,NE 110,RESIDENTIAL,34900,0,34900,128600,0,163500
113447701600000,NE 110,RESIDENTIAL,37400,0,37400,159400,0,196800
113447701700000,NE 110,RESIDENTIAL,34500,0,34500,147400,0,181900
113447701800000,NE 110,RESIDENTIAL,33100,0,33100,107200,0,140300
113447701900000,NE 110,RESIDENTIAL,34000,0,34000,119400,0,153400
113447702000000,NE 110,RESIDENTIAL,33500,0,33500,88100,0,121600
113447702100000,NE 110,RESIDENTIAL,33500,0,33500,117800,0,151300
113447702200000,NE 110,RESIDENTIAL,33500,0,33500,130100,0,163600
113447702500000,NE 110,RESIDENTIAL,33100,0,33100,142300,0,175400
113447702600000,NE 110,RESIDENTIAL,33900,0,33900,138100,0,172000
113447702700000,NE 110,RESIDENTIAL,34500,0,34500,122000,0,156500
113447702800000,NE 110,RESIDENTIAL,35100,0,35100,124300,0,159400
113447702900000,NE 110,RESIDENTIAL,34000,0,34000,154000,0,188000
113447703000000,NE 110,RESIDENTIAL,31000,0,31000,131200,0,162200
113447703100000,NE 110,RESIDENTIAL,31000,0,31000,109400,0,140400
113447703200000,NE 110,RESIDENTIAL,32800,0,32800,97200,0,130000
113447703300000,NE 110,RESIDENTIAL,34500,0,34500,54600,0,89100
113447703500000,NE 110,RESIDENTIAL,33500,0,33500,107000,0,140500
113447703600000,NE 110,RESIDENTIAL,33500,0,33500,0,0,33500
113447800100000,NE 110,RESIDENTIAL,28200,0,28200,79300,0,107500
113447800200000,NE 110,RESIDENTIAL,28800,0,28800,126500,0,155300
113447800300000,NE 110,RESIDENTIAL,28800,0,28800,132200,0,161000
113447800400000,NE 110,RESIDENTIAL,28800,0,28800,111200,0,140000
113447800500000,NE 110,RESIDENTIAL,29100,0,29100,108600,0,137700
113447800600000,NE 110,RESIDENTIAL,30000,0,30000,111300,0,141300
113447800700000,NE 110,RESIDENTIAL,30600,0,30600,123300,0,153900
113447800800000,NE 110,RESIDENTIAL,30800,0,30800,135800,0,166600
113447800900000,NE 110,RESIDENTIAL,34300,0,34300,110100,0,144400
113447801000000,NE 110,RESIDENTIAL,33500,0,33500,117000,0,150500
113447900100000,NE 110,RESIDENTIAL,30600,0,30600,139300,0,169900
113447900200000,NE 110,RESIDENTIAL,30600,0,30600,117100,0,147700
113447900300000,NE 110,RESIDENTIAL,33700,0,33700,128600,0,162300
113447900400000,NE 110,RESIDENTIAL,33700,0,33700,128800,0,162500
113447900500000,NE 110,RESIDENTIAL,31800,0,31800,113200,0,145000
113447900600000,NE 110,RESIDENTIAL,35600,0,35600,130900,0,166500
113447900700000,NE 110,RESIDENTIAL,33700,0,33700,137600,0,171300
113447900800000,NE 110,RESIDENTIAL,33700,0,33700,106900,0,140600
113447900900000,NE 110,RESIDENTIAL,35800,0,35800,111400,0,147200
113512600200000,NE 105,RESIDENTIAL,39000,0,39000,115000,0,154000
113512600300000,NE 105,RESIDENTIAL,33900,0,33900,148300,0,182200
113512600400000,NE 105,RESIDENTIAL,36300,0,36300,133700,0,170000
113512600500000,NE 105,RESIDENTIAL,34500,0,34500,141500,0,176000
113512600600000,NE 105,RESIDENTIAL,37800,0,37800,150000,0,187800
113512600700000,NE 105,RESIDENTIAL,35400,0,35400,141400,0,176800
113512600800000,NE 105,RESIDENTIAL,34700,0,34700,146200,0,180900
113512600900000,NE 105,RESIDENTIAL,35000,0,35000,131500,0,166500
113512601000000,NE 105,RESIDENTIAL,37300,0,37300,141600,0,178900
113512601100000,NE 105,RESIDENTIAL,37500,0,37500,142500,0,180000
113512601200000,NE 105,RESIDENTIAL,38100,0,38100,136600,0,174700
113512601300000,NE 105,RESIDENTIAL,39100,0,39100,151300,0,190400
113512601400000,NE 105,RESIDENTIAL,41600,0,41600,135500,0,177100
113512601500000,NE 105,RESIDENTIAL,40400,0,40400,130000,0,170400
113512601600000,NE 105,RESIDENTIAL,700,0,700,0,0,700
113512601700000,NE 105,RESIDENTIAL,700,0,700,0,0,700
113512700100000,NE 105,RESIDENTIAL,700,0,700,0,0,700
113512700200000,NE 105,RESIDENTIAL,500,0,500,0,0,500
113512700300000,NE 105,RESIDENTIAL,37100,0,37100,130300,0,167400
113512700400000,NE 105,RESIDENTIAL,39700,0,39700,159600,0,199300
113512700500000,NE 105,RESIDENTIAL,40100,0,40100,96100,0,136200
113512700600000,NE 105,RESIDENTIAL,39300,0,39300,152700,0,192000
113512700700000,NE 105,RESIDENTIAL,39500,0,39500,141700,0,181200
113512700800000,NE 105,RESIDENTIAL,4600,0,4600,0,0,4600
113512800100000,NE 105,RESIDENTIAL,41200,0,41200,123400,0,164600
113512800200000,NE 105,RESIDENTIAL,29900,0,29900,116800,0,146700
113512800300000,NE 105,RESIDENTIAL,40000,0,40000,133700,0,173700
113512800400000,NE 105,RESIDENTIAL,33000,0,33000,141700,0,174700
113512800500000,NE 105,RESIDENTIAL,35000,0,35000,123100,0,158100
113512800600000,NE 105,RESIDENTIAL,34100,0,34100,137700,0,171800
113512800700000,NE 105,RESIDENTIAL,34600,0,34600,137800,0,172400
113512800800000,NE 105,RESIDENTIAL,36100,0,36100,115200,0,151300
113512800900000,NE 105,RESIDENTIAL,34000,0,34000,123400,0,157400
113512801000000,NE 105,RESIDENTIAL,40500,0,40500,117600,0,158100
113512801100000,NE 105,RESIDENTIAL,42300,0,42300,136000,0,178300
113512801200000,NE 105,RESIDENTIAL,36600,0,36600,118600,0,155200
113512801300000,NE 105,RESIDENTIAL,39200,0,39200,143200,0,182400
113512801400000,NE 105,RESIDENTIAL,36900,0,36900,125300,0,162200
113512801500000,NE 105,RESIDENTIAL,36100,0,36100,154900,0,191000
113512801600000,NE 105,RESIDENTIAL,36300,0,36300,153100,0,189400
113512801700000,NE 105,RESIDENTIAL,32900,0,32900,132700,0,165600
113512801800000,NE 105,RESIDENTIAL,37200,0,37200,124400,0,161600
113512801900000,NE 105,RESIDENTIAL,35900,0,35900,146400,0,182300
113512900100000,NE 105,RESIDENTIAL,38400,0,38400,134200,0,172600
113512900200000,NE 105,RESIDENTIAL,34000,0,34000,149800,0,183800
113512900300000,NE 105,RESIDENTIAL,38000,0,38000,129200,0,167200
113512900400000,NE 105,RESIDENTIAL,39600,0,39600,145500,0,185100
113512900500000,NE 105,RESIDENTIAL,36800,0,36800,129000,0,165800
113512900600000,NE 105,RESIDENTIAL,35800,0,35800,130900,0,166700
113512900700000,NE 105,RESIDENTIAL,35700,0,35700,134800,0,170500
113512900800000,NE 105,RESIDENTIAL,36600,0,36600,130000,0,166600
113512900900000,NE 105,RESIDENTIAL,36900,0,36900,144300,0,181200
113512901000000,NE 105,RESIDENTIAL,34200,0,34200,129000,0,163200
113512901100000,NE 105,RESIDENTIAL,40000,0,40000,144100,0,184100
113512901200000,NE 105,RESIDENTIAL,41400,0,41400,100800,0,142200
113512901300000,NE 105,RESIDENTIAL,34000,0,34000,122700,0,156700
113512901400000,NE 105,RESIDENTIAL,36100,0,36100,141700,0,177800
113512901500000,NE 105,RESIDENTIAL,38500,0,38500,132900,0,171400
113515100100000,NE 105,RESIDENTIAL,4100,0,4100,0,0,4100
113515100200000,NE 105,RESIDENTIAL,38300,0,38300,130500,0,168800
113515100300000,NE 105,RESIDENTIAL,36800,0,36800,146100,0,182900
113515100400000,NE 105,RESIDENTIAL,36100,0,36100,134800,0,170900
113515100500000,NE 105,RESIDENTIAL,35700,0,35700,120000,0,155700
113515100600000,NE 105,RESIDENTIAL,33500,0,33500,106800,0,140300
113515100700000,NE 105,RESIDENTIAL,35300,0,35300,108800,0,144100
113515100800000,NE 105,RESIDENTIAL,31000,0,31000,130300,0,161300
113515100900000,NE 105,RESIDENTIAL,37400,0,37400,130200,0,167600
113515101000000,NE 105,RESIDENTIAL,38100,0,38100,111100,0,149200
113515200100000,NE 105,RESIDENTIAL,32900,0,32900,133900,0,166800
113515200200000,NE 105,RESIDENTIAL,33700,0,33700,133100,0,166800
113515200300000,NE 105,RESIDENTIAL,31500,0,31500,130600,0,162100
113515200400000,NE 105,RESIDENTIAL,38900,0,38900,135700,0,174600
113515200500000,NE 105,RESIDENTIAL,38000,0,38000,123500,0,161500
113515200600000,NE 105,RESIDENTIAL,30200,0,30200,105800,0,136000
113515200700000,NE 105,RESIDENTIAL,27500,0,27500,143000,0,170500
113515200800000,NE 105,RESIDENTIAL,29000,0,29000,112700,0,141700
113515200900000,NE 105,RESIDENTIAL,29500,0,29500,110600,0,140100
113515201000000,NE 105,RESIDENTIAL,28900,0,28900,98100,0,127000
113515201100000,NE 105,RESIDENTIAL,36800,0,36800,101700,0,138500
113515201200000,NE 105,RESIDENTIAL,36800,0,36800,85300,0,122100
113515201300000,NE 105,RESIDENTIAL,36800,0,36800,114100,0,150900
113515201400000,NE 105,RESIDENTIAL,30000,0,30000,140300,0,170300
113515201500000,NE 105,RESIDENTIAL,37200,0,37200,111200,0,148400
113515201600000,NE 105,RESIDENTIAL,35000,0,35000,122300,0,157300
113515201700000,NE 105,RESIDENTIAL,37400,0,37400,125400,0,162800
113515201800000,NE 105,RESIDENTIAL,39800,0,39800,128600,0,168400
113515201900000,NE 106,RESIDENTIAL,64700,0,64700,271900,0,336600
113515202000000,NE 106,RESIDENTIAL,60700,0,60700,185100,0,245800
113515202100000,NE 106,RESIDENTIAL,62500,0,62500,255800,0,318300
113515202200000,NE 106,RESIDENTIAL,65600,0,65600,214900,0,280500
113515202300000,NE 106,RESIDENTIAL,63900,0,63900,239300,0,303200
113515202400000,NE 106,RESIDENTIAL,62100,0,62100,243500,0,305600
113515202500000,NE 106,RESIDENTIAL,59100,0,59100,239100,0,298200
113515202600000,NE 106,RESIDENTIAL,56800,0,56800,277500,0,334300
113515202700000,NE 106,RESIDENTIAL,58300,0,58300,302800,0,361100
113515202800000,NE 106,RESIDENTIAL,55000,0,55000,250800,0,305800
113515203100000,NE 106,RESIDENTIAL,66600,0,66600,209600,0,276200
113515203200000,NE 106,RESIDENTIAL,62200,0,62200,317100,0,379300
113515203300000,NE 106,RESIDENTIAL,58000,0,58000,324600,0,382600
113515203400000,NE 106,RESIDENTIAL,49500,0,49500,260000,0,309500
113515203500000,NE 106,RESIDENTIAL,62100,0,62100,266900,0,329000
113515203600000,NE 106,RESIDENTIAL,66100,0,66100,255900,0,322000
113515203700000,NE 106,RESIDENTIAL,64100,0,64100,297500,0,361600
113515203800000,NE 106,RESIDENTIAL,59400,0,59400,266700,0,326100
113515203900000,NE 106,RESIDENTIAL,61000,0,61000,225100,0,286100
113515204000000,NE 106,RESIDENTIAL,64000,0,64000,268900,0,332900
113515204100000,NE 106,RESIDENTIAL,55400,0,55400,262300,0,317700
113515204200000,NE 106,RESIDENTIAL,55400,0,55400,241500,0,296900
113515204300000,NE 106,RESIDENTIAL,58300,0,58300,246500,0,304800
113515204400000,NE 106,RESIDENTIAL,55400,0,55400,265400,0,320800
113515204500000,NE 106,RESIDENTIAL,55400,0,55400,298900,0,354300
113515204600000,NE 106,RESIDENTIAL,64700,0,64700,269300,0,334000
113515204700000,NE 106,RESIDENTIAL,83600,0,83600,277700,0,361300
113515300100000,NE 106,RESIDENTIAL,58800,0,58800,244900,0,303700
113515300200000,NE 106,RESIDENTIAL,59400,0,59400,310300,0,369700
113515300300000,NE 106,RESIDENTIAL,57000,0,57000,290400,0,347400
113515300400000,NE 106,RESIDENTIAL,50300,0,50300,259300,0,309600
113515300500000,NE 106,RESIDENTIAL,53500,0,53500,235400,0,288900
113515300600000,NE 106,RESIDENTIAL,55600,0,55600,294100,0,349700
113515300700000,NE 106,RESIDENTIAL,55600,0,55600,313000,0,368600
113515300800000,NE 106,RESIDENTIAL,55600,0,55600,232800,0,288400
113515300900000,NE 106,RESIDENTIAL,53700,0,53700,271800,0,325500
113515301000000,NE 106,RESIDENTIAL,65600,0,65600,215800,0,281400
113515301100000,NE 106,RESIDENTIAL,66600,0,66600,302800,0,369400
113515301200000,NE 106,RESIDENTIAL,58300,0,58300,292000,0,350300
113515301300000,NE 106,RESIDENTIAL,59600,0,59600,307800,0,367400
113515301400000,NE 106,RESIDENTIAL,62800,0,62800,293800,0,356600
113515400100000,NE 105,RESIDENTIAL,35000,0,35000,102100,0,137100
113515400200000,NE 105,RESIDENTIAL,28200,0,28200,119900,0,148100
113515400300000,NE 105,RESIDENTIAL,28200,0,28200,117000,0,145200
113515400400000,NE 105,RESIDENTIAL,33200,0,33200,151000,0,184200
113515400500000,NE 105,RESIDENTIAL,34700,0,34700,149500,0,184200
113515400600000,FITNESS CENTER,COMMERCIAL,0,63200,63200,0,108500,171700
113515500100000,SCHOOL,EXEMPT,0,0,0,0,0,0
113520100100000,NE 160,RESIDENTIAL,48000,0,48000,168400,0,216400
113520100200000,NE 160,RESIDENTIAL,48600,0,48600,210300,0,258900
113520100300000,NE 160,RESIDENTIAL,47700,0,47700,156200,0,203900
113520200100000,NE 160,RESIDENTIAL,49400,0,49400,207200,0,256600
113520200200000,NE 160,RESIDENTIAL,49700,0,49700,214700,0,264400
113520300200000,NE 160,RESIDENTIAL,65200,0,65200,197300,0,262500
113520300300000,NE 105,RESIDENTIAL,36800,0,36800,147800,0,184600
113520300400000,NE 105,RESIDENTIAL,31000,0,31000,124700,0,155700
113520400100000,NE 160,RESIDENTIAL,49000,0,49000,151400,0,200400
113520400200000,NE 160,RESIDENTIAL,47200,0,47200,199400,0,246600
113520400300000,NE 160,RESIDENTIAL,47200,0,47200,163500,0,210700
113520400400000,NE 160,RESIDENTIAL,47200,0,47200,215500,0,262700
113520400500000,NE 160,RESIDENTIAL,49600,0,49600,188500,0,238100
113520400600000,NE 160,RESIDENTIAL,48600,0,48600,194300,0,242900
113520400700000,NE 160,RESIDENTIAL,47600,0,47600,148900,0,196500
113520400800000,NE 160,RESIDENTIAL,50000,0,50000,192300,0,242300
113520400900000,NE 160,RESIDENTIAL,47600,0,47600,177900,0,225500
113520401000000,NE 160,RESIDENTIAL,47600,0,47600,177200,0,224800
113520401100000,NE 160,RESIDENTIAL,50000,0,50000,195300,0,245300
113520401200000,NE 160,RESIDENTIAL,50100,0,50100,191800,0,241900
113520401300000,NE 160,RESIDENTIAL,52100,0,52100,196600,0,248700
113520401400000,NE 160,RESIDENTIAL,47000,0,47000,188900,0,235900
113520401500000,NE 160,RESIDENTIAL,51500,0,51500,211200,0,262700
113520401600000,NE 105,RESIDENTIAL,40400,0,40400,200200,0,240600
113520401700000,NE 105,RESIDENTIAL,39500,0,39500,159200,0,198700
113520401800000,NE 105,RESIDENTIAL,38700,0,38700,162000,0,200700
113520401900000,NE 105,RESIDENTIAL,40200,0,40200,165200,0,205400
113520402000000,NE 105,RESIDENTIAL,38800,0,38800,179000,0,217800
113520402100000,NE 105,RESIDENTIAL,40500,0,40500,178100,0,218600
113520402200000,NE 105,RESIDENTIAL,40200,0,40200,164300,0,204500
113520402300000,NE 105,RESIDENTIAL,39800,0,39800,157700,0,197500
113520402400000,NE 105,RESIDENTIAL,40100,0,40100,164900,0,205000
113520402500000,NE 105,RESIDENTIAL,40100,0,40100,175400,0,215500
113520402600000,NE 105,RESIDENTIAL,40400,0,40400,166800,0,207200
113520402700000,NE 105,RESIDENTIAL,42100,0,42100,157100,0,199200
113520402800000,NE 105,RESIDENTIAL,42300,0,42300,187800,0,230100
113520402900000,NE 105,RESIDENTIAL,40500,0,40500,144100,0,184600
113520403000000,NE 105,RESIDENTIAL,39100,0,39100,154700,0,193800
113520403100000,NE 105,RESIDENTIAL,36700,0,36700,156700,0,193400
113520403200000,NE 105,RESIDENTIAL,37100,0,37100,174100,0,211200
113520403300000,NE 105,RESIDENTIAL,37600,0,37600,166500,0,204100
113520403400000,NE 105,RESIDENTIAL,38700,0,38700,172000,0,210700
113520403500000,NE 105,RESIDENTIAL,37500,0,37500,158100,0,195600
113520403600000,NE 105,RESIDENTIAL,37900,0,37900,178400,0,216300
113520403700000,NE 105,RESIDENTIAL,39800,0,39800,164300,0,204100
113520403800000,NE 105,RESIDENTIAL,39600,0,39600,146600,0,186200
113520403900000,NE 105,RESIDENTIAL,36700,0,36700,154300,0,191000
113520404000000,NE 105,RESIDENTIAL,36700,0,36700,138200,0,174900
113520404100000,NE 105,RESIDENTIAL,39500,0,39500,148800,0,188300
113520404200000,NE 105,RESIDENTIAL,39100,0,39100,159300,0,198400
113520404300000,NE 105,RESIDENTIAL,39600,0,39600,161000,0,200600
113520404400000,NE 105,RESIDENTIAL,39000,0,39000,157600,0,196600
113520404500000,NE 105,RESIDENTIAL,39100,0,39100,154300,0,193400
113520404600000,NE 105,RESIDENTIAL,35900,0,35900,142500,0,178400
113520404700000,NE 105,RESIDENTIAL,39100,0,39100,144400,0,183500
113520404800000,NE 105,RESIDENTIAL,39100,0,39100,160800,0,199900
113520404900000,NE 105,RESIDENTIAL,36700,0,36700,159700,0,196400
113520405000000,NE 105,RESIDENTIAL,41400,0,41400,166100,0,207500
113520405100000,NE 160,RESIDENTIAL,49700,0,49700,162400,0,212100
113520405200000,NE 160,RESIDENTIAL,54400,0,54400,200800,0,255200
113520500100000,NE 105,RESIDENTIAL,40600,0,40600,153800,0,194400
113520500200000,NE 105,RESIDENTIAL,33300,0,33300,132800,0,166100
113520500300000,NE 105,RESIDENTIAL,33300,0,33300,127800,0,161100
113520500400000,NE 105,RESIDENTIAL,33300,0,33300,185100,0,218400
113520500500000,NE 105,RESIDENTIAL,38000,0,38000,137700,0,175700
113520500600000,NE 105,RESIDENTIAL,38000,0,38000,162400,0,200400
113520600100000,NE 105,RESIDENTIAL,40600,0,40600,171800,0,212400
113520600200000,NE 105,RESIDENTIAL,33100,0,33100,134600,0,167700
113520600300000,NE 105,RESIDENTIAL,37600,0,37600,136000,0,173600
113520600400000,NE 105,RESIDENTIAL,35300,0,35300,132500,0,167800
113520600500000,NE 105,RESIDENTIAL,37600,0,37600,139900,0,177500
113520600600000,NE 105,RESIDENTIAL,35300,0,35300,129900,0,165200
113520600700000,NE 105,RESIDENTIAL,34900,0,34900,137400,0,172300
113520600800000,NE 105,RESIDENTIAL,40700,0,40700,133800,0,174500
113520600900000,NE 105,RESIDENTIAL,36000,0,36000,146500,0,182500
113520601000000,NE 105,RESIDENTIAL,35900,0,35900,153700,0,189600
113520601100000,NE 105,RESIDENTIAL,40700,0,40700,164100,0,204800
113520601200000,NE 105,RESIDENTIAL,40600,0,40600,167500,0,208100
113520601300000,NE 105,RESIDENTIAL,39500,0,39500,176100,0,215600
113520601400000,NE 105,RESIDENTIAL,40400,0,40400,132400,0,172800
113520601500000,NE 105,RESIDENTIAL,41600,0,41600,141800,0,183400
113520601600000,NE 105,RESIDENTIAL,42900,0,42900,176500,0,219400
113520601700000,NE 105,RESIDENTIAL,40200,0,40200,176800,0,217000
113520601800000,NE 105,RESIDENTIAL,40500,0,40500,163300,0,203800
113520601900000,NE 105,RESIDENTIAL,40600,0,40600,165500,0,206100
113520602000000,NE 105,RESIDENTIAL,36100,0,36100,134800,0,170900
113520700100000,NE 105,RESIDENTIAL,41000,0,41000,154800,0,195800
113520700200000,NE 105,RESIDENTIAL,32900,0,32900,142000,0,174900
113520700300000,NE 105,RESIDENTIAL,35000,0,35000,141300,0,176300
113520700400000,NE 105,RESIDENTIAL,40800,0,40800,166600,0,207400
113520700500000,NE 105,RESIDENTIAL,40300,0,40300,157200,0,197500
113520700600000,NE 105,RESIDENTIAL,40300,0,40300,158100,0,198400
113520700700000,NE 105,RESIDENTIAL,40800,0,40800,173300,0,214100
113520700800000,NE 105,RESIDENTIAL,40400,0,40400,154100,0,194500
113520700900000,NE 105,RESIDENTIAL,34600,0,34600,147100,0,181700
113520701000000,NE 105,RESIDENTIAL,37200,0,37200,161300,0,198500
113520701100000,NE 105,RESIDENTIAL,35000,0,35000,128400,0,163400
113520701200000,NE 105,RESIDENTIAL,33900,0,33900,155400,0,189300
113520800100000,NE 105,RESIDENTIAL,40200,0,40200,145300,0,185500
113520800200000,NE 105,RESIDENTIAL,30200,0,30200,119900,0,150100
113520800300000,NE 105,RESIDENTIAL,31300,0,31300,153000,0,184300
113520800400000,NE 105,RESIDENTIAL,41600,0,41600,143800,0,185400
113522600100000,NE 105,RESIDENTIAL,38600,0,38600,160000,0,198600
113522600200000,NE 105,RESIDENTIAL,39900,0,39900,187800,0,227700
113522600300000,NE 105,RESIDENTIAL,38000,0,38000,141900,0,179900
113522600400000,NE 105,RESIDENTIAL,38200,0,38200,157900,0,196100
113522600500000,NE 105,RESIDENTIAL,37300,0,37300,155500,0,192800
113522600600000,NE 105,RESIDENTIAL,36800,0,36800,185100,0,221900
113522600700000,NE 105,RESIDENTIAL,35900,0,35900,162900,0,198800
113522600800000,NE 105,RESIDENTIAL,38300,0,38300,161600,0,199900
113522600900000,NE 105,RESIDENTIAL,37800,0,37800,121200,0,159000
113522601000000,NE 105,RESIDENTIAL,40200,0,40200,161300,0,201500
113522601100000,NE 105,RESIDENTIAL,46000,0,46000,155500,0,201500
113522601200000,NE 105,RESIDENTIAL,39300,0,39300,172700,0,212000
113522601300000,NE 105,RESIDENTIAL,40800,0,40800,185900,0,226700
113522700100000,NE 105,RESIDENTIAL,44600,0,44600,160700,0,205300
113522700200000,NE 105,RESIDENTIAL,41800,0,41800,200500,0,242300
113522700300000,NE 105,RESIDENTIAL,41100,0,41100,196700,0,237800
113522700400000,NE 105,RESIDENTIAL,40800,0,40800,160400,0,201200
113522700500000,NE 105,RESIDENTIAL,40300,0,40300,161500,0,201800
113522700600000,NE 105,RESIDENTIAL,40500,0,40500,162300,0,202800
113522700700000,NE 105,RESIDENTIAL,37100,0,37100,156700,0,193800
113522700800000,NE 105,RESIDENTIAL,40300,0,40300,171300,0,211600
113522800100000,NE 105,RESIDENTIAL,43300,0,43300,158700,0,202000
113522800200000,NE 105,RESIDENTIAL,41100,0,41100,167700,0,208800
113522800300000,NE 105,RESIDENTIAL,41700,0,41700,116100,0,157800
113522800400000,NE 105,RESIDENTIAL,35700,0,35700,164500,0,200200
113522800500000,NE 105,RESIDENTIAL,32700,0,32700,156900,0,189600
113522800600000,NE 105,RESIDENTIAL,39000,0,39000,153100,0,192100
113522800700000,NE 105,RESIDENTIAL,36000,0,36000,148000,0,184000
113522800800000,NE 105,RESIDENTIAL,38800,0,38800,168800,0,207600
113522800900000,NE 105,RESIDENTIAL,38400,0,38400,161900,0,200300
113522801000000,NE 105,RESIDENTIAL,37400,0,37400,144500,0,181900
113522801100000,NE 105,RESIDENTIAL,40900,0,40900,162900,0,203800
113522801200000,NE 105,RESIDENTIAL,39900,0,39900,133300,0,173200
113522801300000,NE 105,RESIDENTIAL,38800,0,38800,144300,0,183100
113522801400000,NE 105,RESIDENTIAL,36300,0,36300,139200,0,175500
113522801500000,NE 105,RESIDENTIAL,38800,0,38800,130600,0,169400
113522801600000,NE 105,RESIDENTIAL,36300,0,36300,140500,0,176800
113522801700000,NE 105,RESIDENTIAL,38800,0,38800,159200,0,198000
113522801800000,NE 105,RESIDENTIAL,36300,0,36300,154900,0,191200
113522801900000,NE 105,RESIDENTIAL,41200,0,41200,160400,0,201600
113522802000000,NE 105,RESIDENTIAL,39700,0,39700,162400,0,202100
113522802100000,NE 105,RESIDENTIAL,37100,0,37100,146200,0,183300
113522900100000,NE 105,RESIDENTIAL,40700,0,40700,169800,0,210500
113522900200000,NE 105,RESIDENTIAL,35900,0,35900,159600,0,195500
113522900300000,NE 105,RESIDENTIAL,39900,0,39900,155000,0,194900
113522900400000,NE 105,RESIDENTIAL,41100,0,41100,143200,0,184300
113522900500000,NE 105,RESIDENTIAL,35400,0,35400,146400,0,181800
113522900600000,NE 105,RESIDENTIAL,35400,0,35400,131400,0,166800
113522900700000,NE 105,RESIDENTIAL,40200,0,40200,144000,0,184200
113522900800000,NE 105,RESIDENTIAL,38400,0,38400,172300,0,210700
113522900900000,NE 105,RESIDENTIAL,37400,0,37400,131100,0,168500
113522901000000,NE 105,RESIDENTIAL,40000,0,40000,120100,0,160100
113522901100000,NE 105,RESIDENTIAL,37300,0,37300,158000,0,195300
113522901200000,NE 105,RESIDENTIAL,36400,0,36400,176900,0,213300
113523000100000,NE 105,RESIDENTIAL,40000,0,40000,162500,0,202500
113523000200000,NE 105,RESIDENTIAL,38400,0,38400,174200,0,212600
113523000300000,NE 105,RESIDENTIAL,38600,0,38600,157600,0,196200
113523000400000,NE 105,RESIDENTIAL,39400,0,39400,147100,0,186500
113523000500000,NE 105,RESIDENTIAL,39500,0,39500,145700,0,185200
113523000600000,NE 105,RESIDENTIAL,39500,0,39500,174900,0,214400
113523000700000,NE 105,RESIDENTIAL,37500,0,37500,157900,0,195400
113523000800000,NE 105,RESIDENTIAL,41300,0,41300,170700,0,212000
113523000900000,NE 105,RESIDENTIAL,38900,0,38900,174900,0,213800
113523001000000,NE 105,RESIDENTIAL,38600,0,38600,155000,0,193600
113523001100000,NE 105,RESIDENTIAL,38800,0,38800,150000,0,188800
113523001200000,NE 105,RESIDENTIAL,38100,0,38100,148200,0,186300
113523001300000,NE 105,RESIDENTIAL,37000,0,37000,163600,0,200600
113523001400000,NE 105,RESIDENTIAL,37500,0,37500,170300,0,207800
113523001500000,NE 105,RESIDENTIAL,36000,0,36000,167400,0,203400
113523001600000,NE 105,RESIDENTIAL,40000,0,40000,171900,0,211900
113523001700000,NE 105,RESIDENTIAL,35600,0,35600,142000,0,177600
113523001800000,NE 105,RESIDENTIAL,38700,0,38700,150200,0,188900
113523001900000,NE 105,RESIDENTIAL,40400,0,40400,131300,0,171700
113523002000000,NE 105,RESIDENTIAL,40000,0,40000,176000,0,216000
113523002100000,NE 105,RESIDENTIAL,36000,0,36000,143300,0,179300
113523002200000,NE 105,RESIDENTIAL,38400,0,38400,151500,0,189900
113523002300000,NE 105,RESIDENTIAL,41600,0,41600,156100,0,197700
113523002400000,NE 105,RESIDENTIAL,36000,0,36000,155100,0,191100
113523002500000,NE 105,RESIDENTIAL,38400,0,38400,129100,0,167500
113523002600000,NE 105,RESIDENTIAL,41100,0,41100,153100,0,194200
113523002700000,NE 105,RESIDENTIAL,40600,0,40600,158300,0,198900
113523002800000,NE 105,RESIDENTIAL,40200,0,40200,128500,0,168700
113523002900000,NE 105,RESIDENTIAL,39300,0,39300,155400,0,194700
113523003000000,NE 105,RESIDENTIAL,41500,0,41500,132900,0,174400
113523003100000,NE 105,RESIDENTIAL,37500,0,37500,141300,0,178800
113523003200000,NE 105,RESIDENTIAL,38300,0,38300,137500,0,175800
113523003300000,NE 105,RESIDENTIAL,32700,0,32700,133200,0,165900
113523003400000,NE 105,RESIDENTIAL,40000,0,40000,127800,0,167800
113523003500000,NE 105,RESIDENTIAL,41600,0,41600,154200,0,195800
113523003600000,NE 105,RESIDENTIAL,34700,0,34700,125300,0,160000
113523003700000,NE 105,RESIDENTIAL,38900,0,38900,149800,0,188700
113523003800000,NE 105,RESIDENTIAL,36100,0,36100,145000,0,181100
113523003900000,NE 105,RESIDENTIAL,38900,0,38900,146700,0,185600
113523004000000,NE 105,RESIDENTIAL,37700,0,37700,140400,0,178100
113523004100000,NE 105,RESIDENTIAL,40800,0,40800,150500,0,191300
113523004200000,NE 105,RESIDENTIAL,40500,0,40500,165100,0,205600
113523004300000,NE 105,RESIDENTIAL,39800,0,39800,166700,0,206500
113523004400000,NE 105,RESIDENTIAL,39900,0,39900,155600,0,195500
113523004500000,NE 105,RESIDENTIAL,39900,0,39900,155800,0,195700
113523004600000,NE 105,RESIDENTIAL,39000,0,39000,152000,0,191000
113523004700000,NE 105,RESIDENTIAL,38800,0,38800,130200,0,169000
113523004800000,NE 105,RESIDENTIAL,39200,0,39200,168300,0,207500
113523100100000,NE 105,RESIDENTIAL,41600,0,41600,159200,0,200800
113523100200000,NE 105,RESIDENTIAL,37700,0,37700,161000,0,198700
113523100300000,NE 105,RESIDENTIAL,37900,0,37900,154900,0,192800
113523100400000,NE 105,RESIDENTIAL,40900,0,40900,175300,0,216200
113523100500000,NE 105,RESIDENTIAL,41700,0,41700,179800,0,221500
113523100600000,NE 105,RESIDENTIAL,40300,0,40300,166300,0,206600
113523100700000,NE 105,RESIDENTIAL,40200,0,40200,160600,0,200800
113523100800000,NE 105,RESIDENTIAL,41600,0,41600,138700,0,180300
113523100900000,NE 105,RESIDENTIAL,40400,0,40400,153600,0,194000
113525100100000,NE 105,RESIDENTIAL,40000,0,40000,124200,0,164200
113525100200000,NE 105,RESIDENTIAL,36700,0,36700,143900,0,180600
113525100300000,NE 105,RESIDENTIAL,36100,0,36100,174600,0,210700
113525100400000,NE 105,RESIDENTIAL,36500,0,36500,154900,0,191400
113525100500000,NE 105,RESIDENTIAL,36900,0,36900,152700,0,189600
113525100600000,NE 105,RESIDENTIAL,35300,0,35300,129000,0,164300
113525100700000,NE 105,RESIDENTIAL,38000,0,38000,156100,0,194100
113525100800000,NE 105,RESIDENTIAL,40400,0,40400,152000,0,192400
113525100900000,NE 105,RESIDENTIAL,38000,0,38000,162800,0,200800
113525101000000,NE 105,RESIDENTIAL,44900,0,44900,159300,0,204200
113525101100000,NE 105,RESIDENTIAL,38000,0,38000,168800,0,206800
113525101200000,NE 105,RESIDENTIAL,38000,0,38000,171600,0,209600
113525101300000,NE 105,RESIDENTIAL,38000,0,38000,156700,0,194700
113525101400000,NE 105,RESIDENTIAL,34200,0,34200,0,0,34200
113525101500000,NE 105,RESIDENTIAL,38000,0,38000,161600,0,199600
113525101600000,NE 105,RESIDENTIAL,37700,0,37700,116600,0,154300
113525101700000,NE 105,RESIDENTIAL,41500,0,41500,132400,0,173900
113525101800000,NE 105,RESIDENTIAL,36700,0,36700,165200,0,201900
113525200100000,NE 105,RESIDENTIAL,41000,0,41000,154400,0,195400
113525200200000,NE 105,RESIDENTIAL,41100,0,41100,173500,0,214600
113525200300000,NE 105,RESIDENTIAL,44100,0,44100,195900,0,240000
113525200400000,NE 105,RESIDENTIAL,46100,0,46100,177300,0,223400
113525200500000,NE 105,RESIDENTIAL,41300,0,41300,174100,0,215400
113525200600000,NE 105,RESIDENTIAL,37800,0,37800,175200,0,213000
113525200700000,NE 105,RESIDENTIAL,37200,0,37200,0,0,37200
113525200800000,NE 105,RESIDENTIAL,36600,0,36600,137200,0,173800
113525300100000,NE 105,RESIDENTIAL,33200,0,33200,106900,0,140100
113525300200000,NE 105,RESIDENTIAL,32800,0,32800,117900,0,150700
113525300300000,NE 105,RESIDENTIAL,39500,0,39500,95900,0,135400
113525300400000,NE 105,RESIDENTIAL,32900,0,32900,110300,0,143200
113525300500000,NE 105,RESIDENTIAL,39900,0,39900,94400,0,134300
113525300600000,NE 105,RESIDENTIAL,37100,0,37100,125200,0,162300
113525300700000,NE 105,RESIDENTIAL,33600,0,33600,128300,0,161900
113525300800000,NE 105,RESIDENTIAL,33900,0,33900,114800,0,148700
113525300900000,NE 105,RESIDENTIAL,31600,0,31600,115200,0,146800
113525301000000,NE 105,RESIDENTIAL,34500,0,34500,112500,0,147000
113525301100000,NE 107,RESIDENTIAL,29300,0,29300,131200,0,160500
113525301200000,NE 107,RESIDENTIAL,28900,0,28900,129300,0,158200
113525301300000,NE 107,RESIDENTIAL,26900,0,26900,104700,0,131600
113525301400000,NE 107,RESIDENTIAL,31500,0,31500,102000,0,133500
113525301500000,NE 107,RESIDENTIAL,28300,0,28300,99800,0,128100
113525301600000,NE 107,RESIDENTIAL,30700,0,30700,101300,0,132000
113525301700000,NE 107,RESIDENTIAL,30600,0,30600,122800,0,153400
113525301800000,NE 107,RESIDENTIAL,31000,0,31000,126000,0,157000
113525301900000,NE 107,RESIDENTIAL,31600,0,31600,90700,0,122300
113525302000000,NE 107,RESIDENTIAL,29200,0,29200,98300,0,127500
113525302100000,NE 107,RESIDENTIAL,29200,0,29200,119000,0,148200
113525302200000,NE 107,RESIDENTIAL,29200,0,29200,106500,0,135700
113525302300000,NE 107,RESIDENTIAL,29200,0,29200,113500,0,142700
113525400100000,NE 105,RESIDENTIAL,47900,0,47900,216800,0,264700
113525400200000,NE 105,RESIDENTIAL,44500,0,44500,183200,0,227700
113525400300000,NE 105,RESIDENTIAL,49900,0,49900,208400,0,258300
113525400400000,NE 105,RESIDENTIAL,36100,0,36100,111600,0,147700
113525400500000,NE 107,RESIDENTIAL,31200,0,31200,127400,0,158600
113525400600000,NE 107,RESIDENTIAL,30200,0,30200,93100,0,123300
113525400700000,NE 107,RESIDENTIAL,29600,0,29600,117900,0,147500
113525400800000,NE 107,RESIDENTIAL,29800,0,29800,105200,0,135000
113525400900000,NE 107,RESIDENTIAL,30200,0,30200,120000,0,150200
113525401000000,NE 107,RESIDENTIAL,28900,0,28900,122500,0,151400
113525401100000,NE 107,RESIDENTIAL,30800,0,30800,120600,0,151400
113525401200000,NE 107,RESIDENTIAL,31100,0,31100,104800,0,135900
113525401300000,NE 107,RESIDENTIAL,26200,0,26200,116400,0,142600
113525401400000,NE 107,RESIDENTIAL,27800,0,27800,108800,0,136600
113525401500000,NE 107,RESIDENTIAL,31500,0,31500,88600,0,120100
113525401600000,NE 107,RESIDENTIAL,28800,0,28800,101700,0,130500
113525401700000,NE 107,RESIDENTIAL,36700,0,36700,147900,0,184600
113525401800000,NE 107,RESIDENTIAL,38500,0,38500,148600,0,187100
113525401900000,NE 107,RESIDENTIAL,36500,0,36500,171000,0,207500
113525402000000,NE 107,RESIDENTIAL,35900,0,35900,149700,0,185600
113525402100000,NE 107,RESIDENTIAL,37300,0,37300,183300,0,220600
113525402200000,NE 107,RESIDENTIAL,30300,0,30300,90200,0,120500
113525402300000,NE 107,RESIDENTIAL,30300,0,30300,100100,0,130400
113525500100000,NE 107,RESIDENTIAL,27300,0,27300,109900,0,137200
113525500200000,NE 107,RESIDENTIAL,27100,0,27100,104500,0,131600
113525500300000,NE 107,RESIDENTIAL,27000,0,27000,111300,0,138300
113525500400000,NE 107,RESIDENTIAL,29000,0,29000,119800,0,148800
113525500500000,NE 107,RESIDENTIAL,29800,0,29800,109900,0,139700
113525500600000,NE 107,RESIDENTIAL,29400,0,29400,130100,0,159500
113525500700000,NE 107,RESIDENTIAL,29600,0,29600,115200,0,144800
113525500800000,NE 107,RESIDENTIAL,25800,0,25800,86100,0,111900
113525500900000,NE 107,RESIDENTIAL,25100,0,25100,126600,0,151700
113525501000000,NE 107,RESIDENTIAL,29700,0,29700,126700,0,156400
113525501100000,NE 107,RESIDENTIAL,28100,0,28100,102600,0,130700
113525501200000,NE 107,RESIDENTIAL,26600,0,26600,128800,0,155400
113525501300000,NE 107,RESIDENTIAL,30700,0,30700,162300,0,193000
113525501400000,NE 107,RESIDENTIAL,30200,0,30200,114900,0,145100
113525501500000,NE 107,RESIDENTIAL,31400,0,31400,106800,0,138200
113525501600000,NE 107,RESIDENTIAL,31500,0,31500,118100,0,149600
113525501700000,NE 107,RESIDENTIAL,31900,0,31900,119200,0,151100
113525501800000,NE 107,RESIDENTIAL,31600,0,31600,116100,0,147700
113525501900000,NE 107,RESIDENTIAL,31600,0,31600,140500,0,172100
113525502000000,NE 107,RESIDENTIAL,31600,0,31600,134300,0,165900
113525502100000,NE 107,RESIDENTIAL,31600,0,31600,131100,0,162700
113525600100000,NE 107,RESIDENTIAL,28500,0,28500,122100,0,150600
113525600200000,NE 107,RESIDENTIAL,31200,0,31200,117800,0,149000
113525600300000,NE 107,RESIDENTIAL,30900,0,30900,91900,0,122800
113525600400000,NE 107,RESIDENTIAL,32200,0,32200,129900,0,162100
113525600500000,NE 107,RESIDENTIAL,31900,0,31900,109200,0,141100
113525600600000,NE 107,RESIDENTIAL,31100,0,31100,105100,0,136200
113525600700000,NE 107,RESIDENTIAL,30900,0,30900,114000,0,144900
113525600800000,NE 107,RESIDENTIAL,30700,0,30700,128000,0,158700
113525600900000,NE 107,RESIDENTIAL,32600,0,32600,150300,0,182900
113525601000000,NE 107,RESIDENTIAL,31900,0,31900,116900,0,148800
113525601100000,NE 107,RESIDENTIAL,29200,0,29200,109800,0,139000
113525700100000,NE 107,RESIDENTIAL,31000,0,31000,89400,0,120400
113525700200000,NE 107,RESIDENTIAL,31400,0,31400,131000,0,162400
113525700300000,NE 107,RESIDENTIAL,30800,0,30800,110000,0,140800
113525700400000,NE 107,RESIDENTIAL,31500,0,31500,133200,0,164700
113525800100000,NE 107,RESIDENTIAL,32500,0,32500,112700,0,145200
113525800200000,NE 107,RESIDENTIAL,31600,0,31600,106600,0,138200
113525800300000,NE 107,RESIDENTIAL,30600,0,30600,114900,0,145500
113525800400000,NE 107,RESIDENTIAL,31600,0,31600,111200,0,142800
113525800500000,NE 107,RESIDENTIAL,30900,0,30900,108200,0,139100
113525800600000,NE 107,RESIDENTIAL,28600,0,28600,112400,0,141000
113525800700000,NE 107,RESIDENTIAL,24800,0,24800,108600,0,133400
113527600100000,NE 105,RESIDENTIAL,33300,0,33300,126100,0,159400
113527600200000,NE 105,RESIDENTIAL,35600,0,35600,149500,0,185100
113527600300000,NE 105,RESIDENTIAL,39400,0,39400,149900,0,189300
113527600400000,NE 105,RESIDENTIAL,37900,0,37900,152500,0,190400
113527700100000,NE 105,RESIDENTIAL,42000,0,42000,155900,0,197900
113527700200000,NE 105,RESIDENTIAL,35000,0,35000,138300,0,173300
113527700300000,NE 105,RESIDENTIAL,36400,0,36400,155400,0,191800
113527700400000,NE 105,RESIDENTIAL,38000,0,38000,133100,0,171100
113527700500000,NE 105,RESIDENTIAL,37600,0,37600,162300,0,199900
113527700600000,NE 105,RESIDENTIAL,30400,0,30400,136900,0,167300
113527700700000,NE 105,RESIDENTIAL,33900,0,33900,160100,0,194000
113527700800000,NE 105,RESIDENTIAL,38800,0,38800,149200,0,188000
113527700900000,NE 105,RESIDENTIAL,41400,0,41400,136800,0,178200
113527701000000,NE 105,RESIDENTIAL,37200,0,37200,150500,0,187700
113527701100000,NE 105,RESIDENTIAL,37200,0,37200,152500,0,189700
113527701200000,NE 105,RESIDENTIAL,32600,0,32600,122000,0,154600
113527701300000,NE 105,RESIDENTIAL,36300,0,36300,132000,0,168300
113527701400000,NE 105,RESIDENTIAL,41700,0,41700,124100,0,165800
113527701500000,NE 105,RESIDENTIAL,37100,0,37100,166500,0,203600
113527701600000,NE 105,RESIDENTIAL,32200,0,32200,157100,0,189300
113527701700000,NE 105,RESIDENTIAL,40700,0,40700,135700,0,176400
113527701800000,NE 105,RESIDENTIAL,35300,0,35300,135700,0,171000
113527701900000,NE 105,RESIDENTIAL,40100,0,40100,148900,0,189000
113527702000000,NE 105,RESIDENTIAL,39600,0,39600,151800,0,191400
113527800100000,NE 105,RESIDENTIAL,35000,0,35000,151100,0,186100
113527800200000,NE 105,RESIDENTIAL,34000,0,34000,154400,0,188400
113527800300000,NE 105,RESIDENTIAL,33200,0,33200,142700,0,175900
113527800400000,NE 105,RESIDENTIAL,29400,0,29400,136700,0,166100
113527800500000,NE 105,RESIDENTIAL,34100,0,34100,167100,0,201200
113527800600000,NE 105,RESIDENTIAL,40600,0,40600,141400,0,182000
113527800700000,NE 105,RESIDENTIAL,40600,0,40600,129700,0,170300
113527800800000,NE 105,RESIDENTIAL,36100,0,36100,154600,0,190700
113527800900000,NE 105,RESIDENTIAL,29000,0,29000,138200,0,167200
113527801000000,NE 105,RESIDENTIAL,29000,0,29000,132100,0,161100
113527900100000,NE 105,RESIDENTIAL,33800,0,33800,156700,0,190500
113527900200000,NE 105,RESIDENTIAL,38800,0,38800,148400,0,187200
113527900300000,NE 105,RESIDENTIAL,40500,0,40500,141800,0,182300
113527900400000,NE 105,RESIDENTIAL,40600,0,40600,151300,0,191900
113527900500000,NE 105,RESIDENTIAL,40600,0,40600,157300,0,197900
113527900600000,NE 105,RESIDENTIAL,36100,0,36100,164100,0,200200
113527900700000,NE 105,RESIDENTIAL,31600,0,31600,151800,0,183400
113527900800000,NE 105,RESIDENTIAL,31100,0,31100,156800,0,187900
113528000100000,NE 105,RESIDENTIAL,34700,0,34700,148000,0,182700
113528000200000,NE 107,RESIDENTIAL,26600,0,26600,147500,0,174100
113528000300000,NE 107,RESIDENTIAL,29200,0,29200,160200,0,189400
113528000400000,NE 107,RESIDENTIAL,31700,0,31700,113300,0,145000
113528000500000,NE 107,RESIDENTIAL,31700,0,31700,147900,0,179600
113528000600000,NE 107,RESIDENTIAL,30700,0,30700,105900,0,136600
113528000700000,NE 107,RESIDENTIAL,30900,0,30900,122100,0,153000
113528000800000,NE 107,RESIDENTIAL,31900,0,31900,139400,0,171300
113528000900000,NE 107,RESIDENTIAL,30900,0,30900,108700,0,139600
113528100100000,NE 105,RESIDENTIAL,39300,0,39300,113600,0,152900
113528100200000,NE 105,RESIDENTIAL,32300,0,32300,132600,0,164900
113528100300000,NE 105,RESIDENTIAL,36200,0,36200,143800,0,180000
113528100400000,NE 105,RESIDENTIAL,29500,0,29500,139300,0,168800
113528100500000,NE 105,RESIDENTIAL,36600,0,36600,118900,0,155500
113528100600000,NE 105,RESIDENTIAL,31300,0,31300,128500,0,159800
113528100700000,NE 105,RESIDENTIAL,28800,0,28800,142500,0,171300
113528100800000,NE 105,RESIDENTIAL,31300,0,31300,127100,0,158400
113528100900000,NE 105,RESIDENTIAL,37500,0,37500,100300,0,137800
113528101000000,NE 105,RESIDENTIAL,31300,0,31300,102400,0,133700
113528101100000,NE 105,RESIDENTIAL,35900,0,35900,118800,0,154700
113528101200000,NE 107,RESIDENTIAL,25400,0,25400,102100,0,127500
113528101300000,NE 107,RESIDENTIAL,30800,0,30800,131200,0,162000
113528101400000,NE 107,RESIDENTIAL,25800,0,25800,129600,0,155400
113528101500000,NE 107,RESIDENTIAL,25800,0,25800,113600,0,139400
113528101600000,NE 107,RESIDENTIAL,25800,0,25800,147000,0,172800
113528101700000,NE 107,RESIDENTIAL,25800,0,25800,139600,0,165400
113528101800000,NE 107,RESIDENTIAL,25800,0,25800,114700,0,140500
113528101900000,NE 107,RESIDENTIAL,24000,0,24000,103800,0,127800
113528102000000,NE 107,RESIDENTIAL,24000,0,24000,118000,0,142000
113528102100000,NE 107,RESIDENTIAL,24000,0,24000,105700,0,129700
113528102200000,NE 107,RESIDENTIAL,26500,0,26500,121500,0,148000
113528102300000,NE 107,RESIDENTIAL,25100,0,25100,122400,0,147500
113528102400000,NE 107,RESIDENTIAL,27800,0,27800,141700,0,169500
113528102500000,NE 107,RESIDENTIAL,25400,0,25400,127500,0,152900
113528200100000,NE 105,RESIDENTIAL,34100,0,34100,95000,0,129100
113528200200000,NE 105,RESIDENTIAL,32800,0,32800,112000,0,144800
113528200300000,NE 105,RESIDENTIAL,31700,0,31700,126400,0,158100
113528200400000,NE 107,RESIDENTIAL,26400,0,26400,106300,0,132700
113528200500000,NE 107,RESIDENTIAL,26800,0,26800,120100,0,146900
113528200600000,NE 107,RESIDENTIAL,31800,0,31800,137500,0,169300
113528200700000,NE 107,RESIDENTIAL,25900,0,25900,114100,0,140000
113528300100000,NE 107,RESIDENTIAL,30400,0,30400,120400,0,150800
113528300200000,NE 107,RESIDENTIAL,29900,0,29900,128700,0,158600
113528300300000,NE 107,RESIDENTIAL,28600,0,28600,123300,0,151900
113528300400000,NE 107,RESIDENTIAL,27800,0,27800,108400,0,136200
113528300500000,NE 107,RESIDENTIAL,27100,0,27100,121500,0,148600
113528300600000,NE 107,RESIDENTIAL,26300,0,26300,122700,0,149000
113528300700000,NE 107,RESIDENTIAL,25800,0,25800,103100,0,128900
113528300800000,NE 107,RESIDENTIAL,25800,0,25800,122500,0,148300
113528300900000,NE 107,RESIDENTIAL,25800,0,25800,101100,0,126900
113528301000000,NE 107,RESIDENTIAL,25800,0,25800,119900,0,145700
113528301100000,NE 107,RESIDENTIAL,25800,0,25800,87800,0,113600
113528301200000,NE 107,RESIDENTIAL,26000,0,26000,111400,0,137400
113528301300000,NE 107,RESIDENTIAL,26600,0,26600,131400,0,158000
113528301400000,NE 107,RESIDENTIAL,26900,0,26900,105600,0,132500
113528301500000,NE 107,RESIDENTIAL,25600,0,25600,129400,0,155000
113528301600000,NE 107,RESIDENTIAL,25300,0,25300,123900,0,149200
113528301700000,NE 107,RESIDENTIAL,25200,0,25200,120800,0,146000
113528301800000,NE 107,RESIDENTIAL,25200,0,25200,99500,0,124700
113528301900000,NE 107,RESIDENTIAL,26900,0,26900,100400,0,127300
113528302000000,NE 107,RESIDENTIAL,26900,0,26900,119600,0,146500
113528302100000,NE 107,RESIDENTIAL,26900,0,26900,112000,0,138900
113528302200000,NE 107,RESIDENTIAL,27900,0,27900,122600,0,150500
113528302300000,NE 107,RESIDENTIAL,26900,0,26900,109300,0,136200
113528302400000,NE 107,RESIDENTIAL,25800,0,25800,109200,0,135000
113528302500000,NE 107,RESIDENTIAL,26400,0,26400,105800,0,132200
113528302600000,NE 107,RESIDENTIAL,30900,0,30900,138100,0,169000
113528302700000,NE 107,RESIDENTIAL,29600,0,29600,126400,0,156000
113528302800000,NE 107,RESIDENTIAL,30600,0,30600,124200,0,154800
113528302900000,NE 107,RESIDENTIAL,25800,0,25800,101600,0,127400
113528303000000,NE 107,RESIDENTIAL,24400,0,24400,120300,0,144700
113528303100000,NE 107,RESIDENTIAL,26400,0,26400,130000,0,156400
113528400100000,NE 107,RESIDENTIAL,31700,0,31700,98300,0,130000
113528400200000,NE 107,RESIDENTIAL,31500,0,31500,128200,0,159700
113528400300000,NE 107,RESIDENTIAL,30900,0,30900,119100,0,150000
113528400400000,NE 107,RESIDENTIAL,30600,0,30600,101000,0,131600
113528500100000,NE 107,RESIDENTIAL,32300,0,32300,120600,0,152900
113528500200000,NE 107,RESIDENTIAL,30900,0,30900,118500,0,149400
113528500300000,NE 107,RESIDENTIAL,28400,0,28400,121100,0,149500
113528500400000,NE 107,RESIDENTIAL,30300,0,30300,112800,0,143100
113528500500000,NE 107,RESIDENTIAL,29800,0,29800,129200,0,159000
113528500600000,NE 107,RESIDENTIAL,29600,0,29600,104700,0,134300
113528500700000,NE 107,RESIDENTIAL,29300,0,29300,143400,0,172700
113528500800000,NE 107,RESIDENTIAL,29100,0,29100,111700,0,140800
113528500900000,NE 107,RESIDENTIAL,28800,0,28800,109800,0,138600
113528501000000,NE 107,RESIDENTIAL,31000,0,31000,123400,0,154400
113528501100000,NE 107,RESIDENTIAL,27700,0,27700,116300,0,144000
113528501200000,NE 107,RESIDENTIAL,30900,0,30900,98100,0,129000
113528501300000,NE 107,RESIDENTIAL,28500,0,28500,104000,0,132500
113528501400000,NE 107,RESIDENTIAL,30800,0,30800,135600,0,166400
113528501500000,NE 107,RESIDENTIAL,31700,0,31700,127200,0,158900
113528501600000,NE 107,RESIDENTIAL,31400,0,31400,108500,0,139900
113530100100000,NE 107,RESIDENTIAL,37100,0,37100,109000,0,146100
113530100200000,NE 107,RESIDENTIAL,29200,0,29200,106200,0,135400
113530100300000,NE 107,RESIDENTIAL,30400,0,30400,131100,0,161500
113530100400000,NE 107,RESIDENTIAL,30900,0,30900,126100,0,157000
113530100500000,NE 107,RESIDENTIAL,30500,0,30500,107000,0,137500
113530200100000,NE 107,RESIDENTIAL,31600,0,31600,149600,0,181200
113530200200000,NE 107,RESIDENTIAL,30900,0,30900,121900,0,152800
113530200300000,NE 107,RESIDENTIAL,28900,0,28900,129900,0,158800
113530200400000,NE 107,RESIDENTIAL,31800,0,31800,96700,0,128500
113530200500000,NE 107,RESIDENTIAL,31500,0,31500,114900,0,146400
113530200600000,NE 107,RESIDENTIAL,31400,0,31400,117600,0,149000
113530200700000,NE 107,RESIDENTIAL,31700,0,31700,132100,0,163800
113530200800000,NE 107,RESIDENTIAL,31700,0,31700,115600,0,147300
113530200900000,NE 107,RESIDENTIAL,31900,0,31900,138800,0,170700
113530201000000,NE 107,RESIDENTIAL,31200,0,31200,149900,0,181100
113530201100000,NE 107,RESIDENTIAL,31200,0,31200,130800,0,162000
113530201200000,NE 107,RESIDENTIAL,28400,0,28400,113800,0,142200
113530201300000,NE 107,RESIDENTIAL,25800,0,25800,104200,0,130000
113530201400000,NE 107,RESIDENTIAL,30300,0,30300,106900,0,137200
113530201500000,NE 107,RESIDENTIAL,25600,0,25600,114800,0,140400
113530201600000,NE 107,RESIDENTIAL,25900,0,25900,131500,0,157400
113530201700000,NE 107,RESIDENTIAL,27100,0,27100,124700,0,151800
113530201800000,NE 107,RESIDENTIAL,28800,0,28800,135700,0,164500
113530201900000,NE 107,RESIDENTIAL,29800,0,29800,112800,0,142600
113530202000000,NE 107,RESIDENTIAL,30700,0,30700,125900,0,156600
113530202100000,NE 107,RESIDENTIAL,31900,0,31900,102900,0,134800
113530202200000,NE 107,RESIDENTIAL,29400,0,29400,109200,0,138600
113530202300000,NE 107,RESIDENTIAL,27900,0,27900,106100,0,134000
113530202400000,NE 107,RESIDENTIAL,30400,0,30400,117700,0,148100
113530202500000,NE 107,RESIDENTIAL,30200,0,30200,116300,0,146500
113530202600000,NE 107,RESIDENTIAL,25300,0,25300,93400,0,118700
113530202700000,NE 107,RESIDENTIAL,31200,0,31200,109500,0,140700
113530202800000,NE 107,RESIDENTIAL,30500,0,30500,115400,0,145900
113530202900000,NE 107,RESIDENTIAL,30000,0,30000,111400,0,141400
113530203000000,NE 107,RESIDENTIAL,34100,0,34100,146100,0,180200
113530203100000,NE 107,RESIDENTIAL,31800,0,31800,137700,0,169500
113530203200000,NE 107,RESIDENTIAL,31400,0,31400,97000,0,128400
113530300100000,NE 107,RESIDENTIAL,30400,0,30400,126100,0,156500
113530400100000,NE 107,RESIDENTIAL,32300,0,32300,138800,0,171100
113530400200000,NE 107,RESIDENTIAL,30500,0,30500,133000,0,163500
113530400300000,NE 107,RESIDENTIAL,31200,0,31200,97900,0,129100
113530400400000,NE 107,RESIDENTIAL,31800,0,31800,126700,0,158500
113530400500000,NE 107,RESIDENTIAL,31900,0,31900,126200,0,158100
113530400600000,NE 107,RESIDENTIAL,30900,0,30900,104200,0,135100
113530400700000,NE 107,RESIDENTIAL,31800,0,31800,113900,0,145700
113530400800000,NE 107,RESIDENTIAL,31000,0,31000,118700,0,149700
113530400900000,NE 107,RESIDENTIAL,29800,0,29800,113200,0,143000
113530401000000,NE 107,RESIDENTIAL,29300,0,29300,96900,0,126200
113530401100000,NE 107,RESIDENTIAL,30900,0,30900,126200,0,157100
113530401200000,NE 107,RESIDENTIAL,32300,0,32300,162100,0,194400
113530401300000,NE 107,RESIDENTIAL,31400,0,31400,126300,0,157700
113530401400000,NE 107,RESIDENTIAL,32800,0,32800,107400,0,140200
113530401500000,NE 107,RESIDENTIAL,26600,0,26600,99700,0,126300
113530500100000,NE 107,RESIDENTIAL,31300,0,31300,107000,0,138300
113530500200000,NE 107,RESIDENTIAL,28000,0,28000,101200,0,129200
113530500300000,NE 107,RESIDENTIAL,25700,0,25700,99300,0,125000
113530500400000,NE 107,RESIDENTIAL,26500,0,26500,128700,0,155200
113530500500000,NE 107,RESIDENTIAL,26000,0,26000,113700,0,139700
113530500600000,NE 107,RESIDENTIAL,26000,0,26000,119400,0,145400
113530500700000,NE 107,RESIDENTIAL,30300,0,30300,104800,0,135100
113530500800000,NE 107,RESIDENTIAL,30300,0,30300,118200,0,148500
113530500900000,NE 107,RESIDENTIAL,30300,0,30300,117500,0,147800
113530501000000,NE 107,RESIDENTIAL,30300,0,30300,104100,0,134400
113530501100000,NE 107,RESIDENTIAL,31900,0,31900,124300,0,156200
113530501200000,NE 107,RESIDENTIAL,27000,0,27000,95100,0,122100
113530501300000,NE 107,RESIDENTIAL,32200,0,32200,141700,0,173900
113530501400000,NE 107,RESIDENTIAL,26000,0,26000,132200,0,158200
113530501500000,NE 107,RESIDENTIAL,26000,0,26000,132000,0,158000
113530501600000,NE 107,RESIDENTIAL,26000,0,26000,127400,0,153400
113530501700000,NE 107,RESIDENTIAL,26000,0,26000,120400,0,146400
113530501800000,NE 107,RESIDENTIAL,30300,0,30300,124900,0,155200
113530501900000,NE 107,RESIDENTIAL,26000,0,26000,128100,0,154100
113530502000000,NE 107,RESIDENTIAL,26300,0,26300,131300,0,157600
113530502100000,NE 107,RESIDENTIAL,28300,0,28300,124300,0,152600
113530502200000,NE 107,RESIDENTIAL,31400,0,31400,109000,0,140400
113530502300000,NE 107,RESIDENTIAL,25700,0,25700,113700,0,139400
113530600100000,NE 107,RESIDENTIAL,33200,0,33200,135600,0,168800
113530600200000,NE 107,RESIDENTIAL,30500,0,30500,122500,0,153000
113530600300000,NE 107,RESIDENTIAL,27400,0,27400,110400,0,137800
113530600400000,NE 107,RESIDENTIAL,21900,0,21900,118000,0,139900
113530600500000,NE 107,RESIDENTIAL,27400,0,27400,137500,0,164900
113530600600000,NE 107,RESIDENTIAL,27400,0,27400,117000,0,144400
113530600700000,NE 107,RESIDENTIAL,27400,0,27400,104000,0,131400
113530600800000,NE 107,RESIDENTIAL,27400,0,27400,112900,0,140300
113530600900000,NE 107,RESIDENTIAL,29900,0,29900,112900,0,142800
113530601000000,NE 107,RESIDENTIAL,31200,0,31200,117300,0,148500
113530601100000,NE 107,RESIDENTIAL,31500,0,31500,112900,0,144400
113530601200000,NE 107,RESIDENTIAL,31500,0,31500,119900,0,151400
113530601300000,NE 107,RESIDENTIAL,34300,0,34300,126600,0,160900
113530601400000,NE 107,RESIDENTIAL,35500,0,35500,130100,0,165600
113530601500000,NE 107,RESIDENTIAL,33900,0,33900,104200,0,138100
113530601600000,NE 107,RESIDENTIAL,31000,0,31000,104600,0,135600
113530601700000,NE 107,RESIDENTIAL,28600,0,28600,126400,0,155000
113530601800000,NE 107,RESIDENTIAL,31600,0,31600,83500,0,115100
113530601900000,NE 107,RESIDENTIAL,31300,0,31300,129200,0,160500
113530602000000,NE 107,RESIDENTIAL,33800,0,33800,108200,0,142000
113530602100000,NE 107,RESIDENTIAL,36800,0,36800,117400,0,154200
113530602200000,NE 107,RESIDENTIAL,38600,0,38600,142900,0,181500
113530602300000,NE 107,RESIDENTIAL,32100,0,32100,123600,0,155700
113530602400000,NE 107,RESIDENTIAL,28000,0,28000,101300,0,129300
113530602500000,NE 107,RESIDENTIAL,23600,0,23600,125600,0,149200
113530602600000,NE 107,RESIDENTIAL,30200,0,30200,102800,0,133000
113530602700000,NE 107,RESIDENTIAL,25800,0,25800,111300,0,137100
113530602800000,NE 107,RESIDENTIAL,30500,0,30500,133400,0,163900
113530602900000,NE 107,RESIDENTIAL,25500,0,25500,122400,0,147900
113530603000000,NE 107,RESIDENTIAL,24100,0,24100,103100,0,127200
113530700100000,NE 107,RESIDENTIAL,31200,0,31200,125600,0,156800
113530700200000,NE 107,RESIDENTIAL,31800,0,31800,126800,0,158600
113530700300000,NE 107,RESIDENTIAL,32100,0,32100,135900,0,168000
113530700400000,NE 107,RESIDENTIAL,31600,0,31600,124800,0,156400
113530700500000,NE 107,RESIDENTIAL,33100,0,33100,135400,0,168500
113530700600000,NE 107,RESIDENTIAL,33900,0,33900,135500,0,169400
113530800100000,NE 107,RESIDENTIAL,32100,0,32100,111000,0,143100
113530800200000,NE 107,RESIDENTIAL,30900,0,30900,127600,0,158500
113530800300000,NE 107,RESIDENTIAL,30800,0,30800,121500,0,152300
113530800400000,NE 107,RESIDENTIAL,29000,0,29000,116600,0,145600
113530800500000,NE 107,RESIDENTIAL,30900,0,30900,98900,0,129800
113530800600000,NE 107,RESIDENTIAL,32200,0,32200,112900,0,145100
113530800700000,NE 107,RESIDENTIAL,36700,0,36700,114200,0,150900
113530800800000,NE 107,RESIDENTIAL,34700,0,34700,136600,0,171300
113530800900000,NE 107,RESIDENTIAL,35000,0,35000,145900,0,180900
113530801000000,NE 107,RESIDENTIAL,32000,0,32000,145100,0,177100
113532600100000,NE 107,RESIDENTIAL,32400,0,32400,115300,0,147700
113532600600000,NE 107,RESIDENTIAL,30800,0,30800,86400,0,117200
113532700100000,NE 107,RESIDENTIAL,32000,0,32000,139900,0,171900
113532700200000,NE 107,RESIDENTIAL,32100,0,32100,118500,0,150600
113532700300000,NE 107,RESIDENTIAL,29700,0,29700,121700,0,151400
113532700400000,NE 107,RESIDENTIAL,29100,0,29100,95300,0,124400
113532700500000,NE 107,RESIDENTIAL,32000,0,32000,108400,0,140400
113532700600000,NE 107,RESIDENTIAL,30800,0,30800,134600,0,165400
113532700700000,NE 107,RESIDENTIAL,30700,0,30700,102200,0,132900
113532700800000,NE 107,RESIDENTIAL,30400,0,30400,95700,0,126100
113532700900000,NE 107,RESIDENTIAL,30200,0,30200,132700,0,162900
113532701000000,NE 107,RESIDENTIAL,29200,0,29200,114000,0,143200
113532800100000,CHURCH,EXEMPT,0,390400,390400,0,467400,857800
113532800200000,NE 107,RESIDENTIAL,30900,0,30900,116800,0,147700
113532800300000,NE 107,RESIDENTIAL,30900,0,30900,130100,0,161000
113532800400000,NE 107,RESIDENTIAL,28100,0,28100,130500,0,158600
113532800500000,NE 107,RESIDENTIAL,28100,0,28100,108900,0,137000
113532800600000,NE 107,RESIDENTIAL,29500,0,29500,120700,0,150200
113532800700000,NE 107,RESIDENTIAL,30400,0,30400,127500,0,157900
113532800800000,NE 107,RESIDENTIAL,31300,0,31300,129400,0,160700
113532800900000,NE 107,RESIDENTIAL,32800,0,32800,111200,0,144000
113532900100000,NE 107,RESIDENTIAL,31400,0,31400,126200,0,157600
113532900200000,NE 107,RESIDENTIAL,28400,0,28400,90200,0,118600
113532900300000,NE 107,RESIDENTIAL,32600,0,32600,122000,0,154600
113532900400000,NE 107,RESIDENTIAL,27400,0,27400,99600,0,127000
113532900500000,NE 107,RESIDENTIAL,30500,0,30500,102400,0,132900
113533000100000,NE 107,RESIDENTIAL,31200,0,31200,107300,0,138500
113533000200000,NE 107,RESIDENTIAL,30900,0,30900,106900,0,137800
113533000300000,NE 107,RESIDENTIAL,31300,0,31300,128900,0,160200
113533000400000,NE 107,RESIDENTIAL,30600,0,30600,116100,0,146700
113533000500000,NE 107,RESIDENTIAL,30500,0,30500,90000,0,120500
113533000600000,NE 107,RESIDENTIAL,31900,0,31900,118100,0,150000
113533000700000,NE 107,RESIDENTIAL,32800,0,32800,97400,0,130200
113533000800000,NE 107,RESIDENTIAL,31900,0,31900,108100,0,140000
113533000900000,NE 107,RESIDENTIAL,31300,0,31300,119500,0,150800
113533001000000,NE 107,RESIDENTIAL,31000,0,31000,120300,0,151300
113533001100000,NE 107,RESIDENTIAL,31500,0,31500,110300,0,141800
113533001200000,NE 107,RESIDENTIAL,30300,0,30300,67400,0,97700
113533001300000,NE 107,RESIDENTIAL,31200,0,31200,93100,0,124300
113533001400000,NE 107,RESIDENTIAL,31500,0,31500,98800,0,130300
113533001500000,NE 107,RESIDENTIAL,30800,0,30800,124900,0,155700
113533001600000,NE 107,RESIDENTIAL,32400,0,32400,123300,0,155700
113533001700000,NE 107,RESIDENTIAL,31600,0,31600,131500,0,163100
113533001800000,NE 107,RESIDENTIAL,31700,0,31700,121800,0,153500
113533001900000,NE 107,RESIDENTIAL,30800,0,30800,119900,0,150700
113533002000000,NE 107,RESIDENTIAL,30200,0,30200,111300,0,141500
113533002100000,NE 107,RESIDENTIAL,29700,0,29700,119500,0,149200
113533002200000,NE 107,RESIDENTIAL,28900,0,28900,117300,0,146200
113533002300000,NE 107,RESIDENTIAL,31800,0,31800,104900,0,136700
113533100100000,NE 107,RESIDENTIAL,31000,0,31000,128300,0,159300
113533100200000,NE 107,RESIDENTIAL,32900,0,32900,113000,0,145900
113533100300000,NE 107,RESIDENTIAL,31000,0,31000,137200,0,168200
113533100400000,NE 107,RESIDENTIAL,31000,0,31000,108300,0,139300
113533100500000,NE 107,EXEMPT,0,30900,30900,0,108100,139000
113533100600000,NE 107,RESIDENTIAL,30700,0,30700,97500,0,128200
113533100700000,NE 107,RESIDENTIAL,31000,0,31000,95400,0,126400
113533100800000,NE 107,RESIDENTIAL,32300,0,32300,93700,0,126000
113533100900000,NE 107,RESIDENTIAL,32000,0,32000,125600,0,157600
113533101000000,NE 107,RESIDENTIAL,30600,0,30600,124600,0,155200
113533101100000,NE 107,RESIDENTIAL,32100,0,32100,100000,0,132100
113533101200000,NE 107,RESIDENTIAL,31700,0,31700,103600,0,135300
113533101300000,NE 107,RESIDENTIAL,30600,0,30600,128200,0,158800
113533101400000,NE 107,RESIDENTIAL,32300,0,32300,96900,0,129200
113533101500000,NE 107,RESIDENTIAL,28000,0,28000,108100,0,136100
113533101600000,NE 107,RESIDENTIAL,31300,0,31300,108400,0,139700
113533101700000,NE 107,RESIDENTIAL,27400,0,27400,119100,0,146500
113533101800000,NE 107,RESIDENTIAL,30900,0,30900,159700,0,190600
113533101900000,NE 107,RESIDENTIAL,31400,0,31400,120000,0,151400
113533102000000,NE 107,RESIDENTIAL,32400,0,32400,126100,0,158500
113533102100000,NE 107,RESIDENTIAL,31400,0,31400,109800,0,141200
113533102200000,NE 107,RESIDENTIAL,28700,0,28700,115300,0,144000
113533102300000,NE 107,RESIDENTIAL,30400,0,30400,131100,0,161500
113533102400000,NE 107,RESIDENTIAL,32400,0,32400,122500,0,154900
113533102500000,NE 107,RESIDENTIAL,37200,0,37200,131000,0,168200
113533102600000,NE 107,RESIDENTIAL,35900,0,35900,108300,0,144200
113533102700000,NE 107,RESIDENTIAL,32100,0,32100,68700,0,100800
113533102800000,NE 107,RESIDENTIAL,31800,0,31800,100600,0,132400
113533102900000,NE 107,RESIDENTIAL,32100,0,32100,128100,0,160200
113533103000000,NE 107,RESIDENTIAL,31900,0,31900,97100,0,129000
113533103100000,NE 107,RESIDENTIAL,32200,0,32200,115100,0,147300
113533103200000,NE 107,RESIDENTIAL,33700,0,33700,135300,0,169000
113533103300000,NE 107,RESIDENTIAL,42200,0,42200,107300,0,149500
113533103400000,NE 107,RESIDENTIAL,39900,0,39900,116400,0,156300
113533200100000,NE 107,RESIDENTIAL,30400,0,30400,126100,0,156500
113533200200000,NE 107,RESIDENTIAL,31200,0,31200,115200,0,146400
113533200300000,NE 107,RESIDENTIAL,31200,0,31200,154100,0,185300
113533200400000,NE 107,RESIDENTIAL,31900,0,31900,138600,0,170500
113533200500000,NE 107,RESIDENTIAL,31900,0,31900,122200,0,154100
113533200600000,NE 107,RESIDENTIAL,31900,0,31900,127900,0,159800
113533200700000,NE 107,RESIDENTIAL,27600,0,27600,110200,0,137800
113533200800000,NE 107,RESIDENTIAL,31900,0,31900,126700,0,158600
113533200900000,NE 107,RESIDENTIAL,31200,0,31200,116000,0,147200
113533201000000,NE 107,RESIDENTIAL,31300,0,31300,144100,0,175400
113533201100000,NE 107,RESIDENTIAL,32000,0,32000,136100,0,168100
113533201200000,NE 107,RESIDENTIAL,31900,0,31900,135200,0,167100
113533201300000,NE 107,RESIDENTIAL,27600,0,27600,132100,0,159700
113533201400000,NE 107,RESIDENTIAL,27500,0,27500,141800,0,169300
113533201500000,NE 107,RESIDENTIAL,27500,0,27500,128500,0,156000
113533201600000,NE 107,RESIDENTIAL,27500,0,27500,108500,0,136000
113533201700000,NE 107,RESIDENTIAL,32700,0,32700,101600,0,134300
113535100300000,NE 164,RESIDENTIAL,31400,0,31400,195400,0,226800
113535100400000,NE 164,RESIDENTIAL,30500,0,30500,129600,0,160100
113535100500000,NE 164,RESIDENTIAL,30300,0,30300,130000,0,160300
113535100600000,NE 164,RESIDENTIAL,31000,0,31000,150900,0,181900
113535100700000,NE 164,RESIDENTIAL,31600,0,31600,204600,0,236200
113535100800000,NE 164,RESIDENTIAL,32700,0,32700,173400,0,206100
113535100900000,NE 164,RESIDENTIAL,30000,0,30000,171600,0,201600
113535101000000,NE 164,RESIDENTIAL,30300,0,30300,168000,0,198300
113535101100000,NE 164,RESIDENTIAL,31200,0,31200,204500,0,235700
113535101200000,NE 164,RESIDENTIAL,28000,0,28000,181300,0,209300
113535101300000,NE 164,RESIDENTIAL,32000,0,32000,171000,0,203000
113535101400000,NE 164,RESIDENTIAL,29400,0,29400,196800,0,226200
113535101500000,NE 164,RESIDENTIAL,28100,0,28100,182000,0,210100
113535101600000,NE 164,RESIDENTIAL,57400,0,57400,275600,0,333000
113535101700000,NE 164,RESIDENTIAL,54000,0,54000,246500,0,300500
113535101800000,NE 164,RESIDENTIAL,50400,0,50400,249300,0,299700
113535101900000,NE 164,RESIDENTIAL,56700,0,56700,265500,0,322200
113535102000000,NE 164,RESIDENTIAL,55600,0,55600,232800,0,288400
113535102100000,NE 164,RESIDENTIAL,54500,0,54500,205700,0,260200
113535102200000,NE 164,RESIDENTIAL,58000,0,58000,296300,0,354300
113535102300000,NE 164,RESIDENTIAL,59300,0,59300,263100,0,322400
113535102400000,NE 164,RESIDENTIAL,55500,0,55500,211100,0,266600
113535102700000,NE 164,RESIDENTIAL,54900,0,54900,265500,0,320400
113535102900000,NE 164,RESIDENTIAL,56700,0,56700,247400,0,304100
113535103000000,NE 164,RESIDENTIAL,53000,0,53000,270400,0,323400
113535103100000,NE 164,RESIDENTIAL,56000,0,56000,234100,0,290100
113535103200000,NE 164,RESIDENTIAL,51100,0,51100,247200,0,298300
113535103300000,NE 164,RESIDENTIAL,56600,0,56600,221300,0,277900
113535103400000,NE 164,RESIDENTIAL,57800,0,57800,229000,0,286800
113535103500000,NE 164,RESIDENTIAL,48300,0,48300,188800,0,237100
113535103600000,NE 164,RESIDENTIAL,51500,0,51500,243500,0,295000
113535103700000,NE 164,RESIDENTIAL,54900,0,54900,254900,0,309800
113535103800000,NE 164,RESIDENTIAL,55400,0,55400,240000,0,295400
113535103900000,NE 164,RESIDENTIAL,57200,0,57200,266900,0,324100
113535104000000,NE 164,RESIDENTIAL,54600,0,54600,246100,0,300700
113535104100000,NE 164,RESIDENTIAL,57800,0,57800,274400,0,332200
113535104200000,NE 164,RESIDENTIAL,55600,0,55600,242100,0,297700
113535104300000,NE 164,RESIDENTIAL,56900,0,56900,252500,0,309400
113535104500000,NE 164,RESIDENTIAL,15300,0,15300,0,0,15300
113535104600000,NE 164,RESIDENTIAL,66700,0,66700,246700,0,313400
113535200100000,NE 164,RESIDENTIAL,31200,0,31200,190600,0,221800
113535200200000,NE 164,RESIDENTIAL,31000,0,31000,224800,0,255800
113535200300000,CITY PROPERTY,EXEMPT,0,0,0,0,0,0
113535200400000,NE 164,RESIDENTIAL,51700,0,51700,259700,0,311400
113535200500000,NE 164,RESIDENTIAL,53600,0,53600,258900,0,312500
113535200600000,NE 164,RESIDENTIAL,52900,0,52900,256800,0,309700
113535200700000,NE 164,RESIDENTIAL,47300,0,47300,229400,0,276700
113535200800000,NE 164,RESIDENTIAL,50400,0,50400,300800,0,351200
113535200900000,NE 164,RESIDENTIAL,52300,0,52300,266100,0,318400
113535201000000,NE 164,RESIDENTIAL,53400,0,53400,268800,0,322200
113535201100000,NE 164,RESIDENTIAL,54800,0,54800,333200,0,388000
113535201200000,NE 164,RESIDENTIAL,50400,0,50400,293100,0,343500
113535201300000,NE 164,RESIDENTIAL,53600,0,53600,256600,0,310200
113535201400000,NE 164,RESIDENTIAL,53900,0,53900,231600,0,285500
113535201500000,NE 164,RESIDENTIAL,54200,0,54200,293700,0,347900
113535201600000,NE 164,RESIDENTIAL,54200,0,54200,274200,0,328400
113535201700000,NE 164,RESIDENTIAL,54200,0,54200,259200,0,313400
113535201800000,NE 164,RESIDENTIAL,53400,0,53400,234300,0,287700
113535201900000,NE 164,RESIDENTIAL,47700,0,47700,238200,0,285900
113535300500000,NE 164,RESIDENTIAL,30100,0,30100,142600,0,172700
113535300600000,NE 164,RESIDENTIAL,30200,0,30200,151400,0,181600
113535300700000,NE 164,RESIDENTIAL,31700,0,31700,209300,0,241000
113535300800000,NE 164,RESIDENTIAL,31500,0,31500,177300,0,208800
113535400100000,NE 164,RESIDENTIAL,51000,0,51000,285400,0,336400
113535400200000,NE 164,RESIDENTIAL,54700,0,54700,266000,0,320700
113535400300000,NE 164,RESIDENTIAL,50400,0,50400,263000,0,313400
113535400400000,NE 164,RESIDENTIAL,46800,0,46800,271800,0,318600
113535400500000,NE 164,RESIDENTIAL,50400,0,50400,312300,0,362700
113535400600000,NE 164,RESIDENTIAL,53600,0,53600,291400,0,345000
113535400700000,NE 164,RESIDENTIAL,47300,0,47300,289300,0,336600
113535400800000,NE 164,RESIDENTIAL,50400,0,50400,238000,0,288400
113537600100000,NE 164,RESIDENTIAL,36800,0,36800,223900,0,260700
113537600200000,NE 164,RESIDENTIAL,35700,0,35700,222000,0,257700
113537600300000,NE 164,RESIDENTIAL,35700,0,35700,189200,0,224900
113537600400000,NE 164,RESIDENTIAL,35700,0,35700,177500,0,213200
113537600500000,NE 164,RESIDENTIAL,37900,0,37900,161400,0,199300
113537700100000,NE 164,RESIDENTIAL,36800,0,36800,191000,0,227800
113537700300000,NE 115,RESIDENTIAL,38500,0,38500,0,0,38500
113537700400000,NE 164,RESIDENTIAL,37300,0,37300,212000,0,249300
113537700500000,NE 164,RESIDENTIAL,35800,0,35800,223500,0,259300
113537700600000,NE 164,RESIDENTIAL,35400,0,35400,199800,0,235200
113537700700000,NE 164,RESIDENTIAL,36300,0,36300,225000,0,261300
113537700800000,NE 164,RESIDENTIAL,36600,0,36600,227000,0,263600
113537700900000,NE 164,RESIDENTIAL,37300,0,37300,208300,0,245600
113537701000000,NE 164,RESIDENTIAL,36100,0,36100,186700,0,222800
113537701200000,NE 164,RESIDENTIAL,49900,0,49900,287700,0,337600
113537701300000,NE 164,RESIDENTIAL,53600,0,53600,295500,0,349100
113537701400000,NE 164,RESIDENTIAL,53400,0,53400,247800,0,301200
113537701500000,NE 164,RESIDENTIAL,53400,0,53400,265900,0,319300
113537701600000,NE 164,RESIDENTIAL,54300,0,54300,265900,0,320200
113537701700000,NE 164,RESIDENTIAL,53700,0,53700,252200,0,305900
113537701800000,NE 164,RESIDENTIAL,49100,0,49100,260800,0,309900
113537701900000,NE 164,RESIDENTIAL,55000,0,55000,294100,0,349100
113537702000000,NE 164,RESIDENTIAL,57700,0,57700,287500,0,345200
113537800100000,NE 164,RESIDENTIAL,37700,0,37700,210100,0,247800
113537800200000,NE 164,RESIDENTIAL,35400,0,35400,267800,0,303200
113537800300000,NE 164,RESIDENTIAL,35400,0,35400,227800,0,263200
113537800400000,NE 164,RESIDENTIAL,35000,0,35000,196200,0,231200
113537800500000,NE 164,RESIDENTIAL,37200,0,37200,237700,0,274900
113537800600000,NE 164,RESIDENTIAL,38900,0,38900,182600,0,221500
113537800700000,NE 164,RESIDENTIAL,36000,0,36000,199000,0,235000
113537800800000,NE 164,RESIDENTIAL,30400,0,30400,168800,0,199200
113537800900000,NE 164,RESIDENTIAL,36600,0,36600,188800,0,225400
113537801000000,NE 164,RESIDENTIAL,36900,0,36900,187400,0,224300
113537900100000,NE 164,RESIDENTIAL,35800,0,35800,217400,0,253200
113537900200000,NE 164,RESIDENTIAL,31600,0,31600,200700,0,232300
113537900300000,NE 164,RESIDENTIAL,36600,0,36600,209800,0,246400
113542600100000,NE 107,RESIDENTIAL,35500,0,35500,121800,0,157300
113542600200000,NE 107,RESIDENTIAL,32000,0,32000,140300,0,172300
113542600300000,NE 107,RESIDENTIAL,31700,0,31700,119400,0,151100
113542600500000,NE 107,RESIDENTIAL,31100,0,31100,136900,0,168000
113542600600000,NE 107,RESIDENTIAL,31600,0,31600,143600,0,175200
113542600700000,NE 107,RESIDENTIAL,31000,0,31000,129200,0,160200
113542600800000,NE 107,RESIDENTIAL,31200,0,31200,135900,0,167100
113542600900000,NE 107,RESIDENTIAL,31200,0,31200,121800,0,153000
113542601000000,NE 107,RESIDENTIAL,31200,0,31200,114900,0,146100
113542601100000,NE 107,RESIDENTIAL,31200,0,31200,144900,0,176100
113542601200000,NE 107,RESIDENTIAL,31300,0,31300,139700,0,171000
113542601300000,NE 107,RESIDENTIAL,32900,0,32900,110400,0,143300
113542601400000,NE 107,RESIDENTIAL,32900,0,32900,117400,0,150300
113542601500000,NE 107,RESIDENTIAL,31300,0,31300,128600,0,159900
113542601600000,NE 107,RESIDENTIAL,30700,0,30700,135600,0,166300
113542601700000,NE 107,RESIDENTIAL,31600,0,31600,110300,0,141900
113542601800000,NE 107,RESIDENTIAL,32100,0,32100,116800,0,148900
113542601900000,NE 107,RESIDENTIAL,32200,0,32200,160100,0,192300
113542602000000,NE 107,RESIDENTIAL,30100,0,30100,113600,0,143700
113542602100000,NE 107,RESIDENTIAL,31200,0,31200,108500,0,139700
113542602200000,NE 107,RESIDENTIAL,32100,0,32100,107600,0,139700
113542602300000,NE 107,RESIDENTIAL,31200,0,31200,99600,0,130800
113542602400000,NE 107,RESIDENTIAL,32100,0,32100,107600,0,139700
113542700100000,NE 107,RESIDENTIAL,30900,0,30900,126100,0,157000
113542700200000,NE 107,RESIDENTIAL,27300,0,27300,119600,0,146900
113542700300000,NE 107,RESIDENTIAL,27200,0,27200,95700,0,122900
113542700400000,NE 107,RESIDENTIAL,30700,0,30700,123900,0,154600
113542800100000,NE 107,RESIDENTIAL,29800,0,29800,126600,0,156400
113542800200000,CITY PROPERTY,EXEMPT,0,0,0,0,0,0
113542800300000,NE 107,RESIDENTIAL,30300,0,30300,108500,0,138800
113542800400000,NE 107,RESIDENTIAL,30300,0,30300,130800,0,161100
113542800500000,NE 107,RESIDENTIAL,27800,0,27800,102600,0,130400
113542800600000,NE 107,RESIDENTIAL,31200,0,31200,130600,0,161800
113542800700000,NE 107,RESIDENTIAL,28000,0,28000,98900,0,126900
113542800800000,NE 107,RESIDENTIAL,27300,0,27300,114600,0,141900
113542800900000,NE 107,RESIDENTIAL,27300,0,27300,112700,0,140000
113542801000000,NE 107,RESIDENTIAL,27300,0,27300,104900,0,132200
113542801100000,NE 107,RESIDENTIAL,30600,0,30600,140100,0,170700
113542801200000,NE 107,RESIDENTIAL,30100,0,30100,138400,0,168500
113542801300000,NE 107,RESIDENTIAL,24500,0,24500,101200,0,125700
113542801400000,NE 107,RESIDENTIAL,24500,0,24500,91400,0,115900
113542801500000,NE 107,RESIDENTIAL,26800,0,26800,102400,0,129200
113542801600000,NE 107,RESIDENTIAL,24700,0,24700,120600,0,145300
113542801700000,NE 107,RESIDENTIAL,28900,0,28900,107600,0,136500
113542801800000,NE 107,RESIDENTIAL,24700,0,24700,108800,0,133500
113542801900000,NE 107,RESIDENTIAL,26600,0,26600,123500,0,150100
113542802000000,NE 107,RESIDENTIAL,24700,0,24700,106100,0,130800
113542900100000,NE 107,RESIDENTIAL,31900,0,31900,120800,0,152700
113542900200000,NE 107,RESIDENTIAL,26600,0,26600,118700,0,145300
113542900300000,NE 107,RESIDENTIAL,25000,0,25000,110900,0,135900
113542900400000,NE 107,RESIDENTIAL,24900,0,24900,87400,0,112300
113542900500000,NE 107,RESIDENTIAL,31200,0,31200,143600,0,174800
113542900600000,NE 107,RESIDENTIAL,27500,0,27500,118000,0,145500
113542900700000,NE 107,RESIDENTIAL,28600,0,28600,105700,0,134300
113542900800000,NE 107,RESIDENTIAL,30800,0,30800,136500,0,167300
113542900900000,NE 107,RESIDENTIAL,27400,0,27400,131400,0,158800
113542901000000,NE 107,RESIDENTIAL,26500,0,26500,117700,0,144200
113542901100000,NE 107,RESIDENTIAL,28000,0,28000,98400,0,126400
113542901200000,NE 107,RESIDENTIAL,25800,0,25800,104600,0,130400
113542901300000,NE 107,RESIDENTIAL,25200,0,25200,120300,0,145500
113542901400000,NE 107,RESIDENTIAL,24700,0,24700,101600,0,126300
113542901500000,NE 107,RESIDENTIAL,26400,0,26400,113700,0,140100
113542901600000,NE 107,RESIDENTIAL,30700,0,30700,130600,0,161300
122447800100000,NE 168,AG LAND,3000,0,3000,0,0,3000
122447800200000,NE 168,RESIDENTIAL,59700,0,59700,252300,0,312000
122510200200000,NE 168,RESIDENTIAL,69600,0,69600,0,0,69600
122510200800000,NE 168,AG DWELLING,9900,0,9900,51300,8900,70100
122510200900000,NE 168,AG LAND,22200,0,22200,0,0,22200
122510201000000,NE 168,EXEMPT,0,258500,258500,0,110100,368600
122510201100000,NE 168,EXEMPT,0,118800,118800,0,0,118800
122517600400000,NE 168,AG LAND,53200,0,53200,0,0,53200
122517600500000,NE 168,RESIDENTIAL,98800,0,98800,309300,0,408100
122517600600000,NE 168,RESIDENTIAL,83600,0,83600,361400,0,445000
122540100100000,NE 168,AG DWELLING,109500,0,109500,117800,9000,236300
122547600100000,NE 168,RESIDENTIAL,1400,0,1400,0,0,1400
122547600200000,NE 169,RESIDENTIAL,75600,0,75600,337600,0,413200
122547600300000,NE 169,RESIDENTIAL,75500,0,75500,259800,0,335300
122547600400000,NE 169,RESIDENTIAL,75500,0,75500,244600,0,320100
122547600500000,NE 169,RESIDENTIAL,75500,0,75500,267300,0,342800
122547600600000,NE 169,RESIDENTIAL,75500,0,75500,221900,0,297400
122547600700000,NE 169,RESIDENTIAL,75500,0,75500,282600,0,358100
122547600800000,NE 169,RESIDENTIAL,75500,0,75500,313300,0,388800
122547600900000,NE 169,RESIDENTIAL,75600,0,75600,287500,0,363100
122547601000000,NE 169,RESIDENTIAL,75600,0,75600,368300,0,443900
122547700100000,NE 169,RESIDENTIAL,75000,0,75000,286600,0,361600
122547700200000,NE 169,RESIDENTIAL,75000,0,75000,272200,0,347200
122547700300000,NE 169,RESIDENTIAL,75000,0,75000,333500,0,408500
122547700400000,NE 169,RESIDENTIAL,75000,0,75000,212200,0,287200
122547700500000,NE 169,RESIDENTIAL,75000,0,75000,265300,0,340300
122547700600000,NE 169,RESIDENTIAL,74900,0,74900,248400,0,323300
122547700700000,NE 169,RESIDENTIAL,75000,0,75000,270300,0,345300
122547700800000,NE 169,RESIDENTIAL,75000,0,75000,203700,0,278700
122547700900000,NE 169,RESIDENTIAL,75800,0,75800,271000,0,346800
122547701000000,NE 168,AG LAND,38500,0,38500,0,22400,60900
123610100100000,NE 168,AG DWELLING,32800,0,32800,104400,1300,138500
123610100500000,NE 169,RESIDENTIAL,50100,0,50100,297300,0,347400
123610100600000,NE 169,RESIDENTIAL,50100,0,50100,315700,0,365800
123610100700000,NE 169,RESIDENTIAL,50100,0,50100,280600,0,330700
123610100800000,NE 169,RESIDENTIAL,50100,0,50100,317000,0,367100
123610100900000,NE 169,RESIDENTIAL,50100,0,50100,317800,0,367900
123610101000000,NE 169,RESIDENTIAL,50100,0,50100,319500,0,369600
123610101100000,NE 169,RESIDENTIAL,50100,0,50100,291300,0,341400
123610101200000,NE 169,RESIDENTIAL,50100,0,50100,278600,0,328700
123610101300000,NE 169,RESIDENTIAL,50600,0,50600,321700,0,372300
123610101400000,NE 169,RESIDENTIAL,50600,0,50600,359900,0,410500
123610101500000,NE 169,RESIDENTIAL,50600,0,50600,0,0,50600
123610101600000,NE 168,RESIDENTIAL,49300,0,49300,152500,0,201800
123610101700000,NE 168,RESIDENTIAL,146500,0,146500,173500,0,320000
123610200100000,NE 169,RESIDENTIAL,53100,0,53100,245700,0,298800
123610200200000,NE 169,RESIDENTIAL,52900,0,52900,314400,0,367300
123610200300000,NE 169,RESIDENTIAL,52900,0,52900,278900,0,331800
123610200400000,NE 169,RESIDENTIAL,52900,0,52900,302500,0,355400
123610200500000,NE 169,RESIDENTIAL,52900,0,52900,300000,0,352900
123610200600000,NE 169,RESIDENTIAL,52900,0,52900,328700,0,381600
123610200700000,NE 169,RESIDENTIAL,52900,0,52900,311400,0,364300
123610200800000,NE 169,RESIDENTIAL,52900,0,52900,288200,0,341100
123610200900000,NE 169,RESIDENTIAL,52900,0,52900,285100,0,338000
123610201000000,NE 169,RESIDENTIAL,52900,0,52900,357500,0,410400
123610201100000,NE 169,RESIDENTIAL,52900,0,52900,254500,0,307400
123610201200000,CITY PROPERTY,EXEMPT,0,0,0,0,0,0
123612600100000,NE 168,RESIDENTIAL,16300,0,16300,0,0,16300
123612600700000,NE 168,RESIDENTIAL,72100,0,72100,264500,0,336600
123617600100000,NE 168,RESIDENTIAL,52300,0,52300,201100,0,253400
123617600200000,NE 168,RESIDENTIAL,51900,0,51900,198600,0,250500
123617600300000,NE 168,RESIDENTIAL,51900,0,51900,237500,0,289400
123617600400000,NE 168,RESIDENTIAL,51900,0,51900,192400,0,244300
123617600500000,NE 168,RESIDENTIAL,51900,0,51900,214000,0,265900
123617600600000,NE 168,RESIDENTIAL,51900,0,51900,311700,0,363600
123617600700000,NE 168,RESIDENTIAL,51900,0,51900,187000,0,238900
123617600800000,NE 168,RESIDENTIAL,51900,0,51900,174100,0,226000
123617700100000,NE 168,RESIDENTIAL,51100,0,51100,263900,0,315000
123617700200000,NE 168,RESIDENTIAL,50600,0,50600,216800,0,267400
123617700300000,NE 168,RESIDENTIAL,50600,0,50600,204100,0,254700
123617700400000,NE 168,RESIDENTIAL,50600,0,50600,206000,0,256600
123617700500000,NE 168,RESIDENTIAL,50600,0,50600,216800,0,267400
123617700600000,NE 168,RESIDENTIAL,50600,0,50600,160800,0,211400
123617700700000,NE 168,RESIDENTIAL,50600,0,50600,186700,0,237300
123617700800000,NE 168,RESIDENTIAL,50600,0,50600,132800,0,183400
123617700900000,NE 168,RESIDENTIAL,50400,0,50400,275500,0,325900
123617701000000,NE 168,RESIDENTIAL,50200,0,50200,214500,0,264700
123617701100000,NE 168,RESIDENTIAL,50600,0,50600,236000,0,286600
123617701200000,NE 168,RESIDENTIAL,50600,0,50600,187800,0,238400
123617701300000,NE 168,RESIDENTIAL,50600,0,50600,269600,0,320200
123617701400000,NE 168,RESIDENTIAL,50600,0,50600,202700,0,253300
123617701500000,NE 168,RESIDENTIAL,50600,0,50600,238000,0,288600
123617701600000,NE 168,RESIDENTIAL,51500,0,51500,242300,0,293800
123617800100000,NE 168,RESIDENTIAL,50900,0,50900,229600,0,280500
123617800200000,NE 168,RESIDENTIAL,50800,0,50800,304500,0,355300
123617800300000,NE 168,RESIDENTIAL,50800,0,50800,220100,0,270900
123617800400000,NE 168,RESIDENTIAL,51100,0,51100,210000,0,261100
123617800500000,NE 168,RESIDENTIAL,50600,0,50600,290000,0,340600
123617800600000,NE 168,RESIDENTIAL,51900,0,51900,146400,0,198300
123617800700000,NE 168,RESIDENTIAL,50400,0,50400,202000,0,252400
123617800800000,NE 168,RESIDENTIAL,50300,0,50300,186400,0,236700
123627600200000,NE 170,RESIDENTIAL,5900,0,5900,0,0,5900
123627600300000,NE 170,RESIDENTIAL,57000,0,57000,10900,0,67900
123627600400000,NE 170,RESIDENTIAL,5300,0,5300,0,0,5300
123627600500000,NE 170,RESIDENTIAL,5600,0,5600,0,0,5600
123627600600000,NE 170,RESIDENTIAL,5800,0,5800,0,0,5800
123627600700000,NE 170,RESIDENTIAL,8600,0,8600,0,0,8600
123627600800000,NE 170,RESIDENTIAL,6000,0,6000,0,0,6000
123627600900000,NE 170,RESIDENTIAL,8000,0,8000,0,0,8000
123627601000000,NE 170,RESIDENTIAL,10500,0,10500,0,0,10500
123627700100000,NE 170,RESIDENTIAL,7800,0,7800,0,0,7800
123627700200000,NE 170,RESIDENTIAL,6100,0,6100,0,0,6100
123627700300000,NE 170,RESIDENTIAL,5600,0,5600,0,0,5600
123627700400000,NE 170,RESIDENTIAL,6600,0,6600,0,0,6600
123627700500000,NE 170,RESIDENTIAL,6000,0,6000,0,0,6000
123627700600000,NE 170,RESIDENTIAL,6600,0,6600,0,0,6600
123627700700000,NE 170,RESIDENTIAL,6400,0,6400,0,0,6400
123627700800000,NE 170,RESIDENTIAL,5600,0,5600,0,0,5600
123627700900000,NE 170,RESIDENTIAL,5500,0,5500,0,0,5500
123627701000000,NE 170,RESIDENTIAL,5300,0,5300,0,0,5300
123627701100000,NE 170,RESIDENTIAL,5600,0,5600,0,0,5600
123627701200000,NE 170,RESIDENTIAL,5800,0,5800,0,0,5800
123627701300000,NE 170,RESIDENTIAL,6900,0,6900,0,0,6900
123627701400000,CITY PROPERTY,EXEMPT,0,0,0,0,0,0
123627701500000,NE 170,RESIDENTIAL,7200,0,7200,0,0,7200
123627701600000,NE 170,RESIDENTIAL,8000,0,8000,0,0,8000
123627701700000,NE 170,RESIDENTIAL,6100,0,6100,0,0,6100
123627701800000,NE 170,AG LAND,17100,0,17100,0,0,17100
123627800100000,NE 170,RESIDENTIAL,8300,0,8300,0,0,8300
123627800200000,NE 170,RESIDENTIAL,6400,0,6400,0,0,6400
123627800300000,NE 170,RESIDENTIAL,6400,0,6400,0,0,6400
123627800400000,NE 170,RESIDENTIAL,6400,0,6400,0,0,6400
123627800500000,NE 170,RESIDENTIAL,6400,0,6400,0,0,6400
123627800600000,NE 170,RESIDENTIAL,8300,0,8300,0,0,8300
123627800700000,NE 170,RESIDENTIAL,6600,0,6600,0,0,6600
123627800800000,NE 170,RESIDENTIAL,6700,0,6700,0,0,6700
123627800900000,NE 170,RESIDENTIAL,5900,0,5900,0,0,5900
123627801000000,NE 170,RESIDENTIAL,8600,0,8600,0,0,8600
123627801100000,NE 170,AG LAND,27900,0,27900,0,0,27900
123627900100000,NE 170,RESIDENTIAL,6700,0,6700,0,0,6700
123630101200000,CHURCH,EXEMPT,0,360000,360000,0,638600,998600
123630101300000,NE 170,RESIDENTIAL,8300,0,8300,0,0,8300
123630101400000,NE 170,RESIDENTIAL,5500,0,5500,0,0,5500
123630101500000,NE 170,RESIDENTIAL,5800,0,5800,0,0,5800
123630101600000,NE 170,RESIDENTIAL,5800,0,5800,0,0,5800
123630101700000,NE 170,RESIDENTIAL,5800,0,5800,0,0,5800
123630101800000,NE 170,RESIDENTIAL,5800,0,5800,0,0,5800
123630101900000,NE 170,RESIDENTIAL,5800,0,5800,0,0,5800
123630102000000,NE 170,AG LAND,5500,0,5500,0,0,5500
123640100100000,NE 168,RESIDENTIAL,50000,0,50000,190100,0,240100
123640100200000,NE 168,RESIDENTIAL,50000,0,50000,161100,0,211100
123640100300000,NE 168,RESIDENTIAL,50000,0,50000,196000,0,246000
123640100400000,NE 168,RESIDENTIAL,50000,0,50000,184700,0,234700
123640100500000,NE 168,RESIDENTIAL,50000,0,50000,212400,0,262400
123640100600000,NE 168,RESIDENTIAL,50000,0,50000,179300,0,229300
123640200100000,NE 168,RESIDENTIAL,50700,0,50700,165300,0,216000
123640200200000,NE 168,RESIDENTIAL,50700,0,50700,224500,0,275200
123640200300000,NE 168,RESIDENTIAL,50700,0,50700,202700,0,253400
123640200400000,NE 168,RESIDENTIAL,50700,0,50700,277300,0,328000
123640200500000,NE 168,RESIDENTIAL,50700,0,50700,191300,0,242000
123640200700000,NE 168,RESIDENTIAL,50000,0,50000,240700,0,290700
123640200800000,NE 168,RESIDENTIAL,50000,0,50000,185200,0,235200
123640200900000,NE 168,RESIDENTIAL,50000,0,50000,111300,0,161300
123640201000000,NE 168,RESIDENTIAL,45500,0,45500,182300,0,227800
123640201100000,COUNTY PROPERTY,EXEMPT,0,0,0,0,0,0
123640201300000,NE 172,RESIDENTIAL,35700,0,35700,125600,0,161300
123640201400000,NE 172,RESIDENTIAL,35700,0,35700,149300,0,185000
123640201500000,NE 172,RESIDENTIAL,35700,0,35700,153000,0,188700
123640201600000,NE 172,RESIDENTIAL,35300,0,35300,150900,0,186200
123640201700000,NE 172,AG LAND,1900,0,1900,0,0,1900
123640300100000,NE 172,RESIDENTIAL,43900,0,43900,175600,0,219500
123640300200000,NE 172,RESIDENTIAL,44700,0,44700,191600,0,236300
123640300300000,NE 172,RESIDENTIAL,45700,0,45700,197800,0,243500
123640300400000,NE 172,RESIDENTIAL,52500,0,52500,201900,0,254400
123640300500000,NE 172,RESIDENTIAL,49600,0,49600,196200,0,245800
123640300600000,NE 172,RESIDENTIAL,49000,0,49000,240300,0,289300
123640300700000,CITY PROPERTY,EXEMPT,0,0,0,0,0,0
123640300800000,NE 172,RESIDENTIAL,56800,0,56800,319000,0,375800
123640300900000,NE 172,RESIDENTIAL,58200,0,58200,280300,0,338500
123640301000000,NE 172,RESIDENTIAL,56800,0,56800,279900,0,336700
123640301100000,NE 172,RESIDENTIAL,60400,0,60400,320700,0,381100
123640301200000,NE 172,RESIDENTIAL,51900,0,51900,280700,0,332600
123640301300000,NE 172,RESIDENTIAL,56200,0,56200,274700,0,330900
123640301400000,NE 172,RESIDENTIAL,58000,0,58000,303700,0,361700
123640301500000,NE 172,RESIDENTIAL,53000,0,53000,260900,0,313900
123640301600000,NE 172,RESIDENTIAL,58300,0,58300,264500,0,322800
123640301700000,NE 172,RESIDENTIAL,59000,0,59000,299200,0,358200
123640301800000,NE 172,RESIDENTIAL,58000,0,58000,240600,0,298600
123640302000000,NE 172,RESIDENTIAL,4600,0,4600,0,0,4600
123640400100000,NE 172,RESIDENTIAL,43000,0,43000,223900,0,266900
123640400400000,NE 172,RESIDENTIAL,43300,0,43300,203200,0,246500
123640400500000,NE 172,RESIDENTIAL,40800,0,40800,216400,0,257200
123640400600000,NE 172,RESIDENTIAL,43600,0,43600,182500,0,226100
123640400700000,NE 172,RESIDENTIAL,54500,0,54500,208100,0,262600
123640400800000,NE 172,RESIDENTIAL,49600,0,49600,244600,0,294200
123640400900000,NE 172,RESIDENTIAL,48000,0,48000,231300,0,279300
123640401000000,NE 172,RESIDENTIAL,56800,0,56800,201300,0,258100
123640401100000,NE 172,RESIDENTIAL,45600,0,45600,204400,0,250000
123640401200000,NE 172,RESIDENTIAL,49500,0,49500,221100,0,270600
123640401300000,NE 172,RESIDENTIAL,49000,0,49000,195900,0,244900
123640401400000,NE 172,RESIDENTIAL,60200,0,60200,244900,0,305100
123640401500000,NE 172,RESIDENTIAL,66200,0,66200,305700,0,371900
123640401600000,NE 172,RESIDENTIAL,54600,0,54600,247500,0,302100
123640401700000,NE 172,RESIDENTIAL,6400,0,6400,0,0,6400
123640401800000,NE 172,RESIDENTIAL,58800,0,58800,261200,0,320000
123640401900000,NE 172,RESIDENTIAL,55900,0,55900,233900,0,289800
123640402000000,NE 172,RESIDENTIAL,4700,0,4700,0,0,4700
123640402100000,NE 172,RESIDENTIAL,5300,0,5300,0,0,5300
123640402200000,NE 172,RESIDENTIAL,4600,0,4600,0,0,4600
123640402300000,NE 172,RESIDENTIAL,62700,0,62700,293000,0,355700
123640402400000,NE 172,RESIDENTIAL,3900,0,3900,0,0,3900
123640402500000,NE 172,RESIDENTIAL,52400,0,52400,236900,0,289300
123640402600000,NE 172,RESIDENTIAL,53000,0,53000,226600,0,279600
123640402700000,NE 172,RESIDENTIAL,4200,0,4200,0,0,4200
123640402800000,NE 172,RESIDENTIAL,68600,0,68600,198300,0,266900
123642600600000,NE 168,RESIDENTIAL,59300,0,59300,141200,0,200500
123642600700000,NE 170,RESIDENTIAL,62000,0,62000,326400,0,388400
123642600800000,NE 170,RESIDENTIAL,61500,0,61500,250700,0,312200
123642600900000,NE 170,RESIDENTIAL,60300,0,60300,303500,0,363800
123642601000000,NE 170,RESIDENTIAL,59200,0,59200,282500,0,341700
123642601100000,NE 170,RESIDENTIAL,61600,0,61600,455600,0,517200
123642601200000,NE 170,RESIDENTIAL,61000,0,61000,321400,0,382400
123642601300000,NE 170,RESIDENTIAL,62100,0,62100,352800,0,414900
123642601400000,NE 170,RESIDENTIAL,61500,0,61500,322700,0,384200
123642601700000,NE 170,EXEMPT,0,21700,21700,0,0,21700
123642601800000,CHURCH,EXEMPT,0,8700,8700,0,0,8700
123642602000000,NE 170,RESIDENTIAL,700,0,700,0,0,700
123642602100000,NE 170,RESIDENTIAL,7800,0,7800,0,0,7800
123642602200000,NE 170,RESIDENTIAL,6900,0,6900,0,0,6900
123642602300000,NE 170,RESIDENTIAL,9200,0,9200,0,0,9200
123642700100000,NE 170,RESIDENTIAL,63100,0,63100,294500,0,357600
123642700200000,NE 170,RESIDENTIAL,61900,0,61900,323300,0,385200
123642700300000,NE 170,RESIDENTIAL,60700,0,60700,294100,0,354800
123642700400000,NE 170,RESIDENTIAL,46400,0,46400,283800,0,330200
123642700500000,NE 170,RESIDENTIAL,5200,0,5200,0,0,5200
123642700600000,NE 170,RESIDENTIAL,78600,0,78600,271500,0,350100
123642700700000,NE 170,RESIDENTIAL,69900,0,69900,311400,0,381300
123642700800000,NE 170,RESIDENTIAL,82700,0,82700,298600,0,381300
123642700900000,NE 170,RESIDENTIAL,58500,0,58500,293300,0,351800
123642701000000,NE 170,RESIDENTIAL,73900,0,73900,391400,0,465300
123642701100000,NE 170,RESIDENTIAL,73200,0,73200,337700,0,410900
123642701200000,NE 170,RESIDENTIAL,67200,0,67200,312500,0,379700
123642701300000,NE 170,RESIDENTIAL,75100,0,75100,352100,0,427200
123642701400000,NE 170,RESIDENTIAL,65800,0,65800,360200,0,426000
123642701500000,NE 170,RESIDENTIAL,65800,0,65800,350100,0,415900
123642701600000,NE 170,RESIDENTIAL,65800,0,65800,325500,0,391300
123642701700000,NE 170,RESIDENTIAL,99900,0,99900,587700,0,687600
123642800100000,NE 170,RESIDENTIAL,51700,0,51700,276100,0,327800
123642800200000,NE 170,RESIDENTIAL,45500,0,45500,269000,0,314500
123642800300000,NE 170,RESIDENTIAL,46000,0,46000,312200,0,358200
123642800400000,NE 170,RESIDENTIAL,53500,0,53500,275200,0,328700
123642800500000,NE 170,RESIDENTIAL,61500,0,61500,284600,0,346100
123642800800000,NE 170,RESIDENTIAL,47000,0,47000,323400,0,370400
123642800900000,NE 170,RESIDENTIAL,41100,0,41100,250000,0,291100
123642801000000,NE 170,RESIDENTIAL,48800,0,48800,133500,0,182300
123642801100000,NE 170,RESIDENTIAL,4600,0,4600,0,0,4600
123642801200000,NE 170,RESIDENTIAL,51000,0,51000,347700,0,398700
123642801300000,NE 170,RESIDENTIAL,51000,0,51000,306000,0,357000
123642801400000,NE 170,RESIDENTIAL,51000,0,51000,339900,0,390900
123642801500000,NE 170,RESIDENTIAL,51500,0,51500,439300,0,490800
123642801600000,NE 170,RESIDENTIAL,52000,0,52000,430300,0,482300
123642801700000,NE 170,RESIDENTIAL,52500,0,52500,341900,0,394400
123642801800000,NE 170,RESIDENTIAL,52500,0,52500,348800,0,401300
123642801900000,NE 170,RESIDENTIAL,52000,0,52000,312800,0,364800
123642802000000,NE 170,RESIDENTIAL,55100,0,55100,373300,0,428400
123642802100000,NE 170,RESIDENTIAL,73500,0,73500,399000,0,472500
123642802200000,NE 170,RESIDENTIAL,6900,0,6900,0,0,6900
123642802300000,NE 170,RESIDENTIAL,8000,0,8000,0,0,8000
123645100300000,NE 170,RESIDENTIAL,47500,0,47500,273900,0,321400
123645100400000,NE 170,RESIDENTIAL,600,0,600,0,0,600
123645100500000,NE 170,RESIDENTIAL,44100,0,44100,331900,0,376000
123645100600000,NE 170,RESIDENTIAL,43700,0,43700,0,0,43700
123645100700000,NE 170,RESIDENTIAL,52900,0,52900,322100,0,375000
123645100800000,NE 170,RESIDENTIAL,43700,0,43700,288700,0,332400
123645100900000,NE 170,RESIDENTIAL,53000,0,53000,285600,0,338600
123645101000000,NE 170,RESIDENTIAL,47500,0,47500,82400,0,129900
123645101100000,NE 170,RESIDENTIAL,49200,0,49200,370600,0,419800
123647600300000,NE 172,RESIDENTIAL,42100,0,42100,121000,0,163100
123647600400000,NE 172,RESIDENTIAL,42100,0,42100,118700,0,160800
123647600500000,NE 172,RESIDENTIAL,48700,0,48700,160300,0,209000
123647600600000,NE 172,RESIDENTIAL,46600,0,46600,170000,0,216600
123647600700000,NE 172,RESIDENTIAL,52700,0,52700,193400,0,246100
123647600800000,NE 172,RESIDENTIAL,45100,0,45100,162200,0,207300
123647600900000,NE 172,RESIDENTIAL,40700,0,40700,173400,0,214100
123647601000000,NE 172,RESIDENTIAL,45000,0,45000,214600,0,259600
123647601100000,NE 172,RESIDENTIAL,43000,0,43000,192100,0,235100
123647601200000,NE 172,RESIDENTIAL,42800,0,42800,231000,0,273800
123647601300000,NE 172,RESIDENTIAL,27400,0,27400,180400,0,207800
123647601400000,NE 172,RESIDENTIAL,27600,0,27600,181600,0,209200
123647601500000,NE 172,RESIDENTIAL,44900,0,44900,182200,0,227100
123647601600000,NE 172,RESIDENTIAL,47600,0,47600,192300,0,239900
123647601700000,NE 172,RESIDENTIAL,53600,0,53600,0,0,53600
123647601800000,NE 172,RESIDENTIAL,54300,0,54300,254400,0,308700
123647601900000,NE 172,RESIDENTIAL,50600,0,50600,206700,0,257300
123647602400000,NE 172,RESIDENTIAL,34500,0,34500,0,0,34500
123647602700000,NE 172,RESIDENTIAL,33600,0,33600,133300,0,166900
123647602800000,NE 172,RESIDENTIAL,35300,0,35300,125200,0,160500
123647602900000,NE 172,RESIDENTIAL,35100,0,35100,130000,0,165100
123647603000000,NE 172,RESIDENTIAL,32900,0,32900,132600,0,165500
123647603100000,NE 172,RESIDENTIAL,33300,0,33300,143200,0,176500
123647603200000,NE 172,RESIDENTIAL,35100,0,35100,143700,0,178800
123647603300000,NE 172,RESIDENTIAL,37200,0,37200,144100,0,181300
123647603400000,NE 172,RESIDENTIAL,37800,0,37800,157400,0,195200
123647603500000,NE 172,RESIDENTIAL,37800,0,37800,119200,0,157000
123647603600000,NE 172,RESIDENTIAL,37800,0,37800,124500,0,162300
123647603700000,NE 172,RESIDENTIAL,37100,0,37100,133000,0,170100
123647603800000,NE 172,RESIDENTIAL,35700,0,35700,120000,0,155700
123647603900000,NE 172,RESIDENTIAL,35500,0,35500,121000,0,156500
123647604000000,NE 172,RESIDENTIAL,33300,0,33300,130000,0,163300
123647604100000,NE 172,RESIDENTIAL,31500,0,31500,128300,0,159800
123647604200000,NE 172,RESIDENTIAL,34600,0,34600,128900,0,163500
123647604300000,NE 172,RESIDENTIAL,37800,0,37800,120600,0,158400
123647604400000,NE 172,RESIDENTIAL,100,0,100,0,0,100
123647604600000,NE 172,RESIDENTIAL,30900,0,30900,142000,0,172900
123647900100000,NE 172,RESIDENTIAL,46200,0,46200,184100,0,230300
123647900200000,NE 172,RESIDENTIAL,41600,0,41600,240100,0,281700
123647900300000,NE 172,RESIDENTIAL,41400,0,41400,209300,0,250700
123647900400000,NE 172,RESIDENTIAL,44600,0,44600,167600,0,212200
123647900500000,NE 172,RESIDENTIAL,42200,0,42200,180700,0,222900
123647900600000,NE 172,RESIDENTIAL,41400,0,41400,165600,0,207000
123647900700000,NE 172,RESIDENTIAL,42700,0,42700,145700,0,188400
123647900800000,NE 172,RESIDENTIAL,45900,0,45900,176900,0,222800
123647900900000,NE 172,RESIDENTIAL,47500,0,47500,228600,0,276100
123647901000000,NE 172,RESIDENTIAL,42100,0,42100,181600,0,223700
123647901100000,NE 172,RESIDENTIAL,35300,0,35300,164200,0,199500
123647901200000,NE 172,RESIDENTIAL,44900,0,44900,182200,0,227100
123647901300000,NE 172,RESIDENTIAL,43200,0,43200,202800,0,246000
123647901400000,NE 172,RESIDENTIAL,42500,0,42500,194800,0,237300
123647901500000,NE 172,RESIDENTIAL,47200,0,47200,202400,0,249600
123647901600000,NE 172,RESIDENTIAL,43900,0,43900,216900,0,260800
123647901700000,NE 172,RESIDENTIAL,44600,0,44600,197100,0,241700
123648000100000,NE 172,RESIDENTIAL,40400,0,40400,190400,0,230800
123648000200000,NE 172,RESIDENTIAL,40900,0,40900,179800,0,220700
123648000300000,NE 172,RESIDENTIAL,40300,0,40300,212800,0,253100
123648000400000,NE 172,RESIDENTIAL,41000,0,41000,191100,0,232100
123648000500000,NE 172,RESIDENTIAL,43500,0,43500,189000,0,232500
123648000600000,NE 172,RESIDENTIAL,0,0,0,0,0,0
123648000700000,NE 172,RESIDENTIAL,0,0,0,0,0,0
123648000800000,NE 172,RESIDENTIAL,49500,0,49500,206100,0,255600
123648000900000,NE 172,RESIDENTIAL,51600,0,51600,194600,0,246200
123648001000000,NE 172,RESIDENTIAL,51700,0,51700,240800,0,292500
123648001100000,NE 172,RESIDENTIAL,45900,0,45900,114200,0,160100
123648001200000,NE 172,RESIDENTIAL,200,0,200,0,0,200
123648001300000,NE 172,RESIDENTIAL,47500,0,47500,246200,0,293700
123648001400000,NE 172,RESIDENTIAL,44600,0,44600,270700,0,315300
123648001500000,NE 172,RESIDENTIAL,43000,0,43000,214800,0,257800
123648001600000,NE 172,RESIDENTIAL,52600,0,52600,207400,0,260000
123648001700000,NE 172,RESIDENTIAL,52600,0,52600,215300,0,267900
123648001800000,NE 172,RESIDENTIAL,56100,0,56100,210800,0,266900
123648001900000,NE 172,RESIDENTIAL,50900,0,50900,260000,0,310900
123648002000000,NE 172,RESIDENTIAL,53400,0,53400,272000,0,325400
123648002100000,NE 172,RESIDENTIAL,200,0,200,0,0,200
123648100100000,NE 172,RESIDENTIAL,200,0,200,0,0,200
123648100200000,NE 172,RESIDENTIAL,33600,0,33600,123600,0,157200
123648100300000,NE 172,RESIDENTIAL,34000,0,34000,135100,0,169100
123648100400000,NE 172,RESIDENTIAL,44400,0,44400,34200,0,78600
123648100500000,NE 172,RESIDENTIAL,36800,0,36800,128500,0,165300
123648100600000,NE 172,RESIDENTIAL,34500,0,34500,127900,0,162400
123648100700000,NE 172,RESIDENTIAL,33100,0,33100,128800,0,161900
123648100800000,NE 172,RESIDENTIAL,33500,0,33500,132300,0,165800
123648100900000,NE 172,RESIDENTIAL,38700,0,38700,124800,0,163500
123648101000000,NE 172,RESIDENTIAL,40600,0,40600,111800,0,152400
123648101100000,NE 172,RESIDENTIAL,38000,0,38000,37800,0,75800
123648101200000,NE 172,RESIDENTIAL,32900,0,32900,155800,0,188700
123648101300000,NE 172,RESIDENTIAL,32200,0,32200,160800,0,193000
123648101400000,NE 172,RESIDENTIAL,32200,0,32200,144600,0,176800
123648101500000,NE 172,RESIDENTIAL,36500,0,36500,131400,0,167900
130140100100000,NE 161,RESIDENTIAL,42600,0,42600,212300,0,254900
130140100200000,NE 161,RESIDENTIAL,42500,0,42500,216300,0,258800
130140100300000,NE 161,RESIDENTIAL,42500,0,42500,211500,0,254000
130140100400000,NE 161,RESIDENTIAL,42500,0,42500,188700,0,231200
130140100500000,NE 161,RESIDENTIAL,42500,0,42500,269800,0,312300
130140100600000,NE 161,RESIDENTIAL,42500,0,42500,232300,0,274800
130140100700000,NE 161,RESIDENTIAL,42500,0,42500,240800,0,283300
130140100800000,NE 161,RESIDENTIAL,42500,0,42500,207600,0,250100
130140100900000,NE 161,RESIDENTIAL,47700,0,47700,176500,0,224200
130140101000000,NE 161,RESIDENTIAL,42500,0,42500,229000,0,271500
130140101100000,NE 161,RESIDENTIAL,42500,0,42500,0,0,42500
130140200100000,NE 161,RESIDENTIAL,43400,0,43400,208800,0,252200
130140200200000,NE 161,RESIDENTIAL,46800,0,46800,224500,0,271300
130140200300000,NE 161,RESIDENTIAL,46000,0,46000,230600,0,276600
130140200400000,NE 161,RESIDENTIAL,44800,0,44800,268500,0,313300
130140200500000,NE 161,RESIDENTIAL,42300,0,42300,247100,0,289400
130140200600000,NE 161,RESIDENTIAL,48700,0,48700,204800,0,253500
130140200700000,NE 161,RESIDENTIAL,46300,0,46300,275100,0,321400
130140200800000,NE 161,RESIDENTIAL,45600,0,45600,204600,0,250200
130140200900000,NE 161,RESIDENTIAL,44800,0,44800,208300,0,253100
130140201000000,NE 161,RESIDENTIAL,48200,0,48200,0,0,48200
130140201200000,NE 161,RESIDENTIAL,1100,0,1100,0,0,1100
130140201300000,NE 161,RESIDENTIAL,1100,0,1100,0,0,1100
130140201400000,NE 161,RESIDENTIAL,1000,0,1000,0,0,1000
130140201500000,NE 161,RESIDENTIAL,1100,0,1100,0,0,1100
130140201600000,NE 161,RESIDENTIAL,55500,0,55500,305400,0,360900
130140201700000,NE 161,RESIDENTIAL,58800,0,58800,251500,0,310300
130140201800000,NE 161,RESIDENTIAL,55200,0,55200,222900,0,278100
130140201900000,NE 161,RESIDENTIAL,61800,0,61800,393100,0,454900
130140202000000,NE 161,RESIDENTIAL,59800,0,59800,230000,0,289800
130140202100000,NE 161,RESIDENTIAL,73500,0,73500,292900,0,366400
130140202200000,NE 161,RESIDENTIAL,65000,0,65000,283900,0,348900
130140202300000,NE 161,RESIDENTIAL,61600,0,61600,328800,0,390400
130140202400000,NE 161,RESIDENTIAL,56600,0,56600,0,0,56600
130140202500000,NE 161,RESIDENTIAL,54700,0,54700,225800,0,280500
130140202600000,NE 161,RESIDENTIAL,55100,0,55100,0,0,55100
130140202700000,NE 161,RESIDENTIAL,55100,0,55100,233100,0,288200
130140300100000,NE 161,RESIDENTIAL,53700,0,53700,232000,0,285700
130140300200000,NE 161,RESIDENTIAL,42800,0,42800,246700,0,289500
130140300300000,NE 161,RESIDENTIAL,44600,0,44600,230000,0,274600
130140300400000,NE 161,RESIDENTIAL,46900,0,46900,243500,0,290400
130140300500000,NE 161,RESIDENTIAL,54000,0,54000,0,0,54000
130140300600000,NE 161,RESIDENTIAL,54900,0,54900,247900,0,302800
130140300700000,NE 161,RESIDENTIAL,53200,0,53200,261000,0,314200
130140300800000,NE 161,RESIDENTIAL,56300,0,56300,217000,0,273300
130140300900000,NE 161,RESIDENTIAL,53500,0,53500,284000,0,337500
130140400100000,NE 128,RESIDENTIAL,12000,0,12000,0,0,12000
130142700100000,NE 161,RESIDENTIAL,78100,0,78100,0,0,78100
130142700200000,NE 161,RESIDENTIAL,47700,0,47700,0,0,47700
130142700300000,NE 161,RESIDENTIAL,48000,0,48000,222000,0,270000
130142700400000,NE 161,RESIDENTIAL,49000,0,49000,0,0,49000
130142700500000,NE 161,RESIDENTIAL,47100,0,47100,245300,0,292400
130142700600000,NE 161,RESIDENTIAL,47100,0,47100,229200,0,276300
130142700700000,NE 161,RESIDENTIAL,49000,0,49000,270300,0,319300
130142700800000,NE 161,RESIDENTIAL,47700,0,47700,293100,0,340800
130142700900000,NE 161,RESIDENTIAL,43800,0,43800,0,0,43800
130142701000000,NE 161,RESIDENTIAL,54800,0,54800,243000,0,297800
130142701100000,NE 161,RESIDENTIAL,55000,0,55000,222700,0,277700
130142701200000,NE 161,RESIDENTIAL,62600,0,62600,298000,0,360600
130142701300000,NE 161,RESIDENTIAL,56200,0,56200,0,0,56200
130142701400000,NE 161,RESIDENTIAL,52000,0,52000,203700,0,255700
130142701500000,NE 161,RESIDENTIAL,52000,0,52000,0,0,52000
130142701600000,NE 161,RESIDENTIAL,57900,0,57900,0,0,57900
130142800100000,NE 161,RESIDENTIAL,53500,0,53500,246900,0,300400
130142800200000,NE 161,RESIDENTIAL,53600,0,53600,221200,0,274800
130145100100000,SCHOOL,EXEMPT,0,1404400,1404400,0,12511900,13916300
130145200100000,NE 128,RESIDENTIAL,21500,0,21500,77700,0,99200
130147600100000,NE 128,RESIDENTIAL,80000,0,80000,297500,0,377500
130147600200000,NE 128,RESIDENTIAL,38700,0,38700,0,0,38700
130147600300000,NE 128,RESIDENTIAL,100000,0,100000,577700,0,677700
130147600400000,NE 128,RESIDENTIAL,81200,0,81200,530100,0,611300
130147600500000,NE 128,RESIDENTIAL,77200,0,77200,408200,0,485400
130147600600000,NE 128,RESIDENTIAL,76300,0,76300,289500,0,365800
130147600700000,NE 128,RESIDENTIAL,83000,0,83000,454000,0,537000
130147600800000,NE 128,RESIDENTIAL,98400,0,98400,301200,0,399600
130147600900000,NE 128,RESIDENTIAL,93500,0,93500,552900,0,646400
130147601000000,NE 128,RESIDENTIAL,101700,0,101700,439000,0,540700
130147601100000,NE 128,RESIDENTIAL,85600,0,85600,522700,0,608300
130147601200000,NE 128,RESIDENTIAL,81600,0,81600,338500,0,420100
130147601300000,NE 128,RESIDENTIAL,76300,0,76300,371500,0,447800
130147601400000,NE 128,RESIDENTIAL,74100,0,74100,308900,0,383000
130147601500000,NE 128,RESIDENTIAL,74900,0,74900,451400,0,526300
130147601600000,NE 128,RESIDENTIAL,74200,0,74200,488800,0,563000
130147601700000,NE 128,RESIDENTIAL,54000,0,54000,0,0,54000
130147602000000,NE 128,RESIDENTIAL,43100,0,43100,140400,0,183500
130147602700000,NE 128,RESIDENTIAL,1400,0,1400,0,0,1400
130147800100000,NE 128,RESIDENTIAL,72700,0,72700,443100,0,515800
130147800200000,NE 128,RESIDENTIAL,68600,0,68600,385200,0,453800
130147800300000,NE 128,RESIDENTIAL,74900,0,74900,508600,0,583500
130147800400000,NE 128,RESIDENTIAL,71100,0,71100,364800,0,435900
130147800500000,NE 128,RESIDENTIAL,0,0,0,0,0,0
130147900100000,NE 128,RESIDENTIAL,73400,0,73400,410500,0,483900
130147900200000,NE 128,RESIDENTIAL,74900,0,74900,319200,0,394100
130147900300000,NE 128,RESIDENTIAL,74200,0,74200,637500,0,711700
130147900400000,NE 128,RESIDENTIAL,54500,0,54500,0,0,54500
131140100100000,NE 165,RESIDENTIAL,787600,0,787600,1446700,0,2234300
131147600100000,CITY PROPERTY,EXEMPT,0,0,0,0,0,0
131212600300000,NE 128,RESIDENTIAL,33700,0,33700,122600,0,156300
131220100100000,NE 165,RESIDENTIAL,59300,0,59300,307000,0,366300
131220100200000,NE 165,RESIDENTIAL,51900,0,51900,298900,0,350800
131220100300000,NE 165,RESIDENTIAL,57700,0,57700,277200,0,334900
131220100400000,NE 165,RESIDENTIAL,66300,0,66300,295300,0,361600
131220100500000,NE 165,RESIDENTIAL,74500,0,74500,329200,0,403700
131220100600000,NE 165,RESIDENTIAL,73700,0,73700,293400,0,367100
131220100700000,NE 165,RESIDENTIAL,65900,0,65900,416300,0,482200
131220101000000,NE 165,RESIDENTIAL,65100,0,65100,356900,0,422000
131220101100000,NE 165,RESIDENTIAL,71400,0,71400,328800,0,400200
131220101200000,NE 165,RESIDENTIAL,68700,0,68700,362500,0,431200
131220101300000,NE 165,RESIDENTIAL,72600,0,72600,394800,0,467400
131220101400000,NE 165,RESIDENTIAL,77100,0,77100,326700,0,403800
131220101500000,NE 165,RESIDENTIAL,56400,0,56400,306400,0,362800
131220101600000,NE 165,RESIDENTIAL,59900,0,59900,299900,0,359800
131220101700000,NE 165,RESIDENTIAL,62600,0,62600,479800,0,542400
131220101800000,NE 165,RESIDENTIAL,65800,0,65800,396100,0,461900
131220101900000,NE 165,RESIDENTIAL,72400,0,72400,362000,0,434400
131220102000000,NE 165,RESIDENTIAL,100400,0,100400,515700,0,616100
131220102100000,NE 165,RESIDENTIAL,87700,0,87700,385500,0,473200
131220102200000,NE 165,RESIDENTIAL,104500,0,104500,607100,0,711600
131220102300000,NE 165,RESIDENTIAL,86700,0,86700,556600,0,643300
131220102400000,NE 165,RESIDENTIAL,86500,0,86500,316900,0,403400
131220102500000,NE 165,RESIDENTIAL,100700,0,100700,398700,0,499400
131220102600000,NE 165,RESIDENTIAL,84200,0,84200,433700,0,517900
131220102900000,NE 165,RESIDENTIAL,55800,0,55800,1800,0,57600
131220103000000,NE 165,RESIDENTIAL,60000,0,60000,380200,0,440200
131220103100000,NE 165,RESIDENTIAL,56900,0,56900,319000,0,375900
131220103200000,NE 165,RESIDENTIAL,65900,0,65900,380200,0,446100
131220103300000,NE 165,RESIDENTIAL,61600,0,61600,293000,0,354600
131220103400000,NE 165,RESIDENTIAL,62100,0,62100,489200,0,551300
131220103500000,NE 165,RESIDENTIAL,63600,0,63600,415100,0,478700
131220103600000,NE 165,RESIDENTIAL,63800,0,63800,293200,0,357000
131220103700000,NE 165,RESIDENTIAL,63100,0,63100,391500,0,454600
131220103800000,NE 165,RESIDENTIAL,68900,0,68900,297500,0,366400
131220103900000,NE 165,RESIDENTIAL,60500,0,60500,256800,0,317300
131220104000000,NE 165,RESIDENTIAL,54600,0,54600,0,0,54600
131220104100000,NE 165,RESIDENTIAL,63800,0,63800,467500,0,531300
131220104200000,NE 165,RESIDENTIAL,67300,0,67300,317500,0,384800
131220104300000,NE 165,RESIDENTIAL,62000,0,62000,324000,0,386000
131220104400000,NE 165,RESIDENTIAL,62700,0,62700,392800,0,455500
131220104500000,NE 165,RESIDENTIAL,55100,0,55100,0,0,55100
131220104600000,NE 165,RESIDENTIAL,74600,0,74600,361600,0,436200
131220104700000,NE 165,RESIDENTIAL,58700,0,58700,272600,0,331300
131220104800000,NE 165,RESIDENTIAL,71400,0,71400,354200,0,425600
131220104900000,NE 165,RESIDENTIAL,62800,0,62800,403200,0,466000
131220105000000,NE 165,RESIDENTIAL,73700,0,73700,331400,0,405100
131220105100000,NE 165,RESIDENTIAL,65500,0,65500,353000,0,418500
131220105300000,NE 165,RESIDENTIAL,65100,0,65100,313100,0,378200
131220105400000,NE 165,RESIDENTIAL,67300,0,67300,364500,0,431800
131222700100000,NE 165,RESIDENTIAL,91400,0,91400,363300,0,454700
131222700200000,NE 165,RESIDENTIAL,88300,0,88300,294100,0,382400
131222700300000,NE 165,RESIDENTIAL,70600,0,70600,0,0,70600
131222700400000,NE 165,RESIDENTIAL,76200,0,76200,0,0,76200
131222700500000,NE 165,RESIDENTIAL,82500,0,82500,333500,0,416000
131222700600000,NE 165,RESIDENTIAL,80500,0,80500,0,0,80500
131222700700000,NE 165,RESIDENTIAL,92500,0,92500,0,0,92500
131222700800000,NE 165,RESIDENTIAL,87800,0,87800,540200,0,628000
131222700900000,NE 165,RESIDENTIAL,100100,0,100100,470000,0,570100
131222701000000,NE 165,RESIDENTIAL,74400,0,74400,371200,0,445600
131222701100000,NE 165,RESIDENTIAL,81100,0,81100,417600,0,498700
131222701200000,NE 165,RESIDENTIAL,82300,0,82300,442100,0,524400
131222701300000,NE 165,RESIDENTIAL,104300,0,104300,458500,0,562800
131222701400000,NE 165,RESIDENTIAL,104400,0,104400,466400,0,570800
131222701500000,NE 165,RESIDENTIAL,92200,0,92200,0,0,92200
131222701600000,NE 165,RESIDENTIAL,69000,0,69000,0,0,69000
131222701700000,NE 165,RESIDENTIAL,83400,0,83400,358600,0,442000
131222701800000,NE 165,RESIDENTIAL,92900,0,92900,359800,0,452700
131222702000000,NE 151,RESIDENTIAL,74900,0,74900,0,0,74900
131222702100000,NE 151,RESIDENTIAL,86600,0,86600,527400,0,614000
131222702200000,NE 151,RESIDENTIAL,100800,0,100800,0,0,100800
131222702300000,NE 151,RESIDENTIAL,80000,0,80000,305800,0,385800
131222702400000,NE 151,RESIDENTIAL,93900,0,93900,0,0,93900
131222800100000,NE 151,RESIDENTIAL,74400,0,74400,0,0,74400
131225100100000,NE 165,RESIDENTIAL,96300,0,96300,0,0,96300
131225100500000,NE 165,RESIDENTIAL,122100,0,122100,608500,0,730600
131225100600000,NE 165,RESIDENTIAL,1500,0,1500,0,0,1500
131225100700000,NE 165,RESIDENTIAL,400,0,400,0,0,400
131225100800000,NE 165,RESIDENTIAL,135500,0,135500,549400,0,684900
131225100900000,NE 165,RESIDENTIAL,151000,0,151000,0,0,151000
131225101000000,NE 165,RESIDENTIAL,151600,0,151600,584000,0,735600
131225101100000,NE 165,RESIDENTIAL,94900,0,94900,0,0,94900
131225101200000,NE 165,RESIDENTIAL,153600,0,153600,496100,0,649700
131225101300000,NE 165,RESIDENTIAL,152500,0,152500,852400,0,1004900
131225101400000,NE 165,RESIDENTIAL,155300,0,155300,579900,0,735200
131225101500000,NE 165,RESIDENTIAL,152300,0,152300,491500,0,643800
131225101600000,NE 165,RESIDENTIAL,153400,0,153400,380700,0,534100
131225101700000,NE 165,RESIDENTIAL,154800,0,154800,570100,0,724900
131225101800000,NE 165,RESIDENTIAL,138500,0,138500,557800,0,696300
131225101900000,NE 165,RESIDENTIAL,86800,0,86800,0,0,86800
131225102000000,NE 165,RESIDENTIAL,121500,0,121500,490300,0,611800
131225102200000,NE 151,RESIDENTIAL,95500,0,95500,0,0,95500
131225102300000,NE 151,RESIDENTIAL,64900,0,64900,0,0,64900
131225102400000,NE 151,RESIDENTIAL,127800,0,127800,573700,0,701500
131225102500000,NE 151,RESIDENTIAL,94300,0,94300,0,0,94300
131225102600000,NE 151,RESIDENTIAL,94200,0,94200,544000,0,638200
131225102700000,NE 151,RESIDENTIAL,141900,0,141900,0,0,141900
131225102800000,NE 151,RESIDENTIAL,90500,0,90500,494000,0,584500
131225102900000,NE 151,RESIDENTIAL,61100,0,61100,479000,0,540100
131225103000000,NE 151,RESIDENTIAL,58200,0,58200,4500,0,62700
131225103100000,NE 151,RESIDENTIAL,68400,0,68400,520500,0,588900
131225103200000,NE 151,RESIDENTIAL,69200,0,69200,341800,0,411000
131225103400000,NE 151,RESIDENTIAL,12000,0,12000,0,0,12000
131225103500000,NE 151,RESIDENTIAL,8500,0,8500,0,0,8500
131225103600000,NE 151,RESIDENTIAL,73900,0,73900,394900,0,468800
131225103800000,NE 165,RESIDENTIAL,175000,0,175000,715300,0,890300
131225104000000,NE 151,RESIDENTIAL,72800,0,72800,408600,0,481400
131227600100000,NE 151,RESIDENTIAL,65000,0,65000,143800,0,208800
131227600200000,NE 151,RESIDENTIAL,84900,0,84900,175400,0,260300
131227600300000,NE 165,RESIDENTIAL,100000,0,100000,396300,0,496300
131227600400000,NE 165,RESIDENTIAL,106800,0,106800,453000,0,559800
131227600500000,NE 165,RESIDENTIAL,120500,0,120500,348300,0,468800
131227600600000,NE 165,RESIDENTIAL,121200,0,121200,551200,0,672400
131227600700000,NE 165,RESIDENTIAL,119900,0,119900,490200,0,610100
131227600800000,NE 165,RESIDENTIAL,120100,0,120100,577700,0,697800
131227700100000,NE 165,RESIDENTIAL,111400,0,111400,530100,0,641500
131227700200000,NE 165,RESIDENTIAL,116700,0,116700,552200,0,668900
131227800100000,MISCELLANEOUS,COMMERCIAL,0,244700,244700,0,122500,367200
131227900100000,NE 165,RESIDENTIAL,93400,0,93400,0,0,93400
131227900200000,NE 165,RESIDENTIAL,111200,0,111200,410400,0,521600
131227900300000,NE 165,RESIDENTIAL,117700,0,117700,638800,0,756500
131227900600000,NE 151,RESIDENTIAL,60000,0,60000,136500,0,196500
131227900700000,NE 151,RESIDENTIAL,60000,0,60000,127800,0,187800
131227900800000,NE 165,RESIDENTIAL,121200,0,121200,418500,0,539700
131227901100000,NE 165,RESIDENTIAL,6500,0,6500,0,0,6500
131227901200000,NE 165,RESIDENTIAL,89900,0,89900,0,0,89900
131227901300000,NE 165,RESIDENTIAL,120300,0,120300,406500,0,526800
131227901400000,NE 165,RESIDENTIAL,59400,0,59400,0,0,59400
131227901500000,NE 165,RESIDENTIAL,58200,0,58200,0,0,58200
131230100300000,NE 151,RESIDENTIAL,48000,0,48000,284100,0,332100
131230100400000,NE 151,RESIDENTIAL,43700,0,43700,250100,0,293800
131230100500000,NE 151,RESIDENTIAL,48600,0,48600,234300,0,282900
131230100600000,NE 151,RESIDENTIAL,46000,0,46000,244900,0,290900
131230100700000,NE 151,RESIDENTIAL,38500,0,38500,0,0,38500
131230100800000,NE 151,RESIDENTIAL,48600,0,48600,250100,0,298700
131230100900000,NE 151,RESIDENTIAL,39600,0,39600,0,0,39600
131230101100000,NE 151,RESIDENTIAL,7400,0,7400,0,0,7400
131230101200000,NE 151,RESIDENTIAL,62800,0,62800,286000,0,348800
131230101300000,NE 151,RESIDENTIAL,62100,0,62100,357800,0,419900
131230101400000,NE 151,RESIDENTIAL,63600,0,63600,401700,0,465300
131230101500000,NE 151,RESIDENTIAL,61800,0,61800,384100,0,445900
131230101600000,NE 151,RESIDENTIAL,61200,0,61200,295800,0,357000
131230200200000,NE 151,RESIDENTIAL,11500,0,11500,0,0,11500
131230200300000,NE 151,RESIDENTIAL,72000,0,72000,110400,0,182400
131230200600000,NE 151,RESIDENTIAL,47600,0,47600,215500,0,263100
131230200700000,NE 151,RESIDENTIAL,52100,0,52100,0,0,52100
131230200800000,NE 151,RESIDENTIAL,52700,0,52700,0,0,52700
131230200900000,NE 151,RESIDENTIAL,67900,0,67900,0,0,67900
131230201100000,NE 151,RESIDENTIAL,107800,0,107800,321400,0,429200
131230201200000,NE 151,RESIDENTIAL,61600,0,61600,299800,0,361400
131230201300000,NE 151,RESIDENTIAL,68600,0,68600,353000,0,421600
131230201400000,NE 151,RESIDENTIAL,68600,0,68600,341000,0,409600
131230201500000,NE 151,RESIDENTIAL,62400,0,62400,345300,0,407700
131230201600000,NE 151,RESIDENTIAL,61200,0,61200,281600,0,342800
131230201700000,NE 151,RESIDENTIAL,78800,0,78800,388800,0,467600
131230201800000,NE 151,RESIDENTIAL,110000,0,110000,489400,0,599400
131230201900000,NE 151,RESIDENTIAL,1600,0,1600,0,0,1600
131230202000000,NE 151,RESIDENTIAL,70100,0,70100,0,0,70100
131230300100000,NE 151,RESIDENTIAL,53000,0,53000,249100,0,302100
131230300200000,NE 151,RESIDENTIAL,43500,0,43500,196900,0,240400
131230300300000,NE 151,RESIDENTIAL,43500,0,43500,223100,0,266600
131230300400000,NE 151,RESIDENTIAL,43500,0,43500,197400,0,240900
131230300500000,NE 151,RESIDENTIAL,42400,0,42400,277700,0,320100
131230300600000,NE 151,RESIDENTIAL,46700,0,46700,237700,0,284400
131230301500000,NE 151,RESIDENTIAL,46900,0,46900,249400,0,296300
131230301600000,NE 151,RESIDENTIAL,45100,0,45100,257200,0,302300
131230301900000,NE 151,RESIDENTIAL,40000,0,40000,231900,0,271900
131230302000000,NE 151,RESIDENTIAL,39400,0,39400,240400,0,279800
131230302100000,NE 151,RESIDENTIAL,42300,0,42300,238700,0,281000
131230302200000,NE 151,RESIDENTIAL,52800,0,52800,247600,0,300400
131230302300000,NE 151,RESIDENTIAL,51800,0,51800,276200,0,328000
131230302400000,NE 151,RESIDENTIAL,49000,0,49000,253600,0,302600
131230302500000,NE 151,RESIDENTIAL,49000,0,49000,332100,0,381100
131230302600000,NE 151,RESIDENTIAL,2400,0,2400,0,0,2400
131230302700000,NE 151,RESIDENTIAL,900,0,900,0,0,900
131230302800000,NE 151,RESIDENTIAL,41400,0,41400,260500,0,301900
131230302900000,NE 151,RESIDENTIAL,42400,0,42400,255600,0,298000
131230303200000,NE 151,RESIDENTIAL,63700,0,63700,245400,0,309100
131230303500000,NE 151,RESIDENTIAL,43200,0,43200,0,0,43200
131230303600000,NE 151,RESIDENTIAL,51900,0,51900,10500,0,62400
131230303700000,NE 151,RESIDENTIAL,43000,0,43000,0,0,43000
131230303800000,NE 151,RESIDENTIAL,35300,0,35300,0,0,35300
131230303900000,NE 151,RESIDENTIAL,43000,0,43000,0,0,43000
131230304000000,NE 151,RESIDENTIAL,53800,0,53800,242700,0,296500
131230400100000,NE 151,RESIDENTIAL,47900,0,47900,0,0,47900
131230400200000,NE 151,RESIDENTIAL,50900,0,50900,0,0,50900
131230400300000,NE 151,RESIDENTIAL,63600,0,63600,265600,0,329200
131230400400000,NE 151,RESIDENTIAL,59300,0,59300,332100,0,391400
131230500300000,NE 151,RESIDENTIAL,5500,0,5500,0,0,5500
131230500400000,NE 151,RESIDENTIAL,58700,0,58700,307100,0,365800
131230500500000,NE 151,RESIDENTIAL,58200,0,58200,272300,0,330500
131230500600000,NE 151,RESIDENTIAL,70300,0,70300,289600,0,359900
131230500800000,NE 151,RESIDENTIAL,61600,0,61600,366300,0,427900
131230500900000,NE 151,RESIDENTIAL,62200,0,62200,367000,0,429200
131232600200000,NE 151,RESIDENTIAL,212800,0,212800,338400,0,551200
131232600300000,NE 151,RESIDENTIAL,100000,0,100000,486000,0,586000
131232600400000,NE 151,RESIDENTIAL,61200,0,61200,386500,0,447700
131232600500000,NE 151,RESIDENTIAL,62400,0,62400,372900,0,435300
131232600600000,NE 151,RESIDENTIAL,68600,0,68600,410600,0,479200
131232600900000,NE 151,RESIDENTIAL,73300,0,73300,357300,0,430600
131232601000000,NE 151,RESIDENTIAL,57800,0,57800,350000,0,407800
131232601100000,NE 151,RESIDENTIAL,56200,0,56200,389800,0,446000
131232601200000,NE 151,RESIDENTIAL,62400,0,62400,313500,0,375900
131232601300000,NE 151,RESIDENTIAL,63300,0,63300,310800,0,374100
131232601400000,NE 151,RESIDENTIAL,103700,0,103700,393400,0,497100
131232601500000,NE 151,RESIDENTIAL,101100,0,101100,0,0,101100
131232601600000,NE 151,RESIDENTIAL,98300,0,98300,386500,0,484800
131232601700000,NE 151,RESIDENTIAL,66600,0,66600,420000,0,486600
131232601800000,NE 151,RESIDENTIAL,60500,0,60500,0,0,60500
131232601900000,NE 151,RESIDENTIAL,93000,0,93000,511000,0,604000
131232602000000,NE 151,RESIDENTIAL,100,0,100,0,0,100
131232602100000,NE 151,RESIDENTIAL,63700,0,63700,462500,0,526200
131232602200000,NE 151,RESIDENTIAL,73900,0,73900,408600,0,482500
131232602300000,NE 151,RESIDENTIAL,78300,0,78300,357300,0,435600
131232602400000,NE 151,RESIDENTIAL,67600,0,67600,314200,0,381800
131232602500000,NE 151,RESIDENTIAL,71400,0,71400,511200,0,582600
131232700100000,NE 151,RESIDENTIAL,59300,0,59300,284300,0,343600
131232700200000,NE 151,RESIDENTIAL,59300,0,59300,297000,0,356300
131232700300000,NE 151,RESIDENTIAL,59300,0,59300,313800,0,373100
131232700400000,NE 151,RESIDENTIAL,59300,0,59300,392100,0,451400
131232700500000,NE 151,RESIDENTIAL,65700,0,65700,334700,0,400400
131232700600000,NE 151,RESIDENTIAL,65100,0,65100,333500,0,398600
131232700700000,NE 151,RESIDENTIAL,63000,0,63000,392400,0,455400
131232700800000,NE 151,RESIDENTIAL,58700,0,58700,445500,0,504200
131232700900000,NE 151,RESIDENTIAL,77700,0,77700,428900,0,506600
131232701000000,NE 151,RESIDENTIAL,77000,0,77000,413000,0,490000
131232701100000,NE 151,RESIDENTIAL,59300,0,59300,319100,0,378400
131232701200000,NE 151,RESIDENTIAL,62000,0,62000,376900,0,438900
131232701300000,NE 151,RESIDENTIAL,64300,0,64300,403900,0,468200
131232701400000,NE 151,RESIDENTIAL,67600,0,67600,340100,0,407700
131232701500000,NE 151,RESIDENTIAL,65200,0,65200,74900,0,140100
131232701700000,NE 151,RESIDENTIAL,1100,0,1100,0,0,1100
131235100300000,NE 150,RESIDENTIAL,54300,0,54300,217100,0,271400
131235100400000,NE 150,RESIDENTIAL,54300,0,54300,290000,0,344300
131235100500000,NE 150,RESIDENTIAL,55900,0,55900,253000,0,308900
131235100600000,NE 150,RESIDENTIAL,53500,0,53500,284400,0,337900
131235100700000,NE 150,RESIDENTIAL,53000,0,53000,245100,0,298100
131235100800000,NE 150,RESIDENTIAL,58400,0,58400,303100,0,361500
131235100900000,NE 150,RESIDENTIAL,57000,0,57000,255100,0,312100
131235101000000,NE 150,RESIDENTIAL,57900,0,57900,510200,0,568100
131235101100000,NE 150,RESIDENTIAL,56500,0,56500,210200,0,266700
131235101200000,NE 150,RESIDENTIAL,56500,0,56500,189900,0,246400
131235101400000,NE 150,RESIDENTIAL,47100,0,47100,262700,0,309800
131235101500000,NE 150,RESIDENTIAL,59700,0,59700,266400,0,326100
131235101600000,NE 150,RESIDENTIAL,52900,0,52900,0,0,52900
131235101700000,NE 150,RESIDENTIAL,55100,0,55100,294200,0,349300
131235101800000,NE 150,RESIDENTIAL,55900,0,55900,268900,0,324800
131235101900000,NE 150,RESIDENTIAL,71400,0,71400,303900,0,375300
131235102000000,NE 150,RESIDENTIAL,56200,0,56200,284900,0,341100
131235102100000,NE 150,RESIDENTIAL,58600,0,58600,382400,0,441000
131235102200000,NE 150,RESIDENTIAL,67000,0,67000,325600,0,392600
131235102300000,NE 150,RESIDENTIAL,63600,0,63600,316100,0,379700
131235102400000,NE 150,RESIDENTIAL,57300,0,57300,428700,0,486000
131235102500000,NE 150,RESIDENTIAL,61600,0,61600,367600,0,429200
131235102600000,NE 150,RESIDENTIAL,55100,0,55100,300300,0,355400
131235102700000,NE 150,RESIDENTIAL,55300,0,55300,309100,0,364400
131235102800000,NE 150,RESIDENTIAL,24500,0,24500,0,0,24500
131235102900000,NE 150,RESIDENTIAL,23200,0,23200,0,0,23200
131235103000000,NE 150,RESIDENTIAL,56200,0,56200,354500,0,410700
131235103100000,NE 150,RESIDENTIAL,56200,0,56200,285700,0,341900
131235103200000,NE 150,RESIDENTIAL,56200,0,56200,294900,0,351100
131235103300000,NE 150,RESIDENTIAL,56200,0,56200,214000,0,270200
131235103400000,NE 150,RESIDENTIAL,56200,0,56200,229900,0,286100
131235103500000,NE 150,RESIDENTIAL,59200,0,59200,272800,0,332000
131235103600000,NE 151,RESIDENTIAL,1300,0,1300,0,0,1300
131235103700000,NE 150,RESIDENTIAL,3300,0,3300,1200,0,4500
131235103800000,NE 150,RESIDENTIAL,62300,0,62300,202100,0,264400
131235200100000,NE 150,RESIDENTIAL,54800,0,54800,222400,0,277200
131235200200000,NE 150,RESIDENTIAL,52900,0,52900,265800,0,318700
131235200300000,NE 150,RESIDENTIAL,52600,0,52600,261700,0,314300
131235200400000,NE 150,RESIDENTIAL,52900,0,52900,217400,0,270300
131235200500000,NE 150,RESIDENTIAL,52900,0,52900,265800,0,318700
131235200600000,NE 150,RESIDENTIAL,51300,0,51300,268600,0,319900
131235200700000,NE 150,RESIDENTIAL,52200,0,52200,268400,0,320600
131235200800000,NE 150,RESIDENTIAL,54400,0,54400,167100,0,221500
131235200900000,NE 150,RESIDENTIAL,54100,0,54100,155700,0,209800
131235201000000,NE 150,RESIDENTIAL,52900,0,52900,152500,0,205400
131235201100000,NE 150,RESIDENTIAL,52900,0,52900,192900,0,245800
131235201200000,NE 150,RESIDENTIAL,45700,0,45700,197200,0,242900
131235201300000,NE 150,RESIDENTIAL,51800,0,51800,193200,0,245000
131235201400000,NE 150,RESIDENTIAL,53500,0,53500,188500,0,242000
131235300100000,NE 150,RESIDENTIAL,57300,0,57300,356100,0,413400
131235300200000,NE 150,RESIDENTIAL,56800,0,56800,303500,0,360300
131235300300000,NE 150,RESIDENTIAL,56800,0,56800,261700,0,318500
131235300400000,NE 150,RESIDENTIAL,56700,0,56700,380900,0,437600
131237600100000,NE 150,RESIDENTIAL,45700,0,45700,117900,0,163600
131237600200000,NE 150,RESIDENTIAL,44300,0,44300,99500,0,143800
131237600300000,NE 150,RESIDENTIAL,45000,0,45000,156300,0,201300
131237600500000,NE 150,RESIDENTIAL,0,0,0,0,0,0
131237600600000,NE 150,RESIDENTIAL,45900,0,45900,172300,0,218200
131237600700000,NE 150,RESIDENTIAL,44300,0,44300,171200,0,215500
131237600800000,NE 150,RESIDENTIAL,43700,0,43700,298500,0,342200
131237600900000,NE 150,RESIDENTIAL,52800,0,52800,0,0,52800
131237601000000,NE 150,RESIDENTIAL,52600,0,52600,307000,0,359600
131237601100000,NE 150,RESIDENTIAL,52600,0,52600,370600,0,423200
131237601200000,NE 150,RESIDENTIAL,70100,0,70100,373200,0,443300
131237601300000,NE 150,RESIDENTIAL,16900,0,16900,0,0,16900
131237601500000,NE 150,RESIDENTIAL,62000,0,62000,143600,0,205600
131237700100000,NE 150,RESIDENTIAL,47100,0,47100,212800,0,259900
131237700200000,NE 150,RESIDENTIAL,42600,0,42600,214800,0,257400
131237700300000,NE 150,RESIDENTIAL,42200,0,42200,211500,0,253700
131237700400000,NE 150,RESIDENTIAL,44000,0,44000,212900,0,256900
131237700500000,NE 150,RESIDENTIAL,45900,0,45900,240900,0,286800
131237800100000,NE 150,RESIDENTIAL,57600,0,57600,193900,0,251500
131237800200000,NE 150,RESIDENTIAL,55600,0,55600,232500,0,288100
131237800300000,NE 150,RESIDENTIAL,60900,0,60900,162300,0,223200
131237800400000,NE 150,RESIDENTIAL,60900,0,60900,253100,0,314000
131237800500000,NE 150,RESIDENTIAL,60900,0,60900,354800,0,415700
131237800600000,NE 150,RESIDENTIAL,54800,0,54800,184700,0,239500
131237800700000,NE 150,RESIDENTIAL,60400,0,60400,216200,0,276600
131237900100000,NE 150,RESIDENTIAL,48700,0,48700,247800,0,296500
131237900200000,NE 150,RESIDENTIAL,49100,0,49100,293800,0,342900
131237900300000,NE 150,RESIDENTIAL,54300,0,54300,251000,0,305300
131237900400000,NE 150,RESIDENTIAL,58000,0,58000,281000,0,339000
131237900500000,NE 150,RESIDENTIAL,53400,0,53400,311200,0,364600
131238000100000,NE 150,RESIDENTIAL,58600,0,58600,268200,0,326800
131238000200000,NE 150,RESIDENTIAL,54800,0,54800,274600,0,329400
131238000300000,NE 150,RESIDENTIAL,51700,0,51700,212300,0,264000
131238000400000,NE 150,RESIDENTIAL,56700,0,56700,180400,0,237100
131240100200000,NE 151,RESIDENTIAL,10000,0,10000,0,0,10000
131240100800000,NE 151,RESIDENTIAL,100300,0,100300,0,0,100300
131240100900000,NE 151,RESIDENTIAL,144900,0,144900,555400,0,700300
131240101200000,NE 151,RESIDENTIAL,97200,0,97200,533000,0,630200
131240101300000,NE 151,RESIDENTIAL,99800,0,99800,384300,0,484100
131240101400000,NE 151,RESIDENTIAL,95900,0,95900,419200,0,515100
131240101500000,NE 151,RESIDENTIAL,108600,0,108600,476700,0,585300
131240101600000,NE 151,RESIDENTIAL,98500,0,98500,460600,0,559100
131240101700000,NE 151,RESIDENTIAL,97200,0,97200,441300,0,538500
131240102200000,NE 151,RESIDENTIAL,4000,0,4000,0,0,4000
131240102300000,NE 151,RESIDENTIAL,87800,0,87800,10500,0,98300
131240102400000,NE 151,RESIDENTIAL,92200,0,92200,430700,0,522900
131240200100000,NE 151,RESIDENTIAL,101600,0,101600,527200,0,628800
131240200200000,NE 151,RESIDENTIAL,115200,0,115200,617200,0,732400
131240200300000,NE 151,RESIDENTIAL,110700,0,110700,415900,0,526600
131240200400000,NE 151,RESIDENTIAL,111900,0,111900,373800,0,485700
131240200500000,NE 151,RESIDENTIAL,17200,0,17200,0,0,17200
131240200600000,NE 151,RESIDENTIAL,102600,0,102600,410900,0,513500
131242700100000,NE 151,RESIDENTIAL,58800,0,58800,270500,0,329300
131242700200000,NE 151,RESIDENTIAL,51900,0,51900,305700,0,357600
131242700300000,NE 151,RESIDENTIAL,57700,0,57700,397700,0,455400
131242700400000,NE 151,RESIDENTIAL,51200,0,51200,318800,0,370000
131242700500000,NE 151,RESIDENTIAL,62200,0,62200,344800,0,407000
131242700700000,NE 151,RESIDENTIAL,81700,0,81700,0,0,81700
131242700800000,NE 151,RESIDENTIAL,68800,0,68800,355800,0,424600
131242700900000,NE 151,RESIDENTIAL,90600,0,90600,478400,0,569000
131242701000000,NE 151,RESIDENTIAL,57800,0,57800,303500,0,361300
131242701100000,NE 151,RESIDENTIAL,59900,0,59900,300800,0,360700
131242800100000,NE 151,RESIDENTIAL,58700,0,58700,288300,0,347000
131242800200000,NE 151,RESIDENTIAL,59900,0,59900,0,0,59900
131242800300000,NE 151,RESIDENTIAL,58800,0,58800,264000,0,322800
131242800500000,NE 151,RESIDENTIAL,84900,0,84900,331100,0,416000
131242800600000,NE 151,RESIDENTIAL,76900,0,76900,310600,0,387500
131242800700000,NE 151,RESIDENTIAL,63800,0,63800,333900,0,397700
131242800800000,NE 151,RESIDENTIAL,52700,0,52700,299900,0,352600
131242800900000,NE 151,RESIDENTIAL,52900,0,52900,303200,0,356100
131242801000000,NE 151,RESIDENTIAL,52900,0,52900,327800,0,380700
131242801100000,NE 151,RESIDENTIAL,52900,0,52900,306900,0,359800
131242801300000,NE 151,RESIDENTIAL,54900,0,54900,252400,0,307300
131242801400000,NE 151,RESIDENTIAL,52900,0,52900,305900,0,358800
131242801500000,NE 151,RESIDENTIAL,53500,0,53500,354600,0,408100
131242801600000,NE 151,RESIDENTIAL,56000,0,56000,340400,0,396400
131242801700000,NE 151,RESIDENTIAL,75100,0,75100,380400,0,455500
131242801800000,NE 151,RESIDENTIAL,80100,0,80100,341700,0,421800
131242801900000,NE 151,RESIDENTIAL,69100,0,69100,343100,0,412200
131242802000000,NE 151,RESIDENTIAL,70800,0,70800,423800,0,494600
131242802200000,NE 151,RESIDENTIAL,57800,0,57800,363100,0,420900
131242802400000,NE 151,RESIDENTIAL,62000,0,62000,357000,0,419000
131242802500000,NE 151,RESIDENTIAL,49700,0,49700,358200,0,407900
131242802600000,NE 151,RESIDENTIAL,1200,0,1200,0,0,1200
131242802700000,NE 151,RESIDENTIAL,51700,0,51700,342700,0,394400
131242802800000,NE 151,RESIDENTIAL,99200,0,99200,391400,0,490600
131242802900000,NE 151,RESIDENTIAL,99200,0,99200,450300,0,549500
131242803000000,NE 151,RESIDENTIAL,98300,0,98300,405000,0,503300
131242900100000,NE 151,RESIDENTIAL,52300,0,52300,243800,0,296100
131242900200000,NE 151,RESIDENTIAL,54500,0,54500,273800,0,328300
131242900300000,NE 151,RESIDENTIAL,53900,0,53900,278300,0,332200
131242900400000,NE 151,RESIDENTIAL,59800,0,59800,0,0,59800
131242900500000,NE 151,RESIDENTIAL,52900,0,52900,252800,0,305700
131242900600000,NE 151,RESIDENTIAL,52900,0,52900,312900,0,365800
131242900700000,NE 151,RESIDENTIAL,52900,0,52900,315100,0,368000
131242900800000,NE 151,RESIDENTIAL,52900,0,52900,343500,0,396400
131242900900000,NE 151,RESIDENTIAL,52400,0,52400,313500,0,365900
131242901000000,NE 151,RESIDENTIAL,55000,0,55000,324200,0,379200
131242901100000,NE 151,RESIDENTIAL,60000,0,60000,255000,0,315000
131242901200000,NE 151,RESIDENTIAL,47700,0,47700,228900,0,276600
131242901300000,NE 151,RESIDENTIAL,46400,0,46400,286500,0,332900
131242901400000,NE 151,RESIDENTIAL,46700,0,46700,209200,0,255900
131242901500000,NE 151,RESIDENTIAL,55800,0,55800,253600,0,309400
131242901600000,NE 151,RESIDENTIAL,41700,0,41700,249400,0,291100
131242901700000,NE 151,RESIDENTIAL,45700,0,45700,0,0,45700
131242901800000,NE 151,RESIDENTIAL,58800,0,58800,354900,0,413700
131242901900000,NE 151,RESIDENTIAL,58800,0,58800,228800,0,287600
131242902000000,NE 151,RESIDENTIAL,51000,0,51000,272700,0,323700
131242902100000,NE 151,RESIDENTIAL,42200,0,42200,245700,0,287900
131242902200000,NE 151,RESIDENTIAL,41600,0,41600,206000,0,247600
131242902300000,NE 151,RESIDENTIAL,42800,0,42800,242700,0,285500
131242902400000,NE 151,RESIDENTIAL,57400,0,57400,349600,0,407000
131243000700000,NE 151,RESIDENTIAL,66900,0,66900,227300,0,294200
131243000800000,NE 151,RESIDENTIAL,63700,0,63700,284800,0,348500
131243000900000,NE 151,RESIDENTIAL,62100,0,62100,310300,0,372400
131243001000000,NE 151,RESIDENTIAL,56300,0,56300,77700,0,134000
131243001100000,NE 151,RESIDENTIAL,61800,0,61800,374200,0,436000
131243001200000,NE 151,RESIDENTIAL,58800,0,58800,0,0,58800
131243001300000,NE 151,RESIDENTIAL,59700,0,59700,342200,0,401900
131243001400000,NE 151,RESIDENTIAL,58500,0,58500,0,0,58500
131243100100000,NE 151,RESIDENTIAL,57200,0,57200,247800,0,305000
131243100200000,NE 151,RESIDENTIAL,57900,0,57900,260900,0,318800
131243100300000,NE 151,RESIDENTIAL,46000,0,46000,0,0,46000
131243100400000,NE 151,RESIDENTIAL,7500,0,7500,0,0,7500
131243200100000,NE 151,RESIDENTIAL,119300,0,119300,440400,0,559700
131245100200000,NE 150,RESIDENTIAL,60400,0,60400,201200,0,261600
131245100300000,NE 150,RESIDENTIAL,60300,0,60300,145400,0,205700
131245100400000,NE 150,RESIDENTIAL,60300,0,60300,174500,0,234800
131245100500000,NE 150,RESIDENTIAL,0,0,0,0,0,0
131245100600000,NE 150,RESIDENTIAL,0,0,0,0,0,0
131245200100000,NE 150,RESIDENTIAL,60700,0,60700,153600,0,214300
131245200200000,NE 150,RESIDENTIAL,61100,0,61100,156000,0,217100
131245200300000,NE 150,RESIDENTIAL,60100,0,60100,177700,0,237800
131245200400000,NE 150,RESIDENTIAL,0,0,0,0,0,0
131245200500000,NE 150,RESIDENTIAL,55400,0,55400,166000,0,221400
131245200600000,NE 150,RESIDENTIAL,60300,0,60300,155400,0,215700
131245200700000,NE 150,RESIDENTIAL,61100,0,61100,170100,0,231200
131245200800000,NE 150,RESIDENTIAL,61200,0,61200,180000,0,241200
131245201000000,NE 150,RESIDENTIAL,51000,0,51000,156600,0,207600
131245201100000,NE 150,RESIDENTIAL,46400,0,46400,150600,0,197000
131245201200000,NE 150,RESIDENTIAL,61800,0,61800,212900,0,274700
131245201300000,NE 150,RESIDENTIAL,22000,0,22000,0,0,22000
131245201400000,NE 150,RESIDENTIAL,57100,0,57100,147100,0,204200
131245201500000,NE 150,RESIDENTIAL,60300,0,60300,172700,0,233000
131245201600000,NE 150,RESIDENTIAL,0,0,0,0,0,0
131245300200000,NE 151,RESIDENTIAL,60600,0,60600,0,0,60600
131245300900000,NE 151,RESIDENTIAL,1300,0,1300,0,0,1300
131245301000000,NE 151,RESIDENTIAL,65000,0,65000,344300,0,409300
131245301100000,NE 151,RESIDENTIAL,71600,0,71600,398000,0,469600
131245301600000,NE 151,RESIDENTIAL,77800,0,77800,396300,0,474100
131245301700000,NE 151,RESIDENTIAL,126100,0,126100,358400,0,484500
131245400200000,NE 151,RESIDENTIAL,58400,0,58400,0,0,58400
131245400300000,NE 151,RESIDENTIAL,59300,0,59300,10500,0,69800
131245400400000,NE 151,RESIDENTIAL,61000,0,61000,358000,0,419000
131245400500000,NE 151,RESIDENTIAL,58300,0,58300,410100,0,468400
131245400600000,NE 151,RESIDENTIAL,56600,0,56600,358500,0,415100
131245400800000,NE 151,RESIDENTIAL,66700,0,66700,303700,0,370400
131245400900000,NE 151,RESIDENTIAL,71300,0,71300,348700,0,420000
131245401000000,NE 151,RESIDENTIAL,72500,0,72500,532000,0,604500
131245401100000,NE 151,RESIDENTIAL,61000,0,61000,0,0,61000
131247600500000,NE 151,RESIDENTIAL,111300,0,111300,548700,0,660000
131247600600000,NE 151,RESIDENTIAL,104000,0,104000,550300,0,654300
131247600700000,NE 151,RESIDENTIAL,92100,0,92100,412000,0,504100
131247600800000,NE 151,RESIDENTIAL,4800,0,4800,0,0,4800
131247600900000,NE 151,RESIDENTIAL,97500,0,97500,441900,0,539400
131247601000000,NE 151,RESIDENTIAL,88200,0,88200,439200,0,527400
131247601100000,NE 151,RESIDENTIAL,127900,0,127900,541600,0,669500
131247601200000,NE 151,RESIDENTIAL,97200,0,97200,638300,0,735500
131247601300000,NE 151,RESIDENTIAL,97300,0,97300,303800,0,401100
131247602300000,NE 151,RESIDENTIAL,94600,0,94600,371400,0,466000
131247602400000,NE 151,RESIDENTIAL,85700,0,85700,390800,0,476500
131247602500000,NE 151,RESIDENTIAL,7800,0,7800,0,0,7800
131247602600000,NE 151,RESIDENTIAL,5500,0,5500,0,0,5500
131247602700000,NE 151,RESIDENTIAL,5200,0,5200,0,0,5200
131247602800000,NE 151,RESIDENTIAL,125400,0,125400,131600,0,257000
131247602900000,NE 151,RESIDENTIAL,6200,0,6200,0,0,6200
131247603000000,NE 151,RESIDENTIAL,31000,0,31000,0,0,31000
131247603100000,NE 151,RESIDENTIAL,111400,0,111400,0,0,111400
131247700100000,NE 151,RESIDENTIAL,3800,0,3800,0,0,3800
131247700200000,NE 151,RESIDENTIAL,3600,0,3600,0,0,3600
131247700300000,NE 151,RESIDENTIAL,4900,0,4900,0,0,4900
131247700400000,NE 151,RESIDENTIAL,4700,0,4700,0,0,4700
131312700100000,NE 150,AG LAND,29300,0,29300,0,0,29300
131320100100000,NE 150,AG DWELLING,15100,0,15100,109100,0,124200
131320200100000,NE 150,RESIDENTIAL,60400,0,60400,245700,0,306100
131320200200000,NE 150,RESIDENTIAL,35300,0,35300,112700,0,148000
131320200300000,NE 150,RESIDENTIAL,36600,0,36600,151800,0,188400
131320300100000,NE 150,RESIDENTIAL,57200,0,57200,202000,0,259200
131320300200000,NE 150,RESIDENTIAL,52200,0,52200,296100,0,348300
131320300300000,NE 150,RESIDENTIAL,40900,0,40900,145000,0,185900
131320300400000,NE 150,RESIDENTIAL,40900,0,40900,127600,0,168500
131320400100000,NE 150,RESIDENTIAL,39400,0,39400,142600,0,182000
131320400200000,NE 150,RESIDENTIAL,41600,0,41600,190300,0,231900
131320400300000,NE 150,RESIDENTIAL,39300,0,39300,187100,0,226400
131320400400000,NE 150,RESIDENTIAL,46000,0,46000,183900,0,229900
131322600100000,NE 150,RESIDENTIAL,54300,0,54300,198400,0,252700
131322600200000,NE 150,RESIDENTIAL,53000,0,53000,146100,0,199100
131322600300000,NE 150,RESIDENTIAL,47900,0,47900,176700,0,224600
131322600400000,NE 150,RESIDENTIAL,52600,0,52600,139900,0,192500
131322600500000,NE 150,RESIDENTIAL,54900,0,54900,217800,0,272700
131322600600000,NE 150,RESIDENTIAL,53800,0,53800,167600,0,221400
131322600700000,NE 150,RESIDENTIAL,53800,0,53800,214900,0,268700
131322600800000,NE 150,RESIDENTIAL,37400,0,37400,142600,0,180000
131322600900000,NE 150,RESIDENTIAL,40900,0,40900,182700,0,223600
131322601000000,NE 150,RESIDENTIAL,40900,0,40900,162000,0,202900
131322601100000,NE 150,RESIDENTIAL,40900,0,40900,144400,0,185300
131322601200000,NE 150,RESIDENTIAL,40900,0,40900,161700,0,202600
131322601300000,NE 150,RESIDENTIAL,40900,0,40900,120900,0,161800
131322601400000,NE 150,RESIDENTIAL,40900,0,40900,143400,0,184300
131322700100000,NE 150,RESIDENTIAL,46000,0,46000,239900,0,285900
131322700200000,NE 150,RESIDENTIAL,40900,0,40900,243000,0,283900
131322700300000,NE 150,RESIDENTIAL,40900,0,40900,169000,0,209900
131322700400000,NE 150,RESIDENTIAL,40900,0,40900,220800,0,261700
131322700500000,NE 150,RESIDENTIAL,40900,0,40900,276400,0,317300
131322700600000,NE 150,RESIDENTIAL,40000,0,40000,168000,0,208000
131322700700000,NE 150,RESIDENTIAL,45100,0,45100,212500,0,257600
131322700800000,NE 150,RESIDENTIAL,35000,0,35000,227600,0,262600
131322700900000,NE 150,RESIDENTIAL,33700,0,33700,173300,0,207000
131322701000000,NE 150,RESIDENTIAL,52400,0,52400,176600,0,229000
131322701100000,NE 150,RESIDENTIAL,52300,0,52300,219800,0,272100
131327600100000,CITY PROPERTY,EXEMPT,0,0,0,0,0,0
131330100100000,NW 302,RESIDENTIAL,85700,0,85700,247100,0,332800
131335100700000,NW 309,RESIDENTIAL,111000,0,111000,814300,0,925300
131335100800000,NW 309,RESIDENTIAL,2700,0,2700,0,0,2700
131335100900000,NW 302,RESIDENTIAL,12300,0,12300,0,0,12300
131337600500000,NW 353,RESIDENTIAL,35600,0,35600,347100,0,382700
131337600600000,NW 353,RESIDENTIAL,42000,0,42000,280900,0,322900
131337600700000,NW 353,RESIDENTIAL,45400,0,45400,316600,0,362000
131337600800000,NW 353,RESIDENTIAL,45800,0,45800,0,0,45800
131337600900000,NW 353,RESIDENTIAL,45000,0,45000,0,0,45000
131337601000000,NW 353,RESIDENTIAL,64900,0,64900,323200,0,388100
131337601100000,NW 353,RESIDENTIAL,110300,0,110300,0,0,110300
131337601700000,NW 353,RESIDENTIAL,24900,0,24900,0,0,24900
131337601800000,NW 302,RESIDENTIAL,84700,0,84700,0,0,84700
131337602000000,NW 353,RESIDENTIAL,83200,0,83200,687500,0,770700
131337700100000,NW 353,RESIDENTIAL,30000,0,30000,0,0,30000
131337700200000,NW 353,RESIDENTIAL,36400,0,36400,343900,0,380300
131337700300000,NW 353,RESIDENTIAL,34700,0,34700,0,0,34700
131337700400000,NW 353,RESIDENTIAL,34200,0,34200,0,0,34200
131337700500000,NW 353,RESIDENTIAL,36400,0,36400,290700,0,327100
131337700600000,NW 353,RESIDENTIAL,47700,0,47700,0,0,47700
131342600100000,NW 302,RESIDENTIAL,10500,0,10500,0,0,10500
131342600200000,NW 353,RESIDENTIAL,10500,0,10500,0,0,10500
131342600300000,NW 302,RESIDENTIAL,144500,0,144500,129000,0,273500
131342600400000,NW 302,RESIDENTIAL,78300,0,78300,194600,0,272900
131345100300000,NW 353,RESIDENTIAL,35300,0,35300,0,0,35300
131345100400000,NW 353,RESIDENTIAL,36500,0,36500,250700,0,287200
131345100500000,NW 353,RESIDENTIAL,39300,0,39300,256700,0,296000
131345100600000,NW 353,RESIDENTIAL,37200,0,37200,0,0,37200
131345100700000,NW 353,RESIDENTIAL,37800,0,37800,243100,0,280900
131345100800000,NW 353,RESIDENTIAL,30500,0,30500,240200,0,270700
131345100900000,NW 353,RESIDENTIAL,41900,0,41900,0,0,41900
131345101000000,CITY PROPERTY,EXEMPT,0,0,0,0,0,0
131345101400000,NW 353,RESIDENTIAL,84800,0,84800,306000,0,390800
131345101800000,NW 353,RESIDENTIAL,33700,0,33700,287300,0,321000
131345101900000,NW 353,RESIDENTIAL,33700,0,33700,292100,0,325800
131345102000000,NW 353,RESIDENTIAL,32100,0,32100,308100,0,340200
131345102100000,NW 353,RESIDENTIAL,34800,0,34800,282400,0,317200
131345102200000,NW 353,RESIDENTIAL,5600,0,5600,0,0,5600
131345102300000,NW 353,RESIDENTIAL,16000,0,16000,0,0,16000
131345102400000,NW 353,RESIDENTIAL,48900,0,48900,0,0,48900
131345200100000,NW 353,RESIDENTIAL,38100,0,38100,339100,0,377200
131345200200000,NW 353,RESIDENTIAL,37200,0,37200,271400,0,308600
131345200300000,NW 353,RESIDENTIAL,37800,0,37800,253200,0,291000
131345200400000,NW 353,RESIDENTIAL,34300,0,34300,272100,0,306400
131345200500000,NW 353,RESIDENTIAL,36400,0,36400,230100,0,266500
131345200600000,NW 353,RESIDENTIAL,35300,0,35300,281400,0,316700
131345200700000,NW 353,RESIDENTIAL,35800,0,35800,264700,0,300500
131345200800000,NW 353,RESIDENTIAL,36900,0,36900,318200,0,355100
131345200900000,NW 353,RESIDENTIAL,38400,0,38400,265300,0,303700
131345201000000,NW 353,RESIDENTIAL,5600,0,5600,0,0,5600
131345201100000,NW 353,RESIDENTIAL,4800,0,4800,0,0,4800
131345300100000,NW 353,RESIDENTIAL,38200,0,38200,307100,0,345300
131345300200000,NW 353,RESIDENTIAL,37500,0,37500,330500,0,368000
131345300300000,NW 353,RESIDENTIAL,34000,0,34000,286000,0,320000
131345300400000,NW 353,RESIDENTIAL,81800,0,81800,286900,0,368700
131345400200000,NW 353,RESIDENTIAL,41800,0,41800,259300,0,301100
131345400300000,NW 353,RESIDENTIAL,42300,0,42300,300700,0,343000
131345400400000,NW 353,RESIDENTIAL,40400,0,40400,318400,0,358800
131345400600000,NW 353,RESIDENTIAL,13800,0,13800,0,0,13800
131345400700000,NW 353,RESIDENTIAL,44700,0,44700,324500,0,369200
131345400800000,NW 353,RESIDENTIAL,40200,0,40200,261800,0,302000
131345400900000,NW 353,RESIDENTIAL,47800,0,47800,349500,0,397300
131345401100000,NW 353,RESIDENTIAL,20800,0,20800,227300,0,248100
131345401200000,NW 353,RESIDENTIAL,25700,0,25700,223900,0,249600
131347600200000,NW 353,RESIDENTIAL,96100,0,96100,0,0,96100
131347600300000,NW 302,RESIDENTIAL,41900,0,41900,63200,0,105100
131347600400000,NW 337,RESIDENTIAL,52300,0,52300,100200,0,152500
131347600500000,NW 337,RESIDENTIAL,52300,0,52300,78400,0,130700
131347600600000,NW 337,RESIDENTIAL,52600,0,52600,172600,0,225200
131347600700000,NW 302,RESIDENTIAL,34000,0,34000,145300,0,179300
131347600800000,NW 302,RESIDENTIAL,25200,0,25200,44300,0,69500
131410100100000,CITY PROPERTY,EXEMPT,0,0,0,0,0,0
131515200500000,NW 332,RESIDENTIAL,54500,0,54500,243600,0,298100
131515200600000,NW 332,RESIDENTIAL,54500,0,54500,283700,0,338200
131515200700000,NW 332,RESIDENTIAL,61500,0,61500,225800,0,287300
131515200800000,NW 332,RESIDENTIAL,62900,0,62900,257600,0,320500
131515200900000,CITY PROPERTY,EXEMPT,0,0,0,0,0,0
131515201000000,NW 332,RESIDENTIAL,62700,0,62700,226200,0,288900
131515201100000,NW 332,RESIDENTIAL,66300,0,66300,213200,0,279500
131515201200000,NW 332,RESIDENTIAL,67900,0,67900,220500,0,288400
131515201300000,NW 332,RESIDENTIAL,48400,0,48400,242400,0,290800
131515201400000,NW 332,RESIDENTIAL,48000,0,48000,231700,0,279700
131515201500000,NW 332,RESIDENTIAL,47500,0,47500,228300,0,275800
131515201600000,NW 332,RESIDENTIAL,47500,0,47500,237800,0,285300
131515201700000,NW 332,RESIDENTIAL,53800,0,53800,262100,0,315900
131515201800000,NW 332,RESIDENTIAL,65400,0,65400,286000,0,351400
131515201900000,NW 332,RESIDENTIAL,55900,0,55900,274000,0,329900
131515202000000,NW 332,RESIDENTIAL,49700,0,49700,229700,0,279400
131515202100000,NW 332,RESIDENTIAL,44900,0,44900,231800,0,276700
131515202200000,NW 332,RESIDENTIAL,5500,0,5500,0,0,5500
131515202300000,NW 332,RESIDENTIAL,5800,0,5800,0,0,5800
131515202400000,NW 332,RESIDENTIAL,5800,0,5800,0,0,5800
131515202500000,NW 332,RESIDENTIAL,5100,0,5100,0,0,5100
131515300100000,NW 332,RESIDENTIAL,50500,0,50500,322200,0,372700
131515300200000,NW 332,RESIDENTIAL,44900,0,44900,179800,0,224700
131515300300000,NW 332,RESIDENTIAL,50500,0,50500,225700,0,276200
131515300400000,NW 332,RESIDENTIAL,66200,0,66200,240700,0,306900
131515300500000,NW 332,RESIDENTIAL,56800,0,56800,245500,0,302300
131515300600000,NW 332,RESIDENTIAL,47500,0,47500,245100,0,292600
131515300700000,NW 332,RESIDENTIAL,47700,0,47700,280400,0,328100
131515300800000,NW 332,RESIDENTIAL,6200,0,6200,0,0,6200
131515300900000,NW 332,RESIDENTIAL,5800,0,5800,0,0,5800
131515301000000,NW 332,RESIDENTIAL,50500,0,50500,231700,0,282200
131515301100000,NW 332,RESIDENTIAL,6200,0,6200,0,0,6200
131515301200000,NW 332,RESIDENTIAL,6000,0,6000,0,0,6000
131515301300000,NW 332,RESIDENTIAL,7300,0,7300,0,0,7300
131515301400000,NW 332,RESIDENTIAL,67700,0,67700,247100,0,314800
131515301500000,NW 332,RESIDENTIAL,56100,0,56100,266600,0,322700
131515301600000,NW 332,RESIDENTIAL,6900,0,6900,0,0,6900
131515301700000,NW 332,RESIDENTIAL,56100,0,56100,319300,0,375400
131515400100000,NW 332,RESIDENTIAL,49600,0,49600,215300,0,264900
131515400200000,NW 332,RESIDENTIAL,49700,0,49700,229800,0,279500
131515400300000,NW 332,RESIDENTIAL,54800,0,54800,218000,0,272800
131515400400000,NW 332,RESIDENTIAL,52500,0,52500,217600,0,270100
131515400500000,NW 332,RESIDENTIAL,49600,0,49600,203700,0,253300
131515400600000,NW 332,RESIDENTIAL,6600,0,6600,0,0,6600
131515400700000,NW 332,RESIDENTIAL,7000,0,7000,0,0,7000
131515400800000,NW 332,RESIDENTIAL,7600,0,7600,0,0,7600
131515400900000,NW 332,RESIDENTIAL,8900,0,8900,0,0,8900
131515500100000,NW 332,RESIDENTIAL,65300,0,65300,0,0,65300
131515500200000,NW 332,RESIDENTIAL,53500,0,53500,205100,0,258600
131515500300000,NW 332,RESIDENTIAL,55800,0,55800,196800,0,252600
131522600100000,CITY PROPERTY,EXEMPT,0,0,0,0,0,0
131522600300000,NW 332,AG LAND,32500,0,32500,0,0,32500
131525100200000,NW 332,AG LAND,72800,0,72800,0,0,72800
131527600300000,NW 332,AG LAND,51000,0,51000,0,0,51000
131527600500000,NW 332,AG LAND,19700,0,19700,0,0,19700
131527600600000,NW 332,AG LAND,36700,0,36700,0,0,36700
131527600700000,NW 332,AG LAND,6200,0,6200,0,0,6200
131527600800000,NW 332,RESIDENTIAL,6000,0,6000,0,0,6000
131527700100000,NW 332,RESIDENTIAL,5800,0,5800,0,0,5800
131527700200000,NW 332,RESIDENTIAL,5800,0,5800,0,0,5800
131527700300000,NW 332,RESIDENTIAL,5800,0,5800,0,0,5800
131527700400000,NW 332,RESIDENTIAL,44900,0,44900,202200,0,247100
131527800100000,NW 332,RESIDENTIAL,7400,0,7400,0,0,7400
131527800200000,NW 332,RESIDENTIAL,6000,0,6000,0,0,6000
131527900100000,NW 332,RESIDENTIAL,7300,0,7300,0,0,7300
131527900200000,NW 332,RESIDENTIAL,5900,0,5900,0,0,5900
131532600100000,CITY PROPERTY,EXEMPT,0,0,0,0,0,0
131542600200000,NW 332,AG DWELLING,74600,0,74600,98300,11100,184000
131542600400000,NW 332,RESIDENTIAL,52100,0,52100,217900,0,270000
131542600500000,NW 332,RESIDENTIAL,53500,0,53500,189500,0,243000
131542600600000,NW 332,RESIDENTIAL,53500,0,53500,185900,0,239400
131542600700000,NW 332,RESIDENTIAL,53500,0,53500,193300,0,246800
131542600800000,NW 332,RESIDENTIAL,65600,0,65600,193700,0,259300
131542600900000,NW 332,RESIDENTIAL,64600,0,64600,248400,0,313000
131542601000000,NW 332,RESIDENTIAL,50900,0,50900,251500,0,302400
131542601100000,NW 332,RESIDENTIAL,62700,0,62700,269800,0,332500
131542601200000,CITY PROPERTY,EXEMPT,0,0,0,0,0,0
131542700100000,NW 332,RESIDENTIAL,58200,0,58200,203600,0,261800
131542700200000,NW 332,RESIDENTIAL,53500,0,53500,195500,0,249000
131542700300000,NW 332,RESIDENTIAL,61500,0,61500,185300,0,246800
131542700400000,NW 332,RESIDENTIAL,52400,0,52400,197300,0,249700
131542700500000,NW 332,RESIDENTIAL,55100,0,55100,51300,0,106400
131542700600000,NW 332,RESIDENTIAL,49500,0,49500,203800,0,253300
131542700700000,NW 332,RESIDENTIAL,47100,0,47100,180700,0,227800
131542700800000,NW 332,RESIDENTIAL,50500,0,50500,198500,0,249000
131542700900000,NW 332,RESIDENTIAL,54400,0,54400,179700,0,234100
131542800100000,NW 332,RESIDENTIAL,51100,0,51100,284200,0,335300
131542800200000,NW 332,RESIDENTIAL,50300,0,50300,204200,0,254500
131542800300000,NW 332,RESIDENTIAL,52700,0,52700,205500,0,258200
131542800400000,NW 332,RESIDENTIAL,57700,0,57700,258100,0,315800
132222600100000,NW 332,AG LAND,55700,0,55700,0,0,55700
132222600200000,NW 332,AG LAND,55700,0,55700,0,0,55700
132225100200000,NW 332,RESIDENTIAL,45100,0,45100,83400,0,128500
132225100300000,COUNTY PROPERTY,EXEMPT,0,0,0,0,0,0
132225100400000,NW 322,AG LAND,98000,0,98000,0,0,98000
132232600100000,COUNTY PROPERTY,EXEMPT,0,0,0,0,0,0
132235100100000,COUNTY PROPERTY,EXEMPT,0,0,0,0,0,0
132237600100000,COUNTY PROPERTY,EXEMPT,0,0,0,0,0,0
132245100100000,COUNTY PROPERTY,EXEMPT,0,0,0,0,0,0
132245100200000,NW 332,AG LAND,84400,0,84400,0,0,84400
132247600200000,NW 332,AG LAND,16000,0,16000,0,0,16000
132247600500000,NW 332,RESIDENTIAL,55700,0,55700,183300,0,239000
132247600600000,NW 332,RESIDENTIAL,46800,0,46800,232600,0,279400
132247600700000,NW 332,RESIDENTIAL,48300,0,48300,177000,0,225300
132247600800000,NW 332,RESIDENTIAL,45500,0,45500,171200,0,216700
132247600900000,NW 332,RESIDENTIAL,42400,0,42400,166100,0,208500
132247601000000,NW 332,RESIDENTIAL,44000,0,44000,156700,0,200700
132247601100000,NW 332,RESIDENTIAL,44000,0,44000,166000,0,210000
132247601200000,NW 332,RESIDENTIAL,40400,0,40400,164400,0,204800
132247601300000,NW 332,RESIDENTIAL,43000,0,43000,192900,0,235900
132247601400000,NW 332,RESIDENTIAL,42900,0,42900,160900,0,203800
132247601500000,NW 332,RESIDENTIAL,63400,0,63400,188400,0,251800
132247601600000,NW 332,RESIDENTIAL,58700,0,58700,281500,0,340200
132247601700000,NW 332,RESIDENTIAL,53400,0,53400,219600,0,273000
132247601800000,NW 332,RESIDENTIAL,49900,0,49900,261200,0,311100
132247601900000,NW 332,RESIDENTIAL,44000,0,44000,183900,0,227900
132247602000000,NW 332,RESIDENTIAL,39600,0,39600,179300,0,218900
132247602100000,NW 332,RESIDENTIAL,49500,0,49500,237300,0,286800
132247602200000,NW 332,RESIDENTIAL,43700,0,43700,216700,0,260400
132247602300000,NW 332,RESIDENTIAL,49700,0,49700,253100,0,302800
132247602400000,NW 332,RESIDENTIAL,68800,0,68800,276900,0,345700
132247602500000,NW 332,RESIDENTIAL,1900,0,1900,0,0,1900
132247602600000,NW 332,RESIDENTIAL,69800,0,69800,260600,0,330400
132247602700000,NW 332,RESIDENTIAL,44200,0,44200,186800,0,231000
132247602800000,NW 332,RESIDENTIAL,44900,0,44900,270300,0,315200
132247602900000,NW 332,RESIDENTIAL,41600,0,41600,202300,0,243900
132247603000000,NW 332,RESIDENTIAL,52900,0,52900,305700,0,358600
132247700100000,NW 332,RESIDENTIAL,42800,0,42800,187500,0,230300
132247700200000,NW 332,RESIDENTIAL,43500,0,43500,192900,0,236400
132247700300000,NW 332,RESIDENTIAL,46800,0,46800,200600,0,247400
132247700400000,NW 332,RESIDENTIAL,44100,0,44100,200400,0,244500
132247700500000,NW 332,RESIDENTIAL,45100,0,45100,174800,0,219900
132247700600000,NW 332,RESIDENTIAL,48800,0,48800,225400,0,274200
132247700700000,NW 332,RESIDENTIAL,41200,0,41200,174400,0,215600
132247700800000,NW 332,RESIDENTIAL,40100,0,40100,198300,0,238400
132247700900000,NW 332,RESIDENTIAL,46900,0,46900,217300,0,264200
132247701000000,NW 332,RESIDENTIAL,50000,0,50000,173300,0,223300
132247701100000,NW 332,RESIDENTIAL,45100,0,45100,160300,0,205400
132247701200000,NW 332,RESIDENTIAL,46000,0,46000,187000,0,233000
132247701300000,NW 332,RESIDENTIAL,57300,0,57300,208200,0,265500
132247701400000,NW 332,RESIDENTIAL,61800,0,61800,0,0,61800
132247701500000,CITY PROPERTY,EXEMPT,0,0,0,0,0,0
132247701600000,NW 332,RESIDENTIAL,54500,0,54500,229200,0,283700
132247701700000,NW 332,RESIDENTIAL,500,0,500,0,0,500
132247701800000,NW 332,RESIDENTIAL,44000,0,44000,172300,0,216300
132247701900000,NW 332,RESIDENTIAL,35800,0,35800,200900,0,236700
132247702000000,NW 332,RESIDENTIAL,44000,0,44000,229600,0,273600
132247702100000,NW 332,RESIDENTIAL,400,0,400,0,0,400
132247702200000,NW 332,RESIDENTIAL,42600,0,42600,171600,0,214200
132247702300000,NW 332,RESIDENTIAL,41400,0,41400,205400,0,246800
132247702400000,NW 332,RESIDENTIAL,1200,0,1200,0,0,1200
132247702500000,NW 332,RESIDENTIAL,200,0,200,0,0,200
132247800100000,NW 332,RESIDENTIAL,700,0,700,0,0,700
132247800200000,NW 332,RESIDENTIAL,54200,0,54200,239000,0,293200
132247800300000,NW 332,RESIDENTIAL,44900,0,44900,234800,0,279700
132247800400000,NW 332,RESIDENTIAL,40400,0,40400,174200,0,214600
132247800500000,NW 332,RESIDENTIAL,50900,0,50900,154300,0,205200
132247800600000,NW 332,RESIDENTIAL,50900,0,50900,174300,0,225200
132247800700000,NW 332,RESIDENTIAL,44100,0,44100,193100,0,237200
132247800800000,NW 332,RESIDENTIAL,200,0,200,0,0,200
132247900100000,NW 332,RESIDENTIAL,48200,0,48200,203400,0,251600
132247900200000,NW 332,RESIDENTIAL,44400,0,44400,189500,0,233900
132247900300000,NW 332,RESIDENTIAL,52100,0,52100,222900,0,275000
132340200200000,SCHOOL,EXEMPT,0,0,0,0,0,0
132340200300000,NW 329,RESIDENTIAL,24100,0,24100,94500,0,118600
132340200400000,NW 329,RESIDENTIAL,23900,0,23900,99300,0,123200
132340200500000,NW 329,RESIDENTIAL,26000,0,26000,88400,0,114400
132340200600000,NW 329,RESIDENTIAL,27400,0,27400,102500,0,129900
132340200700000,NW 329,RESIDENTIAL,26500,0,26500,92500,0,119000
132340200800000,NW 329,RESIDENTIAL,26700,0,26700,120200,0,146900
132340200900000,NW 329,RESIDENTIAL,26700,0,26700,69800,0,96500
132340201000000,NW 329,RESIDENTIAL,29300,0,29300,106200,0,135500
132340300100000,NW 329,RESIDENTIAL,26000,0,26000,100600,0,126600
132340300200000,NW 329,RESIDENTIAL,24800,0,24800,114200,0,139000
132340300300000,NW 329,RESIDENTIAL,27600,0,27600,107100,0,134700
132340300400000,NW 329,RESIDENTIAL,27600,0,27600,88900,0,116500
132340300500000,NW 329,RESIDENTIAL,25200,0,25200,95200,0,120400
132340400100000,NW 329,RESIDENTIAL,26300,0,26300,106900,0,133200
132340400200000,NW 329,RESIDENTIAL,27200,0,27200,101200,0,128400
132340400300000,NW 329,RESIDENTIAL,26900,0,26900,101600,0,128500
132340400400000,NW 329,RESIDENTIAL,25900,0,25900,86700,0,112600
132340400500000,NW 329,RESIDENTIAL,24500,0,24500,106700,0,131200
132340400600000,NW 329,RESIDENTIAL,24500,0,24500,99300,0,123800
132340400700000,NW 329,RESIDENTIAL,27800,0,27800,102400,0,130200
132347600100000,NW 329,RESIDENTIAL,25200,0,25200,96800,0,122000
132347600200000,NW 329,RESIDENTIAL,25200,0,25200,101700,0,126900
132347600300000,NW 329,RESIDENTIAL,25200,0,25200,138400,0,163600
132347600400000,NW 329,RESIDENTIAL,25200,0,25200,109000,0,134200
132347600500000,NW 329,RESIDENTIAL,25200,0,25200,113000,0,138200
132347600600000,NW 329,RESIDENTIAL,27600,0,27600,113900,0,141500
132347700100000,NW 329,RESIDENTIAL,24500,0,24500,85600,0,110100
132347700200000,NW 329,RESIDENTIAL,24500,0,24500,86600,0,111100
132347700300000,NW 329,RESIDENTIAL,24500,0,24500,90600,0,115100
132347700400000,NW 329,RESIDENTIAL,24500,0,24500,113300,0,137800
132347700500000,NW 329,RESIDENTIAL,24500,0,24500,102200,0,126700
132347700600000,NW 329,RESIDENTIAL,24500,0,24500,89500,0,114000
132347700700000,NW 329,RESIDENTIAL,27200,0,27200,98000,0,125200
132347700800000,NW 329,RESIDENTIAL,24800,0,24800,99800,0,124600
132347700900000,NW 329,RESIDENTIAL,27200,0,27200,112800,0,140000
132347701000000,NW 329,RESIDENTIAL,24500,0,24500,89500,0,114000
132347701100000,NW 329,RESIDENTIAL,24500,0,24500,93600,0,118100
132347701200000,NW 329,RESIDENTIAL,24500,0,24500,108200,0,132700
132347701300000,NW 329,RESIDENTIAL,24500,0,24500,77000,0,101500
132347800100000,NW 329,RESIDENTIAL,24100,0,24100,101200,0,125300
132347800200000,NW 329,RESIDENTIAL,24100,0,24100,84300,0,108400
132347800300000,NW 329,RESIDENTIAL,25800,0,25800,127500,0,153300
132347800400000,NW 329,RESIDENTIAL,25800,0,25800,101700,0,127500
132347800500000,NW 329,RESIDENTIAL,24800,0,24800,114200,0,139000
132347800600000,NW 329,RESIDENTIAL,24800,0,24800,95000,0,119800
132347800700000,NW 329,RESIDENTIAL,24800,0,24800,96700,0,121500
132347800800000,NW 329,RESIDENTIAL,24800,0,24800,106400,0,131200
132347800900000,NW 329,RESIDENTIAL,26400,0,26400,116300,0,142700
132347801000000,SCHOOL,EXEMPT,0,0,0,0,0,0
132347900100000,NW 329,RESIDENTIAL,27400,0,27400,110500,0,137900
132347900200000,NW 329,RESIDENTIAL,24800,0,24800,96600,0,121400
132347900300000,NW 329,RESIDENTIAL,24800,0,24800,99500,0,124300
132347900400000,NW 329,RESIDENTIAL,24800,0,24800,120300,0,145100
132347900500000,NW 329,RESIDENTIAL,24800,0,24800,102900,0,127700
132347900600000,NW 329,RESIDENTIAL,24800,0,24800,106700,0,131500
132347900700000,NW 329,RESIDENTIAL,24800,0,24800,94600,0,119400
132347900800000,NW 329,RESIDENTIAL,24800,0,24800,87900,0,112700
132347900900000,NW 329,RESIDENTIAL,24800,0,24800,87500,0,112300
132347901000000,NW 329,RESIDENTIAL,24800,0,24800,98100,0,122900
132347901100000,NW 329,RESIDENTIAL,24800,0,24800,97800,0,122600
132347901200000,NW 329,RESIDENTIAL,27400,0,27400,105800,0,133200
132348000100000,NW 329,RESIDENTIAL,27200,0,27200,92300,0,119500
132348000200000,NW 329,RESIDENTIAL,24800,0,24800,99300,0,124100
132348000300000,NW 329,RESIDENTIAL,27200,0,27200,73000,0,100200
132348000400000,NW 329,RESIDENTIAL,25800,0,25800,100600,0,126400
132348000500000,NW 329,RESIDENTIAL,24700,0,24700,100400,0,125100
132348000600000,NW 329,RESIDENTIAL,24700,0,24700,92100,0,116800
132348000700000,NW 329,RESIDENTIAL,24700,0,24700,100800,0,125500
132348000800000,NW 329,RESIDENTIAL,24700,0,24700,115100,0,139800
132348000900000,NW 329,RESIDENTIAL,24700,0,24700,100700,0,125400
132348001000000,NW 329,RESIDENTIAL,24700,0,24700,89300,0,114000
132348001100000,NW 329,RESIDENTIAL,24700,0,24700,102400,0,127100
132348001200000,NW 329,RESIDENTIAL,25800,0,25800,97700,0,123500
132348001300000,NW 329,RESIDENTIAL,27200,0,27200,95100,0,122300
132348001400000,NW 329,RESIDENTIAL,24800,0,24800,114600,0,139400
132348001500000,NW 329,RESIDENTIAL,27200,0,27200,112700,0,139900
132348001600000,NW 329,RESIDENTIAL,25800,0,25800,103200,0,129000
132348001700000,NW 329,RESIDENTIAL,24700,0,24700,109200,0,133900
132348001800000,NW 329,RESIDENTIAL,24700,0,24700,97400,0,122100
132348001900000,NW 329,RESIDENTIAL,24700,0,24700,119500,0,144200
132348002000000,NW 329,RESIDENTIAL,24700,0,24700,102800,0,127500
132348002100000,NW 329,RESIDENTIAL,24700,0,24700,110200,0,134900
132348002200000,NW 329,RESIDENTIAL,24700,0,24700,111200,0,135900
132348002300000,NW 329,RESIDENTIAL,24700,0,24700,95200,0,119900
132348002400000,NW 329,RESIDENTIAL,25800,0,25800,99000,0,124800
132348100100000,NW 329,RESIDENTIAL,28600,0,28600,116400,0,145000
132348100200000,NW 329,RESIDENTIAL,25800,0,25800,76500,0,102300
132348100300000,NW 329,RESIDENTIAL,25800,0,25800,89300,0,115100
132348100400000,NW 329,RESIDENTIAL,25800,0,25800,103300,0,129100
132348100500000,NW 329,RESIDENTIAL,25800,0,25800,107000,0,132800
132348100600000,NW 329,RESIDENTIAL,25800,0,25800,111400,0,137200
132348100700000,NW 329,RESIDENTIAL,25800,0,25800,99000,0,124800
132348100800000,NW 329,RESIDENTIAL,26800,0,26800,129800,0,156600
132410100100000,NW 337,RESIDENTIAL,28000,0,28000,113600,0,141600
132410100200000,NW 337,RESIDENTIAL,50800,0,50800,1600,0,52400
132410100300000,NW 309,RESIDENTIAL,142300,0,142300,0,0,142300
132410100400000,NW 337,RESIDENTIAL,64800,0,64800,11200,0,76000
132410100402000,ANTENNAS/TOWERS(BLL),COMMERCIAL,0,0,0,0,12900,12900
132410100402001,ANTENNAS/TOWERS(BLL),COMMERCIAL,0,0,0,0,96900,96900
132410100402003,ANTENNAS/TOWERS(BLL),COMMERCIAL,0,0,0,0,16500,16500
132410100402004,ANTENNAS/TOWERS(BLL),COMMERCIAL,0,0,0,0,31700,31700
132410100402005,ANTENNAS/TOWERS(BLL),COMMERCIAL,0,0,0,0,55200,55200
132410100402006,ANTENNAS/TOWERS(BLL),COMMERCIAL,0,0,0,0,33300,33300
132410100500000,CITY PROPERTY,EXEMPT,0,0,0,0,0,0
132410100600000,NW 337,RESIDENTIAL,72900,0,72900,0,0,72900
132410100700000,NW 337,RESIDENTIAL,51100,0,51100,140200,0,191300
132410100800000,NW 337,RESIDENTIAL,53500,0,53500,80000,0,133500
132410100900000,NW 337,RESIDENTIAL,38600,0,38600,148000,0,186600
132410200400000,NW 309,RESIDENTIAL,38100,0,38100,233000,0,271100
132412600100000,NW 309,RESIDENTIAL,40400,0,40400,164800,0,205200
132412600200000,NW 309,RESIDENTIAL,40800,0,40800,175800,0,216600
132412600300000,NW 309,RESIDENTIAL,40800,0,40800,178000,0,218800
132412600400000,NW 309,RESIDENTIAL,40800,0,40800,202300,0,243100
132412600500000,NW 309,RESIDENTIAL,41700,0,41700,175700,0,217400
132412600600000,NW 309,RESIDENTIAL,39200,0,39200,122800,0,162000
132412600700000,NW 309,RESIDENTIAL,39200,0,39200,143700,0,182900
132412600800000,NW 309,RESIDENTIAL,43000,0,43000,177000,0,220000
132412600900000,NW 309,RESIDENTIAL,37900,0,37900,213100,0,251000
132412601000000,NW 309,RESIDENTIAL,38100,0,38100,199900,0,238000
132412601100000,NW 309,RESIDENTIAL,42000,0,42000,169900,0,211900
132412601200000,NW 309,RESIDENTIAL,40400,0,40400,250700,0,291100
132412700100000,NW 309,RESIDENTIAL,44300,0,44300,175500,0,219800
132412700200000,NW 309,RESIDENTIAL,44500,0,44500,130500,0,175000
132412700300000,NW 309,RESIDENTIAL,43600,0,43600,125200,0,168800
132412800200000,NW 309,RESIDENTIAL,39000,0,39000,218400,0,257400
132412800300000,NW 309,RESIDENTIAL,36800,0,36800,220200,0,257000
132412800400000,NW 309,RESIDENTIAL,36800,0,36800,232900,0,269700
132412800500000,NW 309,RESIDENTIAL,37200,0,37200,185100,0,222300
132412800600000,NW 309,RESIDENTIAL,38000,0,38000,182200,0,220200
132412800700000,NW 309,RESIDENTIAL,35000,0,35000,191200,0,226200
132412800800000,NW 342,AG LAND,7100,0,7100,0,2100,9200
132412800900000,NW 309,RESIDENTIAL,38100,0,38100,0,0,38100
132412801000000,NW 309,RESIDENTIAL,38100,0,38100,243800,0,281900
132412801100000,NW 309,RESIDENTIAL,38000,0,38000,174700,0,212700
132412801200000,NW 309,RESIDENTIAL,37700,0,37700,222200,0,259900
132412801400000,NW 309,RESIDENTIAL,36900,0,36900,199700,0,236600
132412801500000,NW 309,RESIDENTIAL,13900,0,13900,0,0,13900
132412801600000,NW 309,RESIDENTIAL,13700,0,13700,0,0,13700
132412900100000,NW 309,RESIDENTIAL,39300,0,39300,185400,0,224700
132412900200000,NW 309,RESIDENTIAL,40200,0,40200,226900,0,267100
132412900300000,NW 309,RESIDENTIAL,38000,0,38000,179000,0,217000
132412900400000,NW 309,RESIDENTIAL,37600,0,37600,158500,0,196100
132412900500000,NW 309,RESIDENTIAL,41600,0,41600,152100,0,193700
132412900600000,NW 309,RESIDENTIAL,41500,0,41500,162500,0,204000
132412900700000,NW 309,RESIDENTIAL,40100,0,40100,157200,0,197300
132412900800000,NW 309,RESIDENTIAL,42400,0,42400,236400,0,278800
132412900900000,NW 309,RESIDENTIAL,41000,0,41000,210600,0,251600
132412901000000,NW 309,RESIDENTIAL,41900,0,41900,156100,0,198000
132412901100000,NW 309,RESIDENTIAL,42300,0,42300,167300,0,209600
132412901200000,NW 309,RESIDENTIAL,41600,0,41600,179300,0,220900
132412901300000,NW 309,RESIDENTIAL,41700,0,41700,197600,0,239300
132412901400000,NW 309,RESIDENTIAL,40000,0,40000,156000,0,196000
132412901500000,NW 309,RESIDENTIAL,63700,0,63700,16900,0,80600
132412901600000,NW 309,RESIDENTIAL,32000,0,32000,0,0,32000
132412901700000,NW 309,RESIDENTIAL,39300,0,39300,264100,0,303400
132412901800000,NW 309,RESIDENTIAL,38900,0,38900,199900,0,238800
132412901900000,NW 309,RESIDENTIAL,38800,0,38800,238900,0,277700
132412902000000,NW 309,RESIDENTIAL,38800,0,38800,175600,0,214400
132413000100000,NW 309,RESIDENTIAL,39900,0,39900,98100,0,138000
132413000200000,NW 309,RESIDENTIAL,39400,0,39400,111600,0,151000
132413000300000,NW 309,RESIDENTIAL,41400,0,41400,163100,0,204500
132413000400000,NW 309,RESIDENTIAL,36500,0,36500,156900,0,193400
132413000500000,NW 309,RESIDENTIAL,38500,0,38500,148000,0,186500
132413000600000,NW 309,RESIDENTIAL,41400,0,41400,115600,0,157000
132413000700000,NW 309,RESIDENTIAL,39700,0,39700,200500,0,240200
132413000800000,NW 309,RESIDENTIAL,37700,0,37700,160200,0,197900
132413000900000,NW 309,RESIDENTIAL,40900,0,40900,144100,0,185000
132413001000000,NW 309,RESIDENTIAL,41700,0,41700,168400,0,210100
132413001100000,NW 309,RESIDENTIAL,41700,0,41700,188300,0,230000
132413001200000,NW 309,RESIDENTIAL,40500,0,40500,220500,0,261000
132413001300000,NW 309,RESIDENTIAL,41900,0,41900,0,0,41900
132413001400000,NW 309,RESIDENTIAL,39800,0,39800,257800,0,297600
132413001500000,NW 309,RESIDENTIAL,41900,0,41900,164100,0,206000
132413001600000,NW 309,RESIDENTIAL,42900,0,42900,209300,0,252200
132413001700000,NW 309,RESIDENTIAL,45000,0,45000,199000,0,244000
132413001800000,NW 309,RESIDENTIAL,43000,0,43000,209500,0,252500
132413001900000,NW 309,RESIDENTIAL,40800,0,40800,155700,0,196500
132413002000000,NW 309,RESIDENTIAL,41400,0,41400,166600,0,208000
132413002100000,NW 309,RESIDENTIAL,40600,0,40600,146800,0,187400
132413002200000,NW 309,RESIDENTIAL,40900,0,40900,174200,0,215100
132413002300000,NW 309,RESIDENTIAL,43600,0,43600,146800,0,190400
132413002400000,NW 337,RESIDENTIAL,64200,0,64200,75700,0,139900
132413100100000,NW 337,RESIDENTIAL,20500,0,20500,117500,0,138000
132413200100000,NW 309,RESIDENTIAL,44100,0,44100,224000,0,268100
132413200700000,NW 309,RESIDENTIAL,43000,0,43000,260300,0,303300
132413200900000,NW 309,RESIDENTIAL,38900,0,38900,183900,0,222800
132413201000000,NW 309,RESIDENTIAL,43200,0,43200,0,0,43200
132413201200000,NW 309,RESIDENTIAL,42600,0,42600,237100,0,279700
132415100200000,NW 337,RESIDENTIAL,61300,0,61300,122700,0,184000
132415200100000,NW 309,RESIDENTIAL,62000,0,62000,27700,0,89700
132415200300000,NW 309,RESIDENTIAL,64500,0,64500,146900,0,211400
132415200500000,NW 342,RESIDENTIAL,900,0,900,0,0,900
132415200600000,NW 342,RESIDENTIAL,34000,0,34000,146000,0,180000
132415200700000,NW 342,RESIDENTIAL,34200,0,34200,181700,0,215900
132415200800000,NW 342,RESIDENTIAL,33300,0,33300,154600,0,187900
132415200900000,NW 342,RESIDENTIAL,32300,0,32300,180600,0,212900
132415201000000,NW 342,RESIDENTIAL,33300,0,33300,145100,0,178400
132415201100000,NW 342,RESIDENTIAL,31000,0,31000,139500,0,170500
132415201200000,NW 342,RESIDENTIAL,31000,0,31000,122400,0,153400
132415201300000,NW 342,RESIDENTIAL,31000,0,31000,115100,0,146100
132415201400000,NW 309,RESIDENTIAL,45000,0,45000,213500,0,258500
132415201500000,NW 309,RESIDENTIAL,44900,0,44900,236600,0,281500
132415201600000,NW 309,RESIDENTIAL,44500,0,44500,0,0,44500
132415201700000,NW 309,RESIDENTIAL,56100,0,56100,745400,0,801500
132415201800000,NW 309,RESIDENTIAL,51600,0,51600,1930500,0,1982100
132415201900000,NW 309,RESIDENTIAL,59800,0,59800,350700,0,410500
132415202000000,NW 309,RESIDENTIAL,39400,0,39400,0,0,39400
132415202100000,NW 309,RESIDENTIAL,39900,0,39900,0,0,39900
132415202200000,NW 309,RESIDENTIAL,39900,0,39900,269200,0,309100
132415202300000,NW 309,RESIDENTIAL,39900,0,39900,0,0,39900
132415202400000,CITY PROPERTY,EXEMPT,0,0,0,0,0,0
132415202500000,NW 309,RESIDENTIAL,38800,0,38800,0,0,38800
132415202600000,NW 309,RESIDENTIAL,34200,0,34200,0,0,34200
132415300100000,SCHOOL,EXEMPT,0,0,0,0,0,0
132415300200000,CITY PROPERTY,EXEMPT,0,0,0,0,0,0
132415300300000,NW 342,RESIDENTIAL,32700,0,32700,133800,0,166500
132415300400000,NW 342,RESIDENTIAL,31400,0,31400,124600,0,156000
132415300500000,NW 342,RESIDENTIAL,32900,0,32900,150200,0,183100
132415300600000,NW 342,RESIDENTIAL,33500,0,33500,149700,0,183200
132415300700000,NW 342,RESIDENTIAL,34600,0,34600,143900,0,178500
132415300800000,NW 342,RESIDENTIAL,33000,0,33000,147600,0,180600
132415300900000,NW 342,RESIDENTIAL,33000,0,33000,136400,0,169400
132415301000000,NW 342,RESIDENTIAL,30700,0,30700,134100,0,164800
132415301100000,NW 342,RESIDENTIAL,30500,0,30500,157500,0,188000
132415301200000,NW 342,RESIDENTIAL,30500,0,30500,147300,0,177800
132415301300000,NW 342,RESIDENTIAL,30500,0,30500,139800,0,170300
132415301400000,NW 342,RESIDENTIAL,32400,0,32400,124500,0,156900
132415301500000,CITY PROPERTY,EXEMPT,0,0,0,0,0,0
132415301600000,NW 337,RESIDENTIAL,29000,0,29000,56200,0,85200
132415400100000,NW 342,RESIDENTIAL,36000,0,36000,158000,0,194000
132415400200000,NW 342,RESIDENTIAL,30300,0,30300,132500,0,162800
132415400300000,NW 342,RESIDENTIAL,33000,0,33000,114300,0,147300
132415400400000,NW 342,RESIDENTIAL,33000,0,33000,132500,0,165500
132415400500000,NW 342,RESIDENTIAL,31300,0,31300,162100,0,193400
132415400600000,NW 342,RESIDENTIAL,22900,0,22900,154100,0,177000
132415400700000,NW 342,RESIDENTIAL,21900,0,21900,152900,0,174800
132415400800000,NW 342,RESIDENTIAL,22700,0,22700,135200,0,157900
132415400900000,NW 342,RESIDENTIAL,30300,0,30300,140100,0,170400
132415401000000,NW 342,RESIDENTIAL,32700,0,32700,133000,0,165700
132415401100000,NW 342,RESIDENTIAL,35600,0,35600,112700,0,148300
132415401200000,NW 342,RESIDENTIAL,33600,0,33600,130200,0,163800
132417600100000,NW 337,RESIDENTIAL,54000,0,54000,169300,0,223300
132417600200000,NW 309,RESIDENTIAL,51900,0,51900,151700,0,203600
132417600300000,NW 309,RESIDENTIAL,47000,0,47000,154500,0,201500
132417600400000,NW 309,RESIDENTIAL,55600,0,55600,143900,0,199500
132417600500000,NW 309,RESIDENTIAL,56100,0,56100,133600,0,189700
132417600600000,NW 309,RESIDENTIAL,60000,0,60000,308400,0,368400
132417600700000,NW 309,RESIDENTIAL,50200,0,50200,160700,0,210900
132417600800000,NW 309,RESIDENTIAL,67200,0,67200,104100,0,171300
132417600900000,NW 309,RESIDENTIAL,76600,0,76600,0,0,76600
132417601100000,NW 337,RESIDENTIAL,57000,0,57000,130800,0,187800
132417601200000,NW 309,RESIDENTIAL,0,0,0,0,0,0
132417601300000,NW 309,RESIDENTIAL,0,0,0,0,0,0
132417601400000,NW 309,RESIDENTIAL,0,0,0,0,0,0
132417601500000,NW 309,RESIDENTIAL,0,0,0,0,0,0
132417601600000,NW 309,RESIDENTIAL,0,0,0,0,0,0
132417601700000,NW 309,RESIDENTIAL,10800,0,10800,0,0,10800
132417601800000,NW 309,RESIDENTIAL,61700,0,61700,191300,0,253000
132417601900000,NW 309,RESIDENTIAL,30700,0,30700,0,0,30700
132417700100000,APARTMENT,MULTI-RES,416300,0,416300,2777500,0,3193800
132417700200000,NW 309,RESIDENTIAL,34300,0,34300,165100,0,199400
132417700300000,NW 309,RESIDENTIAL,36000,0,36000,202700,0,238700
132417700400000,NW 309,RESIDENTIAL,41300,0,41300,166100,0,207400
132417700500000,NW 309,RESIDENTIAL,36900,0,36900,181300,0,218200
132417700600000,NW 309,RESIDENTIAL,36700,0,36700,155000,0,191700
132417700800000,NW 309,RESIDENTIAL,44700,0,44700,215200,0,259900
132417700900000,NW 309,RESIDENTIAL,36900,0,36900,181300,0,218200
132417701000000,NW 309,RESIDENTIAL,42500,0,42500,173000,0,215500
132417701100000,NW 309,RESIDENTIAL,41900,0,41900,202000,0,243900
132417701200000,NW 309,RESIDENTIAL,39200,0,39200,200800,0,240000
132417701300000,NW 309,RESIDENTIAL,39500,0,39500,146300,0,185800
132417701400000,NW 309,RESIDENTIAL,38400,0,38400,177500,0,215900
132417701500000,NW 309,RESIDENTIAL,38400,0,38400,166100,0,204500
132417701600000,NW 309,RESIDENTIAL,42300,0,42300,203700,0,246000
132417701700000,NW 309,RESIDENTIAL,37200,0,37200,205600,0,242800
132417701800000,NW 309,RESIDENTIAL,40100,0,40100,141500,0,181600
132417701900000,NW 309,RESIDENTIAL,39000,0,39000,150200,0,189200
132417702000000,NW 309,RESIDENTIAL,58300,0,58300,43700,0,102000
132417702100000,NW 309,RESIDENTIAL,39000,0,39000,184400,0,223400
132417702200000,NW 309,RESIDENTIAL,33600,0,33600,177200,0,210800
132417702300000,NW 309,RESIDENTIAL,34800,0,34800,172400,0,207200
132417702400000,NW 309,RESIDENTIAL,38800,0,38800,187900,0,226700
132417702500000,NW 309,RESIDENTIAL,38400,0,38400,181300,0,219700
132417702600000,NW 309,RESIDENTIAL,38400,0,38400,154100,0,192500
132417702700000,NW 309,RESIDENTIAL,43200,0,43200,174800,0,218000
132417702800000,NW 309,RESIDENTIAL,41800,0,41800,189100,0,230900
132417702900000,NW 309,RESIDENTIAL,41000,0,41000,215200,0,256200
132417703000000,NW 309,RESIDENTIAL,42900,0,42900,188800,0,231700
132417703100000,NW 309,RESIDENTIAL,48700,0,48700,152300,0,201000
132417703200000,NW 309,RESIDENTIAL,200,0,200,0,0,200
132420100300000,NW 309,RESIDENTIAL,600,0,600,0,0,600
132420100400000,NW 309,RESIDENTIAL,600,0,600,0,0,600
132420100500000,NW 309,RESIDENTIAL,1300,0,1300,0,0,1300
132420100600000,NW 309,RESIDENTIAL,49800,0,49800,244000,0,293800
132420100700000,NW 309,RESIDENTIAL,49900,0,49900,174400,0,224300
132420100800000,NW 309,RESIDENTIAL,52100,0,52100,237600,0,289700
132420100900000,NW 309,RESIDENTIAL,57600,0,57600,0,0,57600
132420101000000,NW 309,RESIDENTIAL,38300,0,38300,164200,0,202500
132420101100000,NW 309,RESIDENTIAL,38300,0,38300,98000,0,136300
132420101200000,NW 309,RESIDENTIAL,200,0,200,0,0,200
132420101300000,NW 309,RESIDENTIAL,39200,0,39200,161400,0,200600
132420101400000,NW 309,RESIDENTIAL,44100,0,44100,170000,0,214100
132420200100000,NW 309,RESIDENTIAL,49900,0,49900,208500,0,258400
132420200200000,NW 309,RESIDENTIAL,43700,0,43700,185700,0,229400
132420200300000,NW 309,RESIDENTIAL,44900,0,44900,211000,0,255900
132420200500000,NW 309,RESIDENTIAL,53300,0,53300,223200,0,276500
132420200600000,NW 309,RESIDENTIAL,48800,0,48800,244300,0,293100
132420200700000,NW 309,RESIDENTIAL,56100,0,56100,253200,0,309300
132420300100000,NW 309,RESIDENTIAL,41900,0,41900,124300,0,166200
132420300200000,NW 309,RESIDENTIAL,30000,0,30000,124200,0,154200
132420300300000,NW 309,RESIDENTIAL,30000,0,30000,143100,0,173100
132420300400000,NW 309,RESIDENTIAL,30000,0,30000,135000,0,165000
132420300500000,NW 309,RESIDENTIAL,30000,0,30000,119900,0,149900
132420300600000,NW 309,RESIDENTIAL,30000,0,30000,128100,0,158100
132420300700000,NW 309,RESIDENTIAL,30000,0,30000,128800,0,158800
132420300800000,NW 309,RESIDENTIAL,29800,0,29800,149600,0,179400
132420300900000,NW 309,RESIDENTIAL,31300,0,31300,156100,0,187400
132420301000000,NW 309,RESIDENTIAL,26600,0,26600,107500,0,134100
132420400100000,NW 309,RESIDENTIAL,32700,0,32700,119900,0,152600
132420400200000,NW 309,RESIDENTIAL,43000,0,43000,184000,0,227000
132420400300000,NW 309,RESIDENTIAL,46000,0,46000,224000,0,270000
132420400400000,NW 309,RESIDENTIAL,43100,0,43100,232000,0,275100
132420400500000,NW 309,RESIDENTIAL,41300,0,41300,162000,0,203300
132420400600000,NW 309,RESIDENTIAL,43700,0,43700,228400,0,272100
132420400700000,NW 309,RESIDENTIAL,43700,0,43700,230900,0,274600
132420400800000,NW 309,RESIDENTIAL,41800,0,41800,227800,0,269600
132420400900000,NW 309,RESIDENTIAL,41300,0,41300,217400,0,258700
132420401000000,NW 309,RESIDENTIAL,43700,0,43700,207000,0,250700
132420401100000,NW 309,RESIDENTIAL,49500,0,49500,309900,0,359400
132420401700000,NW 309,RESIDENTIAL,51400,0,51400,116600,0,168000
132420402000000,NW 309,RESIDENTIAL,25600,0,25600,96800,0,122400
132420402100000,NW 309,RESIDENTIAL,27900,0,27900,135300,0,163200
132420402200000,NW 309,RESIDENTIAL,30000,0,30000,113000,0,143000
132420402300000,NW 309,RESIDENTIAL,30000,0,30000,139600,0,169600
132420402400000,NW 309,RESIDENTIAL,30000,0,30000,150000,0,180000
132420402500000,NW 309,RESIDENTIAL,30000,0,30000,112700,0,142700
132420402600000,NW 309,RESIDENTIAL,29500,0,29500,127300,0,156800
132420402700000,NW 309,RESIDENTIAL,29900,0,29900,122600,0,152500
132420500600000,NW 337,RESIDENTIAL,60000,0,60000,187200,0,247200
132420501100000,NW 345,RESIDENTIAL,53400,0,53400,304100,0,357500
132422600200000,NW 309,RESIDENTIAL,52000,0,52000,242200,0,294200
132422600300000,NW 309,RESIDENTIAL,65500,0,65500,130100,0,195600
132422601300000,NW 309,RESIDENTIAL,56700,0,56700,281900,0,338600
132422601400000,NW 309,RESIDENTIAL,53700,0,53700,268200,0,321900
132422601500000,NW 309,RESIDENTIAL,51700,0,51700,0,0,51700
132422601600000,NW 309,RESIDENTIAL,12300,0,12300,0,0,12300
132422601700000,NW 309,RESIDENTIAL,12300,0,12300,0,0,12300
132422800100000,NW 309,RESIDENTIAL,57600,0,57600,284500,0,342100
132422800200000,NW 309,RESIDENTIAL,54500,0,54500,275000,0,329500
132422800300000,NW 309,RESIDENTIAL,53500,0,53500,304900,0,358400
132422800400000,NW 309,RESIDENTIAL,43200,0,43200,0,0,43200
132422800500000,NW 309,RESIDENTIAL,1400,0,1400,0,0,1400
132422900100000,NW 309,RESIDENTIAL,50500,0,50500,0,0,50500
132422900200000,NW 309,RESIDENTIAL,48200,0,48200,0,0,48200
132422900300000,NW 309,RESIDENTIAL,51400,0,51400,265500,0,316900
132422900700000,NW 309,RESIDENTIAL,40300,0,40300,0,0,40300
132422900800000,NW 309,RESIDENTIAL,1300,0,1300,0,0,1300
132422900900000,NW 309,RESIDENTIAL,57900,0,57900,0,0,57900
132422901000000,NW 309,RESIDENTIAL,76900,0,76900,670600,0,747500
132423000100000,NW 345,RESIDENTIAL,28700,0,28700,158100,0,186800
132423000200000,NW 345,RESIDENTIAL,30500,0,30500,0,0,30500
132423000300000,NW 345,RESIDENTIAL,30700,0,30700,132000,0,162700
132423000400000,NW 345,RESIDENTIAL,34200,0,34200,142900,0,177100
132423000500000,NW 345,RESIDENTIAL,39400,0,39400,141000,0,180400
132423000600000,NW 345,RESIDENTIAL,60000,0,60000,0,0,60000
132423000700000,NW 345,RESIDENTIAL,45100,0,45100,165500,0,210600
132423000800000,NW 345,RESIDENTIAL,36400,0,36400,185600,0,222000
132423000900000,NW 345,RESIDENTIAL,35400,0,35400,146700,0,182100
132423001000000,NW 345,RESIDENTIAL,37700,0,37700,159800,0,197500
132423001100000,NW 345,RESIDENTIAL,36100,0,36100,170500,0,206600
132423001200000,NW 345,RESIDENTIAL,28700,0,28700,128500,0,157200
132423001300000,NW 345,RESIDENTIAL,28700,0,28700,163700,0,192400
132423001400000,NW 345,RESIDENTIAL,28600,0,28600,163500,0,192100
132423001500000,NW 345,RESIDENTIAL,29600,0,29600,181600,0,211200
132423001600000,NW 345,RESIDENTIAL,31400,0,31400,166600,0,198000
132423001700000,NW 345,RESIDENTIAL,32300,0,32300,151500,0,183800
132423001800000,NW 345,RESIDENTIAL,33000,0,33000,170200,0,203200
132423001900000,NW 345,RESIDENTIAL,33700,0,33700,186100,0,219800
132423002000000,NW 345,RESIDENTIAL,34900,0,34900,200300,0,235200
132423100100000,NW 345,RESIDENTIAL,40100,0,40100,162900,0,203000
132423100200000,NW 345,RESIDENTIAL,33300,0,33300,168300,0,201600
132423100300000,NW 345,RESIDENTIAL,34300,0,34300,149200,0,183500
132423100400000,NW 345,RESIDENTIAL,34000,0,34000,158000,0,192000
132423100500000,NW 345,RESIDENTIAL,32700,0,32700,166300,0,199000
132423100600000,NW 345,RESIDENTIAL,35600,0,35600,145000,0,180600
132423100700000,NW 345,RESIDENTIAL,34300,0,34300,156000,0,190300
132423100800000,NW 345,RESIDENTIAL,34300,0,34300,157900,0,192200
132423100900000,NW 345,RESIDENTIAL,34300,0,34300,142400,0,176700
132423101000000,NW 345,RESIDENTIAL,34300,0,34300,133200,0,167500
132423200100000,NW 345,RESIDENTIAL,42600,0,42600,173100,0,215700
132423200200000,NW 345,RESIDENTIAL,32200,0,32200,159900,0,192100
132423200300000,NW 345,RESIDENTIAL,33600,0,33600,165000,0,198600
132423200400000,NW 345,RESIDENTIAL,40900,0,40900,194000,0,234900
132423200500000,NW 345,RESIDENTIAL,5700,0,5700,0,0,5700
132423200600000,NW 345,RESIDENTIAL,52500,0,52500,147400,0,199900
132423200700000,NW 345,RESIDENTIAL,7300,0,7300,0,0,7300
132423200800000,NW 345,RESIDENTIAL,38600,0,38600,4200,0,42800
132423200900000,NW 345,RESIDENTIAL,37300,0,37300,4200,0,41500
132423300100000,NW 345,RESIDENTIAL,34300,0,34300,0,0,34300
132423300200000,NW 345,RESIDENTIAL,31500,0,31500,186300,0,217800
132423300300000,NW 345,RESIDENTIAL,31500,0,31500,180800,0,212300
132423300400000,NW 345,RESIDENTIAL,31500,0,31500,197000,0,228500
132423300600000,NW 345,RESIDENTIAL,1300,0,1300,0,0,1300
132423300700000,NW 345,RESIDENTIAL,1300,0,1300,0,0,1300
132423300800000,NW 345,RESIDENTIAL,1400,0,1400,0,0,1400
132423300900000,NW 345,RESIDENTIAL,1600,0,1600,0,0,1600
132423301000000,NW 345,RESIDENTIAL,2100,0,2100,0,0,2100
132423400100000,NW 345,RESIDENTIAL,32200,0,32200,177000,0,209200
132423400200000,NW 345,RESIDENTIAL,34000,0,34000,189400,0,223400
132423400300000,NW 345,RESIDENTIAL,36000,0,36000,189200,0,225200
132423400400000,NW 345,RESIDENTIAL,36000,0,36000,192100,0,228100
132423400600000,NW 345,RESIDENTIAL,3700,0,3700,0,0,3700
132423400700000,NW 345,RESIDENTIAL,1800,0,1800,0,0,1800
132423400800000,NW 345,RESIDENTIAL,1300,0,1300,0,0,1300
132423400900000,NW 345,RESIDENTIAL,1400,0,1400,0,0,1400
132423401000000,NW 345,RESIDENTIAL,1300,0,1300,0,0,1300
132425100200000,NW 345,RESIDENTIAL,31700,0,31700,143500,0,175200
132425100300000,NW 345,RESIDENTIAL,30700,0,30700,156800,0,187500
132425100400000,NW 345,RESIDENTIAL,33900,0,33900,140800,0,174700
132425100500000,NW 345,RESIDENTIAL,37200,0,37200,148000,0,185200
132425100600000,NW 345,RESIDENTIAL,29500,0,29500,137900,0,167400
132425100700000,NW 345,RESIDENTIAL,36000,0,36000,205400,0,241400
132425100800000,NW 345,RESIDENTIAL,23300,0,23300,158400,0,181700
132425100900000,NW 345,RESIDENTIAL,27000,0,27000,163700,0,190700
132425101000000,NW 345,RESIDENTIAL,35000,0,35000,159700,0,194700
132425101100000,CITY PROPERTY,EXEMPT,0,0,0,0,0,0
132425200200000,NW 345,RESIDENTIAL,33500,0,33500,138000,0,171500
132425300200000,NW 345,RESIDENTIAL,42500,0,42500,161800,0,204300
132425300300000,NW 345,RESIDENTIAL,33000,0,33000,150000,0,183000
132425300400000,NW 345,RESIDENTIAL,33500,0,33500,139500,0,173000
132425300500000,NW 345,RESIDENTIAL,49900,0,49900,165100,0,215000
132425300800000,NW 345,RESIDENTIAL,37000,0,37000,140400,0,177400
132425300900000,NW 345,RESIDENTIAL,33600,0,33600,149000,0,182600
132425301000000,NW 345,RESIDENTIAL,32200,0,32200,194800,0,227000
132425301100000,NW 345,RESIDENTIAL,40200,0,40200,210500,0,250700
132425301200000,NW 345,RESIDENTIAL,40200,0,40200,178600,0,218800
132425301400000,NW 345,RESIDENTIAL,43800,0,43800,184300,0,228100
132425301500000,NW 345,RESIDENTIAL,38000,0,38000,182000,0,220000
132425301600000,NW 345,RESIDENTIAL,38900,0,38900,182000,0,220900
132425301700000,CITY PROPERTY,EXEMPT,0,0,0,0,0,0
132425301800000,NW 345,RESIDENTIAL,34700,0,34700,161900,0,196600
132425301900000,NW 345,RESIDENTIAL,25500,0,25500,153900,0,179400
132425302000000,NW 345,RESIDENTIAL,25500,0,25500,137900,0,163400
132425302100000,NW 345,RESIDENTIAL,25500,0,25500,140300,0,165800
132425302200000,NW 345,RESIDENTIAL,25500,0,25500,140300,0,165800
132425302300000,NW 345,RESIDENTIAL,25500,0,25500,139500,0,165000
132425302400000,NW 345,RESIDENTIAL,25300,0,25300,140300,0,165600
132425302500000,NW 345,RESIDENTIAL,25300,0,25300,140600,0,165900
132425302600000,NW 345,RESIDENTIAL,25300,0,25300,151600,0,176900
132425302700000,NW 345,RESIDENTIAL,25300,0,25300,149400,0,174700
132425302800000,NW 345,RESIDENTIAL,25300,0,25300,109700,0,135000
132425302900000,NW 345,RESIDENTIAL,25000,0,25000,102500,0,127500
132425303000000,NW 345,RESIDENTIAL,25000,0,25000,107400,0,132400
132425303100000,NW 345,RESIDENTIAL,25000,0,25000,109700,0,134700
132425303200000,NW 345,RESIDENTIAL,25000,0,25000,109700,0,134700
132425303300000,NW 345,RESIDENTIAL,25000,0,25000,109800,0,134800
132425303400000,NW 345,RESIDENTIAL,24800,0,24800,109700,0,134500
132425303500000,NW 345,RESIDENTIAL,33600,0,33600,169200,0,202800
132425303600000,NW 345,RESIDENTIAL,32000,0,32000,172900,0,204900
132425303700000,NW 345,RESIDENTIAL,32300,0,32300,169600,0,201900
132425303800000,NW 345,RESIDENTIAL,32300,0,32300,182900,0,215200
132425303900000,NW 345,RESIDENTIAL,33300,0,33300,186100,0,219400
132425304000000,NW 345,RESIDENTIAL,32300,0,32300,4200,0,36500
132425304100000,NW 345,RESIDENTIAL,10200,0,10200,0,0,10200
132425304200000,NW 345,RESIDENTIAL,3100,0,3100,0,0,3100
132425400100000,NW 345,RESIDENTIAL,34600,0,34600,159000,0,193600
132425400200000,NW 345,RESIDENTIAL,34600,0,34600,137000,0,171600
132425400300000,NW 345,RESIDENTIAL,34600,0,34600,137400,0,172000
132425400400000,NW 345,RESIDENTIAL,34900,0,34900,143600,0,178500
132425400500000,NW 345,RESIDENTIAL,34900,0,34900,160400,0,195300
132425400600000,NW 345,RESIDENTIAL,34900,0,34900,137000,0,171900
132425400700000,NW 345,RESIDENTIAL,34900,0,34900,157700,0,192600
132425400800000,NW 345,RESIDENTIAL,35200,0,35200,152600,0,187800
132425400900000,NW 345,RESIDENTIAL,35200,0,35200,133100,0,168300
132425401000000,NW 345,RESIDENTIAL,35200,0,35200,147800,0,183000
132425401100000,NW 345,RESIDENTIAL,34600,0,34600,129600,0,164200
132425500100000,NW 345,RESIDENTIAL,33300,0,33300,150900,0,184200
132425500200000,NW 345,RESIDENTIAL,34400,0,34400,153300,0,187700
132425500300000,NW 345,RESIDENTIAL,31700,0,31700,135400,0,167100
132425500400000,NW 345,RESIDENTIAL,31700,0,31700,133300,0,165000
132425500500000,NW 345,RESIDENTIAL,31700,0,31700,135400,0,167100
132425500600000,NW 345,RESIDENTIAL,31700,0,31700,137400,0,169100
132425500700000,NW 345,RESIDENTIAL,31700,0,31700,157300,0,189000
132425500800000,NW 345,RESIDENTIAL,31700,0,31700,153800,0,185500
132425500900000,NW 345,RESIDENTIAL,31700,0,31700,160400,0,192100
132425501000000,NW 345,RESIDENTIAL,31700,0,31700,163800,0,195500
132425501100000,NW 345,RESIDENTIAL,31700,0,31700,156600,0,188300
132425501200000,NW 345,RESIDENTIAL,31700,0,31700,146900,0,178600
132425501300000,NW 345,RESIDENTIAL,32900,0,32900,152600,0,185500
132425501400000,NW 345,RESIDENTIAL,33300,0,33300,152400,0,185700
132425501500000,NW 345,RESIDENTIAL,33300,0,33300,135400,0,168700
132425501600000,NW 345,RESIDENTIAL,33300,0,33300,136200,0,169500
132425501700000,NW 345,RESIDENTIAL,33300,0,33300,145100,0,178400
132425501800000,NW 345,RESIDENTIAL,33300,0,33300,136000,0,169300
132425501900000,NW 345,RESIDENTIAL,33300,0,33300,145600,0,178900
132425502000000,NW 345,RESIDENTIAL,33300,0,33300,135400,0,168700
132425502100000,NW 345,RESIDENTIAL,33300,0,33300,146500,0,179800
132425502200000,NW 345,RESIDENTIAL,33300,0,33300,152200,0,185500
132425600100000,NW 345,RESIDENTIAL,36500,0,36500,139300,0,175800
132425600300000,NW 345,RESIDENTIAL,33200,0,33200,122200,0,155400
132425600400000,NW 345,RESIDENTIAL,33200,0,33200,132500,0,165700
132425600500000,NW 345,RESIDENTIAL,33200,0,33200,145500,0,178700
132425600600000,NW 345,RESIDENTIAL,33200,0,33200,150900,0,184100
132425600700000,NW 345,RESIDENTIAL,33200,0,33200,157600,0,190800
132425600800000,NW 345,RESIDENTIAL,33200,0,33200,152800,0,186000
132425600900000,NW 345,RESIDENTIAL,33200,0,33200,152600,0,185800
132425601000000,NW 345,RESIDENTIAL,33200,0,33200,137900,0,171100
132425601100000,NW 345,RESIDENTIAL,33200,0,33200,150100,0,183300
132425601200000,NW 345,RESIDENTIAL,33200,0,33200,150000,0,183200
132425601300000,NW 345,RESIDENTIAL,35000,0,35000,148700,0,183700
132425601400000,NW 345,RESIDENTIAL,33300,0,33300,171300,0,204600
132425601500000,NW 345,RESIDENTIAL,33200,0,33200,164000,0,197200
132425601600000,NW 345,RESIDENTIAL,33200,0,33200,161300,0,194500
132425601700000,NW 345,RESIDENTIAL,33200,0,33200,145000,0,178200
132425601800000,NW 345,RESIDENTIAL,33200,0,33200,154600,0,187800
132425601900000,NW 345,RESIDENTIAL,33200,0,33200,164300,0,197500
132425602000000,NW 345,RESIDENTIAL,33200,0,33200,143600,0,176800
132425602100000,NW 345,RESIDENTIAL,33200,0,33200,172800,0,206000
132425602200000,NW 345,RESIDENTIAL,33200,0,33200,170400,0,203600
132425602300000,NW 345,RESIDENTIAL,33200,0,33200,173000,0,206200
132425602400000,NW 345,RESIDENTIAL,33200,0,33200,146400,0,179600
132425700400000,NW 345,RESIDENTIAL,37400,0,37400,194500,0,231900
132425700500000,NW 345,RESIDENTIAL,37400,0,37400,177100,0,214500
132425700600000,NW 345,RESIDENTIAL,37400,0,37400,132600,0,170000
132425700700000,NW 345,RESIDENTIAL,37400,0,37400,175200,0,212600
132425700800000,NW 345,RESIDENTIAL,37400,0,37400,170000,0,207400
132425700900000,NW 345,RESIDENTIAL,37400,0,37400,213000,0,250400
132425701000000,NW 345,RESIDENTIAL,37400,0,37400,213800,0,251200
132425701100000,NW 345,RESIDENTIAL,37400,0,37400,182800,0,220200
132425701200000,NW 345,RESIDENTIAL,37400,0,37400,181500,0,218900
132425701300000,NW 345,RESIDENTIAL,37400,0,37400,166400,0,203800
132425701400000,NW 345,RESIDENTIAL,37400,0,37400,223900,0,261300
132425701700000,NW 345,RESIDENTIAL,24000,0,24000,152300,0,176300
132425701800000,NW 345,RESIDENTIAL,24000,0,24000,137300,0,161300
132425701900000,NW 345,RESIDENTIAL,24000,0,24000,152100,0,176100
132425702000000,NW 345,RESIDENTIAL,24000,0,24000,150500,0,174500
132425702100000,NW 345,RESIDENTIAL,24000,0,24000,136600,0,160600
132425702200000,NW 345,RESIDENTIAL,24000,0,24000,152300,0,176300
132425702300000,NW 345,RESIDENTIAL,24000,0,24000,168100,0,192100
132425702400000,NW 345,RESIDENTIAL,24000,0,24000,140300,0,164300
132425702500000,NW 345,RESIDENTIAL,24000,0,24000,148900,0,172900
132425702600000,NW 345,RESIDENTIAL,24000,0,24000,148900,0,172900
132425702700000,NW 345,RESIDENTIAL,24000,0,24000,148900,0,172900
132425702800000,NW 345,RESIDENTIAL,24000,0,24000,148900,0,172900
132425702900000,NW 345,RESIDENTIAL,24000,0,24000,148900,0,172900
132425703000000,NW 345,RESIDENTIAL,24000,0,24000,148900,0,172900
132425703100000,NW 345,RESIDENTIAL,24000,0,24000,148900,0,172900
132425703200000,NW 345,RESIDENTIAL,24000,0,24000,153500,0,177500
132425703300000,NW 345,RESIDENTIAL,22900,0,22900,147900,0,170800
132425800100000,NW 345,RESIDENTIAL,35100,0,35100,149900,0,185000
132425800200000,NW 345,RESIDENTIAL,36600,0,36600,154500,0,191100
132427600100000,NW 337,RESIDENTIAL,39200,0,39200,88500,0,127700
132427600200000,NW 337,RESIDENTIAL,27000,0,27000,42200,0,69200
132427600300000,NW 337,RESIDENTIAL,31600,0,31600,131800,0,163400
132427600400000,NW 337,RESIDENTIAL,31600,0,31600,137700,0,169300
132427600500000,NW 337,RESIDENTIAL,33600,0,33600,161600,0,195200
132427600600000,NW 337,RESIDENTIAL,34000,0,34000,75900,0,109900
132427600800000,NW 337,RESIDENTIAL,35300,0,35300,103700,0,139000
132427600900000,NW 337,RESIDENTIAL,35300,0,35300,162500,0,197800
132427601000000,NW 337,RESIDENTIAL,35300,0,35300,72900,0,108200
132427601100000,NW 337,RESIDENTIAL,21200,0,21200,0,0,21200
132427601200000,NW 337,RESIDENTIAL,35300,0,35300,109700,0,145000
132427601300000,NW 337,RESIDENTIAL,35300,0,35300,112000,0,147300
132427601400000,NW 337,RESIDENTIAL,35300,0,35300,79900,0,115200
132427601500000,NW 337,RESIDENTIAL,35300,0,35300,84700,0,120000
132427601600000,NW 337,RESIDENTIAL,32300,0,32300,109300,0,141600
132427700100000,NW 337,RESIDENTIAL,39800,0,39800,67500,0,107300
132427700200000,NW 337,RESIDENTIAL,29500,0,29500,104800,0,134300
132427700300000,NW 337,RESIDENTIAL,32800,0,32800,75200,0,108000
132427700400000,NW 337,RESIDENTIAL,32800,0,32800,139300,0,172100
132427700500000,NW 337,RESIDENTIAL,32800,0,32800,103900,0,136700
132427700600000,NW 337,RESIDENTIAL,32800,0,32800,141500,0,174300
132427700700000,NW 337,RESIDENTIAL,29000,0,29000,163500,0,192500
132427700800000,NW 337,RESIDENTIAL,21400,0,21400,71200,0,92600
132427700900000,NW 337,RESIDENTIAL,27500,0,27500,123900,0,151400
132427701000000,NW 337,RESIDENTIAL,28000,0,28000,101800,0,129800
132427701100000,NW 337,RESIDENTIAL,28000,0,28000,85500,0,113500
132427701200000,NW 337,RESIDENTIAL,28000,0,28000,97800,0,125800
132427701300000,NW 337,RESIDENTIAL,28000,0,28000,72300,0,100300
132427701500000,NW 337,RESIDENTIAL,28000,0,28000,119400,0,147400
132427701600000,NW 337,RESIDENTIAL,28000,0,28000,89700,0,117700
132427701700000,NW 337,RESIDENTIAL,28000,0,28000,92900,0,120900
132427701800000,NW 337,RESIDENTIAL,28000,0,28000,107700,0,135700
132427701900000,NW 337,RESIDENTIAL,27600,0,27600,81900,0,109500
132427702000000,NW 337,RESIDENTIAL,28700,0,28700,96600,0,125300
132427702100000,NW 337,RESIDENTIAL,28700,0,28700,76400,0,105100
132427702200000,NW 337,RESIDENTIAL,27600,0,27600,86000,0,113600
132427702300000,NW 337,RESIDENTIAL,28000,0,28000,90300,0,118300
132427702400000,NW 337,RESIDENTIAL,28000,0,28000,116000,0,144000
132427702500000,NW 337,RESIDENTIAL,28000,0,28000,98700,0,126700
132427702600000,NW 337,RESIDENTIAL,28000,0,28000,113600,0,141600
132427702700000,NW 337,RESIDENTIAL,19900,0,19900,132600,0,152500
132427702800000,NW 337,RESIDENTIAL,22500,0,22500,112300,0,134800
132427800100000,NW 337,RESIDENTIAL,30900,0,30900,92700,0,123600
132427800200000,NW 337,RESIDENTIAL,31000,0,31000,52000,0,83000
132427800300000,NW 337,RESIDENTIAL,35000,0,35000,134800,0,169800
132427800400000,NW 337,RESIDENTIAL,35000,0,35000,122200,0,157200
132427800500000,NW 337,RESIDENTIAL,35000,0,35000,136600,0,171600
132427800600000,NW 337,RESIDENTIAL,35000,0,35000,127200,0,162200
132427800700000,NW 337,RESIDENTIAL,28000,0,28000,0,0,28000
132427800800000,NW 337,RESIDENTIAL,35000,0,35000,65900,0,100900
132430100100000,NW 337,RESIDENTIAL,34300,0,34300,87300,0,121600
132430100200000,NW 337,RESIDENTIAL,37600,0,37600,65000,0,102600
132430100300000,NW 337,RESIDENTIAL,32400,0,32400,108700,0,141100
132430100400000,NW 337,RESIDENTIAL,29700,0,29700,130700,0,160400
132430100500000,NW 337,RESIDENTIAL,27000,0,27000,133600,0,160600
132430100600000,NW 337,RESIDENTIAL,22200,0,22200,0,0,22200
132430100700000,NW 337,RESIDENTIAL,23700,0,23700,0,0,23700
132430100800000,NW 337,RESIDENTIAL,25100,0,25100,57700,0,82800
132430100900000,NW 337,RESIDENTIAL,34900,0,34900,69400,0,104300
132430101000000,NW 337,RESIDENTIAL,23500,0,23500,129600,0,153100
132430101100000,NW 337,RESIDENTIAL,24400,0,24400,91900,0,116300
132430101200000,NW 337,RESIDENTIAL,18900,0,18900,104800,0,123700
132430101300000,NW 337,RESIDENTIAL,35000,0,35000,149600,0,184600
132430200100000,NW 337,RESIDENTIAL,49600,0,49600,114600,0,164200
132430200200000,NW 337,RESIDENTIAL,16300,0,16300,102700,0,119000
132430200300000,NW 337,RESIDENTIAL,39500,0,39500,79100,0,118600
132430200400000,NW 337,RESIDENTIAL,71300,0,71300,72100,0,143400
132430200600000,NW 337,RESIDENTIAL,63900,0,63900,105300,0,169200
132430200700000,NW 345,RESIDENTIAL,38200,0,38200,122600,0,160800
132430200800000,NW 345,RESIDENTIAL,35700,0,35700,121000,0,156700
132430200900000,NW 345,RESIDENTIAL,35700,0,35700,145000,0,180700
132430201000000,NW 345,RESIDENTIAL,35700,0,35700,119200,0,154900
132430201100000,NW 345,RESIDENTIAL,24300,0,24300,156800,0,181100
132430201200000,NW 345,RESIDENTIAL,24300,0,24300,171100,0,195400
132430201300000,NW 345,RESIDENTIAL,24400,0,24400,146100,0,170500
132430201400000,NW 345,RESIDENTIAL,25200,0,25200,136500,0,161700
132430201500000,NW 345,RESIDENTIAL,27400,0,27400,148200,0,175600
132430201600000,NW 345,RESIDENTIAL,28000,0,28000,115600,0,143600
132430201700000,NW 345,RESIDENTIAL,27400,0,27400,184300,0,211700
132430201800000,NW 345,RESIDENTIAL,24500,0,24500,166600,0,191100
132430201900000,NW 345,RESIDENTIAL,24300,0,24300,155800,0,180100
132430202000000,NW 345,RESIDENTIAL,24300,0,24300,159400,0,183700
132430202100000,NW 345,RESIDENTIAL,1200,0,1200,0,0,1200
132430300200000,NW 337,RESIDENTIAL,35800,0,35800,99500,0,135300
132430300300000,NW 337,RESIDENTIAL,25600,0,25600,104800,0,130400
132430300400000,NW 337,RESIDENTIAL,25600,0,25600,135300,0,160900
132430300500000,NW 337,RESIDENTIAL,34700,0,34700,114600,0,149300
132430300700000,NW 337,RESIDENTIAL,34700,0,34700,104700,0,139400
132430300800000,NW 337,RESIDENTIAL,34700,0,34700,100300,0,135000
132430300900000,NW 337,RESIDENTIAL,34700,0,34700,94100,0,128800
132430301000000,NW 337,RESIDENTIAL,28600,0,28600,68300,0,96900
132430301100000,NW 337,RESIDENTIAL,36000,0,36000,82500,0,118500
132430301200000,NW 337,RESIDENTIAL,34700,0,34700,114900,0,149600
132430301300000,NW 337,RESIDENTIAL,34700,0,34700,107100,0,141800
132430301400000,NW 337,RESIDENTIAL,34700,0,34700,92700,0,127400
132430301500000,NW 337,RESIDENTIAL,34700,0,34700,71000,0,105700
132430301600000,NW 337,RESIDENTIAL,34700,0,34700,96300,0,131000
132430301700000,NW 337,RESIDENTIAL,34700,0,34700,180400,0,215100
132430301800000,NW 337,RESIDENTIAL,29400,0,29400,97500,0,126900
132430301900000,NW 337,RESIDENTIAL,25600,0,25600,63200,0,88800
132430302100000,NW 337,RESIDENTIAL,25600,0,25600,146400,0,172000
132430302200000,NW 337,RESIDENTIAL,55800,0,55800,0,0,55800
132430302300000,NW 337,RESIDENTIAL,55800,0,55800,102500,0,158300
132432600100000,NW 345,RESIDENTIAL,36900,0,36900,128500,0,165400
132432600200000,NW 345,RESIDENTIAL,37900,0,37900,136600,0,174500
132432600300000,NW 345,RESIDENTIAL,39800,0,39800,144200,0,184000
132432600400000,NW 345,RESIDENTIAL,36700,0,36700,142200,0,178900
132432600500000,NW 345,RESIDENTIAL,34600,0,34600,158300,0,192900
132432600600000,NW 345,RESIDENTIAL,32200,0,32200,153500,0,185700
132432600700000,CITY PROPERTY,EXEMPT,0,0,0,0,0,0
132432600800000,NW 345,RESIDENTIAL,33700,0,33700,158800,0,192500
132432600900000,NW 345,RESIDENTIAL,34700,0,34700,154000,0,188700
132432601000000,NW 345,RESIDENTIAL,39500,0,39500,131500,0,171000
132432601100000,NW 345,RESIDENTIAL,41300,0,41300,160800,0,202100
132432601200000,NW 345,RESIDENTIAL,40300,0,40300,144000,0,184300
132432601300000,NW 345,RESIDENTIAL,36700,0,36700,128800,0,165500
132432601400000,NW 345,RESIDENTIAL,36300,0,36300,139500,0,175800
132432700100000,NW 345,RESIDENTIAL,32600,0,32600,160700,0,193300
132432700200000,NW 345,RESIDENTIAL,31700,0,31700,123300,0,155000
132432700300000,NW 345,RESIDENTIAL,32000,0,32000,133400,0,165400
132432700400000,NW 345,RESIDENTIAL,33800,0,33800,138600,0,172400
132432700500000,NW 345,RESIDENTIAL,33500,0,33500,143800,0,177300
132432700600000,NW 345,RESIDENTIAL,33700,0,33700,132300,0,166000
132432800100000,NW 345,RESIDENTIAL,33200,0,33200,160600,0,193800
132432800200000,NW 345,RESIDENTIAL,33200,0,33200,132800,0,166000
132432800300000,NW 345,RESIDENTIAL,35400,0,35400,147600,0,183000
132432800400000,NW 345,RESIDENTIAL,35400,0,35400,128200,0,163600
132432800500000,NW 345,RESIDENTIAL,35600,0,35600,157300,0,192900
132432801100000,NW 345,RESIDENTIAL,33500,0,33500,132300,0,165800
132432801200000,NW 345,RESIDENTIAL,33200,0,33200,168100,0,201300
132432801300000,NW 345,RESIDENTIAL,33200,0,33200,155000,0,188200
132432801400000,NW 345,RESIDENTIAL,35200,0,35200,189400,0,224600
132432801500000,NW 345,RESIDENTIAL,33400,0,33400,155400,0,188800
132432801600000,NW 345,RESIDENTIAL,34000,0,34000,163700,0,197700
132432801800000,NW 345,RESIDENTIAL,30400,0,30400,148300,0,178700
132432801900000,NW 345,RESIDENTIAL,38200,0,38200,128900,0,167100
132432900200000,NW 345,RESIDENTIAL,34600,0,34600,134500,0,169100
132432901000000,NW 345,RESIDENTIAL,37400,0,37400,183000,0,220400
132432901100000,NW 345,RESIDENTIAL,37400,0,37400,176600,0,214000
132432901200000,NW 345,RESIDENTIAL,37400,0,37400,179100,0,216500
132432901300000,NW 345,RESIDENTIAL,35900,0,35900,171500,0,207400
132432901500000,NW 345,RESIDENTIAL,37700,0,37700,130200,0,167900
132432901600000,NW 345,RESIDENTIAL,23300,0,23300,159800,0,183100
132432901700000,NW 345,RESIDENTIAL,23800,0,23800,140000,0,163800
132432901800000,NW 345,RESIDENTIAL,24000,0,24000,151000,0,175000
132432901900000,NW 345,RESIDENTIAL,24000,0,24000,149600,0,173600
132432902000000,NW 345,RESIDENTIAL,24000,0,24000,150500,0,174500
132433000100000,NW 345,RESIDENTIAL,32500,0,32500,150000,0,182500
132433000200000,NW 345,RESIDENTIAL,30500,0,30500,135400,0,165900
132433000300000,NW 345,RESIDENTIAL,27900,0,27900,130000,0,157900
132433000400000,NW 345,RESIDENTIAL,29500,0,29500,131600,0,161100
132433000500000,NW 345,RESIDENTIAL,31700,0,31700,117700,0,149400
132433000600000,NW 345,RESIDENTIAL,29600,0,29600,117700,0,147300
132433000700000,NW 345,RESIDENTIAL,28300,0,28300,118300,0,146600
132433000800000,NW 345,RESIDENTIAL,27200,0,27200,111400,0,138600
132433000900000,NW 345,RESIDENTIAL,24800,0,24800,107600,0,132400
132433001000000,NW 345,RESIDENTIAL,24800,0,24800,109700,0,134500
132433001100000,NW 345,RESIDENTIAL,24800,0,24800,119500,0,144300
132433100100000,NW 326,RESIDENTIAL,69800,0,69800,88500,0,158300
132433100200000,NW 326,AG LAND,4500,0,4500,0,0,4500
132435100100000,NW 326,RESIDENTIAL,30200,0,30200,126500,0,156700
132435100200000,NW 326,RESIDENTIAL,26200,0,26200,78000,0,104200
132435100300000,NW 326,RESIDENTIAL,30100,0,30100,102000,0,132100
132435100400000,NW 326,RESIDENTIAL,32800,0,32800,111800,0,144600
132435100500000,NW 326,RESIDENTIAL,27800,0,27800,107500,0,135300
132435100600000,NW 326,RESIDENTIAL,31100,0,31100,121500,0,152600
132435100700000,NW 326,RESIDENTIAL,25900,0,25900,115400,0,141300
132435100800000,NW 326,RESIDENTIAL,28100,0,28100,108600,0,136700
132435100900000,NW 326,RESIDENTIAL,27600,0,27600,96200,0,123800
132435101000000,NW 326,RESIDENTIAL,29700,0,29700,85500,0,115200
132435101100000,NW 326,RESIDENTIAL,28700,0,28700,104500,0,133200
132435101200000,NW 326,RESIDENTIAL,28900,0,28900,103700,0,132600
132435101300000,NW 326,RESIDENTIAL,26700,0,26700,117800,0,144500
132435101400000,NW 326,RESIDENTIAL,27700,0,27700,102300,0,130000
132435101500000,NW 326,RESIDENTIAL,26500,0,26500,97000,0,123500
132435101600000,NW 326,RESIDENTIAL,30500,0,30500,118400,0,148900
132435101700000,NW 326,RESIDENTIAL,30500,0,30500,108300,0,138800
132435101800000,NW 326,RESIDENTIAL,27500,0,27500,108400,0,135900
132435101900000,NW 326,RESIDENTIAL,30100,0,30100,101200,0,131300
132435102000000,NW 326,RESIDENTIAL,30200,0,30200,108700,0,138900
132435200100000,NW 326,RESIDENTIAL,29400,0,29400,115500,0,144900
132435200200000,NW 326,RESIDENTIAL,28000,0,28000,108600,0,136600
132435200300000,NW 326,RESIDENTIAL,26800,0,26800,105200,0,132000
132435200400000,NW 326,RESIDENTIAL,28000,0,28000,117900,0,145900
132435200500000,NW 326,RESIDENTIAL,26800,0,26800,120400,0,147200
132435200600000,NW 326,RESIDENTIAL,29700,0,29700,124200,0,153900
132435300100000,NW 326,RESIDENTIAL,29800,0,29800,135800,0,165600
132435300200000,NW 326,RESIDENTIAL,26200,0,26200,94100,0,120300
132435300300000,NW 326,RESIDENTIAL,27500,0,27500,92300,0,119800
132435300400000,NW 326,RESIDENTIAL,30100,0,30100,114900,0,145000
132435300500000,NW 326,RESIDENTIAL,27500,0,27500,111300,0,138800
132435300600000,NW 326,RESIDENTIAL,29300,0,29300,104700,0,134000
132435300700000,NW 326,RESIDENTIAL,26600,0,26600,118900,0,145500
132435300800000,NW 326,RESIDENTIAL,25800,0,25800,102100,0,127900
132435300900000,NW 326,RESIDENTIAL,27700,0,27700,105500,0,133200
132435301000000,NW 326,RESIDENTIAL,27200,0,27200,98000,0,125200
132435301100000,NW 326,RESIDENTIAL,26200,0,26200,120700,0,146900
132435301200000,NW 326,RESIDENTIAL,30100,0,30100,124400,0,154500
132435301300000,NW 326,RESIDENTIAL,26200,0,26200,122800,0,149000
132435301400000,NW 326,RESIDENTIAL,27500,0,27500,111600,0,139100
132435301500000,NW 326,RESIDENTIAL,30100,0,30100,114900,0,145000
132435301600000,NW 326,RESIDENTIAL,27500,0,27500,120800,0,148300
132435301700000,NW 326,RESIDENTIAL,27500,0,27500,117100,0,144600
132435301800000,NW 326,RESIDENTIAL,28300,0,28300,126000,0,154300
132435400100000,NW 326,RESIDENTIAL,30800,0,30800,106000,0,136800
132435400200000,NW 326,RESIDENTIAL,26600,0,26600,103900,0,130500
132435400300000,NW 326,RESIDENTIAL,32000,0,32000,124300,0,156300
132435400400000,NW 326,RESIDENTIAL,28700,0,28700,101100,0,129800
132435400500000,NW 326,RESIDENTIAL,30300,0,30300,122100,0,152400
132435400600000,NW 326,RESIDENTIAL,29900,0,29900,111100,0,141000
132435400700000,NW 326,RESIDENTIAL,29100,0,29100,109800,0,138900
132435400800000,NW 326,RESIDENTIAL,32500,0,32500,99800,0,132300
132435500100000,NW 326,RESIDENTIAL,31100,0,31100,121500,0,152600
132435500200000,NW 326,RESIDENTIAL,27500,0,27500,109200,0,136700
132435500300000,NW 326,RESIDENTIAL,27500,0,27500,98800,0,126300
132435500400000,NW 326,RESIDENTIAL,29800,0,29800,133100,0,162900
132435500500000,NW 326,RESIDENTIAL,29800,0,29800,98900,0,128700
132435500600000,NW 326,RESIDENTIAL,29800,0,29800,103200,0,133000
132435500700000,NW 326,RESIDENTIAL,29800,0,29800,113800,0,143600
132435500800000,NW 326,RESIDENTIAL,30800,0,30800,108600,0,139400
132435500900000,NW 326,RESIDENTIAL,32700,0,32700,105800,0,138500
132435501000000,NW 326,RESIDENTIAL,30900,0,30900,108600,0,139500
132435501100000,NW 326,RESIDENTIAL,30100,0,30100,101600,0,131700
132435501200000,NW 326,RESIDENTIAL,28900,0,28900,103900,0,132800
132435501300000,NW 326,RESIDENTIAL,28900,0,28900,124600,0,153500
132435501400000,NW 326,RESIDENTIAL,29400,0,29400,110200,0,139600
132435501500000,NW 326,RESIDENTIAL,30600,0,30600,111500,0,142100
132435501600000,NW 326,RESIDENTIAL,32100,0,32100,108500,0,140600
132435501700000,NW 326,RESIDENTIAL,29900,0,29900,131800,0,161700
132435501800000,NW 326,RESIDENTIAL,26100,0,26100,118400,0,144500
132435501900000,NW 326,RESIDENTIAL,31100,0,31100,122800,0,153900
132435502000000,NW 326,RESIDENTIAL,25000,0,25000,118400,0,143400
132435502100000,NW 326,RESIDENTIAL,29200,0,29200,125600,0,154800
132435502200000,NW 326,RESIDENTIAL,27400,0,27400,151800,0,179200
132435502300000,NW 326,RESIDENTIAL,30800,0,30800,119800,0,150600
132435502400000,NW 326,RESIDENTIAL,31900,0,31900,117700,0,149600
132435502500000,NW 326,RESIDENTIAL,33100,0,33100,126300,0,159400
132435502600000,NW 326,RESIDENTIAL,30600,0,30600,115000,0,145600
132435502700000,NW 326,RESIDENTIAL,30500,0,30500,139100,0,169600
132435502800000,NW 326,RESIDENTIAL,31100,0,31100,126100,0,157200
132435502900000,NW 326,RESIDENTIAL,30600,0,30600,125500,0,156100
132435503000000,NW 326,RESIDENTIAL,29200,0,29200,123500,0,152700
132435503100000,NW 326,RESIDENTIAL,32000,0,32000,151100,0,183100
132435503200000,NW 326,RESIDENTIAL,33400,0,33400,132700,0,166100
132435503300000,NW 326,RESIDENTIAL,32700,0,32700,122600,0,155300
132435503400000,NW 326,RESIDENTIAL,33400,0,33400,134800,0,168200
132435503500000,NW 326,RESIDENTIAL,31200,0,31200,127900,0,159100
132435503600000,NW 326,RESIDENTIAL,30000,0,30000,122900,0,152900
132435503700000,NW 326,RESIDENTIAL,31000,0,31000,164300,0,195300
132435503800000,NW 326,RESIDENTIAL,29800,0,29800,149800,0,179600
132435503900000,NW 326,RESIDENTIAL,30100,0,30100,150400,0,180500
132435504000000,NW 326,RESIDENTIAL,29900,0,29900,109800,0,139700
132435504100000,NW 326,RESIDENTIAL,30300,0,30300,110500,0,140800
132435504200000,NW 326,RESIDENTIAL,29900,0,29900,115800,0,145700
132435504300000,NW 326,RESIDENTIAL,30700,0,30700,109500,0,140200
132435504400000,NW 326,RESIDENTIAL,30200,0,30200,116900,0,147100
132435504500000,NW 326,RESIDENTIAL,26700,0,26700,116000,0,142700
132435504600000,NW 326,RESIDENTIAL,28500,0,28500,112500,0,141000
132435504700000,NW 326,RESIDENTIAL,31300,0,31300,108100,0,139400
132435504800000,NW 326,RESIDENTIAL,31300,0,31300,114200,0,145500
132435504900000,NW 326,RESIDENTIAL,30500,0,30500,122900,0,153400
132435505000000,NW 326,RESIDENTIAL,33900,0,33900,137000,0,170900
132435505100000,NW 326,RESIDENTIAL,30500,0,30500,103000,0,133500
132435505200000,NW 326,RESIDENTIAL,26700,0,26700,100000,0,126700
132435505300000,NW 326,RESIDENTIAL,30800,0,30800,109400,0,140200
132435505400000,NW 326,RESIDENTIAL,26200,0,26200,114200,0,140400
132435505500000,NW 326,RESIDENTIAL,31400,0,31400,103700,0,135100
132435505600000,NW 326,RESIDENTIAL,27900,0,27900,92600,0,120500
132435505700000,NW 326,RESIDENTIAL,25900,0,25900,97900,0,123800
132435505800000,NW 326,RESIDENTIAL,25900,0,25900,111800,0,137700
132435505900000,NW 326,RESIDENTIAL,25900,0,25900,98800,0,124700
132435506000000,NW 326,RESIDENTIAL,25900,0,25900,104400,0,130300
132435506100000,NW 326,RESIDENTIAL,28000,0,28000,102300,0,130300
132435506200000,NW 326,RESIDENTIAL,29200,0,29200,96200,0,125400
132435506300000,NW 326,RESIDENTIAL,29200,0,29200,100000,0,129200
132435506400000,NW 326,RESIDENTIAL,28000,0,28000,114500,0,142500
132435506500000,NW 326,RESIDENTIAL,29200,0,29200,123000,0,152200
132435506600000,NW 326,RESIDENTIAL,29200,0,29200,86600,0,115800
132435506700000,NW 326,RESIDENTIAL,29900,0,29900,118600,0,148500
132435506800000,NW 326,RESIDENTIAL,29700,0,29700,109500,0,139200
132435506900000,NW 326,RESIDENTIAL,32200,0,32200,115900,0,148100
132435600100000,NW 326,RESIDENTIAL,30600,0,30600,103400,0,134000
132435600200000,NW 326,RESIDENTIAL,30600,0,30600,98300,0,128900
132435600300000,NW 326,RESIDENTIAL,27000,0,27000,106000,0,133000
132435600400000,NW 326,RESIDENTIAL,29200,0,29200,91600,0,120800
132435600500000,NW 326,RESIDENTIAL,29200,0,29200,107800,0,137000
132435600600000,NW 326,RESIDENTIAL,29200,0,29200,110600,0,139800
132435600700000,NW 326,RESIDENTIAL,29200,0,29200,103100,0,132300
132435600800000,NW 326,RESIDENTIAL,30800,0,30800,98500,0,129300
132435600900000,NW 326,RESIDENTIAL,29900,0,29900,116900,0,146800
132435601000000,NW 326,RESIDENTIAL,31000,0,31000,111200,0,142200
132435601100000,NW 326,RESIDENTIAL,32500,0,32500,120700,0,153200
132435601200000,NW 326,RESIDENTIAL,32500,0,32500,111800,0,144300
132435601300000,NW 326,RESIDENTIAL,29200,0,29200,109200,0,138400
132435601400000,NW 326,RESIDENTIAL,29200,0,29200,98700,0,127900
132435601500000,NW 326,RESIDENTIAL,27000,0,27000,104100,0,131100
132435700100000,NW 326,RESIDENTIAL,25100,0,25100,119100,0,144200
132435700200000,NW 326,RESIDENTIAL,29800,0,29800,101700,0,131500
132435700300000,NW 326,RESIDENTIAL,27300,0,27300,123300,0,150600
132435700400000,NW 326,RESIDENTIAL,25000,0,25000,106400,0,131400
132435700500000,NW 326,RESIDENTIAL,26800,0,26800,113500,0,140300
132435700600000,NW 326,RESIDENTIAL,25000,0,25000,101900,0,126900
132435700700000,NW 326,RESIDENTIAL,27700,0,27700,120900,0,148600
132435700800000,NW 326,RESIDENTIAL,27300,0,27300,127400,0,154700
132435700900000,NW 326,RESIDENTIAL,31000,0,31000,102800,0,133800
132437600100000,NW 337,RESIDENTIAL,37600,0,37600,91100,0,128700
132437600200000,NW 337,RESIDENTIAL,20300,0,20300,98300,0,118600
132437600300000,NW 337,RESIDENTIAL,40400,0,40400,45600,0,86000
132437600400000,NW 337,RESIDENTIAL,30200,0,30200,155200,0,185400
132437600500000,VACANT LAND,COMMERCIAL,0,75900,75900,0,0,75900
132437600600000,NW 337,RESIDENTIAL,27500,0,27500,0,0,27500
132437600700000,NW 337,RESIDENTIAL,64400,0,64400,165200,0,229600
132437600800000,NW 337,RESIDENTIAL,50800,0,50800,165500,0,216300
132437600900000,NW 337,RESIDENTIAL,60800,0,60800,70800,0,131600
132437700100000,NW 345,RESIDENTIAL,59700,0,59700,154500,0,214200
132437800100000,VACANT LAND,COMMERCIAL,0,49800,49800,0,500,50300
132437800200000,NW 326,RESIDENTIAL,33000,0,33000,60400,0,93400
132437800300000,NW 326,RESIDENTIAL,32400,0,32400,110100,0,142500
132437800400000,NW 326,RESIDENTIAL,31000,0,31000,112500,0,143500
132437800500000,NW 326,RESIDENTIAL,30500,0,30500,111300,0,141800
132437800600000,NW 326,RESIDENTIAL,30900,0,30900,137800,0,168700
132437800700000,NW 326,RESIDENTIAL,31500,0,31500,133500,0,165000
132437800800000,NW 326,RESIDENTIAL,31800,0,31800,119700,0,151500
132437800900000,NW 326,RESIDENTIAL,32000,0,32000,130700,0,162700
132437801000000,NW 326,RESIDENTIAL,31700,0,31700,111800,0,143500
132437801100000,NW 326,RESIDENTIAL,31700,0,31700,127500,0,159200
132437801200000,NW 326,RESIDENTIAL,31200,0,31200,128100,0,159300
132437801300000,NW 326,RESIDENTIAL,31000,0,31000,116400,0,147400
132437801400000,NW 326,RESIDENTIAL,32500,0,32500,137900,0,170400
132437801500000,NW 326,RESIDENTIAL,32800,0,32800,130500,0,163300
132437801600000,NW 326,RESIDENTIAL,32500,0,32500,118200,0,150700
132437801700000,NW 326,RESIDENTIAL,32200,0,32200,132100,0,164300
132437801800000,NW 326,RESIDENTIAL,31900,0,31900,108200,0,140100
132437801900000,NW 326,RESIDENTIAL,31600,0,31600,119600,0,151200
132437802000000,NW 326,RESIDENTIAL,31900,0,31900,107600,0,139500
132437802100000,NW 326,RESIDENTIAL,33800,0,33800,122200,0,156000
132437900100000,NW 326,RESIDENTIAL,30900,0,30900,117600,0,148500
132437900200000,NW 326,RESIDENTIAL,30600,0,30600,129900,0,160500
132437900300000,NW 326,RESIDENTIAL,31000,0,31000,126800,0,157800
132437900400000,NW 326,RESIDENTIAL,30900,0,30900,138100,0,169000
132437900500000,NW 326,RESIDENTIAL,31400,0,31400,118400,0,149800
132437900600000,NW 326,RESIDENTIAL,32300,0,32300,119500,0,151800
132437900700000,NW 326,RESIDENTIAL,30300,0,30300,126300,0,156600
132437900800000,NW 326,RESIDENTIAL,31000,0,31000,138200,0,169200
132437900900000,NW 326,RESIDENTIAL,30700,0,30700,122600,0,153300
132437901000000,NW 326,RESIDENTIAL,30800,0,30800,125000,0,155800
132437901100000,NW 326,RESIDENTIAL,29300,0,29300,141700,0,171000
132438000100000,NW 326,RESIDENTIAL,31600,0,31600,134600,0,166200
132438000200000,NW 326,RESIDENTIAL,30100,0,30100,125000,0,155100
132438000300000,NW 326,RESIDENTIAL,31900,0,31900,121600,0,153500
132438000400000,NW 326,RESIDENTIAL,27200,0,27200,106300,0,133500
132438000500000,NW 326,RESIDENTIAL,31000,0,31000,124200,0,155200
132438000600000,NW 326,RESIDENTIAL,28800,0,28800,126300,0,155100
132438000700000,NW 326,RESIDENTIAL,29100,0,29100,127600,0,156700
132438000800000,NW 326,RESIDENTIAL,29800,0,29800,168200,0,198000
132438000900000,NW 326,RESIDENTIAL,33000,0,33000,118300,0,151300
132438001000000,NW 326,RESIDENTIAL,31100,0,31100,126500,0,157600
132438001100000,NW 326,RESIDENTIAL,32300,0,32300,111000,0,143300
132438001200000,NW 326,RESIDENTIAL,33900,0,33900,138700,0,172600
132438001300000,NW 326,RESIDENTIAL,30400,0,30400,118200,0,148600
132438001400000,NW 326,RESIDENTIAL,30000,0,30000,129600,0,159600
132438001500000,NW 326,RESIDENTIAL,32600,0,32600,125300,0,157900
132438001600000,NW 326,RESIDENTIAL,30400,0,30400,114900,0,145300
132438001700000,NW 326,RESIDENTIAL,31100,0,31100,116700,0,147800
132438001800000,NW 326,RESIDENTIAL,31400,0,31400,110900,0,142300
132438001900000,NW 326,RESIDENTIAL,30500,0,30500,100300,0,130800
132438002000000,NW 326,RESIDENTIAL,31700,0,31700,109000,0,140700
132438002100000,NW 326,RESIDENTIAL,32300,0,32300,128600,0,160900
132438002200000,NW 326,RESIDENTIAL,30300,0,30300,133300,0,163600
132438002300000,NW 326,RESIDENTIAL,32100,0,32100,71500,0,103600
132438002400000,NW 326,RESIDENTIAL,35900,0,35900,68100,0,104000
132438002500000,NW 326,RESIDENTIAL,44300,0,44300,110500,0,154800
132438002600000,NW 326,RESIDENTIAL,64500,0,64500,109200,0,173700
132438002700000,CITY PROPERTY,EXEMPT,0,0,0,0,0,0
132438002702000,ANTENNAS/TOWERS(BLL),COMMERCIAL,0,0,0,0,9200,9200
132438002800000,NW 326,RESIDENTIAL,64200,0,64200,116300,0,180500
132438002900000,NW 326,RESIDENTIAL,33700,0,33700,98300,0,132000
132438003000000,NW 326,RESIDENTIAL,25700,0,25700,136900,0,162600
132440100100000,NW 309,RESIDENTIAL,37500,0,37500,178500,0,216000
132440200100000,CITY PROPERTY,EXEMPT,0,0,0,0,0,0
132440200300000,CITY PROPERTY,EXEMPT,0,0,0,0,0,0
132440200400000,NW 337,RESIDENTIAL,1300,0,1300,0,0,1300
132440200500000,NW 337,RESIDENTIAL,5100,0,5100,0,0,5100
132440200600000,NW 309,RESIDENTIAL,35100,0,35100,153900,0,189000
132440200700000,NW 309,RESIDENTIAL,41600,0,41600,163600,0,205200
132440200800000,NW 309,RESIDENTIAL,40700,0,40700,153000,0,193700
132440200900000,NW 309,RESIDENTIAL,32000,0,32000,166100,0,198100
132440201000000,NW 309,RESIDENTIAL,42800,0,42800,163600,0,206400
132440201100000,NW 309,RESIDENTIAL,34500,0,34500,144700,0,179200
132440201200000,NW 309,RESIDENTIAL,35600,0,35600,151800,0,187400
132440201300000,NW 309,RESIDENTIAL,56100,0,56100,134600,0,190700
132440201400000,NW 309,RESIDENTIAL,38400,0,38400,128800,0,167200
132440201500000,NW 337,RESIDENTIAL,29300,0,29300,92100,0,121400
132440201600000,NW 337,RESIDENTIAL,29300,0,29300,139200,0,168500
132440201700000,NW 337,RESIDENTIAL,29800,0,29800,66800,0,96600
132440201800000,NW 337,RESIDENTIAL,28400,0,28400,140500,0,168900
132440201900000,NW 337,RESIDENTIAL,30300,0,30300,102900,0,133200
132440202000000,NW 337,RESIDENTIAL,23300,0,23300,184800,0,208100
132440202100000,NW 337,RESIDENTIAL,21500,0,21500,42500,0,64000
132440202200000,NW 337,RESIDENTIAL,2000,0,2000,4800,0,6800
132440202300000,NW 337,RESIDENTIAL,18500,0,18500,61100,0,79600
132440202400000,CITY PROPERTY,EXEMPT,0,0,0,0,0,0
132440300100000,NW 337,RESIDENTIAL,52100,0,52100,71700,0,123800
132440300200000,NW 337,RESIDENTIAL,29500,0,29500,90900,0,120400
132440300300000,NW 305,RESIDENTIAL,27200,0,27200,142400,0,169600
132440300400000,NW 305,RESIDENTIAL,27100,0,27100,95100,0,122200
132440300500000,NW 305,RESIDENTIAL,26900,0,26900,122400,0,149300
132440300600000,NW 305,RESIDENTIAL,26600,0,26600,134100,0,160700
132440300700000,NW 305,RESIDENTIAL,26600,0,26600,137100,0,163700
132440300800000,NW 305,RESIDENTIAL,26500,0,26500,136200,0,162700
132440300900000,NW 337,RESIDENTIAL,29700,0,29700,0,0,29700
132440301000000,NW 305,RESIDENTIAL,27500,0,27500,156800,0,184300
132440301100000,NW 337,RESIDENTIAL,30400,0,30400,248900,0,279300
132440301200000,NW 337,RESIDENTIAL,30400,0,30400,0,0,30400
132440301300000,NW 337,RESIDENTIAL,71800,0,71800,193500,0,265300
132440301400000,NW 337,RESIDENTIAL,40300,0,40300,84300,0,124600
132440301500000,NW 337,RESIDENTIAL,34100,0,34100,101700,0,135800
132440301600000,NW 337,RESIDENTIAL,60500,0,60500,0,0,60500
132440301700000,NW 305,RESIDENTIAL,28600,0,28600,156900,0,185500
132440301800000,NW 305,RESIDENTIAL,26700,0,26700,137100,0,163800
132440301900000,NW 305,RESIDENTIAL,27800,0,27800,157200,0,185000
132440302000000,NW 305,RESIDENTIAL,28500,0,28500,185200,0,213700
132440302100000,NW 305,RESIDENTIAL,26600,0,26600,139200,0,165800
132440302200000,NW 305,RESIDENTIAL,26600,0,26600,141300,0,167900
132440302300000,NW 305,RESIDENTIAL,26600,0,26600,130500,0,157100
132440302400000,NW 305,RESIDENTIAL,26600,0,26600,152400,0,179000
132440302500000,NW 305,RESIDENTIAL,25900,0,25900,143100,0,169000
132440302600000,NW 305,RESIDENTIAL,26300,0,26300,161100,0,187400
132442600100000,NW 315,RESIDENTIAL,34400,0,34400,130700,0,165100
132442600200000,NW 315,RESIDENTIAL,29700,0,29700,122500,0,152200
132442600300000,NW 315,RESIDENTIAL,29700,0,29700,108100,0,137800
132442600400000,NW 315,RESIDENTIAL,29700,0,29700,122800,0,152500
132442600500000,NW 315,RESIDENTIAL,29700,0,29700,123700,0,153400
132442600600000,NW 315,RESIDENTIAL,29700,0,29700,109500,0,139200
132442600700000,NW 315,RESIDENTIAL,29700,0,29700,117900,0,147600
132442600800000,NW 315,RESIDENTIAL,20400,0,20400,118700,0,139100
132442600900000,NW 315,RESIDENTIAL,20400,0,20400,5100,0,25500
132442700100000,NW 315,RESIDENTIAL,29700,0,29700,117400,0,147100
132442700200000,NW 315,RESIDENTIAL,40800,0,40800,167900,0,208700
132442700300000,NW 315,RESIDENTIAL,17800,0,17800,52800,0,70600
132442700400000,NW 315,RESIDENTIAL,16500,0,16500,76900,0,93400
132442700500000,NW 315,RESIDENTIAL,12600,0,12600,129800,0,142400
132442700600000,NW 315,RESIDENTIAL,50000,0,50000,96900,0,146900
132442700700000,NW 315,RESIDENTIAL,47100,0,47100,119000,0,166100
132442700800000,NW 315,RESIDENTIAL,29700,0,29700,115000,0,144700
132442700900000,NW 315,RESIDENTIAL,29700,0,29700,125800,0,155500
132442701000000,NW 315,RESIDENTIAL,29700,0,29700,112700,0,142400
132442701100000,NW 315,RESIDENTIAL,29700,0,29700,120000,0,149700
132442701200000,NW 315,RESIDENTIAL,29700,0,29700,122100,0,151800
132442701300000,NW 315,RESIDENTIAL,29700,0,29700,128700,0,158400
132442800100000,NW 315,RESIDENTIAL,17500,0,17500,117300,0,134800
132442800200000,NW 315,RESIDENTIAL,31500,0,31500,136200,0,167700
132442800300000,NW 315,RESIDENTIAL,39300,0,39300,148900,0,188200
132442800400000,NW 315,RESIDENTIAL,39300,0,39300,154300,0,193600
132442800500000,NW 315,RESIDENTIAL,40100,0,40100,141600,0,181700
132442800700000,NW 315,RESIDENTIAL,41900,0,41900,169600,0,211500
132442800800000,NW 315,RESIDENTIAL,41400,0,41400,180600,0,222000
132442800900000,NW 315,RESIDENTIAL,41300,0,41300,178400,0,219700
132442801000000,NW 315,RESIDENTIAL,38500,0,38500,130200,0,168700
132442801100000,NW 315,RESIDENTIAL,38500,0,38500,147200,0,185700
132442801400000,NW 309,RESIDENTIAL,34700,0,34700,197200,0,231900
132442801500000,NW 337,RESIDENTIAL,35500,0,35500,93300,0,128800
132442801600000,NW 309,RESIDENTIAL,37800,0,37800,176600,0,214400
132442801700000,NW 309,RESIDENTIAL,38600,0,38600,133300,0,171900
132442801800000,NW 309,RESIDENTIAL,38600,0,38600,149700,0,188300
132442801900000,NW 315,RESIDENTIAL,32600,0,32600,94900,0,127500
132442802000000,NW 315,RESIDENTIAL,37100,0,37100,140700,0,177800
132442802100000,NW 315,RESIDENTIAL,28500,0,28500,120400,0,148900
132442802200000,NW 315,RESIDENTIAL,28500,0,28500,0,0,28500
132442802300000,NW 315,RESIDENTIAL,30600,0,30600,302600,0,333200
132442802400000,NW 315,RESIDENTIAL,28500,0,28500,114000,0,142500
132442802500000,NW 315,RESIDENTIAL,28500,0,28500,113300,0,141800
132442802600000,NW 315,RESIDENTIAL,29500,0,29500,50500,0,80000
132442802700000,NW 315,RESIDENTIAL,29500,0,29500,33900,0,63400
132442802800000,NW 315,RESIDENTIAL,14700,0,14700,37000,0,51700
132442802900000,NW 315,RESIDENTIAL,17500,0,17500,135900,0,153400
132442803000000,NW 315,RESIDENTIAL,17500,0,17500,83400,0,100900
132442803100000,NW 315,RESIDENTIAL,17500,0,17500,129100,0,146600
132442803200000,NW 315,RESIDENTIAL,0,0,0,0,0,0
132442803300000,NW 337,RESIDENTIAL,41500,0,41500,169600,0,211100
132442803400000,NW 337,RESIDENTIAL,41300,0,41300,200300,0,241600
132442803500000,NW 337,RESIDENTIAL,37200,0,37200,241300,0,278500
132442803600000,NW 309,RESIDENTIAL,58100,0,58100,199700,0,257800
132442900100000,NW 337,RESIDENTIAL,67100,0,67100,129400,0,196500
132442900200000,NW 337,RESIDENTIAL,67100,0,67100,47800,0,114900
132442900400000,NW 337,RESIDENTIAL,23700,0,23700,67800,0,91500
132442900500000,NW 337,AG LAND,1300,0,1300,0,0,1300
132442900600000,NW 337,RESIDENTIAL,61300,0,61300,65700,0,127000
132442900700000,NW 337,RESIDENTIAL,60000,0,60000,125100,0,185100
132442900800000,NW 337,RESIDENTIAL,22400,0,22400,0,0,22400
132445100100000,NW 337,RESIDENTIAL,33300,0,33300,0,0,33300
132445100200000,NW 337,RESIDENTIAL,15000,0,15000,17400,0,32400
132445100300000,NW 337,RESIDENTIAL,26900,0,26900,25200,0,52100
132445100400000,NW 337,RESIDENTIAL,21800,0,21800,35400,0,57200
132445100500000,NW 337,RESIDENTIAL,54100,0,54100,153600,0,207700
132445100600000,NW 337,RESIDENTIAL,56800,0,56800,51500,0,108300
132445100700000,NW 337,RESIDENTIAL,68800,0,68800,67700,0,136500
132445100800000,NW 337,RESIDENTIAL,19800,0,19800,31500,0,51300
132445100900000,NW 337,RESIDENTIAL,19800,0,19800,100600,0,120400
132445101000000,NW 337,RESIDENTIAL,19800,0,19800,90800,0,110600
132445101100000,NW 337,RESIDENTIAL,26400,0,26400,94900,0,121300
132445101200000,SHOP,COMMERCIAL,0,181300,181300,0,456800,638100
132445101300000,NW 337,RESIDENTIAL,30600,0,30600,29200,0,59800
132445200100000,NW 337,RESIDENTIAL,28100,0,28100,115200,0,143300
132445200200000,NW 337,RESIDENTIAL,26400,0,26400,46700,0,73100
132445200300000,NW 337,RESIDENTIAL,29800,0,29800,89700,0,119500
132445200400000,NW 337,RESIDENTIAL,23100,0,23100,118900,0,142000
132445200500000,NW 337,RESIDENTIAL,27300,0,27300,91600,0,118900
132445200600000,NW 337,RESIDENTIAL,27300,0,27300,87300,0,114600
132445200700000,NW 337,RESIDENTIAL,31200,0,31200,87600,0,118800
132445200800000,VACANT LAND,COMMERCIAL,0,48800,48800,0,0,48800
132445200900000,SHOP,COMMERCIAL,70200,199800,270000,177400,194600,642000
132445201000000,NW 337,RESIDENTIAL,30800,0,30800,73700,0,104500
132445201100000,NW 337,RESIDENTIAL,31800,0,31800,29000,0,60800
132445201200000,NW 337,RESIDENTIAL,29700,0,29700,4700,0,34400
132445201300000,NW 337,RESIDENTIAL,31600,0,31600,27700,0,59300
132445201400000,SMALL RETAIL,COMMERCIAL,0,39600,39600,0,69600,109200
132445201500000,NW 337,RESIDENTIAL,20400,0,20400,111700,0,132100
132445201600000,NW 337,RESIDENTIAL,20100,0,20100,74900,0,95000
132445201700000,NW 337,RESIDENTIAL,27100,0,27100,87200,0,114300
132445201800000,NW 337,RESIDENTIAL,21800,0,21800,0,0,21800
132445201900000,NW 337,RESIDENTIAL,27300,0,27300,185400,0,212700
132445202000000,NW 337,RESIDENTIAL,51600,0,51600,71700,0,123300
132445202100000,NW 337,RESIDENTIAL,51600,0,51600,65200,0,116800
132445202200000,NW 337,RESIDENTIAL,31200,0,31200,126600,0,157800
132445202300000,NW 337,RESIDENTIAL,19800,0,19800,92700,0,112500
132445202400000,NW 337,RESIDENTIAL,28100,0,28100,104200,0,132300
132445202500000,NW 337,RESIDENTIAL,26400,0,26400,49600,0,76000
132445202600000,NW 337,RESIDENTIAL,51600,0,51600,82300,0,133900
132447600100000,NW 337,RESIDENTIAL,37100,0,37100,8300,0,45400
132447600200000,NW 337,RESIDENTIAL,18300,0,18300,78900,0,97200
132447600300000,NW 324,RESIDENTIAL,23400,0,23400,90700,0,114100
132447600400000,NW 324,RESIDENTIAL,23200,0,23200,104700,0,127900
132447600500000,NW 324,RESIDENTIAL,23200,0,23200,101700,0,124900
132447600600000,NW 324,RESIDENTIAL,23200,0,23200,89900,0,113100
132447600700000,NW 324,RESIDENTIAL,23200,0,23200,82500,0,105700
132447600800000,NW 324,RESIDENTIAL,23200,0,23200,99600,0,122800
132447600900000,NW 324,RESIDENTIAL,23200,0,23200,98800,0,122000
132447601000000,NW 324,RESIDENTIAL,23200,0,23200,109800,0,133000
132447601100000,NW 324,RESIDENTIAL,23200,0,23200,92700,0,115900
132447601200000,NW 324,RESIDENTIAL,24000,0,24000,114400,0,138400
132447601300000,NW 337,RESIDENTIAL,75700,0,75700,0,0,75700
132447601400000,CHURCH,EXEMPT,0,354100,354100,0,465400,819500
132447700100000,NW 324,RESIDENTIAL,23900,0,23900,83700,0,107600
132447700200000,NW 324,RESIDENTIAL,23200,0,23200,88200,0,111400
132447700300000,NW 324,RESIDENTIAL,23200,0,23200,103900,0,127100
132447700400000,NW 324,RESIDENTIAL,23200,0,23200,110600,0,133800
132447700500000,NW 324,RESIDENTIAL,23200,0,23200,89700,0,112900
132447700600000,NW 324,RESIDENTIAL,23200,0,23200,104500,0,127700
132447700700000,NW 324,RESIDENTIAL,23200,0,23200,90700,0,113900
132447700800000,NW 324,RESIDENTIAL,23200,0,23200,83400,0,106600
132447700900000,NW 324,RESIDENTIAL,23200,0,23200,98300,0,121500
132447701000000,NW 324,RESIDENTIAL,23600,0,23600,155800,0,179400
132447701100000,NW 337,RESIDENTIAL,31200,0,31200,52400,0,83600
132447701200000,NW 337,RESIDENTIAL,29300,0,29300,21100,0,50400
132447701300000,NW 337,RESIDENTIAL,33100,0,33100,90800,0,123900
132447701400000,OFFICE,COMMERCIAL,0,62400,62400,0,235000,297400
132447701500000,BRANCH BANK/CU,COMMERCIAL,0,416000,416000,0,539000,955000
132447800200000,NW 301,RESIDENTIAL,33300,0,33300,111000,0,144300
132447800300000,NW 337,RESIDENTIAL,26200,0,26200,106800,0,133000
132447800400000,NW 337,RESIDENTIAL,30200,0,30200,102600,0,132800
132447800500000,NW 337,RESIDENTIAL,27300,0,27300,90800,0,118100
132447800600000,NW 337,RESIDENTIAL,27300,0,27300,92500,0,119800
132447800700000,NW 337,RESIDENTIAL,23600,0,23600,105800,0,129400
132447800800000,NW 337,RESIDENTIAL,23600,0,23600,42100,0,65700
132447800900000,NW 337,RESIDENTIAL,22200,0,22200,83300,0,105500
132447801000000,NW 337,RESIDENTIAL,22300,0,22300,79400,0,101700
132447801100000,NW 337,RESIDENTIAL,27400,0,27400,176000,0,203400
132447801200000,NW 337,RESIDENTIAL,27400,0,27400,161100,0,188500
132447801300000,NW 337,RESIDENTIAL,33800,0,33800,117200,0,151000
132447801400000,NW 337,RESIDENTIAL,35200,0,35200,104400,0,139600
132447801500000,NW 324,RESIDENTIAL,28400,0,28400,98100,0,126500
132447801600000,NW 324,RESIDENTIAL,26900,0,26900,114300,0,141200
132447801700000,NW 324,RESIDENTIAL,26900,0,26900,102300,0,129200
132447801800000,NW 324,RESIDENTIAL,27500,0,27500,123400,0,150900
132447801900000,NW 324,RESIDENTIAL,26000,0,26000,115500,0,141500
132447802000000,NW 324,RESIDENTIAL,26900,0,26900,89600,0,116500
132447802300000,CHURCH,EXEMPT,0,652000,652000,0,508400,1160400
132447900100000,NW 324,RESIDENTIAL,27600,0,27600,108400,0,136000
132447900200000,NW 324,RESIDENTIAL,27900,0,27900,106700,0,134600
132447900300000,NW 324,RESIDENTIAL,27900,0,27900,101300,0,129200
132447900400000,NW 324,RESIDENTIAL,27900,0,27900,105000,0,132900
132447900500000,NW 324,RESIDENTIAL,26000,0,26000,80100,0,106100
132447900600000,NW 324,RESIDENTIAL,26800,0,26800,121400,0,148200
132447900700000,NW 324,RESIDENTIAL,27900,0,27900,109100,0,137000
132447900800000,NW 324,RESIDENTIAL,27900,0,27900,91100,0,119000
132447900900000,NW 324,RESIDENTIAL,27900,0,27900,105100,0,133000
132447901000000,NW 324,RESIDENTIAL,27900,0,27900,111500,0,139400
132447901100000,NW 324,RESIDENTIAL,27900,0,27900,120500,0,148400
132447901200000,NW 324,RESIDENTIAL,25300,0,25300,96500,0,121800
132448000100000,NW 324,RESIDENTIAL,36200,0,36200,124000,0,160200
132448000200000,NW 337,RESIDENTIAL,27300,0,27300,72500,0,99800
132448000300000,NW 337,RESIDENTIAL,43900,0,43900,67700,0,111600
132448000400000,NW 337,RESIDENTIAL,24100,0,24100,109300,0,133400
132448000500000,NW 337,RESIDENTIAL,28300,0,28300,31400,0,59700
132448000600000,NW 337,RESIDENTIAL,26400,0,26400,202700,0,229100
132448000700000,NW 337,RESIDENTIAL,22000,0,22000,88700,0,110700
132448000800000,NW 337,RESIDENTIAL,19300,0,19300,95200,0,114500
132448000900000,NW 337,RESIDENTIAL,17900,0,17900,87400,0,105300
132448001000000,NW 337,RESIDENTIAL,19600,0,19600,58400,0,78000
132448001100000,NW 324,RESIDENTIAL,25800,0,25800,74600,0,100400
132448001200000,NW 324,RESIDENTIAL,25800,0,25800,87800,0,113600
132510100700000,NW 324,RESIDENTIAL,56700,0,56700,0,0,56700
132510100800000,NW 324,RESIDENTIAL,56700,0,56700,0,0,56700
132510100900000,NW 324,RESIDENTIAL,68000,0,68000,97700,0,165700
132510101000000,NW 324,RESIDENTIAL,68500,0,68500,513400,0,581900
132510101100000,NW 324,RESIDENTIAL,55400,0,55400,100100,0,155500
132510101200000,NW 324,RESIDENTIAL,20300,0,20300,74400,0,94700
132510101300000,NW 324,RESIDENTIAL,50900,0,50900,91100,0,142000
132510101400000,NW 324,RESIDENTIAL,50900,0,50900,120000,0,170900
132510101500000,NW 324,RESIDENTIAL,50900,0,50900,155200,0,206100
132510101600000,NW 324,RESIDENTIAL,50900,0,50900,141700,0,192600
132510102000000,SMALL RETAIL,COMMERCIAL,0,382000,382000,0,258700,640700
132510102100000,RESTAURANT,COMMERCIAL,0,428000,428000,0,215500,643500
132510102200000,AUTO REPAIR/SALES,COMMERCIAL,0,360000,360000,0,214500,574500
132510102300000,FAST FOOD,COMMERCIAL,0,400000,400000,0,878300,1278300
132510102400000,VETERINARY CLINIC,COMMERCIAL,73752,101848,175600,38550,72250,286400
132510102500000,NBHD SHOPPING CENTER,COMMERCIAL,0,465000,465000,0,509300,974300
132510102502000,BILLBOARD(BLL),COMMERCIAL,0,0,0,0,59800,59800
132510102600000,VETERINARY CLINIC,COMMERCIAL,0,97500,97500,0,403000,500500
132510102700000,NW 324,RESIDENTIAL,54700,0,54700,0,0,54700
132510102800000,LG DISCOUNT/RETAIL,COMMERCIAL,0,935000,935000,0,1222300,2157300
132510103000000,VACANT LAND,COMMERCIAL,0,238500,238500,0,0,238500
132510103100000,VACANT LAND,COMMERCIAL,0,288000,288000,0,29600,317600
132512600100000,NW 324,RESIDENTIAL,56700,0,56700,121900,0,178600
132512600200000,NW 324,RESIDENTIAL,60500,0,60500,175600,0,236100
132512600300000,NW 324,RESIDENTIAL,6000,0,6000,0,0,6000
132512600400000,NW 324,RESIDENTIAL,82500,0,82500,0,0,82500
132512600600000,CENTRALLY ASSESSED,OTHER,0,0,0,0,0,0
132512600700000,CENTRALLY ASSESSED,OTHER,0,0,0,0,0,0
132512600800000,NW 324,RESIDENTIAL,58200,0,58200,130500,0,188700
132512600900000,NW 327,RESIDENTIAL,30500,0,30500,104800,0,135300
132512601000000,NW 327,RESIDENTIAL,30500,0,30500,102700,0,133200
132512601100000,NW 327,RESIDENTIAL,30500,0,30500,96700,0,127200
132512601200000,NW 327,RESIDENTIAL,30500,0,30500,97000,0,127500
132512601300000,NW 327,RESIDENTIAL,22900,0,22900,99900,0,122800
132512601400000,NW 327,RESIDENTIAL,22900,0,22900,87300,0,110200
132512601500000,NW 324,RESIDENTIAL,35000,0,35000,100800,0,135800
132512601600000,NW 324,RESIDENTIAL,41300,0,41300,112600,0,153900
132512601700000,NW 324,RESIDENTIAL,56700,0,56700,188500,0,245200
132512601800000,NW 324,RESIDENTIAL,56700,0,56700,121800,0,178500
132512601900000,NW 324,RESIDENTIAL,56700,0,56700,51300,0,108000
132512602000000,NW 324,RESIDENTIAL,56700,0,56700,172400,0,229100
132512602100000,NW 324,RESIDENTIAL,56700,0,56700,274400,0,331100
132512602200000,NW 324,RESIDENTIAL,46100,0,46100,89600,0,135700
132512602300000,NW 324,RESIDENTIAL,48800,0,48800,0,0,48800
132512602400000,NW 324,RESIDENTIAL,44500,0,44500,343600,0,388100
132512602500000,NW 324,RESIDENTIAL,42600,0,42600,309600,0,352200
132512602600000,NW 324,RESIDENTIAL,42600,0,42600,265100,0,307700
132515100100000,CITY PROPERTY,EXEMPT,0,0,0,0,0,0
132515100200000,CITY PROPERTY,EXEMPT,0,0,0,0,0,0
132515100300000,CITY PROPERTY,EXEMPT,0,0,0,0,0,0
132515200100000,CITY PROPERTY,EXEMPT,0,0,0,0,0,0
132515300500000,NW 333,RESIDENTIAL,29400,0,29400,69100,0,98500
132515300600000,NW 333,RESIDENTIAL,29400,0,29400,79000,0,108400
132515300700000,NW 333,RESIDENTIAL,33600,0,33600,58100,0,91700
132515300800000,CITY PROPERTY,EXEMPT,0,0,0,0,0,0
132515300900000,NW 333,RESIDENTIAL,39900,0,39900,124400,0,164300
132515301000000,NW 333,RESIDENTIAL,35500,0,35500,82400,0,117900
132515301100000,NW 333,RESIDENTIAL,34800,0,34800,99800,0,134600
132515301200000,NW 333,RESIDENTIAL,27200,0,27200,61800,0,89000
132515301300000,NW 333,RESIDENTIAL,26500,0,26500,54700,0,81200
132515400200000,NW 333,RESIDENTIAL,25800,0,25800,89200,0,115000
132515400300000,NW 333,RESIDENTIAL,32900,0,32900,69900,0,102800
132515500100000,NW 333,RESIDENTIAL,34700,0,34700,75800,0,110500
132515500200000,NW 333,RESIDENTIAL,29200,0,29200,66500,0,95700
132515500300000,NW 333,RESIDENTIAL,30000,0,30000,88600,0,118600
132515500400000,NW 333,RESIDENTIAL,27000,0,27000,75300,0,102300
132515500500000,NW 333,RESIDENTIAL,24500,0,24500,0,0,24500
132515500600000,NW 333,RESIDENTIAL,22500,0,22500,0,0,22500
132515500700000,NW 333,RESIDENTIAL,29300,0,29300,101600,0,130900
132515500800000,NW 333,RESIDENTIAL,23500,0,23500,93500,0,117000
132515500900000,NW 333,RESIDENTIAL,23500,0,23500,115900,0,139400
132515501000000,NW 333,RESIDENTIAL,23500,0,23500,95100,0,118600
132515501100000,APARTMENT,MULTI-RES,22400,0,22400,116500,0,138900
132515501200000,NW 333,RESIDENTIAL,26900,0,26900,68900,0,95800
132515501300000,NW 333,RESIDENTIAL,26800,0,26800,68200,0,95000
132515501400000,CONVERSION-NW/SW,MULTI-RES,30800,0,30800,60400,0,91200
132515501500000,NW 333,RESIDENTIAL,34700,0,34700,91800,0,126500
132515501600000,APARTMENT,MULTI-RES,21000,0,21000,106800,0,127800
132515501700000,NW 333,RESIDENTIAL,29200,0,29200,61200,0,90400
132515501800000,NW 333,RESIDENTIAL,30500,0,30500,83100,0,113600
132515501900000,NW 333,RESIDENTIAL,30600,0,30600,101000,0,131600
132515502000000,NW 333,RESIDENTIAL,31800,0,31800,116600,0,148400
132515502100000,NW 333,RESIDENTIAL,33500,0,33500,76800,0,110300
132515502200000,NW 333,RESIDENTIAL,26600,0,26600,111800,0,138400
132515600100000,NW 333,RESIDENTIAL,32000,0,32000,132900,0,164900
132515600200000,NW 333,RESIDENTIAL,44600,0,44600,127800,0,172400
132515600300000,NW 333,RESIDENTIAL,40500,0,40500,119900,0,160400
132515600400000,NW 333,RESIDENTIAL,40300,0,40300,113300,0,153600
132515600500000,NW 333,RESIDENTIAL,42700,0,42700,139600,0,182300
132515600600000,NW 333,RESIDENTIAL,36500,0,36500,117000,0,153500
132515600700000,NW 333,RESIDENTIAL,39200,0,39200,142400,0,181600
132515600800000,NW 333,RESIDENTIAL,39900,0,39900,146100,0,186000
132515600900000,NW 333,RESIDENTIAL,40900,0,40900,156400,0,197300
132515601000000,NW 333,RESIDENTIAL,33400,0,33400,114800,0,148200
132515601100000,NW 333,RESIDENTIAL,38200,0,38200,144300,0,182500
132515601200000,NW 333,RESIDENTIAL,38600,0,38600,140000,0,178600
132515601300000,NW 333,RESIDENTIAL,38100,0,38100,126000,0,164100
132515601400000,NW 333,RESIDENTIAL,0,0,0,0,0,0
132515601500000,NW 333,RESIDENTIAL,39700,0,39700,123800,0,163500
132515601600000,NW 333,RESIDENTIAL,38900,0,38900,123900,0,162800
132515601700000,NW 333,RESIDENTIAL,41000,0,41000,148400,0,189400
132515601800000,NW 333,RESIDENTIAL,59400,0,59400,98700,0,158100
132515601900000,SCHOOL,EXEMPT,0,0,0,0,0,0
132515700100000,NW 333,RESIDENTIAL,40100,0,40100,152700,0,192800
132515700200000,NW 333,RESIDENTIAL,29400,0,29400,126700,0,156100
132515700300000,NW 333,RESIDENTIAL,39100,0,39100,146600,0,185700
132515700400000,NW 333,RESIDENTIAL,39600,0,39600,149900,0,189500
132515700500000,NW 333,RESIDENTIAL,39400,0,39400,143100,0,182500
132515700600000,NW 333,RESIDENTIAL,31000,0,31000,134600,0,165600
132515700700000,NW 333,RESIDENTIAL,35800,0,35800,128800,0,164600
132515700800000,NW 333,RESIDENTIAL,39500,0,39500,138900,0,178400
132515700900000,NW 333,RESIDENTIAL,35800,0,35800,126200,0,162000
132515701000000,NW 333,RESIDENTIAL,38300,0,38300,123000,0,161300
132517600200000,CITY PROPERTY,EXEMPT,0,0,0,0,0,0
132517600400000,NW 324,RESIDENTIAL,20700,0,20700,90100,0,110800
132517600500000,NW 324,RESIDENTIAL,21100,0,21100,75100,0,96200
132517600600000,NW 324,RESIDENTIAL,21400,0,21400,82400,0,103800
132517600700000,NW 324,RESIDENTIAL,21800,0,21800,90900,0,112700
132517600800000,NW 324,RESIDENTIAL,26100,0,26100,93100,0,119200
132517600900000,NW 324,RESIDENTIAL,20800,0,20800,91000,0,111800
132517601000000,NW 324,RESIDENTIAL,16900,0,16900,96200,0,113100
132517700100000,FAST FOOD,COMMERCIAL,0,146000,146000,0,232200,378200
132517700200000,NBHD SHOPPING CENTER,COMMERCIAL,0,338400,338400,0,529400,867800
132517700300000,NW 324,RESIDENTIAL,22800,0,22800,96500,0,119300
132517700400000,NW 324,RESIDENTIAL,23600,0,23600,113600,0,137200
132517700500000,NW 324,RESIDENTIAL,23600,0,23600,88900,0,112500
132517700600000,NW 324,RESIDENTIAL,23300,0,23300,92800,0,116100
132517700700000,NW 324,RESIDENTIAL,24400,0,24400,93000,0,117400
132517700800000,NW 324,RESIDENTIAL,25100,0,25100,89100,0,114200
132517700900000,NW 324,RESIDENTIAL,25200,0,25200,128600,0,153800
132517701000000,NW 324,RESIDENTIAL,22600,0,22600,95500,0,118100
132517701100000,NW 324,RESIDENTIAL,23600,0,23600,100400,0,124000
132517701200000,NW 324,RESIDENTIAL,23300,0,23300,100700,0,124000
132517701300000,NW 324,RESIDENTIAL,23300,0,23300,81900,0,105200
132517701400000,NW 324,EXEMPT,0,23300,23300,0,98000,121300
132517701500000,NW 324,RESIDENTIAL,23300,0,23300,100800,0,124100
132517701600000,NW 324,RESIDENTIAL,23300,0,23300,96600,0,119900
132517701700000,NW 324,RESIDENTIAL,23300,0,23300,93400,0,116700
132517701800000,NW 324,RESIDENTIAL,24300,0,24300,90400,0,114700
132517701900000,NW 324,RESIDENTIAL,24100,0,24100,92000,0,116100
132517702000000,NW 324,RESIDENTIAL,24100,0,24100,82600,0,106700
132517702100000,NW 324,RESIDENTIAL,24100,0,24100,84600,0,108700
132517702200000,NW 324,RESIDENTIAL,24100,0,24100,93500,0,117600
132517702300000,NW 324,RESIDENTIAL,24100,0,24100,92200,0,116300
132517702400000,NW 324,RESIDENTIAL,24100,0,24100,93300,0,117400
132517702500000,NW 324,RESIDENTIAL,27100,0,27100,112800,0,139900
132517702600000,NW 324,RESIDENTIAL,26600,0,26600,104100,0,130700
132517702700000,FLAT PARKING,COMMERCIAL,0,162800,162800,0,8100,170900
132517702800000,OFFICE,COMMERCIAL,0,167300,167300,0,355200,522500
132517800100000,NW 324,RESIDENTIAL,24500,0,24500,101200,0,125700
132517800200000,NW 324,RESIDENTIAL,27600,0,27600,93300,0,120900
132517800300000,NW 324,RESIDENTIAL,23300,0,23300,94900,0,118200
132517800400000,NW 324,RESIDENTIAL,23300,0,23300,101800,0,125100
132517800500000,NW 324,RESIDENTIAL,23300,0,23300,94000,0,117300
132517800600000,NW 324,RESIDENTIAL,23300,0,23300,96300,0,119600
132517800700000,NW 324,RESIDENTIAL,23300,0,23300,94000,0,117300
132517800800000,NW 324,RESIDENTIAL,23300,0,23300,86900,0,110200
132517800900000,NW 324,RESIDENTIAL,25500,0,25500,85100,0,110600
132517801000000,NW 324,RESIDENTIAL,25500,0,25500,105700,0,131200
132517801100000,NW 324,RESIDENTIAL,25500,0,25500,94000,0,119500
132517801200000,NW 324,RESIDENTIAL,25500,0,25500,95900,0,121400
132517801300000,NW 324,RESIDENTIAL,23300,0,23300,94600,0,117900
132517801400000,NW 324,RESIDENTIAL,23300,0,23300,98200,0,121500
132517801500000,NW 324,RESIDENTIAL,23300,0,23300,90600,0,113900
132517801600000,NW 324,RESIDENTIAL,23300,0,23300,88200,0,111500
132517801700000,NW 324,RESIDENTIAL,25100,0,25100,90600,0,115700
132517801800000,NW 324,RESIDENTIAL,25500,0,25500,103300,0,128800
132517801900000,NW 324,RESIDENTIAL,27800,0,27800,102300,0,130100
132517802000000,NW 324,RESIDENTIAL,30600,0,30600,101000,0,131600
132517802100000,NW 324,RESIDENTIAL,30600,0,30600,97500,0,128100
132517802200000,NW 324,RESIDENTIAL,28200,0,28200,100700,0,128900
132517802300000,NW 324,RESIDENTIAL,25500,0,25500,113800,0,139300
132517802400000,NW 324,RESIDENTIAL,30800,0,30800,107600,0,138400
132517802500000,NW 324,RESIDENTIAL,29000,0,29000,104600,0,133600
132517802600000,NW 324,RESIDENTIAL,27900,0,27900,111600,0,139500
132517802700000,NW 324,RESIDENTIAL,28600,0,28600,89800,0,118400
132517802800000,NW 324,RESIDENTIAL,25200,0,25200,130800,0,156000
132517802900000,NW 324,RESIDENTIAL,22700,0,22700,95100,0,117800
132517803000000,NW 324,RESIDENTIAL,23300,0,23300,88600,0,111900
132517900100000,NW 324,RESIDENTIAL,28400,0,28400,96900,0,125300
132517900200000,NW 324,RESIDENTIAL,23100,0,23100,95500,0,118600
132517900300000,NW 324,RESIDENTIAL,21800,0,21800,92800,0,114600
132517900400000,NW 324,RESIDENTIAL,22400,0,22400,96900,0,119300
132517900500000,NW 324,RESIDENTIAL,23300,0,23300,85900,0,109200
132517900600000,NW 324,RESIDENTIAL,23300,0,23300,96700,0,120000
132517900700000,NW 324,RESIDENTIAL,23300,0,23300,93200,0,116500
132517900800000,NW 324,RESIDENTIAL,23300,0,23300,88400,0,111700
132517900900000,NW 324,RESIDENTIAL,23300,0,23300,85300,0,108600
132517901000000,NW 324,RESIDENTIAL,23300,0,23300,105700,0,129000
132517901100000,NW 324,RESIDENTIAL,23300,0,23300,100900,0,124200
132517901200000,NW 324,RESIDENTIAL,23300,0,23300,97800,0,121100
132517901300000,NW 324,RESIDENTIAL,23500,0,23500,87300,0,110800
132517901400000,NW 324,RESIDENTIAL,25500,0,25500,87800,0,113300
132517901500000,NW 324,RESIDENTIAL,25500,0,25500,101400,0,126900
132517901600000,NW 324,RESIDENTIAL,25500,0,25500,95400,0,120900
132517901700000,NW 324,RESIDENTIAL,25500,0,25500,89700,0,115200
132517901800000,NW 324,RESIDENTIAL,25500,0,25500,105500,0,131000
132517901900000,NW 324,RESIDENTIAL,23300,0,23300,95500,0,118800
132517902000000,NW 324,RESIDENTIAL,23300,0,23300,90900,0,114200
132517902100000,NW 324,RESIDENTIAL,23300,0,23300,97000,0,120300
132517902200000,NW 324,RESIDENTIAL,23300,0,23300,91200,0,114500
132518000100000,NW 324,RESIDENTIAL,24900,0,24900,108200,0,133100
132518000400000,NW 324,RESIDENTIAL,52600,0,52600,0,0,52600
132518000500000,NW 324,RESIDENTIAL,23400,0,23400,93600,0,117000
132518000600000,NW 324,RESIDENTIAL,23300,0,23300,92600,0,115900
132518000700000,NW 324,RESIDENTIAL,23300,0,23300,110900,0,134200
132518000800000,NW 324,RESIDENTIAL,23300,0,23300,134300,0,157600
132518000900000,NW 324,RESIDENTIAL,23300,0,23300,105000,0,128300
132518001000000,NW 324,RESIDENTIAL,23300,0,23300,76000,0,99300
132518001100000,NW 324,RESIDENTIAL,23300,0,23300,67800,0,91100
132518001200000,NW 324,RESIDENTIAL,22200,0,22200,89900,0,112100
132518001300000,NW 324,RESIDENTIAL,23300,0,23300,89700,0,113000
132518001400000,APARTMENT,RESIDENTIAL,78800,0,78800,287600,0,366400
132518100100000,NW 324,RESIDENTIAL,23300,0,23300,83000,0,106300
132518100200000,NW 324,RESIDENTIAL,23300,0,23300,99900,0,123200
132518100300000,NW 324,RESIDENTIAL,23300,0,23300,88100,0,111400
132518100400000,NW 324,RESIDENTIAL,22200,0,22200,89000,0,111200
132518100500000,NW 324,RESIDENTIAL,23300,0,23300,94500,0,117800
132518100600000,NW 324,RESIDENTIAL,23300,0,23300,109500,0,132800
132518100700000,NW 324,RESIDENTIAL,22200,0,22200,90700,0,112900
132518100800000,NW 324,RESIDENTIAL,23300,0,23300,89500,0,112800
132518100900000,NW 324,RESIDENTIAL,22200,0,22200,87300,0,109500
132518101000000,NW 324,RESIDENTIAL,23300,0,23300,82400,0,105700
132518200100000,NW 324,RESIDENTIAL,21800,0,21800,93500,0,115300
132518200200000,NW 324,RESIDENTIAL,21800,0,21800,91400,0,113200
132518200300000,NW 324,RESIDENTIAL,21800,0,21800,129200,0,151000
132518200400000,NW 324,RESIDENTIAL,21800,0,21800,102200,0,124000
132518200500000,NW 324,RESIDENTIAL,21800,0,21800,93200,0,115000
132518200600000,NW 324,RESIDENTIAL,21900,0,21900,91300,0,113200
132518200700000,APARTMENT,RESIDENTIAL,50000,0,50000,190900,0,240900
132520100100000,NW 328,RESIDENTIAL,32400,0,32400,181600,0,214000
132520100200000,NW 328,RESIDENTIAL,30500,0,30500,176400,0,206900
132520100300000,NW 328,RESIDENTIAL,27600,0,27600,181800,0,209400
132520100400000,NW 328,RESIDENTIAL,30500,0,30500,158100,0,188600
132520100500000,NW 328,RESIDENTIAL,30900,0,30900,178100,0,209000
132520100600000,NW 328,RESIDENTIAL,27200,0,27200,185800,0,213000
132520100700000,NW 328,RESIDENTIAL,27200,0,27200,148100,0,175300
132520100800000,NW 328,RESIDENTIAL,27200,0,27200,155300,0,182500
132520100900000,NW 328,RESIDENTIAL,27200,0,27200,172900,0,200100
132520101000000,NW 328,RESIDENTIAL,27200,0,27200,165900,0,193100
132520101100000,NW 328,RESIDENTIAL,26800,0,26800,158400,0,185200
132520101200000,NW 328,RESIDENTIAL,26800,0,26800,158900,0,185700
132520101300000,NW 328,RESIDENTIAL,28500,0,28500,182000,0,210500
132520101400000,NW 328,RESIDENTIAL,27400,0,27400,150600,0,178000
132520101500000,NW 328,RESIDENTIAL,24200,0,24200,155600,0,179800
132520101600000,NW 327,RESIDENTIAL,30200,0,30200,76100,0,106300
132520101700000,NW 327,RESIDENTIAL,29300,0,29300,84900,0,114200
132520101800000,NW 327,RESIDENTIAL,29000,0,29000,100300,0,129300
132520101900000,NW 327,RESIDENTIAL,24000,0,24000,100300,0,124300
132520102000000,NW 327,RESIDENTIAL,24000,0,24000,97000,0,121000
132520102100000,NW 327,RESIDENTIAL,24000,0,24000,92200,0,116200
132520102200000,NW 327,RESIDENTIAL,24000,0,24000,93900,0,117900
132520102300000,NW 327,RESIDENTIAL,24000,0,24000,104000,0,128000
132520102400000,NW 328,RESIDENTIAL,27700,0,27700,184600,0,212300
132520102500000,NW 328,RESIDENTIAL,27400,0,27400,149900,0,177300
132520102600000,NW 328,RESIDENTIAL,27400,0,27400,164600,0,192000
132520102700000,NW 328,RESIDENTIAL,27400,0,27400,147700,0,175100
132520102800000,NW 328,RESIDENTIAL,27200,0,27200,159600,0,186800
132520200100000,NW 328,RESIDENTIAL,33700,0,33700,166400,0,200100
132520200200000,NW 328,RESIDENTIAL,29100,0,29100,159400,0,188500
132520200300000,NW 328,RESIDENTIAL,29100,0,29100,160800,0,189900
132520200400000,NW 328,RESIDENTIAL,29100,0,29100,159100,0,188200
132520200500000,NW 328,RESIDENTIAL,29100,0,29100,159100,0,188200
132520200600000,NW 328,RESIDENTIAL,29100,0,29100,147100,0,176200
132520200700000,NW 328,RESIDENTIAL,29100,0,29100,163300,0,192400
132520200800000,NW 328,RESIDENTIAL,29100,0,29100,152600,0,181700
132520200900000,NW 328,RESIDENTIAL,29100,0,29100,156500,0,185600
132520201000000,NW 328,RESIDENTIAL,29100,0,29100,158200,0,187300
132520201100000,NW 328,RESIDENTIAL,29100,0,29100,168900,0,198000
132520201200000,NW 328,RESIDENTIAL,27000,0,27000,146300,0,173300
132520201300000,NW 328,RESIDENTIAL,29100,0,29100,167500,0,196600
132520201400000,NW 328,RESIDENTIAL,29100,0,29100,163900,0,193000
132520300100000,NW 328,RESIDENTIAL,31400,0,31400,175100,0,206500
132520300200000,NW 328,RESIDENTIAL,27200,0,27200,186900,0,214100
132520300300000,NW 328,RESIDENTIAL,27200,0,27200,198800,0,226000
132520300400000,NW 328,RESIDENTIAL,27200,0,27200,167600,0,194800
132520300500000,NW 328,RESIDENTIAL,27200,0,27200,175800,0,203000
132520300600000,NW 328,RESIDENTIAL,27200,0,27200,177600,0,204800
132520300700000,NW 328,RESIDENTIAL,27200,0,27200,205100,0,232300
132520300800000,NW 328,RESIDENTIAL,27200,0,27200,199100,0,226300
132520300900000,NW 328,RESIDENTIAL,27200,0,27200,181100,0,208300
132520301000000,NW 328,RESIDENTIAL,27200,0,27200,167600,0,194800
132520301100000,NW 328,RESIDENTIAL,27800,0,27800,173900,0,201700
132520301200000,NW 328,RESIDENTIAL,27000,0,27000,167400,0,194400
132520301300000,NW 328,RESIDENTIAL,28800,0,28800,174600,0,203400
132520301400000,NW 328,RESIDENTIAL,27700,0,27700,138200,0,165900
132520301500000,NW 328,RESIDENTIAL,30000,0,30000,166000,0,196000
132520301600000,NW 328,RESIDENTIAL,29100,0,29100,176300,0,205400
132520301700000,NW 328,RESIDENTIAL,30200,0,30200,143900,0,174100
132520301800000,NW 328,RESIDENTIAL,30300,0,30300,172400,0,202700
132520301900000,NW 328,RESIDENTIAL,28500,0,28500,159400,0,187900
132520302000000,NW 328,RESIDENTIAL,28600,0,28600,167500,0,196100
132520302100000,NW 328,RESIDENTIAL,25200,0,25200,174800,0,200000
132520302200000,NW 328,RESIDENTIAL,25200,0,25200,165800,0,191000
132520302300000,NW 328,RESIDENTIAL,25200,0,25200,181400,0,206600
132520302400000,NW 328,RESIDENTIAL,25200,0,25200,166200,0,191400
132520302500000,NW 328,RESIDENTIAL,25200,0,25200,176700,0,201900
132520302600000,NW 328,RESIDENTIAL,25200,0,25200,156600,0,181800
132520302700000,NW 328,RESIDENTIAL,25200,0,25200,197000,0,222200
132520302800000,NW 328,RESIDENTIAL,29500,0,29500,163700,0,193200
132520400100000,NW 328,RESIDENTIAL,29500,0,29500,183500,0,213000
132520400200000,NW 328,RESIDENTIAL,25200,0,25200,146600,0,171800
132520400300000,NW 328,RESIDENTIAL,28900,0,28900,180600,0,209500
132520400400000,NW 328,RESIDENTIAL,29100,0,29100,146800,0,175900
132520400500000,NW 328,RESIDENTIAL,28300,0,28300,157500,0,185800
132520400600000,NW 328,RESIDENTIAL,27600,0,27600,181500,0,209100
132520400700000,NW 328,RESIDENTIAL,26700,0,26700,162900,0,189600
132520400800000,NW 328,RESIDENTIAL,28300,0,28300,155700,0,184000
132520400900000,NW 328,RESIDENTIAL,30300,0,30300,165900,0,196200
132520401000000,NW 328,RESIDENTIAL,27700,0,27700,121000,0,148700
132520401100000,NW 328,RESIDENTIAL,29400,0,29400,141900,0,171300
132520401200000,NW 328,RESIDENTIAL,30300,0,30300,161300,0,191600
132520401300000,NW 328,RESIDENTIAL,30200,0,30200,138900,0,169100
132520401400000,NW 328,RESIDENTIAL,31400,0,31400,170200,0,201600
132520401500000,NW 328,RESIDENTIAL,30200,0,30200,150700,0,180900
132520401600000,CITY PROPERTY,EXEMPT,0,0,0,0,0,0
132520401700000,NW 327,RESIDENTIAL,33000,0,33000,129700,0,162700
132520401800000,NW 327,RESIDENTIAL,32300,0,32300,87300,0,119600
132520401900000,NW 328,RESIDENTIAL,28900,0,28900,155400,0,184300
132520402000000,NW 328,RESIDENTIAL,26800,0,26800,153300,0,180100
132520500100000,NW 328,RESIDENTIAL,28900,0,28900,144600,0,173500
132520500200000,NW 328,RESIDENTIAL,26500,0,26500,139000,0,165500
132520500300000,NW 328,RESIDENTIAL,28600,0,28600,133000,0,161600
132520500400000,NW 328,RESIDENTIAL,29900,0,29900,136200,0,166100
132520500500000,NW 328,RESIDENTIAL,30900,0,30900,133000,0,163900
132520500600000,NW 328,RESIDENTIAL,25200,0,25200,166900,0,192100
132520500700000,NW 328,RESIDENTIAL,25200,0,25200,146200,0,171400
132520500800000,NW 328,RESIDENTIAL,29500,0,29500,130500,0,160000
132520500900000,NW 328,RESIDENTIAL,31800,0,31800,159300,0,191100
132520501000000,NW 328,RESIDENTIAL,32200,0,32200,167400,0,199600
132520501100000,NW 328,RESIDENTIAL,28000,0,28000,174100,0,202100
132520501200000,NW 327,RESIDENTIAL,24800,0,24800,83200,0,108000
132520501300000,NW 327,RESIDENTIAL,24800,0,24800,85000,0,109800
132520501400000,NW 327,RESIDENTIAL,24800,0,24800,153800,0,178600
132520501500000,NW 327,RESIDENTIAL,24800,0,24800,90800,0,115600
132520501600000,NW 327,RESIDENTIAL,24800,0,24800,96000,0,120800
132520501700000,NW 327,RESIDENTIAL,24800,0,24800,94500,0,119300
132520501800000,NW 327,RESIDENTIAL,24800,0,24800,87600,0,112400
132520501900000,NW 327,RESIDENTIAL,24900,0,24900,116000,0,140900
132520502000000,NW 327,RESIDENTIAL,24800,0,24800,96600,0,121400
132520502100000,NW 327,RESIDENTIAL,26100,0,26100,98700,0,124800
132520502200000,NW 327,RESIDENTIAL,34300,0,34300,103400,0,137700
132520600100000,NW 328,RESIDENTIAL,31400,0,31400,182400,0,213800
132520600200000,NW 328,RESIDENTIAL,27200,0,27200,169400,0,196600
132520600300000,NW 328,RESIDENTIAL,30100,0,30100,126900,0,157000
132520700100000,NW 327,RESIDENTIAL,32700,0,32700,108400,0,141100
132520700200000,NW 327,RESIDENTIAL,26700,0,26700,98400,0,125100
132520700300000,NW 327,RESIDENTIAL,26900,0,26900,89700,0,116600
132520700400000,NW 327,RESIDENTIAL,25200,0,25200,92700,0,117900
132520700500000,NW 327,RESIDENTIAL,25200,0,25200,102300,0,127500
132520700600000,NW 327,RESIDENTIAL,25200,0,25200,87500,0,112700
132520700700000,NW 327,RESIDENTIAL,25200,0,25200,95800,0,121000
132520700800000,NW 327,RESIDENTIAL,25200,0,25200,105000,0,130200
132520700900000,NW 327,RESIDENTIAL,25200,0,25200,89700,0,114900
132520701000000,NW 327,RESIDENTIAL,25200,0,25200,90900,0,116100
132520701100000,NW 327,RESIDENTIAL,28000,0,28000,90700,0,118700
132520800100000,NW 327,RESIDENTIAL,24000,0,24000,76000,0,100000
132520800200000,NW 327,RESIDENTIAL,24000,0,24000,82300,0,106300
132520800300000,NW 327,RESIDENTIAL,24000,0,24000,98600,0,122600
132520800400000,NW 327,RESIDENTIAL,24000,0,24000,79700,0,103700
132520800500000,NW 327,RESIDENTIAL,24000,0,24000,82600,0,106600
132520800600000,NW 327,RESIDENTIAL,24200,0,24200,109100,0,133300
132522600100000,NW 328,RESIDENTIAL,29100,0,29100,183100,0,212200
132522600200000,NW 328,RESIDENTIAL,29900,0,29900,188300,0,218200
132522600300000,NW 328,RESIDENTIAL,29400,0,29400,166500,0,195900
132522600400000,NW 328,RESIDENTIAL,30000,0,30000,138400,0,168400
132522600500000,NW 328,RESIDENTIAL,30200,0,30200,123500,0,153700
132522600600000,NW 328,RESIDENTIAL,31100,0,31100,126800,0,157900
132522700100000,NW 328,RESIDENTIAL,34000,0,34000,190300,0,224300
132522700200000,NW 328,RESIDENTIAL,33700,0,33700,154600,0,188300
132522700300000,NW 328,RESIDENTIAL,31600,0,31600,142900,0,174500
132522700400000,NW 328,RESIDENTIAL,31900,0,31900,163100,0,195000
132522800100000,NW 328,RESIDENTIAL,34000,0,34000,135800,0,169800
132522800200000,NW 328,RESIDENTIAL,34000,0,34000,142000,0,176000
132522800300000,NW 328,RESIDENTIAL,28000,0,28000,124300,0,152300
132522800400000,NW 328,RESIDENTIAL,28000,0,28000,140300,0,168300
132522800500000,NW 328,RESIDENTIAL,28000,0,28000,137000,0,165000
132522800600000,NW 328,RESIDENTIAL,28000,0,28000,159500,0,187500
132522800700000,NW 328,RESIDENTIAL,28000,0,28000,140200,0,168200
132522800800000,NW 328,RESIDENTIAL,28000,0,28000,171000,0,199000
132522800900000,NW 328,RESIDENTIAL,28000,0,28000,128300,0,156300
132522801000000,NW 328,RESIDENTIAL,28000,0,28000,136100,0,164100
132522801100000,NW 328,RESIDENTIAL,27400,0,27400,146100,0,173500
132522801200000,NW 328,RESIDENTIAL,27300,0,27300,132900,0,160200
132522801300000,NW 328,RESIDENTIAL,27200,0,27200,124600,0,151800
132522801400000,NW 327,RESIDENTIAL,24800,0,24800,82400,0,107200
132522801500000,NW 327,RESIDENTIAL,24800,0,24800,99800,0,124600
132522801600000,NW 327,RESIDENTIAL,24800,0,24800,82600,0,107400
132522801700000,NW 327,RESIDENTIAL,25600,0,25600,93100,0,118700
132522801800000,NW 327,RESIDENTIAL,26000,0,26000,88600,0,114600
132522801900000,NW 327,RESIDENTIAL,24400,0,24400,84000,0,108400
132522802000000,NW 327,RESIDENTIAL,24800,0,24800,92700,0,117500
132522802100000,NW 327,RESIDENTIAL,24800,0,24800,101200,0,126000
132522802200000,NW 328,RESIDENTIAL,29300,0,29300,151900,0,181200
132522802300000,NW 328,RESIDENTIAL,27700,0,27700,158200,0,185900
132522802400000,NW 328,RESIDENTIAL,29100,0,29100,124300,0,153400
132522802500000,NW 328,RESIDENTIAL,28000,0,28000,148400,0,176400
132522802600000,NW 328,RESIDENTIAL,28000,0,28000,172900,0,200900
132522802700000,NW 328,RESIDENTIAL,28000,0,28000,132600,0,160600
132522802800000,NW 328,RESIDENTIAL,28000,0,28000,134100,0,162100
132522802900000,NW 328,RESIDENTIAL,28000,0,28000,142100,0,170100
132522803000000,NW 328,RESIDENTIAL,28000,0,28000,156200,0,184200
132522803100000,NW 328,RESIDENTIAL,28000,0,28000,131300,0,159300
132522803200000,NW 328,RESIDENTIAL,28000,0,28000,164400,0,192400
132522900100000,NW 328,RESIDENTIAL,34700,0,34700,165000,0,199700
132522900200000,NW 328,RESIDENTIAL,28600,0,28600,128400,0,157000
132522900300000,NW 328,RESIDENTIAL,28600,0,28600,123200,0,151800
132522900400000,NW 328,RESIDENTIAL,28600,0,28600,131000,0,159600
132522900500000,NW 328,RESIDENTIAL,28600,0,28600,123900,0,152500
132522900600000,NW 328,RESIDENTIAL,28600,0,28600,136600,0,165200
132522900700000,NW 328,RESIDENTIAL,28600,0,28600,147100,0,175700
132522900800000,NW 328,RESIDENTIAL,28600,0,28600,159200,0,187800
132522900900000,NW 328,RESIDENTIAL,28600,0,28600,127100,0,155700
132522901000000,NW 328,RESIDENTIAL,28500,0,28500,136000,0,164500
132522901100000,NW 328,RESIDENTIAL,29200,0,29200,148600,0,177800
132522901200000,NW 328,RESIDENTIAL,27800,0,27800,132500,0,160300
132522901300000,NW 327,RESIDENTIAL,26000,0,26000,115900,0,141900
132522901400000,NW 327,RESIDENTIAL,26000,0,26000,97100,0,123100
132522901500000,NW 327,RESIDENTIAL,26000,0,26000,85900,0,111900
132522901600000,NW 327,RESIDENTIAL,26900,0,26900,102300,0,129200
132523000100000,NW 328,RESIDENTIAL,26000,0,26000,139800,0,165800
132523000200000,NW 328,RESIDENTIAL,26400,0,26400,149100,0,175500
132523000300000,NW 328,RESIDENTIAL,34900,0,34900,128400,0,163300
132523000400000,NW 328,RESIDENTIAL,29800,0,29800,126500,0,156300
132523000500000,NW 328,RESIDENTIAL,27600,0,27600,134500,0,162100
132523000600000,NW 328,RESIDENTIAL,29200,0,29200,127700,0,156900
132523003000000,NW 328,RESIDENTIAL,27200,0,27200,156100,0,183300
132523100100000,NW 328,RESIDENTIAL,30300,0,30300,125500,0,155800
132523100200000,NW 328,RESIDENTIAL,30600,0,30600,125600,0,156200
132523100300000,NW 328,RESIDENTIAL,30600,0,30600,156600,0,187200
132523100400000,NW 328,RESIDENTIAL,31600,0,31600,134900,0,166500
132523100500000,NW 328,RESIDENTIAL,29100,0,29100,135500,0,164600
132523100600000,NW 328,RESIDENTIAL,29100,0,29100,128100,0,157200
132523100700000,NW 328,RESIDENTIAL,29100,0,29100,200400,0,229500
132523100800000,NW 328,RESIDENTIAL,29100,0,29100,141700,0,170800
132523100900000,NW 328,RESIDENTIAL,29100,0,29100,123600,0,152700
132523101000000,NW 328,RESIDENTIAL,28900,0,28900,147300,0,176200
132523101100000,NW 328,RESIDENTIAL,29100,0,29100,185800,0,214900
132523101200000,NW 328,RESIDENTIAL,27500,0,27500,132000,0,159500
132523101300000,NW 327,RESIDENTIAL,24800,0,24800,97600,0,122400
132523101400000,NW 327,RESIDENTIAL,24800,0,24800,89500,0,114300
132523101500000,NW 327,RESIDENTIAL,24000,0,24000,84800,0,108800
132523101600000,NW 327,RESIDENTIAL,26400,0,26400,86600,0,113000
132523101700000,NW 327,RESIDENTIAL,26400,0,26400,85900,0,112300
132523101800000,NW 328,RESIDENTIAL,26900,0,26900,163800,0,190700
132523101900000,NW 328,RESIDENTIAL,25800,0,25800,133000,0,158800
132523102000000,NW 328,RESIDENTIAL,26600,0,26600,133500,0,160100
132523102100000,NW 328,RESIDENTIAL,25200,0,25200,173000,0,198200
132523102200000,NW 328,RESIDENTIAL,25200,0,25200,162100,0,187300
132523102300000,NW 328,RESIDENTIAL,25500,0,25500,185500,0,211000
132523102400000,NW 328,RESIDENTIAL,31600,0,31600,207000,0,238600
132523102500000,NW 328,RESIDENTIAL,32400,0,32400,182300,0,214700
132523102600000,NW 328,RESIDENTIAL,27900,0,27900,166200,0,194100
132523102700000,NW 328,RESIDENTIAL,31300,0,31300,160300,0,191600
132523102800000,NW 328,RESIDENTIAL,29600,0,29600,173700,0,203300
132523102900000,NW 328,RESIDENTIAL,29900,0,29900,143000,0,172900
132523103100000,NW 328,RESIDENTIAL,27200,0,27200,123000,0,150200
132523103200000,NW 328,RESIDENTIAL,27200,0,27200,145200,0,172400
132523103300000,NW 328,RESIDENTIAL,29800,0,29800,183700,0,213500
132523103400000,NW 328,RESIDENTIAL,31100,0,31100,182900,0,214000
132523103500000,NW 328,RESIDENTIAL,29800,0,29800,192500,0,222300
132523103600000,NW 328,RESIDENTIAL,28300,0,28300,169900,0,198200
132523103700000,NW 328,RESIDENTIAL,30600,0,30600,123700,0,154300
132523103800000,NW 328,RESIDENTIAL,31600,0,31600,159200,0,190800
132523103900000,NW 328,RESIDENTIAL,31300,0,31300,135300,0,166600
132523104000000,NW 328,RESIDENTIAL,27000,0,27000,162500,0,189500
132523104100000,NW 328,RESIDENTIAL,28300,0,28300,150400,0,178700
132523104200000,NW 328,RESIDENTIAL,28600,0,28600,140100,0,168700
132523200100000,NW 328,RESIDENTIAL,28800,0,28800,157700,0,186500
132523200200000,NW 328,RESIDENTIAL,27300,0,27300,147100,0,174400
132523200300000,NW 328,RESIDENTIAL,25200,0,25200,190500,0,215700
132523200400000,NW 328,RESIDENTIAL,25200,0,25200,172100,0,197300
132523200500000,NW 328,RESIDENTIAL,25200,0,25200,132900,0,158100
132523200600000,NW 328,RESIDENTIAL,25200,0,25200,134000,0,159200
132523200700000,NW 328,RESIDENTIAL,25200,0,25200,131100,0,156300
132523200800000,NW 328,RESIDENTIAL,26100,0,26100,165100,0,191200
132523200900000,NW 328,RESIDENTIAL,30300,0,30300,157100,0,187400
132523201000000,NW 327,RESIDENTIAL,25600,0,25600,82500,0,108100
132523201100000,NW 327,RESIDENTIAL,24800,0,24800,89500,0,114300
132523201200000,NW 327,RESIDENTIAL,24800,0,24800,84800,0,109600
132523201300000,NW 327,RESIDENTIAL,24800,0,24800,86700,0,111500
132523201400000,NW 327,RESIDENTIAL,24800,0,24800,85600,0,110400
132523201500000,NW 327,RESIDENTIAL,24800,0,24800,91500,0,116300
132523201600000,NW 327,RESIDENTIAL,24800,0,24800,81100,0,105900
132523201700000,NW 327,RESIDENTIAL,24800,0,24800,81100,0,105900
132523201800000,NW 327,RESIDENTIAL,24800,0,24800,82900,0,107700
132523201900000,NW 327,RESIDENTIAL,24800,0,24800,99600,0,124400
132523300100000,NW 327,RESIDENTIAL,26000,0,26000,108600,0,134600
132523300200000,NW 327,RESIDENTIAL,26000,0,26000,86900,0,112900
132523300300000,NW 327,RESIDENTIAL,26000,0,26000,100500,0,126500
132523300400000,NW 327,RESIDENTIAL,26000,0,26000,89300,0,115300
132523300500000,NW 327,RESIDENTIAL,24800,0,24800,91800,0,116600
132523300600000,NW 327,RESIDENTIAL,24800,0,24800,82500,0,107300
132523300700000,NW 327,RESIDENTIAL,24800,0,24800,88600,0,113400
132523300800000,NW 327,RESIDENTIAL,24800,0,24800,80600,0,105400
132523300900000,NW 327,RESIDENTIAL,24800,0,24800,104200,0,129000
132523301000000,NW 327,RESIDENTIAL,24800,0,24800,87000,0,111800
132523301100000,NW 327,RESIDENTIAL,24800,0,24800,82400,0,107200
132523301200000,NW 327,RESIDENTIAL,24800,0,24800,101100,0,125900
132523301300000,NW 327,RESIDENTIAL,24800,0,24800,90300,0,115100
132523301400000,NW 327,RESIDENTIAL,26600,0,26600,102000,0,128600
132523400100000,NW 327,RESIDENTIAL,24000,0,24000,87900,0,111900
132523400200000,NW 327,RESIDENTIAL,24000,0,24000,84500,0,108500
132523400300000,NW 327,RESIDENTIAL,24000,0,24000,86100,0,110100
132523400400000,NW 327,RESIDENTIAL,24000,0,24000,103500,0,127500
132523400500000,NW 327,RESIDENTIAL,24000,0,24000,95000,0,119000
132523400600000,NW 327,RESIDENTIAL,29300,0,29300,74500,0,103800
132525100100000,NW 329,RESIDENTIAL,18300,0,18300,72500,0,90800
132525100200000,NW 329,RESIDENTIAL,19000,0,19000,83600,0,102600
132525100300000,NW 329,RESIDENTIAL,20200,0,20200,69400,0,89600
132525100400000,NW 329,RESIDENTIAL,18900,0,18900,74300,0,93200
132525100500000,NW 329,RESIDENTIAL,18300,0,18300,71900,0,90200
132525100600000,NW 329,RESIDENTIAL,18900,0,18900,86400,0,105300
132525100700000,NW 329,RESIDENTIAL,20200,0,20200,79100,0,99300
132525100800000,NW 329,RESIDENTIAL,18900,0,18900,80800,0,99700
132525100900000,NW 329,RESIDENTIAL,18300,0,18300,83400,0,101700
132525101000000,NW 329,RESIDENTIAL,17800,0,17800,74500,0,92300
132525101100000,NW 329,RESIDENTIAL,22500,0,22500,81500,0,104000
132525101200000,NW 329,RESIDENTIAL,23100,0,23100,102500,0,125600
132525101300000,NW 329,RESIDENTIAL,19500,0,19500,86600,0,106100
132525101400000,NW 329,RESIDENTIAL,19000,0,19000,70900,0,89900
132525101500000,NW 329,RESIDENTIAL,19800,0,19800,79200,0,99000
132525101600000,NW 329,RESIDENTIAL,18900,0,18900,66200,0,85100
132525101700000,NW 329,RESIDENTIAL,19800,0,19800,105200,0,125000
132525101800000,NW 329,RESIDENTIAL,19500,0,19500,73200,0,92700
132525101900000,NW 329,RESIDENTIAL,25900,0,25900,71600,0,97500
132525102000000,NW 329,RESIDENTIAL,23300,0,23300,80100,0,103400
132525102100000,NW 329,RESIDENTIAL,24800,0,24800,73000,0,97800
132525102200000,NW 329,RESIDENTIAL,23100,0,23100,79500,0,102600
132525102300000,NW 329,RESIDENTIAL,23100,0,23100,88900,0,112000
132525102400000,NW 329,RESIDENTIAL,22900,0,22900,86400,0,109300
132525102500000,NW 329,RESIDENTIAL,22900,0,22900,87200,0,110100
132525102600000,NW 329,RESIDENTIAL,22800,0,22800,85400,0,108200
132525102700000,NW 329,RESIDENTIAL,22700,0,22700,79400,0,102100
132525102800000,NW 329,RESIDENTIAL,21800,0,21800,82800,0,104600
132525200100000,NW 329,RESIDENTIAL,24400,0,24400,82900,0,107300
132525200200000,NW 329,RESIDENTIAL,26900,0,26900,87900,0,114800
132525200300000,NW 329,RESIDENTIAL,24200,0,24200,81600,0,105800
132525200400000,NW 329,RESIDENTIAL,25000,0,25000,72200,0,97200
132525200500000,NW 329,RESIDENTIAL,25400,0,25400,98900,0,124300
132525200600000,NW 329,RESIDENTIAL,24800,0,24800,87000,0,111800
132525200700000,NW 329,RESIDENTIAL,22600,0,22600,96900,0,119500
132525200800000,NW 329,RESIDENTIAL,23300,0,23300,85000,0,108300
132525200900000,NW 329,RESIDENTIAL,28700,0,28700,85900,0,114600
132525201000000,NW 329,RESIDENTIAL,28000,0,28000,72000,0,100000
132525201100000,NW 329,RESIDENTIAL,29000,0,29000,85300,0,114300
132525201200000,NW 329,RESIDENTIAL,28500,0,28500,80300,0,108800
132525201300000,NW 329,RESIDENTIAL,29100,0,29100,65100,0,94200
132525300100000,NW 329,RESIDENTIAL,19500,0,19500,77000,0,96500
132525300200000,NW 329,RESIDENTIAL,18900,0,18900,87200,0,106100
132525300300000,NW 329,RESIDENTIAL,20200,0,20200,87600,0,107800
132525300400000,NW 329,RESIDENTIAL,18900,0,18900,82400,0,101300
132525300500000,NW 329,RESIDENTIAL,18900,0,18900,78300,0,97200
132525300600000,NW 329,RESIDENTIAL,20200,0,20200,81600,0,101800
132525300700000,NW 329,RESIDENTIAL,18900,0,18900,73700,0,92600
132525300800000,NW 329,RESIDENTIAL,20200,0,20200,95000,0,115200
132525300900000,NW 329,RESIDENTIAL,18900,0,18900,72900,0,91800
132525301000000,NW 329,RESIDENTIAL,20200,0,20200,87500,0,107700
132525301100000,NW 329,RESIDENTIAL,18900,0,18900,74200,0,93100
132525301200000,NW 329,RESIDENTIAL,18900,0,18900,85900,0,104800
132525301300000,NW 329,RESIDENTIAL,20600,0,20600,60000,0,80600
132525301400000,NW 329,RESIDENTIAL,19700,0,19700,77800,0,97500
132525301500000,CITY PROPERTY,EXEMPT,0,0,0,0,0,0
132525301600000,CITY PROPERTY,EXEMPT,0,0,0,0,0,0
132525400100000,NW 329,RESIDENTIAL,19500,0,19500,60100,0,79600
132525400200000,NW 329,RESIDENTIAL,19500,0,19500,75000,0,94500
132525400300000,NW 329,RESIDENTIAL,20200,0,20200,85500,0,105700
132525400400000,NW 329,RESIDENTIAL,18900,0,18900,74500,0,93400
132525400500000,NW 329,RESIDENTIAL,18300,0,18300,73700,0,92000
132525400600000,NW 329,RESIDENTIAL,18900,0,18900,80100,0,99000
132525400700000,NW 329,RESIDENTIAL,20200,0,20200,86600,0,106800
132525400800000,NW 329,RESIDENTIAL,18900,0,18900,88000,0,106900
132525400900000,NW 329,RESIDENTIAL,18900,0,18900,76800,0,95700
132525401000000,NW 329,RESIDENTIAL,20200,0,20200,60300,0,80500
132525401100000,NW 329,RESIDENTIAL,18900,0,18900,72600,0,91500
132525401200000,NW 329,RESIDENTIAL,18300,0,18300,88200,0,106500
132525401300000,NW 329,RESIDENTIAL,20200,0,20200,90400,0,110600
132525401400000,NW 329,RESIDENTIAL,20700,0,20700,92300,0,113000
132525401500000,NW 329,RESIDENTIAL,20300,0,20300,80900,0,101200
132525401600000,NW 329,RESIDENTIAL,18900,0,18900,77600,0,96500
132525401700000,NW 329,RESIDENTIAL,18300,0,18300,79300,0,97600
132525401800000,NW 329,RESIDENTIAL,18900,0,18900,81400,0,100300
132525401900000,NW 329,RESIDENTIAL,20200,0,20200,89000,0,109200
132525402000000,NW 329,RESIDENTIAL,18900,0,18900,84800,0,103700
132525402100000,NW 329,RESIDENTIAL,18900,0,18900,84200,0,103100
132525402200000,NW 329,RESIDENTIAL,20200,0,20200,95000,0,115200
132525402300000,NW 329,RESIDENTIAL,18900,0,18900,92100,0,111000
132525402400000,NW 329,RESIDENTIAL,18300,0,18300,73300,0,91600
132525402500000,NW 329,RESIDENTIAL,18900,0,18900,77500,0,96400
132525402600000,NW 329,RESIDENTIAL,20200,0,20200,85800,0,106000
132525500100000,NW 329,RESIDENTIAL,18300,0,18300,76100,0,94400
132525500200000,NW 329,RESIDENTIAL,21700,0,21700,87000,0,108700
132525500300000,NW 329,RESIDENTIAL,21900,0,21900,74000,0,95900
132525500400000,NW 329,RESIDENTIAL,20400,0,20400,74100,0,94500
132525500500000,NW 329,RESIDENTIAL,20300,0,20300,79800,0,100100
132525500600000,NW 329,RESIDENTIAL,19300,0,19300,93400,0,112700
132525500700000,NW 329,RESIDENTIAL,20600,0,20600,62900,0,83500
132525500800000,NW 329,RESIDENTIAL,18700,0,18700,89300,0,108000
132525500900000,NW 329,RESIDENTIAL,20100,0,20100,78100,0,98200
132525501000000,NW 329,RESIDENTIAL,19600,0,19600,83000,0,102600
132525501100000,NW 329,RESIDENTIAL,25700,0,25700,74000,0,99700
132525501200000,NW 329,RESIDENTIAL,23300,0,23300,72200,0,95500
132525501300000,NW 329,RESIDENTIAL,24700,0,24700,72200,0,96900
132525501400000,NW 329,RESIDENTIAL,20800,0,20800,104200,0,125000
132525501500000,NW 329,RESIDENTIAL,21700,0,21700,79900,0,101600
132525501600000,NW 329,RESIDENTIAL,20900,0,20900,85800,0,106700
132525501700000,NW 329,RESIDENTIAL,21300,0,21300,85300,0,106600
132525501800000,NW 329,RESIDENTIAL,22100,0,22100,64600,0,86700
132525501900000,NW 329,RESIDENTIAL,22600,0,22600,80100,0,102700
132525502000000,NW 329,RESIDENTIAL,22600,0,22600,73500,0,96100
132525502100000,NW 329,RESIDENTIAL,23700,0,23700,71200,0,94900
132525502200000,NW 329,RESIDENTIAL,23800,0,23800,80200,0,104000
132525502300000,NW 329,RESIDENTIAL,22000,0,22000,73300,0,95300
132525502400000,NW 329,RESIDENTIAL,18900,0,18900,86600,0,105500
132525502500000,NW 329,RESIDENTIAL,18300,0,18300,70900,0,89200
132525502600000,NW 329,RESIDENTIAL,18900,0,18900,88400,0,107300
132525502700000,NW 329,RESIDENTIAL,20200,0,20200,87900,0,108100
132525502800000,NW 329,RESIDENTIAL,18900,0,18900,76700,0,95600
132525502900000,NW 329,RESIDENTIAL,18300,0,18300,71100,0,89400
132525503000000,NW 329,RESIDENTIAL,18900,0,18900,85500,0,104400
132525503100000,NW 329,RESIDENTIAL,20200,0,20200,93900,0,114100
132525503200000,NW 329,RESIDENTIAL,18900,0,18900,76300,0,95200
132525503300000,NW 329,RESIDENTIAL,18900,0,18900,80200,0,99100
132525503400000,NW 329,RESIDENTIAL,18900,0,18900,91100,0,110000
132525600100000,NW 329,RESIDENTIAL,28300,0,28300,93100,0,121400
132525600200000,NW 329,RESIDENTIAL,29700,0,29700,86400,0,116100
132525600300000,NW 329,RESIDENTIAL,25300,0,25300,82800,0,108100
132525600400000,NW 329,RESIDENTIAL,25600,0,25600,83800,0,109400
132525600500000,NW 329,RESIDENTIAL,25900,0,25900,81400,0,107300
132525600600000,NW 329,RESIDENTIAL,23900,0,23900,72000,0,95900
132525600700000,NW 329,RESIDENTIAL,25600,0,25600,81500,0,107100
132525600800000,NW 329,RESIDENTIAL,23900,0,23900,78700,0,102600
132525600900000,NW 329,RESIDENTIAL,25200,0,25200,92400,0,117600
132525601000000,NW 329,RESIDENTIAL,27100,0,27100,89800,0,116900
132525601100000,NW 329,RESIDENTIAL,26300,0,26300,96500,0,122800
132525601200000,NW 329,RESIDENTIAL,24900,0,24900,79700,0,104600
132525601300000,NW 329,RESIDENTIAL,27900,0,27900,85600,0,113500
132525601400000,NW 329,RESIDENTIAL,24500,0,24500,73700,0,98200
132525601500000,NW 329,RESIDENTIAL,23800,0,23800,81400,0,105200
132525601600000,NW 329,RESIDENTIAL,26000,0,26000,85900,0,111900
132525601700000,NW 329,RESIDENTIAL,23200,0,23200,91600,0,114800
132525601800000,NW 329,EXEMPT,0,23800,23800,0,105500,129300
132525601900000,NW 329,RESIDENTIAL,25600,0,25600,87800,0,113400
132525602000000,NW 329,RESIDENTIAL,22800,0,22800,84900,0,107700
132525602100000,NW 329,RESIDENTIAL,23900,0,23900,79100,0,103000
132525602200000,NW 329,RESIDENTIAL,25600,0,25600,88900,0,114500
132525602300000,NW 329,RESIDENTIAL,24100,0,24100,78700,0,102800
132525602400000,NW 329,RESIDENTIAL,24900,0,24900,81100,0,106000
132525700100000,NW 329,RESIDENTIAL,29400,0,29400,95200,0,124600
132525700200000,NW 329,RESIDENTIAL,32600,0,32600,105100,0,137700
132525700300000,NW 329,RESIDENTIAL,24000,0,24000,93000,0,117000
132525700400000,NW 329,RESIDENTIAL,24800,0,24800,95900,0,120700
132525700500000,NW 329,RESIDENTIAL,24100,0,24100,82500,0,106600
132525700600000,NW 329,RESIDENTIAL,23900,0,23900,83700,0,107600
132525700700000,NW 329,RESIDENTIAL,24500,0,24500,101000,0,125500
132525700800000,NW 329,RESIDENTIAL,26200,0,26200,75800,0,102000
132525700900000,NW 329,RESIDENTIAL,22600,0,22600,91600,0,114200
132525701000000,NW 329,RESIDENTIAL,23700,0,23700,100700,0,124400
132525701100000,NW 329,RESIDENTIAL,23300,0,23300,71800,0,95100
132525701200000,NW 329,RESIDENTIAL,22900,0,22900,74900,0,97800
132525701300000,NW 329,RESIDENTIAL,24100,0,24100,81300,0,105400
132525701400000,NW 329,RESIDENTIAL,23200,0,23200,87400,0,110600
132525701500000,NW 329,RESIDENTIAL,23800,0,23800,82200,0,106000
132525701600000,NW 329,RESIDENTIAL,23100,0,23100,100500,0,123600
132525800100000,CITY PROPERTY,EXEMPT,0,0,0,0,0,0
132525900100000,NW 329,RESIDENTIAL,29600,0,29600,89300,0,118900
132527600100000,NW 327,RESIDENTIAL,28900,0,28900,93300,0,122200
132527600200000,NW 327,RESIDENTIAL,26400,0,26400,96200,0,122600
132527600300000,NW 327,RESIDENTIAL,26400,0,26400,99600,0,126000
132527600400000,NW 327,RESIDENTIAL,26700,0,26700,98000,0,124700
132527600500000,NW 327,RESIDENTIAL,26700,0,26700,99100,0,125800
132527600600000,NW 327,RESIDENTIAL,26700,0,26700,93700,0,120400
132527600700000,NW 327,RESIDENTIAL,26700,0,26700,93300,0,120000
132527600800000,NW 327,RESIDENTIAL,26700,0,26700,89200,0,115900
132527600900000,NW 327,RESIDENTIAL,26400,0,26400,106700,0,133100
132527601000000,CITY PROPERTY,EXEMPT,0,0,0,0,0,0
132527601100000,APARTMENT,MULTI-RES,25400,0,25400,129700,0,155100
132527700100000,NW 327,RESIDENTIAL,27700,0,27700,83600,0,111300
132527700200000,NW 327,RESIDENTIAL,22600,0,22600,89600,0,112200
132527700300000,NW 327,RESIDENTIAL,24500,0,24500,101400,0,125900
132527700400000,NW 327,RESIDENTIAL,23800,0,23800,104900,0,128700
132527700500000,NW 327,RESIDENTIAL,24500,0,24500,103900,0,128400
132527700600000,NW 327,RESIDENTIAL,24500,0,24500,106900,0,131400
132527700700000,NW 327,RESIDENTIAL,24500,0,24500,107800,0,132300
132527700800000,NW 327,RESIDENTIAL,24500,0,24500,96600,0,121100
132527700900000,NW 327,RESIDENTIAL,24500,0,24500,96500,0,121000
132527701000000,NW 327,RESIDENTIAL,24500,0,24500,82800,0,107300
132527800100000,NW 327,RESIDENTIAL,21000,0,21000,104600,0,125600
132527800200000,NW 327,RESIDENTIAL,21000,0,21000,94000,0,115000
132527800300000,NW 327,RESIDENTIAL,21000,0,21000,110200,0,131200
132527800400000,NW 327,RESIDENTIAL,21000,0,21000,66100,0,87100
132527800500000,NW 327,RESIDENTIAL,21000,0,21000,82200,0,103200
132527800600000,NW 327,RESIDENTIAL,21000,0,21000,71100,0,92100
132527900100000,NW 327,RESIDENTIAL,28000,0,28000,104400,0,132400
132527900200000,NW 327,RESIDENTIAL,24500,0,24500,90100,0,114600
132527900300000,NW 327,RESIDENTIAL,22600,0,22600,111100,0,133700
132527900400000,NW 327,RESIDENTIAL,22400,0,22400,89800,0,112200
132527900500000,NW 327,RESIDENTIAL,21700,0,21700,101800,0,123500
132527900600000,NW 327,RESIDENTIAL,22400,0,22400,88500,0,110900
132527900700000,NW 327,RESIDENTIAL,21700,0,21700,107000,0,128700
132527900800000,NW 327,RESIDENTIAL,22400,0,22400,106000,0,128400
132527900900000,NW 327,RESIDENTIAL,24200,0,24200,102900,0,127100
132527901000000,NW 327,RESIDENTIAL,27900,0,27900,98400,0,126300
132527901100000,NW 327,RESIDENTIAL,25600,0,25600,91400,0,117000
132527901200000,NW 327,RESIDENTIAL,24800,0,24800,92700,0,117500
132527901300000,NW 327,RESIDENTIAL,25600,0,25600,96700,0,122300
132527901400000,NW 327,RESIDENTIAL,24800,0,24800,100500,0,125300
132527901500000,NW 327,RESIDENTIAL,25600,0,25600,115200,0,140800
132527901600000,NW 327,RESIDENTIAL,25500,0,25500,86100,0,111600
132528000100000,NW 327,RESIDENTIAL,24500,0,24500,87600,0,112100
132528000200000,NW 327,RESIDENTIAL,24500,0,24500,107500,0,132000
132528000300000,NW 327,RESIDENTIAL,21900,0,21900,115500,0,137400
132528000400000,NW 327,RESIDENTIAL,22400,0,22400,102900,0,125300
132528000500000,NW 327,RESIDENTIAL,22400,0,22400,97300,0,119700
132528000600000,NW 327,RESIDENTIAL,22400,0,22400,89200,0,111600
132528000700000,NW 327,RESIDENTIAL,22400,0,22400,107300,0,129700
132528000800000,NW 327,RESIDENTIAL,22400,0,22400,104100,0,126500
132528000900000,NW 327,RESIDENTIAL,22400,0,22400,89600,0,112000
132528001000000,NW 327,RESIDENTIAL,22300,0,22300,94700,0,117000
132528001100000,NW 327,RESIDENTIAL,22500,0,22500,113200,0,135700
132528001200000,NW 327,RESIDENTIAL,22400,0,22400,101400,0,123800
132528001300000,NW 327,RESIDENTIAL,22400,0,22400,101100,0,123500
132528001400000,NW 327,RESIDENTIAL,22400,0,22400,100700,0,123100
132528001500000,NW 327,RESIDENTIAL,22400,0,22400,99700,0,122100
132528001600000,NW 327,RESIDENTIAL,22400,0,22400,91200,0,113600
132528001700000,NW 327,RESIDENTIAL,22400,0,22400,91200,0,113600
132528001800000,NW 327,RESIDENTIAL,21700,0,21700,109600,0,131300
132528100100000,NW 327,RESIDENTIAL,24500,0,24500,97500,0,122000
132528100200000,NW 327,RESIDENTIAL,24500,0,24500,109700,0,134200
132528100300000,NW 327,RESIDENTIAL,22000,0,22000,102100,0,124100
132528100400000,NW 327,RESIDENTIAL,22400,0,22400,103400,0,125800
132528100500000,NW 327,RESIDENTIAL,22400,0,22400,0,0,22400
132528100600000,NW 327,RESIDENTIAL,22400,0,22400,108800,0,131200
132528100700000,NW 327,RESIDENTIAL,22400,0,22400,88800,0,111200
132528100800000,NW 327,RESIDENTIAL,22400,0,22400,103100,0,125500
132528100900000,NW 327,RESIDENTIAL,24400,0,24400,91800,0,116200
132528101000000,NW 327,RESIDENTIAL,24600,0,24600,100000,0,124600
132528101100000,NW 327,RESIDENTIAL,22400,0,22400,81600,0,104000
132528101200000,NW 327,RESIDENTIAL,22400,0,22400,107800,0,130200
132528101300000,NW 327,RESIDENTIAL,21700,0,21700,94200,0,115900
132528101400000,NW 327,RESIDENTIAL,22400,0,22400,115100,0,137500
132528101500000,NW 327,RESIDENTIAL,22400,0,22400,93200,0,115600
132528101600000,NW 327,RESIDENTIAL,21800,0,21800,87500,0,109300
132528200100000,NW 327,RESIDENTIAL,24500,0,24500,59300,0,83800
132528200200000,NW 327,RESIDENTIAL,24500,0,24500,93100,0,117600
132528200300000,NW 327,RESIDENTIAL,22300,0,22300,92600,0,114900
132528200400000,NW 327,RESIDENTIAL,22400,0,22400,99600,0,122000
132528200500000,NW 327,RESIDENTIAL,22400,0,22400,115600,0,138000
132528200600000,NW 327,RESIDENTIAL,22400,0,22400,96100,0,118500
132528200700000,NW 327,RESIDENTIAL,22400,0,22400,110200,0,132600
132528200800000,NW 327,RESIDENTIAL,22600,0,22600,110600,0,133200
132528200900000,NW 327,RESIDENTIAL,22600,0,22600,83100,0,105700
132528201000000,NW 327,RESIDENTIAL,22600,0,22600,92400,0,115000
132528201100000,NW 327,RESIDENTIAL,22600,0,22600,83600,0,106200
132528201200000,NW 327,RESIDENTIAL,22600,0,22600,85300,0,107900
132528201300000,NW 327,RESIDENTIAL,24600,0,24600,89300,0,113900
132528201400000,NW 327,RESIDENTIAL,22400,0,22400,89600,0,112000
132528201500000,NW 327,RESIDENTIAL,24600,0,24600,104600,0,129200
132528201600000,NW 327,RESIDENTIAL,22800,0,22800,99600,0,122400
132528201700000,NW 327,RESIDENTIAL,22600,0,22600,97300,0,119900
132528201800000,NW 327,RESIDENTIAL,22600,0,22600,83800,0,106400
132528201900000,NW 327,RESIDENTIAL,22600,0,22600,84400,0,107000
132528202000000,NW 327,RESIDENTIAL,22600,0,22600,90800,0,113400
132528202100000,NW 327,RESIDENTIAL,22400,0,22400,105700,0,128100
132528202200000,NW 327,RESIDENTIAL,22400,0,22400,88300,0,110700
132528202300000,NW 327,RESIDENTIAL,22400,0,22400,96900,0,119300
132528202400000,NW 327,RESIDENTIAL,22400,0,22400,92900,0,115300
132528202500000,NW 327,RESIDENTIAL,22000,0,22000,87500,0,109500
132528300100000,NW 327,RESIDENTIAL,24500,0,24500,104900,0,129400
132528300200000,NW 327,RESIDENTIAL,22500,0,22500,91000,0,113500
132528300300000,NW 327,RESIDENTIAL,21700,0,21700,112500,0,134200
132528300400000,NW 327,RESIDENTIAL,22400,0,22400,103700,0,126100
132528300500000,NW 327,RESIDENTIAL,22400,0,22400,99900,0,122300
132528300600000,NW 327,RESIDENTIAL,22400,0,22400,86400,0,108800
132528300700000,NW 327,RESIDENTIAL,22400,0,22400,111700,0,134100
132528300800000,NW 327,RESIDENTIAL,22400,0,22400,92400,0,114800
132528300900000,NW 327,RESIDENTIAL,22400,0,22400,81900,0,104300
132528301000000,NW 327,RESIDENTIAL,22400,0,22400,84600,0,107000
132528301100000,NW 327,RESIDENTIAL,22400,0,22400,93600,0,116000
132528301200000,NW 327,RESIDENTIAL,22400,0,22400,69600,0,92000
132528301300000,NW 327,RESIDENTIAL,25000,0,25000,63800,0,88800
132528400100000,CITY PROPERTY,EXEMPT,0,0,0,0,0,0
132528400200000,CITY PROPERTY,EXEMPT,0,0,0,0,0,0
132528400300000,CHURCH,EXEMPT,0,404800,404800,0,613600,1018400
132528500100000,CITY PROPERTY,EXEMPT,0,0,0,0,0,0
132528600100000,NW 327,RESIDENTIAL,22000,0,22000,111600,0,133600
132528600200000,NW 327,RESIDENTIAL,24400,0,24400,100700,0,125100
132528600300000,NW 327,RESIDENTIAL,21700,0,21700,90100,0,111800
132528600400000,NW 327,RESIDENTIAL,21700,0,21700,88700,0,110400
132528600500000,NW 327,RESIDENTIAL,25500,0,25500,90700,0,116200
132528600600000,CITY PROPERTY,EXEMPT,0,0,0,0,0,0
132528700100000,CITY PROPERTY,EXEMPT,0,0,0,0,0,0
132528700200000,CITY PROPERTY,EXEMPT,0,0,0,0,0,0
132530100100000,NW 329,EXEMPT,0,37200,37200,0,107100,144300
132530100200000,NW 329,RESIDENTIAL,57900,0,57900,119800,0,177700
132530100300000,NW 329,RESIDENTIAL,52400,0,52400,105300,0,157700
132530100400000,NW 329,RESIDENTIAL,58600,0,58600,0,0,58600
132530100500000,APARTMENT,MULTI-RES,33600,0,33600,349400,0,383000
132530100600000,NW 329,RESIDENTIAL,33900,0,33900,202000,0,235900
132530200100000,NW 329,AG DWELLING,1000,0,1000,136000,22400,159400
132530200200000,NW 344,RESIDENTIAL,50100,0,50100,165300,0,215400
132530200300000,NW 344,RESIDENTIAL,46600,0,46600,237300,0,283900
132530200400000,NW 344,RESIDENTIAL,46400,0,46400,205200,0,251600
132530200500000,NW 344,RESIDENTIAL,48200,0,48200,204100,0,252300
132530200600000,NW 344,RESIDENTIAL,46700,0,46700,255300,0,302000
132530200700000,NW 344,RESIDENTIAL,46100,0,46100,259300,0,305400
132530200800000,NW 344,RESIDENTIAL,45800,0,45800,224900,0,270700
132530200900000,NW 344,RESIDENTIAL,45800,0,45800,198700,0,244500
132530201000000,NW 344,RESIDENTIAL,46600,0,46600,193100,0,239700
132530201100000,NW 344,RESIDENTIAL,47000,0,47000,224700,0,271700
132530201200000,NW 344,RESIDENTIAL,50900,0,50900,198500,0,249400
132530300100000,NW 344,RESIDENTIAL,48700,0,48700,265000,0,313700
132530300200000,CITY PROPERTY,EXEMPT,0,0,0,0,0,0
132530300300000,NW 344,RESIDENTIAL,51300,0,51300,100800,0,152100
132530300500000,NW 344,RESIDENTIAL,44300,0,44300,217100,0,261400
132530300600000,NW 344,RESIDENTIAL,46600,0,46600,209200,0,255800
132530300700000,NW 344,RESIDENTIAL,45800,0,45800,228900,0,274700
132530300800000,NW 344,RESIDENTIAL,45800,0,45800,224500,0,270300
132530300900000,NW 344,RESIDENTIAL,47700,0,47700,208300,0,256000
132530400100000,NW 344,RESIDENTIAL,50100,0,50100,223600,0,273700
132530400200000,NW 344,RESIDENTIAL,45000,0,45000,201500,0,246500
132530400300000,NW 344,RESIDENTIAL,46300,0,46300,193700,0,240000
132530400400000,NW 344,RESIDENTIAL,44000,0,44000,206700,0,250700
132530400500000,NW 344,RESIDENTIAL,47000,0,47000,221000,0,268000
132530400600000,NW 344,RESIDENTIAL,44000,0,44000,187800,0,231800
132530400700000,NW 344,RESIDENTIAL,45600,0,45600,200300,0,245900
132530400800000,NW 344,RESIDENTIAL,46600,0,46600,239400,0,286000
132530400900000,NW 344,RESIDENTIAL,51900,0,51900,299300,0,351200
132530401000000,NW 344,RESIDENTIAL,47700,0,47700,189400,0,237100
132530401200000,NW 344,RESIDENTIAL,48600,0,48600,208700,0,257300
132530401300000,NW 344,RESIDENTIAL,44600,0,44600,248500,0,293100
132530401400000,NW 344,RESIDENTIAL,46800,0,46800,200100,0,246900
132530401500000,NW 344,RESIDENTIAL,46800,0,46800,238300,0,285100
132530401600000,NW 344,RESIDENTIAL,46800,0,46800,173900,0,220700
132530401700000,NW 344,RESIDENTIAL,46800,0,46800,231500,0,278300
132530401800000,NW 344,RESIDENTIAL,46400,0,46400,204900,0,251300
132530401900000,NW 344,RESIDENTIAL,50900,0,50900,224900,0,275800
132530402000000,NW 344,RESIDENTIAL,52400,0,52400,242200,0,294600
132530402100000,NW 344,RESIDENTIAL,50300,0,50300,238300,0,288600
132530402200000,NW 344,RESIDENTIAL,50900,0,50900,213600,0,264500
132530402400000,NW 344,RESIDENTIAL,46800,0,46800,219700,0,266500
132530402500000,NW 344,RESIDENTIAL,46800,0,46800,186600,0,233400
132530402600000,NW 344,RESIDENTIAL,44000,0,44000,199800,0,243800
132530402700000,NW 344,RESIDENTIAL,46800,0,46800,208500,0,255300
132530402800000,NW 344,RESIDENTIAL,46800,0,46800,223500,0,270300
132530402900000,NW 344,RESIDENTIAL,44000,0,44000,205300,0,249300
132530403000000,NW 344,RESIDENTIAL,46800,0,46800,237600,0,284400
132530403100000,NW 344,RESIDENTIAL,48400,0,48400,227500,0,275900
132530403200000,NW 344,RESIDENTIAL,51300,0,51300,223300,0,274600
132530403300000,NW 344,RESIDENTIAL,53300,0,53300,223300,0,276600
132530403400000,NW 344,RESIDENTIAL,55600,0,55600,218300,0,273900
132530403500000,NW 344,RESIDENTIAL,52500,0,52500,199400,0,251900
132530403600000,NW 344,RESIDENTIAL,51400,0,51400,185600,0,237000
132530403700000,NW 344,RESIDENTIAL,48600,0,48600,186400,0,235000
132532600100000,APARTMENT,MULTI-RES,78500,0,78500,1130900,0,1209400
132532600200000,BRANCH BANK/CU,COMMERCIAL,0,77800,77800,0,223100,300900
132532600300000,NBHD SHOPPING CENTER,COMMERCIAL,0,164800,164800,0,355600,520400
132532600400000,NBHD SHOPPING CENTER,COMMERCIAL,0,257900,257900,0,416800,674700
132532600500000,AUTO REPAIR/SALES,COMMERCIAL,0,50000,50000,0,52500,102500
132532700100000,NW 329,RESIDENTIAL,35300,0,35300,91200,0,126500
132532700200000,CITY PROPERTY,EXEMPT,0,0,0,0,0,0
132532700300000,NW 329,RESIDENTIAL,28400,0,28400,111000,0,139400
132532700400000,NW 329,RESIDENTIAL,28300,0,28300,126300,0,154600
132532700500000,NW 329,RESIDENTIAL,28300,0,28300,137800,0,166100
132532700600000,NW 329,RESIDENTIAL,28700,0,28700,111900,0,140600
132532700700000,NW 329,RESIDENTIAL,26300,0,26300,119100,0,145400
132532700800000,NW 329,RESIDENTIAL,26300,0,26300,120800,0,147100
132532700900000,NW 329,RESIDENTIAL,26300,0,26300,197000,0,223300
132532701200000,DAY CARE CENTER,COMMERCIAL,0,58500,58500,0,219800,278300
132532701300000,NW 340,RESIDENTIAL,34000,0,34000,131800,0,165800
132532701400000,NW 340,RESIDENTIAL,32400,0,32400,119000,0,151400
132532701500000,NW 340,RESIDENTIAL,29500,0,29500,124000,0,153500
132532701600000,NW 340,RESIDENTIAL,31200,0,31200,121100,0,152300
132532701700000,NW 340,RESIDENTIAL,28200,0,28200,141100,0,169300
132532701800000,NW 340,RESIDENTIAL,28700,0,28700,140500,0,169200
132532701900000,NW 340,RESIDENTIAL,30200,0,30200,125800,0,156000
132532702000000,NW 340,RESIDENTIAL,30200,0,30200,128900,0,159100
132532702100000,NW 340,RESIDENTIAL,34300,0,34300,147700,0,182000
132532702200000,NW 340,RESIDENTIAL,31500,0,31500,139700,0,171200
132532702300000,NW 340,RESIDENTIAL,27600,0,27600,131600,0,159200
132532702400000,NW 340,RESIDENTIAL,32500,0,32500,118800,0,151300
132532702600000,OFFICE; MEDICAL,COMMERCIAL,0,127500,127500,0,602600,730100
132532702700000,CONVENIENCE STORE,COMMERCIAL,0,72000,72000,0,234100,306100
132532702800000,RESTAURANT,COMMERCIAL,0,62400,62400,0,95100,157500
132532702900000,VACANT LAND,EXEMPT,0,13100,13100,0,0,13100
132532703200000,NW 329,RESIDENTIAL,36300,0,36300,47100,0,83400
132532703300000,NW 329,RESIDENTIAL,35300,0,35300,84700,0,120000
132532703400000,NW 329,RESIDENTIAL,35300,0,35300,98400,0,133700
132532703500000,OFFICE,COMMERCIAL,0,30000,30000,0,39200,69200
132532703600000,NW 329,EXEMPT,0,212200,212200,0,551600,763800
132532800100000,NW 329,RESIDENTIAL,27300,0,27300,111100,0,138400
132532800200000,NW 329,RESIDENTIAL,27200,0,27200,112800,0,140000
132532800300000,NW 329,RESIDENTIAL,27200,0,27200,122500,0,149700
132532800400000,NW 329,RESIDENTIAL,27200,0,27200,120300,0,147500
132532800500000,NW 329,RESIDENTIAL,30000,0,30000,116100,0,146100
132532800600000,NW 329,RESIDENTIAL,30000,0,30000,130400,0,160400
132532900100000,NW 329,RESIDENTIAL,15700,0,15700,114600,0,130300
132532900200000,NW 329,RESIDENTIAL,12900,0,12900,110500,0,123400
132532900300000,APARTMENT,MULTI-RES,24200,0,24200,160100,0,184300
132532900400000,APARTMENT,RESIDENTIAL,24200,0,24200,141200,0,165400
132533000100000,SERVICE STATION,COMMERCIAL,0,103700,103700,0,65800,169500
132533000200000,WAREHOUSE;MINI STORG,COMMERCIAL,0,68900,68900,0,84200,153100
132533100200000,AUTO REPAIR/SALES,COMMERCIAL,0,160800,160800,0,223700,384500
132533100600000,WAREHOUSE,COMMERCIAL,0,112100,112100,0,193800,305900
132533100800000,WAREHOUSE,COMMERCIAL,0,96300,96300,0,184200,280500
132533101000000,LG DISCOUNT/RETAIL,COMMERCIAL,0,432500,432500,0,389600,822100
132533200400000,OFFICE,COMMERCIAL,26450,26450,52900,96100,96100,245100
132533200500000,NBHD SHOPPING CENTER,COMMERCIAL,0,48000,48000,0,227700,275700
132533200600000,SMALL RETAIL,COMMERCIAL,0,29700,29700,0,147300,177000
132533200700000,SHOP,COMMERCIAL,0,57600,57600,0,107500,165100
132533200800000,SECTION 42,COMMERCIAL,0,20000,20000,0,29000,49000
132533200900000,APARTMENT,EXEMPT,0,35600,35600,0,281000,316600
132535100400000,APARTMENT,MULTI-RES,217600,0,217600,2125200,0,2342800
132535100500000,CITY PROPERTY,EXEMPT,0,0,0,0,0,0
132535200200000,APARTMENT,RESIDENTIAL,483100,0,483100,3303500,0,3786600
132535200300000,APARTMENT,RESIDENTIAL,379200,0,379200,2441400,0,2820600
132535200500000,FITNESS CENTER,COMMERCIAL,0,577800,577800,0,712600,1290400
132537600200000,NW 344,RESIDENTIAL,1600,0,1600,0,0,1600
132537700100000,CITY PROPERTY,EXEMPT,0,0,0,0,0,0
132537700201000,OFFICE,COMMERCIAL,0,34600,34600,0,156500,191100
132537700201001,OFFICE,COMMERCIAL,0,34600,34600,0,156500,191100
132537700201002,OFFICE; MEDICAL,COMMERCIAL,0,30900,30900,0,177700,208600
132537700201003,OFFICE,COMMERCIAL,0,34600,34600,0,156500,191100
132537700201004,OFFICE,COMMERCIAL,0,34600,34600,0,156500,191100
132537700300000,APARTMENT,MULTI-RES,450000,0,450000,3264400,0,3714400
132537800100000,GROCERY STORE,COMMERCIAL,0,776200,776200,0,773800,1550000
132537800200000,VACANT LAND,COMMERCIAL,0,60400,60400,0,0,60400
132537800300000,VACANT LAND,COMMERCIAL,0,423300,423300,0,0,423300
132537800400000,NBHD SHOPPING CENTER,COMMERCIAL,0,362900,362900,0,988300,1351200
132540100100000,NW 333,RESIDENTIAL,28800,0,28800,124800,0,153600
132540100200000,NW 333,RESIDENTIAL,28700,0,28700,161400,0,190100
132540100300000,NW 333,RESIDENTIAL,29900,0,29900,143100,0,173000
132540100400000,NW 333,RESIDENTIAL,31200,0,31200,135900,0,167100
132540100500000,NW 333,RESIDENTIAL,31800,0,31800,118100,0,149900
132540100600000,NW 333,RESIDENTIAL,31800,0,31800,149200,0,181000
132540100700000,NW 333,RESIDENTIAL,31800,0,31800,97500,0,129300
132540100800000,NW 333,RESIDENTIAL,31800,0,31800,137600,0,169400
132540100900000,NW 333,RESIDENTIAL,31800,0,31800,103600,0,135400
132540101000000,NW 333,RESIDENTIAL,32500,0,32500,125200,0,157700
132540200100000,NW 333,RESIDENTIAL,44300,0,44300,154300,0,198600
132540200200000,NW 333,RESIDENTIAL,43600,0,43600,142000,0,185600
132540200300000,NW 333,RESIDENTIAL,34100,0,34100,116400,0,150500
132540200400000,NW 333,RESIDENTIAL,33100,0,33100,145800,0,178900
132540200500000,NW 333,RESIDENTIAL,35600,0,35600,157300,0,192900
132540200600000,NW 333,RESIDENTIAL,38200,0,38200,114800,0,153000
132540200700000,NW 333,RESIDENTIAL,35900,0,35900,96300,0,132200
132540300100000,NW 333,RESIDENTIAL,32100,0,32100,109100,0,141200
132540300200000,NW 333,RESIDENTIAL,34500,0,34500,99400,0,133900
132540300300000,NW 333,RESIDENTIAL,33700,0,33700,117700,0,151400
132540300400000,NW 333,RESIDENTIAL,33100,0,33100,100300,0,133400
132540300500000,NW 333,RESIDENTIAL,33100,0,33100,112200,0,145300
132540300600000,NW 333,RESIDENTIAL,33100,0,33100,112600,0,145700
132540300700000,NW 333,RESIDENTIAL,33100,0,33100,98500,0,131600
132540300800000,NW 333,RESIDENTIAL,33100,0,33100,89300,0,122400
132540300900000,NW 333,RESIDENTIAL,33100,0,33100,163500,0,196600
132540301000000,NW 333,RESIDENTIAL,33100,0,33100,0,0,33100
132540301100000,NW 333,RESIDENTIAL,34600,0,34600,121600,0,156200
132540301200000,NW 333,RESIDENTIAL,34400,0,34400,106100,0,140500
132540301300000,NW 333,RESIDENTIAL,34400,0,34400,113700,0,148100
132540301400000,NW 333,RESIDENTIAL,44700,0,44700,120100,0,164800
132540301500000,NW 333,RESIDENTIAL,35200,0,35200,92300,0,127500
132540301600000,NW 333,RESIDENTIAL,31300,0,31300,94700,0,126000
132540301700000,NW 333,RESIDENTIAL,29000,0,29000,130400,0,159400
132540301800000,NW 333,RESIDENTIAL,28900,0,28900,104100,0,133000
132540301900000,NW 333,RESIDENTIAL,28700,0,28700,110700,0,139400
132540302000000,NW 333,RESIDENTIAL,28700,0,28700,115500,0,144200
132540302100000,NW 333,RESIDENTIAL,28700,0,28700,117400,0,146100
132540302200000,NW 333,RESIDENTIAL,28700,0,28700,102100,0,130800
132540302300000,NW 333,RESIDENTIAL,28700,0,28700,127900,0,156600
132540302400000,NW 333,RESIDENTIAL,28700,0,28700,137600,0,166300
132540302500000,NW 333,RESIDENTIAL,28700,0,28700,124800,0,153500
132540302600000,NW 333,RESIDENTIAL,29700,0,29700,105200,0,134900
132540302700000,NW 333,RESIDENTIAL,40900,0,40900,148600,0,189500
132540302800000,NW 333,RESIDENTIAL,28700,0,28700,114200,0,142900
132540302900000,NW 333,RESIDENTIAL,28700,0,28700,96900,0,125600
132540303000000,NW 333,RESIDENTIAL,28700,0,28700,100000,0,128700
132540303100000,NW 333,RESIDENTIAL,30100,0,30100,120200,0,150300
132540303200000,SCHOOL,EXEMPT,0,603400,603400,0,1055400,1658800
132540303300000,SCHOOL,EXEMPT,0,1470000,1470000,0,2479800,3949800
132540303400000,NW 333,RESIDENTIAL,28600,0,28600,122000,0,150600
132540303500000,NW 333,RESIDENTIAL,28600,0,28600,119000,0,147600
132542600100000,NW 333,RESIDENTIAL,35900,0,35900,130800,0,166700
132542600200000,NW 333,RESIDENTIAL,38400,0,38400,97100,0,135500
132542600300000,NW 333,RESIDENTIAL,38500,0,38500,107200,0,145700
132542600400000,NW 333,RESIDENTIAL,41400,0,41400,111100,0,152500
132542600500000,NW 333,RESIDENTIAL,41400,0,41400,120300,0,161700
132542600600000,NW 333,RESIDENTIAL,33300,0,33300,133200,0,166500
132542600700000,NW 333,RESIDENTIAL,37600,0,37600,132200,0,169800
132542600800000,NW 333,RESIDENTIAL,41000,0,41000,131900,0,172900
132542600900000,NW 333,RESIDENTIAL,38300,0,38300,113000,0,151300
132542601000000,NW 333,RESIDENTIAL,40100,0,40100,111900,0,152000
132542601100000,NW 333,RESIDENTIAL,34300,0,34300,129100,0,163400
132542601200000,NW 333,RESIDENTIAL,31500,0,31500,131200,0,162700
132542601300000,NW 333,RESIDENTIAL,36300,0,36300,115500,0,151800
132542601400000,NW 333,RESIDENTIAL,30900,0,30900,110500,0,141400
132542601500000,NW 333,RESIDENTIAL,30600,0,30600,107400,0,138000
132542601600000,NW 333,RESIDENTIAL,31300,0,31300,103900,0,135200
132542601700000,NW 333,RESIDENTIAL,36600,0,36600,105700,0,142300
132542601800000,NW 333,RESIDENTIAL,31100,0,31100,146700,0,177800
132542601900000,NW 333,RESIDENTIAL,36400,0,36400,133800,0,170200
132542602000000,NW 333,RESIDENTIAL,34300,0,34300,130800,0,165100
132542602100000,NW 333,RESIDENTIAL,36300,0,36300,125200,0,161500
132542602200000,NW 333,RESIDENTIAL,31400,0,31400,131500,0,162900
132542602300000,NW 333,RESIDENTIAL,34900,0,34900,113900,0,148800
132542602400000,NW 333,RESIDENTIAL,40400,0,40400,129600,0,170000
132542602500000,NW 333,RESIDENTIAL,41200,0,41200,127500,0,168700
132542602600000,NW 333,RESIDENTIAL,38700,0,38700,121500,0,160200
132542602700000,NW 333,RESIDENTIAL,33000,0,33000,132000,0,165000
132542602800000,NW 333,RESIDENTIAL,32100,0,32100,133400,0,165500
132542602900000,NW 333,RESIDENTIAL,33000,0,33000,141900,0,174900
132542603000000,NW 333,RESIDENTIAL,31900,0,31900,136900,0,168800
132542603100000,NW 333,RESIDENTIAL,39400,0,39400,142900,0,182300
132542603200000,NW 333,RESIDENTIAL,39700,0,39700,116600,0,156300
132542603300000,NW 333,RESIDENTIAL,38100,0,38100,137500,0,175600
132542603400000,NW 333,RESIDENTIAL,35900,0,35900,127400,0,163300
132542603500000,NW 333,RESIDENTIAL,38900,0,38900,158500,0,197400
132542603600000,NW 333,RESIDENTIAL,38900,0,38900,134500,0,173400
132542603700000,NW 333,RESIDENTIAL,38400,0,38400,148800,0,187200
132542603800000,NW 333,RESIDENTIAL,39400,0,39400,123600,0,163000
132542603900000,SCHOOL,EXEMPT,0,0,0,0,0,0
132542700100000,NW 333,RESIDENTIAL,36400,0,36400,121700,0,158100
132542700200000,NW 333,RESIDENTIAL,31100,0,31100,100900,0,132000
132542700300000,NW 333,RESIDENTIAL,31000,0,31000,142500,0,173500
132542700400000,NW 333,RESIDENTIAL,38200,0,38200,120700,0,158900
132542700500000,NW 333,RESIDENTIAL,38200,0,38200,125300,0,163500
132542700600000,NW 333,RESIDENTIAL,39400,0,39400,101800,0,141200
132542700700000,NW 333,RESIDENTIAL,37500,0,37500,130900,0,168400
132542700800000,NW 333,RESIDENTIAL,34500,0,34500,114900,0,149400
132542700900000,NW 333,RESIDENTIAL,37600,0,37600,144000,0,181600
132542701000000,NW 333,RESIDENTIAL,37100,0,37100,121400,0,158500
132542701100000,NW 333,RESIDENTIAL,40800,0,40800,127700,0,168500
132542701200000,NW 333,RESIDENTIAL,33700,0,33700,133400,0,167100
132542701300000,NW 333,RESIDENTIAL,40000,0,40000,110900,0,150900
132542701400000,NW 333,RESIDENTIAL,37600,0,37600,125500,0,163100
132542701500000,NW 333,RESIDENTIAL,39000,0,39000,111800,0,150800
132542701600000,NW 333,RESIDENTIAL,40800,0,40800,139600,0,180400
132542701700000,NW 333,RESIDENTIAL,36500,0,36500,126300,0,162800
132542701800000,NW 333,RESIDENTIAL,37600,0,37600,137000,0,174600
132542701900000,NW 333,RESIDENTIAL,39000,0,39000,131900,0,170900
132542702000000,NW 333,RESIDENTIAL,40100,0,40100,135000,0,175100
132542702100000,NW 333,RESIDENTIAL,34300,0,34300,131300,0,165600
132542702200000,NW 333,RESIDENTIAL,34500,0,34500,136000,0,170500
132542702300000,NW 333,RESIDENTIAL,29900,0,29900,116400,0,146300
132542702400000,NW 333,RESIDENTIAL,32400,0,32400,136900,0,169300
132542702500000,NW 333,RESIDENTIAL,43200,0,43200,107100,0,150300
132542702600000,NW 333,RESIDENTIAL,35700,0,35700,123200,0,158900
132542702700000,NW 333,RESIDENTIAL,43000,0,43000,187900,0,230900
132542702800000,NW 333,RESIDENTIAL,43300,0,43300,172300,0,215600
132542702900000,NW 333,RESIDENTIAL,36600,0,36600,142500,0,179100
132542703000000,NW 333,RESIDENTIAL,35700,0,35700,125500,0,161200
132542703200000,NW 333,RESIDENTIAL,41800,0,41800,147100,0,188900
132542703300000,NW 333,RESIDENTIAL,29900,0,29900,113600,0,143500
132542703400000,NW 333,RESIDENTIAL,4400,0,4400,0,0,4400
132542703500000,NW 333,RESIDENTIAL,1100,0,1100,0,0,1100
132542703600000,NW 333,RESIDENTIAL,1400,0,1400,0,0,1400
132542703800000,NW 333,RESIDENTIAL,8000,0,8000,0,0,8000
132542703900000,NW 333,RESIDENTIAL,5700,0,5700,0,0,5700
132542704000000,NW 333,RESIDENTIAL,4900,0,4900,0,0,4900
132542704100000,NW 333,RESIDENTIAL,36600,0,36600,142300,0,178900
132542800100000,NW 333,RESIDENTIAL,40800,0,40800,130300,0,171100
132542800200000,NW 333,RESIDENTIAL,35700,0,35700,131700,0,167400
132542800300000,NW 333,RESIDENTIAL,34700,0,34700,115200,0,149900
132542800400000,NW 333,RESIDENTIAL,36500,0,36500,126500,0,163000
132542800500000,NW 333,RESIDENTIAL,42200,0,42200,118100,0,160300
132542800600000,NW 333,RESIDENTIAL,40000,0,40000,152700,0,192700
132542800700000,NW 333,RESIDENTIAL,38900,0,38900,142500,0,181400
132542800800000,NW 333,RESIDENTIAL,38900,0,38900,136700,0,175600
132542800900000,NW 333,RESIDENTIAL,37900,0,37900,132000,0,169900
132542801000000,NW 333,RESIDENTIAL,39100,0,39100,130800,0,169900
132542801100000,NW 333,RESIDENTIAL,30300,0,30300,135100,0,165400
132542801200000,NW 333,RESIDENTIAL,33700,0,33700,145200,0,178900
132542801300000,NW 333,RESIDENTIAL,35100,0,35100,267400,0,302500
132542801400000,NW 333,RESIDENTIAL,31200,0,31200,151400,0,182600
132542801500000,NW 333,RESIDENTIAL,32700,0,32700,194300,0,227000
132542801600000,NW 333,RESIDENTIAL,28400,0,28400,131100,0,159500
132542801700000,NW 333,RESIDENTIAL,32100,0,32100,162700,0,194800
132542801800000,NW 333,RESIDENTIAL,27700,0,27700,128500,0,156200
132545100100000,NW 333,RESIDENTIAL,31700,0,31700,209400,0,241100
132545100200000,NW 333,RESIDENTIAL,31700,0,31700,166000,0,197700
132545100300000,NW 333,RESIDENTIAL,29100,0,29100,126400,0,155500
132545100400000,NW 333,RESIDENTIAL,29100,0,29100,130700,0,159800
132545100500000,NW 333,RESIDENTIAL,29100,0,29100,111600,0,140700
132545100600000,NW 333,RESIDENTIAL,28900,0,28900,94600,0,123500
132545100700000,NW 333,RESIDENTIAL,28900,0,28900,103700,0,132600
132545200100000,SR/NURSING/ASSTD LIV,MULTI-RES,452400,0,452400,3600600,0,4053000
132545200200000,NW 333,RESIDENTIAL,29600,0,29600,119000,0,148600
132545200300000,NW 333,RESIDENTIAL,27800,0,27800,118200,0,146000
132545200400000,NW 333,RESIDENTIAL,27800,0,27800,85500,0,113300
132545200500000,NW 333,RESIDENTIAL,27800,0,27800,152500,0,180300
132545200600000,NW 333,RESIDENTIAL,27800,0,27800,134400,0,162200
132545200700000,NW 333,RESIDENTIAL,28300,0,28300,149400,0,177700
132545200800000,NW 333,RESIDENTIAL,27900,0,27900,138500,0,166400
132545200900000,NW 333,RESIDENTIAL,27800,0,27800,139200,0,167000
132545201000000,NW 333,RESIDENTIAL,27800,0,27800,104100,0,131900
132545201100000,NW 333,RESIDENTIAL,27500,0,27500,124600,0,152100
132545201200000,NW 333,RESIDENTIAL,31400,0,31400,135200,0,166600
132545201300000,NW 333,RESIDENTIAL,30700,0,30700,149800,0,180500
132545201400000,NW 333,RESIDENTIAL,31800,0,31800,153600,0,185400
132545201500000,NW 333,RESIDENTIAL,27500,0,27500,124700,0,152200
132545201600000,NW 333,RESIDENTIAL,27800,0,27800,137600,0,165400
132545201700000,NW 333,RESIDENTIAL,27800,0,27800,120900,0,148700
132545201800000,NW 333,RESIDENTIAL,28000,0,28000,133700,0,161700
132545201900000,VACANT LAND,COMMERCIAL,0,257500,257500,0,0,257500
132545300100000,NW 333,RESIDENTIAL,27300,0,27300,126600,0,153900
132545300200000,NW 333,RESIDENTIAL,30000,0,30000,113000,0,143000
132545300300000,NW 333,RESIDENTIAL,29200,0,29200,109800,0,139000
132545300400000,NW 333,RESIDENTIAL,29800,0,29800,114000,0,143800
132545400200000,APARTMENT,RESIDENTIAL,74200,0,74200,608300,0,682500
132545500100000,OFFICE,COMMERCIAL,0,592500,592500,0,3181300,3773800
132545500200000,OFFICE,COMMERCIAL,0,310400,310400,0,370500,680900
132545500300000,VACANT LAND,COMMERCIAL,0,20800,20800,0,0,20800
132545500400000,VACANT LAND,COMMERCIAL,0,30300,30300,0,0,30300
132545500500000,FLAT PARKING,COMMERCIAL,0,51500,51500,0,35700,87200
132547600100000,NW 333,RESIDENTIAL,27700,0,27700,96500,0,124200
132547600200000,NW 333,RESIDENTIAL,25500,0,25500,115200,0,140700
132547600300000,NW 333,RESIDENTIAL,25200,0,25200,87200,0,112400
132547600400000,NW 333,RESIDENTIAL,23000,0,23000,98300,0,121300
132547600500000,NW 333,RESIDENTIAL,23000,0,23000,102600,0,125600
132547600600000,NW 333,RESIDENTIAL,25500,0,25500,108100,0,133600
132547600700000,NW 333,RESIDENTIAL,27100,0,27100,138000,0,165100
132547600800000,NW 333,RESIDENTIAL,27500,0,27500,157500,0,185000
132547600900000,NW 333,RESIDENTIAL,25100,0,25100,128900,0,154000
132547601000000,NW 333,RESIDENTIAL,25100,0,25100,101700,0,126800
132547601100000,NW 333,RESIDENTIAL,25100,0,25100,87900,0,113000
132547601200000,NW 333,RESIDENTIAL,25100,0,25100,110700,0,135800
132547601300000,NW 333,RESIDENTIAL,25100,0,25100,104400,0,129500
132547601400000,APARTMENT,MULTI-RES,28200,0,28200,124400,0,152600
132547601500000,APARTMENT,MULTI-RES,24200,0,24200,180600,0,204800
132547601600000,APARTMENT,MULTI-RES,25200,0,25200,181000,0,206200
132547601700000,APARTMENT,MULTI-RES,32300,0,32300,250200,0,282500
132547601800000,SR/NURSING/ASSTD LIV,MULTI-RES,77800,0,77800,1048000,0,1125800
132547601900000,NW 333,RESIDENTIAL,23100,0,23100,99400,0,122500
132547602000000,NW 333,RESIDENTIAL,27000,0,27000,105400,0,132400
132547602100000,NW 333,RESIDENTIAL,27200,0,27200,128700,0,155900
132547602200000,NW 333,RESIDENTIAL,26200,0,26200,109000,0,135200
132547602300000,NW 333,RESIDENTIAL,27600,0,27600,132400,0,160000
132547602400000,NW 333,RESIDENTIAL,26900,0,26900,85400,0,112300
132547602500000,NW 333,RESIDENTIAL,27300,0,27300,112900,0,140200
132547602600000,NW 333,RESIDENTIAL,24500,0,24500,81200,0,105700
132547602700000,NW 333,RESIDENTIAL,25900,0,25900,125800,0,151700
132547602800000,NW 333,RESIDENTIAL,25700,0,25700,93800,0,119500
132547602900000,NW 333,RESIDENTIAL,26500,0,26500,87000,0,113500
132547700100000,NW 333,EXEMPT,0,35700,35700,0,147200,182900
132547700200000,NW 333,RESIDENTIAL,31600,0,31600,137400,0,169000
132547700300000,NW 333,RESIDENTIAL,29700,0,29700,147700,0,177400
132547700400000,NW 333,RESIDENTIAL,31500,0,31500,146200,0,177700
132547700500000,NW 333,RESIDENTIAL,29700,0,29700,149300,0,179000
132547700600000,NW 333,RESIDENTIAL,28200,0,28200,121100,0,149300
132547700700000,NW 333,RESIDENTIAL,28200,0,28200,113900,0,142100
132547700800000,NW 333,RESIDENTIAL,27100,0,27100,129400,0,156500
132547700900000,NW 333,RESIDENTIAL,29700,0,29700,123700,0,153400
132547701000000,NW 333,RESIDENTIAL,30100,0,30100,148800,0,178900
132547701100000,NW 333,RESIDENTIAL,29700,0,29700,121600,0,151300
132547701200000,NW 333,RESIDENTIAL,28900,0,28900,119700,0,148600
132547701300000,NW 333,RESIDENTIAL,24100,0,24100,93700,0,117800
132547701400000,NW 333,RESIDENTIAL,31700,0,31700,116700,0,148400
132547701500000,NW 333,RESIDENTIAL,33900,0,33900,106500,0,140400
132547800100000,NW 333,RESIDENTIAL,29300,0,29300,102300,0,131600
132547800200000,NW 333,RESIDENTIAL,29200,0,29200,129100,0,158300
132547800300000,NW 333,RESIDENTIAL,28100,0,28100,103500,0,131600
132547800400000,NW 333,RESIDENTIAL,30300,0,30300,131600,0,161900
132547800500000,NW 333,RESIDENTIAL,29200,0,29200,101200,0,130400
132547800600000,NW 333,RESIDENTIAL,29200,0,29200,107900,0,137100
132547800700000,NW 333,RESIDENTIAL,29200,0,29200,113200,0,142400
132547800800000,NW 333,RESIDENTIAL,28100,0,28100,99100,0,127200
132547800900000,APARTMENT,MULTI-RES,57100,0,57100,416200,0,473300
132547801000000,APARTMENT,RESIDENTIAL,57400,0,57400,391300,0,448700
132547801100000,APARTMENT,RESIDENTIAL,57400,0,57400,390100,0,447500
132547900101000,SMALL RETAIL,COMMERCIAL,0,190000,190000,0,132200,322200
132547900101001,OFFICE,COMMERCIAL,0,190000,190000,0,153400,343400
132547900200000,OFFICE,COMMERCIAL,0,1256000,1256000,0,2192900,3448900
132547900300000,FAST FOOD,COMMERCIAL,0,201400,201400,0,368500,569900
132548000100000,APARTMENT,RESIDENTIAL,39900,0,39900,321200,0,361100
132548000200000,APARTMENT,RESIDENTIAL,111200,0,111200,737100,0,848300
132548000300000,APARTMENT,RESIDENTIAL,96000,0,96000,613300,0,709300
132548000400000,HOTEL,COMMERCIAL,186004,68796,254800,2637417,1104883,3997100
132548000500000,APARTMENT,RESIDENTIAL,39800,0,39800,305700,0,345500
132548000600000,CITY PROPERTY,EXEMPT,0,0,0,0,0,0
132610100100000,NW 329,RESIDENTIAL,30100,0,30100,97300,0,127400
132610100200000,NW 329,RESIDENTIAL,24800,0,24800,94400,0,119200
132610100300000,NW 329,RESIDENTIAL,23700,0,23700,97700,0,121400
132610100400000,NW 329,RESIDENTIAL,23700,0,23700,103300,0,127000
132610100500000,NW 329,RESIDENTIAL,23700,0,23700,110100,0,133800
132610100600000,NW 329,RESIDENTIAL,23700,0,23700,96600,0,120300
132610100700000,NW 329,RESIDENTIAL,23700,0,23700,92400,0,116100
132610100800000,NW 329,RESIDENTIAL,23700,0,23700,94000,0,117700
132610100900000,NW 329,RESIDENTIAL,23700,0,23700,92400,0,116100
132610101000000,NW 329,RESIDENTIAL,23700,0,23700,88500,0,112200
132610101100000,NW 329,RESIDENTIAL,23700,0,23700,107400,0,131100
132610101200000,NW 329,RESIDENTIAL,23700,0,23700,94300,0,118000
132610101300000,NW 329,RESIDENTIAL,23700,0,23700,72400,0,96100
132610101400000,NW 329,RESIDENTIAL,23700,0,23700,100700,0,124400
132610101500000,NW 329,RESIDENTIAL,23700,0,23700,95400,0,119100
132610101600000,NW 329,RESIDENTIAL,23700,0,23700,96100,0,119800
132610101700000,NW 329,RESIDENTIAL,26800,0,26800,98600,0,125400
132610200100000,NW 329,RESIDENTIAL,28800,0,28800,96700,0,125500
132610200200000,NW 329,RESIDENTIAL,28800,0,28800,97900,0,126700
132610200300000,NW 329,RESIDENTIAL,24600,0,24600,85200,0,109800
132610200400000,NW 329,RESIDENTIAL,24200,0,24200,96900,0,121100
132610200500000,NW 329,RESIDENTIAL,24200,0,24200,87800,0,112000
132610200600000,NW 329,RESIDENTIAL,24200,0,24200,105000,0,129200
132610200700000,NW 329,RESIDENTIAL,24200,0,24200,90900,0,115100
132610200800000,NW 329,RESIDENTIAL,24200,0,24200,108700,0,132900
132610200900000,NW 329,RESIDENTIAL,24200,0,24200,86000,0,110200
132610201000000,NW 329,RESIDENTIAL,24200,0,24200,103800,0,128000
132610201100000,NW 329,RESIDENTIAL,24200,0,24200,101300,0,125500
132610201200000,NW 329,RESIDENTIAL,24200,0,24200,96500,0,120700
132610201300000,NW 329,RESIDENTIAL,24200,0,24200,94200,0,118400
132610201400000,NW 329,RESIDENTIAL,24200,0,24200,98700,0,122900
132610201500000,NW 329,RESIDENTIAL,23300,0,23300,89100,0,112400
132610201600000,NW 329,RESIDENTIAL,24800,0,24800,88500,0,113300
132610201700000,NW 329,RESIDENTIAL,26800,0,26800,101100,0,127900
132610201800000,NW 329,RESIDENTIAL,25200,0,25200,100600,0,125800
132610201900000,NW 329,RESIDENTIAL,25900,0,25900,90300,0,116200
132610202000000,NW 329,RESIDENTIAL,23700,0,23700,98500,0,122200
132610202100000,NW 329,RESIDENTIAL,24200,0,24200,87800,0,112000
132610202200000,NW 329,RESIDENTIAL,24200,0,24200,102300,0,126500
132610202300000,NW 329,RESIDENTIAL,24200,0,24200,91600,0,115800
132610202400000,NW 329,RESIDENTIAL,24200,0,24200,98500,0,122700
132610202500000,NW 329,RESIDENTIAL,24200,0,24200,86400,0,110600
132610202600000,NW 329,RESIDENTIAL,24200,0,24200,110500,0,134700
132610202700000,NW 329,RESIDENTIAL,24200,0,24200,89800,0,114000
132610202800000,NW 329,RESIDENTIAL,24200,0,24200,113200,0,137400
132610202900000,NW 329,RESIDENTIAL,24200,0,24200,101700,0,125900
132610203000000,NW 329,RESIDENTIAL,24200,0,24200,88100,0,112300
132610203100000,NW 329,RESIDENTIAL,24200,0,24200,94300,0,118500
132610203200000,NW 329,RESIDENTIAL,24200,0,24200,107500,0,131700
132610203300000,NW 329,RESIDENTIAL,24200,0,24200,98500,0,122700
132610203400000,NW 329,RESIDENTIAL,24800,0,24800,106500,0,131300
132610300100000,NW 329,RESIDENTIAL,24700,0,24700,56100,0,80800
132610300200000,NW 329,RESIDENTIAL,24100,0,24100,89000,0,113100
132610300300000,NW 329,RESIDENTIAL,24700,0,24700,91300,0,116000
132610300400000,NW 329,RESIDENTIAL,24600,0,24600,96000,0,120600
132610300500000,NW 329,RESIDENTIAL,24200,0,24200,89100,0,113300
132610300600000,NW 329,RESIDENTIAL,24200,0,24200,90700,0,114900
132610300700000,NW 329,RESIDENTIAL,24200,0,24200,102700,0,126900
132610300800000,NW 329,RESIDENTIAL,24200,0,24200,95400,0,119600
132610300900000,NW 329,RESIDENTIAL,24200,0,24200,104000,0,128200
132610301000000,NW 329,RESIDENTIAL,24200,0,24200,98000,0,122200
132610301100000,NW 329,RESIDENTIAL,24200,0,24200,92800,0,117000
132610301200000,NW 329,RESIDENTIAL,24200,0,24200,97100,0,121300
132610301300000,NW 329,RESIDENTIAL,24200,0,24200,92300,0,116500
132610301400000,NW 329,RESIDENTIAL,24200,0,24200,99300,0,123500
132610301500000,NW 329,RESIDENTIAL,24200,0,24200,101400,0,125600
132610301600000,NW 329,RESIDENTIAL,24200,0,24200,100000,0,124200
132610301700000,NW 329,RESIDENTIAL,26900,0,26900,99400,0,126300
132610301800000,NW 329,RESIDENTIAL,29700,0,29700,85200,0,114900
132610301900000,NW 329,RESIDENTIAL,25700,0,25700,102000,0,127700
132610302000000,NW 329,RESIDENTIAL,24200,0,24200,93100,0,117300
132610302100000,NW 329,RESIDENTIAL,24200,0,24200,93700,0,117900
132610302200000,NW 329,RESIDENTIAL,24200,0,24200,103200,0,127400
132610302300000,NW 329,RESIDENTIAL,24200,0,24200,93000,0,117200
132610302400000,NW 329,RESIDENTIAL,24200,0,24200,103700,0,127900
132610302500000,NW 329,RESIDENTIAL,24200,0,24200,86800,0,111000
132610302600000,NW 329,RESIDENTIAL,24200,0,24200,91200,0,115400
132610302700000,NW 329,RESIDENTIAL,24200,0,24200,92000,0,116200
132610302800000,NW 329,RESIDENTIAL,24200,0,24200,100400,0,124600
132610302900000,NW 329,RESIDENTIAL,24200,0,24200,96800,0,121000
132610303000000,NW 329,RESIDENTIAL,24200,0,24200,87900,0,112100
132610303100000,NW 329,RESIDENTIAL,24800,0,24800,76200,0,101000
132610400100000,NW 329,RESIDENTIAL,27000,0,27000,111700,0,138700
132610400200000,NW 329,RESIDENTIAL,24100,0,24100,85800,0,109900
132610400300000,NW 329,RESIDENTIAL,24100,0,24100,83900,0,108000
132610400400000,NW 329,RESIDENTIAL,24100,0,24100,95600,0,119700
132610400500000,NW 329,RESIDENTIAL,24100,0,24100,76900,0,101000
132610400600000,NW 329,RESIDENTIAL,23700,0,23700,101900,0,125600
132610400700000,NW 329,RESIDENTIAL,23700,0,23700,77400,0,101100
132610400800000,NW 329,RESIDENTIAL,28200,0,28200,168200,0,196400
132610400900000,NW 329,RESIDENTIAL,7500,0,7500,0,0,7500
132610401000000,SCHOOL,EXEMPT,0,0,0,0,0,0
132610401100000,NW 329,RESIDENTIAL,26700,0,26700,88700,0,115400
132610401200000,NW 329,RESIDENTIAL,26200,0,26200,74200,0,100400
132610401300000,NW 329,RESIDENTIAL,26500,0,26500,103400,0,129900
132610401400000,NW 329,RESIDENTIAL,26200,0,26200,97100,0,123300
132610401500000,NW 329,RESIDENTIAL,25600,0,25600,89800,0,115400
132610401600000,NW 329,RESIDENTIAL,28000,0,28000,90000,0,118000
132610401700000,NW 329,RESIDENTIAL,23700,0,23700,95700,0,119400
132610401800000,NW 329,RESIDENTIAL,23700,0,23700,92400,0,116100
132610401900000,NW 329,RESIDENTIAL,23700,0,23700,88000,0,111700
132610402000000,NW 329,RESIDENTIAL,23700,0,23700,77400,0,101100
132610402100000,NW 329,RESIDENTIAL,23700,0,23700,87900,0,111600
132610402200000,NW 329,RESIDENTIAL,23700,0,23700,83800,0,107500
132610402300000,NW 329,RESIDENTIAL,23700,0,23700,104400,0,128100
132610402400000,NW 329,RESIDENTIAL,23700,0,23700,78300,0,102000
132610402500000,NW 329,RESIDENTIAL,23700,0,23700,91300,0,115000
132610402600000,NW 329,RESIDENTIAL,23700,0,23700,90600,0,114300
132610402700000,NW 329,RESIDENTIAL,23700,0,23700,100200,0,123900
132610402800000,NW 329,RESIDENTIAL,23700,0,23700,93800,0,117500
132610402900000,NW 329,RESIDENTIAL,22900,0,22900,99300,0,122200
132610500100000,NW 329,RESIDENTIAL,30100,0,30100,99700,0,129800
132610600100000,NW 329,RESIDENTIAL,25600,0,25600,89000,0,114600
132610600200000,NW 329,RESIDENTIAL,22300,0,22300,88500,0,110800
132610600300000,NW 329,RESIDENTIAL,26000,0,26000,108800,0,134800
132610700100000,NW 329,RESIDENTIAL,27100,0,27100,100000,0,127100
132610700200000,NW 329,RESIDENTIAL,24300,0,24300,93100,0,117400
132610700300000,NW 329,RESIDENTIAL,28400,0,28400,98100,0,126500
132610700400000,NW 329,RESIDENTIAL,25000,0,25000,89600,0,114600
132610700500000,NW 329,RESIDENTIAL,23800,0,23800,90000,0,113800
132610700600000,NW 329,RESIDENTIAL,25500,0,25500,91100,0,116600
132610800100000,CHURCH,EXEMPT,0,256000,256000,0,910200,1166200
132610900100000,NW 329,RESIDENTIAL,24800,0,24800,81600,0,106400
132610900200000,NW 329,RESIDENTIAL,25000,0,25000,93900,0,118900
132610900300000,NW 329,RESIDENTIAL,25700,0,25700,94900,0,120600
132610900400000,NW 329,RESIDENTIAL,25600,0,25600,103100,0,128700
132612600100000,NW 329,RESIDENTIAL,25900,0,25900,119000,0,144900
132612600200000,NW 329,RESIDENTIAL,24600,0,24600,145200,0,169800
132612600300000,NW 329,RESIDENTIAL,24600,0,24600,88600,0,113200
132612600400000,NW 329,RESIDENTIAL,24600,0,24600,120100,0,144700
132612600500000,NW 329,RESIDENTIAL,29700,0,29700,124300,0,154000
132612600600000,NW 329,RESIDENTIAL,24600,0,24600,145200,0,169800
132612600700000,NW 329,RESIDENTIAL,5100,0,5100,0,0,5100
132612600800000,NW 329,RESIDENTIAL,10200,0,10200,0,0,10200
132612600900000,NW 329,RESIDENTIAL,29700,0,29700,121700,0,151400
132612601000000,NW 329,RESIDENTIAL,5100,0,5100,0,0,5100
132612601100000,NW 329,RESIDENTIAL,5100,0,5100,0,0,5100
132612601200000,NW 329,RESIDENTIAL,5100,0,5100,0,0,5100
132612601300000,NW 329,RESIDENTIAL,5100,0,5100,0,0,5100
132612601400000,NW 329,RESIDENTIAL,6000,0,6000,0,0,6000
132612601500000,NW 329,RESIDENTIAL,25900,0,25900,94800,0,120700
132612601600000,NW 329,RESIDENTIAL,24600,0,24600,89800,0,114400
132612601700000,NW 329,RESIDENTIAL,24600,0,24600,104100,0,128700
132612601800000,NW 329,RESIDENTIAL,24600,0,24600,97400,0,122000
132612601900000,NW 329,RESIDENTIAL,24600,0,24600,97900,0,122500
132612602000000,NW 329,RESIDENTIAL,24600,0,24600,101000,0,125600
132612602100000,NW 329,RESIDENTIAL,24600,0,24600,106800,0,131400
132612602200000,NW 329,RESIDENTIAL,24600,0,24600,93600,0,118200
132612602300000,NW 329,RESIDENTIAL,24600,0,24600,85700,0,110300
132612602400000,NW 329,RESIDENTIAL,24600,0,24600,86600,0,111200
132612602500000,NW 329,RESIDENTIAL,24600,0,24600,89400,0,114000
132612602600000,NW 329,RESIDENTIAL,24600,0,24600,64200,0,88800
132612602700000,NW 329,RESIDENTIAL,25900,0,25900,107000,0,132900
132612700100000,NW 329,RESIDENTIAL,24000,0,24000,103600,0,127600
132612700600000,NW 329,RESIDENTIAL,23000,0,23000,107400,0,130400
132612700800000,NW 329,RESIDENTIAL,24000,0,24000,90000,0,114000
132612700900000,NW 329,RESIDENTIAL,27800,0,27800,139700,0,167500
132612701000000,NW 329,RESIDENTIAL,32600,0,32600,98900,0,131500
132612800100000,NW 329,RESIDENTIAL,26000,0,26000,92500,0,118500
132612800200000,NW 329,RESIDENTIAL,23300,0,23300,88500,0,111800
132612800300000,NW 329,RESIDENTIAL,25800,0,25800,87600,0,113400
132612800400000,NW 329,RESIDENTIAL,24700,0,24700,79900,0,104600
132612800500000,NW 329,RESIDENTIAL,24100,0,24100,97100,0,121200
132612800600000,NW 329,RESIDENTIAL,24300,0,24300,79400,0,103700
132612800700000,NW 329,RESIDENTIAL,24100,0,24100,102700,0,126800
132612800800000,NW 329,RESIDENTIAL,24300,0,24300,95100,0,119400
132612800900000,NW 329,RESIDENTIAL,24200,0,24200,95800,0,120000
132612801000000,NW 329,RESIDENTIAL,24100,0,24100,88900,0,113000
132612801100000,NW 329,RESIDENTIAL,24300,0,24300,96700,0,121000
132612801200000,NW 329,RESIDENTIAL,25300,0,25300,115500,0,140800
132612801300000,NW 329,RESIDENTIAL,25300,0,25300,98200,0,123500
132612801400000,NW 329,RESIDENTIAL,25600,0,25600,92000,0,117600
132612801500000,NW 329,RESIDENTIAL,26400,0,26400,120600,0,147000
132612801600000,NW 329,RESIDENTIAL,25600,0,25600,105100,0,130700
132612801700000,NW 329,RESIDENTIAL,22600,0,22600,78600,0,101200
132612801800000,NW 329,RESIDENTIAL,25100,0,25100,112600,0,137700
132612801900000,NW 329,RESIDENTIAL,24600,0,24600,78600,0,103200
132612802000000,NW 329,RESIDENTIAL,24600,0,24600,100100,0,124700
132612802100000,NW 329,RESIDENTIAL,24800,0,24800,99200,0,124000
132612802200000,NW 329,RESIDENTIAL,24800,0,24800,95200,0,120000
132612802300000,NW 329,RESIDENTIAL,25100,0,25100,88600,0,113700
132612802400000,NW 329,RESIDENTIAL,24600,0,24600,80700,0,105300
132612802500000,NW 329,RESIDENTIAL,24300,0,24300,98700,0,123000
132612802600000,NW 329,RESIDENTIAL,24800,0,24800,94300,0,119100
132612900100000,NW 329,RESIDENTIAL,25800,0,25800,93700,0,119500
132612900200000,NW 329,RESIDENTIAL,23300,0,23300,83200,0,106500
132612900300000,NW 329,RESIDENTIAL,26000,0,26000,103100,0,129100
132612900400000,NW 329,RESIDENTIAL,24800,0,24800,88100,0,112900
132612900500000,NW 329,RESIDENTIAL,24100,0,24100,94500,0,118600
132612900600000,NW 329,RESIDENTIAL,23900,0,23900,103600,0,127500
132612900700000,NW 329,RESIDENTIAL,24200,0,24200,88300,0,112500
132612900800000,NW 329,RESIDENTIAL,24200,0,24200,88300,0,112500
132612900900000,NW 329,RESIDENTIAL,24200,0,24200,98600,0,122800
132612901000000,NW 329,RESIDENTIAL,23800,0,23800,83300,0,107100
132612901100000,NW 329,RESIDENTIAL,24300,0,24300,113600,0,137900
132612901200000,NW 329,RESIDENTIAL,24300,0,24300,91100,0,115400
132612901300000,NW 329,RESIDENTIAL,24800,0,24800,103900,0,128700
132612901400000,NW 329,RESIDENTIAL,25200,0,25200,89300,0,114500
132612901500000,NW 329,RESIDENTIAL,26000,0,26000,90800,0,116800
132612901600000,NW 329,RESIDENTIAL,25600,0,25600,92400,0,118000
132612901700000,NW 329,RESIDENTIAL,22600,0,22600,90500,0,113100
132612901800000,NW 329,RESIDENTIAL,25600,0,25600,111400,0,137000
132612901900000,NW 329,RESIDENTIAL,25500,0,25500,93400,0,118900
132612902000000,NW 329,RESIDENTIAL,26000,0,26000,90500,0,116500
132612902100000,NW 329,RESIDENTIAL,25300,0,25300,95500,0,120800
132612902200000,NW 329,RESIDENTIAL,24800,0,24800,88600,0,113400
132612902300000,NW 329,RESIDENTIAL,24800,0,24800,94200,0,119000
132612902400000,NW 329,RESIDENTIAL,24600,0,24600,92200,0,116800
132612902500000,NW 329,RESIDENTIAL,24700,0,24700,94300,0,119000
132612902600000,NW 329,RESIDENTIAL,24400,0,24400,100200,0,124600
132612902700000,NW 329,RESIDENTIAL,24400,0,24400,93400,0,117800
132612902800000,NW 329,RESIDENTIAL,24600,0,24600,89300,0,113900
132612902900000,NW 329,RESIDENTIAL,24100,0,24100,88000,0,112100
132612903000000,NW 329,RESIDENTIAL,24800,0,24800,82200,0,107000
132613000100000,NW 329,RESIDENTIAL,25800,0,25800,110400,0,136200
132613000200000,NW 329,RESIDENTIAL,23300,0,23300,91000,0,114300
132613000300000,NW 329,RESIDENTIAL,26000,0,26000,90600,0,116600
132613000400000,NW 329,RESIDENTIAL,24800,0,24800,87400,0,112200
132613000500000,NW 329,RESIDENTIAL,24100,0,24100,82100,0,106200
132613000600000,NW 329,RESIDENTIAL,24100,0,24100,92200,0,116300
132613000700000,NW 329,RESIDENTIAL,24100,0,24100,96000,0,120100
132613000800000,NW 329,RESIDENTIAL,24100,0,24100,90200,0,114300
132613000900000,NW 329,RESIDENTIAL,25000,0,25000,87200,0,112200
132613001000000,NW 329,RESIDENTIAL,25000,0,25000,82500,0,107500
132613001100000,NW 329,RESIDENTIAL,25500,0,25500,88400,0,113900
132613001200000,NW 329,RESIDENTIAL,25000,0,25000,81900,0,106900
132613001300000,NW 329,RESIDENTIAL,25100,0,25100,81100,0,106200
132613001400000,NW 329,RESIDENTIAL,24900,0,24900,97100,0,122000
132613001500000,NW 329,RESIDENTIAL,26100,0,26100,81100,0,107200
132613001600000,NW 329,RESIDENTIAL,26000,0,26000,84200,0,110200
132613001700000,NW 329,RESIDENTIAL,22600,0,22600,84600,0,107200
132613001800000,NW 329,RESIDENTIAL,25500,0,25500,93200,0,118700
132613001900000,NW 329,RESIDENTIAL,24900,0,24900,86900,0,111800
132613002000000,NW 329,RESIDENTIAL,25200,0,25200,97500,0,122700
132613002100000,NW 329,RESIDENTIAL,25900,0,25900,98900,0,124800
132613002200000,NW 329,RESIDENTIAL,25100,0,25100,102100,0,127200
132613002300000,NW 329,RESIDENTIAL,24800,0,24800,91400,0,116200
132613002400000,NW 329,RESIDENTIAL,25200,0,25200,94300,0,119500
132613002500000,NW 329,RESIDENTIAL,25100,0,25100,99700,0,124800
132613002600000,NW 329,RESIDENTIAL,24800,0,24800,86400,0,111200
132613002700000,NW 329,RESIDENTIAL,24200,0,24200,84800,0,109000
132613002800000,NW 329,RESIDENTIAL,24200,0,24200,96500,0,120700
132613002900000,NW 329,RESIDENTIAL,24100,0,24100,86900,0,111000
132613003000000,NW 329,RESIDENTIAL,24800,0,24800,84000,0,108800
132613100100000,NW 329,RESIDENTIAL,25800,0,25800,66900,0,92700
132613100200000,NW 329,RESIDENTIAL,23300,0,23300,91300,0,114600
132613100300000,NW 329,RESIDENTIAL,25900,0,25900,82800,0,108700
132613100400000,NW 329,RESIDENTIAL,24800,0,24800,95600,0,120400
132613100500000,NW 329,RESIDENTIAL,24100,0,24100,91900,0,116000
132613100600000,NW 329,RESIDENTIAL,24100,0,24100,87000,0,111100
132613100700000,NW 329,RESIDENTIAL,24100,0,24100,83400,0,107500
132613100800000,NW 329,RESIDENTIAL,24100,0,24100,93200,0,117300
132613100900000,NW 329,RESIDENTIAL,24100,0,24100,87700,0,111800
132613101000000,NW 329,RESIDENTIAL,24900,0,24900,107400,0,132300
132613101100000,NW 329,RESIDENTIAL,24600,0,24600,76300,0,100900
132613101200000,NW 329,RESIDENTIAL,26100,0,26100,97000,0,123100
132613101300000,NW 329,RESIDENTIAL,26600,0,26600,90400,0,117000
132613101400000,NW 329,RESIDENTIAL,26200,0,26200,103100,0,129300
132613101500000,NW 329,RESIDENTIAL,26300,0,26300,98700,0,125000
132613101600000,NW 329,RESIDENTIAL,28600,0,28600,95600,0,124200
132613101700000,NW 329,RESIDENTIAL,25800,0,25800,95400,0,121200
132613101800000,NW 329,RESIDENTIAL,25800,0,25800,90800,0,116600
132613101900000,NW 329,RESIDENTIAL,25400,0,25400,89600,0,115000
132613102000000,NW 329,RESIDENTIAL,28300,0,28300,103500,0,131800
132613102100000,NW 329,RESIDENTIAL,25300,0,25300,97700,0,123000
132613102200000,NW 329,RESIDENTIAL,25700,0,25700,98200,0,123900
132613102300000,NW 329,RESIDENTIAL,25500,0,25500,84300,0,109800
132613102400000,NW 329,RESIDENTIAL,25700,0,25700,86700,0,112400
132613102500000,NW 329,RESIDENTIAL,25000,0,25000,90800,0,115800
132613102600000,NW 329,RESIDENTIAL,24700,0,24700,84700,0,109400
132613102700000,NW 329,RESIDENTIAL,24400,0,24400,98300,0,122700
132613102800000,NW 329,RESIDENTIAL,24100,0,24100,106200,0,130300
132613102900000,NW 329,RESIDENTIAL,24100,0,24100,92800,0,116900
132613103000000,NW 329,RESIDENTIAL,24100,0,24100,87700,0,111800
132613103100000,NW 329,RESIDENTIAL,24100,0,24100,92600,0,116700
132613103200000,NW 329,RESIDENTIAL,24800,0,24800,83000,0,107800
132613200100000,NW 329,RESIDENTIAL,26200,0,26200,94400,0,120600
132613200200000,NW 329,RESIDENTIAL,23300,0,23300,89400,0,112700
132613200300000,NW 329,RESIDENTIAL,25900,0,25900,93100,0,119000
132613200400000,NW 329,RESIDENTIAL,25100,0,25100,91600,0,116700
132613200500000,NW 329,RESIDENTIAL,24300,0,24300,96000,0,120300
132613200600000,NW 329,RESIDENTIAL,24300,0,24300,90500,0,114800
132613200700000,NW 329,RESIDENTIAL,24300,0,24300,88100,0,112400
132613200800000,NW 329,RESIDENTIAL,23200,0,23200,85800,0,109000
132613200900000,NW 329,RESIDENTIAL,22800,0,22800,96400,0,119200
132613201000000,NW 329,RESIDENTIAL,23000,0,23000,81500,0,104500
132613201100000,NW 329,RESIDENTIAL,28800,0,28800,93900,0,122700
132613201200000,NW 329,RESIDENTIAL,25500,0,25500,73600,0,99100
132613201300000,NW 329,RESIDENTIAL,24400,0,24400,97000,0,121400
132613201400000,NW 329,RESIDENTIAL,23500,0,23500,99700,0,123200
132613201500000,NW 329,RESIDENTIAL,24600,0,24600,95800,0,120400
132613201600000,NW 329,RESIDENTIAL,24600,0,24600,98100,0,122700
132613201700000,NW 329,RESIDENTIAL,24600,0,24600,95200,0,119800
132613201800000,NW 329,RESIDENTIAL,24600,0,24600,96900,0,121500
132613201900000,NW 329,RESIDENTIAL,24600,0,24600,95800,0,120400
132613202000000,NW 329,RESIDENTIAL,25300,0,25300,96800,0,122100
132613300100000,NW 329,RESIDENTIAL,28100,0,28100,96200,0,124300
132613300200000,NW 329,RESIDENTIAL,26100,0,26100,115100,0,141200
132613300300000,NW 329,RESIDENTIAL,25800,0,25800,88900,0,114700
132613300400000,NW 329,RESIDENTIAL,26300,0,26300,90200,0,116500
132613300500000,NW 329,RESIDENTIAL,25100,0,25100,104600,0,129700
132615100100000,NW 329,RESIDENTIAL,22600,0,22600,82900,0,105500
132615100200000,NW 329,RESIDENTIAL,25600,0,25600,89300,0,114900
132615100300000,NW 329,RESIDENTIAL,23300,0,23300,96700,0,120000
132615100400000,NW 329,RESIDENTIAL,23400,0,23400,85000,0,108400
132615100500000,NW 329,RESIDENTIAL,23400,0,23400,71600,0,95000
132615100600000,NW 329,RESIDENTIAL,22900,0,22900,79000,0,101900
132615100700000,NW 329,RESIDENTIAL,22900,0,22900,93700,0,116600
132615100800000,NW 329,RESIDENTIAL,22900,0,22900,99300,0,122200
132615100900000,NW 329,RESIDENTIAL,23500,0,23500,86200,0,109700
132615101000000,NW 329,RESIDENTIAL,24400,0,24400,86000,0,110400
132615101100000,NW 329,RESIDENTIAL,25400,0,25400,85600,0,111000
132615101200000,NW 329,RESIDENTIAL,25200,0,25200,80400,0,105600
132615101300000,NW 329,RESIDENTIAL,27800,0,27800,103600,0,131400
132615101400000,NW 329,RESIDENTIAL,22900,0,22900,92500,0,115400
132615101500000,NW 329,RESIDENTIAL,23100,0,23100,83300,0,106400
132615101600000,NW 329,RESIDENTIAL,22900,0,22900,82700,0,105600
132615101700000,NW 329,RESIDENTIAL,27200,0,27200,91300,0,118500
132615101800000,NW 329,RESIDENTIAL,23100,0,23100,107400,0,130500
132615101900000,NW 329,RESIDENTIAL,23900,0,23900,90400,0,114300
132615102000000,NW 329,RESIDENTIAL,23200,0,23200,75300,0,98500
132615102100000,NW 329,RESIDENTIAL,22700,0,22700,64100,0,86800
132615102200000,NW 329,RESIDENTIAL,24300,0,24300,89800,0,114100
132615102300000,NW 329,RESIDENTIAL,25500,0,25500,95400,0,120900
132615102400000,NW 329,RESIDENTIAL,24700,0,24700,77100,0,101800
132615200100000,NW 329,RESIDENTIAL,32300,0,32300,102500,0,134800
132615200200000,NW 329,RESIDENTIAL,32300,0,32300,112100,0,144400
132615200300000,NW 329,RESIDENTIAL,23900,0,23900,98900,0,122800
132615200400000,NW 329,RESIDENTIAL,26200,0,26200,85900,0,112100
132615200500000,NW 329,RESIDENTIAL,22200,0,22200,79700,0,101900
132615200600000,NW 329,RESIDENTIAL,22200,0,22200,92500,0,114700
132615200700000,NW 329,RESIDENTIAL,24300,0,24300,87900,0,112200
132615200800000,NW 329,RESIDENTIAL,26800,0,26800,98500,0,125300
132615200900000,NW 329,RESIDENTIAL,23800,0,23800,77800,0,101600
132615201000000,NW 329,RESIDENTIAL,28700,0,28700,102700,0,131400
132615201100000,NW 329,RESIDENTIAL,26500,0,26500,96500,0,123000
132615201200000,NW 329,RESIDENTIAL,23800,0,23800,70800,0,94600
132615201300000,NW 329,RESIDENTIAL,24400,0,24400,80900,0,105300
132615201400000,NW 329,RESIDENTIAL,24400,0,24400,89500,0,113900
132615201500000,NW 329,RESIDENTIAL,24000,0,24000,99400,0,123400
132615201600000,NW 329,RESIDENTIAL,24000,0,24000,115500,0,139500
132615201700000,NW 329,RESIDENTIAL,25100,0,25100,85600,0,110700
132615300100000,NW 329,RESIDENTIAL,26400,0,26400,100800,0,127200
132615300200000,NW 329,RESIDENTIAL,24400,0,24400,91600,0,116000
132615300300000,NW 329,RESIDENTIAL,22600,0,22600,77400,0,100000
132615300400000,NW 329,RESIDENTIAL,23300,0,23300,86500,0,109800
132615300500000,NW 329,RESIDENTIAL,23800,0,23800,94700,0,118500
132615300600000,NW 329,RESIDENTIAL,23500,0,23500,97700,0,121200
132615300700000,NW 329,RESIDENTIAL,23300,0,23300,87000,0,110300
132615300800000,NW 329,RESIDENTIAL,23000,0,23000,92900,0,115900
132615300900000,NW 329,RESIDENTIAL,23800,0,23800,98100,0,121900
132615301000000,NW 329,RESIDENTIAL,27000,0,27000,92900,0,119900
132615301100000,NW 329,RESIDENTIAL,27000,0,27000,102000,0,129000
132615301200000,NW 329,RESIDENTIAL,23600,0,23600,94900,0,118500
132615301300000,NW 329,RESIDENTIAL,22400,0,22400,93800,0,116200
132615301400000,NW 329,RESIDENTIAL,22800,0,22800,95700,0,118500
132615301500000,NW 329,RESIDENTIAL,24000,0,24000,83400,0,107400
132615301600000,NW 329,RESIDENTIAL,25000,0,25000,89200,0,114200
132615301700000,NW 329,RESIDENTIAL,24000,0,24000,95700,0,119700
132615301800000,NW 329,RESIDENTIAL,24100,0,24100,90400,0,114500
132615301900000,NW 329,RESIDENTIAL,31700,0,31700,102000,0,133700
132615302000000,NW 329,RESIDENTIAL,27000,0,27000,96200,0,123200
132615302100000,NW 329,RESIDENTIAL,25500,0,25500,98200,0,123700
132615302200000,NW 329,RESIDENTIAL,22900,0,22900,91000,0,113900
132615302300000,NW 329,RESIDENTIAL,23300,0,23300,104900,0,128200
132615302400000,NW 329,RESIDENTIAL,24100,0,24100,112700,0,136800
132615400100000,NW 329,RESIDENTIAL,22800,0,22800,102500,0,125300
132615400200000,NW 329,RESIDENTIAL,24400,0,24400,101400,0,125800
132615400300000,NW 329,RESIDENTIAL,24400,0,24400,112200,0,136600
132615400400000,NW 329,RESIDENTIAL,22600,0,22600,88100,0,110700
132615400500000,NW 329,RESIDENTIAL,22600,0,22600,91700,0,114300
132615400600000,NW 329,RESIDENTIAL,22600,0,22600,103300,0,125900
132615400700000,NW 329,RESIDENTIAL,22600,0,22600,100300,0,122900
132615400800000,NW 329,RESIDENTIAL,25600,0,25600,95100,0,120700
132615500100000,NW 329,RESIDENTIAL,26100,0,26100,93800,0,119900
132615500200000,NW 329,RESIDENTIAL,25500,0,25500,87600,0,113100
132615500300000,NW 329,RESIDENTIAL,23400,0,23400,89100,0,112500
132615500400000,NW 329,RESIDENTIAL,24100,0,24100,98400,0,122500
132615500500000,NW 329,RESIDENTIAL,25100,0,25100,96700,0,121800
132615500600000,NW 329,RESIDENTIAL,25900,0,25900,78700,0,104600
132615500700000,NW 329,RESIDENTIAL,25700,0,25700,75400,0,101100
132615500800000,NW 329,RESIDENTIAL,23800,0,23800,113800,0,137600
132615500900000,NW 329,RESIDENTIAL,23100,0,23100,83400,0,106500
132615501000000,NW 329,RESIDENTIAL,21800,0,21800,88000,0,109800
132615501100000,NW 329,RESIDENTIAL,23500,0,23500,86000,0,109500
132615501200000,NW 329,RESIDENTIAL,23300,0,23300,83700,0,107000
132615501300000,NW 329,RESIDENTIAL,23000,0,23000,86300,0,109300
132615501400000,NW 329,RESIDENTIAL,23700,0,23700,84300,0,108000
132615501500000,NW 329,RESIDENTIAL,23300,0,23300,74400,0,97700
132615501600000,NW 329,RESIDENTIAL,23500,0,23500,84600,0,108100
132615501700000,NW 329,RESIDENTIAL,23500,0,23500,90100,0,113600
132615501800000,NW 329,RESIDENTIAL,23300,0,23300,80500,0,103800
132615501900000,NW 329,RESIDENTIAL,23400,0,23400,90700,0,114100
132615502000000,NW 329,RESIDENTIAL,23200,0,23200,89700,0,112900
132615502100000,NW 329,RESIDENTIAL,24300,0,24300,93500,0,117800
132615502200000,NW 329,RESIDENTIAL,27000,0,27000,87300,0,114300
132615502300000,NW 329,RESIDENTIAL,27000,0,27000,89800,0,116800
132615502400000,NW 329,RESIDENTIAL,24700,0,24700,97400,0,122100
132615502500000,NW 329,RESIDENTIAL,23900,0,23900,89600,0,113500
132615502600000,NW 329,RESIDENTIAL,23800,0,23800,93500,0,117300
132615502700000,NW 329,RESIDENTIAL,23800,0,23800,89900,0,113700
132615502800000,NW 329,RESIDENTIAL,23800,0,23800,101700,0,125500
132615502900000,NW 329,RESIDENTIAL,23400,0,23400,90300,0,113700
132615503000000,NW 329,RESIDENTIAL,23000,0,23000,103900,0,126900
132615503100000,NW 329,RESIDENTIAL,23200,0,23200,92900,0,116100
132615503200000,NW 329,RESIDENTIAL,22600,0,22600,91500,0,114100
132615503300000,NW 329,RESIDENTIAL,23200,0,23200,92700,0,115900
132615503400000,NW 329,RESIDENTIAL,23800,0,23800,97000,0,120800
132615503500000,NW 329,RESIDENTIAL,24100,0,24100,91300,0,115400
132615503600000,NW 329,RESIDENTIAL,25400,0,25400,82200,0,107600
132615503700000,NW 329,RESIDENTIAL,29800,0,29800,85100,0,114900
132615503800000,NW 329,RESIDENTIAL,26600,0,26600,92300,0,118900
132615503900000,NW 329,RESIDENTIAL,24800,0,24800,88700,0,113500
132615504000000,NW 329,RESIDENTIAL,23500,0,23500,105100,0,128600
132615504100000,NW 329,RESIDENTIAL,22800,0,22800,96100,0,118900
132615504200000,NW 329,RESIDENTIAL,22500,0,22500,95900,0,118400
132615504300000,NW 329,RESIDENTIAL,22500,0,22500,101600,0,124100
132615504400000,NW 329,RESIDENTIAL,25400,0,25400,86200,0,111600
132615504500000,NW 329,RESIDENTIAL,22600,0,22600,96300,0,118900
132615600100000,CHURCH,EXEMPT,0,173000,173000,0,906700,1079700
132615600200000,NW 329,RESIDENTIAL,23200,0,23200,98400,0,121600
132615600300000,NW 329,RESIDENTIAL,23900,0,23900,84700,0,108600
132615600400000,NW 329,RESIDENTIAL,23600,0,23600,89900,0,113500
132615600500000,NW 329,RESIDENTIAL,23900,0,23900,92500,0,116400
132615600600000,NW 329,RESIDENTIAL,24300,0,24300,105500,0,129800
132615600700000,NW 329,RESIDENTIAL,27200,0,27200,105600,0,132800
132615600800000,NW 329,RESIDENTIAL,23400,0,23400,101500,0,124900
132615600900000,NW 329,RESIDENTIAL,28200,0,28200,129300,0,157500
132615601000000,NW 329,RESIDENTIAL,26000,0,26000,89800,0,115800
132615601100000,NW 329,RESIDENTIAL,22800,0,22800,94200,0,117000
132615601200000,NW 329,RESIDENTIAL,22800,0,22800,89000,0,111800
132615601300000,NW 329,RESIDENTIAL,22800,0,22800,109000,0,131800
132615601400000,NW 329,RESIDENTIAL,21900,0,21900,92000,0,113900
132615601500000,NW 329,RESIDENTIAL,22700,0,22700,91500,0,114200
132615601600000,NW 329,RESIDENTIAL,23300,0,23300,91000,0,114300
132615700100000,NW 329,RESIDENTIAL,27700,0,27700,94000,0,121700
132615700200000,NW 329,RESIDENTIAL,23600,0,23600,106400,0,130000
132615700300000,NW 329,RESIDENTIAL,25600,0,25600,109700,0,135300
132615700400000,NW 329,RESIDENTIAL,27400,0,27400,83700,0,111100
132615700500000,NW 329,RESIDENTIAL,26800,0,26800,104400,0,131200
132615700600000,NW 329,RESIDENTIAL,26000,0,26000,86600,0,112600
132615700700000,NW 329,RESIDENTIAL,23800,0,23800,92400,0,116200
132615700800000,NW 329,RESIDENTIAL,24300,0,24300,93100,0,117400
132615700900000,NW 329,RESIDENTIAL,27500,0,27500,91800,0,119300
132615701000000,NW 329,RESIDENTIAL,27700,0,27700,104400,0,132100
132615701100000,NW 329,RESIDENTIAL,26300,0,26300,102100,0,128400
132615701200000,NW 329,RESIDENTIAL,24200,0,24200,86900,0,111100
132615701300000,NW 329,RESIDENTIAL,23700,0,23700,77600,0,101300
132615701400000,NW 329,RESIDENTIAL,24300,0,24300,89400,0,113700
132615701500000,NW 329,RESIDENTIAL,24800,0,24800,85000,0,109800
132615800100000,NW 329,RESIDENTIAL,25900,0,25900,98400,0,124300
132615800200000,NW 329,RESIDENTIAL,22800,0,22800,89700,0,112500
132615800300000,NW 329,RESIDENTIAL,23000,0,23000,89100,0,112100
132615800400000,NW 329,RESIDENTIAL,23500,0,23500,95800,0,119300
132615800500000,NW 329,RESIDENTIAL,24200,0,24200,84000,0,108200
132615800600000,NW 329,RESIDENTIAL,25000,0,25000,93100,0,118100
132615800700000,NW 329,RESIDENTIAL,25400,0,25400,79400,0,104800
132615800800000,NW 329,RESIDENTIAL,25400,0,25400,93600,0,119000
132615800900000,NW 329,RESIDENTIAL,25000,0,25000,100400,0,125400
132615801000000,NW 329,RESIDENTIAL,23800,0,23800,89300,0,113100
132615801100000,NW 329,RESIDENTIAL,23000,0,23000,100000,0,123000
132615801200000,NW 329,RESIDENTIAL,25600,0,25600,99300,0,124900
132615900100000,NW 329,RESIDENTIAL,25600,0,25600,86000,0,111600
132615900200000,NW 329,RESIDENTIAL,22600,0,22600,102600,0,125200
132615900300000,NW 329,RESIDENTIAL,22600,0,22600,81300,0,103900
132615900400000,NW 329,RESIDENTIAL,23300,0,23300,97000,0,120300
132615900500000,NW 329,RESIDENTIAL,24800,0,24800,91800,0,116600
132615900600000,NW 329,RESIDENTIAL,26600,0,26600,100900,0,127500
132615900700000,NW 329,RESIDENTIAL,26100,0,26100,96500,0,122600
132615900800000,NW 329,RESIDENTIAL,23300,0,23300,88500,0,111800
132617600100000,NW 329,RESIDENTIAL,28200,0,28200,82000,0,110200
132617600200000,NW 329,RESIDENTIAL,29200,0,29200,72700,0,101900
132617700100000,NW 329,RESIDENTIAL,25400,0,25400,85900,0,111300
132617700200000,NW 329,RESIDENTIAL,24400,0,24400,59600,0,84000
132617700300000,NW 329,RESIDENTIAL,25800,0,25800,95000,0,120800
132617700400000,NW 329,RESIDENTIAL,26900,0,26900,95000,0,121900
132617700500000,NW 329,RESIDENTIAL,27400,0,27400,87300,0,114700
132617700600000,NW 329,RESIDENTIAL,27000,0,27000,91600,0,118600
132617700700000,NW 329,RESIDENTIAL,25000,0,25000,82400,0,107400
132617700800000,NW 329,RESIDENTIAL,26000,0,26000,88600,0,114600
132617700900000,NW 329,RESIDENTIAL,23800,0,23800,81800,0,105600
132617701000000,NW 329,RESIDENTIAL,26300,0,26300,93200,0,119500
132617701100000,NW 329,RESIDENTIAL,26300,0,26300,73500,0,99800
132617701200000,NW 329,RESIDENTIAL,25900,0,25900,75200,0,101100
132617701300000,NW 329,RESIDENTIAL,25600,0,25600,74400,0,100000
132617701400000,NW 329,RESIDENTIAL,25300,0,25300,79600,0,104900
132617701500000,NW 329,RESIDENTIAL,24600,0,24600,72500,0,97100
132617701600000,NW 329,RESIDENTIAL,26000,0,26000,87500,0,113500
132617800100000,NW 329,RESIDENTIAL,27000,0,27000,71200,0,98200
132617800200000,NW 329,RESIDENTIAL,23800,0,23800,90700,0,114500
132617800300000,NW 329,RESIDENTIAL,23200,0,23200,68900,0,92100
132617800400000,NW 329,RESIDENTIAL,24400,0,24400,75600,0,100000
132617800500000,NW 329,RESIDENTIAL,26700,0,26700,80300,0,107000
132617800600000,NW 329,RESIDENTIAL,27200,0,27200,72800,0,100000
132617900100000,NW 329,RESIDENTIAL,26800,0,26800,89100,0,115900
132617900200000,NW 329,RESIDENTIAL,26500,0,26500,77900,0,104400
132617900300000,NW 329,RESIDENTIAL,27300,0,27300,85700,0,113000
132617900400000,NW 329,RESIDENTIAL,26700,0,26700,76800,0,103500
132617900500000,NW 329,RESIDENTIAL,26000,0,26000,85400,0,111400
132617900600000,NW 329,RESIDENTIAL,25400,0,25400,100900,0,126300
132617900700000,NW 329,RESIDENTIAL,25400,0,25400,80900,0,106300
132618000100000,NW 329,RESIDENTIAL,25600,0,25600,64600,0,90200
132618000200000,NW 329,RESIDENTIAL,23500,0,23500,98200,0,121700
132618000300000,NW 329,RESIDENTIAL,24200,0,24200,93000,0,117200
132618000400000,NW 329,RESIDENTIAL,24400,0,24400,75600,0,100000
132618000500000,NW 329,RESIDENTIAL,24400,0,24400,75300,0,99700
132618100100000,NW 329,RESIDENTIAL,29300,0,29300,101800,0,131100
132618200100000,NW 329,RESIDENTIAL,24400,0,24400,89800,0,114200
132618200200000,NW 329,RESIDENTIAL,25300,0,25300,83500,0,108800
132618200300000,NW 329,RESIDENTIAL,24300,0,24300,97000,0,121300
132618200400000,NW 329,RESIDENTIAL,23800,0,23800,91200,0,115000
132618200500000,NW 329,RESIDENTIAL,24100,0,24100,89000,0,113100
132618200600000,NW 329,RESIDENTIAL,25900,0,25900,82500,0,108400
132618200700000,NW 329,RESIDENTIAL,23200,0,23200,86600,0,109800
132618200800000,NW 329,RESIDENTIAL,23800,0,23800,104700,0,128500
132618200900000,NW 329,RESIDENTIAL,23800,0,23800,85200,0,109000
132618201000000,NW 329,RESIDENTIAL,25600,0,25600,100600,0,126200
132618201100000,NW 329,RESIDENTIAL,22900,0,22900,80000,0,102900
132618201200000,NW 329,RESIDENTIAL,23800,0,23800,68100,0,91900
132618201300000,NW 329,RESIDENTIAL,23800,0,23800,77200,0,101000
132618201400000,NW 329,RESIDENTIAL,25900,0,25900,0,0,25900
132618201500000,NW 329,RESIDENTIAL,24100,0,24100,84900,0,109000
132618201600000,NW 329,RESIDENTIAL,22900,0,22900,77400,0,100300
132618201700000,NW 329,RESIDENTIAL,25500,0,25500,86900,0,112400
132618201800000,NW 329,RESIDENTIAL,25700,0,25700,143700,0,169400
132618201900000,NW 329,RESIDENTIAL,26100,0,26100,104400,0,130500
132618202000000,NW 329,RESIDENTIAL,25000,0,25000,100400,0,125400
132618202100000,NW 329,RESIDENTIAL,25200,0,25200,101200,0,126400
132618202200000,NW 329,RESIDENTIAL,26500,0,26500,94900,0,121400
132618202300000,NW 329,RESIDENTIAL,25000,0,25000,85100,0,110100
132618202400000,NW 329,RESIDENTIAL,25000,0,25000,97300,0,122300
132618202500000,NW 329,RESIDENTIAL,26000,0,26000,86700,0,112700
132618202600000,NW 329,RESIDENTIAL,24800,0,24800,93400,0,118200
132618202700000,NW 329,RESIDENTIAL,24700,0,24700,64400,0,89100
132618202800000,NW 329,RESIDENTIAL,25600,0,25600,96100,0,121700
132618202900000,NW 329,RESIDENTIAL,25000,0,25000,93400,0,118400
132618203000000,NW 329,RESIDENTIAL,24200,0,24200,86200,0,110400
132618203100000,NW 329,RESIDENTIAL,23900,0,23900,88600,0,112500
132618203200000,NW 329,RESIDENTIAL,25000,0,25000,84600,0,109600
132618300100000,NW 329,RESIDENTIAL,29400,0,29400,78900,0,108300
132618300200000,NW 329,RESIDENTIAL,24300,0,24300,101200,0,125500
132618300300000,NW 329,RESIDENTIAL,24400,0,24400,93000,0,117400
132618300400000,NW 329,RESIDENTIAL,24200,0,24200,92300,0,116500
132618300500000,NW 329,RESIDENTIAL,22400,0,22400,94500,0,116900
132618300600000,NW 329,RESIDENTIAL,23100,0,23100,91400,0,114500
132618300700000,NW 329,RESIDENTIAL,23900,0,23900,106000,0,129900
132618301500000,NW 329,RESIDENTIAL,26300,0,26300,87300,0,113600
132618301600000,NW 329,RESIDENTIAL,22300,0,22300,79400,0,101700
132618301700000,NW 329,RESIDENTIAL,22300,0,22300,84200,0,106500
132618301800000,NW 329,RESIDENTIAL,23000,0,23000,81000,0,104000
132618301900000,NW 329,RESIDENTIAL,22400,0,22400,81900,0,104300
132618302000000,NW 329,RESIDENTIAL,23700,0,23700,94200,0,117900
132618302100000,NW 329,RESIDENTIAL,22300,0,22300,88800,0,111100
132618302200000,NW 329,RESIDENTIAL,23500,0,23500,79600,0,103100
132618302300000,NW 329,RESIDENTIAL,24600,0,24600,94400,0,119000
132618302400000,NW 329,RESIDENTIAL,24700,0,24700,81300,0,106000
132618302500000,NW 329,RESIDENTIAL,23300,0,23300,82200,0,105500
132618302600000,NW 329,RESIDENTIAL,23500,0,23500,88500,0,112000
132618302700000,NW 329,RESIDENTIAL,26200,0,26200,77600,0,103800
132618302800000,NW 329,RESIDENTIAL,28300,0,28300,100000,0,128300
132618400100000,NW 329,RESIDENTIAL,25000,0,25000,68000,0,93000
132618400200000,NW 329,RESIDENTIAL,24100,0,24100,90400,0,114500
132618400300000,NW 329,RESIDENTIAL,26100,0,26100,78600,0,104700
132618400400000,NW 329,RESIDENTIAL,24800,0,24800,72300,0,97100
132618400500000,NW 329,RESIDENTIAL,26100,0,26100,73700,0,99800
132618400600000,NW 329,RESIDENTIAL,25800,0,25800,90300,0,116100
132618400700000,NW 329,RESIDENTIAL,25800,0,25800,96900,0,122700
132618400800000,NW 329,RESIDENTIAL,26100,0,26100,84000,0,110100
132618400900000,NW 329,RESIDENTIAL,24600,0,24600,84200,0,108800
132618401000000,NW 329,RESIDENTIAL,25600,0,25600,81200,0,106800
132618401100000,NW 329,RESIDENTIAL,26000,0,26000,95700,0,121700
132618401200000,NW 329,RESIDENTIAL,26100,0,26100,85600,0,111700
132618401300000,NW 329,RESIDENTIAL,26100,0,26100,90400,0,116500
132618401400000,NW 329,RESIDENTIAL,25800,0,25800,79200,0,105000
132618500100000,NW 329,RESIDENTIAL,26100,0,26100,86200,0,112300
132618500200000,NW 329,RESIDENTIAL,23600,0,23600,88700,0,112300
132618500300000,NW 329,RESIDENTIAL,24400,0,24400,101800,0,126200
132618500400000,NW 329,RESIDENTIAL,26700,0,26700,83200,0,109900
132618500500000,NW 329,RESIDENTIAL,25600,0,25600,80000,0,105600
132618500600000,NW 329,RESIDENTIAL,24700,0,24700,101800,0,126500
132618500700000,NW 329,RESIDENTIAL,24600,0,24600,80300,0,104900
132618500800000,NW 329,RESIDENTIAL,26600,0,26600,65300,0,91900
132618500900000,NW 329,RESIDENTIAL,26100,0,26100,81000,0,107100
132618501000000,NW 329,RESIDENTIAL,26200,0,26200,67300,0,93500
132618501100000,NW 329,RESIDENTIAL,26200,0,26200,92300,0,118500
132618501200000,NW 329,RESIDENTIAL,25600,0,25600,86800,0,112400
132618501300000,NW 329,RESIDENTIAL,23900,0,23900,81800,0,105700
132618501400000,NW 329,RESIDENTIAL,24600,0,24600,77600,0,102200
132618501500000,NW 329,RESIDENTIAL,25500,0,25500,87200,0,112700
132618501600000,NW 329,RESIDENTIAL,23200,0,23200,89900,0,113100
132618501700000,NW 329,RESIDENTIAL,24400,0,24400,97800,0,122200
132618501800000,NW 329,RESIDENTIAL,26000,0,26000,97600,0,123600
132618501900000,NW 329,RESIDENTIAL,27000,0,27000,100700,0,127700
132618502000000,NW 329,RESIDENTIAL,26100,0,26100,96800,0,122900
132618502100000,NW 329,RESIDENTIAL,24700,0,24700,90600,0,115300
132618502200000,NW 329,RESIDENTIAL,26500,0,26500,96100,0,122600
132618502300000,NW 329,RESIDENTIAL,26700,0,26700,91900,0,118600
132618502400000,NW 329,RESIDENTIAL,25700,0,25700,100500,0,126200
132618502500000,NW 329,RESIDENTIAL,24900,0,24900,95500,0,120400
132618502600000,NW 329,RESIDENTIAL,24200,0,24200,77500,0,101700
132618502700000,NW 329,RESIDENTIAL,24200,0,24200,113400,0,137600
132618502800000,NW 329,RESIDENTIAL,23800,0,23800,94200,0,118000
132618502900000,NW 329,RESIDENTIAL,26900,0,26900,101100,0,128000
132618503000000,NW 329,RESIDENTIAL,27100,0,27100,93200,0,120300
132618503100000,NW 329,RESIDENTIAL,24300,0,24300,98800,0,123100
132618503200000,NW 329,RESIDENTIAL,26300,0,26300,92100,0,118400
132618503300000,CHURCH,EXEMPT,0,122600,122600,0,480500,603100
132618503400000,NW 329,RESIDENTIAL,26900,0,26900,74900,0,101800
132618503500000,NW 329,RESIDENTIAL,26100,0,26100,77000,0,103100
132618503600000,NW 329,RESIDENTIAL,27600,0,27600,68900,0,96500
132618503700000,NW 329,RESIDENTIAL,29300,0,29300,74600,0,103900
132618600100000,NW 329,RESIDENTIAL,25400,0,25400,93300,0,118700
132618600200000,NW 329,RESIDENTIAL,23400,0,23400,88200,0,111600
132618600300000,NW 329,RESIDENTIAL,26400,0,26400,89900,0,116300
132618600400000,NW 329,RESIDENTIAL,24100,0,24100,96900,0,121000
132618600500000,NW 329,RESIDENTIAL,24100,0,24100,93900,0,118000
132618600600000,NW 329,RESIDENTIAL,24100,0,24100,95500,0,119600
132618600700000,NW 329,RESIDENTIAL,24100,0,24100,95500,0,119600
132618600800000,NW 329,RESIDENTIAL,25400,0,25400,93200,0,118600
132618600900000,NW 329,RESIDENTIAL,22900,0,22900,68000,0,90900
132618601000000,NW 329,RESIDENTIAL,25300,0,25300,94200,0,119500
132618601100000,NW 329,RESIDENTIAL,24100,0,24100,98100,0,122200
132618601200000,NW 329,RESIDENTIAL,24100,0,24100,97000,0,121100
132618601300000,NW 329,RESIDENTIAL,24100,0,24100,106200,0,130300
132618601400000,NW 329,RESIDENTIAL,24300,0,24300,99100,0,123400
132618700100000,NW 329,RESIDENTIAL,25300,0,25300,98000,0,123300
132618700200000,NW 329,RESIDENTIAL,22600,0,22600,92700,0,115300
132618700300000,NW 329,RESIDENTIAL,23400,0,23400,93400,0,116800
132618700400000,NW 329,RESIDENTIAL,22300,0,22300,87400,0,109700
132618700500000,NW 329,RESIDENTIAL,22300,0,22300,97700,0,120000
132618700600000,NW 329,RESIDENTIAL,22300,0,22300,75800,0,98100
132618700700000,NW 329,RESIDENTIAL,22300,0,22300,112900,0,135200
132618700800000,NW 329,RESIDENTIAL,23000,0,23000,106500,0,129500
132618700900000,NW 329,RESIDENTIAL,22300,0,22300,99300,0,121600
132618701000000,NW 329,RESIDENTIAL,22300,0,22300,82900,0,105200
132618701100000,NW 329,RESIDENTIAL,22300,0,22300,96400,0,118700
132618701200000,NW 329,RESIDENTIAL,22300,0,22300,94000,0,116300
132618701300000,NW 329,RESIDENTIAL,23000,0,23000,96100,0,119100
132618701400000,NW 329,RESIDENTIAL,23000,0,23000,90400,0,113400
132618701500000,NW 329,RESIDENTIAL,25000,0,25000,102800,0,127800
132620100100000,NW 329,RESIDENTIAL,52000,0,52000,141000,0,193000
132620100500000,NW 334,RESIDENTIAL,29200,0,29200,0,0,29200
132620100600000,NW 334,RESIDENTIAL,28200,0,28200,194300,0,222500
132620100700000,NW 334,RESIDENTIAL,28200,0,28200,193200,0,221400
132620100800000,NW 334,RESIDENTIAL,29100,0,29100,170900,0,200000
132620100900000,NW 334,RESIDENTIAL,28800,0,28800,176600,0,205400
132620101000000,NW 334,RESIDENTIAL,28100,0,28100,0,0,28100
132620101100000,NW 334,RESIDENTIAL,33100,0,33100,156200,0,189300
132620101200000,NW 334,RESIDENTIAL,33400,0,33400,178800,0,212200
132620101300000,NW 334,RESIDENTIAL,31100,0,31100,174400,0,205500
132620101400000,NW 334,RESIDENTIAL,39800,0,39800,158900,0,198700
132620101500000,NW 334,RESIDENTIAL,38900,0,38900,153400,0,192300
132620101600000,NW 334,RESIDENTIAL,30100,0,30100,164000,0,194100
132620101800000,NW 334,RESIDENTIAL,40800,0,40800,176600,0,217400
132620102000000,NW 334,RESIDENTIAL,25300,0,25300,180400,0,205700
132620102100000,NW 334,RESIDENTIAL,38600,0,38600,176800,0,215400
132620200100000,NW 329,RESIDENTIAL,26500,0,26500,83400,0,109900
132620200200000,NW 329,RESIDENTIAL,26000,0,26000,90100,0,116100
132620200300000,NW 329,RESIDENTIAL,24800,0,24800,90000,0,114800
132620200400000,NW 329,RESIDENTIAL,24800,0,24800,84700,0,109500
132620200500000,NW 329,RESIDENTIAL,24800,0,24800,99300,0,124100
132620200600000,NW 329,RESIDENTIAL,24800,0,24800,93200,0,118000
132620200700000,NW 329,RESIDENTIAL,24800,0,24800,74700,0,99500
132620200800000,NW 329,RESIDENTIAL,24800,0,24800,99400,0,124200
132620200900000,NW 329,RESIDENTIAL,24800,0,24800,90700,0,115500
132620201000000,NW 329,RESIDENTIAL,27100,0,27100,96700,0,123800
132620201100000,NW 334,RESIDENTIAL,36500,0,36500,189600,0,226100
132620201200000,NW 334,RESIDENTIAL,34000,0,34000,171600,0,205600
132620201300000,NW 334,RESIDENTIAL,37200,0,37200,166100,0,203300
132620201400000,NW 334,RESIDENTIAL,34000,0,34000,162300,0,196300
132620201500000,NW 334,RESIDENTIAL,34000,0,34000,169200,0,203200
132620201600000,NW 334,RESIDENTIAL,34000,0,34000,189800,0,223800
132620201700000,NW 334,RESIDENTIAL,34000,0,34000,173700,0,207700
132620201800000,NW 334,RESIDENTIAL,34700,0,34700,188700,0,223400
132620201900000,NW 334,RESIDENTIAL,39300,0,39300,180400,0,219700
132620202000000,NW 334,RESIDENTIAL,36600,0,36600,164800,0,201400
132620202100000,NW 334,RESIDENTIAL,39200,0,39200,191000,0,230200
132620202200000,NW 334,RESIDENTIAL,30700,0,30700,186800,0,217500
132620202300000,NW 334,RESIDENTIAL,31100,0,31100,172300,0,203400
132620202400000,NW 334,RESIDENTIAL,31100,0,31100,187400,0,218500
132620202500000,NW 334,RESIDENTIAL,31900,0,31900,249400,0,281300
132622600100000,CHURCH,EXEMPT,0,699400,699400,0,3376500,4075900
132625100100000,NW 329,RESIDENTIAL,24500,0,24500,88600,0,113100
132625100300000,NW 329,RESIDENTIAL,26500,0,26500,103400,0,129900
132625100400000,NW 329,RESIDENTIAL,24000,0,24000,90600,0,114600
132625100500000,NW 329,RESIDENTIAL,24000,0,24000,96700,0,120700
132625100600000,NW 329,RESIDENTIAL,21800,0,21800,113800,0,135600
132625100700000,NW 329,RESIDENTIAL,23000,0,23000,89600,0,112600
132625100800000,NW 329,RESIDENTIAL,20800,0,20800,98700,0,119500
132625100900000,NW 329,RESIDENTIAL,24000,0,24000,98500,0,122500
132625101000000,NW 329,RESIDENTIAL,20800,0,20800,116100,0,136900
132625200100000,NW 329,RESIDENTIAL,27100,0,27100,105100,0,132200
132625200200000,NW 332,RESIDENTIAL,29500,0,29500,184000,0,213500
132625200300000,NW 329,RESIDENTIAL,25800,0,25800,109400,0,135200
132625200400000,NW 329,RESIDENTIAL,25800,0,25800,108100,0,133900
132625200500000,NW 329,RESIDENTIAL,25800,0,25800,102400,0,128200
132625200600000,NW 329,RESIDENTIAL,25800,0,25800,93800,0,119600
132625200700000,NW 329,RESIDENTIAL,25800,0,25800,98600,0,124400
132625200800000,NW 329,RESIDENTIAL,25800,0,25800,103400,0,129200
132625200900000,NW 329,RESIDENTIAL,25800,0,25800,111500,0,137300
132625201000000,NW 329,RESIDENTIAL,25800,0,25800,99800,0,125600
132625201100000,NW 329,RESIDENTIAL,25800,0,25800,96700,0,122500
132625201200000,NW 329,RESIDENTIAL,25800,0,25800,100200,0,126000
132625201300000,NW 329,RESIDENTIAL,25800,0,25800,76100,0,101900
132625201400000,NW 329,RESIDENTIAL,25800,0,25800,99000,0,124800
132625201500000,NW 329,RESIDENTIAL,25800,0,25800,86200,0,112000
132625201600000,NW 329,RESIDENTIAL,25800,0,25800,97500,0,123300
132625201700000,NW 329,RESIDENTIAL,25800,0,25800,92400,0,118200
132625201800000,NW 329,RESIDENTIAL,25800,0,25800,101300,0,127100
132625201900000,NW 329,RESIDENTIAL,29700,0,29700,77900,0,107600
132625202000000,NW 329,RESIDENTIAL,23800,0,23800,86700,0,110500
132625202100000,NW 329,RESIDENTIAL,25200,0,25200,103400,0,128600
132625202200000,NW 329,RESIDENTIAL,24000,0,24000,94400,0,118400
132625202300000,NW 329,RESIDENTIAL,25200,0,25200,103700,0,128900
132625202400000,NW 329,RESIDENTIAL,24000,0,24000,86900,0,110900
132625202500000,NW 329,RESIDENTIAL,25600,0,25600,91300,0,116900
132625202600000,NW 329,RESIDENTIAL,24000,0,24000,101100,0,125100
132625202700000,NW 329,RESIDENTIAL,25900,0,25900,100100,0,126000
132627600100000,CITY PROPERTY,EXEMPT,0,0,0,0,0,0
132627600200000,NW 329,RESIDENTIAL,26500,0,26500,103500,0,130000
132627600300000,NW 329,RESIDENTIAL,24400,0,24400,93600,0,118000
132627600400000,NW 329,RESIDENTIAL,24400,0,24400,106900,0,131300
132627600500000,NW 329,RESIDENTIAL,24400,0,24400,99500,0,123900
132627600600000,NW 329,RESIDENTIAL,24400,0,24400,113600,0,138000
132627600700000,NW 329,RESIDENTIAL,24400,0,24400,103600,0,128000
132627700100000,NW 329,RESIDENTIAL,23000,0,23000,103500,0,126500
132627700200000,NW 329,RESIDENTIAL,23200,0,23200,88100,0,111300
132627700300000,NW 329,RESIDENTIAL,23200,0,23200,104500,0,127700
132627700400000,NW 329,RESIDENTIAL,23200,0,23200,80600,0,103800
132627700500000,NW 329,RESIDENTIAL,24300,0,24300,106700,0,131000
132627700600000,NW 329,RESIDENTIAL,24000,0,24000,94300,0,118300
132627700700000,NW 329,RESIDENTIAL,25200,0,25200,103100,0,128300
132627700800000,NW 329,RESIDENTIAL,24100,0,24100,88100,0,112200
132627700900000,NW 329,RESIDENTIAL,22600,0,22600,90200,0,112800
132627701000000,NW 329,RESIDENTIAL,22600,0,22600,109200,0,131800
132627701100000,NW 329,RESIDENTIAL,22600,0,22600,85400,0,108000
132627701200000,NW 329,RESIDENTIAL,23500,0,23500,86300,0,109800
132627701300000,NW 329,RESIDENTIAL,24000,0,24000,111800,0,135800
132627800100000,NW 329,RESIDENTIAL,28800,0,28800,97600,0,126400
132627800200000,NW 329,RESIDENTIAL,26500,0,26500,86900,0,113400
132627800300000,NW 329,RESIDENTIAL,26500,0,26500,96300,0,122800
132627800400000,NW 329,RESIDENTIAL,26500,0,26500,87100,0,113600
132627800500000,NW 329,RESIDENTIAL,26500,0,26500,94500,0,121000
132627800600000,NW 329,RESIDENTIAL,28500,0,28500,107000,0,135500
132627900100000,NW 329,RESIDENTIAL,26500,0,26500,111900,0,138400
132627900200000,NW 329,RESIDENTIAL,24100,0,24100,84900,0,109000
132627900300000,NW 329,RESIDENTIAL,26500,0,26500,99200,0,125700
132627900400000,NW 329,RESIDENTIAL,25300,0,25300,96900,0,122200
132627900500000,NW 329,RESIDENTIAL,25300,0,25300,86600,0,111900
132627900600000,NW 329,RESIDENTIAL,25300,0,25300,87600,0,112900
132627900700000,NW 329,RESIDENTIAL,25300,0,25300,107600,0,132900
132627900800000,NW 329,RESIDENTIAL,25300,0,25300,100500,0,125800
132627900900000,NW 329,RESIDENTIAL,25300,0,25300,107700,0,133000
132627901000000,NW 329,RESIDENTIAL,25300,0,25300,100200,0,125500
132627901100000,NW 329,RESIDENTIAL,25300,0,25300,95800,0,121100
132627901200000,NW 329,RESIDENTIAL,25700,0,25700,118400,0,144100
132627901300000,NW 329,RESIDENTIAL,25500,0,25500,99500,0,125000
132627901400000,NW 329,RESIDENTIAL,25900,0,25900,104900,0,130800
132627901500000,NW 329,RESIDENTIAL,25700,0,25700,81400,0,107100
132627901600000,NW 329,RESIDENTIAL,25300,0,25300,96900,0,122200
132627901700000,NW 329,RESIDENTIAL,25300,0,25300,108000,0,133300
132627901800000,NW 329,RESIDENTIAL,25300,0,25300,93700,0,119000
132627901900000,NW 329,RESIDENTIAL,25300,0,25300,99500,0,124800
132627902000000,NW 329,RESIDENTIAL,25300,0,25300,97700,0,123000
132627902100000,NW 329,RESIDENTIAL,25300,0,25300,88000,0,113300
132627902200000,NW 329,RESIDENTIAL,25300,0,25300,96100,0,121400
132627902300000,NW 329,RESIDENTIAL,25300,0,25300,97100,0,122400
132628000100000,NW 329,RESIDENTIAL,26500,0,26500,103100,0,129600
132628000200000,NW 329,RESIDENTIAL,24100,0,24100,104600,0,128700
132628000300000,NW 329,RESIDENTIAL,26500,0,26500,92100,0,118600
132628000400000,NW 329,RESIDENTIAL,25300,0,25300,95400,0,120700
132628000500000,NW 329,RESIDENTIAL,24900,0,24900,111600,0,136500
132628000600000,NW 329,RESIDENTIAL,24900,0,24900,99900,0,124800
132628000700000,NW 329,RESIDENTIAL,24900,0,24900,97600,0,122500
132628000800000,NW 329,RESIDENTIAL,24900,0,24900,97000,0,121900
132628000900000,NW 329,RESIDENTIAL,24900,0,24900,90100,0,115000
132628001000000,NW 329,RESIDENTIAL,24900,0,24900,91800,0,116700
132628001100000,NW 329,RESIDENTIAL,24900,0,24900,88500,0,113400
132628001200000,NW 329,RESIDENTIAL,26500,0,26500,99000,0,125500
132628001300000,NW 329,RESIDENTIAL,26600,0,26600,85700,0,112300
132628001400000,NW 329,RESIDENTIAL,25700,0,25700,90300,0,116000
132628001500000,NW 329,RESIDENTIAL,25200,0,25200,91900,0,117100
132628001600000,NW 329,RESIDENTIAL,24900,0,24900,94800,0,119700
132628001700000,NW 329,RESIDENTIAL,24900,0,24900,93100,0,118000
132628001800000,NW 329,RESIDENTIAL,24900,0,24900,104400,0,129300
132628001900000,NW 329,RESIDENTIAL,24900,0,24900,95100,0,120000
132628002000000,NW 329,RESIDENTIAL,24900,0,24900,96100,0,121000
132628002100000,NW 329,RESIDENTIAL,24900,0,24900,98100,0,123000
132628002200000,NW 329,RESIDENTIAL,24900,0,24900,90300,0,115200
132628002300000,NW 329,RESIDENTIAL,25300,0,25300,92800,0,118100
132628100100000,NW 329,RESIDENTIAL,26500,0,26500,104200,0,130700
132628100200000,NW 329,RESIDENTIAL,24100,0,24100,99200,0,123300
132628100300000,NW 329,RESIDENTIAL,26500,0,26500,115600,0,142100
132628100400000,NW 329,RESIDENTIAL,25700,0,25700,85700,0,111400
132628100500000,NW 329,RESIDENTIAL,22200,0,22200,115500,0,137700
132628100600000,NW 329,RESIDENTIAL,23800,0,23800,107300,0,131100
132628100700000,NW 329,RESIDENTIAL,22200,0,22200,77000,0,99200
132628100800000,NW 329,RESIDENTIAL,23800,0,23800,103700,0,127500
132628100900000,NW 329,RESIDENTIAL,22800,0,22800,95100,0,117900
132628101000000,NW 329,RESIDENTIAL,24700,0,24700,113900,0,138600
132628101100000,NW 329,RESIDENTIAL,24600,0,24600,99900,0,124500
132628101200000,NW 329,RESIDENTIAL,27200,0,27200,110600,0,137800
132628101300000,NW 329,RESIDENTIAL,28100,0,28100,113700,0,141800
132628101400000,NW 329,RESIDENTIAL,28600,0,28600,89500,0,118100
132628101500000,NW 329,RESIDENTIAL,26300,0,26300,95500,0,121800
132628101600000,NW 329,RESIDENTIAL,26500,0,26500,101800,0,128300
132628101700000,NW 329,RESIDENTIAL,24900,0,24900,84000,0,108900
132628101800000,NW 329,RESIDENTIAL,24900,0,24900,97900,0,122800
132628101900000,NW 329,RESIDENTIAL,24900,0,24900,103000,0,127900
132628102000000,NW 329,RESIDENTIAL,24900,0,24900,101200,0,126100
132628102100000,NW 329,RESIDENTIAL,24900,0,24900,96600,0,121500
132628102200000,NW 329,RESIDENTIAL,24900,0,24900,94000,0,118900
132628102300000,NW 329,RESIDENTIAL,24900,0,24900,109600,0,134500
132628102400000,NW 329,RESIDENTIAL,25300,0,25300,99600,0,124900
132628200100000,NW 329,RESIDENTIAL,24600,0,24600,80700,0,105300
132628200200000,NW 329,RESIDENTIAL,21300,0,21300,86100,0,107400
132628200300000,NW 329,RESIDENTIAL,21300,0,21300,88200,0,109500
132628200400000,NW 329,RESIDENTIAL,24400,0,24400,84100,0,108500
132628200500000,NW 329,RESIDENTIAL,24800,0,24800,104100,0,128900
132628200600000,NW 329,RESIDENTIAL,22200,0,22200,106200,0,128400
132628200700000,NW 329,RESIDENTIAL,22200,0,22200,86400,0,108600
132628200800000,NW 329,RESIDENTIAL,22200,0,22200,90000,0,112200
132628200900000,NW 329,RESIDENTIAL,24200,0,24200,94900,0,119100
132628201000000,NW 329,RESIDENTIAL,22200,0,22200,100300,0,122500
132628201100000,NW 329,RESIDENTIAL,22000,0,22000,100500,0,122500
132628201200000,NW 329,RESIDENTIAL,24400,0,24400,98500,0,122900
132628201300000,NW 329,RESIDENTIAL,29300,0,29300,91700,0,121000
132628201400000,NW 329,RESIDENTIAL,29200,0,29200,115100,0,144300
132628201500000,NW 329,RESIDENTIAL,23800,0,23800,90700,0,114500
132628201600000,NW 329,RESIDENTIAL,23700,0,23700,99500,0,123200
132628201700000,NW 329,RESIDENTIAL,21800,0,21800,96000,0,117800
132628201800000,NW 329,RESIDENTIAL,24200,0,24200,102500,0,126700
132628201900000,NW 329,RESIDENTIAL,22600,0,22600,96300,0,118900
132628202000000,NW 329,RESIDENTIAL,24200,0,24200,86400,0,110600
132628202100000,NW 329,RESIDENTIAL,22600,0,22600,88200,0,110800
132628202200000,NW 329,RESIDENTIAL,25100,0,25100,98400,0,123500
132628300100000,NW 329,RESIDENTIAL,28600,0,28600,98700,0,127300
132628300200000,NW 329,RESIDENTIAL,26700,0,26700,99900,0,126600
132628300300000,NW 329,RESIDENTIAL,26500,0,26500,105600,0,132100
132630100100000,NW 329,RESIDENTIAL,26700,0,26700,85100,0,111800
132630100200000,NW 329,RESIDENTIAL,26100,0,26100,85300,0,111400
132630100300000,NW 329,RESIDENTIAL,26000,0,26000,82500,0,108500
132630100400000,NW 329,RESIDENTIAL,27000,0,27000,81500,0,108500
132630100500000,NW 329,RESIDENTIAL,28100,0,28100,105000,0,133100
132630100600000,NW 329,RESIDENTIAL,29700,0,29700,90700,0,120400
132630100700000,NW 329,RESIDENTIAL,27500,0,27500,95800,0,123300
132630100800000,NW 329,RESIDENTIAL,27600,0,27600,103300,0,130900
132630100900000,NW 329,RESIDENTIAL,26100,0,26100,96500,0,122600
132630101000000,NW 329,RESIDENTIAL,30200,0,30200,102900,0,133100
132630101100000,NW 329,RESIDENTIAL,29400,0,29400,116100,0,145500
132630200100000,NW 329,RESIDENTIAL,28400,0,28400,109200,0,137600
132630200200000,NW 329,RESIDENTIAL,27900,0,27900,87700,0,115600
132630200300000,NW 329,RESIDENTIAL,25600,0,25600,96200,0,121800
132630200400000,NW 329,RESIDENTIAL,25300,0,25300,104400,0,129700
132630200500000,NW 329,RESIDENTIAL,26400,0,26400,86000,0,112400
132630200600000,NW 329,RESIDENTIAL,27600,0,27600,97300,0,124900
132630200700000,NW 329,RESIDENTIAL,24800,0,24800,88400,0,113200
132630200800000,NW 329,RESIDENTIAL,27200,0,27200,108600,0,135800
132630200900000,NW 329,RESIDENTIAL,26400,0,26400,96000,0,122400
132630201000000,NW 329,EXEMPT,0,27000,27000,0,83100,110100
132630201100000,NW 329,RESIDENTIAL,26800,0,26800,87200,0,114000
132630201200000,NW 329,RESIDENTIAL,27100,0,27100,102900,0,130000
132630300100000,NW 329,RESIDENTIAL,26100,0,26100,103100,0,129200
132630300200000,NW 329,RESIDENTIAL,26800,0,26800,99100,0,125900
132630300300000,NW 329,RESIDENTIAL,28100,0,28100,107000,0,135100
132630300400000,NW 329,RESIDENTIAL,25700,0,25700,96200,0,121900
132630300500000,NW 329,RESIDENTIAL,26300,0,26300,115700,0,142000
132630300600000,NW 329,RESIDENTIAL,27700,0,27700,82900,0,110600
132630300700000,NW 329,RESIDENTIAL,25400,0,25400,80100,0,105500
132630400100000,NW 329,RESIDENTIAL,26000,0,26000,109400,0,135400
132630500100000,NW 329,RESIDENTIAL,30600,0,30600,107300,0,137900
132630500200000,NW 329,RESIDENTIAL,27200,0,27200,85300,0,112500
132630500300000,NW 329,RESIDENTIAL,26900,0,26900,107900,0,134800
132630500400000,NW 329,RESIDENTIAL,26000,0,26000,94700,0,120700
132630500500000,NW 329,RESIDENTIAL,27200,0,27200,95400,0,122600
132630500600000,NW 329,RESIDENTIAL,27400,0,27400,104600,0,132000
132630500700000,NW 329,RESIDENTIAL,28500,0,28500,115500,0,144000
132630500800000,NW 329,RESIDENTIAL,30000,0,30000,103100,0,133100
132630500900000,NW 329,RESIDENTIAL,29700,0,29700,94900,0,124600
132630501000000,NW 329,RESIDENTIAL,29400,0,29400,98200,0,127600
132630501100000,NW 329,RESIDENTIAL,29800,0,29800,111400,0,141200
132630501200000,NW 329,RESIDENTIAL,31600,0,31600,95400,0,127000
132630600100000,NW 329,RESIDENTIAL,27400,0,27400,91200,0,118600
132630600200000,NW 329,RESIDENTIAL,26100,0,26100,106000,0,132100
132630600300000,NW 329,RESIDENTIAL,34800,0,34800,108600,0,143400
132630600400000,NW 329,RESIDENTIAL,27100,0,27100,100100,0,127200
132630600500000,NW 329,RESIDENTIAL,27600,0,27600,92900,0,120500
132630600600000,NW 329,RESIDENTIAL,26700,0,26700,91900,0,118600
132630600700000,NW 329,RESIDENTIAL,25300,0,25300,109800,0,135100
132630600800000,NW 329,RESIDENTIAL,25800,0,25800,102300,0,128100
132630600900000,NW 329,RESIDENTIAL,25800,0,25800,92600,0,118400
132630601000000,NW 329,RESIDENTIAL,25800,0,25800,109300,0,135100
132630601100000,NW 329,RESIDENTIAL,25800,0,25800,94700,0,120500
132630601200000,NW 329,RESIDENTIAL,26000,0,26000,100300,0,126300
132630601300000,NW 329,RESIDENTIAL,26000,0,26000,104500,0,130500
132630601400000,NW 329,RESIDENTIAL,26000,0,26000,97700,0,123700
132630601500000,NW 329,RESIDENTIAL,26900,0,26900,92900,0,119800
132630601600000,NW 329,RESIDENTIAL,26400,0,26400,99100,0,125500
132630601700000,NW 329,RESIDENTIAL,27100,0,27100,99200,0,126300
132630601800000,NW 329,RESIDENTIAL,25200,0,25200,104600,0,129800
132630601900000,NW 329,RESIDENTIAL,25200,0,25200,91000,0,116200
132630602000000,NW 329,RESIDENTIAL,26500,0,26500,98900,0,125400
132630602100000,NW 329,RESIDENTIAL,26500,0,26500,109500,0,136000
132630700100000,NW 329,RESIDENTIAL,27200,0,27200,101500,0,128700
132630700200000,NW 329,RESIDENTIAL,24800,0,24800,85800,0,110600
132630700300000,NW 329,RESIDENTIAL,27200,0,27200,113100,0,140300
132630700400000,NW 329,RESIDENTIAL,25100,0,25100,95900,0,121000
132630700500000,NW 329,RESIDENTIAL,25100,0,25100,95600,0,120700
132630700600000,NW 329,RESIDENTIAL,25100,0,25100,83100,0,108200
132630700700000,NW 329,RESIDENTIAL,25000,0,25000,84100,0,109100
132630700800000,NW 329,RESIDENTIAL,25900,0,25900,104800,0,130700
132630700900000,NW 329,RESIDENTIAL,25900,0,25900,90900,0,116800
132630701000000,NW 329,RESIDENTIAL,26000,0,26000,101600,0,127600
132630701100000,NW 329,RESIDENTIAL,24600,0,24600,91000,0,115600
132630701200000,NW 329,RESIDENTIAL,25400,0,25400,90600,0,116000
132630701300000,NW 329,RESIDENTIAL,25400,0,25400,97000,0,122400
132630701400000,NW 329,RESIDENTIAL,25400,0,25400,83300,0,108700
132630701500000,NW 329,RESIDENTIAL,26500,0,26500,98700,0,125200
132630701600000,NW 329,RESIDENTIAL,21300,0,21300,100000,0,121300
132630701700000,NW 329,RESIDENTIAL,23000,0,23000,83000,0,106000
132630701800000,NW 329,RESIDENTIAL,21100,0,21100,86500,0,107600
132630701900000,NW 329,RESIDENTIAL,23000,0,23000,88600,0,111600
132630702000000,NW 329,RESIDENTIAL,23800,0,23800,89000,0,112800
132630702100000,NW 329,RESIDENTIAL,22100,0,22100,91200,0,113300
132630702200000,NW 329,RESIDENTIAL,22500,0,22500,103300,0,125800
132630702300000,NW 329,RESIDENTIAL,23800,0,23800,86500,0,110300
132630702400000,NW 329,RESIDENTIAL,26800,0,26800,97900,0,124700
132630702500000,NW 329,RESIDENTIAL,25400,0,25400,103100,0,128500
132630702600000,NW 329,RESIDENTIAL,25400,0,25400,86500,0,111900
132630702700000,NW 329,RESIDENTIAL,25700,0,25700,98800,0,124500
132630702800000,NW 329,RESIDENTIAL,25700,0,25700,86200,0,111900
132630702900000,NW 329,RESIDENTIAL,25700,0,25700,97400,0,123100
132630703000000,NW 329,RESIDENTIAL,25700,0,25700,86700,0,112400
132630800100000,NW 329,RESIDENTIAL,27600,0,27600,113300,0,140900
132630800200000,NW 329,RESIDENTIAL,28000,0,28000,93800,0,121800
132630800300000,NW 329,RESIDENTIAL,27400,0,27400,100500,0,127900
132630800400000,NW 329,RESIDENTIAL,26700,0,26700,97300,0,124000
132630800500000,NW 329,RESIDENTIAL,26700,0,26700,117700,0,144400
132630800600000,NW 329,RESIDENTIAL,26900,0,26900,103400,0,130300
132630800700000,NW 329,RESIDENTIAL,26000,0,26000,122700,0,148700
132630800800000,NW 329,RESIDENTIAL,25200,0,25200,102700,0,127900
132630800900000,NW 329,RESIDENTIAL,25200,0,25200,101800,0,127000
132630801000000,NW 329,RESIDENTIAL,24800,0,24800,89900,0,114700
132630801100000,NW 329,RESIDENTIAL,24900,0,24900,111700,0,136600
132630801200000,NW 329,RESIDENTIAL,25900,0,25900,90900,0,116800
132630801300000,NW 329,RESIDENTIAL,23700,0,23700,108700,0,132400
132630801400000,NW 329,RESIDENTIAL,23200,0,23200,91200,0,114400
132630801500000,NW 329,RESIDENTIAL,21200,0,21200,96900,0,118100
132630801600000,NW 329,RESIDENTIAL,23300,0,23300,89800,0,113100
132630801700000,NW 329,RESIDENTIAL,21300,0,21300,90300,0,111600
132630801800000,NW 329,RESIDENTIAL,23300,0,23300,95300,0,118600
132630801900000,NW 329,RESIDENTIAL,21300,0,21300,105800,0,127100
132630802000000,NW 329,RESIDENTIAL,23300,0,23300,93800,0,117100
132630802100000,NW 329,RESIDENTIAL,23200,0,23200,86900,0,110100
132630802200000,NW 329,RESIDENTIAL,21300,0,21300,81100,0,102400
132630802300000,NW 329,RESIDENTIAL,23300,0,23300,123800,0,147100
132630802400000,NW 329,RESIDENTIAL,21300,0,21300,100500,0,121800
132630802500000,NW 329,RESIDENTIAL,23300,0,23300,97500,0,120800
132630802600000,NW 329,RESIDENTIAL,23800,0,23800,91200,0,115000
132630802700000,NW 329,RESIDENTIAL,21900,0,21900,84400,0,106300
132630802800000,NW 329,RESIDENTIAL,22000,0,22000,106500,0,128500
132630802900000,NW 329,RESIDENTIAL,21800,0,21800,85100,0,106900
132630803000000,NW 329,RESIDENTIAL,25200,0,25200,107800,0,133000
132630803100000,NW 329,RESIDENTIAL,25600,0,25600,98200,0,123800
132630803200000,NW 329,RESIDENTIAL,25300,0,25300,85800,0,111100
132630803300000,NW 329,RESIDENTIAL,25500,0,25500,92200,0,117700
132630803400000,NW 329,RESIDENTIAL,25100,0,25100,90900,0,116000
132630803500000,NW 329,RESIDENTIAL,25100,0,25100,92100,0,117200
132630803600000,NW 329,RESIDENTIAL,26700,0,26700,93800,0,120500
132630803700000,NW 329,RESIDENTIAL,26700,0,26700,95700,0,122400
132630803800000,NW 329,RESIDENTIAL,27000,0,27000,91300,0,118300
132630803900000,NW 329,RESIDENTIAL,28600,0,28600,103700,0,132300
132630804000000,NW 329,RESIDENTIAL,25900,0,25900,85300,0,111200
132630900100000,NW 329,RESIDENTIAL,29500,0,29500,122800,0,152300
132630900200000,NW 329,RESIDENTIAL,27000,0,27000,109800,0,136800
132630900300000,NW 329,RESIDENTIAL,25600,0,25600,97700,0,123300
132630900400000,NW 329,RESIDENTIAL,25600,0,25600,111900,0,137500
132630900500000,NW 329,RESIDENTIAL,25600,0,25600,89300,0,114900
132630900600000,NW 329,RESIDENTIAL,25600,0,25600,101800,0,127400
132630900700000,NW 329,RESIDENTIAL,25600,0,25600,70400,0,96000
132631000100000,NW 329,RESIDENTIAL,24800,0,24800,95900,0,120700
132631000200000,NW 329,RESIDENTIAL,24800,0,24800,90000,0,114800
132631000300000,NW 329,RESIDENTIAL,24800,0,24800,101000,0,125800
132631000400000,NW 329,RESIDENTIAL,27500,0,27500,113000,0,140500
132631000500000,NW 329,RESIDENTIAL,28900,0,28900,107900,0,136800
132631000600000,NW 329,RESIDENTIAL,29000,0,29000,88900,0,117900
132631000700000,NW 329,RESIDENTIAL,32100,0,32100,107400,0,139500
132631000800000,NW 329,RESIDENTIAL,29100,0,29100,94400,0,123500
132631000900000,NW 329,RESIDENTIAL,28600,0,28600,112800,0,141400
132631001000000,NW 329,RESIDENTIAL,28000,0,28000,100400,0,128400
132631001100000,NW 329,RESIDENTIAL,26600,0,26600,83800,0,110400
132631001200000,NW 329,RESIDENTIAL,27200,0,27200,108500,0,135700
132631001300000,NW 329,RESIDENTIAL,27400,0,27400,97700,0,125100
132631001400000,NW 329,RESIDENTIAL,27100,0,27100,103100,0,130200
132631100100000,NW 329,RESIDENTIAL,26700,0,26700,107000,0,133700
132631100200000,NW 329,RESIDENTIAL,25100,0,25100,97100,0,122200
132631100300000,NW 329,RESIDENTIAL,23500,0,23500,87200,0,110700
132631100400000,NW 329,RESIDENTIAL,25100,0,25100,100200,0,125300
132631100500000,NW 329,RESIDENTIAL,25100,0,25100,97200,0,122300
132631100600000,NW 329,RESIDENTIAL,25100,0,25100,102100,0,127200
132632600100000,NW 329,RESIDENTIAL,28000,0,28000,109700,0,137700
132632600200000,NW 329,RESIDENTIAL,24800,0,24800,93500,0,118300
132632600300000,NW 329,RESIDENTIAL,24800,0,24800,101700,0,126500
132632600400000,NW 329,RESIDENTIAL,28400,0,28400,103800,0,132200
132632700100000,NW 329,RESIDENTIAL,27200,0,27200,87800,0,115000
132632700200000,SCHOOL,EXEMPT,0,0,0,0,0,0
132632700300000,CITY PROPERTY,EXEMPT,0,0,0,0,0,0
132632700400000,NW 329,RESIDENTIAL,26800,0,26800,96400,0,123200
132632700500000,NW 329,RESIDENTIAL,25200,0,25200,106000,0,131200
132632700600000,NW 329,RESIDENTIAL,25200,0,25200,102800,0,128000
132632700700000,NW 329,RESIDENTIAL,25200,0,25200,103000,0,128200
132632700800000,NW 329,RESIDENTIAL,25200,0,25200,93400,0,118600
132632700900000,NW 329,RESIDENTIAL,25200,0,25200,95600,0,120800
132632701000000,NW 329,RESIDENTIAL,25200,0,25200,97100,0,122300
132632701100000,NW 329,RESIDENTIAL,25200,0,25200,96400,0,121600
132632800100000,NW 329,RESIDENTIAL,27500,0,27500,103700,0,131200
132632800200000,NW 332,RESIDENTIAL,44400,0,44400,182800,0,227200
132632800300000,NW 332,RESIDENTIAL,40400,0,40400,160400,0,200800
132632800400000,NW 332,RESIDENTIAL,40400,0,40400,177900,0,218300
132632800500000,NW 332,RESIDENTIAL,40400,0,40400,203000,0,243400
132632800600000,NW 332,RESIDENTIAL,40400,0,40400,169700,0,210100
132632800700000,NW 332,RESIDENTIAL,40400,0,40400,202800,0,243200
132632800800000,NW 332,RESIDENTIAL,44200,0,44200,177900,0,222100
132632801100000,NW 332,RESIDENTIAL,41800,0,41800,245500,0,287300
132632801200000,NW 332,RESIDENTIAL,41800,0,41800,241600,0,283400
132632801300000,NW 332,RESIDENTIAL,41800,0,41800,240800,0,282600
132632801400000,NW 332,RESIDENTIAL,41700,0,41700,287400,0,329100
132632801500000,NW 332,RESIDENTIAL,61700,0,61700,64400,0,126100
132632801600000,NW 329,RESIDENTIAL,26900,0,26900,93900,0,120800
132632801700000,NW 329,RESIDENTIAL,26500,0,26500,113300,0,139800
132632801800000,NW 329,RESIDENTIAL,24200,0,24200,94000,0,118200
132632801900000,NW 329,RESIDENTIAL,22400,0,22400,94700,0,117100
132632802000000,NW 329,RESIDENTIAL,26200,0,26200,91500,0,117700
132632802100000,NW 329,RESIDENTIAL,25900,0,25900,91300,0,117200
132632802200000,NW 329,RESIDENTIAL,23800,0,23800,85300,0,109100
132632802300000,NW 329,RESIDENTIAL,25900,0,25900,101600,0,127500
132632802400000,NW 329,RESIDENTIAL,24200,0,24200,88500,0,112700
132632802500000,NW 329,RESIDENTIAL,26800,0,26800,105600,0,132400
132632802600000,NW 329,RESIDENTIAL,27100,0,27100,87900,0,115000
132632802700000,NW 329,RESIDENTIAL,25500,0,25500,86300,0,111800
132632802800000,NW 329,RESIDENTIAL,25500,0,25500,83100,0,108600
132632802900000,NW 329,RESIDENTIAL,25500,0,25500,97500,0,123000
132632803000000,NW 329,RESIDENTIAL,25500,0,25500,91100,0,116600
132632803100000,NW 329,RESIDENTIAL,25500,0,25500,94700,0,120200
132632803200000,NW 329,RESIDENTIAL,25500,0,25500,90600,0,116100
132632803300000,NW 329,RESIDENTIAL,25500,0,25500,107700,0,133200
132632803400000,NW 332,RESIDENTIAL,48300,0,48300,228600,0,276900
132632900100000,NW 329,RESIDENTIAL,27300,0,27300,79700,0,107000
132632900200000,NW 329,RESIDENTIAL,24800,0,24800,95400,0,120200
132632900300000,NW 329,RESIDENTIAL,27600,0,27600,88700,0,116300
132633000100000,NW 329,RESIDENTIAL,27200,0,27200,94500,0,121700
132633000200000,NW 329,RESIDENTIAL,24800,0,24800,98700,0,123500
132633000300000,NW 329,RESIDENTIAL,27200,0,27200,100700,0,127900
132633100100000,NW 329,RESIDENTIAL,26600,0,26600,111100,0,137700
132633100200000,NW 329,RESIDENTIAL,25200,0,25200,99500,0,124700
132633100300000,NW 329,RESIDENTIAL,25200,0,25200,79800,0,105000
132633100400000,NW 329,RESIDENTIAL,25200,0,25200,85500,0,110700
132633100500000,NW 329,RESIDENTIAL,25200,0,25200,99200,0,124400
132633100600000,NW 329,RESIDENTIAL,25200,0,25200,89400,0,114600
132633100700000,NW 329,RESIDENTIAL,25200,0,25200,74000,0,99200
132633100800000,NW 329,RESIDENTIAL,25200,0,25200,90400,0,115600
132633100900000,NW 329,RESIDENTIAL,25200,0,25200,114500,0,139700
132633101000000,NW 329,RESIDENTIAL,25200,0,25200,97700,0,122900
132633101100000,NW 329,RESIDENTIAL,28300,0,28300,100400,0,128700
132633101200000,NW 329,RESIDENTIAL,26800,0,26800,94300,0,121100
132633101300000,NW 329,RESIDENTIAL,23300,0,23300,83200,0,106500
132633101400000,NW 329,RESIDENTIAL,23300,0,23300,90600,0,113900
132633101500000,NW 329,RESIDENTIAL,21300,0,21300,98000,0,119300
132633101600000,NW 329,RESIDENTIAL,23300,0,23300,94700,0,118000
132633101700000,NW 329,RESIDENTIAL,21300,0,21300,92900,0,114200
132633101800000,NW 329,RESIDENTIAL,23300,0,23300,89200,0,112500
132633101900000,NW 329,RESIDENTIAL,25000,0,25000,105400,0,130400
132633102000000,NW 329,RESIDENTIAL,21300,0,21300,83800,0,105100
132633102100000,NW 329,RESIDENTIAL,25000,0,25000,90000,0,115000
132633102200000,NW 329,RESIDENTIAL,21300,0,21300,85500,0,106800
132633102300000,NW 329,RESIDENTIAL,27100,0,27100,108000,0,135100
132633102400000,NW 329,RESIDENTIAL,22800,0,22800,95500,0,118300
132633200100000,NW 329,RESIDENTIAL,26500,0,26500,101400,0,127900
132633200200000,NW 329,RESIDENTIAL,24400,0,24400,83300,0,107700
132633200300000,NW 329,RESIDENTIAL,28100,0,28100,97800,0,125900
132633300100000,NW 329,RESIDENTIAL,26000,0,26000,94700,0,120700
132633300200000,NW 329,RESIDENTIAL,23300,0,23300,90300,0,113600
132633300300000,NW 329,RESIDENTIAL,21300,0,21300,82100,0,103400
132633300400000,NW 329,RESIDENTIAL,23300,0,23300,87700,0,111000
132633300500000,NW 329,RESIDENTIAL,25100,0,25100,99800,0,124900
132633300600000,NW 329,RESIDENTIAL,24300,0,24300,92400,0,116700
132633300700000,NW 329,RESIDENTIAL,24300,0,24300,101400,0,125700
132633300800000,NW 329,RESIDENTIAL,21300,0,21300,83100,0,104400
132633300900000,NW 329,RESIDENTIAL,23300,0,23300,102900,0,126200
132633301000000,NW 329,RESIDENTIAL,21300,0,21300,88300,0,109600
132633301100000,NW 329,RESIDENTIAL,21300,0,21300,97900,0,119200
132633301200000,NW 329,RESIDENTIAL,24000,0,24000,105800,0,129800
132633301300000,NW 329,RESIDENTIAL,23600,0,23600,109900,0,133500
132633301400000,NW 329,RESIDENTIAL,23500,0,23500,101000,0,124500
132633301500000,NW 329,RESIDENTIAL,23500,0,23500,104100,0,127600
132633301600000,NW 329,RESIDENTIAL,23500,0,23500,106500,0,130000
132633301700000,NW 329,RESIDENTIAL,23500,0,23500,94900,0,118400
132633301800000,NW 329,RESIDENTIAL,23500,0,23500,101000,0,124500
132633301900000,NW 329,RESIDENTIAL,24200,0,24200,97400,0,121600
132633302000000,NW 329,RESIDENTIAL,24200,0,24200,92300,0,116500
132633302100000,NW 329,RESIDENTIAL,23500,0,23500,100400,0,123900
132633302200000,NW 329,RESIDENTIAL,23500,0,23500,99500,0,123000
132633302300000,NW 329,RESIDENTIAL,23500,0,23500,78600,0,102100
132633302400000,NW 329,RESIDENTIAL,27300,0,27300,102700,0,130000
132633302500000,NW 329,RESIDENTIAL,25200,0,25200,103200,0,128400
132633400100000,NW 329,RESIDENTIAL,23500,0,23500,95000,0,118500
132633400200000,NW 329,RESIDENTIAL,24800,0,24800,98100,0,122900
132633400300000,NW 329,RESIDENTIAL,24800,0,24800,89400,0,114200
132633400400000,NW 329,RESIDENTIAL,24800,0,24800,91500,0,116300
132633400500000,NW 329,RESIDENTIAL,21400,0,21400,85600,0,107000
132633400600000,NW 329,RESIDENTIAL,21300,0,21300,96300,0,117600
132633400700000,NW 329,RESIDENTIAL,21300,0,21300,96500,0,117800
132633400800000,NW 329,RESIDENTIAL,21300,0,21300,80100,0,101400
132633400900000,NW 329,RESIDENTIAL,21300,0,21300,90600,0,111900
132633401000000,NW 329,RESIDENTIAL,21300,0,21300,95200,0,116500
132633401100000,NW 329,RESIDENTIAL,21300,0,21300,91300,0,112600
132633401200000,NW 329,RESIDENTIAL,21300,0,21300,82600,0,103900
132633401300000,NW 329,RESIDENTIAL,21300,0,21300,92900,0,114200
132633401400000,NW 329,RESIDENTIAL,21300,0,21300,112400,0,133700
132633401500000,NW 329,RESIDENTIAL,21300,0,21300,95200,0,116500
132633401600000,NW 329,RESIDENTIAL,25200,0,25200,94000,0,119200
132635100100000,NW 329,RESIDENTIAL,23300,0,23300,105200,0,128500
132635100200000,NW 329,RESIDENTIAL,24800,0,24800,88500,0,113300
132635100300000,NW 329,RESIDENTIAL,24800,0,24800,95100,0,119900
132635100400000,NW 329,RESIDENTIAL,24700,0,24700,94100,0,118800
132635100500000,NW 329,RESIDENTIAL,23200,0,23200,99900,0,123100
132635100600000,NW 329,RESIDENTIAL,23300,0,23300,88800,0,112100
132635100700000,NW 329,RESIDENTIAL,23300,0,23300,90500,0,113800
132635100800000,NW 329,RESIDENTIAL,23300,0,23300,103700,0,127000
132635100900000,NW 329,RESIDENTIAL,23300,0,23300,100300,0,123600
132635101000000,NW 329,RESIDENTIAL,23300,0,23300,117100,0,140400
132635101100000,NW 329,RESIDENTIAL,23300,0,23300,107600,0,130900
132635101200000,NW 329,RESIDENTIAL,23300,0,23300,106800,0,130100
132635101300000,NW 329,RESIDENTIAL,23300,0,23300,104800,0,128100
132635101400000,NW 329,RESIDENTIAL,23300,0,23300,97400,0,120700
132635101500000,NW 329,RESIDENTIAL,25900,0,25900,98500,0,124400
132635200100000,NW 329,RESIDENTIAL,26500,0,26500,94700,0,121200
132635200200000,NW 332,RESIDENTIAL,50600,0,50600,190400,0,241000
132635200300000,NW 329,RESIDENTIAL,27700,0,27700,104100,0,131800
132635300100000,NW 329,RESIDENTIAL,23300,0,23300,86200,0,109500
132635300200000,NW 329,RESIDENTIAL,24800,0,24800,82200,0,107000
132635300300000,NW 329,RESIDENTIAL,24800,0,24800,91400,0,116200
132635300400000,NW 329,RESIDENTIAL,24800,0,24800,84900,0,109700
132635300500000,NW 329,RESIDENTIAL,21400,0,21400,103500,0,124900
132635300600000,NW 329,RESIDENTIAL,21300,0,21300,97000,0,118300
132635300700000,NW 329,RESIDENTIAL,21300,0,21300,95500,0,116800
132635300800000,NW 329,RESIDENTIAL,21300,0,21300,98600,0,119900
132635300900000,NW 329,RESIDENTIAL,24900,0,24900,95800,0,120700
132635301000000,NW 329,RESIDENTIAL,24900,0,24900,98600,0,123500
132635301100000,NW 329,RESIDENTIAL,24900,0,24900,103100,0,128000
132635301200000,NW 329,RESIDENTIAL,24900,0,24900,102600,0,127500
132635301300000,NW 329,RESIDENTIAL,24900,0,24900,102700,0,127600
132635301400000,NW 329,RESIDENTIAL,24900,0,24900,103500,0,128400
132635301500000,NW 329,RESIDENTIAL,24900,0,24900,95700,0,120600
132635301600000,NW 329,RESIDENTIAL,24900,0,24900,97200,0,122100
132635301700000,NW 329,RESIDENTIAL,24900,0,24900,101000,0,125900
132635301800000,NW 329,RESIDENTIAL,24900,0,24900,67300,0,92200
132635301900000,NW 329,RESIDENTIAL,31200,0,31200,117200,0,148400
132635400500000,NW 329,RESIDENTIAL,0,0,0,0,0,0
132635502000000,NW 329,RESIDENTIAL,81600,0,81600,0,0,81600
132635502002000,BILLBOARD(BLL),COMMERCIAL,0,0,0,0,10200,10200
132637600100000,NW 329,RESIDENTIAL,25600,0,25600,94300,0,119900
132637600200000,NW 329,RESIDENTIAL,20700,0,20700,83400,0,104100
132637600300000,NW 329,RESIDENTIAL,24000,0,24000,99900,0,123900
132637600400000,NW 329,RESIDENTIAL,20800,0,20800,93900,0,114700
132637600500000,NW 329,RESIDENTIAL,23200,0,23200,104100,0,127300
132637600600000,NW 329,RESIDENTIAL,23300,0,23300,95300,0,118600
132637600700000,NW 329,RESIDENTIAL,24500,0,24500,85900,0,110400
132637600800000,NW 329,RESIDENTIAL,23300,0,23300,95100,0,118400
132637600900000,NW 329,RESIDENTIAL,23300,0,23300,92700,0,116000
132637601000000,NW 329,RESIDENTIAL,23300,0,23300,92700,0,116000
132637601100000,NW 329,RESIDENTIAL,23300,0,23300,94600,0,117900
132637601200000,NW 329,RESIDENTIAL,23300,0,23300,87200,0,110500
132637601300000,NW 329,RESIDENTIAL,23300,0,23300,91600,0,114900
132637601400000,NW 329,RESIDENTIAL,23300,0,23300,87800,0,111100
132637601500000,NW 329,RESIDENTIAL,23300,0,23300,92300,0,115600
132637601600000,NW 329,RESIDENTIAL,23300,0,23300,90600,0,113900
132637601700000,NW 329,RESIDENTIAL,23300,0,23300,83500,0,106800
132637601800000,NW 329,RESIDENTIAL,24400,0,24400,92900,0,117300
132637601900000,APARTMENT,MULTI-RES,728600,0,728600,6822400,0,7551000
132637602000000,WAREHOUSE,COMMERCIAL,0,450700,450700,0,327400,778100
132637602002000,BILLBOARD(BLL),COMMERCIAL,0,0,0,0,5500,5500
132637602100000,WAREHOUSE;MINI STORG,COMMERCIAL,0,232600,232600,0,499800,732400
132637700100000,NW 329,RESIDENTIAL,24800,0,24800,91000,0,115800
132637700200000,NW 329,RESIDENTIAL,25800,0,25800,92600,0,118400
132637700300000,NW 329,RESIDENTIAL,23300,0,23300,88500,0,111800
132637700400000,NW 329,RESIDENTIAL,23300,0,23300,105600,0,128900
132637700500000,NW 329,RESIDENTIAL,23300,0,23300,94000,0,117300
132637700600000,NW 329,RESIDENTIAL,23300,0,23300,102900,0,126200
132637700700000,NW 329,RESIDENTIAL,23300,0,23300,84400,0,107700
132637700800000,NW 329,RESIDENTIAL,23300,0,23300,90200,0,113500
132637700900000,NW 329,RESIDENTIAL,23300,0,23300,106000,0,129300
132637701000000,NW 329,RESIDENTIAL,23300,0,23300,101200,0,124500
132637701100000,NW 329,RESIDENTIAL,23300,0,23300,88300,0,111600
132637701200000,NW 329,RESIDENTIAL,23300,0,23300,101500,0,124800
132637701300000,NW 329,RESIDENTIAL,25900,0,25900,106200,0,132100
132637800100000,NW 329,RESIDENTIAL,26300,0,26300,89800,0,116100
132637800200000,NW 329,RESIDENTIAL,24800,0,24800,95500,0,120300
132637800300000,NW 329,RESIDENTIAL,23300,0,23300,93100,0,116400
132637800400000,NW 329,RESIDENTIAL,24800,0,24800,102000,0,126800
132637800500000,NW 329,RESIDENTIAL,24800,0,24800,86600,0,111400
132637800600000,NW 329,RESIDENTIAL,24800,0,24800,103200,0,128000
132637900100000,NW 329,RESIDENTIAL,26200,0,26200,102600,0,128800
132637900200000,NW 329,RESIDENTIAL,24800,0,24800,93600,0,118400
132637900300000,NW 329,RESIDENTIAL,23300,0,23300,84300,0,107600
132637900400000,NW 329,RESIDENTIAL,24800,0,24800,97700,0,122500
132637900500000,NW 329,RESIDENTIAL,24800,0,24800,94900,0,119700
132637900600000,NW 329,RESIDENTIAL,24800,0,24800,100200,0,125000
132637901000000,DAY CARE CENTER,COMMERCIAL,0,50300,50300,0,210900,261200
132640100100000,NW 329,RESIDENTIAL,30300,0,30300,113300,0,143600
132640100200000,NW 329,RESIDENTIAL,30000,0,30000,142000,0,172000
132640100300000,NW 329,RESIDENTIAL,30000,0,30000,128000,0,158000
132640100400000,NW 329,RESIDENTIAL,30000,0,30000,118300,0,148300
132640100500000,NW 329,RESIDENTIAL,30000,0,30000,115400,0,145400
132640100600000,NW 329,RESIDENTIAL,30800,0,30800,119900,0,150700
132640200100000,NW 329,RESIDENTIAL,30500,0,30500,106000,0,136500
132640200200000,NW 329,RESIDENTIAL,29900,0,29900,132500,0,162400
132640200300000,NW 329,RESIDENTIAL,31200,0,31200,119600,0,150800
132640200400000,NW 329,RESIDENTIAL,31300,0,31300,128800,0,160100
132640200500000,NW 329,RESIDENTIAL,31900,0,31900,116800,0,148700
132640200600000,NW 329,RESIDENTIAL,31200,0,31200,120500,0,151700
132640200700000,NW 329,RESIDENTIAL,31200,0,31200,107500,0,138700
132640200800000,NW 329,RESIDENTIAL,31200,0,31200,123700,0,154900
132640200900000,NW 329,RESIDENTIAL,30000,0,30000,118600,0,148600
132640201000000,NW 329,RESIDENTIAL,31200,0,31200,132900,0,164100
132640201100000,NW 329,RESIDENTIAL,30000,0,30000,130100,0,160100
132640201200000,NW 329,RESIDENTIAL,30000,0,30000,126800,0,156800
132640201300000,NW 329,RESIDENTIAL,30000,0,30000,114500,0,144500
132640201400000,NW 329,RESIDENTIAL,30000,0,30000,146500,0,176500
132640201500000,NW 329,RESIDENTIAL,31300,0,31300,142600,0,173900
132640300100000,NW 329,RESIDENTIAL,32700,0,32700,134500,0,167200
132640300200000,NW 329,RESIDENTIAL,33700,0,33700,115100,0,148800
132640300300000,NW 329,RESIDENTIAL,31700,0,31700,124000,0,155700
132640300400000,NW 329,RESIDENTIAL,33400,0,33400,115200,0,148600
132640300500000,NW 329,RESIDENTIAL,26500,0,26500,115900,0,142400
132640300600000,NW 329,RESIDENTIAL,25600,0,25600,111100,0,136700
132640300700000,NW 329,RESIDENTIAL,25700,0,25700,92200,0,117900
132640300800000,NW 329,RESIDENTIAL,29200,0,29200,114400,0,143600
132640300900000,NW 329,RESIDENTIAL,35000,0,35000,157400,0,192400
132640400100000,NW 329,RESIDENTIAL,29800,0,29800,144800,0,174600
132640400200000,NW 329,RESIDENTIAL,33500,0,33500,119000,0,152500
132640400300000,NW 329,RESIDENTIAL,32600,0,32600,110800,0,143400
132640400400000,NW 329,RESIDENTIAL,32600,0,32600,107600,0,140200
132640400500000,NW 329,RESIDENTIAL,32600,0,32600,107000,0,139600
132640400600000,NW 329,RESIDENTIAL,32000,0,32000,119300,0,151300
132640400700000,NW 329,RESIDENTIAL,32000,0,32000,117400,0,149400
132640400800000,NW 329,RESIDENTIAL,32000,0,32000,113600,0,145600
132640400900000,NW 329,RESIDENTIAL,32600,0,32600,123800,0,156400
132640401000000,NW 329,RESIDENTIAL,32600,0,32600,148600,0,181200
132640401100000,NW 329,RESIDENTIAL,32600,0,32600,112100,0,144700
132640500100000,NW 329,RESIDENTIAL,30100,0,30100,105300,0,135400
132640500200000,NW 329,RESIDENTIAL,30400,0,30400,134500,0,164900
132640500300000,NW 329,RESIDENTIAL,30100,0,30100,120900,0,151000
132640500400000,NW 329,RESIDENTIAL,30100,0,30100,125700,0,155800
132640500500000,NW 329,RESIDENTIAL,30100,0,30100,125300,0,155400
132640500600000,NW 329,RESIDENTIAL,30100,0,30100,132300,0,162400
132640500700000,NW 329,RESIDENTIAL,30100,0,30100,143400,0,173500
132640500800000,NW 329,RESIDENTIAL,30100,0,30100,130100,0,160200
132640500900000,NW 329,RESIDENTIAL,30100,0,30100,144900,0,175000
132640501000000,NW 329,RESIDENTIAL,30100,0,30100,133000,0,163100
132640501100000,NW 329,RESIDENTIAL,30100,0,30100,120300,0,150400
132640501200000,NW 329,RESIDENTIAL,30100,0,30100,112900,0,143000
132640501300000,NW 329,RESIDENTIAL,30100,0,30100,116900,0,147000
132640501400000,NW 329,RESIDENTIAL,30100,0,30100,122000,0,152100
132640501500000,NW 329,RESIDENTIAL,30100,0,30100,110500,0,140600
132640501600000,NW 329,RESIDENTIAL,30100,0,30100,129900,0,160000
132640501700000,NW 329,RESIDENTIAL,28500,0,28500,128600,0,157100
132640501800000,NW 329,RESIDENTIAL,30100,0,30100,127500,0,157600
132640600100000,NW 329,RESIDENTIAL,30400,0,30400,143100,0,173500
132640600200000,NW 329,RESIDENTIAL,31300,0,31300,127600,0,158900
132640600300000,NW 329,RESIDENTIAL,30600,0,30600,111200,0,141800
132640600400000,NW 329,RESIDENTIAL,28200,0,28200,119100,0,147300
132640600500000,NW 329,RESIDENTIAL,30600,0,30600,135700,0,166300
132640600600000,NW 329,RESIDENTIAL,29400,0,29400,106700,0,136100
132640600700000,NW 329,RESIDENTIAL,30200,0,30200,102100,0,132300
132640600800000,NW 329,RESIDENTIAL,29800,0,29800,109400,0,139200
132640600900000,NW 329,RESIDENTIAL,29800,0,29800,117400,0,147200
132640601000000,NW 329,RESIDENTIAL,29600,0,29600,89200,0,118800
132640601100000,NW 329,RESIDENTIAL,29800,0,29800,127900,0,157700
132640601200000,NW 329,RESIDENTIAL,29800,0,29800,173400,0,203200
132640601300000,NW 329,RESIDENTIAL,29800,0,29800,140300,0,170100
132640601400000,NW 329,RESIDENTIAL,29800,0,29800,136800,0,166600
132640601500000,NW 329,RESIDENTIAL,29800,0,29800,119000,0,148800
132640601600000,NW 329,RESIDENTIAL,29800,0,29800,123700,0,153500
132640601700000,NW 329,RESIDENTIAL,29800,0,29800,113200,0,143000
132640601800000,NW 329,RESIDENTIAL,29800,0,29800,122800,0,152600
132640700100000,NW 329,RESIDENTIAL,30000,0,30000,125800,0,155800
132640700200000,NW 329,RESIDENTIAL,32400,0,32400,137300,0,169700
132640700300000,NW 329,RESIDENTIAL,32100,0,32100,136100,0,168200
132640700400000,NW 329,RESIDENTIAL,29700,0,29700,148500,0,178200
132640700500000,NW 329,RESIDENTIAL,28400,0,28400,109800,0,138200
132640700600000,NW 329,RESIDENTIAL,27400,0,27400,128700,0,156100
132640700700000,NW 329,RESIDENTIAL,27400,0,27400,119300,0,146700
132640700800000,NW 329,RESIDENTIAL,27400,0,27400,116500,0,143900
132640700900000,NW 329,RESIDENTIAL,27400,0,27400,117400,0,144800
132640701000000,NW 329,RESIDENTIAL,27400,0,27400,136600,0,164000
132640701100000,NW 329,RESIDENTIAL,27400,0,27400,105600,0,133000
132640701200000,NW 329,RESIDENTIAL,27400,0,27400,102100,0,129500
132640701300000,NW 329,RESIDENTIAL,27400,0,27400,126300,0,153700
132640701400000,NW 329,RESIDENTIAL,27400,0,27400,114500,0,141900
132640701500000,NW 329,RESIDENTIAL,27400,0,27400,106900,0,134300
132640701600000,NW 329,RESIDENTIAL,28200,0,28200,108200,0,136400
132640701700000,NW 329,RESIDENTIAL,29200,0,29200,110700,0,139900
132640701800000,NW 329,RESIDENTIAL,29300,0,29300,120400,0,149700
132640800100000,APARTMENT,MULTI-RES,35300,0,35300,253800,0,289100
132640800200000,NW 329,RESIDENTIAL,33100,0,33100,106600,0,139700
132640800300000,NW 329,RESIDENTIAL,26300,0,26300,113400,0,139700
132640800400000,NW 329,RESIDENTIAL,26300,0,26300,120400,0,146700
132640800500000,NW 329,RESIDENTIAL,27700,0,27700,103200,0,130900
132640800600000,NW 329,RESIDENTIAL,29100,0,29100,100500,0,129600
132640800700000,NW 329,RESIDENTIAL,32900,0,32900,140000,0,172900
132640800800000,NW 329,RESIDENTIAL,30700,0,30700,104000,0,134700
132640800900000,NW 329,RESIDENTIAL,29600,0,29600,113100,0,142700
132640801000000,NW 329,RESIDENTIAL,29800,0,29800,145500,0,175300
132640801100000,NW 329,RESIDENTIAL,30800,0,30800,110900,0,141700
132640801200000,NW 329,RESIDENTIAL,28000,0,28000,145400,0,173400
132640801300000,NW 329,RESIDENTIAL,29600,0,29600,99500,0,129100
132640801400000,NW 329,RESIDENTIAL,30000,0,30000,124900,0,154900
132640801500000,NW 329,RESIDENTIAL,30100,0,30100,120300,0,150400
132640801600000,NW 329,RESIDENTIAL,25600,0,25600,121400,0,147000
132640801700000,NW 329,RESIDENTIAL,26300,0,26300,129900,0,156200
132640801800000,APARTMENT,MULTI-RES,30700,0,30700,253900,0,284600
132640900100000,NW 329,RESIDENTIAL,30000,0,30000,115500,0,145500
132640900200000,NW 329,RESIDENTIAL,28300,0,28300,147400,0,175700
132640900300000,NW 329,RESIDENTIAL,29500,0,29500,128500,0,158000
132640900400000,NW 329,RESIDENTIAL,31300,0,31300,155300,0,186600
132640900500000,NW 329,RESIDENTIAL,29500,0,29500,112300,0,141800
132640900600000,NW 329,RESIDENTIAL,29500,0,29500,123400,0,152900
132640900700000,NW 329,RESIDENTIAL,29500,0,29500,103800,0,133300
132640900800000,NW 329,RESIDENTIAL,29500,0,29500,106900,0,136400
132640900900000,NW 329,RESIDENTIAL,29200,0,29200,103500,0,132700
132640901000000,NW 329,RESIDENTIAL,29100,0,29100,103200,0,132300
132640901100000,NW 329,RESIDENTIAL,29500,0,29500,123400,0,152900
132640901200000,NW 329,RESIDENTIAL,30500,0,30500,112700,0,143200
132640901300000,NW 329,RESIDENTIAL,31100,0,31100,124300,0,155400
132641000100000,NW 329,RESIDENTIAL,29500,0,29500,119100,0,148600
132641000200000,NW 329,RESIDENTIAL,27500,0,27500,143500,0,171000
132641000300000,NW 329,RESIDENTIAL,29600,0,29600,101600,0,131200
132642600100000,NW 329,RESIDENTIAL,28500,0,28500,102900,0,131400
132642600200000,NW 329,RESIDENTIAL,25700,0,25700,121200,0,146900
132642600300000,NW 329,RESIDENTIAL,25700,0,25700,88800,0,114500
132642600400000,NW 329,RESIDENTIAL,25700,0,25700,111100,0,136800
132642600500000,NW 329,RESIDENTIAL,25700,0,25700,86600,0,112300
132642600600000,NW 329,RESIDENTIAL,25700,0,25700,95500,0,121200
132642600700000,NW 329,RESIDENTIAL,25700,0,25700,101600,0,127300
132642600800000,NW 329,RESIDENTIAL,25700,0,25700,95500,0,121200
132642600900000,NW 329,RESIDENTIAL,25700,0,25700,92000,0,117700
132642601000000,NW 329,RESIDENTIAL,25700,0,25700,82900,0,108600
132642601100000,NW 329,RESIDENTIAL,27300,0,27300,91700,0,119000
132642700100000,NW 328,RESIDENTIAL,31400,0,31400,172600,0,204000
132642700200000,NW 328,RESIDENTIAL,32100,0,32100,174800,0,206900
132642700300000,NW 328,RESIDENTIAL,32100,0,32100,167400,0,199500
132642700400000,NW 328,RESIDENTIAL,32100,0,32100,185100,0,217200
132642700500000,NW 328,RESIDENTIAL,31400,0,31400,177900,0,209300
132642700600000,NW 328,RESIDENTIAL,31000,0,31000,182300,0,213300
132642700700000,NW 328,RESIDENTIAL,32000,0,32000,182300,0,214300
132642700800000,NW 328,RESIDENTIAL,32100,0,32100,151300,0,183400
132642700900000,NW 328,RESIDENTIAL,32100,0,32100,170300,0,202400
132642701000000,NW 328,RESIDENTIAL,31100,0,31100,155800,0,186900
132642701100000,NW 328,RESIDENTIAL,37000,0,37000,146600,0,183600
132642701200000,NW 329,RESIDENTIAL,28700,0,28700,91300,0,120000
132642701300000,NW 329,RESIDENTIAL,25700,0,25700,95700,0,121400
132642701400000,NW 329,RESIDENTIAL,25700,0,25700,100800,0,126500
132642701500000,NW 329,RESIDENTIAL,25700,0,25700,106000,0,131700
132642701600000,NW 329,RESIDENTIAL,25700,0,25700,93300,0,119000
132642701700000,NW 329,RESIDENTIAL,25700,0,25700,82500,0,108200
132642701800000,NW 329,RESIDENTIAL,25700,0,25700,96600,0,122300
132642701900000,NW 329,RESIDENTIAL,25700,0,25700,97500,0,123200
132642702000000,NW 329,RESIDENTIAL,25700,0,25700,91300,0,117000
132642702100000,NW 329,RESIDENTIAL,28100,0,28100,96400,0,124500
132642702200000,CITY PROPERTY,EXEMPT,0,0,0,0,0,0
132642800100000,NW 329,RESIDENTIAL,28100,0,28100,112800,0,140900
132642800200000,NW 329,RESIDENTIAL,25300,0,25300,96500,0,121800
132642800300000,NW 329,RESIDENTIAL,27800,0,27800,110300,0,138100
132642800400000,NW 329,RESIDENTIAL,25300,0,25300,87000,0,112300
132642800500000,NW 329,RESIDENTIAL,25500,0,25500,97000,0,122500
132642800600000,NW 329,RESIDENTIAL,25500,0,25500,98800,0,124300
132642800700000,NW 329,RESIDENTIAL,25500,0,25500,100600,0,126100
132642800800000,NW 329,RESIDENTIAL,25500,0,25500,89700,0,115200
132642800900000,NW 329,RESIDENTIAL,25500,0,25500,98700,0,124200
132642801000000,NW 329,RESIDENTIAL,30500,0,30500,109300,0,139800
132642801100000,NW 329,RESIDENTIAL,28000,0,28000,103900,0,131900
132642801200000,NW 329,RESIDENTIAL,25300,0,25300,109100,0,134400
132642801300000,NW 329,RESIDENTIAL,27900,0,27900,95600,0,123500
132642801400000,NW 329,RESIDENTIAL,26700,0,26700,110300,0,137000
132642801500000,NW 329,RESIDENTIAL,25500,0,25500,101800,0,127300
132642801600000,NW 329,RESIDENTIAL,25500,0,25500,122300,0,147800
132642801700000,NW 329,RESIDENTIAL,25500,0,25500,101900,0,127400
132642801800000,NW 329,RESIDENTIAL,25500,0,25500,77300,0,102800
132642801900000,NW 329,RESIDENTIAL,25500,0,25500,100200,0,125700
132642802000000,NW 329,RESIDENTIAL,25700,0,25700,123700,0,149400
132642900100000,NW 329,RESIDENTIAL,28100,0,28100,96900,0,125000
132642900200000,NW 329,RESIDENTIAL,25300,0,25300,85900,0,111200
132642900300000,NW 329,RESIDENTIAL,27800,0,27800,88300,0,116100
132642900400000,NW 329,RESIDENTIAL,25300,0,25300,113200,0,138500
132642900500000,NW 329,RESIDENTIAL,25500,0,25500,103000,0,128500
132642900600000,NW 329,RESIDENTIAL,25500,0,25500,99800,0,125300
132642900700000,NW 329,RESIDENTIAL,25500,0,25500,88400,0,113900
132642900800000,NW 329,RESIDENTIAL,25500,0,25500,96300,0,121800
132642900900000,NW 329,RESIDENTIAL,25500,0,25500,76900,0,102400
132642901000000,NW 329,RESIDENTIAL,28100,0,28100,106300,0,134400
132642901100000,NW 329,RESIDENTIAL,28000,0,28000,118600,0,146600
132642901200000,NW 329,RESIDENTIAL,25300,0,25300,103300,0,128600
132642901300000,NW 329,RESIDENTIAL,27900,0,27900,106100,0,134000
132642901400000,NW 329,RESIDENTIAL,27400,0,27400,101300,0,128700
132642901500000,NW 329,RESIDENTIAL,25500,0,25500,86300,0,111800
132642901600000,NW 329,RESIDENTIAL,25500,0,25500,85200,0,110700
132642901700000,NW 329,RESIDENTIAL,25500,0,25500,94600,0,120100
132642901800000,NW 329,RESIDENTIAL,25500,0,25500,84900,0,110400
132642901900000,NW 329,RESIDENTIAL,25500,0,25500,88000,0,113500
132642902000000,NW 329,RESIDENTIAL,25700,0,25700,90800,0,116500
132643000100000,NW 329,RESIDENTIAL,28000,0,28000,120400,0,148400
132643000200000,NW 329,RESIDENTIAL,25300,0,25300,118600,0,143900
132643000300000,NW 329,RESIDENTIAL,27900,0,27900,91300,0,119200
132643000400000,NW 329,RESIDENTIAL,25300,0,25300,125900,0,151200
132643000500000,NW 329,RESIDENTIAL,25400,0,25400,109200,0,134600
132643000600000,NW 329,RESIDENTIAL,25400,0,25400,77400,0,102800
132643000700000,NW 329,RESIDENTIAL,25400,0,25400,102800,0,128200
132643000800000,NW 329,RESIDENTIAL,25400,0,25400,99200,0,124600
132643000900000,NW 329,RESIDENTIAL,25400,0,25400,102900,0,128300
132643001000000,NW 329,RESIDENTIAL,25400,0,25400,98600,0,124000
132643001100000,NW 329,RESIDENTIAL,25400,0,25400,145200,0,170600
132643100100000,NW 329,RESIDENTIAL,28000,0,28000,89100,0,117100
132643100200000,NW 329,RESIDENTIAL,25100,0,25100,99800,0,124900
132643100300000,NW 329,RESIDENTIAL,26700,0,26700,107500,0,134200
132643100400000,NW 329,RESIDENTIAL,24300,0,24300,91500,0,115800
132643100500000,NW 329,RESIDENTIAL,24900,0,24900,98200,0,123100
132643100600000,NW 329,RESIDENTIAL,24900,0,24900,92000,0,116900
132643100700000,NW 329,RESIDENTIAL,24900,0,24900,95900,0,120800
132643100800000,NW 329,RESIDENTIAL,25700,0,25700,84000,0,109700
132643100900000,NW 329,RESIDENTIAL,25700,0,25700,97600,0,123300
132643101000000,NW 329,RESIDENTIAL,25700,0,25700,122200,0,147900
132643101100000,NW 329,RESIDENTIAL,25800,0,25800,112400,0,138200
132643200100000,NW 329,RESIDENTIAL,26800,0,26800,95200,0,122000
132643200200000,NW 329,RESIDENTIAL,25500,0,25500,83100,0,108600
132643200300000,NW 329,RESIDENTIAL,26900,0,26900,96500,0,123400
132643200400000,NW 329,RESIDENTIAL,25600,0,25600,94800,0,120400
132643200500000,NW 329,RESIDENTIAL,26300,0,26300,111100,0,137400
132643200600000,NW 329,RESIDENTIAL,21800,0,21800,96400,0,118200
132643200700000,NW 329,RESIDENTIAL,25300,0,25300,95300,0,120600
132643200800000,NW 329,RESIDENTIAL,24900,0,24900,86800,0,111700
132643200900000,NW 329,RESIDENTIAL,24900,0,24900,92500,0,117400
132643201000000,NW 329,RESIDENTIAL,24900,0,24900,106100,0,131000
132643201100000,NW 329,RESIDENTIAL,24700,0,24700,99200,0,123900
132643300100000,NW 329,RESIDENTIAL,28500,0,28500,117000,0,145500
132643300200000,NW 329,RESIDENTIAL,24800,0,24800,95500,0,120300
132643300300000,NW 329,RESIDENTIAL,26400,0,26400,103600,0,130000
132643300400000,NW 329,RESIDENTIAL,27900,0,27900,97000,0,124900
132643300500000,NW 329,RESIDENTIAL,25300,0,25300,96500,0,121800
132643300600000,NW 329,RESIDENTIAL,23800,0,23800,101500,0,125300
132643300700000,NW 329,RESIDENTIAL,21800,0,21800,94400,0,116200
132643300800000,NW 329,RESIDENTIAL,26300,0,26300,98800,0,125100
132643300900000,NW 329,RESIDENTIAL,25300,0,25300,93400,0,118700
132643301000000,NW 329,RESIDENTIAL,25300,0,25300,92200,0,117500
132643301100000,NW 329,RESIDENTIAL,23800,0,23800,106100,0,129900
132643301200000,NW 329,RESIDENTIAL,25300,0,25300,103000,0,128300
132643301300000,NW 329,RESIDENTIAL,26600,0,26600,92300,0,118900
132643400100000,NW 329,RESIDENTIAL,27800,0,27800,109200,0,137000
132643400200000,NW 329,RESIDENTIAL,26400,0,26400,109200,0,135600
132643400300000,NW 329,RESIDENTIAL,26200,0,26200,95700,0,121900
132643400400000,NW 329,RESIDENTIAL,22600,0,22600,88200,0,110800
132643400500000,NW 329,RESIDENTIAL,22600,0,22600,96300,0,118900
132643400600000,NW 329,RESIDENTIAL,24200,0,24200,86100,0,110300
132643400700000,NW 329,RESIDENTIAL,24200,0,24200,91100,0,115300
132643400800000,NW 329,RESIDENTIAL,25900,0,25900,94400,0,120300
132643400900000,NW 329,RESIDENTIAL,24200,0,24200,98200,0,122400
132645100100000,NW 329,RESIDENTIAL,25400,0,25400,101000,0,126400
132645100200000,NW 329,RESIDENTIAL,25400,0,25400,101900,0,127300
132645100300000,NW 329,RESIDENTIAL,25400,0,25400,106400,0,131800
132645100400000,NW 329,RESIDENTIAL,25400,0,25400,107000,0,132400
132645100500000,NW 329,RESIDENTIAL,25400,0,25400,105500,0,130900
132645100600000,NW 329,RESIDENTIAL,25400,0,25400,79000,0,104400
132645100700000,NW 329,RESIDENTIAL,25400,0,25400,76400,0,101800
132645100800000,NW 329,RESIDENTIAL,25400,0,25400,97100,0,122500
132645100900000,NW 329,RESIDENTIAL,25400,0,25400,96800,0,122200
132645101000000,NW 329,RESIDENTIAL,26700,0,26700,100400,0,127100
132645101100000,NW 329,RESIDENTIAL,26600,0,26600,98000,0,124600
132645101200000,NW 329,RESIDENTIAL,28200,0,28200,101800,0,130000
132645101300000,NW 329,RESIDENTIAL,28500,0,28500,105700,0,134200
132645101400000,NW 329,RESIDENTIAL,26700,0,26700,110700,0,137400
132645101500000,NW 329,RESIDENTIAL,25400,0,25400,101600,0,127000
132645101600000,NW 329,RESIDENTIAL,25400,0,25400,118600,0,144000
132645101700000,NW 329,RESIDENTIAL,25400,0,25400,101700,0,127100
132645101800000,NW 329,RESIDENTIAL,25400,0,25400,99000,0,124400
132645101900000,NW 329,RESIDENTIAL,25400,0,25400,91500,0,116900
132645102000000,NW 329,RESIDENTIAL,25400,0,25400,101000,0,126400
132645102100000,NW 329,RESIDENTIAL,25400,0,25400,120800,0,146200
132645200100000,NW 329,RESIDENTIAL,25700,0,25700,73400,0,99100
132645200200000,NW 329,RESIDENTIAL,24900,0,24900,95400,0,120300
132645200300000,NW 329,RESIDENTIAL,24900,0,24900,99200,0,124100
132645200400000,NW 329,RESIDENTIAL,24900,0,24900,94900,0,119800
132645200500000,NW 329,RESIDENTIAL,24900,0,24900,94000,0,118900
132645200600000,NW 329,RESIDENTIAL,24900,0,24900,83400,0,108300
132645200700000,NW 329,RESIDENTIAL,24900,0,24900,98900,0,123800
132645200800000,NW 329,RESIDENTIAL,24900,0,24900,87600,0,112500
132645200900000,NW 329,RESIDENTIAL,25100,0,25100,90600,0,115700
132645201000000,NW 329,RESIDENTIAL,24900,0,24900,106300,0,131200
132645201100000,NW 329,RESIDENTIAL,24900,0,24900,93800,0,118700
132645201200000,NW 329,RESIDENTIAL,24100,0,24100,94000,0,118100
132645201300000,NW 329,RESIDENTIAL,23700,0,23700,85000,0,108700
132645201400000,NW 329,RESIDENTIAL,24900,0,24900,94300,0,119200
132645201500000,NW 329,RESIDENTIAL,27600,0,27600,112400,0,140000
132645201600000,NW 329,RESIDENTIAL,29700,0,29700,123400,0,153100
132645201700000,NW 329,RESIDENTIAL,27900,0,27900,112200,0,140100
132645201800000,NW 329,RESIDENTIAL,27300,0,27300,113000,0,140300
132645201900000,NW 329,RESIDENTIAL,26700,0,26700,91100,0,117800
132645202000000,NW 329,RESIDENTIAL,26700,0,26700,108800,0,135500
132645202100000,NW 329,RESIDENTIAL,25700,0,25700,108500,0,134200
132645202200000,NW 329,RESIDENTIAL,25700,0,25700,110800,0,136500
132645202300000,NW 329,RESIDENTIAL,25700,0,25700,100000,0,125700
132645202400000,NW 329,RESIDENTIAL,25700,0,25700,99000,0,124700
132645202500000,NW 329,RESIDENTIAL,25700,0,25700,95900,0,121600
132645300100000,NW 329,RESIDENTIAL,24900,0,24900,94800,0,119700
132645300200000,NW 329,RESIDENTIAL,23800,0,23800,100400,0,124200
132645300300000,NW 329,RESIDENTIAL,23800,0,23800,87600,0,111400
132645300400000,NW 329,RESIDENTIAL,26300,0,26300,85400,0,111700
132645300500000,NW 329,RESIDENTIAL,26300,0,26300,112200,0,138500
132645300600000,NW 329,RESIDENTIAL,25300,0,25300,96100,0,121400
132645300700000,NW 329,RESIDENTIAL,25300,0,25300,110800,0,136100
132645300800000,NW 329,RESIDENTIAL,25300,0,25300,85700,0,111000
132645300900000,NW 329,RESIDENTIAL,21800,0,21800,92900,0,114700
132645301000000,NW 329,RESIDENTIAL,26300,0,26300,102800,0,129100
132645301100000,NW 329,RESIDENTIAL,26300,0,26300,94500,0,120800
132645301200000,NW 329,RESIDENTIAL,23800,0,23800,109200,0,133000
132645301300000,NW 329,RESIDENTIAL,25300,0,25300,85600,0,110900
132645301400000,NW 329,RESIDENTIAL,26400,0,26400,96800,0,123200
132645301500000,NW 329,RESIDENTIAL,22400,0,22400,100000,0,122400
132645301600000,NW 329,RESIDENTIAL,24100,0,24100,100900,0,125000
132645301700000,NW 329,RESIDENTIAL,25600,0,25600,93300,0,118900
132645301800000,NW 329,RESIDENTIAL,38900,0,38900,129900,0,168800
132645301900000,NW 329,RESIDENTIAL,27000,0,27000,111100,0,138100
132645302000000,NW 329,RESIDENTIAL,25500,0,25500,104900,0,130400
132645302100000,NW 329,RESIDENTIAL,24400,0,24400,90500,0,114900
132645302200000,NW 329,RESIDENTIAL,23800,0,23800,96100,0,119900
132645302300000,NW 329,RESIDENTIAL,23900,0,23900,81900,0,105800
132645302400000,NW 329,RESIDENTIAL,24900,0,24900,89100,0,114000
132645302500000,NW 329,RESIDENTIAL,24900,0,24900,79800,0,104700
132645302600000,NW 329,RESIDENTIAL,24900,0,24900,81600,0,106500
132645302700000,NW 329,RESIDENTIAL,24900,0,24900,89700,0,114600
132645302800000,NW 329,RESIDENTIAL,24900,0,24900,91500,0,116400
132645302900000,NW 329,RESIDENTIAL,24900,0,24900,87400,0,112300
132645303000000,NW 329,RESIDENTIAL,24900,0,24900,102700,0,127600
132645400100000,NW 329,RESIDENTIAL,23800,0,23800,89500,0,113300
132645400200000,NW 329,RESIDENTIAL,23800,0,23800,92800,0,116600
132645400300000,NW 329,RESIDENTIAL,23000,0,23000,87600,0,110600
132645400400000,NW 329,RESIDENTIAL,23800,0,23800,92500,0,116300
132645400500000,NW 329,RESIDENTIAL,26300,0,26300,88700,0,115000
132645400600000,NW 329,RESIDENTIAL,21800,0,21800,93200,0,115000
132645400700000,NW 329,RESIDENTIAL,25300,0,25300,102500,0,127800
132645400800000,NW 329,RESIDENTIAL,25300,0,25300,95100,0,120400
132645400900000,NW 329,RESIDENTIAL,23800,0,23800,88000,0,111800
132645401000000,NW 329,RESIDENTIAL,21800,0,21800,90800,0,112600
132645401100000,NW 329,RESIDENTIAL,26300,0,26300,96800,0,123100
132645401200000,NW 329,RESIDENTIAL,27000,0,27000,94500,0,121500
132645401300000,NW 329,RESIDENTIAL,26800,0,26800,105800,0,132600
132645401400000,NW 329,RESIDENTIAL,22200,0,22200,87000,0,109200
132645401500000,NW 329,RESIDENTIAL,23800,0,23800,94500,0,118300
132645401600000,NW 329,RESIDENTIAL,22200,0,22200,85200,0,107400
132645401700000,NW 329,RESIDENTIAL,22200,0,22200,102000,0,124200
132645401800000,NW 329,RESIDENTIAL,23800,0,23800,102200,0,126000
132645401900000,NW 329,RESIDENTIAL,22200,0,22200,81500,0,103700
132645402000000,NW 329,RESIDENTIAL,22200,0,22200,89400,0,111600
132645402100000,NW 329,RESIDENTIAL,23800,0,23800,86700,0,110500
132645402200000,NW 329,RESIDENTIAL,22200,0,22200,86400,0,108600
132645500100000,NW 329,RESIDENTIAL,22600,0,22600,97900,0,120500
132645500200000,NW 329,RESIDENTIAL,25900,0,25900,94100,0,120000
132645500300000,NW 329,RESIDENTIAL,22600,0,22600,86900,0,109500
132645500400000,NW 329,RESIDENTIAL,24200,0,24200,86800,0,111000
132645500500000,NW 329,RESIDENTIAL,22800,0,22800,94200,0,117000
132645500600000,NW 329,RESIDENTIAL,24500,0,24500,83600,0,108100
132645500700000,NW 329,RESIDENTIAL,22800,0,22800,88900,0,111700
132645500800000,NW 329,RESIDENTIAL,22800,0,22800,84000,0,106800
132645500900000,NW 329,RESIDENTIAL,24500,0,24500,91500,0,116000
132645501000000,NW 329,RESIDENTIAL,22800,0,22800,84900,0,107700
132645501100000,NW 329,RESIDENTIAL,25900,0,25900,93900,0,119800
132645600100000,NW 329,RESIDENTIAL,50000,0,50000,112400,0,162400
132645600200000,STATE PROPERTY,EXEMPT,0,0,0,0,0,0
132645700100000,NW 329,RESIDENTIAL,23300,0,23300,91900,0,115200
132645700200000,NW 329,RESIDENTIAL,23300,0,23300,85900,0,109200
132645700300000,NW 329,RESIDENTIAL,22200,0,22200,94900,0,117100
132645700400000,NW 329,RESIDENTIAL,23400,0,23400,91800,0,115200
132645700500000,NW 329,RESIDENTIAL,26000,0,26000,106500,0,132500
132645700600000,NW 329,RESIDENTIAL,24000,0,24000,84400,0,108400
132645700700000,NW 329,RESIDENTIAL,23300,0,23300,97600,0,120900
132645700800000,NW 329,RESIDENTIAL,24800,0,24800,81800,0,106600
132645700900000,NW 329,RESIDENTIAL,23300,0,23300,92400,0,115700
132645701000000,NW 329,RESIDENTIAL,24100,0,24100,103600,0,127700
132645701100000,NW 329,RESIDENTIAL,38600,0,38600,75500,0,114100
132647600100000,NW 329,RESIDENTIAL,38300,0,38300,157800,0,196100
132647600200000,NW 329,RESIDENTIAL,27300,0,27300,120300,0,147600
132647600300000,NW 329,RESIDENTIAL,29600,0,29600,162500,0,192100
132647600400000,NW 329,RESIDENTIAL,27300,0,27300,140300,0,167600
132647700100000,NW 329,RESIDENTIAL,30100,0,30100,125200,0,155300
132647700200000,NW 329,RESIDENTIAL,29700,0,29700,121000,0,150700
132647700300000,CHURCH,EXEMPT,0,509600,509600,0,1043000,1552600
132647700400000,NW 329,RESIDENTIAL,29200,0,29200,126300,0,155500
132647700500000,NW 329,RESIDENTIAL,29700,0,29700,105900,0,135600
132647700600000,NW 329,RESIDENTIAL,30100,0,30100,124300,0,154400
132647800300000,CONVENIENCE STORE,COMMERCIAL,0,276000,276000,0,452400,728400
132647800400000,VACANT LAND,COMMERCIAL,0,130700,130700,0,0,130700
132647800500000,VACANT LAND,COMMERCIAL,0,125000,125000,0,0,125000
132647800600000,VACANT LAND,COMMERCIAL,0,132800,132800,0,0,132800
132710300100000,CITY PROPERTY,EXEMPT,0,0,0,0,0,0
132710300200000,NW 332,RESIDENTIAL,48900,0,48900,164000,0,212900
132710300300000,NW 332,RESIDENTIAL,52000,0,52000,151000,0,203000
132710300400000,NW 332,RESIDENTIAL,46000,0,46000,217300,0,263300
132710300500000,NW 332,RESIDENTIAL,46200,0,46200,200700,0,246900
132710300600000,NW 332,RESIDENTIAL,39200,0,39200,180700,0,219900
132710300700000,NW 332,RESIDENTIAL,46400,0,46400,210300,0,256700
132710300800000,NW 332,RESIDENTIAL,61100,0,61100,219600,0,280700
132710300900000,NW 332,RESIDENTIAL,54400,0,54400,200300,0,254700
132710301000000,NW 332,RESIDENTIAL,37700,0,37700,173600,0,211300
132710301100000,NW 332,RESIDENTIAL,41800,0,41800,200500,0,242300
132710301200000,NW 332,RESIDENTIAL,44000,0,44000,161100,0,205100
132710301300000,NW 332,RESIDENTIAL,36300,0,36300,203900,0,240200
132710301400000,NW 332,RESIDENTIAL,54400,0,54400,210200,0,264600
132710301500000,NW 332,RESIDENTIAL,37600,0,37600,200300,0,237900
132710301600000,NW 332,RESIDENTIAL,38100,0,38100,181800,0,219900
132710301700000,NW 332,RESIDENTIAL,35900,0,35900,171500,0,207400
132710301800000,NW 332,RESIDENTIAL,41400,0,41400,178200,0,219600
132710301900000,NW 332,RESIDENTIAL,38100,0,38100,179400,0,217500
132710302000000,NW 332,RESIDENTIAL,38100,0,38100,204700,0,242800
132710302100000,NW 332,RESIDENTIAL,35900,0,35900,172900,0,208800
132710302200000,NW 332,RESIDENTIAL,57900,0,57900,4000,0,61900
132710302300000,NW 332,RESIDENTIAL,46900,0,46900,216900,0,263800
132710302400000,NW 332,RESIDENTIAL,51500,0,51500,205100,0,256600
132710302500000,NW 332,RESIDENTIAL,44400,0,44400,165500,0,209900
132710302600000,NW 332,RESIDENTIAL,44000,0,44000,176800,0,220800
132710302700000,NW 332,RESIDENTIAL,55000,0,55000,189400,0,244400
132710400100000,NW 332,RESIDENTIAL,56500,0,56500,218700,0,275200
132710400200000,NW 332,RESIDENTIAL,41800,0,41800,222500,0,264300
132710400300000,NW 332,RESIDENTIAL,38500,0,38500,208400,0,246900
132710400400000,NW 332,RESIDENTIAL,45800,0,45800,213600,0,259400
132710400500000,NW 332,RESIDENTIAL,75600,0,75600,235200,0,310800
132710400600000,NW 332,RESIDENTIAL,71300,0,71300,237200,0,308500
132710400700000,CITY PROPERTY,EXEMPT,0,0,0,0,0,0
132710400800000,NW 332,RESIDENTIAL,57000,0,57000,205900,0,262900
132710400900000,NW 332,RESIDENTIAL,40200,0,40200,168200,0,208400
132710401000000,NW 332,RESIDENTIAL,43800,0,43800,196300,0,240100
132710401100000,NW 332,RESIDENTIAL,36300,0,36300,196700,0,233000
132710401200000,NW 332,RESIDENTIAL,47800,0,47800,182500,0,230300
132710401300000,NW 332,RESIDENTIAL,42200,0,42200,179700,0,221900
132710401400000,NW 332,RESIDENTIAL,43300,0,43300,160300,0,203600
132710401500000,NW 332,RESIDENTIAL,65200,0,65200,178900,0,244100
132710401800000,NW 332,RESIDENTIAL,44300,0,44300,171500,0,215800
132710401900000,NW 332,RESIDENTIAL,52500,0,52500,167200,0,219700
132710500100000,NW 332,RESIDENTIAL,55000,0,55000,171100,0,226100
132710500200000,NW 332,RESIDENTIAL,55600,0,55600,182400,0,238000
132710600100000,NW 332,RESIDENTIAL,52300,0,52300,213000,0,265300
132710600200000,NW 332,RESIDENTIAL,36300,0,36300,178900,0,215200
132710600300000,NW 332,RESIDENTIAL,44000,0,44000,167700,0,211700
132710600400000,NW 332,RESIDENTIAL,35800,0,35800,229500,0,265300
132710600500000,NW 332,RESIDENTIAL,55800,0,55800,153900,0,209700
132710600600000,NW 332,RESIDENTIAL,55500,0,55500,140500,0,196000
132710600700000,NW 332,RESIDENTIAL,38500,0,38500,180100,0,218600
132710600800000,NW 332,RESIDENTIAL,36300,0,36300,172200,0,208500
132710600900000,NW 332,RESIDENTIAL,41800,0,41800,184800,0,226600
132710601000000,NW 332,RESIDENTIAL,52300,0,52300,180800,0,233100
132712600100000,NW 332,RESIDENTIAL,59000,0,59000,54200,0,113200
132712600300000,NW 332,RESIDENTIAL,45300,0,45300,160400,0,205700
132712600400000,NW 332,RESIDENTIAL,35700,0,35700,145800,0,181500
132712600500000,NW 332,RESIDENTIAL,39900,0,39900,153800,0,193700
132712600600000,NW 332,RESIDENTIAL,38300,0,38300,143000,0,181300
132712600800000,NW 332,RESIDENTIAL,43500,0,43500,161600,0,205100
132712600900000,NW 332,RESIDENTIAL,43500,0,43500,189200,0,232700
132712601000000,NW 332,RESIDENTIAL,38300,0,38300,180800,0,219100
132712601100000,NW 332,RESIDENTIAL,39900,0,39900,196200,0,236100
132712601200000,NW 332,RESIDENTIAL,39000,0,39000,165300,0,204300
132712601300000,NW 332,RESIDENTIAL,45100,0,45100,200400,0,245500
132712601400000,NW 332,RESIDENTIAL,44400,0,44400,156700,0,201100
132712700100000,NW 332,RESIDENTIAL,49700,0,49700,186700,0,236400
132712700200000,NW 332,RESIDENTIAL,48300,0,48300,171300,0,219600
132712700300000,NW 332,RESIDENTIAL,50200,0,50200,203500,0,253700
132712700400000,NW 332,RESIDENTIAL,48300,0,48300,187700,0,236000
132712700500000,NW 332,RESIDENTIAL,50100,0,50100,228600,0,278700
132712700600000,NW 332,RESIDENTIAL,50800,0,50800,141600,0,192400
132712700700000,NW 332,RESIDENTIAL,51400,0,51400,178700,0,230100
132712700800000,NW 332,RESIDENTIAL,47000,0,47000,169400,0,216400
132712700900000,NW 332,RESIDENTIAL,47700,0,47700,155600,0,203300
132712701000000,NW 332,RESIDENTIAL,50800,0,50800,181200,0,232000
132712701100000,NW 332,RESIDENTIAL,47700,0,47700,176000,0,223700
132712701200000,NW 332,RESIDENTIAL,39000,0,39000,173900,0,212900
132712701300000,NW 332,RESIDENTIAL,46700,0,46700,183200,0,229900
132712701400000,NW 332,RESIDENTIAL,40000,0,40000,185900,0,225900
132712701500000,NW 332,RESIDENTIAL,41100,0,41100,234000,0,275100
132712701600000,NW 332,RESIDENTIAL,41000,0,41000,165600,0,206600
132712701700000,NW 332,RESIDENTIAL,43000,0,43000,196600,0,239600
132712701800000,CITY PROPERTY,EXEMPT,0,0,0,0,0,0
132712701900000,NW 332,RESIDENTIAL,45500,0,45500,263100,0,308600
132712702000000,NW 332,RESIDENTIAL,48100,0,48100,221100,0,269200
132712702100000,NW 332,RESIDENTIAL,52900,0,52900,513600,0,566500
132712702200000,NW 332,RESIDENTIAL,52700,0,52700,264800,0,317500
132712702300000,NW 332,RESIDENTIAL,48600,0,48600,294500,0,343100
132712702400000,NW 332,RESIDENTIAL,13700,0,13700,0,0,13700
132712800100000,NW 332,RESIDENTIAL,38300,0,38300,141000,0,179300
132712800200000,NW 332,RESIDENTIAL,42200,0,42200,189600,0,231800
132712800300000,NW 332,RESIDENTIAL,43200,0,43200,169200,0,212400
132712800400000,NW 332,RESIDENTIAL,43600,0,43600,176800,0,220400
132712800500000,NW 332,RESIDENTIAL,44400,0,44400,165500,0,209900
132712800600000,NW 332,RESIDENTIAL,43400,0,43400,196800,0,240200
132712800800000,NW 332,RESIDENTIAL,38300,0,38300,160900,0,199200
132712800900000,NW 332,RESIDENTIAL,41000,0,41000,187900,0,228900
132712801000000,NW 332,RESIDENTIAL,45800,0,45800,173900,0,219700
132712801100000,NW 332,RESIDENTIAL,43300,0,43300,168400,0,211700
132712801200000,NW 332,RESIDENTIAL,42000,0,42000,176900,0,218900
132712801300000,NW 332,RESIDENTIAL,48200,0,48200,173900,0,222100
132712801400000,NW 332,RESIDENTIAL,45800,0,45800,217600,0,263400
132712801500000,NW 332,RESIDENTIAL,45800,0,45800,205000,0,250800
132712801600000,NW 332,RESIDENTIAL,44600,0,44600,146400,0,191000
132712801700000,NW 332,RESIDENTIAL,39100,0,39100,167900,0,207000
132712801800000,NW 332,RESIDENTIAL,36300,0,36300,189400,0,225700
132712801900000,NW 332,RESIDENTIAL,40700,0,40700,167700,0,208400
132712802000000,NW 332,RESIDENTIAL,39100,0,39100,200700,0,239800
132712802100000,NW 332,RESIDENTIAL,41600,0,41600,170700,0,212300
132712802200000,NW 332,RESIDENTIAL,44000,0,44000,182000,0,226000
132712802300000,NW 332,RESIDENTIAL,42900,0,42900,176500,0,219400
132712802400000,NW 332,RESIDENTIAL,39300,0,39300,149000,0,188300
132712802500000,NW 332,RESIDENTIAL,40700,0,40700,160900,0,201600
132712802600000,NW 332,RESIDENTIAL,39100,0,39100,150600,0,189700
132712802700000,NW 332,RESIDENTIAL,44500,0,44500,175900,0,220400
132712802800000,NW 332,RESIDENTIAL,40300,0,40300,198200,0,238500
132712802900000,NW 332,RESIDENTIAL,40200,0,40200,180900,0,221100
132712803000000,NW 332,RESIDENTIAL,39900,0,39900,139400,0,179300
132712900100000,NW 332,RESIDENTIAL,43200,0,43200,181000,0,224200
132712900200000,NW 332,RESIDENTIAL,43900,0,43900,179600,0,223500
132712900300000,NW 332,RESIDENTIAL,46800,0,46800,162700,0,209500
132712900400000,NW 332,RESIDENTIAL,40700,0,40700,146700,0,187400
132712900500000,NW 332,RESIDENTIAL,42400,0,42400,197800,0,240200
132712900600000,NW 332,RESIDENTIAL,40400,0,40400,218700,0,259100
132712900700000,NW 332,RESIDENTIAL,41700,0,41700,151300,0,193000
132712900800000,NW 332,RESIDENTIAL,45300,0,45300,176100,0,221400
132712900900000,NW 332,RESIDENTIAL,41000,0,41000,156400,0,197400
132712901000000,NW 332,RESIDENTIAL,44300,0,44300,165600,0,209900
132712901100000,NW 332,RESIDENTIAL,35400,0,35400,153600,0,189000
132712901200000,NW 332,RESIDENTIAL,37400,0,37400,200800,0,238200
132713000100000,NW 332,RESIDENTIAL,44900,0,44900,158700,0,203600
132713000200000,NW 332,RESIDENTIAL,38700,0,38700,158400,0,197100
132713000300000,NW 332,RESIDENTIAL,39700,0,39700,174600,0,214300
132713000400000,NW 332,RESIDENTIAL,37800,0,37800,191400,0,229200
132713000500000,NW 332,RESIDENTIAL,44400,0,44400,173600,0,218000
132713000600000,NW 332,RESIDENTIAL,45900,0,45900,175200,0,221100
132713000700000,NW 332,RESIDENTIAL,39400,0,39400,172100,0,211500
132713000800000,NW 332,RESIDENTIAL,36300,0,36300,147100,0,183400
132713000900000,NW 332,RESIDENTIAL,39800,0,39800,164300,0,204100
132713001000000,NW 332,RESIDENTIAL,41300,0,41300,169000,0,210300
132713001100000,NW 332,RESIDENTIAL,43800,0,43800,156400,0,200200
132713001200000,NW 332,RESIDENTIAL,45100,0,45100,197700,0,242800
132715100100000,NW 331,RESIDENTIAL,31800,0,31800,129400,0,161200
132715100200000,NW 331,RESIDENTIAL,34000,0,34000,110400,0,144400
132715100300000,NW 331,RESIDENTIAL,36300,0,36300,156400,0,192700
132715100400000,NW 332,RESIDENTIAL,46400,0,46400,159400,0,205800
132715100500000,NW 332,RESIDENTIAL,42800,0,42800,108900,0,151700
132715100600000,NW 332,RESIDENTIAL,42000,0,42000,137300,0,179300
132715200100000,NW 332,RESIDENTIAL,42200,0,42200,203200,0,245400
132715200200000,NW 332,RESIDENTIAL,48600,0,48600,267500,0,316100
132715200300000,NW 332,RESIDENTIAL,41700,0,41700,150500,0,192200
132715200400000,NW 332,RESIDENTIAL,40100,0,40100,152200,0,192300
132715200500000,NW 332,RESIDENTIAL,35800,0,35800,142400,0,178200
132715200600000,NW 332,RESIDENTIAL,35600,0,35600,181200,0,216800
132715200700000,NW 332,RESIDENTIAL,39400,0,39400,151000,0,190400
132715200800000,NW 332,RESIDENTIAL,40100,0,40100,138800,0,178900
132715200900000,NW 332,RESIDENTIAL,38600,0,38600,163500,0,202100
132715201000000,NW 332,RESIDENTIAL,36200,0,36200,148500,0,184700
132715201100000,NW 332,RESIDENTIAL,35700,0,35700,150100,0,185800
132715201200000,NW 332,RESIDENTIAL,37700,0,37700,164000,0,201700
132715201300000,NW 332,RESIDENTIAL,39500,0,39500,155900,0,195400
132715201400000,NW 332,RESIDENTIAL,38300,0,38300,152800,0,191100
132715201500000,NW 332,RESIDENTIAL,37800,0,37800,150200,0,188000
132715201600000,NW 332,RESIDENTIAL,39900,0,39900,154100,0,194000
132715201700000,NW 332,RESIDENTIAL,38000,0,38000,135400,0,173400
132715201800000,NW 332,RESIDENTIAL,44000,0,44000,138900,0,182900
132715201900000,NW 332,RESIDENTIAL,35200,0,35200,138000,0,173200
132715202000000,NW 332,RESIDENTIAL,39700,0,39700,164200,0,203900
132715202100000,NW 332,RESIDENTIAL,41000,0,41000,154700,0,195700
132715202200000,NW 332,RESIDENTIAL,41000,0,41000,140600,0,181600
132715202300000,NW 332,RESIDENTIAL,41000,0,41000,151800,0,192800
132715202400000,NW 332,RESIDENTIAL,41300,0,41300,153500,0,194800
132715202500000,NW 332,RESIDENTIAL,42600,0,42600,151000,0,193600
132715202600000,NW 332,RESIDENTIAL,46700,0,46700,180600,0,227300
132715202700000,NW 332,RESIDENTIAL,44700,0,44700,166400,0,211100
132715202800000,NW 332,RESIDENTIAL,43500,0,43500,135100,0,178600
132715202900000,NW 332,RESIDENTIAL,44000,0,44000,131400,0,175400
132715203000000,NW 332,RESIDENTIAL,43600,0,43600,143000,0,186600
132715203100000,NW 332,RESIDENTIAL,42500,0,42500,131200,0,173700
132715203200000,NW 332,RESIDENTIAL,44700,0,44700,152300,0,197000
132715300100000,NW 332,RESIDENTIAL,37300,0,37300,153100,0,190400
132715300200000,NW 332,RESIDENTIAL,34800,0,34800,147800,0,182600
132715300300000,NW 332,RESIDENTIAL,33000,0,33000,122200,0,155200
132715300400000,NW 332,RESIDENTIAL,35000,0,35000,137700,0,172700
132715300500000,NW 332,RESIDENTIAL,40700,0,40700,159700,0,200400
132715400100000,NW 331,RESIDENTIAL,35300,0,35300,160800,0,196100
132715400200000,NW 331,RESIDENTIAL,36700,0,36700,137800,0,174500
132715400300000,NW 332,RESIDENTIAL,40600,0,40600,119700,0,160300
132715400400000,NW 332,RESIDENTIAL,42100,0,42100,148100,0,190200
132715400500000,NW 332,RESIDENTIAL,40400,0,40400,169700,0,210100
132715500100000,NW 332,RESIDENTIAL,37800,0,37800,163600,0,201400
132715500200000,NW 332,RESIDENTIAL,38700,0,38700,133100,0,171800
132715500300000,NW 332,RESIDENTIAL,39900,0,39900,150100,0,190000
132715500400000,NW 332,RESIDENTIAL,40000,0,40000,130300,0,170300
132715500500000,NW 332,RESIDENTIAL,37800,0,37800,157800,0,195600
132715500600000,NW 332,RESIDENTIAL,39800,0,39800,157900,0,197700
132715500700000,NW 332,RESIDENTIAL,40400,0,40400,130200,0,170600
132715500800000,NW 332,RESIDENTIAL,37500,0,37500,153200,0,190700
132715500900000,NW 332,RESIDENTIAL,35000,0,35000,150800,0,185800
132715501000000,NW 332,RESIDENTIAL,37100,0,37100,160400,0,197500
132715501100000,NW 332,RESIDENTIAL,39800,0,39800,154300,0,194100
132715501200000,NW 332,RESIDENTIAL,40700,0,40700,172700,0,213400
132715501300000,NW 332,RESIDENTIAL,37300,0,37300,159200,0,196500
132715501400000,NW 332,RESIDENTIAL,41800,0,41800,160300,0,202100
132715501500000,NW 332,RESIDENTIAL,38200,0,38200,166400,0,204600
132715501600000,NW 332,RESIDENTIAL,35700,0,35700,132600,0,168300
132715501700000,NW 332,RESIDENTIAL,38000,0,38000,157900,0,195900
132715501800000,NW 332,RESIDENTIAL,35500,0,35500,131200,0,166700
132715501900000,NW 332,RESIDENTIAL,37500,0,37500,133200,0,170700
132715502000000,NW 332,RESIDENTIAL,35500,0,35500,151100,0,186600
132715502100000,NW 332,RESIDENTIAL,37500,0,37500,111700,0,149200
132715502200000,NW 332,RESIDENTIAL,40400,0,40400,165600,0,206000
132715502300000,NW 332,RESIDENTIAL,39500,0,39500,160600,0,200100
132715502400000,NW 332,RESIDENTIAL,36700,0,36700,162600,0,199300
132715502500000,NW 332,RESIDENTIAL,35700,0,35700,139900,0,175600
132715502600000,NW 332,RESIDENTIAL,38300,0,38300,185700,0,224000
132715502700000,NW 332,RESIDENTIAL,36500,0,36500,145900,0,182400
132715600100000,NW 332,RESIDENTIAL,40800,0,40800,167600,0,208400
132715600200000,NW 332,RESIDENTIAL,38300,0,38300,143700,0,182000
132715600300000,NW 332,RESIDENTIAL,36900,0,36900,163700,0,200600
132715600400000,NW 332,RESIDENTIAL,38700,0,38700,182400,0,221100
132715600500000,NW 332,RESIDENTIAL,41900,0,41900,138900,0,180800
132715700100000,NW 332,RESIDENTIAL,41700,0,41700,152400,0,194100
132715700200000,NW 332,RESIDENTIAL,36700,0,36700,167900,0,204600
132715700300000,NW 332,RESIDENTIAL,37200,0,37200,160200,0,197400
132715700400000,NW 332,RESIDENTIAL,34600,0,34600,167800,0,202400
132715700500000,NW 332,RESIDENTIAL,34700,0,34700,147700,0,182400
132715700600000,NW 332,RESIDENTIAL,39200,0,39200,128800,0,168000
132715700700000,NW 332,RESIDENTIAL,42100,0,42100,160600,0,202700
132715700800000,NW 332,RESIDENTIAL,42500,0,42500,159100,0,201600
132715700900000,NW 332,RESIDENTIAL,43400,0,43400,118100,0,161500
132715701000000,NW 332,RESIDENTIAL,43900,0,43900,143200,0,187100
132715701100000,NW 332,RESIDENTIAL,47100,0,47100,190000,0,237100
132715701200000,NW 332,RESIDENTIAL,39500,0,39500,136000,0,175500
132715701300000,NW 332,RESIDENTIAL,42900,0,42900,159600,0,202500
132715800100000,NW 332,RESIDENTIAL,43900,0,43900,136900,0,180800
132715800200000,NW 332,RESIDENTIAL,39300,0,39300,146300,0,185600
132715800300000,NW 332,RESIDENTIAL,42000,0,42000,127000,0,169000
132715800400000,NW 332,RESIDENTIAL,42400,0,42400,126700,0,169100
132715800500000,NW 332,RESIDENTIAL,36800,0,36800,150400,0,187200
132715800600000,NW 332,RESIDENTIAL,40200,0,40200,157400,0,197600
132715800700000,NW 332,RESIDENTIAL,42600,0,42600,163200,0,205800
132715800800000,NW 332,RESIDENTIAL,42600,0,42600,144900,0,187500
132715800900000,NW 332,RESIDENTIAL,40700,0,40700,155200,0,195900
132715801000000,NW 332,RESIDENTIAL,42000,0,42000,174800,0,216800
132715801100000,NW 332,RESIDENTIAL,37100,0,37100,154200,0,191300
132715801200000,NW 332,EXEMPT,0,37000,37000,0,135800,172800
132715801300000,NW 332,RESIDENTIAL,37700,0,37700,143600,0,181300
132715801400000,NW 332,RESIDENTIAL,42800,0,42800,153100,0,195900
132715900100000,NW 332,RESIDENTIAL,42500,0,42500,204600,0,247100
132717600100000,NW 331,RESIDENTIAL,27600,0,27600,119900,0,147500
132717600200000,NW 331,RESIDENTIAL,29300,0,29300,112600,0,141900
132717600300000,NW 331,RESIDENTIAL,34200,0,34200,128400,0,162600
132717600400000,NW 331,RESIDENTIAL,31100,0,31100,112400,0,143500
132717600500000,NW 331,RESIDENTIAL,32400,0,32400,126500,0,158900
132717600600000,NW 331,RESIDENTIAL,36900,0,36900,112100,0,149000
132717600700000,NW 331,RESIDENTIAL,37400,0,37400,137600,0,175000
132717600800000,NW 331,RESIDENTIAL,34200,0,34200,134500,0,168700
132717600900000,NW 331,RESIDENTIAL,34200,0,34200,126200,0,160400
132717601000000,NW 331,RESIDENTIAL,30800,0,30800,129800,0,160600
132717601100000,NW 331,RESIDENTIAL,35100,0,35100,109100,0,144200
132717601200000,NW 331,RESIDENTIAL,35100,0,35100,145400,0,180500
132717601300000,NW 331,RESIDENTIAL,35100,0,35100,131100,0,166200
132717601400000,NW 331,RESIDENTIAL,35100,0,35100,124300,0,159400
132717601500000,NW 331,RESIDENTIAL,35100,0,35100,126400,0,161500
132717601600000,NW 331,RESIDENTIAL,35100,0,35100,161500,0,196600
132717601700000,NW 331,RESIDENTIAL,36500,0,36500,138700,0,175200
132717700100000,NW 331,RESIDENTIAL,27700,0,27700,160300,0,188000
132717700200000,NW 331,RESIDENTIAL,34600,0,34600,136300,0,170900
132717700300000,NW 331,RESIDENTIAL,29900,0,29900,121400,0,151300
132717700400000,NW 331,RESIDENTIAL,32400,0,32400,118900,0,151300
132717700500000,NW 331,RESIDENTIAL,32700,0,32700,121500,0,154200
132717700600000,NW 331,RESIDENTIAL,31700,0,31700,145500,0,177200
132717700700000,NW 331,RESIDENTIAL,36600,0,36600,112300,0,148900
132717700800000,NW 331,RESIDENTIAL,32300,0,32300,125700,0,158000
132717700900000,NW 331,RESIDENTIAL,31600,0,31600,129500,0,161100
132717701000000,NW 331,RESIDENTIAL,30500,0,30500,124300,0,154800
132717701100000,NW 331,RESIDENTIAL,28700,0,28700,120400,0,149100
132717701200000,NW 331,RESIDENTIAL,31500,0,31500,146000,0,177500
132717701300000,NW 331,RESIDENTIAL,29500,0,29500,120000,0,149500
132717701400000,NW 331,RESIDENTIAL,32500,0,32500,123900,0,156400
132717701500000,NW 331,RESIDENTIAL,29200,0,29200,145700,0,174900
132717701600000,NW 331,RESIDENTIAL,33900,0,33900,146600,0,180500
132717800100000,NW 331,RESIDENTIAL,36300,0,36300,133800,0,170100
132717800200000,NW 331,RESIDENTIAL,29000,0,29000,122600,0,151600
132717800300000,NW 331,RESIDENTIAL,30900,0,30900,135200,0,166100
132717800400000,NW 331,RESIDENTIAL,31300,0,31300,123400,0,154700
132717800500000,NW 331,RESIDENTIAL,27500,0,27500,162400,0,189900
132717800600000,NW 331,RESIDENTIAL,29100,0,29100,153800,0,182900
132717800700000,NW 331,RESIDENTIAL,32100,0,32100,169700,0,201800
132717800800000,NW 331,RESIDENTIAL,30200,0,30200,129500,0,159700
132717800900000,NW 331,RESIDENTIAL,31200,0,31200,143900,0,175100
132717801000000,NW 331,RESIDENTIAL,30000,0,30000,138700,0,168700
132717801100000,NW 331,RESIDENTIAL,31600,0,31600,140800,0,172400
132717801200000,NW 331,RESIDENTIAL,31200,0,31200,134300,0,165500
132717801300000,NW 331,RESIDENTIAL,32300,0,32300,144200,0,176500
132717801400000,NW 331,RESIDENTIAL,31100,0,31100,161600,0,192700
132717801500000,NW 331,RESIDENTIAL,36100,0,36100,153200,0,189300
132717801600000,NW 332,RESIDENTIAL,39200,0,39200,137700,0,176900
132717801700000,NW 331,RESIDENTIAL,37200,0,37200,147200,0,184400
132717801800000,NW 331,RESIDENTIAL,36000,0,36000,118300,0,154300
132717801900000,NW 331,RESIDENTIAL,34800,0,34800,119200,0,154000
132717802000000,NW 331,RESIDENTIAL,29500,0,29500,136000,0,165500
132717802100000,NW 331,RESIDENTIAL,34300,0,34300,101100,0,135400
132717802200000,NW 331,RESIDENTIAL,34700,0,34700,132000,0,166700
132717802300000,NW 331,RESIDENTIAL,32700,0,32700,152200,0,184900
132717802400000,NW 331,RESIDENTIAL,28500,0,28500,137100,0,165600
132717802500000,NW 331,RESIDENTIAL,32800,0,32800,109800,0,142600
132717802600000,NW 331,RESIDENTIAL,28700,0,28700,125400,0,154100
132717802700000,NW 331,RESIDENTIAL,33300,0,33300,134400,0,167700
132717802800000,NW 331,RESIDENTIAL,29400,0,29400,103900,0,133300
132717802900000,NW 331,RESIDENTIAL,36100,0,36100,133900,0,170000
132717900100000,NW 331,RESIDENTIAL,34500,0,34500,134300,0,168800
132717900200000,NW 331,RESIDENTIAL,29800,0,29800,140200,0,170000
132717900300000,NW 331,RESIDENTIAL,29500,0,29500,129800,0,159300
132717900400000,NW 331,RESIDENTIAL,28600,0,28600,135100,0,163700
132717900500000,NW 331,RESIDENTIAL,29400,0,29400,125800,0,155200
132717900600000,NW 331,RESIDENTIAL,29400,0,29400,133000,0,162400
132717900700000,NW 331,RESIDENTIAL,33700,0,33700,127400,0,161100
132717900800000,NW 331,RESIDENTIAL,32800,0,32800,123900,0,156700
132717900900000,NW 331,RESIDENTIAL,33000,0,33000,120100,0,153100
132717901000000,NW 331,RESIDENTIAL,34800,0,34800,130300,0,165100
132717901100000,NW 331,RESIDENTIAL,34800,0,34800,147400,0,182200
132717901200000,NW 331,RESIDENTIAL,35200,0,35200,127100,0,162300
132717901300000,NW 332,RESIDENTIAL,38600,0,38600,128400,0,167000
132717901400000,NW 332,RESIDENTIAL,39200,0,39200,173200,0,212400
132717901500000,NW 332,RESIDENTIAL,39600,0,39600,105300,0,144900
132717901600000,NW 332,RESIDENTIAL,35000,0,35000,115100,0,150100
132717901700000,NW 332,RESIDENTIAL,44200,0,44200,144000,0,188200
132717901800000,NW 331,RESIDENTIAL,36100,0,36100,120900,0,157000
132717901900000,NW 331,RESIDENTIAL,32700,0,32700,135500,0,168200
132717902000000,NW 331,RESIDENTIAL,34200,0,34200,98000,0,132200
132717902100000,NW 331,RESIDENTIAL,38000,0,38000,127500,0,165500
132717902200000,NW 331,RESIDENTIAL,37000,0,37000,121300,0,158300
132717902300000,NW 331,RESIDENTIAL,33600,0,33600,141400,0,175000
132717902400000,NW 331,RESIDENTIAL,28200,0,28200,120100,0,148300
132717902500000,NW 331,RESIDENTIAL,34000,0,34000,131600,0,165600
132717902600000,NW 331,RESIDENTIAL,34400,0,34400,143700,0,178100
132717902700000,NW 331,RESIDENTIAL,31700,0,31700,116700,0,148400
132717902800000,NW 331,RESIDENTIAL,35900,0,35900,159600,0,195500
132717902900000,NW 331,RESIDENTIAL,34600,0,34600,122500,0,157100
132717903000000,NW 331,RESIDENTIAL,33000,0,33000,129800,0,162800
132717903100000,NW 331,RESIDENTIAL,33500,0,33500,129200,0,162700
132717903200000,NW 331,RESIDENTIAL,29400,0,29400,119100,0,148500
132717903300000,NW 331,RESIDENTIAL,34000,0,34000,130800,0,164800
132717903400000,NW 331,RESIDENTIAL,35700,0,35700,111200,0,146900
132717903500000,NW 331,RESIDENTIAL,34100,0,34100,134900,0,169000
132717903600000,NW 331,RESIDENTIAL,34700,0,34700,105700,0,140400
132717903700000,NW 331,RESIDENTIAL,35400,0,35400,112700,0,148100
132717903800000,NW 331,RESIDENTIAL,33100,0,33100,146900,0,180000
132717903900000,NW 331,RESIDENTIAL,35000,0,35000,154200,0,189200
132717904000000,NW 331,RESIDENTIAL,32400,0,32400,125100,0,157500
132717904100000,NW 331,RESIDENTIAL,34600,0,34600,133100,0,167700
132717904200000,NW 331,RESIDENTIAL,28500,0,28500,104800,0,133300
132717904300000,NW 331,RESIDENTIAL,29000,0,29000,126200,0,155200
132718000100000,NW 332,RESIDENTIAL,41500,0,41500,139500,0,181000
132718000200000,NW 332,RESIDENTIAL,36100,0,36100,154700,0,190800
132718000300000,NW 332,RESIDENTIAL,43800,0,43800,133400,0,177200
132718100100000,NW 331,RESIDENTIAL,34000,0,34000,130200,0,164200
132718100200000,NW 331,RESIDENTIAL,27900,0,27900,134200,0,162100
132718100300000,NW 331,RESIDENTIAL,29100,0,29100,128200,0,157300
132718100400000,NW 331,RESIDENTIAL,33500,0,33500,144200,0,177700
132718100500000,NW 331,RESIDENTIAL,27600,0,27600,120200,0,147800
132718100600000,NW 331,RESIDENTIAL,25900,0,25900,97700,0,123600
132718100700000,NW 331,RESIDENTIAL,32800,0,32800,129000,0,161800
132718100800000,NW 331,RESIDENTIAL,32300,0,32300,118900,0,151200
132718100900000,NW 331,RESIDENTIAL,34500,0,34500,123700,0,158200
132718101000000,NW 331,RESIDENTIAL,28200,0,28200,147200,0,175400
132718101100000,NW 331,RESIDENTIAL,33400,0,33400,126700,0,160100
132718200100000,NW 331,RESIDENTIAL,35600,0,35600,119800,0,155400
132718200200000,NW 331,RESIDENTIAL,34100,0,34100,160800,0,194900
132718200300000,NW 331,RESIDENTIAL,35200,0,35200,105400,0,140600
132718200400000,NW 331,RESIDENTIAL,35000,0,35000,122000,0,157000
132718200500000,NW 331,RESIDENTIAL,36100,0,36100,115400,0,151500
132718200600000,NW 332,RESIDENTIAL,44500,0,44500,116800,0,161300
132718200700000,NW 332,RESIDENTIAL,47100,0,47100,158100,0,205200
132718200800000,NW 332,RESIDENTIAL,43700,0,43700,160000,0,203700
132720100200000,NW 332,RESIDENTIAL,37500,0,37500,176700,0,214200
132720200100000,NW 332,RESIDENTIAL,46500,0,46500,183900,0,230400
132720200200000,NW 332,RESIDENTIAL,37200,0,37200,166900,0,204100
132720200300000,NW 332,RESIDENTIAL,38300,0,38300,147600,0,185900
132725200100000,NW 332,RESIDENTIAL,46200,0,46200,273300,0,319500
132725200200000,NW 332,RESIDENTIAL,46200,0,46200,281400,0,327600
132725200300000,NW 332,RESIDENTIAL,46200,0,46200,327300,0,373500
132725200400000,NW 332,RESIDENTIAL,46200,0,46200,212500,0,258700
132725200500000,NW 332,RESIDENTIAL,46200,0,46200,297700,0,343900
132725200600000,NW 332,RESIDENTIAL,46200,0,46200,295500,0,341700
132725200700000,NW 332,RESIDENTIAL,44000,0,44000,284500,0,328500
132725200800000,NW 332,RESIDENTIAL,49100,0,49100,229800,0,278900
132725200900000,NW 332,RESIDENTIAL,61000,0,61000,258500,0,319500
132725201000000,NW 332,RESIDENTIAL,900,0,900,0,0,900
132725300100000,NW 332,RESIDENTIAL,500,0,500,0,0,500
132725300200000,NW 332,RESIDENTIAL,56200,0,56200,331700,0,387900
132725300300000,NW 332,RESIDENTIAL,49900,0,49900,222100,0,272000
132725300400000,NW 332,RESIDENTIAL,100,0,100,0,0,100
132725400100000,NW 332,RESIDENTIAL,44900,0,44900,292300,0,337200
132725400200000,NW 332,RESIDENTIAL,44900,0,44900,239500,0,284400
132725400300000,NW 332,RESIDENTIAL,41500,0,41500,220500,0,262000
132725400400000,NW 332,RESIDENTIAL,41500,0,41500,234400,0,275900
132725400500000,NW 332,RESIDENTIAL,44900,0,44900,219100,0,264000
132725400600000,NW 332,RESIDENTIAL,39300,0,39300,182800,0,222100
132725400700000,NW 332,RESIDENTIAL,44900,0,44900,245800,0,290700
132725400800000,NW 332,RESIDENTIAL,40000,0,40000,194700,0,234700
132725400900000,NW 332,RESIDENTIAL,44800,0,44800,195500,0,240300
132725401000000,NW 332,RESIDENTIAL,45200,0,45200,210700,0,255900
132725401100000,NW 332,RESIDENTIAL,54600,0,54600,215900,0,270500
132725401200000,NW 332,RESIDENTIAL,57200,0,57200,276800,0,334000
132725401300000,NW 332,RESIDENTIAL,500,0,500,0,0,500
132725401400000,NW 332,RESIDENTIAL,500,0,500,0,0,500
132725401500000,NW 332,RESIDENTIAL,500,0,500,0,0,500
132725401600000,NW 332,RESIDENTIAL,43200,0,43200,237800,0,281000
132725401700000,NW 332,RESIDENTIAL,500,0,500,0,0,500
132725401800000,NW 332,RESIDENTIAL,500,0,500,0,0,500
132725401900000,NW 332,RESIDENTIAL,43200,0,43200,194400,0,237600
132725402000000,NW 332,RESIDENTIAL,500,0,500,0,0,500
132725402100000,NW 332,RESIDENTIAL,500,0,500,0,0,500
132725402200000,NW 332,RESIDENTIAL,47100,0,47100,200200,0,247300
132725402300000,NW 332,RESIDENTIAL,46000,0,46000,250500,0,296500
132725500100000,NW 332,RESIDENTIAL,700,0,700,0,0,700
132725500200000,CITY PROPERTY,EXEMPT,0,0,0,0,0,0
132725500400000,NW 332,RESIDENTIAL,47900,0,47900,310500,0,358400
132725500500000,NW 332,RESIDENTIAL,59000,0,59000,308200,0,367200
132725500600000,NW 332,RESIDENTIAL,47600,0,47600,298400,0,346000
132725500700000,NW 332,RESIDENTIAL,50800,0,50800,264200,0,315000
132725500800000,NW 332,RESIDENTIAL,66800,0,66800,361000,0,427800
132725500900000,NW 332,RESIDENTIAL,60000,0,60000,240200,0,300200
132725600100000,NW 332,RESIDENTIAL,43200,0,43200,250400,0,293600
132725600200000,NW 332,RESIDENTIAL,500,0,500,0,0,500
132725600300000,NW 332,RESIDENTIAL,44900,0,44900,267100,0,312000
132725600400000,NW 332,RESIDENTIAL,46000,0,46000,200400,0,246400
132725600500000,NW 332,RESIDENTIAL,400,0,400,0,0,400
132725600600000,NW 332,RESIDENTIAL,500,0,500,0,0,500
132725600700000,NW 332,RESIDENTIAL,44900,0,44900,200300,0,245200
132725600800000,NW 332,RESIDENTIAL,44900,0,44900,267000,0,311900
132725600900000,NW 332,RESIDENTIAL,42600,0,42600,248000,0,290600
132725601000000,NW 332,RESIDENTIAL,46500,0,46500,228600,0,275100
132725601100000,NW 332,RESIDENTIAL,52600,0,52600,229800,0,282400
132725601200000,NW 332,RESIDENTIAL,53000,0,53000,230900,0,283900
132725601300000,NW 332,RESIDENTIAL,47900,0,47900,335300,0,383200
132725601400000,NW 332,RESIDENTIAL,46600,0,46600,136300,0,182900
132725601500000,NW 332,RESIDENTIAL,54800,0,54800,204600,0,259400
132725601600000,NW 332,RESIDENTIAL,600,0,600,0,0,600
132725601800000,CITY PROPERTY,EXEMPT,0,0,0,0,0,0
132727600100000,NW 332,RESIDENTIAL,40000,0,40000,166200,0,206200
132727600200000,NW 332,RESIDENTIAL,40000,0,40000,173200,0,213200
132727600300000,NW 332,RESIDENTIAL,40000,0,40000,140500,0,180500
132727600400000,NW 332,RESIDENTIAL,40000,0,40000,187300,0,227300
132727600500000,NW 332,RESIDENTIAL,40400,0,40400,184300,0,224700
132727700100000,NW 332,RESIDENTIAL,45100,0,45100,155700,0,200800
132727700200000,NW 332,RESIDENTIAL,37500,0,37500,175200,0,212700
132727700300000,NW 332,RESIDENTIAL,37500,0,37500,155500,0,193000
132727700500000,NW 332,RESIDENTIAL,37500,0,37500,137900,0,175400
132727700600000,NW 332,RESIDENTIAL,37500,0,37500,164700,0,202200
132727700700000,NW 332,RESIDENTIAL,45100,0,45100,216100,0,261200
132727800100000,NW 332,RESIDENTIAL,42800,0,42800,179600,0,222400
132727800200000,NW 332,RESIDENTIAL,44300,0,44300,180300,0,224600
132727800300000,NW 332,RESIDENTIAL,45600,0,45600,160400,0,206000
132727900100000,NW 332,RESIDENTIAL,45100,0,45100,159400,0,204500
132727900200000,NW 332,RESIDENTIAL,37500,0,37500,162500,0,200000
132727900300000,NW 332,RESIDENTIAL,37500,0,37500,156600,0,194100
132727900400000,NW 332,RESIDENTIAL,37800,0,37800,150400,0,188200
132727900500000,NW 332,RESIDENTIAL,37500,0,37500,165100,0,202600
132727900600000,NW 332,RESIDENTIAL,41800,0,41800,170700,0,212500
132727900700000,NW 332,RESIDENTIAL,49200,0,49200,236800,0,286000
132727900800000,NW 332,RESIDENTIAL,49500,0,49500,209400,0,258900
132727900900000,NW 332,RESIDENTIAL,49500,0,49500,208400,0,257900
132727901000000,NW 332,RESIDENTIAL,44000,0,44000,252400,0,296400
132727901100000,NW 332,RESIDENTIAL,46200,0,46200,268800,0,315000
132727901200000,NW 332,RESIDENTIAL,45100,0,45100,227100,0,272200
132727901300000,NW 332,RESIDENTIAL,46500,0,46500,281700,0,328200
132727901400000,NW 332,RESIDENTIAL,44000,0,44000,339700,0,383700
132727901500000,NW 332,RESIDENTIAL,44000,0,44000,258500,0,302500
132727901600000,NW 332,RESIDENTIAL,44000,0,44000,255100,0,299100
132728000100000,NW 332,RESIDENTIAL,37900,0,37900,159600,0,197500
132728000200000,NW 332,RESIDENTIAL,38300,0,38300,172600,0,210900
132728000300000,NW 332,RESIDENTIAL,34900,0,34900,164800,0,199700
132728000400000,NW 332,RESIDENTIAL,38400,0,38400,174600,0,213000
132728000500000,NW 332,RESIDENTIAL,38300,0,38300,162400,0,200700
132728000600000,NW 332,RESIDENTIAL,37900,0,37900,155500,0,193400
132728000700000,NW 332,RESIDENTIAL,40000,0,40000,168100,0,208100
132728000800000,NW 332,RESIDENTIAL,36600,0,36600,160900,0,197500
132728000900000,NW 332,RESIDENTIAL,40700,0,40700,175200,0,215900
132728001000000,NW 332,RESIDENTIAL,37900,0,37900,155800,0,193700
132728001100000,NW 332,RESIDENTIAL,37500,0,37500,154500,0,192000
132728001200000,NW 332,RESIDENTIAL,38500,0,38500,166200,0,204700
132728001300000,NW 332,RESIDENTIAL,38300,0,38300,185800,0,224100
132728001400000,NW 332,RESIDENTIAL,44900,0,44900,256700,0,301600
132728001500000,NW 332,RESIDENTIAL,44900,0,44900,219400,0,264300
132728001600000,NW 332,RESIDENTIAL,64500,0,64500,370800,0,435300
132728001700000,NW 332,RESIDENTIAL,48800,0,48800,271900,0,320700
132728001800000,NW 332,RESIDENTIAL,47100,0,47100,240200,0,287300
132728001900000,NW 332,RESIDENTIAL,48100,0,48100,293200,0,341300
132728002000000,NW 332,RESIDENTIAL,47500,0,47500,334200,0,381700
132728002100000,NW 332,RESIDENTIAL,44900,0,44900,225300,0,270200
132728002200000,NW 332,RESIDENTIAL,47100,0,47100,257000,0,304100
132728002300000,NW 332,RESIDENTIAL,49400,0,49400,225500,0,274900
132728002400000,NW 332,RESIDENTIAL,49400,0,49400,226000,0,275400
132728002500000,NW 332,RESIDENTIAL,49400,0,49400,266800,0,316200
132728002600000,NW 332,RESIDENTIAL,49000,0,49000,206200,0,255200
132728002700000,NW 332,RESIDENTIAL,56100,0,56100,288200,0,344300
132728002800000,NW 332,RESIDENTIAL,56100,0,56100,204600,0,260700
132728100100000,NW 332,RESIDENTIAL,40200,0,40200,150100,0,190300
132728100200000,NW 332,RESIDENTIAL,41100,0,41100,192100,0,233200
132728100300000,NW 332,RESIDENTIAL,37000,0,37000,129000,0,166000
132728100400000,NW 332,RESIDENTIAL,39100,0,39100,157100,0,196200
132728100500000,NW 332,RESIDENTIAL,39000,0,39000,194200,0,233200
132728100600000,NW 332,RESIDENTIAL,39600,0,39600,166200,0,205800
132728100800000,NW 332,RESIDENTIAL,42900,0,42900,182992,0,225892
132728100900000,NW 332,RESIDENTIAL,46900,0,46900,230700,0,277600
132728101000000,NW 332,RESIDENTIAL,46900,0,46900,222900,0,269800
132728101100000,NW 332,RESIDENTIAL,46900,0,46900,212400,0,259300
132728101200000,NW 332,RESIDENTIAL,44800,0,44800,256200,0,301000
132728101300000,NW 332,RESIDENTIAL,44900,0,44900,182000,0,226900
132728101400000,NW 332,RESIDENTIAL,46800,0,46800,177200,0,224000
132728101500000,NW 332,RESIDENTIAL,43200,0,43200,226500,0,269700
132728101600000,NW 332,RESIDENTIAL,44300,0,44300,214800,0,259100
132728101700000,NW 332,RESIDENTIAL,500,0,500,0,0,500
132728200100000,NW 332,RESIDENTIAL,53100,0,53100,204400,0,257500
132728200200000,NW 332,RESIDENTIAL,53300,0,53300,204300,0,257600
132740100100000,NW 331,RESIDENTIAL,38300,0,38300,0,0,38300
132740100200000,NW 331,RESIDENTIAL,35100,0,35100,110800,0,145900
132740100300000,NW 331,RESIDENTIAL,35100,0,35100,127500,0,162600
132740100400000,NW 331,RESIDENTIAL,36200,0,36200,131700,0,167900
132740100500000,NW 331,RESIDENTIAL,30400,0,30400,159700,0,190100
132740100600000,NW 331,RESIDENTIAL,29800,0,29800,126300,0,156100
132740100700000,NW 331,RESIDENTIAL,34200,0,34200,143300,0,177500
132740100800000,NW 331,RESIDENTIAL,36100,0,36100,149200,0,185300
132740100900000,NW 331,RESIDENTIAL,40200,0,40200,129200,0,169400
132740101000000,NW 331,RESIDENTIAL,39100,0,39100,142900,0,182000
132740101100000,NW 331,RESIDENTIAL,32800,0,32800,137800,0,170600
132740101200000,NW 331,RESIDENTIAL,38600,0,38600,142600,0,181200
132740101300000,NW 331,RESIDENTIAL,35000,0,35000,160400,0,195400
132740101400000,NW 331,RESIDENTIAL,42700,0,42700,147500,0,190200
132740101500000,NW 331,RESIDENTIAL,41300,0,41300,144300,0,185600
132740101600000,NW 332,RESIDENTIAL,41100,0,41100,165200,0,206300
132740101700000,NW 332,RESIDENTIAL,41700,0,41700,171000,0,212700
132740101800000,NW 332,RESIDENTIAL,38400,0,38400,169200,0,207600
132740101900000,NW 332,RESIDENTIAL,38400,0,38400,197300,0,235700
132740102000000,NW 332,RESIDENTIAL,40500,0,40500,175200,0,215700
132740102100000,NW 332,RESIDENTIAL,41500,0,41500,188000,0,229500
132740102200000,NW 332,RESIDENTIAL,38400,0,38400,163000,0,201400
132740102300000,NW 332,RESIDENTIAL,40900,0,40900,200500,0,241400
132740102400000,NW 332,RESIDENTIAL,38400,0,38400,152800,0,191200
132740102500000,NW 332,RESIDENTIAL,41300,0,41300,191900,0,233200
132740102600000,NW 332,RESIDENTIAL,42000,0,42000,153400,0,195400
132740102700000,NW 332,RESIDENTIAL,40900,0,40900,160400,0,201300
132740102800000,NW 332,RESIDENTIAL,40900,0,40900,172600,0,213500
132740102900000,NW 332,RESIDENTIAL,39900,0,39900,163900,0,203800
132740103000000,NW 332,RESIDENTIAL,41300,0,41300,189000,0,230300
132740103100000,NW 332,RESIDENTIAL,41300,0,41300,173400,0,214700
132740103200000,NW 332,RESIDENTIAL,38400,0,38400,167700,0,206100
132740103400000,SCHOOL,EXEMPT,0,709000,709000,0,1777300,2486300
132740103500000,CITY PROPERTY,EXEMPT,0,0,0,0,0,0
132740200100000,NW 332,RESIDENTIAL,41200,0,41200,175300,0,216500
132740200200000,NW 332,RESIDENTIAL,39600,0,39600,164800,0,204400
132740200300000,NW 332,RESIDENTIAL,43900,0,43900,155300,0,199200
132740300100000,NW 332,RESIDENTIAL,41200,0,41200,189800,0,231000
132740300200000,NW 332,RESIDENTIAL,40600,0,40600,166600,0,207200
132740300400000,NW 332,RESIDENTIAL,39600,0,39600,155600,0,195200
132740300500000,NW 332,RESIDENTIAL,41200,0,41200,188800,0,230000
132740300600000,NW 332,RESIDENTIAL,39600,0,39600,165800,0,205400
132740300700000,NW 332,RESIDENTIAL,4000,0,4000,0,0,4000
132740400100000,NW 332,RESIDENTIAL,40400,0,40400,202500,0,242900
132740400200000,NW 332,RESIDENTIAL,36300,0,36300,161400,0,197700
132740400300000,NW 332,RESIDENTIAL,39900,0,39900,169900,0,209800
132740400600000,NW 332,RESIDENTIAL,39500,0,39500,170200,0,209700
132740400700000,NW 332,RESIDENTIAL,38200,0,38200,153500,0,191700
132740400800000,NW 332,RESIDENTIAL,39200,0,39200,161900,0,201100
132740400900000,NW 332,RESIDENTIAL,41500,0,41500,187400,0,228900
132740401000000,NW 332,RESIDENTIAL,39400,0,39400,163900,0,203300
132740500100000,NW 332,RESIDENTIAL,39900,0,39900,184200,0,224100
132740500200000,NW 332,RESIDENTIAL,40000,0,40000,155300,0,195300
132740500300000,NW 332,RESIDENTIAL,35100,0,35100,163800,0,198900
132740500400000,NW 332,RESIDENTIAL,38200,0,38200,153300,0,191500
132740500500000,NW 332,RESIDENTIAL,38700,0,38700,186900,0,225600
132742600100000,NW 332,RESIDENTIAL,43100,0,43100,161100,0,204200
132742600200000,NW 332,RESIDENTIAL,40000,0,40000,176400,0,216400
132742600300000,NW 332,RESIDENTIAL,40000,0,40000,166300,0,206300
132742600400000,NW 332,RESIDENTIAL,38900,0,38900,188600,0,227500
132742600500000,NW 332,RESIDENTIAL,40800,0,40800,169400,0,210200
132742600600000,NW 332,RESIDENTIAL,38800,0,38800,170200,0,209000
132742600700000,NW 332,RESIDENTIAL,40800,0,40800,189700,0,230500
132742600800000,NW 332,RESIDENTIAL,38800,0,38800,166800,0,205600
132742600900000,NW 332,RESIDENTIAL,38800,0,38800,201300,0,240100
132742601000000,NW 332,RESIDENTIAL,40800,0,40800,189700,0,230500
132742601100000,NW 332,RESIDENTIAL,38800,0,38800,155500,0,194300
132742601200000,NW 332,RESIDENTIAL,41800,0,41800,153400,0,195200
132742601300000,NW 332,RESIDENTIAL,41300,0,41300,170300,0,211600
132742601400000,NW 332,RESIDENTIAL,38800,0,38800,151100,0,189900
132742601500000,NW 332,RESIDENTIAL,41500,0,41500,180000,0,221500
132742700100000,CITY PROPERTY,EXEMPT,0,0,0,0,0,0
132742700200000,NW 332,RESIDENTIAL,50000,0,50000,221000,0,271000
132742700300000,NW 332,RESIDENTIAL,44700,0,44700,178300,0,223000
132742700400000,NW 332,RESIDENTIAL,44500,0,44500,178400,0,222900
132742700500000,NW 332,RESIDENTIAL,46100,0,46100,182200,0,228300
132742700600000,NW 332,RESIDENTIAL,45200,0,45200,165500,0,210700
132742700700000,NW 332,RESIDENTIAL,43700,0,43700,180600,0,224300
132742700800000,NW 332,RESIDENTIAL,40900,0,40900,185100,0,226000
132742700900000,NW 332,RESIDENTIAL,44400,0,44400,189900,0,234300
132742701000000,NW 332,RESIDENTIAL,44000,0,44000,177700,0,221700
132742701100000,NW 332,RESIDENTIAL,46800,0,46800,181400,0,228200
132742701200000,NW 332,RESIDENTIAL,44000,0,44000,196500,0,240500
132742701300000,NW 332,RESIDENTIAL,46800,0,46800,259400,0,306200
132742701400000,NW 332,RESIDENTIAL,44000,0,44000,202400,0,246400
132742701500000,NW 332,RESIDENTIAL,46800,0,46800,180400,0,227200
132742800100000,NW 332,RESIDENTIAL,40100,0,40100,147700,0,187800
132742800200000,NW 332,RESIDENTIAL,39200,0,39200,152100,0,191300
132742800300000,NW 332,RESIDENTIAL,40500,0,40500,191500,0,232000
132742800400000,NW 332,RESIDENTIAL,40400,0,40400,185700,0,226100
132742800500000,NW 332,RESIDENTIAL,37500,0,37500,151800,0,189300
132742800600000,NW 332,RESIDENTIAL,39900,0,39900,200200,0,240100
132742800700000,NW 332,RESIDENTIAL,38000,0,38000,165300,0,203300
132742800800000,NW 332,RESIDENTIAL,40000,0,40000,182600,0,222600
132742800900000,NW 332,RESIDENTIAL,40000,0,40000,177400,0,217400
132742801000000,NW 332,RESIDENTIAL,38000,0,38000,190200,0,228200
132742801100000,NW 332,RESIDENTIAL,41900,0,41900,193100,0,235000
132742801200000,NW 332,RESIDENTIAL,47800,0,47800,184900,0,232700
132742801300000,NW 332,RESIDENTIAL,42500,0,42500,175200,0,217700
132742801400000,NW 332,RESIDENTIAL,41300,0,41300,186100,0,227400
132742801500000,NW 332,RESIDENTIAL,46900,0,46900,164200,0,211100
132742801600000,NW 332,RESIDENTIAL,48800,0,48800,216900,0,265700
132742801700000,NW 332,RESIDENTIAL,42200,0,42200,234000,0,276200
132742801800000,NW 332,RESIDENTIAL,39000,0,39000,160600,0,199600
132742801900000,NW 332,RESIDENTIAL,40000,0,40000,181800,0,221800
132742802000000,NW 332,RESIDENTIAL,39000,0,39000,179100,0,218100
132742802100000,NW 332,RESIDENTIAL,40000,0,40000,186100,0,226100
132742802200000,NW 332,RESIDENTIAL,40000,0,40000,151800,0,191800
132742802300000,NW 332,RESIDENTIAL,39900,0,39900,199200,0,239100
132742802400000,NW 332,RESIDENTIAL,38000,0,38000,135100,0,173100
132742802500000,NW 332,RESIDENTIAL,38800,0,38800,173200,0,212000
132742802600000,NW 332,RESIDENTIAL,38100,0,38100,180100,0,218200
132742802700000,NW 332,RESIDENTIAL,41100,0,41100,171100,0,212200
132742900100000,NW 332,RESIDENTIAL,39300,0,39300,187200,0,226500
132742900200000,NW 332,RESIDENTIAL,41700,0,41700,187600,0,229300
132742900300000,NW 332,RESIDENTIAL,38300,0,38300,159800,0,198100
132742900400000,NW 332,RESIDENTIAL,39900,0,39900,181300,0,221200
132742900500000,NW 332,RESIDENTIAL,36000,0,36000,156700,0,192700
132742900600000,NW 332,RESIDENTIAL,40000,0,40000,186500,0,226500
132742900700000,NW 332,RESIDENTIAL,38000,0,38000,179100,0,217100
132742900800000,NW 332,RESIDENTIAL,39500,0,39500,153100,0,192600
132742900900000,NW 332,RESIDENTIAL,43800,0,43800,171000,0,214800
132742901000000,NW 332,RESIDENTIAL,44200,0,44200,199400,0,243600
132742901100000,NW 332,RESIDENTIAL,46800,0,46800,180800,0,227600
132742901300000,NW 332,RESIDENTIAL,4200,0,4200,0,0,4200
132742901400000,NW 332,RESIDENTIAL,4000,0,4000,0,0,4000
132742901500000,NW 332,RESIDENTIAL,4000,0,4000,0,0,4000
132742901600000,NW 332,RESIDENTIAL,4000,0,4000,0,0,4000
132742901700000,NW 332,RESIDENTIAL,42400,0,42400,208900,0,251300
132742901800000,NW 332,RESIDENTIAL,4000,0,4000,0,0,4000
132742901900000,NW 332,RESIDENTIAL,3900,0,3900,0,0,3900
132742902000000,NW 332,RESIDENTIAL,3900,0,3900,0,0,3900
132743000100000,NW 332,RESIDENTIAL,46800,0,46800,178200,0,225000
132743000200000,NW 332,RESIDENTIAL,42400,0,42400,193200,0,235600
132743000300000,NW 332,RESIDENTIAL,47200,0,47200,187900,0,235100
132743000400000,NW 332,RESIDENTIAL,43000,0,43000,173900,0,216900
132743000500000,NW 332,RESIDENTIAL,41300,0,41300,146900,0,188200
132743000600000,NW 332,RESIDENTIAL,44400,0,44400,203900,0,248300
132743000700000,NW 332,RESIDENTIAL,44000,0,44000,194000,0,238000
132743000800000,NW 332,RESIDENTIAL,41300,0,41300,165400,0,206700
132743000900000,NW 332,RESIDENTIAL,44400,0,44400,212100,0,256500
132743001000000,NW 332,RESIDENTIAL,44000,0,44000,183400,0,227400
132743001100000,NW 332,RESIDENTIAL,41700,0,41700,172400,0,214100
132743001200000,NW 332,RESIDENTIAL,41700,0,41700,153200,0,194900
132743001300000,NW 332,RESIDENTIAL,44300,0,44300,204400,0,248700
132743001400000,NW 332,RESIDENTIAL,44400,0,44400,214700,0,259100
132743001500000,NW 332,RESIDENTIAL,41100,0,41100,190300,0,231400
132743001600000,NW 332,RESIDENTIAL,44400,0,44400,194100,0,238500
132743001700000,NW 332,RESIDENTIAL,41100,0,41100,182000,0,223100
132743100100000,NW 332,RESIDENTIAL,46500,0,46500,222600,0,269100
132743100200000,NW 332,RESIDENTIAL,44900,0,44900,206200,0,251100
132743100300000,NW 332,RESIDENTIAL,45100,0,45100,223400,0,268500
132743100400000,NW 332,RESIDENTIAL,44400,0,44400,263900,0,308300
132743100500000,NW 332,RESIDENTIAL,44400,0,44400,230500,0,274900
132743100600000,NW 332,RESIDENTIAL,42400,0,42400,140600,0,183000
132743100700000,NW 332,RESIDENTIAL,4000,0,4000,0,0,4000
132743100800000,NW 332,RESIDENTIAL,4000,0,4000,0,0,4000
132743100900000,NW 332,RESIDENTIAL,3600,0,3600,0,0,3600
132743200100000,NW 332,RESIDENTIAL,4000,0,4000,0,0,4000
132743200200000,NW 332,RESIDENTIAL,4000,0,4000,0,0,4000
132743200300000,NW 332,RESIDENTIAL,4000,0,4000,0,0,4000
132743200400000,NW 332,RESIDENTIAL,4100,0,4100,0,0,4100
132743200500000,NW 332,RESIDENTIAL,4800,0,4800,0,0,4800
132743200600000,NW 332,RESIDENTIAL,47900,0,47900,165100,0,213000
132743200700000,NW 332,RESIDENTIAL,4900,0,4900,0,0,4900
132743200800000,NW 332,RESIDENTIAL,42900,0,42900,9300,0,52200
132743200900000,NW 332,RESIDENTIAL,4200,0,4200,0,0,4200
132743201000000,NW 332,RESIDENTIAL,4400,0,4400,0,0,4400
132743201100000,NW 332,RESIDENTIAL,4200,0,4200,0,0,4200
132743300100000,NW 332,RESIDENTIAL,4300,0,4300,0,0,4300
132743300200000,NW 332,RESIDENTIAL,47900,0,47900,278500,0,326400
132743300300000,NW 332,RESIDENTIAL,4000,0,4000,0,0,4000
132743300400000,NW 332,RESIDENTIAL,3900,0,3900,0,0,3900
132743300500000,NW 332,RESIDENTIAL,4500,0,4500,0,0,4500
132745100200000,NW 332,RESIDENTIAL,43900,0,43900,273400,0,317300
132745100300000,NW 332,RESIDENTIAL,49500,0,49500,214200,0,263700
132745100400000,NW 332,RESIDENTIAL,4000,0,4000,0,0,4000
132745100500000,NW 332,RESIDENTIAL,89000,0,89000,0,0,89000
132745200100000,NW 332,RESIDENTIAL,41700,0,41700,178000,0,219700
132745200200000,NW 332,RESIDENTIAL,44000,0,44000,205200,0,249200
132745200500000,NW 332,RESIDENTIAL,46000,0,46000,224900,0,270900
132745200600000,NW 332,RESIDENTIAL,46300,0,46300,234500,0,280800
132745300100000,NW 332,RESIDENTIAL,44400,0,44400,176100,0,220500
132745300300000,NW 332,RESIDENTIAL,100,0,100,0,0,100
132745300400000,NW 332,RESIDENTIAL,45900,0,45900,177700,0,223600
132745400100000,NW 332,RESIDENTIAL,44600,0,44600,275200,0,319800
132745400200000,NW 332,RESIDENTIAL,44000,0,44000,190800,0,234800
132745400300000,NW 332,RESIDENTIAL,38500,0,38500,176100,0,214600
132745400400000,NW 332,RESIDENTIAL,44000,0,44000,256700,0,300700
132745400500000,NW 332,RESIDENTIAL,38500,0,38500,164500,0,203000
132745400600000,NW 332,RESIDENTIAL,44000,0,44000,242800,0,286800
132745400700000,NW 332,RESIDENTIAL,42400,0,42400,182400,0,224800
132745400800000,NW 332,RESIDENTIAL,42900,0,42900,170300,0,213200
132745400900000,NW 332,RESIDENTIAL,44000,0,44000,192500,0,236500
132745401000000,NW 332,RESIDENTIAL,45100,0,45100,189500,0,234600
132745500100000,NW 332,RESIDENTIAL,46500,0,46500,226600,0,273100
132745500200000,NW 332,RESIDENTIAL,45000,0,45000,199900,0,244900
132745500300000,NW 332,RESIDENTIAL,36700,0,36700,179100,0,215800
132745500400000,NW 332,RESIDENTIAL,44400,0,44400,226100,0,270500
132745500500000,NW 332,RESIDENTIAL,44400,0,44400,230800,0,275200
132745500600000,NW 332,RESIDENTIAL,44400,0,44400,237300,0,281700
132745500700000,NW 332,RESIDENTIAL,36700,0,36700,168500,0,205200
132745500800000,NW 332,RESIDENTIAL,38900,0,38900,188200,0,227100
132745500900000,NW 332,RESIDENTIAL,44400,0,44400,208900,0,253300
132745501000000,NW 332,RESIDENTIAL,44500,0,44500,171500,0,216000
132745501100000,NW 332,RESIDENTIAL,44300,0,44300,283100,0,327400
132745501200000,NW 332,RESIDENTIAL,44200,0,44200,283400,0,327600
132745501300000,NW 332,RESIDENTIAL,42400,0,42400,190600,0,233000
132745501400000,NW 332,RESIDENTIAL,45900,0,45900,208900,0,254800
132745501500000,NW 332,RESIDENTIAL,46200,0,46200,229600,0,275800
132745501600000,NW 332,RESIDENTIAL,44000,0,44000,200900,0,244900
132745501700000,NW 332,RESIDENTIAL,44900,0,44900,224300,0,269200
132745501800000,NW 332,RESIDENTIAL,44600,0,44600,203500,0,248100
132745600100000,NW 332,RESIDENTIAL,46600,0,46600,168400,0,215000
132745600200000,NW 332,RESIDENTIAL,42900,0,42900,146300,0,189200
132745600300000,NW 332,RESIDENTIAL,47300,0,47300,176000,0,223300
132745600400000,NW 332,RESIDENTIAL,45400,0,45400,164500,0,209900
132745600500000,NW 332,RESIDENTIAL,46400,0,46400,190100,0,236500
132745600600000,NW 332,RESIDENTIAL,40900,0,40900,158000,0,198900
132745600700000,NW 332,RESIDENTIAL,46000,0,46000,178800,0,224800
132745600800000,NW 332,RESIDENTIAL,45300,0,45300,213400,0,258700
132745700100000,NW 332,RESIDENTIAL,46600,0,46600,276000,0,322600
132745700200000,NW 332,RESIDENTIAL,41400,0,41400,191800,0,233200
132745700300000,NW 332,RESIDENTIAL,45700,0,45700,205700,0,251400
132745700400000,NW 332,RESIDENTIAL,42700,0,42700,165800,0,208500
132745700500000,NW 332,RESIDENTIAL,46000,0,46000,274300,0,320300
132745700600000,NW 332,RESIDENTIAL,43600,0,43600,195200,0,238800
132745700700000,NW 332,RESIDENTIAL,43600,0,43600,261600,0,305200
132745700800000,NW 332,RESIDENTIAL,44600,0,44600,219500,0,264100
132745800100000,NW 332,RESIDENTIAL,4300,0,4300,0,0,4300
132747600100000,NW 332,RESIDENTIAL,45900,0,45900,0,0,45900
132747600200000,NW 332,RESIDENTIAL,43200,0,43200,0,0,43200
132747600300000,NW 332,RESIDENTIAL,43400,0,43400,0,0,43400
132747600400000,NW 332,RESIDENTIAL,42100,0,42100,227600,0,269700
132747600500000,NW 332,RESIDENTIAL,40700,0,40700,299500,0,340200
132747600600000,NW 332,RESIDENTIAL,40400,0,40400,245400,0,285800
132747600700000,NW 332,RESIDENTIAL,39400,0,39400,184000,0,223400
132747600800000,NW 332,RESIDENTIAL,38000,0,38000,188500,0,226500
132747600900000,NW 332,RESIDENTIAL,39500,0,39500,160100,0,199600
132747601000000,NW 332,RESIDENTIAL,41600,0,41600,187800,0,229400
132747700100000,NW 332,RESIDENTIAL,40000,0,40000,147600,0,187600
132747700200000,NW 332,RESIDENTIAL,38500,0,38500,183400,0,221900
132747700300000,NW 332,RESIDENTIAL,36600,0,36600,145500,0,182100
132747700400000,NW 332,RESIDENTIAL,41100,0,41100,153400,0,194500
132747800100000,NW 332,RESIDENTIAL,42800,0,42800,0,0,42800
132747800200000,NW 332,RESIDENTIAL,39800,0,39800,0,0,39800
132747800300000,NW 332,RESIDENTIAL,41800,0,41800,0,0,41800
132747800400000,NW 332,RESIDENTIAL,43800,0,43800,0,0,43800
132747800500000,NW 332,RESIDENTIAL,41300,0,41300,256800,0,298100
132747800600000,NW 332,RESIDENTIAL,41300,0,41300,241600,0,282900
132747800700000,NW 332,RESIDENTIAL,42400,0,42400,173500,0,215900
132747800800000,NW 332,RESIDENTIAL,38900,0,38900,160100,0,199000
132747800900000,NW 332,RESIDENTIAL,43300,0,43300,191700,0,235000
132747801000000,NW 332,RESIDENTIAL,42300,0,42300,156900,0,199200
132747801100000,NW 332,RESIDENTIAL,39600,0,39600,167200,0,206800
132747801200000,NW 332,RESIDENTIAL,40800,0,40800,155900,0,196700
132747801300000,WAREHOUSE,COMMERCIAL,0,559600,559600,0,523600,1083200
132747801400000,NW 332,RESIDENTIAL,38800,0,38800,162100,0,200900
132747801500000,NW 332,RESIDENTIAL,41600,0,41600,199500,0,241100
132747801700000,NW 332,RESIDENTIAL,45900,0,45900,175400,0,221300
132747801800000,NW 332,RESIDENTIAL,41600,0,41600,181400,0,223000
132747801900000,NW 332,RESIDENTIAL,40800,0,40800,186600,0,227400
132747802000000,NW 332,RESIDENTIAL,38800,0,38800,148600,0,187400
132747802100000,NW 332,RESIDENTIAL,40700,0,40700,179700,0,220400
132747802200000,NW 332,RESIDENTIAL,38800,0,38800,139100,0,177900
132747802300000,NW 332,RESIDENTIAL,35500,0,35500,179700,0,215200
132747802400000,NW 332,RESIDENTIAL,44200,0,44200,166800,0,211000
132747802500000,NW 332,RESIDENTIAL,45400,0,45400,189000,0,234400
132747802600000,NW 332,RESIDENTIAL,37600,0,37600,168900,0,206500
132747802700000,NW 332,RESIDENTIAL,39600,0,39600,191400,0,231000
132747802800000,NW 332,RESIDENTIAL,45200,0,45200,204400,0,249600
132747802900000,NW 332,RESIDENTIAL,42400,0,42400,176600,0,219000
132747803000000,NW 332,RESIDENTIAL,40600,0,40600,164500,0,205100
132747803100000,NW 332,RESIDENTIAL,40300,0,40300,198400,0,238700
132747803200000,NW 332,RESIDENTIAL,38600,0,38600,184200,0,222800
132747803300000,NW 332,RESIDENTIAL,39200,0,39200,172900,0,212100
132747803400000,NW 332,RESIDENTIAL,41500,0,41500,160000,0,201500
132747803500000,NW 332,RESIDENTIAL,41900,0,41900,154300,0,196200
132747803600000,NW 332,RESIDENTIAL,36700,0,36700,136300,0,173000
132747803700000,NW 332,RESIDENTIAL,38100,0,38100,180403,0,218503
132747803800000,NW 332,RESIDENTIAL,37200,0,37200,188000,0,225200
132747803900000,NW 332,RESIDENTIAL,37900,0,37900,163500,0,201400
132747804000000,NW 332,RESIDENTIAL,38800,0,38800,176400,0,215200
132747804100000,NW 332,RESIDENTIAL,40500,0,40500,193500,0,234000
132747804200000,SHOP,COMMERCIAL,0,483200,483200,0,739800,1223000
132747804300000,NW 332,RESIDENTIAL,42500,0,42500,108400,0,150900
132747900100000,NW 332,RESIDENTIAL,42600,0,42600,167100,0,209700
132747900200000,NW 332,RESIDENTIAL,40300,0,40300,172500,0,212800
132747900300000,NW 332,RESIDENTIAL,41700,0,41700,174300,0,216000
132747900400000,NW 332,RESIDENTIAL,40600,0,40600,158400,0,199000
132747900500000,NW 332,RESIDENTIAL,43800,0,43800,194000,0,237800
132747900600000,NW 332,RESIDENTIAL,39800,0,39800,176500,0,216300
132747900700000,NW 332,RESIDENTIAL,37600,0,37600,181400,0,219000
132747900800000,NW 332,RESIDENTIAL,37600,0,37600,146400,0,184000
132747900900000,NW 332,RESIDENTIAL,37200,0,37200,184000,0,221200
132747901000000,NW 332,RESIDENTIAL,39900,0,39900,141500,0,181400
132747901100000,NW 332,RESIDENTIAL,37900,0,37900,147500,0,185400
133410100200000,VACANT LAND,EXEMPT,0,395000,395000,0,14600,409600
133410100300000,NW 332,AG LAND,41800,0,41800,0,79600,121400
133430100100000,SW 432,AG LAND,111400,0,111400,0,0,111400
133440100100000,SW 432,AG LAND,96500,0,96500,0,0,96500
133440100200000,SW 454,RESIDENTIAL,99000,0,99000,156900,0,255900
133442600100000,SW 432,AG LAND,116500,0,116500,0,0,116500
133445100100000,SW 432,AG LAND,53300,0,53300,0,0,53300
133447600100000,SW 432,AG LAND,68600,0,68600,0,0,68600
133447600200000,STATE PROPERTY,OTHER,0,0,0,0,0,0
133510100200000,VACANT LAND,AG LAND,5500,0,5500,0,0,5500
133510100300000,WAREHOUSE;MINI STORG,COMMERCIAL,0,350400,350400,0,690200,1040600
133510100400000,WAREHOUSE,COMMERCIAL,0,351200,351200,0,424600,775800
133510100500000,PRINTING,INDUSTRIAL,0,340500,340500,0,1031700,1372200
133510100600000,AUTO REPAIR/SALES,COMMERCIAL,0,308000,308000,0,331500,639500
133510100700000,FITNESS CENTER,EXEMPT,0,108000,108000,0,353200,461200
133510101000000,RESTAURANT,COMMERCIAL,0,286400,286400,0,289200,575600
133510101100000,FLAT PARKING,COMMERCIAL,0,113600,113600,0,22900,136500
133510200100000,WAREHOUSE,COMMERCIAL,0,340500,340500,0,1083300,1423800
133510200200000,SHOP,COMMERCIAL,0,171000,171000,0,483300,654300
133510200300000,SHOP,COMMERCIAL,0,168000,168000,0,291400,459400
133510200400000,WAREHOUSE,COMMERCIAL,0,170000,170000,0,278600,448600
133510200500000,SHOP,COMMERCIAL,0,152200,152200,0,127500,279700
133510200600000,VACANT LAND,COMMERCIAL,0,155200,155200,0,0,155200
133510200700000,VACANT LAND,COMMERCIAL,0,92900,92900,0,0,92900
133510200800000,SHOP,COMMERCIAL,0,152100,152100,0,178900,331000
133510200900000,WAREHOUSE,COMMERCIAL,0,160400,160400,0,350700,511100
133512600100000,AUTO REPAIR/SALES,COMMERCIAL,0,294000,294000,0,247400,541400
133512600200000,CONVERSION-NW/SW,MULTI-RES,48000,0,48000,93400,0,141400
133512600300000,NW 329,RESIDENTIAL,48000,0,48000,121900,0,169900
133512600400000,WAREHOUSE,COMMERCIAL,37620,61380,99000,110712,41588,251300
133512600500000,EQUIPMENT MFG;INDUST,INDUSTRIAL,0,453000,453000,0,942600,1395600
133512600700000,SHOP,COMMERCIAL,0,378200,378200,0,235000,613200
133512600800000,NW 329,AG LAND,21500,0,21500,0,0,21500
133512600900000,FLAT PARKING,INDUSTRIAL,0,27000,27000,0,0,27000
133512601000000,FRATERNAL,EXEMPT,0,193000,193000,0,177400,370400
133512601100000,VACANT LAND,COMMERCIAL,0,146500,146500,0,0,146500
133512601200000,SHOP,COMMERCIAL,0,187200,187200,0,105000,292200
133512601300000,SHOP,COMMERCIAL,0,78600,78600,0,139600,218200
133515100100000,NW 329,AG LAND,104000,0,104000,0,0,104000
133515100300000,WAREHOUSE,COMMERCIAL,0,309600,309600,0,161100,470700
133515100400000,NW 329,RESIDENTIAL,60300,0,60300,0,0,60300
133517600100000,CITY PROPERTY,EXEMPT,0,0,0,0,0,0
133517600200000,NW 329,AG LAND,25800,0,25800,0,0,25800
133517600300000,AUTO REPAIR/SALES,COMMERCIAL,21420,131580,153000,77982,85218,316200
133517600400000,NW 329,RESIDENTIAL,54000,0,54000,80200,0,134200
133517600500000,WAREHOUSE;MINI STORG,COMMERCIAL,0,401400,401400,0,243600,645000
133517600600000,CENTRALLY ASSESSED,OTHER,0,0,0,0,0,0
133520100100000,SHOP,COMMERCIAL,19395,196105,215500,27171,246129,488800
133520100200000,SMALL RETAIL,COMMERCIAL,0,152700,152700,0,161500,314200
133520100300000,VACANT LAND,COMMERCIAL,0,0,0,0,0,0
133520200100000,OFFICE,COMMERCIAL,0,84900,84900,0,205900,290800
133520200200000,WAREHOUSE,COMMERCIAL,0,84000,84000,0,34700,118700
133520200300000,OFFICE,COMMERCIAL,0,229500,229500,0,236800,466300
133520200400000,SHOP,COMMERCIAL,0,56900,56900,0,144800,201700
133520200500000,WAREHOUSE,COMMERCIAL,0,196900,196900,0,97100,294000
133520200600000,AUTO SALES,COMMERCIAL,0,120000,120000,0,20500,140500
133520200700000,SHOP,COMMERCIAL,0,138000,138000,0,240700,378700
133520200800000,CHURCH,EXEMPT,0,100000,100000,0,181900,281900
133522600100000,FLAT PARKING,COMMERCIAL,0,323200,323200,0,164200,487400
133522600200000,NW 332,RESIDENTIAL,54700,0,54700,121800,0,176500
133522600300000,NW 332,RESIDENTIAL,33600,0,33600,0,0,33600
133522600400000,CHURCH,EXEMPT,0,938500,938500,0,5032200,5970700
133525100500000,NW 329,RESIDENTIAL,53600,0,53600,137400,0,191000
133525200100000,SW 408,RESIDENTIAL,38100,0,38100,170900,0,209000
133525200200000,SW 408,RESIDENTIAL,400,0,400,0,0,400
133525200300000,SW 408,RESIDENTIAL,38100,0,38100,125500,0,163600
133525200400000,SW 408,RESIDENTIAL,38700,0,38700,172900,0,211600
133525200500000,SW 408,RESIDENTIAL,43000,0,43000,137200,0,180200
133525200600000,SW 408,RESIDENTIAL,800,0,800,0,0,800
133525200700000,SW 408,RESIDENTIAL,40200,0,40200,158300,0,198500
133525200800000,SW 408,RESIDENTIAL,800,0,800,0,0,800
133525200900000,SW 408,RESIDENTIAL,42400,0,42400,8000,0,50400
133525201000000,SW 408,RESIDENTIAL,46000,0,46000,4500,0,50500
133525201100000,SW 408,RESIDENTIAL,900,0,900,0,0,900
133525201200000,CITY PROPERTY,EXEMPT,0,0,0,0,0,0
133525201300000,SW 408,RESIDENTIAL,34800,0,34800,142300,0,177100
133525201400000,SW 408,RESIDENTIAL,36100,0,36100,138800,0,174900
133525201500000,SW 408,RESIDENTIAL,43100,0,43100,145400,0,188500
133525201600000,SW 408,RESIDENTIAL,46000,0,46000,134700,0,180700
133525201700000,SW 408,RESIDENTIAL,36900,0,36900,134100,0,171000
133525201800000,SW 408,RESIDENTIAL,42100,0,42100,134700,0,176800
133525201900000,SW 408,RESIDENTIAL,35400,0,35400,138800,0,174200
133525202000000,SW 408,RESIDENTIAL,31800,0,31800,136200,0,168000
133525202100000,SW 408,RESIDENTIAL,33300,0,33300,138800,0,172100
133525202200000,SW 408,RESIDENTIAL,32700,0,32700,138800,0,171500
133525202300000,SW 408,RESIDENTIAL,32700,0,32700,136200,0,168900
133525202400000,SW 408,RESIDENTIAL,33700,0,33700,138800,0,172500
133525202500000,CITY PROPERTY,EXEMPT,0,0,0,0,0,0
133525202600000,SW 408,RESIDENTIAL,35300,0,35300,138800,0,174100
133525202700000,SW 408,RESIDENTIAL,36100,0,36100,157100,0,193200
133525202800000,SW 408,RESIDENTIAL,35800,0,35800,157800,0,193600
133525202900000,SW 408,RESIDENTIAL,700,0,700,0,0,700
133525300100000,SW 408,RESIDENTIAL,800,0,800,0,0,800
133525300200000,SW 408,RESIDENTIAL,51500,0,51500,205800,0,257300
133525300300000,SW 408,RESIDENTIAL,44900,0,44900,211300,0,256200
133525300400000,SW 408,RESIDENTIAL,46100,0,46100,195500,0,241600
133525400100000,SW 408,RESIDENTIAL,36800,0,36800,10500,0,47300
133525400200000,SW 408,RESIDENTIAL,36800,0,36800,10500,0,47300
133525400300000,SW 408,RESIDENTIAL,38500,0,38500,169000,0,207500
133525400400000,SW 408,RESIDENTIAL,38500,0,38500,183300,0,221800
133525400500000,SW 408,RESIDENTIAL,35800,0,35800,174100,0,209900
133525400600000,SW 408,RESIDENTIAL,38500,0,38500,176900,0,215400
133525400700000,SW 408,RESIDENTIAL,35800,0,35800,166900,0,202700
133525400800000,SW 408,RESIDENTIAL,38500,0,38500,227700,0,266200
133525400900000,CITY PROPERTY,EXEMPT,0,0,0,0,0,0
133525500100000,SW 408,RESIDENTIAL,38500,0,38500,10500,0,49000
133525500200000,SW 408,RESIDENTIAL,38500,0,38500,41700,0,80200
133525500300000,SW 408,RESIDENTIAL,39700,0,39700,177500,0,217200
133525500400000,SW 408,RESIDENTIAL,42900,0,42900,181100,0,224000
133525500500000,SW 408,RESIDENTIAL,41700,0,41700,177500,0,219200
133525500600000,SW 408,RESIDENTIAL,36100,0,36100,160200,0,196300
133525500700000,SW 408,RESIDENTIAL,38900,0,38900,167700,0,206600
133525500800000,SW 408,RESIDENTIAL,36100,0,36100,189800,0,225900
133525500900000,SW 408,RESIDENTIAL,38900,0,38900,187300,0,226200
133525501000000,SW 408,RESIDENTIAL,41700,0,41700,200600,0,242300
133525501100000,SW 408,RESIDENTIAL,40600,0,40600,178800,0,219400
133525501200000,SW 408,RESIDENTIAL,400,0,400,0,0,400
133527600100000,NW 329,AG LAND,48900,0,48900,0,0,48900
133527600200000,MFG HOME PARK,MULTI-RES,1756000,0,1756000,1438300,0,3194300
133530100100000,MFG HOME PARK,MULTI-RES,3613000,0,3613000,1962700,0,5575700
133530100103000,MFG HOME PARK,MULTI-RES,0,0,0,4200,0,4200
133530100103001,MFG HOME PARK,MULTI-RES,0,0,0,3500,0,3500
133530100103002,MFG HOME PARK,MULTI-RES,0,0,0,3700,0,3700
133530100103003,MFG HOME PARK,MULTI-RES,0,0,0,5500,0,5500
133530100103004,MFG HOME PARK,MULTI-RES,0,0,0,5200,0,5200
133530100103005,MFG HOME PARK,MULTI-RES,0,0,0,4800,0,4800
133530100103006,MFG HOME PARK,MULTI-RES,0,0,0,4800,0,4800
133530100103007,MFG HOME PARK,MULTI-RES,0,0,0,3600,0,3600
133530100103008,MFG HOME PARK,MULTI-RES,0,0,0,4800,0,4800
133530100103009,MFG HOME PARK,MULTI-RES,0,0,0,4300,0,4300
133530100103010,MFG HOME PARK,MULTI-RES,0,0,0,4900,0,4900
133530100103011,MFG HOME PARK,MULTI-RES,0,0,0,4900,0,4900
133530100103012,MFG HOME PARK,MULTI-RES,0,0,0,4900,0,4900
133530100103013,MFG HOME PARK,MULTI-RES,0,0,0,5400,0,5400
133530100103014,MFG HOME PARK,MULTI-RES,0,0,0,4900,0,4900
133530100103015,MFG HOME PARK,MULTI-RES,0,0,0,5900,0,5900
133530100103016,MFG HOME PARK,MULTI-RES,0,0,0,4400,0,4400
133530100103017,MFG HOME PARK,MULTI-RES,0,0,0,5600,0,5600
133530100103018,MFG HOME PARK,MULTI-RES,0,0,0,3900,0,3900
133530100103019,MFG HOME PARK,MULTI-RES,0,0,0,5500,0,5500
133530100103020,MFG HOME PARK,MULTI-RES,0,0,0,5600,0,5600
133530100103021,MFG HOME PARK,MULTI-RES,0,0,0,4600,0,4600
133530100103022,MFG HOME PARK,MULTI-RES,0,0,0,3900,0,3900
133530100103023,MFG HOME PARK,MULTI-RES,0,0,0,3500,0,3500
133530100103024,MFG HOME PARK,MULTI-RES,0,0,0,4600,0,4600
133530100103025,MFG HOME PARK,MULTI-RES,0,0,0,4900,0,4900
133530100103026,MFG HOME PARK,MULTI-RES,0,0,0,3900,0,3900
133530100103027,MFG HOME PARK,MULTI-RES,0,0,0,3900,0,3900
133530100103028,MFG HOME PARK,MULTI-RES,0,0,0,3700,0,3700
133530100103029,MFG HOME PARK,MULTI-RES,0,0,0,5800,0,5800
133530100103030,MFG HOME PARK,MULTI-RES,0,0,0,4400,0,4400
133530100103031,MFG HOME PARK,MULTI-RES,0,0,0,4000,0,4000
133530100103032,MFG HOME PARK,MULTI-RES,0,0,0,5700,0,5700
133530100103033,MFG HOME PARK,MULTI-RES,0,0,0,4000,0,4000
133530100103034,MFG HOME PARK,MULTI-RES,0,0,0,5300,0,5300
133530100103035,MFG HOME PARK,MULTI-RES,0,0,0,3800,0,3800
133530100103036,MFG HOME PARK,MULTI-RES,0,0,0,5500,0,5500
133530100103037,MFG HOME PARK,MULTI-RES,0,0,0,4400,0,4400
133530100103038,MFG HOME PARK,MULTI-RES,0,0,0,4100,0,4100
133530100103039,MFG HOME PARK,MULTI-RES,0,0,0,5600,0,5600
133530100103040,MFG HOME PARK,MULTI-RES,0,0,0,5600,0,5600
133530100103041,MFG HOME PARK,MULTI-RES,0,0,0,5100,0,5100
133530100103042,MFG HOME PARK,MULTI-RES,0,0,0,4200,0,4200
133530100103043,MFG HOME PARK,MULTI-RES,0,0,0,3900,0,3900
133530100103044,MFG HOME PARK,MULTI-RES,0,0,0,4600,0,4600
133530100103045,MFG HOME PARK,MULTI-RES,0,0,0,5600,0,5600
133530100103046,MFG HOME PARK,MULTI-RES,0,0,0,6600,0,6600
133530100103047,MFG HOME PARK,MULTI-RES,0,0,0,4200,0,4200
133530100103048,MFG HOME PARK,MULTI-RES,0,0,0,5700,0,5700
133530100103049,MFG HOME PARK,MULTI-RES,0,0,0,5200,0,5200
133530100103050,MFG HOME PARK,MULTI-RES,0,0,0,7200,0,7200
133530100103051,MFG HOME PARK,MULTI-RES,0,0,0,4700,0,4700
133530100103052,MFG HOME PARK,MULTI-RES,0,0,0,5200,0,5200
133530100103053,MFG HOME PARK,MULTI-RES,0,0,0,6400,0,6400
133530100103054,MFG HOME PARK,MULTI-RES,0,0,0,5400,0,5400
133530100103056,MFG HOME PARK,MULTI-RES,0,0,0,4500,0,4500
133530100103057,MFG HOME PARK,MULTI-RES,0,0,0,6400,0,6400
133530100103058,MFG HOME PARK,MULTI-RES,0,0,0,6500,0,6500
133530100103059,MFG HOME PARK,MULTI-RES,0,0,0,6600,0,6600
133530100103061,MFG HOME PARK,MULTI-RES,0,0,0,6500,0,6500
133530100103062,MFG HOME PARK,MULTI-RES,0,0,0,6100,0,6100
133530100103063,MFG HOME PARK,MULTI-RES,0,0,0,4500,0,4500
133530100103064,MFG HOME PARK,MULTI-RES,0,0,0,6900,0,6900
133530100103065,MFG HOME PARK,MULTI-RES,0,0,0,5400,0,5400
133530100103066,MFG HOME PARK,MULTI-RES,0,0,0,5800,0,5800
133530100103067,MFG HOME PARK,MULTI-RES,0,0,0,4700,0,4700
133530100103068,MFG HOME PARK,MULTI-RES,0,0,0,5600,0,5600
133530100103069,MFG HOME PARK,MULTI-RES,0,0,0,7600,0,7600
133530100103070,MFG HOME PARK,MULTI-RES,0,0,0,6800,0,6800
133530100103072,MFG HOME PARK,MULTI-RES,0,0,0,5600,0,5600
133530100103073,MFG HOME PARK,MULTI-RES,0,0,0,4900,0,4900
133530100103074,MFG HOME PARK,MULTI-RES,0,0,0,8200,0,8200
133530100103075,MFG HOME PARK,MULTI-RES,0,0,0,6200,0,6200
133530100103076,MFG HOME PARK,MULTI-RES,0,0,0,4700,0,4700
133530100103077,MFG HOME PARK,MULTI-RES,0,0,0,6200,0,6200
133530100103078,MFG HOME PARK,MULTI-RES,0,0,0,9600,0,9600
133530100103079,MFG HOME PARK,MULTI-RES,0,0,0,3900,0,3900
133530100103080,MFG HOME PARK,MULTI-RES,0,0,0,8100,0,8100
133530100103082,MFG HOME PARK,MULTI-RES,0,0,0,5800,0,5800
133530100103083,MFG HOME PARK,MULTI-RES,0,0,0,3700,0,3700
133530100103084,MFG HOME PARK,MULTI-RES,0,0,0,7200,0,7200
133530100103085,MFG HOME PARK,MULTI-RES,0,0,0,5800,0,5800
133530100103086,MFG HOME PARK,MULTI-RES,0,0,0,6600,0,6600
133530100103087,MFG HOME PARK,MULTI-RES,0,0,0,7300,0,7300
133530100103088,MFG HOME PARK,MULTI-RES,0,0,0,7200,0,7200
133530100103089,MFG HOME PARK,MULTI-RES,0,0,0,4300,0,4300
133530100103091,MFG HOME PARK,MULTI-RES,0,0,0,4400,0,4400
133530100103092,MFG HOME PARK,MULTI-RES,0,0,0,7700,0,7700
133530100103093,MFG HOME PARK,MULTI-RES,0,0,0,6800,0,6800
133530100103094,MFG HOME PARK,MULTI-RES,0,0,0,6000,0,6000
133530100103095,MFG HOME PARK,MULTI-RES,0,0,0,4000,0,4000
133530100103096,MFG HOME PARK,MULTI-RES,0,0,0,8100,0,8100
133530100103097,MFG HOME PARK,MULTI-RES,0,0,0,8100,0,8100
133530100103098,HOSPITAL,MULTI-RES,0,0,0,7600,0,7600
133530100103099,MFG HOME PARK,MULTI-RES,0,0,0,7600,0,7600
133530100103100,MFG HOME PARK,MULTI-RES,0,0,0,7600,0,7600
133530100103101,MFG HOME PARK,MULTI-RES,0,0,0,7100,0,7100
133530100103102,MFG HOME PARK,MULTI-RES,0,0,0,6000,0,6000
133530100103103,MFG HOME PARK,MULTI-RES,0,0,0,8300,0,8300
133530100103104,MFG HOME PARK,MULTI-RES,0,0,0,7900,0,7900
133530100103105,MFG HOME PARK,MULTI-RES,0,0,0,5000,0,5000
133530100103106,MFG HOME PARK,MULTI-RES,0,0,0,7900,0,7900
133530100103107,MFG HOME PARK,MULTI-RES,0,0,0,8000,0,8000
133530100103108,MFG HOME PARK,MULTI-RES,0,0,0,8100,0,8100
133530100103109,MFG HOME PARK,MULTI-RES,0,0,0,8000,0,8000
133530100103110,MFG HOME PARK,MULTI-RES,0,0,0,6100,0,6100
133532600100000,MFG HOME PARK,MULTI-RES,871300,0,871300,357300,0,1228600
133532600103000,MFG HOME PARK,MULTI-RES,0,0,0,6600,0,6600
133532600103001,MFG HOME PARK,MULTI-RES,0,0,0,4600,0,4600
133532600103002,MFG HOME PARK,MULTI-RES,0,0,0,6500,0,6500
133532600103003,MFG HOME PARK,MULTI-RES,0,0,0,6300,0,6300
133532600103004,MFG HOME PARK,MULTI-RES,0,0,0,5600,0,5600
133532600103005,MFG HOME PARK,MULTI-RES,0,0,0,7100,0,7100
133532600103006,MFG HOME PARK,MULTI-RES,0,0,0,6400,0,6400
133532600103007,MFG HOME PARK,MULTI-RES,0,0,0,4900,0,4900
133532600103008,MFG HOME PARK,MULTI-RES,0,0,0,7900,0,7900
133532600103009,MFG HOME PARK,MULTI-RES,0,0,0,7900,0,7900
133532600103010,MFG HOME PARK,MULTI-RES,0,0,0,10100,0,10100
133532600103011,MFG HOME PARK,MULTI-RES,0,0,0,5900,0,5900
133532600103012,MFG HOME PARK,MULTI-RES,0,0,0,7000,0,7000
133532600103013,MFG HOME PARK,MULTI-RES,0,0,0,8700,0,8700
133532600103014,MFG HOME PARK,MULTI-RES,0,0,0,8300,0,8300
133532600103015,MFG HOME PARK,MULTI-RES,0,0,0,9300,0,9300
133532600103016,MFG HOME PARK,MULTI-RES,0,0,0,5600,0,5600
133532600103017,MFG HOME PARK,MULTI-RES,0,0,0,10800,0,10800
133532600103018,MFG HOME PARK,MULTI-RES,0,0,0,8000,0,8000
133532600103019,MFG HOME PARK,MULTI-RES,0,0,0,10100,0,10100
133532600103022,MFG HOME PARK,MULTI-RES,0,0,0,5200,0,5200
133532600103068,MFG HOME PARK,MULTI-RES,0,0,0,6100,0,6100
133532600300000,SW 454,RESIDENTIAL,122600,0,122600,0,0,122600
133535100200000,SW 454,RESIDENTIAL,29800,0,29800,152200,0,182000
133535100300000,SW 454,RESIDENTIAL,29800,0,29800,151500,0,181300
133535100400000,SW 454,RESIDENTIAL,29800,0,29800,177400,0,207200
133535100500000,SW 454,RESIDENTIAL,29800,0,29800,145200,0,175000
133535100600000,SW 454,RESIDENTIAL,29800,0,29800,126500,0,156300
133535100700000,SW 454,RESIDENTIAL,29800,0,29800,127300,0,157100
133535100800000,SW 454,RESIDENTIAL,29800,0,29800,128200,0,158000
133535100900000,SW 454,RESIDENTIAL,30300,0,30300,124000,0,154300
133535101000000,SW 454,RESIDENTIAL,36800,0,36800,148700,0,185500
133535101100000,SW 454,RESIDENTIAL,38600,0,38600,146500,0,185100
133535200100000,SW 454,RESIDENTIAL,32500,0,32500,243300,0,275800
133535200200000,SW 454,RESIDENTIAL,32500,0,32500,119600,0,152100
133535200300000,SW 454,RESIDENTIAL,34300,0,34300,190600,0,224900
133535200400000,NW 329,RESIDENTIAL,92800,0,92800,0,0,92800
133535200500000,SW 454,RESIDENTIAL,31300,0,31300,148700,0,180000
133535200600000,SW 454,RESIDENTIAL,35600,0,35600,193700,0,229300
133535200700000,SW 454,RESIDENTIAL,28300,0,28300,177800,0,206100
133535200800000,SW 454,RESIDENTIAL,29800,0,29800,153600,0,183400
133535200900000,SW 454,RESIDENTIAL,29800,0,29800,168400,0,198200
133535201000000,SW 454,RESIDENTIAL,29800,0,29800,189000,0,218800
133535201100000,SW 454,RESIDENTIAL,29800,0,29800,204100,0,233900
133535300100000,SW 454,RESIDENTIAL,29800,0,29800,132800,0,162600
133535300200000,SW 454,RESIDENTIAL,29800,0,29800,144100,0,173900
133535300300000,SW 454,RESIDENTIAL,31800,0,31800,126400,0,158200
133535400100000,SW 454,RESIDENTIAL,29800,0,29800,170300,0,200100
133535400200000,SW 454,RESIDENTIAL,29800,0,29800,158400,0,188200
133535400300000,SW 454,RESIDENTIAL,29800,0,29800,164100,0,193900
133535400400000,SW 454,RESIDENTIAL,29800,0,29800,143300,0,173100
133535400500000,SW 454,RESIDENTIAL,29800,0,29800,147800,0,177600
133535400600000,SW 454,RESIDENTIAL,31200,0,31200,154400,0,185600
133535400700000,SW 454,RESIDENTIAL,32800,0,32800,148100,0,180900
133535400800000,SW 454,RESIDENTIAL,33100,0,33100,148400,0,181500
133535400900000,SW 454,RESIDENTIAL,35700,0,35700,178800,0,214500
133535401000000,SW 454,RESIDENTIAL,29800,0,29800,168500,0,198300
133535401100000,SW 454,RESIDENTIAL,29800,0,29800,166200,0,196000
133535401200000,SW 454,RESIDENTIAL,29800,0,29800,148900,0,178700
133535401300000,SW 454,RESIDENTIAL,29800,0,29800,145700,0,175500
133535500100000,SW 454,RESIDENTIAL,29800,0,29800,180200,0,210000
133535500200000,SW 454,RESIDENTIAL,29800,0,29800,163300,0,193100
133535500300000,SW 454,RESIDENTIAL,29800,0,29800,150100,0,179900
133535500400000,SW 454,RESIDENTIAL,26800,0,26800,0,0,26800
133535500500000,SW 454,RESIDENTIAL,26800,0,26800,0,0,26800
133535500600000,SW 454,RESIDENTIAL,31600,0,31600,67100,0,98700
133535500700000,SW 454,RESIDENTIAL,30000,0,30000,147200,0,177200
133535500800000,SW 454,RESIDENTIAL,35700,0,35700,133000,0,168700
133535500900000,SW 454,RESIDENTIAL,40100,0,40100,183800,0,223900
133535501000000,SW 454,RESIDENTIAL,39100,0,39100,199100,0,238200
133535501100000,SW 454,RESIDENTIAL,37600,0,37600,140600,0,178200
133537600100000,NW 329,AG LAND,128200,0,128200,0,0,128200
133540100100000,NW 329,AG LAND,112700,0,112700,0,3300,116000
133540100102000,NW 329,RESIDENTIAL,0,0,0,12900,0,12900
133545100100000,NW 329,AG LAND,110500,0,110500,0,2400,112900
133545100200000,NW 329,RESIDENTIAL,74400,0,74400,151600,0,226000
133547600100000,NW 329,AG LAND,114400,0,114400,0,0,114400
133610100300000,FLAT PARKING,EXEMPT,0,181800,181800,0,17400,199200
133610100302000,BILLBOARD(BLL),COMMERCIAL,0,0,0,0,14100,14100
133610100400000,OFFICE,EXEMPT,0,441000,441000,0,1199000,1640000
133610100500000,MFG HOME PARK,MULTI-RES,281500,0,281500,399100,0,680600
133610100600000,VACANT LAND,COMMERCIAL,0,9500,9500,0,0,9500
133610100700000,MFG HOME PARK,MULTI-RES,9500,0,9500,0,0,9500
133610100800000,OFFICE,EXEMPT,0,62000,62000,0,261900,323900
133610100900000,WAREHOUSE,COMMERCIAL,0,77300,77300,0,170200,247500
133610101000000,SMALL RETAIL,COMMERCIAL,0,268800,268800,0,220500,489300
133610101100000,RESTAURANT,COMMERCIAL,0,279200,279200,0,186800,466000
133610101200000,LG DISCOUNT/RETAIL,COMMERCIAL,0,825000,825000,0,1088400,1913400
133610101300000,FLAT PARKING,COMMERCIAL,0,505000,505000,0,19100,524100
133610200100000,FITNESS CENTER,COMMERCIAL,0,222000,222000,0,19100,241100
133610200300000,NW 329,AG LAND,25200,0,25200,0,0,25200
133610200400000,GROCERY STORE,COMMERCIAL,0,936000,936000,0,905000,1841000
133610200500000,WAREHOUSE,COMMERCIAL,0,201000,201000,0,56400,257400
133610200600000,AUTO REPAIR/SALES,COMMERCIAL,0,64100,64100,0,51200,115300
133610200700000,FITNESS CENTER,COMMERCIAL,0,336000,336000,0,577300,913300
133610200800000,VACANT LAND,COMMERCIAL,0,19200,19200,0,0,19200
133612600100000,AUTO REPAIR/SALES,COMMERCIAL,0,278000,278000,0,223400,501400
133612600200000,PRINTING,INDUSTRIAL,0,232000,232000,0,489600,721600
133612600300000,HOTEL,COMMERCIAL,0,274000,274000,0,471800,745800
133612600400000,MFG HOME PARK,MULTI-RES,366000,0,366000,291200,0,657200
133612600500000,WAREHOUSE,COMMERCIAL,0,265000,265000,0,322300,587300
133612600502000,BILLBOARD(BLL),COMMERCIAL,0,0,0,0,44700,44700
133612600600000,NW 329,RESIDENTIAL,50800,0,50800,44900,0,95700
133612700100000,NW 329,AG LAND,52800,0,52800,0,0,52800
133615100200000,OFFICE,COMMERCIAL,0,129100,129100,0,357700,486800
133615100400000,APARTMENT,MULTI-RES,19700,0,19700,114200,0,133900
133615100500000,APARTMENT,MULTI-RES,19600,0,19600,128200,0,147800
133615100600000,APARTMENT,MULTI-RES,19600,0,19600,128900,0,148500
133615100700000,APARTMENT,MULTI-RES,19600,0,19600,88900,0,108500
133615100800000,APARTMENT,MULTI-RES,19600,0,19600,88900,0,108500
133615100900000,APARTMENT,MULTI-RES,19500,0,19500,95700,0,115200
133615101000000,APARTMENT,MULTI-RES,19500,0,19500,94300,0,113800
133615101800000,APARTMENT,RESIDENTIAL,19000,0,19000,103900,0,122900
133615102100000,APARTMENT,MULTI-RES,19000,0,19000,109600,0,128600
133615102200000,APARTMENT,MULTI-RES,19000,0,19000,116500,0,135500
133615102300000,APARTMENT,MULTI-RES,19000,0,19000,116300,0,135300
133615102400000,APARTMENT,MULTI-RES,19000,0,19000,108400,0,127400
133615102700000,OFFICE; MEDICAL,COMMERCIAL,0,286500,286500,0,224200,510700
133615102800000,FITNESS CENTER,COMMERCIAL,0,180000,180000,0,415000,595000
133615200200000,CHURCH,EXEMPT,0,144300,144300,0,345900,490200
133615200300000,CHURCH,EXEMPT,0,144300,144300,0,454400,598700
133615200401000,OFFICE,COMMERCIAL,0,22900,22900,0,50800,73700
133615200401001,OFFICE,COMMERCIAL,0,22900,22900,0,40600,63500
133615200401002,OFFICE,COMMERCIAL,0,22900,22900,0,40600,63500
133615200401003,OFFICE,COMMERCIAL,0,22900,22900,0,40600,63500
133615200401004,OFFICE,COMMERCIAL,0,21800,21800,0,61300,83100
133615200401005,OFFICE,COMMERCIAL,0,21800,21800,0,61300,83100
133615200401006,OFFICE,COMMERCIAL,0,21800,21800,0,61300,83100
133615200401007,OFFICE,COMMERCIAL,0,21800,21800,0,51700,73500
133615200500000,SMALL RETAIL,COMMERCIAL,0,170800,170800,0,354200,525000
133615200600000,CHURCH,EXEMPT,0,288600,288600,0,619000,907600
133615200800000,OFFICE; MEDICAL,COMMERCIAL,0,83200,83200,0,240700,323900
133617600200000,GROCERY STORE,COMMERCIAL,0,2186000,2186000,0,8996800,11182800
133617600400000,RESTAURANT,COMMERCIAL,0,254100,254100,0,462700,716800
133617600700000,FAST FOOD,COMMERCIAL,0,368800,368800,0,651600,1020400
133617600800000,VACANT LAND,COMMERCIAL,0,1600,1600,0,0,1600
133617600900000,AUTO REPAIR/SALES,COMMERCIAL,0,325200,325200,0,356400,681600
133617601100000,BRANCH BANK/CU,COMMERCIAL,0,648900,648900,0,986600,1635500
133617700200000,SMALL RETAIL,EXEMPT,0,306800,306800,0,577400,884200
133617700300000,BOWLING ALLEY,COMMERCIAL,0,386600,386600,0,703500,1090100
133617700400000,WAREHOUSE;MINI STORG,COMMERCIAL,0,298500,298500,0,582600,881100
133617700500000,OFFICE,COMMERCIAL,0,136200,136200,0,190000,326200
133620100100000,SHOP,COMMERCIAL,0,422400,422400,0,1445400,1867800
133620100200000,FLAT PARKING,COMMERCIAL,0,205800,205800,0,64800,270600
133620200100000,CARWASH,COMMERCIAL,0,266000,266000,0,251000,517000
133620200200000,WAREHOUSE;MINI STORG,COMMERCIAL,0,96400,96400,0,272800,369200
133620200300000,WAREHOUSE,COMMERCIAL,0,705700,705700,0,5600200,6305900
133620200400000,FEDERAL PROPERTY,EXEMPT,0,0,0,0,0,0
133622600100000,SHOP,COMMERCIAL,0,892800,892800,0,1034500,1927300
133622600200000,WAREHOUSE;MINI STORG,COMMERCIAL,0,192000,192000,0,333900,525900
133622700400000,WAREHOUSE,COMMERCIAL,0,951500,951500,0,4330900,5282400
133625100200000,FLAT PARKING,COMMERCIAL,0,816800,816800,0,141900,958700
133625100300000,VACANT LAND,COMMERCIAL,0,768300,768300,0,0,768300
133627600200000,WAREHOUSE,COMMERCIAL,0,483000,483000,0,4188100,4671100
133627600301000,WAREHOUSE,COMMERCIAL,0,23600,23600,0,119300,142900
133627600301001,WAREHOUSE,COMMERCIAL,0,23600,23600,0,119300,142900
133627600301002,WAREHOUSE,COMMERCIAL,0,23600,23600,0,121800,145400
133627600301003,WAREHOUSE,COMMERCIAL,0,23600,23600,0,123900,147500
133627600301004,WAREHOUSE,COMMERCIAL,0,23600,23600,0,123900,147500
133627600301005,WAREHOUSE,COMMERCIAL,0,23600,23600,0,123900,147500
133627600301006,WAREHOUSE,COMMERCIAL,0,23600,23600,0,123900,147500
133627600301007,WAREHOUSE,COMMERCIAL,0,23600,23600,0,123900,147500
133627600301008,WAREHOUSE,COMMERCIAL,0,23600,23600,0,118500,142100
133627600301009,WAREHOUSE,COMMERCIAL,0,23600,23600,0,123900,147500
133627600301010,WAREHOUSE,COMMERCIAL,0,23600,23600,0,123900,147500
133627600301011,WAREHOUSE,COMMERCIAL,0,23600,23600,0,123900,147500
133627600400000,MATERIALS MFG;INDUST,INDUSTRIAL,0,528000,528000,0,1961300,2489300
133627600500000,OFFICE; MEDICAL,COMMERCIAL,0,296000,296000,0,928300,1224300
133627600600000,VACANT LAND,COMMERCIAL,0,332600,332600,0,0,332600
133627600700000,VACANT LAND,COMMERCIAL,0,636000,636000,0,0,636000
133627600800000,NBHD SHOPPING CENTER,COMMERCIAL,0,533000,533000,0,550500,1083500
133627600900000,OFFICE,COMMERCIAL,0,444000,444000,0,2817100,3261100
133630100100000,CONVENIENCE STORE,COMMERCIAL,0,188600,188600,0,291500,480100
133630100200000,NW 329,AG LAND,56300,0,56300,0,0,56300
133632600100000,MFG HOME PARK,MULTI-RES,4524500,0,4524500,2866100,0,7390600
133632600103000,MFG HOME PARK,MULTI-RES,0,0,0,5100,0,5100
133632600103001,MFG HOME PARK,MULTI-RES,0,0,0,4300,0,4300
133632600103002,MFG HOME PARK,MULTI-RES,0,0,0,4000,0,4000
133632600103003,MFG HOME PARK,MULTI-RES,0,0,0,5500,0,5500
133632600103005,MFG HOME PARK,MULTI-RES,0,0,0,5100,0,5100
133632600103006,MFG HOME PARK,MULTI-RES,0,0,0,6400,0,6400
133632600103007,MFG HOME PARK,MULTI-RES,0,0,0,5100,0,5100
133632600103008,MFG HOME PARK,MULTI-RES,0,0,0,6600,0,6600
133632600103009,MFG HOME PARK,MULTI-RES,0,0,0,5100,0,5100
133632600103010,MFG HOME PARK,MULTI-RES,0,0,0,5100,0,5100
133632600103011,MFG HOME PARK,MULTI-RES,0,0,0,4100,0,4100
133632600103012,MFG HOME PARK,MULTI-RES,0,0,0,6600,0,6600
133632600103013,MFG HOME PARK,MULTI-RES,0,0,0,5100,0,5100
133632600103014,MFG HOME PARK,MULTI-RES,0,0,0,3800,0,3800
133632600103015,MFG HOME PARK,MULTI-RES,0,0,0,4200,0,4200
133632600103016,MFG HOME PARK,MULTI-RES,0,0,0,5200,0,5200
133632600103017,MFG HOME PARK,MULTI-RES,0,0,0,3300,0,3300
133632600103018,MFG HOME PARK,MULTI-RES,0,0,0,8600,0,8600
133632600103019,MFG HOME PARK,MULTI-RES,0,0,0,7100,0,7100
133632600103020,MFG HOME PARK,MULTI-RES,0,0,0,6600,0,6600
133632600103021,MFG HOME PARK,MULTI-RES,0,0,0,8300,0,8300
133632600103022,MFG HOME PARK,MULTI-RES,0,0,0,7100,0,7100
133632600103023,MFG HOME PARK,MULTI-RES,0,0,0,6500,0,6500
133632600103024,MFG HOME PARK,MULTI-RES,0,0,0,10300,0,10300
133632600103025,MFG HOME PARK,MULTI-RES,0,0,0,6000,0,6000
133632600103026,MFG HOME PARK,MULTI-RES,0,0,0,4000,0,4000
133632600103027,MFG HOME PARK,MULTI-RES,0,0,0,12900,0,12900
133632600103028,MFG HOME PARK,MULTI-RES,0,0,0,8800,0,8800
133632600103029,MFG HOME PARK,MULTI-RES,0,0,0,8000,0,8000
133632600103030,MFG HOME PARK,MULTI-RES,0,0,0,5900,0,5900
133637600100000,LG DISCOUNT/RETAIL,COMMERCIAL,0,760500,760500,0,554500,1315000
133637600200000,VACANT LAND,COMMERCIAL,0,25500,25500,0,0,25500
133637700200000,SW 407,AG LAND,12900,0,12900,0,0,12900
133637700300000,VACANT LAND,COMMERCIAL,0,428000,428000,0,0,428000
133640100600000,DEPT/ANCHOR STORE,COMMERCIAL,0,894000,894000,0,3905600,4799600
133640100700000,BRANCH BANK/CU,COMMERCIAL,0,64400,64400,0,374100,438500
133640101001000,BRANCH BANK/CU,COMMERCIAL,0,831200,831200,0,1308800,2140000
133640101001004,NBHD SHOPPING CENTER,COMMERCIAL,0,1009800,1009800,0,1269200,2279000
133640101001005,NBHD SHOPPING CENTER,COMMERCIAL,0,347400,347400,0,1037000,1384400
133640101002000,BILLBOARD(BLL),COMMERCIAL,0,0,0,0,15600,15600
133640101100000,VACANT LAND,COMMERCIAL,0,168000,168000,0,8700,176700
133640101500000,VACANT LAND,COMMERCIAL,0,0,0,0,0,0
133640101600000,VACANT LAND,COMMERCIAL,0,2405300,2405300,0,476100,2881400
133640101700000,VACANT LAND,COMMERCIAL,0,12000,12000,0,0,12000
133640101900000,NBHD SHOPPING CENTER,COMMERCIAL,0,632000,632000,0,854300,1486300
133640102000000,VACANT LAND,COMMERCIAL,0,516000,516000,0,0,516000
133640200400000,SW 420,RESIDENTIAL,30200,0,30200,87100,0,117300
133640200500000,SW 420,RESIDENTIAL,30200,0,30200,76100,0,106300
133640200600000,SW 420,RESIDENTIAL,30400,0,30400,80300,0,110700
133642600100000,LG DISCOUNT/RETAIL,COMMERCIAL,0,310500,310500,0,1157000,1467500
133642600200000,OFFICE,COMMERCIAL,0,87100,87100,0,247500,334600
133642600300000,CONVENIENCE STORE,COMMERCIAL,0,526500,526500,0,0,526500
133642700200000,OFFICE,COMMERCIAL,0,70700,70700,0,260500,331200
133642700300000,CARWASH,COMMERCIAL,0,243000,243000,0,152000,395000
133642700400000,OFFICE; MEDICAL,COMMERCIAL,0,88500,88500,0,498300,586800
133642700500000,FLAT PARKING,COMMERCIAL,0,238200,238200,0,3400,241600
133642700600000,LG DISCOUNT/RETAIL,COMMERCIAL,0,1128600,1128600,0,2657600,3786200
133642700700000,AUTO REPAIR/SALES,COMMERCIAL,0,184000,184000,0,237900,421900
133642700800000,RESTAURANT,COMMERCIAL,0,354000,354000,0,749900,1103900
133642700900000,LG DISCOUNT/RETAIL,COMMERCIAL,0,1139300,1139300,0,3102700,4242000
133642700902000,BILLBOARD(BLL),COMMERCIAL,0,0,0,0,65500,65500
133645100200000,FITNESS CENTER,COMMERCIAL,0,32600,32600,0,575800,608400
133645100300000,RESTAURANT,COMMERCIAL,0,333600,333600,0,265100,598700
133645100400000,NBHD SHOPPING CENTER,COMMERCIAL,0,559200,559200,0,725900,1285100
133645200100000,NBHD SHOPPING CENTER,COMMERCIAL,0,280800,280800,0,697600,978400
133645200102000,BILLBOARD(BLL),COMMERCIAL,0,0,0,0,43400,43400
133645300200000,LG DISCOUNT/RETAIL,COMMERCIAL,0,2573700,2573700,0,6980500,9554200
133647600200000,REG SHOPPING CENTER,COMMERCIAL,0,1061300,1061300,0,0,1061300
133647600300000,DEPT/ANCHOR STORE,COMMERCIAL,0,596000,596000,0,1563300,2159300
133647600400000,DEPT/ANCHOR STORE,COMMERCIAL,0,1700200,1700200,0,2816000,4516200
133647600800000,BRANCH BANK/CU,COMMERCIAL,0,716000,716000,0,1273000,1989000
133647601000000,BRANCH BANK/CU,COMMERCIAL,0,224000,224000,0,734500,958500
133647601100000,FAST FOOD,COMMERCIAL,0,516000,516000,0,1175500,1691500
133647601400000,VACANT LAND,COMMERCIAL,0,260000,260000,0,0,260000
133647601500000,VACANT LAND,COMMERCIAL,0,0,0,0,0,0
133647601600000,VACANT LAND,COMMERCIAL,0,1139300,1139300,0,0,1139300
133647601700000,FLAT PARKING,COMMERCIAL,0,840000,840000,0,0,840000
133647601800000,FLAT PARKING,COMMERCIAL,0,1446000,1446000,0,0,1446000
133647601900000,VACANT LAND,COMMERCIAL,0,556000,556000,0,0,556000
140132600300000,APARTMENT,MULTI-RES,18600,0,18600,146800,0,165400
140132600400000,APARTMENT,MULTI-RES,22000,0,22000,144500,0,166500
140132600600000,APARTMENT,MULTI-RES,19200,0,19200,139200,0,158400
140132600700000,APARTMENT,MULTI-RES,22700,0,22700,173000,0,195700
140132600800000,APARTMENT,MULTI-RES,20200,0,20200,147700,0,167900
140132600900000,APARTMENT,MULTI-RES,17500,0,17500,146700,0,164200
140132601100000,NE 115,RESIDENTIAL,8800,0,8800,0,0,8800
140132700300000,NBHD SHOPPING CENTER,COMMERCIAL,0,580000,580000,0,1388600,1968600
140132700401009,LG DISCOUNT/RETAIL,COMMERCIAL,0,116100,116100,0,592900,709000
140132700401010,SMALL RETAIL,COMMERCIAL,0,54600,54600,0,309400,364000
140132700401011,OFFICE,COMMERCIAL,0,153100,153100,0,1113700,1266800
140132700401012,SMALL RETAIL,COMMERCIAL,0,65200,65200,0,309800,375000
140132700401013,FITNESS CENTER,COMMERCIAL,0,484400,484400,0,3119800,3604200
140132700401014,LG DISCOUNT/RETAIL,COMMERCIAL,0,120900,120900,0,500100,621000
140132700900000,VACANT LAND,COMMERCIAL,0,0,0,0,0,0
140132701300000,FLAT PARKING,COMMERCIAL,0,50000,50000,0,11500,61500
140133100100000,LG DISCOUNT/RETAIL,COMMERCIAL,0,209600,209600,0,664500,874100
140133100200000,FLAT PARKING,COMMERCIAL,0,208000,208000,0,38500,246500
140133100300000,VACANT LAND,COMMERCIAL,0,136000,136000,0,0,136000
140133100400000,FITNESS CENTER,COMMERCIAL,0,166400,166400,0,775100,941500
140215100700000,OFFICE,COMMERCIAL,0,310000,310000,0,339700,649700
140215100800000,VACANT LAND,COMMERCIAL,0,0,0,0,0,0
140215200200000,LG DISCOUNT/RETAIL,COMMERCIAL,0,2620000,2620000,0,4358300,6978300
140215200300000,SMALL RETAIL,COMMERCIAL,0,240500,240500,0,0,240500
140215200302000,SMALL RETAIL,COMMERCIAL,0,0,0,0,446900,446900
140215200400000,RESTAURANT,COMMERCIAL,0,410500,410500,0,368100,778600
140220100100000,CENTRALLY ASSESSED,OTHER,0,0,0,0,0,0
140220100200000,NE 115,RESIDENTIAL,6300,0,6300,0,0,6300
140220100300000,NE 115,RESIDENTIAL,2400,0,2400,0,0,2400
140220100400000,NE 115,RESIDENTIAL,9000,0,9000,0,0,9000
140220200100000,FITNESS CENTER,COMMERCIAL,0,252100,252100,0,730300,982400
140220200200000,AUTO REPAIR/SALES,COMMERCIAL,0,63000,63000,0,49800,112800
140220200300000,NE 115,RESIDENTIAL,41900,0,41900,109100,0,151000
140220200400000,LG DISCOUNT/RETAIL,COMMERCIAL,0,833000,833000,0,879600,1712600
140220200500000,SMALL RETAIL,COMMERCIAL,0,180600,180600,0,186200,366800
140220200600000,NBHD SHOPPING CENTER,COMMERCIAL,0,401100,401100,0,937100,1338200
140220200700000,SHOP,COMMERCIAL,0,94800,94800,0,80200,175000
140220200702000,BILLBOARD(BLL),COMMERCIAL,0,0,0,0,12300,12300
140220200800000,AUTO REPAIR/SALES,COMMERCIAL,0,175500,175500,0,210300,385800
140220200900000,FLAT PARKING,COMMERCIAL,0,29000,29000,0,5300,34300
140220201000000,OFFICE,COMMERCIAL,0,178800,178800,0,475900,654700
140220201100000,CITY PROPERTY,EXEMPT,0,0,0,0,0,0
140220300600000,OFFICE,COMMERCIAL,0,73100,73100,0,193000,266100
140220300700000,OFFICE,COMMERCIAL,0,47300,47300,0,154800,202100
140220300800000,OFFICE,COMMERCIAL,0,63700,63700,0,147700,211400
140220300900000,OFFICE,COMMERCIAL,0,35600,35600,0,172700,208300
140220301000000,OFFICE,COMMERCIAL,0,124400,124400,0,490100,614500
140220301100000,LAUNDROMAT/CLEANERS,COMMERCIAL,0,76400,76400,0,192900,269300
140220301200000,DAY CARE CENTER,COMMERCIAL,0,71900,71900,0,207300,279200
140220301300000,FITNESS CENTER,COMMERCIAL,0,61000,61000,0,154700,215700
140220400300000,APARTMENT,MULTI-RES,175800,0,175800,1590400,0,1766200
140220400400000,APARTMENT,MULTI-RES,136200,0,136200,1343700,0,1479900
140220400500000,APARTMENT,MULTI-RES,112500,0,112500,1322800,0,1435300
140222600200000,NE 164,RESIDENTIAL,28000,0,28000,216200,0,244200
140222600300000,NE 164,RESIDENTIAL,28000,0,28000,165300,0,193300
140222600400000,NE 164,RESIDENTIAL,30200,0,30200,204700,0,234900
140222600500000,NE 164,RESIDENTIAL,31500,0,31500,195400,0,226900
140222600600000,NE 164,RESIDENTIAL,48500,0,48500,300000,0,348500
140222700100000,NE 164,RESIDENTIAL,28300,0,28300,190900,0,219200
140222700200000,NE 164,RESIDENTIAL,28300,0,28300,179700,0,208000
140222700300000,NE 164,RESIDENTIAL,28600,0,28600,147900,0,176500
140222700400000,NE 164,RESIDENTIAL,31600,0,31600,206200,0,237800
140222701300000,NE 164,RESIDENTIAL,52700,0,52700,269200,0,321900
140222701400000,NE 164,RESIDENTIAL,45900,0,45900,248100,0,294000
140222701500000,NE 164,RESIDENTIAL,45500,0,45500,199700,0,245200
140222703000000,LG DISCOUNT/RETAIL,COMMERCIAL,0,480500,480500,0,1226200,1706700
140222703100000,OFFICE,COMMERCIAL,0,112500,112500,0,464800,577300
140222703200000,NE 164,RESIDENTIAL,31000,0,31000,170300,0,201300
140222703300000,NE 164,RESIDENTIAL,28200,0,28200,235500,0,263700
140222703400000,NE 164,RESIDENTIAL,28300,0,28300,177600,0,205900
140222703500000,NE 164,RESIDENTIAL,28400,0,28400,186500,0,214900
140222703600000,NE 164,RESIDENTIAL,28400,0,28400,186900,0,215300
140222703700000,NE 164,RESIDENTIAL,30200,0,30200,156300,0,186500
140222800100000,WAREHOUSE,COMMERCIAL,0,251900,251900,0,1099400,1351300
140222800200000,WAREHOUSE;MINI STORG,COMMERCIAL,0,581300,581300,0,554900,1136200
140222800202000,BILLBOARD(BLL),COMMERCIAL,0,0,0,0,52000,52000
140222800300000,NBHD SHOPPING CENTER,COMMERCIAL,0,239000,239000,0,953700,1192700
140222800400000,OFFICE,COMMERCIAL,0,411000,411000,0,1305000,1716000
140222800600000,CONVENIENCE STORE,COMMERCIAL,0,252000,252000,0,299640,551640
140222800700000,FLAT PARKING,COMMERCIAL,0,132000,132000,0,7013,139013
140222800900000,FAST FOOD,COMMERCIAL,0,235000,235000,0,673900,908900
140222900100000,CENTRALLY ASSESSED,OTHER,0,0,0,0,0,0
140223000100000,NE 164,RESIDENTIAL,55900,0,55900,317100,0,373000
140225100100000,HIGH TECH/RESEARCH,INDUSTRIAL,0,2502800,2502800,0,14994200,17497000
140225100200000,HIGH TECH/RESEARCH,INDUSTRIAL,0,41600,41600,0,523600,565200
140225100300000,RESTAURANT,COMMERCIAL,0,783000,783000,0,1126600,1909600
140227600100000,NBHD SHOPPING CENTER,COMMERCIAL,0,126300,126300,0,593300,719600
140227600200000,OFFICE,COMMERCIAL,0,123900,123900,0,382600,506500
140227600400000,SMALL RETAIL,COMMERCIAL,37996,127204,165200,117461,393239,675900
140227600500000,OFFICE,COMMERCIAL,0,95900,95900,0,227900,323800
140227600700000,SMALL RETAIL,COMMERCIAL,0,366000,366000,0,485900,851900
140227600800000,CARWASH,COMMERCIAL,0,483600,483600,0,363900,847500
140227600900000,RESTAURANT,COMMERCIAL,0,1000000,1000000,0,897700,1897700
140227601000000,SMALL RETAIL,COMMERCIAL,0,208000,208000,0,418100,626100
140227601100000,FAST FOOD,COMMERCIAL,0,630000,630000,0,561200,1191200
140227601200000,OFFICE,COMMERCIAL,0,101900,101900,0,207900,309800
140227601300000,OFFICE,COMMERCIAL,0,99500,99500,0,209400,308900
140227601400000,OFFICE,COMMERCIAL,0,99300,99300,0,205500,304800
140227601500000,SMALL RETAIL,COMMERCIAL,0,343200,343200,0,332700,675900
140227601600000,OFFICE,COMMERCIAL,0,126200,126200,0,700600,826800
140227601700000,OFFICE,COMMERCIAL,0,123900,123900,0,378800,502700
140227601900000,OFFICE,COMMERCIAL,0,191100,191100,0,480900,672000
140227602100000,FLAT PARKING,COMMERCIAL,0,145000,145000,0,18100,163100
140227602200000,DAY CARE CENTER,COMMERCIAL,0,490000,490000,0,2329300,2819300
140227602300000,VACANT LAND,COMMERCIAL,0,1800,1800,0,0,1800
140227602400000,VACANT LAND,COMMERCIAL,0,0,0,0,0,0
140227602500000,VACANT LAND,COMMERCIAL,0,0,0,0,0,0
140227700100000,VACANT LAND,COMMERCIAL,0,0,0,0,0,0
140227700200000,WAREHOUSE;MINI STORG,COMMERCIAL,0,134400,134400,0,82700,217100
140227700300000,CHURCH,EXEMPT,0,457400,457400,0,3609500,4066900
140227700400000,WAREHOUSE,COMMERCIAL,0,244400,244400,0,4700,249100
140227700500000,SKATING RINK,COMMERCIAL,0,244400,244400,0,397200,641600
140227700600000,OFFICE,COMMERCIAL,0,622000,622000,0,878300,1500300
140227700800000,CONVENIENCE STORE,COMMERCIAL,0,600000,600000,0,454800,1054800
140227700900000,FLAT PARKING,COMMERCIAL,0,14000,14000,0,1900,15900
140230100100000,RESTAURANT,COMMERCIAL,0,755000,755000,0,779400,1534400
140230100200000,FAST FOOD,COMMERCIAL,0,825000,825000,0,1094000,1919000
140230100300000,RESTAURANT,COMMERCIAL,0,480000,480000,0,295200,775200
140230100400000,RESTAURANT,COMMERCIAL,0,432000,432000,0,413000,845000
140230100500000,FAST FOOD,COMMERCIAL,0,637800,637800,0,549600,1187400
140230100600000,VACANT LAND,COMMERCIAL,0,0,0,0,0,0
140230100700000,RESTAURANT,COMMERCIAL,0,580200,580200,0,608800,1189000
140230100800000,RESTAURANT,COMMERCIAL,0,590000,590000,0,630400,1220400
140230100900000,LG DISCOUNT/RETAIL,COMMERCIAL,0,1233800,1233800,0,4692600,5926400
140230101100000,FLAT PARKING,COMMERCIAL,0,877500,877500,0,345100,1222600
140230101200000,GROCERY STORE,COMMERCIAL,0,331200,331200,0,2246189,2577389
140230101300000,VACANT LAND,COMMERCIAL,0,0,0,0,0,0
140230101400000,LG DISCOUNT/RETAIL,COMMERCIAL,0,242700,242700,0,816400,1059100
140232600100000,RESTAURANT,COMMERCIAL,0,990000,990000,0,792900,1782900
140232600200000,OFFICE,COMMERCIAL,0,500600,500600,0,703700,1204300
140232600300000,OFFICE,COMMERCIAL,0,362900,362900,0,588000,950900
140232600400000,CITY PROPERTY,EXEMPT,0,0,0,0,0,0
140232600500000,NE 117,RESIDENTIAL,23800,0,23800,80500,0,104300
140232600600000,CITY PROPERTY,EXEMPT,0,0,0,0,0,0
140232600700000,CITY PROPERTY,EXEMPT,0,0,0,0,0,0
140232600800000,NE 117,RESIDENTIAL,23800,0,23800,67700,0,91500
140232600900000,NE 117,RESIDENTIAL,25900,0,25900,93300,0,119200
140232601000000,NE 117,RESIDENTIAL,25900,0,25900,58200,0,84100
140232601100000,NE 117,RESIDENTIAL,25900,0,25900,154600,0,180500
140232601200000,NE 117,RESIDENTIAL,25900,0,25900,86000,0,111900
140232601300000,NE 117,RESIDENTIAL,25200,0,25200,85900,0,111100
140232601400000,NE 117,RESIDENTIAL,30800,0,30800,101000,0,131800
140232601500000,NE 117,RESIDENTIAL,30000,0,30000,88200,0,118200
140232601600000,NE 117,RESIDENTIAL,30300,0,30300,120000,0,150300
140232601700000,FUNERAL HOME,COMMERCIAL,0,704900,704900,0,317600,1022500
140232601800000,OFFICE,COMMERCIAL,0,76200,76200,0,974700,1050900
140232601900000,OFFICE,COMMERCIAL,0,86900,86900,0,850900,937800
140232602000000,DEPT/ANCHOR STORE,COMMERCIAL,0,1161000,1161000,0,3213800,4374800
140232602100000,VACANT LAND,COMMERCIAL,0,700,700,0,0,700
140235100100000,FUNERAL HOME,EXEMPT,0,4480000,4480000,0,2174700,6654700
140237600100000,VACANT LAND,COMMERCIAL,0,800,800,0,0,800
140237600200000,FUNERAL HOME,COMMERCIAL,0,145200,145200,0,234700,379900
140237600300000,FUNERAL HOME,COMMERCIAL,0,413100,413100,0,904400,1317500
140237600302000,ANTENNAS/TOWERS(BLL),COMMERCIAL,0,0,0,0,155500,155500
140237600400000,LG DISCOUNT/RETAIL,COMMERCIAL,0,318300,318300,0,278200,596500
140237600500000,CITY PROPERTY,EXEMPT,0,0,0,0,0,0
140237700100000,OFFICE,COMMERCIAL,0,121200,121200,0,192000,313200
140237700200000,FLAT PARKING,COMMERCIAL,0,76300,76300,0,5900,82200
140237700300000,OFFICE; MEDICAL,COMMERCIAL,0,393300,393300,0,252000,645300
140237700400000,OFFICE; MEDICAL,COMMERCIAL,57765,327335,385100,43665,183135,611900
140237700500000,OFFICE,COMMERCIAL,0,130900,130900,0,164200,295100
140237700600000,OFFICE; MEDICAL,COMMERCIAL,0,164600,164600,0,180700,345300
140237700700000,NE 115,RESIDENTIAL,17700,0,17700,95000,0,112700
140237700800000,NE 115,RESIDENTIAL,20200,0,20200,58300,0,78500
140237700901000,OFFICE,COMMERCIAL,0,2500,2500,0,46200,48700
140237700901001,OFFICE,COMMERCIAL,0,1500,1500,0,28700,30200
140237700901002,OFFICE,COMMERCIAL,0,3100,3100,0,48400,51500
140237700901003,OFFICE,COMMERCIAL,0,1500,1500,0,28700,30200
140237700901004,OFFICE,COMMERCIAL,0,1500,1500,0,28700,30200
140237700901005,OFFICE,COMMERCIAL,0,600,600,0,11200,11800
140237700901006,OFFICE,COMMERCIAL,0,1500,1500,0,28700,30200
140237700901007,OFFICE,COMMERCIAL,0,1500,1500,0,28700,30200
140237700901052,OFFICE,COMMERCIAL,0,700,700,0,14100,14800
140237700901053,OFFICE,COMMERCIAL,0,600,600,0,20500,21100
140237701200000,NE 115,RESIDENTIAL,2100,0,2100,0,0,2100
140240100300000,LG DISCOUNT/RETAIL,COMMERCIAL,0,1090000,1090000,0,1583000,2673000
140240100400000,AUTO REPAIR/SALES,COMMERCIAL,0,355000,355000,0,281100,636100
140240100500000,AUTO REPAIR/SALES,COMMERCIAL,0,254000,254000,0,203800,457800
140240100502000,BILLBOARD(BLL),COMMERCIAL,0,0,0,0,43400,43400
140240100600000,NBHD SHOPPING CENTER,COMMERCIAL,0,218500,218500,0,462600,681100
140240100700000,FLAT PARKING,COMMERCIAL,0,33600,33600,0,3800,37400
140240100800000,FLAT PARKING,COMMERCIAL,0,5000,5000,0,100,5100
140240101200000,SMALL RETAIL,COMMERCIAL,0,830000,830000,0,761500,1591500
140240101300000,LG DISCOUNT/RETAIL,COMMERCIAL,0,1092000,1092000,0,2715200,3807200
140240200100000,NBHD SHOPPING CENTER,COMMERCIAL,0,680000,680000,0,1253500,1933500
140240200200000,LG DISCOUNT/RETAIL,COMMERCIAL,0,2623500,2623500,0,1981300,4604800
140240200300000,SMALL RETAIL,COMMERCIAL,0,290000,290000,0,466500,756500
140240200400000,SMALL RETAIL,COMMERCIAL,0,228500,228500,0,187700,416200
140240200402000,BILLBOARD(BLL),COMMERCIAL,0,0,0,0,12800,12800
140240200500000,CITY PROPERTY,EXEMPT,0,0,0,0,0,0
140240300400000,SMALL RETAIL,COMMERCIAL,0,366000,366000,0,0,366000
140240301600000,OFFICE,COMMERCIAL,0,408000,408000,0,1263900,1671900
140240301700000,AUTO REPAIR/SALES,COMMERCIAL,0,278400,278400,0,250800,529200
140240400200000,NBHD SHOPPING CENTER,COMMERCIAL,0,730000,730000,0,2249100,2979100
140240400400000,RESTAURANT,COMMERCIAL,0,1620000,1620000,0,1213000,2833000
140240400500000,HOTEL,COMMERCIAL,0,333000,333000,0,512200,845200
140242600100000,DEPT/ANCHOR STORE,COMMERCIAL,0,2488800,2488800,0,2511200,5000000
140242600200000,FAST FOOD,COMMERCIAL,0,460000,460000,0,864100,1324100
140242600300000,REG SHOPPING CENTER,COMMERCIAL,0,5116300,5116300,0,29218800,34335100
140245100100000,RESTAURANT,COMMERCIAL,0,375000,375000,0,756000,1131000
140245100200000,SMALL RETAIL,COMMERCIAL,0,156600,156600,0,315600,472200
140245100500000,OFFICE,COMMERCIAL,0,792800,792800,0,867200,1660000
140245100600000,FAST FOOD,COMMERCIAL,0,244000,244000,0,379000,623000
140245100700000,SMALL RETAIL,COMMERCIAL,0,195200,195200,0,277300,472500
140245100800000,BARS/LOUNGE,COMMERCIAL,0,97400,97400,0,202800,300200
140245100900000,WAREHOUSE;MINI STORG,COMMERCIAL,0,118800,118800,0,85400,204200
140245101100000,NE 115,RESIDENTIAL,10000,0,10000,0,0,10000
140245101200000,WAREHOUSE;MINI STORG,COMMERCIAL,0,43000,43000,0,34900,77900
140245101300000,CENTRALLY ASSESSED,EXEMPT,0,0,0,0,0,0
140245101400000,VACANT LAND,COMMERCIAL,0,371300,371300,0,0,371300
140245101500000,LG DISCOUNT/RETAIL,COMMERCIAL,0,1997500,1997500,0,4621000,6618500
140245200100000,BRANCH BANK/CU,COMMERCIAL,0,120000,120000,0,348200,468200
140245200200000,BRANCH BANK/CU,COMMERCIAL,0,350000,350000,0,358900,708900
140245200300000,AUTO REPAIR/SALES,COMMERCIAL,0,181500,181500,0,400100,581600
140245200400000,SHOP,EXEMPT,0,56000,56000,0,175900,231900
140245300401001,OFFICE,COMMERCIAL,0,3900,3900,0,50500,54400
140245300500000,NE 115,RESIDENTIAL,30900,0,30900,174500,0,205400
140245300600000,NE 115,RESIDENTIAL,15600,0,15600,83600,0,99200
140245300700000,NE 115,RESIDENTIAL,3000,0,3000,0,0,3000
140245300800000,NE 115,RESIDENTIAL,100,0,100,0,0,100
140245300900000,NE 115,RESIDENTIAL,4000,0,4000,0,0,4000
140247600900000,VACANT LAND,EXEMPT,0,1735000,1735000,0,0,1735000
140247601000000,LG DISCOUNT/RETAIL,COMMERCIAL,0,1352500,1352500,0,2334100,3686600
140247601300000,LG DISCOUNT/RETAIL,COMMERCIAL,0,2041300,2041300,0,5223100,7264400
140247601400000,LG DISCOUNT/RETAIL,COMMERCIAL,0,1097300,1097300,0,5217200,6314500
140310100100000,NE 110,RESIDENTIAL,29600,0,29600,81300,0,110900
140310100200000,NE 110,RESIDENTIAL,28800,0,28800,109500,0,138300
140310100300000,NE 110,RESIDENTIAL,28800,0,28800,129400,0,158200
140310100400000,NE 110,RESIDENTIAL,28800,0,28800,139200,0,168000
140310100500000,NE 110,RESIDENTIAL,28800,0,28800,95200,0,124000
140310100600000,NE 110,RESIDENTIAL,28800,0,28800,147400,0,176200
140310100700000,NE 110,RESIDENTIAL,34500,0,34500,128400,0,162900
140310100800000,NE 110,RESIDENTIAL,36300,0,36300,124000,0,160300
140310200100000,NE 110,RESIDENTIAL,27600,0,27600,124100,0,151700
140310200200000,NE 110,RESIDENTIAL,31900,0,31900,136800,0,168700
140310300300000,APARTMENT,RESIDENTIAL,16500,0,16500,100200,0,116700
140310300600000,APARTMENT,RESIDENTIAL,24800,0,24800,142600,0,167400
140310300900000,CHURCH,EXEMPT,0,640000,640000,0,1028100,1668100
140310400400000,NBHD SHOPPING CENTER,COMMERCIAL,0,220000,220000,0,886700,1106700
140310400500000,NBHD SHOPPING CENTER,COMMERCIAL,0,317500,317500,0,819200,1136700
140310400600000,VACANT LAND,COMMERCIAL,0,300,300,0,0,300
140310400700000,BRANCH BANK/CU,COMMERCIAL,0,332000,332000,0,1122300,1454300
140312600100000,NE 110,RESIDENTIAL,27500,0,27500,126300,0,153800
140312600200000,NE 110,RESIDENTIAL,24900,0,24900,107100,0,132000
140312600300000,NE 110,RESIDENTIAL,24900,0,24900,117900,0,142800
140312600400000,NE 110,RESIDENTIAL,24900,0,24900,114700,0,139600
140312600500000,NE 110,RESIDENTIAL,24900,0,24900,112600,0,137500
140312600600000,NE 110,RESIDENTIAL,25000,0,25000,128400,0,153400
140312600700000,NE 110,RESIDENTIAL,27000,0,27000,103100,0,130100
140312700100000,NE 110,RESIDENTIAL,26800,0,26800,96500,0,123300
140312700200000,NE 110,RESIDENTIAL,23900,0,23900,102400,0,126300
140312800100000,NE 110,RESIDENTIAL,30100,0,30100,86800,0,116900
140312800200000,NE 110,RESIDENTIAL,25400,0,25400,126700,0,152100
140312800300000,NE 110,RESIDENTIAL,24300,0,24300,109200,0,133500
140312800400000,NE 110,RESIDENTIAL,24300,0,24300,114400,0,138700
140312800500000,NE 110,RESIDENTIAL,24300,0,24300,120500,0,144800
140312800600000,NE 110,RESIDENTIAL,24700,0,24700,111200,0,135900
140312800700000,NE 110,RESIDENTIAL,26100,0,26100,98900,0,125000
140312800800000,NE 110,RESIDENTIAL,26100,0,26100,123800,0,149900
140312800900000,NE 110,RESIDENTIAL,25900,0,25900,105400,0,131300
140312801000000,NE 110,RESIDENTIAL,25600,0,25600,85500,0,111100
140312801100000,NE 110,RESIDENTIAL,24700,0,24700,105900,0,130600
140312801200000,NE 110,RESIDENTIAL,24700,0,24700,107100,0,131800
140312801300000,NE 110,RESIDENTIAL,24900,0,24900,94100,0,119000
140312801400000,NE 110,RESIDENTIAL,25500,0,25500,105200,0,130700
140312801500000,NE 110,RESIDENTIAL,25700,0,25700,87300,0,113000
140312801600000,NE 110,RESIDENTIAL,29000,0,29000,132900,0,161900
140312900100000,NE 110,RESIDENTIAL,25800,0,25800,96200,0,122000
140312900200000,NE 110,RESIDENTIAL,23900,0,23900,94100,0,118000
140312900300000,NE 110,RESIDENTIAL,25700,0,25700,92300,0,118000
140312900400000,NE 110,RESIDENTIAL,25500,0,25500,120400,0,145900
140312900500000,NE 110,RESIDENTIAL,25800,0,25800,98100,0,123900
140313000100000,AUTO REPAIR/SALES,COMMERCIAL,0,102600,102600,0,193000,295600
140313000200000,SHOP,COMMERCIAL,0,208300,208300,0,280900,489200
140313000202000,BILLBOARD(BLL),COMMERCIAL,0,0,0,0,52000,52000
140313000500000,VACANT LAND,COMMERCIAL,0,977400,977400,0,0,977400
140315100100000,HIGH TECH/RESEARCH,INDUSTRIAL,0,4549700,4549700,0,15386800,19936500
140317600100000,ANTENNAS/TOWERS(BLL),COMMERCIAL,0,152100,152100,0,1100,153200
140320100100000,NE 110,RESIDENTIAL,23900,0,23900,90100,0,114000
140320200200000,LG DISCOUNT/RETAIL,COMMERCIAL,0,1437000,1437000,0,6607900,8044900
140320200300000,NBHD SHOPPING CENTER,COMMERCIAL,0,677500,677500,0,3165700,3843200
140320200400000,BRANCH BANK/CU,COMMERCIAL,0,510000,510000,0,780400,1290400
140320300100000,NE 110,RESIDENTIAL,23900,0,23900,88900,0,112800
140320300200000,NE 111,RESIDENTIAL,400,0,400,0,0,400
140320300300000,NE 110,RESIDENTIAL,25500,0,25500,74600,0,100100
140320400100000,CITY PROPERTY,EXEMPT,0,0,0,0,0,0
140320400200000,CONC/ASPH;INDUSTRIAL,COMMERCIAL,0,382400,382400,0,273600,656000
140320400400000,VACANT LAND,COMMERCIAL,0,138400,138400,0,0,138400
140320400500000,VACANT LAND,COMMERCIAL,0,429500,429500,0,0,429500
140320400502000,BILLBOARD(BLL),COMMERCIAL,0,0,0,0,42500,42500
140320500100000,WAREHOUSE,COMMERCIAL,0,339000,339000,0,2998400,3337400
140320500200000,FLAT PARKING,COMMERCIAL,0,103600,103600,0,40700,144300
140320500300000,SHOP,COMMERCIAL,0,424000,424000,0,1169100,1593100
140320500400000,VACANT LAND,COMMERCIAL,0,34900,34900,0,0,34900
140320500500000,VACANT LAND,COMMERCIAL,0,51700,51700,0,0,51700
140320500600000,VACANT LAND,COMMERCIAL,0,71300,71300,0,0,71300
140322600100000,SHOP,COMMERCIAL,0,83300,83300,0,147300,230600
140322600200000,VACANT LAND,COMMERCIAL,0,33700,33700,0,0,33700
140322600300000,VACANT LAND,COMMERCIAL,0,134900,134900,0,0,134900
140322600400000,OFFICE,COMMERCIAL,0,148800,148800,0,454900,603700
140322600500000,FLAT PARKING,COMMERCIAL,0,202000,202000,0,8300,210300
140322600600000,SMALL RETAIL,COMMERCIAL,0,212000,212000,0,564700,776700
140322600701000,VETERINARY CLINIC,COMMERCIAL,0,81300,81300,0,368500,449800
140322600701001,SMALL RETAIL,COMMERCIAL,0,24400,24400,0,101000,125400
140322600701002,SMALL RETAIL,COMMERCIAL,0,24400,24400,0,101000,125400
140322600701003,SMALL RETAIL,COMMERCIAL,0,24400,24400,0,101000,125400
140322600701004,SMALL RETAIL,COMMERCIAL,0,24400,24400,0,101000,125400
140322600800000,RESTAURANT,COMMERCIAL,0,280000,280000,0,667000,947000
140322700100000,OFFICE,COMMERCIAL,0,333800,333800,0,766000,1099800
140322700200000,OFFICE,EXEMPT,0,498000,498000,0,894600,1392600
140322700300000,VACANT LAND,COMMERCIAL,0,854000,854000,0,0,854000
140322700400000,DAY CARE CENTER,COMMERCIAL,0,217500,217500,0,359400,576900
140322700500000,FAST FOOD,COMMERCIAL,0,275000,275000,0,995300,1270300
140322800200000,WAREHOUSE,EXEMPT,0,774800,774800,0,1479000,2253800
140322800300000,CONVENIENCE STORE,COMMERCIAL,0,303600,303600,0,317500,621100
140322800600000,BRANCH BANK/CU,COMMERCIAL,0,300000,300000,0,1260400,1560400
140322801000000,VACANT LAND,COMMERCIAL,0,0,0,0,0,0
140322801100000,VACANT LAND,COMMERCIAL,0,297500,297500,0,0,297500
140322801102000,BILLBOARD(BLL),COMMERCIAL,0,0,0,0,49900,49900
140322801200000,VACANT LAND,COMMERCIAL,0,130700,130700,0,0,130700
140322801300000,VACANT LAND,COMMERCIAL,0,135500,135500,0,0,135500
140322801400000,VACANT LAND,COMMERCIAL,0,108600,108600,0,0,108600
140322801500000,VACANT LAND,COMMERCIAL,0,232500,232500,0,0,232500
140322801600000,VACANT LAND,COMMERCIAL,0,1042600,1042600,0,0,1042600
140322801700000,VACANT LAND,COMMERCIAL,0,121300,121300,0,0,121300
140325100100000,OFFICE,COMMERCIAL,0,431000,431000,0,3262400,3693400
140325100300000,HOTEL,COMMERCIAL,0,420000,420000,0,1615400,2035400
140325100400000,THEATER,COMMERCIAL,0,1274300,1274300,0,6842900,8117200
140325100500000,NBHD SHOPPING CENTER,COMMERCIAL,0,616500,616500,0,1475900,2092400
140325100600000,FLAT PARKING,COMMERCIAL,0,138800,138800,0,45900,184700
140325100700000,OFFICE; MEDICAL,COMMERCIAL,0,1040300,1040300,0,4712900,5753200
140325100800000,BRANCH BANK/CU,COMMERCIAL,0,300000,300000,0,801900,1101900
140325200100000,OFFICE,COMMERCIAL,0,132800,132800,0,594700,727500
140325200200000,OFFICE,COMMERCIAL,0,207000,207000,0,653300,860300
140325200300000,OFFICE,COMMERCIAL,0,214500,214500,0,644700,859200
140325200400000,RESTAURANT,COMMERCIAL,0,648000,648000,0,734600,1382600
140325200500000,HOTEL,COMMERCIAL,0,541100,541100,0,2693400,3234500
140325300100000,AUTO REPAIR/SALES,COMMERCIAL,0,441000,441000,0,305400,746400
140325300200000,OFFICE,COMMERCIAL,0,86600,86600,0,272600,359200
140325300300000,RESTAURANT,COMMERCIAL,0,401000,401000,0,445400,846400
140325300400000,FLAT PARKING,COMMERCIAL,0,118000,118000,0,38400,156400
140325300402000,BILLBOARD(BLL),COMMERCIAL,0,0,0,0,43900,43900
140325300500000,OFFICE,COMMERCIAL,0,99300,99300,0,567600,666900
140327600100000,WAREHOUSE,COMMERCIAL,0,423000,423000,0,1353400,1776400
140327600200000,MATERIALS MFG;INDUST,INDUSTRIAL,0,424000,424000,0,1134500,1558500
140327600300000,FLAT PARKING,COMMERCIAL,0,694500,694500,0,103300,797800
140327600400000,HOTEL,COMMERCIAL,0,672000,672000,0,4239100,4911100
140327600500000,HOTEL,COMMERCIAL,0,636000,636000,0,4392600,5028600
140327600700000,HOTEL,COMMERCIAL,0,470400,470400,0,2077800,2548200
140327600800000,FLAT PARKING,COMMERCIAL,0,321000,321000,0,65000,386000
140327700100000,HOTEL,COMMERCIAL,0,187500,187500,0,960400,1147900
140327700200000,HIGH TECH/RESEARCH,INDUSTRIAL,0,990000,990000,0,4246600,5236600
140327700300000,HOTEL,COMMERCIAL,0,1312000,1312000,0,6820000,8132000
140327700400000,FLAT PARKING,COMMERCIAL,0,106500,106500,0,8900,115400
140327700500000,OFFICE,COMMERCIAL,0,90500,90500,0,294700,385200
140327700502000,BILLBOARD(BLL),COMMERCIAL,0,0,0,0,49200,49200
140330100100000,SCHOOL,EXEMPT,0,0,0,0,0,0
140330100200000,CITY PROPERTY,EXEMPT,0,0,0,0,0,0
140332600100000,CITY PROPERTY,EXEMPT,0,0,0,0,0,0
140337600100000,SCHOOL,EXEMPT,0,177000,177000,0,201400,378400
140337600200000,NE 117,RESIDENTIAL,22500,0,22500,78900,0,101400
140337600300000,NE 117,RESIDENTIAL,21300,0,21300,86200,0,107500
140337600400000,NE 117,RESIDENTIAL,21300,0,21300,81500,0,102800
140337600500000,NE 117,RESIDENTIAL,21300,0,21300,73000,0,94300
140337600600000,NE 117,RESIDENTIAL,21300,0,21300,82100,0,103400
140337600700000,NE 117,RESIDENTIAL,21300,0,21300,89700,0,111000
140337600800000,NE 117,RESIDENTIAL,21300,0,21300,97800,0,119100
140337600900000,NE 117,RESIDENTIAL,21300,0,21300,85700,0,107000
140337601000000,NE 117,RESIDENTIAL,24400,0,24400,89700,0,114100
140337700100000,NE 117,RESIDENTIAL,23100,0,23100,62200,0,85300
140337700200000,NE 117,RESIDENTIAL,22500,0,22500,76700,0,99200
140337700300000,NE 117,RESIDENTIAL,22500,0,22500,80500,0,103000
140337700400000,NE 117,RESIDENTIAL,22500,0,22500,79400,0,101900
140337700500000,NE 117,RESIDENTIAL,22500,0,22500,83500,0,106000
140337700600000,NE 117,RESIDENTIAL,22500,0,22500,90200,0,112700
140337700700000,NE 117,RESIDENTIAL,21300,0,21300,82700,0,104000
140337700800000,NE 117,RESIDENTIAL,21300,0,21300,81300,0,102600
140337700900000,NE 117,RESIDENTIAL,21300,0,21300,79800,0,101100
140337701000000,NE 117,RESIDENTIAL,25400,0,25400,93300,0,118700
140337800100000,NE 117,RESIDENTIAL,24300,0,24300,104600,0,128900
140337800200000,NE 117,RESIDENTIAL,23500,0,23500,101400,0,124900
140337800300000,NE 117,RESIDENTIAL,22300,0,22300,62900,0,85200
140337800400000,NE 117,RESIDENTIAL,21400,0,21400,61900,0,83300
140337800500000,NE 117,RESIDENTIAL,21800,0,21800,63500,0,85300
140337800600000,NE 117,RESIDENTIAL,21400,0,21400,58100,0,79500
140337800700000,NE 117,RESIDENTIAL,20800,0,20800,67000,0,87800
140337800800000,NE 117,RESIDENTIAL,20600,0,20600,64300,0,84900
140337800900000,NE 117,RESIDENTIAL,21300,0,21300,86000,0,107300
140337801000000,NE 117,RESIDENTIAL,22100,0,22100,60500,0,82600
140337801100000,NE 117,RESIDENTIAL,21400,0,21400,82500,0,103900
140337801200000,NE 117,RESIDENTIAL,22500,0,22500,71000,0,93500
140337801300000,NE 117,RESIDENTIAL,21300,0,21300,91100,0,112400
140337801400000,NE 117,RESIDENTIAL,21300,0,21300,70500,0,91800
140337801500000,NE 117,RESIDENTIAL,21300,0,21300,75200,0,96500
140337801600000,NE 117,RESIDENTIAL,21300,0,21300,90700,0,112000
140337801700000,NE 117,RESIDENTIAL,21300,0,21300,76800,0,98100
140337801800000,NE 117,RESIDENTIAL,21800,0,21800,87200,0,109000
140337801900000,NE 117,RESIDENTIAL,22500,0,22500,81700,0,104200
140337802000000,NE 117,RESIDENTIAL,22500,0,22500,76300,0,98800
140337802100000,NE 117,RESIDENTIAL,22500,0,22500,83900,0,106400
140337802200000,NE 117,RESIDENTIAL,24200,0,24200,92500,0,116700
140337802300000,NE 117,RESIDENTIAL,22700,0,22700,82700,0,105400
140337802400000,NE 117,RESIDENTIAL,25200,0,25200,85900,0,111100
140337802500000,NE 117,RESIDENTIAL,22500,0,22500,83900,0,106400
140337802600000,NE 117,RESIDENTIAL,22500,0,22500,95400,0,117900
140337802700000,NE 117,RESIDENTIAL,22500,0,22500,95700,0,118200
140337802800000,NE 117,RESIDENTIAL,21800,0,21800,80200,0,102000
140337802900000,NE 117,RESIDENTIAL,21300,0,21300,86800,0,108100
140337803000000,NE 117,RESIDENTIAL,21300,0,21300,88600,0,109900
140337803100000,NE 117,RESIDENTIAL,21300,0,21300,56100,0,77400
140337803200000,NE 117,RESIDENTIAL,21300,0,21300,63700,0,85000
140337803300000,NE 117,RESIDENTIAL,21300,0,21300,80000,0,101300
140337803400000,NE 117,RESIDENTIAL,21700,0,21700,85300,0,107000
140337803500000,NE 117,RESIDENTIAL,21300,0,21300,78500,0,99800
140337803600000,NE 117,RESIDENTIAL,21300,0,21300,80800,0,102100
140337803700000,NE 117,RESIDENTIAL,22600,0,22600,83600,0,106200
140337803800000,NE 117,RESIDENTIAL,22700,0,22700,52700,0,75400
140337803900000,NE 117,RESIDENTIAL,23900,0,23900,75600,0,99500
140337804000000,NE 117,RESIDENTIAL,24000,0,24000,95300,0,119300
140337804100000,NE 117,RESIDENTIAL,22900,0,22900,96300,0,119200
140337804200000,NE 117,RESIDENTIAL,22900,0,22900,80000,0,102900
140337804300000,NE 117,RESIDENTIAL,22000,0,22000,94000,0,116000
140337804400000,NE 117,RESIDENTIAL,22300,0,22300,84600,0,106900
140337900100000,NE 117,RESIDENTIAL,23100,0,23100,81300,0,104400
140337900200000,NE 117,RESIDENTIAL,23300,0,23300,72200,0,95500
140337900300000,NE 117,RESIDENTIAL,23300,0,23300,78600,0,101900
140337900400000,NE 117,RESIDENTIAL,23300,0,23300,76600,0,99900
140337900500000,NE 117,RESIDENTIAL,23300,0,23300,98000,0,121300
140337900600000,NE 117,RESIDENTIAL,22500,0,22500,87800,0,110300
140337900700000,NE 117,RESIDENTIAL,22500,0,22500,88800,0,111300
140337900800000,NE 117,RESIDENTIAL,22500,0,22500,66100,0,88600
140337900900000,NE 117,RESIDENTIAL,24000,0,24000,85500,0,109500
140337901000000,NE 117,RESIDENTIAL,22900,0,22900,86200,0,109100
140337901100000,NE 117,RESIDENTIAL,24600,0,24600,61300,0,85900
140337901200000,NE 117,RESIDENTIAL,23200,0,23200,61800,0,85000
140337901300000,NE 117,RESIDENTIAL,22100,0,22100,65200,0,87300
140337901400000,NE 117,RESIDENTIAL,25400,0,25400,78200,0,103600
140337901500000,NE 117,RESIDENTIAL,25400,0,25400,74500,0,99900
140337901600000,NE 117,RESIDENTIAL,25400,0,25400,85400,0,110800
140337901700000,NE 117,RESIDENTIAL,25400,0,25400,75800,0,101200
140337901800000,NE 117,RESIDENTIAL,25400,0,25400,95000,0,120400
140337901900000,NE 117,RESIDENTIAL,25400,0,25400,79100,0,104500
140337902000000,CHURCH,EXEMPT,0,115000,115000,0,149000,264000
140337902100000,BRANCH BANK/CU,COMMERCIAL,0,642000,642000,0,3055700,3697700
140337902300000,FAST FOOD,COMMERCIAL,0,33300,33300,0,91400,124700
140337902400000,AUTO REPAIR/SALES,COMMERCIAL,0,182400,182400,0,144500,326900
140337902500000,SMALL RETAIL,COMMERCIAL,0,200300,200300,0,405500,605800
140337902700000,NBHD SHOPPING CENTER,COMMERCIAL,0,269700,269700,0,871800,1141500
140337902800000,OFFICE,COMMERCIAL,0,382500,382500,0,192200,574700
140337902900000,OFFICE,COMMERCIAL,0,41000,41000,0,5700,46700
140338000100000,NE 117,RESIDENTIAL,23600,0,23600,89600,0,113200
140338000200000,NE 117,RESIDENTIAL,22800,0,22800,72000,0,94800
140338000300000,NE 117,RESIDENTIAL,21900,0,21900,79100,0,101000
140338000400000,NE 117,RESIDENTIAL,21300,0,21300,84800,0,106100
140338000500000,NE 117,RESIDENTIAL,21300,0,21300,79700,0,101000
140338000600000,NE 117,RESIDENTIAL,21200,0,21200,83300,0,104500
140338000700000,NE 117,RESIDENTIAL,21200,0,21200,76600,0,97800
140338000800000,NE 117,RESIDENTIAL,21200,0,21200,82800,0,104000
140338000900000,NE 121,RESIDENTIAL,21200,0,21200,82100,0,103300
140338001000000,NE 117,RESIDENTIAL,21200,0,21200,73400,0,94600
140338001100000,NE 117,RESIDENTIAL,21200,0,21200,52100,0,73300
140338001200000,NE 117,RESIDENTIAL,21200,0,21200,78300,0,99500
140338001300000,NE 117,RESIDENTIAL,21200,0,21200,83500,0,104700
140338001400000,NE 117,RESIDENTIAL,21200,0,21200,87100,0,108300
140338001500000,NE 117,RESIDENTIAL,24200,0,24200,75800,0,100000
140338001600000,NE 117,RESIDENTIAL,22700,0,22700,75800,0,98500
140338001700000,NE 117,RESIDENTIAL,25200,0,25200,77700,0,102900
140338001800000,NE 117,RESIDENTIAL,21200,0,21200,78500,0,99700
140338001900000,NE 117,RESIDENTIAL,21200,0,21200,81800,0,103000
140338002000000,NE 117,RESIDENTIAL,21200,0,21200,81300,0,102500
140338002100000,NE 117,RESIDENTIAL,21200,0,21200,93500,0,114700
140338002200000,NE 117,RESIDENTIAL,21200,0,21200,72100,0,93300
140338002300000,NE 117,RESIDENTIAL,21200,0,21200,89500,0,110700
140338002400000,NE 117,RESIDENTIAL,21200,0,21200,73000,0,94200
140338002500000,NE 117,RESIDENTIAL,21200,0,21200,73200,0,94400
140338002600000,NE 117,RESIDENTIAL,21200,0,21200,92500,0,113700
140338002700000,NE 117,RESIDENTIAL,21300,0,21300,98900,0,120200
140338002800000,NE 117,RESIDENTIAL,21300,0,21300,77800,0,99100
140338002900000,NE 117,RESIDENTIAL,21700,0,21700,80700,0,102400
140338003000000,NE 117,RESIDENTIAL,21800,0,21800,74700,0,96500
140338100200000,AUTO REPAIR/SALES,COMMERCIAL,0,3400,3400,0,136600,140000
140338100500000,OFFICE,EXEMPT,0,372000,372000,0,952700,1324700
140338100700000,OFFICE,COMMERCIAL,0,40300,40300,0,139500,179800
140340100100000,OFFICE,COMMERCIAL,0,1009100,1009100,0,1313000,2322100
140340200100000,NE 117,RESIDENTIAL,28300,0,28300,84300,0,112600
140340200200000,NE 117,RESIDENTIAL,29300,0,29300,112300,0,141600
140340200300000,NE 117,RESIDENTIAL,22600,0,22600,94500,0,117100
140340200400000,NE 117,RESIDENTIAL,22600,0,22600,89800,0,112400
140340200500000,NE 117,RESIDENTIAL,22600,0,22600,78700,0,101300
140340200600000,NE 117,RESIDENTIAL,22600,0,22600,76600,0,99200
140340200700000,NE 117,RESIDENTIAL,22600,0,22600,85100,0,107700
140340200800000,NE 117,RESIDENTIAL,22600,0,22600,88100,0,110700
140340200900000,NE 117,RESIDENTIAL,22600,0,22600,94200,0,116800
140340201000000,NE 117,RESIDENTIAL,26500,0,26500,93200,0,119700
140340201100000,NE 117,RESIDENTIAL,27000,0,27000,87000,0,114000
140340201200000,NE 117,RESIDENTIAL,22900,0,22900,110700,0,133600
140340201300000,NE 117,RESIDENTIAL,22800,0,22800,87500,0,110300
140340201400000,NE 117,RESIDENTIAL,26400,0,26400,82400,0,108800
140340201500000,NE 117,RESIDENTIAL,26600,0,26600,115400,0,142000
140340201600000,NE 117,RESIDENTIAL,21300,0,21300,81500,0,102800
140340201700000,NE 117,RESIDENTIAL,21300,0,21300,81200,0,102500
140340201800000,NE 117,RESIDENTIAL,25400,0,25400,85100,0,110500
140340201900000,NE 117,RESIDENTIAL,22700,0,22700,75600,0,98300
140340202000000,NE 117,RESIDENTIAL,23500,0,23500,95000,0,118500
140340202100000,NE 117,RESIDENTIAL,24400,0,24400,82800,0,107200
140340202200000,NE 117,RESIDENTIAL,24400,0,24400,73300,0,97700
140340202300000,NE 117,RESIDENTIAL,24400,0,24400,86400,0,110800
140340202400000,NE 117,RESIDENTIAL,24400,0,24400,91800,0,116200
140340202500000,NE 117,RESIDENTIAL,30200,0,30200,0,0,30200
140340202600000,NE 117,RESIDENTIAL,38400,0,38400,102400,0,140800
140340202700000,NE 117,RESIDENTIAL,23500,0,23500,84800,0,108300
140340202800000,NE 117,RESIDENTIAL,24600,0,24600,78500,0,103100
140340202900000,NE 117,RESIDENTIAL,25300,0,25300,83500,0,108800
140340203000000,NE 117,RESIDENTIAL,25300,0,25300,82800,0,108100
140340203100000,NE 117,RESIDENTIAL,25300,0,25300,82100,0,107400
140340203200000,NE 117,RESIDENTIAL,25300,0,25300,84400,0,109700
140340300100000,NE 117,RESIDENTIAL,28100,0,28100,89400,0,117500
140340300200000,NE 117,RESIDENTIAL,29100,0,29100,68900,0,98000
140340300300000,NE 117,RESIDENTIAL,22600,0,22600,85700,0,108300
140340300400000,NE 117,RESIDENTIAL,22600,0,22600,80600,0,103200
140340300500000,NE 117,RESIDENTIAL,22600,0,22600,91300,0,113900
140340300600000,NE 117,RESIDENTIAL,22600,0,22600,85900,0,108500
140340300700000,NE 117,RESIDENTIAL,22600,0,22600,73700,0,96300
140340300800000,NE 117,RESIDENTIAL,22600,0,22600,91500,0,114100
140340300900000,NE 117,RESIDENTIAL,22600,0,22600,78700,0,101300
140340301000000,NE 117,RESIDENTIAL,24200,0,24200,93600,0,117800
140340301100000,NE 117,RESIDENTIAL,27200,0,27200,96100,0,123300
140340301200000,NE 117,RESIDENTIAL,27000,0,27000,93600,0,120600
140340301300000,NE 117,RESIDENTIAL,27300,0,27300,90800,0,118100
140340301400000,NE 117,RESIDENTIAL,25300,0,25300,88900,0,114200
140340301500000,NE 117,RESIDENTIAL,25300,0,25300,80900,0,106200
140340301600000,NE 117,RESIDENTIAL,25300,0,25300,89700,0,115000
140340301700000,NE 117,RESIDENTIAL,25300,0,25300,78000,0,103300
140340301800000,NE 117,RESIDENTIAL,25300,0,25300,86700,0,112000
140340301900000,NE 117,RESIDENTIAL,25300,0,25300,82500,0,107800
140340302000000,NE 117,RESIDENTIAL,25300,0,25300,79500,0,104800
140340400100000,OFFICE,COMMERCIAL,0,137000,137000,0,243200,380200
140340400200000,CITY PROPERTY,EXEMPT,0,43600,43600,0,109300,152900
140340400300000,NE 116,RESIDENTIAL,43600,0,43600,78400,0,122000
140340400400000,NE 116,RESIDENTIAL,43600,0,43600,97100,0,140700
140340400500000,NE 116,RESIDENTIAL,43600,0,43600,83800,0,127400
140340400600000,NE 116,RESIDENTIAL,28100,0,28100,121800,0,149900
140340400700000,NE 116,RESIDENTIAL,30400,0,30400,134200,0,164600
140340400800000,NE 116,EXEMPT,0,32600,32600,0,95000,127600
140340400900000,NE 116,RESIDENTIAL,30500,0,30500,117300,0,147800
140340401000000,NE 116,RESIDENTIAL,32300,0,32300,132800,0,165100
140340401100000,NE 116,RESIDENTIAL,28100,0,28100,117100,0,145200
140340401200000,CITY PROPERTY,EXEMPT,0,0,0,0,0,0
140340401300000,CITY PROPERTY,EXEMPT,0,0,0,0,0,0
140340401400000,CITY PROPERTY,EXEMPT,0,0,0,0,0,0
140340500100000,CHURCH,EXEMPT,0,73500,73500,0,163100,236600
140340500200000,NE 116,RESIDENTIAL,43600,0,43600,111400,0,155000
140340500300000,NE 116,RESIDENTIAL,43600,0,43600,91300,0,134900
140340500400000,NE 116,RESIDENTIAL,43600,0,43600,109500,0,153100
140340500500000,NE 116,RESIDENTIAL,43600,0,43600,88500,0,132100
140340500600000,NE 116,RESIDENTIAL,43600,0,43600,94700,0,138300
140340500700000,NE 116,RESIDENTIAL,34000,0,34000,141100,0,175100
140340500800000,NE 116,RESIDENTIAL,32700,0,32700,153800,0,186500
140340500900000,NE 116,RESIDENTIAL,32700,0,32700,148500,0,181200
140340501000000,NE 116,RESIDENTIAL,32700,0,32700,141500,0,174200
140340501100000,NE 116,RESIDENTIAL,32700,0,32700,148400,0,181100
140340501200000,NE 116,RESIDENTIAL,32700,0,32700,163100,0,195800
140340600100000,NE 116,RESIDENTIAL,37700,0,37700,99400,0,137100
140340600200000,NE 116,RESIDENTIAL,39200,0,39200,153700,0,192900
140340600300000,NE 116,RESIDENTIAL,32100,0,32100,195000,0,227100
140340600400000,NE 116,RESIDENTIAL,41700,0,41700,143200,0,184900
140342600100000,NE 117,RESIDENTIAL,31700,0,31700,95100,0,126800
140342600200000,NE 117,RESIDENTIAL,20700,0,20700,59200,0,79900
140342600300000,NE 117,RESIDENTIAL,19000,0,19000,91400,0,110400
140342600400000,NE 117,RESIDENTIAL,29300,0,29300,66100,0,95400
140342600500000,NE 117,RESIDENTIAL,26300,0,26300,85800,0,112100
140342600600000,NE 117,RESIDENTIAL,28500,0,28500,55100,0,83600
140342600700000,NE 117,RESIDENTIAL,30100,0,30100,101700,0,131800
140342600800000,NE 117,RESIDENTIAL,26000,0,26000,81600,0,107600
140342600900000,NE 117,RESIDENTIAL,27200,0,27200,90300,0,117500
140342601000000,NE 117,RESIDENTIAL,26400,0,26400,81200,0,107600
140342601100000,NE 117,RESIDENTIAL,28600,0,28600,74700,0,103300
140342601200000,NE 117,RESIDENTIAL,24400,0,24400,82700,0,107100
140342601300000,NE 117,RESIDENTIAL,25400,0,25400,80400,0,105800
140342601400000,NE 117,RESIDENTIAL,24900,0,24900,95800,0,120700
140342601500000,NE 117,RESIDENTIAL,24200,0,24200,88200,0,112400
140342700100000,CHURCH,EXEMPT,0,781200,781200,0,287600,1068800
140342700200000,NE 117,RESIDENTIAL,25900,0,25900,102700,0,128600
140342700300000,NE 117,RESIDENTIAL,23000,0,23000,80200,0,103200
140342700400000,NE 117,RESIDENTIAL,26100,0,26100,72700,0,98800
140342700500000,NE 117,RESIDENTIAL,24300,0,24300,98600,0,122900
140342700600000,NE 117,RESIDENTIAL,23900,0,23900,75700,0,99600
140342700700000,NE 117,RESIDENTIAL,23700,0,23700,79100,0,102800
140342700800000,NE 117,RESIDENTIAL,23700,0,23700,92300,0,116000
140342700900000,NE 117,RESIDENTIAL,24200,0,24200,84900,0,109100
140342701000000,NE 117,RESIDENTIAL,24900,0,24900,83300,0,108200
140342701100000,NE 117,RESIDENTIAL,23900,0,23900,85100,0,109000
140342701200000,NE 117,RESIDENTIAL,25300,0,25300,74100,0,99400
140342701300000,NE 117,RESIDENTIAL,24500,0,24500,109800,0,134300
140342701400000,NE 117,RESIDENTIAL,29600,0,29600,89400,0,119000
140342701500000,NE 117,RESIDENTIAL,25700,0,25700,63300,0,89000
140342701600000,NE 117,RESIDENTIAL,26800,0,26800,66600,0,93400
140342701700000,NE 117,RESIDENTIAL,29100,0,29100,69600,0,98700
140342800100000,NE 117,RESIDENTIAL,24700,0,24700,85900,0,110600
140342800200000,NE 117,RESIDENTIAL,23300,0,23300,78800,0,102100
140342800300000,NE 117,RESIDENTIAL,23300,0,23300,75900,0,99200
140342800400000,NE 117,RESIDENTIAL,23300,0,23300,76100,0,99400
140342800500000,NE 117,RESIDENTIAL,23300,0,23300,94400,0,117700
140342800600000,NE 117,RESIDENTIAL,23300,0,23300,87000,0,110300
140342800700000,NE 117,RESIDENTIAL,23300,0,23300,86000,0,109300
140342800800000,NE 117,RESIDENTIAL,24800,0,24800,92100,0,116900
140342900100000,NE 117,RESIDENTIAL,28600,0,28600,86200,0,114800
140342900200000,NE 117,RESIDENTIAL,26500,0,26500,101800,0,128300
140342900300000,NE 117,RESIDENTIAL,27000,0,27000,82300,0,109300
140342900400000,NE 117,RESIDENTIAL,27600,0,27600,76700,0,104300
140342900500000,NE 117,RESIDENTIAL,26500,0,26500,83200,0,109700
140342900600000,NE 117,RESIDENTIAL,25700,0,25700,77300,0,103000
140342900700000,NE 117,RESIDENTIAL,24500,0,24500,74100,0,98600
140342900800000,NE 117,RESIDENTIAL,24300,0,24300,68700,0,93000
140342900900000,NE 117,RESIDENTIAL,23700,0,23700,54600,0,78300
140342901000000,NE 117,RESIDENTIAL,23600,0,23600,69100,0,92700
140342901100000,NE 117,RESIDENTIAL,23500,0,23500,77100,0,100600
140342901200000,NE 117,RESIDENTIAL,23500,0,23500,75100,0,98600
140342901300000,NE 117,RESIDENTIAL,23500,0,23500,70700,0,94200
140342901400000,NE 117,RESIDENTIAL,23500,0,23500,74600,0,98100
140342901500000,NE 117,RESIDENTIAL,23500,0,23500,70800,0,94300
140342901600000,NE 117,RESIDENTIAL,23500,0,23500,72600,0,96100
140342901700000,NE 117,RESIDENTIAL,23700,0,23700,71300,0,95000
140342901800000,NE 117,RESIDENTIAL,26100,0,26100,91100,0,117200
140342901900000,NE 117,RESIDENTIAL,23000,0,23000,92000,0,115000
140342902000000,NE 117,RESIDENTIAL,26100,0,26100,102400,0,128500
140342902100000,NE 117,RESIDENTIAL,21700,0,21700,72400,0,94100
140342902200000,NE 117,RESIDENTIAL,23700,0,23700,66200,0,89900
140342902300000,NE 117,RESIDENTIAL,24100,0,24100,81600,0,105700
140342902400000,NE 117,RESIDENTIAL,24100,0,24100,88000,0,112100
140342902500000,NE 117,RESIDENTIAL,24100,0,24100,84100,0,108200
140342902600000,NE 117,RESIDENTIAL,23900,0,23900,50000,0,73900
140342902700000,NE 117,RESIDENTIAL,23900,0,23900,76100,0,100000
140342902800000,NE 117,RESIDENTIAL,24400,0,24400,79500,0,103900
140342902900000,NE 117,RESIDENTIAL,24700,0,24700,114200,0,138900
140342903000000,NE 117,RESIDENTIAL,25500,0,25500,82200,0,107700
140342903100000,NE 117,RESIDENTIAL,26900,0,26900,76500,0,103400
140342903200000,NE 117,RESIDENTIAL,27600,0,27600,132100,0,159700
140342903300000,NE 117,RESIDENTIAL,27500,0,27500,103700,0,131200
140342903400000,NE 117,RESIDENTIAL,28600,0,28600,86400,0,115000
140342903500000,NE 117,RESIDENTIAL,21600,0,21600,80500,0,102100
140342903600000,NE 117,RESIDENTIAL,23100,0,23100,112600,0,135700
140342903700000,NE 117,RESIDENTIAL,23100,0,23100,66900,0,90000
140342903800000,NE 117,RESIDENTIAL,24800,0,24800,47600,0,72400
140342903900000,NE 117,RESIDENTIAL,28400,0,28400,80600,0,109000
140342904000000,NE 117,RESIDENTIAL,22800,0,22800,83700,0,106500
140343000100000,NE 117,RESIDENTIAL,25400,0,25400,55900,0,81300
140343000200000,NE 117,RESIDENTIAL,21300,0,21300,78900,0,100200
140343000300000,NE 117,RESIDENTIAL,21300,0,21300,81100,0,102400
140343000400000,NE 117,RESIDENTIAL,21300,0,21300,78100,0,99400
140343000500000,NE 117,RESIDENTIAL,23300,0,23300,82800,0,106100
140343000600000,NE 117,RESIDENTIAL,23300,0,23300,77300,0,100600
140343000700000,NE 117,RESIDENTIAL,23300,0,23300,99900,0,123200
140343000800000,NE 117,RESIDENTIAL,23300,0,23300,89800,0,113100
140343000900000,NE 117,RESIDENTIAL,23300,0,23300,84000,0,107300
140343001000000,NE 117,RESIDENTIAL,23300,0,23300,74000,0,97300
140343001100000,NE 117,RESIDENTIAL,23300,0,23300,97400,0,120700
140343001200000,NE 117,RESIDENTIAL,23300,0,23300,86700,0,110000
140343001300000,NE 117,RESIDENTIAL,23300,0,23300,75000,0,98300
140343001400000,NE 117,RESIDENTIAL,42800,0,42800,62400,0,105200
140343001500000,NE 117,RESIDENTIAL,24900,0,24900,71000,0,95900
140343001600000,NE 117,RESIDENTIAL,30100,0,30100,79200,0,109300
140343001700000,NE 117,RESIDENTIAL,25400,0,25400,65600,0,91000
140343001800000,NE 117,RESIDENTIAL,12600,0,12600,0,0,12600
140343001900000,NE 117,RESIDENTIAL,27300,0,27300,106700,0,134000
140343100100000,NE 117,RESIDENTIAL,28600,0,28600,66100,0,94700
140343100200000,NE 117,RESIDENTIAL,24300,0,24300,79600,0,103900
140343100300000,NE 117,RESIDENTIAL,23500,0,23500,82800,0,106300
140343100400000,NE 117,RESIDENTIAL,24300,0,24300,84800,0,109100
140343100500000,NE 117,RESIDENTIAL,24300,0,24300,88700,0,113000
140343100600000,NE 117,RESIDENTIAL,24300,0,24300,75800,0,100100
140343100700000,NE 117,RESIDENTIAL,24300,0,24300,86000,0,110300
140343100800000,NE 117,RESIDENTIAL,24300,0,24300,92600,0,116900
140343100900000,NE 117,RESIDENTIAL,24300,0,24300,94300,0,118600
140343101000000,NE 117,RESIDENTIAL,24300,0,24300,66100,0,90400
140343101100000,NE 117,RESIDENTIAL,24300,0,24300,92400,0,116700
140343101200000,NE 117,RESIDENTIAL,25500,0,25500,88300,0,113800
140343101300000,NE 117,RESIDENTIAL,26100,0,26100,81100,0,107200
140343101400000,NE 117,RESIDENTIAL,23000,0,23000,78500,0,101500
140343101500000,NE 117,RESIDENTIAL,26100,0,26100,97000,0,123100
140343101600000,NE 117,RESIDENTIAL,22200,0,22200,79100,0,101300
140343101700000,NE 117,RESIDENTIAL,24800,0,24800,68600,0,93400
140343101800000,NE 117,RESIDENTIAL,22300,0,22300,56200,0,78500
140343101900000,NE 117,RESIDENTIAL,22900,0,22900,92700,0,115600
140343102000000,NE 117,RESIDENTIAL,22300,0,22300,101300,0,123600
140343102100000,NE 117,RESIDENTIAL,22900,0,22900,102600,0,125500
140343102200000,NE 117,RESIDENTIAL,22300,0,22300,83700,0,106000
140343102300000,NE 117,RESIDENTIAL,24800,0,24800,91600,0,116400
140343102400000,NE 117,RESIDENTIAL,23500,0,23500,82100,0,105600
140343102500000,NE 117,RESIDENTIAL,28600,0,28600,98800,0,127400
140343102600000,NE 117,RESIDENTIAL,22600,0,22600,86900,0,109500
140343200100000,NE 117,RESIDENTIAL,24800,0,24800,85600,0,110400
140343200200000,NE 117,RESIDENTIAL,22900,0,22900,90500,0,113400
140343200300000,NE 117,RESIDENTIAL,22900,0,22900,88100,0,111000
140343200400000,NE 117,RESIDENTIAL,22900,0,22900,96000,0,118900
140343200500000,NE 117,RESIDENTIAL,22900,0,22900,87500,0,110400
140343200600000,NE 117,RESIDENTIAL,22900,0,22900,83700,0,106600
140343200700000,NE 117,RESIDENTIAL,22900,0,22900,100500,0,123400
140343200800000,NE 117,RESIDENTIAL,22900,0,22900,78400,0,101300
140343200900000,NE 117,RESIDENTIAL,23200,0,23200,104500,0,127700
140343201000000,NE 117,RESIDENTIAL,22500,0,22500,87000,0,109500
140343300100000,NE 117,RESIDENTIAL,25500,0,25500,83800,0,109300
140343300200000,NE 117,RESIDENTIAL,22800,0,22800,79500,0,102300
140343300300000,NE 117,RESIDENTIAL,22500,0,22500,87800,0,110300
140343300400000,NE 117,RESIDENTIAL,22400,0,22400,94500,0,116900
140343300500000,NE 117,RESIDENTIAL,22400,0,22400,80000,0,102400
140343300600000,NE 117,RESIDENTIAL,22400,0,22400,83700,0,106100
140343300700000,NE 117,RESIDENTIAL,22400,0,22400,83100,0,105500
140343300800000,NE 117,RESIDENTIAL,21900,0,21900,79800,0,101700
140343300900000,NE 117,RESIDENTIAL,24600,0,24600,88900,0,113500
140343301000000,NE 117,RESIDENTIAL,23000,0,23000,114700,0,137700
140343301100000,NE 117,RESIDENTIAL,24600,0,24600,91000,0,115600
140343301200000,NE 117,RESIDENTIAL,23400,0,23400,76600,0,100000
140343301300000,NE 117,RESIDENTIAL,24600,0,24600,88900,0,113500
140343301400000,NE 117,RESIDENTIAL,25100,0,25100,61900,0,87000
140343301500000,NE 117,RESIDENTIAL,25200,0,25200,80400,0,105600
140343301600000,NE 117,RESIDENTIAL,30100,0,30100,75000,0,105100
140343301700000,NE 117,RESIDENTIAL,22600,0,22600,82400,0,105000
140343400100000,NE 117,RESIDENTIAL,24200,0,24200,89300,0,113500
140343400200000,NE 117,RESIDENTIAL,25400,0,25400,88100,0,113500
140343400300000,NE 117,RESIDENTIAL,24900,0,24900,106400,0,131300
140343400400000,NE 117,RESIDENTIAL,24800,0,24800,95500,0,120300
140345100100000,NE 117,RESIDENTIAL,29600,0,29600,75300,0,104900
140345100200000,NE 117,RESIDENTIAL,28700,0,28700,57200,0,85900
140345100300000,NE 117,RESIDENTIAL,22900,0,22900,69200,0,92100
140345100400000,NE 117,RESIDENTIAL,23600,0,23600,79300,0,102900
140345100500000,NE 117,RESIDENTIAL,25100,0,25100,83700,0,108800
140345100600000,NE 117,RESIDENTIAL,24800,0,24800,87500,0,112300
140345200100000,NE 117,RESIDENTIAL,27100,0,27100,101100,0,128200
140345200200000,NE 117,RESIDENTIAL,23300,0,23300,79900,0,103200
140345200300000,NE 117,RESIDENTIAL,23300,0,23300,79700,0,103000
140345200400000,NE 117,RESIDENTIAL,23300,0,23300,69700,0,93000
140345200500000,NE 117,RESIDENTIAL,23300,0,23300,90600,0,113900
140345200600000,NE 117,RESIDENTIAL,23300,0,23300,92700,0,116000
140345200700000,NE 117,RESIDENTIAL,23300,0,23300,64300,0,87600
140345200800000,NE 117,RESIDENTIAL,23300,0,23300,86700,0,110000
140345200900000,NE 117,RESIDENTIAL,23300,0,23300,83100,0,106400
140345201000000,NE 117,RESIDENTIAL,23300,0,23300,89300,0,112600
140345201100000,NE 117,RESIDENTIAL,23300,0,23300,87600,0,110900
140345201200000,NE 117,RESIDENTIAL,23300,0,23300,90600,0,113900
140345201300000,NE 117,RESIDENTIAL,23300,0,23300,100900,0,124200
140345201400000,NE 117,RESIDENTIAL,23300,0,23300,95800,0,119100
140345201500000,NE 117,RESIDENTIAL,27100,0,27100,86800,0,113900
140345201600000,NE 117,RESIDENTIAL,20300,0,20300,81800,0,102100
140345300100000,NE 117,RESIDENTIAL,21700,0,21700,80100,0,101800
140345300200000,NE 117,RESIDENTIAL,21300,0,21300,77600,0,98900
140345300300000,NE 117,RESIDENTIAL,21300,0,21300,72500,0,93800
140345300400000,NE 117,RESIDENTIAL,21300,0,21300,73300,0,94600
140345300500000,NE 117,RESIDENTIAL,21300,0,21300,68600,0,89900
140345300600000,NE 117,RESIDENTIAL,21300,0,21300,82800,0,104100
140345300700000,NE 117,RESIDENTIAL,21300,0,21300,78100,0,99400
140345300800000,NE 117,RESIDENTIAL,21300,0,21300,103500,0,124800
140345300900000,NE 117,RESIDENTIAL,21300,0,21300,80900,0,102200
140345301000000,NE 117,RESIDENTIAL,21300,0,21300,75100,0,96400
140345301100000,NE 117,RESIDENTIAL,21300,0,21300,87100,0,108400
140345301200000,NE 117,RESIDENTIAL,21300,0,21300,83000,0,104300
140345301300000,NE 117,RESIDENTIAL,21300,0,21300,86900,0,108200
140345301400000,NE 117,RESIDENTIAL,21300,0,21300,72200,0,93500
140345301500000,NE 117,RESIDENTIAL,21300,0,21300,76300,0,97600
140345301600000,NE 117,RESIDENTIAL,21300,0,21300,71300,0,92600
140345301700000,NE 117,RESIDENTIAL,21300,0,21300,79500,0,100800
140345301800000,NE 117,RESIDENTIAL,21700,0,21700,65500,0,87200
140345301900000,NE 117,RESIDENTIAL,20300,0,20300,74000,0,94300
140345400100000,NE 117,RESIDENTIAL,22500,0,22500,79200,0,101700
140345400200000,NE 117,RESIDENTIAL,21400,0,21400,59100,0,80500
140345400300000,NE 117,RESIDENTIAL,21600,0,21600,56200,0,77800
140345400400000,NE 117,RESIDENTIAL,21600,0,21600,76000,0,97600
140345400500000,NE 117,RESIDENTIAL,21400,0,21400,58000,0,79400
140345400600000,NE 117,RESIDENTIAL,24400,0,24400,76500,0,100900
140345400700000,NE 117,RESIDENTIAL,29000,0,29000,67000,0,96000
140345500100000,NE 117,RESIDENTIAL,31700,0,31700,82500,0,114200
140345500200000,NE 117,EXEMPT,0,47500,47500,0,85800,133300
140345500300000,CHURCH,EXEMPT,0,184300,184300,0,75500,259800
140345500400000,NE 117,RESIDENTIAL,40400,0,40400,125400,0,165800
140345500500000,NE 117,RESIDENTIAL,20900,0,20900,79900,0,100800
140345500600000,NE 117,RESIDENTIAL,22800,0,22800,27000,0,49800
140345500700000,NE 117,RESIDENTIAL,26300,0,26300,102600,0,128900
140345500800000,NE 117,RESIDENTIAL,27500,0,27500,84600,0,112100
140345500900000,NE 117,RESIDENTIAL,25600,0,25600,87700,0,113300
140345501000000,NE 117,RESIDENTIAL,25000,0,25000,82500,0,107500
140345501100000,NE 117,RESIDENTIAL,25000,0,25000,115300,0,140300
140345501200000,NE 117,RESIDENTIAL,25100,0,25100,99500,0,124600
140345501300000,NE 117,RESIDENTIAL,25000,0,25000,89700,0,114700
140345501400000,NE 117,RESIDENTIAL,25000,0,25000,100300,0,125300
140345501500000,NE 117,RESIDENTIAL,25000,0,25000,107800,0,132800
140345501600000,NE 117,RESIDENTIAL,25000,0,25000,119600,0,144600
140345501700000,NE 117,RESIDENTIAL,25000,0,25000,58300,0,83300
140345501800000,NE 117,RESIDENTIAL,24300,0,24300,69000,0,93300
140345501900000,NE 117,RESIDENTIAL,34200,0,34200,92900,0,127100
140345502000000,NE 117,RESIDENTIAL,4900,0,4900,1100,0,6000
140345502100000,NE 117,RESIDENTIAL,29100,0,29100,69900,0,99000
140345502200000,NE 117,RESIDENTIAL,5000,0,5000,0,0,5000
140345502300000,NE 117,RESIDENTIAL,29400,0,29400,86100,0,115500
140345502400000,NE 117,RESIDENTIAL,33800,0,33800,94400,0,128200
140345502500000,NE 117,RESIDENTIAL,4400,0,4400,0,0,4400
140345502600000,NE 117,RESIDENTIAL,29100,0,29100,127600,0,156700
140345502700000,NE 117,RESIDENTIAL,29100,0,29100,100700,0,129800
140345502800000,NE 117,RESIDENTIAL,29100,0,29100,144300,0,173400
140345502900000,NE 117,RESIDENTIAL,28800,0,28800,137300,0,166100
140345600100000,NE 117,RESIDENTIAL,31600,0,31600,53600,0,85200
140345600200000,NE 117,RESIDENTIAL,30000,0,30000,84500,0,114500
140345600300000,NE 117,RESIDENTIAL,28200,0,28200,70600,0,98800
140345600400000,NE 117,RESIDENTIAL,34700,0,34700,159900,0,194600
140345600500000,NE 117,RESIDENTIAL,29300,0,29300,83400,0,112700
140345600600000,APARTMENT,MULTI-RES,336000,0,336000,1890800,0,2226800
140345600700000,NE 117,RESIDENTIAL,36700,0,36700,101800,0,138500
140345600800000,NE 117,RESIDENTIAL,32900,0,32900,119900,0,152800
140345600900000,NE 117,RESIDENTIAL,33800,0,33800,116800,0,150600
140345601000000,NE 117,RESIDENTIAL,33800,0,33800,65400,0,99200
140345601100000,NE 117,RESIDENTIAL,33700,0,33700,96900,0,130600
140345601200000,NE 117,RESIDENTIAL,30700,0,30700,103400,0,134100
140345601300000,NE 117,RESIDENTIAL,35400,0,35400,98800,0,134200
140345601400000,NE 117,RESIDENTIAL,30500,0,30500,94400,0,124900
140345700100000,NE 117,RESIDENTIAL,38900,0,38900,81200,0,120100
140345700200000,NE 117,RESIDENTIAL,25000,0,25000,94400,0,119400
140345700300000,NE 117,RESIDENTIAL,25000,0,25000,92200,0,117200
140345700400000,NE 117,RESIDENTIAL,25000,0,25000,70000,0,95000
140345700500000,NE 117,RESIDENTIAL,25000,0,25000,70000,0,95000
140345700600000,NE 117,RESIDENTIAL,25000,0,25000,80300,0,105300
140345700700000,NE 117,RESIDENTIAL,25000,0,25000,101500,0,126500
140345700800000,NE 117,RESIDENTIAL,25000,0,25000,88900,0,113900
140345700900000,NE 117,RESIDENTIAL,25000,0,25000,114900,0,139900
140345701000000,NE 117,RESIDENTIAL,24300,0,24300,74500,0,98800
140345701100000,NE 116,RESIDENTIAL,14600,0,14600,56100,0,70700
140345701200000,NE 116,RESIDENTIAL,20400,0,20400,110400,0,130800
140345701300000,NE 116,RESIDENTIAL,27900,0,27900,112800,0,140700
140345701400000,NE 116,RESIDENTIAL,27900,0,27900,101900,0,129800
140345701500000,NE 116,RESIDENTIAL,27900,0,27900,134400,0,162300
140345701600000,NE 116,RESIDENTIAL,31300,0,31300,159900,0,191200
140345701700000,NE 116,RESIDENTIAL,30000,0,30000,140400,0,170400
140345701800000,NE 116,RESIDENTIAL,30000,0,30000,85800,0,115800
140345800100000,NE 116,RESIDENTIAL,27600,0,27600,115300,0,142900
140345800200000,NE 116,RESIDENTIAL,27600,0,27600,118800,0,146400
140345800300000,NE 116,RESIDENTIAL,27600,0,27600,114000,0,141600
140345800400000,NE 116,RESIDENTIAL,25000,0,25000,108800,0,133800
140347600100000,NE 116,RESIDENTIAL,32100,0,32100,129900,0,162000
140347600200000,NE 116,RESIDENTIAL,32100,0,32100,181800,0,213900
140347600300000,NE 116,RESIDENTIAL,32100,0,32100,146400,0,178500
140347600400000,NE 116,RESIDENTIAL,32100,0,32100,131200,0,163300
140347700100000,NE 116,RESIDENTIAL,44700,0,44700,233800,0,278500
140347700200000,NE 116,RESIDENTIAL,39800,0,39800,199900,0,239700
140347700300000,NE 116,RESIDENTIAL,32100,0,32100,177200,0,209300
140347700400000,NE 116,RESIDENTIAL,32100,0,32100,165600,0,197700
140347700500000,NE 116,RESIDENTIAL,32100,0,32100,121800,0,153900
140347700600000,NE 116,RESIDENTIAL,32500,0,32500,113500,0,146000
140347700700000,NE 116,RESIDENTIAL,33100,0,33100,177300,0,210400
140347700800000,NE 116,RESIDENTIAL,32100,0,32100,127300,0,159400
140347700900000,NE 116,RESIDENTIAL,32100,0,32100,103900,0,136000
140347701000000,NE 116,RESIDENTIAL,32100,0,32100,100100,0,132200
140347701100000,NE 116,RESIDENTIAL,32100,0,32100,100500,0,132600
140347800100000,NE 116,RESIDENTIAL,32700,0,32700,136100,0,168800
140347800200000,NE 116,RESIDENTIAL,35300,0,35300,116400,0,151700
140347800300000,NE 116,RESIDENTIAL,34700,0,34700,162500,0,197200
140347800400000,NE 116,RESIDENTIAL,34800,0,34800,114200,0,149000
140347900100000,NE 116,RESIDENTIAL,32100,0,32100,120100,0,152200
140347900200000,NE 116,RESIDENTIAL,32100,0,32100,187900,0,220000
140347900300000,NE 116,RESIDENTIAL,32100,0,32100,126500,0,158600
140347900400000,NE 116,RESIDENTIAL,29200,0,29200,158600,0,187800
140347900500000,NE 116,RESIDENTIAL,30400,0,30400,145300,0,175700
140347900600000,NE 116,RESIDENTIAL,33800,0,33800,261000,0,294800
140347900700000,NE 116,RESIDENTIAL,29800,0,29800,141700,0,171500
140347900800000,NE 116,RESIDENTIAL,33700,0,33700,110400,0,144100
140347900900000,NE 116,RESIDENTIAL,30400,0,30400,129800,0,160200
140347901000000,NE 116,RESIDENTIAL,32100,0,32100,88400,0,120500
140347901100000,NE 116,RESIDENTIAL,32100,0,32100,112400,0,144500
140347901200000,NE 116,RESIDENTIAL,32100,0,32100,142500,0,174600
140347901300000,NE 116,RESIDENTIAL,32100,0,32100,141400,0,173500
140347901400000,NE 116,RESIDENTIAL,33400,0,33400,102800,0,136200
140347901500000,NE 116,RESIDENTIAL,31400,0,31400,122800,0,154200
140347901600000,NE 116,RESIDENTIAL,32100,0,32100,97300,0,129400
140347901700000,NE 116,RESIDENTIAL,32100,0,32100,107200,0,139300
140347901800000,NE 116,RESIDENTIAL,32100,0,32100,93700,0,125800
140347901900000,NE 116,RESIDENTIAL,32100,0,32100,79100,0,111200
140348000100000,NE 116,RESIDENTIAL,36000,0,36000,130800,0,166800
140348000200000,NE 116,RESIDENTIAL,26500,0,26500,180000,0,206500
140348000300000,NE 116,RESIDENTIAL,32400,0,32400,132400,0,164800
140348000400000,NE 116,RESIDENTIAL,32400,0,32400,91700,0,124100
140348000500000,NE 116,RESIDENTIAL,32400,0,32400,152100,0,184500
140348000600000,NE 116,RESIDENTIAL,33200,0,33200,128200,0,161400
140348000700000,NE 116,RESIDENTIAL,33900,0,33900,192200,0,226100
140348000800000,NE 116,RESIDENTIAL,32100,0,32100,118400,0,150500
140348000900000,NE 116,RESIDENTIAL,32100,0,32100,116600,0,148700
140348001000000,NE 116,RESIDENTIAL,32100,0,32100,179600,0,211700
140348001100000,NE 116,RESIDENTIAL,32100,0,32100,76700,0,108800
140348001200000,NE 116,RESIDENTIAL,33400,0,33400,110100,0,143500
140348001300000,NE 116,RESIDENTIAL,33700,0,33700,105100,0,138800
140348001400000,NE 116,RESIDENTIAL,30300,0,30300,114200,0,144500
140348001500000,NE 116,RESIDENTIAL,34500,0,34500,127100,0,161600
140348001600000,NE 116,RESIDENTIAL,31600,0,31600,127200,0,158800
140348001700000,NE 116,RESIDENTIAL,31500,0,31500,180400,0,211900
140348001800000,NE 116,RESIDENTIAL,32400,0,32400,116500,0,148900
140348100100000,NE 116,RESIDENTIAL,32800,0,32800,98700,0,131500
140348100200000,NE 116,RESIDENTIAL,32100,0,32100,91400,0,123500
140348100300000,NE 116,RESIDENTIAL,32100,0,32100,140800,0,172900
140348100400000,NE 116,RESIDENTIAL,32100,0,32100,118900,0,151000
140348100500000,NE 116,RESIDENTIAL,32100,0,32100,94500,0,126600
140348100600000,NE 116,RESIDENTIAL,31100,0,31100,93500,0,124600
140348200100000,NE 116,RESIDENTIAL,32800,0,32800,108500,0,141300
140348200200000,NE 116,RESIDENTIAL,32100,0,32100,74000,0,106100
140348200300000,NE 116,RESIDENTIAL,32100,0,32100,123200,0,155300
140348200400000,NE 116,RESIDENTIAL,32100,0,32100,123300,0,155400
140348200500000,NE 116,RESIDENTIAL,32100,0,32100,84400,0,116500
140348200600000,NE 116,RESIDENTIAL,34400,0,34400,130800,0,165200
140410100200000,WAREHOUSE,COMMERCIAL,0,444500,444500,0,431400,875900
140410100300000,CENTRALLY ASSESSED,OTHER,0,0,0,0,0,0
140410100400000,WAREHOUSE,COMMERCIAL,0,348800,348800,0,362700,711500
140410100500000,EQUIPMENT MFG;INDUST,INDUSTRIAL,0,288800,288800,0,1643500,1932300
140410100600000,OFFICE,COMMERCIAL,0,420000,420000,0,481400,901400
140410100800000,OFFICE,COMMERCIAL,0,407000,407000,0,1854900,2261900
140410200100000,WAREHOUSE,COMMERCIAL,0,784500,784500,0,3299100,4083600
140410200200000,PAPER; INDUSTRIAL,INDUSTRIAL,0,1055200,1055200,0,3579700,4634900
140410200300000,VACANT LAND,COMMERCIAL,0,1400,1400,0,0,1400
140412600100000,CENTRALLY ASSESSED,OTHER,0,0,0,0,0,0
140412600200000,SMALL RETAIL,COMMERCIAL,0,134700,134700,0,242200,376900
140412600300000,VETERINARY CLINIC,COMMERCIAL,0,95900,95900,0,178600,274500
140412600400000,SMALL RETAIL,COMMERCIAL,42732,75968,118700,49392,93908,262000
140412600500000,SMALL RETAIL,COMMERCIAL,0,167500,167500,0,153100,320600
140412600502000,BILLBOARD(BLL),COMMERCIAL,0,0,0,0,56900,56900
140412600600000,FLAT PARKING,COMMERCIAL,0,0,0,0,8000,8000
140412600700000,AUTO REPAIR/SALES,COMMERCIAL,0,90000,90000,0,224900,314900
140412600800000,FLAT PARKING,COMMERCIAL,0,71800,71800,0,6800,78600
140412600900000,SHOP,COMMERCIAL,0,93000,93000,0,139800,232800
140412601000000,FLAT PARKING,COMMERCIAL,0,2400,2400,0,15500,17900
140412601100000,OFFICE,COMMERCIAL,0,151900,151900,0,292800,444700
140412601200000,OFFICE,COMMERCIAL,0,140400,140400,0,526000,666400
140412601300000,VACANT LAND,COMMERCIAL,0,60000,60000,0,0,60000
140412601400000,RESTAURANT,COMMERCIAL,0,267500,267500,0,190700,458200
140412602500000,FLAT PARKING,COMMERCIAL,0,3900,3900,0,800,4700
140412900100000,SHOP,COMMERCIAL,0,356300,356300,0,664300,1020600
140412900200000,FLAT PARKING,COMMERCIAL,0,266300,266300,0,0,266300
140412900300000,FLAT PARKING,COMMERCIAL,0,0,0,0,0,0
140413000100000,SMALL RETAIL,COMMERCIAL,0,260000,260000,0,107500,367500
140413000300000,SMALL RETAIL,COMMERCIAL,0,174600,174600,0,405700,580300
140413000400000,OFFICE,COMMERCIAL,0,105900,105900,0,173100,279000
140413000500000,SMALL RETAIL,COMMERCIAL,0,111400,111400,0,414000,525400
140413000600000,FLAT PARKING,COMMERCIAL,0,0,0,0,0,0
140413000700000,VACANT LAND,COMMERCIAL,0,0,0,0,0,0
140413000900000,LG DISCOUNT/RETAIL,COMMERCIAL,0,915600,915600,0,1998000,2913600
140413100100000,LG DISCOUNT/RETAIL,COMMERCIAL,0,292500,292500,0,463700,756200
140413100200000,WAREHOUSE;MINI STORG,COMMERCIAL,0,182500,182500,0,115600,298100
140413100300000,FAST FOOD,COMMERCIAL,0,500000,500000,0,642200,1142200
140413100400000,SMALL RETAIL,COMMERCIAL,0,235000,235000,0,309100,544100
140413100402000,BILLBOARD(BLL),COMMERCIAL,0,0,0,0,53400,53400
140413100500000,LG DISCOUNT/RETAIL,COMMERCIAL,0,210000,210000,0,394300,604300
140413100600000,SMALL RETAIL,COMMERCIAL,0,100200,100200,0,159200,259400
140413100602000,BILLBOARD(BLL),COMMERCIAL,0,0,0,0,14100,14100
140413101100000,OFFICE,COMMERCIAL,0,222500,222500,0,1063600,1286100
140413101200000,VACANT LAND,COMMERCIAL,0,0,0,0,0,0
140413101300000,WAREHOUSE,COMMERCIAL,0,108300,108300,0,182800,291100
140415100100000,VACANT LAND,COMMERCIAL,0,64500,64500,0,0,64500
140415100400000,LG DISCOUNT/RETAIL,COMMERCIAL,0,281400,281400,0,331100,612500
140415100600000,CENTRALLY ASSESSED,OTHER,0,0,0,0,0,0
140415100602000,BILLBOARD(BLL),COMMERCIAL,0,0,0,0,41500,41500
140415200100000,LG DISCOUNT/RETAIL,COMMERCIAL,0,1086700,1086700,0,3543000,4629700
140415200200000,AUTO REPAIR/SALES,COMMERCIAL,0,466100,466100,0,532100,998200
140415200301000,WAREHOUSE,COMMERCIAL,0,69100,69100,0,215300,284400
140415200301001,WAREHOUSE,COMMERCIAL,0,68700,68700,0,235400,304100
140415200301002,SHOP,COMMERCIAL,0,135300,135300,0,279400,414700
140415200400000,AUTO REPAIR/SALES,COMMERCIAL,0,300000,300000,0,359500,659500
140415300200000,OFFICE; MEDICAL,COMMERCIAL,0,831000,831000,0,3343300,4174300
140415300300000,OFFICE; MEDICAL,COMMERCIAL,0,170000,170000,0,589300,759300
140415300400000,NE 111,RESIDENTIAL,65400,0,65400,204000,0,269400
140417600100000,OFFICE,COMMERCIAL,0,114800,114800,0,349700,464500
140417600200000,OFFICE,COMMERCIAL,0,62800,62800,0,399400,462200
140417600400000,AUTO REPAIR/SALES,COMMERCIAL,0,1122800,1122800,0,3011000,4133800
140417600500000,FLAT PARKING,COMMERCIAL,0,595700,595700,0,20700,616400
140417600600000,AUTO REPAIR/SALES,COMMERCIAL,0,450700,450700,0,427100,877800
140417600700000,SHOP,COMMERCIAL,0,147000,147000,0,98000,245000
140417600800000,BRANCH BANK/CU,COMMERCIAL,0,558000,558000,0,425200,983200
140417601000000,FLAT PARKING,COMMERCIAL,0,25200,25200,0,13200,38400
140417601100000,VACANT LAND,COMMERCIAL,0,1400,1400,0,0,1400
140417700100000,AUTO REPAIR/SALES,COMMERCIAL,0,1182500,1182500,0,802100,1984600
140417700200000,SHOP,COMMERCIAL,0,265500,265500,0,309400,574900
140417700300000,VACANT LAND,COMMERCIAL,0,54900,54900,0,0,54900
140417700400000,AUTO REPAIR/SALES,COMMERCIAL,0,244200,244200,0,333600,577800
140417800100000,HIGH TECH/RESEARCH,INDUSTRIAL,0,688500,688500,0,1486400,2174900
140420500100000,LG DISCOUNT/RETAIL,COMMERCIAL,0,795000,795000,0,879700,1674700
140420500200000,FLAT PARKING,COMMERCIAL,0,0,0,0,18300,18300
140420500300000,APARTMENT,RESIDENTIAL,26900,0,26900,300700,0,327600
140420500400000,APARTMENT,RESIDENTIAL,26800,0,26800,300700,0,327500
140420500500000,APARTMENT,RESIDENTIAL,33000,0,33000,317800,0,350800
140420500700000,APARTMENT,RESIDENTIAL,29700,0,29700,301400,0,331100
140420500800000,APARTMENT,MULTI-RES,27300,0,27300,262700,0,290000
140420500900000,APARTMENT,MULTI-RES,598400,0,598400,3609900,0,4208300
140420501000000,SHOP,COMMERCIAL,0,37200,37200,0,70400,107600
140420501100000,RESTAURANT,COMMERCIAL,0,48700,48700,0,68500,117200
140420501200000,RESTAURANT,COMMERCIAL,0,103800,103800,0,152000,255800
140420501300000,SMALL RETAIL,COMMERCIAL,0,113000,113000,0,164900,277900
140420501400000,RESTAURANT,COMMERCIAL,0,183000,183000,0,237600,420600
140420501500000,BARS/LOUNGE,COMMERCIAL,0,115600,115600,0,169300,284900
140420600100000,APARTMENT,RESIDENTIAL,42300,0,42300,380300,0,422600
140420600200000,SMALL RETAIL,COMMERCIAL,0,48600,48600,0,191700,240300
140423100100000,HOTEL,COMMERCIAL,0,546000,546000,0,1428700,1974700
140423100200000,RESTAURANT,COMMERCIAL,0,250500,250500,0,396900,647400
140423100300000,SHOP,COMMERCIAL,0,170000,170000,0,475400,645400
140423100400000,EQUIPMENT MFG;INDUST,INDUSTRIAL,0,346500,346500,0,1331300,1677800
140423100500000,SHOP,COMMERCIAL,0,87200,87200,0,666800,754000
140423100600000,CENTRALLY ASSESSED,OTHER,0,0,0,0,0,0
140423200100000,OFFICE,COMMERCIAL,0,146200,146200,0,286200,432400
140423200200000,SMALL RETAIL,COMMERCIAL,0,157800,157800,0,90500,248300
140423200300000,NBHD SHOPPING CENTER,COMMERCIAL,0,416000,416000,0,1059800,1475800
140425100100000,CITY PROPERTY,EXEMPT,0,0,0,0,0,0
140425200100000,CITY PROPERTY,EXEMPT,0,0,0,0,0,0
140427600300000,WAREHOUSE,COMMERCIAL,0,188700,188700,0,342500,531200
140427600400000,WAREHOUSE,INDUSTRIAL,0,271000,271000,0,1495200,1766200
140427600500000,WAREHOUSE,COMMERCIAL,0,206300,206300,0,582400,788700
140427600600000,WAREHOUSE,COMMERCIAL,0,205200,205200,0,1164700,1369900
140427600700000,WAREHOUSE,COMMERCIAL,0,124800,124800,0,744200,869000
140427600800000,WAREHOUSE,COMMERCIAL,0,94400,94400,0,166900,261300
140427600900000,SHOP,COMMERCIAL,0,106400,106400,0,352200,458600
140427601000000,FLAT PARKING,COMMERCIAL,0,400,400,0,600,1000
140427601200000,CENTRALLY ASSESSED,OTHER,0,0,0,0,0,0
140427601300000,SHOP,COMMERCIAL,0,105100,105100,0,258700,363800
140427601400000,AUTO REPAIR/SALES,COMMERCIAL,0,251400,251400,0,377500,628900
140427700100000,NBHD SHOPPING CENTER,COMMERCIAL,0,332500,332500,0,813500,1146000
140427700200000,OFFICE,COMMERCIAL,0,42000,42000,0,208600,250600
140427700300000,NE 112,RESIDENTIAL,24300,0,24300,67000,0,91300
140427700400000,NE 112,RESIDENTIAL,10000,0,10000,45300,0,55300
140427700500000,NE 112,RESIDENTIAL,24500,0,24500,83600,0,108100
140427700600000,NE 112,RESIDENTIAL,30200,0,30200,64900,0,95100
140427700700000,NE 112,RESIDENTIAL,18100,0,18100,76700,0,94800
140427700800000,NE 112,RESIDENTIAL,18300,0,18300,67200,0,85500
140427700900000,NE 112,RESIDENTIAL,31400,0,31400,65500,0,96900
140427701000000,NE 112,RESIDENTIAL,19700,0,19700,98600,0,118300
140427701100000,CENTRALLY ASSESSED,OTHER,0,0,0,0,0,0
140427800100000,CHURCH,EXEMPT,0,84400,84400,0,101600,186000
140427800200000,NE 112,RESIDENTIAL,20800,0,20800,0,0,20800
140427800300000,NE 112,RESIDENTIAL,19900,0,19900,57500,0,77400
140427800400000,NE 112,RESIDENTIAL,20100,0,20100,74400,0,94500
140427800500000,NE 112,RESIDENTIAL,18900,0,18900,37100,0,56000
140427800600000,NE 112,RESIDENTIAL,18900,0,18900,0,0,18900
140427800700000,VACANT LAND,COMMERCIAL,0,713800,713800,0,0,713800
140430100300000,SMALL RETAIL,COMMERCIAL,0,86100,86100,0,176200,262300
140430100400000,SHOP,COMMERCIAL,0,45900,45900,0,65300,111200
140430100500000,HOTEL,COMMERCIAL,0,178800,178800,0,739300,918100
140430100600000,SMALL RETAIL,COMMERCIAL,0,76200,76200,0,266500,342700
140430100700000,WAREHOUSE;MINI STORG,COMMERCIAL,0,161300,161300,0,226500,387800
140430100800000,AUTO REPAIR/SALES,COMMERCIAL,0,437500,437500,0,1420700,1858200
140430100900000,SMALL RETAIL,COMMERCIAL,0,185500,185500,0,248300,433800
140430101000000,AUTO REPAIR/SALES,COMMERCIAL,0,473600,473600,0,782000,1255600
140430101100000,SHOP,COMMERCIAL,0,46500,46500,0,175500,222000
140430101200000,CITY PROPERTY,EXEMPT,0,0,0,0,0,0
140430101300000,CENTRALLY ASSESSED,OTHER,0,0,0,0,0,0
140430101400000,CITY PROPERTY,EXEMPT,0,0,0,0,0,0
140430200100000,NE 120,RESIDENTIAL,35900,0,35900,133400,0,169300
140430200200000,NE 120,RESIDENTIAL,33300,0,33300,149500,0,182800
140430300100000,NE 120,RESIDENTIAL,38400,0,38400,141600,0,180000
140430300200000,NE 120,RESIDENTIAL,39500,0,39500,147300,0,186800
140432600100000,NE 120,RESIDENTIAL,35900,0,35900,139900,0,175800
140432600200000,NE 120,RESIDENTIAL,34200,0,34200,117900,0,152100
140432600300000,NE 120,RESIDENTIAL,34600,0,34600,135200,0,169800
140432600400000,NE 120,RESIDENTIAL,38500,0,38500,110500,0,149000
140432600500000,NE 120,RESIDENTIAL,39900,0,39900,102300,0,142200
140432600600000,NE 120,RESIDENTIAL,38400,0,38400,146000,0,184400
140432600700000,NE 120,RESIDENTIAL,38800,0,38800,161300,0,200100
140432601000000,NE 120,RESIDENTIAL,36300,0,36300,169100,0,205400
140432601100000,NE 120,RESIDENTIAL,2500,0,2500,0,0,2500
140432601200000,NE 120,RESIDENTIAL,35300,0,35300,141200,0,176500
140432601300000,NE 120,RESIDENTIAL,36300,0,36300,132100,0,168400
140432601400000,NE 120,RESIDENTIAL,39200,0,39200,175800,0,215000
140432601500000,NE 120,RESIDENTIAL,38000,0,38000,194200,0,232200
140432601600000,NE 120,RESIDENTIAL,35600,0,35600,173200,0,208800
140432601700000,NE 120,RESIDENTIAL,35600,0,35600,163800,0,199400
140432601800000,NE 120,RESIDENTIAL,36300,0,36300,123800,0,160100
140432601900000,NE 120,RESIDENTIAL,39800,0,39800,144800,0,184600
140432602000000,NE 120,RESIDENTIAL,39900,0,39900,140200,0,180100
140432602100000,NE 120,RESIDENTIAL,39400,0,39400,144900,0,184300
140432602200000,NE 120,RESIDENTIAL,38000,0,38000,176500,0,214500
140432700100000,NE 120,RESIDENTIAL,36500,0,36500,159800,0,196300
140432700200000,NE 120,RESIDENTIAL,38000,0,38000,153800,0,191800
140432700300000,NE 120,RESIDENTIAL,35600,0,35600,167300,0,202900
140432700400000,NE 120,RESIDENTIAL,33300,0,33300,153400,0,186700
140432700500000,NE 120,RESIDENTIAL,38000,0,38000,186300,0,224300
140432700600000,NE 120,RESIDENTIAL,40900,0,40900,180100,0,221000
140432700700000,NE 120,RESIDENTIAL,41300,0,41300,149600,0,190900
140432700800000,NE 120,RESIDENTIAL,39400,0,39400,127700,0,167100
140432700900000,NE 120,RESIDENTIAL,44300,0,44300,190800,0,235100
140432701000000,NE 120,RESIDENTIAL,38500,0,38500,152400,0,190900
140432701100000,NE 120,RESIDENTIAL,37800,0,37800,133600,0,171400
140432701200000,NE 120,RESIDENTIAL,37100,0,37100,159300,0,196400
140432701300000,NE 120,RESIDENTIAL,38400,0,38400,137000,0,175400
140432701400000,NE 120,RESIDENTIAL,37600,0,37600,137900,0,175500
140432701500000,NE 120,RESIDENTIAL,700,0,700,0,0,700
140432701600000,NE 120,RESIDENTIAL,39800,0,39800,212700,0,252500
140432701700000,NE 120,RESIDENTIAL,46200,0,46200,165900,0,212100
140432701800000,NE 120,RESIDENTIAL,34100,0,34100,141800,0,175900
140432701900000,NE 120,RESIDENTIAL,38400,0,38400,125600,0,164000
140432702000000,NE 120,RESIDENTIAL,31800,0,31800,138500,0,170300
140432702100000,NE 120,RESIDENTIAL,34300,0,34300,189700,0,224000
140432702200000,NE 120,RESIDENTIAL,31500,0,31500,129500,0,161000
140432702300000,NE 120,RESIDENTIAL,31300,0,31300,146600,0,177900
140432702400000,NE 120,RESIDENTIAL,33400,0,33400,130700,0,164100
140432702500000,NE 120,RESIDENTIAL,39800,0,39800,147300,0,187100
140432702600000,NE 120,RESIDENTIAL,32400,0,32400,152000,0,184400
140432702700000,NE 120,RESIDENTIAL,33900,0,33900,143300,0,177200
140432702800000,NE 120,RESIDENTIAL,33900,0,33900,166200,0,200100
140432702900000,NE 120,RESIDENTIAL,35200,0,35200,160200,0,195400
140432703000000,NE 120,RESIDENTIAL,39700,0,39700,137000,0,176700
140432703100000,NE 120,RESIDENTIAL,41700,0,41700,139100,0,180800
140432703200000,NE 120,RESIDENTIAL,41400,0,41400,145100,0,186500
140432703300000,NE 120,RESIDENTIAL,37900,0,37900,129400,0,167300
140432703400000,NE 120,RESIDENTIAL,33900,0,33900,134600,0,168500
140432703500000,NE 120,RESIDENTIAL,33900,0,33900,132300,0,166200
140432703600000,NE 120,RESIDENTIAL,32000,0,32000,143800,0,175800
140432703700000,NE 120,RESIDENTIAL,33500,0,33500,128000,0,161500
140432703800000,NE 120,RESIDENTIAL,35900,0,35900,146700,0,182600
140432703900000,NE 120,RESIDENTIAL,32300,0,32300,102400,0,134700
140432704000000,NE 120,RESIDENTIAL,32300,0,32300,117700,0,150000
140432704100000,NE 120,RESIDENTIAL,32300,0,32300,128500,0,160800
140432704200000,NE 120,RESIDENTIAL,32800,0,32800,103900,0,136700
140432800100000,NE 120,RESIDENTIAL,36200,0,36200,133800,0,170000
140432800200000,NE 120,RESIDENTIAL,34800,0,34800,127800,0,162600
140432800300000,NE 120,RESIDENTIAL,35400,0,35400,136300,0,171700
140432800400000,NE 120,RESIDENTIAL,30900,0,30900,98200,0,129100
140432800500000,NE 120,RESIDENTIAL,30900,0,30900,110200,0,141100
140432800600000,NE 120,RESIDENTIAL,30900,0,30900,107800,0,138700
140432800700000,NE 120,RESIDENTIAL,30900,0,30900,126200,0,157100
140432800800000,NE 120,RESIDENTIAL,31200,0,31200,113800,0,145000
140432900100000,NE 120,RESIDENTIAL,39200,0,39200,143900,0,183100
140432900200000,NE 120,RESIDENTIAL,38800,0,38800,157300,0,196100
140432900300000,NE 120,RESIDENTIAL,36000,0,36000,179800,0,215800
140432900400000,NE 120,RESIDENTIAL,38400,0,38400,132800,0,171200
140432900500000,NE 120,RESIDENTIAL,33300,0,33300,127500,0,160800
140432900600000,NE 120,RESIDENTIAL,38800,0,38800,0,0,38800
140432900800000,NE 120,RESIDENTIAL,33600,0,33600,192400,0,226000
140432900900000,NE 120,RESIDENTIAL,35800,0,35800,130000,0,165800
140435100100000,NE 121,RESIDENTIAL,25800,0,25800,101700,0,127500
140435100200000,NE 121,RESIDENTIAL,26800,0,26800,97600,0,124400
140435100300000,NE 121,RESIDENTIAL,27100,0,27100,100500,0,127600
140435100400000,NE 121,RESIDENTIAL,26900,0,26900,114300,0,141200
140435100500000,NE 121,RESIDENTIAL,26000,0,26000,128200,0,154200
140435100600000,NE 121,RESIDENTIAL,29000,0,29000,93400,0,122400
140435100700000,NE 121,RESIDENTIAL,27100,0,27100,97600,0,124700
140435100800000,NE 121,RESIDENTIAL,26900,0,26900,104700,0,131600
140435100900000,NE 121,RESIDENTIAL,27000,0,27000,114800,0,141800
140435101000000,NE 121,RESIDENTIAL,25900,0,25900,96700,0,122600
140435101100000,NE 121,RESIDENTIAL,25200,0,25200,97800,0,123000
140435101200000,NE 121,RESIDENTIAL,24800,0,24800,125000,0,149800
140435101300000,NE 121,RESIDENTIAL,25200,0,25200,101900,0,127100
140435200100000,NE 121,RESIDENTIAL,29500,0,29500,97700,0,127200
140435200200000,NE 121,RESIDENTIAL,30000,0,30000,149900,0,179900
140435200300000,NE 121,RESIDENTIAL,28100,0,28100,128000,0,156100
140435200400000,NE 121,RESIDENTIAL,30000,0,30000,122500,0,152500
140435200500000,NE 121,RESIDENTIAL,29900,0,29900,160800,0,190700
140435200600000,NE 121,RESIDENTIAL,28100,0,28100,131700,0,159800
140435200700000,NE 121,RESIDENTIAL,28600,0,28600,138900,0,167500
140435300100000,NE 121,RESIDENTIAL,28600,0,28600,131900,0,160500
140435300200000,NE 121,RESIDENTIAL,28100,0,28100,137000,0,165100
140435300300000,NE 121,RESIDENTIAL,29700,0,29700,124500,0,154200
140435300400000,NE 121,RESIDENTIAL,30700,0,30700,128200,0,158900
140435300500000,NE 121,RESIDENTIAL,31500,0,31500,131400,0,162900
140435300600000,NE 121,RESIDENTIAL,29900,0,29900,102300,0,132200
140435300700000,NE 121,RESIDENTIAL,30300,0,30300,101300,0,131600
140435300800000,NE 121,RESIDENTIAL,29900,0,29900,139400,0,169300
140435300900000,NE 121,RESIDENTIAL,28300,0,28300,108300,0,136600
140435301000000,NE 121,RESIDENTIAL,30700,0,30700,112500,0,143200
140435301100000,SCHOOL,EXEMPT,0,0,0,0,0,0
140435400100000,NE 121,RESIDENTIAL,27000,0,27000,113000,0,140000
140435400200000,NE 121,RESIDENTIAL,30700,0,30700,117500,0,148200
140435400300000,NE 121,RESIDENTIAL,34000,0,34000,148200,0,182200
140435400400000,NE 121,RESIDENTIAL,32500,0,32500,137600,0,170100
140435400500000,NE 121,RESIDENTIAL,35500,0,35500,164900,0,200400
140435400600000,NE 121,RESIDENTIAL,31700,0,31700,117200,0,148900
140435400700000,NE 121,RESIDENTIAL,33200,0,33200,156900,0,190100
140435400800000,NE 121,RESIDENTIAL,27200,0,27200,117000,0,144200
140435400900000,NE 121,RESIDENTIAL,24500,0,24500,95200,0,119700
140435401000000,NE 121,RESIDENTIAL,25400,0,25400,79900,0,105300
140435401100000,NE 121,RESIDENTIAL,24600,0,24600,94300,0,118900
140435401200000,NE 121,RESIDENTIAL,25400,0,25400,102000,0,127400
140435401300000,NE 121,RESIDENTIAL,24200,0,24200,96800,0,121000
140435401400000,NE 121,RESIDENTIAL,25200,0,25200,127300,0,152500
140435401500000,NE 121,RESIDENTIAL,26400,0,26400,95000,0,121400
140435401600000,NE 121,RESIDENTIAL,27000,0,27000,109400,0,136400
140435401700000,NE 121,RESIDENTIAL,26100,0,26100,82600,0,108700
140435401800000,NE 121,RESIDENTIAL,26600,0,26600,106400,0,133000
140435401900000,NE 121,RESIDENTIAL,26700,0,26700,137100,0,163800
140435500100000,NE 121,RESIDENTIAL,27400,0,27400,123500,0,150900
140435500200000,NE 121,RESIDENTIAL,28400,0,28400,105200,0,133600
140435500300000,NE 121,RESIDENTIAL,28700,0,28700,109300,0,138000
140435500400000,NE 121,RESIDENTIAL,28400,0,28400,101800,0,130200
140435500500000,NE 121,RESIDENTIAL,28500,0,28500,0,0,28500
140435500600000,NE 121,RESIDENTIAL,36500,0,36500,176100,0,212600
140435500700000,NE 121,RESIDENTIAL,26400,0,26400,105800,0,132200
140435500800000,NE 121,RESIDENTIAL,29300,0,29300,140200,0,169500
140435500900000,NE 121,RESIDENTIAL,30000,0,30000,120300,0,150300
140435501000000,NE 121,RESIDENTIAL,30100,0,30100,144800,0,174900
140435501100000,NE 121,RESIDENTIAL,31000,0,31000,149500,0,180500
140435501200000,NE 121,RESIDENTIAL,32100,0,32100,137100,0,169200
140435501300000,NE 121,RESIDENTIAL,28700,0,28700,115600,0,144300
140435501400000,NE 121,RESIDENTIAL,28700,0,28700,110600,0,139300
140435600100000,NE 121,RESIDENTIAL,30500,0,30500,116900,0,147400
140435600200000,NE 121,RESIDENTIAL,29900,0,29900,124500,0,154400
140435600300000,NE 121,RESIDENTIAL,27700,0,27700,147200,0,174900
140435600400000,NE 121,RESIDENTIAL,30300,0,30300,129100,0,159400
140435600500000,NE 121,RESIDENTIAL,30300,0,30300,134800,0,165100
140435600600000,NE 121,RESIDENTIAL,30300,0,30300,123000,0,153300
140435600700000,NE 121,RESIDENTIAL,30300,0,30300,159200,0,189500
140435600800000,NE 121,RESIDENTIAL,28900,0,28900,136500,0,165400
140435600900000,NE 121,RESIDENTIAL,30300,0,30300,134800,0,165100
140435601000000,NE 121,RESIDENTIAL,29400,0,29400,142800,0,172200
140435601100000,NE 121,RESIDENTIAL,30200,0,30200,149000,0,179200
140435601200000,NE 121,RESIDENTIAL,30000,0,30000,92600,0,122600
140435601300000,NE 121,RESIDENTIAL,29600,0,29600,125600,0,155200
140435601400000,NE 121,RESIDENTIAL,30300,0,30300,113500,0,143800
140435601500000,NE 121,RESIDENTIAL,30300,0,30300,117300,0,147600
140435601600000,NE 121,RESIDENTIAL,30700,0,30700,114000,0,144700
140435601700000,NE 121,RESIDENTIAL,31900,0,31900,128800,0,160700
140435700100000,NE 121,RESIDENTIAL,27000,0,27000,121600,0,148600
140435700200000,NE 121,RESIDENTIAL,26300,0,26300,112300,0,138600
140435700300000,NE 121,RESIDENTIAL,24900,0,24900,94700,0,119600
140435700400000,NE 121,RESIDENTIAL,26800,0,26800,87000,0,113800
140435700500000,NE 121,RESIDENTIAL,27500,0,27500,86300,0,113800
140435700600000,NE 121,RESIDENTIAL,29200,0,29200,90500,0,119700
140435700700000,NE 121,RESIDENTIAL,30600,0,30600,120400,0,151000
140435700800000,NE 121,RESIDENTIAL,21400,0,21400,88100,0,109500
140435700900000,NE 121,RESIDENTIAL,21400,0,21400,82000,0,103400
140435701000000,NE 121,RESIDENTIAL,21000,0,21000,86600,0,107600
140435701100000,NE 121,RESIDENTIAL,22700,0,22700,120100,0,142800
140437600100000,HOTEL,COMMERCIAL,0,500700,500700,0,2491600,2992300
140437600300000,FLAT PARKING,COMMERCIAL,0,30800,30800,0,6800,37600
140437600400000,CENTRALLY ASSESSED,OTHER,0,0,0,0,0,0
140437600500000,CITY PROPERTY,EXEMPT,0,0,0,0,0,0
140437601000000,APARTMENT,MULTI-RES,24500,0,24500,152900,0,177400
140437700100000,NE 121,RESIDENTIAL,33300,0,33300,133000,0,166300
140437700200000,NE 121,RESIDENTIAL,28400,0,28400,158600,0,187000
140437700300000,NE 121,RESIDENTIAL,16000,0,16000,102000,0,118000
140437700400000,NE 121,RESIDENTIAL,10400,0,10400,88900,0,99300
140437700500000,NE 121,RESIDENTIAL,10200,0,10200,102400,0,112600
140437700600000,NE 121,RESIDENTIAL,15200,0,15200,103600,0,118800
140437701200000,NE 121,RESIDENTIAL,40600,0,40600,236200,0,276800
140437701300000,NE 121,RESIDENTIAL,36700,0,36700,212700,0,249400
140437701400000,NE 121,RESIDENTIAL,30000,0,30000,153900,0,183900
140437701500000,NE 121,RESIDENTIAL,28100,0,28100,153400,0,181500
140437701600000,NE 121,RESIDENTIAL,30000,0,30000,168000,0,198000
140437701700000,NE 121,RESIDENTIAL,19500,0,19500,143400,0,162900
140437701800000,NE 121,RESIDENTIAL,28100,0,28100,152000,0,180100
140437701900000,NE 121,RESIDENTIAL,30900,0,30900,198000,0,228900
140437702000000,NE 121,RESIDENTIAL,26800,0,26800,72100,0,98900
140437702100000,NE 121,RESIDENTIAL,21600,0,21600,62200,0,83800
140437702200000,NE 121,RESIDENTIAL,21300,0,21300,93400,0,114700
140437702300000,NE 121,RESIDENTIAL,22400,0,22400,108900,0,131300
140437702400000,NE 121,RESIDENTIAL,22800,0,22800,125700,0,148500
140437702500000,NE 121,RESIDENTIAL,23600,0,23600,122600,0,146200
140437702600000,NE 121,RESIDENTIAL,23900,0,23900,116200,0,140100
140437702700000,NE 121,RESIDENTIAL,22700,0,22700,116700,0,139400
140437702800000,NE 121,RESIDENTIAL,22700,0,22700,116300,0,139000
140437702900000,NE 121,RESIDENTIAL,22400,0,22400,120500,0,142900
140437703000000,NE 121,RESIDENTIAL,22400,0,22400,97000,0,119400
140437703100000,NE 121,RESIDENTIAL,21800,0,21800,86200,0,108000
140437800100000,NE 121,RESIDENTIAL,29500,0,29500,127100,0,156600
140437800200000,NE 121,RESIDENTIAL,30600,0,30600,154400,0,185000
140437800300000,NE 121,RESIDENTIAL,30600,0,30600,154400,0,185000
140437800400000,NE 121,RESIDENTIAL,32500,0,32500,154800,0,187300
140437800500000,NE 121,RESIDENTIAL,30600,0,30600,147700,0,178300
140437800600000,NE 121,RESIDENTIAL,28700,0,28700,138200,0,166900
140437800700000,NE 121,RESIDENTIAL,29200,0,29200,167500,0,196700
140437800800000,NE 121,RESIDENTIAL,32000,0,32000,179100,0,211100
140437800900000,NE 121,RESIDENTIAL,25900,0,25900,126300,0,152200
140437801000000,NE 121,RESIDENTIAL,25400,0,25400,108400,0,133800
140437801100000,NE 121,RESIDENTIAL,25200,0,25200,122000,0,147200
140437801200000,NE 121,RESIDENTIAL,25200,0,25200,94100,0,119300
140437801300000,NE 121,RESIDENTIAL,26000,0,26000,98900,0,124900
140437801400000,NE 121,RESIDENTIAL,38200,0,38200,172900,0,211100
140437801500000,NE 121,RESIDENTIAL,28100,0,28100,156100,0,184200
140437801600000,NE 121,RESIDENTIAL,32100,0,32100,198500,0,230600
140437801700000,NE 121,RESIDENTIAL,30700,0,30700,154300,0,185000
140437801800000,NE 121,RESIDENTIAL,31300,0,31300,158300,0,189600
140437801900000,NE 121,RESIDENTIAL,32100,0,32100,160300,0,192400
140440100100000,SCHOOL,EXEMPT,0,1615000,1615000,0,6707900,8322900
140440100400000,NE 118,RESIDENTIAL,26200,0,26200,150100,0,176300
140440100500000,NE 118,RESIDENTIAL,24300,0,24300,87500,0,111800
140440100700000,NE 118,RESIDENTIAL,22900,0,22900,60600,0,83500
140440100800000,NE 118,RESIDENTIAL,24900,0,24900,88400,0,113300
140440100900000,NE 118,RESIDENTIAL,23400,0,23400,91300,0,114700
140440101000000,NE 118,RESIDENTIAL,23400,0,23400,102100,0,125500
140440101100000,NE 118,RESIDENTIAL,23400,0,23400,99600,0,123000
140440101200000,NE 118,RESIDENTIAL,23400,0,23400,97200,0,120600
140440101300000,NE 118,RESIDENTIAL,24200,0,24200,120000,0,144200
140440101400000,NE 118,RESIDENTIAL,23400,0,23400,94900,0,118300
140440101500000,NE 118,RESIDENTIAL,23400,0,23400,113000,0,136400
140440101600000,NE 118,RESIDENTIAL,23400,0,23400,113600,0,137000
140440101700000,NE 118,RESIDENTIAL,23400,0,23400,93600,0,117000
140440101800000,NE 118,RESIDENTIAL,23400,0,23400,91900,0,115300
140440101900000,NE 118,RESIDENTIAL,23400,0,23400,101200,0,124600
140440102000000,NE 118,RESIDENTIAL,23400,0,23400,94200,0,117600
140440102100000,NE 118,RESIDENTIAL,23400,0,23400,92100,0,115500
140440102200000,NE 118,RESIDENTIAL,23400,0,23400,115200,0,138600
140440102300000,NE 118,RESIDENTIAL,23400,0,23400,120000,0,143400
140440102400000,NE 118,RESIDENTIAL,23400,0,23400,105100,0,128500
140440102500000,NE 118,RESIDENTIAL,23400,0,23400,93000,0,116400
140440102600000,NE 118,EXEMPT,0,25800,25800,0,115200,141000
140440102700000,NE 118,RESIDENTIAL,23400,0,23400,75200,0,98600
140440102800000,NE 118,RESIDENTIAL,39700,0,39700,171200,0,210900
140440200100000,NE 118,RESIDENTIAL,25100,0,25100,99400,0,124500
140440200200000,NE 118,RESIDENTIAL,23400,0,23400,93400,0,116800
140440200300000,NE 118,RESIDENTIAL,23400,0,23400,83600,0,107000
140440200400000,NE 118,RESIDENTIAL,23400,0,23400,79300,0,102700
140440200500000,NE 118,RESIDENTIAL,23400,0,23400,85600,0,109000
140440200600000,NE 118,RESIDENTIAL,23400,0,23400,78900,0,102300
140440200700000,NE 118,RESIDENTIAL,23400,0,23400,114900,0,138300
140440200800000,NE 118,RESIDENTIAL,23400,0,23400,96600,0,120000
140440200900000,NE 118,RESIDENTIAL,23400,0,23400,82400,0,105800
140440201000000,NE 118,RESIDENTIAL,23400,0,23400,92500,0,115900
140440201100000,NE 118,RESIDENTIAL,23400,0,23400,92900,0,116300
140440201200000,NE 118,RESIDENTIAL,23400,0,23400,101100,0,124500
140440201300000,NE 118,RESIDENTIAL,23400,0,23400,107100,0,130500
140440201400000,NE 118,RESIDENTIAL,23400,0,23400,92400,0,115800
140440201500000,NE 118,RESIDENTIAL,23400,0,23400,98100,0,121500
140440201600000,NE 118,RESIDENTIAL,23700,0,23700,81100,0,104800
140440201700000,NE 118,RESIDENTIAL,23400,0,23400,80900,0,104300
140440201800000,NE 118,RESIDENTIAL,23400,0,23400,89100,0,112500
140440201900000,NE 118,RESIDENTIAL,20100,0,20100,77100,0,97200
140440202000000,NE 118,RESIDENTIAL,25900,0,25900,116900,0,142800
140440202100000,NE 118,RESIDENTIAL,24900,0,24900,122700,0,147600
140440202200000,NE 118,RESIDENTIAL,24300,0,24300,118400,0,142700
140440202300000,NE 118,RESIDENTIAL,24000,0,24000,96300,0,120300
140440202400000,NE 118,RESIDENTIAL,23300,0,23300,102400,0,125700
140440202500000,NE 118,RESIDENTIAL,24300,0,24300,109400,0,133700
140440202600000,NE 118,RESIDENTIAL,22500,0,22500,104200,0,126700
140440202700000,NE 118,RESIDENTIAL,24200,0,24200,85000,0,109200
140440202800000,NE 118,RESIDENTIAL,23300,0,23300,74700,0,98000
140440202900000,NE 118,RESIDENTIAL,22500,0,22500,99100,0,121600
140440203000000,NE 118,RESIDENTIAL,23300,0,23300,93200,0,116500
140440203100000,NE 118,RESIDENTIAL,25400,0,25400,84400,0,109800
140440203200000,NE 118,RESIDENTIAL,26000,0,26000,91200,0,117200
140440203300000,NE 118,RESIDENTIAL,26300,0,26300,112400,0,138700
140440203400000,NE 118,RESIDENTIAL,22600,0,22600,98800,0,121400
140440203500000,NE 118,RESIDENTIAL,22300,0,22300,85400,0,107700
140440203600000,NE 118,RESIDENTIAL,25900,0,25900,130900,0,156800
140440203700000,NE 118,RESIDENTIAL,50500,0,50500,120300,0,170800
140440203900000,NE 118,RESIDENTIAL,22600,0,22600,89500,0,112100
140440204000000,NE 118,RESIDENTIAL,22800,0,22800,100700,0,123500
140440204100000,NE 118,RESIDENTIAL,21400,0,21400,103800,0,125200
140440204200000,NE 118,RESIDENTIAL,21400,0,21400,101500,0,122900
140440204300000,NE 118,RESIDENTIAL,21400,0,21400,100400,0,121800
140440204400000,NE 118,RESIDENTIAL,19600,0,19600,104700,0,124300
140440300100000,NE 118,RESIDENTIAL,21400,0,21400,117100,0,138500
140440300200000,NE 118,RESIDENTIAL,21900,0,21900,102800,0,124700
140440300300000,NE 118,RESIDENTIAL,25700,0,25700,119000,0,144700
140440300400000,NE 118,RESIDENTIAL,24100,0,24100,102500,0,126600
140440400100000,NE 118,RESIDENTIAL,25500,0,25500,112200,0,137700
140440400200000,NE 118,RESIDENTIAL,24500,0,24500,115100,0,139600
140440400300000,NE 118,RESIDENTIAL,24100,0,24100,77300,0,101400
140440400400000,NE 118,RESIDENTIAL,25700,0,25700,91800,0,117500
140440400500000,NE 118,RESIDENTIAL,22500,0,22500,105800,0,128300
140440400600000,NE 118,RESIDENTIAL,23900,0,23900,100400,0,124300
140440400700000,NE 118,RESIDENTIAL,22900,0,22900,98300,0,121200
140440600100000,AUTO REPAIR/SALES,COMMERCIAL,0,360000,360000,0,411200,771200
140440600200000,HOTEL,COMMERCIAL,0,501300,501300,0,2726300,3227600
140440600300000,NBHD SHOPPING CENTER,COMMERCIAL,0,684000,684000,0,994600,1678600
140442700100000,NE 118,RESIDENTIAL,29200,0,29200,0,0,29200
140442700300000,AUTO REPAIR/SALES,COMMERCIAL,0,804000,804000,0,1393900,2197900
140442700400000,CHURCH,EXEMPT,0,574800,574800,0,4369600,4944400
140442700600000,NE 118,RESIDENTIAL,30800,0,30800,89700,0,120500
140442700700000,NE 118,RESIDENTIAL,38000,0,38000,83900,0,121900
140442700800000,NE 118,RESIDENTIAL,27200,0,27200,99300,0,126500
140442700900000,NE 118,EXEMPT,0,50500,50500,0,97900,148400
140442701000000,FLAT PARKING,COMMERCIAL,0,85500,85500,0,36000,121500
140442701100000,WAREHOUSE,COMMERCIAL,0,438800,438800,0,1699500,2138300
140445100100000,NE 118,RESIDENTIAL,23800,0,23800,94900,0,118700
140445100200000,NE 118,RESIDENTIAL,23300,0,23300,94000,0,117300
140445100300000,NE 118,RESIDENTIAL,23300,0,23300,86300,0,109600
140445100400000,NE 118,RESIDENTIAL,21200,0,21200,96600,0,117800
140445100500000,NE 118,RESIDENTIAL,21200,0,21200,92800,0,114000
140445100600000,NE 118,RESIDENTIAL,21200,0,21200,84100,0,105300
140445100700000,NE 118,RESIDENTIAL,21200,0,21200,102900,0,124100
140445100800000,NE 118,RESIDENTIAL,21200,0,21200,88600,0,109800
140445100900000,NE 118,RESIDENTIAL,21200,0,21200,85200,0,106400
140445101000000,NE 118,RESIDENTIAL,21200,0,21200,80900,0,102100
140445101100000,NE 118,RESIDENTIAL,21200,0,21200,74600,0,95800
140445101200000,NE 118,RESIDENTIAL,21200,0,21200,91400,0,112600
140445101300000,NE 118,RESIDENTIAL,21200,0,21200,91800,0,113000
140445101400000,NE 118,RESIDENTIAL,21200,0,21200,95100,0,116300
140445101500000,NE 118,RESIDENTIAL,25000,0,25000,103900,0,128900
140445101600000,NE 118,RESIDENTIAL,24700,0,24700,97600,0,122300
140445101700000,NE 118,RESIDENTIAL,25200,0,25200,116100,0,141300
140445101800000,NE 118,RESIDENTIAL,24600,0,24600,93700,0,118300
140445101900000,NE 118,RESIDENTIAL,28400,0,28400,118100,0,146500
140445200100000,NE 118,RESIDENTIAL,23800,0,23800,109500,0,133300
140445200200000,NE 118,RESIDENTIAL,23300,0,23300,111900,0,135200
140445200300000,NE 118,RESIDENTIAL,23400,0,23400,101400,0,124800
140445200400000,NE 118,RESIDENTIAL,23400,0,23400,99900,0,123300
140445200500000,NE 118,RESIDENTIAL,23900,0,23900,102500,0,126400
140445200600000,NE 118,RESIDENTIAL,25300,0,25300,95900,0,121200
140445200700000,NE 118,RESIDENTIAL,24300,0,24300,107600,0,131900
140445200800000,NE 118,RESIDENTIAL,22700,0,22700,90700,0,113400
140445200900000,NE 118,RESIDENTIAL,20400,0,20400,94400,0,114800
140445201000000,NE 118,RESIDENTIAL,23000,0,23000,87000,0,110000
140445201100000,NE 118,RESIDENTIAL,23000,0,23000,72400,0,95400
140445201200000,NE 118,RESIDENTIAL,23000,0,23000,97400,0,120400
140445201300000,NE 118,RESIDENTIAL,23000,0,23000,92000,0,115000
140445201400000,NE 118,RESIDENTIAL,23000,0,23000,81100,0,104100
140445201500000,NE 118,RESIDENTIAL,21700,0,21700,88800,0,110500
140445201600000,NE 118,RESIDENTIAL,21600,0,21600,86000,0,107600
140445201700000,NE 118,RESIDENTIAL,24600,0,24600,83400,0,108000
140445201800000,NE 118,RESIDENTIAL,24300,0,24300,85800,0,110100
140445201900000,NE 118,RESIDENTIAL,23000,0,23000,83900,0,106900
140445202000000,NE 118,RESIDENTIAL,23000,0,23000,84100,0,107100
140445202100000,NE 118,RESIDENTIAL,23000,0,23000,80300,0,103300
140445202200000,NE 118,RESIDENTIAL,23000,0,23000,99700,0,122700
140445202300000,NE 118,RESIDENTIAL,23000,0,23000,132500,0,155500
140445202400000,NE 118,RESIDENTIAL,22500,0,22500,111000,0,133500
140445202500000,NE 118,RESIDENTIAL,21600,0,21600,83800,0,105400
140445202600000,NE 118,RESIDENTIAL,22600,0,22600,94400,0,117000
140445202700000,NE 118,RESIDENTIAL,22500,0,22500,81700,0,104200
140445202800000,NE 118,RESIDENTIAL,21200,0,21200,81600,0,102800
140445202900000,NE 118,RESIDENTIAL,23600,0,23600,98500,0,122100
140445203000000,NE 118,RESIDENTIAL,23600,0,23600,97100,0,120700
140445300100000,NE 118,RESIDENTIAL,23700,0,23700,91300,0,115000
140445300200000,NE 118,RESIDENTIAL,24000,0,24000,110700,0,134700
140445300300000,NE 118,RESIDENTIAL,24000,0,24000,78600,0,102600
140445300400000,NE 118,RESIDENTIAL,23400,0,23400,118900,0,142300
140445400100000,NE 118,RESIDENTIAL,28600,0,28600,84800,0,113400
140445400200000,NE 118,RESIDENTIAL,31100,0,31100,81900,0,113000
140445400400000,SMALL RETAIL,COMMERCIAL,0,270900,270900,0,521700,792600
140445400500000,NE 118,RESIDENTIAL,25400,0,25400,106500,0,131900
140445400700000,NE 118,RESIDENTIAL,31700,0,31700,126000,0,157700
140445400800000,CHURCH,EXEMPT,0,600000,600000,0,447700,1047700
140445401100000,OFFICE; MEDICAL,COMMERCIAL,0,60000,60000,0,63700,123700
140445401200000,SMALL RETAIL,COMMERCIAL,0,57600,57600,0,47500,105100
140445401300000,NE 118,RESIDENTIAL,23000,0,23000,0,0,23000
140445401400000,NE 118,RESIDENTIAL,21200,0,21200,99700,0,120900
140445401500000,NE 118,RESIDENTIAL,22200,0,22200,86700,0,108900
140445401600000,NE 118,RESIDENTIAL,20100,0,20100,115300,0,135400
140445401700000,NE 118,RESIDENTIAL,21000,0,21000,81300,0,102300
140445401800000,NE 118,RESIDENTIAL,20800,0,20800,88500,0,109300
140445401900000,NE 118,RESIDENTIAL,20800,0,20800,83100,0,103900
140445402000000,NE 118,RESIDENTIAL,23100,0,23100,70600,0,93700
140445402100000,OFFICE; MEDICAL,COMMERCIAL,0,235900,235900,0,605000,840900
140445500200000,FLAT PARKING,COMMERCIAL,0,70000,70000,0,9800,79800
140445500300000,AUTO REPAIR/SALES,COMMERCIAL,0,445000,445000,0,532000,977000
140445500400000,NBHD SHOPPING CENTER,COMMERCIAL,0,245800,245800,0,982000,1227800
140445500500000,FLAT PARKING,COMMERCIAL,0,3400,3400,0,6300,9700
140445500600000,FLAT PARKING,COMMERCIAL,0,18800,18800,0,3000,21800
140445600100000,OFFICE,COMMERCIAL,0,61000,61000,0,210800,271800
140445600200000,NE 118,RESIDENTIAL,30000,0,30000,62700,0,92700
140445700100000,NE 118,RESIDENTIAL,25900,0,25900,89400,0,115300
140445700200000,NE 118,RESIDENTIAL,21400,0,21400,76000,0,97400
140445700500000,NE 118,RESIDENTIAL,20000,0,20000,82600,0,102600
140445700600000,NE 118,RESIDENTIAL,20000,0,20000,84800,0,104800
140445700700000,FAST FOOD,COMMERCIAL,0,501000,501000,0,868800,1369800
140445800100000,NBHD SHOPPING CENTER,COMMERCIAL,0,451100,451100,0,1516000,1967100
140445800200000,FLAT PARKING,COMMERCIAL,0,41100,41100,0,6600,47700
140445800400000,FAST FOOD,COMMERCIAL,0,127900,127900,0,82800,210700
140445800500000,CONVENIENCE STORE,COMMERCIAL,0,162600,162600,0,208200,370800
140445800600000,FLAT PARKING,COMMERCIAL,0,54100,54100,0,2500,56600
140445800700000,RESTAURANT,COMMERCIAL,0,131500,131500,0,88900,220400
140445800800000,RESTAURANT,COMMERCIAL,0,153500,153500,0,81500,235000
140445800900000,CITY PROPERTY,EXEMPT,0,0,0,0,0,0
140445801000000,SMALL RETAIL,COMMERCIAL,0,132500,132500,0,309500,442000
140447600100000,NE 118,RESIDENTIAL,19500,0,19500,59000,0,78500
140447600200000,NE 118,RESIDENTIAL,20500,0,20500,82300,0,102800
140447600300000,NE 118,RESIDENTIAL,19700,0,19700,65900,0,85600
140447600400000,NE 118,RESIDENTIAL,19700,0,19700,60300,0,80000
140447600500000,NE 118,RESIDENTIAL,19700,0,19700,64900,0,84600
140447600600000,NE 118,RESIDENTIAL,19700,0,19700,73700,0,93400
140447600700000,NE 118,RESIDENTIAL,19700,0,19700,67000,0,86700
140447600800000,NE 118,RESIDENTIAL,19700,0,19700,68200,0,87900
140447600900000,NE 118,RESIDENTIAL,19700,0,19700,65300,0,85000
140447601000000,NE 118,RESIDENTIAL,19700,0,19700,63600,0,83300
140447601100000,NE 118,RESIDENTIAL,19700,0,19700,76200,0,95900
140447601200000,NE 118,RESIDENTIAL,19700,0,19700,68500,0,88200
140447601300000,NE 118,RESIDENTIAL,19700,0,19700,61400,0,81100
140447601400000,NE 118,RESIDENTIAL,19700,0,19700,64700,0,84400
140447601500000,NE 118,RESIDENTIAL,19700,0,19700,60900,0,80600
140447601600000,NE 118,RESIDENTIAL,19700,0,19700,69900,0,89600
140447601700000,NE 118,RESIDENTIAL,19700,0,19700,64200,0,83900
140447601800000,NE 118,RESIDENTIAL,19700,0,19700,65500,0,85200
140447601900000,NE 118,RESIDENTIAL,19700,0,19700,62200,0,81900
140447602000000,NE 118,RESIDENTIAL,19700,0,19700,79400,0,99100
140447602100000,NE 118,RESIDENTIAL,22100,0,22100,70900,0,93000
140447602200000,NE 118,RESIDENTIAL,22100,0,22100,93500,0,115600
140447602300000,NE 118,RESIDENTIAL,19700,0,19700,61100,0,80800
140447602400000,NE 118,RESIDENTIAL,19700,0,19700,67600,0,87300
140447602500000,NE 118,RESIDENTIAL,19700,0,19700,68600,0,88300
140447602600000,NE 118,RESIDENTIAL,19700,0,19700,59700,0,79400
140447602700000,NE 118,RESIDENTIAL,19700,0,19700,80100,0,99800
140447602800000,NE 118,RESIDENTIAL,19700,0,19700,63400,0,83100
140447602900000,NE 118,RESIDENTIAL,19700,0,19700,51000,0,70700
140447603000000,NE 118,RESIDENTIAL,19700,0,19700,68300,0,88000
140447603100000,NE 118,RESIDENTIAL,19700,0,19700,66300,0,86000
140447603200000,NE 118,RESIDENTIAL,19700,0,19700,59200,0,78900
140447603300000,NE 118,RESIDENTIAL,19700,0,19700,55000,0,74700
140447603400000,NE 118,RESIDENTIAL,19700,0,19700,64200,0,83900
140447603500000,NE 118,RESIDENTIAL,19700,0,19700,82300,0,102000
140447603600000,NE 118,RESIDENTIAL,19700,0,19700,68100,0,87800
140447603700000,NE 118,RESIDENTIAL,19700,0,19700,69300,0,89000
140447603800000,NE 118,RESIDENTIAL,19700,0,19700,72800,0,92500
140447603900000,NE 118,RESIDENTIAL,19700,0,19700,72000,0,91700
140447604000000,NE 118,RESIDENTIAL,19700,0,19700,76700,0,96400
140447700100000,NE 118,RESIDENTIAL,21100,0,21100,74500,0,95600
140447700200000,NE 118,RESIDENTIAL,20400,0,20400,89900,0,110300
140447700300000,NE 118,RESIDENTIAL,20000,0,20000,67300,0,87300
140447700400000,NE 118,RESIDENTIAL,20000,0,20000,53400,0,73400
140447700500000,NE 118,RESIDENTIAL,24100,0,24100,80300,0,104400
140447700600000,NE 118,RESIDENTIAL,20000,0,20000,92300,0,112300
140447700700000,NE 118,RESIDENTIAL,20000,0,20000,66100,0,86100
140447700800000,NE 118,RESIDENTIAL,20000,0,20000,55700,0,75700
140447700900000,NE 118,RESIDENTIAL,20000,0,20000,67000,0,87000
140447701000000,NE 118,RESIDENTIAL,20000,0,20000,77500,0,97500
140447701100000,NE 118,RESIDENTIAL,20000,0,20000,65900,0,85900
140447701200000,NE 118,RESIDENTIAL,20000,0,20000,64700,0,84700
140447701300000,NE 118,RESIDENTIAL,20000,0,20000,68500,0,88500
140447701400000,NE 118,RESIDENTIAL,20000,0,20000,106600,0,126600
140447701500000,NE 118,RESIDENTIAL,20000,0,20000,67800,0,87800
140447701600000,NE 118,RESIDENTIAL,20000,0,20000,67900,0,87900
140447701700000,NE 118,RESIDENTIAL,20000,0,20000,73300,0,93300
140447701800000,NE 118,RESIDENTIAL,20000,0,20000,64200,0,84200
140447701900000,NE 118,RESIDENTIAL,20000,0,20000,73000,0,93000
140447702000000,NE 118,RESIDENTIAL,20000,0,20000,71400,0,91400
140447702100000,NE 118,RESIDENTIAL,20800,0,20800,89800,0,110600
140447702200000,NE 118,RESIDENTIAL,21500,0,21500,64300,0,85800
140447702300000,NE 118,RESIDENTIAL,20000,0,20000,65100,0,85100
140447702400000,NE 118,RESIDENTIAL,20000,0,20000,60500,0,80500
140447702500000,NE 118,RESIDENTIAL,20000,0,20000,64900,0,84900
140447702600000,NE 118,RESIDENTIAL,20000,0,20000,63400,0,83400
140447702700000,NE 118,RESIDENTIAL,20000,0,20000,62800,0,82800
140447702800000,NE 118,RESIDENTIAL,20000,0,20000,66600,0,86600
140447702900000,NE 118,RESIDENTIAL,20000,0,20000,70000,0,90000
140447703000000,NE 118,RESIDENTIAL,20000,0,20000,52200,0,72200
140447703100000,NE 118,RESIDENTIAL,20000,0,20000,58800,0,78800
140447703200000,NE 118,RESIDENTIAL,20000,0,20000,69200,0,89200
140447703300000,NE 118,RESIDENTIAL,20000,0,20000,59300,0,79300
140447703400000,NE 118,RESIDENTIAL,20000,0,20000,68000,0,88000
140447703500000,NE 118,RESIDENTIAL,20000,0,20000,73500,0,93500
140447703600000,NE 118,RESIDENTIAL,20000,0,20000,63000,0,83000
140447703700000,NE 118,RESIDENTIAL,20000,0,20000,71400,0,91400
140447703800000,NE 118,RESIDENTIAL,20000,0,20000,63000,0,83000
140447703900000,NE 118,RESIDENTIAL,20900,0,20900,63400,0,84300
140447704000000,NE 118,RESIDENTIAL,20600,0,20600,72500,0,93100
140447800100000,NE 118,RESIDENTIAL,20300,0,20300,93100,0,113400
140447800200000,NE 118,RESIDENTIAL,25600,0,25600,91200,0,116800
140447800300000,NE 118,RESIDENTIAL,24800,0,24800,104000,0,128800
140447800400000,NE 118,RESIDENTIAL,23800,0,23800,63100,0,86900
140447800500000,NE 118,RESIDENTIAL,23400,0,23400,81800,0,105200
140447800600000,NE 118,RESIDENTIAL,23500,0,23500,95200,0,118700
140447800700000,NE 118,RESIDENTIAL,21800,0,21800,100900,0,122700
140447800800000,CITY PROPERTY,EXEMPT,0,0,0,0,0,0
140447800900000,NE 118,RESIDENTIAL,23400,0,23400,93200,0,116600
140447801000000,CITY PROPERTY,EXEMPT,0,0,0,0,0,0
140447801200000,NE 118,RESIDENTIAL,25000,0,25000,0,0,25000
140447801300000,OFFICE,COMMERCIAL,0,176000,176000,0,650200,826200
140447801400000,NE 118,RESIDENTIAL,20800,0,20800,97700,0,118500
140447801500000,NE 118,RESIDENTIAL,19700,0,19700,48200,0,67900
140447801600000,NE 118,RESIDENTIAL,19700,0,19700,72900,0,92600
140447801700000,NE 118,RESIDENTIAL,19700,0,19700,71500,0,91200
140447801800000,NE 118,RESIDENTIAL,19700,0,19700,87000,0,106700
140447801900000,NE 118,RESIDENTIAL,19700,0,19700,78000,0,97700
140447802000000,NE 118,RESIDENTIAL,19700,0,19700,71600,0,91300
140447802100000,NE 118,RESIDENTIAL,19700,0,19700,66800,0,86500
140447802200000,NE 118,RESIDENTIAL,19700,0,19700,68700,0,88400
140447802300000,NE 118,RESIDENTIAL,19700,0,19700,67300,0,87000
140447802400000,NE 118,RESIDENTIAL,19700,0,19700,62800,0,82500
140447802500000,NE 118,RESIDENTIAL,19700,0,19700,58800,0,78500
140447802600000,NE 118,RESIDENTIAL,19700,0,19700,67700,0,87400
140447802700000,NE 118,RESIDENTIAL,19700,0,19700,73800,0,93500
140447802800000,CITY PROPERTY,EXEMPT,0,0,0,0,0,0
140447802900000,NE 118,RESIDENTIAL,20800,0,20800,90300,0,111100
140447803000000,NE 118,RESIDENTIAL,19700,0,19700,63100,0,82800
140447803100000,NE 118,RESIDENTIAL,19700,0,19700,89400,0,109100
140447803200000,NE 118,RESIDENTIAL,19700,0,19700,79100,0,98800
140447900100000,NE 118,RESIDENTIAL,19500,0,19500,108800,0,128300
140447900200000,NE 118,RESIDENTIAL,25800,0,25800,99200,0,125000
140447900300000,NE 118,RESIDENTIAL,23800,0,23800,95400,0,119200
140447900400000,NE 118,RESIDENTIAL,23800,0,23800,98300,0,122100
140447900500000,NE 118,RESIDENTIAL,23800,0,23800,93700,0,117500
140447900600000,NE 118,RESIDENTIAL,23800,0,23800,146200,0,170000
140447900700000,NE 118,RESIDENTIAL,23800,0,23800,87300,0,111100
140447900800000,NE 118,RESIDENTIAL,23800,0,23800,86300,0,110100
140447900900000,NE 118,RESIDENTIAL,23800,0,23800,92900,0,116700
140447901000000,NE 118,RESIDENTIAL,23800,0,23800,103800,0,127600
140447901100000,NE 118,RESIDENTIAL,23800,0,23800,99100,0,122900
140447901201000,OFFICE,COMMERCIAL,0,27800,27800,0,83700,111500
140447901201001,OFFICE,COMMERCIAL,0,27800,27800,0,83700,111500
140447901201002,OFFICE,COMMERCIAL,0,27800,27800,0,83700,111500
140447901201003,OFFICE,COMMERCIAL,0,27800,27800,0,84400,112200
140447901201004,OFFICE,COMMERCIAL,0,35000,35000,0,102700,137700
140447901201005,OFFICE,COMMERCIAL,0,35000,35000,0,102700,137700
140447901201006,OFFICE,COMMERCIAL,0,139800,139800,0,294200,434000
140447901301000,OFFICE,COMMERCIAL,0,27800,27800,0,83300,111100
140447901301001,OFFICE,COMMERCIAL,0,27800,27800,0,82600,110400
140447901301002,OFFICE,COMMERCIAL,0,27800,27800,0,83700,111500
140447901301003,OFFICE,COMMERCIAL,0,27800,27800,0,83700,111500
140447901400000,CHURCH,EXEMPT,0,456000,456000,0,204700,660700
140447901401000,OFFICE,COMMERCIAL,0,27800,27800,0,80000,107800
140447901401001,OFFICE,COMMERCIAL,0,27800,27800,0,79200,107000
140447901401002,OFFICE,COMMERCIAL,0,27800,27800,0,80000,107800
140447901401003,OFFICE,COMMERCIAL,0,27800,27800,0,80600,108400
140447901500000,APARTMENT,MULTI-RES,37400,0,37400,121600,0,159000
140447901600000,APARTMENT,RESIDENTIAL,19500,0,19500,189200,0,208700
140447902000000,APARTMENT,RESIDENTIAL,64800,0,64800,656300,0,721100
140447902100000,APARTMENT,MULTI-RES,16200,0,16200,100700,0,116900
140447902200000,APARTMENT,MULTI-RES,28600,0,28600,145800,0,174400
140448000100000,NE 118,RESIDENTIAL,25600,0,25600,91100,0,116700
140448000200000,NE 118,RESIDENTIAL,23800,0,23800,84400,0,108200
140448000300000,NE 118,RESIDENTIAL,23800,0,23800,105000,0,128800
140448000400000,NE 118,RESIDENTIAL,23800,0,23800,94700,0,118500
140448000500000,NE 118,RESIDENTIAL,24600,0,24600,100700,0,125300
140448000600000,NE 118,RESIDENTIAL,23000,0,23000,102400,0,125400
140448000700000,NE 118,RESIDENTIAL,23800,0,23800,97600,0,121400
140448000800000,NE 118,RESIDENTIAL,23400,0,23400,108100,0,131500
140448000900000,NE 118,RESIDENTIAL,19900,0,19900,68500,0,88400
140448001000000,NE 118,RESIDENTIAL,24200,0,24200,103400,0,127600
140448001100000,NE 118,RESIDENTIAL,19800,0,19800,0,0,19800
140510600100000,CONVENIENCE STORE,COMMERCIAL,0,207000,207000,0,259400,466400
140510600200000,FLAT PARKING,COMMERCIAL,0,168000,168000,0,11400,179400
140510600300000,NBHD SHOPPING CENTER,COMMERCIAL,0,91500,91500,0,350900,442400
140510600400000,WAREHOUSE,COMMERCIAL,0,236000,236000,0,326300,562300
140510600501000,NBHD SHOPPING CENTER,COMMERCIAL,0,34500,34500,0,125600,160100
140510600501001,NBHD SHOPPING CENTER,COMMERCIAL,0,23700,23700,0,86600,110300
140510600501002,NBHD SHOPPING CENTER,COMMERCIAL,0,28000,28000,0,102000,130000
140510600501003,NBHD SHOPPING CENTER,COMMERCIAL,0,21500,21500,0,78900,100400
140510600501004,NBHD SHOPPING CENTER,COMMERCIAL,0,28000,28000,0,102000,130000
140510600501005,NBHD SHOPPING CENTER,COMMERCIAL,0,23700,23700,0,86600,110300
140510600501006,NBHD SHOPPING CENTER,COMMERCIAL,0,28000,28000,0,102000,130000
140510600501007,NBHD SHOPPING CENTER,COMMERCIAL,0,23700,23700,0,86600,110300
140510600501008,NBHD SHOPPING CENTER,COMMERCIAL,0,28000,28000,0,102000,130000
140510600501009,NBHD SHOPPING CENTER,COMMERCIAL,0,23700,23700,0,86600,110300
140510600501010,NBHD SHOPPING CENTER,COMMERCIAL,0,28000,28000,0,102000,130000
140510600501011,NBHD SHOPPING CENTER,COMMERCIAL,0,25800,25800,0,94300,120100
140510600501012,NBHD SHOPPING CENTER,COMMERCIAL,0,28000,28000,0,102000,130000
140510600501013,NBHD SHOPPING CENTER,COMMERCIAL,0,23700,23700,0,86600,110300
140510600501014,NBHD SHOPPING CENTER,COMMERCIAL,0,28000,28000,0,106100,134100
140510600501015,NBHD SHOPPING CENTER,COMMERCIAL,0,23700,23700,0,87400,111100
140510600501016,NBHD SHOPPING CENTER,COMMERCIAL,0,28000,28000,0,103000,131000
140510600501017,NBHD SHOPPING CENTER,COMMERCIAL,0,23700,23700,0,86600,110300
140510600501018,NBHD SHOPPING CENTER,COMMERCIAL,0,28000,28000,0,107600,135600
140510600501019,NBHD SHOPPING CENTER,COMMERCIAL,0,23700,23700,0,86600,110300
140510600501020,NBHD SHOPPING CENTER,COMMERCIAL,0,29500,29500,0,104700,134200
140510600501021,NBHD SHOPPING CENTER,COMMERCIAL,0,22300,22300,0,81300,103600
140510600501022,NBHD SHOPPING CENTER,COMMERCIAL,0,25800,25800,0,94300,120100
140510600501023,NBHD SHOPPING CENTER,COMMERCIAL,0,22500,22500,0,82000,104500
140510600501024,NBHD SHOPPING CENTER,COMMERCIAL,0,29200,29200,0,113700,142900
140510600600000,FAST FOOD,COMMERCIAL,0,546800,546800,0,750200,1297000
140510600700000,FLAT PARKING,COMMERCIAL,0,207800,207800,0,78300,286100
140510600900000,FAST FOOD,COMMERCIAL,0,535600,535600,0,782700,1318300
140510601000000,FLAT PARKING,COMMERCIAL,0,140700,140700,0,58500,199200
140510601200000,FAST FOOD,COMMERCIAL,0,248000,248000,0,616600,864600
140510601300000,FAST FOOD,COMMERCIAL,0,225200,225200,0,476300,701500
140510601400000,FAST FOOD,COMMERCIAL,0,394400,394400,0,907000,1301400
140510601500000,VACANT LAND,COMMERCIAL,0,228000,228000,0,0,228000
140512900100000,NBHD SHOPPING CENTER,COMMERCIAL,0,276400,276400,0,587200,863600
140512900200000,RESTAURANT,COMMERCIAL,0,216900,216900,0,288800,505700
140512900300000,FAST FOOD,COMMERCIAL,0,299200,299200,0,434500,733700
140512900400000,SMALL RETAIL,COMMERCIAL,0,322400,322400,0,475100,797500
140512900900000,GROCERY STORE,COMMERCIAL,0,507500,507500,0,1021400,1528900
140512901200000,LG DISCOUNT/RETAIL,COMMERCIAL,0,1339000,1339000,0,7162700,8501700
140512901300000,VACANT LAND,COMMERCIAL,0,2000,2000,0,0,2000
140512901500000,BRANCH BANK/CU,COMMERCIAL,0,882600,882600,0,3519300,4401900
140515100300000,VACANT LAND,COMMERCIAL,0,31300,31300,0,0,31300
140515100500000,CHURCH,EXEMPT,0,1402300,1402300,0,5957000,7359300
140517600300000,WAREHOUSE,COMMERCIAL,0,209900,209900,0,830600,1040500
140517600400000,WAREHOUSE,COMMERCIAL,0,239000,239000,0,662600,901600
140517600500000,WAREHOUSE,COMMERCIAL,0,200500,200500,0,783800,984300
140517600600000,VACANT LAND,COMMERCIAL,0,104100,104100,0,0,104100
140517600700000,DAY CARE CENTER,COMMERCIAL,0,93600,93600,0,365200,458800
140517600800000,VACANT LAND,COMMERCIAL,0,108000,108000,0,0,108000
140517600900000,LG DISCOUNT/RETAIL,COMMERCIAL,0,1165000,1165000,0,5024000,6189000
140517601000000,LG DISCOUNT/RETAIL,COMMERCIAL,0,1495100,1495100,0,6715700,8210800
140517601100000,WAREHOUSE,COMMERCIAL,0,254100,254100,0,1179900,1434000
140517601200000,BILLBOARD(BLL),COMMERCIAL,0,203500,203500,0,73900,277400
140520800100000,NE 111,RESIDENTIAL,700,0,700,0,0,700
140520800200000,SECTION 42,COMMERCIAL,0,128000,128000,0,127000,255000
140520800300000,NE 168,RESIDENTIAL,60000,0,60000,187500,0,247500
140520800400000,APARTMENT,EXEMPT,0,108800,108800,0,524200,633000
140520800500000,APARTMENT,EXEMPT,0,43700,43700,0,181400,225100
140522700100000,CHURCH,EXEMPT,0,412900,412900,0,704100,1117000
140522700200000,NE 113,RESIDENTIAL,25400,0,25400,100300,0,125700
140522700300000,NE 113,RESIDENTIAL,25400,0,25400,113900,0,139300
140522700400000,NE 113,RESIDENTIAL,25700,0,25700,111200,0,136900
140522700500000,NE 113,RESIDENTIAL,25700,0,25700,105700,0,131400
140522700600000,NE 113,RESIDENTIAL,25900,0,25900,131200,0,157100
140522700700000,NE 113,RESIDENTIAL,25100,0,25100,101800,0,126900
140522700800000,NE 113,RESIDENTIAL,29500,0,29500,98800,0,128300
140522700900000,NE 113,RESIDENTIAL,29500,0,29500,104700,0,134200
140522701000000,NE 113,RESIDENTIAL,25400,0,25400,99100,0,124500
140522701100000,NE 113,RESIDENTIAL,25400,0,25400,95800,0,121200
140522701200000,NE 113,RESIDENTIAL,25400,0,25400,101300,0,126700
140522701300000,NE 113,RESIDENTIAL,27800,0,27800,97100,0,124900
140522800100000,CHURCH,EXEMPT,0,458000,458000,0,1760800,2218800
140522800200000,NE 113,RESIDENTIAL,27800,0,27800,118800,0,146600
140522800300000,NE 113,RESIDENTIAL,27000,0,27000,118100,0,145100
140522800400000,NE 113,RESIDENTIAL,26700,0,26700,105000,0,131700
140522800500000,NE 113,RESIDENTIAL,26700,0,26700,93800,0,120500
140522800600000,NE 113,RESIDENTIAL,26500,0,26500,117200,0,143700
140522800700000,NE 113,RESIDENTIAL,26500,0,26500,109800,0,136300
140522800800000,NE 113,RESIDENTIAL,26500,0,26500,108100,0,134600
140522800900000,NE 113,RESIDENTIAL,27600,0,27600,123100,0,150700
140522801000000,NE 113,RESIDENTIAL,29100,0,29100,121800,0,150900
140522801100000,NE 113,RESIDENTIAL,28700,0,28700,124300,0,153000
140522801200000,NE 113,RESIDENTIAL,26700,0,26700,90300,0,117000
140522801300000,NE 113,RESIDENTIAL,26500,0,26500,108700,0,135200
140522801400000,NE 113,RESIDENTIAL,26500,0,26500,94900,0,121400
140522900100000,NE 113,RESIDENTIAL,26400,0,26400,113500,0,139900
140522900200000,NE 113,RESIDENTIAL,28600,0,28600,106600,0,135200
140522900300000,NE 113,RESIDENTIAL,28600,0,28600,111800,0,140400
140522900400000,NE 113,RESIDENTIAL,25400,0,25400,82100,0,107500
140522900500000,NE 113,RESIDENTIAL,24700,0,24700,111500,0,136200
140522900600000,NE 113,RESIDENTIAL,26100,0,26100,114100,0,140200
140522900700000,NE 113,RESIDENTIAL,25400,0,25400,104300,0,129700
140522900800000,NE 113,RESIDENTIAL,25400,0,25400,101800,0,127200
140522900900000,NE 113,RESIDENTIAL,25400,0,25400,109400,0,134800
140522901000000,NE 113,RESIDENTIAL,25400,0,25400,110900,0,136300
140522901100000,NE 113,RESIDENTIAL,26400,0,26400,102800,0,129200
140523000100000,NE 113,RESIDENTIAL,28400,0,28400,116200,0,144600
140523000200000,NE 113,RESIDENTIAL,27600,0,27600,112200,0,139800
140523000300000,NE 113,RESIDENTIAL,27600,0,27600,103900,0,131500
140523000400000,NE 113,RESIDENTIAL,27600,0,27600,112200,0,139800
140523000500000,NE 113,RESIDENTIAL,27600,0,27600,102700,0,130300
140523000600000,NE 113,RESIDENTIAL,27600,0,27600,110800,0,138400
140523000700000,NE 113,RESIDENTIAL,27600,0,27600,111900,0,139500
140523000800000,NE 113,RESIDENTIAL,30100,0,30100,106800,0,136900
140523000900000,NE 113,RESIDENTIAL,27800,0,27800,107400,0,135200
140523001000000,NE 113,RESIDENTIAL,27800,0,27800,131500,0,159300
140523001100000,NE 113,RESIDENTIAL,31500,0,31500,100800,0,132300
140523001200000,NE 113,RESIDENTIAL,31300,0,31300,112200,0,143500
140523001300000,NE 113,RESIDENTIAL,28700,0,28700,118100,0,146800
140523001400000,NE 113,RESIDENTIAL,28700,0,28700,115100,0,143800
140523001500000,NE 113,RESIDENTIAL,28700,0,28700,108300,0,137000
140525100100000,NE 113,RESIDENTIAL,27900,0,27900,103500,0,131400
140525100200000,NE 113,RESIDENTIAL,25400,0,25400,102000,0,127400
140525100300000,NE 113,RESIDENTIAL,25400,0,25400,106900,0,132300
140525100400000,NE 113,RESIDENTIAL,25400,0,25400,79100,0,104500
140525100500000,NE 113,RESIDENTIAL,25400,0,25400,107400,0,132800
140525100600000,NE 113,RESIDENTIAL,25400,0,25400,106500,0,131900
140525100700000,NE 113,RESIDENTIAL,27300,0,27300,100600,0,127900
140525100800000,NE 113,RESIDENTIAL,27300,0,27300,90700,0,118000
140525100900000,NE 113,RESIDENTIAL,25400,0,25400,100300,0,125700
140525101000000,NE 113,RESIDENTIAL,25400,0,25400,101800,0,127200
140525101100000,NE 113,RESIDENTIAL,25400,0,25400,116900,0,142300
140525101200000,NE 113,RESIDENTIAL,25400,0,25400,95000,0,120400
140525101300000,NE 113,RESIDENTIAL,25400,0,25400,106100,0,131500
140525101400000,NE 113,RESIDENTIAL,27900,0,27900,111000,0,138900
140525101500000,NE 113,RESIDENTIAL,27800,0,27800,113400,0,141200
140525101600000,NE 113,RESIDENTIAL,25400,0,25400,107700,0,133100
140525101700000,NE 113,RESIDENTIAL,25400,0,25400,116400,0,141800
140525101800000,NE 113,RESIDENTIAL,25400,0,25400,113400,0,138800
140525101900000,NE 113,RESIDENTIAL,27800,0,27800,123700,0,151500
140525102000000,NE 113,RESIDENTIAL,27900,0,27900,126300,0,154200
140525102100000,NE 113,RESIDENTIAL,25400,0,25400,96600,0,122000
140525102200000,NE 113,RESIDENTIAL,25400,0,25400,115400,0,140800
140525102300000,NE 113,RESIDENTIAL,25400,0,25400,99800,0,125200
140525102400000,NE 113,RESIDENTIAL,25400,0,25400,107400,0,132800
140525102500000,NE 113,RESIDENTIAL,25400,0,25400,102600,0,128000
140525102600000,NE 113,RESIDENTIAL,27300,0,27300,112800,0,140100
140525102700000,NE 113,RESIDENTIAL,27300,0,27300,108800,0,136100
140525102800000,NE 113,RESIDENTIAL,27300,0,27300,87800,0,115100
140525102900000,NE 113,RESIDENTIAL,27300,0,27300,96200,0,123500
140525103000000,NE 113,RESIDENTIAL,27300,0,27300,107400,0,134700
140525103100000,NE 113,RESIDENTIAL,27300,0,27300,109000,0,136300
140525103200000,NE 113,RESIDENTIAL,26800,0,26800,123600,0,150400
140525103300000,NE 113,RESIDENTIAL,28500,0,28500,97100,0,125600
140525103400000,NE 113,RESIDENTIAL,26800,0,26800,129800,0,156600
140525103500000,NE 113,RESIDENTIAL,27300,0,27300,105100,0,132400
140525103600000,NE 113,RESIDENTIAL,26500,0,26500,102800,0,129300
140525200100000,NE 113,RESIDENTIAL,26600,0,26600,89400,0,116000
140525200200000,NE 113,RESIDENTIAL,25400,0,25400,107700,0,133100
140525200300000,NE 113,RESIDENTIAL,25400,0,25400,108200,0,133600
140525200400000,NE 113,RESIDENTIAL,25400,0,25400,106100,0,131500
140525200500000,NE 113,RESIDENTIAL,25400,0,25400,106100,0,131500
140525200600000,NE 113,RESIDENTIAL,25900,0,25900,128900,0,154800
140525200700000,NE 113,RESIDENTIAL,25900,0,25900,95200,0,121100
140525200800000,NE 113,RESIDENTIAL,25400,0,25400,107100,0,132500
140525200900000,NE 113,RESIDENTIAL,25400,0,25400,108800,0,134200
140525201000000,NE 113,RESIDENTIAL,25400,0,25400,114900,0,140300
140525201100000,NE 113,RESIDENTIAL,25400,0,25400,116400,0,141800
140525201200000,NE 113,RESIDENTIAL,26600,0,26600,102500,0,129100
140525300100000,NE 113,RESIDENTIAL,28700,0,28700,112400,0,141100
140525300200000,NE 113,RESIDENTIAL,28700,0,28700,77600,0,106300
140525300300000,NE 113,RESIDENTIAL,28700,0,28700,110100,0,138800
140525300400000,NE 113,RESIDENTIAL,31300,0,31300,101700,0,133000
140525300500000,NE 113,RESIDENTIAL,31200,0,31200,117400,0,148600
140525300600000,NE 113,RESIDENTIAL,30800,0,30800,118300,0,149100
140525300700000,NE 113,RESIDENTIAL,27800,0,27800,113800,0,141600
140525300800000,NE 113,RESIDENTIAL,27800,0,27800,87600,0,115400
140525300900000,NE 113,RESIDENTIAL,26200,0,26200,116500,0,142700
140525301000000,NE 113,RESIDENTIAL,26200,0,26200,108700,0,134900
140525301100000,NE 113,RESIDENTIAL,26200,0,26200,108300,0,134500
140525301200000,NE 113,RESIDENTIAL,26300,0,26300,95600,0,121900
140525301300000,NE 113,RESIDENTIAL,26100,0,26100,127600,0,153700
140525301400000,NE 113,RESIDENTIAL,28400,0,28400,121900,0,150300
140525301500000,NE 113,RESIDENTIAL,27000,0,27000,97100,0,124100
140525301600000,NE 113,RESIDENTIAL,27000,0,27000,102500,0,129500
140525301700000,NE 113,RESIDENTIAL,27000,0,27000,83900,0,110900
140525301800000,NE 113,RESIDENTIAL,27000,0,27000,77600,0,104600
140525301900000,NE 113,RESIDENTIAL,27000,0,27000,81300,0,108300
140525302000000,NE 113,RESIDENTIAL,27000,0,27000,92400,0,119400
140525302100000,NE 113,RESIDENTIAL,27000,0,27000,111800,0,138800
140525302200000,NE 113,RESIDENTIAL,28400,0,28400,105300,0,133700
140525302300000,NE 113,RESIDENTIAL,27000,0,27000,106400,0,133400
140525302400000,NE 113,RESIDENTIAL,27700,0,27700,113000,0,140700
140525302500000,NE 113,RESIDENTIAL,26300,0,26300,99300,0,125600
140525302600000,NE 113,RESIDENTIAL,27000,0,27000,62500,0,89500
140525302700000,NE 113,RESIDENTIAL,29100,0,29100,97300,0,126400
140525302800000,NE 113,RESIDENTIAL,30700,0,30700,100000,0,130700
140525302900000,NE 113,RESIDENTIAL,30800,0,30800,105600,0,136400
140525303000000,NE 113,RESIDENTIAL,31300,0,31300,110200,0,141500
140525303100000,NE 113,RESIDENTIAL,29100,0,29100,119600,0,148700
140525303200000,NE 113,RESIDENTIAL,27000,0,27000,110000,0,137000
140525303300000,NE 113,RESIDENTIAL,27000,0,27000,107400,0,134400
140525303400000,NE 113,RESIDENTIAL,27000,0,27000,100400,0,127400
140525303500000,NE 113,RESIDENTIAL,27000,0,27000,119700,0,146700
140525400100000,NE 113,RESIDENTIAL,26500,0,26500,122400,0,148900
140525400200000,NE 113,RESIDENTIAL,26500,0,26500,117000,0,143500
140525400300000,NE 113,RESIDENTIAL,25900,0,25900,108600,0,134500
140525400400000,NE 113,RESIDENTIAL,26200,0,26200,112600,0,138800
140525400500000,NE 113,RESIDENTIAL,25600,0,25600,88300,0,113900
140525400600000,NE 113,RESIDENTIAL,25900,0,25900,127400,0,153300
140525400700000,NE 113,RESIDENTIAL,25900,0,25900,94400,0,120300
140525400800000,NE 113,RESIDENTIAL,26200,0,26200,110900,0,137100
140525400900000,NE 113,RESIDENTIAL,26200,0,26200,112000,0,138200
140525401000000,NE 113,RESIDENTIAL,26200,0,26200,94700,0,120900
140525500100000,NE 113,RESIDENTIAL,25700,0,25700,100300,0,126000
140525500200000,NE 113,RESIDENTIAL,25900,0,25900,110300,0,136200
140525500300000,NE 113,RESIDENTIAL,25700,0,25700,109600,0,135300
140525500400000,NE 113,RESIDENTIAL,25700,0,25700,98400,0,124100
140525500500000,NE 113,RESIDENTIAL,26000,0,26000,109000,0,135000
140525500600000,NE 113,RESIDENTIAL,30500,0,30500,90800,0,121300
140525500700000,NE 113,RESIDENTIAL,25500,0,25500,88600,0,114100
140525500800000,NE 113,RESIDENTIAL,26300,0,26300,118600,0,144900
140525500900000,NE 113,RESIDENTIAL,25700,0,25700,100700,0,126400
140525600100000,NE 113,RESIDENTIAL,26900,0,26900,127000,0,153900
140525600200000,NE 113,RESIDENTIAL,27100,0,27100,128200,0,155300
140525600300000,NE 113,RESIDENTIAL,26100,0,26100,133400,0,159500
140525600400000,NE 113,RESIDENTIAL,26100,0,26100,110100,0,136200
140525600500000,NE 113,RESIDENTIAL,27300,0,27300,127800,0,155100
140525600600000,NE 113,RESIDENTIAL,31700,0,31700,120100,0,151800
140525600700000,NE 113,RESIDENTIAL,25900,0,25900,100800,0,126700
140525600800000,NE 113,RESIDENTIAL,25900,0,25900,115200,0,141100
140525600900000,NE 113,RESIDENTIAL,25900,0,25900,109500,0,135400
140525601000000,NE 113,RESIDENTIAL,25900,0,25900,110100,0,136000
140525601100000,NE 113,RESIDENTIAL,25900,0,25900,110800,0,136700
140525601200000,NE 113,RESIDENTIAL,25900,0,25900,118700,0,144600
140525601300000,NE 113,RESIDENTIAL,25900,0,25900,112500,0,138400
140525601400000,NE 113,RESIDENTIAL,26500,0,26500,111000,0,137500
140525601500000,NE 113,RESIDENTIAL,25900,0,25900,123700,0,149600
140525601600000,NE 113,RESIDENTIAL,25900,0,25900,107600,0,133500
140525601700000,NE 113,RESIDENTIAL,25900,0,25900,122600,0,148500
140525601800000,NE 113,RESIDENTIAL,25900,0,25900,108900,0,134800
140525601900000,NE 113,RESIDENTIAL,25700,0,25700,102900,0,128600
140525602000000,NE 113,RESIDENTIAL,27900,0,27900,101100,0,129000
140525602100000,NE 113,RESIDENTIAL,28400,0,28400,141000,0,169400
140525602200000,NE 113,RESIDENTIAL,27900,0,27900,112000,0,139900
140525602300000,NE 113,RESIDENTIAL,27200,0,27200,104300,0,131500
140525602400000,NE 113,RESIDENTIAL,27500,0,27500,109100,0,136600
140525602500000,NE 113,RESIDENTIAL,27300,0,27300,99500,0,126800
140525602600000,NE 113,RESIDENTIAL,27300,0,27300,126500,0,153800
140525602700000,NE 113,RESIDENTIAL,27300,0,27300,114900,0,142200
140525602800000,NE 113,RESIDENTIAL,27700,0,27700,98600,0,126300
140525602900000,NE 113,RESIDENTIAL,27500,0,27500,95000,0,122500
140525603000000,NE 113,RESIDENTIAL,26700,0,26700,109400,0,136100
140525603100000,NE 113,RESIDENTIAL,26700,0,26700,106200,0,132900
140525700100000,NE 113,RESIDENTIAL,27200,0,27200,167200,0,194400
140525700200000,NE 113,RESIDENTIAL,25400,0,25400,93100,0,118500
140525700300000,NE 113,RESIDENTIAL,25400,0,25400,94200,0,119600
140525700400000,NE 113,RESIDENTIAL,25400,0,25400,110000,0,135400
140525700500000,NE 113,RESIDENTIAL,25400,0,25400,94500,0,119900
140525700600000,NE 113,RESIDENTIAL,25400,0,25400,105600,0,131000
140525700700000,NE 113,RESIDENTIAL,25400,0,25400,111000,0,136400
140525700800000,NE 113,RESIDENTIAL,25400,0,25400,110300,0,135700
140525700900000,NE 113,RESIDENTIAL,25400,0,25400,105300,0,130700
140525701000000,NE 113,RESIDENTIAL,25400,0,25400,101900,0,127300
140525701100000,NE 113,RESIDENTIAL,25400,0,25400,109500,0,134900
140525701200000,NE 113,RESIDENTIAL,27300,0,27300,104400,0,131700
140525701300000,NE 113,RESIDENTIAL,26700,0,26700,108800,0,135500
140525701400000,NE 113,RESIDENTIAL,26700,0,26700,107500,0,134200
140525701500000,NE 113,RESIDENTIAL,26700,0,26700,125500,0,152200
140525701600000,NE 113,RESIDENTIAL,27600,0,27600,111000,0,138600
140525701700000,NE 113,RESIDENTIAL,27300,0,27300,115600,0,142900
140525701800000,NE 113,RESIDENTIAL,26700,0,26700,109700,0,136400
140525701900000,NE 113,RESIDENTIAL,26700,0,26700,118800,0,145500
140525702000000,NE 113,RESIDENTIAL,26700,0,26700,120700,0,147400
140525702100000,NE 113,RESIDENTIAL,27900,0,27900,105700,0,133600
140525702200000,NE 113,RESIDENTIAL,31500,0,31500,99400,0,130900
140525702300000,NE 113,RESIDENTIAL,28800,0,28800,119100,0,147900
140525702400000,NE 113,RESIDENTIAL,26500,0,26500,116500,0,143000
140525702500000,NE 113,RESIDENTIAL,26700,0,26700,107500,0,134200
140525702600000,NE 113,RESIDENTIAL,26700,0,26700,116500,0,143200
140525702700000,NE 113,RESIDENTIAL,27000,0,27000,112000,0,139000
140525702800000,NE 113,RESIDENTIAL,27000,0,27000,141200,0,168200
140525800100000,NE 113,RESIDENTIAL,28400,0,28400,132800,0,161200
140525800200000,NE 113,RESIDENTIAL,25400,0,25400,100200,0,125600
140525800300000,NE 113,RESIDENTIAL,25400,0,25400,99100,0,124500
140525800400000,NE 113,RESIDENTIAL,27100,0,27100,103800,0,130900
140525800500000,NE 113,RESIDENTIAL,27300,0,27300,112600,0,139900
140525900200000,NE 113,RESIDENTIAL,27100,0,27100,108200,0,135300
140525900300000,NE 113,RESIDENTIAL,27000,0,27000,108500,0,135500
140525900400000,NE 113,RESIDENTIAL,27300,0,27300,103500,0,130800
140525900500000,NE 113,RESIDENTIAL,27300,0,27300,103700,0,131000
140525900600000,NE 113,RESIDENTIAL,27300,0,27300,110800,0,138100
140525900700000,NE 113,RESIDENTIAL,27300,0,27300,122200,0,149500
140527600100000,MFG HOME PARK,MULTI-RES,3114500,0,3114500,2192300,0,5306800
140530100100000,NE 123,RESIDENTIAL,16200,0,16200,7400,0,23600
140530100200000,NE 123,RESIDENTIAL,27500,0,27500,102300,0,129800
140530100300000,NE 123,RESIDENTIAL,27100,0,27100,117600,0,144700
140530100400000,NE 123,RESIDENTIAL,27100,0,27100,99400,0,126500
140530100500000,NE 123,RESIDENTIAL,27100,0,27100,102900,0,130000
140530100600000,NE 123,RESIDENTIAL,28000,0,28000,106100,0,134100
140530100700000,NE 123,RESIDENTIAL,28400,0,28400,103600,0,132000
140530100800000,NE 123,RESIDENTIAL,28400,0,28400,115200,0,143600
140530100900000,NE 123,RESIDENTIAL,29000,0,29000,94100,0,123100
140530101000000,NE 123,RESIDENTIAL,27100,0,27100,105200,0,132300
140530101100000,NE 123,RESIDENTIAL,27100,0,27100,114900,0,142000
140530101200000,NE 123,RESIDENTIAL,27100,0,27100,91700,0,118800
140530101300000,NE 123,RESIDENTIAL,29100,0,29100,95900,0,125000
140530101400000,NE 123,RESIDENTIAL,38500,0,38500,116800,0,155300
140530101500000,NE 123,RESIDENTIAL,27900,0,27900,117700,0,145600
140530101600000,NE 123,RESIDENTIAL,27100,0,27100,126000,0,153100
140530101700000,NE 123,RESIDENTIAL,27100,0,27100,106600,0,133700
140530101800000,NE 123,RESIDENTIAL,27100,0,27100,101900,0,129000
140530101900000,NE 123,RESIDENTIAL,27100,0,27100,139800,0,166900
140530102000000,NE 123,RESIDENTIAL,27100,0,27100,104900,0,132000
140530102100000,NE 123,RESIDENTIAL,27100,0,27100,106100,0,133200
140530102200000,NE 123,RESIDENTIAL,27100,0,27100,115900,0,143000
140530200100000,NE 123,RESIDENTIAL,28200,0,28200,98100,0,126300
140530200200000,NE 123,RESIDENTIAL,27400,0,27400,101700,0,129100
140530200300000,NE 123,RESIDENTIAL,27400,0,27400,94800,0,122200
140530200400000,NE 123,RESIDENTIAL,27400,0,27400,101700,0,129100
140530200500000,NE 123,RESIDENTIAL,27400,0,27400,117400,0,144800
140530200600000,NE 123,RESIDENTIAL,27400,0,27400,97600,0,125000
140530200700000,NE 123,RESIDENTIAL,27400,0,27400,111100,0,138500
140530200800000,NE 123,RESIDENTIAL,27400,0,27400,119400,0,146800
140530200900000,NE 123,RESIDENTIAL,27400,0,27400,124600,0,152000
140530300100000,NE 123,RESIDENTIAL,28000,0,28000,86000,0,114000
140530300200000,NE 123,RESIDENTIAL,28500,0,28500,112000,0,140500
140530300300000,NE 123,RESIDENTIAL,26900,0,26900,97900,0,124800
140530300400000,NE 123,RESIDENTIAL,28500,0,28500,129100,0,157600
140530300500000,NE 123,RESIDENTIAL,27100,0,27100,100000,0,127100
140530300600000,NE 123,RESIDENTIAL,28500,0,28500,86300,0,114800
140530300700000,NE 123,RESIDENTIAL,27100,0,27100,100100,0,127200
140530300800000,NE 123,RESIDENTIAL,26100,0,26100,93200,0,119300
140530300900000,NE 123,RESIDENTIAL,29400,0,29400,140500,0,169900
140530301000000,NE 123,RESIDENTIAL,27000,0,27000,132600,0,159600
140530301100000,NE 123,RESIDENTIAL,28600,0,28600,111400,0,140000
140530301200000,NE 123,RESIDENTIAL,26100,0,26100,110900,0,137000
140530301300000,NE 123,RESIDENTIAL,29800,0,29800,112600,0,142400
140530301400000,NE 123,RESIDENTIAL,26300,0,26300,102400,0,128700
140530301500000,NE 123,RESIDENTIAL,28500,0,28500,99400,0,127900
140530301600000,NE 123,RESIDENTIAL,28500,0,28500,128500,0,157000
140530301700000,NE 123,RESIDENTIAL,28500,0,28500,124500,0,153000
140530301800000,NE 123,RESIDENTIAL,28500,0,28500,104200,0,132700
140530400100000,NE 123,RESIDENTIAL,29300,0,29300,112700,0,142000
140530400200000,NE 123,RESIDENTIAL,28200,0,28200,114500,0,142700
140530400300000,NE 123,RESIDENTIAL,28500,0,28500,132000,0,160500
140530400400000,NE 123,RESIDENTIAL,28500,0,28500,119200,0,147700
140530400500000,NE 123,RESIDENTIAL,28500,0,28500,115500,0,144000
140530400600000,NE 123,RESIDENTIAL,28500,0,28500,112300,0,140800
140530400700000,NE 123,RESIDENTIAL,28600,0,28600,125800,0,154400
140530400800000,NE 123,RESIDENTIAL,28300,0,28300,93200,0,121500
140530400900000,NE 123,RESIDENTIAL,27700,0,27700,111100,0,138800
140530401000000,NE 123,RESIDENTIAL,27700,0,27700,118800,0,146500
140530401100000,NE 123,RESIDENTIAL,27700,0,27700,109100,0,136800
140530401200000,NE 123,RESIDENTIAL,27700,0,27700,88300,0,116000
140530401300000,NE 123,RESIDENTIAL,27700,0,27700,111800,0,139500
140530401400000,NE 123,RESIDENTIAL,27700,0,27700,94000,0,121700
140530401500000,NE 123,RESIDENTIAL,27700,0,27700,117400,0,145100
140532600100000,NE 113,RESIDENTIAL,27300,0,27300,125000,0,152300
140532600200000,NE 113,RESIDENTIAL,34600,0,34600,126500,0,161100
140532600300000,NE 113,RESIDENTIAL,37000,0,37000,121000,0,158000
140532600400000,NE 113,RESIDENTIAL,28200,0,28200,116800,0,145000
140532600500000,NE 113,RESIDENTIAL,27900,0,27900,108600,0,136500
140532600600000,NE 113,RESIDENTIAL,27300,0,27300,129800,0,157100
140532600700000,NE 113,RESIDENTIAL,30700,0,30700,132400,0,163100
140532600800000,NE 113,RESIDENTIAL,28600,0,28600,119700,0,148300
140532600900000,NE 113,RESIDENTIAL,27000,0,27000,90300,0,117300
140532601000000,NE 113,RESIDENTIAL,26700,0,26700,108700,0,135400
140532601100000,NE 113,RESIDENTIAL,26500,0,26500,91800,0,118300
140532601300000,NE 113,RESIDENTIAL,27000,0,27000,147800,0,174800
140532601400000,NE 113,RESIDENTIAL,31600,0,31600,203100,0,234700
140532601500000,NE 113,RESIDENTIAL,37600,0,37600,0,0,37600
140532601600000,NE 113,RESIDENTIAL,29000,0,29000,0,0,29000
140532601700000,NE 113,RESIDENTIAL,28300,0,28300,192500,0,220800
140532601800000,NE 113,RESIDENTIAL,29500,0,29500,161000,0,190500
140532601900000,NE 113,RESIDENTIAL,30300,0,30300,167900,0,198200
140532602000000,NE 113,RESIDENTIAL,30800,0,30800,134600,0,165400
140532602100000,NE 113,RESIDENTIAL,31500,0,31500,185900,0,217400
140532602200000,NE 113,RESIDENTIAL,35500,0,35500,137300,0,172800
140532602300000,NE 113,RESIDENTIAL,30600,0,30600,167300,0,197900
140535100100000,CITY PROPERTY,EXEMPT,0,0,0,0,0,0
140535900100000,NE 113,RESIDENTIAL,26500,0,26500,100600,0,127100
140537600100000,NE 123,RESIDENTIAL,27400,0,27400,107300,0,134700
140537600200000,NE 123,RESIDENTIAL,25500,0,25500,100300,0,125800
140537600300000,NE 123,RESIDENTIAL,27700,0,27700,107800,0,135500
140537600400000,NE 123,RESIDENTIAL,27400,0,27400,103900,0,131300
140537600500000,NE 123,RESIDENTIAL,28000,0,28000,73400,0,101400
140537600600000,NE 123,RESIDENTIAL,29600,0,29600,115500,0,145100
140537600700000,NE 123,RESIDENTIAL,29600,0,29600,93700,0,123300
140537600800000,NE 123,RESIDENTIAL,27600,0,27600,99300,0,126900
140537600900000,NE 123,RESIDENTIAL,27400,0,27400,110700,0,138100
140537601000000,NE 123,RESIDENTIAL,26500,0,26500,115100,0,141600
140537601100000,NE 123,RESIDENTIAL,27600,0,27600,107100,0,134700
140537601200000,NE 123,RESIDENTIAL,27500,0,27500,90100,0,117600
140537601300000,NE 123,RESIDENTIAL,27800,0,27800,127800,0,155600
140537601400000,NE 123,RESIDENTIAL,24500,0,24500,101200,0,125700
140537601500000,NE 123,RESIDENTIAL,24500,0,24500,121900,0,146400
140537601600000,NE 123,RESIDENTIAL,26100,0,26100,119200,0,145300
140537601700000,NE 123,RESIDENTIAL,26100,0,26100,112800,0,138900
140537601800000,NE 123,RESIDENTIAL,26100,0,26100,104800,0,130900
140537601900000,NE 123,RESIDENTIAL,26100,0,26100,88100,0,114200
140537602200000,NE 123,RESIDENTIAL,25400,0,25400,93500,0,118900
140537700100000,NE 123,RESIDENTIAL,26700,0,26700,97000,0,123700
140537700200000,NE 123,RESIDENTIAL,28500,0,28500,100800,0,129300
140537700300000,NE 123,RESIDENTIAL,28400,0,28400,100000,0,128400
140537700400000,NE 123,RESIDENTIAL,28800,0,28800,105400,0,134200
140537700500000,NE 123,RESIDENTIAL,32900,0,32900,126000,0,158900
140537700600000,NE 123,RESIDENTIAL,30300,0,30300,129600,0,159900
140537700700000,NE 123,RESIDENTIAL,27400,0,27400,95300,0,122700
140537700800000,NE 123,RESIDENTIAL,27600,0,27600,98300,0,125900
140537700900000,NE 123,RESIDENTIAL,26700,0,26700,124400,0,151100
140537701000000,NE 123,RESIDENTIAL,30400,0,30400,99900,0,130300
140537800100000,NE 123,RESIDENTIAL,28600,0,28600,99700,0,128300
140537800200000,NE 123,RESIDENTIAL,28500,0,28500,122200,0,150700
140537800300000,NE 123,RESIDENTIAL,28300,0,28300,122700,0,151000
140537800400000,NE 123,RESIDENTIAL,27900,0,27900,118300,0,146200
140537800500000,NE 123,RESIDENTIAL,27800,0,27800,102700,0,130500
140537800600000,NE 123,RESIDENTIAL,27600,0,27600,124700,0,152300
140537800700000,NE 123,RESIDENTIAL,27300,0,27300,83800,0,111100
140537800800000,NE 123,RESIDENTIAL,26000,0,26000,124100,0,150100
140537800900000,NE 123,RESIDENTIAL,27200,0,27200,121900,0,149100
140537801000000,NE 123,RESIDENTIAL,27900,0,27900,130400,0,158300
140537801100000,NE 123,RESIDENTIAL,28300,0,28300,130900,0,159200
140537801200000,NE 123,RESIDENTIAL,28300,0,28300,111000,0,139300
140537801300000,NE 123,RESIDENTIAL,28300,0,28300,92500,0,120800
140537801400000,NE 123,RESIDENTIAL,28300,0,28300,108700,0,137000
140537801500000,NE 123,RESIDENTIAL,28300,0,28300,103200,0,131500
140537801600000,NE 123,RESIDENTIAL,28300,0,28300,78800,0,107100
140537801700000,NE 123,RESIDENTIAL,28300,0,28300,124800,0,153100
140537801800000,NE 123,RESIDENTIAL,28300,0,28300,107400,0,135700
140537801900000,NE 123,RESIDENTIAL,28300,0,28300,117400,0,145700
140537802000000,NE 123,RESIDENTIAL,26000,0,26000,88600,0,114600
140537802100000,NE 123,RESIDENTIAL,26000,0,26000,112900,0,138900
140537802200000,NE 123,RESIDENTIAL,26000,0,26000,111800,0,137800
140537802300000,NE 123,RESIDENTIAL,26000,0,26000,97600,0,123600
140537802400000,NE 123,RESIDENTIAL,26000,0,26000,98600,0,124600
140537802500000,NE 123,RESIDENTIAL,26000,0,26000,118200,0,144200
140537802600000,NE 123,RESIDENTIAL,26000,0,26000,87300,0,113300
140537802700000,NE 123,RESIDENTIAL,26000,0,26000,90700,0,116700
140537802800000,NE 123,RESIDENTIAL,25600,0,25600,144900,0,170500
140537802900000,NE 123,RESIDENTIAL,25600,0,25600,98200,0,123800
140537803000000,NE 123,RESIDENTIAL,25600,0,25600,93800,0,119400
140537803100000,NE 123,RESIDENTIAL,25700,0,25700,115200,0,140900
140537803200000,NE 123,RESIDENTIAL,26000,0,26000,110500,0,136500
140537803300000,NE 123,RESIDENTIAL,27300,0,27300,111400,0,138700
140537803400000,NE 123,RESIDENTIAL,26600,0,26600,113900,0,140500
140537803500000,NE 123,RESIDENTIAL,28200,0,28200,122200,0,150400
140537803600000,NE 123,RESIDENTIAL,28300,0,28300,100600,0,128900
140537803700000,NE 123,RESIDENTIAL,30000,0,30000,108300,0,138300
140537900100000,NE 123,RESIDENTIAL,27100,0,27100,137900,0,165000
140537900200000,NE 123,RESIDENTIAL,27100,0,27100,90200,0,117300
140537900300000,NE 123,RESIDENTIAL,28700,0,28700,131600,0,160300
140537900400000,NE 123,RESIDENTIAL,28200,0,28200,104500,0,132700
140537900500000,NE 123,RESIDENTIAL,27300,0,27300,126200,0,153500
140537900600000,NE 123,RESIDENTIAL,28000,0,28000,95700,0,123700
140537900700000,NE 123,RESIDENTIAL,32900,0,32900,84102,0,117002
140537900800000,NE 123,RESIDENTIAL,27900,0,27900,122900,0,150800
140537900900000,NE 123,RESIDENTIAL,28000,0,28000,102000,0,130000
140537901000000,NE 123,RESIDENTIAL,28000,0,28000,125700,0,153700
140537901100000,NE 123,RESIDENTIAL,28000,0,28000,96700,0,124700
140537901200000,NE 123,RESIDENTIAL,28000,0,28000,93900,0,121900
140537901300000,NE 123,RESIDENTIAL,28000,0,28000,123700,0,151700
140537901400000,NE 123,RESIDENTIAL,28000,0,28000,111700,0,139700
140537901500000,NE 123,RESIDENTIAL,28000,0,28000,121600,0,149600
140537901600000,NE 123,RESIDENTIAL,28000,0,28000,120900,0,148900
140537901700000,NE 123,RESIDENTIAL,25600,0,25600,117200,0,142800
140537901800000,NE 123,RESIDENTIAL,28900,0,28900,105600,0,134500
140538000100000,NE 123,RESIDENTIAL,0,0,0,0,0,0
140538000200000,NE 123,RESIDENTIAL,27300,0,27300,104400,0,131700
140538000300000,NE 123,RESIDENTIAL,27200,0,27200,146100,0,173300
140538000400000,NE 123,RESIDENTIAL,26000,0,26000,123000,0,149000
140538000500000,NE 123,RESIDENTIAL,28400,0,28400,116800,0,145200
140538000600000,NE 123,RESIDENTIAL,27200,0,27200,111300,0,138500
140538000700000,NE 123,RESIDENTIAL,27300,0,27300,123100,0,150400
140538000800000,NE 123,RESIDENTIAL,28300,0,28300,109500,0,137800
140538000900000,NE 123,RESIDENTIAL,25800,0,25800,109400,0,135200
140538001000000,NE 123,RESIDENTIAL,25800,0,25800,117700,0,143500
140538001100000,NE 123,RESIDENTIAL,25800,0,25800,99900,0,125700
140538001200000,NE 123,RESIDENTIAL,25800,0,25800,90400,0,116200
140538001300000,NE 123,RESIDENTIAL,25800,0,25800,100800,0,126600
140538001400000,NE 123,RESIDENTIAL,25800,0,25800,111300,0,137100
140538001500000,NE 123,RESIDENTIAL,25800,0,25800,112600,0,138400
140538001600000,NE 123,RESIDENTIAL,25800,0,25800,122000,0,147800
140538001700000,NE 123,EXEMPT,0,37200,37200,0,115200,152400
140538001800000,CHURCH,EXEMPT,0,445000,445000,0,183000,628000
140540100100000,NE 123,RESIDENTIAL,30800,0,30800,89500,0,120300
140540100200000,NE 123,RESIDENTIAL,21100,0,21100,84300,0,105400
140540100300000,NE 123,RESIDENTIAL,28100,0,28100,99800,0,127900
140540100400000,NE 123,RESIDENTIAL,30000,0,30000,119900,0,149900
140540100500000,NE 123,RESIDENTIAL,25700,0,25700,90100,0,115800
140540100600000,NE 123,RESIDENTIAL,29000,0,29000,111000,0,140000
140540200100000,CITY PROPERTY,EXEMPT,0,0,0,0,0,0
140540200200000,NE 123,RESIDENTIAL,28200,0,28200,112700,0,140900
140540200300000,NE 123,RESIDENTIAL,27000,0,27000,111700,0,138700
140540200400000,NE 123,EXEMPT,0,27100,27100,0,103600,130700
140540200500000,NE 123,RESIDENTIAL,27100,0,27100,131400,0,158500
140540200600000,NE 123,RESIDENTIAL,27100,0,27100,118300,0,145400
140540200700000,NE 123,RESIDENTIAL,27100,0,27100,118200,0,145300
140540200800000,NE 123,RESIDENTIAL,27100,0,27100,120200,0,147300
140540200900000,NE 123,RESIDENTIAL,27100,0,27100,106300,0,133400
140540201000000,NE 123,RESIDENTIAL,27100,0,27100,109000,0,136100
140540201100000,NE 123,RESIDENTIAL,27100,0,27100,105600,0,132700
140540201200000,NE 123,RESIDENTIAL,25000,0,25000,117200,0,142200
140540201300000,NE 123,RESIDENTIAL,27800,0,27800,130000,0,157800
140540201400000,NE 123,RESIDENTIAL,26800,0,26800,129700,0,156500
140540300100000,NE 123,RESIDENTIAL,29900,0,29900,130200,0,160100
140540300200000,NE 123,RESIDENTIAL,31200,0,31200,109600,0,140800
140540300300000,NE 123,RESIDENTIAL,30300,0,30300,132400,0,162700
140540300400000,NE 123,RESIDENTIAL,30300,0,30300,59000,0,89300
140540300500000,NE 123,RESIDENTIAL,30300,0,30300,118200,0,148500
140540300600000,NE 123,RESIDENTIAL,29700,0,29700,107000,0,136700
140540300700000,NE 123,RESIDENTIAL,28000,0,28000,103100,0,131100
140540300800000,NE 123,RESIDENTIAL,28000,0,28000,134900,0,162900
140540400100000,NE 123,RESIDENTIAL,28000,0,28000,110500,0,138500
140540400200000,NE 123,RESIDENTIAL,20900,0,20900,108100,0,129000
140540400300000,NE 123,RESIDENTIAL,20900,0,20900,106100,0,127000
140540400400000,NE 123,RESIDENTIAL,20900,0,20900,137000,0,157900
140540400500000,NE 123,RESIDENTIAL,20900,0,20900,94600,0,115500
140540400600000,NE 123,RESIDENTIAL,20900,0,20900,87300,0,108200
140540400700000,NE 123,RESIDENTIAL,20900,0,20900,115500,0,136400
140540400800000,NE 123,RESIDENTIAL,20900,0,20900,92500,0,113400
140540400900000,NE 123,RESIDENTIAL,20900,0,20900,97800,0,118700
140540401000000,NE 123,RESIDENTIAL,20900,0,20900,90600,0,111500
140540401100000,NE 123,RESIDENTIAL,27100,0,27100,109100,0,136200
140540401200000,NE 123,RESIDENTIAL,27100,0,27100,125000,0,152100
140540401300000,NE 123,RESIDENTIAL,28800,0,28800,112000,0,140800
140540401400000,NE 123,RESIDENTIAL,28800,0,28800,102700,0,131500
140540401500000,NE 123,RESIDENTIAL,28800,0,28800,116100,0,144900
140540401600000,NE 123,RESIDENTIAL,28800,0,28800,113500,0,142300
140540401700000,NE 123,RESIDENTIAL,28000,0,28000,101700,0,129700
140540500100000,NE 123,RESIDENTIAL,28500,0,28500,117100,0,145600
140540500200000,NE 123,RESIDENTIAL,27600,0,27600,86700,0,114300
140540500300000,NE 123,RESIDENTIAL,27400,0,27400,96000,0,123400
140540500400000,NE 123,RESIDENTIAL,27400,0,27400,111100,0,138500
140540500500000,NE 123,RESIDENTIAL,27400,0,27400,106900,0,134300
140540500600000,NE 123,RESIDENTIAL,27400,0,27400,94900,0,122300
140540500700000,NE 123,RESIDENTIAL,27400,0,27400,128400,0,155800
140540500800000,NE 123,RESIDENTIAL,27400,0,27400,111900,0,139300
140540500900000,NE 123,RESIDENTIAL,27400,0,27400,92800,0,120200
140540501000000,NE 123,RESIDENTIAL,27400,0,27400,111500,0,138900
140540501100000,NE 123,RESIDENTIAL,27400,0,27400,105800,0,133200
140540501200000,NE 123,RESIDENTIAL,27400,0,27400,123400,0,150800
140540501300000,NE 123,RESIDENTIAL,27200,0,27200,120900,0,148100
140542800200000,NE 125,RESIDENTIAL,51900,0,51900,187900,0,239800
140542800300000,NE 125,RESIDENTIAL,44300,0,44300,171200,0,215500
140542800400000,NE 125,RESIDENTIAL,42300,0,42300,203800,0,246100
140542800500000,NE 125,RESIDENTIAL,40700,0,40700,159500,0,200200
140542800600000,NE 125,RESIDENTIAL,40200,0,40200,174400,0,214600
140542800700000,NE 125,RESIDENTIAL,40700,0,40700,169200,0,209900
140542800800000,NE 125,RESIDENTIAL,40200,0,40200,204500,0,244700
140542800900000,NE 125,RESIDENTIAL,40200,0,40200,167600,0,207800
140542801000000,NE 125,RESIDENTIAL,40700,0,40700,193000,0,233700
140542900100000,NE 125,RESIDENTIAL,43900,0,43900,191300,0,235200
140542900200000,NE 125,RESIDENTIAL,40700,0,40700,179200,0,219900
140542900300000,NE 125,RESIDENTIAL,44000,0,44000,182600,0,226600
140542900400000,NE 125,RESIDENTIAL,39800,0,39800,143500,0,183300
140542900500000,NE 125,RESIDENTIAL,37800,0,37800,126100,0,163900
140542900600000,NE 125,RESIDENTIAL,41500,0,41500,164800,0,206300
140542900700000,NE 125,RESIDENTIAL,38900,0,38900,154600,0,193500
140542900800000,NE 125,RESIDENTIAL,37800,0,37800,140400,0,178200
140542900900000,NE 125,RESIDENTIAL,41500,0,41500,188600,0,230100
140542901000000,NE 125,RESIDENTIAL,38900,0,38900,167800,0,206700
140542901100000,NE 125,RESIDENTIAL,42000,0,42000,170500,0,212500
140542901200000,NE 125,RESIDENTIAL,42000,0,42000,164700,0,206700
140542901300000,NE 125,RESIDENTIAL,39900,0,39900,172700,0,212600
140542901400000,NE 125,RESIDENTIAL,39900,0,39900,185500,0,225400
140542901500000,NE 125,RESIDENTIAL,42000,0,42000,174200,0,216200
140542901600000,NE 125,RESIDENTIAL,39900,0,39900,172300,0,212200
140542901700000,NE 125,RESIDENTIAL,41400,0,41400,227100,0,268500
140543000100000,NE 125,RESIDENTIAL,47600,0,47600,173500,0,221100
140543000200000,NE 125,RESIDENTIAL,42700,0,42700,172400,0,215100
140543000300000,NE 125,RESIDENTIAL,42800,0,42800,154700,0,197500
140543000400000,NE 125,RESIDENTIAL,42800,0,42800,165000,0,207800
140543000500000,NE 125,RESIDENTIAL,42800,0,42800,147800,0,190600
140543000600000,NE 125,RESIDENTIAL,42800,0,42800,130200,0,173000
140543000700000,NE 125,RESIDENTIAL,42800,0,42800,169800,0,212600
140545100300000,CHURCH,EXEMPT,0,427200,427200,0,1223700,1650900
140545200200000,NE 125,RESIDENTIAL,41900,0,41900,168800,0,210700
140545200300000,NE 125,RESIDENTIAL,45500,0,45500,173700,0,219200
140545200400000,NE 125,RESIDENTIAL,45100,0,45100,183000,0,228100
140545200500000,NE 125,RESIDENTIAL,42600,0,42600,151700,0,194300
140545200600000,NE 125,RESIDENTIAL,39900,0,39900,166300,0,206200
140545200700000,NE 125,RESIDENTIAL,46100,0,46100,127000,0,173100
140545300100000,NE 125,RESIDENTIAL,44900,0,44900,203200,0,248100
140545300200000,NE 125,RESIDENTIAL,44900,0,44900,162200,0,207100
140545400100000,NE 125,RESIDENTIAL,42800,0,42800,155700,0,198500
140545400200000,NE 125,RESIDENTIAL,42800,0,42800,130000,0,172800
140545400300000,NE 125,RESIDENTIAL,41700,0,41700,145200,0,186900
140545400400000,NE 125,RESIDENTIAL,45000,0,45000,168100,0,213100
140545400500000,NE 125,RESIDENTIAL,46300,0,46300,162800,0,209100
140545400600000,NE 125,RESIDENTIAL,44300,0,44300,141800,0,186100
140545400700000,NE 125,RESIDENTIAL,41700,0,41700,137300,0,179000
140545400800000,NE 125,RESIDENTIAL,45800,0,45800,201400,0,247200
140545400900000,NE 125,RESIDENTIAL,45300,0,45300,189600,0,234900
140545500200000,CHURCH,EXEMPT,0,530000,530000,0,1664700,2194700
140547600100000,NE 123,RESIDENTIAL,28000,0,28000,118000,0,146000
140547600200000,NE 123,RESIDENTIAL,28000,0,28000,96800,0,124800
140547600300000,NE 123,RESIDENTIAL,28000,0,28000,121200,0,149200
140547600400000,NE 123,RESIDENTIAL,28000,0,28000,123400,0,151400
140547600500000,NE 123,RESIDENTIAL,28000,0,28000,122900,0,150900
140547600600000,NE 123,RESIDENTIAL,28000,0,28000,113600,0,141600
140547600700000,NE 123,RESIDENTIAL,28000,0,28000,101200,0,129200
140547600800000,NE 123,RESIDENTIAL,31100,0,31100,92300,0,123400
140547600900000,NE 123,RESIDENTIAL,31600,0,31600,108200,0,139800
140547601000000,NE 123,RESIDENTIAL,30500,0,30500,109300,0,139800
140547601100000,NE 123,RESIDENTIAL,27200,0,27200,112900,0,140100
140547601200000,NE 123,EXEMPT,0,26900,26900,0,97800,124700
140547601300000,NE 123,RESIDENTIAL,28600,0,28600,102600,0,131200
140547601400000,CITY PROPERTY,EXEMPT,0,0,0,0,0,0
140547601500000,CHURCH,EXEMPT,0,438400,438400,0,1291500,1729900
140547601600000,SCHOOL,EXEMPT,0,0,0,0,0,0
140547700100000,NE 123,RESIDENTIAL,27300,0,27300,115300,0,142600
140547700200000,NE 123,RESIDENTIAL,20900,0,20900,127400,0,148300
140547700300000,NE 123,RESIDENTIAL,20800,0,20800,107200,0,128000
140547700400000,NE 123,RESIDENTIAL,20800,0,20800,123700,0,144500
140547700500000,NE 123,RESIDENTIAL,20800,0,20800,93700,0,114500
140547700600000,NE 123,RESIDENTIAL,20800,0,20800,96000,0,116800
140547700700000,NE 123,RESIDENTIAL,20800,0,20800,93700,0,114500
140547700800000,NE 123,RESIDENTIAL,20800,0,20800,98900,0,119700
140547700900000,NE 123,RESIDENTIAL,21900,0,21900,98000,0,119900
140547701000000,NE 123,RESIDENTIAL,28000,0,28000,94700,0,122700
140547701100000,NE 123,RESIDENTIAL,27100,0,27100,105200,0,132300
140547701200000,NE 123,RESIDENTIAL,27100,0,27100,85400,0,112500
140547701300000,NE 123,RESIDENTIAL,27100,0,27100,87400,0,114500
140547701400000,NE 123,RESIDENTIAL,27100,0,27100,97200,0,124300
140547701500000,NE 123,RESIDENTIAL,27100,0,27100,90200,0,117300
140547701600000,NE 123,RESIDENTIAL,27100,0,27100,93700,0,120800
140547800100000,SCHOOL,EXEMPT,0,0,0,0,0,0
140610200100000,BRANCH BANK/CU,COMMERCIAL,0,485000,485000,0,1766800,2251800
140610200200000,FAST FOOD,COMMERCIAL,0,485000,485000,0,1264600,1749600
140610300100000,CONVENIENCE STORE,COMMERCIAL,0,550900,550900,0,521100,1072000
140612800200000,NE 168,RESIDENTIAL,51800,0,51800,0,0,51800
140612800300000,NE 168,RESIDENTIAL,52400,0,52400,0,0,52400
140612800400000,AUTO REPAIR/SALES,COMMERCIAL,0,192500,192500,0,630100,822600
140612900100000,NE 168,AG LAND,35500,0,35500,0,0,35500
140612900300000,SHOP,COMMERCIAL,0,117000,117000,0,195900,312900
140612900400000,NE 168,RESIDENTIAL,53300,0,53300,259400,0,312700
140612900500000,NE 168,RESIDENTIAL,5800,0,5800,0,0,5800
140615100200000,NE 168,AG LAND,23400,0,23400,0,0,23400
140615200200000,NE 168,AG LAND,32500,0,32500,0,0,32500
140617600100000,NBHD SHOPPING CENTER,COMMERCIAL,0,3362900,3362900,0,6991100,10354000
140617600300000,FAST FOOD,COMMERCIAL,0,468000,468000,0,743400,1211400
140617600400000,BRANCH BANK/CU,COMMERCIAL,0,728000,728000,0,574100,1302100
140617600500000,GROCERY STORE,COMMERCIAL,0,1135620,1135620,0,5464380,6600000
140617600800000,NBHD SHOPPING CENTER,COMMERCIAL,0,400000,400000,0,1020800,1420800
140617600900000,NBHD SHOPPING CENTER,COMMERCIAL,0,800000,800000,0,1631900,2431900
140617601000000,VACANT LAND,COMMERCIAL,0,0,0,0,0,0
140617601100000,FLAT PARKING,COMMERCIAL,0,102000,102000,0,33700,135700
140617601400000,VACANT LAND,COMMERCIAL,0,783900,783900,0,0,783900
140617601500000,RESTAURANT,COMMERCIAL,0,560000,560000,0,773800,1333800
140620100200000,NE 168,AG DWELLING,29200,0,29200,244600,1400,275200
140620100400000,NE 168,RESIDENTIAL,55600,0,55600,137400,0,193000
140620100500000,NE 168,RESIDENTIAL,40300,0,40300,129800,0,170100
140620100600000,NE 168,RESIDENTIAL,32500,0,32500,142100,0,174600
140620100700000,NE 168,RESIDENTIAL,22900,0,22900,112600,0,135500
140620100800000,NE 168,RESIDENTIAL,32700,0,32700,166200,0,198900
140620100900000,NE 168,RESIDENTIAL,28800,0,28800,0,0,28800
140620200100000,NE 168,RESIDENTIAL,45300,0,45300,102600,0,147900
140620200200000,NE 168,AG DWELLING,3100,0,3100,139900,6300,149300
140620200300000,NE 168,AG LAND,4400,0,4400,0,0,4400
140620200400000,NE 168,RESIDENTIAL,45500,0,45500,0,0,45500
140620200500000,NE 168,RESIDENTIAL,45500,0,45500,195900,0,241400
140620200600000,NE 168,RESIDENTIAL,56500,0,56500,72600,0,129100
140620200700000,NE 168,RESIDENTIAL,45700,0,45700,174300,0,220000
140620200800000,NE 168,RESIDENTIAL,45700,0,45700,149700,0,195400
140620300200000,NE 168,RESIDENTIAL,51000,0,51000,80800,0,131800
140620300300000,NE 168,RESIDENTIAL,54900,0,54900,304800,0,359700
140620300500000,NE 168,RESIDENTIAL,67500,0,67500,192500,0,260000
140622600300000,NE 168,RESIDENTIAL,10400,0,10400,0,0,10400
140622600400000,NE 172,RESIDENTIAL,2800,0,2800,0,0,2800
140622600500000,NE 172,RESIDENTIAL,56100,0,56100,20900,0,77000
140623000100000,NE 172,RESIDENTIAL,39600,0,39600,171200,0,210800
140623000200000,NE 172,RESIDENTIAL,39900,0,39900,190900,0,230800
140623100100000,NE 172,RESIDENTIAL,39800,0,39800,137600,0,177400
140623100200000,NE 172,RESIDENTIAL,39000,0,39000,138900,0,177900
140623100300000,NE 172,RESIDENTIAL,39000,0,39000,139200,0,178200
140623100400000,NE 172,RESIDENTIAL,39000,0,39000,137900,0,176900
140623100500000,NE 172,RESIDENTIAL,39000,0,39000,136500,0,175500
140623100600000,NE 172,RESIDENTIAL,41400,0,41400,200100,0,241500
140623100700000,NE 172,RESIDENTIAL,41500,0,41500,165300,0,206800
140625100100000,NE 168,AG LAND,5700,0,5700,0,0,5700
140625100700000,NE 168,AG LAND,2800,0,2800,0,0,2800
140625200100000,OFFICE,COMMERCIAL,0,540800,540800,0,2386400,2927200
140627600100000,NE 168,AG LAND,35500,0,35500,0,0,35500
140627600200000,NE 168,RESIDENTIAL,30400,0,30400,75100,0,105500
140627600400000,OFFICE,COMMERCIAL,0,523000,523000,0,4026000,4549000
140627600500000,OFFICE,COMMERCIAL,0,312000,312000,0,1264200,1576200
140627600600000,OFFICE; MEDICAL,COMMERCIAL,0,185000,185000,0,670800,855800
140627600700000,CITY PROPERTY,EXEMPT,0,0,0,0,0,0
140627700100000,CITY PROPERTY,EXEMPT,0,0,0,0,0,0
140630100100000,OFFICE,COMMERCIAL,0,280000,280000,0,947800,1227800
140630200100000,FLAT PARKING,COMMERCIAL,0,142500,142500,0,94700,237200
140630200200000,OFFICE,COMMERCIAL,0,826000,826000,0,13262700,14088700
140630200300000,NE 168,AG LAND,12200,0,12200,0,0,12200
140630200500000,NE 127,RESIDENTIAL,79100,0,79100,241500,0,320600
140630200600000,NE 127,RESIDENTIAL,85100,0,85100,243100,0,328200
140630200700000,NE 127,RESIDENTIAL,87600,0,87600,296400,0,384000
140630200800000,NE 127,RESIDENTIAL,77300,0,77300,345500,0,422800
140630200900000,NE 127,RESIDENTIAL,79400,0,79400,275600,0,355000
140630201000000,NE 127,RESIDENTIAL,81300,0,81300,285900,0,367200
140630201100000,NE 127,RESIDENTIAL,78200,0,78200,314100,0,392300
140630201200000,NE 127,RESIDENTIAL,81600,0,81600,262200,0,343800
140630201400000,NE 127,RESIDENTIAL,67400,0,67400,260100,0,327500
140630201500000,NE 127,RESIDENTIAL,67500,0,67500,279700,0,347200
140630201600000,NE 127,RESIDENTIAL,71000,0,71000,305600,0,376600
140630201700000,NE 127,RESIDENTIAL,69500,0,69500,321000,0,390500
140630201800000,NE 127,RESIDENTIAL,67100,0,67100,267700,0,334800
140630201900000,NE 127,RESIDENTIAL,67200,0,67200,284800,0,352000
140630202000000,NE 127,RESIDENTIAL,68700,0,68700,302500,0,371200
140630202100000,NE 127,RESIDENTIAL,67700,0,67700,331300,0,399000
140630202200000,NE 127,RESIDENTIAL,69500,0,69500,337500,0,407000
140630202300000,NE 127,RESIDENTIAL,67400,0,67400,254700,0,322100
140630202400000,NE 127,RESIDENTIAL,57500,0,57500,0,0,57500
140630202500000,NE 127,RESIDENTIAL,64800,0,64800,374700,0,439500
140630202600000,NE 127,RESIDENTIAL,95300,0,95300,352600,0,447900
140630202700000,NE 127,RESIDENTIAL,86800,0,86800,300900,0,387700
140630300100000,NE 127,RESIDENTIAL,76500,0,76500,322000,0,398500
140630300200000,NE 127,RESIDENTIAL,86000,0,86000,308700,0,394700
140630300300000,NE 127,RESIDENTIAL,80800,0,80800,320000,0,400800
140630300400000,NE 127,RESIDENTIAL,82500,0,82500,303700,0,386200
140630300500000,NE 127,RESIDENTIAL,90500,0,90500,306000,0,396500
140630300600000,NE 127,RESIDENTIAL,86500,0,86500,221200,0,307700
140630300700000,NE 127,RESIDENTIAL,85200,0,85200,353500,0,438700
140630300800000,NE 127,RESIDENTIAL,102600,0,102600,409800,0,512400
140630301100000,NE 127,RESIDENTIAL,94800,0,94800,372600,0,467400
140632800100000,NE 161,RESIDENTIAL,1800,0,1800,0,0,1800
140632800200000,NE 161,RESIDENTIAL,45900,0,45900,202600,0,248500
140632800300000,NE 161,RESIDENTIAL,42500,0,42500,255400,0,297900
140633000100000,NE 161,RESIDENTIAL,900,0,900,0,0,900
140633000200000,NE 161,RESIDENTIAL,47800,0,47800,215900,0,263700
140635100100000,NE 128,RESIDENTIAL,74000,0,74000,481500,0,555500
140635100200000,NE 128,RESIDENTIAL,102700,0,102700,523200,0,625900
140635100300000,NE 128,RESIDENTIAL,102800,0,102800,505700,0,608500
140635100400000,NE 128,RESIDENTIAL,85600,0,85600,253300,0,338900
140635100500000,NE 128,RESIDENTIAL,103700,0,103700,385000,0,488700
140635100600000,NE 128,RESIDENTIAL,101700,0,101700,332700,0,434400
140635100700000,NE 128,RESIDENTIAL,94500,0,94500,280000,0,374500
140635100800000,NE 128,RESIDENTIAL,108500,0,108500,768300,0,876800
140635100900000,NE 128,RESIDENTIAL,99000,0,99000,381800,0,480800
140635101000000,NE 128,RESIDENTIAL,75600,0,75600,304300,0,379900
140635101100000,NE 128,RESIDENTIAL,102900,0,102900,527900,0,630800
140635101200000,NE 128,RESIDENTIAL,3200,0,3200,0,0,3200
140635101300000,NE 128,RESIDENTIAL,103200,0,103200,624900,0,728100
140635101400000,NE 128,RESIDENTIAL,100800,0,100800,488300,0,589100
140635101500000,NE 128,RESIDENTIAL,75800,0,75800,501500,0,577300
140635101600000,NE 128,RESIDENTIAL,78500,0,78500,320100,0,398600
140635101700000,NE 128,RESIDENTIAL,80500,0,80500,302500,0,383000
140635101800000,NE 128,RESIDENTIAL,103900,0,103900,446200,0,550100
140635101900000,NE 128,RESIDENTIAL,104600,0,104600,496000,0,600600
140635102000000,NE 128,RESIDENTIAL,96000,0,96000,391600,0,487600
140635102100000,NE 128,RESIDENTIAL,104300,0,104300,376400,0,480700
140635102200000,NE 128,RESIDENTIAL,82700,0,82700,432800,0,515500
140635102300000,NE 128,RESIDENTIAL,38800,0,38800,186500,0,225300
140635102400000,NE 128,RESIDENTIAL,39000,0,39000,139600,0,178600
140635102500000,NE 128,RESIDENTIAL,33700,0,33700,213400,0,247100
140635102600000,NE 128,RESIDENTIAL,38800,0,38800,78100,0,116900
140635200100000,NE 128,RESIDENTIAL,94100,0,94100,316900,0,411000
140635200200000,NE 128,RESIDENTIAL,96000,0,96000,764000,0,860000
140635200600000,NE 128,RESIDENTIAL,57500,0,57500,0,0,57500
140635200700000,NE 128,RESIDENTIAL,80300,0,80300,279900,0,360200
140635200800000,NE 128,RESIDENTIAL,39100,0,39100,80400,0,119500
140637600100000,NE 127,RESIDENTIAL,57600,0,57600,225600,0,283200
140637600200000,NE 127,RESIDENTIAL,57600,0,57600,220200,0,277800
140637600300000,NE 127,RESIDENTIAL,57600,0,57600,215300,0,272900
140637600400000,NE 127,RESIDENTIAL,57600,0,57600,195600,0,253200
140637600500000,NE 127,RESIDENTIAL,65400,0,65400,278700,0,344100
140637600600000,NE 127,RESIDENTIAL,64400,0,64400,168700,0,233100
140637600700000,NE 127,RESIDENTIAL,60600,0,60600,221400,0,282000
140637600800000,NE 127,RESIDENTIAL,58400,0,58400,222100,0,280500
140637600900000,NE 127,RESIDENTIAL,65400,0,65400,238100,0,303500
140637601000000,NE 127,RESIDENTIAL,65500,0,65500,250000,0,315500
140637601100000,NE 127,RESIDENTIAL,71200,0,71200,248300,0,319500
140637601200000,NE 127,RESIDENTIAL,65500,0,65500,227000,0,292500
140637601300000,NE 127,RESIDENTIAL,59500,0,59500,216200,0,275700
140637601400000,NE 127,RESIDENTIAL,62800,0,62800,208400,0,271200
140637601500000,NE 127,RESIDENTIAL,66600,0,66600,218800,0,285400
140637601600000,NE 127,RESIDENTIAL,66500,0,66500,288100,0,354600
140637601700000,NE 127,RESIDENTIAL,80800,0,80800,280400,0,361200
140637601800000,NE 127,RESIDENTIAL,77500,0,77500,269200,0,346700
140637601900000,NE 127,RESIDENTIAL,74100,0,74100,207700,0,281800
140637602000000,NE 127,RESIDENTIAL,92600,0,92600,140600,0,233200
140637602100000,NE 127,RESIDENTIAL,88400,0,88400,155900,0,244300
140637602200000,NE 127,RESIDENTIAL,80500,0,80500,213800,0,294300
140637602300000,NE 127,RESIDENTIAL,74800,0,74800,99100,0,173900
140637602400000,NE 127,RESIDENTIAL,60300,0,60300,122300,0,182600
140637602500000,DAY CARE CENTER,COMMERCIAL,0,217000,217000,0,365300,582300
140637602600000,NE 127,RESIDENTIAL,66700,0,66700,327500,0,394200
140637602700000,NE 127,RESIDENTIAL,100,0,100,0,0,100
140637700100000,NE 127,RESIDENTIAL,76300,0,76300,219600,0,295900
140637700300000,NE 127,RESIDENTIAL,81800,0,81800,259000,0,340800
140637800100000,NE 127,RESIDENTIAL,79700,0,79700,240800,0,320500
140637800200000,NE 127,RESIDENTIAL,80100,0,80100,259000,0,339100
140637800300000,NE 127,RESIDENTIAL,79500,0,79500,184800,0,264300
140637800400000,NE 127,RESIDENTIAL,78500,0,78500,252600,0,331100
140637800500000,NE 127,RESIDENTIAL,78500,0,78500,243200,0,321700
140637800600000,NE 127,RESIDENTIAL,83300,0,83300,241700,0,325000
140637800700000,NE 127,RESIDENTIAL,69300,0,69300,163900,0,233200
140637800800000,NE 127,RESIDENTIAL,69900,0,69900,231400,0,301300
140637800900000,NE 127,RESIDENTIAL,71800,0,71800,234000,0,305800
140637801000000,NE 127,RESIDENTIAL,73100,0,73100,155300,0,228400
140637801100000,NE 127,RESIDENTIAL,64100,0,64100,250000,0,314100
140637801200000,NE 127,RESIDENTIAL,72800,0,72800,279600,0,352400
140637801300000,NE 127,RESIDENTIAL,75400,0,75400,168300,0,243700
140637801400000,NE 127,RESIDENTIAL,71000,0,71000,187000,0,258000
140637801500000,NE 127,RESIDENTIAL,68800,0,68800,190500,0,259300
140637801600000,NE 127,RESIDENTIAL,68300,0,68300,216800,0,285100
140637801700000,NE 127,RESIDENTIAL,70900,0,70900,237200,0,308100
140637801800000,NE 127,RESIDENTIAL,67600,0,67600,184400,0,252000
140637801900000,NE 127,RESIDENTIAL,70700,0,70700,264300,0,335000
140637802000000,NE 127,RESIDENTIAL,72700,0,72700,359000,0,431700
140642600100000,NE 127,AG LAND,21800,0,21800,0,0,21800
140642600200000,OFFICE,COMMERCIAL,0,410000,410000,0,1226700,1636700
140642700100000,OFFICE,COMMERCIAL,0,747900,747900,0,17584100,18332000
140645100100000,OFFICE,COMMERCIAL,0,1685400,1685400,0,10726600,12412000
140645100200000,FLAT PARKING,COMMERCIAL,0,196500,196500,0,130200,326700
140645100300000,OFFICE,COMMERCIAL,0,49500,49500,0,5012600,5062100
140710100100000,BRANCH BANK/CU,COMMERCIAL,0,338000,338000,0,609100,947100
140710100200000,RESTAURANT,COMMERCIAL,0,310000,310000,0,400600,710600
140710100300000,OFFICE,COMMERCIAL,0,285000,285000,0,840900,1125900
140710100400000,OFFICE,COMMERCIAL,0,177000,177000,0,1000500,1177500
140710100500000,OFFICE,COMMERCIAL,0,326300,326300,0,1573100,1899400
140710100600000,FLAT PARKING,COMMERCIAL,0,123600,123600,0,25600,149200
140710100700000,OFFICE,COMMERCIAL,0,159000,159000,0,653300,812300
140710100800000,OFFICE; MEDICAL,COMMERCIAL,0,78400,78400,0,326900,405300
140710100900000,OFFICE,COMMERCIAL,0,70900,70900,0,220800,291700
140710101000000,OFFICE,COMMERCIAL,0,333200,333200,0,663900,997100
140710101001000,OFFICE; MEDICAL,COMMERCIAL,0,165200,165200,0,571500,736700
140710101001001,OFFICE,COMMERCIAL,0,165200,165200,0,581400,746600
140710200200000,OFFICE,COMMERCIAL,0,318000,318000,0,964700,1282700
140710200300000,OFFICE,COMMERCIAL,0,108500,108500,0,392500,501000
140710200400000,OFFICE; MEDICAL,COMMERCIAL,0,118400,118400,0,345200,463600
140710200701000,OFFICE,COMMERCIAL,0,282900,282900,0,1207600,1490500
140710200701001,OFFICE,COMMERCIAL,0,735100,735100,0,4547200,5282300
140710200701002,OFFICE,COMMERCIAL,0,41400,41400,0,221800,263200
140710200701003,OFFICE,COMMERCIAL,0,48200,48200,0,257600,305800
140710200701004,OFFICE,COMMERCIAL,0,53300,53300,0,267100,320400
140710200701005,OFFICE,COMMERCIAL,0,89300,89300,0,0,89300
140710200701006,OFFICE,COMMERCIAL,0,102800,102800,0,0,102800
140710200701007,VACANT LAND,COMMERCIAL,0,0,0,0,0,0
140710200801000,VACANT LAND,COMMERCIAL,0,0,0,0,0,0
140710200801001,OFFICE,COMMERCIAL,0,0,0,0,0,0
140710200801002,VACANT LAND,COMMERCIAL,0,0,0,0,0,0
140710200801003,VACANT LAND,COMMERCIAL,0,0,0,0,0,0
140710200801004,VACANT LAND,COMMERCIAL,0,0,0,0,0,0
140710200801005,VACANT LAND,COMMERCIAL,0,0,0,0,0,0
140710200801006,VACANT LAND,COMMERCIAL,0,0,0,0,0,0
140710200801007,VACANT LAND,COMMERCIAL,0,0,0,0,0,0
140710300100000,OFFICE,COMMERCIAL,0,286500,286500,0,1269800,1556300
140710300200000,OFFICE,EXEMPT,0,197200,197200,0,651900,849100
140710300300000,OFFICE,COMMERCIAL,0,617000,617000,0,2662600,3279600
140712600100000,CHURCH,EXEMPT,0,527500,527500,0,359000,886500
140712600200000,NE 140,RESIDENTIAL,48400,0,48400,74800,0,123200
140712600300000,NE 140,RESIDENTIAL,48500,0,48500,106500,0,155000
140712600600000,NE 140,RESIDENTIAL,50000,0,50000,182500,0,232500
140712600700000,NE 140,RESIDENTIAL,50000,0,50000,175300,0,225300
140712700400000,NE 140,RESIDENTIAL,50200,0,50200,181400,0,231600
140712700500000,NE 140,RESIDENTIAL,50000,0,50000,162400,0,212400
140712700700000,NE 140,RESIDENTIAL,50200,0,50200,112100,0,162300
140712701100000,NE 140,RESIDENTIAL,50200,0,50200,151700,0,201900
140712701200000,NE 140,RESIDENTIAL,50200,0,50200,132900,0,183100
140712800100000,NE 140,RESIDENTIAL,42500,0,42500,183500,0,226000
140712800200000,NE 140,RESIDENTIAL,50100,0,50100,140700,0,190800
140712800300000,NE 140,RESIDENTIAL,50100,0,50100,123400,0,173500
140712800400000,NE 140,RESIDENTIAL,50000,0,50000,173800,0,223800
140712800600000,NE 140,RESIDENTIAL,50000,0,50000,182000,0,232000
140712800700000,NE 140,RESIDENTIAL,44600,0,44600,128100,0,172700
140712800800000,NE 140,RESIDENTIAL,45500,0,45500,88800,0,134300
140712800900000,NE 140,RESIDENTIAL,44200,0,44200,107700,0,151900
140712900100000,NE 140,RESIDENTIAL,2900,0,2900,0,0,2900
140715100100000,NE 140,RESIDENTIAL,50300,0,50300,176100,0,226400
140715100200000,NE 140,RESIDENTIAL,50500,0,50500,108000,0,158500
140715100400000,NE 140,RESIDENTIAL,51000,0,51000,84100,0,135100
140715100600000,NE 140,RESIDENTIAL,50400,0,50400,137100,0,187500
140715100700000,NE 140,RESIDENTIAL,45500,0,45500,181200,0,226700
140715100800000,NE 140,RESIDENTIAL,45500,0,45500,155000,0,200500
140715200100000,NE 140,RESIDENTIAL,53100,0,53100,140800,0,193900
140715300200000,NE 140,RESIDENTIAL,45200,0,45200,143900,0,189100
140717600100000,OFFICE,COMMERCIAL,0,119600,119600,0,371800,491400
140717600200000,OFFICE,COMMERCIAL,0,130700,130700,0,373600,504300
140717600300000,OFFICE,COMMERCIAL,0,102200,102200,0,379300,481500
140717600600000,OFFICE; MEDICAL,COMMERCIAL,0,230000,230000,0,668100,898100
140717600800000,OFFICE,COMMERCIAL,0,82300,82300,0,323200,405500
140717600900000,OFFICE,COMMERCIAL,0,144400,144400,0,373400,517800
140717700100000,OFFICE,COMMERCIAL,0,230000,230000,0,516700,746700
140717800100000,OFFICE,COMMERCIAL,0,153200,153200,0,576100,729300
140717800200000,OFFICE,COMMERCIAL,0,419000,419000,0,584000,1003000
140717900900000,NE 138,RESIDENTIAL,73600,0,73600,0,0,73600
140717901000000,NE 138,RESIDENTIAL,56000,0,56000,365500,0,421500
140717901100000,NE 138,RESIDENTIAL,77200,0,77200,271300,0,348500
140717901200000,NE 138,RESIDENTIAL,68500,0,68500,294000,0,362500
140717901300000,NE 138,RESIDENTIAL,70600,0,70600,306000,0,376600
140717901400000,NE 138,RESIDENTIAL,80000,0,80000,313100,0,393100
140718000100000,OFFICE; MEDICAL,COMMERCIAL,0,125500,125500,0,578300,703800
140718000400000,OFFICE; MEDICAL,COMMERCIAL,0,174000,174000,0,211200,385200
140718000700000,NE 138,RESIDENTIAL,57600,0,57600,301600,0,359200
140718000800000,NE 138,RESIDENTIAL,51900,0,51900,0,0,51900
140718000900000,NE 138,RESIDENTIAL,54600,0,54600,244300,0,298900
140718001000000,OFFICE; MEDICAL,COMMERCIAL,0,174000,174000,0,696000,870000
140718001100000,OFFICE,COMMERCIAL,0,318100,318100,0,1231900,1550000
140718001400000,OFFICE; MEDICAL,COMMERCIAL,0,138700,138700,0,628700,767400
140718001500000,NE 138,RESIDENTIAL,62900,0,62900,0,0,62900
140718001600000,NE 138,RESIDENTIAL,74100,0,74100,253700,0,327800
140720100100000,NE 140,RESIDENTIAL,41600,0,41600,130000,0,171600
140720100200000,NE 140,RESIDENTIAL,41700,0,41700,153700,0,195400
140720100300000,NE 140,RESIDENTIAL,42200,0,42200,142900,0,185100
140720100400000,NE 140,RESIDENTIAL,38500,0,38500,149500,0,188000
140720100500000,NE 140,RESIDENTIAL,38500,0,38500,118900,0,157400
140720100600000,NE 140,RESIDENTIAL,38100,0,38100,133800,0,171900
140720100700000,NE 140,RESIDENTIAL,39100,0,39100,152000,0,191100
140720100800000,NE 140,RESIDENTIAL,40500,0,40500,151200,0,191700
140720100900000,NE 140,RESIDENTIAL,40500,0,40500,135900,0,176400
140720101000000,NE 140,RESIDENTIAL,40000,0,40000,120300,0,160300
140720101100000,NE 140,RESIDENTIAL,39600,0,39600,149400,0,189000
140720101200000,NE 140,RESIDENTIAL,46200,0,46200,193700,0,239900
140720101300000,NE 140,RESIDENTIAL,43100,0,43100,155700,0,198800
140720101400000,NE 140,RESIDENTIAL,43400,0,43400,157700,0,201100
140720101500000,NE 140,RESIDENTIAL,43300,0,43300,151200,0,194500
140720101600000,NE 140,RESIDENTIAL,30100,0,30100,133500,0,163600
140720101700000,NE 140,RESIDENTIAL,32000,0,32000,150600,0,182600
140720101800000,NE 140,RESIDENTIAL,27800,0,27800,135400,0,163200
140720101900000,NE 140,RESIDENTIAL,35600,0,35600,149300,0,184900
140720102000000,NE 140,RESIDENTIAL,34300,0,34300,171400,0,205700
140720102100000,NE 140,RESIDENTIAL,2400,0,2400,0,0,2400
140720102200000,NE 140,RESIDENTIAL,39700,0,39700,136200,0,175900
140720102300000,NE 140,RESIDENTIAL,32600,0,32600,163700,0,196300
140720102400000,NE 140,RESIDENTIAL,33800,0,33800,146800,0,180600
140720102500000,NE 140,RESIDENTIAL,34200,0,34200,140700,0,174900
140720102600000,NE 140,RESIDENTIAL,33800,0,33800,160300,0,194100
140720102700000,NE 140,RESIDENTIAL,36000,0,36000,146200,0,182200
140720102800000,NE 140,RESIDENTIAL,40700,0,40700,149700,0,190400
140720102900000,NE 140,RESIDENTIAL,40800,0,40800,166500,0,207300
140720103000000,NE 140,RESIDENTIAL,37200,0,37200,160500,0,197700
140720103100000,NE 158,RESIDENTIAL,45300,0,45300,225100,0,270400
140720103200000,NE 158,RESIDENTIAL,42600,0,42600,235400,0,278000
140720103300000,NE 158,RESIDENTIAL,40800,0,40800,233200,0,274000
140720103400000,NE 158,RESIDENTIAL,38300,0,38300,198900,0,237200
140720103500000,NE 158,RESIDENTIAL,39500,0,39500,219100,0,258600
140720103600000,NE 158,RESIDENTIAL,39500,0,39500,207800,0,247300
140720103700000,NE 158,RESIDENTIAL,39500,0,39500,186000,0,225500
140720103800000,NE 158,RESIDENTIAL,39500,0,39500,192800,0,232300
140720103900000,NE 158,RESIDENTIAL,41400,0,41400,202100,0,243500
140720104000000,NE 140,RESIDENTIAL,3500,0,3500,0,0,3500
140720104100000,NE 152,RESIDENTIAL,27000,0,27000,202100,0,229100
140720104200000,NE 152,RESIDENTIAL,28200,0,28200,258500,0,286700
140720104300000,NE 152,RESIDENTIAL,26900,0,26900,256000,0,282900
140720200200000,NE 140,RESIDENTIAL,4400,0,4400,0,0,4400
140720200300000,NE 140,RESIDENTIAL,23300,0,23300,126400,0,149700
140720200400000,NE 140,RESIDENTIAL,9700,0,9700,102000,0,111700
140720200500000,NE 140,RESIDENTIAL,10400,0,10400,105600,0,116000
140720200600000,NE 140,RESIDENTIAL,10800,0,10800,117800,0,128600
140720200700000,NE 140,RESIDENTIAL,10500,0,10500,120500,0,131000
140720200800000,NE 140,RESIDENTIAL,18400,0,18400,123400,0,141800
140720200900000,NE 140,RESIDENTIAL,4000,0,4000,0,0,4000
140720201000000,NE 140,RESIDENTIAL,19400,0,19400,123700,0,143100
140720201100000,NE 140,RESIDENTIAL,9000,0,9000,96600,0,105600
140720201200000,NE 140,RESIDENTIAL,10000,0,10000,103800,0,113800
140720201300000,NE 140,RESIDENTIAL,10800,0,10800,117000,0,127800
140720201400000,NE 140,RESIDENTIAL,10600,0,10600,118900,0,129500
140720201500000,NE 140,RESIDENTIAL,20200,0,20200,122000,0,142200
140720201600000,NE 140,RESIDENTIAL,39700,0,39700,150300,0,190000
140720201700000,NE 140,RESIDENTIAL,39600,0,39600,156200,0,195800
140720201800000,NE 140,RESIDENTIAL,30400,0,30400,138300,0,168700
140720201900000,NE 140,RESIDENTIAL,36200,0,36200,162900,0,199100
140720202000000,NE 140,RESIDENTIAL,31300,0,31300,140400,0,171700
140720202100000,NE 140,RESIDENTIAL,29100,0,29100,138300,0,167400
140720202200000,NE 140,RESIDENTIAL,36200,0,36200,133200,0,169400
140720202300000,NE 140,RESIDENTIAL,34200,0,34200,150800,0,185000
140720202400000,NE 140,RESIDENTIAL,39400,0,39400,139300,0,178700
140720202500000,NE 140,RESIDENTIAL,30800,0,30800,136100,0,166900
140720202600000,NE 140,RESIDENTIAL,37300,0,37300,138000,0,175300
140720202700000,NE 140,RESIDENTIAL,25500,0,25500,145000,0,170500
140720202800000,NE 140,RESIDENTIAL,36600,0,36600,125900,0,162500
140720202900000,NE 140,RESIDENTIAL,36800,0,36800,161700,0,198500
140720203000000,NE 140,RESIDENTIAL,40300,0,40300,149400,0,189700
140720203100000,NE 140,RESIDENTIAL,35400,0,35400,135400,0,170800
140720203200000,NE 140,RESIDENTIAL,39300,0,39300,151500,0,190800
140720203300000,NE 140,RESIDENTIAL,33100,0,33100,135100,0,168200
140720203400000,NE 140,RESIDENTIAL,29800,0,29800,132800,0,162600
140720203500000,NE 140,RESIDENTIAL,31700,0,31700,146100,0,177800
140720203600000,NE 140,RESIDENTIAL,39300,0,39300,145400,0,184700
140720203700000,NE 140,RESIDENTIAL,34200,0,34200,132100,0,166300
140720203800000,NE 140,RESIDENTIAL,33500,0,33500,120100,0,153600
140720203900000,NE 140,RESIDENTIAL,33100,0,33100,136600,0,169700
140720204000000,NE 140,RESIDENTIAL,35100,0,35100,138600,0,173700
140720204100000,NE 140,RESIDENTIAL,32600,0,32600,126100,0,158700
140720204200000,NE 140,RESIDENTIAL,40100,0,40100,150900,0,191000
140720204300000,NE 140,RESIDENTIAL,36000,0,36000,155700,0,191700
140720204400000,NE 152,RESIDENTIAL,21700,0,21700,218600,0,240300
140720204500000,NE 152,RESIDENTIAL,20500,0,20500,206100,0,226600
140720204700000,NE 152,RESIDENTIAL,20500,0,20500,257000,0,277500
140720204800000,NE 152,RESIDENTIAL,20500,0,20500,233500,0,254000
140720204900000,NE 152,RESIDENTIAL,21700,0,21700,239000,0,260700
140720205000000,NE 152,RESIDENTIAL,21700,0,21700,245200,0,266900
140720205100000,NE 152,RESIDENTIAL,20500,0,20500,210600,0,231100
140720205200000,NE 152,RESIDENTIAL,20500,0,20500,266400,0,286900
140720205300000,NE 152,RESIDENTIAL,20500,0,20500,270900,0,291400
140720205400000,NE 152,RESIDENTIAL,20500,0,20500,231800,0,252300
140720205500000,NE 152,RESIDENTIAL,21800,0,21800,263700,0,285500
140720205600000,NE 152,RESIDENTIAL,29600,0,29600,265600,0,295200
140720205700000,NE 152,RESIDENTIAL,20500,0,20500,253700,0,274200
140720205800000,NE 152,RESIDENTIAL,20500,0,20500,253200,0,273700
140720205900000,NE 152,RESIDENTIAL,29600,0,29600,252800,0,282400
140720206000000,NE 152,RESIDENTIAL,26600,0,26600,258900,0,285500
140720206100000,NE 152,RESIDENTIAL,22200,0,22200,254700,0,276900
140720206200000,NE 152,RESIDENTIAL,26400,0,26400,236700,0,263100
140720206300000,NE 152,RESIDENTIAL,27200,0,27200,253600,0,280800
140722600300000,NE 158,RESIDENTIAL,48300,0,48300,183800,0,232100
140722600400000,NE 158,RESIDENTIAL,49000,0,49000,157500,0,206500
140722600500000,NE 158,RESIDENTIAL,47000,0,47000,217100,0,264100
140722600600000,NE 158,RESIDENTIAL,47000,0,47000,199900,0,246900
140722600700000,NE 158,RESIDENTIAL,47000,0,47000,189100,0,236100
140722600800000,NE 158,RESIDENTIAL,49500,0,49500,210700,0,260200
140722600900000,NE 158,RESIDENTIAL,49500,0,49500,183400,0,232900
140722601000000,NE 158,RESIDENTIAL,49500,0,49500,207800,0,257300
140722601100000,NE 158,RESIDENTIAL,50500,0,50500,216500,0,267000
140722601200000,NE 158,RESIDENTIAL,50500,0,50500,210000,0,260500
140722601300000,NE 158,RESIDENTIAL,50000,0,50000,196300,0,246300
140722601400000,NE 158,RESIDENTIAL,55600,0,55600,205000,0,260600
140722601500000,NE 158,RESIDENTIAL,48500,0,48500,194600,0,243100
140722601600000,NE 158,RESIDENTIAL,39000,0,39000,226000,0,265000
140722601700000,NE 158,RESIDENTIAL,48900,0,48900,220300,0,269200
140722601800000,NE 158,RESIDENTIAL,47000,0,47000,200300,0,247300
140722601900000,NE 158,RESIDENTIAL,47000,0,47000,244800,0,291800
140722602000000,NE 158,RESIDENTIAL,47000,0,47000,204300,0,251300
140722602100000,NE 158,RESIDENTIAL,47000,0,47000,224100,0,271100
140722602200000,NE 158,RESIDENTIAL,47000,0,47000,217900,0,264900
140722602300000,NE 158,RESIDENTIAL,49200,0,49200,229500,0,278700
140722602400000,NE 158,RESIDENTIAL,41900,0,41900,193400,0,235300
140722602500000,NE 158,RESIDENTIAL,41900,0,41900,206800,0,248700
140722602600000,NE 158,RESIDENTIAL,44600,0,44600,219100,0,263700
140722602700000,NE 158,RESIDENTIAL,40700,0,40700,197700,0,238400
140722602800000,NE 158,RESIDENTIAL,38100,0,38100,83300,0,121400
140722602900000,NE 158,RESIDENTIAL,1700,0,1700,0,0,1700
140722603000000,NE 158,RESIDENTIAL,0,0,0,0,0,0
140722603100000,NE 158,RESIDENTIAL,42800,0,42800,145500,0,188300
140722603200000,NE 158,RESIDENTIAL,36000,0,36000,159300,0,195300
140722603300000,NE 158,RESIDENTIAL,36100,0,36100,151500,0,187600
140722603400000,NE 158,RESIDENTIAL,36400,0,36400,165700,0,202100
140722603500000,NE 158,RESIDENTIAL,38700,0,38700,173500,0,212200
140722603600000,NE 158,RESIDENTIAL,40500,0,40500,155000,0,195500
140722603700000,NE 158,RESIDENTIAL,1900,0,1900,0,0,1900
140722603800000,NE 152,RESIDENTIAL,23900,0,23900,227700,0,251600
140722603900000,NE 152,RESIDENTIAL,24600,0,24600,228600,0,253200
140722604000000,NE 152,RESIDENTIAL,24600,0,24600,220000,0,244600
140722604100000,NE 152,RESIDENTIAL,24600,0,24600,245400,0,270000
140722604200000,NE 152,RESIDENTIAL,24600,0,24600,243100,0,267700
140722604300000,NE 152,RESIDENTIAL,24600,0,24600,253900,0,278500
140722604400000,NE 152,RESIDENTIAL,24600,0,24600,239900,0,264500
140722604500000,NE 152,RESIDENTIAL,24600,0,24600,257800,0,282400
140722604600000,NE 152,RESIDENTIAL,24600,0,24600,242500,0,267100
140722604700000,NE 152,RESIDENTIAL,24600,0,24600,245600,0,270200
140722604800000,NE 152,RESIDENTIAL,24600,0,24600,244300,0,268900
140722604900000,NE 152,RESIDENTIAL,24600,0,24600,258900,0,283500
140722605000000,NE 152,RESIDENTIAL,24600,0,24600,236400,0,261000
140722605100000,NE 152,RESIDENTIAL,23800,0,23800,232900,0,256700
140722605200000,NE 152,RESIDENTIAL,22900,0,22900,214100,0,237000
140722605300000,NE 152,RESIDENTIAL,23400,0,23400,213700,0,237100
140722605400000,NE 152,RESIDENTIAL,26500,0,26500,233300,0,259800
140722605500000,NE 152,RESIDENTIAL,26900,0,26900,248400,0,275300
140722605600000,NE 152,RESIDENTIAL,26400,0,26400,199800,0,226200
140722605700000,NE 152,RESIDENTIAL,26200,0,26200,249900,0,276100
140722605800000,NE 152,RESIDENTIAL,25600,0,25600,237500,0,263100
140722700100000,NE 158,RESIDENTIAL,40100,0,40100,117100,0,157200
140722700200000,NE 158,RESIDENTIAL,42500,0,42500,178100,0,220600
140722700300000,NE 158,RESIDENTIAL,40500,0,40500,190800,0,231300
140722700400000,NE 158,RESIDENTIAL,40900,0,40900,166900,0,207800
140722700500000,NE 158,RESIDENTIAL,40900,0,40900,196000,0,236900
140722700600000,NE 158,RESIDENTIAL,40900,0,40900,201700,0,242600
140722700700000,NE 158,RESIDENTIAL,40900,0,40900,174100,0,215000
140722700800000,NE 158,RESIDENTIAL,46300,0,46300,178100,0,224400
140722700900000,NE 158,RESIDENTIAL,40500,0,40500,218200,0,258700
140722701000000,NE 158,RESIDENTIAL,48000,0,48000,212200,0,260200
140722701100000,NE 158,RESIDENTIAL,50000,0,50000,223400,0,273400
140722701200000,NE 158,RESIDENTIAL,50400,0,50400,239600,0,290000
140722701300000,NE 158,RESIDENTIAL,45300,0,45300,196300,0,241600
140722701400000,NE 158,RESIDENTIAL,42800,0,42800,189300,0,232100
140722701500000,NE 158,RESIDENTIAL,43200,0,43200,201700,0,244900
140722701600000,NE 158,RESIDENTIAL,43200,0,43200,216900,0,260100
140722701700000,NE 158,RESIDENTIAL,43200,0,43200,214400,0,257600
140722701800000,NE 158,RESIDENTIAL,43200,0,43200,203300,0,246500
140722701900000,NE 158,RESIDENTIAL,43200,0,43200,189200,0,232400
140722702000000,NE 158,RESIDENTIAL,44300,0,44300,189800,0,234100
140722702100000,NE 158,RESIDENTIAL,44300,0,44300,217400,0,261700
140722702200000,NE 158,RESIDENTIAL,40200,0,40200,187600,0,227800
140722702300000,NE 158,RESIDENTIAL,43000,0,43000,199000,0,242000
140722702400000,NE 158,RESIDENTIAL,42200,0,42200,190800,0,233000
140722702500000,NE 158,RESIDENTIAL,43600,0,43600,193700,0,237300
140722702600000,NE 158,RESIDENTIAL,43100,0,43100,153600,0,196700
140722702700000,NE 158,RESIDENTIAL,38500,0,38500,145300,0,183800
140722702800000,NE 158,RESIDENTIAL,36400,0,36400,146000,0,182400
140722702900000,NE 158,RESIDENTIAL,36400,0,36400,143600,0,180000
140722703000000,NE 158,RESIDENTIAL,36400,0,36400,135800,0,172200
140722703100000,NE 158,RESIDENTIAL,36400,0,36400,141400,0,177800
140722703200000,NE 158,RESIDENTIAL,36400,0,36400,128000,0,164400
140722703300000,NE 158,RESIDENTIAL,36400,0,36400,136900,0,173300
140722703400000,NE 158,RESIDENTIAL,36400,0,36400,147300,0,183700
140722703500000,NE 158,RESIDENTIAL,36400,0,36400,115200,0,151600
140722703600000,NE 158,RESIDENTIAL,36400,0,36400,127200,0,163600
140722800200000,NE 152,RESIDENTIAL,21900,0,21900,263500,0,285400
140722800300000,NE 152,RESIDENTIAL,21900,0,21900,213100,0,235000
140722800400000,NE 152,RESIDENTIAL,21900,0,21900,265300,0,287200
140722800500000,NE 152,RESIDENTIAL,21900,0,21900,222200,0,244100
140722800600000,NE 152,RESIDENTIAL,21900,0,21900,259300,0,281200
140722800700000,NE 152,RESIDENTIAL,29500,0,29500,244200,0,273700
140725100100000,NE 158,RESIDENTIAL,35000,0,35000,150100,0,185100
140725100200000,NE 158,RESIDENTIAL,40500,0,40500,169200,0,209700
140725100300000,NE 158,RESIDENTIAL,40500,0,40500,150800,0,191300
140725100400000,NE 158,RESIDENTIAL,40500,0,40500,180900,0,221400
140725100500000,NE 158,RESIDENTIAL,40500,0,40500,152200,0,192700
140725100600000,NE 158,RESIDENTIAL,45700,0,45700,166400,0,212100
140725100700000,NE 158,RESIDENTIAL,42800,0,42800,153800,0,196600
140725100800000,NE 158,RESIDENTIAL,45900,0,45900,164000,0,209900
140725100900000,NE 158,RESIDENTIAL,44800,0,44800,180000,0,224800
140725101000000,NE 158,RESIDENTIAL,49700,0,49700,178400,0,228100
140725101100000,NE 158,RESIDENTIAL,44800,0,44800,224500,0,269300
140725101200000,NE 158,RESIDENTIAL,44600,0,44600,203700,0,248300
140725101300000,NE 158,RESIDENTIAL,41100,0,41100,191500,0,232600
140725101400000,NE 158,RESIDENTIAL,41100,0,41100,159900,0,201000
140725101500000,NE 158,RESIDENTIAL,46700,0,46700,204000,0,250700
140725101600000,NE 158,RESIDENTIAL,46600,0,46600,183500,0,230100
140725200100000,NE 158,RESIDENTIAL,40400,0,40400,155800,0,196200
140725200200000,NE 158,RESIDENTIAL,30200,0,30200,0,0,30200
140725200300000,NE 158,RESIDENTIAL,22000,0,22000,0,0,22000
140725200400000,NE 158,RESIDENTIAL,43300,0,43300,201000,0,244300
140725200500000,NE 158,RESIDENTIAL,41200,0,41200,166900,0,208100
140725200600000,NE 140,RESIDENTIAL,400,0,400,0,0,400
140725200700000,NE 158,RESIDENTIAL,44200,0,44200,208400,0,252600
140725200800000,NE 158,RESIDENTIAL,43800,0,43800,209200,0,253000
140725200900000,NE 158,RESIDENTIAL,40700,0,40700,207400,0,248100
140725201000000,NE 158,RESIDENTIAL,40700,0,40700,192500,0,233200
140725201100000,NE 158,RESIDENTIAL,40600,0,40600,204200,0,244800
140725201200000,NE 158,RESIDENTIAL,43400,0,43400,228000,0,271400
140725201300000,NE 158,RESIDENTIAL,43900,0,43900,218400,0,262300
140725201400000,NE 158,RESIDENTIAL,49900,0,49900,227300,0,277200
140725201500000,NE 158,RESIDENTIAL,40100,0,40100,0,0,40100
140725201600000,NE 158,RESIDENTIAL,39000,0,39000,186500,0,225500
140725201700000,NE 158,RESIDENTIAL,37100,0,37100,185400,0,222500
140725201800000,NE 158,RESIDENTIAL,36600,0,36600,158600,0,195200
140725201900000,NE 158,RESIDENTIAL,36600,0,36600,153900,0,190500
140725202000000,NE 158,RESIDENTIAL,33100,0,33100,159100,0,192200
140725202100000,NE 158,RESIDENTIAL,34200,0,34200,183300,0,217500
140725202200000,NE 158,RESIDENTIAL,37800,0,37800,141400,0,179200
140725202300000,NE 158,RESIDENTIAL,37800,0,37800,164900,0,202700
140725202400000,NE 158,RESIDENTIAL,37800,0,37800,155400,0,193200
140725202500000,NE 158,RESIDENTIAL,39000,0,39000,174600,0,213600
140725202600000,NE 158,RESIDENTIAL,37400,0,37400,210900,0,248300
140725202700000,NE 158,RESIDENTIAL,37800,0,37800,182200,0,220000
140725202800000,NE 158,RESIDENTIAL,37800,0,37800,208100,0,245900
140725202900000,NE 158,RESIDENTIAL,37800,0,37800,200300,0,238100
140725203000000,NE 158,RESIDENTIAL,42600,0,42600,209900,0,252500
140725203100000,NE 158,RESIDENTIAL,44300,0,44300,193700,0,238000
140725203200000,NE 158,RESIDENTIAL,41700,0,41700,179600,0,221300
140725203300000,NE 158,RESIDENTIAL,35600,0,35600,179900,0,215500
140725203400000,NE 158,RESIDENTIAL,38500,0,38500,190500,0,229000
140725203500000,NE 158,RESIDENTIAL,37500,0,37500,161800,0,199300
140725203600000,NE 158,RESIDENTIAL,40200,0,40200,152200,0,192400
140725203700000,NE 158,RESIDENTIAL,39000,0,39000,205000,0,244000
140725203800000,NE 158,RESIDENTIAL,39000,0,39000,163700,0,202700
140725203900000,NE 158,RESIDENTIAL,39000,0,39000,166800,0,205800
140725204000000,NE 158,RESIDENTIAL,39000,0,39000,181600,0,220600
140725204100000,NE 158,RESIDENTIAL,39000,0,39000,166600,0,205600
140725204200000,NE 158,RESIDENTIAL,43900,0,43900,152400,0,196300
140727600100000,NE 158,RESIDENTIAL,44700,0,44700,200900,0,245600
140727600200000,NE 158,RESIDENTIAL,40300,0,40300,202100,0,242400
140727600300000,NE 158,RESIDENTIAL,40300,0,40300,210600,0,250900
140727600400000,NE 158,RESIDENTIAL,40300,0,40300,183300,0,223600
140727600500000,NE 158,RESIDENTIAL,40300,0,40300,215800,0,256100
140727600600000,NE 158,RESIDENTIAL,40700,0,40700,230900,0,271600
140727600700000,NE 158,RESIDENTIAL,41200,0,41200,196300,0,237500
140727600800000,NE 158,RESIDENTIAL,43300,0,43300,188000,0,231300
140727600900000,NE 158,RESIDENTIAL,43900,0,43900,220000,0,263900
140727601000000,NE 158,RESIDENTIAL,49200,0,49200,287600,0,336800
140727601100000,NE 158,RESIDENTIAL,39400,0,39400,0,0,39400
140727601200000,NE 158,RESIDENTIAL,65300,0,65300,0,0,65300
140727601300000,NE 158,RESIDENTIAL,40900,0,40900,180200,0,221100
140727601400000,NE 158,RESIDENTIAL,42800,0,42800,221300,0,264100
140727601500000,NE 158,RESIDENTIAL,42800,0,42800,189400,0,232200
140727601600000,NE 158,RESIDENTIAL,42800,0,42800,166900,0,209700
140727601700000,NE 158,RESIDENTIAL,43800,0,43800,170300,0,214100
140727601800000,NE 158,RESIDENTIAL,43800,0,43800,183600,0,227400
140727601900000,NE 158,RESIDENTIAL,43800,0,43800,182600,0,226400
140727602000000,NE 158,RESIDENTIAL,43800,0,43800,184900,0,228700
140727602100000,NE 158,RESIDENTIAL,42500,0,42500,164700,0,207200
140727602200000,NE 158,RESIDENTIAL,44500,0,44500,219900,0,264400
140727602300000,NE 158,RESIDENTIAL,45800,0,45800,218300,0,264100
140727602400000,NE 158,RESIDENTIAL,47700,0,47700,178200,0,225900
140727602500000,NE 158,RESIDENTIAL,48600,0,48600,179700,0,228300
140727602600000,NE 158,RESIDENTIAL,48600,0,48600,240600,0,289200
140727602700000,NE 158,RESIDENTIAL,49400,0,49400,237900,0,287300
140727602800000,NE 158,RESIDENTIAL,52400,0,52400,188400,0,240800
140727602900000,NE 158,RESIDENTIAL,48900,0,48900,0,0,48900
140727603000000,NE 158,RESIDENTIAL,49300,0,49300,190500,0,239800
140727603100000,NE 158,RESIDENTIAL,48500,0,48500,222500,0,271000
140727603200000,NE 158,RESIDENTIAL,49600,0,49600,236000,0,285600
140727603300000,NE 158,RESIDENTIAL,42400,0,42400,219800,0,262200
140727603400000,NE 158,RESIDENTIAL,43100,0,43100,183000,0,226100
140727603500000,NE 158,RESIDENTIAL,46500,0,46500,213700,0,260200
140727603600000,NE 158,RESIDENTIAL,42900,0,42900,189600,0,232500
140727603700000,NE 158,RESIDENTIAL,42900,0,42900,171100,0,214000
140727603800000,NE 158,RESIDENTIAL,42300,0,42300,178100,0,220400
140727603900000,NE 158,RESIDENTIAL,40200,0,40200,168600,0,208800
140727604000000,NE 158,RESIDENTIAL,38900,0,38900,161700,0,200600
140727604100000,NE 158,RESIDENTIAL,41800,0,41800,184400,0,226200
140727604200000,NE 158,RESIDENTIAL,37800,0,37800,159400,0,197200
140727604300000,NE 158,RESIDENTIAL,38600,0,38600,170400,0,209000
140727604400000,NE 158,RESIDENTIAL,38600,0,38600,200300,0,238900
140727604500000,NE 158,RESIDENTIAL,38600,0,38600,200400,0,239000
140727604600000,NE 158,RESIDENTIAL,38600,0,38600,175200,0,213800
140727604700000,NE 158,RESIDENTIAL,45100,0,45100,203500,0,248600
140730100100000,NE 158,RESIDENTIAL,43800,0,43800,156300,0,200100
140730100200000,NE 140,RESIDENTIAL,54600,0,54600,0,0,54600
140730100300000,NE 158,RESIDENTIAL,42800,0,42800,188400,0,231200
140730100400000,NE 158,RESIDENTIAL,46300,0,46300,174700,0,221000
140730100500000,NE 158,RESIDENTIAL,44800,0,44800,178600,0,223400
140730100600000,NE 158,RESIDENTIAL,45200,0,45200,257500,0,302700
140730100700000,NE 158,RESIDENTIAL,43500,0,43500,160400,0,203900
140730100800000,NE 158,RESIDENTIAL,42400,0,42400,174100,0,216500
140730100900000,NE 158,RESIDENTIAL,41000,0,41000,158800,0,199800
140730101000000,NE 158,RESIDENTIAL,36600,0,36600,176800,0,213400
140730101100000,NE 158,RESIDENTIAL,37100,0,37100,172600,0,209700
140730101200000,NE 158,RESIDENTIAL,41900,0,41900,184800,0,226700
140730101300000,NE 158,RESIDENTIAL,47100,0,47100,201900,0,249000
140730101400000,NE 158,RESIDENTIAL,48300,0,48300,169200,0,217500
140730101500000,NE 158,RESIDENTIAL,42800,0,42800,179000,0,221800
140730101600000,NE 158,RESIDENTIAL,38900,0,38900,168800,0,207700
140730101700000,NE 158,RESIDENTIAL,43200,0,43200,160900,0,204100
140730200100000,NE 158,RESIDENTIAL,38300,0,38300,173200,0,211500
140730200200000,NE 158,RESIDENTIAL,46400,0,46400,231900,0,278300
140730200300000,NE 158,RESIDENTIAL,48700,0,48700,241100,0,289800
140730200400000,NE 158,RESIDENTIAL,46400,0,46400,222700,0,269100
140730200500000,NE 158,RESIDENTIAL,47500,0,47500,244400,0,291900
140730200600000,NE 158,RESIDENTIAL,37600,0,37600,163800,0,201400
140730200700000,NE 158,RESIDENTIAL,38300,0,38300,207900,0,246200
140730200800000,NE 158,RESIDENTIAL,37600,0,37600,223000,0,260600
140730200900000,NE 158,RESIDENTIAL,36600,0,36600,180400,0,217000
140730201000000,NE 158,RESIDENTIAL,36700,0,36700,230400,0,267100
140730201100000,NE 158,RESIDENTIAL,39900,0,39900,241300,0,281200
140730201200000,NE 158,RESIDENTIAL,38300,0,38300,179500,0,217800
140730300100000,NE 158,RESIDENTIAL,43300,0,43300,199300,0,242600
140730300200000,NE 158,RESIDENTIAL,45100,0,45100,169200,0,214300
140730300300000,NE 158,RESIDENTIAL,43300,0,43300,187500,0,230800
140730300400000,NE 158,RESIDENTIAL,51200,0,51200,212200,0,263400
140730400100000,NE 158,RESIDENTIAL,49100,0,49100,148200,0,197300
140730400200000,NE 158,RESIDENTIAL,50200,0,50200,198600,0,248800
140730400300000,NE 158,RESIDENTIAL,52000,0,52000,225200,0,277200
140730400400000,NE 158,RESIDENTIAL,50500,0,50500,255900,0,306400
140730400500000,NE 140,RESIDENTIAL,18800,0,18800,0,0,18800
140730400600000,NE 158,RESIDENTIAL,49000,0,49000,213600,0,262600
140730400700000,NE 158,RESIDENTIAL,49000,0,49000,189800,0,238800
140730400800000,NE 158,RESIDENTIAL,46900,0,46900,191400,0,238300
140730400900000,NE 158,RESIDENTIAL,36400,0,36400,0,0,36400
140730401000000,NE 158,RESIDENTIAL,69400,0,69400,288400,0,357800
140730401100000,NE 153,RESIDENTIAL,6200,0,6200,0,0,6200
140730401200000,NE 153,RESIDENTIAL,18600,0,18600,194600,0,213200
140730401300000,NE 153,RESIDENTIAL,13000,0,13000,135200,0,148200
140730401400000,NE 153,RESIDENTIAL,15600,0,15600,139700,0,155300
140730401500000,NE 153,RESIDENTIAL,19100,0,19100,150300,0,169400
140730401600000,NE 153,RESIDENTIAL,19100,0,19100,176500,0,195600
140730401800000,NE 158,RESIDENTIAL,8100,0,8100,0,0,8100
140730500100000,NE 158,RESIDENTIAL,45000,0,45000,203400,0,248400
140732600100000,NE 158,RESIDENTIAL,38300,0,38300,181400,0,219700
140732600200000,NE 158,RESIDENTIAL,39100,0,39100,228800,0,267900
140732600300000,NE 158,RESIDENTIAL,44800,0,44800,216400,0,261200
140732600400000,NE 158,RESIDENTIAL,46500,0,46500,259700,0,306200
140732600500000,NE 158,RESIDENTIAL,48000,0,48000,214500,0,262500
140732600600000,NE 158,RESIDENTIAL,48000,0,48000,218400,0,266400
140732700100000,NE 158,RESIDENTIAL,50200,0,50200,207500,0,257700
140732700200000,NE 158,RESIDENTIAL,102700,0,102700,0,0,102700
140732700300000,NE 158,RESIDENTIAL,43600,0,43600,175300,0,218900
140732700400000,NE 158,RESIDENTIAL,44500,0,44500,213200,0,257700
140732700500000,NE 153,RESIDENTIAL,17400,0,17400,169400,0,186800
140732700600000,NE 153,RESIDENTIAL,13200,0,13200,128000,0,141200
140732700700000,NE 153,RESIDENTIAL,15600,0,15600,148600,0,164200
140732700800000,NE 153,RESIDENTIAL,18900,0,18900,164600,0,183500
140732700900000,NE 153,RESIDENTIAL,19700,0,19700,172900,0,192600
140732701000000,NE 153,RESIDENTIAL,14900,0,14900,0,0,14900
140732701100000,NE 153,RESIDENTIAL,18300,0,18300,161400,0,179700
140732701200000,NE 153,RESIDENTIAL,13400,0,13400,141700,0,155100
140732701300000,NE 153,RESIDENTIAL,16200,0,16200,149800,0,166000
140732701400000,NE 153,RESIDENTIAL,19300,0,19300,147600,0,166900
140732701500000,NE 153,RESIDENTIAL,21100,0,21100,175000,0,196100
140732701600000,NE 153,RESIDENTIAL,18500,0,18500,178700,0,197200
140732701700000,NE 153,RESIDENTIAL,13200,0,13200,132300,0,145500
140732701800000,NE 153,RESIDENTIAL,15000,0,15000,153400,0,168400
140732701900000,NE 153,RESIDENTIAL,18200,0,18200,154200,0,172400
140732702000000,NE 153,RESIDENTIAL,18300,0,18300,164500,0,182800
140732702100000,NE 153,RESIDENTIAL,19400,0,19400,183100,0,202500
140732702200000,NE 153,RESIDENTIAL,18600,0,18600,150900,0,169500
140732702300000,NE 153,RESIDENTIAL,15000,0,15000,147900,0,162900
140732702400000,NE 153,RESIDENTIAL,13200,0,13200,140900,0,154100
140732702500000,NE 153,RESIDENTIAL,19700,0,19700,173700,0,193400
140732702600000,NE 153,RESIDENTIAL,20500,0,20500,198800,0,219300
140732702700000,NE 153,RESIDENTIAL,17400,0,17400,150700,0,168100
140732702800000,NE 153,RESIDENTIAL,15200,0,15200,159900,0,175100
140732702900000,NE 153,RESIDENTIAL,13000,0,13000,138500,0,151500
140732703000000,NE 153,RESIDENTIAL,20200,0,20200,201700,0,221900
140732703100000,NE 158,RESIDENTIAL,47700,0,47700,203500,0,251200
140732703200000,NE 158,RESIDENTIAL,48000,0,48000,211800,0,259800
140732703300000,NE 158,RESIDENTIAL,45900,0,45900,209700,0,255600
140732800100000,NE 158,RESIDENTIAL,48300,0,48300,209500,0,257800
140732800200000,NE 153,RESIDENTIAL,8000,0,8000,0,0,8000
140732800300000,NE 158,RESIDENTIAL,46400,0,46400,239300,0,285700
140732800400000,NE 158,RESIDENTIAL,43400,0,43400,235700,0,279100
140732800500000,NE 158,RESIDENTIAL,45500,0,45500,215200,0,260700
140732800600000,NE 153,RESIDENTIAL,1900,0,1900,0,0,1900
140732800700000,NE 140,RESIDENTIAL,900,0,900,0,0,900
140735100100000,NE 151,RESIDENTIAL,333000,0,333000,0,0,333000
140735100200000,NE 151,RESIDENTIAL,7000,0,7000,0,0,7000
140737600100000,CITY PROPERTY,EXEMPT,0,0,0,0,0,0
140740100100000,NE 138,RESIDENTIAL,70100,0,70100,242400,0,312500
140740100200000,NE 138,RESIDENTIAL,63700,0,63700,252100,0,315800
140740100300000,NE 138,RESIDENTIAL,78400,0,78400,280500,0,358900
140740100400000,NE 138,RESIDENTIAL,80900,0,80900,318600,0,399500
140740100500000,NE 138,RESIDENTIAL,97200,0,97200,347700,0,444900
140740100600000,NE 138,RESIDENTIAL,75600,0,75600,282100,0,357700
140740100700000,NE 138,RESIDENTIAL,103600,0,103600,361500,0,465100
140740100800000,NE 138,RESIDENTIAL,114700,0,114700,337800,0,452500
140740100900000,NE 157,RESIDENTIAL,79800,0,79800,256500,0,336300
140740101000000,NE 157,RESIDENTIAL,71000,0,71000,292900,0,363900
140740101100000,NE 157,RESIDENTIAL,64500,0,64500,222700,0,287200
140740101200000,NE 157,RESIDENTIAL,100000,0,100000,304500,0,404500
140740101300000,NE 157,RESIDENTIAL,82800,0,82800,217800,0,300600
140740101400000,NE 157,RESIDENTIAL,87700,0,87700,340500,0,428200
140740101500000,NE 157,RESIDENTIAL,91600,0,91600,358200,0,449800
140740101600000,NE 157,RESIDENTIAL,89500,0,89500,312100,0,401600
140740101700000,NE 157,RESIDENTIAL,86600,0,86600,0,0,86600
140740101900000,NE 157,RESIDENTIAL,75300,0,75300,256200,0,331500
140740102000000,NE 157,RESIDENTIAL,53200,0,53200,0,0,53200
140740102100000,NE 157,RESIDENTIAL,72500,0,72500,352300,0,424800
140740102200000,NE 157,RESIDENTIAL,75600,0,75600,417100,0,492700
140740102300000,NE 157,RESIDENTIAL,80400,0,80400,315700,0,396100
140740102400000,NE 157,RESIDENTIAL,80200,0,80200,354700,0,434900
140740102500000,NE 138,RESIDENTIAL,65300,0,65300,297000,0,362300
140740102600000,NE 138,RESIDENTIAL,56200,0,56200,349500,0,405700
140740102700000,NE 138,RESIDENTIAL,53100,0,53100,0,0,53100
140740102800000,NE 157,RESIDENTIAL,67300,0,67300,293400,0,360700
140740102900000,NE 157,RESIDENTIAL,66500,0,66500,207300,0,273800
140740103000000,NE 157,RESIDENTIAL,76000,0,76000,251200,0,327200
140740103100000,NE 157,RESIDENTIAL,65500,0,65500,239200,0,304700
140740103200000,NE 157,RESIDENTIAL,64900,0,64900,386800,0,451700
140740103300000,NE 157,RESIDENTIAL,58600,0,58600,296500,0,355100
140740103400000,NE 138,RESIDENTIAL,67700,0,67700,238400,0,306100
140740103500000,NE 138,RESIDENTIAL,59500,0,59500,269000,0,328500
140740103600000,CENTRALLY ASSESSED,OTHER,0,0,0,0,0,0
140742600200000,NE 157,RESIDENTIAL,22800,0,22800,0,0,22800
140742600300000,NE 157,RESIDENTIAL,10400,0,10400,0,0,10400
140742600400000,NE 157,RESIDENTIAL,15300,0,15300,0,0,15300
140742600500000,NE 157,RESIDENTIAL,55100,0,55100,0,0,55100
140742600600000,NE 157,RESIDENTIAL,34600,0,34600,0,0,34600
140742700100000,NE 158,RESIDENTIAL,74400,0,74400,242700,0,317100
140742700200000,NE 158,RESIDENTIAL,44600,0,44600,159700,0,204300
140742700300000,NE 158,RESIDENTIAL,46800,0,46800,198200,0,245000
140742700400000,NE 158,RESIDENTIAL,44200,0,44200,236400,0,280600
140742700500000,NE 158,RESIDENTIAL,34500,0,34500,209800,0,244300
140742700600000,NE 158,RESIDENTIAL,54600,0,54600,176400,0,231000
140742700700000,NE 158,RESIDENTIAL,65400,0,65400,204300,0,269700
140742700800000,NE 158,RESIDENTIAL,83900,0,83900,196900,0,280800
140742700900000,NE 158,RESIDENTIAL,49900,0,49900,212700,0,262600
140742701000000,NE 158,RESIDENTIAL,49900,0,49900,247800,0,297700
140742701100000,NE 158,RESIDENTIAL,52000,0,52000,219300,0,271300
140745100100000,CITY PROPERTY,EXEMPT,0,0,0,0,0,0
140810100100000,NE 134,RESIDENTIAL,29200,0,29200,129800,0,159000
140810100200000,NE 134,RESIDENTIAL,25800,0,25800,127200,0,153000
140810100300000,NE 134,RESIDENTIAL,23800,0,23800,139000,0,162800
140810100400000,NE 134,RESIDENTIAL,23800,0,23800,124200,0,148000
140810100500000,NE 134,RESIDENTIAL,27400,0,27400,132500,0,159900
140810100600000,NE 134,RESIDENTIAL,34000,0,34000,119700,0,153700
140810100700000,NE 134,RESIDENTIAL,30900,0,30900,103400,0,134300
140810100800000,NE 134,RESIDENTIAL,34300,0,34300,131200,0,165500
140810100900000,NE 134,RESIDENTIAL,33700,0,33700,111100,0,144800
140810101000000,NE 134,RESIDENTIAL,36100,0,36100,126800,0,162900
140810101100000,NE 134,RESIDENTIAL,34900,0,34900,126600,0,161500
140810101200000,NE 134,RESIDENTIAL,34900,0,34900,142400,0,177300
140810101300000,NE 134,RESIDENTIAL,34900,0,34900,118700,0,153600
140810101400000,NE 134,RESIDENTIAL,33800,0,33800,141200,0,175000
140810101500000,NE 134,RESIDENTIAL,31500,0,31500,116400,0,147900
140810101600000,NE 134,RESIDENTIAL,31100,0,31100,94200,0,125300
140810101700000,NE 134,RESIDENTIAL,32600,0,32600,102300,0,134900
140810200100000,NE 134,RESIDENTIAL,26100,0,26100,114100,0,140200
140810200200000,NE 134,RESIDENTIAL,24800,0,24800,123900,0,148700
140810200300000,NE 134,RESIDENTIAL,24800,0,24800,95000,0,119800
140810200400000,NE 134,RESIDENTIAL,25500,0,25500,106500,0,132000
140810200500000,CHURCH,EXEMPT,0,91800,91800,0,337500,429300
140810200600000,FLAT PARKING,EXEMPT,0,100500,100500,0,13300,113800
140810200700000,NE 134,RESIDENTIAL,25700,0,25700,123000,0,148700
140810200800000,NE 134,RESIDENTIAL,27900,0,27900,131100,0,159000
140810200900000,NE 134,RESIDENTIAL,27900,0,27900,121300,0,149200
140810201000000,NE 134,RESIDENTIAL,27600,0,27600,107900,0,135500
140810201100000,NE 134,RESIDENTIAL,27600,0,27600,112300,0,139900
140810201200000,FLAT PARKING,EXEMPT,0,93000,93000,0,9500,102500
140810201300000,NE 134,RESIDENTIAL,27200,0,27200,93200,0,120400
140810201400000,NE 134,RESIDENTIAL,27200,0,27200,107900,0,135100
140810201500000,NE 134,RESIDENTIAL,27200,0,27200,101000,0,128200
140810201600000,NE 134,RESIDENTIAL,27800,0,27800,99200,0,127000
140810300100000,NE 134,RESIDENTIAL,36100,0,36100,123100,0,159200
140810300200000,NE 134,RESIDENTIAL,35000,0,35000,124900,0,159900
140810300300000,NE 134,RESIDENTIAL,26900,0,26900,104800,0,131700
140810300400000,NE 134,RESIDENTIAL,27600,0,27600,132500,0,160100
140810300500000,NE 134,RESIDENTIAL,27600,0,27600,124200,0,151800
140810300600000,NE 134,RESIDENTIAL,28300,0,28300,107300,0,135600
140810300700000,NE 134,RESIDENTIAL,27700,0,27700,115700,0,143400
140810300800000,NE 134,RESIDENTIAL,27400,0,27400,96600,0,124000
140810300900000,NE 134,RESIDENTIAL,28200,0,28200,106500,0,134700
140810301000000,NE 134,RESIDENTIAL,28300,0,28300,128100,0,156400
140810301100000,NE 134,RESIDENTIAL,29300,0,29300,113500,0,142800
140810301200000,NE 134,RESIDENTIAL,36200,0,36200,149700,0,185900
140810301300000,NE 134,RESIDENTIAL,33700,0,33700,113200,0,146900
140810301400000,NE 134,RESIDENTIAL,33600,0,33600,126900,0,160500
140810301500000,NE 134,RESIDENTIAL,32300,0,32300,134200,0,166500
140810301600000,NE 134,RESIDENTIAL,33700,0,33700,100000,0,133700
140810301700000,NE 134,RESIDENTIAL,32900,0,32900,77900,0,110800
140810301800000,NE 134,RESIDENTIAL,32100,0,32100,135100,0,167200
140810301900000,NE 134,RESIDENTIAL,33500,0,33500,139400,0,172900
140810400100000,NE 134,RESIDENTIAL,31300,0,31300,159200,0,190500
140810400200000,NE 134,RESIDENTIAL,28800,0,28800,100300,0,129100
140810400300000,NE 134,RESIDENTIAL,28500,0,28500,146700,0,175200
140810400400000,NE 134,RESIDENTIAL,28200,0,28200,120700,0,148900
140810400500000,NE 134,RESIDENTIAL,27900,0,27900,117300,0,145200
140810400600000,NE 134,RESIDENTIAL,30000,0,30000,92000,0,122000
140810400700000,NE 134,RESIDENTIAL,27600,0,27600,99700,0,127300
140810400800000,NE 134,RESIDENTIAL,27600,0,27600,125600,0,153200
140810400900000,NE 134,RESIDENTIAL,27600,0,27600,115300,0,142900
140810401000000,NE 134,RESIDENTIAL,27300,0,27300,115700,0,143000
140810401100000,NE 134,RESIDENTIAL,32300,0,32300,134800,0,167100
140810401200000,NE 134,RESIDENTIAL,32100,0,32100,148600,0,180700
140810401300000,NE 134,RESIDENTIAL,31700,0,31700,137300,0,169000
140810401400000,NE 134,RESIDENTIAL,32100,0,32100,148600,0,180700
140810401500000,NE 134,RESIDENTIAL,33000,0,33000,123100,0,156100
140810401600000,NE 134,RESIDENTIAL,32700,0,32700,122900,0,155600
140810401700000,NE 134,RESIDENTIAL,33100,0,33100,125200,0,158300
140810401800000,NE 134,RESIDENTIAL,33100,0,33100,108000,0,141100
140810401900000,NE 134,RESIDENTIAL,31700,0,31700,145800,0,177500
140810402000000,NE 134,RESIDENTIAL,32900,0,32900,149300,0,182200
140810500100000,NE 134,RESIDENTIAL,30000,0,30000,138800,0,168800
140810500200000,NE 134,RESIDENTIAL,31700,0,31700,108500,0,140200
140810500300000,NE 134,RESIDENTIAL,31700,0,31700,139600,0,171300
140810500400000,NE 134,RESIDENTIAL,32100,0,32100,113900,0,146000
140810500500000,NE 134,RESIDENTIAL,32400,0,32400,123000,0,155400
140810500600000,NE 134,RESIDENTIAL,34800,0,34800,145100,0,179900
140810500700000,NE 134,RESIDENTIAL,32800,0,32800,156000,0,188800
140810500800000,NE 134,RESIDENTIAL,33500,0,33500,88600,0,122100
140810500900000,NE 134,RESIDENTIAL,33200,0,33200,154800,0,188000
140810501000000,NE 134,RESIDENTIAL,32700,0,32700,117500,0,150200
140810501100000,NE 134,RESIDENTIAL,36400,0,36400,130200,0,166600
140810501200000,NE 134,RESIDENTIAL,34300,0,34300,127000,0,161300
140810501300000,NE 134,RESIDENTIAL,34800,0,34800,132700,0,167500
140810501400000,NE 134,RESIDENTIAL,34000,0,34000,131800,0,165800
140810501500000,NE 134,RESIDENTIAL,31600,0,31600,141900,0,173500
140810501600000,NE 134,RESIDENTIAL,34400,0,34400,127200,0,161600
140810501700000,NE 134,RESIDENTIAL,32700,0,32700,119600,0,152300
140810501800000,NE 134,RESIDENTIAL,32700,0,32700,67500,0,100200
140810501900000,NE 134,RESIDENTIAL,32700,0,32700,116400,0,149100
140810502000000,NE 134,RESIDENTIAL,33400,0,33400,96400,0,129800
140810600100000,NE 134,RESIDENTIAL,33300,0,33300,121800,0,155100
140810600200000,NE 134,RESIDENTIAL,35600,0,35600,101400,0,137000
140810600300000,NE 134,RESIDENTIAL,34800,0,34800,109800,0,144600
140810600400000,NE 134,RESIDENTIAL,35600,0,35600,95700,0,131300
140810600500000,NE 134,RESIDENTIAL,34400,0,34400,108600,0,143000
140810600600000,NE 134,RESIDENTIAL,33600,0,33600,138400,0,172000
140810600700000,NE 134,RESIDENTIAL,34500,0,34500,100400,0,134900
140810600800000,NE 134,RESIDENTIAL,34000,0,34000,128600,0,162600
140810600900000,NE 134,RESIDENTIAL,34400,0,34400,113200,0,147600
140810601000000,NE 134,RESIDENTIAL,34600,0,34600,140000,0,174600
140810601100000,NE 134,RESIDENTIAL,34600,0,34600,126800,0,161400
140810601200000,NE 134,RESIDENTIAL,34100,0,34100,134100,0,168200
140810601300000,NE 134,RESIDENTIAL,34100,0,34100,166400,0,200500
140810601400000,NE 134,RESIDENTIAL,34000,0,34000,138800,0,172800
140810601500000,NE 134,RESIDENTIAL,34800,0,34800,144200,0,179000
140810601600000,NE 134,RESIDENTIAL,33800,0,33800,119500,0,153300
140810601700000,NE 134,RESIDENTIAL,36100,0,36100,111300,0,147400
140810601800000,NE 134,RESIDENTIAL,36900,0,36900,130700,0,167600
140810601900000,NE 134,RESIDENTIAL,34400,0,34400,84300,0,118700
140810602000000,NE 134,RESIDENTIAL,35500,0,35500,116200,0,151700
140810602100000,NE 134,RESIDENTIAL,33600,0,33600,120400,0,154000
140810602200000,NE 134,RESIDENTIAL,30600,0,30600,128700,0,159300
140810700100000,NE 134,RESIDENTIAL,35700,0,35700,126300,0,162000
140810700200000,NE 134,RESIDENTIAL,33800,0,33800,126800,0,160600
140810700300000,NE 134,RESIDENTIAL,33300,0,33300,118800,0,152100
140810700400000,NE 134,RESIDENTIAL,33900,0,33900,131600,0,165500
140810700500000,NE 134,RESIDENTIAL,32800,0,32800,145800,0,178600
140812600100000,NE 134,RESIDENTIAL,26000,0,26000,124900,0,150900
140812600200000,NE 134,RESIDENTIAL,28800,0,28800,155500,0,184300
140812600300000,NE 134,RESIDENTIAL,28500,0,28500,154100,0,182600
140812600400000,NE 134,RESIDENTIAL,30400,0,30400,131900,0,162300
140812600500000,NE 134,RESIDENTIAL,29400,0,29400,151700,0,181100
140812700100000,NE 134,RESIDENTIAL,28500,0,28500,149100,0,177600
140812700200000,NE 134,RESIDENTIAL,33400,0,33400,140600,0,174000
140812700300000,NE 134,RESIDENTIAL,33000,0,33000,106800,0,139800
140812700400000,NE 134,RESIDENTIAL,33200,0,33200,156500,0,189700
140812700500000,NE 134,RESIDENTIAL,33100,0,33100,133600,0,166700
140812700600000,NE 134,RESIDENTIAL,32300,0,32300,139300,0,171600
140812700700000,NE 134,RESIDENTIAL,32200,0,32200,143000,0,175200
140812700800000,NE 134,RESIDENTIAL,31200,0,31200,123100,0,154300
140812700900000,NE 134,RESIDENTIAL,31600,0,31600,149100,0,180700
140812701000000,NE 134,RESIDENTIAL,31500,0,31500,135900,0,167400
140812701100000,NE 134,RESIDENTIAL,30300,0,30300,151800,0,182100
140812701200000,NE 134,RESIDENTIAL,32400,0,32400,126800,0,159200
140812701300000,NE 134,RESIDENTIAL,27400,0,27400,117400,0,144800
140812701400000,NE 134,RESIDENTIAL,28700,0,28700,130200,0,158900
140812701500000,NE 134,RESIDENTIAL,30600,0,30600,130600,0,161200
140812701600000,NE 134,RESIDENTIAL,30700,0,30700,143500,0,174200
140812701700000,NE 134,RESIDENTIAL,29200,0,29200,143100,0,172300
140812701800000,NE 134,RESIDENTIAL,27800,0,27800,127500,0,155300
140812800100000,NE 134,RESIDENTIAL,32100,0,32100,133700,0,165800
140812800200000,NE 134,RESIDENTIAL,35400,0,35400,133000,0,168400
140812800300000,NE 134,RESIDENTIAL,31700,0,31700,168900,0,200600
140812800400000,NE 134,RESIDENTIAL,34100,0,34100,143800,0,177900
140812800500000,NE 134,RESIDENTIAL,33400,0,33400,135100,0,168500
140812800600000,NE 134,RESIDENTIAL,34300,0,34300,127500,0,161800
140812800700000,NE 134,RESIDENTIAL,34200,0,34200,127100,0,161300
140812800800000,NE 134,RESIDENTIAL,39200,0,39200,196800,0,236000
140812800900000,NE 134,RESIDENTIAL,36100,0,36100,215600,0,251700
140812801000000,NE 134,RESIDENTIAL,36400,0,36400,168100,0,204500
140812801100000,NE 134,RESIDENTIAL,37700,0,37700,170200,0,207900
140812801200000,NE 134,RESIDENTIAL,37300,0,37300,140500,0,177800
140812801300000,NE 134,RESIDENTIAL,36700,0,36700,158900,0,195600
140812801400000,NE 134,RESIDENTIAL,35000,0,35000,147700,0,182700
140812801500000,NE 134,RESIDENTIAL,32700,0,32700,125200,0,157900
140812900100000,NE 134,RESIDENTIAL,35600,0,35600,171000,0,206600
140812900200000,NE 134,RESIDENTIAL,32500,0,32500,163600,0,196100
140812900300000,NE 134,RESIDENTIAL,34200,0,34200,144800,0,179000
140812900400000,NE 134,RESIDENTIAL,34200,0,34200,155500,0,189700
140812900500000,NE 134,RESIDENTIAL,34200,0,34200,170300,0,204500
140812900600000,NE 134,RESIDENTIAL,34500,0,34500,169800,0,204300
140812900700000,NE 134,RESIDENTIAL,35800,0,35800,151000,0,186800
140812900800000,NE 134,RESIDENTIAL,36900,0,36900,180000,0,216900
140812900900000,NE 134,RESIDENTIAL,32800,0,32800,157900,0,190700
140812901000000,NE 134,RESIDENTIAL,32900,0,32900,157300,0,190200
140812901100000,NE 134,RESIDENTIAL,32900,0,32900,159800,0,192700
140812901200000,NE 134,RESIDENTIAL,32900,0,32900,143500,0,176400
140812901300000,NE 134,RESIDENTIAL,32900,0,32900,146000,0,178900
140813000100000,NE 134,RESIDENTIAL,33700,0,33700,116400,0,150100
140813000200000,NE 134,RESIDENTIAL,36400,0,36400,126000,0,162400
140813000300000,NE 134,RESIDENTIAL,36400,0,36400,167000,0,203400
140813000400000,NE 134,RESIDENTIAL,36400,0,36400,182000,0,218400
140813000500000,NE 134,RESIDENTIAL,37300,0,37300,172700,0,210000
140813000600000,NE 134,RESIDENTIAL,39900,0,39900,183700,0,223600
140813000700000,NE 134,RESIDENTIAL,42800,0,42800,210300,0,253100
140813000800000,NE 135,RESIDENTIAL,47100,0,47100,249500,0,296600
140813000900000,NE 135,RESIDENTIAL,45800,0,45800,192400,0,238200
140813001000000,NE 135,RESIDENTIAL,45300,0,45300,299200,0,344500
140813001100000,NE 135,RESIDENTIAL,45600,0,45600,299500,0,345100
140813001200000,NE 135,RESIDENTIAL,42600,0,42600,233700,0,276300
140813001300000,NE 135,RESIDENTIAL,43900,0,43900,174500,0,218400
140813001400000,NE 135,RESIDENTIAL,38800,0,38800,179600,0,218400
140813001500000,NE 135,RESIDENTIAL,39400,0,39400,200700,0,240100
140813001600000,NE 135,RESIDENTIAL,39600,0,39600,205500,0,245100
140813001700000,NE 135,RESIDENTIAL,39900,0,39900,180300,0,220200
140813001800000,NE 134,RESIDENTIAL,36000,0,36000,145800,0,181800
140813001900000,NE 134,RESIDENTIAL,34100,0,34100,138100,0,172200
140813002000000,NE 134,RESIDENTIAL,33000,0,33000,136100,0,169100
140813002100000,NE 134,RESIDENTIAL,37400,0,37400,190000,0,227400
140813002200000,NE 134,RESIDENTIAL,37200,0,37200,148000,0,185200
140813002300000,NE 134,RESIDENTIAL,38200,0,38200,163100,0,201300
140813002400000,NE 134,RESIDENTIAL,39600,0,39600,158500,0,198100
140813002500000,NE 134,RESIDENTIAL,36400,0,36400,199100,0,235500
140813002600000,NE 134,RESIDENTIAL,39200,0,39200,140800,0,180000
140813002700000,NE 134,RESIDENTIAL,39900,0,39900,175300,0,215200
140813100100000,NE 134,RESIDENTIAL,32500,0,32500,141000,0,173500
140813100200000,NE 134,RESIDENTIAL,32800,0,32800,137900,0,170700
140813100300000,NE 134,RESIDENTIAL,33100,0,33100,101200,0,134300
140813100400000,NE 134,RESIDENTIAL,33200,0,33200,153700,0,186900
140813100500000,NE 134,RESIDENTIAL,34600,0,34600,137700,0,172300
140813100600000,NE 134,RESIDENTIAL,38800,0,38800,159900,0,198700
140813100700000,NE 134,RESIDENTIAL,35100,0,35100,161200,0,196300
140813100800000,NE 134,RESIDENTIAL,36500,0,36500,168500,0,205000
140813100900000,NE 134,RESIDENTIAL,33900,0,33900,154300,0,188200
140813101000000,NE 134,RESIDENTIAL,34600,0,34600,173900,0,208500
140813101100000,NE 134,RESIDENTIAL,32600,0,32600,142300,0,174900
140813200100000,NE 134,RESIDENTIAL,31800,0,31800,134300,0,166100
140813200200000,NE 134,RESIDENTIAL,33900,0,33900,118900,0,152800
140813200300000,NE 134,RESIDENTIAL,32100,0,32100,133800,0,165900
140813200400000,NE 134,RESIDENTIAL,32600,0,32600,132800,0,165400
140813200500000,NE 134,RESIDENTIAL,31100,0,31100,128400,0,159500
140813200600000,NE 134,RESIDENTIAL,31700,0,31700,139400,0,171100
140813200700000,NE 135,RESIDENTIAL,39200,0,39200,183800,0,223000
140813200800000,NE 135,RESIDENTIAL,43800,0,43800,194900,0,238700
140813200900000,NE 135,RESIDENTIAL,39600,0,39600,255900,0,295500
140813201000000,NE 135,RESIDENTIAL,41500,0,41500,209500,0,251000
140813201100000,NE 135,RESIDENTIAL,45900,0,45900,237300,0,283200
140813201200000,NE 135,RESIDENTIAL,43500,0,43500,223900,0,267400
140813201300000,NE 135,RESIDENTIAL,45600,0,45600,213300,0,258900
140813201400000,NE 135,RESIDENTIAL,43100,0,43100,189500,0,232600
140813201500000,NE 135,RESIDENTIAL,43900,0,43900,305300,0,349200
140813201600000,NE 135,RESIDENTIAL,46900,0,46900,204000,0,250900
140813201700000,NE 135,RESIDENTIAL,42600,0,42600,286800,0,329400
140813201800000,NE 135,RESIDENTIAL,34700,0,34700,246800,0,281500
140813201900000,NE 135,RESIDENTIAL,41600,0,41600,277900,0,319500
140813202000000,NE 135,RESIDENTIAL,47500,0,47500,287100,0,334600
140813202100000,NE 135,RESIDENTIAL,46400,0,46400,272400,0,318800
140813202200000,NE 134,RESIDENTIAL,49200,0,49200,170100,0,219300
140813202300000,NE 134,RESIDENTIAL,51700,0,51700,225400,0,277100
140813202400000,NE 134,RESIDENTIAL,47000,0,47000,182600,0,229600
140813202500000,NE 134,RESIDENTIAL,42800,0,42800,182900,0,225700
140813202600000,NE 134,RESIDENTIAL,40700,0,40700,178500,0,219200
140813202700000,NE 134,RESIDENTIAL,40300,0,40300,158200,0,198500
140815100100000,NE 134,RESIDENTIAL,45600,0,45600,221800,0,267400
140815100200000,NE 134,RESIDENTIAL,45600,0,45600,217700,0,263300
140815100300000,NE 134,RESIDENTIAL,49200,0,49200,198900,0,248100
140815100400000,NE 135,RESIDENTIAL,61600,0,61600,355200,0,416800
140815100500000,NE 135,RESIDENTIAL,48700,0,48700,279400,0,328100
140815100600000,NE 135,RESIDENTIAL,48900,0,48900,265200,0,314100
140815100700000,NE 135,RESIDENTIAL,52000,0,52000,240600,0,292600
140815100800000,NE 135,RESIDENTIAL,53100,0,53100,365700,0,418800
140815200100000,NE 135,RESIDENTIAL,85100,0,85100,211600,0,296700
140815200200000,NE 135,RESIDENTIAL,48800,0,48800,250800,0,299600
140815200300000,NE 135,RESIDENTIAL,46900,0,46900,259700,0,306600
140815200400000,NE 135,RESIDENTIAL,44100,0,44100,245700,0,289800
140815200500000,NE 135,RESIDENTIAL,44400,0,44400,216900,0,261300
140815200600000,NE 135,RESIDENTIAL,50600,0,50600,238100,0,288700
140815200700000,NE 135,RESIDENTIAL,48800,0,48800,232600,0,281400
140815200800000,NE 135,RESIDENTIAL,48200,0,48200,198800,0,247000
140815200900000,NE 135,RESIDENTIAL,51600,0,51600,200900,0,252500
140815201000000,NE 135,RESIDENTIAL,52900,0,52900,209000,0,261900
140815201100000,NE 135,RESIDENTIAL,69300,0,69300,289900,0,359200
140815201200000,NE 135,RESIDENTIAL,53100,0,53100,242600,0,295700
140815201300000,NE 135,RESIDENTIAL,69800,0,69800,280800,0,350600
140815201400000,NE 135,RESIDENTIAL,62000,0,62000,224300,0,286300
140815201500000,NE 135,RESIDENTIAL,61500,0,61500,227700,0,289200
140815201600000,NE 135,RESIDENTIAL,64300,0,64300,250200,0,314500
140815201700000,NE 135,RESIDENTIAL,57300,0,57300,270800,0,328100
140815201800000,NE 135,RESIDENTIAL,56200,0,56200,246300,0,302500
140815201900000,NE 135,RESIDENTIAL,58000,0,58000,300300,0,358300
140815202000000,NE 135,RESIDENTIAL,59100,0,59100,257100,0,316200
140815202100000,NE 135,RESIDENTIAL,60000,0,60000,206200,0,266200
140815202200000,NE 136,RESIDENTIAL,62400,0,62400,293100,0,355500
140815202300000,NE 136,RESIDENTIAL,57900,0,57900,332100,0,390000
140815202400000,NE 136,RESIDENTIAL,55700,0,55700,297700,0,353400
140815202500000,NE 136,RESIDENTIAL,61700,0,61700,266900,0,328600
140815202600000,NE 136,RESIDENTIAL,63200,0,63200,306000,0,369200
140815202700000,NE 136,RESIDENTIAL,83100,0,83100,292100,0,375200
140815202800000,NE 136,RESIDENTIAL,67600,0,67600,363900,0,431500
140815202900000,NE 136,RESIDENTIAL,65000,0,65000,303500,0,368500
140815203000000,NE 136,RESIDENTIAL,62700,0,62700,281100,0,343800
140815203100000,NE 136,RESIDENTIAL,57400,0,57400,255000,0,312400
140815203200000,NE 136,RESIDENTIAL,43600,0,43600,247000,0,290600
140815203300000,NE 136,RESIDENTIAL,44300,0,44300,281500,0,325800
140815203400000,NE 136,RESIDENTIAL,45700,0,45700,276800,0,322500
140815203500000,NE 136,RESIDENTIAL,76500,0,76500,269100,0,345600
140815203600000,NE 136,RESIDENTIAL,85000,0,85000,273200,0,358200
140815203700000,NE 136,RESIDENTIAL,47600,0,47600,345700,0,393300
140815203800000,NE 136,RESIDENTIAL,40000,0,40000,333900,0,373900
140817600100000,NE 134,RESIDENTIAL,32500,0,32500,173300,0,205800
140817600200000,NE 134,RESIDENTIAL,32900,0,32900,137700,0,170600
140817600300000,NE 134,RESIDENTIAL,31700,0,31700,139600,0,171300
140817600400000,NE 134,RESIDENTIAL,30700,0,30700,165300,0,196000
140817600500000,NE 134,RESIDENTIAL,30200,0,30200,146200,0,176400
140817600600000,NE 134,RESIDENTIAL,30100,0,30100,144500,0,174600
140817600700000,NE 134,RESIDENTIAL,30100,0,30100,148800,0,178900
140817600800000,NE 134,RESIDENTIAL,30100,0,30100,147200,0,177300
140817600900000,NE 134,RESIDENTIAL,30100,0,30100,158600,0,188700
140817601000000,NE 134,RESIDENTIAL,30100,0,30100,169000,0,199100
140817601100000,NE 134,RESIDENTIAL,30200,0,30200,154900,0,185100
140817601200000,NE 133,RESIDENTIAL,1400,0,1400,0,0,1400
140817700100000,NE 134,RESIDENTIAL,29900,0,29900,112400,0,142300
140817700200000,NE 134,RESIDENTIAL,36600,0,36600,112300,0,148900
140817700300000,NE 134,RESIDENTIAL,37200,0,37200,127700,0,164900
140817700400000,NE 134,RESIDENTIAL,33400,0,33400,131800,0,165200
140817700500000,NE 134,RESIDENTIAL,37000,0,37000,164300,0,201300
140817700600000,NE 134,RESIDENTIAL,35300,0,35300,112100,0,147400
140817700700000,NE 134,RESIDENTIAL,36500,0,36500,150800,0,187300
140817700800000,NE 134,RESIDENTIAL,33100,0,33100,130400,0,163500
140817700900000,NE 134,RESIDENTIAL,32600,0,32600,162400,0,195000
140817701000000,NE 134,RESIDENTIAL,34400,0,34400,161100,0,195500
140817701100000,NE 134,RESIDENTIAL,40700,0,40700,137600,0,178300
140817701200000,NE 134,RESIDENTIAL,39700,0,39700,155600,0,195300
140817701300000,NE 134,RESIDENTIAL,32500,0,32500,112500,0,145000
140817701400000,NE 134,RESIDENTIAL,32400,0,32400,121900,0,154300
140817701500000,NE 134,RESIDENTIAL,30200,0,30200,110800,0,141000
140817701600000,NE 134,RESIDENTIAL,28600,0,28600,113600,0,142200
140817701700000,NE 134,RESIDENTIAL,29300,0,29300,143300,0,172600
140817800100000,NE 134,RESIDENTIAL,35000,0,35000,121500,0,156500
140817800200000,NE 134,RESIDENTIAL,34200,0,34200,144100,0,178300
140817800300000,NE 134,RESIDENTIAL,38000,0,38000,131000,0,169000
140817800400000,NE 134,RESIDENTIAL,34700,0,34700,136700,0,171400
140817800500000,NE 134,RESIDENTIAL,33400,0,33400,179600,0,213000
140817800600000,NE 134,RESIDENTIAL,34500,0,34500,115600,0,150100
140817800700000,NE 135,RESIDENTIAL,64100,0,64100,259200,0,323300
140817800800000,NE 135,RESIDENTIAL,75300,0,75300,255900,0,331200
140817800900000,NE 134,RESIDENTIAL,47000,0,47000,216700,0,263700
140817801000000,NE 134,RESIDENTIAL,33000,0,33000,132800,0,165800
140817801100000,NE 134,RESIDENTIAL,32600,0,32600,170900,0,203500
140817801200000,NE 134,RESIDENTIAL,43200,0,43200,167100,0,210300
140817801300000,NE 134,RESIDENTIAL,39800,0,39800,166600,0,206400
140817801400000,NE 134,RESIDENTIAL,34700,0,34700,119500,0,154200
140817801500000,NE 134,RESIDENTIAL,34900,0,34900,119100,0,154000
140817801600000,NE 134,RESIDENTIAL,37100,0,37100,172500,0,209600
140817801700000,NE 134,RESIDENTIAL,34200,0,34200,106300,0,140500
140817801800000,NE 134,RESIDENTIAL,36100,0,36100,126400,0,162500
140817900100000,NE 134,RESIDENTIAL,45400,0,45400,170800,0,216200
140817900200000,NE 134,RESIDENTIAL,39100,0,39100,155700,0,194800
140817900300000,NE 134,RESIDENTIAL,38400,0,38400,169100,0,207500
140817900400000,NE 134,RESIDENTIAL,37900,0,37900,140100,0,178000
140817900700000,NE 134,RESIDENTIAL,38600,0,38600,185000,0,223600
140818000100000,NE 134,RESIDENTIAL,38800,0,38800,174200,0,213000
140818000200000,NE 134,RESIDENTIAL,38300,0,38300,185200,0,223500
140818000300000,NE 134,RESIDENTIAL,53100,0,53100,143600,0,196700
140818000400000,NE 134,RESIDENTIAL,39200,0,39200,142800,0,182000
140818000500000,NE 134,RESIDENTIAL,36400,0,36400,168500,0,204900
140818000600000,NE 134,RESIDENTIAL,35900,0,35900,110300,0,146200
140818000700000,NE 134,RESIDENTIAL,43400,0,43400,224500,0,267900
140818000800000,NE 134,RESIDENTIAL,31700,0,31700,180400,0,212100
140818000900000,NE 134,RESIDENTIAL,31800,0,31800,0,0,31800
140818001300000,CITY PROPERTY,EXEMPT,0,0,0,0,0,0
140818001400000,CENTRALLY ASSESSED,OTHER,0,0,0,0,0,0
140818100100000,NE 135,RESIDENTIAL,48200,0,48200,168200,0,216400
140818100200000,NE 135,RESIDENTIAL,44400,0,44400,202900,0,247300
140818100300000,NE 135,RESIDENTIAL,44200,0,44200,172600,0,216800
140818100400000,NE 135,RESIDENTIAL,52100,0,52100,201400,0,253500
140818100500000,NE 135,RESIDENTIAL,77000,0,77000,257400,0,334400
140818100600000,NE 135,RESIDENTIAL,64700,0,64700,266000,0,330700
140818100700000,NE 135,RESIDENTIAL,51500,0,51500,231300,0,282800
140818100800000,NE 135,RESIDENTIAL,73900,0,73900,306100,0,380000
140818100900000,NE 135,RESIDENTIAL,64400,0,64400,215300,0,279700
140818101000000,NE 135,RESIDENTIAL,64600,0,64600,216800,0,281400
140818101100000,NE 135,RESIDENTIAL,57300,0,57300,233100,0,290400
140818101200000,NE 135,RESIDENTIAL,63200,0,63200,200500,0,263700
140818200500000,NE 134,RESIDENTIAL,34700,0,34700,157100,0,191800
140818200600000,NE 134,RESIDENTIAL,34900,0,34900,167200,0,202100
140820100100000,NE 139,RESIDENTIAL,22500,0,22500,0,0,22500
140820100200000,NE 139,RESIDENTIAL,32700,0,32700,130500,0,163200
140820100300000,NE 139,RESIDENTIAL,30900,0,30900,124900,0,155800
140820100400000,NE 139,RESIDENTIAL,31100,0,31100,141300,0,172400
140820100500000,NE 139,RESIDENTIAL,32600,0,32600,122700,0,155300
140820100600000,NE 139,RESIDENTIAL,29700,0,29700,121800,0,151500
140820100700000,NE 139,RESIDENTIAL,28500,0,28500,127200,0,155700
140820100800000,NE 139,RESIDENTIAL,27100,0,27100,136100,0,163200
140820100900000,NE 139,RESIDENTIAL,27100,0,27100,158000,0,185100
140820101000000,NE 139,RESIDENTIAL,26200,0,26200,130700,0,156900
140820101100000,NE 139,RESIDENTIAL,29600,0,29600,108700,0,138300
140820101400000,NE 139,RESIDENTIAL,15200,0,15200,160900,0,176100
140820101500000,NE 139,RESIDENTIAL,10300,0,10300,173900,0,184200
140820101600000,NE 139,RESIDENTIAL,21000,0,21000,149500,0,170500
140820101700000,NE 139,RESIDENTIAL,9400,0,9400,116200,0,125600
140820101800000,NE 139,RESIDENTIAL,15800,0,15800,115000,0,130800
140820101900000,NE 139,RESIDENTIAL,16300,0,16300,125600,0,141900
140820102000000,NE 139,RESIDENTIAL,9400,0,9400,114700,0,124100
140820102300000,NE 139,RESIDENTIAL,13700,0,13700,149900,0,163600
140820102400000,NE 139,RESIDENTIAL,12300,0,12300,161600,0,173900
140820102600000,NE 139,RESIDENTIAL,28500,0,28500,155800,0,184300
140820103900000,NE 139,RESIDENTIAL,16600,0,16600,148000,0,164600
140820104000000,NE 139,RESIDENTIAL,10300,0,10300,142200,0,152500
140820104100000,NE 139,RESIDENTIAL,29600,0,29600,100100,0,129700
140820104200000,NE 139,RESIDENTIAL,32700,0,32700,131100,0,163800
140820104300000,NE 139,RESIDENTIAL,28400,0,28400,165900,0,194300
140820104400000,NE 139,RESIDENTIAL,28300,0,28300,143900,0,172200
140820104500000,NE 139,RESIDENTIAL,31200,0,31200,159200,0,190400
140820104600000,NE 139,RESIDENTIAL,31200,0,31200,160200,0,191400
140820104700000,NE 139,RESIDENTIAL,31200,0,31200,164000,0,195200
140820104800000,NE 139,RESIDENTIAL,29000,0,29000,147500,0,176500
140820104900000,NE 139,RESIDENTIAL,29900,0,29900,165500,0,195400
140820105000000,NE 139,RESIDENTIAL,29600,0,29600,139400,0,169000
140820105100000,NE 139,RESIDENTIAL,29600,0,29600,127800,0,157400
140820105200000,NE 139,RESIDENTIAL,33100,0,33100,184100,0,217200
140820105300000,NE 139,RESIDENTIAL,33200,0,33200,136000,0,169200
140820105400000,NE 139,RESIDENTIAL,32300,0,32300,127500,0,159800
140820105500000,NE 139,RESIDENTIAL,31800,0,31800,140900,0,172700
140820105600000,NE 139,RESIDENTIAL,30700,0,30700,133400,0,164100
140820105700000,NE 139,RESIDENTIAL,31900,0,31900,152300,0,184200
140820105800000,NE 139,RESIDENTIAL,32600,0,32600,154400,0,187000
140820105900000,NE 139,RESIDENTIAL,30500,0,30500,165500,0,196000
140820106000000,NE 139,RESIDENTIAL,31500,0,31500,147800,0,179300
140820106100000,NE 139,RESIDENTIAL,24900,0,24900,113500,0,138400
140820106200000,NE 139,RESIDENTIAL,33700,0,33700,160600,0,194300
140820106300000,NE 139,RESIDENTIAL,31100,0,31100,157800,0,188900
140820106400000,NE 139,RESIDENTIAL,34000,0,34000,154700,0,188700
140820106500000,NE 139,RESIDENTIAL,33100,0,33100,134000,0,167100
140820106600000,NE 139,RESIDENTIAL,32400,0,32400,118900,0,151300
140820106700000,NE 139,RESIDENTIAL,33900,0,33900,124400,0,158300
140820106800000,NE 139,RESIDENTIAL,32400,0,32400,116500,0,148900
140820106900000,NE 139,RESIDENTIAL,31800,0,31800,141900,0,173700
140820107000000,NE 139,RESIDENTIAL,31800,0,31800,158700,0,190500
140820107100000,NE 139,RESIDENTIAL,32200,0,32200,125000,0,157200
140820107200000,NE 139,RESIDENTIAL,56700,0,56700,0,0,56700
140820107300000,NE 139,RESIDENTIAL,46000,0,46000,227000,0,273000
140820107400000,NE 139,RESIDENTIAL,43100,0,43100,174400,0,217500
140820107500000,NE 139,RESIDENTIAL,44900,0,44900,170000,0,214900
140820107600000,NE 139,RESIDENTIAL,40200,0,40200,193900,0,234100
140820107700000,NE 139,RESIDENTIAL,40000,0,40000,149800,0,189800
140820107800000,NE 139,RESIDENTIAL,40400,0,40400,152800,0,193200
140820107900000,NE 139,RESIDENTIAL,41700,0,41700,199100,0,240800
140820108000000,NE 139,RESIDENTIAL,39100,0,39100,166400,0,205500
140820108100000,NE 139,RESIDENTIAL,42000,0,42000,174200,0,216200
140820108200000,NE 139,RESIDENTIAL,43100,0,43100,165400,0,208500
140820108300000,NE 139,RESIDENTIAL,46000,0,46000,191300,0,237300
140820108400000,NE 139,RESIDENTIAL,46500,0,46500,195400,0,241900
140820108500000,NE 139,RESIDENTIAL,44000,0,44000,162800,0,206800
140820108600000,NE 139,RESIDENTIAL,43800,0,43800,162500,0,206300
140820108700000,NE 139,RESIDENTIAL,44100,0,44100,177300,0,221400
140820108800000,NE 139,RESIDENTIAL,43400,0,43400,140500,0,183900
140820108900000,NE 139,RESIDENTIAL,43400,0,43400,225000,0,268400
140820109000000,NE 139,RESIDENTIAL,43400,0,43400,176200,0,219600
140820109100000,NE 139,RESIDENTIAL,48400,0,48400,160600,0,209000
140820109200000,NE 135,RESIDENTIAL,100,0,100,0,0,100
140820109300000,NE 139,RESIDENTIAL,47100,0,47100,140800,0,187900
140820109400000,NE 139,RESIDENTIAL,46500,0,46500,164800,0,211300
140820109500000,NE 139,RESIDENTIAL,46300,0,46300,148600,0,194900
140820109600000,NE 139,RESIDENTIAL,46100,0,46100,208600,0,254700
140820109700000,NE 139,RESIDENTIAL,46000,0,46000,142200,0,188200
140820109800000,NE 139,RESIDENTIAL,47000,0,47000,147400,0,194400
140820109900000,NE 139,RESIDENTIAL,45800,0,45800,240800,0,286600
140820110000000,NE 139,RESIDENTIAL,47200,0,47200,175300,0,222500
140820110100000,NE 139,RESIDENTIAL,47200,0,47200,139000,0,186200
140820110200000,NE 139,RESIDENTIAL,47300,0,47300,127900,0,175200
140820110400000,CHURCH,EXEMPT,0,480400,480400,0,3325700,3806100
140820200100000,NE 135,RESIDENTIAL,44000,0,44000,271800,0,315800
140820200200000,NE 135,RESIDENTIAL,41900,0,41900,261600,0,303500
140820200300000,NE 135,RESIDENTIAL,44600,0,44600,256300,0,300900
140820200400000,NE 135,RESIDENTIAL,43600,0,43600,203200,0,246800
140820200500000,NE 135,RESIDENTIAL,40500,0,40500,218600,0,259100
140820300100000,NE 136,RESIDENTIAL,35000,0,35000,146200,0,181200
140820300200000,NE 136,RESIDENTIAL,33600,0,33600,170500,0,204100
140822602400000,OFFICE,COMMERCIAL,0,190000,190000,0,280600,470600
140822801000000,NE 140,RESIDENTIAL,11100,0,11100,0,0,11100
140825100100000,NE 138,RESIDENTIAL,10900,0,10900,0,0,10900
140825100200000,NE 138,RESIDENTIAL,61900,0,61900,133800,0,195700
140825100300000,NE 138,RESIDENTIAL,50500,0,50500,167300,0,217800
140825100400000,NE 138,RESIDENTIAL,48800,0,48800,130500,0,179300
140825100500000,NE 138,RESIDENTIAL,55300,0,55300,185000,0,240300
140825100600000,NE 138,RESIDENTIAL,43700,0,43700,218100,0,261800
140825100700000,NE 138,RESIDENTIAL,31000,0,31000,144400,0,175400
140825100800000,NE 138,RESIDENTIAL,44600,0,44600,295100,0,339700
140825100900000,NE 138,RESIDENTIAL,48200,0,48200,190300,0,238500
140825101000000,NE 138,RESIDENTIAL,49400,0,49400,136000,0,185400
140825101100000,NE 138,RESIDENTIAL,45100,0,45100,223900,0,269000
140825101200000,NE 138,RESIDENTIAL,46600,0,46600,169100,0,215700
140825101300000,NE 138,RESIDENTIAL,46600,0,46600,249200,0,295800
140825101400000,NE 138,RESIDENTIAL,49000,0,49000,187000,0,236000
140825101500000,NE 138,RESIDENTIAL,51600,0,51600,226100,0,277700
140825101600000,NE 138,RESIDENTIAL,48700,0,48700,181600,0,230300
140825101700000,NE 138,RESIDENTIAL,67200,0,67200,295800,0,363000
140825101900000,NE 138,RESIDENTIAL,76600,0,76600,267200,0,343800
140825102000000,NE 138,RESIDENTIAL,76600,0,76600,297900,0,374500
140825102100000,NE 138,RESIDENTIAL,53300,0,53300,285700,0,339000
140825102200000,NE 138,RESIDENTIAL,52600,0,52600,193200,0,245800
140825102300000,NE 138,RESIDENTIAL,75400,0,75400,263700,0,339100
140825102400000,NE 138,RESIDENTIAL,54600,0,54600,174200,0,228800
140825102500000,NE 138,RESIDENTIAL,49900,0,49900,200900,0,250800
140825102600000,NE 138,RESIDENTIAL,46600,0,46600,190100,0,236700
140825102700000,NE 138,RESIDENTIAL,46600,0,46600,198000,0,244600
140825102800000,NE 138,RESIDENTIAL,51900,0,51900,205400,0,257300
140825102900000,NE 138,RESIDENTIAL,44800,0,44800,152400,0,197200
140825103000000,NE 138,RESIDENTIAL,52600,0,52600,129000,0,181600
140825103100000,NE 138,RESIDENTIAL,56500,0,56500,239700,0,296200
140825103200000,NE 138,RESIDENTIAL,50400,0,50400,255800,0,306200
140825103300000,NE 138,RESIDENTIAL,56700,0,56700,201100,0,257800
140825103400000,NE 138,RESIDENTIAL,48600,0,48600,259900,0,308500
140825103500000,NE 138,RESIDENTIAL,48200,0,48200,282600,0,330800
140825103600000,NE 138,RESIDENTIAL,51300,0,51300,234000,0,285300
140825103700000,NE 138,RESIDENTIAL,57000,0,57000,183800,0,240800
140825103800000,NE 138,RESIDENTIAL,56900,0,56900,220700,0,277600
140825103900000,NE 138,RESIDENTIAL,61800,0,61800,299500,0,361300
140825104000000,NE 138,RESIDENTIAL,0,0,0,0,0,0
140825104100000,NE 138,RESIDENTIAL,0,0,0,0,0,0
140825104200000,NE 138,RESIDENTIAL,0,0,0,0,0,0
140825104300000,NE 136,RESIDENTIAL,64100,0,64100,271700,0,335800
140825200100000,NE 138,RESIDENTIAL,47900,0,47900,194000,0,241900
140825200300000,NE 138,RESIDENTIAL,47500,0,47500,144200,0,191700
140825200400000,NE 138,RESIDENTIAL,47500,0,47500,167100,0,214600
140825200500000,NE 138,RESIDENTIAL,47500,0,47500,147600,0,195100
140825300700000,NE 138,RESIDENTIAL,100,0,100,0,0,100
140825400100000,NE 138,RESIDENTIAL,51500,0,51500,314200,0,365700
140825400200000,NE 138,RESIDENTIAL,51300,0,51300,283400,0,334700
140825400300000,NE 138,RESIDENTIAL,50900,0,50900,289700,0,340600
140825400400000,NE 138,RESIDENTIAL,52200,0,52200,294300,0,346500
140825400500000,NE 138,RESIDENTIAL,57000,0,57000,280700,0,337700
140825400600000,NE 138,RESIDENTIAL,55800,0,55800,300200,0,356000
140825400700000,NE 138,RESIDENTIAL,47500,0,47500,241400,0,288900
140827600100000,NE 136,RESIDENTIAL,34600,0,34600,147200,0,181800
140827600200000,NE 136,RESIDENTIAL,33900,0,33900,155800,0,189700
140827600300000,NE 136,RESIDENTIAL,34500,0,34500,143400,0,177900
140827600400000,NE 136,RESIDENTIAL,35200,0,35200,153800,0,189000
140827600500000,NE 136,RESIDENTIAL,35200,0,35200,162400,0,197600
140827600600000,NE 136,RESIDENTIAL,34100,0,34100,149600,0,183700
140827600700000,NE 136,RESIDENTIAL,34700,0,34700,152100,0,186800
140827600800000,NE 136,RESIDENTIAL,35000,0,35000,145500,0,180500
140827600900000,NE 136,RESIDENTIAL,33900,0,33900,174500,0,208400
140827601000000,NE 136,RESIDENTIAL,33800,0,33800,157200,0,191000
140827601100000,NE 136,RESIDENTIAL,35400,0,35400,154600,0,190000
140827601200000,NE 136,RESIDENTIAL,34500,0,34500,136000,0,170500
140827601300000,NE 136,RESIDENTIAL,33700,0,33700,165000,0,198700
140827601400000,NE 136,RESIDENTIAL,36800,0,36800,146500,0,183300
140827601500000,NE 136,RESIDENTIAL,31100,0,31100,129100,0,160200
140827601600000,NE 136,RESIDENTIAL,31700,0,31700,151800,0,183500
140827601700000,NE 136,RESIDENTIAL,32600,0,32600,176400,0,209000
140827601800000,NE 136,RESIDENTIAL,32300,0,32300,171700,0,204000
140827601900000,NE 136,RESIDENTIAL,32900,0,32900,154600,0,187500
140827602000000,NE 136,RESIDENTIAL,32100,0,32100,138400,0,170500
140827602100000,NE 136,RESIDENTIAL,33300,0,33300,159900,0,193200
140827602200000,NE 136,RESIDENTIAL,33200,0,33200,138600,0,171800
140827602300000,NE 136,RESIDENTIAL,33400,0,33400,186300,0,219700
140827602400000,NE 136,RESIDENTIAL,34900,0,34900,182200,0,217100
140827602500000,NE 136,RESIDENTIAL,35200,0,35200,191800,0,227000
140827602600000,NE 136,RESIDENTIAL,33800,0,33800,163600,0,197400
140827602700000,NE 136,RESIDENTIAL,35000,0,35000,165500,0,200500
140827602800000,NE 136,RESIDENTIAL,31400,0,31400,144200,0,175600
140827602900000,NE 136,RESIDENTIAL,31700,0,31700,168600,0,200300
140827603000000,NE 136,RESIDENTIAL,34600,0,34600,160300,0,194900
140827603100000,NE 136,RESIDENTIAL,34600,0,34600,148500,0,183100
140827603200000,NE 136,RESIDENTIAL,32800,0,32800,144000,0,176800
140827603300000,NE 136,RESIDENTIAL,31700,0,31700,175100,0,206800
140827700100000,NE 136,RESIDENTIAL,34200,0,34200,155200,0,189400
140827700200000,NE 136,RESIDENTIAL,34200,0,34200,179000,0,213200
140827700300000,NE 136,RESIDENTIAL,33800,0,33800,149100,0,182900
140827700400000,NE 136,RESIDENTIAL,33800,0,33800,121200,0,155000
140827700500000,NE 136,RESIDENTIAL,34100,0,34100,131700,0,165800
140827700600000,NE 136,RESIDENTIAL,36200,0,36200,151400,0,187600
140827700700000,NE 136,RESIDENTIAL,33800,0,33800,162400,0,196200
140827800100000,NE 136,RESIDENTIAL,36200,0,36200,158500,0,194700
140827800200000,NE 136,RESIDENTIAL,36200,0,36200,146800,0,183000
140827800300000,NE 136,RESIDENTIAL,36600,0,36600,180500,0,217100
140827800400000,NE 136,RESIDENTIAL,37300,0,37300,159600,0,196900
140827800500000,NE 136,RESIDENTIAL,36100,0,36100,127900,0,164000
140827800600000,NE 136,RESIDENTIAL,37800,0,37800,137700,0,175500
140827800700000,NE 136,RESIDENTIAL,35200,0,35200,139700,0,174900
140827800800000,NE 136,RESIDENTIAL,35600,0,35600,138200,0,173800
140827800900000,NE 136,RESIDENTIAL,35600,0,35600,208500,0,244100
140827801000000,NE 136,RESIDENTIAL,37500,0,37500,178100,0,215600
140827801100000,NE 136,RESIDENTIAL,37600,0,37600,184900,0,222500
140827801200000,NE 136,RESIDENTIAL,40000,0,40000,182400,0,222400
140827801300000,NE 136,RESIDENTIAL,46400,0,46400,213700,0,260100
140827801400000,NE 136,RESIDENTIAL,37600,0,37600,149300,0,186900
140827801500000,NE 136,RESIDENTIAL,38700,0,38700,173100,0,211800
140827801600000,NE 136,RESIDENTIAL,38900,0,38900,168900,0,207800
140827801700000,NE 136,RESIDENTIAL,36400,0,36400,163500,0,199900
140827801800000,NE 136,RESIDENTIAL,36700,0,36700,154300,0,191000
140827801900000,NE 136,RESIDENTIAL,32900,0,32900,150800,0,183700
140827802000000,NE 136,RESIDENTIAL,35500,0,35500,139800,0,175300
140827802100000,NE 136,RESIDENTIAL,36600,0,36600,153600,0,190200
140827802200000,NE 136,RESIDENTIAL,36900,0,36900,149300,0,186200
140827802300000,NE 136,RESIDENTIAL,37800,0,37800,223400,0,261200
140827802400000,NE 136,RESIDENTIAL,33900,0,33900,156200,0,190100
140827802500000,NE 136,RESIDENTIAL,35300,0,35300,146800,0,182100
140827802600000,NE 136,RESIDENTIAL,37900,0,37900,173800,0,211700
140827802700000,NE 136,RESIDENTIAL,45100,0,45100,159400,0,204500
140827802800000,NE 136,RESIDENTIAL,45600,0,45600,176700,0,222300
140827802900000,NE 136,RESIDENTIAL,46100,0,46100,189300,0,235400
140827803000000,NE 136,RESIDENTIAL,45700,0,45700,152100,0,197800
140827900100000,NE 136,RESIDENTIAL,46200,0,46200,324800,0,371000
140828000100000,NE 136,RESIDENTIAL,42600,0,42600,200300,0,242900
140828000200000,NE 136,RESIDENTIAL,42000,0,42000,225900,0,267900
140828000300000,NE 136,RESIDENTIAL,43500,0,43500,242100,0,285600
140828000400000,NE 136,RESIDENTIAL,33500,0,33500,167700,0,201200
140828000500000,NE 136,RESIDENTIAL,33100,0,33100,170900,0,204000
140828000600000,NE 136,RESIDENTIAL,36900,0,36900,170300,0,207200
140828000700000,NE 136,RESIDENTIAL,35400,0,35400,149500,0,184900
140828000800000,NE 136,RESIDENTIAL,38700,0,38700,195200,0,233900
140828000900000,NE 136,RESIDENTIAL,38800,0,38800,192200,0,231000
140828001000000,NE 136,RESIDENTIAL,36100,0,36100,201800,0,237900
140828001100000,NE 136,RESIDENTIAL,36800,0,36800,160900,0,197700
140828001200000,NE 136,RESIDENTIAL,35900,0,35900,153500,0,189400
140828001300000,NE 136,RESIDENTIAL,37700,0,37700,178000,0,215700
140828001400000,NE 136,RESIDENTIAL,38000,0,38000,176000,0,214000
140830100100000,NE 137,RESIDENTIAL,61800,0,61800,197900,0,259700
140830100200000,NE 136,RESIDENTIAL,47500,0,47500,185200,0,232700
140830100300000,NE 137,RESIDENTIAL,55000,0,55000,192200,0,247200
140830100400000,NE 137,RESIDENTIAL,32500,0,32500,179000,0,211500
140830100700000,NE 137,RESIDENTIAL,64000,0,64000,285000,0,349000
140830100900000,NE 167,RESIDENTIAL,76500,0,76500,341400,0,417900
140830101000000,NE 167,RESIDENTIAL,69000,0,69000,303900,0,372900
140830101100000,NE 167,RESIDENTIAL,68300,0,68300,396100,0,464400
140830101200000,NE 167,RESIDENTIAL,71200,0,71200,365800,0,437000
140830101300000,NE 167,RESIDENTIAL,73400,0,73400,382200,0,455600
140830101400000,NE 167,RESIDENTIAL,72100,0,72100,371700,0,443800
140830101500000,NE 167,RESIDENTIAL,86400,0,86400,304700,0,391100
140830101600000,NE 167,RESIDENTIAL,73400,0,73400,366600,0,440000
140830101700000,NE 167,RESIDENTIAL,88100,0,88100,384600,0,472700
140830101800000,NE 167,RESIDENTIAL,95900,0,95900,332400,0,428300
140830101900000,NE 167,RESIDENTIAL,5000,0,5000,0,0,5000
140830102000000,NE 167,RESIDENTIAL,5000,0,5000,0,0,5000
140830102100000,NE 167,RESIDENTIAL,93900,0,93900,162800,0,256700
140830102200000,NE 167,RESIDENTIAL,3600,0,3600,0,0,3600
140830102300000,NE 167,RESIDENTIAL,89200,0,89200,286600,0,375800
140830102600000,NE 167,RESIDENTIAL,6100,0,6100,0,0,6100
140830102700000,NE 167,RESIDENTIAL,5000,0,5000,0,0,5000
140830102800000,NE 167,RESIDENTIAL,4800,0,4800,0,0,4800
140830102900000,NE 167,RESIDENTIAL,101000,0,101000,331900,0,432900
140830103000000,NE 167,RESIDENTIAL,98000,0,98000,351500,0,449500
140830103100000,NE 167,RESIDENTIAL,98000,0,98000,346000,0,444000
140830103200000,NE 149,RESIDENTIAL,3900,0,3900,0,0,3900
140830103300000,NE 149,RESIDENTIAL,25200,0,25200,0,0,25200
140830103600000,NE 167,RESIDENTIAL,79200,0,79200,0,0,79200
140830103700000,NE 167,RESIDENTIAL,113200,0,113200,320000,0,433200
140830200100000,NE 137,RESIDENTIAL,49500,0,49500,177900,0,227400
140830200200000,NE 137,RESIDENTIAL,55700,0,55700,160200,0,215900
140830200300000,NE 137,RESIDENTIAL,58400,0,58400,267300,0,325700
140830200400000,NE 137,RESIDENTIAL,70300,0,70300,278700,0,349000
140830200500000,NE 137,RESIDENTIAL,57300,0,57300,236200,0,293500
140830200600000,NE 137,RESIDENTIAL,60400,0,60400,183600,0,244000
140830200700000,NE 137,RESIDENTIAL,62000,0,62000,203500,0,265500
140830200800000,NE 137,RESIDENTIAL,60300,0,60300,262400,0,322700
140830200900000,NE 137,RESIDENTIAL,49900,0,49900,166600,0,216500
140830201000000,NE 137,RESIDENTIAL,55100,0,55100,185600,0,240700
140830201100000,NE 137,RESIDENTIAL,54400,0,54400,168900,0,223300
140830201200000,NE 137,RESIDENTIAL,54900,0,54900,181200,0,236100
140830300100000,NE 137,RESIDENTIAL,61100,0,61100,230600,0,291700
140830300200000,NE 137,RESIDENTIAL,60900,0,60900,241800,0,302700
140830300300000,NE 137,RESIDENTIAL,63800,0,63800,209100,0,272900
140830300400000,NE 137,RESIDENTIAL,65200,0,65200,237400,0,302600
140830300500000,NE 137,RESIDENTIAL,64000,0,64000,212600,0,276600
140830300600000,NE 137,RESIDENTIAL,60800,0,60800,211200,0,272000
140830300700000,NE 167,RESIDENTIAL,104600,0,104600,520400,0,625000
140830300800000,NE 167,RESIDENTIAL,92800,0,92800,331200,0,424000
140830300900000,NE 167,RESIDENTIAL,75600,0,75600,355400,0,431000
140830301000000,NE 167,RESIDENTIAL,98300,0,98300,345300,0,443600
140830301100000,NE 167,RESIDENTIAL,89400,0,89400,376600,0,466000
140830301200000,NE 167,RESIDENTIAL,88700,0,88700,377400,0,466100
140830301300000,NE 167,RESIDENTIAL,83400,0,83400,355300,0,438700
140830301400000,NE 167,RESIDENTIAL,86400,0,86400,366700,0,453100
140832600100000,NE 137,RESIDENTIAL,69000,0,69000,351700,0,420700
140832600200000,NE 137,RESIDENTIAL,68800,0,68800,311400,0,380200
140832600300000,NE 137,RESIDENTIAL,78200,0,78200,250400,0,328600
140832600400000,NE 138,RESIDENTIAL,65900,0,65900,225000,0,290900
140832600500000,NE 138,RESIDENTIAL,64100,0,64100,248400,0,312500
140832600600000,NE 138,RESIDENTIAL,60600,0,60600,187200,0,247800
140832600700000,NE 138,RESIDENTIAL,64300,0,64300,347300,0,411600
140832600800000,NE 138,RESIDENTIAL,61700,0,61700,326100,0,387800
140832600900000,NE 138,RESIDENTIAL,67700,0,67700,255200,0,322900
140832601000000,NE 138,RESIDENTIAL,62300,0,62300,238000,0,300300
140832601100000,NE 138,RESIDENTIAL,54700,0,54700,341400,0,396100
140832601200000,NE 138,RESIDENTIAL,58000,0,58000,267000,0,325000
140832601300000,NE 138,RESIDENTIAL,51000,0,51000,168200,0,219200
140832601400000,NE 138,RESIDENTIAL,56400,0,56400,241500,0,297900
140832601500000,NE 138,RESIDENTIAL,55500,0,55500,298300,0,353800
140832601600000,NE 138,RESIDENTIAL,80500,0,80500,236500,0,317000
140832601800000,NE 137,RESIDENTIAL,77200,0,77200,227800,0,305000
140832601900000,NE 137,RESIDENTIAL,30400,0,30400,0,0,30400
140832602000000,NE 137,RESIDENTIAL,78300,0,78300,192500,0,270800
140832602100000,NE 137,RESIDENTIAL,77200,0,77200,211800,0,289000
140832602300000,NE 167,RESIDENTIAL,91100,0,91100,449600,0,540700
140832602400000,NE 167,RESIDENTIAL,78800,0,78800,478300,0,557100
140832602500000,NE 167,RESIDENTIAL,99500,0,99500,333000,0,432500
140832602600000,NE 167,RESIDENTIAL,86900,0,86900,336500,0,423400
140832602700000,CITY PROPERTY,EXEMPT,0,0,0,0,0,0
140832602800000,NE 167,RESIDENTIAL,74800,0,74800,358700,0,433500
140832700100000,NE 138,RESIDENTIAL,62200,0,62200,341700,0,403900
140835100100000,NE 167,RESIDENTIAL,71500,0,71500,0,0,71500
140835100200000,NE 167,RESIDENTIAL,81100,0,81100,411800,0,492900
140835100300000,NE 167,RESIDENTIAL,88000,0,88000,447000,0,535000
140835100400000,NE 167,RESIDENTIAL,73400,0,73400,435600,0,509000
140835200200000,NE 167,RESIDENTIAL,154100,0,154100,971300,0,1125400
140835200300000,NE 167,RESIDENTIAL,71200,0,71200,558600,0,629800
140835200400000,NE 167,RESIDENTIAL,93000,0,93000,379000,0,472000
140835200500000,NE 167,RESIDENTIAL,88900,0,88900,425500,0,514400
140835200600000,NE 167,RESIDENTIAL,102200,0,102200,383600,0,485800
140835200700000,NE 167,RESIDENTIAL,90300,0,90300,334000,0,424300
140835200800000,NE 167,RESIDENTIAL,53400,0,53400,0,0,53400
140835200900000,NE 167,RESIDENTIAL,59100,0,59100,366900,0,426000
140835201000000,NE 167,RESIDENTIAL,88600,0,88600,284500,0,373100
140835201100000,NE 167,RESIDENTIAL,87700,0,87700,262900,0,350600
140835201200000,CENTRALLY ASSESSED,OTHER,0,0,0,0,0,0
140835201300000,NE 167,RESIDENTIAL,77600,0,77600,414500,0,492100
140835201400000,NE 167,RESIDENTIAL,83000,0,83000,461200,0,544200
140835201500000,NE 167,RESIDENTIAL,129400,0,129400,401800,0,531200
140835201600000,NE 167,RESIDENTIAL,131000,0,131000,446500,0,577500
140835201700000,NE 167,RESIDENTIAL,206400,0,206400,546200,0,752600
140835201800000,NE 167,RESIDENTIAL,122900,0,122900,500700,0,623600
140835201900000,NE 167,RESIDENTIAL,98400,0,98400,500700,0,599100
140835202000000,NE 167,RESIDENTIAL,95558,0,95558,434442,0,530000
140837600100000,CITY PROPERTY,EXEMPT,0,0,0,0,0,0
140837600500000,NE 167,RESIDENTIAL,113200,0,113200,344600,0,457800
140837600600000,NE 167,RESIDENTIAL,81400,0,81400,320200,0,401600
140837600700000,NE 167,RESIDENTIAL,80500,0,80500,343500,0,424000
140837601000000,NE 167,RESIDENTIAL,74600,0,74600,370300,0,444900
140837601100000,NE 167,RESIDENTIAL,75700,0,75700,319700,0,395400
140837601200000,NE 167,RESIDENTIAL,22900,0,22900,0,0,22900
140837601300000,NE 167,RESIDENTIAL,134100,0,134100,270700,0,404800
140837601400000,NE 167,RESIDENTIAL,133300,0,133300,424000,0,557300
140837601500000,NE 167,RESIDENTIAL,121700,0,121700,552300,0,674000
140837601600000,NE 167,RESIDENTIAL,8100,0,8100,0,0,8100
140837601700000,NE 167,RESIDENTIAL,9000,0,9000,0,0,9000
140837601800000,NE 167,RESIDENTIAL,127900,0,127900,307700,0,435600
140837700100000,NE 167,RESIDENTIAL,60800,0,60800,347000,0,407800
140837700200000,NE 167,RESIDENTIAL,73200,0,73200,334500,0,407700
140837700300000,NE 167,RESIDENTIAL,74800,0,74800,396900,0,471700
140837700600000,NE 167,RESIDENTIAL,54000,0,54000,404300,0,458300
140837700900000,NE 167,RESIDENTIAL,57400,0,57400,326300,0,383700
140837701000000,NE 167,RESIDENTIAL,68600,0,68600,344200,0,412800
140837701300000,NE 167,RESIDENTIAL,58600,0,58600,356400,0,415000
140837701600000,NE 167,RESIDENTIAL,37200,0,37200,0,0,37200
140840100100000,NE 135,RESIDENTIAL,25400,0,25400,167000,0,192400
140840100200000,NE 135,RESIDENTIAL,27600,0,27600,133900,0,161500
140840100300000,NE 135,RESIDENTIAL,27600,0,27600,126000,0,153600
140840100400000,NE 135,RESIDENTIAL,27600,0,27600,141700,0,169300
140840100500000,NE 135,RESIDENTIAL,29400,0,29400,135500,0,164900
140840100600000,NE 135,RESIDENTIAL,29400,0,29400,120500,0,149900
140840100700000,NE 135,RESIDENTIAL,31500,0,31500,104600,0,136100
140840100800000,NE 135,RESIDENTIAL,29200,0,29200,117800,0,147000
140840100900000,NE 135,RESIDENTIAL,28300,0,28300,161700,0,190000
140840101000000,NE 135,RESIDENTIAL,27600,0,27600,126800,0,154400
140840101100000,NE 135,RESIDENTIAL,29400,0,29400,118100,0,147500
140840101200000,NE 135,RESIDENTIAL,27600,0,27600,114300,0,141900
140840101300000,NE 135,RESIDENTIAL,27600,0,27600,101400,0,129000
140840101400000,NE 135,RESIDENTIAL,27600,0,27600,112100,0,139700
140840101500000,NE 135,RESIDENTIAL,28700,0,28700,127600,0,156300
140840200100000,NE 135,RESIDENTIAL,32800,0,32800,121300,0,154100
140840200200000,NE 135,RESIDENTIAL,32800,0,32800,112000,0,144800
140840200300000,NE 135,RESIDENTIAL,62000,0,62000,0,0,62000
140840200400000,NE 135,RESIDENTIAL,37600,0,37600,174000,0,211600
140840200500000,NE 135,RESIDENTIAL,36100,0,36100,165800,0,201900
140840200600000,NE 135,RESIDENTIAL,35100,0,35100,139800,0,174900
140840200700000,NE 135,RESIDENTIAL,36700,0,36700,117600,0,154300
140840200800000,NE 135,RESIDENTIAL,37100,0,37100,160100,0,197200
140840200900000,NE 135,RESIDENTIAL,33400,0,33400,147400,0,180800
140840201000000,NE 135,RESIDENTIAL,34800,0,34800,141400,0,176200
140840201100000,NE 135,RESIDENTIAL,34300,0,34300,152100,0,186400
140840201200000,NE 135,RESIDENTIAL,34000,0,34000,128800,0,162800
140840201300000,NE 135,RESIDENTIAL,33500,0,33500,144100,0,177600
140840201500000,NE 135,RESIDENTIAL,30900,0,30900,161200,0,192100
140840201600000,NE 135,RESIDENTIAL,32700,0,32700,147200,0,179900
140840201700000,NE 135,RESIDENTIAL,29800,0,29800,155400,0,185200
140840201800000,NE 135,RESIDENTIAL,32400,0,32400,167100,0,199500
140840201900000,NE 135,RESIDENTIAL,100,0,100,0,0,100
140840202000000,NE 135,RESIDENTIAL,32300,0,32300,119100,0,151400
140840300100000,NE 135,RESIDENTIAL,28400,0,28400,116500,0,144900
140840300200000,NE 135,RESIDENTIAL,28200,0,28200,119400,0,147600
140840300300000,NE 135,RESIDENTIAL,30900,0,30900,143500,0,174400
140840300400000,NE 135,RESIDENTIAL,31100,0,31100,145300,0,176400
140840300500000,NE 135,RESIDENTIAL,33700,0,33700,169700,0,203400
140840300600000,NE 135,RESIDENTIAL,34000,0,34000,126300,0,160300
140840300700000,NE 135,RESIDENTIAL,33800,0,33800,154300,0,188100
140840300800000,NE 135,RESIDENTIAL,31400,0,31400,137200,0,168600
140840300900000,NE 135,RESIDENTIAL,32100,0,32100,129000,0,161100
140840301000000,NE 135,RESIDENTIAL,31700,0,31700,149100,0,180800
140840301100000,NE 135,RESIDENTIAL,29200,0,29200,114500,0,143700
140840301200000,NE 135,RESIDENTIAL,36400,0,36400,136600,0,173000
140840301300000,NE 135,RESIDENTIAL,36700,0,36700,145500,0,182200
140840301400000,NE 135,RESIDENTIAL,36700,0,36700,157700,0,194400
140840301500000,NE 135,RESIDENTIAL,36400,0,36400,139800,0,176200
140840301600000,NE 135,RESIDENTIAL,36400,0,36400,156700,0,193100
140840301700000,NE 135,RESIDENTIAL,36400,0,36400,154900,0,191300
140840301800000,NE 135,RESIDENTIAL,34700,0,34700,149400,0,184100
140840301900000,NE 135,RESIDENTIAL,33900,0,33900,146300,0,180200
140840302000000,NE 135,RESIDENTIAL,35600,0,35600,155800,0,191400
140840302200000,NE 135,RESIDENTIAL,32600,0,32600,165600,0,198200
140840302300000,NE 135,RESIDENTIAL,30500,0,30500,126200,0,156700
140840302400000,NE 135,RESIDENTIAL,28900,0,28900,120400,0,149300
140840302500000,NE 135,RESIDENTIAL,23100,0,23100,131400,0,154500
140840302600000,NE 135,RESIDENTIAL,28400,0,28400,118200,0,146600
140840302800000,NE 135,RESIDENTIAL,34900,0,34900,151600,0,186500
140840400100000,NE 135,RESIDENTIAL,35100,0,35100,114000,0,149100
140840400200000,NE 135,RESIDENTIAL,31300,0,31300,130100,0,161400
140840400300000,NE 135,RESIDENTIAL,35700,0,35700,141200,0,176900
140840400400000,NE 135,RESIDENTIAL,37200,0,37200,201900,0,239100
140840400500000,NE 135,RESIDENTIAL,36100,0,36100,147300,0,183400
140840400600000,NE 135,RESIDENTIAL,35700,0,35700,139400,0,175100
140840400700000,NE 135,RESIDENTIAL,37600,0,37600,142300,0,179900
140840400800000,NE 135,RESIDENTIAL,39200,0,39200,174000,0,213200
140840400900000,NE 135,RESIDENTIAL,35200,0,35200,138000,0,173200
140840401000000,NE 135,RESIDENTIAL,37500,0,37500,170000,0,207500
140840401100000,NE 135,RESIDENTIAL,37100,0,37100,142600,0,179700
140840401200000,NE 135,RESIDENTIAL,35800,0,35800,116600,0,152400
140840401300000,NE 135,RESIDENTIAL,42000,0,42000,264200,0,306200
140842600100000,NE 135,RESIDENTIAL,93300,0,93300,0,0,93300
140842600200000,NE 135,RESIDENTIAL,177000,0,177000,0,0,177000
140842600300000,NE 135,RESIDENTIAL,39400,0,39400,169200,0,208600
140842600400000,NE 135,RESIDENTIAL,35600,0,35600,169600,0,205200
140842600500000,NE 135,RESIDENTIAL,38000,0,38000,143600,0,181600
140842600600000,NE 135,RESIDENTIAL,40100,0,40100,163500,0,203600
140842600700000,NE 135,RESIDENTIAL,38000,0,38000,141600,0,179600
140842600800000,NE 135,RESIDENTIAL,39800,0,39800,213200,0,253000
140842600900000,NE 135,RESIDENTIAL,36600,0,36600,184900,0,221500
140845100100000,NE 135,RESIDENTIAL,29900,0,29900,154700,0,184600
140845100200000,NE 135,RESIDENTIAL,33200,0,33200,134000,0,167200
140845100300000,NE 135,RESIDENTIAL,31700,0,31700,149500,0,181200
140845200100000,NE 135,RESIDENTIAL,41300,0,41300,147700,0,189000
140845200200000,NE 135,RESIDENTIAL,39100,0,39100,193500,0,232600
140845200300000,NE 135,RESIDENTIAL,33300,0,33300,152900,0,186200
140845200400000,NE 135,RESIDENTIAL,35600,0,35600,167600,0,203200
140845200500000,NE 135,RESIDENTIAL,34500,0,34500,159500,0,194000
140845200600000,NE 135,RESIDENTIAL,36600,0,36600,128600,0,165200
140845200700000,NE 135,RESIDENTIAL,38200,0,38200,175900,0,214100
140845200800000,NE 135,RESIDENTIAL,35400,0,35400,191900,0,227300
140845200900000,NE 135,RESIDENTIAL,35100,0,35100,151800,0,186900
140845201000000,NE 135,RESIDENTIAL,37100,0,37100,145600,0,182700
140845201100000,NE 135,RESIDENTIAL,39800,0,39800,170400,0,210200
140845201200000,NE 135,RESIDENTIAL,37400,0,37400,180000,0,217400
140845201300000,NE 135,RESIDENTIAL,37300,0,37300,175800,0,213100
140845201400000,NE 135,RESIDENTIAL,36000,0,36000,162800,0,198800
140845201500000,NE 135,RESIDENTIAL,47700,0,47700,205100,0,252800
140845201600000,NE 149,RESIDENTIAL,39400,0,39400,151100,0,190500
140845201700000,NE 149,RESIDENTIAL,33400,0,33400,169400,0,202800
140845201800000,NE 149,RESIDENTIAL,33400,0,33400,162100,0,195500
140845201900000,NE 135,RESIDENTIAL,40100,0,40100,191900,0,232000
140845202000000,NE 135,RESIDENTIAL,37100,0,37100,164700,0,201800
140845202100000,NE 135,RESIDENTIAL,37400,0,37400,212400,0,249800
140845202200000,NE 135,RESIDENTIAL,37600,0,37600,156900,0,194500
140845202300000,NE 135,RESIDENTIAL,45400,0,45400,174400,0,219800
140845202400000,NE 135,RESIDENTIAL,37700,0,37700,149900,0,187600
140845202500000,NE 135,RESIDENTIAL,35800,0,35800,128800,0,164600
140845202600000,NE 135,RESIDENTIAL,35500,0,35500,124200,0,159700
140845202700000,NE 135,RESIDENTIAL,36900,0,36900,130300,0,167200
140845202800000,NE 135,RESIDENTIAL,37900,0,37900,185800,0,223700
140845202900000,NE 135,RESIDENTIAL,34900,0,34900,183500,0,218400
140845300100000,NE 135,RESIDENTIAL,38300,0,38300,148200,0,186500
140845300200000,NE 135,RESIDENTIAL,88600,0,88600,0,0,88600
140845300300000,NE 135,RESIDENTIAL,47300,0,47300,161200,0,208500
140845300400000,NE 135,RESIDENTIAL,46600,0,46600,188900,0,235500
140845300500000,NE 135,RESIDENTIAL,47000,0,47000,153600,0,200600
140845300600000,NE 149,RESIDENTIAL,54400,0,54400,189200,0,243600
140845300700000,NE 149,RESIDENTIAL,31500,0,31500,181100,0,212600
140845300800000,NE 135,RESIDENTIAL,34300,0,34300,155000,0,189300
140845300900000,NE 135,RESIDENTIAL,39600,0,39600,164200,0,203800
140845301000000,NE 135,RESIDENTIAL,39500,0,39500,157700,0,197200
140845301100000,NE 135,RESIDENTIAL,39400,0,39400,224900,0,264300
140845301200000,NE 135,RESIDENTIAL,32600,0,32600,151800,0,184400
140845301300000,NE 135,RESIDENTIAL,40800,0,40800,194100,0,234900
140845301400000,NE 135,RESIDENTIAL,45500,0,45500,192100,0,237600
140845301500000,NE 135,RESIDENTIAL,40300,0,40300,178700,0,219000
140845301600000,NE 135,RESIDENTIAL,37500,0,37500,139600,0,177100
140845301700000,NE 135,RESIDENTIAL,36800,0,36800,146000,0,182800
140845301800000,NE 135,RESIDENTIAL,35400,0,35400,161600,0,197000
140845301900000,NE 135,RESIDENTIAL,36000,0,36000,165000,0,201000
140845302000000,NE 135,RESIDENTIAL,36400,0,36400,179200,0,215600
140845302100000,NE 135,RESIDENTIAL,37100,0,37100,138000,0,175100
140845302200000,NE 135,RESIDENTIAL,37700,0,37700,173400,0,211100
140845302300000,NE 135,RESIDENTIAL,38400,0,38400,152800,0,191200
140847600200000,NE 135,RESIDENTIAL,33300,0,33300,148900,0,182200
140847600400000,NE 135,RESIDENTIAL,34300,0,34300,151500,0,185800
140847600500000,NE 135,RESIDENTIAL,36000,0,36000,142400,0,178400
140847600600000,NE 135,RESIDENTIAL,38000,0,38000,121700,0,159700
140847600700000,NE 135,RESIDENTIAL,45800,0,45800,159400,0,205200
140847600800000,NE 135,RESIDENTIAL,32200,0,32200,0,0,32200
140847600900000,NE 135,RESIDENTIAL,36100,0,36100,141500,0,177600
140847601000000,NE 135,RESIDENTIAL,36900,0,36900,121600,0,158500
140847601100000,NE 135,RESIDENTIAL,36200,0,36200,111000,0,147200
140847601200000,NE 135,RESIDENTIAL,35700,0,35700,155500,0,191200
140847601300000,NE 135,RESIDENTIAL,36000,0,36000,144000,0,180000
140847601400000,NE 135,RESIDENTIAL,36400,0,36400,162500,0,198900
140847601500000,NE 135,RESIDENTIAL,36200,0,36200,151300,0,187500
140847601600000,NE 135,RESIDENTIAL,37500,0,37500,199300,0,236800
140847601700000,NE 135,RESIDENTIAL,38000,0,38000,156800,0,194800
140847601800000,NE 135,RESIDENTIAL,36100,0,36100,154600,0,190700
140847601900000,NE 135,RESIDENTIAL,35800,0,35800,151200,0,187000
140847602000000,NE 135,RESIDENTIAL,35800,0,35800,141800,0,177600
140847602100000,NE 135,RESIDENTIAL,35900,0,35900,135500,0,171400
140847602200000,NE 135,RESIDENTIAL,36700,0,36700,147100,0,183800
140847602300000,NE 135,RESIDENTIAL,36400,0,36400,149900,0,186300
140847602400000,NE 135,RESIDENTIAL,37400,0,37400,153700,0,191100
140847602500000,NE 135,RESIDENTIAL,36600,0,36600,171300,0,207900
140847602600000,NE 135,RESIDENTIAL,36100,0,36100,185300,0,221400
140847602700000,NE 135,RESIDENTIAL,36300,0,36300,171200,0,207500
140847602800000,NE 135,RESIDENTIAL,33300,0,33300,139200,0,172500
140847602900000,NE 135,RESIDENTIAL,33300,0,33300,145500,0,178800
140847603000000,NE 135,RESIDENTIAL,30700,0,30700,157200,0,187900
140847603100000,NE 135,RESIDENTIAL,3500,0,3500,0,0,3500
140847603300000,NE 135,RESIDENTIAL,94800,0,94800,144800,0,239600
140847603400000,NE 135,RESIDENTIAL,100,0,100,0,0,100
140847603500000,NE 135,RESIDENTIAL,33700,0,33700,168400,0,202100
140847700100000,NE 135,RESIDENTIAL,33900,0,33900,163700,0,197600
140847700200000,NE 135,RESIDENTIAL,31000,0,31000,142700,0,173700
140847700300000,NE 135,RESIDENTIAL,33000,0,33000,149200,0,182200
140847700400000,NE 135,RESIDENTIAL,36100,0,36100,161400,0,197500
140847700500000,NE 135,RESIDENTIAL,46100,0,46100,139600,0,185700
140847700600000,NE 135,RESIDENTIAL,45200,0,45200,223400,0,268600
140847700700000,NE 135,RESIDENTIAL,39600,0,39600,134100,0,173700
140847700800000,NE 135,RESIDENTIAL,37400,0,37400,135900,0,173300
140847700900000,NE 135,RESIDENTIAL,35600,0,35600,147800,0,183400
140847701000000,NE 135,RESIDENTIAL,33400,0,33400,146600,0,180000
140847701100000,NE 135,RESIDENTIAL,31100,0,31100,173400,0,204500
140847701200000,NE 135,RESIDENTIAL,41000,0,41000,149300,0,190300
140847701300000,NE 135,RESIDENTIAL,43200,0,43200,151700,0,194900
140847701400000,NE 135,RESIDENTIAL,40700,0,40700,147400,0,188100
140847701500000,NE 135,RESIDENTIAL,33700,0,33700,141000,0,174700
140847701600000,NE 135,RESIDENTIAL,30600,0,30600,162000,0,192600
140910100100000,NE 132,RESIDENTIAL,18800,0,18800,77700,0,96500
140910100200000,NE 132,RESIDENTIAL,15200,0,15200,84900,0,100100
140910100300000,NE 132,RESIDENTIAL,14600,0,14600,70400,0,85000
140910100400000,OFFICE; MEDICAL,COMMERCIAL,0,75000,75000,0,199400,274400
140910100500000,OFFICE,COMMERCIAL,0,149600,149600,0,374100,523700
140910100600000,APARTMENT,EXEMPT,0,91200,91200,0,837000,928200
140910100800000,APARTMENT,MULTI-RES,103200,0,103200,1298900,0,1402100
140910101100000,SCHOOL,EXEMPT,0,0,0,0,0,0
140910101200000,NE 132,RESIDENTIAL,19700,0,19700,92100,0,111800
140910101300000,NE 132,RESIDENTIAL,20700,0,20700,105900,0,126600
140910101400000,NE 132,RESIDENTIAL,20700,0,20700,96900,0,117600
140910101500000,NE 132,RESIDENTIAL,20700,0,20700,92700,0,113400
140910101600000,NE 132,RESIDENTIAL,20700,0,20700,103600,0,124300
140910101700000,NE 132,RESIDENTIAL,20700,0,20700,92300,0,113000
140910101800000,NE 132,RESIDENTIAL,20700,0,20700,101300,0,122000
140910101900000,NE 132,RESIDENTIAL,20700,0,20700,121900,0,142600
140910102000000,NE 132,RESIDENTIAL,20700,0,20700,92900,0,113600
140910102100000,NE 132,RESIDENTIAL,20700,0,20700,128800,0,149500
140910102200000,NE 132,RESIDENTIAL,20700,0,20700,126400,0,147100
140910102300000,NE 132,RESIDENTIAL,20700,0,20700,114300,0,135000
140910102400000,NE 132,RESIDENTIAL,20700,0,20700,127200,0,147900
140910102500000,APARTMENT,MULTI-RES,154200,0,154200,1415900,0,1570100
140910102600000,APARTMENT,MULTI-RES,92800,0,92800,723000,0,815800
140910200100000,APARTMENT,MULTI-RES,719800,0,719800,14050900,0,14770700
140910200200000,NE 132,RESIDENTIAL,24000,0,24000,105800,0,129800
140910200300000,NE 132,RESIDENTIAL,24000,0,24000,116100,0,140100
140910200400000,NE 132,RESIDENTIAL,24000,0,24000,110900,0,134900
140910200500000,NE 132,RESIDENTIAL,24000,0,24000,92700,0,116700
140910200600000,NE 132,RESIDENTIAL,24000,0,24000,94700,0,118700
140910200700000,NE 132,RESIDENTIAL,24000,0,24000,78400,0,102400
140910200800000,NE 132,RESIDENTIAL,24000,0,24000,83100,0,107100
140910200900000,NE 132,RESIDENTIAL,24000,0,24000,96200,0,120200
140910201000000,NE 132,RESIDENTIAL,24000,0,24000,89600,0,113600
140910201100000,NE 132,RESIDENTIAL,24000,0,24000,94800,0,118800
140910201200000,NE 132,RESIDENTIAL,26800,0,26800,111100,0,137900
140910300100000,NE 132,RESIDENTIAL,24700,0,24700,96100,0,120800
140910300200000,NE 132,RESIDENTIAL,24000,0,24000,89400,0,113400
140910300300000,NE 132,RESIDENTIAL,24000,0,24000,82100,0,106100
140910300400000,NE 132,RESIDENTIAL,24000,0,24000,81100,0,105100
140910300500000,NE 132,RESIDENTIAL,24000,0,24000,100900,0,124900
140910300600000,NE 132,RESIDENTIAL,24000,0,24000,97300,0,121300
140910300700000,NE 132,RESIDENTIAL,24000,0,24000,134700,0,158700
140910300800000,NE 132,RESIDENTIAL,24000,0,24000,84200,0,108200
140910300900000,NE 132,RESIDENTIAL,24000,0,24000,117300,0,141300
140910301000000,NE 132,RESIDENTIAL,24000,0,24000,102900,0,126900
140910301100000,NE 132,RESIDENTIAL,24000,0,24000,82900,0,106900
140910301200000,NE 132,RESIDENTIAL,24000,0,24000,96500,0,120500
140910301300000,NE 132,RESIDENTIAL,23200,0,23200,98500,0,121700
140910301400000,NE 132,RESIDENTIAL,24000,0,24000,91900,0,115900
140910301500000,NE 132,RESIDENTIAL,24000,0,24000,89000,0,113000
140910301600000,NE 132,RESIDENTIAL,24000,0,24000,85800,0,109800
140910301700000,NE 132,RESIDENTIAL,24000,0,24000,103600,0,127600
140910301800000,NE 132,RESIDENTIAL,24000,0,24000,122700,0,146700
140910301900000,NE 132,RESIDENTIAL,24000,0,24000,84600,0,108600
140910302000000,NE 132,RESIDENTIAL,24000,0,24000,105600,0,129600
140910302100000,NE 132,RESIDENTIAL,24000,0,24000,83400,0,107400
140910302200000,NE 132,RESIDENTIAL,23300,0,23300,85000,0,108300
140912600100000,BRANCH BANK/CU,COMMERCIAL,0,214000,214000,0,378000,592000
140912600200000,LG DISCOUNT/RETAIL,COMMERCIAL,0,694500,694500,0,1466600,2161100
140912600300000,RESTAURANT,COMMERCIAL,0,292500,292500,0,265300,557800
140912600400000,NBHD SHOPPING CENTER,COMMERCIAL,0,116400,116400,0,472500,588900
140912600500000,SMALL RETAIL,COMMERCIAL,0,305000,305000,0,458400,763400
140912600600000,NE 132,RESIDENTIAL,29300,0,29300,123300,0,152600
140912600700000,NE 132,RESIDENTIAL,25800,0,25800,97500,0,123300
140912600800000,NE 132,RESIDENTIAL,24000,0,24000,112100,0,136100
140912600900000,NE 132,RESIDENTIAL,24000,0,24000,71200,0,95200
140912601000000,NE 132,RESIDENTIAL,24000,0,24000,98800,0,122800
140912601100000,SMALL RETAIL,COMMERCIAL,0,28700,28700,0,123100,151800
140912601200000,OFFICE,COMMERCIAL,0,40000,40000,0,125300,165300
140912601300000,OFFICE,COMMERCIAL,0,29500,29500,0,150500,180000
140912601400000,VETERINARY CLINIC,COMMERCIAL,0,38300,38300,0,202100,240400
140912601500000,FITNESS CENTER,COMMERCIAL,0,246000,246000,0,362000,608000
140912700100000,CONVENIENCE STORE,COMMERCIAL,0,227000,227000,0,203400,430400
140912700200000,AUTO REPAIR/SALES,COMMERCIAL,0,159200,159200,0,87400,246600
140912700700000,CENTRALLY ASSESSED,OTHER,0,0,0,0,0,0
140912700800000,SMALL RETAIL,COMMERCIAL,0,98200,98200,0,111300,209500
140912700900000,BARS/LOUNGE,COMMERCIAL,0,70300,70300,0,104100,174400
140912701000000,RESTAURANT,COMMERCIAL,0,261500,261500,0,231100,492600
140912701100000,RESTAURANT,COMMERCIAL,0,175200,175200,0,214400,389600
140912701200000,LAUNDROMAT/CLEANERS,COMMERCIAL,0,83200,83200,0,221200,304400
140912701300000,FAST FOOD,COMMERCIAL,0,170100,170100,0,480800,650900
140912701400000,NBHD SHOPPING CENTER,COMMERCIAL,0,312700,312700,0,550000,862700
140912701500000,LAUNDROMAT/CLEANERS,COMMERCIAL,0,96400,96400,0,67700,164100
140912701600000,LG DISCOUNT/RETAIL,COMMERCIAL,0,325400,325400,0,261900,587300
140912701700000,FLAT PARKING,COMMERCIAL,0,28800,28800,0,5900,34700
140912701800000,FLAT PARKING,COMMERCIAL,0,21600,21600,0,3400,25000
140912701900000,SMALL RETAIL,COMMERCIAL,0,76500,76500,0,142800,219300
140912702000000,SMALL RETAIL,COMMERCIAL,0,77700,77700,0,148100,225800
140912800100000,NE 132,RESIDENTIAL,24000,0,24000,89900,0,113900
140912800200000,NE 132,RESIDENTIAL,24000,0,24000,101100,0,125100
140912800300000,NE 132,RESIDENTIAL,24000,0,24000,86400,0,110400
140912800400000,NE 132,RESIDENTIAL,24000,0,24000,79900,0,103900
140912800500000,NE 132,RESIDENTIAL,25900,0,25900,97600,0,123500
140912800600000,NE 132,RESIDENTIAL,24500,0,24500,77100,0,101600
140912800700000,NE 132,RESIDENTIAL,24000,0,24000,80600,0,104600
140912800800000,NE 132,RESIDENTIAL,23200,0,23200,83900,0,107100
140912800900000,NE 132,RESIDENTIAL,24000,0,24000,85200,0,109200
140912801000000,NE 132,RESIDENTIAL,23200,0,23200,94300,0,117500
140912900100000,NE 133,RESIDENTIAL,100,0,100,0,0,100
140915100100000,NE 132,RESIDENTIAL,24000,0,24000,99900,0,123900
140915100200000,NE 132,RESIDENTIAL,24000,0,24000,87500,0,111500
140915100300000,NE 132,RESIDENTIAL,23500,0,23500,117800,0,141300
140915100400000,NE 132,RESIDENTIAL,20700,0,20700,89500,0,110200
140915100500000,NE 132,RESIDENTIAL,20300,0,20300,96900,0,117200
140915100600000,NE 132,RESIDENTIAL,20300,0,20300,86700,0,107000
140915100700000,NE 132,RESIDENTIAL,20200,0,20200,88100,0,108300
140915100800000,NE 132,RESIDENTIAL,23600,0,23600,96100,0,119700
140915100900000,NE 132,RESIDENTIAL,23200,0,23200,83900,0,107100
140915101000000,NE 132,RESIDENTIAL,23200,0,23200,85500,0,108700
140915102000000,CENTRALLY ASSESSED,OTHER,0,0,0,0,0,0
140915200100000,OFFICE,COMMERCIAL,0,140400,140400,0,322200,462600
140915200200000,CONVERSIONS; NON-APT,RESIDENTIAL,36800,0,36800,80500,0,117300
140915200300000,OFFICE,COMMERCIAL,0,98800,98800,0,368000,466800
140915200500000,NE 132,RESIDENTIAL,24000,0,24000,48800,0,72800
140915200600000,NE 132,RESIDENTIAL,25100,0,25100,68200,0,93300
140915200700000,APARTMENT,MULTI-RES,31200,0,31200,197100,0,228300
140915200800000,OFFICE,COMMERCIAL,0,42000,42000,0,66600,108600
140915200900000,OFFICE; MEDICAL,COMMERCIAL,0,139200,139200,0,565700,704900
140915201000000,NE 132,RESIDENTIAL,26300,0,26300,77000,0,103300
140915201100000,BRANCH BANK/CU,COMMERCIAL,0,93500,93500,0,233300,326800
140915201200000,OFFICE,COMMERCIAL,0,91500,91500,0,246200,337700
140915201300000,OFFICE,COMMERCIAL,0,88500,88500,0,325600,414100
140915201400000,NE 132,RESIDENTIAL,14800,0,14800,41600,0,56400
140915300100000,NE 132,RESIDENTIAL,23800,0,23800,82700,0,106500
140915300200000,NE 132,RESIDENTIAL,23800,0,23800,110800,0,134600
140915300300000,NE 132,RESIDENTIAL,23200,0,23200,96600,0,119800
140915300400000,NE 132,RESIDENTIAL,26700,0,26700,82400,0,109100
140915300500000,NE 132,RESIDENTIAL,24500,0,24500,58300,0,82800
140915300600000,NE 132,RESIDENTIAL,24900,0,24900,116600,0,141500
140915300700000,NE 132,RESIDENTIAL,24400,0,24400,88600,0,113000
140915300800000,NE 132,RESIDENTIAL,24000,0,24000,77100,0,101100
140915300900000,NE 132,RESIDENTIAL,24000,0,24000,108900,0,132900
140915400100000,NE 132,RESIDENTIAL,24000,0,24000,101400,0,125400
140915400200000,NE 132,RESIDENTIAL,24000,0,24000,88500,0,112500
140915400300000,NE 132,RESIDENTIAL,24000,0,24000,86700,0,110700
140915400400000,NE 132,RESIDENTIAL,24000,0,24000,81100,0,105100
140915400500000,NE 132,RESIDENTIAL,23400,0,23400,75900,0,99300
140915400600000,NE 132,RESIDENTIAL,17500,0,17500,57400,0,74900
140915400700000,NE 132,RESIDENTIAL,17100,0,17100,67300,0,84400
140915400800000,NE 132,RESIDENTIAL,17100,0,17100,53400,0,70500
140915400900000,NE 132,RESIDENTIAL,17100,0,17100,105700,0,122800
140915401000000,NE 132,RESIDENTIAL,17100,0,17100,70500,0,87600
140915500100000,NE 132,RESIDENTIAL,18000,0,18000,96900,0,114900
140915500200000,NE 132,RESIDENTIAL,18000,0,18000,84300,0,102300
140915500300000,NE 132,RESIDENTIAL,18000,0,18000,62000,0,80000
140915500400000,NE 132,RESIDENTIAL,17500,0,17500,66400,0,83900
140915500500000,NE 132,RESIDENTIAL,12900,0,12900,64400,0,77300
140915500600000,OFFICE,EXEMPT,0,66500,66500,0,63700,130200
140915500700000,NE 132,RESIDENTIAL,19600,0,19600,69100,0,88700
140915600100000,WAREHOUSE,COMMERCIAL,0,240800,240800,0,323000,563800
140915600102000,ANTENNAS/TOWERS(BLL),COMMERCIAL,0,0,0,0,229600,229600
140915600200000,SMALL RETAIL,COMMERCIAL,0,65400,65400,0,196000,261400
140915700100000,NE 132,RESIDENTIAL,16900,0,16900,58500,0,75400
140915700200000,NE 132,RESIDENTIAL,17100,0,17100,51200,0,68300
140915700300000,OFFICE,COMMERCIAL,46160,69240,115400,105360,146840,367600
140917600100000,NE 132,RESIDENTIAL,23900,0,23900,100300,0,124200
140917600200000,NE 132,RESIDENTIAL,23800,0,23800,98600,0,122400
140917600300000,NE 132,RESIDENTIAL,24000,0,24000,91600,0,115600
140917600400000,NE 132,RESIDENTIAL,24000,0,24000,121700,0,145700
140917600500000,NE 132,RESIDENTIAL,24000,0,24000,132800,0,156800
140917600600000,NE 132,RESIDENTIAL,24000,0,24000,89700,0,113700
140917600700000,NE 132,RESIDENTIAL,24000,0,24000,90900,0,114900
140917600800000,NE 132,RESIDENTIAL,24000,0,24000,82400,0,106400
140917600900000,NE 132,RESIDENTIAL,24000,0,24000,69200,0,93200
140917601000000,NE 132,RESIDENTIAL,24000,0,24000,102700,0,126700
140917601100000,NE 132,RESIDENTIAL,24000,0,24000,85400,0,109400
140917601200000,NE 132,RESIDENTIAL,23200,0,23200,101000,0,124200
140917601300000,NE 132,RESIDENTIAL,23500,0,23500,104400,0,127900
140917601400000,NE 132,RESIDENTIAL,24000,0,24000,89700,0,113700
140917601500000,NE 132,RESIDENTIAL,24000,0,24000,90900,0,114900
140917601600000,NE 132,RESIDENTIAL,24000,0,24000,95600,0,119600
140917601700000,NE 132,RESIDENTIAL,24000,0,24000,94100,0,118100
140917601800000,NE 132,RESIDENTIAL,24000,0,24000,86600,0,110600
140917601900000,NE 132,RESIDENTIAL,24000,0,24000,97000,0,121000
140917602000000,NE 132,RESIDENTIAL,23800,0,23800,85400,0,109200
140917602100000,NE 132,RESIDENTIAL,23800,0,23800,117400,0,141200
140917602200000,NE 132,RESIDENTIAL,25600,0,25600,97100,0,122700
140917700100000,CHURCH,EXEMPT,0,361000,361000,0,142300,503300
140917700200000,NE 132,RESIDENTIAL,26900,0,26900,109400,0,136300
140917700300000,NE 132,RESIDENTIAL,25100,0,25100,116800,0,141900
140917700400000,NE 132,RESIDENTIAL,25600,0,25600,92000,0,117600
140917700500000,NE 132,RESIDENTIAL,25600,0,25600,127700,0,153300
140917700600000,NE 132,RESIDENTIAL,43400,0,43400,89800,0,133200
140917700700000,NE 132,RESIDENTIAL,14300,0,14300,66600,0,80900
140917700800000,NE 132,RESIDENTIAL,15400,0,15400,61400,0,76800
140917700900000,NE 132,RESIDENTIAL,15400,0,15400,46700,0,62100
140917701000000,NE 132,RESIDENTIAL,15400,0,15400,53400,0,68800
140917701100000,NE 132,RESIDENTIAL,15400,0,15400,62600,0,78000
140917701200000,NE 132,RESIDENTIAL,15400,0,15400,72600,0,88000
140917701300000,NE 132,RESIDENTIAL,15200,0,15200,58400,0,73600
140917800100000,NE 132,RESIDENTIAL,27600,0,27600,80900,0,108500
140917800200000,NE 132,RESIDENTIAL,26500,0,26500,102900,0,129400
140917800300000,NE 132,RESIDENTIAL,25600,0,25600,105100,0,130700
140917800400000,NE 132,RESIDENTIAL,24600,0,24600,109700,0,134300
140917800500000,NE 132,RESIDENTIAL,24600,0,24600,94000,0,118600
140917800600000,NE 132,RESIDENTIAL,24300,0,24300,94400,0,118700
140917800700000,NE 132,RESIDENTIAL,23800,0,23800,115300,0,139100
140917800800000,NE 132,RESIDENTIAL,23800,0,23800,107600,0,131400
140917800900000,NE 132,RESIDENTIAL,23800,0,23800,85700,0,109500
140917801000000,NE 132,RESIDENTIAL,23800,0,23800,101500,0,125300
140917801100000,NE 132,RESIDENTIAL,23800,0,23800,97000,0,120800
140917801200000,NE 132,RESIDENTIAL,23800,0,23800,83000,0,106800
140917801300000,NE 132,RESIDENTIAL,23800,0,23800,99300,0,123100
140917801400000,NE 132,RESIDENTIAL,23800,0,23800,104300,0,128100
140917801500000,NE 132,RESIDENTIAL,24000,0,24000,93400,0,117400
140917801600000,NE 132,RESIDENTIAL,24000,0,24000,112600,0,136600
140917801700000,NE 132,RESIDENTIAL,24000,0,24000,94900,0,118900
140917801800000,NE 132,RESIDENTIAL,24000,0,24000,107800,0,131800
140917801900000,NE 132,RESIDENTIAL,24000,0,24000,93400,0,117400
140917802000000,NE 132,RESIDENTIAL,24000,0,24000,82400,0,106400
140917802100000,NE 132,RESIDENTIAL,24000,0,24000,61100,0,85100
140917802200000,NE 132,RESIDENTIAL,24000,0,24000,86200,0,110200
140917802300000,NE 132,RESIDENTIAL,24000,0,24000,79300,0,103300
140917802400000,NE 132,RESIDENTIAL,24500,0,24500,69700,0,94200
140917802500000,NE 132,RESIDENTIAL,25000,0,25000,103600,0,128600
140917802600000,NE 132,RESIDENTIAL,25200,0,25200,79200,0,104400
140917802700000,NE 132,RESIDENTIAL,25400,0,25400,102400,0,127800
140917802800000,NE 132,RESIDENTIAL,25000,0,25000,83000,0,108000
140917802900000,NE 132,RESIDENTIAL,23800,0,23800,69000,0,92800
140917803000000,NE 132,RESIDENTIAL,23500,0,23500,97900,0,121400
140917803100000,NE 132,RESIDENTIAL,23800,0,23800,95300,0,119100
140917900100000,NE 132,RESIDENTIAL,24400,0,24400,94400,0,118800
140917900200000,NE 132,RESIDENTIAL,24000,0,24000,89000,0,113000
140917900300000,NE 132,RESIDENTIAL,24000,0,24000,78300,0,102300
140917900400000,NE 132,RESIDENTIAL,24000,0,24000,98000,0,122000
140917900500000,NE 132,RESIDENTIAL,24000,0,24000,92500,0,116500
140917900600000,NE 132,RESIDENTIAL,24000,0,24000,86300,0,110300
140917900700000,NE 132,RESIDENTIAL,24000,0,24000,88800,0,112800
140917900800000,NE 132,RESIDENTIAL,24000,0,24000,92300,0,116300
140917900900000,NE 132,RESIDENTIAL,24000,0,24000,83500,0,107500
140917901000000,NE 132,RESIDENTIAL,24000,0,24000,87500,0,111500
140917901100000,NE 132,RESIDENTIAL,24000,0,24000,91500,0,115500
140917901200000,NE 132,RESIDENTIAL,24000,0,24000,84700,0,108700
140917901300000,NE 132,RESIDENTIAL,24000,0,24000,100800,0,124800
140917901400000,NE 132,RESIDENTIAL,24000,0,24000,87800,0,111800
140917901500000,NE 132,RESIDENTIAL,24000,0,24000,97500,0,121500
140917901600000,NE 132,RESIDENTIAL,17200,0,17200,66600,0,83800
140917901700000,NE 132,RESIDENTIAL,17100,0,17100,63200,0,80300
140917901800000,NE 132,RESIDENTIAL,17100,0,17100,62500,0,79600
140917901900000,NE 132,RESIDENTIAL,17100,0,17100,61500,0,78600
140917902000000,NE 132,RESIDENTIAL,14300,0,14300,104200,0,118500
140917902100000,NE 132,RESIDENTIAL,15700,0,15700,91800,0,107500
140917902200000,NE 132,RESIDENTIAL,23100,0,23100,76700,0,99800
140917902300000,NE 132,RESIDENTIAL,17100,0,17100,92900,0,110000
140917902400000,NE 132,RESIDENTIAL,17100,0,17100,68000,0,85100
140917902500000,NE 132,RESIDENTIAL,17100,0,17100,64200,0,81300
140917902600000,NE 132,RESIDENTIAL,17100,0,17100,65900,0,83000
140917902700000,NE 132,RESIDENTIAL,17100,0,17100,50600,0,67700
140917902800000,NE 132,RESIDENTIAL,17100,0,17100,61600,0,78700
140917902900000,NE 132,RESIDENTIAL,16200,0,16200,67600,0,83800
140918000100000,NE 132,RESIDENTIAL,17400,0,17400,67300,0,84700
140918000200000,NE 132,RESIDENTIAL,16900,0,16900,63400,0,80300
140918000300000,NE 132,RESIDENTIAL,17300,0,17300,81000,0,98300
140918000400000,NE 132,RESIDENTIAL,18800,0,18800,64000,0,82800
140918100100000,NE 132,RESIDENTIAL,16900,0,16900,61600,0,78500
140918100200000,NE 132,RESIDENTIAL,16900,0,16900,71300,0,88200
140918100300000,NE 132,RESIDENTIAL,16900,0,16900,66400,0,83300
140918100400000,NE 132,RESIDENTIAL,16900,0,16900,72400,0,89300
140918100500000,NE 132,RESIDENTIAL,16900,0,16900,71700,0,88600
140918100600000,NE 132,RESIDENTIAL,16900,0,16900,62400,0,79300
140918100700000,NE 132,RESIDENTIAL,16900,0,16900,58800,0,75700
140918100800000,NE 132,RESIDENTIAL,16900,0,16900,71400,0,88300
140918100900000,NE 132,RESIDENTIAL,16900,0,16900,53600,0,70500
140918101000000,NE 132,RESIDENTIAL,16900,0,16900,66000,0,82900
140918101100000,NE 132,RESIDENTIAL,16900,0,16900,66000,0,82900
140918101200000,NE 132,RESIDENTIAL,16900,0,16900,64500,0,81400
140918101300000,NE 132,RESIDENTIAL,16900,0,16900,59100,0,76000
140918101400000,NE 132,RESIDENTIAL,16900,0,16900,66700,0,83600
140918101500000,NE 132,RESIDENTIAL,16900,0,16900,56000,0,72900
140918101600000,NE 132,RESIDENTIAL,16900,0,16900,66500,0,83400
140918101700000,NE 132,RESIDENTIAL,16900,0,16900,50900,0,67800
140918101800000,NE 132,RESIDENTIAL,17100,0,17100,63400,0,80500
140918101900000,NE 132,RESIDENTIAL,17100,0,17100,59200,0,76300
140918102000000,NE 132,RESIDENTIAL,17100,0,17100,101600,0,118700
140918102100000,NE 132,RESIDENTIAL,17100,0,17100,63300,0,80400
140918102200000,NE 132,RESIDENTIAL,16900,0,16900,45800,0,62700
140918102300000,NE 132,RESIDENTIAL,16900,0,16900,66900,0,83800
140918102400000,NE 132,RESIDENTIAL,16900,0,16900,66100,0,83000
140918102500000,NE 132,RESIDENTIAL,16900,0,16900,62900,0,79800
140918102600000,NE 132,RESIDENTIAL,16900,0,16900,65400,0,82300
140918102700000,NE 132,RESIDENTIAL,16900,0,16900,64300,0,81200
140918102800000,NE 132,RESIDENTIAL,16900,0,16900,73200,0,90100
140918102900000,NE 132,RESIDENTIAL,16900,0,16900,72900,0,89800
140918103000000,NE 132,RESIDENTIAL,16900,0,16900,56400,0,73300
140918103100000,NE 132,RESIDENTIAL,16900,0,16900,64700,0,81600
140918103200000,NE 132,RESIDENTIAL,16900,0,16900,52900,0,69800
140918103300000,NE 132,RESIDENTIAL,16900,0,16900,51100,0,68000
140918103400000,NE 132,RESIDENTIAL,16900,0,16900,69800,0,86700
140918103500000,NE 132,RESIDENTIAL,16900,0,16900,50000,0,66900
140918103600000,NE 132,RESIDENTIAL,16900,0,16900,62400,0,79300
140918103700000,NE 132,RESIDENTIAL,16900,0,16900,74700,0,91600
140918103800000,NE 132,RESIDENTIAL,16900,0,16900,94700,0,111600
140918200100000,NE 132,RESIDENTIAL,17400,0,17400,63000,0,80400
140918200200000,NE 132,RESIDENTIAL,16900,0,16900,66800,0,83700
140918200300000,NE 132,RESIDENTIAL,16900,0,16900,64000,0,80900
140918200400000,NE 132,RESIDENTIAL,16900,0,16900,59600,0,76500
140918200500000,NE 132,RESIDENTIAL,16900,0,16900,63700,0,80600
140918200600000,NE 132,RESIDENTIAL,16900,0,16900,64900,0,81800
140918200700000,NE 132,RESIDENTIAL,16900,0,16900,63700,0,80600
140918200800000,NE 132,RESIDENTIAL,16900,0,16900,63300,0,80200
140918200900000,NE 132,RESIDENTIAL,16900,0,16900,62800,0,79700
140918201000000,NE 132,RESIDENTIAL,16900,0,16900,59000,0,75900
140918201100000,NE 132,RESIDENTIAL,16900,0,16900,69800,0,86700
140918201200000,NE 132,RESIDENTIAL,16900,0,16900,61500,0,78400
140918201300000,NE 132,RESIDENTIAL,16900,0,16900,55400,0,72300
140918201400000,NE 132,RESIDENTIAL,16900,0,16900,75300,0,92200
140918201500000,NE 132,RESIDENTIAL,16900,0,16900,85700,0,102600
140918201600000,NE 132,RESIDENTIAL,16900,0,16900,69600,0,86500
140918201700000,NE 132,RESIDENTIAL,16900,0,16900,71900,0,88800
140918201800000,NE 132,RESIDENTIAL,16900,0,16900,65800,0,82700
140918201900000,NE 132,RESIDENTIAL,16900,0,16900,52200,0,69100
140918202000000,NE 132,RESIDENTIAL,16900,0,16900,47300,0,64200
140918202100000,NE 132,RESIDENTIAL,16900,0,16900,62800,0,79700
140918202200000,NE 132,RESIDENTIAL,16900,0,16900,58900,0,75800
140920100100000,NE 133,RESIDENTIAL,25600,0,25600,111900,0,137500
140920100200000,NE 133,RESIDENTIAL,24400,0,24400,102800,0,127200
140920100300000,NE 133,RESIDENTIAL,24400,0,24400,88900,0,113300
140920100400000,NE 133,RESIDENTIAL,25700,0,25700,106100,0,131800
140920100500000,NE 133,RESIDENTIAL,27300,0,27300,108500,0,135800
140920100600000,NE 133,RESIDENTIAL,27100,0,27100,103000,0,130100
140920100700000,NE 133,RESIDENTIAL,26600,0,26600,119700,0,146300
140920100800000,NE 133,RESIDENTIAL,27300,0,27300,89500,0,116800
140920100900000,NE 133,RESIDENTIAL,25400,0,25400,99000,0,124400
140920101000000,NE 133,RESIDENTIAL,24400,0,24400,111500,0,135900
140920101100000,NE 133,RESIDENTIAL,28200,0,28200,111000,0,139200
140920101200000,NE 133,RESIDENTIAL,29100,0,29100,118200,0,147300
140920101300000,NE 133,RESIDENTIAL,29100,0,29100,111000,0,140100
140920101400000,NE 133,RESIDENTIAL,29100,0,29100,105700,0,134800
140920101500000,NE 133,RESIDENTIAL,29500,0,29500,114800,0,144300
140920101600000,NE 133,RESIDENTIAL,29500,0,29500,113400,0,142900
140920101700000,NE 133,RESIDENTIAL,29100,0,29100,119300,0,148400
140920101800000,NE 133,RESIDENTIAL,27200,0,27200,118600,0,145800
140920101900000,NE 133,RESIDENTIAL,27200,0,27200,120800,0,148000
140920102000000,NE 133,RESIDENTIAL,27200,0,27200,107200,0,134400
140920102100000,NE 133,RESIDENTIAL,27200,0,27200,107800,0,135000
140920102200000,NE 133,RESIDENTIAL,28000,0,28000,108300,0,136300
140920102300000,NE 133,RESIDENTIAL,28400,0,28400,108400,0,136800
140920102400000,NE 133,RESIDENTIAL,30100,0,30100,119500,0,149600
140920102500000,NE 133,RESIDENTIAL,28000,0,28000,94900,0,122900
140920102600000,NE 133,RESIDENTIAL,27700,0,27700,108100,0,135800
140920102700000,NE 133,RESIDENTIAL,27700,0,27700,113300,0,141000
140920102800000,NE 133,RESIDENTIAL,27700,0,27700,118700,0,146400
140920102900000,NE 133,RESIDENTIAL,28800,0,28800,104200,0,133000
140920103000000,NE 133,RESIDENTIAL,28300,0,28300,95200,0,123500
140920103100000,NE 133,RESIDENTIAL,26800,0,26800,108600,0,135400
140920103200000,NE 133,RESIDENTIAL,27300,0,27300,96200,0,123500
140920103300000,NE 133,RESIDENTIAL,28100,0,28100,104600,0,132700
140920103400000,NE 133,RESIDENTIAL,28300,0,28300,94500,0,122800
140920103500000,NE 133,RESIDENTIAL,30400,0,30400,104500,0,134900
140920103600000,NE 133,RESIDENTIAL,25700,0,25700,104100,0,129800
140920103700000,NE 133,RESIDENTIAL,27900,0,27900,125200,0,153100
140920103800000,NE 133,RESIDENTIAL,27300,0,27300,94100,0,121400
140920103900000,NE 133,RESIDENTIAL,26800,0,26800,109000,0,135800
140920200100000,NE 133,RESIDENTIAL,31700,0,31700,111800,0,143500
140920200200000,NE 133,RESIDENTIAL,28000,0,28000,92800,0,120800
140920200300000,NE 133,RESIDENTIAL,28200,0,28200,100900,0,129100
140920200400000,NE 133,RESIDENTIAL,29400,0,29400,152800,0,182200
140920200500000,NE 133,RESIDENTIAL,28200,0,28200,126400,0,154600
140920200600000,NE 133,RESIDENTIAL,31100,0,31100,122400,0,153500
140920200700000,NE 133,RESIDENTIAL,28600,0,28600,97700,0,126300
140920200800000,NE 133,RESIDENTIAL,29500,0,29500,133200,0,162700
140920200900000,NE 133,RESIDENTIAL,30400,0,30400,124000,0,154400
140920201000000,NE 133,RESIDENTIAL,29000,0,29000,104200,0,133200
140920201100000,NE 133,RESIDENTIAL,28200,0,28200,104200,0,132400
140920201200000,NE 133,RESIDENTIAL,27900,0,27900,99100,0,127000
140920201300000,NE 133,RESIDENTIAL,27200,0,27200,118200,0,145400
140920201400000,NE 133,RESIDENTIAL,27200,0,27200,100700,0,127900
140920201500000,NE 133,RESIDENTIAL,27200,0,27200,102100,0,129300
140920201600000,NE 133,RESIDENTIAL,28100,0,28100,102600,0,130700
140920201700000,NE 133,RESIDENTIAL,28500,0,28500,127800,0,156300
140920201800000,NE 133,RESIDENTIAL,28100,0,28100,116500,0,144600
140920201900000,NE 133,RESIDENTIAL,29200,0,29200,102700,0,131900
140920202000000,NE 133,RESIDENTIAL,26900,0,26900,94400,0,121300
140920202100000,NE 133,RESIDENTIAL,26900,0,26900,106700,0,133600
140920202200000,NE 133,RESIDENTIAL,26900,0,26900,115500,0,142400
140920202300000,NE 133,RESIDENTIAL,27400,0,27400,110200,0,137600
140920202400000,NE 133,RESIDENTIAL,27400,0,27400,106400,0,133800
140920202500000,NE 133,RESIDENTIAL,27800,0,27800,113700,0,141500
140920202600000,NE 133,RESIDENTIAL,26300,0,26300,115400,0,141700
140920202700000,NE 133,RESIDENTIAL,26300,0,26300,85500,0,111800
140920300100000,NE 133,RESIDENTIAL,27400,0,27400,132500,0,159900
140920300200000,NE 133,RESIDENTIAL,28600,0,28600,93300,0,121900
140920300300000,NE 133,RESIDENTIAL,27200,0,27200,97500,0,124700
140920300400000,NE 133,RESIDENTIAL,27200,0,27200,112400,0,139600
140920300500000,NE 133,RESIDENTIAL,28800,0,28800,99600,0,128400
140920300600000,NE 133,RESIDENTIAL,30100,0,30100,92800,0,122900
140920300700000,NE 133,RESIDENTIAL,28800,0,28800,103600,0,132400
140920300800000,NE 133,RESIDENTIAL,29600,0,29600,119700,0,149300
140920300900000,NE 133,RESIDENTIAL,28900,0,28900,125000,0,153900
140920301000000,NE 133,RESIDENTIAL,29300,0,29300,118500,0,147800
140920301100000,NE 133,RESIDENTIAL,29400,0,29400,118400,0,147800
140920301200000,NE 133,RESIDENTIAL,29300,0,29300,84900,0,114200
140920301300000,NE 133,RESIDENTIAL,29000,0,29000,114500,0,143500
140920301400000,NE 133,RESIDENTIAL,28500,0,28500,107200,0,135700
140920301500000,NE 133,RESIDENTIAL,27700,0,27700,128000,0,155700
140920301600000,NE 133,RESIDENTIAL,29800,0,29800,125200,0,155000
140920301700000,NE 133,RESIDENTIAL,32100,0,32100,97100,0,129200
140920301800000,NE 133,RESIDENTIAL,29700,0,29700,104700,0,134400
140920400100000,NE 133,RESIDENTIAL,27700,0,27700,116100,0,143800
140920400200000,NE 133,RESIDENTIAL,26000,0,26000,124700,0,150700
140920400300000,NE 133,RESIDENTIAL,26000,0,26000,97600,0,123600
140920400400000,NE 133,RESIDENTIAL,26000,0,26000,105700,0,131700
140920400500000,NE 133,RESIDENTIAL,27400,0,27400,91000,0,118400
140920400600000,NE 133,EXEMPT,0,28400,28400,0,105500,133900
140920400700000,NE 133,RESIDENTIAL,28700,0,28700,124800,0,153500
140920400800000,NE 133,RESIDENTIAL,27600,0,27600,97200,0,124800
140920400900000,NE 133,RESIDENTIAL,27300,0,27300,94100,0,121400
140920401000000,NE 133,RESIDENTIAL,28300,0,28300,111400,0,139700
140920401100000,NE 133,RESIDENTIAL,28000,0,28000,106600,0,134600
140920401200000,NE 133,RESIDENTIAL,26400,0,26400,115800,0,142200
140920401300000,NE 133,RESIDENTIAL,26100,0,26100,69700,0,95800
140920401400000,NE 133,RESIDENTIAL,27400,0,27400,96400,0,123800
140920401500000,NE 133,RESIDENTIAL,28100,0,28100,108600,0,136700
140920401600000,NE 133,RESIDENTIAL,26400,0,26400,89400,0,115800
140920401700000,NE 133,RESIDENTIAL,29500,0,29500,112700,0,142200
140920401800000,NE 133,RESIDENTIAL,28300,0,28300,129600,0,157900
140920401900000,NE 133,RESIDENTIAL,27400,0,27400,80600,0,108000
140920402000000,NE 133,RESIDENTIAL,27300,0,27300,84600,0,111900
140920402100000,NE 133,RESIDENTIAL,26200,0,26200,106500,0,132700
140920402200000,NE 133,RESIDENTIAL,25700,0,25700,107000,0,132700
140920402300000,NE 133,RESIDENTIAL,25500,0,25500,113800,0,139300
140920402400000,NE 133,RESIDENTIAL,27700,0,27700,95900,0,123600
140920402500000,NE 133,RESIDENTIAL,27400,0,27400,92300,0,119700
140920402600000,NE 133,RESIDENTIAL,26900,0,26900,110000,0,136900
140920402700000,NE 133,RESIDENTIAL,27900,0,27900,94500,0,122400
140920402800000,NE 133,RESIDENTIAL,27400,0,27400,74200,0,101600
140920500100000,NE 133,RESIDENTIAL,27400,0,27400,99000,0,126400
140920500200000,NE 133,RESIDENTIAL,27600,0,27600,127600,0,155200
140920500300000,NE 133,RESIDENTIAL,26400,0,26400,112800,0,139200
140920500400000,NE 133,RESIDENTIAL,25200,0,25200,107300,0,132500
140920500500000,NE 133,RESIDENTIAL,26200,0,26200,87600,0,113800
140920500600000,NE 133,RESIDENTIAL,26400,0,26400,102700,0,129100
140920500700000,NE 133,RESIDENTIAL,25200,0,25200,92000,0,117200
140920500800000,NE 133,RESIDENTIAL,25200,0,25200,110100,0,135300
140920500900000,NE 133,RESIDENTIAL,26700,0,26700,141500,0,168200
140920501000000,NE 133,RESIDENTIAL,29100,0,29100,112000,0,141100
140920501100000,NE 133,RESIDENTIAL,29100,0,29100,94800,0,123900
140920501200000,NE 133,RESIDENTIAL,28000,0,28000,102600,0,130600
140920501300000,NE 133,RESIDENTIAL,28400,0,28400,115600,0,144000
140920501400000,NE 133,RESIDENTIAL,28500,0,28500,108200,0,136700
140920600100000,NE 133,RESIDENTIAL,28700,0,28700,112500,0,141200
140920600200000,NE 133,RESIDENTIAL,29600,0,29600,97300,0,126900
140920600300000,NE 133,RESIDENTIAL,27500,0,27500,94000,0,121500
140922600100000,NE 133,RESIDENTIAL,24000,0,24000,89000,0,113000
140922600200000,NE 133,RESIDENTIAL,25000,0,25000,103400,0,128400
140922600300000,NE 133,RESIDENTIAL,25000,0,25000,94600,0,119600
140922600400000,NE 133,RESIDENTIAL,25000,0,25000,101100,0,126100
140922600500000,NE 133,RESIDENTIAL,25000,0,25000,89300,0,114300
140922600600000,NE 133,RESIDENTIAL,30900,0,30900,112800,0,143700
140922600700000,NE 133,RESIDENTIAL,30100,0,30100,87200,0,117300
140922600800000,NE 133,RESIDENTIAL,31400,0,31400,123200,0,154600
140922600900000,NE 133,RESIDENTIAL,27200,0,27200,97300,0,124500
140922601000000,NE 133,RESIDENTIAL,26600,0,26600,96600,0,123200
140922601100000,NE 133,RESIDENTIAL,27700,0,27700,104300,0,132000
140922601200000,NE 133,RESIDENTIAL,27200,0,27200,117400,0,144600
140922601300000,NE 133,RESIDENTIAL,28400,0,28400,98800,0,127200
140922700100000,NE 133,RESIDENTIAL,30600,0,30600,96500,0,127100
140922700200000,NE 133,RESIDENTIAL,27000,0,27000,129000,0,156000
140922700300000,NE 133,RESIDENTIAL,25500,0,25500,121400,0,146900
140922700400000,NE 133,RESIDENTIAL,25000,0,25000,129200,0,154200
140922700500000,NE 133,RESIDENTIAL,25700,0,25700,146500,0,172200
140922700600000,NE 133,RESIDENTIAL,30900,0,30900,110900,0,141800
140922700700000,NE 133,RESIDENTIAL,32900,0,32900,125300,0,158200
140922700800000,NE 133,RESIDENTIAL,31200,0,31200,129900,0,161100
140922700900000,NE 133,RESIDENTIAL,32400,0,32400,140800,0,173200
140922701000000,NE 133,RESIDENTIAL,29700,0,29700,137600,0,167300
140922701100000,NE 133,RESIDENTIAL,30200,0,30200,114700,0,144900
140922701200000,NE 133,RESIDENTIAL,28900,0,28900,108400,0,137300
140922701300000,NE 133,RESIDENTIAL,25700,0,25700,105000,0,130700
140922701400000,NE 133,RESIDENTIAL,31800,0,31800,113800,0,145600
140922701500000,NE 133,RESIDENTIAL,28200,0,28200,118500,0,146700
140922800100000,NE 133,RESIDENTIAL,29100,0,29100,108200,0,137300
140922800200000,NE 133,RESIDENTIAL,26500,0,26500,122500,0,149000
140922800300000,NE 133,RESIDENTIAL,29800,0,29800,150300,0,180100
140922800400000,NE 133,RESIDENTIAL,31600,0,31600,141700,0,173300
140922800500000,NE 133,RESIDENTIAL,30700,0,30700,124900,0,155600
140922800600000,NE 133,RESIDENTIAL,30600,0,30600,110700,0,141300
140922800700000,NE 133,RESIDENTIAL,31200,0,31200,133400,0,164600
140922800800000,NE 133,RESIDENTIAL,29700,0,29700,115100,0,144800
140922800900000,NE 133,RESIDENTIAL,31400,0,31400,152100,0,183500
140922801000000,NE 133,RESIDENTIAL,32900,0,32900,124400,0,157300
140922801100000,NE 133,RESIDENTIAL,27700,0,27700,117700,0,145400
140922801200000,NE 133,RESIDENTIAL,25700,0,25700,95400,0,121100
140922801300000,NE 133,RESIDENTIAL,30300,0,30300,120400,0,150700
140922801400000,NE 133,RESIDENTIAL,27500,0,27500,103300,0,130800
140922801500000,NE 133,RESIDENTIAL,26600,0,26600,118000,0,144600
140922801600000,NE 133,RESIDENTIAL,29300,0,29300,124800,0,154100
140922801700000,NE 133,RESIDENTIAL,31200,0,31200,111300,0,142500
140922801800000,NE 133,RESIDENTIAL,31600,0,31600,117700,0,149300
140922801900000,NE 133,RESIDENTIAL,31100,0,31100,132500,0,163600
140922802000000,NE 133,RESIDENTIAL,30700,0,30700,142200,0,172900
140922802100000,NE 133,RESIDENTIAL,29700,0,29700,119900,0,149600
140922802200000,NE 133,RESIDENTIAL,29100,0,29100,116000,0,145100
140922802300000,NE 133,RESIDENTIAL,30600,0,30600,127200,0,157800
140922802400000,NE 133,RESIDENTIAL,33200,0,33200,144500,0,177700
140922802500000,NE 133,RESIDENTIAL,31700,0,31700,141200,0,172900
140922802600000,NE 133,RESIDENTIAL,29900,0,29900,116700,0,146600
140922802700000,NE 133,RESIDENTIAL,28300,0,28300,153700,0,182000
140922802800000,NE 133,RESIDENTIAL,32800,0,32800,128500,0,161300
140922802900000,NE 133,RESIDENTIAL,31000,0,31000,109000,0,140000
140922803000000,NE 133,RESIDENTIAL,27200,0,27200,122200,0,149400
140922803100000,NE 133,RESIDENTIAL,29500,0,29500,124300,0,153800
140922803200000,NE 133,RESIDENTIAL,29500,0,29500,144500,0,174000
140922900100000,NE 133,RESIDENTIAL,25200,0,25200,101200,0,126400
140922900200000,NE 133,RESIDENTIAL,25700,0,25700,82500,0,108200
140922900300000,NE 133,RESIDENTIAL,25700,0,25700,77500,0,103200
140922900400000,NE 133,RESIDENTIAL,25700,0,25700,95700,0,121400
140922900500000,NE 133,RESIDENTIAL,25700,0,25700,97800,0,123500
140922900600000,NE 133,RESIDENTIAL,26700,0,26700,102500,0,129200
140922900700000,NE 133,RESIDENTIAL,26700,0,26700,86400,0,113100
140922900800000,NE 133,RESIDENTIAL,26700,0,26700,101800,0,128500
140922900900000,NE 133,RESIDENTIAL,27300,0,27300,120100,0,147400
140923000100000,NE 133,RESIDENTIAL,26600,0,26600,73500,0,100100
140923000200000,NE 133,RESIDENTIAL,27200,0,27200,94900,0,122100
140923000300000,NE 133,RESIDENTIAL,27400,0,27400,97000,0,124400
140923000400000,NE 133,RESIDENTIAL,28100,0,28100,123500,0,151600
140923000500000,NE 133,RESIDENTIAL,28800,0,28800,152000,0,180800
140923000600000,NE 133,RESIDENTIAL,28800,0,28800,138500,0,167300
140923000700000,NE 133,RESIDENTIAL,28100,0,28100,88500,0,116600
140923000800000,NE 133,RESIDENTIAL,27500,0,27500,109300,0,136800
140923000900000,NE 133,RESIDENTIAL,27600,0,27600,109600,0,137200
140923001000000,NE 133,RESIDENTIAL,27500,0,27500,113300,0,140800
140923001100000,NE 133,RESIDENTIAL,29400,0,29400,135000,0,164400
140923001200000,NE 133,RESIDENTIAL,29100,0,29100,113200,0,142300
140923001300000,NE 133,RESIDENTIAL,26700,0,26700,113300,0,140000
140923001400000,NE 133,RESIDENTIAL,27900,0,27900,122100,0,150000
140923001500000,NE 133,RESIDENTIAL,28600,0,28600,87900,0,116500
140923001600000,NE 133,RESIDENTIAL,28600,0,28600,94100,0,122700
140923100100000,NE 133,RESIDENTIAL,29200,0,29200,89600,0,118800
140923100200000,NE 133,RESIDENTIAL,25700,0,25700,99900,0,125600
140923100300000,NE 133,RESIDENTIAL,25700,0,25700,100500,0,126200
140923100400000,NE 133,RESIDENTIAL,28600,0,28600,108500,0,137100
140923200100000,NE 133,RESIDENTIAL,30500,0,30500,94700,0,125200
140923200200000,NE 133,RESIDENTIAL,28000,0,28000,111300,0,139300
140923200300000,NE 133,RESIDENTIAL,27400,0,27400,110900,0,138300
140923200400000,NE 133,RESIDENTIAL,30800,0,30800,94200,0,125000
140923200500000,NE 133,RESIDENTIAL,28300,0,28300,104800,0,133100
140923200600000,NE 133,RESIDENTIAL,27800,0,27800,82400,0,110200
140923200700000,NE 133,RESIDENTIAL,28100,0,28100,92400,0,120500
140923200800000,NE 133,RESIDENTIAL,29600,0,29600,87800,0,117400
140923200900000,NE 133,RESIDENTIAL,27000,0,27000,139900,0,166900
140923201000000,NE 133,RESIDENTIAL,27000,0,27000,93400,0,120400
140923300100000,NE 133,RESIDENTIAL,28000,0,28000,107100,0,135100
140923300200000,NE 133,RESIDENTIAL,31900,0,31900,121300,0,153200
140923300300000,NE 133,RESIDENTIAL,31000,0,31000,157100,0,188100
140923300400000,NE 133,RESIDENTIAL,30700,0,30700,129000,0,159700
140923300500000,NE 133,RESIDENTIAL,30100,0,30100,113100,0,143200
140923300600000,NE 133,RESIDENTIAL,31500,0,31500,134900,0,166400
140923300700000,NE 133,RESIDENTIAL,30700,0,30700,109800,0,140500
140923300800000,NE 133,RESIDENTIAL,29700,0,29700,116200,0,145900
140923300900000,NE 133,RESIDENTIAL,29700,0,29700,128900,0,158600
140923301000000,NE 133,RESIDENTIAL,30400,0,30400,128100,0,158500
140923301100000,NE 133,RESIDENTIAL,28600,0,28600,118900,0,147500
140923301200000,NE 133,RESIDENTIAL,26800,0,26800,97400,0,124200
140923301300000,NE 133,RESIDENTIAL,30700,0,30700,101500,0,132200
140923301400000,NE 133,RESIDENTIAL,27200,0,27200,109900,0,137100
140923301500000,NE 133,RESIDENTIAL,27200,0,27200,112600,0,139800
140923301600000,NE 133,RESIDENTIAL,27200,0,27200,120300,0,147500
140923301700000,NE 133,RESIDENTIAL,28600,0,28600,127600,0,156200
140923301800000,NE 133,RESIDENTIAL,27700,0,27700,98700,0,126400
140923301900000,NE 133,RESIDENTIAL,25700,0,25700,103500,0,129200
140923302000000,NE 133,RESIDENTIAL,25700,0,25700,112400,0,138100
140923302100000,NE 133,RESIDENTIAL,25700,0,25700,115900,0,141600
140923400100000,NE 133,RESIDENTIAL,27200,0,27200,112300,0,139500
140923400200000,NE 133,RESIDENTIAL,28800,0,28800,124100,0,152900
140923400300000,NE 133,RESIDENTIAL,28000,0,28000,103300,0,131300
140923400400000,NE 133,RESIDENTIAL,24000,0,24000,105100,0,129100
140923400500000,NE 133,RESIDENTIAL,30400,0,30400,129300,0,159700
140925100100000,NE 133,RESIDENTIAL,30300,0,30300,107900,0,138200
140925200100000,NE 133,RESIDENTIAL,29600,0,29600,94500,0,124100
140925200200000,NE 133,RESIDENTIAL,30500,0,30500,114900,0,145400
140925200300000,NE 133,RESIDENTIAL,29300,0,29300,104300,0,133600
140925200400000,NE 133,RESIDENTIAL,30000,0,30000,103600,0,133600
140925200500000,NE 133,RESIDENTIAL,27800,0,27800,90800,0,118600
140925200600000,NE 133,RESIDENTIAL,30400,0,30400,116400,0,146800
140925200700000,NE 133,RESIDENTIAL,31900,0,31900,126800,0,158700
140925200800000,NE 133,RESIDENTIAL,33700,0,33700,105200,0,138900
140925200900000,NE 133,RESIDENTIAL,35200,0,35200,125400,0,160600
140925201000000,NE 133,RESIDENTIAL,32500,0,32500,99000,0,131500
140925201100000,NE 133,RESIDENTIAL,30700,0,30700,98100,0,128800
140925201200000,NE 133,RESIDENTIAL,30400,0,30400,137300,0,167700
140925201300000,NE 133,RESIDENTIAL,31000,0,31000,116800,0,147800
140925201400000,NE 133,RESIDENTIAL,30500,0,30500,106000,0,136500
140925201500000,NE 133,RESIDENTIAL,33000,0,33000,113400,0,146400
140925201600000,NE 133,RESIDENTIAL,36500,0,36500,121000,0,157500
140925201700000,NE 133,RESIDENTIAL,37200,0,37200,119200,0,156400
140925201800000,NE 133,RESIDENTIAL,39900,0,39900,162500,0,202400
140925201900000,NE 133,RESIDENTIAL,39400,0,39400,128800,0,168200
140925202000000,NE 133,RESIDENTIAL,40400,0,40400,134500,0,174900
140925202100000,NE 133,RESIDENTIAL,40500,0,40500,203400,0,243900
140925202200000,NE 133,RESIDENTIAL,31300,0,31300,180900,0,212200
140925202300000,NE 133,RESIDENTIAL,34600,0,34600,141900,0,176500
140925202400000,NE 133,RESIDENTIAL,32400,0,32400,127400,0,159800
140925202500000,NE 133,RESIDENTIAL,35600,0,35600,146500,0,182100
140925202600000,NE 133,RESIDENTIAL,35300,0,35300,132600,0,167900
140925202700000,NE 133,RESIDENTIAL,35900,0,35900,154500,0,190400
140925202800000,NE 133,RESIDENTIAL,32000,0,32000,134800,0,166800
140925202900000,NE 133,RESIDENTIAL,28500,0,28500,134200,0,162700
140925203000000,NE 133,RESIDENTIAL,28300,0,28300,133400,0,161700
140925203100000,NE 133,RESIDENTIAL,27000,0,27000,128200,0,155200
140925203200000,NE 133,RESIDENTIAL,30100,0,30100,121600,0,151700
140925203300000,NE 133,RESIDENTIAL,28600,0,28600,117000,0,145600
140925203400000,NE 133,RESIDENTIAL,30100,0,30100,115500,0,145600
140925300100000,NE 133,RESIDENTIAL,31000,0,31000,120800,0,151800
140925300200000,NE 133,RESIDENTIAL,28800,0,28800,105900,0,134700
140925300300000,NE 133,RESIDENTIAL,28600,0,28600,114500,0,143100
140925300400000,NE 133,RESIDENTIAL,32600,0,32600,153400,0,186000
140925300500000,NE 133,RESIDENTIAL,30000,0,30000,144600,0,174600
140925300600000,NE 133,RESIDENTIAL,30200,0,30200,115600,0,145800
140925300700000,NE 133,RESIDENTIAL,29700,0,29700,121600,0,151300
140925300800000,NE 133,RESIDENTIAL,30100,0,30100,118100,0,148200
140925300900000,NE 133,RESIDENTIAL,30100,0,30100,107600,0,137700
140925301000000,NE 133,RESIDENTIAL,41100,0,41100,278600,0,319700
140925301100000,NE 133,RESIDENTIAL,32600,0,32600,101300,0,133900
140925301200000,NE 133,RESIDENTIAL,30800,0,30800,111300,0,142100
140925301300000,NE 133,RESIDENTIAL,32500,0,32500,111600,0,144100
140925301400000,NE 133,RESIDENTIAL,31100,0,31100,123700,0,154800
140925301500000,NE 133,RESIDENTIAL,30100,0,30100,111900,0,142000
140925301600000,NE 133,RESIDENTIAL,30500,0,30500,114800,0,145300
140925400100000,NE 133,RESIDENTIAL,30600,0,30600,119300,0,149900
140925400200000,NE 133,RESIDENTIAL,39600,0,39600,171900,0,211500
140925400300000,NE 133,RESIDENTIAL,30600,0,30600,144600,0,175200
140925400400000,NE 133,RESIDENTIAL,30400,0,30400,100500,0,130900
140925400500000,NE 133,RESIDENTIAL,29500,0,29500,120600,0,150100
140925400600000,NE 133,RESIDENTIAL,31800,0,31800,132700,0,164500
140925400700000,NE 133,RESIDENTIAL,33700,0,33700,131400,0,165100
140925400800000,NE 133,RESIDENTIAL,33700,0,33700,126700,0,160400
140925400900000,NE 133,RESIDENTIAL,31800,0,31800,134900,0,166700
140925401000000,NE 133,RESIDENTIAL,33800,0,33800,126900,0,160700
140925401100000,NE 133,RESIDENTIAL,33000,0,33000,129700,0,162700
140925401200000,NE 133,RESIDENTIAL,36700,0,36700,136900,0,173600
140925401300000,NE 133,RESIDENTIAL,66200,0,66200,239700,0,305900
140925401400000,NE 133,RESIDENTIAL,33900,0,33900,110800,0,144700
140925401500000,NE 133,RESIDENTIAL,34100,0,34100,109800,0,143900
140925401600000,NE 133,RESIDENTIAL,27700,0,27700,128100,0,155800
140925401700000,NE 133,RESIDENTIAL,34400,0,34400,134300,0,168700
140925401800000,NE 133,RESIDENTIAL,35400,0,35400,133800,0,169200
140925401900000,NE 133,RESIDENTIAL,31100,0,31100,119000,0,150100
140925402000000,NE 133,RESIDENTIAL,35600,0,35600,118300,0,153900
140925402100000,NE 133,RESIDENTIAL,37600,0,37600,153300,0,190900
140925402200000,NE 133,RESIDENTIAL,38300,0,38300,92800,0,131100
140925402300000,NE 133,RESIDENTIAL,37200,0,37200,146900,0,184100
140925402400000,NE 133,RESIDENTIAL,37600,0,37600,134000,0,171600
140925402500000,NE 133,RESIDENTIAL,38800,0,38800,161000,0,199800
140925500100000,NE 133,RESIDENTIAL,29400,0,29400,126200,0,155600
140925500200000,NE 133,RESIDENTIAL,28800,0,28800,127700,0,156500
140925500300000,NE 133,RESIDENTIAL,31300,0,31300,125200,0,156500
140925500400000,NE 133,RESIDENTIAL,28900,0,28900,159600,0,188500
140925500500000,NE 133,RESIDENTIAL,31000,0,31000,121700,0,152700
140925500600000,NE 133,RESIDENTIAL,30600,0,30600,138000,0,168600
140925500700000,NE 133,RESIDENTIAL,31000,0,31000,148000,0,179000
140925500800000,NE 133,RESIDENTIAL,31000,0,31000,109600,0,140600
140925500900000,NE 133,RESIDENTIAL,31000,0,31000,140500,0,171500
140925501000000,NE 133,RESIDENTIAL,30900,0,30900,135400,0,166300
140925600100000,NE 133,RESIDENTIAL,36300,0,36300,124300,0,160600
140925600200000,NE 133,RESIDENTIAL,33700,0,33700,156300,0,190000
140925600300000,NE 133,RESIDENTIAL,33700,0,33700,112800,0,146500
140925600400000,NE 133,RESIDENTIAL,33500,0,33500,127100,0,160600
140925600500000,NE 133,RESIDENTIAL,28600,0,28600,114900,0,143500
140925600600000,NE 133,RESIDENTIAL,35400,0,35400,122300,0,157700
140925600700000,NE 133,RESIDENTIAL,35500,0,35500,173300,0,208800
140927600100000,NE 133,RESIDENTIAL,27800,0,27800,81300,0,109100
140927600200000,NE 133,RESIDENTIAL,29300,0,29300,90500,0,119800
140927600300000,NE 133,RESIDENTIAL,27200,0,27200,104100,0,131300
140927600400000,NE 133,RESIDENTIAL,27600,0,27600,103100,0,130700
140927600500000,NE 133,RESIDENTIAL,27600,0,27600,97500,0,125100
140927600600000,NE 133,RESIDENTIAL,27600,0,27600,101000,0,128600
140927600700000,NE 133,RESIDENTIAL,27600,0,27600,123600,0,151200
140927600800000,NE 133,RESIDENTIAL,27600,0,27600,96100,0,123700
140927600900000,NE 133,RESIDENTIAL,27600,0,27600,103500,0,131100
140927601000000,NE 133,RESIDENTIAL,300,0,300,0,0,300
140927700100000,NE 133,RESIDENTIAL,29300,0,29300,99900,0,129200
140927700200000,NE 133,RESIDENTIAL,27800,0,27800,102900,0,130700
140927700300000,NE 133,RESIDENTIAL,28800,0,28800,110500,0,139300
140927700400000,NE 133,RESIDENTIAL,27500,0,27500,103300,0,130800
140927700500000,NE 133,RESIDENTIAL,27000,0,27000,118900,0,145900
140927700600000,NE 133,RESIDENTIAL,26900,0,26900,101500,0,128400
140927700700000,NE 133,RESIDENTIAL,26900,0,26900,95700,0,122600
140927700800000,NE 133,RESIDENTIAL,26900,0,26900,99400,0,126300
140927700900000,NE 133,RESIDENTIAL,25700,0,25700,123500,0,149200
140927701000000,NE 133,RESIDENTIAL,25700,0,25700,101400,0,127100
140927701100000,NE 133,RESIDENTIAL,25700,0,25700,125900,0,151600
140927701200000,NE 133,RESIDENTIAL,25700,0,25700,108100,0,133800
140927701300000,NE 133,RESIDENTIAL,25700,0,25700,86700,0,112400
140927701400000,NE 133,RESIDENTIAL,25400,0,25400,110700,0,136100
140927800100000,NE 133,RESIDENTIAL,26000,0,26000,123000,0,149000
140927800200000,NE 133,RESIDENTIAL,25500,0,25500,93100,0,118600
140927900100000,NE 133,RESIDENTIAL,30800,0,30800,118500,0,149300
140927900200000,NE 133,RESIDENTIAL,26000,0,26000,143800,0,169800
140927900300000,NE 133,RESIDENTIAL,28100,0,28100,98500,0,126600
140927900400000,NE 133,RESIDENTIAL,28500,0,28500,87800,0,116300
140927900500000,NE 133,RESIDENTIAL,28600,0,28600,95100,0,123700
140927900600000,NE 133,RESIDENTIAL,25700,0,25700,91300,0,117000
140927900700000,NE 133,RESIDENTIAL,25700,0,25700,84600,0,110300
140927900800000,NE 133,RESIDENTIAL,25700,0,25700,84600,0,110300
140927900900000,NE 133,RESIDENTIAL,25700,0,25700,92400,0,118100
140927901000000,NE 133,RESIDENTIAL,25700,0,25700,103400,0,129100
140927901100000,NE 133,RESIDENTIAL,25700,0,25700,124300,0,150000
140927901200000,NE 133,RESIDENTIAL,25700,0,25700,103400,0,129100
140927901300000,NE 133,RESIDENTIAL,25700,0,25700,102800,0,128500
140927901400000,NE 133,RESIDENTIAL,26000,0,26000,100600,0,126600
140927901500000,NE 133,RESIDENTIAL,26600,0,26600,89600,0,116200
140927901600000,NE 133,RESIDENTIAL,27200,0,27200,96000,0,123200
140927901700000,NE 133,RESIDENTIAL,27200,0,27200,102100,0,129300
140927901800000,NE 133,RESIDENTIAL,27200,0,27200,90900,0,118100
140927901900000,NE 133,RESIDENTIAL,27200,0,27200,104100,0,131300
140927902000000,NE 133,RESIDENTIAL,27200,0,27200,93900,0,121100
140927902100000,NE 133,RESIDENTIAL,27200,0,27200,101000,0,128200
140927902200000,NE 133,RESIDENTIAL,27300,0,27300,106400,0,133700
140927902300000,NE 133,RESIDENTIAL,29400,0,29400,108600,0,138000
140927902400000,NE 133,RESIDENTIAL,28700,0,28700,125500,0,154200
140927902500000,NE 133,RESIDENTIAL,28300,0,28300,113600,0,141900
140927902600000,NE 133,RESIDENTIAL,27700,0,27700,100000,0,127700
140927902700000,NE 133,RESIDENTIAL,30800,0,30800,121200,0,152000
140928000100000,NE 133,RESIDENTIAL,25400,0,25400,96400,0,121800
140928000200000,NE 133,RESIDENTIAL,26100,0,26100,134200,0,160300
140928000300000,NE 133,RESIDENTIAL,28300,0,28300,107400,0,135700
140928000400000,NE 133,RESIDENTIAL,29500,0,29500,107500,0,137000
140928000500000,NE 133,RESIDENTIAL,30800,0,30800,126000,0,156800
140928000600000,NE 133,RESIDENTIAL,27200,0,27200,114400,0,141600
140928000700000,NE 133,RESIDENTIAL,29100,0,29100,106700,0,135800
140928000800000,NE 133,RESIDENTIAL,29100,0,29100,106200,0,135300
140928000900000,NE 133,RESIDENTIAL,29100,0,29100,110300,0,139400
140928001000000,NE 133,RESIDENTIAL,29100,0,29100,118600,0,147700
140928001100000,NE 133,RESIDENTIAL,30700,0,30700,130000,0,160700
140928100100000,NE 133,RESIDENTIAL,29200,0,29200,106300,0,135500
140928100200000,NE 133,RESIDENTIAL,27700,0,27700,89200,0,116900
140928100300000,NE 133,RESIDENTIAL,27400,0,27400,110500,0,137900
140928100400000,NE 133,RESIDENTIAL,28900,0,28900,101700,0,130600
140928100500000,NE 133,RESIDENTIAL,28000,0,28000,106400,0,134400
140928100600000,NE 133,RESIDENTIAL,26800,0,26800,115400,0,142200
140928100700000,NE 133,RESIDENTIAL,28800,0,28800,103700,0,132500
140928100800000,NE 133,RESIDENTIAL,27900,0,27900,108400,0,136300
140928100900000,NE 133,RESIDENTIAL,28200,0,28200,87500,0,115700
140928101000000,NE 133,RESIDENTIAL,28200,0,28200,106600,0,134800
140928101100000,NE 133,RESIDENTIAL,29300,0,29300,120600,0,149900
140928101200000,NE 133,RESIDENTIAL,27400,0,27400,93700,0,121100
140928101300000,NE 133,RESIDENTIAL,27900,0,27900,97300,0,125200
140928101400000,NE 133,RESIDENTIAL,29400,0,29400,129800,0,159200
140928101500000,NE 133,RESIDENTIAL,31100,0,31100,115400,0,146500
140928101600000,NE 133,RESIDENTIAL,30800,0,30800,123500,0,154300
140928101700000,NE 133,RESIDENTIAL,31400,0,31400,129600,0,161000
140928101800000,NE 133,RESIDENTIAL,29100,0,29100,105900,0,135000
140928101900000,NE 133,RESIDENTIAL,28200,0,28200,103400,0,131600
140928102000000,NE 133,RESIDENTIAL,28000,0,28000,113900,0,141900
140928102100000,NE 133,RESIDENTIAL,28000,0,28000,112900,0,140900
140928102200000,NE 133,RESIDENTIAL,28600,0,28600,113000,0,141600
140928102300000,NE 133,RESIDENTIAL,29600,0,29600,109900,0,139500
140928102400000,NE 133,RESIDENTIAL,29800,0,29800,113700,0,143500
140928102500000,NE 133,RESIDENTIAL,28800,0,28800,88600,0,117400
140928200100000,NE 133,RESIDENTIAL,29400,0,29400,109700,0,139100
140928200200000,NE 133,RESIDENTIAL,27600,0,27600,72900,0,100500
140928200300000,NE 133,RESIDENTIAL,28500,0,28500,97800,0,126300
140928200400000,NE 133,RESIDENTIAL,28500,0,28500,91500,0,120000
140928200500000,NE 133,RESIDENTIAL,30500,0,30500,96100,0,126600
140928200600000,NE 133,RESIDENTIAL,29700,0,29700,106800,0,136500
140928200900000,NE 133,RESIDENTIAL,36100,0,36100,113300,0,149400
140928300100000,NE 133,RESIDENTIAL,28800,0,28800,82000,0,110800
140928300200000,NE 133,RESIDENTIAL,28600,0,28600,118300,0,146900
140928300300000,NE 133,RESIDENTIAL,28300,0,28300,108800,0,137100
140928300400000,NE 133,RESIDENTIAL,28000,0,28000,112700,0,140700
140928300500000,NE 133,RESIDENTIAL,31000,0,31000,114200,0,145200
140928300600000,NE 133,RESIDENTIAL,30000,0,30000,115800,0,145800
140928300700000,NE 133,RESIDENTIAL,28200,0,28200,109500,0,137700
140928300800000,NE 133,RESIDENTIAL,30100,0,30100,103600,0,133700
140928300900000,NE 133,RESIDENTIAL,29700,0,29700,106600,0,136300
140928301000000,NE 133,RESIDENTIAL,30400,0,30400,144500,0,174900
140928301100000,NE 133,RESIDENTIAL,31700,0,31700,118300,0,150000
140928301200000,NE 133,RESIDENTIAL,33100,0,33100,104700,0,137800
140928301300000,NE 133,RESIDENTIAL,31600,0,31600,125700,0,157300
140928301400000,NE 133,RESIDENTIAL,31300,0,31300,113700,0,145000
140928301500000,NE 133,RESIDENTIAL,30400,0,30400,130700,0,161100
140928301600000,NE 133,RESIDENTIAL,29400,0,29400,123800,0,153200
140928301700000,NE 133,RESIDENTIAL,29900,0,29900,119900,0,149800
140928301800000,NE 133,RESIDENTIAL,29900,0,29900,105300,0,135200
140928301900000,NE 133,RESIDENTIAL,29100,0,29100,118100,0,147200
140928302000000,NE 133,RESIDENTIAL,30000,0,30000,113900,0,143900
140928302100000,NE 133,RESIDENTIAL,28700,0,28700,104700,0,133400
140928302200000,NE 133,RESIDENTIAL,29700,0,29700,116300,0,146000
140928302300000,NE 133,RESIDENTIAL,29500,0,29500,74400,0,103900
140928400100000,NE 133,RESIDENTIAL,31700,0,31700,116100,0,147800
140928400200000,NE 133,RESIDENTIAL,32400,0,32400,113900,0,146300
140928400300000,NE 133,RESIDENTIAL,30800,0,30800,101000,0,131800
140928400400000,NE 133,RESIDENTIAL,30800,0,30800,140100,0,170900
140928400500000,NE 133,RESIDENTIAL,30800,0,30800,109200,0,140000
140928400600000,NE 133,RESIDENTIAL,30800,0,30800,129300,0,160100
140928400700000,NE 133,RESIDENTIAL,30100,0,30100,110400,0,140500
140928400800000,NE 133,RESIDENTIAL,29400,0,29400,122400,0,151800
140928400900000,NE 133,RESIDENTIAL,30800,0,30800,127100,0,157900
140928401000000,NE 133,RESIDENTIAL,36000,0,36000,123200,0,159200
140928401100000,NE 133,RESIDENTIAL,35600,0,35600,130800,0,166400
140928401200000,NE 133,RESIDENTIAL,36800,0,36800,119800,0,156600
140928401300000,NE 133,RESIDENTIAL,33600,0,33600,123400,0,157000
140928401400000,NE 133,RESIDENTIAL,35100,0,35100,116500,0,151600
140928401500000,NE 133,RESIDENTIAL,36400,0,36400,128300,0,164700
140930100100000,SECTION 42,COMMERCIAL,0,561600,561600,0,3059500,3621100
140930100200000,NE 147,RESIDENTIAL,24900,0,24900,0,0,24900
140930100300000,NE 147,RESIDENTIAL,38400,0,38400,103900,0,142300
140930100400000,NE 147,RESIDENTIAL,40200,0,40200,137900,0,178100
140930100500000,NE 147,RESIDENTIAL,25400,0,25400,0,0,25400
140930100600000,NE 147,RESIDENTIAL,39600,0,39600,140300,0,179900
140930100700000,NE 147,RESIDENTIAL,19800,0,19800,0,0,19800
140930200100000,NE 147,RESIDENTIAL,37400,0,37400,103600,0,141000
140930200200000,NE 147,RESIDENTIAL,27000,0,27000,103900,0,130900
140930200300000,NE 147,RESIDENTIAL,29000,0,29000,100600,0,129600
140930200400000,NE 147,RESIDENTIAL,34100,0,34100,106800,0,140900
140930200500000,NE 147,RESIDENTIAL,35200,0,35200,119600,0,154800
140930200600000,NE 147,RESIDENTIAL,32700,0,32700,59900,0,92600
140930200700000,NE 147,RESIDENTIAL,34900,0,34900,97000,0,131900
140930200800000,NE 147,RESIDENTIAL,30600,0,30600,125500,0,156100
140930200900000,NE 147,RESIDENTIAL,20500,0,20500,109500,0,130000
140930201000000,NE 147,RESIDENTIAL,31800,0,31800,93000,0,124800
140930201100000,NE 147,RESIDENTIAL,32100,0,32100,93500,0,125600
140930201200000,NE 147,RESIDENTIAL,28300,0,28300,114200,0,142500
140930201300000,NE 147,RESIDENTIAL,27000,0,27000,87200,0,114200
140930201400000,NE 147,RESIDENTIAL,26600,0,26600,81600,0,108200
140930201500000,NE 147,RESIDENTIAL,28500,0,28500,67000,0,95500
140930201600000,CITY PROPERTY,EXEMPT,0,0,0,0,0,0
140930201700000,NE 147,RESIDENTIAL,32800,0,32800,145200,0,178000
140930201800000,NE 147,RESIDENTIAL,32300,0,32300,148400,0,180700
140930201900000,NE 147,RESIDENTIAL,32300,0,32300,136600,0,168900
140930202000000,NE 147,RESIDENTIAL,32300,0,32300,134000,0,166300
140930202100000,NE 147,RESIDENTIAL,32300,0,32300,136600,0,168900
140930202200000,NE 147,RESIDENTIAL,32100,0,32100,126700,0,158800
140930202300000,NE 147,RESIDENTIAL,34400,0,34400,189200,0,223600
140930202400000,NE 147,RESIDENTIAL,33600,0,33600,120100,0,153700
140930202500000,NE 147,RESIDENTIAL,34200,0,34200,156400,0,190600
140930202600000,NE 147,RESIDENTIAL,32900,0,32900,120300,0,153200
140930202700000,NE 147,RESIDENTIAL,33000,0,33000,140600,0,173600
140930202800000,NE 147,RESIDENTIAL,32700,0,32700,153400,0,186100
140930202900000,NE 147,RESIDENTIAL,32700,0,32700,125500,0,158200
140930203000000,NE 147,RESIDENTIAL,33900,0,33900,130600,0,164500
140930203100000,NE 147,RESIDENTIAL,31800,0,31800,121600,0,153400
140930203200000,NE 147,RESIDENTIAL,53900,0,53900,55200,0,109100
140930203300000,NE 147,RESIDENTIAL,55800,0,55800,248500,0,304300
140930203400000,NE 147,RESIDENTIAL,60300,0,60300,258700,0,319000
140930203500000,NE 147,RESIDENTIAL,51200,0,51200,53200,0,104400
140930203600000,NE 147,RESIDENTIAL,25500,0,25500,81200,0,106700
140930203700000,NE 147,RESIDENTIAL,31300,0,31300,167400,0,198700
140930203800000,NE 147,RESIDENTIAL,31500,0,31500,146300,0,177800
140930203900000,NE 147,RESIDENTIAL,31200,0,31200,118300,0,149500
140930204000000,NE 147,RESIDENTIAL,30300,0,30300,182100,0,212400
140930204100000,NE 147,RESIDENTIAL,26600,0,26600,86400,0,113000
140930204200000,NE 147,RESIDENTIAL,27100,0,27100,129300,0,156400
140932600100000,NE 147,RESIDENTIAL,40500,0,40500,106600,0,147100
140932600200000,NE 147,RESIDENTIAL,39100,0,39100,148800,0,187900
140932700100000,NE 147,RESIDENTIAL,58000,0,58000,160600,0,218600
140932700200000,NE 147,RESIDENTIAL,58200,0,58200,175400,0,233600
140932700300000,NE 147,RESIDENTIAL,32400,0,32400,98100,0,130500
140932700400000,NE 147,RESIDENTIAL,31200,0,31200,131200,0,162400
140932700500000,NE 147,RESIDENTIAL,29200,0,29200,0,0,29200
140932700600000,NE 147,RESIDENTIAL,31000,0,31000,109000,0,140000
140932701000000,NE 147,RESIDENTIAL,23900,0,23900,95500,0,119400
140932701100000,NE 147,RESIDENTIAL,33800,0,33800,125900,0,159700
140932701200000,NE 147,RESIDENTIAL,22200,0,22200,83400,0,105600
140932701300000,NE 147,RESIDENTIAL,25200,0,25200,74200,0,99400
140932701400000,NE 147,RESIDENTIAL,29200,0,29200,135400,0,164600
140932701500000,NE 147,RESIDENTIAL,26400,0,26400,73200,0,99600
140932701600000,NE 147,RESIDENTIAL,47900,0,47900,137400,0,185300
140932701700000,NE 147,RESIDENTIAL,35000,0,35000,66200,0,101200
140932701800000,NE 147,RESIDENTIAL,30900,0,30900,182400,0,213300
140932701900000,NE 147,RESIDENTIAL,30700,0,30700,127800,0,158500
140932702000000,NE 147,RESIDENTIAL,48200,0,48200,58700,0,106900
140932702100000,NE 147,RESIDENTIAL,45600,0,45600,203500,0,249100
140932702300000,NE 147,RESIDENTIAL,35000,0,35000,109300,0,144300
140932800100000,NE 147,RESIDENTIAL,30300,0,30300,100600,0,130900
140932800200000,NE 147,RESIDENTIAL,26200,0,26200,29600,0,55800
140932800300000,NE 147,RESIDENTIAL,37200,0,37200,58000,0,95200
140932800400000,NE 147,RESIDENTIAL,37900,0,37900,138100,0,176000
140932800500000,NE 147,RESIDENTIAL,39500,0,39500,158100,0,197600
140932800600000,NE 147,RESIDENTIAL,30200,0,30200,109600,0,139800
140932800700000,NE 147,RESIDENTIAL,38100,0,38100,129200,0,167300
140932800800000,NE 147,RESIDENTIAL,38700,0,38700,110200,0,148900
140932800900000,NE 147,RESIDENTIAL,50400,0,50400,57700,0,108100
140932801000000,NE 147,RESIDENTIAL,50500,0,50500,121400,0,171900
140932801100000,NE 147,RESIDENTIAL,52300,0,52300,130000,0,182300
140932801200000,NE 147,RESIDENTIAL,34900,0,34900,121300,0,156200
140932801300000,NE 147,RESIDENTIAL,32800,0,32800,105900,0,138700
140932801400000,NE 147,RESIDENTIAL,30900,0,30900,148300,0,179200
140932801500000,NE 147,RESIDENTIAL,26800,0,26800,154300,0,181100
140932801600000,NE 147,RESIDENTIAL,28800,0,28800,125300,0,154100
140932801700000,NE 147,RESIDENTIAL,28500,0,28500,131400,0,159900
140932801800000,NE 147,RESIDENTIAL,32900,0,32900,135600,0,168500
140932801900000,NE 147,RESIDENTIAL,28000,0,28000,127700,0,155700
140932802000000,NE 147,RESIDENTIAL,32800,0,32800,213600,0,246400
140932802100000,NE 147,RESIDENTIAL,35000,0,35000,166900,0,201900
140932802200000,NE 147,RESIDENTIAL,45900,0,45900,31400,0,77300
140932802300000,NE 147,RESIDENTIAL,35500,0,35500,163200,0,198700
140932802400000,NE 147,RESIDENTIAL,45500,0,45500,90800,0,136300
140932802500000,NE 147,RESIDENTIAL,43200,0,43200,47500,0,90700
140932802600000,NE 147,RESIDENTIAL,50100,0,50100,249200,0,299300
140932802700000,NE 147,RESIDENTIAL,50100,0,50100,276400,0,326500
140932802800000,NE 147,RESIDENTIAL,44600,0,44600,116400,0,161000
140932802900000,NE 147,RESIDENTIAL,49500,0,49500,121400,0,170900
140932803000000,NE 147,RESIDENTIAL,48800,0,48800,52100,0,100900
140932803100000,NE 147,RESIDENTIAL,30000,0,30000,113700,0,143700
140932803400000,NE 147,RESIDENTIAL,1400,0,1400,0,0,1400
140935100100000,NE 147,RESIDENTIAL,25900,0,25900,104500,0,130400
140935100200000,NE 147,RESIDENTIAL,44900,0,44900,99700,0,144600
140935100300000,NE 147,RESIDENTIAL,49900,0,49900,124200,0,174100
140935100400000,NE 147,RESIDENTIAL,28900,0,28900,117800,0,146700
140935100500000,NE 147,RESIDENTIAL,28200,0,28200,136600,0,164800
140935100600000,NE 147,RESIDENTIAL,28500,0,28500,139900,0,168400
140935100700000,NE 147,RESIDENTIAL,28500,0,28500,117200,0,145700
140935100800000,NE 147,RESIDENTIAL,28200,0,28200,129100,0,157300
140935100900000,NE 147,RESIDENTIAL,27600,0,27600,108300,0,135900
140935101000000,NE 147,RESIDENTIAL,26000,0,26000,130500,0,156500
140935101100000,NE 147,RESIDENTIAL,51100,0,51100,39600,0,90700
140935101400000,NE 147,RESIDENTIAL,26900,0,26900,0,0,26900
140935101500000,NE 147,RESIDENTIAL,19100,0,19100,35200,0,54300
140935101600000,NE 147,RESIDENTIAL,21200,0,21200,0,0,21200
140935101700000,NE 147,RESIDENTIAL,25400,0,25400,85500,0,110900
140935101800000,NE 147,RESIDENTIAL,23300,0,23300,35000,0,58300
140935101900000,NE 147,RESIDENTIAL,19100,0,19100,94800,0,113900
140935102000000,NE 147,RESIDENTIAL,19100,0,19100,105600,0,124700
140935102100000,NE 147,RESIDENTIAL,4200,0,4200,0,0,4200
140935102200000,NE 147,RESIDENTIAL,52500,0,52500,186200,0,238700
140935102300000,NE 147,RESIDENTIAL,52700,0,52700,198200,0,250900
140935102400000,NE 147,RESIDENTIAL,53300,0,53300,91100,0,144400
140935102500000,NE 147,RESIDENTIAL,37500,0,37500,113200,0,150700
140935102600000,NE 147,RESIDENTIAL,37600,0,37600,63700,0,101300
140935102700000,NE 147,RESIDENTIAL,52200,0,52200,73300,0,125500
140935102800000,NE 147,RESIDENTIAL,52400,0,52400,295800,0,348200
140935102900000,NE 147,RESIDENTIAL,49700,0,49700,321100,0,370800
140935103000000,NE 147,RESIDENTIAL,25000,0,25000,0,0,25000
140935103100000,NE 147,RESIDENTIAL,51400,0,51400,395600,0,447000
140935200100000,NE 147,RESIDENTIAL,37500,0,37500,131600,0,169100
140935200200000,NE 147,RESIDENTIAL,30200,0,30200,79400,0,109600
140935200300000,NE 147,RESIDENTIAL,51700,0,51700,212100,0,263800
140935200400000,NE 147,RESIDENTIAL,26500,0,26500,99900,0,126400
140935200500000,NE 147,RESIDENTIAL,25800,0,25800,125000,0,150800
140935200600000,NE 147,RESIDENTIAL,25800,0,25800,121300,0,147100
140935200700000,NE 147,RESIDENTIAL,28000,0,28000,87900,0,115900
140935300100000,NE 147,RESIDENTIAL,24800,0,24800,193400,0,218200
140935300200000,NE 147,RESIDENTIAL,47800,0,47800,102500,0,150300
140935300300000,NE 147,RESIDENTIAL,26400,0,26400,0,0,26400
140935300500000,NE 147,RESIDENTIAL,27000,0,27000,96600,0,123600
140935300600000,NE 147,RESIDENTIAL,37400,0,37400,48900,0,86300
140935301000000,NE 147,RESIDENTIAL,20700,0,20700,43500,0,64200
140935301100000,NE 147,RESIDENTIAL,31100,0,31100,104400,0,135500
140935301200000,NE 147,RESIDENTIAL,37000,0,37000,62400,0,99400
140935301400000,NE 147,RESIDENTIAL,33300,0,33300,101300,0,134600
140935301500000,NE 147,RESIDENTIAL,33600,0,33600,105100,0,138700
140935301600000,NE 147,RESIDENTIAL,34600,0,34600,105900,0,140500
140935301700000,NE 147,RESIDENTIAL,21800,0,21800,31200,0,53000
140935301800000,NE 147,RESIDENTIAL,25900,0,25900,108900,0,134800
140935301900000,NE 147,RESIDENTIAL,26900,0,26900,103200,0,130100
140935302000000,NE 147,RESIDENTIAL,26600,0,26600,106900,0,133500
140935302100000,NE 147,RESIDENTIAL,31900,0,31900,600,0,32500
140935302200000,NE 147,RESIDENTIAL,40700,0,40700,131100,0,171800
140937600100000,NE 147,RESIDENTIAL,50600,0,50600,110800,0,161400
140937600200000,NE 147,RESIDENTIAL,42300,0,42300,90200,0,132500
140937600300000,NE 147,RESIDENTIAL,39200,0,39200,64400,0,103600
140937600400000,NE 147,RESIDENTIAL,38100,0,38100,129500,0,167600
140937600500000,NE 147,RESIDENTIAL,28600,0,28600,90600,0,119200
140937600600000,NE 147,RESIDENTIAL,40500,0,40500,53600,0,94100
140937600700000,NE 147,RESIDENTIAL,24400,0,24400,39300,0,63700
140937600800000,NE 147,RESIDENTIAL,30100,0,30100,87800,0,117900
140937600900000,NE 147,RESIDENTIAL,35700,0,35700,59000,0,94700
140937601000000,NE 147,RESIDENTIAL,28700,0,28700,95600,0,124300
140937601100000,NE 147,RESIDENTIAL,25400,0,25400,86300,0,111700
140937601200000,NE 147,RESIDENTIAL,24700,0,24700,94200,0,118900
140937601300000,NE 147,RESIDENTIAL,23400,0,23400,90800,0,114200
140937601400000,NE 147,RESIDENTIAL,24100,0,24100,98400,0,122500
140937601500000,NE 147,RESIDENTIAL,22500,0,22500,92600,0,115100
140937601600000,NE 147,RESIDENTIAL,22500,0,22500,93800,0,116300
140937601700000,NE 147,RESIDENTIAL,23600,0,23600,89300,0,112900
140937601800000,NE 147,RESIDENTIAL,23600,0,23600,109400,0,133000
140937601900000,NE 147,RESIDENTIAL,6600,0,6600,0,0,6600
140937700100000,NE 147,RESIDENTIAL,25600,0,25600,137500,0,163100
140937700200000,NE 147,RESIDENTIAL,26000,0,26000,118800,0,144800
140937700300000,NE 147,RESIDENTIAL,22400,0,22400,114400,0,136800
140937700400000,NE 147,RESIDENTIAL,23900,0,23900,66400,0,90300
140937700500000,NE 147,RESIDENTIAL,26200,0,26200,104800,0,131000
140937700600000,NE 147,RESIDENTIAL,26000,0,26000,117700,0,143700
140937700700000,NE 147,RESIDENTIAL,26000,0,26000,125500,0,151500
140937700800000,NE 147,RESIDENTIAL,26600,0,26600,119300,0,145900
140937700900000,NE 147,RESIDENTIAL,27400,0,27400,109800,0,137200
140937701000000,NE 147,RESIDENTIAL,25300,0,25300,107600,0,132900
140937701100000,NE 147,RESIDENTIAL,23900,0,23900,108500,0,132400
140937701200000,NE 147,RESIDENTIAL,23900,0,23900,108100,0,132000
140937701300000,NE 147,RESIDENTIAL,29800,0,29800,128800,0,158600
140937701400000,NE 147,RESIDENTIAL,28300,0,28300,123200,0,151500
140937701500000,NE 147,RESIDENTIAL,24200,0,24200,139300,0,163500
140937701600000,NE 147,RESIDENTIAL,21400,0,21400,121900,0,143300
140937701700000,NE 147,RESIDENTIAL,33800,0,33800,116000,0,149800
140937701800000,NE 147,RESIDENTIAL,55500,0,55500,114800,0,170300
140937701900000,NE 147,RESIDENTIAL,53300,0,53300,42200,0,95500
140937702000000,NE 147,RESIDENTIAL,25100,0,25100,67500,0,92600
140937702100000,NE 147,RESIDENTIAL,26600,0,26600,109900,0,136500
140937702200000,NE 147,RESIDENTIAL,48400,0,48400,134300,0,182700
140937702300000,NE 147,RESIDENTIAL,39300,0,39300,132000,0,171300
140937702400000,NE 147,RESIDENTIAL,28600,0,28600,77900,0,106500
140937702500000,NE 147,RESIDENTIAL,18700,0,18700,63500,0,82200
140937702600000,NE 147,RESIDENTIAL,18700,0,18700,51500,0,70200
140937702700000,NE 147,RESIDENTIAL,22900,0,22900,55900,0,78800
140937702800000,NE 147,RESIDENTIAL,22900,0,22900,64200,0,87100
140937702900000,NE 147,RESIDENTIAL,32100,0,32100,154400,0,186500
140937703000000,NE 147,RESIDENTIAL,29500,0,29500,81600,0,111100
140937703100000,NE 147,RESIDENTIAL,45900,0,45900,175600,0,221500
140937703200000,NE 147,RESIDENTIAL,27200,0,27200,129300,0,156500
140937703300000,NE 147,RESIDENTIAL,28700,0,28700,122900,0,151600
140937703400000,NE 147,RESIDENTIAL,28700,0,28700,141900,0,170600
140937703500000,NE 147,RESIDENTIAL,28700,0,28700,116200,0,144900
140937703600000,NE 147,RESIDENTIAL,28700,0,28700,138100,0,166800
140937703700000,NE 147,RESIDENTIAL,28700,0,28700,138800,0,167500
140937703800000,NE 147,RESIDENTIAL,29700,0,29700,132500,0,162200
140937703900000,NE 147,RESIDENTIAL,29900,0,29900,134700,0,164600
140937704000000,NE 147,RESIDENTIAL,4700,0,4700,0,0,4700
140937704100000,NE 147,RESIDENTIAL,31100,0,31100,169500,0,200600
140937704200000,NE 147,RESIDENTIAL,30300,0,30300,153000,0,183300
140937704300000,NE 147,RESIDENTIAL,33100,0,33100,163800,0,196900
140937704400000,NE 147,RESIDENTIAL,28400,0,28400,137400,0,165800
140937704500000,NE 147,RESIDENTIAL,28800,0,28800,147600,0,176400
140937704600000,NE 147,RESIDENTIAL,28800,0,28800,131500,0,160300
140937704700000,NE 147,RESIDENTIAL,28600,0,28600,138800,0,167400
140937704800000,NE 147,RESIDENTIAL,28100,0,28100,138300,0,166400
140937704900000,NE 147,RESIDENTIAL,28100,0,28100,128300,0,156400
140937800100000,NE 147,RESIDENTIAL,18200,0,18200,12400,0,30600
140937800200000,NE 147,RESIDENTIAL,15800,0,15800,105200,0,121000
140937800300000,NE 147,RESIDENTIAL,22900,0,22900,100100,0,123000
140937800400000,NE 147,RESIDENTIAL,22900,0,22900,90700,0,113600
140937800500000,NE 147,RESIDENTIAL,22900,0,22900,92900,0,115800
140937800600000,NE 147,RESIDENTIAL,22900,0,22900,84400,0,107300
140937800700000,NE 147,RESIDENTIAL,22900,0,22900,128400,0,151300
140937800800000,NE 147,RESIDENTIAL,22500,0,22500,104100,0,126600
140937800900000,NE 147,RESIDENTIAL,22500,0,22500,106200,0,128700
140937801000000,NE 147,RESIDENTIAL,22500,0,22500,113500,0,136000
140937803200000,NE 147,RESIDENTIAL,39400,0,39400,171400,0,210800
140937803300000,NE 147,RESIDENTIAL,39900,0,39900,87500,0,127400
140937803500000,NE 147,RESIDENTIAL,26800,0,26800,82600,0,109400
140937900100000,NE 147,RESIDENTIAL,24400,0,24400,100900,0,125300
140937900200000,NE 147,RESIDENTIAL,22500,0,22500,81000,0,103500
140937900300000,NE 147,RESIDENTIAL,24400,0,24400,78300,0,102700
140937900400000,NE 147,RESIDENTIAL,22500,0,22500,87900,0,110400
140937900500000,NE 147,RESIDENTIAL,26000,0,26000,88800,0,114800
140937900600000,NE 147,RESIDENTIAL,23500,0,23500,96700,0,120200
140937900700000,NE 147,RESIDENTIAL,22500,0,22500,99600,0,122100
140937900800000,NE 147,RESIDENTIAL,23200,0,23200,102600,0,125800
140937900900000,NE 147,RESIDENTIAL,22500,0,22500,83000,0,105500
140937901000000,NE 147,RESIDENTIAL,23200,0,23200,108200,0,131400
140938000100000,NE 147,RESIDENTIAL,28600,0,28600,94200,0,122800
140938000200000,NE 147,RESIDENTIAL,35700,0,35700,132300,0,168000
140938000300000,NE 147,RESIDENTIAL,44300,0,44300,137300,0,181600
140938000400000,NE 147,RESIDENTIAL,31600,0,31600,61300,0,92900
140938000500000,NE 147,RESIDENTIAL,29300,0,29300,108300,0,137600
140938000600000,NE 147,RESIDENTIAL,20200,0,20200,40800,0,61000
140940100100000,NE 131,RESIDENTIAL,15400,0,15400,105100,0,120500
140940100200000,NE 131,RESIDENTIAL,22800,0,22800,102000,0,124800
140940100300000,NE 131,RESIDENTIAL,17600,0,17600,25400,0,43000
140940100400000,NE 131,RESIDENTIAL,17600,0,17600,104600,0,122200
140940100500000,NE 131,RESIDENTIAL,18300,0,18300,65300,0,83600
140940100600000,NE 131,RESIDENTIAL,15800,0,15800,96300,0,112100
140940100700000,NE 131,RESIDENTIAL,17600,0,17600,106400,0,124000
140940100800000,NE 131,RESIDENTIAL,17600,0,17600,95300,0,112900
140940100900000,NE 131,RESIDENTIAL,22600,0,22600,117900,0,140500
140940101000000,NE 131,RESIDENTIAL,19800,0,19800,81400,0,101200
140940101100000,NE 131,RESIDENTIAL,14600,0,14600,62900,0,77500
140940101200000,NE 131,RESIDENTIAL,14600,0,14600,57700,0,72300
140940101300000,NE 131,RESIDENTIAL,18500,0,18500,70100,0,88600
140940101400000,NE 131,RESIDENTIAL,17400,0,17400,72600,0,90000
140940101500000,NE 131,RESIDENTIAL,17400,0,17400,86500,0,103900
140940101600000,NE 131,RESIDENTIAL,20900,0,20900,112900,0,133800
140940101700000,NE 131,RESIDENTIAL,20900,0,20900,48000,0,68900
140940101800000,NE 131,RESIDENTIAL,17400,0,17400,48900,0,66300
140940101900000,NE 131,RESIDENTIAL,17400,0,17400,73600,0,91000
140940102000000,NE 131,RESIDENTIAL,17400,0,17400,70300,0,87700
140940102100000,NE 131,RESIDENTIAL,14600,0,14600,31600,0,46200
140940102200000,NE 131,RESIDENTIAL,20300,0,20300,103900,0,124200
140940102300000,NE 131,RESIDENTIAL,23500,0,23500,39700,0,63200
140940200100000,NE 131,RESIDENTIAL,11200,0,11200,33800,0,45000
140940200200000,NE 131,RESIDENTIAL,17300,0,17300,57400,0,74700
140940200300000,NE 131,RESIDENTIAL,17300,0,17300,89400,0,106700
140940200400000,NE 131,RESIDENTIAL,17300,0,17300,40000,0,57300
140940200500000,NE 131,RESIDENTIAL,17300,0,17300,60900,0,78200
140940200600000,NE 131,RESIDENTIAL,17300,0,17300,51900,0,69200
140940200700000,NE 131,RESIDENTIAL,17300,0,17300,90400,0,107700
140940200800000,NE 131,RESIDENTIAL,17300,0,17300,64600,0,81900
140940200900000,NE 131,RESIDENTIAL,17300,0,17300,25600,0,42900
140940201000000,NE 131,RESIDENTIAL,17300,0,17300,49700,0,67000
140940201100000,NE 131,RESIDENTIAL,17300,0,17300,28300,0,45600
140940201200000,NE 131,RESIDENTIAL,22400,0,22400,89600,0,112000
140940201300000,NE 131,RESIDENTIAL,22400,0,22400,89800,0,112200
140940201400000,NE 131,RESIDENTIAL,17300,0,17300,97700,0,115000
140940201500000,NE 131,RESIDENTIAL,17300,0,17300,108700,0,126000
140940201600000,NE 131,RESIDENTIAL,17300,0,17300,74400,0,91700
140940201700000,NE 131,RESIDENTIAL,17300,0,17300,58800,0,76100
140940201800000,NE 131,RESIDENTIAL,22300,0,22300,118600,0,140900
140940201900000,NE 131,RESIDENTIAL,18500,0,18500,88400,0,106900
140940300100000,NE 131,RESIDENTIAL,21600,0,21600,72000,0,93600
140940300200000,NE 131,RESIDENTIAL,17700,0,17700,109300,0,127000
140940300300000,NE 131,RESIDENTIAL,17700,0,17700,92300,0,110000
140940300400000,NE 131,RESIDENTIAL,20700,0,20700,95600,0,116300
140940300500000,NE 131,RESIDENTIAL,32300,0,32300,114800,0,147100
140940300600000,NE 131,RESIDENTIAL,17100,0,17100,42600,0,59700
140940300700000,NE 131,RESIDENTIAL,17000,0,17000,83100,0,100100
140940300800000,NE 131,RESIDENTIAL,25400,0,25400,72100,0,97500
140940300900000,NE 131,RESIDENTIAL,20200,0,20200,44000,0,64200
140940301000000,NE 131,RESIDENTIAL,21500,0,21500,92100,0,113600
140940301200000,NE 131,RESIDENTIAL,16800,0,16800,0,0,16800
140940301300000,FLAT PARKING,COMMERCIAL,0,67900,67900,0,5800,73700
140940301400000,NE 131,RESIDENTIAL,17000,0,17000,0,0,17000
140940301500000,NE 131,RESIDENTIAL,19000,0,19000,94600,0,113600
140940301600000,NE 131,RESIDENTIAL,16800,0,16800,116100,0,132900
140940301700000,NE 131,RESIDENTIAL,16800,0,16800,84200,0,101000
140940302000000,NE 131,RESIDENTIAL,25900,0,25900,78600,0,104500
140940302100000,NE 131,RESIDENTIAL,17300,0,17300,138100,0,155400
140940302200000,NE 131,RESIDENTIAL,17300,0,17300,88500,0,105800
140940302300000,NE 131,RESIDENTIAL,17300,0,17300,67100,0,84400
140940302400000,NE 131,RESIDENTIAL,22400,0,22400,93500,0,115900
140940302500000,NE 131,RESIDENTIAL,17300,0,17300,50600,0,67900
140940302600000,NE 131,RESIDENTIAL,17300,0,17300,78800,0,96100
140940302700000,NE 131,RESIDENTIAL,17300,0,17300,18500,0,35800
140940302800000,NE 131,RESIDENTIAL,22400,0,22400,72000,0,94400
140940302900000,NE 131,RESIDENTIAL,22400,0,22400,86700,0,109100
140940303000000,NE 131,RESIDENTIAL,22400,0,22400,63400,0,85800
140940303100000,NE 131,RESIDENTIAL,22400,0,22400,75200,0,97600
140940303200000,NE 131,RESIDENTIAL,19400,0,19400,36000,0,55400
140940400200000,NE 131,RESIDENTIAL,15200,0,15200,50400,0,65600
140940400300000,NE 131,RESIDENTIAL,18400,0,18400,59700,0,78100
140940400400000,NE 131,RESIDENTIAL,21400,0,21400,71300,0,92700
140940400500000,NE 131,RESIDENTIAL,20000,0,20000,112400,0,132400
140940400600000,NE 131,RESIDENTIAL,18000,0,18000,0,0,18000
140940400700000,NE 131,RESIDENTIAL,18000,0,18000,70300,0,88300
140940400800000,NE 131,RESIDENTIAL,14300,0,14300,73100,0,87400
140940400900000,NE 131,RESIDENTIAL,15500,0,15500,64200,0,79700
140940401000000,NE 131,RESIDENTIAL,14300,0,14300,75100,0,89400
140940401100000,NE 131,RESIDENTIAL,16800,0,16800,74500,0,91300
140940401200000,NE 131,RESIDENTIAL,16800,0,16800,68600,0,85400
140940401400000,OFFICE; MEDICAL,COMMERCIAL,0,192000,192000,0,475100,667100
140940402000000,GROCERY STORE,COMMERCIAL,0,1083460,1083460,0,4790940,5874400
140942600100000,FLAT PARKING,COMMERCIAL,0,109800,109800,0,10200,120000
140942600200000,OFFICE,COMMERCIAL,0,116100,116100,0,292500,408600
140942600300000,NE 132,RESIDENTIAL,14900,0,14900,84500,0,99400
140942600400000,NE 131,RESIDENTIAL,20200,0,20200,91100,0,111300
140942600500000,NE 132,RESIDENTIAL,13900,0,13900,60900,0,74800
140942600600000,RESTAURANT,COMMERCIAL,0,114500,114500,0,97900,212400
140942600700000,SMALL RETAIL,COMMERCIAL,0,17400,17400,0,45600,63000
140942601000000,CONVENIENCE STORE,COMMERCIAL,0,168800,168800,0,136200,305000
140942601100000,LAUNDROMAT/CLEANERS,COMMERCIAL,0,97400,97400,0,201300,298700
140942601200000,OFFICE,COMMERCIAL,0,191000,191000,0,445100,636100
140942601300000,LG DISCOUNT/RETAIL,COMMERCIAL,0,468800,468800,0,868700,1337500
140942700100000,NE 132,RESIDENTIAL,13200,0,13200,108400,0,121600
140942700200000,NE 132,RESIDENTIAL,13600,0,13600,66100,0,79700
140942700300000,NE 132,RESIDENTIAL,14400,0,14400,65400,0,79800
140942700400000,NE 132,RESIDENTIAL,10400,0,10400,43500,0,53900
140942700500000,NE 132,RESIDENTIAL,10200,0,10200,0,0,10200
140942700600000,OFFICE; MEDICAL,COMMERCIAL,0,99600,99600,0,148300,247900
140942800200000,VACANT LAND,COMMERCIAL,0,18800,18800,0,0,18800
140942800300000,VACANT LAND,COMMERCIAL,0,189500,189500,0,405900,595400
140942900100000,AUTO REPAIR/SALES,COMMERCIAL,0,77000,77000,0,35700,112700
140942900200000,RESTAURANT,COMMERCIAL,0,136200,136200,0,226200,362400
140942900300000,RESTAURANT,COMMERCIAL,0,138400,138400,0,116800,255200
140942900400000,AUTO REPAIR/SALES,COMMERCIAL,0,240000,240000,0,143400,383400
140943000100000,CITY PROPERTY,EXEMPT,0,0,0,0,0,0
140945100100000,OFFICE,COMMERCIAL,0,128500,128500,0,495000,623500
140945100200000,OFFICE,COMMERCIAL,0,86300,86300,0,373200,459500
140945100300000,OFFICE; MEDICAL,COMMERCIAL,0,78900,78900,0,107000,185900
140945100401000,OFFICE; MEDICAL,COMMERCIAL,0,74100,74100,0,283400,357500
140945100401001,OFFICE,COMMERCIAL,0,74100,74100,0,384300,458400
140945100500000,NE 146,RESIDENTIAL,16900,0,16900,23200,0,40100
140945100600000,NE 146,RESIDENTIAL,22400,0,22400,14900,0,37300
140945100700000,SMALL RETAIL,COMMERCIAL,88290,107910,196200,83640,144660,424500
140945100702000,ANTENNAS/TOWERS(BLL),COMMERCIAL,0,0,0,0,88600,88600
140945101400000,CENTRALLY ASSESSED,OTHER,0,0,0,0,0,0
140945101600000,DAY CARE CENTER,COMMERCIAL,0,176400,176400,0,222700,399100
140945101700000,OFFICE; MEDICAL,COMMERCIAL,0,508100,508100,0,786700,1294800
140945200100000,CITY PROPERTY,EXEMPT,0,0,0,0,0,0
140945200200000,NE 146,RESIDENTIAL,8800,0,8800,0,0,8800
140945200300000,NE 147,RESIDENTIAL,10600,0,10600,95700,0,106300
140945200400000,NE 147,RESIDENTIAL,15300,0,15300,93800,0,109100
140945200500000,NE 147,RESIDENTIAL,15300,0,15300,93700,0,109000
140945200600000,NE 147,RESIDENTIAL,15300,0,15300,70500,0,85800
140945200700000,NE 147,RESIDENTIAL,15300,0,15300,85400,0,100700
140945200800000,NE 147,RESIDENTIAL,15300,0,15300,98200,0,113500
140945200900000,NE 147,RESIDENTIAL,15000,0,15000,111800,0,126800
140945201100000,NE 147,RESIDENTIAL,31500,0,31500,83000,0,114500
140947600100000,OFFICE,COMMERCIAL,0,415200,415200,0,705300,1120500
140947700200000,SMALL RETAIL,COMMERCIAL,0,377100,377100,0,616600,993700
140947700500000,NE 146,RESIDENTIAL,10700,0,10700,18100,0,28800
140947700600000,NE 146,RESIDENTIAL,9500,0,9500,52900,0,62400
140947700700000,NE 146,RESIDENTIAL,10500,0,10500,0,0,10500
140947700800000,NE 146,RESIDENTIAL,13100,0,13100,12400,0,25500
140947700900000,OFFICE; MEDICAL,COMMERCIAL,0,272000,272000,0,1352300,1624300
140947701100000,NE 143,RESIDENTIAL,22400,0,22400,27400,0,49800
140947701200000,NE 143,RESIDENTIAL,22200,0,22200,0,0,22200
140947701300000,NE 143,RESIDENTIAL,42300,0,42300,123400,0,165700
140947701400000,NE 143,RESIDENTIAL,27700,0,27700,146600,0,174300
140947701500000,NE 143,RESIDENTIAL,20000,0,20000,92500,0,112500
140947701600000,NE 143,RESIDENTIAL,19900,0,19900,76000,0,95900
140947701700000,NE 143,RESIDENTIAL,19900,0,19900,80200,0,100100
140947701800000,NE 143,RESIDENTIAL,19900,0,19900,84200,0,104100
140947701900000,NE 143,RESIDENTIAL,19900,0,19900,87000,0,106900
140947702000000,NE 143,RESIDENTIAL,19900,0,19900,92700,0,112600
140947702100000,NE 143,RESIDENTIAL,15600,0,15600,71200,0,86800
140947702200000,APARTMENT,MULTI-RES,21800,0,21800,130800,0,152600
140947702300000,NE 143,RESIDENTIAL,19200,0,19200,98800,0,118000
140947702400000,NE 143,RESIDENTIAL,17700,0,17700,74000,0,91700
140947702500000,NE 143,RESIDENTIAL,18000,0,18000,70000,0,88000
140947702600000,NE 143,RESIDENTIAL,21100,0,21100,75900,0,97000
140947702700000,NE 143,RESIDENTIAL,30200,0,30200,62100,0,92300
140947702800000,NE 143,RESIDENTIAL,25000,0,25000,100400,0,125400
140947702900000,NE 143,RESIDENTIAL,18400,0,18400,78500,0,96900
140947703000000,NE 143,RESIDENTIAL,18200,0,18200,61400,0,79600
140947703100000,NE 143,RESIDENTIAL,18200,0,18200,12400,0,30600
140947703200000,NE 143,RESIDENTIAL,29600,0,29600,112600,0,142200
140947703300000,NE 143,RESIDENTIAL,25600,0,25600,81500,0,107100
140947703400000,NE 143,RESIDENTIAL,30100,0,30100,78000,0,108100
140947800200000,NE 146,RESIDENTIAL,13400,0,13400,51400,0,64800
140947800300000,NE 146,RESIDENTIAL,13700,0,13700,64500,0,78200
140947800400000,NE 146,RESIDENTIAL,11900,0,11900,36000,0,47900
140947800500000,NE 146,RESIDENTIAL,11900,0,11900,53600,0,65500
140947800600000,NE 146,RESIDENTIAL,11900,0,11900,30100,0,42000
140947800700000,CONVENIENCE STORE,COMMERCIAL,0,369700,369700,0,620600,990300
140947801300000,NE 146,RESIDENTIAL,17000,0,17000,0,0,17000
140947801500000,NE 146,RESIDENTIAL,18900,0,18900,41000,0,59900
140947801600000,NE 146,RESIDENTIAL,22400,0,22400,4600,0,27000
140947801700000,NE 146,RESIDENTIAL,22000,0,22000,43500,0,65500
140947801800000,NE 146,RESIDENTIAL,22000,0,22000,41200,0,63200
140947801900000,NE 146,RESIDENTIAL,20600,0,20600,111400,0,132000
140947802000000,NE 146,RESIDENTIAL,20600,0,20600,45400,0,66000
140947802100000,NE 146,RESIDENTIAL,22200,0,22200,82200,0,104400
140947802200000,NE 146,RESIDENTIAL,25400,0,25400,48400,0,73800
140947802300000,NE 146,RESIDENTIAL,16800,0,16800,46300,0,63100
140947802400000,NE 146,RESIDENTIAL,14300,0,14300,0,0,14300
140947802500000,CONVENIENCE STORE,COMMERCIAL,0,135200,135200,0,207400,342600
140947802600000,NE 146,RESIDENTIAL,19100,0,19100,49700,0,68800
140947802700000,NE 146,RESIDENTIAL,15900,0,15900,48100,0,64000
140947802800000,NE 146,RESIDENTIAL,25500,0,25500,67900,0,93400
140947802900000,NE 146,RESIDENTIAL,22300,0,22300,47500,0,69800
140947803000000,NE 143,RESIDENTIAL,18300,0,18300,76200,0,94500
140947803100000,NE 143,RESIDENTIAL,20500,0,20500,103800,0,124300
140947803200000,NE 143,RESIDENTIAL,20500,0,20500,82000,0,102500
140947803300000,NE 143,RESIDENTIAL,23100,0,23100,135600,0,158700
140947803400000,NE 143,RESIDENTIAL,20700,0,20700,84100,0,104800
140947803500000,NE 143,RESIDENTIAL,21100,0,21100,84000,0,105100
140947803600000,NE 143,RESIDENTIAL,21500,0,21500,97300,0,118800
140947803700000,NE 143,RESIDENTIAL,26000,0,26000,104900,0,130900
140947803800000,NE 143,RESIDENTIAL,27000,0,27000,110300,0,137300
140947900200000,NE 143,RESIDENTIAL,21200,0,21200,62700,0,83900
140947900300000,NE 143,RESIDENTIAL,21400,0,21400,64900,0,86300
140947900400000,NE 143,RESIDENTIAL,19300,0,19300,68100,0,87400
140947900500000,NE 143,RESIDENTIAL,21000,0,21000,92600,0,113600
140947900600000,NE 143,RESIDENTIAL,16200,0,16200,81600,0,97800
140947900700000,NE 143,RESIDENTIAL,14600,0,14600,70500,0,85100
140947900800000,NE 143,RESIDENTIAL,19100,0,19100,40700,0,59800
140947900900000,NE 143,RESIDENTIAL,22700,0,22700,70200,0,92900
140948000100000,NE 143,RESIDENTIAL,24300,0,24300,71800,0,96100
140948000200000,NE 143,RESIDENTIAL,23400,0,23400,65700,0,89100
140948000300000,NE 143,RESIDENTIAL,25000,0,25000,68600,0,93600
140948000400000,NE 143,RESIDENTIAL,34300,0,34300,164700,0,199000
140948000500000,NE 143,RESIDENTIAL,37300,0,37300,97900,0,135200
140948000600000,NE 143,RESIDENTIAL,28700,0,28700,96100,0,124800
140948000700000,NE 143,RESIDENTIAL,19200,0,19200,72000,0,91200
140948000800000,NE 143,RESIDENTIAL,21000,0,21000,79000,0,100000
140948000900000,NE 143,RESIDENTIAL,34800,0,34800,66200,0,101000
140948001000000,NE 143,RESIDENTIAL,13700,0,13700,56800,0,70500
140948001100000,NE 143,RESIDENTIAL,17600,0,17600,80700,0,98300
140948001200000,FLAT PARKING,EXEMPT,0,19800,19800,0,6200,26000
140948001300000,NE 143,RESIDENTIAL,28100,0,28100,114200,0,142300
140948001400000,NE 143,RESIDENTIAL,19100,0,19100,94500,0,113600
140948001500000,NE 143,RESIDENTIAL,17600,0,17600,84800,0,102400
140948001600000,NE 143,RESIDENTIAL,24500,0,24500,98600,0,123100
140948001700000,NE 143,RESIDENTIAL,25900,0,25900,76600,0,102500
140948001800000,NE 143,RESIDENTIAL,26800,0,26800,82600,0,109400
140948001900000,NE 143,RESIDENTIAL,27600,0,27600,124000,0,151600
141010100100000,NE 130,RESIDENTIAL,19700,0,19700,88700,0,108400
141010100200000,NE 130,RESIDENTIAL,20200,0,20200,95000,0,115200
141010100300000,NE 130,RESIDENTIAL,18000,0,18000,64300,0,82300
141010100400000,NE 130,RESIDENTIAL,17500,0,17500,78400,0,95900
141010100500000,NE 130,RESIDENTIAL,15500,0,15500,103200,0,118700
141010100600000,NE 130,RESIDENTIAL,15500,0,15500,83300,0,98800
141010100700000,NE 130,RESIDENTIAL,15500,0,15500,103100,0,118600
141010100800000,NE 130,RESIDENTIAL,15500,0,15500,68900,0,84400
141010100900000,NE 130,RESIDENTIAL,15500,0,15500,77900,0,93400
141010101000000,NE 130,RESIDENTIAL,15500,0,15500,77900,0,93400
141010101100000,NE 130,RESIDENTIAL,15500,0,15500,81200,0,96700
141010101200000,NE 130,RESIDENTIAL,16600,0,16600,80500,0,97100
141010200100000,NE 130,RESIDENTIAL,17500,0,17500,67700,0,85200
141010200200000,NE 130,RESIDENTIAL,18900,0,18900,94400,0,113300
141010200300000,NE 130,RESIDENTIAL,15500,0,15500,75900,0,91400
141010200400000,NE 130,RESIDENTIAL,15500,0,15500,76100,0,91600
141010200500000,NE 130,RESIDENTIAL,15500,0,15500,86300,0,101800
141010200600000,NE 130,RESIDENTIAL,15500,0,15500,76200,0,91700
141010300100000,NE 130,RESIDENTIAL,17300,0,17300,91600,0,108900
141010300200000,NE 130,RESIDENTIAL,17300,0,17300,73400,0,90700
141010300300000,NE 130,RESIDENTIAL,17500,0,17500,95500,0,113000
141010300400000,NE 130,RESIDENTIAL,17500,0,17500,75600,0,93100
141010300500000,NE 130,RESIDENTIAL,17500,0,17500,65100,0,82600
141010400100000,NE 130,RESIDENTIAL,19000,0,19000,90500,0,109500
141010400200000,NE 130,RESIDENTIAL,17500,0,17500,71500,0,89000
141010400300000,NE 130,RESIDENTIAL,17500,0,17500,91300,0,108800
141010400400000,NE 130,RESIDENTIAL,15500,0,15500,108300,0,123800
141010400500000,NE 130,RESIDENTIAL,15500,0,15500,98600,0,114100
141010400600000,NE 130,RESIDENTIAL,17500,0,17500,67000,0,84500
141010400700000,NE 130,RESIDENTIAL,15500,0,15500,78400,0,93900
141010400800000,NE 130,RESIDENTIAL,15500,0,15500,77700,0,93200
141010400900000,NE 130,RESIDENTIAL,15500,0,15500,63900,0,79400
141010401000000,NE 130,RESIDENTIAL,15500,0,15500,96900,0,112400
141010401100000,NE 130,RESIDENTIAL,15500,0,15500,53200,0,68700
141010401200000,NE 130,RESIDENTIAL,15500,0,15500,73900,0,89400
141010401300000,NE 130,RESIDENTIAL,16600,0,16600,67600,0,84200
141010401400000,NE 130,RESIDENTIAL,19500,0,19500,66700,0,86200
141010401500000,NE 130,RESIDENTIAL,19500,0,19500,42400,0,61900
141010401600000,NE 130,RESIDENTIAL,19400,0,19400,57000,0,76400
141010401700000,NE 130,RESIDENTIAL,19800,0,19800,62900,0,82700
141010401800000,NE 130,RESIDENTIAL,19800,0,19800,62300,0,82100
141010401900000,NE 130,RESIDENTIAL,19400,0,19400,90500,0,109900
141010402000000,NE 130,RESIDENTIAL,19800,0,19800,79900,0,99700
141010402100000,NE 130,RESIDENTIAL,19400,0,19400,54100,0,73500
141010402200000,NE 130,RESIDENTIAL,19700,0,19700,99100,0,118800
141010402300000,NE 130,RESIDENTIAL,19200,0,19200,79800,0,99000
141010402400000,NE 130,RESIDENTIAL,16100,0,16100,57600,0,73700
141010402500000,NE 130,RESIDENTIAL,22900,0,22900,80100,0,103000
141010500100000,NE 130,RESIDENTIAL,16600,0,16600,90100,0,106700
141010500200000,NE 130,RESIDENTIAL,15500,0,15500,100900,0,116400
141010500300000,NE 130,RESIDENTIAL,15500,0,15500,90100,0,105600
141010500400000,NE 130,RESIDENTIAL,15500,0,15500,85300,0,100800
141010500500000,NE 130,RESIDENTIAL,15500,0,15500,97300,0,112800
141010500600000,NE 130,RESIDENTIAL,17300,0,17300,70600,0,87900
141010500700000,NE 130,RESIDENTIAL,17300,0,17300,63400,0,80700
141010500800000,NE 130,RESIDENTIAL,15500,0,15500,103700,0,119200
141010500900000,NE 130,RESIDENTIAL,15500,0,15500,76100,0,91600
141010501000000,NE 130,RESIDENTIAL,15500,0,15500,101900,0,117400
141010501100000,NE 130,RESIDENTIAL,15500,0,15500,87900,0,103400
141010501200000,NE 130,RESIDENTIAL,15500,0,15500,92200,0,107700
141010501300000,NE 130,RESIDENTIAL,15500,0,15500,73200,0,88700
141010501400000,NE 130,RESIDENTIAL,17500,0,17500,80100,0,97600
141010600100000,NE 130,RESIDENTIAL,20200,0,20200,83800,0,104000
141010600200000,NE 130,RESIDENTIAL,18900,0,18900,90500,0,109400
141010600300000,NE 130,RESIDENTIAL,18500,0,18500,77900,0,96400
141010600400000,NE 130,RESIDENTIAL,19200,0,19200,67100,0,86300
141010600500000,NE 130,RESIDENTIAL,21600,0,21600,111500,0,133100
141010600600000,NE 130,RESIDENTIAL,25200,0,25200,79000,0,104200
141010600700000,NE 130,RESIDENTIAL,23300,0,23300,64500,0,87800
141010600800000,NE 130,RESIDENTIAL,23300,0,23300,34100,0,57400
141010600900000,NE 130,RESIDENTIAL,23300,0,23300,87800,0,111100
141010601000000,NE 130,RESIDENTIAL,17500,0,17500,53700,0,71200
141010700100000,NE 130,RESIDENTIAL,21600,0,21600,126600,0,148200
141010700200000,NE 130,RESIDENTIAL,23100,0,23100,102700,0,125800
141010700300000,NE 130,RESIDENTIAL,23800,0,23800,69100,0,92900
141010700400000,NE 130,RESIDENTIAL,23900,0,23900,85800,0,109700
141010700500000,NE 130,RESIDENTIAL,22700,0,22700,83700,0,106400
141010700600000,NE 130,RESIDENTIAL,22700,0,22700,68500,0,91200
141010700700000,NE 130,RESIDENTIAL,23900,0,23900,97900,0,121800
141010700800000,NE 130,RESIDENTIAL,22700,0,22700,52500,0,75200
141010700900000,NE 130,RESIDENTIAL,22700,0,22700,59800,0,82500
141010701000000,NE 130,RESIDENTIAL,23700,0,23700,61500,0,85200
141010701100000,NE 130,RESIDENTIAL,23700,0,23700,78700,0,102400
141010701200000,NE 130,RESIDENTIAL,16000,0,16000,80300,0,96300
141010701300000,NE 130,RESIDENTIAL,15800,0,15800,78200,0,94000
141010701400000,NE 130,RESIDENTIAL,15800,0,15800,60200,0,76000
141010701500000,NE 130,RESIDENTIAL,15800,0,15800,91200,0,107000
141010701600000,NE 130,RESIDENTIAL,15800,0,15800,49200,0,65000
141010701700000,NE 130,RESIDENTIAL,15800,0,15800,40000,0,55800
141010701800000,NE 130,RESIDENTIAL,15800,0,15800,78700,0,94500
141010701900000,NE 130,RESIDENTIAL,16800,0,16800,97000,0,113800
141010702000000,NE 130,RESIDENTIAL,15800,0,15800,58500,0,74300
141010702100000,NE 130,RESIDENTIAL,15800,0,15800,43700,0,59500
141010702200000,NE 130,RESIDENTIAL,15800,0,15800,78000,0,93800
141010702300000,NE 130,RESIDENTIAL,15800,0,15800,86600,0,102400
141010702400000,NE 130,RESIDENTIAL,19000,0,19000,100400,0,119400
141010702500000,NE 130,RESIDENTIAL,16000,0,16000,61200,0,77200
141010800100000,NE 130,RESIDENTIAL,24800,0,24800,59100,0,83900
141010800200000,NE 130,RESIDENTIAL,19700,0,19700,81000,0,100700
141010800300000,NE 130,RESIDENTIAL,18500,0,18500,94800,0,113300
141010800400000,NE 130,RESIDENTIAL,18500,0,18500,91900,0,110400
141010800500000,NE 130,RESIDENTIAL,18500,0,18500,97100,0,115600
141010800600000,NE 130,RESIDENTIAL,16200,0,16200,65500,0,81700
141010800700000,NE 130,RESIDENTIAL,16200,0,16200,62300,0,78500
141010800800000,NE 130,RESIDENTIAL,16200,0,16200,66900,0,83100
141010800900000,NE 130,RESIDENTIAL,16200,0,16200,67700,0,83900
141010801000000,NE 130,RESIDENTIAL,20400,0,20400,102000,0,122400
141010801100000,NE 130,RESIDENTIAL,20900,0,20900,97000,0,117900
141010801200000,NE 130,RESIDENTIAL,22600,0,22600,70500,0,93100
141010801300000,NE 130,RESIDENTIAL,17500,0,17500,86600,0,104100
141010900100000,NE 130,RESIDENTIAL,20400,0,20400,90000,0,110400
141010900200000,NE 130,RESIDENTIAL,18500,0,18500,51800,0,70300
141010900300000,NE 130,RESIDENTIAL,18200,0,18200,65800,0,84000
141010900400000,NE 130,RESIDENTIAL,18200,0,18200,55100,0,73300
141010900500000,NE 130,RESIDENTIAL,18200,0,18200,65700,0,83900
141010900600000,NE 130,RESIDENTIAL,4400,0,4400,0,0,4400
141010900700000,NE 130,RESIDENTIAL,17500,0,17500,57600,0,75100
141010900800000,NE 130,RESIDENTIAL,18200,0,18200,54900,0,73100
141010900900000,NE 130,RESIDENTIAL,16700,0,16700,69900,0,86600
141010901000000,NE 130,RESIDENTIAL,16200,0,16200,108600,0,124800
141010901100000,NE 130,RESIDENTIAL,16200,0,16200,82600,0,98800
141010901200000,NE 130,RESIDENTIAL,16200,0,16200,66700,0,82900
141010901300000,NE 130,RESIDENTIAL,16200,0,16200,100300,0,116500
141010901400000,NE 130,RESIDENTIAL,19500,0,19500,68600,0,88100
141011000100000,NE 130,RESIDENTIAL,25900,0,25900,74900,0,100800
141011000200000,NE 130,RESIDENTIAL,23300,0,23300,82000,0,105300
141011000300000,NE 130,RESIDENTIAL,24700,0,24700,80200,0,104900
141011000400000,NE 130,RESIDENTIAL,16200,0,16200,63600,0,79800
141011000500000,NE 130,RESIDENTIAL,16200,0,16200,95700,0,111900
141011000600000,NE 130,RESIDENTIAL,16200,0,16200,71100,0,87300
141011000700000,NE 130,RESIDENTIAL,16200,0,16200,90500,0,106700
141011000800000,NE 130,RESIDENTIAL,16200,0,16200,111800,0,128000
141011000900000,NE 130,RESIDENTIAL,24400,0,24400,74200,0,98600
141011001000000,NE 130,RESIDENTIAL,25100,0,25100,67200,0,92300
141011001100000,NE 130,RESIDENTIAL,16200,0,16200,99300,0,115500
141011001200000,NE 130,RESIDENTIAL,16200,0,16200,68600,0,84800
141011001300000,NE 130,RESIDENTIAL,25900,0,25900,103200,0,129100
141011001400000,NE 130,RESIDENTIAL,24200,0,24200,74700,0,98900
141011001500000,NE 130,RESIDENTIAL,24200,0,24200,88100,0,112300
141011001600000,NE 130,RESIDENTIAL,25900,0,25900,57200,0,83100
141011100100000,NE 130,RESIDENTIAL,24600,0,24600,71600,0,96200
141011100200000,NE 130,RESIDENTIAL,24600,0,24600,77300,0,101900
141011100300000,NE 130,RESIDENTIAL,22600,0,22600,82800,0,105400
141011100400000,NE 130,RESIDENTIAL,28300,0,28300,63900,0,92200
141011100500000,NE 130,RESIDENTIAL,28300,0,28300,74700,0,103000
141011100700000,NE 130,RESIDENTIAL,16200,0,16200,53700,0,69900
141011100800000,NE 130,RESIDENTIAL,16200,0,16200,61400,0,77600
141011100900000,NE 130,RESIDENTIAL,16200,0,16200,65600,0,81800
141011101000000,NE 130,RESIDENTIAL,16200,0,16200,77500,0,93700
141011101100000,NE 130,RESIDENTIAL,25900,0,25900,73100,0,99000
141011101200000,NE 130,RESIDENTIAL,16200,0,16200,61900,0,78100
141011101300000,NE 130,RESIDENTIAL,24200,0,24200,91800,0,116000
141011101400000,NE 130,RESIDENTIAL,24200,0,24200,95600,0,119800
141011101500000,NE 130,RESIDENTIAL,16200,0,16200,62400,0,78600
141011101600000,NE 130,RESIDENTIAL,24200,0,24200,79500,0,103700
141011200100000,NE 130,RESIDENTIAL,16200,0,16200,89700,0,105900
141011200200000,NE 130,RESIDENTIAL,21600,0,21600,74200,0,95800
141011200300000,NE 130,RESIDENTIAL,21600,0,21600,82800,0,104400
141011200400000,NE 130,RESIDENTIAL,16200,0,16200,80500,0,96700
141011200500000,NE 130,RESIDENTIAL,16200,0,16200,40400,0,56600
141011200600000,NE 130,RESIDENTIAL,21800,0,21800,61900,0,83700
141011200700000,NE 130,RESIDENTIAL,18600,0,18600,56100,0,74700
141011200800000,NE 130,RESIDENTIAL,21800,0,21800,64500,0,86300
141011200900000,NE 130,RESIDENTIAL,18600,0,18600,54000,0,72600
141011201000000,NE 130,RESIDENTIAL,21600,0,21600,60500,0,82100
141011201100000,NE 130,RESIDENTIAL,21600,0,21600,65600,0,87200
141011201200000,NE 130,RESIDENTIAL,16200,0,16200,52400,0,68600
141011201300000,NE 130,RESIDENTIAL,16200,0,16200,104600,0,120800
141011201400000,NE 130,RESIDENTIAL,24200,0,24200,64300,0,88500
141011201500000,NE 130,RESIDENTIAL,24200,0,24200,93400,0,117600
141011201600000,NE 130,RESIDENTIAL,25900,0,25900,93400,0,119300
141011201900000,NE 130,RESIDENTIAL,33900,0,33900,91600,0,125500
141011300100000,NE 130,RESIDENTIAL,25900,0,25900,81300,0,107200
141011300200000,NE 130,RESIDENTIAL,25000,0,25000,79700,0,104700
141011300300000,NE 130,RESIDENTIAL,24100,0,24100,82200,0,106300
141011300400000,NE 130,RESIDENTIAL,24200,0,24200,92700,0,116900
141011300500000,NE 130,RESIDENTIAL,24200,0,24200,91400,0,115600
141011300600000,NE 130,RESIDENTIAL,24200,0,24200,101100,0,125300
141011300700000,NE 130,RESIDENTIAL,22200,0,22200,83100,0,105300
141011300900000,NE 130,RESIDENTIAL,25800,0,25800,81600,0,107400
141011301000000,NE 130,RESIDENTIAL,21600,0,21600,101800,0,123400
141011301100000,NE 130,RESIDENTIAL,25900,0,25900,87800,0,113700
141011301200000,NE 130,RESIDENTIAL,25900,0,25900,120100,0,146000
141011301300000,NE 130,RESIDENTIAL,21800,0,21800,60100,0,81900
141011301400000,NE 130,RESIDENTIAL,18600,0,18600,83400,0,102000
141011301500000,NE 130,RESIDENTIAL,21800,0,21800,67100,0,88900
141011301600000,NE 130,RESIDENTIAL,18600,0,18600,48300,0,66900
141012600100000,GOLF COURSE,COMMERCIAL,0,200000,200000,0,413300,613300
141015100100000,NE 131,RESIDENTIAL,17500,0,17500,34600,0,52100
141015100200000,NE 131,RESIDENTIAL,17600,0,17600,31700,0,49300
141015100300000,NE 131,RESIDENTIAL,16700,0,16700,62400,0,79100
141015100400000,NE 131,RESIDENTIAL,17000,0,17000,43100,0,60100
141015100500000,NE 131,RESIDENTIAL,15400,0,15400,47200,0,62600
141015100600000,NE 131,RESIDENTIAL,17000,0,17000,46900,0,63900
141015100700000,NE 131,RESIDENTIAL,16700,0,16700,57400,0,74100
141015100800000,NE 131,RESIDENTIAL,17000,0,17000,66400,0,83400
141015100900000,NE 131,RESIDENTIAL,15400,0,15400,62300,0,77700
141015101000000,NE 131,RESIDENTIAL,17000,0,17000,64400,0,81400
141015101100000,NE 131,RESIDENTIAL,16700,0,16700,55900,0,72600
141015101200000,NE 131,RESIDENTIAL,18000,0,18000,72200,0,90200
141015101300000,NE 131,RESIDENTIAL,19300,0,19300,71400,0,90700
141015101400000,NE 131,RESIDENTIAL,17700,0,17700,59700,0,77400
141015101500000,NE 131,RESIDENTIAL,17900,0,17900,59500,0,77400
141015101600000,NE 131,RESIDENTIAL,16200,0,16200,57200,0,73400
141015101700000,NE 131,RESIDENTIAL,17700,0,17700,53500,0,71200
141015101800000,NE 131,RESIDENTIAL,17200,0,17200,80900,0,98100
141015101900000,NE 131,RESIDENTIAL,17400,0,17400,67000,0,84400
141015102000000,NE 131,RESIDENTIAL,15800,0,15800,54100,0,69900
141015102100000,NE 131,RESIDENTIAL,17200,0,17200,61800,0,79000
141015102200000,NE 131,RESIDENTIAL,16700,0,16700,64800,0,81500
141015200100000,NE 131,RESIDENTIAL,18100,0,18100,63100,0,81200
141015200200000,NE 131,RESIDENTIAL,19200,0,19200,70100,0,89300
141015200300000,NE 131,RESIDENTIAL,19500,0,19500,59700,0,79200
141015200400000,NE 131,RESIDENTIAL,18200,0,18200,55300,0,73500
141015200500000,NE 131,RESIDENTIAL,19500,0,19500,78600,0,98100
141015200600000,NE 131,RESIDENTIAL,18200,0,18200,51000,0,69200
141015200700000,NE 131,RESIDENTIAL,19500,0,19500,92200,0,111700
141015200800000,NE 131,RESIDENTIAL,18200,0,18200,54800,0,73000
141015200900000,NE 131,RESIDENTIAL,19500,0,19500,72300,0,91800
141015201000000,NE 131,RESIDENTIAL,19500,0,19500,79700,0,99200
141015201100000,NE 131,RESIDENTIAL,18800,0,18800,71800,0,90600
141015201200000,NE 131,RESIDENTIAL,18500,0,18500,53200,0,71700
141015201300000,NE 131,RESIDENTIAL,17200,0,17200,55200,0,72400
141015201400000,NE 131,RESIDENTIAL,17600,0,17600,56200,0,73800
141015201500000,NE 131,RESIDENTIAL,15900,0,15900,46400,0,62300
141015201600000,NE 131,RESIDENTIAL,17600,0,17600,38800,0,56400
141015201700000,NE 131,RESIDENTIAL,17200,0,17200,66800,0,84000
141015201800000,NE 131,RESIDENTIAL,17600,0,17600,54200,0,71800
141015201900000,NE 131,RESIDENTIAL,15900,0,15900,53900,0,69800
141015202000000,NE 131,RESIDENTIAL,17600,0,17600,57800,0,75400
141015202100000,NE 131,RESIDENTIAL,17200,0,17200,55700,0,72900
141015300100000,NE 131,RESIDENTIAL,18500,0,18500,67700,0,86200
141015300200000,NE 131,RESIDENTIAL,17500,0,17500,80600,0,98100
141015300300000,NE 131,RESIDENTIAL,17400,0,17400,68100,0,85500
141015300400000,NE 131,RESIDENTIAL,17400,0,17400,64900,0,82300
141015300500000,NE 131,RESIDENTIAL,16700,0,16700,58000,0,74700
141015300600000,NE 131,RESIDENTIAL,17100,0,17100,77000,0,94100
141015300700000,NE 131,RESIDENTIAL,16100,0,16100,56100,0,72200
141015300800000,NE 131,RESIDENTIAL,17400,0,17400,69600,0,87000
141015300900000,NE 131,RESIDENTIAL,17100,0,17100,60500,0,77600
141015301000000,NE 131,RESIDENTIAL,16100,0,16100,35900,0,52000
141015301100000,NE 131,RESIDENTIAL,17100,0,17100,68700,0,85800
141015301200000,NE 131,RESIDENTIAL,18300,0,18300,61900,0,80200
141015301300000,NE 131,RESIDENTIAL,19000,0,19000,61800,0,80800
141015301400000,NE 131,RESIDENTIAL,18000,0,18000,55800,0,73800
141015301500000,NE 131,RESIDENTIAL,19300,0,19300,58600,0,77900
141015301600000,NE 131,RESIDENTIAL,19300,0,19300,62400,0,81700
141015301700000,NE 131,RESIDENTIAL,18000,0,18000,58700,0,76700
141015301800000,NE 131,RESIDENTIAL,19300,0,19300,72500,0,91800
141015301900000,NE 131,RESIDENTIAL,19300,0,19300,88000,0,107300
141015302000000,NE 131,RESIDENTIAL,19300,0,19300,68200,0,87500
141015302100000,NE 131,RESIDENTIAL,18000,0,18000,68200,0,86200
141015400100000,NE 131,RESIDENTIAL,17300,0,17300,62800,0,80100
141015400200000,NE 131,RESIDENTIAL,23700,0,23700,109300,0,133000
141015400300000,NE 131,RESIDENTIAL,24200,0,24200,96400,0,120600
141015400400000,NE 131,RESIDENTIAL,24200,0,24200,131300,0,155500
141015400500000,NE 131,RESIDENTIAL,24000,0,24000,103400,0,127400
141015400600000,NE 131,RESIDENTIAL,23700,0,23700,117500,0,141200
141015400700000,NE 131,RESIDENTIAL,23700,0,23700,91400,0,115100
141015400800000,NE 131,RESIDENTIAL,23500,0,23500,112000,0,135500
141015400900000,NE 131,RESIDENTIAL,23900,0,23900,114700,0,138600
141015401000000,NE 131,RESIDENTIAL,16700,0,16700,58800,0,75500
141015401100000,NE 131,RESIDENTIAL,16400,0,16400,53200,0,69600
141015401200000,NE 131,RESIDENTIAL,16700,0,16700,48700,0,65400
141015401300000,NE 131,RESIDENTIAL,16700,0,16700,70900,0,87600
141015401400000,NE 131,RESIDENTIAL,15400,0,15400,66300,0,81700
141015401500000,NE 131,RESIDENTIAL,16700,0,16700,60200,0,76900
141015401600000,NE 131,RESIDENTIAL,16400,0,16400,79600,0,96000
141015401700000,NE 131,RESIDENTIAL,15400,0,15400,55800,0,71200
141015401800000,NE 131,RESIDENTIAL,16700,0,16700,69800,0,86500
141015401900000,NE 131,EXEMPT,0,16100,16100,0,54600,70700
141015500100000,NE 131,RESIDENTIAL,21000,0,21000,75600,0,96600
141015500200000,NE 131,RESIDENTIAL,21000,0,21000,86900,0,107900
141015500300000,NE 131,RESIDENTIAL,21000,0,21000,115800,0,136800
141015500400000,NE 131,RESIDENTIAL,21000,0,21000,111300,0,132300
141015500500000,NE 131,RESIDENTIAL,21000,0,21000,84500,0,105500
141015500600000,NE 131,RESIDENTIAL,13800,0,13800,54700,0,68500
141015500700000,NE 131,RESIDENTIAL,14100,0,14100,49400,0,63500
141015500800000,NE 131,RESIDENTIAL,14100,0,14100,51600,0,65700
141015500900000,NE 131,RESIDENTIAL,21000,0,21000,48500,0,69500
141015501000000,NE 131,RESIDENTIAL,21000,0,21000,109300,0,130300
141015501100000,NE 131,RESIDENTIAL,21000,0,21000,107900,0,128900
141015501200000,NE 131,RESIDENTIAL,21000,0,21000,56700,0,77700
141015501300000,NE 131,RESIDENTIAL,21000,0,21000,23000,0,44000
141015501400000,NE 131,RESIDENTIAL,21000,0,21000,83000,0,104000
141015501500000,NE 131,RESIDENTIAL,21000,0,21000,67000,0,88000
141015600100000,NE 131,RESIDENTIAL,21000,0,21000,84800,0,105800
141015600200000,NE 131,RESIDENTIAL,21000,0,21000,81200,0,102200
141015600300000,NE 131,RESIDENTIAL,21000,0,21000,81600,0,102600
141015600400000,NE 131,RESIDENTIAL,21000,0,21000,97600,0,118600
141015600500000,NE 131,RESIDENTIAL,21000,0,21000,100300,0,121300
141015600600000,NE 131,RESIDENTIAL,21000,0,21000,65900,0,86900
141015600700000,NE 131,RESIDENTIAL,21000,0,21000,118200,0,139200
141015600800000,NE 131,RESIDENTIAL,19500,0,19500,87300,0,106800
141015600900000,NE 131,RESIDENTIAL,22500,0,22500,102200,0,124700
141015601000000,NE 131,RESIDENTIAL,21000,0,21000,81700,0,102700
141015601100000,NE 131,RESIDENTIAL,21000,0,21000,72900,0,93900
141015601200000,NE 131,RESIDENTIAL,10500,0,10500,42900,0,53400
141015601300000,NE 131,RESIDENTIAL,10500,0,10500,37800,0,48300
141015700100000,NE 131,RESIDENTIAL,14400,0,14400,91700,0,106100
141015700200000,NE 131,RESIDENTIAL,24300,0,24300,98500,0,122800
141015700400000,NE 131,RESIDENTIAL,13500,0,13500,0,0,13500
141015700500000,NE 131,RESIDENTIAL,13500,0,13500,88200,0,101700
141015700600000,NE 131,RESIDENTIAL,23300,0,23300,116800,0,140100
141015700700000,NE 131,RESIDENTIAL,22700,0,22700,121200,0,143900
141015700800000,NE 131,RESIDENTIAL,22800,0,22800,111700,0,134500
141015700900000,NE 131,RESIDENTIAL,22800,0,22800,69600,0,92400
141015701000000,NE 131,RESIDENTIAL,22800,0,22800,71100,0,93900
141015800100000,NE 131,RESIDENTIAL,15800,0,15800,64700,0,80500
141015800200000,NE 131,RESIDENTIAL,15800,0,15800,76700,0,92500
141015800300000,NE 131,RESIDENTIAL,10500,0,10500,34800,0,45300
141015800400000,NE 131,RESIDENTIAL,21000,0,21000,62400,0,83400
141015800500000,NE 131,RESIDENTIAL,21000,0,21000,69300,0,90300
141015800600000,NE 131,RESIDENTIAL,21000,0,21000,71600,0,92600
141015800700000,NE 131,RESIDENTIAL,13500,0,13500,56900,0,70400
141015800800000,NE 131,RESIDENTIAL,15000,0,15000,38900,0,53900
141015800900000,NE 131,RESIDENTIAL,13500,0,13500,51700,0,65200
141015801000000,NE 131,RESIDENTIAL,21000,0,21000,66200,0,87200
141015801100000,NE 131,RESIDENTIAL,21000,0,21000,77200,0,98200
141015801200000,NE 131,RESIDENTIAL,21000,0,21000,55000,0,76000
141015801300000,NE 131,RESIDENTIAL,21000,0,21000,57400,0,78400
141015801400000,NE 131,RESIDENTIAL,21000,0,21000,88000,0,109000
141015801500000,NE 131,RESIDENTIAL,21000,0,21000,87600,0,108600
141015801600000,NE 131,RESIDENTIAL,21000,0,21000,73200,0,94200
141015900100000,NE 131,RESIDENTIAL,21000,0,21000,60300,0,81300
141015900200000,NE 131,RESIDENTIAL,21000,0,21000,84400,0,105400
141015900300000,NE 131,RESIDENTIAL,21000,0,21000,78300,0,99300
141015900400000,NE 131,RESIDENTIAL,21700,0,21700,34000,0,55700
141015900500000,NE 131,RESIDENTIAL,12000,0,12000,46800,0,58800
141015900600000,NE 131,RESIDENTIAL,15000,0,15000,81200,0,96200
141015900700000,NE 131,RESIDENTIAL,10500,0,10500,37800,0,48300
141015900800000,CITY PROPERTY,EXEMPT,0,0,0,0,0,0
141015900900000,NE 131,RESIDENTIAL,13700,0,13700,34600,0,48300
141015901000000,NE 131,RESIDENTIAL,13700,0,13700,45100,0,58800
141015901100000,NE 131,RESIDENTIAL,21800,0,21800,96000,0,117800
141015901200000,NE 131,RESIDENTIAL,22900,0,22900,117500,0,140400
141015901300000,NE 131,RESIDENTIAL,21000,0,21000,106000,0,127000
141015901400000,NE 131,RESIDENTIAL,21000,0,21000,82400,0,103400
141015901500000,NE 131,RESIDENTIAL,21000,0,21000,74300,0,95300
141015901600000,NE 131,RESIDENTIAL,21000,0,21000,56700,0,77700
141015901700000,NE 131,RESIDENTIAL,21000,0,21000,37400,0,58400
141015901800000,NE 131,RESIDENTIAL,21000,0,21000,73300,0,94300
141017600100000,NE 129,RESIDENTIAL,17000,0,17000,88500,0,105500
141017600200000,NE 129,RESIDENTIAL,19700,0,19700,37300,0,57000
141017600300000,NE 129,RESIDENTIAL,20100,0,20100,116600,0,136700
141017600400000,NE 129,RESIDENTIAL,21700,0,21700,99700,0,121400
141017600500000,NE 129,RESIDENTIAL,29200,0,29200,131300,0,160500
141017600600000,NE 129,RESIDENTIAL,27600,0,27600,118400,0,146000
141017600700000,NE 129,RESIDENTIAL,22400,0,22400,79100,0,101500
141017600800000,NE 129,RESIDENTIAL,20900,0,20900,93900,0,114800
141017600900000,NE 129,RESIDENTIAL,19700,0,19700,59800,0,79500
141017601000000,NE 129,RESIDENTIAL,21000,0,21000,102900,0,123900
141017601100000,NE 129,RESIDENTIAL,17600,0,17600,81100,0,98700
141017601200000,NE 129,RESIDENTIAL,17300,0,17300,83000,0,100300
141017601300000,NE 129,RESIDENTIAL,17300,0,17300,117900,0,135200
141017601400000,NE 129,RESIDENTIAL,23600,0,23600,72800,0,96400
141017601500000,NE 129,RESIDENTIAL,23600,0,23600,90000,0,113600
141017601600000,NE 129,RESIDENTIAL,25100,0,25100,113800,0,138900
141017601700000,NE 129,RESIDENTIAL,23600,0,23600,100700,0,124300
141017601800000,NE 129,RESIDENTIAL,23600,0,23600,129300,0,152900
141017601900000,NE 129,RESIDENTIAL,19100,0,19100,99900,0,119000
141017602000000,NE 129,RESIDENTIAL,16400,0,16400,87400,0,103800
141017602100000,NE 129,RESIDENTIAL,18400,0,18400,79400,0,97800
141017602200000,NE 129,RESIDENTIAL,20000,0,20000,67400,0,87400
141017700100000,SCHOOL,EXEMPT,0,0,0,0,0,0
141017800100000,NE 129,RESIDENTIAL,21100,0,21100,134200,0,155300
141017800200000,NE 129,RESIDENTIAL,20700,0,20700,72500,0,93200
141017800300000,NE 129,RESIDENTIAL,20100,0,20100,125900,0,146000
141017800400000,NE 129,RESIDENTIAL,20100,0,20100,114700,0,134800
141017800500000,NE 129,RESIDENTIAL,20100,0,20100,92900,0,113000
141017800600000,NE 129,RESIDENTIAL,20100,0,20100,128700,0,148800
141017800700000,NE 129,RESIDENTIAL,20100,0,20100,130900,0,151000
141017800800000,NE 129,RESIDENTIAL,20100,0,20100,64700,0,84800
141017800900000,NE 129,RESIDENTIAL,20100,0,20100,76000,0,96100
141017801000000,NE 129,RESIDENTIAL,19300,0,19300,94100,0,113400
141017801100000,NE 129,RESIDENTIAL,20900,0,20900,146800,0,167700
141017801200000,NE 129,RESIDENTIAL,20100,0,20100,86600,0,106700
141017801300000,NE 129,RESIDENTIAL,20100,0,20100,112900,0,133000
141017801400000,NE 129,RESIDENTIAL,20100,0,20100,82600,0,102700
141017801500000,NE 129,RESIDENTIAL,20100,0,20100,90200,0,110300
141017801600000,NE 129,RESIDENTIAL,20100,0,20100,128200,0,148300
141017801700000,NE 129,RESIDENTIAL,20100,0,20100,90500,0,110600
141017801800000,NE 129,RESIDENTIAL,20100,0,20100,69900,0,90000
141017801900000,NE 129,RESIDENTIAL,17300,0,17300,84100,0,101400
141017802000000,NE 129,RESIDENTIAL,26200,0,26200,107800,0,134000
141017802100000,NE 129,RESIDENTIAL,20900,0,20900,132800,0,153700
141017802200000,NE 129,RESIDENTIAL,21300,0,21300,101600,0,122900
141017900100000,NE 131,RESIDENTIAL,21000,0,21000,103300,0,124300
141017900200000,NE 131,RESIDENTIAL,21000,0,21000,78100,0,99100
141017900300000,NE 131,RESIDENTIAL,21000,0,21000,84100,0,105100
141017900400000,NE 131,RESIDENTIAL,15800,0,15800,76400,0,92200
141017900500000,NE 131,RESIDENTIAL,15800,0,15800,84700,0,100500
141017900600000,NE 131,RESIDENTIAL,21000,0,21000,92700,0,113700
141017900700000,NE 131,RESIDENTIAL,10500,0,10500,60800,0,71300
141017900800000,NE 131,RESIDENTIAL,10500,0,10500,32700,0,43200
141017900900000,NE 131,RESIDENTIAL,21000,0,21000,57100,0,78100
141017901000000,NE 131,RESIDENTIAL,10500,0,10500,64700,0,75200
141017901100000,NE 131,RESIDENTIAL,25200,0,25200,113500,0,138700
141017901200000,NE 131,RESIDENTIAL,21000,0,21000,90900,0,111900
141017901300000,NE 131,RESIDENTIAL,10500,0,10500,61000,0,71500
141017901400000,NE 131,RESIDENTIAL,15800,0,15800,50200,0,66000
141017901500000,NE 131,RESIDENTIAL,15800,0,15800,76000,0,91800
141017901600000,NE 131,RESIDENTIAL,10500,0,10500,50700,0,61200
141017901700000,NE 131,RESIDENTIAL,19500,0,19500,50600,0,70100
141017901800000,NE 131,RESIDENTIAL,12000,0,12000,30900,0,42900
141017901900000,NE 131,RESIDENTIAL,21000,0,21000,66500,0,87500
141018000100000,NE 129,RESIDENTIAL,15800,0,15800,58200,0,74000
141018000200000,NE 129,RESIDENTIAL,16500,0,16500,82700,0,99200
141018000300000,NE 129,RESIDENTIAL,24600,0,24600,84500,0,109100
141018000400000,NE 129,RESIDENTIAL,15800,0,15800,42000,0,57800
141018000500000,NE 129,RESIDENTIAL,15800,0,15800,117100,0,132900
141018000600000,NE 129,RESIDENTIAL,19700,0,19700,80400,0,100100
141018000700000,NE 129,RESIDENTIAL,19700,0,19700,45300,0,65000
141018000800000,NE 129,RESIDENTIAL,19700,0,19700,76900,0,96600
141018000900000,NE 129,RESIDENTIAL,19700,0,19700,101900,0,121600
141018001000000,NE 129,RESIDENTIAL,15800,0,15800,94900,0,110700
141018001100000,NE 129,RESIDENTIAL,15800,0,15800,111800,0,127600
141018001200000,NE 129,RESIDENTIAL,20100,0,20100,98100,0,118200
141018001300000,NE 129,RESIDENTIAL,20100,0,20100,106100,0,126200
141018001400000,NE 129,RESIDENTIAL,15800,0,15800,53000,0,68800
141018001500000,NE 129,RESIDENTIAL,15800,0,15800,59100,0,74900
141018001600000,NE 129,RESIDENTIAL,15800,0,15800,52100,0,67900
141018001700000,NE 129,RESIDENTIAL,15800,0,15800,75600,0,91400
141018001800000,NE 129,RESIDENTIAL,15800,0,15800,75000,0,90800
141018001900000,NE 129,RESIDENTIAL,17700,0,17700,64100,0,81800
141018002000000,NE 129,RESIDENTIAL,23600,0,23600,73300,0,96900
141018002100000,NE 129,RESIDENTIAL,19700,0,19700,68200,0,87900
141018002200000,NE 129,RESIDENTIAL,19700,0,19700,103700,0,123400
141018002300000,NE 129,RESIDENTIAL,20100,0,20100,79800,0,99900
141018002400000,NE 129,RESIDENTIAL,17700,0,17700,105000,0,122700
141018002500000,NE 129,RESIDENTIAL,17700,0,17700,78900,0,96600
141018002600000,NE 129,RESIDENTIAL,22100,0,22100,79000,0,101100
141018100100000,NE 131,RESIDENTIAL,21000,0,21000,73000,0,94000
141018100200000,NE 131,RESIDENTIAL,21000,0,21000,109300,0,130300
141018100300000,NE 131,RESIDENTIAL,14600,0,14600,91600,0,106200
141018100400000,NE 131,RESIDENTIAL,13300,0,13300,73700,0,87000
141018100500000,NE 131,RESIDENTIAL,14100,0,14100,69900,0,84000
141018100600000,NE 131,RESIDENTIAL,21000,0,21000,67300,0,88300
141018100700000,NE 131,RESIDENTIAL,21000,0,21000,107600,0,128600
141018100800000,NE 131,RESIDENTIAL,21000,0,21000,80000,0,101000
141018100900000,NE 131,RESIDENTIAL,21000,0,21000,43100,0,64100
141018101000000,NE 131,RESIDENTIAL,14000,0,14000,67500,0,81500
141018101100000,NE 131,RESIDENTIAL,14000,0,14000,61800,0,75800
141018101200000,NE 131,RESIDENTIAL,17000,0,17000,58300,0,75300
141018101300000,NE 131,RESIDENTIAL,18000,0,18000,85400,0,103400
141018101400000,NE 131,RESIDENTIAL,21000,0,21000,70300,0,91300
141018101500000,NE 131,RESIDENTIAL,17500,0,17500,59700,0,77200
141018101600000,NE 131,RESIDENTIAL,17500,0,17500,69300,0,86800
141018101700000,NE 131,RESIDENTIAL,17500,0,17500,52600,0,70100
141018101800000,NE 131,RESIDENTIAL,21000,0,21000,66800,0,87800
141018101900000,NE 131,RESIDENTIAL,10500,0,10500,52100,0,62600
141020100100000,GOLF COURSE,COMMERCIAL,1796,177804,179600,70900,375000,625500
141020200100000,CONVENIENCE STORE,COMMERCIAL,0,111900,111900,0,225100,337000
141020200200000,SMALL RETAIL,COMMERCIAL,0,77000,77000,0,192900,269900
141020200300000,OFFICE,COMMERCIAL,0,136000,136000,0,484500,620500
141022600100000,OFFICE; MEDICAL,COMMERCIAL,34500,34500,69000,103750,95450,268200
141022600200000,NE 132,RESIDENTIAL,27200,0,27200,101300,0,128500
141022600300000,NE 132,RESIDENTIAL,23800,0,23800,90700,0,114500
141022600400000,NE 132,RESIDENTIAL,11200,0,11200,82200,0,93400
141022600500000,NE 132,RESIDENTIAL,24600,0,24600,60900,0,85500
141022600600000,NE 132,RESIDENTIAL,22600,0,22600,111800,0,134400
141022600700000,NE 132,RESIDENTIAL,24700,0,24700,110100,0,134800
141022600800000,NE 132,RESIDENTIAL,30600,0,30600,99000,0,129600
141022600900000,NE 132,RESIDENTIAL,27400,0,27400,95300,0,122700
141022601000000,NE 132,RESIDENTIAL,22100,0,22100,98100,0,120200
141022601100000,NE 132,RESIDENTIAL,24400,0,24400,97500,0,121900
141022601200000,NE 132,RESIDENTIAL,27200,0,27200,97400,0,124600
141022601300000,NE 132,RESIDENTIAL,25000,0,25000,120200,0,145200
141022601400000,APARTMENT,MULTI-RES,37200,0,37200,334800,0,372000
141022601500000,FLAT PARKING,COMMERCIAL,0,91500,91500,0,26800,118300
141022700100000,NE 132,RESIDENTIAL,23900,0,23900,99400,0,123300
141022700200000,NE 132,RESIDENTIAL,21800,0,21800,102300,0,124100
141022700300000,NE 132,RESIDENTIAL,19200,0,19200,120200,0,139400
141022700400000,NE 132,RESIDENTIAL,29100,0,29100,158100,0,187200
141022700500000,NE 132,RESIDENTIAL,30200,0,30200,92000,0,122200
141022700600000,NE 132,RESIDENTIAL,21800,0,21800,110500,0,132300
141022700700000,NE 132,RESIDENTIAL,18900,0,18900,81700,0,100600
141022701000000,NE 132,RESIDENTIAL,17800,0,17800,106900,0,124700
141022701100000,NE 132,RESIDENTIAL,18000,0,18000,105900,0,123900
141022701200000,NE 132,RESIDENTIAL,20200,0,20200,111800,0,132000
141022701300000,NE 132,RESIDENTIAL,18900,0,18900,109400,0,128300
141022701400000,NE 132,RESIDENTIAL,29000,0,29000,134700,0,163700
141022701500000,NE 132,RESIDENTIAL,27600,0,27600,156900,0,184500
141022701600000,NE 132,RESIDENTIAL,27600,0,27600,96400,0,124000
141022701700000,NE 132,RESIDENTIAL,27600,0,27600,119300,0,146900
141022701800000,NE 132,RESIDENTIAL,27800,0,27800,112800,0,140600
141022701900000,NE 132,RESIDENTIAL,28300,0,28300,98600,0,126900
141022702000000,NE 132,RESIDENTIAL,24400,0,24400,99700,0,124100
141022702100000,NE 132,RESIDENTIAL,25000,0,25000,85700,0,110700
141022702200000,NE 132,RESIDENTIAL,25000,0,25000,107600,0,132600
141022702300000,NE 132,RESIDENTIAL,25000,0,25000,88200,0,113200
141022702400000,NE 132,RESIDENTIAL,27900,0,27900,94500,0,122400
141022702500000,NE 132,RESIDENTIAL,27000,0,27000,109500,0,136500
141022702600000,NE 132,RESIDENTIAL,23700,0,23700,99300,0,123000
141022702700000,NE 132,RESIDENTIAL,32800,0,32800,99200,0,132000
141022800100000,NE 132,RESIDENTIAL,60800,0,60800,81100,0,141900
141022800200000,NE 132,RESIDENTIAL,20900,0,20900,85800,0,106700
141022800300000,NE 132,RESIDENTIAL,23000,0,23000,87800,0,110800
141022800400000,NE 132,RESIDENTIAL,23000,0,23000,99200,0,122200
141022800500000,NE 132,RESIDENTIAL,22300,0,22300,104000,0,126300
141022800600000,NE 132,RESIDENTIAL,22300,0,22300,80600,0,102900
141022800700000,NE 132,RESIDENTIAL,17300,0,17300,96400,0,113700
141022800800000,NE 132,RESIDENTIAL,13800,0,13800,95400,0,109200
141022900100000,NE 132,RESIDENTIAL,24100,0,24100,108100,0,132200
141022900200000,NE 132,RESIDENTIAL,24200,0,24200,113100,0,137300
141022900300000,NE 132,RESIDENTIAL,22600,0,22600,101500,0,124100
141022900400000,NE 132,RESIDENTIAL,24700,0,24700,114800,0,139500
141022900500000,NE 132,RESIDENTIAL,24700,0,24700,103900,0,128600
141022900600000,NE 132,RESIDENTIAL,24900,0,24900,109700,0,134600
141022900700000,NE 132,RESIDENTIAL,24900,0,24900,105800,0,130700
141022900800000,NE 132,RESIDENTIAL,24900,0,24900,81700,0,106600
141022900900000,NE 132,RESIDENTIAL,24900,0,24900,96500,0,121400
141022901000000,NE 132,RESIDENTIAL,25100,0,25100,110000,0,135100
141022901100000,NE 132,RESIDENTIAL,25400,0,25400,86800,0,112200
141022901200000,NE 132,RESIDENTIAL,25300,0,25300,88300,0,113600
141022901300000,NE 132,RESIDENTIAL,25300,0,25300,100200,0,125500
141022901400000,NE 132,RESIDENTIAL,25300,0,25300,96700,0,122000
141022901500000,NE 132,RESIDENTIAL,25300,0,25300,99700,0,125000
141022901600000,NE 132,RESIDENTIAL,25300,0,25300,92400,0,117700
141022901700000,NE 132,RESIDENTIAL,25900,0,25900,87300,0,113200
141022901800000,NE 132,RESIDENTIAL,25200,0,25200,86100,0,111300
141022901900000,NE 132,RESIDENTIAL,25700,0,25700,107600,0,133300
141022902000000,NE 132,RESIDENTIAL,25000,0,25000,79400,0,104400
141022902100000,NE 132,RESIDENTIAL,26900,0,26900,64700,0,91600
141022902200000,NE 132,RESIDENTIAL,27800,0,27800,97800,0,125600
141023000100000,NE 132,RESIDENTIAL,25600,0,25600,118800,0,144400
141023000200000,NE 132,RESIDENTIAL,19800,0,19800,109500,0,129300
141023000300000,NE 132,RESIDENTIAL,24200,0,24200,80300,0,104500
141023000400000,NE 132,RESIDENTIAL,17600,0,17600,90800,0,108400
141023000500000,NE 132,RESIDENTIAL,17800,0,17800,89000,0,106800
141023000600000,NE 132,RESIDENTIAL,21500,0,21500,89800,0,111300
141023000700000,NE 132,RESIDENTIAL,21700,0,21700,106700,0,128400
141023000800000,NE 132,RESIDENTIAL,24400,0,24400,102800,0,127200
141023000900000,NE 132,RESIDENTIAL,18900,0,18900,94300,0,113200
141023001000000,NE 132,RESIDENTIAL,16800,0,16800,106100,0,122900
141023001100000,NE 132,RESIDENTIAL,15300,0,15300,81200,0,96500
141023100100000,NE 132,RESIDENTIAL,22800,0,22800,81100,0,103900
141023100200000,NE 132,RESIDENTIAL,23000,0,23000,74600,0,97600
141023100300000,NE 132,RESIDENTIAL,23000,0,23000,83800,0,106800
141023100400000,NE 132,RESIDENTIAL,23000,0,23000,89400,0,112400
141023100500000,NE 132,RESIDENTIAL,23000,0,23000,117600,0,140600
141023100600000,NE 132,RESIDENTIAL,24200,0,24200,96400,0,120600
141023100700000,NE 132,RESIDENTIAL,21700,0,21700,64100,0,85800
141023100800000,NE 132,RESIDENTIAL,20600,0,20600,94600,0,115200
141023100900000,NE 132,RESIDENTIAL,14100,0,14100,96800,0,110900
141023101000000,NE 132,RESIDENTIAL,14100,0,14100,58900,0,73000
141023101100000,NE 132,RESIDENTIAL,16500,0,16500,50900,0,67400
141023200100000,NE 132,RESIDENTIAL,25000,0,25000,91900,0,116900
141023200200000,NE 132,RESIDENTIAL,25000,0,25000,83800,0,108800
141023200300000,NE 132,RESIDENTIAL,24900,0,24900,95000,0,119900
141023200400000,NE 132,RESIDENTIAL,23800,0,23800,103500,0,127300
141023200500000,NE 132,RESIDENTIAL,24600,0,24600,122600,0,147200
141023200600000,NE 132,RESIDENTIAL,23000,0,23000,89200,0,112200
141023200700000,NE 132,RESIDENTIAL,24600,0,24600,94600,0,119200
141023200800000,NE 132,RESIDENTIAL,23800,0,23800,119900,0,143700
141023200900000,NE 132,RESIDENTIAL,23800,0,23800,83600,0,107400
141023201000000,NE 132,RESIDENTIAL,23800,0,23800,104800,0,128600
141023201100000,NE 132,RESIDENTIAL,23600,0,23600,89900,0,113500
141023201200000,NE 132,RESIDENTIAL,24000,0,24000,114200,0,138200
141023201300000,NE 132,RESIDENTIAL,21300,0,21300,105100,0,126400
141023201400000,NE 132,RESIDENTIAL,21300,0,21300,102200,0,123500
141023201500000,NE 132,RESIDENTIAL,21300,0,21300,98600,0,119900
141023201600000,NE 132,RESIDENTIAL,21300,0,21300,95800,0,117100
141023201700000,NE 132,RESIDENTIAL,21300,0,21300,111600,0,132900
141023201800000,NE 132,RESIDENTIAL,21300,0,21300,77100,0,98400
141023201900000,NE 132,RESIDENTIAL,21300,0,21300,96400,0,117700
141023202000000,NE 132,RESIDENTIAL,21300,0,21300,89900,0,111200
141023202100000,NE 132,RESIDENTIAL,21300,0,21300,94800,0,116100
141023202200000,NE 132,RESIDENTIAL,21300,0,21300,81800,0,103100
141023202300000,NE 132,EXEMPT,0,33000,33000,0,119600,152600
141023300100000,NE 132,RESIDENTIAL,20300,0,20300,74100,0,94400
141023300200000,NE 132,RESIDENTIAL,19700,0,19700,62800,0,82500
141023300300000,NE 132,RESIDENTIAL,21600,0,21600,83300,0,104900
141023300400000,NE 132,RESIDENTIAL,17400,0,17400,58200,0,75600
141023400100000,NE 132,RESIDENTIAL,19800,0,19800,63600,0,83400
141023400200000,NE 132,RESIDENTIAL,26400,0,26400,83800,0,110200
141023400300000,NE 132,RESIDENTIAL,22300,0,22300,82900,0,105200
141023400400000,NE 132,RESIDENTIAL,29600,0,29600,96600,0,126200
141023400500000,NE 132,RESIDENTIAL,23300,0,23300,79900,0,103200
141023400600000,NE 132,RESIDENTIAL,23200,0,23200,147300,0,170500
141023400700000,NE 132,RESIDENTIAL,25200,0,25200,88500,0,113700
141023400800000,NE 132,RESIDENTIAL,22600,0,22600,88700,0,111300
141023400900000,NE 132,RESIDENTIAL,22600,0,22600,98700,0,121300
141023401000000,NE 132,RESIDENTIAL,22600,0,22600,78700,0,101300
141023401100000,NE 132,RESIDENTIAL,25100,0,25100,106200,0,131300
141023401200000,NE 132,RESIDENTIAL,21800,0,21800,94600,0,116400
141025100100000,GOLF COURSE,COMMERCIAL,0,25500,25500,0,39900,65400
141025100200000,NE 132,RESIDENTIAL,20900,0,20900,79700,0,100600
141025100300000,NE 132,RESIDENTIAL,17200,0,17200,71200,0,88400
141025100400000,NE 132,RESIDENTIAL,22200,0,22200,69000,0,91200
141025100500000,NE 132,RESIDENTIAL,23100,0,23100,71200,0,94300
141025100600000,NE 132,RESIDENTIAL,20400,0,20400,73500,0,93900
141025100700000,NE 132,RESIDENTIAL,20200,0,20200,68800,0,89000
141025100800000,NE 132,RESIDENTIAL,21800,0,21800,81900,0,103700
141025100900000,NE 132,RESIDENTIAL,21800,0,21800,74500,0,96300
141025101000000,NE 132,EXEMPT,0,32700,32700,0,52700,85400
141025101100000,NE 132,RESIDENTIAL,21800,0,21800,83000,0,104800
141025101200000,NE 132,RESIDENTIAL,22200,0,22200,74000,0,96200
141025101300000,NE 132,RESIDENTIAL,21800,0,21800,93500,0,115300
141025101400000,NE 132,RESIDENTIAL,22200,0,22200,73400,0,95600
141025101500000,NE 132,RESIDENTIAL,21100,0,21100,58500,0,79600
141025101600000,NE 131,RESIDENTIAL,17800,0,17800,71300,0,89100
141025101700000,NE 131,RESIDENTIAL,17800,0,17800,73300,0,91100
141025101800000,NE 131,RESIDENTIAL,20200,0,20200,78400,0,98600
141025200100000,NE 132,RESIDENTIAL,15000,0,15000,76600,0,91600
141025200200000,NE 132,RESIDENTIAL,16500,0,16500,51600,0,68100
141025200300000,NE 132,RESIDENTIAL,16500,0,16500,51500,0,68000
141025200400000,NE 132,RESIDENTIAL,16500,0,16500,53000,0,69500
141025200500000,NE 132,RESIDENTIAL,16500,0,16500,63500,0,80000
141025200600000,NE 132,RESIDENTIAL,16500,0,16500,57400,0,73900
141025200700000,NE 132,RESIDENTIAL,16500,0,16500,53600,0,70100
141025200800000,NE 132,RESIDENTIAL,16500,0,16500,55400,0,71900
141025200900000,NE 132,RESIDENTIAL,16500,0,16500,51400,0,67900
141025201000000,NE 132,RESIDENTIAL,16500,0,16500,41500,0,58000
141025201100000,NE 132,RESIDENTIAL,16500,0,16500,55500,0,72000
141025201200000,NE 132,RESIDENTIAL,17100,0,17100,77500,0,94600
141025201300000,NE 132,RESIDENTIAL,21600,0,21600,76200,0,97800
141025201400000,NE 132,RESIDENTIAL,19700,0,19700,63000,0,82700
141025201500000,NE 132,RESIDENTIAL,20300,0,20300,76700,0,97000
141025201600000,NE 132,RESIDENTIAL,15000,0,15000,49000,0,64000
141025201700000,NE 132,RESIDENTIAL,15000,0,15000,53900,0,68900
141025201800000,NE 132,RESIDENTIAL,15000,0,15000,86500,0,101500
141025201900000,NE 132,RESIDENTIAL,15000,0,15000,95400,0,110400
141025202000000,NE 132,RESIDENTIAL,15000,0,15000,76200,0,91200
141025202100000,NE 132,RESIDENTIAL,16300,0,16300,50200,0,66500
141025202200000,NE 132,RESIDENTIAL,15000,0,15000,74700,0,89700
141025202300000,NE 132,RESIDENTIAL,15000,0,15000,58900,0,73900
141025202400000,NE 132,RESIDENTIAL,15000,0,15000,59800,0,74800
141025202500000,NE 132,RESIDENTIAL,15000,0,15000,69800,0,84800
141025300100000,NE 132,RESIDENTIAL,16900,0,16900,61300,0,78200
141025300200000,NE 132,RESIDENTIAL,27100,0,27100,86200,0,113300
141025300300000,NE 132,RESIDENTIAL,23900,0,23900,105600,0,129500
141025300400000,NE 132,RESIDENTIAL,18300,0,18300,64300,0,82600
141025300500000,NE 132,RESIDENTIAL,18300,0,18300,68500,0,86800
141025300600000,NE 132,RESIDENTIAL,16900,0,16900,50900,0,67800
141025300700000,NE 132,RESIDENTIAL,20500,0,20500,67200,0,87700
141025300800000,NE 132,RESIDENTIAL,19500,0,19500,39700,0,59200
141025300900000,NE 132,RESIDENTIAL,21100,0,21100,73200,0,94300
141025301000000,NE 132,RESIDENTIAL,18500,0,18500,68100,0,86600
141025301100000,NE 132,RESIDENTIAL,16800,0,16800,50900,0,67700
141025301200000,NE 132,RESIDENTIAL,16900,0,16900,56800,0,73700
141025400100000,NE 132,RESIDENTIAL,16600,0,16600,65900,0,82500
141025400200000,NE 132,RESIDENTIAL,19000,0,19000,64300,0,83300
141025400300000,NE 132,RESIDENTIAL,16000,0,16000,44200,0,60200
141025400400000,NE 132,RESIDENTIAL,17500,0,17500,50700,0,68200
141025400500000,NE 132,RESIDENTIAL,17500,0,17500,51000,0,68500
141025400600000,NE 132,RESIDENTIAL,17500,0,17500,73900,0,91400
141025400700000,NE 132,RESIDENTIAL,17500,0,17500,53000,0,70500
141025400800000,NE 132,RESIDENTIAL,17500,0,17500,51700,0,69200
141025400900000,NE 132,RESIDENTIAL,18700,0,18700,112200,0,130900
141025401000000,NE 132,RESIDENTIAL,22800,0,22800,110000,0,132800
141025401100000,NE 132,RESIDENTIAL,17500,0,17500,117700,0,135200
141025401200000,NE 132,RESIDENTIAL,16000,0,16000,144900,0,160900
141025401300000,NE 132,RESIDENTIAL,17500,0,17500,89900,0,107400
141025401400000,NE 132,RESIDENTIAL,17500,0,17500,117300,0,134800
141025401500000,NE 132,RESIDENTIAL,18300,0,18300,90900,0,109200
141025401600000,NE 132,RESIDENTIAL,17500,0,17500,77800,0,95300
141025401700000,NE 132,RESIDENTIAL,16900,0,16900,82100,0,99000
141025500100000,NE 132,RESIDENTIAL,24000,0,24000,90200,0,114200
141025500200000,NE 132,RESIDENTIAL,24000,0,24000,62500,0,86500
141025500300000,NE 132,RESIDENTIAL,22100,0,22100,82100,0,104200
141025500400000,NE 132,RESIDENTIAL,22800,0,22800,69400,0,92200
141025500500000,NE 132,RESIDENTIAL,24300,0,24300,72300,0,96600
141025500600000,NE 132,RESIDENTIAL,14600,0,14600,52300,0,66900
141025500700000,NE 132,RESIDENTIAL,15800,0,15800,68800,0,84600
141025500800000,NE 132,RESIDENTIAL,15200,0,15200,59000,0,74200
141025500900000,NE 132,RESIDENTIAL,15100,0,15100,91800,0,106900
141025501000000,NE 132,RESIDENTIAL,14600,0,14600,53100,0,67700
141025501100000,NE 132,RESIDENTIAL,14600,0,14600,102700,0,117300
141025501200000,NE 132,RESIDENTIAL,15200,0,15200,52200,0,67400
141025501300000,NE 132,RESIDENTIAL,16900,0,16900,69100,0,86000
141025501400000,NE 131,RESIDENTIAL,21300,0,21300,91100,0,112400
141025501500000,NE 131,RESIDENTIAL,17800,0,17800,89300,0,107100
141025501600000,NE 131,RESIDENTIAL,17800,0,17800,71400,0,89200
141025501700000,NE 131,RESIDENTIAL,17800,0,17800,80200,0,98000
141025501800000,NE 131,RESIDENTIAL,17800,0,17800,73800,0,91600
141025501900000,NE 131,RESIDENTIAL,17800,0,17800,65100,0,82900
141025502000000,NE 131,RESIDENTIAL,17800,0,17800,69100,0,86900
141025502100000,NE 131,RESIDENTIAL,17800,0,17800,75800,0,93600
141025502200000,NE 131,RESIDENTIAL,17800,0,17800,90100,0,107900
141025502300000,NE 131,RESIDENTIAL,17800,0,17800,91800,0,109600
141025502400000,NE 132,RESIDENTIAL,18400,0,18400,53100,0,71500
141025502500000,NE 132,RESIDENTIAL,20000,0,20000,94300,0,114300
141025502600000,NE 132,RESIDENTIAL,24100,0,24100,66300,0,90400
141025502700000,NE 132,RESIDENTIAL,20000,0,20000,67200,0,87200
141025502800000,NE 132,RESIDENTIAL,19300,0,19300,51100,0,70400
141025502900000,NE 132,RESIDENTIAL,18000,0,18000,56800,0,74800
141025503000000,NE 132,RESIDENTIAL,20300,0,20300,51700,0,72000
141025503100000,NE 132,RESIDENTIAL,22500,0,22500,62300,0,84800
141025503200000,NE 132,RESIDENTIAL,19500,0,19500,56400,0,75900
141025503300000,NE 132,RESIDENTIAL,20000,0,20000,69400,0,89400
141025503400000,NE 132,RESIDENTIAL,24900,0,24900,49800,0,74700
141025600100000,NE 132,RESIDENTIAL,20000,0,20000,109300,0,129300
141025600200000,NE 132,RESIDENTIAL,19100,0,19100,51100,0,70200
141025600300000,NE 132,RESIDENTIAL,19700,0,19700,69500,0,89200
141025600400000,NE 132,RESIDENTIAL,16700,0,16700,53300,0,70000
141025600500000,NE 132,RESIDENTIAL,17400,0,17400,63900,0,81300
141025600600000,NE 132,RESIDENTIAL,18600,0,18600,78000,0,96600
141025600700000,NE 132,RESIDENTIAL,19100,0,19100,43700,0,62800
141025600800000,NE 132,RESIDENTIAL,17800,0,17800,72900,0,90700
141025600900000,NE 132,RESIDENTIAL,17300,0,17300,53300,0,70600
141025601000000,NE 132,RESIDENTIAL,20000,0,20000,65600,0,85600
141025601100000,NE 132,RESIDENTIAL,16900,0,16900,116000,0,132900
141025601200000,NE 132,RESIDENTIAL,18300,0,18300,102300,0,120600
141025601300000,NE 132,RESIDENTIAL,18600,0,18600,87200,0,105800
141025601400000,NE 132,RESIDENTIAL,21100,0,21100,123700,0,144800
141025601500000,NE 132,RESIDENTIAL,16500,0,16500,86700,0,103200
141025601600000,NE 132,RESIDENTIAL,18200,0,18200,104800,0,123000
141025601700000,NE 132,RESIDENTIAL,20900,0,20900,121800,0,142700
141025601800000,DAY CARE CENTER,COMMERCIAL,0,33800,33800,0,118000,151800
141025601900000,NE 132,RESIDENTIAL,18300,0,18300,104700,0,123000
141025602000000,NE 132,RESIDENTIAL,17200,0,17200,105300,0,122500
141025602100000,NE 132,RESIDENTIAL,17000,0,17000,77600,0,94600
141025602200000,NE 132,RESIDENTIAL,17600,0,17600,76500,0,94100
141025602300000,NE 132,RESIDENTIAL,17200,0,17200,71000,0,88200
141025700100000,NE 132,RESIDENTIAL,19700,0,19700,69500,0,89200
141025700200000,NE 132,RESIDENTIAL,18600,0,18600,62700,0,81300
141025700300000,NE 132,RESIDENTIAL,21600,0,21600,112900,0,134500
141025700400000,NE 132,RESIDENTIAL,20300,0,20300,138600,0,158900
141025700500000,NE 132,RESIDENTIAL,22700,0,22700,89000,0,111700
141025700600000,NE 132,RESIDENTIAL,29000,0,29000,194900,0,223900
141025700700000,NE 132,RESIDENTIAL,26400,0,26400,137600,0,164000
141025700800000,NE 132,RESIDENTIAL,20500,0,20500,53800,0,74300
141025700900000,NE 132,RESIDENTIAL,17300,0,17300,67300,0,84600
141025701000000,NE 132,RESIDENTIAL,18500,0,18500,91600,0,110100
141025701100000,NE 132,RESIDENTIAL,20100,0,20100,73400,0,93500
141027600100000,GOLF COURSE,COMMERCIAL,0,463300,463300,0,2993000,3456300
141027600200000,NE 131,RESIDENTIAL,14900,0,14900,66100,0,81000
141027600300000,NE 131,RESIDENTIAL,14900,0,14900,93200,0,108100
141027600400000,NE 131,RESIDENTIAL,19300,0,19300,103200,0,122500
141027600500000,NE 131,RESIDENTIAL,19300,0,19300,93800,0,113100
141027600600000,NE 131,RESIDENTIAL,19300,0,19300,123000,0,142300
141027600700000,NE 131,RESIDENTIAL,19000,0,19000,101700,0,120700
141027600800000,NE 131,RESIDENTIAL,17800,0,17800,113000,0,130800
141027600900000,NE 131,RESIDENTIAL,17800,0,17800,90500,0,108300
141027601000000,NE 131,RESIDENTIAL,23200,0,23200,114500,0,137700
141027601100000,NE 131,RESIDENTIAL,20200,0,20200,83400,0,103600
141027601200000,NE 131,RESIDENTIAL,22300,0,22300,122700,0,145000
141027601300000,NE 131,RESIDENTIAL,17800,0,17800,80700,0,98500
141027601400000,NE 131,RESIDENTIAL,17800,0,17800,83600,0,101400
141027601500000,NE 131,RESIDENTIAL,17800,0,17800,86900,0,104700
141027601600000,NE 131,RESIDENTIAL,17800,0,17800,65900,0,83700
141027601700000,NE 131,RESIDENTIAL,17800,0,17800,52600,0,70400
141027601800000,NE 131,RESIDENTIAL,17800,0,17800,77300,0,95100
141027601900000,NE 131,RESIDENTIAL,18400,0,18400,64900,0,83300
141030100100000,NE 131,RESIDENTIAL,14900,0,14900,55600,0,70500
141030100200000,NE 131,RESIDENTIAL,13600,0,13600,66200,0,79800
141030100300000,NE 131,RESIDENTIAL,21100,0,21100,69900,0,91000
141030100400000,NE 131,RESIDENTIAL,16100,0,16100,56300,0,72400
141030100500000,NE 131,RESIDENTIAL,16400,0,16400,63300,0,79700
141030100600000,NE 131,RESIDENTIAL,17000,0,17000,91200,0,108200
141030100700000,NE 131,RESIDENTIAL,23300,0,23300,62900,0,86200
141030100800000,NE 131,RESIDENTIAL,24200,0,24200,83900,0,108100
141030100900000,NE 131,RESIDENTIAL,24200,0,24200,54600,0,78800
141030101000000,NE 131,RESIDENTIAL,24200,0,24200,36400,0,60600
141030101100000,NE 131,RESIDENTIAL,23800,0,23800,81900,0,105700
141030101200000,NE 131,RESIDENTIAL,24200,0,24200,79100,0,103300
141030101300000,NE 131,RESIDENTIAL,24200,0,24200,111600,0,135800
141030101400000,NE 131,RESIDENTIAL,24200,0,24200,106600,0,130800
141030101500000,NE 131,RESIDENTIAL,26300,0,26300,146800,0,173100
141030101600000,NE 131,RESIDENTIAL,24000,0,24000,100300,0,124300
141030101700000,NE 131,RESIDENTIAL,26300,0,26300,46300,0,72600
141030101800000,NE 131,RESIDENTIAL,26300,0,26300,71400,0,97700
141030101900000,NE 131,RESIDENTIAL,26300,0,26300,60700,0,87000
141030102000000,NE 131,RESIDENTIAL,26800,0,26800,32000,0,58800
141030102100000,NE 131,RESIDENTIAL,26000,0,26000,74400,0,100400
141030102200000,NE 131,RESIDENTIAL,26000,0,26000,96800,0,122800
141030102300000,NE 131,RESIDENTIAL,28000,0,28000,107400,0,135400
141030102400000,NE 131,RESIDENTIAL,26600,0,26600,73300,0,99900
141030102500000,NE 131,RESIDENTIAL,15100,0,15100,76200,0,91300
141030102600000,NE 131,RESIDENTIAL,17700,0,17700,90800,0,108500
141030102700000,NE 131,RESIDENTIAL,17400,0,17400,72300,0,89700
141030102800000,NE 131,RESIDENTIAL,28100,0,28100,110600,0,138700
141030102900000,NE 131,RESIDENTIAL,17100,0,17100,80300,0,97400
141030103000000,NE 131,RESIDENTIAL,15700,0,15700,101500,0,117200
141030103100000,NE 131,RESIDENTIAL,19700,0,19700,76800,0,96500
141030103200000,NE 131,RESIDENTIAL,14400,0,14400,36800,0,51200
141030103300000,NE 131,RESIDENTIAL,14400,0,14400,46400,0,60800
141030200100000,NE 131,RESIDENTIAL,24200,0,24200,122300,0,146500
141030200200000,NE 131,RESIDENTIAL,24200,0,24200,84700,0,108900
141030200300000,NE 131,RESIDENTIAL,17700,0,17700,87100,0,104800
141030200400000,NE 131,RESIDENTIAL,26300,0,26300,79400,0,105700
141030300100000,CENTRALLY ASSESSED,OTHER,0,0,0,0,0,0
141030300200000,NE 131,RESIDENTIAL,13000,0,13000,44900,0,57900
141030300300000,NE 131,RESIDENTIAL,19500,0,19500,79200,0,98700
141030300400000,NE 131,RESIDENTIAL,26000,0,26000,42800,0,68800
141030300500000,NE 131,RESIDENTIAL,26000,0,26000,100500,0,126500
141030300600000,NE 131,RESIDENTIAL,26000,0,26000,111600,0,137600
141030300700000,NE 131,RESIDENTIAL,26000,0,26000,81300,0,107300
141030300800000,NE 131,RESIDENTIAL,26000,0,26000,54800,0,80800
141030300900000,NE 131,RESIDENTIAL,26000,0,26000,87300,0,113300
141030301000000,NE 131,RESIDENTIAL,27000,0,27000,70600,0,97600
141030301200000,NE 131,RESIDENTIAL,23200,0,23200,52300,0,75500
141030301300000,NE 131,RESIDENTIAL,26500,0,26500,92000,0,118500
141030301400000,NE 131,RESIDENTIAL,26000,0,26000,138300,0,164300
141030301500000,DAY CARE CENTER,COMMERCIAL,0,44800,44800,0,128800,173600
141030301600000,NE 131,RESIDENTIAL,26000,0,26000,100000,0,126000
141030301700000,NE 131,RESIDENTIAL,25500,0,25500,95200,0,120700
141030301800000,NE 131,RESIDENTIAL,24700,0,24700,110900,0,135600
141030301900000,NE 131,RESIDENTIAL,26000,0,26000,100800,0,126800
141030302000000,NE 131,RESIDENTIAL,26000,0,26000,98300,0,124300
141030302100000,NE 131,RESIDENTIAL,26000,0,26000,99300,0,125300
141030302200000,NE 131,RESIDENTIAL,26000,0,26000,91600,0,117600
141030302300000,NE 131,RESIDENTIAL,19500,0,19500,92100,0,111600
141030302400000,NE 131,RESIDENTIAL,19500,0,19500,80900,0,100400
141030302500000,NE 131,RESIDENTIAL,13000,0,13000,49600,0,62600
141030302600000,NE 131,RESIDENTIAL,19500,0,19500,76600,0,96100
141030302700000,NE 131,RESIDENTIAL,29000,0,29000,86100,0,115100
141030302800000,NE 131,RESIDENTIAL,15900,0,15900,118600,0,134500
141030302900000,NE 131,RESIDENTIAL,15900,0,15900,125300,0,141200
141030400100000,NE 131,RESIDENTIAL,17300,0,17300,56100,0,73400
141030400200000,NE 131,RESIDENTIAL,26500,0,26500,62500,0,89000
141030400300000,NE 131,RESIDENTIAL,25500,0,25500,89000,0,114500
141030400400000,NE 131,RESIDENTIAL,17300,0,17300,34800,0,52100
141030400500000,NE 131,RESIDENTIAL,17300,0,17300,53000,0,70300
141030400600000,NE 131,RESIDENTIAL,17300,0,17300,45700,0,63000
141030500100000,NE 131,RESIDENTIAL,17300,0,17300,73600,0,90900
141030500200000,NE 131,RESIDENTIAL,22800,0,22800,200600,0,223400
141030500300000,NE 131,RESIDENTIAL,16300,0,16300,62900,0,79200
141030500400000,NE 131,RESIDENTIAL,13000,0,13000,79600,0,92600
141030500500000,NE 131,RESIDENTIAL,16800,0,16800,83300,0,100100
141030500600000,NE 131,RESIDENTIAL,16800,0,16800,89000,0,105800
141030500700000,NE 131,RESIDENTIAL,16300,0,16300,101400,0,117700
141030500800000,NE 131,EXEMPT,0,25500,25500,0,104600,130100
141030500900000,NE 131,RESIDENTIAL,19100,0,19100,96900,0,116000
141030501000000,NE 131,RESIDENTIAL,19100,0,19100,97000,0,116100
141030501100000,NE 131,RESIDENTIAL,19100,0,19100,86200,0,105300
141030501200000,NE 131,RESIDENTIAL,19100,0,19100,79600,0,98700
141030501300000,NE 131,RESIDENTIAL,19500,0,19500,114100,0,133600
141030501400000,NE 131,RESIDENTIAL,16100,0,16100,78800,0,94900
141030501500000,NE 131,RESIDENTIAL,15900,0,15900,72200,0,88100
141030501600000,NE 131,RESIDENTIAL,22900,0,22900,92600,0,115500
141030501700000,NE 131,RESIDENTIAL,26000,0,26000,73200,0,99200
141030501800000,NE 131,RESIDENTIAL,28100,0,28100,55300,0,83400
141030501900000,NE 131,RESIDENTIAL,22900,0,22900,59900,0,82800
141030502000000,NE 131,RESIDENTIAL,26000,0,26000,57400,0,83400
141030502100000,NE 131,RESIDENTIAL,14000,0,14000,54100,0,68100
141030502200000,NE 131,RESIDENTIAL,14000,0,14000,41700,0,55700
141030502300000,NE 131,RESIDENTIAL,26500,0,26500,82600,0,109100
141030502400000,NE 131,RESIDENTIAL,26000,0,26000,63500,0,89500
141030502500000,NE 131,RESIDENTIAL,26500,0,26500,123100,0,149600
141030502600000,NE 131,RESIDENTIAL,26500,0,26500,99600,0,126100
141030502700000,NE 131,RESIDENTIAL,13300,0,13300,57100,0,70400
141030502800000,NE 131,RESIDENTIAL,13300,0,13300,43200,0,56500
141030502900000,NE 131,RESIDENTIAL,26500,0,26500,93900,0,120400
141030503000000,NE 131,RESIDENTIAL,16300,0,16300,100000,0,116300
141030503100000,NE 131,RESIDENTIAL,30000,0,30000,81200,0,111200
141030503200000,NE 131,RESIDENTIAL,13000,0,13000,30300,0,43300
141030503300000,NE 131,RESIDENTIAL,13000,0,13000,49500,0,62500
141030503400000,NE 131,RESIDENTIAL,26000,0,26000,64900,0,90900
141030503500000,NE 131,RESIDENTIAL,17300,0,17300,60100,0,77400
141030503600000,NE 131,RESIDENTIAL,17300,0,17300,29900,0,47200
141030503700000,NE 131,RESIDENTIAL,17300,0,17300,31000,0,48300
141030600100000,NE 131,RESIDENTIAL,24700,0,24700,97100,0,121800
141030600200000,NE 131,RESIDENTIAL,16900,0,16900,80000,0,96900
141030600300000,NE 131,RESIDENTIAL,15600,0,15600,30400,0,46000
141030600400000,NE 131,RESIDENTIAL,26000,0,26000,37600,0,63600
141030700100000,NE 131,RESIDENTIAL,18400,0,18400,69900,0,88300
141030700200000,NE 131,RESIDENTIAL,16600,0,16600,88400,0,105000
141030700300000,NE 131,RESIDENTIAL,26500,0,26500,116000,0,142500
141030700400000,NE 131,RESIDENTIAL,26500,0,26500,88200,0,114700
141030700500000,NE 131,RESIDENTIAL,26500,0,26500,117400,0,143900
141030700600000,NE 131,RESIDENTIAL,19900,0,19900,63700,0,83600
141030700700000,NE 131,RESIDENTIAL,19900,0,19900,58700,0,78600
141030700800000,NE 131,RESIDENTIAL,27300,0,27300,98600,0,125900
141030700900000,NE 131,RESIDENTIAL,14300,0,14300,122400,0,136700
141030701000000,NE 131,RESIDENTIAL,12200,0,12200,16100,0,28300
141030701100000,NE 131,RESIDENTIAL,12200,0,12200,66400,0,78600
141030701200000,NE 131,RESIDENTIAL,24500,0,24500,51200,0,75700
141030701300000,NE 131,RESIDENTIAL,24500,0,24500,51100,0,75600
141030701400000,NE 131,RESIDENTIAL,24500,0,24500,81400,0,105900
141030701500000,NE 131,RESIDENTIAL,24500,0,24500,64700,0,89200
141030701600000,NE 131,RESIDENTIAL,15300,0,15300,142100,0,157400
141030701700000,NE 131,RESIDENTIAL,17400,0,17400,94200,0,111600
141030701800000,NE 131,RESIDENTIAL,17900,0,17900,88500,0,106400
141030701900000,NE 131,RESIDENTIAL,17900,0,17900,91500,0,109400
141030702000000,NE 131,RESIDENTIAL,17900,0,17900,93500,0,111400
141030800100000,NE 131,RESIDENTIAL,26500,0,26500,82700,0,109200
141030800200000,NE 131,RESIDENTIAL,17700,0,17700,46400,0,64100
141030800300000,NE 131,RESIDENTIAL,13300,0,13300,46600,0,59900
141030800400000,NE 131,RESIDENTIAL,26500,0,26500,55300,0,81800
141030800500000,NE 131,RESIDENTIAL,26500,0,26500,74000,0,100500
141030800600000,NE 131,RESIDENTIAL,13300,0,13300,51800,0,65100
141030800700000,NE 131,RESIDENTIAL,13300,0,13300,21500,0,34800
141030800800000,NE 131,RESIDENTIAL,13300,0,13300,17400,0,30700
141030800900000,NE 131,RESIDENTIAL,12200,0,12200,37500,0,49700
141030801000000,NE 131,RESIDENTIAL,12200,0,12200,74100,0,86300
141030801100000,NE 131,RESIDENTIAL,12200,0,12200,39800,0,52000
141030801200000,NE 131,RESIDENTIAL,12200,0,12200,48000,0,60200
141030801300000,NE 131,RESIDENTIAL,12200,0,12200,48900,0,61100
141030801400000,NE 131,RESIDENTIAL,12200,0,12200,25400,0,37600
141030801500000,NE 131,RESIDENTIAL,12200,0,12200,59700,0,71900
141030801600000,NE 131,RESIDENTIAL,12200,0,12200,46400,0,58600
141030801700000,NE 131,RESIDENTIAL,16300,0,16300,59400,0,75700
141030801800000,NE 131,RESIDENTIAL,24500,0,24500,79400,0,103900
141030900100000,NE 131,RESIDENTIAL,13300,0,13300,45100,0,58400
141030900200000,NE 131,RESIDENTIAL,13300,0,13300,49100,0,62400
141030900300000,NE 131,RESIDENTIAL,24700,0,24700,119900,0,144600
141030900400000,NE 131,RESIDENTIAL,25900,0,25900,50300,0,76200
141030900500000,NE 131,RESIDENTIAL,12200,0,12200,76300,0,88500
141030900600000,NE 131,RESIDENTIAL,12200,0,12200,66000,0,78200
141032600100000,NE 131,RESIDENTIAL,24200,0,24200,108500,0,132700
141032600200000,NE 131,RESIDENTIAL,24000,0,24000,103100,0,127100
141032600300000,NE 131,RESIDENTIAL,24200,0,24200,103800,0,128000
141032600400000,NE 131,RESIDENTIAL,24000,0,24000,109600,0,133600
141032600500000,NE 131,RESIDENTIAL,23800,0,23800,100200,0,124000
141032600600000,NE 131,RESIDENTIAL,24500,0,24500,87000,0,111500
141032600700000,NE 131,RESIDENTIAL,24500,0,24500,85300,0,109800
141032600800000,NE 131,RESIDENTIAL,24500,0,24500,86600,0,111100
141032600900000,NE 131,RESIDENTIAL,22600,0,22600,55300,0,77900
141032601000000,NE 131,RESIDENTIAL,18200,0,18200,52300,0,70500
141032601100000,NE 131,RESIDENTIAL,18500,0,18500,53800,0,72300
141032601200000,VACANT LAND,EXEMPT,0,66100,66100,0,0,66100
141032601300000,CHURCH,EXEMPT,0,29400,29400,0,60500,89900
141032601400000,NE 131,RESIDENTIAL,17700,0,17700,64100,0,81800
141032601500000,NE 131,RESIDENTIAL,26000,0,26000,97200,0,123200
141032601600000,NE 131,RESIDENTIAL,26700,0,26700,52900,0,79600
141032601700000,NE 131,RESIDENTIAL,14300,0,14300,76600,0,90900
141032601800000,NE 131,RESIDENTIAL,14300,0,14300,73300,0,87600
141032601900000,NE 131,RESIDENTIAL,26000,0,26000,74400,0,100400
141032602000000,NE 131,RESIDENTIAL,26000,0,26000,70100,0,96100
141032602100000,NE 131,RESIDENTIAL,26000,0,26000,103400,0,129400
141032602200000,NE 131,RESIDENTIAL,26800,0,26800,102100,0,128900
141032602300000,NE 131,RESIDENTIAL,16400,0,16400,63700,0,80100
141032602400000,NE 131,RESIDENTIAL,19700,0,19700,126300,0,146000
141032602500000,NE 131,RESIDENTIAL,16400,0,16400,54200,0,70600
141032602600000,NE 131,RESIDENTIAL,26500,0,26500,65700,0,92200
141032602700000,NE 131,RESIDENTIAL,17400,0,17400,67500,0,84900
141032602800000,NE 131,RESIDENTIAL,17400,0,17400,75500,0,92900
141032700100000,NE 131,RESIDENTIAL,14400,0,14400,71200,0,85600
141032700200000,NE 132,RESIDENTIAL,21100,0,21100,117900,0,139000
141032700300000,NE 131,RESIDENTIAL,16900,0,16900,61600,0,78500
141032700400000,NE 131,RESIDENTIAL,16200,0,16200,103300,0,119500
141032700500000,NE 131,RESIDENTIAL,16200,0,16200,61200,0,77400
141032700600000,NE 131,RESIDENTIAL,14800,0,14800,40800,0,55600
141032700700000,NE 131,RESIDENTIAL,13200,0,13200,89800,0,103000
141032700800000,NE 131,RESIDENTIAL,14300,0,14300,83900,0,98200
141032800100000,NE 131,RESIDENTIAL,26000,0,26000,92400,0,118400
141032800200000,NE 131,RESIDENTIAL,27600,0,27600,57100,0,84700
141032800300000,NE 131,RESIDENTIAL,24400,0,24400,30100,0,54500
141032800400000,NE 131,RESIDENTIAL,17200,0,17200,87400,0,104600
141032800500000,NE 131,RESIDENTIAL,17200,0,17200,87000,0,104200
141032800600000,NE 131,RESIDENTIAL,17600,0,17600,69000,0,86600
141032800700000,NE 131,RESIDENTIAL,26000,0,26000,81200,0,107200
141032800800000,NE 131,RESIDENTIAL,26000,0,26000,88600,0,114600
141032800900000,NE 131,RESIDENTIAL,26000,0,26000,90600,0,116600
141032801000000,NE 131,RESIDENTIAL,26000,0,26000,113200,0,139200
141032801100000,NE 131,RESIDENTIAL,13300,0,13300,52400,0,65700
141032801200000,NE 131,RESIDENTIAL,13300,0,13300,74400,0,87700
141032801300000,NE 131,RESIDENTIAL,27000,0,27000,88700,0,115700
141032801400000,NE 131,RESIDENTIAL,20000,0,20000,0,0,20000
141032801500000,NE 131,RESIDENTIAL,16100,0,16100,76400,0,92500
141032801600000,NE 131,RESIDENTIAL,21200,0,21200,77400,0,98600
141032801700000,NE 131,RESIDENTIAL,18900,0,18900,102000,0,120900
141032801800000,NE 131,RESIDENTIAL,20700,0,20700,65500,0,86200
141032801900000,NE 131,RESIDENTIAL,25000,0,25000,106100,0,131100
141032802000000,NE 131,RESIDENTIAL,25500,0,25500,106200,0,131700
141032802100000,NE 131,RESIDENTIAL,13000,0,13000,78200,0,91200
141032802200000,NE 131,RESIDENTIAL,19500,0,19500,71900,0,91400
141032802300000,NE 131,RESIDENTIAL,19500,0,19500,65200,0,84700
141032802400000,NE 131,RESIDENTIAL,26000,0,26000,56900,0,82900
141032802500000,NE 131,RESIDENTIAL,26000,0,26000,89200,0,115200
141032802600000,NE 131,RESIDENTIAL,17600,0,17600,105500,0,123100
141032802700000,NE 131,RESIDENTIAL,17200,0,17200,93000,0,110200
141032802800000,NE 131,RESIDENTIAL,17200,0,17200,79000,0,96200
141032802900000,NE 131,RESIDENTIAL,19500,0,19500,92000,0,111500
141032803000000,NE 131,RESIDENTIAL,19500,0,19500,97200,0,116700
141032803100000,NE 131,RESIDENTIAL,19500,0,19500,112900,0,132400
141032803200000,NE 131,RESIDENTIAL,19500,0,19500,82700,0,102200
141032900100000,NE 131,RESIDENTIAL,15800,0,15800,65300,0,81100
141032900200000,NE 131,RESIDENTIAL,12700,0,12700,96500,0,109200
141032900300000,NE 131,RESIDENTIAL,12200,0,12200,87200,0,99400
141032900400000,NE 131,RESIDENTIAL,13000,0,13000,52200,0,65200
141032900500000,NE 131,RESIDENTIAL,12600,0,12600,0,0,12600
141032900600000,OFFICE,COMMERCIAL,0,147000,147000,0,619100,766100
141033000100000,NE 131,RESIDENTIAL,16900,0,16900,104900,0,121800
141033000200000,NE 131,RESIDENTIAL,19500,0,19500,114600,0,134100
141033000300000,NE 131,RESIDENTIAL,19500,0,19500,107200,0,126700
141033000400000,NE 131,RESIDENTIAL,16000,0,16000,84900,0,100900
141033000500000,NE 131,RESIDENTIAL,15800,0,15800,53500,0,69300
141033000600000,NE 131,RESIDENTIAL,21400,0,21400,76100,0,97500
141033000700000,NE 131,RESIDENTIAL,20500,0,20500,70700,0,91200
141033000800000,NE 131,RESIDENTIAL,15400,0,15400,70700,0,86100
141033000900000,NE 131,RESIDENTIAL,19500,0,19500,83400,0,102900
141033001000000,NE 131,RESIDENTIAL,26000,0,26000,79700,0,105700
141033001100000,NE 131,RESIDENTIAL,26000,0,26000,104100,0,130100
141033001200000,NE 131,RESIDENTIAL,25500,0,25500,108200,0,133700
141033001300000,NE 131,RESIDENTIAL,26000,0,26000,111600,0,137600
141033001400000,NE 131,RESIDENTIAL,26000,0,26000,85400,0,111400
141033001500000,NE 131,RESIDENTIAL,24400,0,24400,19800,0,44200
141033001600000,NE 131,RESIDENTIAL,18000,0,18000,54800,0,72800
141033001700000,NE 131,RESIDENTIAL,21400,0,21400,40500,0,61900
141033001800000,APARTMENT,RESIDENTIAL,25700,0,25700,388300,0,414000
141033001900000,APARTMENT,RESIDENTIAL,19500,0,19500,182900,0,202400
141033002000000,APARTMENT,RESIDENTIAL,15100,0,15100,170200,0,185300
141033002100000,NE 131,RESIDENTIAL,11400,0,11400,23000,0,34400
141033002300000,NE 131,RESIDENTIAL,23900,0,23900,56500,0,80400
141033002500000,NE 131,RESIDENTIAL,11400,0,11400,22600,0,34000
141033002600000,NE 131,RESIDENTIAL,30600,0,30600,118400,0,149000
141033002700000,NE 131,RESIDENTIAL,21500,0,21500,35300,0,56800
141033002800000,NE 131,RESIDENTIAL,26500,0,26500,31900,0,58400
141033002900000,NE 131,RESIDENTIAL,26000,0,26000,55800,0,81800
141033003000000,NE 131,RESIDENTIAL,26000,0,26000,39700,0,65700
141033003100000,NE 131,RESIDENTIAL,19500,0,19500,67700,0,87200
141033003200000,NE 131,RESIDENTIAL,16900,0,16900,52900,0,69800
141033003300000,NE 131,RESIDENTIAL,18300,0,18300,85600,0,103900
141033003400000,NE 131,RESIDENTIAL,22100,0,22100,34988,0,57088
141033003500000,NE 131,RESIDENTIAL,26800,0,26800,88900,0,115700
141033003600000,NE 131,RESIDENTIAL,26000,0,26000,90200,0,116200
141033003700000,NE 131,RESIDENTIAL,26000,0,26000,64000,0,90000
141033003800000,NE 131,RESIDENTIAL,10400,0,10400,57100,0,67500
141033100100000,NE 131,RESIDENTIAL,24700,0,24700,74000,0,98700
141033100200000,NE 131,RESIDENTIAL,13300,0,13300,75800,0,89100
141033100300000,NE 131,RESIDENTIAL,13300,0,13300,70100,0,83400
141033100400000,NE 131,RESIDENTIAL,24400,0,24400,105000,0,129400
141033100500000,NE 131,RESIDENTIAL,13300,0,13300,68200,0,81500
141033100600000,NE 131,RESIDENTIAL,13300,0,13300,65400,0,78700
141033100700000,NE 131,RESIDENTIAL,28800,0,28800,100200,0,129000
141033100800000,NE 131,RESIDENTIAL,14400,0,14400,42100,0,56500
141033100900000,NE 131,RESIDENTIAL,13300,0,13300,57400,0,70700
141033101000000,NE 131,RESIDENTIAL,26000,0,26000,125100,0,151100
141033101100000,NE 131,RESIDENTIAL,27300,0,27300,131100,0,158400
141033101200000,NE 131,RESIDENTIAL,26500,0,26500,120500,0,147000
141033101300000,NE 131,RESIDENTIAL,26500,0,26500,78900,0,105400
141033101400000,NE 131,RESIDENTIAL,22900,0,22900,89000,0,111900
141033101600000,NE 131,RESIDENTIAL,19800,0,19800,52700,0,72500
141033101700000,CONVENIENCE STORE,COMMERCIAL,0,435000,435000,0,931900,1366900
141033101800000,NE 131,RESIDENTIAL,26400,0,26400,63200,0,89600
141033102000000,NE 131,RESIDENTIAL,26600,0,26600,41200,0,67800
141033102100000,NE 131,RESIDENTIAL,24500,0,24500,89500,0,114000
141033102200000,NE 131,RESIDENTIAL,24500,0,24500,82100,0,106600
141033102300000,NE 131,RESIDENTIAL,21600,0,21600,48500,0,70100
141033102400000,NE 131,RESIDENTIAL,25000,0,25000,34000,0,59000
141033102500000,NE 131,RESIDENTIAL,12200,0,12200,51000,0,63200
141033102600000,NE 131,RESIDENTIAL,24500,0,24500,57700,0,82200
141033102700000,NE 131,RESIDENTIAL,25200,0,25200,74400,0,99600
141033102800000,NE 131,RESIDENTIAL,24500,0,24500,90400,0,114900
141033102900000,NE 131,RESIDENTIAL,25900,0,25900,63500,0,89400
141035100100000,NE 143,RESIDENTIAL,25000,0,25000,102200,0,127200
141035100200000,NE 143,RESIDENTIAL,16800,0,16800,82700,0,99500
141035100300000,NE 143,RESIDENTIAL,16800,0,16800,71000,0,87800
141035100400000,NE 143,RESIDENTIAL,16800,0,16800,66400,0,83200
141035100500000,NE 143,RESIDENTIAL,29700,0,29700,96400,0,126100
141035100600000,NE 143,RESIDENTIAL,30200,0,30200,72500,0,102700
141035100700000,NE 143,RESIDENTIAL,37700,0,37700,84400,0,122100
141035100800000,NE 143,RESIDENTIAL,31200,0,31200,89100,0,120300
141035100900000,NE 143,RESIDENTIAL,31200,0,31200,100100,0,131300
141035101000000,NE 143,RESIDENTIAL,37700,0,37700,78100,0,115800
141035101100000,NE 143,RESIDENTIAL,30200,0,30200,75300,0,105500
141035101200000,NE 143,RESIDENTIAL,30200,0,30200,95700,0,125900
141035101300000,NE 143,RESIDENTIAL,26500,0,26500,62400,0,88900
141035101400000,NE 143,RESIDENTIAL,25200,0,25200,38800,0,64000
141035101500000,NE 143,RESIDENTIAL,25000,0,25000,53100,0,78100
141035101600000,NE 143,RESIDENTIAL,29700,0,29700,73400,0,103100
141035101700000,NE 143,RESIDENTIAL,30200,0,30200,66600,0,96800
141035101800000,NE 143,RESIDENTIAL,32900,0,32900,92200,0,125100
141035101900000,NE 143,RESIDENTIAL,4700,0,4700,0,0,4700
141035102000000,NE 143,RESIDENTIAL,5000,0,5000,0,0,5000
141035102100000,NE 143,RESIDENTIAL,3700,0,3700,0,0,3700
141035102200000,NE 143,RESIDENTIAL,6500,0,6500,0,0,6500
141035102300000,NE 143,RESIDENTIAL,6500,0,6500,0,0,6500
141035102400000,NE 143,RESIDENTIAL,26300,0,26300,173500,0,199800
141035102500000,NE 143,RESIDENTIAL,23300,0,23300,84600,0,107900
141035102600000,NE 143,RESIDENTIAL,25000,0,25000,109700,0,134700
141035200100000,NE 143,RESIDENTIAL,25700,0,25700,95800,0,121500
141035200200000,NE 143,RESIDENTIAL,30200,0,30200,65700,0,95900
141035200400000,NE 143,RESIDENTIAL,30200,0,30200,132900,0,163100
141035200500000,NE 143,RESIDENTIAL,3100,0,3100,0,0,3100
141035200600000,NE 143,RESIDENTIAL,3100,0,3100,0,0,3100
141035200700000,NE 143,RESIDENTIAL,25200,0,25200,83400,0,108600
141035200800000,NE 143,RESIDENTIAL,25200,0,25200,101000,0,126200
141035200900000,NE 143,RESIDENTIAL,4300,0,4300,0,0,4300
141035201000000,NE 143,RESIDENTIAL,6500,0,6500,0,0,6500
141035201100000,NE 143,RESIDENTIAL,29500,0,29500,86900,0,116400
141035201200000,NE 143,RESIDENTIAL,32400,0,32400,52800,0,85200
141035201300000,NE 143,RESIDENTIAL,4300,0,4300,0,0,4300
141035201400000,NE 143,RESIDENTIAL,27000,0,27000,98600,0,125600
141035201500000,NE 143,RESIDENTIAL,29000,0,29000,77900,0,106900
141035201600000,NE 143,RESIDENTIAL,27500,0,27500,84600,0,112100
141035201700000,NE 143,RESIDENTIAL,27500,0,27500,92200,0,119700
141035201800000,NE 143,RESIDENTIAL,27500,0,27500,73300,0,100800
141035201900000,NE 143,RESIDENTIAL,27000,0,27000,98400,0,125400
141035202000000,OFFICE,COMMERCIAL,0,85400,85400,0,371900,457300
141035202100000,NE 143,RESIDENTIAL,22700,0,22700,47500,0,70200
141035202200000,NE 143,RESIDENTIAL,22700,0,22700,109900,0,132600
141035202300000,NE 143,RESIDENTIAL,22700,0,22700,82800,0,105500
141035202400000,NE 143,RESIDENTIAL,31200,0,31200,66900,0,98100
141035202500000,NE 143,RESIDENTIAL,20800,0,20800,78500,0,99300
141035202600000,NE 143,RESIDENTIAL,15800,0,15800,58000,0,73800
141035202700000,NE 143,RESIDENTIAL,15800,0,15800,33500,0,49300
141035202800000,NE 143,RESIDENTIAL,32200,0,32200,117000,0,149200
141035202900000,NE 143,RESIDENTIAL,25900,0,25900,99300,0,125200
141035203000000,NE 143,RESIDENTIAL,4700,0,4700,0,0,4700
141035203100000,NE 143,RESIDENTIAL,25200,0,25200,62200,0,87400
141035300100000,NE 143,RESIDENTIAL,19900,0,19900,96700,0,116600
141035300200000,NE 143,RESIDENTIAL,18700,0,18700,107400,0,126100
141035300300000,NE 143,RESIDENTIAL,27500,0,27500,96000,0,123500
141035300400000,NE 143,RESIDENTIAL,23500,0,23500,106000,0,129500
141035300500000,NE 143,RESIDENTIAL,24300,0,24300,108000,0,132300
141035300600000,NE 143,RESIDENTIAL,22700,0,22700,79500,0,102200
141035300700000,NE 143,RESIDENTIAL,22700,0,22700,91900,0,114600
141035300800000,NE 143,RESIDENTIAL,27300,0,27300,92400,0,119700
141035300900000,NE 143,RESIDENTIAL,33800,0,33800,89600,0,123400
141035301000000,NE 143,RESIDENTIAL,25300,0,25300,108700,0,134000
141035301100000,NE 143,RESIDENTIAL,27200,0,27200,134300,0,161500
141035301200000,NE 143,RESIDENTIAL,26500,0,26500,120700,0,147200
141035301300000,NE 143,RESIDENTIAL,26500,0,26500,89200,0,115700
141035301400000,NE 143,RESIDENTIAL,26500,0,26500,88400,0,114900
141035301500000,NE 143,RESIDENTIAL,26500,0,26500,109900,0,136400
141035301600000,NE 143,RESIDENTIAL,24500,0,24500,138100,0,162600
141035301700000,NE 143,RESIDENTIAL,26500,0,26500,105400,0,131900
141035301800000,NE 143,RESIDENTIAL,21500,0,21500,100800,0,122300
141035400100000,NE 143,RESIDENTIAL,23400,0,23400,69600,0,93000
141035400200000,NE 143,RESIDENTIAL,22700,0,22700,102200,0,124900
141035400300000,NE 143,RESIDENTIAL,28800,0,28800,113800,0,142600
141035400400000,NE 143,RESIDENTIAL,27400,0,27400,80700,0,108100
141035400500000,NE 143,RESIDENTIAL,22700,0,22700,97500,0,120200
141035400600000,NE 143,RESIDENTIAL,22700,0,22700,77200,0,99900
141035400700000,NE 143,RESIDENTIAL,22700,0,22700,88500,0,111200
141035400800000,NE 143,RESIDENTIAL,32600,0,32600,117600,0,150200
141035400900000,NE 143,RESIDENTIAL,25200,0,25200,69600,0,94800
141035401000000,NE 143,RESIDENTIAL,22700,0,22700,62000,0,84700
141035401100000,NE 143,RESIDENTIAL,22700,0,22700,97600,0,120300
141035401200000,NE 143,RESIDENTIAL,19700,0,19700,61300,0,81000
141035401300000,NE 143,RESIDENTIAL,19700,0,19700,85200,0,104900
141035401400000,NE 143,RESIDENTIAL,19700,0,19700,45200,0,64900
141035401500000,NE 143,RESIDENTIAL,20100,0,20100,57300,0,77400
141035401600000,NE 143,RESIDENTIAL,19700,0,19700,62000,0,81700
141035401700000,NE 143,RESIDENTIAL,20100,0,20100,79900,0,100000
141035401800000,NE 143,RESIDENTIAL,19700,0,19700,73200,0,92900
141035401900000,NE 143,RESIDENTIAL,19600,0,19600,78500,0,98100
141035500100000,NE 143,RESIDENTIAL,23500,0,23500,94800,0,118300
141035500200000,NE 143,RESIDENTIAL,24600,0,24600,115600,0,140200
141035500300000,NE 143,RESIDENTIAL,27000,0,27000,98300,0,125300
141035500400000,NE 143,RESIDENTIAL,27000,0,27000,85700,0,112700
141035500500000,NE 143,RESIDENTIAL,27200,0,27200,101200,0,128400
141035500600000,NE 143,RESIDENTIAL,27000,0,27000,150900,0,177900
141035500700000,NE 143,RESIDENTIAL,27000,0,27000,112100,0,139100
141035500800000,NE 143,RESIDENTIAL,25000,0,25000,100400,0,125400
141035500900000,NE 143,RESIDENTIAL,27800,0,27800,138400,0,166200
141035501000000,NE 143,RESIDENTIAL,26300,0,26300,98800,0,125100
141035501100000,NE 143,RESIDENTIAL,20500,0,20500,87400,0,107900
141035501200000,NE 143,RESIDENTIAL,20500,0,20500,91100,0,111600
141035501300000,NE 143,RESIDENTIAL,18200,0,18200,51900,0,70100
141035501400000,NE 143,RESIDENTIAL,18200,0,18200,54600,0,72800
141035501500000,NE 143,RESIDENTIAL,20500,0,20500,72900,0,93400
141035501600000,NE 143,RESIDENTIAL,18200,0,18200,64700,0,82900
141035501700000,NE 143,RESIDENTIAL,20500,0,20500,64200,0,84700
141035501800000,NE 143,RESIDENTIAL,22700,0,22700,74500,0,97200
141035501900000,NE 143,RESIDENTIAL,22700,0,22700,62700,0,85400
141035502000000,NE 143,RESIDENTIAL,23400,0,23400,84000,0,107400
141035502100000,NE 143,RESIDENTIAL,22400,0,22400,88000,0,110400
141035502200000,NE 143,RESIDENTIAL,20500,0,20500,77100,0,97600
141035502300000,NE 143,RESIDENTIAL,20500,0,20500,82300,0,102800
141035502400000,NE 143,RESIDENTIAL,20500,0,20500,78500,0,99000
141035502500000,NE 143,RESIDENTIAL,20500,0,20500,73700,0,94200
141035502600000,NE 143,RESIDENTIAL,20500,0,20500,104500,0,125000
141035502700000,NE 143,RESIDENTIAL,20500,0,20500,67300,0,87800
141035502800000,NE 143,RESIDENTIAL,20500,0,20500,81000,0,101500
141035502900000,NE 143,RESIDENTIAL,20500,0,20500,72300,0,92800
141035503000000,NE 143,RESIDENTIAL,24900,0,24900,102000,0,126900
141035503100000,NE 143,RESIDENTIAL,25100,0,25100,93500,0,118600
141035503200000,NE 143,RESIDENTIAL,23900,0,23900,84400,0,108300
141035503300000,NE 143,RESIDENTIAL,25600,0,25600,135600,0,161200
141035503400000,NE 143,RESIDENTIAL,25600,0,25600,61800,0,87400
141035503500000,NE 143,RESIDENTIAL,25600,0,25600,99100,0,124700
141035503600000,NE 143,RESIDENTIAL,17000,0,17000,75200,0,92200
141035503700000,NE 143,RESIDENTIAL,17000,0,17000,58100,0,75100
141035503800000,NE 143,RESIDENTIAL,26200,0,26200,122400,0,148600
141037600300000,NE 143,RESIDENTIAL,6800,0,6800,0,0,6800
141037600400000,NE 143,RESIDENTIAL,7400,0,7400,0,0,7400
141037600500000,NE 142,RESIDENTIAL,23300,0,23300,104500,0,127800
141037700100000,NE 143,RESIDENTIAL,24200,0,24200,32900,0,57100
141037700200000,NE 143,RESIDENTIAL,22700,0,22700,118100,0,140800
141037700300000,NE 143,RESIDENTIAL,21700,0,21700,96900,0,118600
141037700400000,NE 143,RESIDENTIAL,30400,0,30400,111400,0,141800
141037700500000,NE 143,RESIDENTIAL,23500,0,23500,100100,0,123600
141037700600000,NE 143,RESIDENTIAL,22700,0,22700,81200,0,103900
141037700700000,NE 143,RESIDENTIAL,23200,0,23200,92100,0,115300
141037700800000,NE 143,RESIDENTIAL,23600,0,23600,76500,0,100100
141037700900000,NE 143,RESIDENTIAL,22700,0,22700,72100,0,94800
141037701000000,NE 143,RESIDENTIAL,23100,0,23100,121600,0,144700
141037701100000,NE 143,RESIDENTIAL,31200,0,31200,72800,0,104000
141037701200000,NE 143,RESIDENTIAL,15100,0,15100,45900,0,61000
141037701300000,NE 143,RESIDENTIAL,2900,0,2900,33600,0,36500
141037701400000,NE 143,RESIDENTIAL,23000,0,23000,39500,0,62500
141037701500000,NE 143,RESIDENTIAL,21400,0,21400,92500,0,113900
141037800100000,NE 143,RESIDENTIAL,21000,0,21000,55500,0,76500
141037800200000,NE 143,RESIDENTIAL,17000,0,17000,62200,0,79200
141037800300000,NE 143,RESIDENTIAL,18900,0,18900,46900,0,65800
141037800400000,NE 143,RESIDENTIAL,17000,0,17000,48100,0,65100
141037800500000,NE 143,RESIDENTIAL,18900,0,18900,56800,0,75700
141037800600000,NE 143,RESIDENTIAL,21900,0,21900,55900,0,77800
141037800700000,NE 143,RESIDENTIAL,25600,0,25600,58900,0,84500
141037800800000,NE 143,RESIDENTIAL,25600,0,25600,92600,0,118200
141037800900000,NE 143,RESIDENTIAL,23400,0,23400,88500,0,111900
141037801000000,NE 143,RESIDENTIAL,24900,0,24900,70400,0,95300
141037801100000,NE 143,RESIDENTIAL,20400,0,20400,72300,0,92700
141037801200000,NE 143,RESIDENTIAL,20800,0,20800,71900,0,92700
141037801300000,NE 143,RESIDENTIAL,21000,0,21000,58600,0,79600
141037801400000,NE 143,RESIDENTIAL,18900,0,18900,50700,0,69600
141037801500000,NE 143,RESIDENTIAL,17000,0,17000,50500,0,67500
141037801600000,NE 143,RESIDENTIAL,18900,0,18900,69100,0,88000
141037801700000,NE 143,RESIDENTIAL,17000,0,17000,65700,0,82700
141037801800000,NE 143,RESIDENTIAL,21900,0,21900,42700,0,64600
141037900100000,NE 143,RESIDENTIAL,21100,0,21100,76200,0,97300
141037900200000,NE 143,RESIDENTIAL,25700,0,25700,57300,0,83000
141037900300000,NE 143,RESIDENTIAL,18200,0,18200,102800,0,121000
141037900400000,NE 143,RESIDENTIAL,29800,0,29800,76000,0,105800
141038000200000,NE 143,RESIDENTIAL,35100,0,35100,0,0,35100
141038000300000,NE 143,RESIDENTIAL,19700,0,19700,109300,0,129000
141038000400000,NE 143,RESIDENTIAL,18900,0,18900,98000,0,116900
141038000500000,NE 143,RESIDENTIAL,18100,0,18100,99000,0,117100
141038000600000,NE 143,RESIDENTIAL,19700,0,19700,78300,0,98000
141038000700000,NE 143,RESIDENTIAL,18900,0,18900,72000,0,90900
141038000800000,NE 143,RESIDENTIAL,18100,0,18100,102500,0,120600
141038001000000,NE 143,RESIDENTIAL,28100,0,28100,96700,0,124800
141038001100000,CHURCH,EXEMPT,0,224000,224000,0,94200,318200
141038100100000,NE 143,RESIDENTIAL,21000,0,21000,80200,0,101200
141038100200000,NE 143,RESIDENTIAL,17000,0,17000,55100,0,72100
141038100300000,NE 143,RESIDENTIAL,18900,0,18900,51900,0,70800
141038100400000,NE 143,RESIDENTIAL,17000,0,17000,55600,0,72600
141038100500000,NE 143,RESIDENTIAL,18900,0,18900,54000,0,72900
141038100600000,NE 143,RESIDENTIAL,21800,0,21800,59300,0,81100
141038100700000,NE 143,RESIDENTIAL,21300,0,21300,57600,0,78900
141038100800000,NE 143,RESIDENTIAL,21800,0,21800,45600,0,67400
141038100900000,NE 143,RESIDENTIAL,18100,0,18100,53200,0,71300
141038101000000,NE 143,RESIDENTIAL,17200,0,17200,47100,0,64300
141038101100000,NE 143,RESIDENTIAL,21000,0,21000,57800,0,78800
141038101200000,NE 143,RESIDENTIAL,20500,0,20500,66300,0,86800
141038101300000,NE 143,RESIDENTIAL,20500,0,20500,78000,0,98500
141038101400000,NE 143,RESIDENTIAL,20500,0,20500,62300,0,82800
141038101500000,NE 143,RESIDENTIAL,24000,0,24000,150800,0,174800
141038101600000,NE 143,RESIDENTIAL,24800,0,24800,104800,0,129600
141038101700000,NE 143,RESIDENTIAL,20900,0,20900,61800,0,82700
141038101800000,NE 143,RESIDENTIAL,18900,0,18900,51600,0,70500
141038101900000,NE 143,RESIDENTIAL,17000,0,17000,50300,0,67300
141038102000000,NE 143,RESIDENTIAL,18900,0,18900,56300,0,75200
141038102100000,NE 143,RESIDENTIAL,17000,0,17000,51400,0,68400
141038102200000,NE 143,RESIDENTIAL,21800,0,21800,80100,0,101900
141038200100000,NE 143,RESIDENTIAL,23500,0,23500,151700,0,175200
141038200200000,NE 143,RESIDENTIAL,22700,0,22700,74300,0,97000
141038200300000,NE 143,RESIDENTIAL,22700,0,22700,98400,0,121100
141038200400000,NE 143,RESIDENTIAL,22700,0,22700,99200,0,121900
141038200500000,NE 143,RESIDENTIAL,23100,0,23100,72400,0,95500
141038200600000,NE 143,RESIDENTIAL,23500,0,23500,81000,0,104500
141038200700000,NE 143,RESIDENTIAL,22700,0,22700,86800,0,109500
141038200800000,NE 143,RESIDENTIAL,22700,0,22700,69300,0,92000
141038200900000,NE 143,RESIDENTIAL,22700,0,22700,75200,0,97900
141038201000000,NE 143,RESIDENTIAL,23100,0,23100,96700,0,119800
141038201100000,NE 143,RESIDENTIAL,24600,0,24600,73700,0,98300
141038201200000,NE 143,RESIDENTIAL,22700,0,22700,111600,0,134300
141038201300000,NE 143,RESIDENTIAL,22700,0,22700,84000,0,106700
141038201400000,NE 143,RESIDENTIAL,22700,0,22700,91400,0,114100
141038201500000,NE 143,RESIDENTIAL,22000,0,22000,108500,0,130500
141038201600000,NE 143,RESIDENTIAL,24600,0,24600,100900,0,125500
141038201700000,NE 143,RESIDENTIAL,22700,0,22700,92400,0,115100
141038201800000,NE 143,RESIDENTIAL,22700,0,22700,119100,0,141800
141038201900000,NE 143,RESIDENTIAL,22700,0,22700,88300,0,111000
141038202000000,NE 143,RESIDENTIAL,22000,0,22000,94900,0,116900
141038300100000,NE 143,RESIDENTIAL,25500,0,25500,74700,0,100200
141038300200000,NE 143,RESIDENTIAL,23500,0,23500,105800,0,129300
141038300300000,NE 143,RESIDENTIAL,23500,0,23500,87900,0,111400
141038300400000,NE 143,RESIDENTIAL,22700,0,22700,77400,0,100100
141038300500000,NE 143,RESIDENTIAL,19700,0,19700,73900,0,93600
141038300600000,NE 143,RESIDENTIAL,23500,0,23500,76900,0,100400
141038300700000,NE 143,RESIDENTIAL,22700,0,22700,77900,0,100600
141038300800000,NE 143,RESIDENTIAL,22700,0,22700,91900,0,114600
141038300900000,NE 143,RESIDENTIAL,22700,0,22700,65800,0,88500
141038301000000,NE 143,RESIDENTIAL,23000,0,23000,85200,0,108200
141038301100000,NE 143,RESIDENTIAL,23500,0,23500,106900,0,130400
141038301200000,NE 143,RESIDENTIAL,26500,0,26500,122100,0,148600
141038301300000,NE 143,RESIDENTIAL,22700,0,22700,90500,0,113200
141038301400000,NE 143,RESIDENTIAL,27000,0,27000,122800,0,149800
141038301500000,NE 143,RESIDENTIAL,28200,0,28200,91300,0,119500
141038301600000,NE 143,RESIDENTIAL,24600,0,24600,123600,0,148200
141038301700000,NE 143,RESIDENTIAL,26500,0,26500,116500,0,143000
141038301800000,NE 143,RESIDENTIAL,22700,0,22700,105200,0,127900
141038301900000,NE 143,RESIDENTIAL,23200,0,23200,89400,0,112600
141038400100000,NE 143,RESIDENTIAL,23500,0,23500,113200,0,136700
141038400200000,NE 143,RESIDENTIAL,22700,0,22700,110100,0,132800
141038400300000,NE 143,RESIDENTIAL,22700,0,22700,111700,0,134400
141038400400000,NE 143,RESIDENTIAL,22700,0,22700,87200,0,109900
141038400500000,NE 143,RESIDENTIAL,23000,0,23000,88400,0,111400
141038400600000,NE 143,RESIDENTIAL,23500,0,23500,81500,0,105000
141038400700000,NE 143,RESIDENTIAL,22700,0,22700,70200,0,92900
141038400800000,NE 143,RESIDENTIAL,22700,0,22700,106000,0,128700
141038400900000,NE 143,RESIDENTIAL,22700,0,22700,88900,0,111600
141038401000000,NE 143,RESIDENTIAL,23000,0,23000,73700,0,96700
141038401100000,NE 143,RESIDENTIAL,22000,0,22000,88500,0,110500
141038401200000,NE 143,RESIDENTIAL,20500,0,20500,98400,0,118900
141038401300000,NE 143,RESIDENTIAL,20500,0,20500,97000,0,117500
141038401400000,NE 143,RESIDENTIAL,20500,0,20500,89300,0,109800
141038401500000,NE 143,RESIDENTIAL,19700,0,19700,105300,0,125000
141038401600000,NE 143,RESIDENTIAL,22000,0,22000,93600,0,115600
141038401700000,NE 143,RESIDENTIAL,20500,0,20500,78800,0,99300
141038401800000,NE 143,RESIDENTIAL,20500,0,20500,130400,0,150900
141038401900000,NE 143,RESIDENTIAL,20500,0,20500,114300,0,134800
141038402000000,NE 143,RESIDENTIAL,19700,0,19700,126800,0,146500
141038500100000,NE 143,RESIDENTIAL,23500,0,23500,76300,0,99800
141038500200000,NE 143,RESIDENTIAL,22700,0,22700,102400,0,125100
141038500300000,NE 143,RESIDENTIAL,25800,0,25800,116300,0,142100
141038500400000,NE 143,RESIDENTIAL,26500,0,26500,100900,0,127400
141038500500000,NE 143,RESIDENTIAL,27200,0,27200,137500,0,164700
141038500600000,NE 143,RESIDENTIAL,26500,0,26500,98300,0,124800
141038500700000,NE 143,RESIDENTIAL,22700,0,22700,94100,0,116800
141038500800000,NE 143,RESIDENTIAL,27300,0,27300,113200,0,140500
141038500900000,NE 143,RESIDENTIAL,22900,0,22900,115700,0,138600
141038501000000,NE 143,RESIDENTIAL,21200,0,21200,80400,0,101600
141038501100000,NE 143,RESIDENTIAL,20500,0,20500,77300,0,97800
141038501200000,NE 143,RESIDENTIAL,20500,0,20500,97800,0,118300
141038501300000,NE 143,RESIDENTIAL,20500,0,20500,91200,0,111700
141038501400000,NE 143,RESIDENTIAL,20600,0,20600,83700,0,104300
141038501500000,NE 143,RESIDENTIAL,21100,0,21100,81200,0,102300
141038501600000,NE 143,RESIDENTIAL,20500,0,20500,74800,0,95300
141038501700000,NE 143,RESIDENTIAL,20500,0,20500,80100,0,100600
141038501800000,NE 143,RESIDENTIAL,20500,0,20500,115500,0,136000
141038501900000,NE 143,RESIDENTIAL,21000,0,21000,87000,0,108000
141040100100000,NE 129,RESIDENTIAL,17100,0,17100,93500,0,110600
141040100200000,NE 129,RESIDENTIAL,24100,0,24100,83000,0,107100
141040100300000,NE 129,RESIDENTIAL,24100,0,24100,29600,0,53700
141040100400000,NE 129,RESIDENTIAL,16100,0,16100,61600,0,77700
141040100500000,NE 129,RESIDENTIAL,16100,0,16100,49800,0,65900
141040100600000,NE 129,RESIDENTIAL,16100,0,16100,61600,0,77700
141040100700000,NE 129,RESIDENTIAL,16100,0,16100,94900,0,111000
141040100800000,NE 129,RESIDENTIAL,17300,0,17300,66600,0,83900
141040100900000,NE 129,RESIDENTIAL,14800,0,14800,51100,0,65900
141040101000000,NE 129,RESIDENTIAL,16100,0,16100,85100,0,101200
141040101100000,NE 129,RESIDENTIAL,16100,0,16100,87700,0,103800
141040101200000,NE 129,RESIDENTIAL,17200,0,17200,69600,0,86800
141040101300000,NE 129,RESIDENTIAL,17700,0,17700,74800,0,92500
141040101400000,NE 129,RESIDENTIAL,20500,0,20500,38100,0,58600
141040101500000,NE 129,RESIDENTIAL,20100,0,20100,68200,0,88300
141040101600000,NE 129,RESIDENTIAL,20100,0,20100,94500,0,114600
141040101700000,NE 129,RESIDENTIAL,24100,0,24100,110100,0,134200
141040101800000,NE 129,RESIDENTIAL,16100,0,16100,63700,0,79800
141040101900000,NE 129,RESIDENTIAL,16100,0,16100,77000,0,93100
141040102000000,NE 129,RESIDENTIAL,16100,0,16100,69600,0,85700
141040102100000,NE 129,RESIDENTIAL,16100,0,16100,63000,0,79100
141040102200000,NE 129,RESIDENTIAL,16900,0,16900,71000,0,87900
141040102300000,NE 129,RESIDENTIAL,15200,0,15200,80900,0,96100
141040102400000,NE 129,RESIDENTIAL,20500,0,20500,77100,0,97600
141040102500000,CONVERSION-NE/SE,MULTI-RES,21800,0,21800,36500,0,58300
141040102600000,NE 129,RESIDENTIAL,19000,0,19000,116900,0,135900
141040102700000,NE 129,RESIDENTIAL,18100,0,18100,92200,0,110300
141040102800000,NE 129,RESIDENTIAL,15800,0,15800,84500,0,100300
141040102900000,NE 129,RESIDENTIAL,15800,0,15800,55400,0,71200
141040200100000,NE 129,RESIDENTIAL,17200,0,17200,68600,0,85800
141040200200000,NE 129,RESIDENTIAL,16100,0,16100,83100,0,99200
141040200300000,NE 129,RESIDENTIAL,16100,0,16100,94100,0,110200
141040200400000,NE 129,RESIDENTIAL,20500,0,20500,93300,0,113800
141040200500000,NE 129,RESIDENTIAL,30100,0,30100,56200,0,86300
141040200600000,NE 129,RESIDENTIAL,20500,0,20500,122400,0,142900
141040200700000,NE 129,RESIDENTIAL,18200,0,18200,48000,0,66200
141040200800000,NE 129,RESIDENTIAL,18200,0,18200,63200,0,81400
141040200900000,NE 129,RESIDENTIAL,15900,0,15900,88900,0,104800
141040201000000,NE 129,RESIDENTIAL,16100,0,16100,50200,0,66300
141040201100000,NE 129,RESIDENTIAL,16100,0,16100,94400,0,110500
141040201200000,NE 129,RESIDENTIAL,24100,0,24100,86600,0,110700
141040201300000,NE 129,RESIDENTIAL,22500,0,22500,68700,0,91200
141040201400000,NE 129,RESIDENTIAL,25300,0,25300,132100,0,157400
141040201500000,NE 129,RESIDENTIAL,24100,0,24100,103700,0,127800
141040201600000,NE 129,RESIDENTIAL,24100,0,24100,112500,0,136600
141040201700000,NE 129,RESIDENTIAL,20000,0,20000,90800,0,110800
141040201800000,NE 129,RESIDENTIAL,16400,0,16400,92300,0,108700
141040201900000,NE 129,RESIDENTIAL,17200,0,17200,58600,0,75800
141040202000000,NE 129,RESIDENTIAL,17200,0,17200,62000,0,79200
141040202100000,NE 129,RESIDENTIAL,19100,0,19100,94800,0,113900
141040300100000,NE 129,RESIDENTIAL,20100,0,20100,96100,0,116200
141040300200000,NE 129,RESIDENTIAL,16100,0,16100,112700,0,128800
141040300300000,NE 129,RESIDENTIAL,16100,0,16100,108300,0,124400
141040300400000,NE 129,RESIDENTIAL,16100,0,16100,95600,0,111700
141040300500000,NE 129,RESIDENTIAL,16100,0,16100,81200,0,97300
141040300600000,NE 129,RESIDENTIAL,16100,0,16100,68700,0,84800
141040300700000,NE 129,RESIDENTIAL,16100,0,16100,61600,0,77700
141040300800000,NE 129,RESIDENTIAL,20500,0,20500,81100,0,101600
141040300900000,NE 129,RESIDENTIAL,20100,0,20100,57900,0,78000
141040301000000,NE 129,RESIDENTIAL,20100,0,20100,64100,0,84200
141040301100000,NE 129,RESIDENTIAL,20100,0,20100,90000,0,110100
141040301200000,NE 129,RESIDENTIAL,17600,0,17600,76000,0,93600
141040301300000,NE 129,RESIDENTIAL,18000,0,18000,73500,0,91500
141040301500000,NE 129,RESIDENTIAL,18700,0,18700,80000,0,98700
141040301600000,NE 129,RESIDENTIAL,21300,0,21300,90300,0,111600
141040301700000,NE 129,RESIDENTIAL,21700,0,21700,78700,0,100400
141040301800000,NE 129,RESIDENTIAL,21300,0,21300,69600,0,90900
141040301900000,NE 129,RESIDENTIAL,16100,0,16100,86000,0,102100
141040302000000,NE 129,RESIDENTIAL,16100,0,16100,92300,0,108400
141040302100000,NE 129,RESIDENTIAL,24100,0,24100,111000,0,135100
141040302200000,NE 129,RESIDENTIAL,16100,0,16100,64200,0,80300
141040302300000,NE 129,RESIDENTIAL,16100,0,16100,72000,0,88100
141040302400000,NE 129,RESIDENTIAL,24100,0,24100,98300,0,122400
141040302500000,NE 129,RESIDENTIAL,18600,0,18600,80800,0,99400
141040302600000,NE 129,RESIDENTIAL,23900,0,23900,88000,0,111900
141040302700000,NE 129,RESIDENTIAL,20100,0,20100,78700,0,98800
141040302900000,NE 129,RESIDENTIAL,27200,0,27200,86400,0,113600
141040400100000,NE 129,RESIDENTIAL,20000,0,20000,121900,0,141900
141040400200000,NE 129,RESIDENTIAL,16100,0,16100,57100,0,73200
141040400300000,NE 129,RESIDENTIAL,16100,0,16100,122800,0,138900
141040400400000,NE 129,RESIDENTIAL,17100,0,17100,78400,0,95500
141040400500000,NE 129,RESIDENTIAL,15000,0,15000,112300,0,127300
141040400600000,NE 129,RESIDENTIAL,24100,0,24100,86700,0,110800
141040400700000,NE 129,RESIDENTIAL,16100,0,16100,69900,0,86000
141040401000000,NE 129,RESIDENTIAL,16100,0,16100,47200,0,63300
141040401100000,NE 129,RESIDENTIAL,16100,0,16100,58300,0,74400
141040401200000,NE 129,RESIDENTIAL,16100,0,16100,63300,0,79400
141040401300000,NE 129,RESIDENTIAL,17500,0,17500,89500,0,107000
141040401400000,NE 129,RESIDENTIAL,19100,0,19100,91000,0,110100
141040401500000,NE 129,RESIDENTIAL,20100,0,20100,68800,0,88900
141040401600000,NE 129,RESIDENTIAL,20100,0,20100,74900,0,95000
141040401700000,NE 129,RESIDENTIAL,20500,0,20500,72400,0,92900
141040401800000,NE 129,RESIDENTIAL,16100,0,16100,101500,0,117600
141040401900000,NE 129,RESIDENTIAL,16100,0,16100,68900,0,85000
141040402000000,NE 129,RESIDENTIAL,16100,0,16100,67000,0,83100
141040402100000,NE 129,RESIDENTIAL,16100,0,16100,78200,0,94300
141040402200000,NE 129,RESIDENTIAL,24100,0,24100,84400,0,108500
141040402300000,NE 129,RESIDENTIAL,19100,0,19100,80800,0,99900
141040402500000,NE 129,RESIDENTIAL,22800,0,22800,118600,0,141400
141040402600000,NE 129,RESIDENTIAL,24100,0,24100,109100,0,133200
141040500100000,NE 129,RESIDENTIAL,19100,0,19100,81100,0,100200
141040500200000,NE 129,RESIDENTIAL,17900,0,17900,116500,0,134400
141040500300000,NE 129,RESIDENTIAL,13900,0,13900,89200,0,103100
141040500400000,NE 129,RESIDENTIAL,15900,0,15900,81200,0,97100
141040500500000,NE 129,RESIDENTIAL,15900,0,15900,83300,0,99200
141040500600000,NE 129,RESIDENTIAL,20300,0,20300,89700,0,110000
141040500700000,NE 129,RESIDENTIAL,27800,0,27800,95500,0,123300
141040500800000,NE 129,RESIDENTIAL,15900,0,15900,106900,0,122800
141040500900000,NE 129,RESIDENTIAL,20300,0,20300,85000,0,105300
141040501000000,NE 129,RESIDENTIAL,20300,0,20300,40700,0,61000
141040501100000,NE 129,RESIDENTIAL,23900,0,23900,86500,0,110400
141040501200000,NE 129,RESIDENTIAL,17600,0,17600,77100,0,94700
141040501300000,NE 129,RESIDENTIAL,17600,0,17600,73100,0,90700
141040501400000,NE 129,RESIDENTIAL,13800,0,13800,76800,0,90600
141040501500000,NE 129,RESIDENTIAL,13800,0,13800,77000,0,90800
141040501600000,NE 129,RESIDENTIAL,16500,0,16500,84700,0,101200
141040501700000,NE 129,RESIDENTIAL,19800,0,19800,108700,0,128500
141040501800000,NE 129,RESIDENTIAL,19300,0,19300,61000,0,80300
141040501900000,NE 129,RESIDENTIAL,17200,0,17200,83600,0,100800
141040502000000,NE 129,RESIDENTIAL,13800,0,13800,101700,0,115500
141040502100000,NE 129,RESIDENTIAL,20700,0,20700,97100,0,117800
141040502200000,NE 129,RESIDENTIAL,12700,0,12700,64600,0,77300
141040502300000,NE 129,RESIDENTIAL,12700,0,12700,97600,0,110300
141040502400000,NE 129,RESIDENTIAL,12400,0,12400,55200,0,67600
141040502500000,NE 129,RESIDENTIAL,18600,0,18600,82400,0,101000
141040600100000,NE 129,RESIDENTIAL,14000,0,14000,70900,0,84900
141040600200000,NE 129,RESIDENTIAL,14000,0,14000,67500,0,81500
141040600300000,NE 129,RESIDENTIAL,15900,0,15900,72600,0,88500
141040600400000,NE 129,RESIDENTIAL,15900,0,15900,73100,0,89000
141040600500000,NE 129,RESIDENTIAL,21900,0,21900,61800,0,83700
141040600600000,NE 129,RESIDENTIAL,17900,0,17900,10400,0,28300
141040600700000,NE 129,RESIDENTIAL,20300,0,20300,50700,0,71000
141040600800000,NE 129,RESIDENTIAL,23900,0,23900,115600,0,139500
141040600900000,NE 129,RESIDENTIAL,21900,0,21900,83900,0,105800
141040601000000,NE 129,RESIDENTIAL,20700,0,20700,98900,0,119600
141040601100000,NE 129,RESIDENTIAL,21100,0,21100,118200,0,139300
141040601200000,NE 129,RESIDENTIAL,20700,0,20700,42200,0,62900
141040601300000,NE 129,RESIDENTIAL,20700,0,20700,66400,0,87100
141040601400000,NE 129,RESIDENTIAL,20700,0,20700,83300,0,104000
141040601500000,NE 129,RESIDENTIAL,20700,0,20700,63300,0,84000
141040601600000,NE 129,RESIDENTIAL,20700,0,20700,94500,0,115200
141040601700000,NE 129,RESIDENTIAL,20700,0,20700,108400,0,129100
141040601800000,NE 129,RESIDENTIAL,15400,0,15400,63900,0,79300
141040601900000,NE 129,RESIDENTIAL,18500,0,18500,75000,0,93500
141040602000000,NE 129,RESIDENTIAL,13700,0,13700,57600,0,71300
141042600100000,NE 129,RESIDENTIAL,16400,0,16400,64200,0,80600
141042600200000,NE 129,RESIDENTIAL,24100,0,24100,109200,0,133300
141042600300000,NE 129,RESIDENTIAL,24100,0,24100,82500,0,106600
141042600400000,NE 129,RESIDENTIAL,21300,0,21300,129700,0,151000
141042600500000,NE 129,RESIDENTIAL,21300,0,21300,105500,0,126800
141042600600000,NE 129,RESIDENTIAL,21700,0,21700,64200,0,85900
141042600700000,NE 129,RESIDENTIAL,24100,0,24100,76300,0,100400
141042600800000,NE 129,RESIDENTIAL,24100,0,24100,67300,0,91400
141042600900000,NE 129,RESIDENTIAL,20100,0,20100,79500,0,99600
141042601000000,NE 129,RESIDENTIAL,22100,0,22100,72900,0,95000
141042601100000,NE 129,RESIDENTIAL,22100,0,22100,73800,0,95900
141042601200000,NE 129,RESIDENTIAL,19600,0,19600,60400,0,80000
141042601300000,NE 129,RESIDENTIAL,16400,0,16400,103200,0,119600
141042601400000,NE 129,RESIDENTIAL,20100,0,20100,61600,0,81700
141042700100000,NE 129,RESIDENTIAL,19100,0,19100,84200,0,103300
141042700200000,NE 129,RESIDENTIAL,24100,0,24100,45000,0,69100
141042700300000,NE 129,RESIDENTIAL,16100,0,16100,70800,0,86900
141042700400000,NE 129,RESIDENTIAL,16100,0,16100,54500,0,70600
141042700500000,NE 129,RESIDENTIAL,24100,0,24100,83800,0,107900
141042700600000,NE 129,RESIDENTIAL,24100,0,24100,89500,0,113600
141042700700000,HIGH TECH/RESEARCH,INDUSTRIAL,0,863100,863100,0,3261900,4125000
141042700800000,NE 129,RESIDENTIAL,16100,0,16100,36100,0,52200
141042700900000,NE 129,RESIDENTIAL,18100,0,18100,67900,0,86000
141042701000000,NE 129,RESIDENTIAL,24100,0,24100,113700,0,137800
141042701100000,NE 129,RESIDENTIAL,24100,0,24100,53900,0,78000
141042701200000,NE 129,RESIDENTIAL,19600,0,19600,98200,0,117800
141042701300000,NE 129,RESIDENTIAL,19600,0,19600,52300,0,71900
141042701400000,NE 129,RESIDENTIAL,23000,0,23000,92000,0,115000
141042701500000,NE 129,RESIDENTIAL,17500,0,17500,76500,0,94000
141042800100000,NE 129,RESIDENTIAL,19600,0,19600,91700,0,111300
141042800200000,NE 129,RESIDENTIAL,15900,0,15900,75000,0,90900
141042800300000,NE 129,RESIDENTIAL,15900,0,15900,70200,0,86100
141042800400000,NE 129,RESIDENTIAL,15100,0,15100,82400,0,97500
141042800500000,NE 129,RESIDENTIAL,16700,0,16700,110200,0,126900
141042800600000,NE 129,RESIDENTIAL,20700,0,20700,111600,0,132300
141042800700000,NE 129,RESIDENTIAL,26400,0,26400,91800,0,118200
141042800800000,NE 129,RESIDENTIAL,20700,0,20700,120500,0,141200
141042800900000,NE 129,RESIDENTIAL,20700,0,20700,84400,0,105100
141042801000000,NE 129,RESIDENTIAL,20700,0,20700,52700,0,73400
141042801100000,NE 129,RESIDENTIAL,13800,0,13800,65500,0,79300
141042801200000,NE 129,RESIDENTIAL,13800,0,13800,70100,0,83900
141042801300000,NE 129,RESIDENTIAL,17000,0,17000,76900,0,93900
141042801400000,NE 129,RESIDENTIAL,16400,0,16400,123900,0,140300
141042801500000,NE 129,RESIDENTIAL,16400,0,16400,94400,0,110800
141045100800000,NE 142,RESIDENTIAL,30300,0,30300,129600,0,159900
141045100900000,NE 142,RESIDENTIAL,26200,0,26200,121900,0,148100
141045101000000,NE 142,RESIDENTIAL,28400,0,28400,135500,0,163900
141045101100000,NE 142,RESIDENTIAL,28400,0,28400,133100,0,161500
141045101200000,NE 142,RESIDENTIAL,34100,0,34100,161200,0,195300
141045200100000,NE 142,RESIDENTIAL,19300,0,19300,107700,0,127000
141045200200000,NE 142,RESIDENTIAL,19800,0,19800,113700,0,133500
141045200300000,NE 142,RESIDENTIAL,24900,0,24900,113800,0,138700
141045200400000,NE 142,RESIDENTIAL,24000,0,24000,84700,0,108700
141045200500000,NE 142,RESIDENTIAL,24000,0,24000,105100,0,129100
141045200600000,NE 142,RESIDENTIAL,24200,0,24200,108500,0,132700
141045200700000,NE 142,RESIDENTIAL,24200,0,24200,98300,0,122500
141045200800000,NE 142,RESIDENTIAL,24500,0,24500,103300,0,127800
141045200900000,NE 142,RESIDENTIAL,24500,0,24500,92800,0,117300
141045201000000,NE 142,RESIDENTIAL,24500,0,24500,111600,0,136100
141045201100000,NE 142,RESIDENTIAL,35500,0,35500,143200,0,178700
141045201200000,NE 142,RESIDENTIAL,35100,0,35100,137600,0,172700
141045201300000,NE 142,RESIDENTIAL,32000,0,32000,129900,0,161900
141045201400000,NE 142,RESIDENTIAL,26200,0,26200,81400,0,107600
141045201500000,NE 142,RESIDENTIAL,24500,0,24500,89400,0,113900
141045201600000,NE 142,RESIDENTIAL,24500,0,24500,104000,0,128500
141045201700000,NE 142,RESIDENTIAL,24500,0,24500,92500,0,117000
141045201800000,NE 142,RESIDENTIAL,24200,0,24200,95700,0,119900
141045201900000,NE 142,RESIDENTIAL,23700,0,23700,135600,0,159300
141045300100000,NE 142,RESIDENTIAL,25400,0,25400,110800,0,136200
141045300200000,NE 142,RESIDENTIAL,25300,0,25300,109600,0,134900
141045300300000,NE 142,RESIDENTIAL,24200,0,24200,111900,0,136100
141045300400000,NE 142,RESIDENTIAL,24200,0,24200,123800,0,148000
141045300500000,NE 142,RESIDENTIAL,24200,0,24200,103900,0,128100
141045300600000,NE 142,RESIDENTIAL,24200,0,24200,116000,0,140200
141045300700000,NE 142,RESIDENTIAL,24200,0,24200,104800,0,129000
141045300800000,NE 142,RESIDENTIAL,22200,0,22200,129900,0,152100
141045300900000,NE 142,RESIDENTIAL,26200,0,26200,122600,0,148800
141045301000000,NE 142,RESIDENTIAL,24200,0,24200,90700,0,114900
141045301100000,NE 142,RESIDENTIAL,24200,0,24200,104200,0,128400
141045301200000,NE 142,RESIDENTIAL,24200,0,24200,105500,0,129700
141045301300000,NE 142,RESIDENTIAL,24200,0,24200,105800,0,130000
141045301400000,NE 142,RESIDENTIAL,24200,0,24200,111800,0,136000
141045301500000,NE 142,RESIDENTIAL,24200,0,24200,99200,0,123400
141045301600000,NE 142,RESIDENTIAL,24200,0,24200,78100,0,102300
141045301700000,NE 142,RESIDENTIAL,24200,0,24200,117600,0,141800
141045301800000,NE 142,RESIDENTIAL,24200,0,24200,112300,0,136500
141045301900000,NE 142,RESIDENTIAL,24200,0,24200,84100,0,108300
141045302000000,NE 142,RESIDENTIAL,24200,0,24200,98500,0,122700
141045400100000,NE 142,RESIDENTIAL,25300,0,25300,103400,0,128700
141045400200000,NE 142,RESIDENTIAL,28900,0,28900,125100,0,154000
141045400300000,NE 142,RESIDENTIAL,25800,0,25800,108500,0,134300
141045400400000,NE 142,RESIDENTIAL,25500,0,25500,118000,0,143500
141045400500000,NE 142,RESIDENTIAL,25500,0,25500,94100,0,119600
141045400600000,NE 142,RESIDENTIAL,25200,0,25200,90100,0,115300
141045400700000,NE 142,RESIDENTIAL,25200,0,25200,114600,0,139800
141045400800000,NE 142,RESIDENTIAL,25000,0,25000,90600,0,115600
141045400900000,NE 142,RESIDENTIAL,23000,0,23000,96000,0,119000
141045401000000,NE 142,RESIDENTIAL,25000,0,25000,105400,0,130400
141045401100000,NE 142,RESIDENTIAL,24200,0,24200,73200,0,97400
141045401200000,NE 142,RESIDENTIAL,24200,0,24200,85300,0,109500
141045401300000,NE 142,RESIDENTIAL,24200,0,24200,105600,0,129800
141045401400000,NE 142,RESIDENTIAL,24200,0,24200,89900,0,114100
141045401500000,NE 142,RESIDENTIAL,24200,0,24200,75200,0,99400
141045401600000,NE 142,RESIDENTIAL,24200,0,24200,86300,0,110500
141045401700000,NE 142,RESIDENTIAL,24200,0,24200,99800,0,124000
141045401800000,NE 142,RESIDENTIAL,24200,0,24200,94300,0,118500
141045401900000,NE 142,RESIDENTIAL,24200,0,24200,82200,0,106400
141045402000000,NE 142,RESIDENTIAL,24200,0,24200,112800,0,137000
141045500100000,NE 142,RESIDENTIAL,31700,0,31700,159300,0,191000
141045500200000,NE 142,RESIDENTIAL,32200,0,32200,169500,0,201700
141045500300000,NE 142,RESIDENTIAL,25200,0,25200,89200,0,114400
141045500400000,NE 142,RESIDENTIAL,29500,0,29500,128400,0,157900
141045500500000,NE 142,RESIDENTIAL,29500,0,29500,115000,0,144500
141045500600000,NE 142,RESIDENTIAL,29500,0,29500,112600,0,142100
141045500700000,NE 142,RESIDENTIAL,29500,0,29500,111500,0,141000
141045500800000,NE 142,RESIDENTIAL,25200,0,25200,118300,0,143500
141045500900000,NE 142,RESIDENTIAL,25200,0,25200,97900,0,123100
141045501000000,NE 142,RESIDENTIAL,25200,0,25200,93200,0,118400
141045501100000,NE 142,RESIDENTIAL,25200,0,25200,99400,0,124600
141045501200000,NE 142,RESIDENTIAL,29900,0,29900,100900,0,130800
141045501300000,NE 142,RESIDENTIAL,26200,0,26200,98400,0,124600
141045501400000,NE 142,RESIDENTIAL,25200,0,25200,84900,0,110100
141045501500000,NE 142,RESIDENTIAL,25200,0,25200,90800,0,116000
141045501600000,NE 142,RESIDENTIAL,25200,0,25200,114300,0,139500
141045501700000,NE 142,RESIDENTIAL,25200,0,25200,92600,0,117800
141045501800000,NE 142,RESIDENTIAL,29500,0,29500,98500,0,128000
141045501900000,NE 142,RESIDENTIAL,29500,0,29500,127900,0,157400
141045502000000,NE 142,RESIDENTIAL,29500,0,29500,102500,0,132000
141045502100000,NE 142,RESIDENTIAL,29500,0,29500,120800,0,150300
141045502200000,NE 142,RESIDENTIAL,25200,0,25200,101400,0,126600
141045502300000,NE 142,RESIDENTIAL,30300,0,30300,107800,0,138100
141045502400000,NE 142,RESIDENTIAL,33000,0,33000,162300,0,195300
141045600600000,NE 142,RESIDENTIAL,22300,0,22300,127700,0,150000
141045600700000,NE 142,RESIDENTIAL,26500,0,26500,119200,0,145700
141045600800000,NE 142,RESIDENTIAL,26500,0,26500,121400,0,147900
141045600900000,NE 142,RESIDENTIAL,25000,0,25000,108100,0,133100
141045601000000,NE 142,RESIDENTIAL,27300,0,27300,116300,0,143600
141045700100000,NE 142,RESIDENTIAL,32600,0,32600,213700,0,246300
141045700200000,NE 142,RESIDENTIAL,29500,0,29500,132100,0,161600
141045700300000,NE 142,RESIDENTIAL,30000,0,30000,154800,0,184800
141045700400000,NE 142,RESIDENTIAL,29500,0,29500,132900,0,162400
141045700500000,NE 142,RESIDENTIAL,25200,0,25200,98900,0,124100
141045700600000,NE 142,RESIDENTIAL,29500,0,29500,103200,0,132700
141045700700000,NE 142,RESIDENTIAL,29500,0,29500,108500,0,138000
141045700800000,NE 142,RESIDENTIAL,29500,0,29500,122000,0,151500
141045700900000,NE 142,RESIDENTIAL,25200,0,25200,111500,0,136700
141045701000000,NE 142,RESIDENTIAL,25200,0,25200,99400,0,124600
141045701100000,NE 142,RESIDENTIAL,22700,0,22700,85700,0,108400
141045701200000,NE 142,RESIDENTIAL,26800,0,26800,95600,0,122400
141045701300000,NE 142,RESIDENTIAL,30300,0,30300,121000,0,151300
141045701400000,NE 142,RESIDENTIAL,27300,0,27300,161600,0,188900
141045701500000,NE 142,RESIDENTIAL,24600,0,24600,95300,0,119900
141045701600000,NE 142,RESIDENTIAL,26500,0,26500,109000,0,135500
141045701700000,NE 142,RESIDENTIAL,26500,0,26500,90700,0,117200
141045701800000,NE 142,RESIDENTIAL,26500,0,26500,97300,0,123800
141045701900000,NE 142,RESIDENTIAL,26500,0,26500,98300,0,124800
141045702000000,NE 142,RESIDENTIAL,27000,0,27000,129300,0,156300
141045702100000,NE 142,RESIDENTIAL,28800,0,28800,119100,0,147900
141045702200000,NE 142,RESIDENTIAL,29000,0,29000,122600,0,151600
141045702300000,NE 142,RESIDENTIAL,28600,0,28600,111400,0,140000
141045800100000,NE 142,RESIDENTIAL,28400,0,28400,126100,0,154500
141045800200000,NE 142,RESIDENTIAL,28400,0,28400,112600,0,141000
141045800300000,NE 142,RESIDENTIAL,28400,0,28400,139500,0,167900
141045800400000,NE 142,RESIDENTIAL,28300,0,28300,123700,0,152000
141045800500000,NE 142,RESIDENTIAL,26500,0,26500,124700,0,151200
141047600100000,NE 141,RESIDENTIAL,14600,0,14600,53900,0,68500
141047600200000,NE 141,RESIDENTIAL,18000,0,18000,73700,0,91700
141047600300000,NE 141,RESIDENTIAL,19200,0,19200,101800,0,121000
141047600400000,NE 141,RESIDENTIAL,23300,0,23300,108300,0,131600
141047600500000,NE 141,RESIDENTIAL,23300,0,23300,88700,0,112000
141047600600000,NE 141,RESIDENTIAL,24500,0,24500,118600,0,143100
141047600700000,NE 141,RESIDENTIAL,22100,0,22100,45100,0,67200
141047700100000,NE 141,RESIDENTIAL,21800,0,21800,78100,0,99900
141047700200000,NE 141,RESIDENTIAL,14600,0,14600,84900,0,99500
141047700300000,NE 141,RESIDENTIAL,19500,0,19500,91000,0,110500
141047700400000,NE 141,RESIDENTIAL,17600,0,17600,86800,0,104400
141047700500000,NE 141,RESIDENTIAL,15500,0,15500,39500,0,55000
141047700600000,NE 141,RESIDENTIAL,15500,0,15500,46900,0,62400
141047700700000,NE 141,RESIDENTIAL,15500,0,15500,61300,0,76800
141047700800000,NE 141,RESIDENTIAL,23300,0,23300,68000,0,91300
141047700900000,NE 141,RESIDENTIAL,23300,0,23300,75700,0,99000
141047701000000,NE 141,RESIDENTIAL,15500,0,15500,61800,0,77300
141047701100000,NE 141,RESIDENTIAL,15500,0,15500,50200,0,65700
141047701200000,NE 141,RESIDENTIAL,15500,0,15500,61700,0,77200
141047701300000,NE 141,RESIDENTIAL,23300,0,23300,88000,0,111300
141047701400000,NE 141,RESIDENTIAL,23300,0,23300,96100,0,119400
141047701500000,NE 141,RESIDENTIAL,23300,0,23300,75900,0,99200
141047800100000,NE 141,RESIDENTIAL,22500,0,22500,93700,0,116200
141047800200000,NE 141,RESIDENTIAL,22500,0,22500,88200,0,110700
141047800300000,NE 141,RESIDENTIAL,26500,0,26500,80300,0,106800
141047800400000,NE 141,RESIDENTIAL,17800,0,17800,75300,0,93100
141047800500000,NE 141,RESIDENTIAL,20200,0,20200,40300,0,60500
141047800600000,NE 141,RESIDENTIAL,20200,0,20200,80700,0,100900
141047800700000,NE 141,RESIDENTIAL,20200,0,20200,76500,0,96700
141047800800000,NE 141,RESIDENTIAL,20800,0,20800,62500,0,83300
141047800900000,NE 141,RESIDENTIAL,23300,0,23300,61000,0,84300
141047801000000,NE 141,RESIDENTIAL,23300,0,23300,83000,0,106300
141047801100000,NE 141,RESIDENTIAL,23300,0,23300,105400,0,128700
141047801200000,NE 141,RESIDENTIAL,19400,0,19400,120600,0,140000
141047900100000,NE 141,RESIDENTIAL,21200,0,21200,78000,0,99200
141047900200000,NE 141,RESIDENTIAL,19400,0,19400,81400,0,100800
141047900300000,NE 141,RESIDENTIAL,19200,0,19200,63900,0,83100
141047900400000,NE 141,RESIDENTIAL,19200,0,19200,84800,0,104000
141047900500000,NE 141,RESIDENTIAL,19200,0,19200,70800,0,90000
141047900600000,NE 141,RESIDENTIAL,16600,0,16600,75000,0,91600
141047900700000,NE 141,RESIDENTIAL,15200,0,15200,76400,0,91600
141047900800000,NE 141,RESIDENTIAL,14800,0,14800,52100,0,66900
141048000700000,NE 142,RESIDENTIAL,31600,0,31600,162200,0,193800
141048000800000,NE 142,RESIDENTIAL,31600,0,31600,144800,0,176400
141048000900000,NE 142,RESIDENTIAL,28600,0,28600,146400,0,175000
141048001000000,NE 142,RESIDENTIAL,31900,0,31900,151800,0,183700
141048100100000,NE 141,RESIDENTIAL,14400,0,14400,60200,0,74600
141048100200000,NE 141,RESIDENTIAL,25800,0,25800,70600,0,96400
141048100300000,NE 141,RESIDENTIAL,19600,0,19600,88100,0,107700
141048100400000,NE 141,RESIDENTIAL,23300,0,23300,91900,0,115200
141048100500000,NE 141,RESIDENTIAL,23300,0,23300,64200,0,87500
141048100600000,NE 141,RESIDENTIAL,23300,0,23300,136400,0,159700
141048100700000,NE 141,RESIDENTIAL,23300,0,23300,80600,0,103900
141048200100000,NE 141,RESIDENTIAL,23300,0,23300,52700,0,76000
141048200200000,NE 141,RESIDENTIAL,15500,0,15500,63100,0,78600
141048200300000,NE 141,RESIDENTIAL,15500,0,15500,50600,0,66100
141048200400000,NE 141,RESIDENTIAL,15500,0,15500,55600,0,71100
141048200500000,NE 141,RESIDENTIAL,23300,0,23300,92500,0,115800
141048200600000,NE 141,RESIDENTIAL,23300,0,23300,73300,0,96600
141048200700000,NE 141,RESIDENTIAL,27900,0,27900,67900,0,95800
141048200800000,NE 141,RESIDENTIAL,23300,0,23300,102500,0,125800
141048200900000,NE 141,RESIDENTIAL,23300,0,23300,79000,0,102300
141048201000000,NE 141,RESIDENTIAL,23300,0,23300,53600,0,76900
141048201100000,NE 141,RESIDENTIAL,15500,0,15500,51000,0,66500
141048201200000,NE 141,RESIDENTIAL,13600,0,13600,50800,0,64400
141048201300000,NE 141,RESIDENTIAL,17500,0,17500,66700,0,84200
141048201400000,NE 141,RESIDENTIAL,23300,0,23300,107000,0,130300
141048201500000,NE 141,RESIDENTIAL,23300,0,23300,65600,0,88900
141048300100000,NE 141,RESIDENTIAL,23300,0,23300,89000,0,112300
141048300200000,NE 141,RESIDENTIAL,20000,0,20000,107700,0,127700
141048300300000,NE 141,RESIDENTIAL,20000,0,20000,76000,0,96000
141048300400000,NE 141,RESIDENTIAL,20000,0,20000,69200,0,89200
141048300500000,NE 141,RESIDENTIAL,20000,0,20000,92600,0,112600
141048300600000,NE 141,RESIDENTIAL,20000,0,20000,89800,0,109800
141048300700000,NE 141,RESIDENTIAL,20000,0,20000,103900,0,123900
141048300800000,NE 141,RESIDENTIAL,20000,0,20000,47200,0,67200
141048300900000,NE 141,RESIDENTIAL,14400,0,14400,54100,0,68500
141048301000000,NE 141,RESIDENTIAL,14400,0,14400,71000,0,85400
141048301100000,NE 141,RESIDENTIAL,23300,0,23300,83400,0,106700
141048301200000,NE 141,RESIDENTIAL,23300,0,23300,99800,0,123100
141048301300000,NE 141,RESIDENTIAL,23300,0,23300,102600,0,125900
141048301400000,NE 141,RESIDENTIAL,23300,0,23300,78400,0,101700
141048301500000,NE 141,RESIDENTIAL,23300,0,23300,53700,0,77000
141048301600000,NE 141,RESIDENTIAL,23300,0,23300,46600,0,69900
141048400100000,NE 141,RESIDENTIAL,19200,0,19200,82400,0,101600
141048400200000,NE 141,RESIDENTIAL,25900,0,25900,72200,0,98100
141048400300000,NE 141,RESIDENTIAL,25900,0,25900,100500,0,126400
141048400400000,NE 141,RESIDENTIAL,19200,0,19200,86300,0,105500
141048400500000,NE 141,RESIDENTIAL,19200,0,19200,100100,0,119300
141048400600000,NE 141,RESIDENTIAL,15400,0,15400,68600,0,84000
141048400700000,NE 141,RESIDENTIAL,15400,0,15400,88500,0,103900
141048400800000,NE 141,RESIDENTIAL,16200,0,16200,72600,0,88800
141048500100000,FLAT PARKING,COMMERCIAL,0,4400,4400,0,1800,6200
141048500200000,FLAT PARKING,COMMERCIAL,0,4400,4400,0,1800,6200
141048500300000,FLAT PARKING,COMMERCIAL,0,32600,32600,0,24800,57400
141048600100000,NE 141,RESIDENTIAL,14600,0,14600,81700,0,96300
141048600200000,NE 141,RESIDENTIAL,23300,0,23300,120900,0,144200
141048600300000,NE 141,RESIDENTIAL,23300,0,23300,76800,0,100100
141048600400000,NE 141,RESIDENTIAL,23300,0,23300,116900,0,140200
141048600500000,CHURCH,EXEMPT,0,43200,43200,0,76300,119500
141048600600000,NE 141,RESIDENTIAL,22900,0,22900,62100,0,85000
141048600700000,NE 141,RESIDENTIAL,18200,0,18200,112000,0,130200
141048600800000,NE 141,RESIDENTIAL,14600,0,14600,72300,0,86900
141048600900000,NE 141,RESIDENTIAL,14600,0,14600,65200,0,79800
141048601000000,NE 141,RESIDENTIAL,14600,0,14600,68100,0,82700
141048601100000,NE 141,RESIDENTIAL,14600,0,14600,60100,0,74700
141048601200000,NE 141,RESIDENTIAL,14600,0,14600,79000,0,93600
141048700100000,NE 141,RESIDENTIAL,23300,0,23300,65800,0,89100
141048700200000,NE 141,RESIDENTIAL,19300,0,19300,88200,0,107500
141048700300000,NE 141,RESIDENTIAL,28100,0,28100,56400,0,84500
141048700400000,NE 141,RESIDENTIAL,20000,0,20000,93200,0,113200
141048700500000,NE 141,RESIDENTIAL,20000,0,20000,75600,0,95600
141048700600000,NE 141,RESIDENTIAL,20000,0,20000,67800,0,87800
141048700700000,NE 141,RESIDENTIAL,16000,0,16000,52700,0,68700
141048700800000,NE 141,RESIDENTIAL,14800,0,14800,48100,0,62900
141048700900000,NE 141,RESIDENTIAL,14600,0,14600,38000,0,52600
141048701000000,NE 141,RESIDENTIAL,23300,0,23300,69100,0,92400
141048701100000,NE 141,RESIDENTIAL,23300,0,23300,113900,0,137200
141048701200000,NE 141,RESIDENTIAL,23300,0,23300,60700,0,84000
141048701300000,NE 141,RESIDENTIAL,23300,0,23300,111800,0,135100
141048701400000,NE 141,RESIDENTIAL,23300,0,23300,86900,0,110200
141048800100000,NE 141,RESIDENTIAL,19200,0,19200,62100,0,81300
141048800200000,NE 141,RESIDENTIAL,19200,0,19200,86300,0,105500
141048800300000,NE 141,RESIDENTIAL,19200,0,19200,96100,0,115300
141048800400000,NE 141,RESIDENTIAL,19200,0,19200,83400,0,102600
141048800500000,NE 141,RESIDENTIAL,20700,0,20700,79700,0,100400
141048800600000,NE 141,RESIDENTIAL,24100,0,24100,124000,0,148100
141048900100000,NE 142,RESIDENTIAL,28200,0,28200,130500,0,158700
141048900200000,NE 142,RESIDENTIAL,27800,0,27800,138500,0,166300
141048900300000,NE 142,RESIDENTIAL,27000,0,27000,143900,0,170900
141048900400000,NE 142,RESIDENTIAL,28400,0,28400,127100,0,155500
141048900500000,NE 142,RESIDENTIAL,28400,0,28400,142200,0,170600
141048900600000,NE 142,RESIDENTIAL,24600,0,24600,127600,0,152200
141048900700000,NE 142,RESIDENTIAL,24600,0,24600,108500,0,133100
141048900800000,NE 142,RESIDENTIAL,26500,0,26500,82300,0,108800
141048900900000,NE 142,RESIDENTIAL,23400,0,23400,103600,0,127000
141048901000000,NE 142,RESIDENTIAL,25000,0,25000,84700,0,109700
141110100100000,NE 115,RESIDENTIAL,133400,0,133400,573300,0,706700
141110100200000,NE 115,RESIDENTIAL,110000,0,110000,212900,0,322900
141110100300000,VACANT LAND,EXEMPT,0,295200,295200,0,0,295200
141110100400000,NE 115,RESIDENTIAL,30500,0,30500,0,0,30500
141110100500000,NE 115,RESIDENTIAL,122800,0,122800,444600,0,567400
141110100600000,NE 115,RESIDENTIAL,120800,0,120800,322500,0,443300
141110100700000,NE 115,RESIDENTIAL,102700,0,102700,280500,0,383200
141112800300000,APARTMENT,MULTI-RES,20800,0,20800,126600,0,147400
141120100100000,AUTO REPAIR/SALES,COMMERCIAL,0,1593600,1593600,0,1754200,3347800
141120100200000,AUTO REPAIR/SALES,COMMERCIAL,0,48300,48300,0,90100,138400
141120100300000,APARTMENT,RESIDENTIAL,21600,0,21600,131500,0,153100
141120100400000,APARTMENT,MULTI-RES,21600,0,21600,127100,0,148700
141120100500000,APARTMENT,MULTI-RES,21600,0,21600,140100,0,161700
141120100600000,APARTMENT,RESIDENTIAL,21600,0,21600,95800,0,117400
141120100700000,APARTMENT,RESIDENTIAL,21500,0,21500,146400,0,167900
141120100800000,APARTMENT,RESIDENTIAL,21300,0,21300,141300,0,162600
141120100900000,APARTMENT,MULTI-RES,21600,0,21600,127100,0,148700
141120200100000,OFFICE,COMMERCIAL,0,438000,438000,0,763900,1201900
141120200200000,APARTMENT,MULTI-RES,96600,0,96600,300300,0,396900
141120200300000,BRANCH BANK/CU,COMMERCIAL,0,339300,339300,0,1152800,1492100
141120200400000,OFFICE,COMMERCIAL,0,168000,168000,0,460800,628800
141120300200000,APARTMENT,MULTI-RES,25300,0,25300,154400,0,179700
141120300800000,APARTMENT,MULTI-RES,23200,0,23200,142000,0,165200
141120400200000,SE 201,RESIDENTIAL,400,0,400,0,0,400
141120400400000,APARTMENT,EXEMPT,0,112400,112400,0,1007400,1119800
141120400600000,CENTRALLY ASSESSED,OTHER,0,0,0,0,0,0
141120400700000,RESTAURANT,COMMERCIAL,0,652000,652000,0,704300,1356300
141120400800000,AUTO REPAIR/SALES,COMMERCIAL,0,76200,76200,0,65900,142100
141120400900000,WAREHOUSE,COMMERCIAL,0,249900,249900,0,153400,403300
141120400902000,BILLBOARD(BLL),COMMERCIAL,0,0,0,0,23900,23900
141120401000000,SMALL RETAIL,COMMERCIAL,0,192000,192000,0,121200,313200
141120401100000,RESTAURANT,COMMERCIAL,0,147900,147900,0,220000,367900
141120401300000,WAREHOUSE,COMMERCIAL,0,207500,207500,0,387600,595100
141120401400000,VACANT LAND,COMMERCIAL,0,10100,10100,0,0,10100
141120401500000,AUTO REPAIR/SALES,COMMERCIAL,0,627000,627000,0,924400,1551400
141120401600000,CENTRALLY ASSESSED,OTHER,0,0,0,0,0,0
141120401700000,CENTRALLY ASSESSED,OTHER,0,0,0,0,0,0
141122600100000,NE 129,RESIDENTIAL,28200,0,28200,106300,0,134500
141122600200000,NE 129,RESIDENTIAL,27700,0,27700,126800,0,154500
141122600300000,NE 129,RESIDENTIAL,27700,0,27700,91900,0,119600
141122600400000,NE 129,RESIDENTIAL,27700,0,27700,121200,0,148900
141122600500000,NE 129,RESIDENTIAL,27700,0,27700,102600,0,130300
141122600600000,NE 129,RESIDENTIAL,27700,0,27700,124300,0,152000
141122600700000,NE 129,RESIDENTIAL,27300,0,27300,144400,0,171700
141122700100000,NE 129,RESIDENTIAL,39200,0,39200,85600,0,124800
141122700200000,NE 129,RESIDENTIAL,35900,0,35900,110000,0,145900
141122700300000,NE 129,RESIDENTIAL,35900,0,35900,31800,0,67700
141122700400000,NE 129,RESIDENTIAL,30500,0,30500,138500,0,169000
141122700500000,NE 129,RESIDENTIAL,33500,0,33500,115100,0,148600
141122700600000,NE 129,RESIDENTIAL,41900,0,41900,118900,0,160800
141122700700000,CHURCH,EXEMPT,0,425000,425000,0,1412800,1837800
141122700800000,NE 129,RESIDENTIAL,29900,0,29900,143100,0,173000
141122700900000,NE 129,RESIDENTIAL,27200,0,27200,124400,0,151600
141122701000000,NE 129,RESIDENTIAL,25000,0,25000,115100,0,140100
141122701100000,NE 129,RESIDENTIAL,24900,0,24900,90200,0,115100
141122701200000,NE 129,RESIDENTIAL,24900,0,24900,91000,0,115900
141122701300000,NE 129,RESIDENTIAL,24900,0,24900,115000,0,139900
141122701400000,NE 129,RESIDENTIAL,25000,0,25000,119700,0,144700
141122701500000,NE 129,RESIDENTIAL,23400,0,23400,106100,0,129500
141122701600000,NE 129,RESIDENTIAL,24900,0,24900,130200,0,155100
141122701700000,NE 129,RESIDENTIAL,25800,0,25800,121100,0,146900
141122701800000,NE 129,RESIDENTIAL,24700,0,24700,61600,0,86300
141122701900000,NE 129,RESIDENTIAL,25900,0,25900,124600,0,150500
141122702000000,NE 129,RESIDENTIAL,27200,0,27200,70700,0,97900
141122702100000,NE 129,RESIDENTIAL,27200,0,27200,115700,0,142900
141122800100000,AUTO REPAIR/SALES,COMMERCIAL,0,209100,209100,0,102200,311300
141122800200000,OFFICE,COMMERCIAL,0,56300,56300,0,390100,446400
141122800300000,NE 129,RESIDENTIAL,17700,0,17700,0,0,17700
141122800400000,NE 129,RESIDENTIAL,17700,0,17700,70400,0,88100
141122800500000,NE 129,RESIDENTIAL,17700,0,17700,61700,0,79400
141122800600000,NE 129,RESIDENTIAL,17700,0,17700,82300,0,100000
141122800700000,NE 129,RESIDENTIAL,20600,0,20600,151400,0,172000
141122800800000,NE 129,RESIDENTIAL,20500,0,20500,61000,0,81500
141122800900000,NE 129,RESIDENTIAL,20100,0,20100,46800,0,66900
141122801000000,NE 129,RESIDENTIAL,19400,0,19400,73000,0,92400
141122801100000,NE 129,RESIDENTIAL,19000,0,19000,56500,0,75500
141122801200000,NE 129,RESIDENTIAL,18400,0,18400,55400,0,73800
141122801300000,NE 129,RESIDENTIAL,18600,0,18600,86500,0,105100
141122801400000,NE 129,RESIDENTIAL,20700,0,20700,78000,0,98700
141122801500000,NE 129,RESIDENTIAL,21500,0,21500,93300,0,114800
141122801600000,NE 129,RESIDENTIAL,21200,0,21200,81300,0,102500
141122801700000,NE 129,RESIDENTIAL,20500,0,20500,68600,0,89100
141122801800000,NE 129,RESIDENTIAL,20500,0,20500,112100,0,132600
141122801900000,NE 129,RESIDENTIAL,20200,0,20200,75200,0,95400
141122802000000,NE 129,RESIDENTIAL,19700,0,19700,68700,0,88400
141122802100000,NE 129,RESIDENTIAL,21200,0,21200,81400,0,102600
141122802200000,NE 129,RESIDENTIAL,20300,0,20300,82300,0,102600
141122802300000,NE 129,RESIDENTIAL,21000,0,21000,75100,0,96100
141122802400000,NE 129,RESIDENTIAL,21500,0,21500,76200,0,97700
141122802500000,NE 129,RESIDENTIAL,21200,0,21200,82400,0,103600
141122802600000,NE 129,RESIDENTIAL,17300,0,17300,61000,0,78300
141122802700000,NE 129,RESIDENTIAL,18000,0,18000,82600,0,100600
141122802800000,NE 129,RESIDENTIAL,19200,0,19200,71300,0,90500
141122802900000,NE 129,RESIDENTIAL,23000,0,23000,83100,0,106100
141122803000000,NE 129,RESIDENTIAL,22700,0,22700,110100,0,132800
141122803100000,NE 129,RESIDENTIAL,21300,0,21300,74400,0,95700
141122803200000,NE 129,RESIDENTIAL,20300,0,20300,44500,0,64800
141122803300000,NE 129,RESIDENTIAL,20400,0,20400,58700,0,79100
141122803400000,OFFICE,COMMERCIAL,23500,23500,47000,50766,52334,150100
141122803500000,BARS/LOUNGE,COMMERCIAL,0,202200,202200,0,129600,331800
141122900100000,NE 130,RESIDENTIAL,18100,0,18100,106600,0,124700
141122900200000,NE 130,RESIDENTIAL,19400,0,19400,91600,0,111000
141122900300000,NE 130,RESIDENTIAL,19400,0,19400,87700,0,107100
141122900400000,NE 130,RESIDENTIAL,16800,0,16800,35300,0,52100
141122900700000,NE 130,RESIDENTIAL,15700,0,15700,46100,0,61800
141122900800000,NE 130,RESIDENTIAL,15700,0,15700,86100,0,101800
141122900900000,NE 130,RESIDENTIAL,15700,0,15700,62600,0,78300
141122901000000,NE 130,RESIDENTIAL,15700,0,15700,79900,0,95600
141122901100000,NE 130,RESIDENTIAL,15700,0,15700,66200,0,81900
141122901300000,NE 130,RESIDENTIAL,23200,0,23200,102300,0,125500
141122901400000,NE 130,RESIDENTIAL,20400,0,20400,96800,0,117200
141123000100000,NE 129,RESIDENTIAL,15200,0,15200,100800,0,116000
141123000200000,NE 129,RESIDENTIAL,22100,0,22100,74300,0,96400
141123000300000,NE 129,RESIDENTIAL,22200,0,22200,68100,0,90300
141123000400000,NE 129,RESIDENTIAL,22700,0,22700,91700,0,114400
141123000500000,NE 129,RESIDENTIAL,22900,0,22900,76400,0,99300
141123000600000,NE 129,RESIDENTIAL,23100,0,23100,73400,0,96500
141123000700000,NE 129,RESIDENTIAL,21300,0,21300,98700,0,120000
141123000800000,NE 129,RESIDENTIAL,22700,0,22700,60300,0,83000
141123000900000,NE 129,RESIDENTIAL,22700,0,22700,70800,0,93500
141123001000000,NE 129,RESIDENTIAL,22000,0,22000,79900,0,101900
141123001100000,NE 129,RESIDENTIAL,19900,0,19900,76400,0,96300
141123001200000,NE 129,RESIDENTIAL,20700,0,20700,72500,0,93200
141123001300000,NE 129,RESIDENTIAL,20500,0,20500,76500,0,97000
141123001400000,NE 129,RESIDENTIAL,16700,0,16700,50700,0,67400
141123001500000,NE 129,RESIDENTIAL,17700,0,17700,71200,0,88900
141123001600000,NE 129,RESIDENTIAL,17500,0,17500,67400,0,84900
141123001700000,NE 129,RESIDENTIAL,20500,0,20500,92400,0,112900
141123001800000,NE 129,RESIDENTIAL,20000,0,20000,66400,0,86400
141123001900000,NE 129,RESIDENTIAL,19800,0,19800,68700,0,88500
141123002000000,NE 129,RESIDENTIAL,19500,0,19500,59500,0,79000
141123002100000,NE 129,RESIDENTIAL,21800,0,21800,65800,0,87600
141123002200000,NE 129,RESIDENTIAL,22200,0,22200,43600,0,65800
141123002300000,NE 129,RESIDENTIAL,22000,0,22000,89700,0,111700
141123002400000,NE 129,RESIDENTIAL,21800,0,21800,88700,0,110500
141123002500000,NE 129,RESIDENTIAL,23600,0,23600,108100,0,131700
141123002600000,NE 129,RESIDENTIAL,20000,0,20000,90400,0,110400
141123002700000,NE 129,RESIDENTIAL,20500,0,20500,0,0,20500
141123002800000,NE 129,RESIDENTIAL,16900,0,16900,73300,0,90200
141123002900000,OFFICE,COMMERCIAL,0,52700,52700,0,53500,106200
141123100100000,OFFICE,COMMERCIAL,0,39400,39400,0,68800,108200
141123100200000,NE 129,RESIDENTIAL,16700,0,16700,81100,0,97800
141123100300000,NE 129,RESIDENTIAL,14000,0,14000,70100,0,84100
141123100400000,NE 129,RESIDENTIAL,21200,0,21200,66500,0,87700
141123100500000,NE 129,RESIDENTIAL,21100,0,21100,90800,0,111900
141123100600000,NE 129,RESIDENTIAL,21700,0,21700,83500,0,105200
141123100700000,NE 129,RESIDENTIAL,12700,0,12700,0,0,12700
141123100800000,NE 129,RESIDENTIAL,17000,0,17000,71900,0,88900
141123100900000,NE 129,RESIDENTIAL,17300,0,17300,57700,0,75000
141123101000000,NE 129,RESIDENTIAL,19500,0,19500,61600,0,81100
141123101100000,NE 129,RESIDENTIAL,22600,0,22600,59600,0,82200
141123101200000,NE 129,RESIDENTIAL,23300,0,23300,78500,0,101800
141123101300000,NE 129,RESIDENTIAL,20800,0,20800,43500,0,64300
141123101400000,NE 129,RESIDENTIAL,26600,0,26600,60300,0,86900
141123101500000,NE 129,RESIDENTIAL,19400,0,19400,53100,0,72500
141123101600000,NE 129,RESIDENTIAL,23100,0,23100,73500,0,96600
141123101700000,NE 129,RESIDENTIAL,23900,0,23900,99200,0,123100
141123101800000,NE 129,RESIDENTIAL,12800,0,12800,102300,0,115100
141123101900000,NE 129,RESIDENTIAL,15200,0,15200,111200,0,126400
141123102000000,NE 129,RESIDENTIAL,14900,0,14900,80000,0,94900
141123102100000,NE 129,RESIDENTIAL,14600,0,14600,65600,0,80200
141123102200000,NE 129,RESIDENTIAL,16900,0,16900,120700,0,137600
141123102300000,NE 129,RESIDENTIAL,18900,0,18900,115400,0,134300
141123102400000,NE 129,RESIDENTIAL,15200,0,15200,69700,0,84900
141123102500000,NE 129,RESIDENTIAL,14300,0,14300,76600,0,90900
141123102600000,NE 129,RESIDENTIAL,10800,0,10800,123500,0,134300
141123102700000,NE 129,RESIDENTIAL,17300,0,17300,84400,0,101700
141123102800000,NE 129,RESIDENTIAL,18600,0,18600,72800,0,91400
141123102900000,NE 129,RESIDENTIAL,15900,0,15900,70100,0,86000
141123103000000,OFFICE,COMMERCIAL,0,62600,62600,0,66400,129000
141123200100000,NE 130,RESIDENTIAL,15700,0,15700,64300,0,80000
141123200200000,NE 130,RESIDENTIAL,15700,0,15700,62500,0,78200
141123200300000,NE 130,RESIDENTIAL,20400,0,20400,102800,0,123200
141123200400000,NE 130,RESIDENTIAL,15700,0,15700,86300,0,102000
141123200500000,NE 130,RESIDENTIAL,15700,0,15700,81500,0,97200
141123200600000,NE 130,RESIDENTIAL,20400,0,20400,87700,0,108100
141123200700000,NE 130,RESIDENTIAL,18800,0,18800,63400,0,82200
141123200800000,NE 130,RESIDENTIAL,22300,0,22300,73300,0,95600
141123200900000,NE 130,RESIDENTIAL,19400,0,19400,83800,0,103200
141123201000000,NE 130,RESIDENTIAL,22100,0,22100,106600,0,128700
141123201100000,NE 130,RESIDENTIAL,22100,0,22100,97900,0,120000
141123201200000,NE 130,RESIDENTIAL,17600,0,17600,111800,0,129400
141123201300000,NE 130,RESIDENTIAL,19100,0,19100,73600,0,92700
141123201400000,NE 130,RESIDENTIAL,19100,0,19100,87100,0,106200
141123201500000,NE 130,RESIDENTIAL,15700,0,15700,38800,0,54500
141123201600000,NE 130,RESIDENTIAL,15700,0,15700,88200,0,103900
141123201700000,NE 130,RESIDENTIAL,15700,0,15700,74500,0,90200
141123300100000,RESTAURANT,COMMERCIAL,0,207700,207700,0,183600,391300
141125100100000,NBHD SHOPPING CENTER,COMMERCIAL,0,1125000,1125000,0,3679300,4804300
141125100200000,SMALL RETAIL,COMMERCIAL,0,59900,59900,0,98300,158200
141125100300000,FLAT PARKING,COMMERCIAL,0,50600,50600,0,23800,74400
141125100400000,LG DISCOUNT/RETAIL,COMMERCIAL,0,77000,77000,0,557000,634000
141125200100000,OFFICE; MEDICAL,COMMERCIAL,0,183100,183100,0,698100,881200
141125200200000,NE 129,RESIDENTIAL,18200,0,18200,111100,0,129300
141125200300000,NE 129,RESIDENTIAL,19700,0,19700,59700,0,79400
141125200400000,NE 129,RESIDENTIAL,19700,0,19700,68400,0,88100
141125200500000,NE 129,RESIDENTIAL,19700,0,19700,77600,0,97300
141125200600000,NE 129,RESIDENTIAL,19700,0,19700,80000,0,99700
141125200700000,NE 129,RESIDENTIAL,19700,0,19700,100000,0,119700
141125200800000,NE 129,RESIDENTIAL,19700,0,19700,124100,0,143800
141125200900000,NE 129,RESIDENTIAL,19700,0,19700,114900,0,134600
141125201000000,NE 129,RESIDENTIAL,19700,0,19700,111200,0,130900
141125201100000,NE 129,RESIDENTIAL,19700,0,19700,86900,0,106600
141125201200000,NE 129,RESIDENTIAL,19700,0,19700,89400,0,109100
141125201300000,NE 129,RESIDENTIAL,19700,0,19700,99300,0,119000
141125201400000,NE 129,RESIDENTIAL,19700,0,19700,87600,0,107300
141125201500000,NE 129,RESIDENTIAL,19700,0,19700,77700,0,97400
141125201600000,NE 129,RESIDENTIAL,19300,0,19300,86000,0,105300
141125201700000,NE 129,RESIDENTIAL,18800,0,18800,88800,0,107600
141125201800000,NE 129,RESIDENTIAL,18900,0,18900,85800,0,104700
141125201900000,NE 129,RESIDENTIAL,20000,0,20000,81900,0,101900
141125202000000,NE 129,RESIDENTIAL,19900,0,19900,90400,0,110300
141125202100000,NE 129,RESIDENTIAL,19000,0,19000,94300,0,113300
141125202200000,NE 129,RESIDENTIAL,19700,0,19700,95400,0,115100
141125202300000,NE 129,RESIDENTIAL,19700,0,19700,71600,0,91300
141125202400000,NE 129,RESIDENTIAL,19700,0,19700,86300,0,106000
141125202500000,NE 129,RESIDENTIAL,19700,0,19700,108500,0,128200
141125202600000,NE 129,RESIDENTIAL,19700,0,19700,96300,0,116000
141125202700000,NE 129,RESIDENTIAL,19700,0,19700,70400,0,90100
141125202800000,NE 129,RESIDENTIAL,19700,0,19700,160900,0,180600
141125202900000,NE 129,RESIDENTIAL,27600,0,27600,117700,0,145300
141125203000000,NE 129,RESIDENTIAL,24000,0,24000,105100,0,129100
141125203100000,NE 129,RESIDENTIAL,16000,0,16000,122100,0,138100
141125203200000,FLAT PARKING,COMMERCIAL,0,50100,50100,0,3600,53700
141125203300000,OFFICE,COMMERCIAL,0,48300,48300,0,149000,197300
141125203400000,SMALL RETAIL,COMMERCIAL,0,66900,66900,0,95200,162100
141125203500000,OFFICE,COMMERCIAL,0,70900,70900,0,143500,214400
141125300100000,CHURCH,EXEMPT,0,244000,244000,0,453000,697000
141125300200000,APARTMENT,MULTI-RES,57800,0,57800,782200,0,840000
141125300300000,NE 129,RESIDENTIAL,19700,0,19700,96000,0,115700
141125300400000,NE 129,RESIDENTIAL,23600,0,23600,106700,0,130300
141125300500000,NE 129,RESIDENTIAL,23600,0,23600,87300,0,110900
141125300600000,NE 129,RESIDENTIAL,23600,0,23600,84200,0,107800
141125300700000,NE 129,RESIDENTIAL,23600,0,23600,91500,0,115100
141125300800000,NE 129,RESIDENTIAL,20000,0,20000,99900,0,119900
141125300900000,NE 129,RESIDENTIAL,15100,0,15100,91100,0,106200
141125301000000,NE 129,RESIDENTIAL,15100,0,15100,114000,0,129100
141125301100000,NE 129,RESIDENTIAL,18400,0,18400,67500,0,85900
141125301200000,NE 129,RESIDENTIAL,18400,0,18400,109000,0,127400
141125301300000,NE 129,RESIDENTIAL,4800,0,4800,0,0,4800
141125301400000,NE 129,RESIDENTIAL,16700,0,16700,107500,0,124200
141125301500000,NE 129,RESIDENTIAL,20100,0,20100,122000,0,142100
141125301600000,NE 129,RESIDENTIAL,27600,0,27600,148900,0,176500
141125301700000,NE 129,RESIDENTIAL,23600,0,23600,150200,0,173800
141125301800000,NE 129,RESIDENTIAL,23600,0,23600,156700,0,180300
141125301900000,APARTMENT,MULTI-RES,25200,0,25200,123000,0,148200
141125302000000,FLAT PARKING,EXEMPT,0,128600,128600,0,15300,143900
141125302100000,OFFICE,COMMERCIAL,0,169400,169400,0,775800,945200
141125302400000,FLAT PARKING,EXEMPT,0,115500,115500,0,12900,128400
141125400100000,SE 201,RESIDENTIAL,10200,0,10200,100000,0,110200
141125400200000,SE 201,RESIDENTIAL,10200,0,10200,82100,0,92300
141125400300000,SE 201,RESIDENTIAL,8200,0,8200,50100,0,58300
141125400400000,AUTO REPAIR/SALES,COMMERCIAL,0,147000,147000,0,250900,397900
141125401000000,SE 201,RESIDENTIAL,10200,0,10200,66100,0,76300
141125401100000,SE 201,RESIDENTIAL,10900,0,10900,78000,0,88900
141125401200000,SE 201,RESIDENTIAL,11000,0,11000,74400,0,85400
141125401300000,SE 201,RESIDENTIAL,11000,0,11000,56100,0,67100
141125401400000,SE 201,RESIDENTIAL,11000,0,11000,53400,0,64400
141125401500000,SE 201,RESIDENTIAL,11000,0,11000,63000,0,74000
141125401600000,SE 201,RESIDENTIAL,11000,0,11000,66000,0,77000
141125401700000,SE 201,RESIDENTIAL,11000,0,11000,84300,0,95300
141125401800000,SE 201,RESIDENTIAL,11000,0,11000,74500,0,85500
141125401900000,SE 201,RESIDENTIAL,11000,0,11000,77700,0,88700
141125402000000,NBHD SHOPPING CENTER,COMMERCIAL,0,156800,156800,0,462900,619700
141125402100000,BRANCH BANK/CU,COMMERCIAL,0,184000,184000,0,650400,834400
141125500100000,BRANCH BANK/CU,COMMERCIAL,0,532000,532000,0,372300,904300
141125500200000,NE 129,RESIDENTIAL,22100,0,22100,114600,0,136700
141125500300000,NE 129,RESIDENTIAL,20100,0,20100,97900,0,118000
141125500400000,NE 129,RESIDENTIAL,19700,0,19700,105700,0,125400
141125500500000,NE 129,RESIDENTIAL,19700,0,19700,102000,0,121700
141125500600000,CONVERSION-NE/SE,MULTI-RES,24100,0,24100,27100,0,51200
141125500700000,NE 129,RESIDENTIAL,23600,0,23600,115500,0,139100
141125500800000,NE 129,RESIDENTIAL,20900,0,20900,116500,0,137400
141125500900000,NE 129,RESIDENTIAL,21300,0,21300,106400,0,127700
141125501000000,NE 129,RESIDENTIAL,20900,0,20900,106400,0,127300
141125501100000,NE 129,RESIDENTIAL,15800,0,15800,69300,0,85100
141125501200000,NE 129,RESIDENTIAL,15800,0,15800,70100,0,85900
141125501300000,NE 129,RESIDENTIAL,17600,0,17600,86300,0,103900
141125501400000,NE 129,RESIDENTIAL,16300,0,16300,101600,0,117900
141125501500000,NE 129,RESIDENTIAL,25200,0,25200,69900,0,95100
141125501600000,NE 129,RESIDENTIAL,24000,0,24000,85000,0,109000
141125501700000,NE 129,RESIDENTIAL,17900,0,17900,49500,0,67400
141125501800000,NE 129,RESIDENTIAL,17900,0,17900,89000,0,106900
141125501900000,NE 129,RESIDENTIAL,26800,0,26800,74600,0,101400
141125502000000,NE 129,RESIDENTIAL,17900,0,17900,58500,0,76400
141125502100000,NE 129,RESIDENTIAL,22800,0,22800,85200,0,108000
141125502200000,NE 129,RESIDENTIAL,22300,0,22300,101800,0,124100
141125502300000,NE 129,RESIDENTIAL,20100,0,20100,68800,0,88900
141125502400000,NE 129,RESIDENTIAL,20100,0,20100,92900,0,113000
141125502500000,NE 129,RESIDENTIAL,15600,0,15600,76000,0,91600
141125502600000,NE 129,RESIDENTIAL,15600,0,15600,93800,0,109400
141127600200000,APARTMENT,RESIDENTIAL,28000,0,28000,110800,0,138800
141127600300000,SE 201,RESIDENTIAL,18200,0,18200,70100,0,88300
141127600400000,VACANT LAND,COMMERCIAL,0,1000,1000,0,0,1000
141127600500000,VACANT LAND,COMMERCIAL,0,14500,14500,0,26800,41300
141127600600000,SE 201,RESIDENTIAL,21000,0,21000,77100,0,98100
141127600700000,SE 201,RESIDENTIAL,14200,0,14200,42300,0,56500
141127600800000,SE 201,RESIDENTIAL,12600,0,12600,80500,0,93100
141127600900000,SE 201,RESIDENTIAL,12600,0,12600,66200,0,78800
141127601000000,SE 201,RESIDENTIAL,12600,0,12600,50000,0,62600
141127601100000,SE 201,RESIDENTIAL,12500,0,12500,76400,0,88900
141127601200000,SE 201,RESIDENTIAL,12500,0,12500,59000,0,71500
141127601300000,SE 201,RESIDENTIAL,12500,0,12500,65500,0,78000
141127601400000,SE 201,RESIDENTIAL,12700,0,12700,79600,0,92300
141127601700000,SE 201,RESIDENTIAL,19600,0,19600,102300,0,121900
141127601800000,SE 201,RESIDENTIAL,17400,0,17400,74800,0,92200
141127601900000,SE 201,RESIDENTIAL,15700,0,15700,78500,0,94200
141127602000000,SE 201,RESIDENTIAL,15700,0,15700,57900,0,73600
141127602100000,SE 201,RESIDENTIAL,15700,0,15700,78100,0,93800
141127602200000,SE 201,RESIDENTIAL,20200,0,20200,91200,0,111400
141127602400000,APARTMENT,RESIDENTIAL,495700,0,495700,3780400,0,4276100
141127602500000,SE 201,RESIDENTIAL,16800,0,16800,61000,0,77800
141127602600000,SE 201,RESIDENTIAL,18000,0,18000,57800,0,75800
141127602700000,SE 201,RESIDENTIAL,20000,0,20000,79800,0,99800
141127602800000,SE 201,RESIDENTIAL,22900,0,22900,81200,0,104100
141127602900000,SE 201,RESIDENTIAL,19500,0,19500,68000,0,87500
141127603000000,SE 201,RESIDENTIAL,16500,0,16500,48500,0,65000
141127603100000,SE 201,RESIDENTIAL,19500,0,19500,97000,0,116500
141127603200000,CITY PROPERTY,EXEMPT,0,0,0,0,0,0
141127603300000,SE 201,RESIDENTIAL,14400,0,14400,78700,0,93100
141127603400000,SE 201,RESIDENTIAL,18100,0,18100,114800,0,132900
141127603500000,VACANT LAND,COMMERCIAL,0,4300,4300,0,0,4300
141127603600000,APARTMENT,MULTI-RES,389600,0,389600,2525000,0,2914600
141130100100000,SE 201,RESIDENTIAL,18300,0,18300,105800,0,124100
141130100200000,SE 201,RESIDENTIAL,18300,0,18300,124800,0,143100
141130100300000,SE 201,RESIDENTIAL,18300,0,18300,114800,0,133100
141130100400000,SE 201,RESIDENTIAL,18300,0,18300,76000,0,94300
141130100500000,SE 201,RESIDENTIAL,11400,0,11400,45900,0,57300
141130100600000,SE 201,RESIDENTIAL,11400,0,11400,24800,0,36200
141130100700000,SE 201,RESIDENTIAL,18300,0,18300,75300,0,93600
141130100800000,SE 201,RESIDENTIAL,18300,0,18300,92600,0,110900
141130100900000,SE 201,RESIDENTIAL,11400,0,11400,80800,0,92200
141130101000000,SE 201,RESIDENTIAL,11400,0,11400,54200,0,65600
141130101100000,SE 201,RESIDENTIAL,18300,0,18300,78400,0,96700
141130101200000,SE 201,RESIDENTIAL,18300,0,18300,70500,0,88800
141130101300000,SE 201,RESIDENTIAL,18300,0,18300,75800,0,94100
141130101400000,SE 201,RESIDENTIAL,18300,0,18300,97700,0,116000
141130101500000,SE 201,RESIDENTIAL,18300,0,18300,129500,0,147800
141130101600000,SE 201,RESIDENTIAL,20000,0,20000,87000,0,107000
141130101700000,SE 201,RESIDENTIAL,17100,0,17100,81400,0,98500
141130101800000,SE 201,RESIDENTIAL,18300,0,18300,57200,0,75500
141130101900000,SE 201,RESIDENTIAL,18300,0,18300,87900,0,106200
141130102000000,SE 201,RESIDENTIAL,18300,0,18300,100900,0,119200
141130102100000,SE 201,RESIDENTIAL,18300,0,18300,76600,0,94900
141130102200000,SE 201,RESIDENTIAL,18300,0,18300,46800,0,65100
141130102300000,SE 201,RESIDENTIAL,18300,0,18300,94300,0,112600
141130102400000,SE 201,RESIDENTIAL,20000,0,20000,97200,0,117200
141130102500000,SE 201,RESIDENTIAL,17100,0,17100,55600,0,72700
141130102600000,SE 201,RESIDENTIAL,14500,0,14500,79000,0,93500
141130102700000,SE 201,RESIDENTIAL,14300,0,14300,86300,0,100600
141130200100000,VACANT LAND,COMMERCIAL,0,16900,16900,0,0,16900
141130200300000,SE 201,RESIDENTIAL,17700,0,17700,100300,0,118000
141130200400000,FEDERAL PROPERTY,EXEMPT,0,0,0,0,0,0
141130300100000,APARTMENT,RESIDENTIAL,27500,0,27500,229500,0,257000
141130300200000,SE 201,RESIDENTIAL,11900,0,11900,69700,0,81600
141130300300000,SE 201,RESIDENTIAL,11600,0,11600,73600,0,85200
141130300400000,SE 201,RESIDENTIAL,18800,0,18800,70200,0,89000
141130300500000,SE 201,RESIDENTIAL,17600,0,17600,102900,0,120500
141130300600000,SE 201,RESIDENTIAL,18800,0,18800,100500,0,119300
141130300700000,SE 201,RESIDENTIAL,11800,0,11800,46100,0,57900
141130300800000,SE 201,RESIDENTIAL,11800,0,11800,61400,0,73200
141130300900000,SE 201,RESIDENTIAL,18800,0,18800,51700,0,70500
141130301000000,SE 201,RESIDENTIAL,11800,0,11800,35100,0,46900
141130301100000,SE 201,RESIDENTIAL,11800,0,11800,54900,0,66700
141130301200000,SE 201,RESIDENTIAL,18800,0,18800,65900,0,84700
141130301300000,SE 201,RESIDENTIAL,18800,0,18800,68400,0,87200
141130301400000,SE 201,RESIDENTIAL,18800,0,18800,53200,0,72000
141130301500000,SE 201,RESIDENTIAL,18800,0,18800,74200,0,93000
141130301600000,WAREHOUSE,COMMERCIAL,0,141300,141300,0,256700,398000
141130301700000,WAREHOUSE,COMMERCIAL,0,63400,63400,0,225100,288500
141130301800000,WAREHOUSE,COMMERCIAL,0,230000,230000,0,571200,801200
141130400100000,VACANT LAND,COMMERCIAL,0,11400,11400,0,0,11400
141130400200000,WAREHOUSE,COMMERCIAL,0,76600,76600,0,166400,243000
141130400300000,APARTMENT,MULTI-RES,17200,0,17200,115100,0,132300
141130400400000,CONVERSION-NE/SE,MULTI-RES,19800,0,19800,109900,0,129700
141130400600000,VACANT LAND,COMMERCIAL,0,14100,14100,0,0,14100
141130500100000,CEMETERY,EXEMPT,0,492000,492000,0,0,492000
141130500200000,CENTRALLY ASSESSED,OTHER,0,0,0,0,0,0
141130500300000,SHOP,COMMERCIAL,0,49600,49600,0,209100,258700
141130500400000,WAREHOUSE,COMMERCIAL,0,323100,323100,0,730800,1053900
141130500500000,FLAT PARKING,COMMERCIAL,0,25600,25600,0,3600,29200
141130500700000,CITY PROPERTY,EXEMPT,0,0,0,0,0,0
141130500800000,CITY PROPERTY,EXEMPT,0,0,0,0,0,0
141130500900000,SE 201,RESIDENTIAL,21600,0,21600,87700,0,109300
141132600100000,SE 201,RESIDENTIAL,11400,0,11400,59300,0,70700
141132600200000,SE 201,RESIDENTIAL,11400,0,11400,75300,0,86700
141132600300000,SE 201,RESIDENTIAL,11400,0,11400,50100,0,61500
141132600400000,SE 201,RESIDENTIAL,11400,0,11400,55400,0,66800
141132600500000,OFFICE; MEDICAL,COMMERCIAL,0,344800,344800,0,667700,1012500
141132600600000,APARTMENT,MULTI-RES,25400,0,25400,102200,0,127600
141132600700000,APARTMENT,MULTI-RES,25100,0,25100,96300,0,121400
141132600800000,SE 201,RESIDENTIAL,11400,0,11400,45400,0,56800
141132601000000,SE 201,RESIDENTIAL,18300,0,18300,110400,0,128700
141132700100000,CONVENIENCE STORE,COMMERCIAL,0,381200,381200,0,524600,905800
141132700200000,NE 129,RESIDENTIAL,27300,0,27300,85800,0,113100
141132700300000,NE 129,RESIDENTIAL,27300,0,27300,94300,0,121600
141132700400000,NE 129,RESIDENTIAL,18200,0,18200,85000,0,103200
141132700500000,NE 129,RESIDENTIAL,18200,0,18200,92100,0,110300
141132700600000,NE 129,RESIDENTIAL,27300,0,27300,112100,0,139400
141132700700000,SCHOOL,EXEMPT,0,228800,228800,0,608000,836800
141132700800000,NE 129,RESIDENTIAL,19300,0,19300,85100,0,104400
141132700900000,NE 129,RESIDENTIAL,20400,0,20400,62900,0,83300
141132701000000,NE 129,RESIDENTIAL,20000,0,20000,85900,0,105900
141132701100000,NE 129,RESIDENTIAL,22700,0,22700,83200,0,105900
141132701200000,NE 129,RESIDENTIAL,22700,0,22700,98800,0,121500
141132701300000,NE 129,RESIDENTIAL,20000,0,20000,81100,0,101100
141132701400000,NE 129,RESIDENTIAL,22700,0,22700,63700,0,86400
141132701500000,NE 129,RESIDENTIAL,22700,0,22700,86000,0,108700
141132701600000,NE 129,RESIDENTIAL,22700,0,22700,82300,0,105000
141132701700000,NE 129,RESIDENTIAL,22700,0,22700,86600,0,109300
141132701800000,NE 129,RESIDENTIAL,22700,0,22700,63000,0,85700
141132701900000,NE 129,RESIDENTIAL,22700,0,22700,80700,0,103400
141132702000000,NE 129,RESIDENTIAL,17300,0,17300,59300,0,76600
141132702100000,CONVERSION-NE/SE,MULTI-RES,19300,0,19300,56200,0,75500
141132702200000,NE 129,RESIDENTIAL,15100,0,15100,61600,0,76700
141132702300000,NE 129,RESIDENTIAL,12100,0,12100,63600,0,75700
141132702400000,VACANT LAND,COMMERCIAL,0,33400,33400,0,0,33400
141132702500000,CONVERSIONS; NON-APT,COMMERCIAL,0,84400,84400,0,85700,170100
141132800100000,SE 201,RESIDENTIAL,11500,0,11500,46700,0,58200
141132800200000,SE 201,RESIDENTIAL,17300,0,17300,95100,0,112400
141132800300000,SE 201,RESIDENTIAL,17300,0,17300,62800,0,80100
141132800400000,SE 201,RESIDENTIAL,11500,0,11500,62300,0,73800
141132800500000,SE 201,RESIDENTIAL,11500,0,11500,71600,0,83100
141132800600000,AUTO REPAIR/SALES,COMMERCIAL,0,100200,100200,0,62100,162300
141132800700000,VACANT LAND,COMMERCIAL,0,71400,71400,0,5000,76400
141132800702000,BILLBOARD(BLL),COMMERCIAL,0,0,0,0,24000,24000
141132800800000,OFFICE; MEDICAL,COMMERCIAL,0,67000,67000,0,172700,239700
141132800900000,FAST FOOD,COMMERCIAL,0,90700,90700,0,182600,273300
141132801000000,SE 201,RESIDENTIAL,10300,0,10300,0,0,10300
141132801100000,SE 201,RESIDENTIAL,18000,0,18000,24800,0,42800
141132801200000,SE 201,RESIDENTIAL,18000,0,18000,43700,0,61700
141132801300000,SE 201,RESIDENTIAL,12000,0,12000,67200,0,79200
141132801400000,SE 201,RESIDENTIAL,12000,0,12000,70100,0,82100
141132801500000,SE 201,RESIDENTIAL,12000,0,12000,79000,0,91000
141132900100000,AUTO REPAIR/SALES,COMMERCIAL,0,44000,44000,0,42900,86900
141132900200000,SMALL RETAIL,COMMERCIAL,3640,1560,5200,44310,18990,68500
141132900300000,FLAT PARKING,COMMERCIAL,0,2000,2000,0,0,2000
141132900400000,NE 129,RESIDENTIAL,15000,0,15000,83000,0,98000
141132900500000,NE 129,RESIDENTIAL,27300,0,27300,42800,0,70100
141132900600000,NE 129,RESIDENTIAL,27300,0,27300,107600,0,134900
141132900700000,NE 129,RESIDENTIAL,22700,0,22700,87100,0,109800
141132900800000,NE 129,RESIDENTIAL,22700,0,22700,56400,0,79100
141132901000000,NE 129,RESIDENTIAL,23400,0,23400,79800,0,103200
141132901100000,NE 129,RESIDENTIAL,27300,0,27300,132900,0,160200
141132901200000,NE 129,RESIDENTIAL,23500,0,23500,103700,0,127200
141132901300000,NE 129,RESIDENTIAL,17900,0,17900,62800,0,80700
141132901400000,NE 129,RESIDENTIAL,17100,0,17100,97100,0,114200
141132901500000,NE 129,RESIDENTIAL,24500,0,24500,61300,0,85800
141132901600000,NE 129,RESIDENTIAL,24100,0,24100,96100,0,120200
141132901800000,NE 129,RESIDENTIAL,18200,0,18200,76000,0,94200
141132901900000,NE 129,RESIDENTIAL,27300,0,27300,95300,0,122600
141132902000000,FRATERNAL,EXEMPT,0,44400,44400,0,13500,57900
141132902100000,NE 129,RESIDENTIAL,19600,0,19600,87400,0,107000
141132902200000,CONVERSION-NE/SE,MULTI-RES,9500,0,9500,60700,0,70200
141132902600000,RESTAURANT,COMMERCIAL,0,164700,164700,0,204800,369500
141132902602000,FAST FOOD,COMMERCIAL,0,0,0,0,67200,67200
141132902700000,NBHD SHOPPING CENTER,COMMERCIAL,0,240000,240000,0,720300,960300
141132902900000,NE 129,RESIDENTIAL,3400,0,3400,0,0,3400
141132903000000,CHURCH,EXEMPT,0,257600,257600,0,657800,915400
141133000100000,SE 201,RESIDENTIAL,18000,0,18000,19800,0,37800
141133000200000,FLAT PARKING,COMMERCIAL,0,69600,69600,0,1900,71500
141133000300000,FLAT PARKING,COMMERCIAL,0,69600,69600,0,1900,71500
141133000400000,WAREHOUSE,COMMERCIAL,0,50400,50400,0,6000,56400
141133000500000,SMALL RETAIL,COMMERCIAL,0,121400,121400,0,171200,292600
141133000600000,SMALL RETAIL,COMMERCIAL,0,117500,117500,0,185100,302600
141133000700000,SMALL RETAIL,COMMERCIAL,0,68300,68300,0,50600,118900
141133000800000,SMALL RETAIL,COMMERCIAL,0,94500,94500,0,95000,189500
141133000900000,BARS/LOUNGE,COMMERCIAL,0,42200,42200,0,182300,224500
141133001000000,BARS/LOUNGE,COMMERCIAL,0,42200,42200,0,126100,168300
141133001100000,SMALL RETAIL,COMMERCIAL,0,52400,52400,0,78800,131200
141133001200000,SMALL RETAIL,COMMERCIAL,0,19300,19300,0,129700,149000
141133001300000,SMALL RETAIL,COMMERCIAL,0,203800,203800,0,456600,660400
141133100100000,AUTO REPAIR/SALES,COMMERCIAL,0,55900,55900,0,125000,180900
141133100200000,VETERINARY CLINIC,COMMERCIAL,0,20800,20800,0,68700,89500
141133100300000,SMALL RETAIL,COMMERCIAL,2919,10981,13900,20685,77815,112400
141133100400000,NE 129,RESIDENTIAL,17400,0,17400,84200,0,101600
141133100500000,NE 129,RESIDENTIAL,17600,0,17600,74500,0,92100
141133100600000,NE 129,RESIDENTIAL,30100,0,30100,105200,0,135300
141133100700000,CONVERSION-NE/SE,MULTI-RES,24000,0,24000,34100,0,58100
141133100800000,NE 129,RESIDENTIAL,16900,0,16900,86800,0,103700
141133100900000,NE 129,RESIDENTIAL,21600,0,21600,74100,0,95700
141133101000000,NE 129,RESIDENTIAL,23400,0,23400,135400,0,158800
141133101100000,NE 129,RESIDENTIAL,27000,0,27000,124600,0,151600
141133101200000,NE 129,RESIDENTIAL,28700,0,28700,101300,0,130000
141133101300000,NE 129,RESIDENTIAL,18900,0,18900,89900,0,108800
141133101400000,NE 129,RESIDENTIAL,16400,0,16400,92800,0,109200
141133101500000,NE 129,RESIDENTIAL,23900,0,23900,85900,0,109800
141133101900000,APARTMENT,MULTI-RES,22000,0,22000,363500,0,385500
141133102000000,APARTMENT,MULTI-RES,23900,0,23900,189700,0,213600
141133102100000,APARTMENT,MULTI-RES,22900,0,22900,189100,0,212000
141133102200000,NE 129,RESIDENTIAL,16700,0,16700,81800,0,98500
141133102300000,NE 129,RESIDENTIAL,20400,0,20400,141400,0,161800
141133102400000,NE 129,RESIDENTIAL,18500,0,18500,91600,0,110100
141133102500000,APARTMENT,MULTI-RES,46100,0,46100,386600,0,432700
141133102600000,FAST FOOD,COMMERCIAL,0,300800,300800,0,565100,865900
141133102700000,CARWASH,COMMERCIAL,13860,78540,92400,39670,182230,314300
141133102800000,FRATERNAL,EXEMPT,0,56800,56800,0,186300,243100
141135100100000,WAREHOUSE,COMMERCIAL,0,136300,136300,0,160300,296600
141135100200000,SMALL RETAIL,COMMERCIAL,0,150500,150500,0,201000,351500
141135100300000,OFFICE,COMMERCIAL,0,397100,397100,0,1047300,1444400
141135100400000,SMALL RETAIL,COMMERCIAL,0,98100,98100,0,253200,351300
141135200100000,CONVENIENCE STORE,COMMERCIAL,0,48000,48000,0,0,48000
141135200200000,CONVENIENCE STORE,COMMERCIAL,0,92000,92000,0,0,92000
141135200300000,CONVENIENCE STORE,COMMERCIAL,0,56000,56000,0,0,56000
141135200400000,NE 141,RESIDENTIAL,20600,0,20600,71200,0,91800
141135200500000,NE 141,RESIDENTIAL,20600,0,20600,72100,0,92700
141135200600000,NE 141,RESIDENTIAL,20600,0,20600,53000,0,73600
141135200700000,NE 141,RESIDENTIAL,20600,0,20600,78800,0,99400
141135200800000,NE 141,RESIDENTIAL,20600,0,20600,71100,0,91700
141135200900000,NE 141,RESIDENTIAL,20600,0,20600,62600,0,83200
141135201000000,NE 141,RESIDENTIAL,20600,0,20600,55000,0,75600
141135201200000,APARTMENT,MULTI-RES,13900,0,13900,104500,0,118400
141135201300000,APARTMENT,MULTI-RES,14100,0,14100,123000,0,137100
141135201500000,APARTMENT,RESIDENTIAL,32400,0,32400,262700,0,295100
141135201600000,NE 141,RESIDENTIAL,22000,0,22000,59000,0,81000
141135201700000,NE 141,RESIDENTIAL,22000,0,22000,36100,0,58100
141135201800000,NE 141,RESIDENTIAL,22000,0,22000,91300,0,113300
141135201900000,NE 141,RESIDENTIAL,22000,0,22000,70500,0,92500
141135202000000,NE 141,RESIDENTIAL,22000,0,22000,69700,0,91700
141135202100000,NE 141,RESIDENTIAL,22000,0,22000,80800,0,102800
141135202400000,WAREHOUSE,COMMERCIAL,0,57600,57600,0,165700,223300
141135202500000,NE 141,RESIDENTIAL,15500,0,15500,79900,0,95400
141135202600000,NE 141,RESIDENTIAL,19400,0,19400,90900,0,110300
141135202700000,LAUNDROMAT/CLEANERS,COMMERCIAL,0,44100,44100,0,60900,105000
141135202800000,BARS/LOUNGE,COMMERCIAL,0,44100,44100,0,45300,89400
141135202802000,BILLBOARD(BLL),COMMERCIAL,0,0,0,0,19000,19000
141135202900000,CONVENIENCE STORE,COMMERCIAL,0,356000,356000,0,967700,1323700
141135203000000,CONVENIENCE STORE,COMMERCIAL,0,124000,124000,0,0,124000
141135203100000,NE 141,RESIDENTIAL,17300,0,17300,73300,0,90600
141135203200000,APARTMENT,MULTI-RES,31500,0,31500,318400,0,349900
141135300100000,OFFICE,COMMERCIAL,0,153000,153000,0,262400,415400
141135300200000,WAREHOUSE,COMMERCIAL,0,139500,139500,0,1007000,1146500
141135300300000,CITY PROPERTY,EXEMPT,0,0,0,0,0,0
141135300400000,SHOP,COMMERCIAL,0,15900,15900,0,52200,68100
141135300500000,CITY PROPERTY,EXEMPT,0,0,0,0,0,0
141135300600000,SMALL RETAIL,COMMERCIAL,12402,10998,23400,35068,46032,104500
141135300700000,SMALL RETAIL,COMMERCIAL,11368,130732,142100,12424,129876,284400
141135300800000,VACANT LAND,COMMERCIAL,0,472800,472800,0,0,472800
141135300900000,VACANT LAND,COMMERCIAL,0,11800,11800,0,0,11800
141135301000000,VACANT LAND,COMMERCIAL,0,14500,14500,0,0,14500
141135301100000,VACANT LAND,COMMERCIAL,0,9000,9000,0,0,9000
141135301102000,BILLBOARD(BLL),COMMERCIAL,0,0,0,0,21300,21300
141135301200000,WAREHOUSE,COMMERCIAL,0,484100,484100,0,1184000,1668100
141135301300000,VACANT LAND,COMMERCIAL,0,61400,61400,0,0,61400
141135400100000,WAREHOUSE,COMMERCIAL,0,31700,31700,0,160300,192000
141135400200000,WAREHOUSE,COMMERCIAL,0,25500,25500,0,161000,186500
141135400300000,SMALL RETAIL,COMMERCIAL,0,11900,11900,0,100000,111900
141135400400000,SE 201,RESIDENTIAL,6000,0,6000,25100,0,31100
141135400500000,SMALL RETAIL,COMMERCIAL,0,45400,45400,0,85900,131300
141135400600000,VACANT LAND,COMMERCIAL,0,45400,45400,0,100,45500
141135400700000,OFFICE,COMMERCIAL,0,18900,18900,0,102600,121500
141135400800000,WAREHOUSE,COMMERCIAL,0,30800,30800,0,57200,88000
141135400900000,PRINTING,INDUSTRIAL,0,45400,45400,0,171500,216900
141135401000000,SMALL RETAIL,COMMERCIAL,0,126500,126500,0,187100,313600
141137600100000,CEMETERY,EXEMPT,0,49000,49000,0,64700,113700
141137600200000,SE 201,RESIDENTIAL,14700,0,14700,45400,0,60100
141137600300000,CEMETERY,EXEMPT,0,19400,19400,0,0,19400
141137600400000,CITY PROPERTY,EXEMPT,0,0,0,0,0,0
141137600500000,CITY PROPERTY,EXEMPT,0,0,0,0,0,0
141137600600000,CITY PROPERTY,EXEMPT,0,0,0,0,0,0
141137600700000,SE 201,RESIDENTIAL,14400,0,14400,64900,0,79300
141137600800000,SE 201,RESIDENTIAL,14400,0,14400,57600,0,72000
141137600900000,SE 201,RESIDENTIAL,14400,0,14400,55900,0,70300
141137601000000,SE 201,RESIDENTIAL,14400,0,14400,75100,0,89500
141137601100000,SE 201,RESIDENTIAL,14400,0,14400,49300,0,63700
141137601200000,SE 201,RESIDENTIAL,14400,0,14400,86200,0,100600
141137601300000,SE 201,RESIDENTIAL,14400,0,14400,77500,0,91900
141137601400000,SE 201,RESIDENTIAL,14400,0,14400,79700,0,94100
141137601500000,SE 201,RESIDENTIAL,18900,0,18900,72200,0,91100
141137601600000,SE 201,RESIDENTIAL,18400,0,18400,62300,0,80700
141137601700000,SE 201,RESIDENTIAL,17000,0,17000,66200,0,83200
141137700100000,SE 201,RESIDENTIAL,12000,0,12000,75700,0,87700
141137700200000,SE 201,RESIDENTIAL,12900,0,12900,50200,0,63100
141137700300000,SE 201,RESIDENTIAL,18600,0,18600,36800,0,55400
141137700600000,FEED/ADDITIVE;INDUST,INDUSTRIAL,0,1332500,1332500,0,6554900,7887400
141137701500000,SE 201,RESIDENTIAL,18900,0,18900,87800,0,106700
141137800100000,SE 201,RESIDENTIAL,10300,0,10300,11800,0,22100
141137800200000,SE 201,RESIDENTIAL,14100,0,14100,85600,0,99700
141137800300000,SE 201,RESIDENTIAL,14300,0,14300,36400,0,50700
141137800400000,SE 201,RESIDENTIAL,14400,0,14400,40600,0,55000
141137800500000,SE 201,RESIDENTIAL,14400,0,14400,53300,0,67700
141137800600000,SE 201,RESIDENTIAL,14400,0,14400,56000,0,70400
141137800700000,SE 201,RESIDENTIAL,14400,0,14400,31300,0,45700
141137800800000,SE 201,RESIDENTIAL,14400,0,14400,78000,0,92400
141137800900000,SE 201,RESIDENTIAL,15300,0,15300,54700,0,70000
141137801000000,SE 201,RESIDENTIAL,15500,0,15500,76600,0,92100
141137801100000,SE 201,RESIDENTIAL,9600,0,9600,23900,0,33500
141137801200000,SE 201,RESIDENTIAL,9600,0,9600,35100,0,44700
141137801300000,SE 201,RESIDENTIAL,16300,0,16300,29900,0,46200
141137801400000,SE 201,RESIDENTIAL,19800,0,19800,62900,0,82700
141137801500000,SE 201,RESIDENTIAL,9800,0,9800,0,0,9800
141137801600000,SE 201,RESIDENTIAL,10400,0,10400,78500,0,88900
141137801700000,SE 201,RESIDENTIAL,8800,0,8800,0,0,8800
141137801800000,SE 201,RESIDENTIAL,14600,0,14600,45800,0,60400
141137801900000,SE 201,RESIDENTIAL,14400,0,14400,82500,0,96900
141137802000000,SE 201,RESIDENTIAL,14400,0,14400,60300,0,74700
141137802100000,SE 201,RESIDENTIAL,14400,0,14400,29000,0,43400
141137802200000,SE 201,RESIDENTIAL,14400,0,14400,76100,0,90500
141137802300000,SE 201,RESIDENTIAL,14400,0,14400,69700,0,84100
141137802400000,SE 201,RESIDENTIAL,14400,0,14400,37700,0,52100
141137802500000,SE 201,RESIDENTIAL,14400,0,14400,67300,0,81700
141137802600000,SE 201,RESIDENTIAL,11800,0,11800,44500,0,56300
141137802700000,SE 201,RESIDENTIAL,16800,0,16800,14100,0,30900
141137802800000,SE 201,RESIDENTIAL,16400,0,16400,34400,0,50800
141137900100000,SE 201,RESIDENTIAL,14300,0,14300,67500,0,81800
141137900200000,SE 201,RESIDENTIAL,14400,0,14400,47000,0,61400
141137900300000,SE 201,RESIDENTIAL,14400,0,14400,52900,0,67300
141137900400000,SE 201,RESIDENTIAL,14400,0,14400,24900,0,39300
141137900500000,SE 201,RESIDENTIAL,14400,0,14400,60000,0,74400
141137900600000,SE 201,RESIDENTIAL,14400,0,14400,48400,0,62800
141137900700000,SE 201,RESIDENTIAL,14400,0,14400,86300,0,100700
141137900800000,SE 201,RESIDENTIAL,14400,0,14400,76000,0,90400
141137900900000,SE 201,RESIDENTIAL,14400,0,14400,48000,0,62400
141137901000000,SE 201,RESIDENTIAL,14400,0,14400,89600,0,104000
141137901100000,SE 201,RESIDENTIAL,14400,0,14400,85000,0,99400
141137901200000,SE 201,RESIDENTIAL,14400,0,14400,64500,0,78900
141137901300000,SE 201,RESIDENTIAL,14400,0,14400,41600,0,56000
141137901400000,SE 201,RESIDENTIAL,14400,0,14400,67700,0,82100
141137901500000,SE 201,RESIDENTIAL,14100,0,14100,44300,0,58400
141137901600000,SE 201,RESIDENTIAL,12800,0,12800,25300,0,38100
141137901700000,SE 201,RESIDENTIAL,8600,0,8600,40800,0,49400
141137901800000,SE 201,RESIDENTIAL,8600,0,8600,41700,0,50300
141137901900000,SE 201,RESIDENTIAL,8600,0,8600,38800,0,47400
141137902000000,SE 201,RESIDENTIAL,11400,0,11400,55400,0,66800
141137902100000,SE 201,RESIDENTIAL,9000,0,9000,36500,0,45500
141137902200000,SE 201,RESIDENTIAL,8000,0,8000,36000,0,44000
141137902300000,SE 201,RESIDENTIAL,17400,0,17400,0,0,17400
141137902400000,SE 201,RESIDENTIAL,13700,0,13700,99700,0,113400
141137902500000,SE 201,RESIDENTIAL,18100,0,18100,69100,0,87200
141137902600000,SE 201,RESIDENTIAL,22300,0,22300,80100,0,102400
141137902700000,SE 201,RESIDENTIAL,16900,0,16900,75700,0,92600
141137902800000,SE 201,RESIDENTIAL,12700,0,12700,53100,0,65800
141137902900000,SE 201,RESIDENTIAL,15900,0,15900,66100,0,82000
141137903000000,SE 201,RESIDENTIAL,18100,0,18100,55400,0,73500
141137903100000,SE 201,RESIDENTIAL,15800,0,15800,117000,0,132800
141137903200000,SE 201,RESIDENTIAL,16000,0,16000,41900,0,57900
141137903300000,SE 201,RESIDENTIAL,22300,0,22300,71600,0,93900
141137903400000,SE 201,RESIDENTIAL,16100,0,16100,53000,0,69100
141137903500000,SE 201,RESIDENTIAL,16100,0,16100,55000,0,71100
141137903600000,SE 201,RESIDENTIAL,16100,0,16100,65200,0,81300
141137903700000,SE 201,RESIDENTIAL,16100,0,16100,70000,0,86100
141137903800000,SE 201,RESIDENTIAL,19100,0,19100,72300,0,91400
141137903900000,SE 201,RESIDENTIAL,13100,0,13100,59800,0,72900
141137904000000,SE 201,RESIDENTIAL,13700,0,13700,58300,0,72000
141137904100000,SE 201,RESIDENTIAL,13400,0,13400,68600,0,82000
141137904200000,SE 201,RESIDENTIAL,15300,0,15300,98200,0,113500
141138000100000,APARTMENT,MULTI-RES,53000,0,53000,292900,0,345900
141138000200000,SE 201,RESIDENTIAL,18000,0,18000,58700,0,76700
141138000300000,SE 201,RESIDENTIAL,17300,0,17300,66100,0,83400
141138000400000,SE 201,RESIDENTIAL,12000,0,12000,63700,0,75700
141138000500000,SE 201,RESIDENTIAL,20000,0,20000,73900,0,93900
141138000600000,SE 201,RESIDENTIAL,14500,0,14500,87300,0,101800
141138000700000,SE 201,RESIDENTIAL,14200,0,14200,80200,0,94400
141138000800000,SE 201,RESIDENTIAL,14300,0,14300,72500,0,86800
141138000900000,SE 201,RESIDENTIAL,18900,0,18900,77500,0,96400
141138001000000,APARTMENT,MULTI-RES,17100,0,17100,199800,0,216900
141138001100000,SE 201,RESIDENTIAL,15600,0,15600,82600,0,98200
141138001200000,APARTMENT,RESIDENTIAL,47300,0,47300,516700,0,564000
141138001300000,SE 201,RESIDENTIAL,22000,0,22000,37200,0,59200
141138001400000,SE 201,RESIDENTIAL,20800,0,20800,47800,0,68600
141138001500000,SE 201,RESIDENTIAL,20800,0,20800,56000,0,76800
141138001700000,CITY PROPERTY,EXEMPT,0,0,0,0,0,0
141138001800000,CITY PROPERTY,EXEMPT,0,0,0,0,0,0
141138001900000,APARTMENT,RESIDENTIAL,82400,0,82400,866600,0,949000
141138100100000,SE 201,RESIDENTIAL,11700,0,11700,69400,0,81100
141138100200000,AUTO REPAIR/SALES,COMMERCIAL,0,51300,51300,0,239900,291200
141138100300000,SHOP,COMMERCIAL,0,28200,28200,0,163400,191600
141138100400000,WAREHOUSE,COMMERCIAL,0,46200,46200,0,213800,260000
141138100500000,VACANT LAND,COMMERCIAL,0,20500,20500,0,0,20500
141138100600000,WAREHOUSE,COMMERCIAL,0,172000,172000,0,755700,927700
141138100700000,OFFICE,COMMERCIAL,0,18200,18200,0,73100,91300
141138100800000,AUTO REPAIR/SALES,COMMERCIAL,0,21700,21700,0,66900,88600
141138100900000,APARTMENT,MULTI-RES,38800,0,38800,258100,0,296900
141140200600000,SE 202,RESIDENTIAL,34600,0,34600,230000,0,264600
141142601200000,CEMETERY,EXEMPT,0,560000,560000,0,0,560000
141142601300000,CEMETERY,EXEMPT,0,628800,628800,0,0,628800
141145100100000,SE 202,RESIDENTIAL,37600,0,37600,81000,0,118600
141145100200000,SE 202,RESIDENTIAL,30200,0,30200,55600,0,85800
141145100300000,SE 202,RESIDENTIAL,30000,0,30000,106900,0,136900
141145100400000,SE 202,RESIDENTIAL,46400,0,46400,197100,0,243500
141145100500000,SE 202,RESIDENTIAL,38800,0,38800,139000,0,177800
141145100600000,SE 202,RESIDENTIAL,45600,0,45600,146200,0,191800
141145100700000,SE 202,RESIDENTIAL,45400,0,45400,161800,0,207200
141145100800000,SE 202,RESIDENTIAL,30900,0,30900,132300,0,163200
141145100900000,SE 202,RESIDENTIAL,29500,0,29500,111700,0,141200
141145101000000,SE 202,RESIDENTIAL,42300,0,42300,167000,0,209300
141145101100000,SE 202,RESIDENTIAL,23300,0,23300,141100,0,164400
141145101200000,SE 202,RESIDENTIAL,32400,0,32400,134300,0,166700
141145200100000,CEMETERY,EXEMPT,0,560000,560000,0,0,560000
141145200200000,SE 202,RESIDENTIAL,35600,0,35600,83200,0,118800
141145200300000,SE 202,RESIDENTIAL,25500,0,25500,95900,0,121400
141145200400000,SE 202,RESIDENTIAL,25800,0,25800,122900,0,148700
141145200700000,SE 202,RESIDENTIAL,15800,0,15800,133900,0,149700
141145200800000,SE 202,RESIDENTIAL,25400,0,25400,133900,0,159300
141145300100000,SE 202,RESIDENTIAL,40000,0,40000,136200,0,176200
141145300500000,SE 202,RESIDENTIAL,20400,0,20400,157400,0,177800
141145300600000,SE 202,RESIDENTIAL,19300,0,19300,144400,0,163700
141145400100000,SE 202,RESIDENTIAL,16300,0,16300,0,0,16300
141145400200000,SE 202,RESIDENTIAL,11900,0,11900,70800,0,82700
141145500100000,SE 202,RESIDENTIAL,46300,0,46300,231200,0,277500
141145500200000,SE 257,RESIDENTIAL,46400,0,46400,312700,0,359100
141145500300000,SE 257,RESIDENTIAL,58100,0,58100,266800,0,324900
141145500400000,SE 257,RESIDENTIAL,88100,0,88100,264600,0,352700
141145500500000,SE 257,RESIDENTIAL,70800,0,70800,331400,0,402200
141145500600000,SE 257,RESIDENTIAL,65400,0,65400,304800,0,370200
141145500700000,SE 257,RESIDENTIAL,52900,0,52900,244100,0,297000
141145500800000,SE 257,RESIDENTIAL,54300,0,54300,226800,0,281100
141145600100000,SE 202,RESIDENTIAL,85900,0,85900,147900,0,233800
141145700100000,SE 202,RESIDENTIAL,16800,0,16800,0,0,16800
141145700200000,SE 202,RESIDENTIAL,23500,0,23500,161800,0,185300
141145700300000,SE 202,RESIDENTIAL,16800,0,16800,79600,0,96400
141145700400000,SE 202,RESIDENTIAL,31500,0,31500,78000,0,109500
141145700500000,SE 202,RESIDENTIAL,25200,0,25200,60900,0,86100
141145700600000,SE 202,RESIDENTIAL,20100,0,20100,94400,0,114500
141145700700000,CITY PROPERTY,EXEMPT,0,0,0,0,0,0
141147600100000,SE 202,RESIDENTIAL,6500,0,6500,70300,0,76800
141147600200000,SE 202,RESIDENTIAL,24000,0,24000,141800,0,165800
141147600300000,SE 202,RESIDENTIAL,24000,0,24000,115100,0,139100
141147600400000,SE 202,RESIDENTIAL,24500,0,24500,129900,0,154400
141147600500000,SE 202,RESIDENTIAL,25000,0,25000,107800,0,132800
141147600600000,SE 202,RESIDENTIAL,25000,0,25000,189400,0,214400
141147600700000,SE 202,RESIDENTIAL,30600,0,30600,125400,0,156000
141147600800000,SE 202,RESIDENTIAL,3900,0,3900,0,0,3900
141147600900000,SE 202,RESIDENTIAL,24000,0,24000,75500,0,99500
141147700100000,SE 202,RESIDENTIAL,12000,0,12000,139300,0,151300
141147700200000,SE 202,RESIDENTIAL,30600,0,30600,141200,0,171800
141147700300000,SE 202,RESIDENTIAL,32100,0,32100,197100,0,229200
141147700400000,SE 202,RESIDENTIAL,22500,0,22500,198500,0,221000
141147700500000,SE 202,RESIDENTIAL,23700,0,23700,272200,0,295900
141147700600000,SE 202,RESIDENTIAL,2000,0,2000,0,0,2000
141147800100000,SE 202,RESIDENTIAL,35100,0,35100,203900,0,239000
141147800200000,SE 202,RESIDENTIAL,18000,0,18000,96000,0,114000
141147800300000,SE 202,RESIDENTIAL,18000,0,18000,104100,0,122100
141147800400000,SE 202,RESIDENTIAL,24000,0,24000,104200,0,128200
141147800500000,SE 202,RESIDENTIAL,41700,0,41700,143000,0,184700
141147800600000,CENTRALLY ASSESSED,OTHER,0,0,0,0,0,0
141147800700000,CENTRALLY ASSESSED,OTHER,0,0,0,0,0,0
141147800800000,CENTRALLY ASSESSED,OTHER,0,0,0,0,0,0
141147900100000,SE 202,RESIDENTIAL,27200,0,27200,82800,0,110000
141147900200000,SE 202,RESIDENTIAL,15600,0,15600,95100,0,110700
141147900300000,SE 202,RESIDENTIAL,15600,0,15600,101700,0,117300
141147900400000,SE 202,RESIDENTIAL,24000,0,24000,134600,0,158600
141147900700000,SE 202,RESIDENTIAL,28300,0,28300,70400,0,98700
141147900800000,SE 202,RESIDENTIAL,31000,0,31000,138700,0,169700
141147900900000,SE 202,RESIDENTIAL,18600,0,18600,76300,0,94900
141147901000000,SE 202,RESIDENTIAL,23300,0,23300,156400,0,179700
141147901100000,SE 202,RESIDENTIAL,9900,0,9900,0,0,9900
141147901200000,SE 202,RESIDENTIAL,19800,0,19800,118700,0,138500
141147901300000,SE 202,RESIDENTIAL,5200,0,5200,2400,0,7600
141147901400000,SE 202,RESIDENTIAL,24500,0,24500,143700,0,168200
141147901500000,SE 202,RESIDENTIAL,34500,0,34500,103900,0,138400
141147901600000,SE 202,RESIDENTIAL,16400,0,16400,155400,0,171800
141147901700000,SE 202,RESIDENTIAL,21800,0,21800,118400,0,140200
141147901800000,SE 202,RESIDENTIAL,25000,0,25000,94200,0,119200
141147901900000,SE 202,RESIDENTIAL,20800,0,20800,127500,0,148300
141147902000000,SE 202,RESIDENTIAL,16700,0,16700,43400,0,60100
141147902100000,SE 202,RESIDENTIAL,15800,0,15800,82400,0,98200
141147902200000,SE 202,RESIDENTIAL,7700,0,7700,0,0,7700
141147902300000,SE 202,RESIDENTIAL,4200,0,4200,0,0,4200
141147902400000,SE 202,RESIDENTIAL,8600,0,8600,0,0,8600
141147902500000,SE 202,RESIDENTIAL,4400,0,4400,0,0,4400
141147902600000,SE 202,RESIDENTIAL,8800,0,8800,159100,0,167900
141147903000000,SE 202,RESIDENTIAL,8300,0,8300,0,0,8300
141147903100000,SE 202,RESIDENTIAL,12400,0,12400,0,0,12400
141147903200000,SE 202,RESIDENTIAL,17000,0,17000,215400,0,232400
141147903400000,SE 202,RESIDENTIAL,3600,0,3600,0,0,3600
141147903500000,SE 202,RESIDENTIAL,3600,0,3600,0,0,3600
141147903600000,SE 202,RESIDENTIAL,23400,0,23400,53600,0,77000
141147903700000,SE 202,RESIDENTIAL,23500,0,23500,106100,0,129600
141147903800000,SE 202,RESIDENTIAL,33600,0,33600,124100,0,157700
141148000100000,SE 202,RESIDENTIAL,28200,0,28200,141600,0,169800
141148000200000,SE 202,RESIDENTIAL,51300,0,51300,112500,0,163800
141148000300000,SE 202,RESIDENTIAL,39900,0,39900,181300,0,221200
141148000400000,SE 202,RESIDENTIAL,24500,0,24500,135400,0,159900
141148000500000,SE 202,RESIDENTIAL,15600,0,15600,0,0,15600
141148000600000,SE 202,RESIDENTIAL,29000,0,29000,148400,0,177400
141148100100000,SE 202,RESIDENTIAL,45700,0,45700,79900,0,125600
141148100200000,SE 257,RESIDENTIAL,40200,0,40200,324300,0,364500
141148100300000,SE 257,RESIDENTIAL,100300,0,100300,196800,0,297100
141148100400000,SE 257,RESIDENTIAL,20000,0,20000,0,0,20000
141148100600000,SE 257,RESIDENTIAL,103500,0,103500,268600,0,372100
141148100700000,SE 257,RESIDENTIAL,39200,0,39200,0,0,39200
141148100800000,SE 257,RESIDENTIAL,31000,0,31000,0,0,31000
141148100900000,SE 257,RESIDENTIAL,50800,0,50800,0,0,50800
141148101000000,SE 257,RESIDENTIAL,55300,0,55300,312200,0,367500
141148101100000,SE 257,RESIDENTIAL,57000,0,57000,232300,0,289300
141148101200000,SE 257,RESIDENTIAL,71200,0,71200,299300,0,370500
141148101300000,SE 257,RESIDENTIAL,74900,0,74900,294400,0,369300
141148101400000,SE 257,RESIDENTIAL,70100,0,70100,289500,0,359600
141148101500000,SE 257,RESIDENTIAL,67200,0,67200,240000,0,307200
141148101600000,SE 257,RESIDENTIAL,64800,0,64800,244400,0,309200
141148101700000,SE 257,RESIDENTIAL,61700,0,61700,193800,0,255500
141148101800000,SE 257,RESIDENTIAL,82000,0,82000,389700,0,471700
141148101900000,SE 257,RESIDENTIAL,39200,0,39200,234600,0,273800
141148102000000,SE 257,RESIDENTIAL,69400,0,69400,315700,0,385100
141148102100000,SE 257,RESIDENTIAL,60400,0,60400,233600,0,294000
141148102400000,SE 257,RESIDENTIAL,91300,0,91300,271300,0,362600
141148102500000,SE 257,RESIDENTIAL,26400,0,26400,0,0,26400
141148102600000,SE 257,RESIDENTIAL,45700,0,45700,283600,0,329300
141235100600000,SE 202,RESIDENTIAL,34700,0,34700,170400,0,205100
141235100800000,SE 202,RESIDENTIAL,28600,0,28600,161900,0,190500
141235100900000,SE 202,RESIDENTIAL,27700,0,27700,113800,0,141500
141235101000000,SE 202,RESIDENTIAL,43900,0,43900,182100,0,226000
141235200600000,SE 202,RESIDENTIAL,42400,0,42400,108900,0,151300
141235200700000,SE 202,RESIDENTIAL,42300,0,42300,156600,0,198900
141235200800000,SE 202,RESIDENTIAL,53600,0,53600,186900,0,240500
141235200900000,SE 202,RESIDENTIAL,74600,0,74600,149400,0,224000
141235201000000,SE 202,RESIDENTIAL,59900,0,59900,152400,0,212300
141322601500000,SE 202,RESIDENTIAL,159200,0,159200,567600,0,726800
141322601600000,SE 202,RESIDENTIAL,152900,0,152900,803600,0,956500
141330102100000,SE 211,RESIDENTIAL,90600,0,90600,251100,0,341700
141332600900000,CITY PROPERTY,EXEMPT,0,0,0,0,0,0
141332601000000,CHURCH,EXEMPT,0,467400,467400,0,2163500,2630900
141332601100000,CHURCH,EXEMPT,0,360000,360000,0,1579900,1939900
141335100100000,SE 211,RESIDENTIAL,44100,0,44100,0,0,44100
141335100200000,SE 211,RESIDENTIAL,44000,0,44000,358500,0,402500
141335100300000,SE 211,RESIDENTIAL,46200,0,46200,243500,0,289700
141335100400000,SE 211,RESIDENTIAL,6500,0,6500,0,0,6500
141335100500000,SE 211,RESIDENTIAL,64800,0,64800,418800,0,483600
141335100600000,SE 211,RESIDENTIAL,55700,0,55700,0,0,55700
141335100700000,SE 211,RESIDENTIAL,44000,0,44000,0,0,44000
141335100800000,SE 211,RESIDENTIAL,44100,0,44100,225100,0,269200
141335100900000,SE 211,RESIDENTIAL,53100,0,53100,161500,0,214600
141335101000000,SE 211,RESIDENTIAL,53100,0,53100,187400,0,240500
141335101100000,CHURCH,EXEMPT,0,158200,158200,0,378100,536300
141335101600000,SE 211,RESIDENTIAL,105200,0,105200,228300,0,333500
141335101800000,SE 211,RESIDENTIAL,89900,0,89900,349400,0,439300
141335101900000,SE 211,RESIDENTIAL,56200,0,56200,249300,0,305500
141335102000000,SE 211,RESIDENTIAL,145900,0,145900,254900,0,400800
141335102100000,SE 211,RESIDENTIAL,137700,0,137700,436000,0,573700
141335102200000,SE 211,RESIDENTIAL,141700,0,141700,304900,0,446600
141335102300000,SE 211,RESIDENTIAL,145300,0,145300,261700,0,407000
141335102400000,SE 211,RESIDENTIAL,136400,0,136400,329100,0,465500
141335102500000,SE 211,RESIDENTIAL,141800,0,141800,174100,0,315900
141335200100000,SE 211,RESIDENTIAL,49900,0,49900,170300,0,220200
141335200400000,SE 211,RESIDENTIAL,49900,0,49900,163600,0,213500
141335200500000,SE 211,RESIDENTIAL,52800,0,52800,199000,0,251800
141335200600000,SE 211,RESIDENTIAL,46300,0,46300,165900,0,212200
141335200700000,SE 211,RESIDENTIAL,53500,0,53500,178500,0,232000
141337600100000,SE 210,RESIDENTIAL,131200,0,131200,326100,0,457300
141337600200000,SE 210,RESIDENTIAL,100800,0,100800,60500,0,161300
141337600300000,SE 210,RESIDENTIAL,101500,0,101500,89600,0,191100
141337600500000,SE 210,RESIDENTIAL,198600,0,198600,660800,0,859400
141337600600000,SE 210,RESIDENTIAL,194500,0,194500,642700,0,837200
141337600700000,SE 210,RESIDENTIAL,192900,0,192900,590100,0,783000
141337601000000,SE 210,RESIDENTIAL,39200,0,39200,249900,0,289100
141337601100000,SE 210,RESIDENTIAL,38500,0,38500,224300,0,262800
141337601200000,SE 210,RESIDENTIAL,40600,0,40600,207200,0,247800
141337601300000,SE 210,RESIDENTIAL,42300,0,42300,221300,0,263600
141337601400000,SE 210,RESIDENTIAL,43400,0,43400,208100,0,251500
141337601500000,SE 210,RESIDENTIAL,45000,0,45000,227100,0,272100
141337601600000,SE 210,RESIDENTIAL,39400,0,39400,177300,0,216700
141337601700000,SE 210,RESIDENTIAL,43700,0,43700,260000,0,303700
141337601800000,SE 210,RESIDENTIAL,45700,0,45700,211800,0,257500
141337601900000,SE 210,RESIDENTIAL,40500,0,40500,235800,0,276300
141337602000000,CITY PROPERTY,EXEMPT,0,0,0,0,0,0
141337602100000,CITY PROPERTY,EXEMPT,0,0,0,0,0,0
141337700100000,SE 210,RESIDENTIAL,37900,0,37900,182800,0,220700
141337700200000,SE 210,RESIDENTIAL,36000,0,36000,186400,0,222400
141337700300000,SE 210,RESIDENTIAL,35900,0,35900,173500,0,209400
141337700400000,SE 210,RESIDENTIAL,38700,0,38700,205700,0,244400
141337700500000,SE 210,RESIDENTIAL,41900,0,41900,176100,0,218000
141337700600000,SE 210,RESIDENTIAL,44400,0,44400,226200,0,270600
141340100300000,SE 244,RESIDENTIAL,5900,0,5900,0,0,5900
141340200300000,SE 209,RESIDENTIAL,94900,0,94900,197800,0,292700
141340200400000,SE 209,RESIDENTIAL,94400,0,94400,307600,0,402000
141345100100000,SE 209,RESIDENTIAL,58100,0,58100,140700,0,198800
141345100200000,SE 209,RESIDENTIAL,59400,0,59400,164000,0,223400
141345100300000,SE 209,RESIDENTIAL,81500,0,81500,160700,0,242200
141345100500000,SE 209,RESIDENTIAL,84600,0,84600,165300,0,249900
141345100600000,SE 209,RESIDENTIAL,90100,0,90100,138400,0,228500
141345100700000,SE 209,RESIDENTIAL,84900,0,84900,141400,0,226300
141345100800000,SE 209,RESIDENTIAL,56500,0,56500,132000,0,188500
141345100900000,SE 209,RESIDENTIAL,56500,0,56500,155400,0,211900
141345101000000,SE 209,RESIDENTIAL,56500,0,56500,133400,0,189900
141345101100000,SE 209,RESIDENTIAL,48000,0,48000,121900,0,169900
141345101200000,SE 209,RESIDENTIAL,48000,0,48000,139300,0,187300
141345101300000,SE 209,RESIDENTIAL,54500,0,54500,129700,0,184200
141345200100000,SE 209,RESIDENTIAL,45300,0,45300,167700,0,213000
141345200200000,SE 209,RESIDENTIAL,42000,0,42000,145600,0,187600
141345200300000,SE 209,RESIDENTIAL,42000,0,42000,139600,0,181600
141345200400000,SE 209,RESIDENTIAL,42500,0,42500,170300,0,212800
141345200500000,SE 209,RESIDENTIAL,40500,0,40500,112100,0,152600
141345200600000,SE 209,RESIDENTIAL,40000,0,40000,109400,0,149400
141345200700000,SE 209,RESIDENTIAL,40000,0,40000,111800,0,151800
141345200800000,SE 209,RESIDENTIAL,44500,0,44500,105100,0,149600
141345300100000,SE 209,RESIDENTIAL,62900,0,62900,171300,0,234200
141345300200000,SE 209,RESIDENTIAL,82700,0,82700,204800,0,287500
141345300300000,SE 209,RESIDENTIAL,65100,0,65100,173300,0,238400
141345300400000,SE 209,RESIDENTIAL,67800,0,67800,139600,0,207400
141345300500000,SE 209,RESIDENTIAL,64300,0,64300,114300,0,178600
141345300600000,SE 209,RESIDENTIAL,65600,0,65600,170200,0,235800
141345300700000,SE 209,RESIDENTIAL,67700,0,67700,176600,0,244300
141345300800000,SE 209,RESIDENTIAL,63600,0,63600,194400,0,258000
141345300900000,SE 209,RESIDENTIAL,64500,0,64500,174200,0,238700
141345301000000,SE 209,RESIDENTIAL,62000,0,62000,121700,0,183700
141345301100000,SE 209,RESIDENTIAL,49900,0,49900,165300,0,215200
141345301200000,SE 209,RESIDENTIAL,52200,0,52200,158200,0,210400
141345301300000,SE 209,RESIDENTIAL,37300,0,37300,189200,0,226500
141345301400000,SE 209,RESIDENTIAL,42000,0,42000,142400,0,184400
141345301500000,SE 209,RESIDENTIAL,42700,0,42700,192700,0,235400
141345301600000,SE 209,RESIDENTIAL,41600,0,41600,160000,0,201600
141345301700000,SE 209,RESIDENTIAL,41100,0,41100,135600,0,176700
141345301800000,SE 209,RESIDENTIAL,42600,0,42600,141300,0,183900
141345301900000,SE 209,RESIDENTIAL,45200,0,45200,189400,0,234600
141345302000000,SE 209,RESIDENTIAL,45500,0,45500,165500,0,211000
141345302100000,SE 209,RESIDENTIAL,41000,0,41000,131300,0,172300
141345302200000,SE 209,RESIDENTIAL,39000,0,39000,124300,0,163300
141345302300000,SE 209,RESIDENTIAL,39000,0,39000,156700,0,195700
141345302400000,SE 209,RESIDENTIAL,42500,0,42500,142600,0,185100
141345302500000,SE 209,RESIDENTIAL,48900,0,48900,156600,0,205500
141345302600000,SE 209,RESIDENTIAL,38400,0,38400,146400,0,184800
141345302700000,SE 209,RESIDENTIAL,39500,0,39500,127600,0,167100
141345302800000,SE 209,RESIDENTIAL,41400,0,41400,144400,0,185800
141345302900000,SE 209,RESIDENTIAL,41700,0,41700,148500,0,190200
141345303000000,SE 209,RESIDENTIAL,43300,0,43300,127500,0,170800
141345303100000,SE 209,RESIDENTIAL,41000,0,41000,166900,0,207900
141345303200000,SE 209,RESIDENTIAL,45900,0,45900,174400,0,220300
141345303300000,SE 209,RESIDENTIAL,49300,0,49300,180500,0,229800
141345303400000,SE 209,RESIDENTIAL,44100,0,44100,158400,0,202500
141345303500000,SE 209,RESIDENTIAL,58700,0,58700,188200,0,246900
141345303600000,SE 209,RESIDENTIAL,57000,0,57000,172600,0,229600
141345303700000,SE 209,RESIDENTIAL,59300,0,59300,201000,0,260300
141345400100000,CITY PROPERTY,EXEMPT,0,0,0,0,0,0
141347700100000,SE 209,RESIDENTIAL,88800,0,88800,118000,0,206800
141347700200000,SE 209,RESIDENTIAL,81800,0,81800,212700,0,294500
141347700300000,SE 209,RESIDENTIAL,90000,0,90000,79500,0,169500
141347700400000,SE 209,RESIDENTIAL,91300,0,91300,117100,0,208400
141347700500000,SE 209,RESIDENTIAL,90800,0,90800,146300,0,237100
141347700600000,SE 209,RESIDENTIAL,84600,0,84600,146100,0,230700
141347700700000,SE 209,RESIDENTIAL,58000,0,58000,159800,0,217800
141347700800000,SE 209,RESIDENTIAL,90000,0,90000,182700,0,272700
141347700900000,SE 209,RESIDENTIAL,90100,0,90100,131600,0,221700
141347701000000,SE 209,RESIDENTIAL,90800,0,90800,161400,0,252200
141347701100000,SE 209,RESIDENTIAL,91100,0,91100,193600,0,284700
141347701200000,SE 209,RESIDENTIAL,73400,0,73400,124300,0,197700
141347701300000,SE 209,RESIDENTIAL,68400,0,68400,128300,0,196700
141347701400000,SE 209,RESIDENTIAL,61400,0,61400,139900,0,201300
141347701500000,SE 209,RESIDENTIAL,68400,0,68400,160200,0,228600
141347701600000,SE 209,RESIDENTIAL,82300,0,82300,103800,0,186100
141347701700000,SE 209,RESIDENTIAL,90200,0,90200,125300,0,215500
141347701800000,SE 209,RESIDENTIAL,90400,0,90400,171100,0,261500
141347701900000,SE 209,RESIDENTIAL,96400,0,96400,242200,0,338600
141347702000000,SE 209,RESIDENTIAL,54400,0,54400,103600,0,158000
141347800100000,SE 209,RESIDENTIAL,90300,0,90300,159500,0,249800
141347800200000,SE 209,RESIDENTIAL,86300,0,86300,190700,0,277000
141347800300000,SE 209,RESIDENTIAL,90100,0,90100,189800,0,279900
141347800400000,SE 209,RESIDENTIAL,61100,0,61100,202200,0,263300
141347800500000,SE 209,RESIDENTIAL,56000,0,56000,202900,0,258900
141410100100000,GOLF COURSE,COMMERCIAL,0,1047200,1047200,0,3973700,5020900
141420100100000,CITY PROPERTY,EXEMPT,0,0,0,0,0,0
141420100200000,CITY PROPERTY,EXEMPT,0,0,0,0,0,0
141420100300000,SE 201,RESIDENTIAL,24600,0,24600,72600,0,97200
141420100400000,SE 201,RESIDENTIAL,30300,0,30300,87000,0,117300
141420100500000,SE 201,RESIDENTIAL,26300,0,26300,79800,0,106100
141420100600000,SE 201,RESIDENTIAL,20600,0,20600,45900,0,66500
141420100700000,SE 201,RESIDENTIAL,20600,0,20600,135100,0,155700
141420100800000,APARTMENT,MULTI-RES,16300,0,16300,91600,0,107900
141420100900000,SE 201,RESIDENTIAL,22400,0,22400,109500,0,131900
141420101000000,SE 201,RESIDENTIAL,30000,0,30000,87400,0,117400
141420101100000,SE 201,RESIDENTIAL,33300,0,33300,104000,0,137300
141420101200000,SE 201,RESIDENTIAL,27500,0,27500,64100,0,91600
141420101300000,SE 201,RESIDENTIAL,31700,0,31700,91400,0,123100
141420101400000,SE 201,RESIDENTIAL,37900,0,37900,140100,0,178000
141420200100000,SE 201,RESIDENTIAL,12100,0,12100,80000,0,92100
141420200200000,APARTMENT,MULTI-RES,73600,0,73600,897200,0,970800
141420200300000,APARTMENT,MULTI-RES,53100,0,53100,475200,0,528300
141420200400000,SE 201,RESIDENTIAL,20000,0,20000,95000,0,115000
141420200500000,SE 201,RESIDENTIAL,23500,0,23500,57400,0,80900
141420200600000,SE 201,RESIDENTIAL,23500,0,23500,53700,0,77200
141420200700000,APARTMENT,RESIDENTIAL,46800,0,46800,674000,0,720800
141420200800000,SE 201,RESIDENTIAL,20000,0,20000,116000,0,136000
141420200900000,SE 201,RESIDENTIAL,23800,0,23800,118000,0,141800
141420201000000,SE 201,RESIDENTIAL,17800,0,17800,24000,0,41800
141420201100000,SE 201,RESIDENTIAL,13400,0,13400,83400,0,96800
141420300100000,VACANT LAND,COMMERCIAL,0,2500,2500,0,0,2500
141420300200000,SE 203,RESIDENTIAL,148500,0,148500,707000,0,855500
141420300300000,SE 201,RESIDENTIAL,31800,0,31800,151200,0,183000
141420300400000,SE 201,RESIDENTIAL,24300,0,24300,110200,0,134500
141420300500000,SE 201,RESIDENTIAL,25500,0,25500,110700,0,136200
141420300600000,SE 201,RESIDENTIAL,23500,0,23500,122200,0,145700
141420300700000,SE 201,RESIDENTIAL,27100,0,27100,0,0,27100
141420300800000,SE 201,RESIDENTIAL,20400,0,20400,104100,0,124500
141420300900000,SE 201,RESIDENTIAL,21300,0,21300,95000,0,116300
141420301000000,SE 201,RESIDENTIAL,26900,0,26900,85600,0,112500
141420301100000,SE 201,RESIDENTIAL,29200,0,29200,69600,0,98800
141420301200000,SE 201,RESIDENTIAL,22600,0,22600,146300,0,168900
141420301300000,SE 201,RESIDENTIAL,16100,0,16100,115800,0,131900
141420301400000,SE 201,RESIDENTIAL,15700,0,15700,105000,0,120700
141420301500000,SE 201,RESIDENTIAL,15700,0,15700,111100,0,126800
141420301600000,SE 201,RESIDENTIAL,23900,0,23900,130700,0,154600
141420301700000,SE 201,RESIDENTIAL,23900,0,23900,55400,0,79300
141420301800000,SE 201,RESIDENTIAL,19600,0,19600,79300,0,98900
141420301900000,SE 201,RESIDENTIAL,20400,0,20400,115900,0,136300
141420302000000,SE 201,RESIDENTIAL,16100,0,16100,71900,0,88000
141420302100000,SE 201,RESIDENTIAL,15700,0,15700,84800,0,100500
141420302200000,SE 201,RESIDENTIAL,32500,0,32500,98100,0,130600
141420302300000,SE 201,RESIDENTIAL,21700,0,21700,68300,0,90000
141420302400000,SE 203,RESIDENTIAL,67000,0,67000,163400,0,230400
141420302500000,SE 203,RESIDENTIAL,75900,0,75900,216300,0,292200
141420302600000,SE 203,RESIDENTIAL,95100,0,95100,309400,0,404500
141420302700000,SE 203,RESIDENTIAL,131100,0,131100,317900,0,449000
141420302800000,SE 203,RESIDENTIAL,139300,0,139300,552800,0,692100
141420400100000,SE 203,RESIDENTIAL,65000,0,65000,142000,0,207000
141420400200000,SE 203,RESIDENTIAL,41600,0,41600,0,0,41600
141420400300000,SE 203,RESIDENTIAL,51500,0,51500,0,0,51500
141420400400000,SE 203,RESIDENTIAL,44500,0,44500,159500,0,204000
141420400500000,SE 203,RESIDENTIAL,42000,0,42000,146200,0,188200
141420400600000,SE 203,RESIDENTIAL,33100,0,33100,165500,0,198600
141420400700000,SE 203,RESIDENTIAL,73800,0,73800,146400,0,220200
141420400800000,SE 203,RESIDENTIAL,56000,0,56000,162400,0,218400
141420400900000,SE 203,RESIDENTIAL,54200,0,54200,136400,0,190600
141420401000000,SE 203,RESIDENTIAL,51700,0,51700,140500,0,192200
141420401100000,SE 203,RESIDENTIAL,51700,0,51700,138000,0,189700
141420401200000,SE 203,RESIDENTIAL,52200,0,52200,136600,0,188800
141420401300000,SE 203,RESIDENTIAL,51200,0,51200,132700,0,183900
141420401400000,SE 203,RESIDENTIAL,61100,0,61100,151500,0,212600
141420401500000,SE 203,RESIDENTIAL,60400,0,60400,141600,0,202000
141420500100000,SE 203,RESIDENTIAL,45000,0,45000,113600,0,158600
141420500200000,SE 203,RESIDENTIAL,46400,0,46400,145100,0,191500
141420500300000,SE 203,RESIDENTIAL,49100,0,49100,121200,0,170300
141420500400000,SE 203,RESIDENTIAL,49500,0,49500,175400,0,224900
141420500500000,SE 203,RESIDENTIAL,46400,0,46400,105200,0,151600
141420500600000,SE 203,RESIDENTIAL,47400,0,47400,106800,0,154200
141420500700000,SE 203,RESIDENTIAL,30000,0,30000,110500,0,140500
141420500800000,SE 203,RESIDENTIAL,30300,0,30300,120100,0,150400
141420500900000,SE 203,RESIDENTIAL,22400,0,22400,106700,0,129100
141420501000000,SE 203,RESIDENTIAL,22400,0,22400,93400,0,115800
141422600100000,FLAT PARKING,COMMERCIAL,0,35200,35200,0,4700,39900
141422600200000,FLAT PARKING,COMMERCIAL,0,82800,82800,0,6600,89400
141422600300000,LG DISCOUNT/RETAIL,COMMERCIAL,0,456000,456000,0,818500,1274500
141422600400000,FLAT PARKING,COMMERCIAL,0,148800,148800,0,13200,162000
141422600500000,SE 201,RESIDENTIAL,26200,0,26200,97300,0,123500
141422600600000,FLAT PARKING,COMMERCIAL,0,13200,13200,0,1300,14500
141422700100000,CONVENIENCE STORE,COMMERCIAL,0,199000,199000,0,226400,425400
141422700200000,FLAT PARKING,COMMERCIAL,0,12700,12700,0,2000,14700
141422700300000,SMALL RETAIL,COMMERCIAL,0,10300,10300,0,62000,72300
141422700400000,FLAT PARKING,COMMERCIAL,0,16500,16500,0,1200,17700
141422700800000,OFFICE,COMMERCIAL,0,435000,435000,0,1670800,2105800
141422700900000,SMALL RETAIL,COMMERCIAL,0,211500,211500,0,635800,847300
141422701000000,OFFICE,COMMERCIAL,0,456000,456000,0,1174900,1630900
141422701100000,NE 141,RESIDENTIAL,11800,0,11800,64300,0,76100
141422701200000,NE 141,RESIDENTIAL,13800,0,13800,70800,0,84600
141422701300000,NE 141,RESIDENTIAL,23800,0,23800,85100,0,108900
141422701400000,SMALL RETAIL,COMMERCIAL,11700,11700,23400,79900,79900,183200
141422701500000,FLAT PARKING,COMMERCIAL,0,49000,49000,0,4000,53000
141422701600000,SMALL RETAIL,COMMERCIAL,0,54300,54300,0,151600,205900
141422701700000,SMALL RETAIL,COMMERCIAL,0,52500,52500,0,188900,241400
141422701800000,AUTO REPAIR/SALES,COMMERCIAL,0,131300,131300,0,101800,233100
141422800200000,NE 141,RESIDENTIAL,23400,0,23400,120500,0,143900
141422800300000,NE 141,RESIDENTIAL,23400,0,23400,70800,0,94200
141422800400000,NE 141,RESIDENTIAL,23400,0,23400,76900,0,100300
141422800500000,NE 141,RESIDENTIAL,23400,0,23400,124900,0,148300
141422800600000,NE 141,RESIDENTIAL,23400,0,23400,83200,0,106600
141422800700000,NE 141,RESIDENTIAL,23400,0,23400,70900,0,94300
141422800800000,NE 141,RESIDENTIAL,23400,0,23400,105400,0,128800
141422800900000,NE 141,RESIDENTIAL,23400,0,23400,107900,0,131300
141422801000000,NE 141,RESIDENTIAL,23200,0,23200,78600,0,101800
141422801100000,NE 141,RESIDENTIAL,23200,0,23200,82100,0,105300
141422801200000,NE 141,RESIDENTIAL,23200,0,23200,69900,0,93100
141422801300000,NE 141,RESIDENTIAL,22200,0,22200,45200,0,67400
141422801400000,NE 141,RESIDENTIAL,22700,0,22700,85700,0,108400
141422801500000,NE 141,RESIDENTIAL,22600,0,22600,68300,0,90900
141422801600000,NE 141,RESIDENTIAL,19200,0,19200,60800,0,80000
141422801700000,NE 141,RESIDENTIAL,22700,0,22700,80100,0,102800
141422801800000,APARTMENT,MULTI-RES,14600,0,14600,122300,0,136900
141422801900000,NE 141,RESIDENTIAL,27200,0,27200,71900,0,99100
141422802000000,OFFICE,COMMERCIAL,0,43100,43100,0,178300,221400
141422802200000,APARTMENT,RESIDENTIAL,27000,0,27000,123500,0,150500
141422802300000,CONVERSION-NE/SE,MULTI-RES,28100,0,28100,89800,0,117900
141422802601000,OFFICE; MEDICAL,COMMERCIAL,0,80200,80200,0,354600,434800
141422802601001,OFFICE; MEDICAL,COMMERCIAL,0,80200,80200,0,371500,451700
141422900700000,OFFICE,COMMERCIAL,0,204000,204000,0,157700,361700
141422900900000,SE 201,RESIDENTIAL,10100,0,10100,58200,0,68300
141422901000000,SE 201,RESIDENTIAL,10100,0,10100,0,0,10100
141422901100000,SE 201,RESIDENTIAL,6400,0,6400,0,0,6400
141422901200000,SE 201,RESIDENTIAL,8700,0,8700,5000,0,13700
141422901300000,SE 201,RESIDENTIAL,18600,0,18600,82100,0,100700
141422901400000,SE 201,RESIDENTIAL,17600,0,17600,91100,0,108700
141422901500000,SE 201,RESIDENTIAL,17600,0,17600,76800,0,94400
141422901700000,OFFICE,COMMERCIAL,0,159000,159000,0,367500,526500
141422901800000,OFFICE; MEDICAL,COMMERCIAL,0,228000,228000,0,368500,596500
141422901900000,FLAT PARKING,COMMERCIAL,0,72000,72000,0,8400,80400
141422902000000,VACANT LAND,COMMERCIAL,0,297000,297000,0,0,297000
141423000100000,SE 204,RESIDENTIAL,7400,0,7400,92200,0,99600
141423000200000,SE 204,RESIDENTIAL,7400,0,7400,64300,0,71700
141423000300000,SE 204,RESIDENTIAL,6300,0,6300,42300,0,48600
141423000400000,SE 204,RESIDENTIAL,8400,0,8400,72700,0,81100
141423000500000,SE 204,RESIDENTIAL,12700,0,12700,68200,0,80900
141423000600000,SE 204,RESIDENTIAL,7900,0,7900,75400,0,83300
141423000700000,SE 204,RESIDENTIAL,11700,0,11700,65000,0,76700
141423000800000,SE 204,RESIDENTIAL,16200,0,16200,79900,0,96100
141423000900000,SE 204,RESIDENTIAL,21300,0,21300,100800,0,122100
141423001000000,SE 204,RESIDENTIAL,22200,0,22200,47300,0,69500
141423001100000,SE 204,RESIDENTIAL,26300,0,26300,92500,0,118800
141423001200000,SE 204,RESIDENTIAL,24000,0,24000,92000,0,116000
141423001300000,SE 204,RESIDENTIAL,24000,0,24000,108400,0,132400
141423001400000,SE 204,RESIDENTIAL,14900,0,14900,97800,0,112700
141423001500000,SE 204,RESIDENTIAL,24000,0,24000,66800,0,90800
141423001600000,SE 204,RESIDENTIAL,300,0,300,0,0,300
141423001700000,SE 204,RESIDENTIAL,12000,0,12000,28100,0,40100
141423001800000,SE 204,RESIDENTIAL,16000,0,16000,79300,0,95300
141423100200000,NE 154,RESIDENTIAL,18800,0,18800,60100,0,78900
141423100300000,NE 154,RESIDENTIAL,17200,0,17200,78900,0,96100
141423100400000,NE 154,RESIDENTIAL,17000,0,17000,46300,0,63300
141423100500000,NE 154,RESIDENTIAL,22700,0,22700,72400,0,95100
141423100600000,NE 154,RESIDENTIAL,19800,0,19800,87300,0,107100
141423100700000,NE 154,RESIDENTIAL,19800,0,19800,77300,0,97100
141423100800000,NE 154,RESIDENTIAL,19800,0,19800,96600,0,116400
141423100900000,NE 154,RESIDENTIAL,19800,0,19800,92600,0,112400
141423101000000,NE 154,RESIDENTIAL,19800,0,19800,89900,0,109700
141423101100000,NE 154,RESIDENTIAL,25500,0,25500,90400,0,115900
141423101200000,NE 154,RESIDENTIAL,25500,0,25500,55700,0,81200
141423101300000,CONVERSION-NE/SE,MULTI-RES,25500,0,25500,89200,0,114700
141423101400000,OFFICE,COMMERCIAL,0,92100,92100,0,81900,174000
141423200100000,NE 154,RESIDENTIAL,25600,0,25600,74200,0,99800
141423200200000,NE 154,RESIDENTIAL,12700,0,12700,73500,0,86200
141423200300000,NE 154,RESIDENTIAL,12200,0,12200,67400,0,79600
141423200400000,NE 154,RESIDENTIAL,27200,0,27200,95700,0,122900
141423200500000,NE 154,RESIDENTIAL,26300,0,26300,78800,0,105100
141423200600000,NE 154,RESIDENTIAL,25500,0,25500,83500,0,109000
141423200700000,NE 154,RESIDENTIAL,25500,0,25500,95900,0,121400
141423200800000,NE 154,RESIDENTIAL,25500,0,25500,79200,0,104700
141423200900000,NE 154,RESIDENTIAL,25500,0,25500,80900,0,106400
141423201000000,NE 154,RESIDENTIAL,25500,0,25500,34500,0,60000
141423201100000,NE 154,RESIDENTIAL,25500,0,25500,100500,0,126000
141423201200000,NE 154,RESIDENTIAL,25500,0,25500,115600,0,141100
141423201300000,NE 154,RESIDENTIAL,25500,0,25500,104100,0,129600
141423201400000,NE 154,RESIDENTIAL,25500,0,25500,113600,0,139100
141423201500000,NE 154,RESIDENTIAL,25500,0,25500,104600,0,130100
141425100100000,SE 204,RESIDENTIAL,18200,0,18200,108800,0,127000
141425100200000,SE 204,RESIDENTIAL,20400,0,20400,85800,0,106200
141425100300000,SE 204,RESIDENTIAL,14900,0,14900,78900,0,93800
141425100400000,SE 204,RESIDENTIAL,19900,0,19900,97800,0,117700
141425200100000,NE 154,RESIDENTIAL,25500,0,25500,106700,0,132200
141425200200000,NE 154,RESIDENTIAL,19800,0,19800,83800,0,103600
141425200300000,NE 154,RESIDENTIAL,19800,0,19800,93500,0,113300
141425200400000,NE 154,RESIDENTIAL,19800,0,19800,92300,0,112100
141425200500000,NE 154,RESIDENTIAL,19800,0,19800,97800,0,117600
141425200600000,NE 154,RESIDENTIAL,20000,0,20000,71400,0,91400
141425200700000,NE 154,RESIDENTIAL,20000,0,20000,138500,0,158500
141425200800000,NE 154,RESIDENTIAL,19800,0,19800,93600,0,113400
141425200900000,NE 154,RESIDENTIAL,20000,0,20000,101000,0,121000
141425201000000,NE 154,RESIDENTIAL,22400,0,22400,111600,0,134000
141425201100000,NE 154,RESIDENTIAL,22500,0,22500,111000,0,133500
141425201200000,NE 154,RESIDENTIAL,19800,0,19800,79000,0,98800
141425201300000,NE 154,RESIDENTIAL,19800,0,19800,83500,0,103300
141425201400000,NE 154,RESIDENTIAL,19800,0,19800,71200,0,91000
141425201500000,NE 154,RESIDENTIAL,19800,0,19800,107300,0,127100
141425201600000,NE 154,RESIDENTIAL,21000,0,21000,78800,0,99800
141425201700000,NE 154,RESIDENTIAL,21900,0,21900,99100,0,121000
141425201800000,NE 154,RESIDENTIAL,13800,0,13800,78500,0,92300
141425201900000,NE 154,RESIDENTIAL,19400,0,19400,85000,0,104400
141425202000000,NE 154,RESIDENTIAL,13000,0,13000,78200,0,91200
141425202100000,NE 154,RESIDENTIAL,17900,0,17900,99200,0,117100
141425202200000,NE 154,RESIDENTIAL,25500,0,25500,115300,0,140800
141425202300000,NE 154,RESIDENTIAL,25500,0,25500,91300,0,116800
141425202400000,NE 154,RESIDENTIAL,25500,0,25500,93800,0,119300
141425202500000,NE 154,RESIDENTIAL,25500,0,25500,74300,0,99800
141425202600000,NE 154,RESIDENTIAL,30600,0,30600,89800,0,120400
141425202700000,NE 154,RESIDENTIAL,20400,0,20400,51500,0,71900
141425202800000,NE 154,RESIDENTIAL,25700,0,25700,146800,0,172500
141425202900000,NE 154,RESIDENTIAL,25700,0,25700,119400,0,145100
141425203000000,NE 154,RESIDENTIAL,25500,0,25500,118300,0,143800
141425203100000,NE 154,RESIDENTIAL,25500,0,25500,89600,0,115100
141425203200000,NE 154,RESIDENTIAL,25500,0,25500,87900,0,113400
141425300100000,NE 154,RESIDENTIAL,20400,0,20400,99100,0,119500
141425300200000,NE 154,RESIDENTIAL,25500,0,25500,85500,0,111000
141425300300000,NE 154,RESIDENTIAL,25500,0,25500,80500,0,106000
141425300400000,NE 154,RESIDENTIAL,25500,0,25500,87500,0,113000
141425300500000,NE 154,RESIDENTIAL,25500,0,25500,50500,0,76000
141425300600000,NE 154,RESIDENTIAL,25500,0,25500,100300,0,125800
141425300700000,NE 154,RESIDENTIAL,25500,0,25500,93000,0,118500
141425300800000,NE 154,RESIDENTIAL,25500,0,25500,101500,0,127000
141425300900000,NE 154,RESIDENTIAL,25500,0,25500,88000,0,113500
141425301000000,NE 154,RESIDENTIAL,25500,0,25500,93600,0,119100
141425301100000,NE 154,RESIDENTIAL,13200,0,13200,70600,0,83800
141425301200000,NE 154,RESIDENTIAL,13400,0,13400,69600,0,83000
141425301300000,NE 154,RESIDENTIAL,24000,0,24000,98200,0,122200
141425301400000,NE 154,RESIDENTIAL,20400,0,20400,100000,0,120400
141425301500000,NE 154,RESIDENTIAL,20400,0,20400,98700,0,119100
141425301600000,NE 154,RESIDENTIAL,20400,0,20400,79600,0,100000
141425301700000,NE 154,RESIDENTIAL,20400,0,20400,86500,0,106900
141425301800000,NE 154,RESIDENTIAL,20400,0,20400,75400,0,95800
141425301900000,NE 154,RESIDENTIAL,20400,0,20400,81800,0,102200
141425302000000,NE 154,RESIDENTIAL,20400,0,20400,87900,0,108300
141425302100000,NE 154,RESIDENTIAL,20400,0,20400,81700,0,102100
141425302200000,NE 154,RESIDENTIAL,20400,0,20400,87700,0,108100
141425302300000,NE 154,RESIDENTIAL,20400,0,20400,119100,0,139500
141425302400000,NE 154,RESIDENTIAL,20400,0,20400,74300,0,94700
141425302500000,NE 154,RESIDENTIAL,20400,0,20400,92700,0,113100
141425400100000,SE 204,RESIDENTIAL,19200,0,19200,118200,0,137400
141425400200000,SE 204,RESIDENTIAL,24000,0,24000,96400,0,120400
141425400300000,SE 204,RESIDENTIAL,24000,0,24000,117200,0,141200
141425400400000,SE 204,RESIDENTIAL,28000,0,28000,116700,0,144700
141425400500000,SE 204,RESIDENTIAL,20000,0,20000,119000,0,139000
141425400600000,SE 204,RESIDENTIAL,18000,0,18000,96700,0,114700
141425400700000,SE 204,RESIDENTIAL,15600,0,15600,50800,0,66400
141425400800000,SE 204,RESIDENTIAL,15800,0,15800,47300,0,63100
141425400900000,SE 204,RESIDENTIAL,19400,0,19400,76900,0,96300
141425401000000,SE 204,RESIDENTIAL,19600,0,19600,69100,0,88700
141425401100000,SE 204,RESIDENTIAL,23500,0,23500,64800,0,88300
141425401200000,SE 204,RESIDENTIAL,25500,0,25500,76700,0,102200
141425401300000,SE 204,RESIDENTIAL,25500,0,25500,80500,0,106000
141425401400000,SE 204,RESIDENTIAL,25500,0,25500,93400,0,118900
141425401500000,SE 204,RESIDENTIAL,25500,0,25500,109200,0,134700
141425401600000,SE 204,RESIDENTIAL,25500,0,25500,71400,0,96900
141425401700000,SE 204,RESIDENTIAL,17000,0,17000,78600,0,95600
141425401800000,SE 204,RESIDENTIAL,27200,0,27200,78700,0,105900
141425401900000,SE 204,RESIDENTIAL,14500,0,14500,84500,0,99000
141425500100000,SE 204,RESIDENTIAL,25500,0,25500,126600,0,152100
141425500200000,SE 204,RESIDENTIAL,25500,0,25500,141100,0,166600
141425500300000,SE 204,RESIDENTIAL,12800,0,12800,113100,0,125900
141425500400000,SE 204,RESIDENTIAL,12800,0,12800,70700,0,83500
141425500500000,SE 204,RESIDENTIAL,25500,0,25500,77600,0,103100
141425500600000,SE 204,RESIDENTIAL,25500,0,25500,85600,0,111100
141425500700000,SE 204,RESIDENTIAL,25500,0,25500,130000,0,155500
141425500800000,SE 204,RESIDENTIAL,27200,0,27200,121100,0,148300
141425500900000,SE 204,RESIDENTIAL,17000,0,17000,50500,0,67500
141425501000000,SE 204,RESIDENTIAL,16500,0,16500,91100,0,107600
141425501100000,SE 204,RESIDENTIAL,16100,0,16100,81200,0,97300
141425501200000,SE 204,RESIDENTIAL,14100,0,14100,39700,0,53800
141425501300000,SE 204,RESIDENTIAL,13400,0,13400,66800,0,80200
141425501400000,SE 204,RESIDENTIAL,14600,0,14600,78600,0,93200
141425501500000,SE 204,RESIDENTIAL,16100,0,16100,87600,0,103700
141425501600000,SE 204,RESIDENTIAL,25500,0,25500,100800,0,126300
141425501700000,SE 204,RESIDENTIAL,25500,0,25500,119400,0,144900
141425501800000,SE 204,RESIDENTIAL,25500,0,25500,111700,0,137200
141425501900000,SE 204,RESIDENTIAL,25500,0,25500,105900,0,131400
141425502000000,SE 204,RESIDENTIAL,25500,0,25500,110100,0,135600
141425502100000,SE 204,RESIDENTIAL,25500,0,25500,108300,0,133800
141425502200000,SE 204,RESIDENTIAL,25500,0,25500,87400,0,112900
141425502300000,SE 204,RESIDENTIAL,17000,0,17000,43400,0,60400
141425502400000,SE 204,RESIDENTIAL,17000,0,17000,63100,0,80100
141425502500000,SE 204,RESIDENTIAL,17000,0,17000,83300,0,100300
141425600100000,SE 204,RESIDENTIAL,17000,0,17000,63800,0,80800
141425600200000,SE 204,RESIDENTIAL,17000,0,17000,105300,0,122300
141425600300000,SE 204,RESIDENTIAL,17000,0,17000,34200,0,51200
141425600400000,SE 204,RESIDENTIAL,25500,0,25500,97200,0,122700
141425600500000,SE 204,RESIDENTIAL,25500,0,25500,98300,0,123800
141425600600000,SE 204,RESIDENTIAL,26800,0,26800,141600,0,168400
141425600700000,SE 204,RESIDENTIAL,21300,0,21300,82900,0,104200
141425600800000,SE 204,RESIDENTIAL,25500,0,25500,91500,0,117000
141425600900000,SE 204,RESIDENTIAL,25500,0,25500,87600,0,113100
141425601000000,SE 204,RESIDENTIAL,25500,0,25500,52100,0,77600
141425601100000,SE 204,RESIDENTIAL,21300,0,21300,112900,0,134200
141425601200000,SE 204,RESIDENTIAL,24000,0,24000,111000,0,135000
141425601300000,SE 204,RESIDENTIAL,14600,0,14600,72500,0,87100
141425601400000,SE 204,RESIDENTIAL,13200,0,13200,35700,0,48900
141425601500000,SE 204,RESIDENTIAL,19200,0,19200,57900,0,77100
141425601600000,SE 204,RESIDENTIAL,22200,0,22200,107400,0,129600
141425601700000,SE 204,RESIDENTIAL,19100,0,19100,98600,0,117700
141425601800000,SE 204,RESIDENTIAL,19100,0,19100,105000,0,124100
141425601900000,SE 204,RESIDENTIAL,19100,0,19100,146000,0,165100
141425602000000,SE 204,RESIDENTIAL,21300,0,21300,109500,0,130800
141425602100000,SE 204,RESIDENTIAL,23400,0,23400,110000,0,133400
141425602200000,SE 204,RESIDENTIAL,25500,0,25500,89300,0,114800
141425602300000,SE 204,RESIDENTIAL,25500,0,25500,153200,0,178700
141425602400000,SE 204,RESIDENTIAL,26400,0,26400,84600,0,111000
141425602500000,SE 204,RESIDENTIAL,20000,0,20000,132900,0,152900
141425602600000,SE 204,RESIDENTIAL,19100,0,19100,110800,0,129900
141425602700000,SE 204,RESIDENTIAL,19100,0,19100,99500,0,118600
141425602800000,SE 204,RESIDENTIAL,19100,0,19100,110600,0,129700
141425602900000,SE 204,RESIDENTIAL,19100,0,19100,111500,0,130600
141425700600000,SCHOOL,EXEMPT,0,810800,810800,0,3248500,4059300
141425800100000,NE 154,RESIDENTIAL,19000,0,19000,107700,0,126700
141425800200000,NE 154,RESIDENTIAL,13200,0,13200,57400,0,70600
141425800300000,NE 154,RESIDENTIAL,16500,0,16500,62500,0,79000
141425800400000,NE 154,RESIDENTIAL,20400,0,20400,74600,0,95000
141425800500000,NE 154,RESIDENTIAL,20400,0,20400,95700,0,116100
141425800600000,NE 154,RESIDENTIAL,20400,0,20400,77100,0,97500
141425800700000,NE 154,RESIDENTIAL,20400,0,20400,120700,0,141100
141425800800000,NE 154,RESIDENTIAL,20400,0,20400,91200,0,111600
141425800900000,NE 154,RESIDENTIAL,20400,0,20400,69300,0,89700
141427600100000,SE 203,RESIDENTIAL,63300,0,63300,205900,0,269200
141427700100000,SE 203,RESIDENTIAL,40900,0,40900,153800,0,194700
141427700200000,SE 203,RESIDENTIAL,43400,0,43400,121200,0,164600
141427700300000,SE 203,RESIDENTIAL,79900,0,79900,180100,0,260000
141427700400000,SE 203,RESIDENTIAL,40400,0,40400,86500,0,126900
141427700500000,SE 203,RESIDENTIAL,39600,0,39600,103400,0,143000
141427700600000,SE 203,RESIDENTIAL,39800,0,39800,139100,0,178900
141427700700000,SE 203,RESIDENTIAL,39600,0,39600,113300,0,152900
141427700800000,SE 203,RESIDENTIAL,40800,0,40800,121900,0,162700
141427700900000,SE 203,RESIDENTIAL,44700,0,44700,220400,0,265100
141427701000000,SE 203,RESIDENTIAL,43500,0,43500,153600,0,197100
141427701100000,SE 203,RESIDENTIAL,44200,0,44200,161500,0,205700
141427701200000,SE 203,RESIDENTIAL,44100,0,44100,149000,0,193100
141427701300000,SE 203,RESIDENTIAL,44500,0,44500,165400,0,209900
141427701400000,SE 203,RESIDENTIAL,0,0,0,0,0,0
141427800100000,SE 203,RESIDENTIAL,55900,0,55900,153600,0,209500
141427800200000,SE 203,RESIDENTIAL,52600,0,52600,126600,0,179200
141427800300000,SE 203,RESIDENTIAL,49400,0,49400,160700,0,210100
141427800400000,SE 203,RESIDENTIAL,49900,0,49900,154900,0,204800
141427800500000,SE 203,RESIDENTIAL,54600,0,54600,132700,0,187300
141427800600000,SE 203,RESIDENTIAL,56700,0,56700,186400,0,243100
141427800700000,SE 203,RESIDENTIAL,59000,0,59000,189800,0,248800
141427800800000,SE 203,RESIDENTIAL,62300,0,62300,183700,0,246000
141427800900000,SE 203,RESIDENTIAL,65200,0,65200,281800,0,347000
141427801000000,SE 203,RESIDENTIAL,56400,0,56400,191500,0,247900
141427801100000,SE 203,RESIDENTIAL,56300,0,56300,182700,0,239000
141427801200000,SE 203,RESIDENTIAL,56300,0,56300,209700,0,266000
141427801300000,SE 203,RESIDENTIAL,56300,0,56300,167700,0,224000
141427801400000,SE 203,RESIDENTIAL,56300,0,56300,259600,0,315900
141427801500000,SE 203,RESIDENTIAL,56300,0,56300,157200,0,213500
141427900100000,SE 203,RESIDENTIAL,54300,0,54300,163000,0,217300
141427900200000,SE 203,RESIDENTIAL,61200,0,61200,183900,0,245100
141427900300000,SE 203,RESIDENTIAL,41200,0,41200,184900,0,226100
141427900400000,SE 203,RESIDENTIAL,40800,0,40800,125100,0,165900
141427900500000,SE 203,RESIDENTIAL,40800,0,40800,169200,0,210000
141427900600000,SE 203,RESIDENTIAL,40800,0,40800,172700,0,213500
141427900700000,SE 203,RESIDENTIAL,37000,0,37000,132300,0,169300
141427900800000,SE 203,RESIDENTIAL,38800,0,38800,123000,0,161800
141427900900000,SE 203,RESIDENTIAL,38200,0,38200,130200,0,168400
141427901000000,SE 203,RESIDENTIAL,41400,0,41400,116500,0,157900
141427901100000,SE 203,RESIDENTIAL,49300,0,49300,137600,0,186900
141427901200000,SE 203,RESIDENTIAL,40700,0,40700,140000,0,180700
141427901300000,SE 203,RESIDENTIAL,40000,0,40000,137500,0,177500
141427901400000,SE 203,RESIDENTIAL,46300,0,46300,105400,0,151700
141427901500000,SE 203,RESIDENTIAL,46800,0,46800,126500,0,173300
141427901600000,SE 203,RESIDENTIAL,47300,0,47300,191900,0,239200
141427901700000,SE 203,RESIDENTIAL,45300,0,45300,82300,0,127600
141427901800000,SE 203,RESIDENTIAL,44600,0,44600,98600,0,143200
141427901900000,SE 203,RESIDENTIAL,45100,0,45100,97400,0,142500
141427902000000,SE 203,RESIDENTIAL,45500,0,45500,104400,0,149900
141427902100000,SE 203,RESIDENTIAL,45900,0,45900,129600,0,175500
141427902200000,SE 203,RESIDENTIAL,46400,0,46400,118900,0,165300
141427902300000,SE 203,RESIDENTIAL,46400,0,46400,149100,0,195500
141428000100000,SE 203,RESIDENTIAL,75200,0,75200,251800,0,327000
141428000200000,SE 203,RESIDENTIAL,51800,0,51800,244300,0,296100
141428000300000,SE 203,RESIDENTIAL,52500,0,52500,132400,0,184900
141428000400000,SE 203,RESIDENTIAL,52500,0,52500,116600,0,169100
141428000500000,SE 203,RESIDENTIAL,51200,0,51200,192800,0,244000
141428000600000,SE 203,RESIDENTIAL,53700,0,53700,248500,0,302200
141428000700000,SE 203,RESIDENTIAL,78700,0,78700,257900,0,336600
141428000800000,SE 203,RESIDENTIAL,84100,0,84100,214000,0,298100
141428000900000,SE 203,RESIDENTIAL,84300,0,84300,343500,0,427800
141428100100000,SE 203,RESIDENTIAL,51700,0,51700,136200,0,187900
141428100200000,SE 203,RESIDENTIAL,43200,0,43200,122900,0,166100
141428100300000,SE 203,RESIDENTIAL,39500,0,39500,110800,0,150300
141428100400000,SE 203,RESIDENTIAL,38800,0,38800,107700,0,146500
141428100500000,SE 203,RESIDENTIAL,39000,0,39000,125000,0,164000
141428100600000,SE 203,RESIDENTIAL,36900,0,36900,105700,0,142600
141428100700000,SE 203,RESIDENTIAL,38500,0,38500,120400,0,158900
141428100800000,SE 203,RESIDENTIAL,37600,0,37600,113500,0,151100
141428100900000,SE 203,RESIDENTIAL,33100,0,33100,115500,0,148600
141428101000000,SE 203,RESIDENTIAL,32300,0,32300,144500,0,176800
141428101100000,SE 203,RESIDENTIAL,32700,0,32700,95500,0,128200
141428101200000,SE 203,RESIDENTIAL,36700,0,36700,151400,0,188100
141428101300000,SE 203,RESIDENTIAL,23700,0,23700,121800,0,145500
141428101400000,SE 203,RESIDENTIAL,25900,0,25900,88300,0,114200
141428101500000,SE 203,RESIDENTIAL,42500,0,42500,106900,0,149400
141428101600000,SE 203,RESIDENTIAL,46800,0,46800,110400,0,157200
141428101700000,SE 203,RESIDENTIAL,43900,0,43900,136300,0,180200
141428101800000,SE 203,RESIDENTIAL,37800,0,37800,142300,0,180100
141428101900000,SE 203,RESIDENTIAL,37300,0,37300,142700,0,180000
141428102000000,SE 203,RESIDENTIAL,37700,0,37700,119300,0,157000
141428102100000,SE 203,RESIDENTIAL,37200,0,37200,132400,0,169600
141428102200000,SE 203,RESIDENTIAL,36800,0,36800,119500,0,156300
141428102300000,SE 203,RESIDENTIAL,37600,0,37600,98100,0,135700
141428102400000,SE 203,RESIDENTIAL,51700,0,51700,123300,0,175000
141428102500000,SE 203,RESIDENTIAL,38800,0,38800,133200,0,172000
141428102600000,SE 203,RESIDENTIAL,38800,0,38800,140900,0,179700
141428200100000,SE 203,RESIDENTIAL,66200,0,66200,426800,0,493000
141428200200000,SE 203,RESIDENTIAL,73800,0,73800,307700,0,381500
141428200300000,SE 203,RESIDENTIAL,97400,0,97400,571100,0,668500
141428200400000,SE 203,RESIDENTIAL,93500,0,93500,228600,0,322100
141428200500000,SE 203,RESIDENTIAL,84000,0,84000,223500,0,307500
141428200600000,SE 203,RESIDENTIAL,108400,0,108400,316400,0,424800
141428200700000,SE 203,RESIDENTIAL,75600,0,75600,230700,0,306300
141428200800000,SE 203,RESIDENTIAL,75600,0,75600,306400,0,382000
141428200900000,SE 203,RESIDENTIAL,48600,0,48600,210200,0,258800
141428201000000,SE 203,RESIDENTIAL,46700,0,46700,189800,0,236500
141428201100000,SE 203,RESIDENTIAL,55100,0,55100,190000,0,245100
141428201200000,SE 203,RESIDENTIAL,43700,0,43700,157700,0,201400
141428201300000,SE 203,RESIDENTIAL,42300,0,42300,142800,0,185100
141428201400000,SE 203,RESIDENTIAL,38500,0,38500,131800,0,170300
141428201500000,SE 203,RESIDENTIAL,37700,0,37700,77800,0,115500
141428201600000,SE 203,RESIDENTIAL,37400,0,37400,112400,0,149800
141428201700000,SE 203,RESIDENTIAL,37200,0,37200,130600,0,167800
141428201800000,SE 203,RESIDENTIAL,37100,0,37100,88900,0,126000
141428201900000,SE 203,RESIDENTIAL,42300,0,42300,125100,0,167400
141428300100000,SE 203,RESIDENTIAL,41600,0,41600,78600,0,120200
141428300200000,SE 203,RESIDENTIAL,28700,0,28700,70000,0,98700
141428300300000,SE 203,RESIDENTIAL,34000,0,34000,83400,0,117400
141428300400000,SE 203,RESIDENTIAL,37600,0,37600,113100,0,150700
141428300500000,SE 203,RESIDENTIAL,37600,0,37600,109200,0,146800
141428300600000,SE 203,RESIDENTIAL,49700,0,49700,111900,0,161600
141428300700000,SE 203,RESIDENTIAL,41900,0,41900,102000,0,143900
141428300800000,SE 203,RESIDENTIAL,30700,0,30700,89400,0,120100
141430100100000,SE 203,RESIDENTIAL,111900,0,111900,490000,0,601900
141430100200000,SCHOOL,EXEMPT,0,0,0,0,0,0
141432600100000,SE 208,RESIDENTIAL,29400,0,29400,98800,0,128200
141432600200000,SE 208,RESIDENTIAL,29400,0,29400,127000,0,156400
141432600300000,SE 208,RESIDENTIAL,29400,0,29400,94800,0,124200
141432600400000,SE 208,RESIDENTIAL,29400,0,29400,92800,0,122200
141432600500000,SE 208,RESIDENTIAL,30900,0,30900,149400,0,180300
141432600600000,SE 208,RESIDENTIAL,31500,0,31500,130600,0,162100
141432600700000,SE 208,RESIDENTIAL,32100,0,32100,154300,0,186400
141432600800000,SE 208,RESIDENTIAL,36100,0,36100,135600,0,171700
141432600900000,SE 208,RESIDENTIAL,35600,0,35600,125500,0,161100
141432601000000,SE 208,RESIDENTIAL,35200,0,35200,147800,0,183000
141432601100000,SE 208,RESIDENTIAL,30900,0,30900,94900,0,125800
141432601200000,SE 208,RESIDENTIAL,31500,0,31500,87000,0,118500
141432601300000,SE 208,RESIDENTIAL,32100,0,32100,129800,0,161900
141432700100000,SE 208,RESIDENTIAL,32100,0,32100,169400,0,201500
141432700200000,SE 208,RESIDENTIAL,28400,0,28400,100800,0,129200
141432700300000,SE 208,RESIDENTIAL,28400,0,28400,79600,0,108000
141432800100000,NE 154,RESIDENTIAL,40000,0,40000,0,0,40000
141432800102000,ANTENNAS/TOWERS(BLL),COMMERCIAL,0,0,0,0,11800,11800
141432800300000,OFFICE,COMMERCIAL,0,194400,194400,0,108200,302600
141432800400000,VACANT LAND,COMMERCIAL,0,48500,48500,0,0,48500
141432800500000,OFFICE,COMMERCIAL,0,129700,129700,0,176900,306600
141432900100000,FLAT PARKING,EXEMPT,0,58100,58100,0,15200,73300
141432900200000,SE 208,RESIDENTIAL,63200,0,63200,153900,0,217100
141432900300000,SE 208,RESIDENTIAL,63200,0,63200,204000,0,267200
141432900400000,SE 208,RESIDENTIAL,63200,0,63200,174900,0,238100
141432900500000,SE 208,RESIDENTIAL,63200,0,63200,218100,0,281300
141432900600000,SE 208,RESIDENTIAL,62100,0,62100,0,0,62100
141432900700000,SE 208,RESIDENTIAL,109200,0,109200,199500,0,308700
141432900800000,SE 208,RESIDENTIAL,43300,0,43300,0,0,43300
141432900900000,VACANT LAND,COMMERCIAL,0,500,500,0,0,500
141432901000000,APARTMENT,RESIDENTIAL,564200,0,564200,17627100,0,18191300
141432901400000,CHURCH,EXEMPT,0,300800,300800,0,1231700,1532500
141432901501000,VACANT LAND,COMMERCIAL,0,600,600,0,0,600
141435201500000,SE 218,RESIDENTIAL,116000,0,116000,186500,0,302500
141435400100000,SE 207,RESIDENTIAL,21200,0,21200,52600,0,73800
141435400200000,SE 207,RESIDENTIAL,19200,0,19200,121200,0,140400
141435400300000,SE 207,RESIDENTIAL,39000,0,39000,93400,0,132400
141435400400000,SE 207,RESIDENTIAL,42600,0,42600,116000,0,158600
141435400500000,SE 207,RESIDENTIAL,43200,0,43200,94500,0,137700
141435500100000,SE 207,RESIDENTIAL,89600,0,89600,213000,0,302600
141435500200000,SE 207,RESIDENTIAL,51400,0,51400,206200,0,257600
141435500300000,SE 207,RESIDENTIAL,59600,0,59600,166300,0,225900
141437600100000,SE 207,RESIDENTIAL,90100,0,90100,196100,0,286200
141437600200000,SE 207,RESIDENTIAL,65900,0,65900,144200,0,210100
141437600300000,SE 207,RESIDENTIAL,51200,0,51200,196300,0,247500
141437600400000,SE 207,RESIDENTIAL,51200,0,51200,221200,0,272400
141437600500000,SE 207,RESIDENTIAL,45300,0,45300,187500,0,232800
141437600600000,SE 207,RESIDENTIAL,20200,0,20200,84600,0,104800
141437600700000,SE 207,RESIDENTIAL,25500,0,25500,103790,0,129290
141437600800000,SE 207,RESIDENTIAL,22600,0,22600,83100,0,105700
141437600900000,SE 207,RESIDENTIAL,26300,0,26300,157100,0,183400
141437601000000,SE 207,RESIDENTIAL,26500,0,26500,132000,0,158500
141437601100000,SE 207,RESIDENTIAL,25100,0,25100,81100,0,106200
141437601200000,SE 207,RESIDENTIAL,25100,0,25100,109600,0,134700
141437601300000,SE 207,RESIDENTIAL,30200,0,30200,178700,0,208900
141437601400000,SE 207,RESIDENTIAL,28300,0,28300,130400,0,158700
141437601500000,SE 207,RESIDENTIAL,27800,0,27800,213300,0,241100
141437700100000,SE 207,RESIDENTIAL,18700,0,18700,163300,0,182000
141437700200000,SE 207,RESIDENTIAL,38500,0,38500,127200,0,165700
141437700300000,SE 207,RESIDENTIAL,30500,0,30500,141300,0,171800
141437700400000,SE 207,RESIDENTIAL,20000,0,20000,105200,0,125200
141437700500000,SE 207,RESIDENTIAL,16000,0,16000,72100,0,88100
141437700600000,SE 207,RESIDENTIAL,16000,0,16000,87300,0,103300
141437700700000,SE 207,RESIDENTIAL,16000,0,16000,82300,0,98300
141437700800000,SE 207,RESIDENTIAL,16000,0,16000,74500,0,90500
141437700900000,SE 207,RESIDENTIAL,16000,0,16000,88300,0,104300
141437701000000,SE 207,RESIDENTIAL,20000,0,20000,65700,0,85700
141437701100000,SE 207,RESIDENTIAL,20000,0,20000,68300,0,88300
141437701200000,SE 207,RESIDENTIAL,20000,0,20000,91100,0,111100
141437701300000,SE 207,RESIDENTIAL,16000,0,16000,91000,0,107000
141437701400000,SE 207,RESIDENTIAL,16000,0,16000,88300,0,104300
141437701500000,SE 207,RESIDENTIAL,20000,0,20000,74000,0,94000
141437701600000,SE 207,RESIDENTIAL,22400,0,22400,57700,0,80100
141437800100000,SE 207,RESIDENTIAL,56200,0,56200,151300,0,207500
141437800200000,SE 207,RESIDENTIAL,20000,0,20000,71900,0,91900
141437800400000,SE 207,RESIDENTIAL,28000,0,28000,96800,0,124800
141437800500000,SE 207,RESIDENTIAL,20000,0,20000,89100,0,109100
141437800600000,SE 207,RESIDENTIAL,28000,0,28000,145500,0,173500
141437800700000,SE 207,RESIDENTIAL,14600,0,14600,64900,0,79500
141437800800000,SE 207,RESIDENTIAL,17400,0,17400,73400,0,90800
141437800900000,SE 207,RESIDENTIAL,17400,0,17400,70600,0,88000
141437801000000,SE 207,RESIDENTIAL,20000,0,20000,79200,0,99200
141437801100000,SE 207,RESIDENTIAL,20000,0,20000,83900,0,103900
141437801200000,SE 207,RESIDENTIAL,20000,0,20000,97800,0,117800
141437801300000,SE 207,RESIDENTIAL,21600,0,21600,111900,0,133500
141437900100000,SE 207,RESIDENTIAL,29400,0,29400,134200,0,163600
141437900200000,SE 207,RESIDENTIAL,24200,0,24200,106300,0,130500
141437900300000,SE 207,RESIDENTIAL,24200,0,24200,87300,0,111500
141437900400000,SE 207,RESIDENTIAL,25000,0,25000,69100,0,94100
141437900500000,SE 207,RESIDENTIAL,32800,0,32800,80900,0,113700
141437900600000,SE 207,RESIDENTIAL,29100,0,29100,212100,0,241200
141437900700000,SE 207,RESIDENTIAL,41900,0,41900,107400,0,149300
141437900800000,SE 207,RESIDENTIAL,27200,0,27200,89200,0,116400
141437900900000,SE 207,RESIDENTIAL,27900,0,27900,138100,0,166000
141438000100000,SE 207,RESIDENTIAL,24900,0,24900,132200,0,157100
141438000200000,SE 207,RESIDENTIAL,24900,0,24900,135200,0,160100
141438000300000,SE 207,RESIDENTIAL,20200,0,20200,97800,0,118000
141438000400000,SE 207,RESIDENTIAL,20200,0,20200,97900,0,118100
141438000500000,SE 207,RESIDENTIAL,28300,0,28300,99000,0,127300
141438000600000,SE 207,RESIDENTIAL,20200,0,20200,108300,0,128500
141438000700000,SE 207,RESIDENTIAL,20200,0,20200,60300,0,80500
141438000800000,SE 207,RESIDENTIAL,20200,0,20200,124200,0,144400
141438000900000,SE 207,RESIDENTIAL,27500,0,27500,106400,0,133900
141438001000000,SE 207,RESIDENTIAL,30300,0,30300,161000,0,191300
141438001100000,SE 207,RESIDENTIAL,25700,0,25700,95400,0,121100
141438001200000,SE 207,RESIDENTIAL,25800,0,25800,84500,0,110300
141438001300000,SE 207,RESIDENTIAL,23500,0,23500,59800,0,83300
141438001400000,SE 207,RESIDENTIAL,23400,0,23400,84200,0,107600
141438001500000,SE 207,RESIDENTIAL,23400,0,23400,116800,0,140200
141438100100000,SE 207,RESIDENTIAL,20000,0,20000,126400,0,146400
141438100200000,SE 207,RESIDENTIAL,20000,0,20000,79900,0,99900
141438100300000,SE 207,RESIDENTIAL,20000,0,20000,84300,0,104300
141438100400000,SE 207,RESIDENTIAL,20000,0,20000,88700,0,108700
141438100500000,SE 207,RESIDENTIAL,20000,0,20000,60700,0,80700
141438100600000,SE 207,RESIDENTIAL,20000,0,20000,66700,0,86700
141438100700000,SE 207,RESIDENTIAL,20000,0,20000,68500,0,88500
141438100800000,SE 207,RESIDENTIAL,20000,0,20000,67600,0,87600
141438100900000,SE 207,RESIDENTIAL,20000,0,20000,67000,0,87000
141438101000000,SE 207,RESIDENTIAL,20000,0,20000,68700,0,88700
141438101100000,SE 207,RESIDENTIAL,28000,0,28000,125900,0,153900
141438101200000,SE 207,RESIDENTIAL,28000,0,28000,170000,0,198000
141438101300000,SE 207,RESIDENTIAL,20000,0,20000,102200,0,122200
141438101400000,SE 207,RESIDENTIAL,20000,0,20000,70800,0,90800
141438101500000,SE 207,RESIDENTIAL,20000,0,20000,71100,0,91100
141438101600000,SE 207,RESIDENTIAL,20000,0,20000,123700,0,143700
141438101700000,SE 207,RESIDENTIAL,20000,0,20000,84800,0,104800
141438101800000,SE 207,RESIDENTIAL,20000,0,20000,80400,0,100400
141438101900000,SE 207,RESIDENTIAL,20000,0,20000,94200,0,114200
141438102000000,SE 207,RESIDENTIAL,20000,0,20000,120100,0,140100
141438200100000,SE 207,RESIDENTIAL,20000,0,20000,88100,0,108100
141438200200000,SE 207,RESIDENTIAL,20000,0,20000,144200,0,164200
141438200300000,SE 207,RESIDENTIAL,26200,0,26200,159100,0,185300
141438200400000,SE 207,RESIDENTIAL,25600,0,25600,144300,0,169900
141438200500000,SE 207,RESIDENTIAL,25700,0,25700,115300,0,141000
141438200600000,SE 207,RESIDENTIAL,26700,0,26700,159900,0,186600
141438200700000,SE 207,RESIDENTIAL,22500,0,22500,75000,0,97500
141438200800000,SE 207,RESIDENTIAL,26000,0,26000,175900,0,201900
141438200900000,SE 207,RESIDENTIAL,21800,0,21800,130900,0,152700
141438201000000,SE 207,RESIDENTIAL,23300,0,23300,113100,0,136400
141438201100000,SE 207,RESIDENTIAL,20000,0,20000,81200,0,101200
141438201200000,SE 207,RESIDENTIAL,20000,0,20000,47900,0,67900
141438201300000,SE 207,RESIDENTIAL,20000,0,20000,44200,0,64200
141438201400000,SE 207,RESIDENTIAL,20000,0,20000,69100,0,89100
141438201500000,SE 207,RESIDENTIAL,20000,0,20000,63600,0,83600
141438201600000,SE 207,RESIDENTIAL,20000,0,20000,80200,0,100200
141438201700000,SE 207,RESIDENTIAL,20000,0,20000,80600,0,100600
141438201800000,SE 207,RESIDENTIAL,20000,0,20000,87000,0,107000
141438300100000,SE 207,RESIDENTIAL,100500,0,100500,139500,0,240000
141438300200000,SE 207,RESIDENTIAL,61400,0,61400,270100,0,331500
141438300300000,SE 207,RESIDENTIAL,100300,0,100300,158900,0,259200
141438300400000,SE 207,RESIDENTIAL,51300,0,51300,149900,0,201200
141438300500000,SE 207,RESIDENTIAL,45200,0,45200,139100,0,184300
141438300600000,SE 207,RESIDENTIAL,45200,0,45200,153200,0,198400
141438300700000,SE 207,RESIDENTIAL,45200,0,45200,96300,0,141500
141438300800000,SE 207,RESIDENTIAL,22600,0,22600,64000,0,86600
141438300900000,SE 207,RESIDENTIAL,21500,0,21500,83700,0,105200
141438301000000,SE 207,RESIDENTIAL,21500,0,21500,56200,0,77700
141438301100000,SE 207,RESIDENTIAL,21500,0,21500,74500,0,96000
141438301200000,SE 207,RESIDENTIAL,21500,0,21500,58800,0,80300
141438301300000,SE 207,RESIDENTIAL,25800,0,25800,75200,0,101000
141438301400000,SE 207,RESIDENTIAL,26000,0,26000,70800,0,96800
141438301500000,SE 207,RESIDENTIAL,21200,0,21200,98100,0,119300
141440100100000,SE 211,RESIDENTIAL,6300,0,6300,0,0,6300
141440100200000,SE 211,RESIDENTIAL,175500,0,175500,473400,0,648900
141440100300000,SE 211,RESIDENTIAL,160500,0,160500,365500,0,526000
141440100400000,SE 211,RESIDENTIAL,162000,0,162000,347300,0,509300
141440100500000,SE 211,RESIDENTIAL,103400,0,103400,386000,0,489400
141440100600000,SE 211,RESIDENTIAL,67600,0,67600,285100,0,352700
141440100700000,SE 211,RESIDENTIAL,74100,0,74100,326300,0,400400
141440100800000,SE 211,RESIDENTIAL,76500,0,76500,282500,0,359000
141440100900000,SE 211,RESIDENTIAL,77300,0,77300,418200,0,495500
141440101000000,SE 211,RESIDENTIAL,74700,0,74700,287400,0,362100
141440101100000,SE 211,RESIDENTIAL,155300,0,155300,261100,0,416400
141440101200000,SE 211,RESIDENTIAL,153900,0,153900,233200,0,387100
141440101300000,SE 211,RESIDENTIAL,153200,0,153200,184100,0,337300
141440101400000,SE 211,RESIDENTIAL,82800,0,82800,211000,0,293800
141440101500000,SE 211,RESIDENTIAL,82700,0,82700,266300,0,349000
141440101600000,SE 211,RESIDENTIAL,84200,0,84200,249500,0,333700
141440101700000,SE 211,RESIDENTIAL,83900,0,83900,269100,0,353000
141440101800000,SE 211,RESIDENTIAL,94100,0,94100,302900,0,397000
141440101900000,SE 211,RESIDENTIAL,176600,0,176600,246300,0,422900
141440102000000,SE 211,RESIDENTIAL,3600,0,3600,0,0,3600
141440102100000,SE 211,RESIDENTIAL,0,0,0,0,0,0
141440200100000,SE 211,RESIDENTIAL,113300,0,113300,145700,0,259000
141440200200000,SE 211,RESIDENTIAL,0,0,0,0,0,0
141442600100000,SE 206,RESIDENTIAL,52700,0,52700,279800,0,332500
141442600200000,SE 206,RESIDENTIAL,53800,0,53800,148700,0,202500
141442600300000,SE 206,RESIDENTIAL,85400,0,85400,266500,0,351900
141442600400000,SE 206,RESIDENTIAL,87800,0,87800,198900,0,286700
141442600500000,SE 206,RESIDENTIAL,77200,0,77200,201400,0,278600
141442600600000,SE 206,RESIDENTIAL,50900,0,50900,192200,0,243100
141442600700000,SE 206,RESIDENTIAL,49800,0,49800,221800,0,271600
141442600800000,SE 206,RESIDENTIAL,53400,0,53400,238500,0,291900
141442600900000,SE 206,RESIDENTIAL,45900,0,45900,179100,0,225000
141442601000000,SE 206,RESIDENTIAL,48200,0,48200,209400,0,257600
141442601100000,SE 206,RESIDENTIAL,48900,0,48900,153900,0,202800
141442601200000,SE 206,RESIDENTIAL,51000,0,51000,177700,0,228700
141442601300000,SE 206,RESIDENTIAL,51000,0,51000,155600,0,206600
141442601400000,SE 206,RESIDENTIAL,54700,0,54700,210600,0,265300
141442700100000,SE 203,RESIDENTIAL,99800,0,99800,325200,0,425000
141442700200000,SE 203,RESIDENTIAL,58900,0,58900,213500,0,272400
141442700300000,SE 203,RESIDENTIAL,61800,0,61800,140800,0,202600
141442700400000,SE 203,RESIDENTIAL,44500,0,44500,145200,0,189700
141442700500000,SE 203,RESIDENTIAL,39600,0,39600,205900,0,245500
141442800100000,SE 206,RESIDENTIAL,52900,0,52900,151800,0,204700
141442800200000,SE 206,RESIDENTIAL,79400,0,79400,163000,0,242400
141442800300000,SE 206,RESIDENTIAL,76900,0,76900,181600,0,258500
141442800400000,SE 206,RESIDENTIAL,68500,0,68500,196000,0,264500
141442800500000,SE 206,RESIDENTIAL,66500,0,66500,194000,0,260500
141442800600000,SE 206,RESIDENTIAL,52000,0,52000,155400,0,207400
141442800700000,SE 206,RESIDENTIAL,50700,0,50700,243600,0,294300
141442800800000,SE 206,RESIDENTIAL,50100,0,50100,177100,0,227200
141442800900000,SE 206,RESIDENTIAL,48900,0,48900,109000,0,157900
141442801000000,SE 206,RESIDENTIAL,49600,0,49600,191400,0,241000
141442801100000,SE 206,RESIDENTIAL,41900,0,41900,178600,0,220500
141442900100000,SE 206,RESIDENTIAL,56400,0,56400,166100,0,222500
141442900200000,SE 206,RESIDENTIAL,50000,0,50000,207800,0,257800
141442900300000,SE 206,RESIDENTIAL,50000,0,50000,191500,0,241500
141442900400000,SE 206,RESIDENTIAL,47700,0,47700,176400,0,224100
141442900500000,SE 206,RESIDENTIAL,48800,0,48800,197500,0,246300
141442900600000,SE 206,RESIDENTIAL,47300,0,47300,118700,0,166000
141442900700000,SE 206,RESIDENTIAL,45200,0,45200,175600,0,220800
141442900800000,SE 206,RESIDENTIAL,50300,0,50300,178700,0,229000
141442900900000,SE 206,RESIDENTIAL,50300,0,50300,198600,0,248900
141442901000000,SE 206,RESIDENTIAL,50500,0,50500,190900,0,241400
141442901100000,SE 206,RESIDENTIAL,52400,0,52400,163600,0,216000
141442901200000,SE 206,RESIDENTIAL,49300,0,49300,202000,0,251300
141442901300000,SE 206,RESIDENTIAL,52500,0,52500,180600,0,233100
141442901400000,SE 206,RESIDENTIAL,47500,0,47500,151800,0,199300
141442901500000,SE 206,RESIDENTIAL,50400,0,50400,112200,0,162600
141442901600000,SE 206,RESIDENTIAL,44500,0,44500,208500,0,253000
141442901700000,SE 206,RESIDENTIAL,42700,0,42700,170500,0,213200
141442901800000,SE 206,RESIDENTIAL,54100,0,54100,153700,0,207800
141442901900000,SE 206,RESIDENTIAL,45500,0,45500,175500,0,221000
141442902000000,SE 206,RESIDENTIAL,48800,0,48800,165400,0,214200
141442902100000,SE 206,RESIDENTIAL,46600,0,46600,185000,0,231600
141442902200000,SE 206,RESIDENTIAL,44600,0,44600,128900,0,173500
141442902300000,SE 206,RESIDENTIAL,56900,0,56900,175700,0,232600
141442902400000,SE 206,RESIDENTIAL,54100,0,54100,227400,0,281500
141442902500000,SE 206,RESIDENTIAL,50700,0,50700,160800,0,211500
141442902600000,SE 206,RESIDENTIAL,0,0,0,0,0,0
141443000100000,SE 206,RESIDENTIAL,53500,0,53500,253100,0,306600
141443000200000,SE 206,RESIDENTIAL,55200,0,55200,176100,0,231300
141443000300000,SE 206,RESIDENTIAL,55200,0,55200,247700,0,302900
141443000400000,SE 206,EXEMPT,0,53900,53900,0,179600,233500
141443000500000,SE 206,RESIDENTIAL,48000,0,48000,136200,0,184200
141443000600000,SE 206,RESIDENTIAL,51900,0,51900,224600,0,276500
141443000700000,SE 206,RESIDENTIAL,47000,0,47000,226800,0,273800
141443000800000,SE 206,RESIDENTIAL,52600,0,52600,199400,0,252000
141443000900000,SE 206,RESIDENTIAL,52000,0,52000,183100,0,235100
141443001000000,SE 206,RESIDENTIAL,54600,0,54600,181300,0,235900
141443001100000,SE 206,RESIDENTIAL,47200,0,47200,200700,0,247900
141445100100000,SE 211,RESIDENTIAL,160000,0,160000,278800,0,438800
141445100200000,SE 211,RESIDENTIAL,132500,0,132500,385100,0,517600
141445100300000,CITY PROPERTY,EXEMPT,0,0,0,0,0,0
141445100400000,SE 211,RESIDENTIAL,181100,0,181100,577600,0,758700
141445200100000,CITY PROPERTY,EXEMPT,0,0,0,0,0,0
141445200200000,SE 211,RESIDENTIAL,86400,0,86400,277100,0,363500
141445200300000,SE 211,RESIDENTIAL,109300,0,109300,291400,0,400700
141445200400000,CITY PROPERTY,EXEMPT,0,0,0,0,0,0
141447600100000,SE 211,RESIDENTIAL,7300,0,7300,0,0,7300
141447600200000,SE 211,RESIDENTIAL,69200,0,69200,633300,0,702500
141447600300000,SE 211,RESIDENTIAL,55400,0,55400,228400,0,283800
141447600400000,SE 211,RESIDENTIAL,55800,0,55800,246200,0,302000
141447600500000,SE 211,RESIDENTIAL,69700,0,69700,225200,0,294900
141447600600000,SE 211,RESIDENTIAL,128700,0,128700,386600,0,515300
141447600700000,SE 211,RESIDENTIAL,101700,0,101700,699300,0,801000
141447600800000,SE 211,RESIDENTIAL,103700,0,103700,273700,0,377400
141447600900000,SE 211,RESIDENTIAL,103600,0,103600,346500,0,450100
141447601000000,SE 211,RESIDENTIAL,105700,0,105700,293100,0,398800
141447601100000,SE 211,RESIDENTIAL,65800,0,65800,154700,0,220500
141447601200000,SE 211,RESIDENTIAL,9700,0,9700,0,0,9700
141447601300000,SE 211,RESIDENTIAL,106200,0,106200,95000,0,201200
141447601400000,SE 211,RESIDENTIAL,15000,0,15000,0,0,15000
141447601500000,SE 211,RESIDENTIAL,100000,0,100000,375600,0,475600
141447601600000,SE 211,RESIDENTIAL,100000,0,100000,339400,0,439400
141447601700000,SE 211,RESIDENTIAL,72100,0,72100,356700,0,428800
141447601800000,SE 211,RESIDENTIAL,77600,0,77600,191900,0,269500
141447601900000,SE 211,RESIDENTIAL,68700,0,68700,192100,0,260800
141447602000000,SE 211,RESIDENTIAL,84200,0,84200,286900,0,371100
141447602100000,SE 211,RESIDENTIAL,101600,0,101600,246100,0,347700
141447602200000,SE 211,RESIDENTIAL,5500,0,5500,0,0,5500
141447602300000,SE 211,RESIDENTIAL,100100,0,100100,380900,0,481000
141447602400000,SE 211,RESIDENTIAL,0,0,0,0,0,0
141447602500000,SE 211,RESIDENTIAL,0,0,0,0,0,0
141447700100000,SE 211,RESIDENTIAL,68400,0,68400,267800,0,336200
141447700200000,SE 211,RESIDENTIAL,2100,0,2100,0,0,2100
141447800100000,SE 211,RESIDENTIAL,250000,0,250000,598400,0,848400
141447800200000,SE 212,RESIDENTIAL,126200,0,126200,692000,0,818200
141447800300000,SE 212,RESIDENTIAL,128500,0,128500,378900,0,507400
141447800400000,CITY PROPERTY,EXEMPT,0,0,0,0,0,0
141510100200000,NE 142,RESIDENTIAL,27300,0,27300,102800,0,130100
141510100300000,NE 142,RESIDENTIAL,27600,0,27600,102600,0,130200
141510100400000,NE 142,RESIDENTIAL,27600,0,27600,114700,0,142300
141510100500000,NE 142,RESIDENTIAL,25500,0,25500,98200,0,123700
141510100600000,NE 142,RESIDENTIAL,25500,0,25500,103800,0,129300
141510100700000,NE 142,RESIDENTIAL,25500,0,25500,112400,0,137900
141510100800000,NE 142,RESIDENTIAL,25500,0,25500,72000,0,97500
141510100900000,NE 142,RESIDENTIAL,27600,0,27600,79800,0,107400
141510101000000,NE 142,RESIDENTIAL,27600,0,27600,109000,0,136600
141510101100000,NE 142,RESIDENTIAL,27600,0,27600,103200,0,130800
141510101200000,NE 142,RESIDENTIAL,27600,0,27600,94600,0,122200
141510101300000,NE 142,RESIDENTIAL,27600,0,27600,97600,0,125200
141510101400000,NE 142,RESIDENTIAL,27100,0,27100,99300,0,126400
141510101500000,SCHOOL,EXEMPT,0,0,0,0,0,0
141510200100000,NE 142,RESIDENTIAL,28600,0,28600,94800,0,123400
141510200200000,NE 142,RESIDENTIAL,27200,0,27200,115900,0,143100
141510200300000,NE 142,RESIDENTIAL,27600,0,27600,99600,0,127200
141510200400000,NE 142,RESIDENTIAL,27200,0,27200,118100,0,145300
141510200500000,NE 142,RESIDENTIAL,26500,0,26500,95800,0,122300
141510200600000,NE 142,RESIDENTIAL,31200,0,31200,98800,0,130000
141510200700000,NE 142,RESIDENTIAL,30200,0,30200,123100,0,153300
141510200800000,NE 142,RESIDENTIAL,23700,0,23700,121200,0,144900
141510200900000,NE 142,RESIDENTIAL,27600,0,27600,122100,0,149700
141510201000000,NE 142,RESIDENTIAL,27600,0,27600,102700,0,130300
141510201100000,NE 142,RESIDENTIAL,29800,0,29800,129300,0,159100
141510201200000,NE 142,RESIDENTIAL,28500,0,28500,123100,0,151600
141510201300000,NE 142,RESIDENTIAL,26800,0,26800,99600,0,126400
141510201400000,NE 142,RESIDENTIAL,24300,0,24300,105800,0,130100
141510201500000,NE 142,RESIDENTIAL,30200,0,30200,125000,0,155200
141510201600000,NE 142,RESIDENTIAL,26500,0,26500,100500,0,127000
141510201700000,NE 142,RESIDENTIAL,27100,0,27100,129800,0,156900
141510201800000,NE 142,RESIDENTIAL,28700,0,28700,97800,0,126500
141510201900000,NE 142,RESIDENTIAL,29600,0,29600,141200,0,170800
141510202000000,NE 142,RESIDENTIAL,30900,0,30900,129500,0,160400
141510202100000,NE 142,RESIDENTIAL,27300,0,27300,125300,0,152600
141510202200000,NE 142,RESIDENTIAL,27600,0,27600,108000,0,135600
141510300100000,NE 142,RESIDENTIAL,27700,0,27700,108000,0,135700
141510300200000,NE 142,RESIDENTIAL,24700,0,24700,121400,0,146100
141510300300000,NE 142,RESIDENTIAL,28200,0,28200,145700,0,173900
141510300400000,NE 142,RESIDENTIAL,31500,0,31500,107500,0,139000
141510300500000,NE 142,RESIDENTIAL,31600,0,31600,106300,0,137900
141510300600000,NE 142,RESIDENTIAL,28600,0,28600,99900,0,128500
141510300700000,NE 142,RESIDENTIAL,30400,0,30400,118600,0,149000
141510300800000,NE 142,RESIDENTIAL,35300,0,35300,97500,0,132800
141510300900000,NE 142,RESIDENTIAL,33200,0,33200,129600,0,162800
141510301000000,NE 142,RESIDENTIAL,34100,0,34100,121600,0,155700
141510301100000,NE 142,RESIDENTIAL,33500,0,33500,110600,0,144100
141510400100000,SCHOOL,EXEMPT,0,0,0,0,0,0
141510400200000,NE 154,RESIDENTIAL,20200,0,20200,88500,0,108700
141510400300000,NE 154,RESIDENTIAL,20400,0,20400,89400,0,109800
141510400400000,NE 154,RESIDENTIAL,25500,0,25500,101000,0,126500
141510400500000,NE 154,RESIDENTIAL,25500,0,25500,96400,0,121900
141510500100000,NE 154,RESIDENTIAL,25000,0,25000,99000,0,124000
141510500200000,NE 154,RESIDENTIAL,22100,0,22100,101400,0,123500
141510500300000,NE 154,RESIDENTIAL,21800,0,21800,101400,0,123200
141510500400000,NE 154,RESIDENTIAL,7800,0,7800,0,0,7800
141510500500000,NE 154,RESIDENTIAL,24100,0,24100,132100,0,156200
141510500600000,NE 154,RESIDENTIAL,18400,0,18400,75300,0,93700
141510500700000,NE 154,RESIDENTIAL,21600,0,21600,66000,0,87600
141510500800000,NE 154,RESIDENTIAL,26800,0,26800,135600,0,162400
141510500900000,NE 154,RESIDENTIAL,20600,0,20600,100100,0,120700
141510501000000,NE 154,RESIDENTIAL,20600,0,20600,84600,0,105200
141510501100000,NE 154,RESIDENTIAL,21200,0,21200,96900,0,118100
141510501200000,NE 154,RESIDENTIAL,21200,0,21200,75300,0,96500
141510501300000,NE 154,RESIDENTIAL,21200,0,21200,70100,0,91300
141510501400000,NE 154,RESIDENTIAL,21200,0,21200,95700,0,116900
141510501500000,NE 154,RESIDENTIAL,21200,0,21200,85500,0,106700
141510501600000,NE 154,RESIDENTIAL,21200,0,21200,86100,0,107300
141510501700000,NE 154,RESIDENTIAL,20000,0,20000,84300,0,104300
141510600100000,NE 154,RESIDENTIAL,23000,0,23000,74600,0,97600
141510700100000,NE 142,RESIDENTIAL,28100,0,28100,97400,0,125500
141510700200000,NE 142,RESIDENTIAL,24200,0,24200,154500,0,178700
141510700300000,NE 142,RESIDENTIAL,25500,0,25500,113800,0,139300
141510700400000,NE 142,RESIDENTIAL,25500,0,25500,102100,0,127600
141510700500000,NE 142,RESIDENTIAL,25500,0,25500,105500,0,131000
141510700600000,NE 142,RESIDENTIAL,25500,0,25500,91600,0,117100
141510700700000,NE 142,RESIDENTIAL,25500,0,25500,109900,0,135400
141510700800000,NE 142,RESIDENTIAL,27600,0,27600,72200,0,99800
141510700900000,NE 154,RESIDENTIAL,20000,0,20000,114200,0,134200
141510701000000,NE 154,RESIDENTIAL,20000,0,20000,82900,0,102900
141510701100000,NE 154,RESIDENTIAL,25000,0,25000,68300,0,93300
141510701200000,NE 154,RESIDENTIAL,25000,0,25000,79100,0,104100
141510701300000,NE 154,RESIDENTIAL,25000,0,25000,57500,0,82500
141510701400000,NE 154,RESIDENTIAL,25000,0,25000,77800,0,102800
141510701500000,NE 154,RESIDENTIAL,25000,0,25000,85000,0,110000
141510701600000,NE 154,RESIDENTIAL,25000,0,25000,82500,0,107500
141510701700000,NE 154,RESIDENTIAL,26000,0,26000,97000,0,123000
141510701800000,NE 154,RESIDENTIAL,23600,0,23600,78500,0,102100
141510701900000,NE 154,RESIDENTIAL,18200,0,18200,86500,0,104700
141510702000000,NE 154,RESIDENTIAL,26500,0,26500,94600,0,121100
141510800100000,NE 142,RESIDENTIAL,30000,0,30000,124100,0,154100
141510800200000,NE 142,RESIDENTIAL,24600,0,24600,97300,0,121900
141510800300000,NE 142,RESIDENTIAL,24900,0,24900,94100,0,119000
141510800400000,NE 142,RESIDENTIAL,24900,0,24900,95700,0,120600
141510800500000,NE 142,RESIDENTIAL,24100,0,24100,97500,0,121600
141510800600000,NE 142,RESIDENTIAL,22900,0,22900,135300,0,158200
141510800700000,NE 142,RESIDENTIAL,26400,0,26400,69000,0,95400
141510800800000,NE 142,RESIDENTIAL,27600,0,27600,82200,0,109800
141510800900000,NE 142,RESIDENTIAL,25500,0,25500,127700,0,153200
141510801000000,NE 142,RESIDENTIAL,25500,0,25500,119100,0,144600
141510801100000,NE 142,RESIDENTIAL,27600,0,27600,101800,0,129400
141510801200000,NE 142,RESIDENTIAL,23800,0,23800,81500,0,105300
141510900100000,NE 142,RESIDENTIAL,26600,0,26600,58400,0,85000
141510900200000,NE 142,RESIDENTIAL,25500,0,25500,93900,0,119400
141510900300000,NE 154,RESIDENTIAL,20000,0,20000,76200,0,96200
141512600100000,NE 142,RESIDENTIAL,30000,0,30000,135100,0,165100
141512600200000,NE 142,RESIDENTIAL,29700,0,29700,118800,0,148500
141512600300000,NE 142,RESIDENTIAL,26400,0,26400,126200,0,152600
141512600400000,NE 142,RESIDENTIAL,26400,0,26400,98900,0,125300
141512600500000,NE 142,RESIDENTIAL,26400,0,26400,119800,0,146200
141512600600000,NE 142,RESIDENTIAL,23500,0,23500,99500,0,123000
141512600700000,NE 142,RESIDENTIAL,29000,0,29000,130300,0,159300
141512600800000,NE 142,RESIDENTIAL,30800,0,30800,125100,0,155900
141512600900000,NE 142,RESIDENTIAL,29300,0,29300,86900,0,116200
141512601000000,NE 142,RESIDENTIAL,29600,0,29600,123400,0,153000
141512601100000,NE 142,RESIDENTIAL,31400,0,31400,111800,0,143200
141512700100000,NE 142,EXEMPT,0,26400,26400,0,92600,119000
141512700200000,NE 142,RESIDENTIAL,29000,0,29000,120900,0,149900
141512700300000,NE 142,RESIDENTIAL,26700,0,26700,108900,0,135600
141512700400000,NE 142,RESIDENTIAL,24000,0,24000,111600,0,135600
141512700500000,NE 142,RESIDENTIAL,30500,0,30500,102000,0,132500
141512700600000,NE 142,RESIDENTIAL,28600,0,28600,122100,0,150700
141512700700000,NE 142,RESIDENTIAL,24400,0,24400,112800,0,137200
141512700800000,NE 142,RESIDENTIAL,22500,0,22500,93400,0,115900
141512700900000,NE 142,RESIDENTIAL,24100,0,24100,87200,0,111300
141512701000000,NE 142,RESIDENTIAL,25000,0,25000,115500,0,140500
141512701100000,NE 142,RESIDENTIAL,25100,0,25100,86400,0,111500
141512701200000,NE 142,RESIDENTIAL,24900,0,24900,95000,0,119900
141512701300000,NE 142,RESIDENTIAL,24100,0,24100,117900,0,142000
141512701400000,NE 142,RESIDENTIAL,28200,0,28200,126400,0,154600
141512701500000,NE 142,RESIDENTIAL,26600,0,26600,100100,0,126700
141512701600000,NE 142,RESIDENTIAL,26600,0,26600,106100,0,132700
141512701700000,NE 142,RESIDENTIAL,26800,0,26800,87400,0,114200
141512701800000,NE 142,RESIDENTIAL,25800,0,25800,78100,0,103900
141512701900000,NE 142,RESIDENTIAL,26800,0,26800,89600,0,116400
141512702000000,NE 142,RESIDENTIAL,27100,0,27100,116500,0,143600
141512702100000,NE 142,RESIDENTIAL,29000,0,29000,142500,0,171500
141512702200000,NE 142,RESIDENTIAL,23000,0,23000,90400,0,113400
141512702300000,NE 142,RESIDENTIAL,26300,0,26300,119300,0,145600
141512702400000,NE 142,RESIDENTIAL,25700,0,25700,77100,0,102800
141512702500000,NE 142,RESIDENTIAL,25600,0,25600,103400,0,129000
141512702600000,NE 142,RESIDENTIAL,25600,0,25600,108900,0,134500
141512702700000,NE 142,RESIDENTIAL,26300,0,26300,64300,0,90600
141512800100000,NE 142,RESIDENTIAL,24100,0,24100,83200,0,107300
141512800200000,NE 142,RESIDENTIAL,23900,0,23900,88400,0,112300
141512800300000,NE 142,RESIDENTIAL,30200,0,30200,137600,0,167800
141512800400000,NE 142,RESIDENTIAL,31000,0,31000,93400,0,124400
141512800500000,NE 142,RESIDENTIAL,24500,0,24500,88600,0,113100
141512800600000,NE 142,RESIDENTIAL,28300,0,28300,83400,0,111700
141512900100000,NE 142,RESIDENTIAL,24400,0,24400,118700,0,143100
141512900200000,NE 142,RESIDENTIAL,24300,0,24300,119900,0,144200
141512900300000,NE 142,RESIDENTIAL,24300,0,24300,103500,0,127800
141512900400000,NE 142,RESIDENTIAL,25400,0,25400,114900,0,140300
141512900500000,NE 142,RESIDENTIAL,24200,0,24200,83400,0,107600
141512900600000,NE 142,RESIDENTIAL,24200,0,24200,64600,0,88800
141512900700000,NE 142,RESIDENTIAL,24000,0,24000,97100,0,121100
141512900800000,NE 142,RESIDENTIAL,24900,0,24900,113600,0,138500
141512900900000,NE 142,RESIDENTIAL,22900,0,22900,75300,0,98200
141512901000000,NE 142,RESIDENTIAL,22900,0,22900,77600,0,100500
141512901100000,NE 142,RESIDENTIAL,22900,0,22900,91200,0,114100
141512901200000,NE 142,RESIDENTIAL,22900,0,22900,76900,0,99800
141512901300000,NE 142,RESIDENTIAL,22700,0,22700,99800,0,122500
141512901400000,NE 142,RESIDENTIAL,28300,0,28300,104400,0,132700
141513000100000,NE 142,RESIDENTIAL,27800,0,27800,73400,0,101200
141513000200000,NE 142,RESIDENTIAL,26000,0,26000,76600,0,102600
141513000300000,NE 142,RESIDENTIAL,26000,0,26000,78900,0,104900
141513000400000,NE 142,RESIDENTIAL,26000,0,26000,74400,0,100400
141513000500000,NE 142,RESIDENTIAL,25000,0,25000,104800,0,129800
141513000600000,NE 142,RESIDENTIAL,26000,0,26000,78300,0,104300
141513000700000,NE 142,RESIDENTIAL,26000,0,26000,108100,0,134100
141513000800000,NE 142,RESIDENTIAL,26000,0,26000,112200,0,138200
141513000900000,NE 142,RESIDENTIAL,25400,0,25400,77700,0,103100
141513001000000,NE 142,RESIDENTIAL,22900,0,22900,78700,0,101600
141513001100000,NE 142,RESIDENTIAL,22900,0,22900,68900,0,91800
141513001200000,NE 142,RESIDENTIAL,22900,0,22900,73200,0,96100
141513001300000,NE 142,RESIDENTIAL,22900,0,22900,69700,0,92600
141513001400000,NE 142,RESIDENTIAL,22900,0,22900,43500,0,66400
141513001500000,NE 142,RESIDENTIAL,22900,0,22900,107300,0,130200
141513001600000,NE 142,RESIDENTIAL,22900,0,22900,51900,0,74800
141513001700000,NE 142,RESIDENTIAL,22900,0,22900,62900,0,85800
141513001800000,NE 142,RESIDENTIAL,22900,0,22900,79400,0,102300
141513001900000,NE 142,RESIDENTIAL,27200,0,27200,104700,0,131900
141513100100000,NE 142,RESIDENTIAL,23500,0,23500,105600,0,129100
141513100200000,NE 142,RESIDENTIAL,23100,0,23100,57000,0,80100
141513100300000,NE 142,RESIDENTIAL,23100,0,23100,82300,0,105400
141513100400000,NE 142,RESIDENTIAL,23100,0,23100,82800,0,105900
141513100500000,NE 142,RESIDENTIAL,23100,0,23100,88900,0,112000
141513100600000,NE 142,RESIDENTIAL,23100,0,23100,72000,0,95100
141513100700000,NE 142,RESIDENTIAL,23100,0,23100,89600,0,112700
141513100800000,NE 142,RESIDENTIAL,23100,0,23100,98400,0,121500
141513100900000,NE 142,RESIDENTIAL,23100,0,23100,86400,0,109500
141513101000000,NE 142,RESIDENTIAL,23100,0,23100,97000,0,120100
141513101100000,NE 142,RESIDENTIAL,23100,0,23100,78200,0,101300
141513101200000,NE 142,RESIDENTIAL,23100,0,23100,78700,0,101800
141513101300000,NE 142,RESIDENTIAL,23400,0,23400,91500,0,114900
141513101400000,NE 142,RESIDENTIAL,23400,0,23400,91500,0,114900
141513101500000,NE 142,RESIDENTIAL,22200,0,22200,94300,0,116500
141513101600000,NE 142,RESIDENTIAL,23400,0,23400,85100,0,108500
141513101700000,NE 142,RESIDENTIAL,23400,0,23400,65900,0,89300
141513101800000,NE 142,RESIDENTIAL,23400,0,23400,95900,0,119300
141513101900000,NE 142,RESIDENTIAL,23400,0,23400,87200,0,110600
141513102000000,NE 142,RESIDENTIAL,23400,0,23400,89900,0,113300
141513102100000,NE 142,RESIDENTIAL,25500,0,25500,82800,0,108300
141513200100000,CHURCH,EXEMPT,0,41600,41600,0,231500,273100
141513200200000,NE 142,RESIDENTIAL,24000,0,24000,77800,0,101800
141513200300000,NE 142,RESIDENTIAL,25600,0,25600,90900,0,116500
141513200400000,NE 142,RESIDENTIAL,25700,0,25700,93400,0,119100
141513200500000,NE 142,RESIDENTIAL,23400,0,23400,84800,0,108200
141513200600000,NE 142,RESIDENTIAL,23400,0,23400,78500,0,101900
141513200700000,NE 142,RESIDENTIAL,23400,0,23400,89100,0,112500
141513200800000,NE 142,RESIDENTIAL,23400,0,23400,82900,0,106300
141513200900000,NE 142,RESIDENTIAL,23400,0,23400,89400,0,112800
141513201000000,NE 142,RESIDENTIAL,24600,0,24600,52900,0,77500
141513201100000,NE 142,RESIDENTIAL,25800,0,25800,74200,0,100000
141513201200000,NE 142,RESIDENTIAL,24200,0,24200,94800,0,119000
141513201300000,NE 142,RESIDENTIAL,24200,0,24200,97600,0,121800
141513201400000,NE 142,RESIDENTIAL,23600,0,23600,124600,0,148200
141513201500000,NE 142,RESIDENTIAL,24400,0,24400,71500,0,95900
141513201600000,NE 142,RESIDENTIAL,24600,0,24600,80300,0,104900
141513201700000,NE 142,RESIDENTIAL,25200,0,25200,84900,0,110100
141513201800000,NE 142,RESIDENTIAL,23400,0,23400,78100,0,101500
141513201900000,NE 142,RESIDENTIAL,23400,0,23400,90000,0,113400
141513202000000,NE 142,RESIDENTIAL,23400,0,23400,94400,0,117800
141513202100000,NE 142,RESIDENTIAL,23400,0,23400,108600,0,132000
141513202200000,NE 142,RESIDENTIAL,23400,0,23400,75100,0,98500
141513202300000,NE 142,RESIDENTIAL,23300,0,23300,86600,0,109900
141513202400000,NE 142,RESIDENTIAL,24000,0,24000,70800,0,94800
141513300100000,NE 142,RESIDENTIAL,29400,0,29400,57100,0,86500
141513300200000,NE 142,RESIDENTIAL,24400,0,24400,65500,0,89900
141513300300000,NE 142,RESIDENTIAL,23600,0,23600,53800,0,77400
141513300400000,NE 142,RESIDENTIAL,25100,0,25100,93000,0,118100
141513300500000,NE 142,RESIDENTIAL,28200,0,28200,67800,0,96000
141513300600000,NE 142,RESIDENTIAL,27300,0,27300,71800,0,99100
141513300700000,NE 142,RESIDENTIAL,25800,0,25800,100600,0,126400
141513300800000,NE 142,RESIDENTIAL,26300,0,26300,70900,0,97200
141513300900000,NE 142,RESIDENTIAL,24500,0,24500,89300,0,113800
141513301000000,NE 142,RESIDENTIAL,26600,0,26600,97200,0,123800
141513301100000,NE 142,RESIDENTIAL,25200,0,25200,63600,0,88800
141513301200000,NE 142,RESIDENTIAL,25700,0,25700,103500,0,129200
141513301300000,NE 142,RESIDENTIAL,25500,0,25500,89100,0,114600
141513301400000,NE 142,RESIDENTIAL,26400,0,26400,95000,0,121400
141513301500000,NE 142,RESIDENTIAL,25300,0,25300,89600,0,114900
141513301600000,NE 142,RESIDENTIAL,23600,0,23600,92400,0,116000
141513301700000,NE 142,RESIDENTIAL,23700,0,23700,74300,0,98000
141513400100000,NE 142,RESIDENTIAL,25500,0,25500,88600,0,114100
141513400200000,NE 142,RESIDENTIAL,25500,0,25500,67200,0,92700
141513400300000,NE 142,RESIDENTIAL,25500,0,25500,63700,0,89200
141515100100000,NE 142,RESIDENTIAL,25500,0,25500,87700,0,113200
141515100200000,NE 142,RESIDENTIAL,25500,0,25500,82200,0,107700
141515100300000,NE 142,RESIDENTIAL,25500,0,25500,75200,0,100700
141515100400000,NE 142,RESIDENTIAL,25500,0,25500,85900,0,111400
141515100500000,NE 142,RESIDENTIAL,25500,0,25500,79300,0,104800
141515100600000,NE 142,RESIDENTIAL,25500,0,25500,93900,0,119400
141515100700000,NE 142,RESIDENTIAL,26800,0,26800,93200,0,120000
141515100800000,NE 142,RESIDENTIAL,22000,0,22000,84800,0,106800
141515100900000,NE 142,RESIDENTIAL,23400,0,23400,86200,0,109600
141515101000000,NE 142,RESIDENTIAL,23400,0,23400,78900,0,102300
141515101100000,NE 142,RESIDENTIAL,23400,0,23400,90500,0,113900
141515101200000,NE 142,RESIDENTIAL,23400,0,23400,90800,0,114200
141515101300000,NE 142,RESIDENTIAL,23400,0,23400,96800,0,120200
141515101400000,NE 142,RESIDENTIAL,23800,0,23800,101900,0,125700
141515101500000,NE 142,RESIDENTIAL,27300,0,27300,96200,0,123500
141515101600000,NE 154,RESIDENTIAL,26500,0,26500,78100,0,104600
141515101700000,NE 154,RESIDENTIAL,23500,0,23500,91400,0,114900
141515101800000,NE 154,RESIDENTIAL,26500,0,26500,87100,0,113600
141515101900000,NE 154,RESIDENTIAL,27900,0,27900,69200,0,97100
141515102000000,NE 154,RESIDENTIAL,23300,0,23300,53400,0,76700
141515102100000,CITY PROPERTY,EXEMPT,0,0,0,0,0,0
141515102200000,NE 154,RESIDENTIAL,30900,0,30900,122600,0,153500
141515102300000,NE 154,RESIDENTIAL,26500,0,26500,118200,0,144700
141515102400000,NE 154,RESIDENTIAL,21500,0,21500,84000,0,105500
141515102500000,CITY PROPERTY,EXEMPT,0,0,0,0,0,0
141515102600000,CENTRALLY ASSESSED,OTHER,0,0,0,0,0,0
141515200100000,NE 142,RESIDENTIAL,23400,0,23400,103500,0,126900
141515200200000,NE 142,RESIDENTIAL,23400,0,23400,86800,0,110200
141515200300000,NE 142,RESIDENTIAL,23400,0,23400,98800,0,122200
141515200400000,NE 142,RESIDENTIAL,24300,0,24300,65300,0,89600
141515200500000,NE 142,RESIDENTIAL,24100,0,24100,82000,0,106100
141515200600000,NE 142,RESIDENTIAL,26500,0,26500,96200,0,122700
141515200700000,NE 142,RESIDENTIAL,26500,0,26500,90500,0,117000
141515200800000,NE 142,RESIDENTIAL,26400,0,26400,86300,0,112700
141515200900000,NE 142,RESIDENTIAL,27700,0,27700,113200,0,140900
141515201000000,NE 142,RESIDENTIAL,23400,0,23400,88700,0,112100
141515201100000,NE 142,RESIDENTIAL,23400,0,23400,82300,0,105700
141515201200000,NE 142,RESIDENTIAL,23400,0,23400,79500,0,102900
141515201300000,NE 142,RESIDENTIAL,24600,0,24600,81200,0,105800
141515201400000,NE 142,RESIDENTIAL,24100,0,24100,80500,0,104600
141515300100000,NE 142,RESIDENTIAL,24400,0,24400,90700,0,115100
141515300200000,NE 142,RESIDENTIAL,26700,0,26700,129600,0,156300
141515400100000,NE 154,RESIDENTIAL,25400,0,25400,86800,0,112200
141515400200000,NE 154,RESIDENTIAL,26900,0,26900,96100,0,123000
141515400300000,NE 154,RESIDENTIAL,25900,0,25900,85000,0,110900
141515400400000,NE 154,RESIDENTIAL,26000,0,26000,76300,0,102300
141515400500000,NE 154,RESIDENTIAL,26800,0,26800,65300,0,92100
141515400600000,NE 154,RESIDENTIAL,25800,0,25800,79900,0,105700
141515400700000,NE 154,RESIDENTIAL,24700,0,24700,56500,0,81200
141515400800000,NE 154,RESIDENTIAL,25400,0,25400,71200,0,96600
141515400900000,NE 154,RESIDENTIAL,22500,0,22500,47200,0,69700
141515401000000,NE 154,RESIDENTIAL,21800,0,21800,56200,0,78000
141515401100000,NE 154,RESIDENTIAL,23700,0,23700,100000,0,123700
141515401200000,NE 154,RESIDENTIAL,25700,0,25700,88700,0,114400
141515401300000,NE 154,RESIDENTIAL,25700,0,25700,115600,0,141300
141515401400000,NE 154,RESIDENTIAL,21400,0,21400,89500,0,110900
141515401500000,NE 154,RESIDENTIAL,21400,0,21400,84700,0,106100
141515401600000,NE 154,RESIDENTIAL,21200,0,21200,75100,0,96300
141515401700000,NE 154,RESIDENTIAL,21000,0,21000,84900,0,105900
141515401800000,NE 154,RESIDENTIAL,21000,0,21000,80600,0,101600
141515401900000,NE 154,RESIDENTIAL,20800,0,20800,80100,0,100900
141515402000000,NE 154,RESIDENTIAL,20600,0,20600,68300,0,88900
141515402100000,NE 154,RESIDENTIAL,20600,0,20600,70700,0,91300
141515402200000,NE 154,RESIDENTIAL,20400,0,20400,55700,0,76100
141515402300000,NE 154,RESIDENTIAL,20200,0,20200,81500,0,101700
141515402400000,NE 154,RESIDENTIAL,20200,0,20200,98300,0,118500
141515500100000,NE 154,RESIDENTIAL,22100,0,22100,66000,0,88100
141515500200000,NE 154,RESIDENTIAL,20300,0,20300,96000,0,116300
141515500300000,NE 154,RESIDENTIAL,21500,0,21500,67100,0,88600
141515500400000,NE 154,RESIDENTIAL,21500,0,21500,110200,0,131700
141515500500000,NE 154,RESIDENTIAL,21500,0,21500,86200,0,107700
141515500600000,NE 154,RESIDENTIAL,21500,0,21500,89900,0,111400
141515500700000,NE 154,RESIDENTIAL,21700,0,21700,81600,0,103300
141515500800000,NE 154,RESIDENTIAL,25800,0,25800,113600,0,139400
141515500900000,NE 154,RESIDENTIAL,23500,0,23500,153400,0,176900
141515501000000,NE 154,RESIDENTIAL,22900,0,22900,136200,0,159100
141515600100000,NE 154,RESIDENTIAL,22700,0,22700,84700,0,107400
141515600200000,NE 154,RESIDENTIAL,20200,0,20200,96900,0,117100
141515600300000,NE 154,RESIDENTIAL,20000,0,20000,68100,0,88100
141515600400000,NE 154,RESIDENTIAL,21700,0,21700,74700,0,96400
141515700100000,NE 154,RESIDENTIAL,26500,0,26500,30800,0,57300
141515700200000,NE 154,RESIDENTIAL,22100,0,22100,55800,0,77900
141515700300000,NE 154,RESIDENTIAL,22100,0,22100,84800,0,106900
141515700400000,NE 154,RESIDENTIAL,22600,0,22600,71100,0,93700
141515700500000,NE 154,RESIDENTIAL,20800,0,20800,70000,0,90800
141515700600000,NE 154,RESIDENTIAL,20800,0,20800,77400,0,98200
141515700700000,NE 154,RESIDENTIAL,22700,0,22700,58100,0,80800
141515700800000,NE 154,RESIDENTIAL,22500,0,22500,57000,0,79500
141515700900000,NE 154,RESIDENTIAL,24800,0,24800,72500,0,97300
141515701000000,NE 154,RESIDENTIAL,28300,0,28300,88600,0,116900
141515701100000,NE 154,RESIDENTIAL,20400,0,20400,79200,0,99600
141515701200000,NE 154,RESIDENTIAL,20600,0,20600,85300,0,105900
141515701300000,NE 154,RESIDENTIAL,20800,0,20800,82000,0,102800
141515701400000,NE 154,RESIDENTIAL,20800,0,20800,64000,0,84800
141515701500000,NE 154,RESIDENTIAL,21000,0,21000,95000,0,116000
141517600100000,NE 154,RESIDENTIAL,25500,0,25500,100900,0,126400
141517600200000,NE 154,RESIDENTIAL,20400,0,20400,94700,0,115100
141517600300000,NE 154,RESIDENTIAL,20400,0,20400,100300,0,120700
141517600400000,NE 154,RESIDENTIAL,20400,0,20400,77300,0,97700
141517600500000,NE 154,RESIDENTIAL,20400,0,20400,83300,0,103700
141517600600000,NE 154,RESIDENTIAL,20400,0,20400,91400,0,111800
141517600700000,NE 154,RESIDENTIAL,20400,0,20400,87200,0,107600
141517600800000,NE 154,RESIDENTIAL,20400,0,20400,84200,0,104600
141517600900000,NE 154,RESIDENTIAL,20400,0,20400,71200,0,91600
141517601000000,NE 154,RESIDENTIAL,20400,0,20400,71200,0,91600
141517601100000,NE 154,RESIDENTIAL,17600,0,17600,85700,0,103300
141517601200000,NE 154,RESIDENTIAL,14000,0,14000,59500,0,73500
141517601300000,NE 154,RESIDENTIAL,16800,0,16800,81300,0,98100
141517601400000,NE 154,RESIDENTIAL,17000,0,17000,76700,0,93700
141517601500000,NE 154,RESIDENTIAL,23600,0,23600,76700,0,100300
141517601600000,NE 154,RESIDENTIAL,20200,0,20200,77400,0,97600
141517601700000,NE 154,RESIDENTIAL,25500,0,25500,87400,0,112900
141517601800000,NE 154,RESIDENTIAL,25500,0,25500,102500,0,128000
141517601900000,NE 154,RESIDENTIAL,25500,0,25500,90200,0,115700
141517602000000,NE 154,RESIDENTIAL,25500,0,25500,75800,0,101300
141517602100000,NE 154,RESIDENTIAL,25500,0,25500,79100,0,104600
141517602200000,NE 154,RESIDENTIAL,25500,0,25500,138200,0,163700
141517602300000,NE 154,RESIDENTIAL,25500,0,25500,90800,0,116300
141517700100000,NE 154,RESIDENTIAL,21200,0,21200,116900,0,138100
141517700200000,NE 154,RESIDENTIAL,20600,0,20600,94300,0,114900
141517700300000,NE 154,RESIDENTIAL,20600,0,20600,89500,0,110100
141517700400000,NE 154,RESIDENTIAL,20600,0,20600,83200,0,103800
141517700500000,NE 154,RESIDENTIAL,20600,0,20600,65000,0,85600
141517700600000,NE 154,RESIDENTIAL,20600,0,20600,78900,0,99500
141517700700000,NE 154,RESIDENTIAL,20600,0,20600,76300,0,96900
141517700800000,NE 154,RESIDENTIAL,20600,0,20600,95900,0,116500
141517700900000,NE 154,RESIDENTIAL,20600,0,20600,104700,0,125300
141517701000000,NE 154,RESIDENTIAL,21200,0,21200,101900,0,123100
141517701100000,NE 154,RESIDENTIAL,21200,0,21200,89900,0,111100
141517701200000,NE 154,RESIDENTIAL,21200,0,21200,79300,0,100500
141517701300000,NE 154,RESIDENTIAL,21200,0,21200,53200,0,74400
141517701400000,NE 154,RESIDENTIAL,21200,0,21200,108800,0,130000
141517701500000,NE 154,RESIDENTIAL,21200,0,21200,93100,0,114300
141517701600000,NE 154,RESIDENTIAL,21200,0,21200,89300,0,110500
141517701700000,NE 154,RESIDENTIAL,21200,0,21200,98800,0,120000
141517800100000,NE 154,RESIDENTIAL,17600,0,17600,83200,0,100800
141517800200000,NE 154,RESIDENTIAL,19200,0,19200,83000,0,102200
141517800300000,NE 154,RESIDENTIAL,20300,0,20300,103300,0,123600
141517800400000,NE 154,RESIDENTIAL,17200,0,17200,61300,0,78500
141517800500000,NE 154,RESIDENTIAL,15800,0,15800,75000,0,90800
141517800600000,NE 154,RESIDENTIAL,24700,0,24700,60100,0,84800
141517800700000,NE 154,RESIDENTIAL,20900,0,20900,111000,0,131900
141517800800000,NE 154,RESIDENTIAL,17600,0,17600,67100,0,84700
141517800900000,NE 154,RESIDENTIAL,16600,0,16600,75500,0,92100
141517900100000,NE 154,RESIDENTIAL,20000,0,20000,53100,0,73100
141517900200000,NE 154,RESIDENTIAL,25000,0,25000,62300,0,87300
141517900300000,NE 154,RESIDENTIAL,25000,0,25000,85700,0,110700
141517900400000,NE 154,RESIDENTIAL,25000,0,25000,81500,0,106500
141517900500000,NE 154,RESIDENTIAL,25000,0,25000,82100,0,107100
141517900600000,NE 154,RESIDENTIAL,20000,0,20000,87500,0,107500
141518000100000,NE 154,RESIDENTIAL,25500,0,25500,84000,0,109500
141518000200000,NE 154,RESIDENTIAL,19300,0,19300,66900,0,86200
141518000300000,NE 154,RESIDENTIAL,20000,0,20000,43000,0,63000
141518100100000,NE 154,RESIDENTIAL,18000,0,18000,76200,0,94200
141518100200000,NE 154,RESIDENTIAL,16200,0,16200,62100,0,78300
141518100300000,NE 154,RESIDENTIAL,16700,0,16700,63200,0,79900
141518100400000,NE 154,RESIDENTIAL,25500,0,25500,59200,0,84700
141518100500000,NE 154,RESIDENTIAL,25500,0,25500,94000,0,119500
141518100600000,NE 154,RESIDENTIAL,20400,0,20400,76800,0,97200
141518100700000,NE 154,RESIDENTIAL,20400,0,20400,62500,0,82900
141518100800000,NE 154,RESIDENTIAL,25500,0,25500,93400,0,118900
141518100900000,NE 154,RESIDENTIAL,25500,0,25500,143300,0,168800
141518101000000,NE 154,RESIDENTIAL,25500,0,25500,112700,0,138200
141518101100000,NE 154,RESIDENTIAL,25500,0,25500,72300,0,97800
141518101200000,NE 154,RESIDENTIAL,26100,0,26100,68900,0,95000
141518101300000,NE 154,RESIDENTIAL,21900,0,21900,69800,0,91700
141518101400000,NE 154,RESIDENTIAL,20400,0,20400,63400,0,83800
141518101500000,NE 154,RESIDENTIAL,20400,0,20400,63300,0,83700
141518101600000,NE 154,RESIDENTIAL,20400,0,20400,64200,0,84600
141518101700000,NE 154,RESIDENTIAL,20400,0,20400,70900,0,91300
141518200100000,NE 154,RESIDENTIAL,22100,0,22100,78500,0,100600
141518200200000,NE 154,RESIDENTIAL,21500,0,21500,65900,0,87400
141518200300000,NE 154,RESIDENTIAL,18700,0,18700,63400,0,82100
141518200400000,NE 154,RESIDENTIAL,14700,0,14700,67700,0,82400
141518200500000,NE 154,RESIDENTIAL,18700,0,18700,69900,0,88600
141518200600000,NE 154,RESIDENTIAL,14000,0,14000,59400,0,73400
141518200700000,NE 154,RESIDENTIAL,20400,0,20400,83800,0,104200
141518200800000,NE 154,RESIDENTIAL,20400,0,20400,79800,0,100200
141518200900000,NE 154,RESIDENTIAL,20400,0,20400,87700,0,108100
141518201000000,NE 154,RESIDENTIAL,20400,0,20400,105200,0,125600
141518201100000,NE 154,RESIDENTIAL,20400,0,20400,80000,0,100400
141518201200000,NE 154,RESIDENTIAL,20400,0,20400,77200,0,97600
141518201300000,NE 154,RESIDENTIAL,20400,0,20400,103100,0,123500
141518201400000,NE 154,RESIDENTIAL,20400,0,20400,71300,0,91700
141518201500000,NE 154,RESIDENTIAL,20400,0,20400,102000,0,122400
141518201600000,NE 154,RESIDENTIAL,21400,0,21400,81800,0,103200
141518201700000,NE 154,RESIDENTIAL,22000,0,22000,74800,0,96800
141518201800000,NE 154,RESIDENTIAL,17700,0,17700,86700,0,104400
141518201900000,NE 154,RESIDENTIAL,23800,0,23800,77700,0,101500
141518202000000,NE 154,RESIDENTIAL,25500,0,25500,87200,0,112700
141518202100000,NE 154,RESIDENTIAL,25500,0,25500,104600,0,130100
141518202200000,NE 154,RESIDENTIAL,25500,0,25500,107000,0,132500
141518202300000,NE 154,RESIDENTIAL,25500,0,25500,93600,0,119100
141518202400000,NE 154,RESIDENTIAL,23000,0,23000,0,0,23000
141518202500000,NE 154,RESIDENTIAL,23000,0,23000,54100,0,77100
141518202600000,NE 154,RESIDENTIAL,25500,0,25500,88300,0,113800
141518202700000,NE 154,RESIDENTIAL,25500,0,25500,118000,0,143500
141518300100000,NE 154,RESIDENTIAL,18100,0,18100,71300,0,89400
141518300200000,NE 154,RESIDENTIAL,18200,0,18200,85200,0,103400
141518300300000,NE 154,RESIDENTIAL,20000,0,20000,69100,0,89100
141518300400000,NE 154,RESIDENTIAL,20800,0,20800,70100,0,90900
141518300500000,NE 154,RESIDENTIAL,20000,0,20000,82300,0,102300
141518300600000,NE 154,RESIDENTIAL,20000,0,20000,90200,0,110200
141518300700000,NE 154,RESIDENTIAL,20000,0,20000,66300,0,86300
141518300800000,NE 154,RESIDENTIAL,20000,0,20000,61700,0,81700
141518300900000,NE 154,RESIDENTIAL,20000,0,20000,79900,0,99900
141518301000000,NE 154,RESIDENTIAL,20000,0,20000,75400,0,95400
141518301100000,NE 154,RESIDENTIAL,20000,0,20000,78500,0,98500
141518301200000,NE 154,RESIDENTIAL,20000,0,20000,99100,0,119100
141518301300000,NE 154,RESIDENTIAL,20000,0,20000,116400,0,136400
141518301400000,NE 154,RESIDENTIAL,24900,0,24900,87800,0,112700
141518301500000,NE 154,RESIDENTIAL,16800,0,16800,93400,0,110200
141518301600000,NE 154,RESIDENTIAL,16800,0,16800,97300,0,114100
141518301700000,NE 154,RESIDENTIAL,15400,0,15400,81700,0,97100
141518301800000,NE 154,RESIDENTIAL,22400,0,22400,104700,0,127100
141518301900000,NE 154,RESIDENTIAL,20000,0,20000,98700,0,118700
141518302000000,NE 154,RESIDENTIAL,20000,0,20000,76300,0,96300
141518302100000,NE 154,RESIDENTIAL,20000,0,20000,72200,0,92200
141518302200000,NE 154,RESIDENTIAL,20000,0,20000,75700,0,95700
141518302300000,NE 154,RESIDENTIAL,20000,0,20000,97400,0,117400
141518302400000,NE 154,RESIDENTIAL,20000,0,20000,100400,0,120400
141518302500000,NE 154,RESIDENTIAL,20000,0,20000,71300,0,91300
141518302600000,NE 154,RESIDENTIAL,20000,0,20000,67700,0,87700
141518302700000,NE 154,RESIDENTIAL,20000,0,20000,74200,0,94200
141518302800000,NE 154,RESIDENTIAL,20000,0,20000,95900,0,115900
141518400100000,NE 154,RESIDENTIAL,25700,0,25700,106900,0,132600
141518400200000,NE 154,RESIDENTIAL,19300,0,19300,62800,0,82100
141518400300000,NE 154,RESIDENTIAL,26100,0,26100,102000,0,128100
141518400400000,NE 154,RESIDENTIAL,20000,0,20000,102100,0,122100
141518400500000,NE 154,RESIDENTIAL,20000,0,20000,73400,0,93400
141518400600000,NE 154,RESIDENTIAL,20000,0,20000,88700,0,108700
141518400700000,NE 154,RESIDENTIAL,20000,0,20000,86400,0,106400
141518400800000,NE 154,RESIDENTIAL,20000,0,20000,104600,0,124600
141518400900000,NE 154,RESIDENTIAL,20000,0,20000,105500,0,125500
141518401000000,NE 154,RESIDENTIAL,20000,0,20000,102300,0,122300
141518401100000,NE 154,RESIDENTIAL,20000,0,20000,113500,0,133500
141518401200000,NE 154,RESIDENTIAL,20600,0,20600,90600,0,111200
141518401300000,NE 154,RESIDENTIAL,21200,0,21200,97300,0,118500
141518401400000,NE 154,RESIDENTIAL,28000,0,28000,119500,0,147500
141518401500000,NE 154,RESIDENTIAL,20000,0,20000,76900,0,96900
141518401600000,NE 154,RESIDENTIAL,20000,0,20000,98000,0,118000
141518401700000,NE 154,RESIDENTIAL,20000,0,20000,84400,0,104400
141518401800000,NE 154,RESIDENTIAL,20000,0,20000,86400,0,106400
141518401900000,NE 154,RESIDENTIAL,20000,0,20000,104600,0,124600
141518402000000,NE 154,RESIDENTIAL,20000,0,20000,70900,0,90900
141518402100000,NE 154,RESIDENTIAL,20000,0,20000,76700,0,96700
141518402200000,NE 154,RESIDENTIAL,20000,0,20000,86000,0,106000
141518500100000,NE 154,RESIDENTIAL,37300,0,37300,99400,0,136700
141518500200000,NE 154,RESIDENTIAL,34500,0,34500,115600,0,150100
141518500300000,NE 154,RESIDENTIAL,33200,0,33200,112600,0,145800
141518500400000,NE 154,RESIDENTIAL,24600,0,24600,106600,0,131200
141518500500000,NE 154,RESIDENTIAL,26900,0,26900,106000,0,132900
141518500600000,NE 154,RESIDENTIAL,25600,0,25600,95800,0,121400
141518600100000,NE 154,RESIDENTIAL,21200,0,21200,90400,0,111600
141518600200000,NE 154,RESIDENTIAL,22600,0,22600,0,0,22600
141518600300000,NE 154,RESIDENTIAL,22400,0,22400,104200,0,126600
141518600400000,NE 154,RESIDENTIAL,22100,0,22100,89100,0,111200
141518600500000,NE 154,RESIDENTIAL,21900,0,21900,102300,0,124200
141518600600000,NE 154,RESIDENTIAL,22600,0,22600,77800,0,100400
141518600700000,NE 154,RESIDENTIAL,30000,0,30000,113400,0,143400
141518600800000,NE 154,RESIDENTIAL,19800,0,19800,92800,0,112600
141518600900000,NE 154,RESIDENTIAL,19600,0,19600,99100,0,118700
141518601000000,NE 154,RESIDENTIAL,19400,0,19400,88300,0,107700
141518601100000,NE 154,RESIDENTIAL,19200,0,19200,92300,0,111500
141518601200000,NE 154,RESIDENTIAL,18800,0,18800,77700,0,96500
141518601300000,NE 154,RESIDENTIAL,18600,0,18600,74900,0,93500
141518601400000,NE 154,RESIDENTIAL,19300,0,19300,75600,0,94900
141518601500000,NE 154,RESIDENTIAL,21200,0,21200,83300,0,104500
141518601600000,NE 154,RESIDENTIAL,18600,0,18600,77300,0,95900
141518601700000,NE 154,RESIDENTIAL,18800,0,18800,76000,0,94800
141518601800000,NE 154,RESIDENTIAL,19200,0,19200,77900,0,97100
141518601900000,NE 154,RESIDENTIAL,19400,0,19400,78800,0,98200
141518602000000,NE 154,RESIDENTIAL,29400,0,29400,116800,0,146200
141518602100000,NE 154,RESIDENTIAL,21700,0,21700,76800,0,98500
141518602200000,NE 154,RESIDENTIAL,23800,0,23800,76300,0,100100
141518602300000,NE 154,RESIDENTIAL,21200,0,21200,75900,0,97100
141518602400000,NE 154,RESIDENTIAL,21400,0,21400,90600,0,112000
141518602500000,NE 154,RESIDENTIAL,21800,0,21800,124500,0,146300
141518602600000,NE 154,RESIDENTIAL,21400,0,21400,127500,0,148900
141518602700000,NE 154,RESIDENTIAL,23000,0,23000,88400,0,111400
141518602800000,NE 154,RESIDENTIAL,19400,0,19400,98000,0,117400
141518602900000,NE 154,RESIDENTIAL,24500,0,24500,119000,0,143500
141518603000000,NE 154,RESIDENTIAL,19500,0,19500,87400,0,106900
141518700100000,NE 154,RESIDENTIAL,19500,0,19500,86500,0,106000
141518700200000,NE 154,RESIDENTIAL,17600,0,17600,73600,0,91200
141518700300000,NE 154,RESIDENTIAL,17800,0,17800,68800,0,86600
141518700400000,NE 154,RESIDENTIAL,16400,0,16400,75000,0,91400
141518700500000,NE 154,RESIDENTIAL,16400,0,16400,83300,0,99700
141518700600000,NE 154,RESIDENTIAL,20000,0,20000,96000,0,116000
141518700700000,NE 154,RESIDENTIAL,22000,0,22000,70000,0,92000
141518700800000,NE 154,RESIDENTIAL,22700,0,22700,123400,0,146100
141518700900000,NE 154,RESIDENTIAL,22900,0,22900,80500,0,103400
141518701000000,NE 154,RESIDENTIAL,22900,0,22900,80400,0,103300
141518701100000,NE 154,RESIDENTIAL,22900,0,22900,120900,0,143800
141518701200000,NE 154,RESIDENTIAL,22900,0,22900,82200,0,105100
141518800100000,NE 154,RESIDENTIAL,19100,0,19100,65300,0,84400
141518800200000,NE 154,RESIDENTIAL,18900,0,18900,107800,0,126700
141518800300000,NE 154,RESIDENTIAL,18700,0,18700,87900,0,106600
141518800400000,NE 154,RESIDENTIAL,18400,0,18400,63900,0,82300
141518800500000,NE 154,RESIDENTIAL,23500,0,23500,90900,0,114400
141520100200000,NE 142,RESIDENTIAL,26800,0,26800,103700,0,130500
141520100300000,NE 142,RESIDENTIAL,29300,0,29300,99600,0,128900
141520100400000,NE 142,RESIDENTIAL,30600,0,30600,99400,0,130000
141520100500000,NE 142,RESIDENTIAL,24100,0,24100,72700,0,96800
141520200100000,NE 142,RESIDENTIAL,28400,0,28400,97900,0,126300
141520200200000,NE 142,RESIDENTIAL,21800,0,21800,82400,0,104200
141520200300000,NE 142,RESIDENTIAL,23000,0,23000,100900,0,123900
141520200400000,NE 142,RESIDENTIAL,23200,0,23200,83800,0,107000
141520200500000,NE 142,RESIDENTIAL,23600,0,23600,83400,0,107000
141520200600000,NE 142,RESIDENTIAL,24100,0,24100,105400,0,129500
141520200700000,NE 142,RESIDENTIAL,24300,0,24300,88700,0,113000
141520200800000,NE 142,RESIDENTIAL,24800,0,24800,97400,0,122200
141520200900000,NE 142,RESIDENTIAL,25000,0,25000,67600,0,92600
141520201000000,NE 142,RESIDENTIAL,25200,0,25200,74400,0,99600
141520201100000,NE 142,RESIDENTIAL,27600,0,27600,84900,0,112500
141520201200000,NE 142,RESIDENTIAL,27800,0,27800,105600,0,133400
141520201300000,NE 144,RESIDENTIAL,31500,0,31500,121200,0,152700
141520201400000,NE 144,RESIDENTIAL,32000,0,32000,134800,0,166800
141520201500000,NE 144,RESIDENTIAL,33900,0,33900,120100,0,154000
141520201600000,NE 142,RESIDENTIAL,31000,0,31000,169500,0,200500
141520201700000,NE 142,RESIDENTIAL,28200,0,28200,82000,0,110200
141520201800000,NE 142,RESIDENTIAL,29800,0,29800,100400,0,130200
141520201900000,NE 142,RESIDENTIAL,30700,0,30700,136500,0,167200
141520202000000,NE 142,RESIDENTIAL,30900,0,30900,77300,0,108200
141520202100000,NE 142,RESIDENTIAL,30400,0,30400,113100,0,143500
141520202200000,NE 142,RESIDENTIAL,28400,0,28400,127000,0,155400
141520202300000,NE 142,RESIDENTIAL,29300,0,29300,117700,0,147000
141520202400000,NE 142,RESIDENTIAL,28800,0,28800,163200,0,192000
141520202500000,NE 142,RESIDENTIAL,28500,0,28500,127800,0,156300
141520202600000,NE 142,RESIDENTIAL,28500,0,28500,87700,0,116200
141520202700000,NE 142,RESIDENTIAL,28200,0,28200,98800,0,127000
141520202800000,NE 142,RESIDENTIAL,26100,0,26100,102300,0,128400
141520202900000,NE 142,RESIDENTIAL,26300,0,26300,98500,0,124800
141520203000000,NE 142,RESIDENTIAL,30100,0,30100,118600,0,148700
141520300100000,NE 142,RESIDENTIAL,34300,0,34300,100200,0,134500
141520300200000,NE 142,RESIDENTIAL,24400,0,24400,90700,0,115100
141520300300000,NE 142,RESIDENTIAL,24400,0,24400,91000,0,115400
141520300400000,NE 142,RESIDENTIAL,24400,0,24400,116000,0,140400
141520300500000,NE 142,RESIDENTIAL,28400,0,28400,92000,0,120400
141520300600000,NE 142,RESIDENTIAL,24900,0,24900,83700,0,108600
141520300700000,NE 142,RESIDENTIAL,25200,0,25200,90500,0,115700
141520300800000,NE 142,RESIDENTIAL,25200,0,25200,93400,0,118600
141520300900000,NE 142,RESIDENTIAL,25200,0,25200,121000,0,146200
141520301000000,NE 142,RESIDENTIAL,25200,0,25200,106500,0,131700
141520301100000,NE 142,RESIDENTIAL,24900,0,24900,116400,0,141300
141520301200000,NE 142,RESIDENTIAL,24900,0,24900,132400,0,157300
141520301300000,NE 142,RESIDENTIAL,28700,0,28700,140400,0,169100
141520301400000,NE 142,RESIDENTIAL,29200,0,29200,103600,0,132800
141520301500000,NE 142,RESIDENTIAL,26900,0,26900,95500,0,122400
141520301600000,NE 142,RESIDENTIAL,26500,0,26500,131700,0,158200
141520301700000,NE 142,RESIDENTIAL,27600,0,27600,140300,0,167900
141520301800000,NE 142,RESIDENTIAL,33500,0,33500,119200,0,152700
141520301900000,NE 142,RESIDENTIAL,23800,0,23800,104500,0,128300
141520302000000,NE 142,RESIDENTIAL,24300,0,24300,107200,0,131500
141520302100000,NE 142,RESIDENTIAL,25400,0,25400,106700,0,132100
141520302200000,NE 142,RESIDENTIAL,33600,0,33600,143200,0,176800
141520302300000,NE 142,RESIDENTIAL,36000,0,36000,114600,0,150600
141520302400000,NE 142,RESIDENTIAL,33400,0,33400,112300,0,145700
141520302500000,NE 142,RESIDENTIAL,27200,0,27200,89300,0,116500
141520302600000,NE 142,RESIDENTIAL,27100,0,27100,85000,0,112100
141520302700000,NE 142,RESIDENTIAL,27300,0,27300,79200,0,106500
141520302800000,NE 142,RESIDENTIAL,26800,0,26800,87700,0,114500
141520302900000,NE 142,RESIDENTIAL,25200,0,25200,111600,0,136800
141520303000000,NE 142,RESIDENTIAL,24700,0,24700,83000,0,107700
141520303100000,NE 142,RESIDENTIAL,24700,0,24700,88500,0,113200
141520303200000,NE 142,RESIDENTIAL,25000,0,25000,89500,0,114500
141520303300000,NE 142,RESIDENTIAL,24000,0,24000,73800,0,97800
141520400100000,NE 142,RESIDENTIAL,31700,0,31700,122000,0,153700
141520400200000,NE 142,RESIDENTIAL,26000,0,26000,124200,0,150200
141520400300000,NE 142,RESIDENTIAL,25200,0,25200,152000,0,177200
141520400400000,NE 142,RESIDENTIAL,24500,0,24500,96000,0,120500
141520400500000,NE 142,RESIDENTIAL,25400,0,25400,92900,0,118300
141520400600000,NE 142,RESIDENTIAL,25000,0,25000,115900,0,140900
141520400700000,NE 142,RESIDENTIAL,22100,0,22100,63900,0,86000
141520400800000,NE 142,RESIDENTIAL,31400,0,31400,110500,0,141900
141520400900000,NE 142,RESIDENTIAL,27600,0,27600,113300,0,140900
141520401000000,NE 142,RESIDENTIAL,27100,0,27100,142200,0,169300
141520401100000,NE 142,RESIDENTIAL,24200,0,24200,86000,0,110200
141520401200000,NE 142,RESIDENTIAL,25000,0,25000,93300,0,118300
141520401300000,NE 142,RESIDENTIAL,25800,0,25800,100100,0,125900
141520401400000,NE 142,RESIDENTIAL,26300,0,26300,101700,0,128000
141520401500000,NE 142,RESIDENTIAL,31200,0,31200,104400,0,135600
141522600100000,NE 144,RESIDENTIAL,31900,0,31900,132300,0,164200
141522600200000,NE 145,RESIDENTIAL,31800,0,31800,107300,0,139100
141522600300000,NE 145,RESIDENTIAL,21900,0,21900,99700,0,121600
141522600400000,NE 145,RESIDENTIAL,26200,0,26200,131700,0,157900
141522600500000,NE 145,RESIDENTIAL,28800,0,28800,118200,0,147000
141522600600000,NE 145,RESIDENTIAL,28800,0,28800,140000,0,168800
141522600700000,NE 145,RESIDENTIAL,28800,0,28800,134900,0,163700
141522600800000,NE 145,RESIDENTIAL,28100,0,28100,147100,0,175200
141522600900000,NE 145,RESIDENTIAL,27700,0,27700,124300,0,152000
141522601000000,NE 145,RESIDENTIAL,27500,0,27500,105500,0,133000
141522601100000,NE 145,RESIDENTIAL,24600,0,24600,117600,0,142200
141522601300000,NE 145,RESIDENTIAL,30200,0,30200,97800,0,128000
141522601400000,NE 145,RESIDENTIAL,30400,0,30400,93500,0,123900
141522601500000,NE 145,RESIDENTIAL,20100,0,20100,80800,0,100900
141522601600000,NE 145,RESIDENTIAL,25700,0,25700,102800,0,128500
141522601700000,NE 145,RESIDENTIAL,29100,0,29100,129900,0,159000
141522601800000,NE 145,RESIDENTIAL,22000,0,22000,129400,0,151400
141522601900000,NE 145,RESIDENTIAL,22000,0,22000,78700,0,100700
141522602100000,NE 145,RESIDENTIAL,29100,0,29100,151700,0,180800
141522602200000,NE 145,RESIDENTIAL,27800,0,27800,94300,0,122100
141522602300000,NE 145,RESIDENTIAL,29200,0,29200,129400,0,158600
141522602400000,NE 145,RESIDENTIAL,24500,0,24500,84200,0,108700
141522602500000,NE 145,RESIDENTIAL,27300,0,27300,137500,0,164800
141522602600000,NE 144,RESIDENTIAL,32200,0,32200,127000,0,159200
141522602700000,NE 144,RESIDENTIAL,30600,0,30600,133900,0,164500
141522602800000,NE 144,RESIDENTIAL,34700,0,34700,119100,0,153800
141522602900000,NE 144,RESIDENTIAL,33500,0,33500,124700,0,158200
141522603000000,NE 144,RESIDENTIAL,28400,0,28400,124800,0,153200
141522603100000,NE 144,RESIDENTIAL,26400,0,26400,133900,0,160300
141522603200000,NE 144,RESIDENTIAL,42100,0,42100,152500,0,194600
141522700100000,NE 144,RESIDENTIAL,35100,0,35100,139500,0,174600
141522700200000,NE 144,RESIDENTIAL,28600,0,28600,117100,0,145700
141522700300000,NE 144,RESIDENTIAL,31600,0,31600,122400,0,154000
141522700400000,NE 144,RESIDENTIAL,31300,0,31300,124200,0,155500
141522700500000,NE 144,RESIDENTIAL,35100,0,35100,130400,0,165500
141522700600000,NE 145,RESIDENTIAL,27900,0,27900,95600,0,123500
141522700700000,NE 145,RESIDENTIAL,26800,0,26800,95000,0,121800
141522700800000,NE 145,RESIDENTIAL,26800,0,26800,132900,0,159700
141522700900000,NE 145,RESIDENTIAL,26800,0,26800,116900,0,143700
141522701000000,NE 145,RESIDENTIAL,25700,0,25700,89700,0,115400
141522701100000,NE 145,RESIDENTIAL,28900,0,28900,107600,0,136500
141522701200000,NE 145,RESIDENTIAL,32100,0,32100,138000,0,170100
141522701300000,NE 145,RESIDENTIAL,31600,0,31600,157900,0,189500
141522701400000,NE 145,RESIDENTIAL,27200,0,27200,123200,0,150400
141522701500000,NE 145,RESIDENTIAL,28000,0,28000,160300,0,188300
141522701600000,NE 145,RESIDENTIAL,30300,0,30300,77400,0,107700
141522800100000,NE 145,RESIDENTIAL,36300,0,36300,131600,0,167900
141522800200000,NE 145,RESIDENTIAL,36000,0,36000,117400,0,153400
141522800300000,NE 145,RESIDENTIAL,35500,0,35500,124900,0,160400
141522800400000,NE 145,RESIDENTIAL,28800,0,28800,110600,0,139400
141522800500000,NE 145,RESIDENTIAL,28700,0,28700,156400,0,185100
141522800600000,NE 145,RESIDENTIAL,27600,0,27600,137000,0,164600
141522800700000,NE 145,RESIDENTIAL,33200,0,33200,90800,0,124000
141522800800000,NE 145,RESIDENTIAL,16700,0,16700,116900,0,133600
141522800900000,NE 145,RESIDENTIAL,17300,0,17300,85000,0,102300
141522801000000,NE 145,RESIDENTIAL,19400,0,19400,80100,0,99500
141522801100000,NE 145,RESIDENTIAL,20300,0,20300,80300,0,100600
141522801200000,NE 145,RESIDENTIAL,20400,0,20400,101500,0,121900
141522801300000,NE 145,RESIDENTIAL,20400,0,20400,94600,0,115000
141522801400000,NE 145,RESIDENTIAL,20400,0,20400,67000,0,87400
141522801500000,NE 145,RESIDENTIAL,23300,0,23300,78700,0,102000
141522801600000,NE 145,RESIDENTIAL,22400,0,22400,88400,0,110800
141522801700000,NE 145,RESIDENTIAL,20400,0,20400,104500,0,124900
141522801800000,NE 145,RESIDENTIAL,20400,0,20400,92500,0,112900
141522801900000,NE 145,RESIDENTIAL,20400,0,20400,96300,0,116700
141522802000000,NE 145,RESIDENTIAL,20400,0,20400,107900,0,128300
141522802100000,NE 145,RESIDENTIAL,20400,0,20400,78200,0,98600
141522802200000,NE 145,RESIDENTIAL,20400,0,20400,71000,0,91400
141522802300000,NE 145,RESIDENTIAL,19800,0,19800,96400,0,116200
141522802400000,NE 145,RESIDENTIAL,24800,0,24800,84200,0,109000
141522802700000,NE 145,RESIDENTIAL,22400,0,22400,124100,0,146500
141522802800000,NE 145,RESIDENTIAL,27100,0,27100,93800,0,120900
141522802900000,NE 145,RESIDENTIAL,17400,0,17400,92100,0,109500
141522803000000,NE 145,RESIDENTIAL,17300,0,17300,80300,0,97600
141522803100000,NE 145,RESIDENTIAL,25900,0,25900,94700,0,120600
141522803400000,NE 145,RESIDENTIAL,23700,0,23700,102000,0,125700
141522803500000,NE 145,RESIDENTIAL,23200,0,23200,82400,0,105600
141522900100000,NE 145,RESIDENTIAL,28800,0,28800,80400,0,109200
141522900200000,NE 145,RESIDENTIAL,16600,0,16600,87400,0,104000
141522900300000,NE 145,RESIDENTIAL,16600,0,16600,65600,0,82200
141522900400000,NE 145,RESIDENTIAL,16600,0,16600,91000,0,107600
141522900500000,NE 145,RESIDENTIAL,20800,0,20800,116100,0,136900
141522900600000,NE 145,RESIDENTIAL,20800,0,20800,90500,0,111300
141522900700000,NE 145,RESIDENTIAL,20800,0,20800,79000,0,99800
141522900800000,NE 145,RESIDENTIAL,20800,0,20800,81400,0,102200
141522900900000,NE 145,RESIDENTIAL,20800,0,20800,104400,0,125200
141522901000000,NE 145,RESIDENTIAL,20800,0,20800,112900,0,133700
141523000100000,NE 145,RESIDENTIAL,31100,0,31100,91600,0,122700
141523000200000,NE 145,RESIDENTIAL,15900,0,15900,77600,0,93500
141523000300000,NE 145,RESIDENTIAL,18000,0,18000,34800,0,52800
141523000400000,NE 145,RESIDENTIAL,20600,0,20600,43900,0,64500
141523000500000,NE 145,RESIDENTIAL,20700,0,20700,74000,0,94700
141523000600000,NE 145,RESIDENTIAL,21300,0,21300,119600,0,140900
141523000700000,NE 145,RESIDENTIAL,22100,0,22100,106600,0,128700
141523000800000,NE 145,RESIDENTIAL,22300,0,22300,79300,0,101600
141523000900000,NE 145,RESIDENTIAL,27100,0,27100,133400,0,160500
141523001000000,NE 145,RESIDENTIAL,19100,0,19100,62500,0,81600
141523001100000,NE 145,RESIDENTIAL,23000,0,23000,119100,0,142100
141523001200000,NE 145,RESIDENTIAL,20400,0,20400,73800,0,94200
141523001300000,NE 145,RESIDENTIAL,29100,0,29100,94300,0,123400
141523001400000,NE 145,RESIDENTIAL,22400,0,22400,69600,0,92000
141523100100000,NE 145,RESIDENTIAL,20800,0,20800,86500,0,107300
141523100200000,NE 145,RESIDENTIAL,20800,0,20800,67500,0,88300
141523100300000,NE 145,RESIDENTIAL,20800,0,20800,110100,0,130900
141523100400000,NE 145,RESIDENTIAL,20800,0,20800,70700,0,91500
141523100500000,NE 145,RESIDENTIAL,20800,0,20800,48600,0,69400
141523100600000,NE 145,RESIDENTIAL,20800,0,20800,73700,0,94500
141523100700000,NE 145,RESIDENTIAL,25000,0,25000,67900,0,92900
141523100800000,NE 145,RESIDENTIAL,20800,0,20800,52000,0,72800
141525100100000,NE 146,RESIDENTIAL,17700,0,17700,70000,0,87700
141525100200000,NE 146,RESIDENTIAL,19800,0,19800,83500,0,103300
141525100300000,NE 146,RESIDENTIAL,14100,0,14100,68000,0,82100
141525100400000,NE 146,RESIDENTIAL,20100,0,20100,76000,0,96100
141525200100000,NE 145,RESIDENTIAL,28200,0,28200,104500,0,132700
141525200200000,NE 145,RESIDENTIAL,21200,0,21200,66300,0,87500
141525200300000,NE 145,RESIDENTIAL,20100,0,20100,105000,0,125100
141525200400000,NE 145,RESIDENTIAL,18400,0,18400,79000,0,97400
141525200500000,NE 145,EXEMPT,0,23400,23400,0,62700,86100
141525200600000,NE 145,RESIDENTIAL,22000,0,22000,64100,0,86100
141525200700000,NE 145,RESIDENTIAL,21500,0,21500,95400,0,116900
141525200800000,NE 145,EXEMPT,0,22100,22100,0,72900,95000
141525200900000,NE 145,RESIDENTIAL,20300,0,20300,99200,0,119500
141525201000000,NE 145,RESIDENTIAL,27200,0,27200,88600,0,115800
141525201100000,NE 145,RESIDENTIAL,24600,0,24600,79800,0,104400
141525201200000,NE 145,RESIDENTIAL,21100,0,21100,71500,0,92600
141525201300000,NE 145,EXEMPT,0,22100,22100,0,68000,90100
141525201400000,NE 145,RESIDENTIAL,24700,0,24700,89900,0,114600
141525300100000,NE 145,RESIDENTIAL,21800,0,21800,67900,0,89700
141525300200000,NE 145,RESIDENTIAL,27100,0,27100,69100,0,96200
141525300300000,NE 145,RESIDENTIAL,27900,0,27900,105600,0,133500
141525300400000,NE 145,RESIDENTIAL,28200,0,28200,76900,0,105100
141525300500000,NE 145,RESIDENTIAL,28500,0,28500,75800,0,104300
141525300600000,NE 145,RESIDENTIAL,28500,0,28500,111800,0,140300
141525300700000,NE 145,RESIDENTIAL,29400,0,29400,102400,0,131800
141525300800000,NE 145,RESIDENTIAL,29200,0,29200,74100,0,103300
141525300900000,NE 145,RESIDENTIAL,25800,0,25800,74600,0,100400
141525301000000,NE 145,RESIDENTIAL,26200,0,26200,38500,0,64700
141525301100000,NE 145,RESIDENTIAL,25800,0,25800,59100,0,84900
141525301200000,NE 145,RESIDENTIAL,26200,0,26200,68800,0,95000
141525301300000,NE 145,RESIDENTIAL,29200,0,29200,82200,0,111400
141525301400000,NE 145,RESIDENTIAL,26900,0,26900,109100,0,136000
141525301500000,NE 145,RESIDENTIAL,24100,0,24100,71900,0,96000
141525301600000,NE 145,RESIDENTIAL,23700,0,23700,79300,0,103000
141525301700000,NE 145,RESIDENTIAL,19400,0,19400,86100,0,105500
141525301800000,NE 145,RESIDENTIAL,19400,0,19400,27500,0,46900
141525301900000,NE 145,RESIDENTIAL,32800,0,32800,59200,0,92000
141525302000000,NE 145,RESIDENTIAL,18600,0,18600,72400,0,91000
141525302100000,NE 145,RESIDENTIAL,31400,0,31400,107300,0,138700
141525302200000,NE 145,RESIDENTIAL,29500,0,29500,119000,0,148500
141525302300000,NE 145,RESIDENTIAL,24800,0,24800,83900,0,108700
141525302400000,NE 145,RESIDENTIAL,28200,0,28200,66600,0,94800
141525302500000,NE 145,RESIDENTIAL,26900,0,26900,94700,0,121600
141525302600000,NE 145,RESIDENTIAL,19900,0,19900,52800,0,72700
141525302700000,NE 145,RESIDENTIAL,20200,0,20200,37300,0,57500
141525302800000,NE 145,RESIDENTIAL,22200,0,22200,53000,0,75200
141525302900000,NE 145,RESIDENTIAL,18700,0,18700,55900,0,74600
141525303000000,NE 145,RESIDENTIAL,20900,0,20900,52700,0,73600
141525303100000,NE 145,RESIDENTIAL,25900,0,25900,137900,0,163800
141525303200000,NE 145,RESIDENTIAL,30800,0,30800,79400,0,110200
141525303300000,NE 145,RESIDENTIAL,24200,0,24200,67800,0,92000
141525303400000,NE 145,RESIDENTIAL,22000,0,22000,95100,0,117100
141525303500000,NE 145,RESIDENTIAL,23300,0,23300,144500,0,167800
141525303600000,NE 145,RESIDENTIAL,23700,0,23700,63700,0,87400
141525303700000,NE 145,RESIDENTIAL,22200,0,22200,59700,0,81900
141525400100000,NE 145,RESIDENTIAL,26400,0,26400,58600,0,85000
141525400200000,NE 145,RESIDENTIAL,24500,0,24500,41300,0,65800
141525400300000,NE 145,RESIDENTIAL,25000,0,25000,52800,0,77800
141525400400000,NE 145,RESIDENTIAL,25100,0,25100,59200,0,84300
141525400500000,NE 145,RESIDENTIAL,27100,0,27100,25500,0,52600
141525400600000,NE 145,RESIDENTIAL,21400,0,21400,69100,0,90500
141525400700000,NE 145,RESIDENTIAL,22800,0,22800,82300,0,105100
141525400800000,NE 145,RESIDENTIAL,29200,0,29200,73000,0,102200
141525400900000,SCHOOL,EXEMPT,0,0,0,0,0,0
141525401000000,NE 145,RESIDENTIAL,27000,0,27000,90500,0,117500
141525401100000,NE 145,RESIDENTIAL,20300,0,20300,101100,0,121400
141525401200000,NE 145,RESIDENTIAL,22600,0,22600,82000,0,104600
141525401300000,NE 145,RESIDENTIAL,21200,0,21200,92700,0,113900
141525401400000,NE 145,RESIDENTIAL,23400,0,23400,97000,0,120400
141525401500000,NE 145,RESIDENTIAL,28400,0,28400,106700,0,135100
141525500100000,NE 146,RESIDENTIAL,17500,0,17500,91000,0,108500
141525500200000,NE 146,RESIDENTIAL,11600,0,11600,62600,0,74200
141525500300000,NE 146,RESIDENTIAL,11900,0,11900,47500,0,59400
141525500400000,NE 146,RESIDENTIAL,11600,0,11600,42100,0,53700
141525500500000,NE 146,RESIDENTIAL,17500,0,17500,52500,0,70000
141525500600000,NE 146,RESIDENTIAL,17500,0,17500,41500,0,59000
141525500700000,NE 146,RESIDENTIAL,12300,0,12300,45800,0,58100
141525500800000,NE 146,RESIDENTIAL,19600,0,19600,72600,0,92200
141525500900000,NE 146,RESIDENTIAL,18500,0,18500,46400,0,64900
141525501000000,NE 146,RESIDENTIAL,16700,0,16700,73800,0,90500
141525501100000,NE 146,RESIDENTIAL,16200,0,16200,90700,0,106900
141525501200000,NE 146,RESIDENTIAL,19800,0,19800,56700,0,76500
141525501300000,NE 146,RESIDENTIAL,19600,0,19600,71100,0,90700
141525501400000,NE 146,RESIDENTIAL,17500,0,17500,89400,0,106900
141525501500000,NE 146,RESIDENTIAL,17500,0,17500,57800,0,75300
141525501600000,NE 146,RESIDENTIAL,17500,0,17500,95200,0,112700
141525501700000,NE 146,RESIDENTIAL,17500,0,17500,68700,0,86200
141525501800000,NE 146,RESIDENTIAL,17500,0,17500,70600,0,88100
141525600100000,NE 146,RESIDENTIAL,13400,0,13400,59300,0,72700
141525600200000,NE 146,RESIDENTIAL,14100,0,14100,63700,0,77800
141525600300000,NE 146,RESIDENTIAL,21300,0,21300,56700,0,78000
141525600400000,NE 146,RESIDENTIAL,21300,0,21300,73300,0,94600
141525600500000,NE 146,RESIDENTIAL,21300,0,21300,84900,0,106200
141525600600000,NE 146,RESIDENTIAL,21300,0,21300,71600,0,92900
141525600700000,NE 146,RESIDENTIAL,21300,0,21300,65300,0,86600
141525600800000,NE 146,RESIDENTIAL,21300,0,21300,59400,0,80700
141525600900000,NE 146,RESIDENTIAL,21300,0,21300,63700,0,85000
141525601000000,NE 146,RESIDENTIAL,21300,0,21300,83700,0,105000
141525601100000,NE 146,RESIDENTIAL,17900,0,17900,48700,0,66600
141525601200000,NE 146,RESIDENTIAL,19800,0,19800,78900,0,98700
141525601300000,NE 146,RESIDENTIAL,16700,0,16700,64100,0,80800
141525601400000,NE 146,RESIDENTIAL,12900,0,12900,73800,0,86700
141525601500000,NE 146,RESIDENTIAL,17600,0,17600,68500,0,86100
141525601600000,NE 146,RESIDENTIAL,18500,0,18500,87400,0,105900
141525601700000,NE 146,RESIDENTIAL,21300,0,21300,68700,0,90000
141525601800000,NE 146,RESIDENTIAL,21300,0,21300,52800,0,74100
141525601900000,NE 146,RESIDENTIAL,21300,0,21300,47000,0,68300
141525602000000,NE 146,RESIDENTIAL,21300,0,21300,74400,0,95700
141525602100000,NE 146,RESIDENTIAL,21300,0,21300,69400,0,90700
141525602200000,NE 146,RESIDENTIAL,21300,0,21300,49300,0,70600
141525602300000,NE 146,RESIDENTIAL,21300,0,21300,61100,0,82400
141525602400000,NE 146,RESIDENTIAL,21300,0,21300,53700,0,75000
141525602500000,NE 146,RESIDENTIAL,21300,0,21300,65900,0,87200
141525602600000,NE 146,RESIDENTIAL,21300,0,21300,62600,0,83900
141525602700000,NE 146,RESIDENTIAL,21300,0,21300,56900,0,78200
141525602800000,NE 146,RESIDENTIAL,21000,0,21000,92900,0,113900
141525602900000,NE 146,RESIDENTIAL,16500,0,16500,72000,0,88500
141525603000000,NE 146,RESIDENTIAL,21500,0,21500,91800,0,113300
141525603100000,NE 146,RESIDENTIAL,18300,0,18300,66100,0,84400
141527600100000,SCHOOL,EXEMPT,0,575400,575400,0,1249500,1824900
141527600200000,EDUCATIONAL/COLLEGE,COMMERCIAL,0,2671800,2671800,0,17624400,20296200
141527601200000,NE 145,RESIDENTIAL,30700,0,30700,132400,0,163100
141527602000000,NE 145,RESIDENTIAL,29400,0,29400,165900,0,195300
141527700100000,NE 146,RESIDENTIAL,18200,0,18200,64300,0,82500
141527700200000,NE 146,RESIDENTIAL,17500,0,17500,48400,0,65900
141527700300000,NE 146,RESIDENTIAL,17500,0,17500,56400,0,73900
141527700400000,NE 146,RESIDENTIAL,17500,0,17500,59300,0,76800
141527700500000,NE 146,RESIDENTIAL,17500,0,17500,63100,0,80600
141527700600000,NE 146,RESIDENTIAL,17500,0,17500,50700,0,68200
141527700700000,NE 146,RESIDENTIAL,17500,0,17500,60000,0,77500
141527700800000,NE 146,RESIDENTIAL,17500,0,17500,58300,0,75800
141527700900000,NE 146,RESIDENTIAL,17500,0,17500,61500,0,79000
141527701000000,NE 146,RESIDENTIAL,17500,0,17500,71000,0,88500
141527701100000,NE 146,RESIDENTIAL,17500,0,17500,69700,0,87200
141527701200000,NE 146,RESIDENTIAL,17500,0,17500,55700,0,73200
141527701300000,NE 146,RESIDENTIAL,17500,0,17500,29600,0,47100
141527701400000,NE 146,RESIDENTIAL,17500,0,17500,54000,0,71500
141527701500000,NE 146,RESIDENTIAL,17500,0,17500,43800,0,61300
141527701600000,NE 146,RESIDENTIAL,17500,0,17500,34800,0,52300
141527701700000,NE 146,RESIDENTIAL,17500,0,17500,49800,0,67300
141527701800000,NE 146,RESIDENTIAL,17500,0,17500,46200,0,63700
141527701900000,NE 146,RESIDENTIAL,17500,0,17500,35400,0,52900
141527702000000,NE 146,RESIDENTIAL,17500,0,17500,50700,0,68200
141527702100000,NE 146,RESIDENTIAL,17500,0,17500,27200,0,44700
141527702200000,NE 146,RESIDENTIAL,17500,0,17500,29900,0,47400
141527702300000,NE 146,RESIDENTIAL,17500,0,17500,48700,0,66200
141527702400000,NE 146,RESIDENTIAL,17500,0,17500,35100,0,52600
141527702500000,NE 146,RESIDENTIAL,17500,0,17500,39800,0,57300
141527702600000,NE 146,RESIDENTIAL,19300,0,19300,43900,0,63200
141530100200000,WAREHOUSE,COMMERCIAL,0,67500,67500,0,102800,170300
141530100300000,WAREHOUSE,COMMERCIAL,0,63000,63000,0,128300,191300
141530100400000,WAREHOUSE,COMMERCIAL,0,42000,42000,0,43600,85600
141530100500000,VACANT LAND,COMMERCIAL,0,21500,21500,0,0,21500
141530100600000,WAREHOUSE,COMMERCIAL,0,21500,21500,0,41900,63400
141530100700000,WAREHOUSE,COMMERCIAL,0,21500,21500,0,20100,41600
141530100800000,WAREHOUSE,COMMERCIAL,0,21500,21500,0,30100,51600
141530100900000,WAREHOUSE,COMMERCIAL,0,21500,21500,0,52400,73900
141530101000000,WAREHOUSE,COMMERCIAL,0,21500,21500,0,26300,47800
141530101100000,CITY PROPERTY,EXEMPT,0,0,0,0,0,0
141530101400000,VACANT LAND,COMMERCIAL,0,12500,12500,0,0,12500
141530101900000,EDUCATIONAL/COLLEGE,EXEMPT,0,12500,12500,0,0,12500
141530102000000,EDUCATIONAL/COLLEGE,EXEMPT,0,3800,3800,0,0,3800
141530102100000,EDUCATIONAL/COLLEGE,EXEMPT,0,2500,2500,0,0,2500
141530200600000,EQUIPMENT MFG;INDUST,INDUSTRIAL,0,573800,573800,0,882700,1456500
141530200700000,EDUCATIONAL/COLLEGE,EXEMPT,0,857200,857200,0,0,857200
141530300100000,FLAT PARKING,INDUSTRIAL,0,37500,37500,0,17300,54800
141530300200000,WAREHOUSE,COMMERCIAL,0,72300,72300,0,92200,164500
141530400100000,NE 122,RESIDENTIAL,23000,0,23000,96500,0,119500
141530400200000,NE 122,RESIDENTIAL,23000,0,23000,79200,0,102200
141530400300000,NE 122,RESIDENTIAL,24200,0,24200,79600,0,103800
141530500100000,NE 155,RESIDENTIAL,22000,0,22000,62000,0,84000
141530500200000,NE 155,RESIDENTIAL,25700,0,25700,56600,0,82300
141530500300000,NE 155,RESIDENTIAL,26200,0,26200,55200,0,81400
141530500400000,NE 155,RESIDENTIAL,23000,0,23000,58700,0,81700
141530500600000,NE 155,RESIDENTIAL,20000,0,20000,58600,0,78600
141530500700000,LITERARY/LIBRARY/ART,EXEMPT,0,63000,63000,0,351600,414600
141530501000000,NE 155,RESIDENTIAL,20000,0,20000,50900,0,70900
141530501100000,NE 155,RESIDENTIAL,23800,0,23800,46900,0,70700
141530501200000,NE 155,RESIDENTIAL,13200,0,13200,41200,0,54400
141530501300000,NE 155,RESIDENTIAL,12800,0,12800,46600,0,59400
141530501400000,NE 155,RESIDENTIAL,20000,0,20000,71900,0,91900
141530501500000,NE 155,RESIDENTIAL,20000,0,20000,54800,0,74800
141530501600000,NE 155,RESIDENTIAL,20000,0,20000,77300,0,97300
141530501700000,NE 155,RESIDENTIAL,20000,0,20000,47200,0,67200
141530501800000,NE 155,RESIDENTIAL,20000,0,20000,50900,0,70900
141530501900000,NE 155,RESIDENTIAL,20000,0,20000,46400,0,66400
141532600100000,NE 146,RESIDENTIAL,17200,0,17200,85800,0,103000
141532600200000,NE 146,RESIDENTIAL,16400,0,16400,0,0,16400
141532600300000,NE 146,RESIDENTIAL,25500,0,25500,54700,0,80200
141532600400000,NE 146,RESIDENTIAL,25500,0,25500,50700,0,76200
141532600500000,NE 146,RESIDENTIAL,25500,0,25500,77800,0,103300
141532600600000,NE 146,RESIDENTIAL,25500,0,25500,47600,0,73100
141532600700000,NE 146,RESIDENTIAL,25500,0,25500,55000,0,80500
141532600800000,NE 146,RESIDENTIAL,12800,0,12800,50700,0,63500
141532600900000,NE 146,RESIDENTIAL,12800,0,12800,50900,0,63700
141532601000000,NE 146,RESIDENTIAL,12800,0,12800,53500,0,66300
141532601100000,NE 146,RESIDENTIAL,12800,0,12800,49600,0,62400
141532601200000,NE 146,RESIDENTIAL,17000,0,17000,49500,0,66500
141532601300000,NE 146,RESIDENTIAL,17000,0,17000,43700,0,60700
141532601400000,NE 146,RESIDENTIAL,17000,0,17000,60000,0,77000
141532601500000,NE 146,RESIDENTIAL,17000,0,17000,37200,0,54200
141532601600000,NE 146,RESIDENTIAL,17000,0,17000,43300,0,60300
141532601700000,NE 146,RESIDENTIAL,17000,0,17000,44400,0,61400
141532601800000,SHOP,COMMERCIAL,0,262600,262600,0,305600,568200
141532700100000,NE 146,RESIDENTIAL,25500,0,25500,56100,0,81600
141532700200000,NE 146,RESIDENTIAL,18000,0,18000,44300,0,62300
141532700300000,NE 146,RESIDENTIAL,17200,0,17200,67500,0,84700
141532700400000,NE 146,RESIDENTIAL,17200,0,17200,50100,0,67300
141532700500000,NE 146,RESIDENTIAL,17200,0,17200,78400,0,95600
141532700600000,NE 146,RESIDENTIAL,17200,0,17200,63100,0,80300
141532700700000,NE 146,RESIDENTIAL,17200,0,17200,63100,0,80300
141532700800000,NE 146,RESIDENTIAL,13600,0,13600,65400,0,79000
141532700900000,NE 146,RESIDENTIAL,14000,0,14000,57500,0,71500
141532701000000,NE 146,RESIDENTIAL,13800,0,13800,72700,0,86500
141532701100000,NE 146,RESIDENTIAL,15500,0,15500,72400,0,87900
141532701200000,NE 146,RESIDENTIAL,17200,0,17200,43800,0,61000
141532701300000,NE 146,RESIDENTIAL,17200,0,17200,69600,0,86800
141532701400000,NE 146,RESIDENTIAL,17200,0,17200,54400,0,71600
141532701500000,NE 146,RESIDENTIAL,17200,0,17200,54300,0,71500
141532701600000,NE 146,RESIDENTIAL,17200,0,17200,60700,0,77900
141532701700000,NE 146,RESIDENTIAL,16500,0,16500,69600,0,86100
141532701800000,NE 146,RESIDENTIAL,25500,0,25500,61100,0,86600
141532701900000,NE 146,RESIDENTIAL,17000,0,17000,52000,0,69000
141532702000000,NE 146,RESIDENTIAL,19100,0,19100,79500,0,98600
141532702100000,NE 146,RESIDENTIAL,14900,0,14900,36900,0,51800
141532702200000,NE 146,RESIDENTIAL,25500,0,25500,105000,0,130500
141532800100000,NE 146,RESIDENTIAL,14000,0,14000,39800,0,53800
141532800200000,NE 146,RESIDENTIAL,16200,0,16200,52500,0,68700
141532800300000,NE 146,RESIDENTIAL,18500,0,18500,72400,0,90900
141532800400000,NE 146,RESIDENTIAL,16200,0,16200,28600,0,44800
141532800500000,NE 146,RESIDENTIAL,16200,0,16200,57700,0,73900
141532800600000,NE 146,RESIDENTIAL,16200,0,16200,50300,0,66500
141532800700000,NE 146,RESIDENTIAL,16200,0,16200,55800,0,72000
141532800800000,NE 146,RESIDENTIAL,16200,0,16200,67900,0,84100
141532800900000,NE 146,RESIDENTIAL,19400,0,19400,44900,0,64300
141532801000000,NE 146,RESIDENTIAL,19400,0,19400,100800,0,120200
141532801100000,NE 146,RESIDENTIAL,16200,0,16200,70300,0,86500
141532801200000,NE 146,RESIDENTIAL,16200,0,16200,44400,0,60600
141532801300000,NE 146,RESIDENTIAL,10500,0,10500,90300,0,100800
141532801400000,NE 146,RESIDENTIAL,10500,0,10500,0,0,10500
141532801500000,NE 146,RESIDENTIAL,22400,0,22400,57000,0,79400
141532801600000,NE 146,RESIDENTIAL,15300,0,15300,73900,0,89200
141532801700000,NE 146,RESIDENTIAL,12900,0,12900,52100,0,65000
141532801800000,NE 146,RESIDENTIAL,12900,0,12900,55500,0,68400
141532801900000,NE 146,RESIDENTIAL,12900,0,12900,47800,0,60700
141532802000000,NE 146,RESIDENTIAL,12900,0,12900,48600,0,61500
141532802100000,NE 146,RESIDENTIAL,12900,0,12900,45300,0,58200
141532802200000,NE 146,RESIDENTIAL,12900,0,12900,58800,0,71700
141532802300000,NE 146,RESIDENTIAL,12900,0,12900,38100,0,51000
141532802400000,NE 146,RESIDENTIAL,12900,0,12900,41000,0,53900
141532802500000,NE 146,RESIDENTIAL,12900,0,12900,40800,0,53700
141532802600000,NE 146,RESIDENTIAL,12900,0,12900,60000,0,72900
141532802700000,NE 146,RESIDENTIAL,12900,0,12900,106300,0,119200
141532802800000,NE 146,RESIDENTIAL,12900,0,12900,38100,0,51000
141532802900000,NE 146,RESIDENTIAL,12900,0,12900,58700,0,71600
141532803000000,NE 146,RESIDENTIAL,12900,0,12900,60800,0,73700
141532900100000,NE 146,RESIDENTIAL,21300,0,21300,56800,0,78100
141532900200000,NE 146,RESIDENTIAL,17800,0,17800,53600,0,71400
141532900300000,NE 146,RESIDENTIAL,17000,0,17000,67200,0,84200
141532900400000,NE 146,RESIDENTIAL,17000,0,17000,51600,0,68600
141532900500000,NE 146,RESIDENTIAL,17000,0,17000,50200,0,67200
141532900600000,NE 146,RESIDENTIAL,17000,0,17000,43000,0,60000
141532900700000,NE 146,RESIDENTIAL,17000,0,17000,58100,0,75100
141532900800000,NE 146,RESIDENTIAL,18500,0,18500,53900,0,72400
141532900900000,NE 146,RESIDENTIAL,18100,0,18100,51000,0,69100
141532901000000,NE 146,RESIDENTIAL,17000,0,17000,38100,0,55100
141532901100000,NE 146,RESIDENTIAL,17000,0,17000,46900,0,63900
141532901200000,NE 146,RESIDENTIAL,17000,0,17000,51900,0,68900
141532901300000,NE 146,RESIDENTIAL,17000,0,17000,45100,0,62100
141532901400000,NE 146,RESIDENTIAL,21600,0,21600,44000,0,65600
141532901500000,NE 146,RESIDENTIAL,25500,0,25500,70900,0,96400
141532901600000,NE 146,RESIDENTIAL,25500,0,25500,62200,0,87700
141532901700000,NE 146,RESIDENTIAL,17000,0,17000,24400,0,41400
141532901800000,NE 146,RESIDENTIAL,17000,0,17000,53500,0,70500
141532901900000,NE 146,RESIDENTIAL,21300,0,21300,58700,0,80000
141533000100000,CENTRALLY ASSESSED,OTHER,0,0,0,0,0,0
141533000900000,SHOP,COMMERCIAL,0,25200,25200,0,80100,105300
141533001000000,FLAT PARKING,COMMERCIAL,0,23400,23400,0,9600,33000
141533100100000,EQUIPMENT MFG;INDUST,INDUSTRIAL,0,19100,19100,0,234600,253700
141533100200000,NE 146,RESIDENTIAL,21300,0,21300,45700,0,67000
141533100300000,NE 146,RESIDENTIAL,17300,0,17300,32500,0,49800
141533100400000,NE 146,RESIDENTIAL,17300,0,17300,43400,0,60700
141533100500000,NE 146,RESIDENTIAL,17300,0,17300,68400,0,85700
141533100600000,NE 146,RESIDENTIAL,17300,0,17300,54400,0,71700
141533100700000,NE 146,RESIDENTIAL,17900,0,17900,49200,0,67100
141533100800000,EQUIPMENT MFG;INDUST,INDUSTRIAL,0,51400,51400,0,605300,656700
141533200200000,NE 146,RESIDENTIAL,17700,0,17700,65300,0,83000
141533200300000,NE 146,RESIDENTIAL,16200,0,16200,62000,0,78200
141533200400000,NE 146,RESIDENTIAL,16200,0,16200,69600,0,85800
141533200500000,NE 146,RESIDENTIAL,16200,0,16200,64300,0,80500
141533200600000,NE 146,RESIDENTIAL,16200,0,16200,75300,0,91500
141533200700000,NE 146,RESIDENTIAL,16200,0,16200,66000,0,82200
141533200800000,NE 146,RESIDENTIAL,16200,0,16200,78200,0,94400
141533200900000,NE 146,RESIDENTIAL,16200,0,16200,63800,0,80000
141533201000000,NE 146,RESIDENTIAL,16200,0,16200,30900,0,47100
141533201100000,NE 146,RESIDENTIAL,16200,0,16200,75200,0,91400
141533201200000,NE 146,RESIDENTIAL,16200,0,16200,63800,0,80000
141533201300000,NE 146,RESIDENTIAL,16200,0,16200,39100,0,55300
141533201400000,NE 146,RESIDENTIAL,16200,0,16200,59700,0,75900
141533201500000,NE 146,RESIDENTIAL,16200,0,16200,49100,0,65300
141533300100000,NE 146,RESIDENTIAL,11700,0,11700,56000,0,67700
141533301600000,NE 146,RESIDENTIAL,10900,0,10900,55000,0,65900
141533301700000,NE 146,RESIDENTIAL,10900,0,10900,39100,0,50000
141533301800000,NE 146,RESIDENTIAL,11600,0,11600,51500,0,63100
141533301900000,NE 146,RESIDENTIAL,13400,0,13400,52900,0,66300
141533302000000,NE 146,RESIDENTIAL,10900,0,10900,45600,0,56500
141533302100000,NE 146,RESIDENTIAL,10900,0,10900,30400,0,41300
141533302200000,NE 146,RESIDENTIAL,14200,0,14200,41900,0,56100
141535100200000,VACANT LAND,COMMERCIAL,0,1700,1700,0,0,1700
141535100300000,RESTAURANT,COMMERCIAL,0,33600,33600,0,97700,131300
141535100400000,FLAT PARKING,COMMERCIAL,0,16800,16800,0,3400,20200
141535100500000,WAREHOUSE,COMMERCIAL,0,127500,127500,0,94500,222000
141535200200000,CENTRALLY ASSESSED,OTHER,0,0,0,0,0,0
141535200400000,SMALL RETAIL,COMMERCIAL,0,129900,129900,0,1072500,1202400
141535200500000,CENTRALLY ASSESSED,OTHER,0,0,0,0,0,0
141535200700000,WAREHOUSE,COMMERCIAL,0,126000,126000,0,182700,308700
141535200800000,FLAT PARKING,COMMERCIAL,0,65000,65000,0,23200,88200
141535300100000,FLAT PARKING,INDUSTRIAL,0,15200,15200,0,7100,22300
141535300200000,NE 146,RESIDENTIAL,16200,0,16200,59100,0,75300
141535300300000,NE 146,RESIDENTIAL,16200,0,16200,54200,0,70400
141535300400000,NE 146,RESIDENTIAL,16200,0,16200,41900,0,58100
141535300500000,BARS/LOUNGE,COMMERCIAL,0,20400,20400,0,34900,55300
141535400100000,NE 156,RESIDENTIAL,11200,0,11200,40400,0,51600
141535400200000,NE 156,RESIDENTIAL,8900,0,8900,38000,0,46900
141535400300000,NE 156,RESIDENTIAL,8900,0,8900,30200,0,39100
141535400400000,WAREHOUSE,COMMERCIAL,0,50300,50300,0,50100,100400
141535400500000,VACANT LAND,COMMERCIAL,0,10400,10400,0,0,10400
141535400800000,WAREHOUSE,COMMERCIAL,0,94000,94000,0,239200,333200
141535401000000,WAREHOUSE,COMMERCIAL,0,29900,29900,0,1700,31600
141535401100000,WAREHOUSE,COMMERCIAL,0,6300,6300,0,16900,23200
141535401200000,FLAT PARKING,COMMERCIAL,0,11200,11200,0,2500,13700
141535401300000,BARS/LOUNGE,COMMERCIAL,0,9000,9000,0,68900,77900
141535401400000,SMALL RETAIL,COMMERCIAL,0,17000,17000,0,102400,119400
141535401500000,OFFICE,EXEMPT,0,117300,117300,0,504900,622200
141535401600000,NE 156,RESIDENTIAL,21600,0,21600,46400,0,68000
141535401700000,NE 156,RESIDENTIAL,13400,0,13400,37800,0,51200
141535500100000,FOOD GRADE;INDUST,INDUSTRIAL,0,825100,825100,0,3174000,3999100
141535600100000,NE 156,RESIDENTIAL,10400,0,10400,25300,0,35700
141535600200000,NE 156,RESIDENTIAL,11000,0,11000,46300,0,57300
141535600300000,NE 156,RESIDENTIAL,8800,0,8800,34000,0,42800
141535600400000,NE 156,RESIDENTIAL,8800,0,8800,36300,0,45100
141535600500000,NE 156,RESIDENTIAL,20600,0,20600,65700,0,86300
141535600600000,NE 156,RESIDENTIAL,19800,0,19800,49200,0,69000
141535600700000,NE 156,RESIDENTIAL,19800,0,19800,40700,0,60500
141535600800000,NE 156,RESIDENTIAL,16000,0,16000,47600,0,63600
141535600900000,NE 156,RESIDENTIAL,20800,0,20800,27800,0,48600
141535601000000,NE 156,RESIDENTIAL,20100,0,20100,51900,0,72000
141535601100000,NE 156,RESIDENTIAL,20100,0,20100,36900,0,57000
141535601200000,NE 156,RESIDENTIAL,20100,0,20100,51900,0,72000
141535601300000,NE 156,RESIDENTIAL,10700,0,10700,34300,0,45000
141535601400000,CONVERSION-CENT CORE,MULTI-RES,15900,0,15900,33000,0,48900
141535601500000,NE 156,RESIDENTIAL,16700,0,16700,44100,0,60800
141535601600000,NE 156,RESIDENTIAL,17600,0,17600,59600,0,77200
141535601700000,NE 156,RESIDENTIAL,17600,0,17600,55400,0,73000
141535601800000,NE 156,RESIDENTIAL,17300,0,17300,40100,0,57400
141535601900000,NE 156,RESIDENTIAL,17300,0,17300,43600,0,60900
141535602000000,NE 156,RESIDENTIAL,17300,0,17300,57500,0,74800
141535602100000,NE 156,RESIDENTIAL,17300,0,17300,13200,0,30500
141535602200000,NE 156,RESIDENTIAL,600,0,600,0,0,600
141535700100000,FLAT PARKING,INDUSTRIAL,0,1000,1000,0,0,1000
141535700200000,NE 156,EXEMPT,0,21600,21600,0,53600,75200
141535700300000,NE 156,RESIDENTIAL,21200,0,21200,53800,0,75000
141535700400000,APARTMENT,EXEMPT,0,26400,26400,0,143900,170300
141535700500000,NE 156,RESIDENTIAL,22200,0,22200,14400,0,36600
141535800100000,NE 156,RESIDENTIAL,17300,0,17300,42700,0,60000
141535800200000,NE 156,RESIDENTIAL,17600,0,17600,51100,0,68700
141535800300000,CONVERSION-CENT CORE,MULTI-RES,17600,0,17600,54600,0,72200
141535800400000,NE 156,RESIDENTIAL,17600,0,17600,50000,0,67600
141535800500000,NE 156,RESIDENTIAL,12900,0,12900,32600,0,45500
141535800600000,NE 156,RESIDENTIAL,7500,0,7500,27800,0,35300
141535800700000,NE 156,RESIDENTIAL,7400,0,7400,39400,0,46800
141535800800000,NE 156,RESIDENTIAL,4200,0,4200,1100,0,5300
141535800900000,NE 156,RESIDENTIAL,18900,0,18900,36100,0,55000
141535801000000,CONVERSION-CENT CORE,MULTI-RES,20100,0,20100,28500,0,48600
141535801100000,NE 156,RESIDENTIAL,20100,0,20100,38200,0,58300
141535900100000,FLAT PARKING,COMMERCIAL,0,21000,21000,0,0,21000
141535900102000,FAST FOOD,COMMERCIAL,0,0,0,0,57500,57500
141535900200000,NE 156,RESIDENTIAL,9900,0,9900,35600,0,45500
141535900300000,NE 156,RESIDENTIAL,12400,0,12400,41700,0,54100
141535900400000,NE 156,RESIDENTIAL,11200,0,11200,30200,0,41400
141535900500000,NE 156,RESIDENTIAL,11200,0,11200,36800,0,48000
141535900600000,APARTMENT,RESIDENTIAL,16800,0,16800,128000,0,144800
141535900700000,NE 156,RESIDENTIAL,12000,0,12000,34800,0,46800
141535900800000,NE 156,RESIDENTIAL,12000,0,12000,32000,0,44000
141535900900000,NE 156,RESIDENTIAL,20400,0,20400,35000,0,55400
141535901000000,NE 156,RESIDENTIAL,20400,0,20400,40600,0,61000
141535901100000,NE 156,RESIDENTIAL,20400,0,20400,23200,0,43600
141535901200000,NE 156,RESIDENTIAL,12000,0,12000,42600,0,54600
141535901300000,NE 156,RESIDENTIAL,12000,0,12000,41100,0,53100
141535901400000,NE 156,RESIDENTIAL,12000,0,12000,32700,0,44700
141535901500000,NE 156,RESIDENTIAL,12000,0,12000,40900,0,52900
141535901600000,CONVERSION-CENT CORE,MULTI-RES,18000,0,18000,27300,0,45300
141535901700000,NE 156,RESIDENTIAL,18500,0,18500,50700,0,69200
141535901800000,NE 156,RESIDENTIAL,9900,0,9900,38100,0,48000
141535901900000,NE 156,RESIDENTIAL,12000,0,12000,41500,0,53500
141535902000000,NE 156,RESIDENTIAL,12000,0,12000,30500,0,42500
141535902100000,NE 156,RESIDENTIAL,12000,0,12000,44000,0,56000
141535902200000,NE 156,RESIDENTIAL,12000,0,12000,44300,0,56300
141535902300000,NE 156,RESIDENTIAL,12000,0,12000,47400,0,59400
141535902400000,NE 156,RESIDENTIAL,20400,0,20400,46400,0,66800
141535902500000,NE 156,RESIDENTIAL,16000,0,16000,39700,0,55700
141535902600000,NE 156,RESIDENTIAL,16000,0,16000,38100,0,54100
141535902700000,NE 156,RESIDENTIAL,12800,0,12800,44200,0,57000
141535902800000,NE 156,RESIDENTIAL,21800,0,21800,71400,0,93200
141536000100000,NE 156,RESIDENTIAL,9900,0,9900,39000,0,48900
141536000200000,NE 156,RESIDENTIAL,9900,0,9900,60500,0,70400
141536000300000,NE 156,RESIDENTIAL,6500,0,6500,41300,0,47800
141536000400000,NE 156,RESIDENTIAL,14000,0,14000,55300,0,69300
141536000500000,NE 156,RESIDENTIAL,11500,0,11500,39600,0,51100
141536000600000,NE 156,RESIDENTIAL,20000,0,20000,39400,0,59400
141536000700000,NE 156,RESIDENTIAL,16000,0,16000,57900,0,73900
141536100100000,CITY PROPERTY,EXEMPT,0,0,0,0,0,0
141537600100000,NE 155,RESIDENTIAL,20000,0,20000,51800,0,71800
141537600200000,NE 155,RESIDENTIAL,20000,0,20000,62100,0,82100
141537600300000,NE 155,RESIDENTIAL,20000,0,20000,49500,0,69500
141537600400000,NE 155,RESIDENTIAL,24000,0,24000,65600,0,89600
141537600500000,NE 155,RESIDENTIAL,20000,0,20000,63000,0,83000
141537600600000,NE 155,RESIDENTIAL,20000,0,20000,53500,0,73500
141537600700000,NE 155,RESIDENTIAL,26400,0,26400,91400,0,117800
141537600800000,NE 155,RESIDENTIAL,16000,0,16000,56000,0,72000
141537600900000,NE 155,RESIDENTIAL,15400,0,15400,42200,0,57600
141537601000000,NE 155,RESIDENTIAL,15400,0,15400,31100,0,46500
141537601100000,NE 155,RESIDENTIAL,15400,0,15400,54100,0,69500
141537601200000,NE 155,RESIDENTIAL,15400,0,15400,48500,0,63900
141537601300000,APARTMENT,RESIDENTIAL,20300,0,20300,247000,0,267300
141537601400000,APARTMENT,RESIDENTIAL,14800,0,14800,71600,0,86400
141537601500000,NE 155,RESIDENTIAL,15000,0,15000,47800,0,62800
141537601600000,NE 155,RESIDENTIAL,15000,0,15000,47700,0,62700
141537601700000,NE 155,RESIDENTIAL,20000,0,20000,60800,0,80800
141537601800000,NE 155,RESIDENTIAL,16000,0,16000,61900,0,77900
141537601900000,NE 155,RESIDENTIAL,18000,0,18000,54200,0,72200
141537602000000,NE 155,RESIDENTIAL,22100,0,22100,68400,0,90500
141537602100000,NE 155,RESIDENTIAL,20000,0,20000,49700,0,69700
141537700100000,NE 155,RESIDENTIAL,20000,0,20000,66100,0,86100
141537700200000,NE 155,RESIDENTIAL,20000,0,20000,46300,0,66300
141537700300000,NE 155,RESIDENTIAL,20000,0,20000,50800,0,70800
141537700400000,NE 155,RESIDENTIAL,20000,0,20000,51700,0,71700
141537700500000,NE 155,RESIDENTIAL,20000,0,20000,43600,0,63600
141537700600000,NE 155,RESIDENTIAL,18000,0,18000,45800,0,63800
141537700700000,NE 155,RESIDENTIAL,16600,0,16600,38000,0,54600
141537700800000,NE 155,RESIDENTIAL,19000,0,19000,45300,0,64300
141537700900000,NE 155,RESIDENTIAL,20000,0,20000,59200,0,79200
141537701000000,NE 155,RESIDENTIAL,20000,0,20000,48100,0,68100
141537701100000,NE 155,RESIDENTIAL,20000,0,20000,49400,0,69400
141537800100000,NE 155,RESIDENTIAL,27600,0,27600,91700,0,119300
141537800200000,NE 155,RESIDENTIAL,17600,0,17600,19500,0,37100
141537800300000,NE 155,RESIDENTIAL,17600,0,17600,33700,0,51300
141537800400000,NE 155,RESIDENTIAL,15400,0,15400,42500,0,57900
141537800500000,NE 155,RESIDENTIAL,9100,0,9100,30800,0,39900
141537800600000,NE 155,RESIDENTIAL,9100,0,9100,32200,0,41300
141537800700000,NE 155,RESIDENTIAL,12500,0,12500,42800,0,55300
141537800800000,NE 155,RESIDENTIAL,12500,0,12500,32700,0,45200
141537800900000,NE 155,RESIDENTIAL,12800,0,12800,37300,0,50100
141537801000000,NE 155,RESIDENTIAL,12800,0,12800,65500,0,78300
141537801100000,NE 155,RESIDENTIAL,13200,0,13200,46800,0,60000
141537801200000,NE 155,RESIDENTIAL,10400,0,10400,17200,0,27600
141537801300000,NE 155,RESIDENTIAL,10400,0,10400,63300,0,73700
141537801400000,NE 155,RESIDENTIAL,22000,0,22000,59900,0,81900
141537801500000,APARTMENT,RESIDENTIAL,10000,0,10000,124900,0,134900
141537801600000,NE 155,RESIDENTIAL,22000,0,22000,62400,0,84400
141537801700000,CONVERSION-CENT CORE,MULTI-RES,36700,0,36700,44900,0,81600
141537802100000,NE 155,RESIDENTIAL,30600,0,30600,62800,0,93400
141537802200000,NE 155,RESIDENTIAL,31200,0,31200,96800,0,128000
141537802300000,NE 155,RESIDENTIAL,23600,0,23600,110000,0,133600
141537802400000,NE 155,RESIDENTIAL,23600,0,23600,107800,0,131400
141537900200000,WAREHOUSE,COMMERCIAL,0,36000,36000,0,114400,150400
141537900300000,VACANT LAND,COMMERCIAL,0,2200,2200,0,0,2200
141537900400000,SHOP,COMMERCIAL,0,69800,69800,0,190400,260200
141537900500000,VACANT LAND,COMMERCIAL,0,95000,95000,0,280400,375400
141538000100000,NE 155,RESIDENTIAL,20400,0,20400,63400,0,83800
141538000200000,NE 155,RESIDENTIAL,20400,0,20400,56600,0,77000
141538000300000,NE 155,RESIDENTIAL,20400,0,20400,51900,0,72300
141538000400000,NE 155,RESIDENTIAL,20400,0,20400,35000,0,55400
141538000500000,NE 155,RESIDENTIAL,17600,0,17600,27100,0,44700
141538000600000,NE 155,RESIDENTIAL,17600,0,17600,39400,0,57000
141538000700000,APARTMENT,RESIDENTIAL,16600,0,16600,124600,0,141200
141538000800000,CONVERSION-CENT CORE,MULTI-RES,22600,0,22600,98400,0,121000
141538000900000,NE 155,RESIDENTIAL,24500,0,24500,95800,0,120300
141538100100000,NE 155,RESIDENTIAL,32500,0,32500,99200,0,131700
141538100200000,NE 155,RESIDENTIAL,30000,0,30000,88900,0,118900
141538100300000,NE 155,RESIDENTIAL,25000,0,25000,50100,0,75100
141538100400000,NE 155,RESIDENTIAL,25000,0,25000,30900,0,55900
141538100500000,NE 155,RESIDENTIAL,25000,0,25000,60900,0,85900
141538100600000,NE 155,RESIDENTIAL,25000,0,25000,66300,0,91300
141538100700000,NE 155,RESIDENTIAL,25000,0,25000,35200,0,60200
141538100800000,CONVERSION-CENT CORE,MULTI-RES,25000,0,25000,40800,0,65800
141538100900000,CONVERSION-CENT CORE,MULTI-RES,25000,0,25000,45100,0,70100
141538101000000,NE 155,RESIDENTIAL,25000,0,25000,36400,0,61400
141538101100000,NE 155,RESIDENTIAL,23500,0,23500,46300,0,69800
141538101200000,NE 155,RESIDENTIAL,17500,0,17500,42800,0,60300
141538101300000,NE 155,RESIDENTIAL,10900,0,10900,40700,0,51600
141538101400000,NE 155,RESIDENTIAL,10900,0,10900,38300,0,49200
141538101500000,NE 155,RESIDENTIAL,13300,0,13300,45800,0,59100
141538101600000,NE 156,RESIDENTIAL,12500,0,12500,54900,0,67400
141538101700000,NE 155,RESIDENTIAL,13400,0,13400,51300,0,64700
141538101800000,NE 155,RESIDENTIAL,13400,0,13400,43200,0,56600
141538101900000,NE 155,RESIDENTIAL,18400,0,18400,51700,0,70100
141538102000000,NE 155,RESIDENTIAL,26000,0,26000,38200,0,64200
141538102100000,APARTMENT,RESIDENTIAL,18000,0,18000,209700,0,227700
141538102200000,NE 155,RESIDENTIAL,25000,0,25000,54500,0,79500
141538102300000,NE 155,RESIDENTIAL,25500,0,25500,18600,0,44100
141538102400000,NE 155,RESIDENTIAL,25000,0,25000,84500,0,109500
141538102500000,NE 155,RESIDENTIAL,25000,0,25000,56500,0,81500
141538102600000,NE 155,RESIDENTIAL,25000,0,25000,53400,0,78400
141538200100000,NE 156,RESIDENTIAL,10200,0,10200,44300,0,54500
141538200200000,NE 156,RESIDENTIAL,10200,0,10200,35400,0,45600
141538200300000,NE 156,RESIDENTIAL,5900,0,5900,31000,0,36900
141538200400000,NE 156,RESIDENTIAL,17300,0,17300,54500,0,71800
141538300100000,NE 155,RESIDENTIAL,17800,0,17800,68400,0,86200
141538300200000,NE 155,RESIDENTIAL,14700,0,14700,75300,0,90000
141538300300000,NE 155,RESIDENTIAL,10800,0,10800,23400,0,34200
141538300400000,NE 155,RESIDENTIAL,10800,0,10800,47100,0,57900
141538300500000,NE 155,RESIDENTIAL,15500,0,15500,51500,0,67000
141538300600000,NE 155,RESIDENTIAL,15000,0,15000,42100,0,57100
141538300700000,NE 155,RESIDENTIAL,17500,0,17500,28500,0,46000
141538300800000,NE 155,RESIDENTIAL,17500,0,17500,44000,0,61500
141538300900000,NE 155,RESIDENTIAL,25000,0,25000,74100,0,99100
141538301000000,CONVERSION-CENT CORE,MULTI-RES,25000,0,25000,50400,0,75400
141538301100000,NE 155,RESIDENTIAL,25000,0,25000,51600,0,76600
141538301200000,NE 155,RESIDENTIAL,16500,0,16500,52500,0,69000
141538301300000,NE 155,RESIDENTIAL,16500,0,16500,46600,0,63100
141538301400000,NE 155,RESIDENTIAL,17000,0,17000,34900,0,51900
141538301500000,APARTMENT,MULTI-RES,14000,0,14000,145400,0,159400
141538301600000,NE 155,RESIDENTIAL,25000,0,25000,29800,0,54800
141538301700000,NE 155,RESIDENTIAL,15500,0,15500,47800,0,63300
141538301800000,NE 155,RESIDENTIAL,15500,0,15500,36000,0,51500
141538301900000,NE 155,RESIDENTIAL,22000,0,22000,53700,0,75700
141538302000000,NE 155,RESIDENTIAL,13200,0,13200,54400,0,67600
141538302100000,CHURCH,EXEMPT,0,107000,107000,0,561200,668200
141538302200000,NE 155,RESIDENTIAL,20000,0,20000,18700,0,38700
141538302300000,NE 155,RESIDENTIAL,20000,0,20000,39300,0,59300
141538302400000,NE 155,RESIDENTIAL,25500,0,25500,90600,0,116100
141538302500000,NE 155,RESIDENTIAL,25000,0,25000,57200,0,82200
141538302600000,CONVERSION-CENT CORE,MULTI-RES,25000,0,25000,35600,0,60600
141538302700000,NE 155,RESIDENTIAL,25000,0,25000,44500,0,69500
141538400100000,NE 156,RESIDENTIAL,16400,0,16400,33200,0,49600
141538400200000,NE 156,RESIDENTIAL,9800,0,9800,51600,0,61400
141538400300000,NE 156,RESIDENTIAL,9800,0,9800,43600,0,53400
141538400400000,NE 156,RESIDENTIAL,8800,0,8800,15600,0,24400
141538400500000,NE 156,RESIDENTIAL,8800,0,8800,30700,0,39500
141538400600000,NE 156,RESIDENTIAL,17300,0,17300,47600,0,64900
141538400700000,NE 156,RESIDENTIAL,17300,0,17300,40200,0,57500
141538400800000,NE 156,RESIDENTIAL,12300,0,12300,38100,0,50400
141538400900000,NE 156,RESIDENTIAL,12300,0,12300,54700,0,67000
141538401000000,NE 156,RESIDENTIAL,11900,0,11900,0,0,11900
141538401100000,NE 156,RESIDENTIAL,20100,0,20100,21700,0,41800
141538401200000,NE 156,RESIDENTIAL,19900,0,19900,59100,0,79000
141538401300000,NE 156,RESIDENTIAL,20800,0,20800,0,0,20800
141538401400000,NE 156,RESIDENTIAL,19800,0,19800,42100,0,61900
141538401500000,NE 156,RESIDENTIAL,19800,0,19800,47500,0,67300
141538401600000,NE 156,RESIDENTIAL,19800,0,19800,66000,0,85800
141538500100000,APARTMENT,RESIDENTIAL,28000,0,28000,268200,0,296200
141538500200000,CONVERSION-CENT CORE,MULTI-RES,17000,0,17000,65800,0,82800
141538500300000,NE 155,RESIDENTIAL,18800,0,18800,34200,0,53000
141538500400000,NE 155,RESIDENTIAL,16500,0,16500,61200,0,77700
141538500500000,NE 155,RESIDENTIAL,17000,0,17000,52400,0,69400
141538500600000,NE 155,RESIDENTIAL,16500,0,16500,54800,0,71300
141538500700000,NE 155,RESIDENTIAL,25000,0,25000,50600,0,75600
141538500800000,NE 155,RESIDENTIAL,25000,0,25000,51100,0,76100
141538500900000,NE 155,RESIDENTIAL,25000,0,25000,63200,0,88200
141538501000000,NE 155,RESIDENTIAL,25000,0,25000,69000,0,94000
141538501100000,NE 155,RESIDENTIAL,25000,0,25000,59800,0,84800
141538501200000,NE 155,RESIDENTIAL,25000,0,25000,69900,0,94900
141538501300000,NE 155,RESIDENTIAL,25000,0,25000,45700,0,70700
141538501400000,NE 155,RESIDENTIAL,25000,0,25000,60500,0,85500
141538501500000,NE 155,RESIDENTIAL,12500,0,12500,59900,0,72400
141538501600000,NE 155,RESIDENTIAL,12500,0,12500,44100,0,56600
141538501700000,NE 155,RESIDENTIAL,12500,0,12500,0,0,12500
141538501800000,NE 155,RESIDENTIAL,10000,0,10000,37100,0,47100
141538501900000,NE 155,RESIDENTIAL,12800,0,12800,54000,0,66800
141538600100000,NE 156,RESIDENTIAL,16600,0,16600,57700,0,74300
141538600200000,NE 156,RESIDENTIAL,9600,0,9600,31000,0,40600
141538600300000,NE 156,RESIDENTIAL,11000,0,11000,50600,0,61600
141538600400000,NE 156,RESIDENTIAL,13800,0,13800,34200,0,48000
141538600500000,NE 156,RESIDENTIAL,19800,0,19800,49300,0,69100
141538600600000,NE 156,RESIDENTIAL,19800,0,19800,50100,0,69900
141538600700000,NE 156,RESIDENTIAL,19800,0,19800,48300,0,68100
141538600800000,NE 156,RESIDENTIAL,19800,0,19800,7300,0,27100
141538600900000,NE 156,RESIDENTIAL,19800,0,19800,21300,0,41100
141538601000000,NE 156,RESIDENTIAL,20800,0,20800,47200,0,68000
141540100100000,NE 154,RESIDENTIAL,29800,0,29800,86400,0,116200
141540100200000,NE 154,RESIDENTIAL,32700,0,32700,83800,0,116500
141540100300000,NE 154,RESIDENTIAL,29800,0,29800,105300,0,135100
141540100400000,NE 154,RESIDENTIAL,39100,0,39100,165400,0,204500
141540100500000,NE 154,RESIDENTIAL,36000,0,36000,148000,0,184000
141540100600000,NE 154,RESIDENTIAL,11600,0,11600,56100,0,67700
141540100700000,NE 154,RESIDENTIAL,37800,0,37800,78700,0,116500
141540100800000,NE 154,RESIDENTIAL,49100,0,49100,192900,0,242000
141540100900000,NE 154,RESIDENTIAL,32000,0,32000,99800,0,131800
141540200100000,NE 154,RESIDENTIAL,20200,0,20200,86500,0,106700
141540200200000,NE 154,RESIDENTIAL,25500,0,25500,102200,0,127700
141540200300000,NE 154,RESIDENTIAL,22500,0,22500,71700,0,94200
141540200400000,NE 154,RESIDENTIAL,25200,0,25200,114800,0,140000
141540300100000,NE 154,RESIDENTIAL,22700,0,22700,141300,0,164000
141540300200000,NE 154,RESIDENTIAL,23300,0,23300,113700,0,137000
141540300300000,NE 154,RESIDENTIAL,23200,0,23200,91200,0,114400
141540300400000,NE 154,RESIDENTIAL,25500,0,25500,93600,0,119100
141540300500000,NE 154,RESIDENTIAL,21800,0,21800,79800,0,101600
141540300600000,NE 154,RESIDENTIAL,21700,0,21700,84300,0,106000
141540300700000,NE 154,RESIDENTIAL,25200,0,25200,102700,0,127900
141540300800000,NE 154,RESIDENTIAL,22500,0,22500,41600,0,64100
141540300900000,NE 154,RESIDENTIAL,20600,0,20600,67700,0,88300
141540301000000,NE 154,RESIDENTIAL,28800,0,28800,146900,0,175700
141540301100000,NE 154,RESIDENTIAL,20200,0,20200,76900,0,97100
141540301200000,NE 154,RESIDENTIAL,20000,0,20000,78200,0,98200
141540301300000,NE 154,RESIDENTIAL,20000,0,20000,69500,0,89500
141540301400000,NE 154,RESIDENTIAL,19800,0,19800,98300,0,118100
141540301500000,NE 154,RESIDENTIAL,19500,0,19500,85000,0,104500
141540301600000,NE 154,RESIDENTIAL,19300,0,19300,85000,0,104300
141540301700000,NE 154,RESIDENTIAL,23300,0,23300,104600,0,127900
141540301800000,NE 154,RESIDENTIAL,18400,0,18400,69200,0,87600
141540301900000,NE 154,RESIDENTIAL,18600,0,18600,62900,0,81500
141540302000000,NE 154,RESIDENTIAL,18800,0,18800,79600,0,98400
141540302100000,NE 154,RESIDENTIAL,25900,0,25900,98500,0,124400
141540302200000,NE 154,RESIDENTIAL,26200,0,26200,131300,0,157500
141540302300000,NE 154,RESIDENTIAL,21900,0,21900,65700,0,87600
141540302400000,NE 154,RESIDENTIAL,20400,0,20400,82800,0,103200
141540302500000,NE 154,RESIDENTIAL,20500,0,20500,40000,0,60500
141540302600000,NE 154,RESIDENTIAL,21000,0,21000,61900,0,82900
141540302700000,NE 154,RESIDENTIAL,21100,0,21100,106700,0,127800
141540302800000,NE 154,RESIDENTIAL,21300,0,21300,122300,0,143600
141540302900000,NE 154,RESIDENTIAL,21900,0,21900,92700,0,114600
141540303000000,NE 154,RESIDENTIAL,21900,0,21900,67800,0,89700
141540303100000,NE 154,RESIDENTIAL,20600,0,20600,67500,0,88100
141540303200000,NE 154,RESIDENTIAL,21300,0,21300,91600,0,112900
141540303300000,NE 154,RESIDENTIAL,21300,0,21300,55500,0,76800
141540303400000,NE 154,RESIDENTIAL,20900,0,20900,55600,0,76500
141540303500000,NE 154,RESIDENTIAL,21400,0,21400,53200,0,74600
141540400100000,SCHOOL,EXEMPT,0,0,0,0,0,0
141540400200000,NE 154,RESIDENTIAL,24300,0,24300,62400,0,86700
141540400300000,NE 154,RESIDENTIAL,23500,0,23500,62300,0,85800
141540500100000,NE 154,RESIDENTIAL,31600,0,31600,55700,0,87300
141540500200000,NE 154,RESIDENTIAL,26200,0,26200,0,0,26200
141540500300000,NE 154,RESIDENTIAL,27300,0,27300,94300,0,121600
141540500400000,NE 154,RESIDENTIAL,30100,0,30100,114400,0,144500
141540500500000,CHURCH,EXEMPT,0,354300,354300,0,535800,890100
141540500600000,NE 154,RESIDENTIAL,24500,0,24500,96400,0,120900
141540500700000,NE 154,RESIDENTIAL,25800,0,25800,85400,0,111200
141540500800000,NE 154,RESIDENTIAL,30600,0,30600,83000,0,113600
141540600100000,NE 154,RESIDENTIAL,22800,0,22800,53400,0,76200
141540600200000,NE 154,RESIDENTIAL,17000,0,17000,64300,0,81300
141540600300000,NE 154,RESIDENTIAL,17000,0,17000,63600,0,80600
141540600400000,NE 154,RESIDENTIAL,14700,0,14700,61500,0,76200
141540600500000,NE 154,RESIDENTIAL,14500,0,14500,40000,0,54500
141540600600000,NE 154,RESIDENTIAL,16400,0,16400,66100,0,82500
141540600700000,NE 154,RESIDENTIAL,16000,0,16000,60500,0,76500
141540600800000,NE 154,RESIDENTIAL,26400,0,26400,90400,0,116800
141540600900000,NE 154,RESIDENTIAL,25800,0,25800,115300,0,141100
141540601000000,NE 154,RESIDENTIAL,26700,0,26700,116200,0,142900
141540601100000,NE 154,RESIDENTIAL,27600,0,27600,119800,0,147400
141540601200000,NE 154,RESIDENTIAL,28000,0,28000,120000,0,148000
141540601300000,NE 154,RESIDENTIAL,18500,0,18500,114000,0,132500
141540601400000,NE 154,RESIDENTIAL,25900,0,25900,81100,0,107000
141540601500000,NE 154,RESIDENTIAL,25900,0,25900,99500,0,125400
141540601600000,NE 154,RESIDENTIAL,33900,0,33900,135900,0,169800
141540601700000,NE 154,RESIDENTIAL,30800,0,30800,120300,0,151100
141540601800000,NE 154,RESIDENTIAL,22000,0,22000,87600,0,109600
141540601900000,NE 154,RESIDENTIAL,22000,0,22000,97300,0,119300
141540602000000,NE 154,RESIDENTIAL,20400,0,20400,71900,0,92300
141540602100000,NE 154,RESIDENTIAL,30000,0,30000,114700,0,144700
141540602200000,NE 154,RESIDENTIAL,19400,0,19400,74800,0,94200
141540602300000,NE 154,RESIDENTIAL,19400,0,19400,78600,0,98000
141540602400000,NE 154,RESIDENTIAL,19400,0,19400,74300,0,93700
141540602500000,NE 154,RESIDENTIAL,19400,0,19400,63000,0,82400
141540602700000,FLAT PARKING,COMMERCIAL,0,60600,60600,0,10300,70900
141540602800000,APARTMENT,RESIDENTIAL,57800,0,57800,759200,0,817000
141540602900000,NE 154,RESIDENTIAL,25500,0,25500,87500,0,113000
141540603000000,NE 154,RESIDENTIAL,20600,0,20600,82300,0,102900
141540603100000,NE 154,RESIDENTIAL,19800,0,19800,84300,0,104100
141540603200000,NE 154,RESIDENTIAL,17300,0,17300,56900,0,74200
141540603300000,APARTMENT,MULTI-RES,99800,0,99800,1538600,0,1638400
141540603400000,NE 154,RESIDENTIAL,22000,0,22000,13200,0,35200
141540700100000,NE 154,RESIDENTIAL,20500,0,20500,121500,0,142000
141540700200000,NE 154,RESIDENTIAL,15200,0,15200,66500,0,81700
141540700300000,NE 154,RESIDENTIAL,23800,0,23800,78300,0,102100
141540700400000,NE 154,RESIDENTIAL,25500,0,25500,52300,0,77800
141540700500000,NE 154,RESIDENTIAL,20400,0,20400,72700,0,93100
141540700600000,NE 154,RESIDENTIAL,17600,0,17600,56400,0,74000
141540700700000,NE 154,RESIDENTIAL,22400,0,22400,84100,0,106500
141540700800000,NE 154,RESIDENTIAL,17600,0,17600,71800,0,89400
141540700900000,NE 154,RESIDENTIAL,20400,0,20400,73000,0,93400
141540701000000,NE 154,RESIDENTIAL,20400,0,20400,100000,0,120400
141540701100000,NE 154,RESIDENTIAL,17600,0,17600,92300,0,109900
141540800100000,SE 218,RESIDENTIAL,51900,0,51900,147200,0,199100
141542600100000,NE 154,RESIDENTIAL,25300,0,25300,86600,0,111900
141542600200000,NE 154,RESIDENTIAL,25100,0,25100,115300,0,140400
141542600300000,NE 154,RESIDENTIAL,23300,0,23300,80600,0,103900
141542600400000,NE 154,RESIDENTIAL,26800,0,26800,83900,0,110700
141542600500000,NE 154,RESIDENTIAL,20000,0,20000,87800,0,107800
141542600600000,NE 154,RESIDENTIAL,25000,0,25000,89100,0,114100
141542600700000,NE 154,RESIDENTIAL,26800,0,26800,72800,0,99600
141542600800000,NE 154,RESIDENTIAL,21000,0,21000,71600,0,92600
141542600900000,NE 154,RESIDENTIAL,20400,0,20400,72300,0,92700
141542601000000,NE 154,RESIDENTIAL,20400,0,20400,70700,0,91100
141542601100000,NE 154,RESIDENTIAL,27200,0,27200,64300,0,91500
141542700300000,SCHOOL,EXEMPT,0,0,0,0,0,0
141542800100000,NE 154,RESIDENTIAL,26500,0,26500,92200,0,118700
141542800200000,NE 154,RESIDENTIAL,25200,0,25200,135000,0,160200
141542800300000,NE 154,RESIDENTIAL,20400,0,20400,68100,0,88500
141542800400000,NE 154,RESIDENTIAL,20400,0,20400,89900,0,110300
141542800500000,NE 154,RESIDENTIAL,20400,0,20400,85800,0,106200
141542800600000,NE 154,RESIDENTIAL,21000,0,21000,78600,0,99600
141542800700000,NE 154,RESIDENTIAL,19000,0,19000,72900,0,91900
141542800800000,NE 154,RESIDENTIAL,17100,0,17100,73400,0,90500
141542900100000,NE 122,RESIDENTIAL,25200,0,25200,98100,0,123300
141542900200000,NE 122,RESIDENTIAL,24600,0,24600,146800,0,171400
141542900300000,NE 122,RESIDENTIAL,23600,0,23600,87000,0,110600
141542900400000,NE 122,RESIDENTIAL,23600,0,23600,85400,0,109000
141542900500000,NE 122,RESIDENTIAL,23600,0,23600,102500,0,126100
141542900600000,NE 122,RESIDENTIAL,23600,0,23600,91400,0,115000
141542900700000,NE 122,RESIDENTIAL,23600,0,23600,109300,0,132900
141542900800000,NE 122,RESIDENTIAL,23600,0,23600,103500,0,127100
141542900900000,NE 122,RESIDENTIAL,23600,0,23600,105000,0,128600
141542901000000,NE 122,RESIDENTIAL,23600,0,23600,110600,0,134200
141542901100000,NE 122,RESIDENTIAL,23600,0,23600,89100,0,112700
141542901200000,NE 122,RESIDENTIAL,23600,0,23600,104000,0,127600
141542901300000,NE 122,RESIDENTIAL,23600,0,23600,98300,0,121900
141542901400000,NE 122,RESIDENTIAL,25300,0,25300,137400,0,162700
141542901500000,NE 122,RESIDENTIAL,24700,0,24700,95700,0,120400
141542901600000,NE 122,RESIDENTIAL,23600,0,23600,106600,0,130200
141542901700000,NE 122,RESIDENTIAL,23600,0,23600,109200,0,132800
141542901800000,NE 122,RESIDENTIAL,23600,0,23600,68800,0,92400
141542901900000,NE 122,RESIDENTIAL,23600,0,23600,111500,0,135100
141542902000000,NE 122,RESIDENTIAL,23600,0,23600,106000,0,129600
141542902100000,NE 122,RESIDENTIAL,23600,0,23600,104900,0,128500
141542902200000,NE 122,RESIDENTIAL,23600,0,23600,80900,0,104500
141542902300000,NE 122,RESIDENTIAL,23600,0,23600,128200,0,151800
141542902400000,NE 122,RESIDENTIAL,23600,0,23600,78300,0,101900
141542902500000,NE 122,RESIDENTIAL,23600,0,23600,65700,0,89300
141542902600000,NE 122,RESIDENTIAL,23600,0,23600,115600,0,139200
141543000100000,NE 122,RESIDENTIAL,25300,0,25300,118000,0,143300
141543000200000,NE 122,RESIDENTIAL,24700,0,24700,83700,0,108400
141543000300000,NE 122,RESIDENTIAL,23600,0,23600,86700,0,110300
141543000400000,NE 122,RESIDENTIAL,23600,0,23600,91900,0,115500
141543000500000,NE 122,RESIDENTIAL,23600,0,23600,107700,0,131300
141543000600000,NE 122,RESIDENTIAL,23600,0,23600,100200,0,123800
141543000700000,NE 122,RESIDENTIAL,23600,0,23600,112700,0,136300
141543000800000,NE 122,RESIDENTIAL,23600,0,23600,117100,0,140700
141543000900000,NE 122,RESIDENTIAL,23600,0,23600,108900,0,132500
141543001000000,NE 122,RESIDENTIAL,23600,0,23600,109300,0,132900
141543001100000,NE 122,RESIDENTIAL,23600,0,23600,108600,0,132200
141543001200000,NE 122,RESIDENTIAL,23600,0,23600,97800,0,121400
141543001300000,NE 122,RESIDENTIAL,23600,0,23600,104500,0,128100
141543001400000,NE 122,RESIDENTIAL,25300,0,25300,113400,0,138700
141543001500000,NE 122,RESIDENTIAL,24700,0,24700,82400,0,107100
141543001600000,NE 122,RESIDENTIAL,23600,0,23600,101800,0,125400
141543001700000,NE 122,RESIDENTIAL,23600,0,23600,98700,0,122300
141543001800000,NE 122,RESIDENTIAL,23600,0,23600,98100,0,121700
141543001900000,NE 122,RESIDENTIAL,23700,0,23700,90400,0,114100
141543002000000,NE 122,RESIDENTIAL,23600,0,23600,102100,0,125700
141543002100000,NE 122,RESIDENTIAL,23600,0,23600,86100,0,109700
141543002200000,NE 122,RESIDENTIAL,23600,0,23600,93400,0,117000
141543002300000,NE 122,RESIDENTIAL,23600,0,23600,106500,0,130100
141543002400000,NE 122,RESIDENTIAL,23600,0,23600,109100,0,132700
141543002500000,NE 122,RESIDENTIAL,23600,0,23600,92400,0,116000
141543002600000,NE 122,RESIDENTIAL,23600,0,23600,150000,0,173600
141543100100000,NE 122,RESIDENTIAL,29400,0,29400,96100,0,125500
141543100200000,NE 122,RESIDENTIAL,24800,0,24800,101400,0,126200
141543100300000,NE 122,RESIDENTIAL,23600,0,23600,87800,0,111400
141543100400000,NE 122,RESIDENTIAL,23600,0,23600,97700,0,121300
141543100500000,NE 122,RESIDENTIAL,23600,0,23600,112700,0,136300
141543100600000,NE 122,RESIDENTIAL,23600,0,23600,83400,0,107000
141543100700000,NE 122,RESIDENTIAL,23600,0,23600,101400,0,125000
141543100800000,NE 122,RESIDENTIAL,23600,0,23600,75200,0,98800
141543100900000,NE 122,RESIDENTIAL,23600,0,23600,97800,0,121400
141543101000000,NE 122,RESIDENTIAL,23600,0,23600,103300,0,126900
141543101100000,NE 122,RESIDENTIAL,23600,0,23600,91700,0,115300
141543101200000,NE 122,RESIDENTIAL,23600,0,23600,89200,0,112800
141543101300000,NE 122,RESIDENTIAL,23600,0,23600,83200,0,106800
141543101400000,NE 122,RESIDENTIAL,25300,0,25300,84600,0,109900
141543101500000,NE 122,RESIDENTIAL,24700,0,24700,94600,0,119300
141543101600000,NE 122,RESIDENTIAL,23600,0,23600,82100,0,105700
141543101700000,NE 122,RESIDENTIAL,23600,0,23600,103700,0,127300
141543101800000,NE 122,RESIDENTIAL,23600,0,23600,80500,0,104100
141543101900000,NE 122,RESIDENTIAL,23600,0,23600,114500,0,138100
141543102000000,NE 122,RESIDENTIAL,23600,0,23600,87900,0,111500
141543102100000,NE 122,RESIDENTIAL,23600,0,23600,66300,0,89900
141543102200000,NE 122,RESIDENTIAL,23600,0,23600,116600,0,140200
141543102300000,NE 122,RESIDENTIAL,23600,0,23600,95900,0,119500
141543102400000,NE 122,RESIDENTIAL,23600,0,23600,98100,0,121700
141543102500000,NE 122,RESIDENTIAL,23600,0,23600,116500,0,140100
141543200100000,NE 122,RESIDENTIAL,24300,0,24300,93800,0,118100
141543200200000,NE 122,RESIDENTIAL,23000,0,23000,94300,0,117300
141543200300000,NE 122,RESIDENTIAL,23000,0,23000,104600,0,127600
141543200400000,NE 122,RESIDENTIAL,23000,0,23000,96000,0,119000
141543200500000,NE 122,RESIDENTIAL,23000,0,23000,86500,0,109500
141543200600000,NE 122,RESIDENTIAL,23000,0,23000,86900,0,109900
141543200700000,NE 122,RESIDENTIAL,23000,0,23000,94400,0,117400
141543200800000,NE 122,RESIDENTIAL,23000,0,23000,115900,0,138900
141543200900000,NE 122,RESIDENTIAL,23000,0,23000,102000,0,125000
141543201000000,NE 122,RESIDENTIAL,23000,0,23000,114300,0,137300
141543201100000,NE 122,RESIDENTIAL,24700,0,24700,105400,0,130100
141543201200000,NE 122,RESIDENTIAL,24700,0,24700,99100,0,123800
141543201300000,NE 122,RESIDENTIAL,23600,0,23600,103500,0,127100
141543201400000,NE 122,RESIDENTIAL,23600,0,23600,86200,0,109800
141543201500000,NE 122,RESIDENTIAL,23600,0,23600,95600,0,119200
141543201600000,NE 122,RESIDENTIAL,23600,0,23600,110400,0,134000
141543201700000,NE 122,RESIDENTIAL,23600,0,23600,110300,0,133900
141543201800000,NE 122,RESIDENTIAL,23600,0,23600,108700,0,132300
141543201900000,NE 122,RESIDENTIAL,23600,0,23600,67600,0,91200
141543202000000,NE 122,RESIDENTIAL,23600,0,23600,78700,0,102300
141543202100000,NE 122,RESIDENTIAL,23600,0,23600,94700,0,118300
141543202200000,NE 122,RESIDENTIAL,23600,0,23600,108500,0,132100
141543202300000,NE 122,RESIDENTIAL,23600,0,23600,100900,0,124500
141543300100000,NE 154,RESIDENTIAL,25500,0,25500,101800,0,127300
141543300200000,NE 154,RESIDENTIAL,25500,0,25500,86500,0,112000
141543300300000,NE 154,RESIDENTIAL,25500,0,25500,83800,0,109300
141543300400000,NE 154,RESIDENTIAL,25500,0,25500,83900,0,109400
141543300500000,NE 154,RESIDENTIAL,25500,0,25500,74700,0,100200
141543300600000,NE 154,RESIDENTIAL,25500,0,25500,111500,0,137000
141543300700000,NE 154,RESIDENTIAL,25500,0,25500,94500,0,120000
141543300800000,NE 154,RESIDENTIAL,25500,0,25500,91500,0,117000
141543300900000,NE 154,RESIDENTIAL,25500,0,25500,105800,0,131300
141543301000000,NE 154,RESIDENTIAL,25500,0,25500,97300,0,122800
141543301100000,NE 154,RESIDENTIAL,25500,0,25500,102300,0,127800
141543301200000,NE 154,RESIDENTIAL,20400,0,20400,79100,0,99500
141543301300000,NE 154,RESIDENTIAL,20400,0,20400,66700,0,87100
141543301400000,NE 154,RESIDENTIAL,20400,0,20400,70400,0,90800
141543301500000,NE 154,RESIDENTIAL,20400,0,20400,82100,0,102500
141543301600000,NE 154,RESIDENTIAL,20400,0,20400,81200,0,101600
141543301700000,NE 154,RESIDENTIAL,25500,0,25500,80100,0,105600
141543301800000,NE 154,RESIDENTIAL,25500,0,25500,83900,0,109400
141543301900000,NE 154,RESIDENTIAL,28200,0,28200,126300,0,154500
141543302000000,NE 154,RESIDENTIAL,28600,0,28600,120600,0,149200
141543302100000,NE 154,RESIDENTIAL,28200,0,28200,114000,0,142200
141543302200000,NE 154,RESIDENTIAL,33200,0,33200,120400,0,153600
141543302300000,NE 154,RESIDENTIAL,25500,0,25500,102900,0,128400
141543302400000,NE 154,RESIDENTIAL,25500,0,25500,105500,0,131000
141543302500000,NE 154,RESIDENTIAL,23000,0,23000,118800,0,141800
141543302600000,NE 154,RESIDENTIAL,26600,0,26600,122600,0,149200
141543302700000,NE 154,RESIDENTIAL,25500,0,25500,93600,0,119100
141543302800000,NE 154,RESIDENTIAL,25500,0,25500,95600,0,121100
141543302900000,NE 154,RESIDENTIAL,25000,0,25000,90900,0,115900
141543303000000,NE 154,RESIDENTIAL,26000,0,26000,72200,0,98200
141543400100000,NE 155,RESIDENTIAL,23000,0,23000,40800,0,63800
141543400200000,NE 155,RESIDENTIAL,15400,0,15400,46500,0,61900
141543400300000,NE 155,RESIDENTIAL,22000,0,22000,52400,0,74400
141543500100000,NE 154,RESIDENTIAL,27000,0,27000,74500,0,101500
141543500200000,NE 154,RESIDENTIAL,27000,0,27000,154000,0,181000
141543500300000,NE 154,RESIDENTIAL,25500,0,25500,81700,0,107200
141543500400000,NE 154,RESIDENTIAL,25500,0,25500,102300,0,127800
141545100100000,NE 154,RESIDENTIAL,16300,0,16300,93500,0,109800
141545100200000,NE 154,RESIDENTIAL,16300,0,16300,65700,0,82000
141545100300000,NE 154,RESIDENTIAL,16300,0,16300,80300,0,96600
141545100400000,NE 154,RESIDENTIAL,25500,0,25500,119500,0,145000
141545100500000,NE 154,RESIDENTIAL,25500,0,25500,52700,0,78200
141545100600000,NE 154,RESIDENTIAL,25500,0,25500,116100,0,141600
141545100700000,NE 154,RESIDENTIAL,25500,0,25500,116600,0,142100
141545100800000,NE 154,RESIDENTIAL,27300,0,27300,77700,0,105000
141545100900000,NE 154,RESIDENTIAL,25500,0,25500,126000,0,151500
141545101000000,NE 154,RESIDENTIAL,25500,0,25500,114300,0,139800
141545101100000,NE 154,RESIDENTIAL,25500,0,25500,84100,0,109600
141545101200000,NE 154,RESIDENTIAL,25500,0,25500,137300,0,162800
141545101300000,NE 154,RESIDENTIAL,25500,0,25500,65200,0,90700
141545101400000,APARTMENT,MULTI-RES,54200,0,54200,779700,0,833900
141545101500000,APARTMENT,RESIDENTIAL,54200,0,54200,854100,0,908300
141545101600000,APARTMENT,MULTI-RES,14500,0,14500,102600,0,117100
141545101700000,CONVERSION-CENT CORE,MULTI-RES,21100,0,21100,44700,0,65800
141545101800000,NE 154,RESIDENTIAL,12800,0,12800,55000,0,67800
141545101900000,NE 154,RESIDENTIAL,13600,0,13600,44300,0,57900
141545102000000,NE 154,RESIDENTIAL,17700,0,17700,59300,0,77000
141545102100000,NE 154,RESIDENTIAL,16300,0,16300,96700,0,113000
141545102200000,NE 154,RESIDENTIAL,18400,0,18400,91100,0,109500
141545102300000,NE 154,RESIDENTIAL,20400,0,20400,94600,0,115000
141545102400000,NE 154,RESIDENTIAL,20400,0,20400,75300,0,95700
141545102500000,NE 154,RESIDENTIAL,16300,0,16300,76800,0,93100
141545102600000,NE 154,RESIDENTIAL,16300,0,16300,65300,0,81600
141545200100000,NE 154,RESIDENTIAL,25500,0,25500,101900,0,127400
141545200200000,NE 154,RESIDENTIAL,25500,0,25500,74100,0,99600
141545200300000,NE 154,RESIDENTIAL,25500,0,25500,82500,0,108000
141545200400000,NE 154,RESIDENTIAL,25500,0,25500,80200,0,105700
141545200500000,NE 154,RESIDENTIAL,25500,0,25500,88700,0,114200
141545200600000,NE 154,RESIDENTIAL,22000,0,22000,69700,0,91700
141545200700000,NE 154,RESIDENTIAL,18700,0,18700,92000,0,110700
141545200800000,NE 154,RESIDENTIAL,18700,0,18700,87500,0,106200
141545200900000,NE 154,RESIDENTIAL,21700,0,21700,87000,0,108700
141545201000000,NE 154,RESIDENTIAL,32500,0,32500,101900,0,134400
141545201100000,NE 154,RESIDENTIAL,25500,0,25500,23800,0,49300
141545201200000,NE 154,RESIDENTIAL,25500,0,25500,98800,0,124300
141545300100000,NE 155,RESIDENTIAL,28100,0,28100,112600,0,140700
141545300200000,NE 155,RESIDENTIAL,22500,0,22500,56200,0,78700
141545300300000,NE 155,RESIDENTIAL,20000,0,20000,59000,0,79000
141545300400000,NE 155,RESIDENTIAL,20000,0,20000,51900,0,71900
141545400100000,NE 155,RESIDENTIAL,79400,0,79400,117800,0,197200
141545400200000,NE 155,RESIDENTIAL,24100,0,24100,60300,0,84400
141545400300000,NE 155,RESIDENTIAL,22400,0,22400,89600,0,112000
141545400400000,NE 155,RESIDENTIAL,18500,0,18500,65400,0,83900
141545400500000,NE 155,RESIDENTIAL,19100,0,19100,63400,0,82500
141545400600000,NE 155,RESIDENTIAL,18800,0,18800,66900,0,85700
141545400700000,NE 155,EXEMPT,0,20400,20400,0,50600,71000
141545400800000,NE 155,RESIDENTIAL,22800,0,22800,47300,0,70100
141545400900000,NE 155,RESIDENTIAL,22800,0,22800,74600,0,97400
141545401000000,NE 155,RESIDENTIAL,21300,0,21300,80400,0,101700
141545401100000,NE 155,RESIDENTIAL,22800,0,22800,119200,0,142000
141545401200000,NE 155,RESIDENTIAL,26800,0,26800,83800,0,110600
141545500400000,FLAT PARKING,COMMERCIAL,0,16600,16600,0,8500,25100
141545500500000,CENTRALLY ASSESSED,OTHER,0,0,0,0,0,0
141545500600000,FLAT PARKING,COMMERCIAL,0,9300,9300,0,4900,14200
141545500700000,VACANT LAND,COMMERCIAL,0,18700,18700,0,0,18700
141545500800000,VACANT LAND,COMMERCIAL,0,18700,18700,0,0,18700
141545500900000,VACANT LAND,COMMERCIAL,0,18700,18700,0,0,18700
141545501000000,FLAT PARKING,COMMERCIAL,0,40700,40700,0,1400,42100
141545501100000,FLAT PARKING,COMMERCIAL,0,40700,40700,0,300,41000
141545501200000,OFFICE,EXEMPT,0,22500,22500,0,45800,68300
141545501300000,FLAT PARKING,COMMERCIAL,0,70500,70500,0,4100,74600
141545501400000,OFFICE,COMMERCIAL,0,391200,391200,0,879000,1270200
141545501500000,VACANT LAND,COMMERCIAL,0,141000,141000,0,0,141000
141545501600000,SR/NURSING/ASSTD LIV,MULTI-RES,121600,0,121600,1699200,0,1820800
141545600100000,NE 155,RESIDENTIAL,22000,0,22000,71100,0,93100
141545600200000,NE 155,RESIDENTIAL,22000,0,22000,59500,0,81500
141545600300000,NE 155,RESIDENTIAL,28300,0,28300,86300,0,114600
141545600400000,NE 155,RESIDENTIAL,20000,0,20000,75300,0,95300
141545600500000,NE 155,RESIDENTIAL,15700,0,15700,44000,0,59700
141545600700000,NE 155,RESIDENTIAL,13800,0,13800,44100,0,57900
141545600800000,NE 155,RESIDENTIAL,20400,0,20400,60400,0,80800
141545600900000,NE 155,RESIDENTIAL,21600,0,21600,31800,0,53400
141545601000000,NE 155,RESIDENTIAL,20400,0,20400,49700,0,70100
141545601100000,NE 155,RESIDENTIAL,21000,0,21000,88800,0,109800
141545601200000,APARTMENT,MULTI-RES,16500,0,16500,92500,0,109000
141545601300000,NE 155,RESIDENTIAL,20800,0,20800,75400,0,96200
141545601400000,APARTMENT,MULTI-RES,16000,0,16000,88200,0,104200
141545601500000,CONVERSION-CENT CORE,MULTI-RES,22400,0,22400,80200,0,102600
141545601600000,CONVERSION-CENT CORE,MULTI-RES,18400,0,18400,28000,0,46400
141545601700000,NE 155,RESIDENTIAL,18400,0,18400,40200,0,58600
141545601800000,NE 155,RESIDENTIAL,12400,0,12400,50500,0,62900
141545601900000,NE 155,RESIDENTIAL,14000,0,14000,32300,0,46300
141545602000000,NE 155,RESIDENTIAL,16700,0,16700,18900,0,35600
141545602100000,NE 155,RESIDENTIAL,26400,0,26400,33300,0,59700
141545602200000,NE 155,RESIDENTIAL,22400,0,22400,49800,0,72200
141545602300000,CONVERSION-CENT CORE,MULTI-RES,22400,0,22400,53800,0,76200
141545602400000,APARTMENT,MULTI-RES,36000,0,36000,203000,0,239000
141545602500000,APARTMENT,MULTI-RES,34000,0,34000,264200,0,298200
141545602700000,APARTMENT,MULTI-RES,16500,0,16500,121200,0,137700
141545603100000,APARTMENT,MULTI-RES,26200,0,26200,149700,0,175900
141545603200000,NE 155,RESIDENTIAL,25500,0,25500,46300,0,71800
141545603300000,NE 155,RESIDENTIAL,26000,0,26000,72900,0,98900
141545603400000,NE 155,RESIDENTIAL,25500,0,25500,68300,0,93800
141545603500000,OFFICE,COMMERCIAL,0,242300,242300,0,160700,403000
141545603600000,FLAT PARKING,COMMERCIAL,0,113700,113700,0,23100,136800
141545603700000,FUNERAL HOME,COMMERCIAL,34110,193290,227400,20819,150681,398900
141545603800000,APARTMENT,MULTI-RES,60600,0,60600,370000,0,430600
141545603900000,BRANCH BANK/CU,COMMERCIAL,0,564000,564000,0,2424400,2988400
141545604000000,NE 155,RESIDENTIAL,6600,0,6600,53400,0,60000
141545604100000,NE 155,RESIDENTIAL,7700,0,7700,39100,0,46800
141545604200000,NE 155,RESIDENTIAL,7700,0,7700,54300,0,62000
141545604300000,NE 155,RESIDENTIAL,8800,0,8800,56300,0,65100
141545700100000,SE 215,RESIDENTIAL,20700,0,20700,70300,0,91000
141545700200000,SE 215,RESIDENTIAL,17300,0,17300,94200,0,111500
141545700300000,CHURCH,EXEMPT,0,43600,43600,0,61600,105200
141545700400000,OFFICE; MEDICAL,COMMERCIAL,0,312000,312000,0,650600,962600
141545700500000,SE 218,RESIDENTIAL,66000,0,66000,117100,0,183100
141545700600000,SE 215,RESIDENTIAL,18900,0,18900,103200,0,122100
141545700700000,SE 215,RESIDENTIAL,18900,0,18900,94900,0,113800
141545800100000,SE 218,RESIDENTIAL,24900,0,24900,32400,0,57300
141545800200000,SE 218,RESIDENTIAL,10500,0,10500,29300,0,39800
141545800300000,OFFICE,COMMERCIAL,0,133000,133000,0,194900,327900
141545800400000,OFFICE,COMMERCIAL,0,192900,192900,0,771500,964400
141545800700000,SE 218,RESIDENTIAL,30000,0,30000,75100,0,105100
141547600100000,SE 218,RESIDENTIAL,61600,0,61600,121700,0,183300
141547600200000,SE 218,RESIDENTIAL,172500,0,172500,0,0,172500
141547600400000,OFFICE,COMMERCIAL,0,327000,327000,0,2172900,2499900
141547600500000,OFFICE; MEDICAL,COMMERCIAL,0,384000,384000,0,791100,1175100
141547600600000,OFFICE; MEDICAL,COMMERCIAL,0,65100,65100,0,164600,229700
141547600700000,FLAT PARKING,COMMERCIAL,0,79500,79500,0,6000,85500
141547600800000,SE 215,RESIDENTIAL,18100,0,18100,119900,0,138000
141547600900000,SE 215,RESIDENTIAL,16200,0,16200,92300,0,108500
141547601000000,SE 215,RESIDENTIAL,16200,0,16200,98100,0,114300
141547601100000,SE 215,RESIDENTIAL,12600,0,12600,88100,0,100700
141547601200000,SE 215,RESIDENTIAL,14400,0,14400,86800,0,101200
141547601300000,SE 215,RESIDENTIAL,12600,0,12600,105800,0,118400
141547601400000,SE 215,RESIDENTIAL,15300,0,15300,115900,0,131200
141547700100000,OFFICE,COMMERCIAL,53900,53900,107800,147750,147750,403300
141547800100000,NE 154,RESIDENTIAL,23000,0,23000,89200,0,112200
141547800200000,NE 154,RESIDENTIAL,22400,0,22400,119300,0,141700
141547800300000,NE 154,RESIDENTIAL,22400,0,22400,87600,0,110000
141547800400000,NE 154,RESIDENTIAL,17600,0,17600,43800,0,61400
141547800500000,NE 154,RESIDENTIAL,22400,0,22400,91100,0,113500
141547800600000,OFFICE,COMMERCIAL,26460,194040,220500,35040,256960,512500
141547800700000,OFFICE,COMMERCIAL,0,184200,184200,0,315200,499400
141547800800000,NE 154,RESIDENTIAL,21900,0,21900,62300,0,84200
141547800900000,OFFICE; MEDICAL,COMMERCIAL,0,530700,530700,0,1267400,1798100
141547801000000,NE 154,RESIDENTIAL,23000,0,23000,92900,0,115900
141547900100000,NE 154,RESIDENTIAL,18600,0,18600,68900,0,87500
141547900200000,NE 154,RESIDENTIAL,19000,0,19000,79200,0,98200
141548000100000,SE 218,RESIDENTIAL,119300,0,119300,344700,0,464000
141548000200000,LITERARY/LIBRARY/ART,EXEMPT,0,1560000,1560000,0,1371800,2931800
141548000300000,SE 215,RESIDENTIAL,14400,0,14400,120500,0,134900
141548000400000,SE 215,RESIDENTIAL,14400,0,14400,75200,0,89600
141548000500000,SE 215,RESIDENTIAL,14100,0,14100,87300,0,101400
141548000600000,SE 215,RESIDENTIAL,14400,0,14400,88500,0,102900
141548000700000,SE 215,RESIDENTIAL,14400,0,14400,77800,0,92200
141548000800000,SE 215,RESIDENTIAL,14400,0,14400,88500,0,102900
141548000900000,SE 215,RESIDENTIAL,15400,0,15400,100800,0,116200
141548001000000,SE 215,RESIDENTIAL,18600,0,18600,114100,0,132700
141548001100000,SE 218,RESIDENTIAL,99200,0,99200,339200,0,438400
141548001200000,SE 218,EXEMPT,0,72000,72000,0,141300,213300
141548100100000,SE 215,RESIDENTIAL,19900,0,19900,88900,0,108800
141548100200000,SE 215,RESIDENTIAL,15200,0,15200,90700,0,105900
141548100300000,SE 215,RESIDENTIAL,16900,0,16900,93400,0,110300
141548100400000,SE 215,RESIDENTIAL,17100,0,17100,83700,0,100800
141548100500000,SE 215,RESIDENTIAL,17500,0,17500,104800,0,122300
141548100600000,SE 215,RESIDENTIAL,17500,0,17500,120100,0,137600
141548100700000,SE 215,RESIDENTIAL,20000,0,20000,116700,0,136700
141548200100000,SE 218,RESIDENTIAL,101000,0,101000,161800,0,262800
141548200200000,SE 218,RESIDENTIAL,51700,0,51700,295000,0,346700
141548200300000,SE 218,RESIDENTIAL,49900,0,49900,172700,0,222600
141548200400000,SE 215,RESIDENTIAL,18300,0,18300,116400,0,134700
141548200500000,SE 215,RESIDENTIAL,17800,0,17800,117300,0,135100
141548200600000,SE 218,RESIDENTIAL,46200,0,46200,227600,0,273800
141548200700000,SE 218,RESIDENTIAL,81700,0,81700,138100,0,219800
141610100100000,CHURCH,EXEMPT,0,58500,58500,0,102600,161100
141610100200000,NE 145,RESIDENTIAL,24600,0,24600,117000,0,141600
141610100300000,NE 145,RESIDENTIAL,24800,0,24800,88000,0,112800
141610100400000,NE 145,RESIDENTIAL,24800,0,24800,68400,0,93200
141610100500000,NE 145,RESIDENTIAL,25500,0,25500,78900,0,104400
141610100600000,NE 145,RESIDENTIAL,29800,0,29800,47300,0,77100
141610100700000,NE 145,RESIDENTIAL,20200,0,20200,65900,0,86100
141610100800000,NE 145,RESIDENTIAL,20200,0,20200,91400,0,111600
141610100900000,NE 145,RESIDENTIAL,20200,0,20200,87700,0,107900
141610101000000,NE 145,RESIDENTIAL,20200,0,20200,84400,0,104600
141610101100000,NE 145,RESIDENTIAL,20200,0,20200,71100,0,91300
141610101200000,NE 145,RESIDENTIAL,20200,0,20200,48200,0,68400
141610101300000,NE 145,RESIDENTIAL,20600,0,20600,69400,0,90000
141610200200000,NE 145,RESIDENTIAL,15100,0,15100,73400,0,88500
141610200300000,NE 145,RESIDENTIAL,15100,0,15100,90400,0,105500
141610200400000,NE 145,RESIDENTIAL,15000,0,15000,83700,0,98700
141610200500000,NE 145,RESIDENTIAL,15100,0,15100,49900,0,65000
141610200600000,NE 145,RESIDENTIAL,15100,0,15100,60000,0,75100
141610200700000,NE 145,RESIDENTIAL,25500,0,25500,82300,0,107800
141610200800000,NE 145,RESIDENTIAL,25500,0,25500,53100,0,78600
141610200900000,NE 145,RESIDENTIAL,27500,0,27500,101100,0,128600
141610201000000,NE 145,RESIDENTIAL,23500,0,23500,89800,0,113300
141610201100000,NE 145,RESIDENTIAL,24200,0,24200,39200,0,63400
141610201200000,NE 145,RESIDENTIAL,25800,0,25800,105300,0,131100
141610201300000,NE 145,RESIDENTIAL,20700,0,20700,105800,0,126500
141610201400000,NE 145,RESIDENTIAL,16200,0,16200,53600,0,69800
141610201500000,NE 145,RESIDENTIAL,16100,0,16100,89800,0,105900
141610201600000,NE 145,RESIDENTIAL,16100,0,16100,85800,0,101900
141610201700000,NE 145,RESIDENTIAL,20000,0,20000,109400,0,129400
141610201800000,NE 145,RESIDENTIAL,20500,0,20500,126100,0,146600
141610201900000,NE 145,RESIDENTIAL,19100,0,19100,96200,0,115300
141610202000000,NE 145,RESIDENTIAL,19100,0,19100,83400,0,102500
141610202100000,NE 145,RESIDENTIAL,28700,0,28700,102100,0,130800
141610202200000,NE 145,RESIDENTIAL,20300,0,20300,61500,0,81800
141610202300000,NE 145,RESIDENTIAL,23700,0,23700,1600,0,25300
141610300100000,NE 145,RESIDENTIAL,15100,0,15100,43000,0,58100
141610300200000,NE 145,RESIDENTIAL,15100,0,15100,57100,0,72200
141610300300000,NE 145,RESIDENTIAL,15100,0,15100,82300,0,97400
141610300400000,NE 145,RESIDENTIAL,15100,0,15100,70900,0,86000
141610300500000,NE 145,RESIDENTIAL,15400,0,15400,54300,0,69700
141610300600000,NE 145,RESIDENTIAL,12700,0,12700,41100,0,53800
141610300700000,NE 145,RESIDENTIAL,12500,0,12500,52900,0,65400
141610300800000,NE 145,RESIDENTIAL,16200,0,16200,72200,0,88400
141610300900000,NE 145,RESIDENTIAL,16600,0,16600,63500,0,80100
141610301000000,AUTO REPAIR/SALES,COMMERCIAL,78325,42175,120500,41155,9045,170700
141610301100000,NE 145,RESIDENTIAL,23200,0,23200,93700,0,116900
141610301200000,NE 145,RESIDENTIAL,26200,0,26200,97700,0,123900
141610301300000,NE 145,RESIDENTIAL,25000,0,25000,89900,0,114900
141610301400000,NE 145,RESIDENTIAL,25000,0,25000,108100,0,133100
141610301500000,NE 145,RESIDENTIAL,26700,0,26700,97500,0,124200
141610301600000,NE 145,RESIDENTIAL,19900,0,19900,90500,0,110400
141610301700000,NE 145,RESIDENTIAL,19900,0,19900,92200,0,112100
141610301800000,NE 145,RESIDENTIAL,19900,0,19900,56900,0,76800
141610301900000,NE 145,RESIDENTIAL,16600,0,16600,76000,0,92600
141610302000000,NE 145,RESIDENTIAL,20300,0,20300,98200,0,118500
141610302100000,NE 145,RESIDENTIAL,21200,0,21200,96000,0,117200
141610302200000,NE 145,RESIDENTIAL,21100,0,21100,84600,0,105700
141610302300000,NE 145,RESIDENTIAL,18300,0,18300,84700,0,103000
141610302400000,NE 145,RESIDENTIAL,17200,0,17200,93700,0,110900
141610302600000,NE 145,RESIDENTIAL,24500,0,24500,127200,0,151700
141610303100000,NE 145,RESIDENTIAL,19500,0,19500,75600,0,95100
141610400100000,NE 145,RESIDENTIAL,20800,0,20800,80800,0,101600
141610400200000,NE 145,RESIDENTIAL,20200,0,20200,86300,0,106500
141610400300000,NE 145,RESIDENTIAL,20200,0,20200,44500,0,64700
141610400400000,NE 145,RESIDENTIAL,20200,0,20200,83500,0,103700
141610400500000,NE 145,RESIDENTIAL,20200,0,20200,108000,0,128200
141610400600000,NE 145,RESIDENTIAL,20200,0,20200,88400,0,108600
141610400700000,NE 145,RESIDENTIAL,20200,0,20200,84700,0,104900
141610400800000,NE 145,RESIDENTIAL,20200,0,20200,74700,0,94900
141610400900000,NE 145,RESIDENTIAL,27200,0,27200,69100,0,96300
141610401000000,NE 145,RESIDENTIAL,22600,0,22600,76300,0,98900
141610401100000,APARTMENT,MULTI-RES,22500,0,22500,250200,0,272700
141610401200000,NE 145,RESIDENTIAL,22200,0,22200,76800,0,99000
141610401300000,NE 145,RESIDENTIAL,25900,0,25900,87100,0,113000
141610401400000,NE 145,RESIDENTIAL,19100,0,19100,93600,0,112700
141610401500000,NE 145,RESIDENTIAL,19100,0,19100,72100,0,91200
141610401600000,NE 145,RESIDENTIAL,14500,0,14500,89400,0,103900
141610401700000,APARTMENT,MULTI-RES,390000,0,390000,610000,0,1000000
141610500100000,NE 145,RESIDENTIAL,27000,0,27000,79000,0,106000
141610500200000,NE 145,RESIDENTIAL,28700,0,28700,62000,0,90700
141610500600000,NE 145,RESIDENTIAL,23500,0,23500,53400,0,76900
141610500700000,APARTMENT,RESIDENTIAL,30800,0,30800,254900,0,285700
141610500800000,APARTMENT,RESIDENTIAL,30800,0,30800,279300,0,310100
141610600100000,NE 145,RESIDENTIAL,20400,0,20400,104700,0,125100
141610600200000,NE 145,RESIDENTIAL,18200,0,18200,105800,0,124000
141610600300000,NE 145,RESIDENTIAL,15900,0,15900,90000,0,105900
141610600400000,NE 145,RESIDENTIAL,15900,0,15900,73500,0,89400
141610600500000,NE 145,RESIDENTIAL,15900,0,15900,84400,0,100300
141610600600000,NE 145,RESIDENTIAL,20300,0,20300,98200,0,118500
141610600700000,NE 145,RESIDENTIAL,21500,0,21500,50000,0,71500
141610600800000,NE 145,RESIDENTIAL,25100,0,25100,91700,0,116800
141610600900000,NE 145,RESIDENTIAL,23400,0,23400,87400,0,110800
141610601100000,NE 145,RESIDENTIAL,34700,0,34700,70300,0,105000
141610601200000,NE 145,RESIDENTIAL,20100,0,20100,66300,0,86400
141610601300000,NE 145,RESIDENTIAL,19100,0,19100,72100,0,91200
141610601400000,NE 145,RESIDENTIAL,19100,0,19100,86100,0,105200
141610700100000,NE 145,RESIDENTIAL,18000,0,18000,85500,0,103500
141610700200000,NE 145,RESIDENTIAL,15000,0,15000,81000,0,96000
141610700300000,NE 145,RESIDENTIAL,13800,0,13800,86800,0,100600
141610700400000,NE 145,RESIDENTIAL,19700,0,19700,76300,0,96000
141610700500000,NE 145,RESIDENTIAL,17800,0,17800,93900,0,111700
141610700600000,NE 145,RESIDENTIAL,23200,0,23200,51900,0,75100
141610700700000,APARTMENT,MULTI-RES,108000,0,108000,464900,0,572900
141610700800000,NE 145,RESIDENTIAL,18000,0,18000,87200,0,105200
141610700900000,NE 145,RESIDENTIAL,18000,0,18000,87900,0,105900
141610701000000,NE 145,RESIDENTIAL,19300,0,19300,95000,0,114300
141610701100000,NE 145,RESIDENTIAL,16100,0,16100,81500,0,97600
141612600100000,AUTO REPAIR/SALES,COMMERCIAL,0,79000,79000,0,53900,132900
141612600200000,OFFICE,COMMERCIAL,0,187800,187800,0,385200,573000
141612600300000,OFFICE,COMMERCIAL,0,98100,98100,0,49400,147500
141612600400000,NE 146,RESIDENTIAL,30700,0,30700,101900,0,132600
141612600900000,NE 146,RESIDENTIAL,29600,0,29600,118200,0,147800
141612601100000,OFFICE; MEDICAL,COMMERCIAL,0,141300,141300,0,210600,351900
141612601200000,NE 146,RESIDENTIAL,25100,0,25100,44600,0,69700
141612601300000,NE 146,RESIDENTIAL,25900,0,25900,30500,0,56400
141612601400000,APARTMENT,RESIDENTIAL,15700,0,15700,134800,0,150500
141612601700000,NE 146,RESIDENTIAL,11700,0,11700,19300,0,31000
141612601800000,APARTMENT,RESIDENTIAL,72000,0,72000,665200,0,737200
141612601900000,SMALL RETAIL,COMMERCIAL,0,26000,26000,0,72400,98400
141612602000000,WAREHOUSE,COMMERCIAL,0,28000,28000,0,75400,103400
141612602100000,APARTMENT,RESIDENTIAL,16600,0,16600,142100,0,158700
141612602200000,APARTMENT,RESIDENTIAL,15700,0,15700,145200,0,160900
141612700100000,NE 147,RESIDENTIAL,31200,0,31200,158800,0,190000
141612700200000,NE 147,RESIDENTIAL,30200,0,30200,139500,0,169700
141612700300000,NE 147,RESIDENTIAL,31300,0,31300,126500,0,157800
141612700400000,NE 147,RESIDENTIAL,31300,0,31300,125400,0,156700
141612700500000,NE 147,RESIDENTIAL,31300,0,31300,116900,0,148200
141612700600000,NE 147,RESIDENTIAL,31800,0,31800,154100,0,185900
141612800100000,APARTMENT,RESIDENTIAL,27100,0,27100,100100,0,127200
141612800700000,NE 146,RESIDENTIAL,33600,0,33600,0,0,33600
141612800800000,NE 146,RESIDENTIAL,36100,0,36100,0,0,36100
141612800900000,NE 146,RESIDENTIAL,700,0,700,0,0,700
141615100100000,NE 146,RESIDENTIAL,22600,0,22600,0,0,22600
141615100200000,NE 146,RESIDENTIAL,22600,0,22600,0,0,22600
141615100300000,VACANT LAND,COMMERCIAL,0,115800,115800,0,0,115800
141615100400000,NE 146,RESIDENTIAL,22800,0,22800,58200,0,81000
141615100600000,OFFICE; MEDICAL,COMMERCIAL,0,94100,94100,0,269300,363400
141615100800000,NE 146,RESIDENTIAL,30800,0,30800,87100,0,117900
141615100900000,NE 146,RESIDENTIAL,27700,0,27700,55200,0,82900
141615200100000,CITY PROPERTY,EXEMPT,0,0,0,0,0,0
141615300100000,NE 146,RESIDENTIAL,16100,0,16100,47700,0,63800
141615300200000,NE 146,RESIDENTIAL,14000,0,14000,12900,0,26900
141615300300000,NE 146,RESIDENTIAL,14000,0,14000,65600,0,79600
141615300400000,NE 146,RESIDENTIAL,14000,0,14000,60700,0,74700
141615300500000,NE 146,RESIDENTIAL,25200,0,25200,47100,0,72300
141615300600000,NE 146,RESIDENTIAL,13200,0,13200,66700,0,79900
141615300700000,NE 146,RESIDENTIAL,14700,0,14700,61500,0,76200
141615300800000,NE 146,RESIDENTIAL,14000,0,14000,56600,0,70600
141615300900000,NE 146,RESIDENTIAL,14000,0,14000,66300,0,80300
141615301000000,NE 146,RESIDENTIAL,14000,0,14000,70900,0,84900
141615301100000,NE 146,RESIDENTIAL,14000,0,14000,37600,0,51600
141615301200000,NE 146,RESIDENTIAL,14000,0,14000,41100,0,55100
141615301300000,NE 146,RESIDENTIAL,14000,0,14000,23100,0,37100
141615301400000,NE 146,RESIDENTIAL,14000,0,14000,54300,0,68300
141615301500000,NE 146,RESIDENTIAL,14000,0,14000,53500,0,67500
141615301600000,NE 146,RESIDENTIAL,11600,0,11600,32500,0,44100
141615301700000,NE 146,RESIDENTIAL,13200,0,13200,20900,0,34100
141615301800000,NE 146,RESIDENTIAL,20300,0,20300,40200,0,60500
141615301900000,OFFICE,COMMERCIAL,0,25200,25200,0,74600,99800
141615302000000,SMALL RETAIL,COMMERCIAL,10976,11424,22400,14504,20896,57800
141615302100000,WAREHOUSE,COMMERCIAL,0,22400,22400,0,32700,55100
141615302200000,NE 146,RESIDENTIAL,14000,0,14000,48200,0,62200
141615302300000,NE 146,RESIDENTIAL,11600,0,11600,49800,0,61400
141615302400000,NE 146,RESIDENTIAL,11900,0,11900,47200,0,59100
141615302500000,NE 146,RESIDENTIAL,11600,0,11600,35300,0,46900
141615302600000,NE 146,RESIDENTIAL,21000,0,21000,75400,0,96400
141615302700000,NE 146,RESIDENTIAL,14000,0,14000,21900,0,35900
141615500200000,NE 146,RESIDENTIAL,21400,0,21400,42800,0,64200
141615500300000,NE 146,RESIDENTIAL,26400,0,26400,31600,0,58000
141615500400000,NE 146,RESIDENTIAL,18600,0,18600,36100,0,54700
141615500500000,NE 146,RESIDENTIAL,15500,0,15500,54300,0,69800
141615500600000,NE 146,RESIDENTIAL,15700,0,15700,15900,0,31600
141615500700000,NE 146,RESIDENTIAL,18800,0,18800,47700,0,66500
141615500800000,NE 146,RESIDENTIAL,19000,0,19000,33700,0,52700
141615500900000,NE 146,RESIDENTIAL,6300,0,6300,0,0,6300
141615501000000,NE 146,RESIDENTIAL,12600,0,12600,40100,0,52700
141615501100000,NE 146,RESIDENTIAL,14700,0,14700,63300,0,78000
141615501200000,NE 146,RESIDENTIAL,23800,0,23800,49200,0,73000
141615501500000,NE 146,RESIDENTIAL,35300,0,35300,135700,0,171000
141617600100000,NE 145,RESIDENTIAL,27500,0,27500,45000,0,72500
141617600200000,VACANT LAND,COMMERCIAL,0,0,0,0,0,0
141617600300000,NE 145,RESIDENTIAL,28200,0,28200,52800,0,81000
141617600400000,APARTMENT,MULTI-RES,400000,0,400000,800000,0,1200000
141617600500000,NE 145,RESIDENTIAL,23800,0,23800,47200,0,71000
141617600600000,NE 145,RESIDENTIAL,4100,0,4100,63300,0,67400
141617600800000,NE 145,RESIDENTIAL,17900,0,17900,72900,0,90800
141617600900000,NE 145,RESIDENTIAL,17900,0,17900,86400,0,104300
141617601000000,NE 145,RESIDENTIAL,17900,0,17900,64400,0,82300
141617601200000,NE 145,RESIDENTIAL,19900,0,19900,89200,0,109100
141617601300000,NE 145,RESIDENTIAL,19900,0,19900,62700,0,82600
141617601400000,NE 145,RESIDENTIAL,26500,0,26500,85500,0,112000
141617601500000,APARTMENT,MULTI-RES,63400,0,63400,563300,0,626700
141617601600000,NE 145,RESIDENTIAL,20600,0,20600,82900,0,103500
141617601700000,NE 145,RESIDENTIAL,24200,0,24200,102800,0,127000
141617601800000,CONVERSION-NE/SE,MULTI-RES,21000,0,21000,66900,0,87900
141617601900000,NE 145,RESIDENTIAL,19600,0,19600,93700,0,113300
141617602000000,NE 145,RESIDENTIAL,20200,0,20200,88900,0,109100
141617602100000,COUNTY PROPERTY,EXEMPT,0,0,0,0,0,0
141617602200000,SCHOOL,EXEMPT,0,0,0,0,0,0
141617700100000,NE 145,RESIDENTIAL,19100,0,19100,96600,0,115700
141617700200000,NE 145,RESIDENTIAL,27400,0,27400,100200,0,127600
141617700300000,NE 146,RESIDENTIAL,18500,0,18500,77700,0,96200
141617700400000,CONVERSION-NE/SE,MULTI-RES,18900,0,18900,48200,0,67100
141617700500000,NE 145,RESIDENTIAL,20700,0,20700,72500,0,93200
141617800100000,NE 146,RESIDENTIAL,20900,0,20900,41800,0,62700
141617800200000,NE 146,RESIDENTIAL,14900,0,14900,44700,0,59600
141617800300000,NE 146,RESIDENTIAL,15800,0,15800,57300,0,73100
141617800400000,NE 146,RESIDENTIAL,14100,0,14100,41900,0,56000
141617800500000,NE 146,RESIDENTIAL,14900,0,14900,31400,0,46300
141617800600000,NE 146,RESIDENTIAL,14900,0,14900,76200,0,91100
141617800700000,NE 146,RESIDENTIAL,17700,0,17700,49100,0,66800
141617900100000,NE 145,RESIDENTIAL,19300,0,19300,77100,0,96400
141617900300000,NE 146,RESIDENTIAL,17300,0,17300,61600,0,78900
141617900400000,APARTMENT,RESIDENTIAL,47800,0,47800,425100,0,472900
141617900500000,APARTMENT,RESIDENTIAL,44500,0,44500,59600,0,104100
141617900600000,NE 145,RESIDENTIAL,22100,0,22100,78300,0,100400
141617900700000,APARTMENT,RESIDENTIAL,52400,0,52400,537000,0,589400
141618000100000,NE 146,RESIDENTIAL,16400,0,16400,47900,0,64300
141618000200000,NE 146,RESIDENTIAL,15200,0,15200,58100,0,73300
141618000300000,NE 146,RESIDENTIAL,15200,0,15200,52700,0,67900
141618000400000,NE 146,RESIDENTIAL,15200,0,15200,33000,0,48200
141618000500000,NE 146,RESIDENTIAL,15200,0,15200,46800,0,62000
141618000600000,NE 146,RESIDENTIAL,15200,0,15200,21800,0,37000
141618000700000,NE 146,RESIDENTIAL,18100,0,18100,95800,0,113900
141618000800000,NE 146,RESIDENTIAL,16300,0,16300,51800,0,68100
141618000900000,NE 146,RESIDENTIAL,21700,0,21700,65200,0,86900
141618001000000,NE 146,RESIDENTIAL,15200,0,15200,45900,0,61100
141618001100000,NE 146,RESIDENTIAL,15200,0,15200,47800,0,63000
141618001200000,NE 146,RESIDENTIAL,15200,0,15200,32300,0,47500
141618001300000,NE 146,RESIDENTIAL,15200,0,15200,27000,0,42200
141618001400000,NE 146,RESIDENTIAL,15200,0,15200,43300,0,58500
141618001500000,NE 146,RESIDENTIAL,14500,0,14500,43700,0,58200
141618100100000,NE 145,RESIDENTIAL,22100,0,22100,72300,0,94400
141618100200000,APARTMENT,MULTI-RES,114400,0,114400,1151100,0,1265500
141618100300000,NE 145,RESIDENTIAL,20700,0,20700,76200,0,96900
141618100400000,NE 145,RESIDENTIAL,25400,0,25400,81800,0,107200
141618100500000,NE 145,RESIDENTIAL,17600,0,17600,86800,0,104400
141618200100000,NE 146,RESIDENTIAL,15700,0,15700,50100,0,65800
141618200200000,NE 146,RESIDENTIAL,15200,0,15200,40300,0,55500
141618200300000,NE 146,RESIDENTIAL,15200,0,15200,58200,0,73400
141618200400000,NE 146,RESIDENTIAL,15200,0,15200,64700,0,79900
141618200500000,NE 146,RESIDENTIAL,15200,0,15200,42600,0,57800
141618200600000,NE 146,RESIDENTIAL,15200,0,15200,41200,0,56400
141618200700000,NE 146,RESIDENTIAL,15200,0,15200,35400,0,50600
141618200800000,NE 146,RESIDENTIAL,16600,0,16600,41400,0,58000
141618200900000,NE 146,RESIDENTIAL,19800,0,19800,38700,0,58500
141618201000000,NE 146,RESIDENTIAL,13600,0,13600,45800,0,59400
141618201100000,NE 146,RESIDENTIAL,15200,0,15200,36900,0,52100
141618201200000,NE 146,RESIDENTIAL,15200,0,15200,50800,0,66000
141618201300000,NE 146,RESIDENTIAL,15200,0,15200,42200,0,57400
141618201400000,NE 146,RESIDENTIAL,15200,0,15200,46700,0,61900
141618201500000,NE 146,RESIDENTIAL,10700,0,10700,43200,0,53900
141618201600000,NE 146,RESIDENTIAL,9600,0,9600,0,0,9600
141618300100000,NE 145,RESIDENTIAL,21100,0,21100,96500,0,117600
141618300200000,NE 146,RESIDENTIAL,17800,0,17800,30300,0,48100
141618300300000,NE 145,RESIDENTIAL,27800,0,27800,71400,0,99200
141618300400000,NE 145,RESIDENTIAL,24400,0,24400,68200,0,92600
141618300500000,NE 145,RESIDENTIAL,22500,0,22500,91600,0,114100
141618300600000,NE 145,RESIDENTIAL,24100,0,24100,78700,0,102800
141618300700000,NE 145,RESIDENTIAL,23500,0,23500,87500,0,111000
141618300800000,NE 145,RESIDENTIAL,18100,0,18100,92800,0,110900
141618300900000,NE 145,RESIDENTIAL,17000,0,17000,91100,0,108100
141618301000000,NE 145,RESIDENTIAL,17000,0,17000,58900,0,75900
141618301100000,NE 145,RESIDENTIAL,17000,0,17000,96200,0,113200
141618301200000,CHURCH,EXEMPT,0,30900,30900,0,75400,106300
141618301300000,NE 145,RESIDENTIAL,18800,0,18800,109400,0,128200
141618301400000,NE 145,RESIDENTIAL,19200,0,19200,69500,0,88700
141618301500000,NE 145,RESIDENTIAL,18300,0,18300,71200,0,89500
141618400100000,NE 146,RESIDENTIAL,15000,0,15000,47400,0,62400
141618400200000,NE 146,RESIDENTIAL,15200,0,15200,25600,0,40800
141618400300000,NE 146,RESIDENTIAL,15200,0,15200,71500,0,86700
141618400400000,NE 146,RESIDENTIAL,15200,0,15200,79500,0,94700
141618400500000,NE 146,RESIDENTIAL,15200,0,15200,62400,0,77600
141618400600000,NE 146,RESIDENTIAL,15200,0,15200,19200,0,34400
141618400700000,NE 146,RESIDENTIAL,15200,0,15200,37100,0,52300
141618400800000,NE 146,RESIDENTIAL,13000,0,13000,34100,0,47100
141618400900000,NE 146,RESIDENTIAL,9200,0,9200,31600,0,40800
141618401200000,OFFICE,COMMERCIAL,0,66700,66700,0,137300,204000
141618401300000,AUTO REPAIR/SALES,COMMERCIAL,0,26000,26000,0,37800,63800
141618401400000,NE 145,RESIDENTIAL,16700,0,16700,77100,0,93800
141618401500000,NE 145,RESIDENTIAL,8100,0,8100,0,0,8100
141618401600000,NE 145,RESIDENTIAL,16500,0,16500,92600,0,109100
141618401700000,NE 145,RESIDENTIAL,18400,0,18400,50100,0,68500
141618401800000,NE 145,RESIDENTIAL,18400,0,18400,84700,0,103100
141618401900000,NE 145,RESIDENTIAL,18600,0,18600,52600,0,71200
141620100100000,NE 147,RESIDENTIAL,28200,0,28200,87400,0,115600
141620100200000,NE 147,RESIDENTIAL,28900,0,28900,69400,0,98300
141620100300000,NE 147,RESIDENTIAL,28900,0,28900,125700,0,154600
141620100400000,NE 147,RESIDENTIAL,28900,0,28900,128600,0,157500
141620100500000,NE 147,RESIDENTIAL,28900,0,28900,91500,0,120400
141620100600000,NE 147,RESIDENTIAL,28900,0,28900,105100,0,134000
141620100700000,NE 147,RESIDENTIAL,29000,0,29000,115800,0,144800
141620100800000,NE 147,RESIDENTIAL,29900,0,29900,87000,0,116900
141620100900000,NE 147,RESIDENTIAL,29200,0,29200,138100,0,167300
141620101000000,NE 147,RESIDENTIAL,31600,0,31600,144000,0,175600
141620101100000,NE 147,RESIDENTIAL,39300,0,39300,104400,0,143700
141620200100000,NE 147,RESIDENTIAL,27300,0,27300,130300,0,157600
141620200200000,NE 147,RESIDENTIAL,23000,0,23000,105400,0,128400
141620200300000,NE 147,RESIDENTIAL,25700,0,25700,98400,0,124100
141620200400000,NE 147,RESIDENTIAL,25000,0,25000,119400,0,144400
141620200500000,NE 147,RESIDENTIAL,23800,0,23800,90300,0,114100
141620200600000,NE 147,RESIDENTIAL,23000,0,23000,104700,0,127700
141620200700000,NE 147,RESIDENTIAL,25100,0,25100,106800,0,131900
141620200800000,NE 147,RESIDENTIAL,10800,0,10800,0,0,10800
141620200900000,NE 147,RESIDENTIAL,28800,0,28800,99900,0,128700
141620201000000,NE 147,RESIDENTIAL,24700,0,24700,84200,0,108900
141620201100000,NE 147,RESIDENTIAL,24700,0,24700,90900,0,115600
141620201200000,NE 147,RESIDENTIAL,24700,0,24700,76200,0,100900
141620201300000,NE 147,RESIDENTIAL,24700,0,24700,99400,0,124100
141620201400000,NE 147,RESIDENTIAL,24700,0,24700,81200,0,105900
141620201500000,NE 147,RESIDENTIAL,24700,0,24700,88800,0,113500
141620201600000,NE 147,RESIDENTIAL,24900,0,24900,102200,0,127100
141620201700000,NE 147,RESIDENTIAL,25700,0,25700,89900,0,115600
141620201800000,NE 147,RESIDENTIAL,25600,0,25600,99900,0,125500
141620201900000,NE 147,RESIDENTIAL,28700,0,28700,129300,0,158000
141620202000000,NE 147,RESIDENTIAL,27100,0,27100,117700,0,144800
141620202100000,NE 147,RESIDENTIAL,29100,0,29100,111100,0,140200
141620202200000,NE 147,RESIDENTIAL,28400,0,28400,116200,0,144600
141620202300000,NE 147,RESIDENTIAL,27700,0,27700,96500,0,124200
141620202400000,NE 147,RESIDENTIAL,26900,0,26900,105200,0,132100
141620202500000,NE 147,RESIDENTIAL,27500,0,27500,108800,0,136300
141620202600000,NE 147,RESIDENTIAL,28200,0,28200,71000,0,99200
141620202700000,NE 147,RESIDENTIAL,28200,0,28200,99400,0,127600
141620202800000,NE 147,RESIDENTIAL,28200,0,28200,127500,0,155700
141620202900000,NE 147,RESIDENTIAL,29700,0,29700,78300,0,108000
141620203000000,NE 147,RESIDENTIAL,30800,0,30800,104500,0,135300
141620203100000,NE 147,RESIDENTIAL,29100,0,29100,129700,0,158800
141620203200000,NE 147,RESIDENTIAL,29400,0,29400,120000,0,149400
141620203300000,NE 147,RESIDENTIAL,28200,0,28200,123400,0,151600
141620203400000,NE 147,RESIDENTIAL,28900,0,28900,88500,0,117400
141620203500000,NE 147,RESIDENTIAL,28800,0,28800,95000,0,123800
141620203600000,NE 147,RESIDENTIAL,24100,0,24100,106900,0,131000
141620203700000,NE 147,RESIDENTIAL,24100,0,24100,87400,0,111500
141620203800000,NE 147,RESIDENTIAL,26700,0,26700,85800,0,112500
141620300100000,SCHOOL,EXEMPT,0,470900,470900,0,2181700,2652600
141620400100000,NE 147,RESIDENTIAL,26600,0,26600,112900,0,139500
141620400200000,NE 147,RESIDENTIAL,32300,0,32300,105200,0,137500
141620400300000,NE 147,RESIDENTIAL,30000,0,30000,126700,0,156700
141620400400000,NE 147,RESIDENTIAL,29800,0,29800,128600,0,158400
141620400500000,NE 147,RESIDENTIAL,29800,0,29800,135500,0,165300
141620400600000,NE 147,RESIDENTIAL,29500,0,29500,122000,0,151500
141620400700000,NE 147,RESIDENTIAL,28700,0,28700,132500,0,161200
141620400800000,NE 147,RESIDENTIAL,29800,0,29800,102400,0,132200
141620400900000,NE 147,RESIDENTIAL,28600,0,28600,91100,0,119700
141620401000000,NE 147,RESIDENTIAL,28700,0,28700,116300,0,145000
141620401100000,NE 147,RESIDENTIAL,27400,0,27400,110100,0,137500
141620401200000,NE 147,RESIDENTIAL,31800,0,31800,115700,0,147500
141620401300000,NE 147,RESIDENTIAL,35300,0,35300,104400,0,139700
141620401400000,NE 147,RESIDENTIAL,35600,0,35600,114400,0,150000
141620401500000,NE 147,RESIDENTIAL,34900,0,34900,127800,0,162700
141620401600000,NE 147,RESIDENTIAL,35500,0,35500,117600,0,153100
141620401700000,NE 147,RESIDENTIAL,31500,0,31500,114200,0,145700
141620401800000,NE 147,RESIDENTIAL,29500,0,29500,100400,0,129900
141620401900000,NE 147,RESIDENTIAL,29500,0,29500,95100,0,124600
141620500100000,NE 147,RESIDENTIAL,31100,0,31100,114600,0,145700
141620500200000,NE 147,RESIDENTIAL,35400,0,35400,119600,0,155000
141620500300000,NE 147,RESIDENTIAL,36200,0,36200,109700,0,145900
141620500400000,NE 147,RESIDENTIAL,37400,0,37400,118600,0,156000
141620500500000,NE 147,RESIDENTIAL,38200,0,38200,114800,0,153000
141620500600000,NE 147,RESIDENTIAL,35900,0,35900,147900,0,183800
141620500700000,NE 147,RESIDENTIAL,36300,0,36300,103100,0,139400
141620500800000,NE 147,RESIDENTIAL,31500,0,31500,82600,0,114100
141620500900000,NE 147,RESIDENTIAL,36000,0,36000,160500,0,196500
141620501000000,NE 147,RESIDENTIAL,34800,0,34800,139000,0,173800
141620501100000,NE 147,RESIDENTIAL,35600,0,35600,141600,0,177200
141620501200000,NE 147,RESIDENTIAL,32000,0,32000,111300,0,143300
141620501300000,NE 147,RESIDENTIAL,29300,0,29300,111900,0,141200
141620501400000,NE 147,RESIDENTIAL,29000,0,29000,116500,0,145500
141620501500000,NE 147,RESIDENTIAL,32400,0,32400,119500,0,151900
141620501600000,NE 147,RESIDENTIAL,35400,0,35400,123700,0,159100
141620501700000,NE 147,RESIDENTIAL,31800,0,31800,111400,0,143200
141620501800000,NE 147,RESIDENTIAL,19100,0,19100,156000,0,175100
141620501900000,NE 147,RESIDENTIAL,22000,0,22000,7100,0,29100
141620502000000,NE 147,RESIDENTIAL,35300,0,35300,139100,0,174400
141620502100000,NE 147,RESIDENTIAL,33700,0,33700,150700,0,184400
141620502200000,NE 147,RESIDENTIAL,34900,0,34900,177800,0,212700
141620502300000,NE 147,RESIDENTIAL,34500,0,34500,146200,0,180700
141620502400000,NE 147,RESIDENTIAL,36500,0,36500,139600,0,176100
141620502500000,NE 147,RESIDENTIAL,31600,0,31600,127000,0,158600
141620502600000,NE 147,RESIDENTIAL,28300,0,28300,144600,0,172900
141620502700000,NE 147,RESIDENTIAL,30700,0,30700,134800,0,165500
141620502800000,NE 147,RESIDENTIAL,33300,0,33300,132900,0,166200
141620502900000,NE 147,RESIDENTIAL,32900,0,32900,122500,0,155400
141620503000000,NE 147,RESIDENTIAL,33200,0,33200,157300,0,190500
141620503100000,NE 147,RESIDENTIAL,29500,0,29500,140400,0,169900
141620503200000,NE 147,RESIDENTIAL,29500,0,29500,146900,0,176400
141620600100000,NE 147,RESIDENTIAL,30100,0,30100,121100,0,151200
141620600200000,NE 147,RESIDENTIAL,24700,0,24700,127900,0,152600
141620600300000,NE 147,RESIDENTIAL,26200,0,26200,117700,0,143900
141620600400000,NE 147,RESIDENTIAL,26400,0,26400,118300,0,144700
141620600500000,NE 147,RESIDENTIAL,28500,0,28500,145100,0,173600
141620600600000,NE 147,RESIDENTIAL,36200,0,36200,129200,0,165400
141620600700000,NE 147,RESIDENTIAL,30900,0,30900,151000,0,181900
141620600800000,NE 147,RESIDENTIAL,36200,0,36200,156400,0,192600
141620600900000,NE 147,RESIDENTIAL,36800,0,36800,150400,0,187200
141620601000000,NE 147,RESIDENTIAL,36100,0,36100,134900,0,171000
141620601100000,NE 147,RESIDENTIAL,34300,0,34300,116000,0,150300
141620601200000,NE 148,RESIDENTIAL,38600,0,38600,121000,0,159600
141620601300000,NE 148,RESIDENTIAL,40600,0,40600,149300,0,189900
141622600100000,NE 147,RESIDENTIAL,32100,0,32100,127300,0,159400
141622600200000,NE 147,RESIDENTIAL,32400,0,32400,113900,0,146300
141622600300000,NE 147,RESIDENTIAL,32700,0,32700,177400,0,210100
141622600400000,NE 147,RESIDENTIAL,33100,0,33100,137900,0,171000
141622600500000,NE 147,RESIDENTIAL,36000,0,36000,176400,0,212400
141622600600000,NE 147,RESIDENTIAL,31600,0,31600,115500,0,147100
141622600700000,NE 147,RESIDENTIAL,34300,0,34300,132100,0,166400
141622600800000,NE 147,RESIDENTIAL,34200,0,34200,128500,0,162700
141622600900000,NE 147,RESIDENTIAL,29700,0,29700,135000,0,164700
141622601000000,NE 147,RESIDENTIAL,35600,0,35600,135500,0,171100
141622601100000,NE 147,RESIDENTIAL,27900,0,27900,166100,0,194000
141622601200000,NE 147,RESIDENTIAL,31000,0,31000,102700,0,133700
141622601300000,NE 147,RESIDENTIAL,33100,0,33100,151700,0,184800
141622601400000,NE 147,RESIDENTIAL,37900,0,37900,130400,0,168300
141622601500000,NE 147,RESIDENTIAL,52300,0,52300,94800,0,147100
141622601600000,NE 147,RESIDENTIAL,40900,0,40900,155700,0,196600
141622601700000,NE 147,RESIDENTIAL,42000,0,42000,112400,0,154400
141622601800000,NE 147,RESIDENTIAL,48400,0,48400,117400,0,165800
141622601900000,NE 147,RESIDENTIAL,39500,0,39500,207300,0,246800
141622602000000,NE 147,RESIDENTIAL,33400,0,33400,167200,0,200600
141622602100000,NE 147,RESIDENTIAL,30100,0,30100,119700,0,149800
141622602200000,NE 147,RESIDENTIAL,31200,0,31200,166400,0,197600
141622602300000,NE 147,RESIDENTIAL,31500,0,31500,135400,0,166900
141622602400000,NE 147,RESIDENTIAL,30300,0,30300,143800,0,174100
141622602500000,NE 147,RESIDENTIAL,33000,0,33000,109200,0,142200
141622602600000,NE 147,RESIDENTIAL,33700,0,33700,103500,0,137200
141622602700000,NE 147,RESIDENTIAL,33700,0,33700,104600,0,138300
141622602800000,NE 147,RESIDENTIAL,33500,0,33500,97300,0,130800
141622602900000,NE 147,RESIDENTIAL,35400,0,35400,74000,0,109400
141622603000000,NE 147,RESIDENTIAL,30100,0,30100,96900,0,127000
141622603100000,NE 147,RESIDENTIAL,200,0,200,0,0,200
141622603200000,NE 147,RESIDENTIAL,0,0,0,0,0,0
141623100100000,NE 147,RESIDENTIAL,31600,0,31600,117100,0,148700
141623100200000,NE 147,RESIDENTIAL,29500,0,29500,136300,0,165800
141623100300000,NE 147,RESIDENTIAL,29500,0,29500,117400,0,146900
141623100400000,NE 147,RESIDENTIAL,30400,0,30400,152200,0,182600
141623100500000,NE 147,RESIDENTIAL,33300,0,33300,155900,0,189200
141623100600000,NE 147,RESIDENTIAL,33700,0,33700,133000,0,166700
141625100100000,NE 147,RESIDENTIAL,33600,0,33600,141000,0,174600
141625100200000,CITY PROPERTY,EXEMPT,0,0,0,0,0,0
141625100400000,CARWASH,COMMERCIAL,0,60400,60400,0,86700,147100
141625100500000,OFFICE,COMMERCIAL,0,73300,73300,0,142500,215800
141627600100000,NE 147,RESIDENTIAL,35000,0,35000,122300,0,157300
141627600400000,VACANT LAND,COMMERCIAL,0,69500,69500,0,0,69500
141627600500000,BRANCH BANK/CU,COMMERCIAL,0,229400,229400,0,839300,1068700
141627700100000,NE 147,RESIDENTIAL,27400,0,27400,130100,0,157500
141627700200000,NE 147,RESIDENTIAL,29900,0,29900,134200,0,164100
141627700300000,NE 147,RESIDENTIAL,26000,0,26000,127900,0,153900
141627700400000,NE 147,RESIDENTIAL,22700,0,22700,143300,0,166000
141627700500000,NE 147,RESIDENTIAL,36600,0,36600,139600,0,176200
141627700600000,NE 147,RESIDENTIAL,35400,0,35400,123600,0,159000
141627700700000,NE 147,RESIDENTIAL,39000,0,39000,139400,0,178400
141627700800000,NE 147,RESIDENTIAL,32300,0,32300,150200,0,182500
141627700900000,NE 147,RESIDENTIAL,31600,0,31600,148500,0,180100
141627701000000,NE 148,RESIDENTIAL,45400,0,45400,190700,0,236100
141627701100000,NE 148,RESIDENTIAL,34100,0,34100,0,0,34100
141627701200000,NE 148,RESIDENTIAL,38000,0,38000,154000,0,192000
141627701300000,NE 148,RESIDENTIAL,37300,0,37300,153100,0,190400
141627701400000,NE 148,RESIDENTIAL,38900,0,38900,179000,0,217900
141627701500000,NE 148,RESIDENTIAL,35500,0,35500,160800,0,196300
141627701600000,NE 148,RESIDENTIAL,18500,0,18500,142000,0,160500
141627701700000,NE 148,RESIDENTIAL,18700,0,18700,142500,0,161200
141627800200000,NE 148,RESIDENTIAL,20300,0,20300,127200,0,147500
141627800300000,NE 148,RESIDENTIAL,20200,0,20200,130500,0,150700
141627800400000,NE 148,RESIDENTIAL,19100,0,19100,113900,0,133000
141627800500000,NE 148,RESIDENTIAL,18700,0,18700,111200,0,129900
141627800600000,NE 148,RESIDENTIAL,18700,0,18700,129700,0,148400
141627800700000,NE 148,RESIDENTIAL,19000,0,19000,126400,0,145400
141627800800000,NE 148,RESIDENTIAL,38900,0,38900,134600,0,173500
141627800900000,NE 148,RESIDENTIAL,40100,0,40100,158000,0,198100
141627801000000,NE 148,RESIDENTIAL,43500,0,43500,202600,0,246100
141627801100000,NE 148,RESIDENTIAL,42900,0,42900,174700,0,217600
141627801200000,NE 148,RESIDENTIAL,40000,0,40000,164500,0,204500
141627801300000,NE 148,RESIDENTIAL,44600,0,44600,144900,0,189500
141627801400000,NE 148,RESIDENTIAL,43600,0,43600,122400,0,166000
141627801500000,NE 148,RESIDENTIAL,41700,0,41700,145900,0,187600
141627801600000,VACANT LAND,COMMERCIAL,0,420000,420000,0,0,420000
141627801700000,VACANT LAND,COMMERCIAL,0,1500,1500,0,0,1500
141627801800000,OFFICE,COMMERCIAL,0,250400,250400,0,1673900,1924300
141630100100000,CITY PROPERTY,EXEMPT,0,0,0,0,0,0
141630100400000,CITY PROPERTY,EXEMPT,0,0,0,0,0,0
141630100500000,PAPER; INDUSTRIAL,INDUSTRIAL,0,635600,635600,0,3280600,3916200
141630100600000,CENTRALLY ASSESSED,OTHER,0,0,0,0,0,0
141630100700000,WAREHOUSE,COMMERCIAL,0,505000,505000,0,3216500,3721500
141630200100000,CENTRALLY ASSESSED,OTHER,0,0,0,0,0,0
141632600100000,CITY PROPERTY,EXEMPT,0,0,0,0,0,0
141632600400000,CITY PROPERTY,EXEMPT,0,0,0,0,0,0
141632600700000,CITY PROPERTY,EXEMPT,0,0,0,0,0,0
141632600900000,CENTRALLY ASSESSED,OTHER,0,0,0,0,0,0
141632601400000,FOOD GRADE;INDUST,INDUSTRIAL,0,124000,124000,0,841000,965000
141632601500000,FOOD GRADE;INDUST,INDUSTRIAL,0,317100,317100,0,892900,1210000
141632601700000,WAREHOUSE,COMMERCIAL,0,690000,690000,0,789900,1479900
141635100100000,VACANT LAND,INDUSTRIAL,0,18800,18800,0,0,18800
141635100200000,CITY PROPERTY,EXEMPT,0,0,0,0,0,0
141635100400000,CENTRALLY ASSESSED,OTHER,0,0,0,0,0,0
141637600100000,FLAT PARKING,INDUSTRIAL,0,20900,20900,0,24000,44900
141637600102000,BILLBOARD(BLL),COMMERCIAL,0,0,0,0,10200,10200
141637600200000,CENTRALLY ASSESSED,OTHER,0,0,0,0,0,0
141637700100000,CITY PROPERTY,EXEMPT,0,0,0,0,0,0
141637700200000,OFFICE,COMMERCIAL,15192,27008,42200,103356,183744,329300
141637700600000,SHOP,COMMERCIAL,0,143100,143100,0,797100,940200
141637700700000,CENTRALLY ASSESSED,OTHER,0,0,0,0,0,0
141637700800000,CENTRALLY ASSESSED,OTHER,0,0,0,0,0,0
141637701000000,SHOP,COMMERCIAL,0,152000,152000,0,767900,919900
141637701100000,SHOP,COMMERCIAL,0,100000,100000,0,301500,401500
141640100100000,CITY PROPERTY,EXEMPT,0,0,0,0,0,0
141640200100000,NE 146,RESIDENTIAL,21000,0,21000,75100,0,96100
141640200200000,APARTMENT,MULTI-RES,15200,0,15200,71400,0,86600
141640200300000,NE 146,RESIDENTIAL,15800,0,15800,66500,0,82300
141640200400000,NE 146,RESIDENTIAL,16600,0,16600,55200,0,71800
141640200500000,NE 146,RESIDENTIAL,16600,0,16600,49600,0,66200
141640200600000,NE 146,RESIDENTIAL,26200,0,26200,47300,0,73500
141640200700000,NE 146,RESIDENTIAL,26200,0,26200,36600,0,62800
141640200800000,NE 146,RESIDENTIAL,25900,0,25900,72400,0,98300
141640200900000,NE 146,RESIDENTIAL,22000,0,22000,75400,0,97400
141640201000000,NE 146,RESIDENTIAL,21200,0,21200,39200,0,60400
141640201100000,NE 146,RESIDENTIAL,27800,0,27800,47700,0,75500
141640201200000,NE 146,RESIDENTIAL,26400,0,26400,28800,0,55200
141640201300000,NE 146,RESIDENTIAL,13700,0,13700,67900,0,81600
141640201400000,NE 146,RESIDENTIAL,15400,0,15400,52400,0,67800
141640201500000,NE 146,RESIDENTIAL,20200,0,20200,65600,0,85800
141640201600000,NE 146,RESIDENTIAL,16800,0,16800,70100,0,86900
141640201700000,NE 146,RESIDENTIAL,13400,0,13400,46700,0,60100
141640201800000,NE 146,RESIDENTIAL,13400,0,13400,54900,0,68300
141640201900000,NE 146,RESIDENTIAL,21200,0,21200,170500,0,191700
141640202000000,NE 146,RESIDENTIAL,14700,0,14700,62000,0,76700
141640202100000,NE 146,RESIDENTIAL,23100,0,23100,79600,0,102700
141640202200000,NE 146,RESIDENTIAL,22700,0,22700,49400,0,72100
141640202300000,NE 146,RESIDENTIAL,22700,0,22700,57900,0,80600
141640202400000,NE 146,RESIDENTIAL,24000,0,24000,94600,0,118600
141640202500000,NE 146,RESIDENTIAL,20400,0,20400,47200,0,67600
141640202600000,NE 146,RESIDENTIAL,22900,0,22900,64800,0,87700
141640202700000,NE 146,RESIDENTIAL,22900,0,22900,76900,0,99800
141640202800000,NE 146,RESIDENTIAL,22400,0,22400,97900,0,120300
141640300100000,NE 146,RESIDENTIAL,24000,0,24000,64000,0,88000
141640300200000,SMALL RETAIL,COMMERCIAL,0,23200,23200,0,67800,91000
141640300300000,NE 146,RESIDENTIAL,14100,0,14100,30300,0,44400
141640300400000,NE 146,RESIDENTIAL,14100,0,14100,0,0,14100
141640300500000,NE 146,RESIDENTIAL,14100,0,14100,42200,0,56300
141640300600000,NE 146,RESIDENTIAL,14100,0,14100,0,0,14100
141640300700000,NE 146,RESIDENTIAL,14100,0,14100,53500,0,67600
141640300800000,NE 146,RESIDENTIAL,14100,0,14100,84400,0,98500
141640300900000,NE 146,RESIDENTIAL,14100,0,14100,45300,0,59400
141640301000000,NE 146,RESIDENTIAL,14100,0,14100,68700,0,82800
141640301100000,NE 146,RESIDENTIAL,14100,0,14100,24600,0,38700
141640301200000,NE 146,RESIDENTIAL,14100,0,14100,51300,0,65400
141640301300000,NE 146,RESIDENTIAL,14100,0,14100,52800,0,66900
141640301400000,NE 146,RESIDENTIAL,10600,0,10600,52900,0,63500
141640301500000,NE 146,RESIDENTIAL,10600,0,10600,37900,0,48500
141640301600000,NE 146,RESIDENTIAL,14100,0,14100,49300,0,63400
141640301700000,NE 146,RESIDENTIAL,13100,0,13100,45000,0,58100
141640301800000,NE 146,RESIDENTIAL,17300,0,17300,56600,0,73900
141640301900000,NE 146,RESIDENTIAL,13100,0,13100,48800,0,61900
141640302000000,NE 146,RESIDENTIAL,15700,0,15700,41600,0,57300
141640302100000,NE 146,RESIDENTIAL,15700,0,15700,50900,0,66600
141640302200000,NE 146,RESIDENTIAL,24200,0,24200,72100,0,96300
141640302300000,NE 146,RESIDENTIAL,12100,0,12100,54800,0,66900
141640302400000,NE 146,RESIDENTIAL,12100,0,12100,46400,0,58500
141640302500000,NE 146,RESIDENTIAL,24200,0,24200,65500,0,89700
141640302600000,NE 146,RESIDENTIAL,16200,0,16200,34600,0,50800
141640302700000,NE 146,RESIDENTIAL,16200,0,16200,60200,0,76400
141640302800000,NE 146,RESIDENTIAL,16200,0,16200,28100,0,44300
141640302900000,NE 146,RESIDENTIAL,16200,0,16200,48900,0,65100
141640303000000,NE 146,RESIDENTIAL,16200,0,16200,77500,0,93700
141640303100000,NE 146,RESIDENTIAL,16200,0,16200,77000,0,93200
141640303200000,NE 146,RESIDENTIAL,16200,0,16200,47900,0,64100
141640303300000,NE 146,RESIDENTIAL,16200,0,16200,57500,0,73700
141640303400000,NE 146,RESIDENTIAL,16200,0,16200,54300,0,70500
141640400100000,NE 146,RESIDENTIAL,17300,0,17300,57100,0,74400
141640400200000,NE 146,RESIDENTIAL,14400,0,14400,113300,0,127700
141640400300000,NE 146,RESIDENTIAL,14700,0,14700,63900,0,78600
141640400400000,NE 146,RESIDENTIAL,17100,0,17100,58300,0,75400
141640400500000,NE 146,RESIDENTIAL,16400,0,16400,42600,0,59000
141640400600000,NE 146,RESIDENTIAL,16400,0,16400,50900,0,67300
141640400700000,NE 146,RESIDENTIAL,15200,0,15200,60100,0,75300
141640400800000,NE 146,RESIDENTIAL,17000,0,17000,47800,0,64800
141640400900000,NE 146,RESIDENTIAL,26000,0,26000,60900,0,86900
141640401000000,NE 146,RESIDENTIAL,26000,0,26000,60000,0,86000
141640401100000,NE 146,RESIDENTIAL,17100,0,17100,65200,0,82300
141640401200000,NE 146,RESIDENTIAL,17100,0,17100,78100,0,95200
141640401300000,NE 146,RESIDENTIAL,17100,0,17100,45200,0,62300
141640401400000,NE 146,RESIDENTIAL,17300,0,17300,59600,0,76900
141640401500000,NE 146,RESIDENTIAL,17100,0,17100,53700,0,70800
141640401600000,NE 146,RESIDENTIAL,15200,0,15200,56200,0,71400
141640401700000,NE 146,RESIDENTIAL,15200,0,15200,57600,0,72800
141640401800000,NE 146,RESIDENTIAL,14800,0,14800,44800,0,59600
141640401900000,NE 146,RESIDENTIAL,14600,0,14600,60300,0,74900
141640402000000,SMALL RETAIL,COMMERCIAL,19824,62776,82600,25416,80484,188500
141640402100000,NE 146,RESIDENTIAL,15000,0,15000,36000,0,51000
141640402200000,NE 146,RESIDENTIAL,24100,0,24100,60300,0,84400
141640402300000,NE 146,RESIDENTIAL,15000,0,15000,28000,0,43000
141640402400000,NE 146,RESIDENTIAL,15000,0,15000,59700,0,74700
141640402500000,NE 146,RESIDENTIAL,15400,0,15400,70400,0,85800
141640402600000,NE 146,RESIDENTIAL,15500,0,15500,60900,0,76400
141640402700000,NE 146,RESIDENTIAL,15000,0,15000,89700,0,104700
141640402800000,NE 146,RESIDENTIAL,15000,0,15000,82600,0,97600
141640402900000,NE 146,RESIDENTIAL,16800,0,16800,47500,0,64300
141640500100000,NE 146,RESIDENTIAL,9800,0,9800,19100,0,28900
141640500200000,NE 146,RESIDENTIAL,13600,0,13600,56400,0,70000
141640500300000,NE 146,RESIDENTIAL,7900,0,7900,43200,0,51100
141640500400000,NE 146,RESIDENTIAL,13700,0,13700,57400,0,71100
141640500500000,NE 146,RESIDENTIAL,14100,0,14100,40100,0,54200
141640500600000,NE 146,RESIDENTIAL,14100,0,14100,54600,0,68700
141640500700000,NE 146,RESIDENTIAL,14100,0,14100,52000,0,66100
141640500800000,NE 146,RESIDENTIAL,14100,0,14100,68900,0,83000
141640500900000,NE 146,RESIDENTIAL,14100,0,14100,53200,0,67300
141640501000000,NE 146,RESIDENTIAL,14100,0,14100,58500,0,72600
141640501100000,NE 146,RESIDENTIAL,14100,0,14100,50600,0,64700
141640501200000,NE 146,RESIDENTIAL,14100,0,14100,54300,0,68400
141640501300000,NE 146,RESIDENTIAL,14100,0,14100,29300,0,43400
141640501400000,NE 146,RESIDENTIAL,14100,0,14100,49800,0,63900
141640501500000,NE 146,RESIDENTIAL,14100,0,14100,68100,0,82200
141640501600000,NE 146,RESIDENTIAL,14100,0,14100,38500,0,52600
141640501700000,NE 146,RESIDENTIAL,12300,0,12300,41200,0,53500
141640501800000,NE 146,RESIDENTIAL,27000,0,27000,61300,0,88300
141640501900000,NE 146,RESIDENTIAL,15500,0,15500,56900,0,72400
141640502000000,NE 146,RESIDENTIAL,18400,0,18400,91700,0,110100
141640502100000,NE 146,RESIDENTIAL,18400,0,18400,64200,0,82600
141640502200000,NE 146,RESIDENTIAL,18400,0,18400,61400,0,79800
141640502300000,NE 146,RESIDENTIAL,18400,0,18400,62300,0,80700
141640502400000,NE 146,RESIDENTIAL,24500,0,24500,103900,0,128400
141640502500000,NE 146,RESIDENTIAL,24500,0,24500,61900,0,86400
141640502600000,NE 146,RESIDENTIAL,24500,0,24500,55900,0,80400
141640502700000,NE 146,RESIDENTIAL,11600,0,11600,37500,0,49100
141642600100000,BARS/LOUNGE,COMMERCIAL,12096,32704,44800,26001,70299,141100
141642600200000,NE 146,RESIDENTIAL,14000,0,14000,49300,0,63300
141642600300000,NE 146,RESIDENTIAL,14000,0,14000,42700,0,56700
141642600400000,NE 146,RESIDENTIAL,14000,0,14000,39000,0,53000
141642600500000,NE 146,RESIDENTIAL,13200,0,13200,27400,0,40600
141642600600000,NE 146,RESIDENTIAL,14000,0,14000,39000,0,53000
141642600700000,NE 146,RESIDENTIAL,14000,0,14000,44600,0,58600
141642600800000,NE 146,RESIDENTIAL,14000,0,14000,38800,0,52800
141642600900000,NE 146,RESIDENTIAL,14000,0,14000,38300,0,52300
141642601000000,NE 146,RESIDENTIAL,14000,0,14000,39000,0,53000
141642601100000,NE 146,RESIDENTIAL,14000,0,14000,45000,0,59000
141642601200000,NE 146,RESIDENTIAL,14000,0,14000,0,0,14000
141642601300000,NE 146,RESIDENTIAL,14000,0,14000,75400,0,89400
141642601400000,NE 146,RESIDENTIAL,14000,0,14000,26300,0,40300
141642601500000,NE 146,RESIDENTIAL,14000,0,14000,47500,0,61500
141642601600000,NE 146,RESIDENTIAL,14000,0,14000,40300,0,54300
141642601700000,NE 146,RESIDENTIAL,14000,0,14000,54300,0,68300
141642601800000,NE 146,RESIDENTIAL,14000,0,14000,58700,0,72700
141642601900000,NE 146,RESIDENTIAL,4200,0,4200,28700,0,32900
141642602000000,NE 146,RESIDENTIAL,9800,0,9800,36100,0,45900
141642602100000,NE 146,RESIDENTIAL,14000,0,14000,58100,0,72100
141642602200000,NE 146,RESIDENTIAL,14000,0,14000,50600,0,64600
141642602300000,NE 146,RESIDENTIAL,14000,0,14000,42800,0,56800
141642602400000,NE 146,RESIDENTIAL,14000,0,14000,54500,0,68500
141642602500000,NE 146,RESIDENTIAL,14000,0,14000,26200,0,40200
141642602600000,NE 146,RESIDENTIAL,14000,0,14000,52200,0,66200
141642602700000,NE 146,RESIDENTIAL,14000,0,14000,53100,0,67100
141642602800000,NE 146,RESIDENTIAL,14000,0,14000,39900,0,53900
141642602900000,NE 146,RESIDENTIAL,14000,0,14000,35300,0,49300
141642603000000,NE 146,RESIDENTIAL,14000,0,14000,42900,0,56900
141642603100000,NE 146,RESIDENTIAL,14000,0,14000,55100,0,69100
141642603200000,NE 146,RESIDENTIAL,14000,0,14000,44900,0,58900
141642603300000,NE 146,RESIDENTIAL,13200,0,13200,45400,0,58600
141642603400000,NE 146,RESIDENTIAL,14000,0,14000,41700,0,55700
141642700100000,NE 146,RESIDENTIAL,14000,0,14000,44400,0,58400
141642700200000,MATERIALS MFG;INDUST,INDUSTRIAL,0,96900,96900,0,613900,710800
141642700300000,NE 146,RESIDENTIAL,16800,0,16800,30500,0,47300
141642700400000,NE 146,RESIDENTIAL,14000,0,14000,56700,0,70700
141642700500000,NE 146,RESIDENTIAL,11800,0,11800,49500,0,61300
141642700600000,NE 146,RESIDENTIAL,14000,0,14000,54900,0,68900
141642700700000,NE 146,RESIDENTIAL,14000,0,14000,83800,0,97800
141642700800000,NE 146,RESIDENTIAL,14000,0,14000,29600,0,43600
141642800100000,VACANT LAND,COMMERCIAL,0,21300,21300,0,0,21300
141642800200000,NE 146,RESIDENTIAL,14400,0,14400,73700,0,88100
141642800300000,SHOP,COMMERCIAL,0,22000,22000,0,89600,111600
141642800400000,WAREHOUSE,COMMERCIAL,0,19600,19600,0,53100,72700
141642800500000,VETERINARY CLINIC,COMMERCIAL,0,52100,52100,0,108400,160500
141642800600000,NE 146,RESIDENTIAL,14400,0,14400,40300,0,54700
141642800700000,NE 146,RESIDENTIAL,12000,0,12000,14200,0,26200
141642800800000,NE 146,RESIDENTIAL,12000,0,12000,21000,0,33000
141642800900000,WAREHOUSE,COMMERCIAL,0,18800,18800,0,80100,98900
141642801000000,MATERIALS MFG;INDUST,INDUSTRIAL,0,38100,38100,0,8100,46200
141642900100000,CONVERSION-NE/SE,MULTI-RES,14000,0,14000,42600,0,56600
141642900200000,NE 146,RESIDENTIAL,14600,0,14600,62800,0,77400
141642900300000,NE 146,RESIDENTIAL,16500,0,16500,55800,0,72300
141642900400000,NE 146,RESIDENTIAL,14500,0,14500,26800,0,41300
141642900500000,NE 146,RESIDENTIAL,14400,0,14400,47000,0,61400
141642900600000,NE 146,RESIDENTIAL,14600,0,14600,54300,0,68900
141642900700000,NE 146,RESIDENTIAL,14000,0,14000,33900,0,47900
141642900800000,NE 146,RESIDENTIAL,16800,0,16800,38000,0,54800
141642900900000,NE 146,RESIDENTIAL,11800,0,11800,27700,0,39500
141642901000000,NE 146,RESIDENTIAL,14000,0,14000,55100,0,69100
141642901100000,NE 146,RESIDENTIAL,14000,0,14000,65100,0,79100
141642901200000,NE 146,RESIDENTIAL,14000,0,14000,31900,0,45900
141643000100000,SHOP,COMMERCIAL,0,25900,25900,0,48800,74700
141643000200000,NE 146,RESIDENTIAL,14400,0,14400,55000,0,69400
141643000300000,WAREHOUSE,COMMERCIAL,0,16800,16800,0,54700,71500
141643000400000,NE 146,RESIDENTIAL,12000,0,12000,23600,0,35600
141643000600000,WAREHOUSE,COMMERCIAL,0,64600,64600,0,191500,256100
141643000900000,SHOP,COMMERCIAL,0,38500,38500,0,109800,148300
141643001000000,NE 146,RESIDENTIAL,18200,0,18200,52300,0,70500
141643100100000,NE 146,RESIDENTIAL,14000,0,14000,75000,0,89000
141643100200000,NE 146,RESIDENTIAL,14000,0,14000,44000,0,58000
141643100500000,NE 146,RESIDENTIAL,14000,0,14000,53200,0,67200
141643100600000,NE 146,RESIDENTIAL,16800,0,16800,28200,0,45000
141643100700000,NE 146,RESIDENTIAL,14000,0,14000,46500,0,60500
141643100800000,NE 146,RESIDENTIAL,14000,0,14000,48100,0,62100
141643100900000,NE 146,RESIDENTIAL,14000,0,14000,59200,0,73200
141643101000000,NE 146,RESIDENTIAL,14000,0,14000,74600,0,88600
141643101100000,NE 146,RESIDENTIAL,16800,0,16800,59500,0,76300
141643101200000,NE 146,RESIDENTIAL,14000,0,14000,50600,0,64600
141643101300000,NE 146,RESIDENTIAL,14000,0,14000,43800,0,57800
141643101400000,NE 146,RESIDENTIAL,14000,0,14000,30600,0,44600
141643101500000,NE 146,RESIDENTIAL,14000,0,14000,55000,0,69000
141643101600000,NE 146,RESIDENTIAL,14000,0,14000,55000,0,69000
141643101900000,NE 146,RESIDENTIAL,14000,0,14000,40200,0,54200
141643102000000,NE 146,RESIDENTIAL,14000,0,14000,43400,0,57400
141643102100000,NE 146,RESIDENTIAL,14000,0,14000,107800,0,121800
141643102200000,NE 146,RESIDENTIAL,14000,0,14000,70000,0,84000
141643102300000,NE 146,RESIDENTIAL,14000,0,14000,42600,0,56600
141643102400000,NE 146,RESIDENTIAL,14000,0,14000,45100,0,59100
141643102500000,NE 146,RESIDENTIAL,14000,0,14000,47600,0,61600
141643102600000,NE 146,RESIDENTIAL,14000,0,14000,40900,0,54900
141643102700000,NE 146,RESIDENTIAL,14000,0,14000,91800,0,105800
141643102800000,NE 146,RESIDENTIAL,16800,0,16800,54200,0,71000
141643200100000,NE 146,RESIDENTIAL,15800,0,15800,55600,0,71400
141643200200000,NE 146,RESIDENTIAL,14200,0,14200,47300,0,61500
141643200300000,NE 146,RESIDENTIAL,14000,0,14000,52400,0,66400
141643200400000,NE 146,RESIDENTIAL,15400,0,15400,57500,0,72900
141643200500000,NE 146,RESIDENTIAL,17100,0,17100,33000,0,50100
141643200600000,NE 146,RESIDENTIAL,14000,0,14000,37500,0,51500
141643200700000,NE 146,RESIDENTIAL,14200,0,14200,63500,0,77700
141643200800000,NE 146,RESIDENTIAL,14000,0,14000,54800,0,68800
141643200900000,NE 146,RESIDENTIAL,14000,0,14000,40700,0,54700
141643201000000,NE 146,RESIDENTIAL,14000,0,14000,42100,0,56100
141643201100000,NE 146,RESIDENTIAL,13100,0,13100,49200,0,62300
141643201200000,NE 146,RESIDENTIAL,15800,0,15800,56500,0,72300
141643300100000,WAREHOUSE,COMMERCIAL,0,27100,27100,0,66100,93200
141643300200000,SHOP,COMMERCIAL,0,14400,14400,0,65200,79600
141643300300000,SHOP,COMMERCIAL,0,36000,36000,0,75700,111700
141643300400000,NE 146,RESIDENTIAL,11200,0,11200,34900,0,46100
141643300500000,NE 146,RESIDENTIAL,12000,0,12000,50700,0,62700
141643300600000,NE 146,RESIDENTIAL,17100,0,17100,72800,0,89900
141643300700000,SHOP,COMMERCIAL,0,119400,119400,0,123100,242500
141643300800000,VACANT LAND,COMMERCIAL,0,1100,1100,0,0,1100
141643300900000,VACANT LAND,COMMERCIAL,0,22500,22500,0,0,22500
141643400100000,NE 146,RESIDENTIAL,16800,0,16800,4100,0,20900
141643400200000,OFFICE; MEDICAL,COMMERCIAL,0,144000,144000,0,942100,1086100
141643400300000,NE 146,RESIDENTIAL,14000,0,14000,38500,0,52500
141643400400000,NE 146,RESIDENTIAL,14000,0,14000,0,0,14000
141643400500000,NE 146,RESIDENTIAL,17600,0,17600,0,0,17600
141645100100000,CONVERSION-NE/SE,MULTI-RES,16600,0,16600,43400,0,60000
141645100200000,NE 146,RESIDENTIAL,14000,0,14000,47300,0,61300
141645200100000,NE 146,RESIDENTIAL,14000,0,14000,23500,0,37500
141645300100000,NE 146,RESIDENTIAL,12600,0,12600,47500,0,60100
141645300200000,NE 146,RESIDENTIAL,12300,0,12300,44900,0,57200
141645300300000,NE 146,RESIDENTIAL,13200,0,13200,36600,0,49800
141645300400000,NE 146,RESIDENTIAL,12300,0,12300,42100,0,54400
141645300500000,NE 146,RESIDENTIAL,14000,0,14000,49000,0,63000
141645300600000,NE 146,RESIDENTIAL,14000,0,14000,9400,0,23400
141645300700000,NE 146,RESIDENTIAL,14000,0,14000,31500,0,45500
141645300800000,NE 146,RESIDENTIAL,14000,0,14000,45500,0,59500
141645300900000,NE 146,RESIDENTIAL,14000,0,14000,52200,0,66200
141645301000000,NE 146,RESIDENTIAL,14000,0,14000,43700,0,57700
141645301100000,NE 146,RESIDENTIAL,14000,0,14000,0,0,14000
141645301200000,NE 146,RESIDENTIAL,14000,0,14000,35300,0,49300
141645301300000,NE 146,RESIDENTIAL,14000,0,14000,37300,0,51300
141645301400000,NE 146,RESIDENTIAL,14000,0,14000,86100,0,100100
141645301500000,NE 146,RESIDENTIAL,14000,0,14000,35900,0,49900
141645301600000,NE 146,RESIDENTIAL,14000,0,14000,24700,0,38700
141645301700000,NE 146,RESIDENTIAL,14000,0,14000,52600,0,66600
141645301800000,NE 146,RESIDENTIAL,14000,0,14000,39500,0,53500
141645301900000,NE 146,RESIDENTIAL,16100,0,16100,43200,0,59300
141645302000000,NE 146,RESIDENTIAL,5700,0,5700,30700,0,36400
141645302100000,BARS/LOUNGE,COMMERCIAL,0,28000,28000,0,118000,146000
141645302200000,NE 146,RESIDENTIAL,14000,0,14000,75500,0,89500
141645302300000,NE 146,RESIDENTIAL,14000,0,14000,61000,0,75000
141645302400000,NE 146,RESIDENTIAL,14000,0,14000,44400,0,58400
141645302500000,NE 146,RESIDENTIAL,14000,0,14000,29800,0,43800
141645302600000,NE 146,RESIDENTIAL,14000,0,14000,43300,0,57300
141645302700000,NE 146,RESIDENTIAL,14000,0,14000,53300,0,67300
141645302800000,NE 146,RESIDENTIAL,14000,0,14000,44600,0,58600
141645302900000,NE 146,RESIDENTIAL,14000,0,14000,53800,0,67800
141645303000000,NE 146,RESIDENTIAL,14000,0,14000,66500,0,80500
141645303100000,NE 146,RESIDENTIAL,14000,0,14000,38300,0,52300
141645303200000,NE 146,RESIDENTIAL,14000,0,14000,64500,0,78500
141645303300000,NE 146,RESIDENTIAL,14000,0,14000,68100,0,82100
141645303400000,NE 146,RESIDENTIAL,14000,0,14000,31800,0,45800
141645303500000,NE 146,RESIDENTIAL,14000,0,14000,51900,0,65900
141645400100000,NE 146,RESIDENTIAL,15800,0,15800,48800,0,64600
141645400200000,NE 146,RESIDENTIAL,16100,0,16100,76500,0,92600
141645400300000,NE 146,RESIDENTIAL,18600,0,18600,88400,0,107000
141645400400000,NE 146,RESIDENTIAL,18400,0,18400,38500,0,56900
141645400500000,WAREHOUSE;MINI STORG,COMMERCIAL,0,30800,30800,0,51900,82700
141645400600000,WAREHOUSE;MINI STORG,COMMERCIAL,0,16900,16900,0,62700,79600
141645400700000,NE 146,RESIDENTIAL,15800,0,15800,36300,0,52100
141645400800000,NE 146,RESIDENTIAL,15800,0,15800,58400,0,74200
141645400900000,NE 146,RESIDENTIAL,14000,0,14000,55800,0,69800
141645401000000,NE 146,RESIDENTIAL,14000,0,14000,42300,0,56300
141645401100000,NE 146,RESIDENTIAL,14000,0,14000,43500,0,57500
141645401200000,NE 146,RESIDENTIAL,15800,0,15800,44400,0,60200
141645500100000,NE 146,RESIDENTIAL,15800,0,15800,73400,0,89200
141645500400000,NE 146,RESIDENTIAL,15800,0,15800,69200,0,85000
141645500500000,NE 146,RESIDENTIAL,15800,0,15800,52100,0,67900
141645500600000,NE 146,RESIDENTIAL,14000,0,14000,48100,0,62100
141645500700000,CONVERSION-NE/SE,MULTI-RES,16800,0,16800,15000,0,31800
141645500800000,NE 146,RESIDENTIAL,8000,0,8000,0,0,8000
141645500900000,WAREHOUSE,COMMERCIAL,0,48400,48400,0,43100,91500
141645600100000,AUTO REPAIR/SALES,COMMERCIAL,0,50400,50400,0,40900,91300
141645600200000,NE 146,RESIDENTIAL,16600,0,16600,49800,0,66400
141645600300000,NE 146,RESIDENTIAL,14000,0,14000,118200,0,132200
141645600400000,NE 146,RESIDENTIAL,6000,0,6000,0,0,6000
141645600500000,NE 146,RESIDENTIAL,6000,0,6000,0,0,6000
141645600600000,NE 146,RESIDENTIAL,14000,0,14000,28700,0,42700
141645600700000,NE 146,RESIDENTIAL,14000,0,14000,43800,0,57800
141645600800000,NE 146,RESIDENTIAL,17300,0,17300,53700,0,71000
141645600900000,NE 146,RESIDENTIAL,20300,0,20300,33100,0,53400
141645601000000,NE 146,RESIDENTIAL,14000,0,14000,30500,0,44500
141645601100000,NE 146,RESIDENTIAL,14000,0,14000,33700,0,47700
141645601200000,NE 146,RESIDENTIAL,14000,0,14000,41900,0,55900
141645601300000,NE 146,RESIDENTIAL,14000,0,14000,41500,0,55500
141645700100000,NE 146,RESIDENTIAL,16500,0,16500,38600,0,55100
141645700200000,NE 146,RESIDENTIAL,18200,0,18200,44100,0,62300
141645700300000,CITY PROPERTY,EXEMPT,0,0,0,0,0,0
141645700400000,NE 146,RESIDENTIAL,7000,0,7000,30800,0,37800
141645700500000,NE 146,RESIDENTIAL,9600,0,9600,0,0,9600
141645700600000,CENTRALLY ASSESSED,OTHER,0,0,0,0,0,0
141645800100000,WAREHOUSE,COMMERCIAL,0,88100,88100,0,145000,233100
141645800200000,WAREHOUSE,COMMERCIAL,0,48600,48600,0,184400,233000
141645900100000,CITY PROPERTY,EXEMPT,0,0,0,0,0,0
141645900200000,CITY PROPERTY,EXEMPT,0,0,0,0,0,0
141645900300000,CITY PROPERTY,EXEMPT,0,0,0,0,0,0
141645900400000,CITY PROPERTY,EXEMPT,0,0,0,0,0,0
141645900500000,CITY PROPERTY,EXEMPT,0,0,0,0,0,0
141645900600000,SHOP,COMMERCIAL,0,38400,38400,0,38300,76700
141645900700000,CITY PROPERTY,EXEMPT,0,0,0,0,0,0
141645901100000,SHOP,COMMERCIAL,0,62800,62800,0,252800,315600
141645901200000,FLAT PARKING,COMMERCIAL,0,36400,36400,0,13300,49700
141645901300000,CITY PROPERTY,EXEMPT,0,0,0,0,0,0
141645901400000,CENTRALLY ASSESSED,OTHER,0,0,0,0,0,0
141645901500000,CENTRALLY ASSESSED,OTHER,0,0,0,0,0,0
141645901600000,CENTRALLY ASSESSED,OTHER,0,0,0,0,0,0
141645901700000,CENTRALLY ASSESSED,OTHER,0,0,0,0,0,0
141645901800000,RESTAURANT,COMMERCIAL,0,100600,100600,0,113500,214100
141647600100000,NE 146,RESIDENTIAL,8900,0,8900,30900,0,39800
141647600200000,NE 146,RESIDENTIAL,9100,0,9100,32700,0,41800
141647600300000,NE 146,RESIDENTIAL,9700,0,9700,30100,0,39800
141647600400000,NE 146,RESIDENTIAL,6500,0,6500,0,0,6500
141647600500000,NE 146,RESIDENTIAL,14000,0,14000,35600,0,49600
141647600600000,NE 146,RESIDENTIAL,14000,0,14000,38300,0,52300
141647600700000,NE 146,RESIDENTIAL,14000,0,14000,32300,0,46300
141647600800000,NE 146,RESIDENTIAL,13900,0,13900,40200,0,54100
141647600900000,NE 146,RESIDENTIAL,13900,0,13900,29900,0,43800
141647601000000,NE 146,RESIDENTIAL,13900,0,13900,0,0,13900
141647601100000,NE 146,RESIDENTIAL,16600,0,16600,45000,0,61600
141647601200000,NE 146,RESIDENTIAL,13700,0,13700,21000,0,34700
141647601300000,NE 146,RESIDENTIAL,13700,0,13700,32900,0,46600
141647601400000,NE 146,RESIDENTIAL,13700,0,13700,0,0,13700
141647601500000,NE 146,RESIDENTIAL,13600,0,13600,40400,0,54000
141647601600000,NE 146,RESIDENTIAL,13600,0,13600,35400,0,49000
141647601700000,NE 146,RESIDENTIAL,13400,0,13400,35600,0,49000
141647601800000,NE 146,RESIDENTIAL,13400,0,13400,44300,0,57700
141647601900000,VACANT LAND,COMMERCIAL,0,13100,13100,0,0,13100
141647602000000,FLAT PARKING,COMMERCIAL,0,12600,12600,0,2600,15200
141647602100000,FLAT PARKING,COMMERCIAL,0,11900,11900,0,3400,15300
141647602200000,FLAT PARKING,COMMERCIAL,0,10800,10800,0,2200,13000
141647602300000,WAREHOUSE,COMMERCIAL,0,93400,93400,0,468100,561500
141647700100000,NE 146,RESIDENTIAL,10600,0,10600,43400,0,54000
141647700200000,NE 146,RESIDENTIAL,9900,0,9900,41900,0,51800
141647700300000,NE 146,RESIDENTIAL,11900,0,11900,50000,0,61900
141647700400000,NE 146,RESIDENTIAL,19200,0,19200,89800,0,109000
141647700500000,NE 146,RESIDENTIAL,14000,0,14000,71800,0,85800
141647700600000,NE 146,RESIDENTIAL,14000,0,14000,67200,0,81200
141647700700000,NE 146,RESIDENTIAL,14000,0,14000,61500,0,75500
141647700800000,NE 146,RESIDENTIAL,14000,0,14000,51400,0,65400
141647700900000,NE 146,RESIDENTIAL,14000,0,14000,68100,0,82100
141647701000000,NE 146,RESIDENTIAL,14000,0,14000,70400,0,84400
141647701100000,NE 146,RESIDENTIAL,14000,0,14000,73400,0,87400
141647701200000,NE 146,RESIDENTIAL,14000,0,14000,45400,0,59400
141647701300000,NE 146,RESIDENTIAL,14000,0,14000,73600,0,87600
141647701400000,NE 146,RESIDENTIAL,14000,0,14000,63900,0,77900
141647701500000,NE 146,RESIDENTIAL,14000,0,14000,62600,0,76600
141647701600000,NE 146,RESIDENTIAL,14000,0,14000,59400,0,73400
141647701700000,NE 146,RESIDENTIAL,14000,0,14000,57200,0,71200
141647701800000,NE 146,RESIDENTIAL,14000,0,14000,55700,0,69700
141647701900000,NE 146,RESIDENTIAL,14000,0,14000,33400,0,47400
141647702000000,NE 146,RESIDENTIAL,14000,0,14000,41700,0,55700
141647702100000,NE 146,RESIDENTIAL,14000,0,14000,67300,0,81300
141647702200000,NE 146,RESIDENTIAL,14000,0,14000,80500,0,94500
141647702300000,NE 146,RESIDENTIAL,14000,0,14000,57500,0,71500
141647702400000,NE 146,RESIDENTIAL,12300,0,12300,40500,0,52800
141647702500000,NE 146,RESIDENTIAL,12900,0,12900,33700,0,46600
141647702600000,NE 146,RESIDENTIAL,11300,0,11300,37000,0,48300
141647702900000,NE 146,RESIDENTIAL,10300,0,10300,33700,0,44000
141647703000000,NE 146,RESIDENTIAL,13800,0,13800,36200,0,50000
141647703100000,NE 146,RESIDENTIAL,9800,0,9800,37800,0,47600
141647703200000,NE 146,RESIDENTIAL,14000,0,14000,40100,0,54100
141647703300000,NE 146,RESIDENTIAL,14000,0,14000,46000,0,60000
141647703400000,NE 146,RESIDENTIAL,14000,0,14000,0,0,14000
141647703500000,NE 146,RESIDENTIAL,14000,0,14000,17600,0,31600
141647703600000,NE 146,RESIDENTIAL,14000,0,14000,47200,0,61200
141647703700000,NE 146,RESIDENTIAL,16800,0,16800,46500,0,63300
141647703800000,NE 146,RESIDENTIAL,14000,0,14000,55000,0,69000
141647703900000,NE 146,RESIDENTIAL,14000,0,14000,40200,0,54200
141647704000000,NE 146,RESIDENTIAL,14000,0,14000,51000,0,65000
141647704100000,NE 146,RESIDENTIAL,14000,0,14000,40600,0,54600
141647704200000,NE 146,RESIDENTIAL,14000,0,14000,42000,0,56000
141647704300000,NE 146,RESIDENTIAL,14000,0,14000,48800,0,62800
141647704400000,NE 146,RESIDENTIAL,14000,0,14000,39700,0,53700
141647704500000,NE 146,RESIDENTIAL,14000,0,14000,48600,0,62600
141647704600000,NE 146,RESIDENTIAL,14000,0,14000,21700,0,35700
141647704700000,NE 146,RESIDENTIAL,14000,0,14000,40800,0,54800
141647704800000,NE 146,RESIDENTIAL,12600,0,12600,0,0,12600
141647704900000,NE 146,RESIDENTIAL,9800,0,9800,59000,0,68800
141647705000000,NE 146,RESIDENTIAL,10200,0,10200,54100,0,64300
141647800100000,NE 146,RESIDENTIAL,15200,0,15200,50100,0,65300
141647900100000,NE 146,RESIDENTIAL,21100,0,21100,44700,0,65800
141647900200000,NE 146,RESIDENTIAL,11600,0,11600,46300,0,57900
141647900300000,NE 146,RESIDENTIAL,12000,0,12000,56800,0,68800
141647900400000,NE 146,RESIDENTIAL,12300,0,12300,57600,0,69900
141648000100000,NE 146,RESIDENTIAL,25400,0,25400,82600,0,108000
141648000200000,NE 146,RESIDENTIAL,14100,0,14100,50800,0,64900
141648000300000,NE 146,RESIDENTIAL,15400,0,15400,70300,0,85700
141648000400000,NE 146,RESIDENTIAL,18400,0,18400,71700,0,90100
141648000500000,NE 146,RESIDENTIAL,15000,0,15000,66900,0,81900
141648000600000,NE 146,RESIDENTIAL,15000,0,15000,46700,0,61700
141648000700000,NE 146,RESIDENTIAL,22300,0,22300,73700,0,96000
141648000800000,NE 146,RESIDENTIAL,22300,0,22300,48900,0,71200
141648000900000,NE 146,RESIDENTIAL,14500,0,14500,25600,0,40100
141648001000000,NE 146,RESIDENTIAL,22500,0,22500,67100,0,89600
141648001100000,NE 146,RESIDENTIAL,22500,0,22500,58500,0,81000
141648001200000,NE 146,RESIDENTIAL,15000,0,15000,44300,0,59300
141648001300000,NE 146,RESIDENTIAL,14300,0,14300,58400,0,72700
141648001400000,NE 146,RESIDENTIAL,14600,0,14600,43200,0,57800
141648001500000,NE 146,RESIDENTIAL,14600,0,14600,60400,0,75000
141648001600000,NE 146,RESIDENTIAL,15000,0,15000,49900,0,64900
141648001700000,NE 146,RESIDENTIAL,22200,0,22200,72400,0,94600
141648001800000,NE 146,RESIDENTIAL,22200,0,22200,66700,0,88900
141648001900000,NE 146,RESIDENTIAL,14100,0,14100,45400,0,59500
141648002000000,NE 146,RESIDENTIAL,15100,0,15100,58900,0,74000
141648002100000,NE 146,RESIDENTIAL,15100,0,15100,75500,0,90600
141648002200000,NE 146,RESIDENTIAL,19800,0,19800,61300,0,81100
141648002300000,NE 146,RESIDENTIAL,18900,0,18900,59900,0,78800
141648002400000,NE 146,RESIDENTIAL,18900,0,18900,48900,0,67800
141648002500000,NE 146,RESIDENTIAL,18800,0,18800,47500,0,66300
141648002600000,NE 146,RESIDENTIAL,14000,0,14000,64900,0,78900
141648002700000,NE 146,RESIDENTIAL,14000,0,14000,62200,0,76200
141648002800000,NE 146,RESIDENTIAL,21000,0,21000,63600,0,84600
141648002900000,NE 146,RESIDENTIAL,15100,0,15100,56000,0,71100
141648003000000,NE 146,RESIDENTIAL,15100,0,15100,65100,0,80200
141648003100000,NE 146,RESIDENTIAL,14100,0,14100,73800,0,87900
141648003200000,NE 146,RESIDENTIAL,22200,0,22200,70100,0,92300
141648003300000,NE 146,RESIDENTIAL,22200,0,22200,38400,0,60600
141648003400000,APARTMENT,MULTI-RES,20900,0,20900,85700,0,106600
141648003500000,NE 146,RESIDENTIAL,22100,0,22100,36900,0,59000
141648003600000,NE 146,RESIDENTIAL,14300,0,14300,80500,0,94800
141648003700000,NE 146,RESIDENTIAL,15000,0,15000,59200,0,74200
141648003800000,NE 146,RESIDENTIAL,15000,0,15000,37400,0,52400
141648003900000,NE 146,RESIDENTIAL,14100,0,14100,62500,0,76600
141648004000000,NE 146,RESIDENTIAL,15000,0,15000,21500,0,36500
141648004100000,NE 146,RESIDENTIAL,15000,0,15000,44100,0,59100
141648004200000,NE 146,RESIDENTIAL,15000,0,15000,49400,0,64400
141648004300000,NE 146,RESIDENTIAL,15000,0,15000,53100,0,68100
141648004400000,NE 146,RESIDENTIAL,15000,0,15000,59700,0,74700
141648004500000,NE 146,RESIDENTIAL,18700,0,18700,73300,0,92000
141648004600000,NE 146,RESIDENTIAL,16600,0,16600,59300,0,75900
141648100100000,NE 146,RESIDENTIAL,20500,0,20500,55800,0,76300
141648100200000,NE 146,RESIDENTIAL,9900,0,9900,49800,0,59700
141648100300000,NE 146,RESIDENTIAL,10900,0,10900,56300,0,67200
141648100400000,NE 146,RESIDENTIAL,14100,0,14100,50800,0,64900
141648100500000,NE 146,RESIDENTIAL,14100,0,14100,33700,0,47800
141648100600000,NE 146,RESIDENTIAL,14100,0,14100,57900,0,72000
141648100700000,NE 146,RESIDENTIAL,14100,0,14100,47300,0,61400
141648100800000,NE 146,RESIDENTIAL,14100,0,14100,71900,0,86000
141648100900000,NE 146,RESIDENTIAL,14100,0,14100,79800,0,93900
141648101000000,NE 146,RESIDENTIAL,14100,0,14100,38300,0,52400
141648101100000,NE 146,RESIDENTIAL,23800,0,23800,35000,0,58800
141648101200000,NE 146,RESIDENTIAL,13800,0,13800,37300,0,51100
141648101300000,NE 146,RESIDENTIAL,14100,0,14100,34100,0,48200
141648101400000,NE 146,RESIDENTIAL,14100,0,14100,60900,0,75000
141648101500000,NE 146,RESIDENTIAL,21200,0,21200,44800,0,66000
141648101600000,NE 146,RESIDENTIAL,20900,0,20900,53400,0,74300
141648101700000,NE 146,RESIDENTIAL,20800,0,20800,70400,0,91200
141648101800000,NE 146,RESIDENTIAL,20800,0,20800,67600,0,88400
141648101900000,NE 146,RESIDENTIAL,13600,0,13600,56100,0,69700
141648102000000,FLAT PARKING,COMMERCIAL,0,57900,57900,0,12500,70400
141648102100000,NE 146,RESIDENTIAL,18900,0,18900,31300,0,50200
141648102200000,NE 146,RESIDENTIAL,18900,0,18900,38300,0,57200
141648102300000,NE 146,RESIDENTIAL,18900,0,18900,65200,0,84100
141648102400000,NE 146,RESIDENTIAL,17900,0,17900,44300,0,62200
141648102500000,NE 146,RESIDENTIAL,21300,0,21300,33100,0,54400
141648102600000,NE 146,RESIDENTIAL,10700,0,10700,37300,0,48000
141648102700000,NE 146,RESIDENTIAL,10700,0,10700,38900,0,49600
141648102800000,NE 146,RESIDENTIAL,21400,0,21400,59100,0,80500
141648102900000,NE 146,RESIDENTIAL,21400,0,21400,54500,0,75900
141648103000000,NE 146,RESIDENTIAL,21500,0,21500,64800,0,86300
141648103100000,NE 146,RESIDENTIAL,21500,0,21500,93000,0,114500
141648103200000,NE 146,RESIDENTIAL,13800,0,13800,43000,0,56800
141648103300000,NE 146,RESIDENTIAL,14600,0,14600,21800,0,36400
141648103400000,NE 146,RESIDENTIAL,14600,0,14600,41600,0,56200
141648103500000,NE 146,RESIDENTIAL,21800,0,21800,72300,0,94100
141648103600000,NE 146,RESIDENTIAL,21600,0,21600,42700,0,64300
141648103700000,NE 146,RESIDENTIAL,21600,0,21600,55800,0,77400
141648103800000,NE 146,RESIDENTIAL,21600,0,21600,65900,0,87500
141648103900000,NE 146,RESIDENTIAL,21600,0,21600,48700,0,70300
141648104000000,NE 146,RESIDENTIAL,21600,0,21600,48300,0,69900
141648200100000,NE 146,RESIDENTIAL,25500,0,25500,64900,0,90400
141648200200000,NE 146,RESIDENTIAL,22400,0,22400,1900,0,24300
141648200300000,NE 146,RESIDENTIAL,22300,0,22300,82000,0,104300
141648200400000,NE 146,RESIDENTIAL,21000,0,21000,76800,0,97800
141648200500000,NE 146,RESIDENTIAL,20800,0,20800,37700,0,58500
141648200600000,NE 146,RESIDENTIAL,20600,0,20600,0,0,20600
141648200700000,NE 146,RESIDENTIAL,15800,0,15800,42100,0,57900
141648200800000,NE 146,RESIDENTIAL,14900,0,14900,42200,0,57100
141648200900000,AUTO REPAIR/SALES,COMMERCIAL,0,29900,29900,0,34500,64400
141710100200000,NE 135,RESIDENTIAL,68000,0,68000,866300,0,934300
141710100300000,NE 135,RESIDENTIAL,43100,0,43100,183100,0,226200
141710100400000,NE 135,RESIDENTIAL,40400,0,40400,265800,0,306200
141710100500000,NE 135,RESIDENTIAL,30900,0,30900,0,0,30900
141710100600000,NE 149,RESIDENTIAL,37400,0,37400,0,0,37400
141710100700000,NE 149,RESIDENTIAL,0,0,0,0,0,0
141710101400000,NE 149,RESIDENTIAL,0,0,0,0,0,0
141710200300000,OFFICE,EXEMPT,0,546600,546600,0,2242700,2789300
141712600100000,NE 135,RESIDENTIAL,41300,0,41300,0,0,41300
141712600200000,NE 149,RESIDENTIAL,42300,0,42300,0,0,42300
141712600300000,NE 149,RESIDENTIAL,40800,0,40800,200500,0,241300
141712600400000,NE 149,RESIDENTIAL,47000,0,47000,186600,0,233600
141712600500000,NE 149,RESIDENTIAL,49200,0,49200,155800,0,205000
141712600600000,NE 149,RESIDENTIAL,36600,0,36600,239700,0,276300
141712600700000,NE 149,RESIDENTIAL,52700,0,52700,0,0,52700
141712600900000,NE 149,RESIDENTIAL,56600,0,56600,228400,0,285000
141712601100000,NE 149,RESIDENTIAL,35900,0,35900,243300,0,279200
141712601200000,NE 149,RESIDENTIAL,61500,0,61500,220300,0,281800
141712601300000,NE 149,RESIDENTIAL,8200,0,8200,0,0,8200
141712601400000,NE 149,RESIDENTIAL,500,0,500,0,0,500
141712601500000,NE 149,RESIDENTIAL,8300,0,8300,0,0,8300
141712601600000,NE 135,RESIDENTIAL,36300,0,36300,386300,0,422600
141712700100000,NE 149,RESIDENTIAL,66000,0,66000,327300,0,393300
141712700200000,NE 149,RESIDENTIAL,66900,0,66900,300200,0,367100
141712700300000,NE 149,RESIDENTIAL,65300,0,65300,222700,0,288000
141712700400000,NE 149,RESIDENTIAL,63000,0,63000,250900,0,313900
141712700500000,NE 149,RESIDENTIAL,56900,0,56900,288100,0,345000
141712700600000,NE 149,RESIDENTIAL,50700,0,50700,203100,0,253800
141712700700000,NE 149,RESIDENTIAL,50500,0,50500,189000,0,239500
141712700800000,NE 149,RESIDENTIAL,50500,0,50500,202800,0,253300
141712700900000,NE 149,RESIDENTIAL,51000,0,51000,251600,0,302600
141712701000000,NE 149,RESIDENTIAL,57600,0,57600,214100,0,271700
141712701100000,NE 149,RESIDENTIAL,44000,0,44000,223600,0,267600
141712701200000,NE 149,RESIDENTIAL,67300,0,67300,251800,0,319100
141712701300000,NE 149,RESIDENTIAL,41300,0,41300,0,0,41300
141712701400000,NE 149,RESIDENTIAL,52100,0,52100,148600,0,200700
141712701700000,NE 149,RESIDENTIAL,65000,0,65000,245600,0,310600
141712701800000,NE 149,RESIDENTIAL,65000,0,65000,214300,0,279300
141712701900000,NE 149,RESIDENTIAL,144600,0,144600,693000,0,837600
141712702000000,NE 149,RESIDENTIAL,56100,0,56100,501200,0,557300
141712702100000,NE 149,RESIDENTIAL,70900,0,70900,216100,0,287000
141712702200000,NE 149,RESIDENTIAL,6300,0,6300,0,0,6300
141712702300000,NE 149,RESIDENTIAL,100300,0,100300,323900,0,424200
141712702400000,NE 149,RESIDENTIAL,10900,0,10900,0,0,10900
141712702500000,NE 149,RESIDENTIAL,67200,0,67200,205600,0,272800
141712702600000,NE 149,RESIDENTIAL,76300,0,76300,311500,0,387800
141712702800000,NE 149,RESIDENTIAL,45100,0,45100,0,0,45100
141712702900000,NE 149,RESIDENTIAL,62100,0,62100,194300,0,256400
141712703000000,NE 149,RESIDENTIAL,62800,0,62800,174700,0,237500
141712703100000,NE 149,RESIDENTIAL,34800,0,34800,240300,0,275100
141712703200000,NE 149,RESIDENTIAL,54000,0,54000,222300,0,276300
141712703300000,NE 149,RESIDENTIAL,38600,0,38600,262100,0,300700
141712703400000,NE 149,RESIDENTIAL,63600,0,63600,272900,0,336500
141712703500000,NE 149,RESIDENTIAL,58900,0,58900,236400,0,295300
141712703600000,NE 149,RESIDENTIAL,51400,0,51400,163900,0,215300
141712703700000,NE 149,RESIDENTIAL,45900,0,45900,176700,0,222600
141712703800000,NE 149,RESIDENTIAL,37600,0,37600,210300,0,247900
141712703900000,NE 149,RESIDENTIAL,36300,0,36300,172800,0,209100
141712704000000,NE 149,RESIDENTIAL,15900,0,15900,0,0,15900
141712704100000,NE 149,RESIDENTIAL,69300,0,69300,173700,0,243000
141712704200000,NE 149,RESIDENTIAL,63600,0,63600,0,0,63600
141712800100000,NE 149,RESIDENTIAL,54100,0,54100,203900,0,258000
141712800200000,NE 149,RESIDENTIAL,54000,0,54000,182500,0,236500
141712800300000,NE 149,RESIDENTIAL,66000,0,66000,291000,0,357000
141712800400000,NE 149,RESIDENTIAL,66900,0,66900,283900,0,350800
141712800500000,NE 149,RESIDENTIAL,68900,0,68900,284100,0,353000
141715100100000,NE 149,RESIDENTIAL,4200,0,4200,0,0,4200
141715200100000,NE 149,RESIDENTIAL,52300,0,52300,0,0,52300
141715200200000,NE 149,RESIDENTIAL,70100,0,70100,185700,0,255800
141715300100000,CITY PROPERTY,EXEMPT,0,0,0,0,0,0
141717600300000,NE 149,RESIDENTIAL,13500,0,13500,0,0,13500
141717700100000,SHOP,COMMERCIAL,0,402500,402500,0,641800,1044300
141717700200000,FLAT PARKING,COMMERCIAL,0,8300,8300,0,9600,17900
141717700300000,WAREHOUSE,COMMERCIAL,0,131800,131800,0,346400,478200
141717700400000,WAREHOUSE,COMMERCIAL,0,31000,31000,0,112900,143900
141717800100000,VACANT LAND,COMMERCIAL,0,1300,1300,0,0,1300
141717800200000,CITY PROPERTY,EXEMPT,0,0,0,0,0,0
141720100200000,NE 149,RESIDENTIAL,75800,0,75800,311400,0,387200
141720100300000,NE 149,RESIDENTIAL,62500,0,62500,315000,0,377500
141720100400000,NE 149,RESIDENTIAL,76400,0,76400,318400,0,394800
141720100600000,NE 149,RESIDENTIAL,118100,0,118100,454100,0,572200
141720100700000,NE 149,RESIDENTIAL,70100,0,70100,275700,0,345800
141720100900000,NE 167,RESIDENTIAL,66600,0,66600,9000,0,75600
141720101000000,NE 167,RESIDENTIAL,37000,0,37000,282600,0,319600
141720101100000,NE 167,RESIDENTIAL,91600,0,91600,329700,0,421300
141720200100000,NE 167,RESIDENTIAL,27300,0,27300,0,0,27300
141720200600000,NE 167,RESIDENTIAL,74100,0,74100,0,0,74100
141720200700000,NE 167,RESIDENTIAL,70100,0,70100,0,0,70100
141720300100000,CITY PROPERTY,EXEMPT,0,0,0,0,0,0
141720300200000,CITY PROPERTY,EXEMPT,0,0,0,0,0,0
141722600100000,CITY PROPERTY,EXEMPT,0,0,0,0,0,0
141725100100000,NW 301,RESIDENTIAL,27000,0,27000,74900,0,101900
141725100200000,NW 301,RESIDENTIAL,31800,0,31800,85500,0,117300
141725100300000,NW 301,RESIDENTIAL,66600,0,66600,0,0,66600
141725100400000,CITY PROPERTY,EXEMPT,0,0,0,0,0,0
141725100500000,CITY PROPERTY,EXEMPT,0,0,0,0,0,0
141725100600000,NW 301,RESIDENTIAL,24800,0,24800,37900,0,62700
141725100700000,NW 301,RESIDENTIAL,20700,0,20700,51700,0,72400
141725100800000,NW 301,RESIDENTIAL,27900,0,27900,131000,0,158900
141725100900000,NW 301,RESIDENTIAL,27000,0,27000,98300,0,125300
141725101000000,NW 301,RESIDENTIAL,31200,0,31200,105700,0,136900
141725101100000,NW 301,RESIDENTIAL,25200,0,25200,131800,0,157000
141725101200000,NW 301,RESIDENTIAL,87100,0,87100,0,0,87100
141725200100000,CITY PROPERTY,EXEMPT,0,0,0,0,0,0
141725200200000,CITY PROPERTY,EXEMPT,0,0,0,0,0,0
141725200300000,NW 303,RESIDENTIAL,18100,0,18100,206400,0,224500
141725200400000,NW 303,RESIDENTIAL,15000,0,15000,213700,0,228700
141725200500000,NW 303,RESIDENTIAL,15000,0,15000,216000,0,231000
141725200600000,NW 303,RESIDENTIAL,17000,0,17000,216900,0,233900
141725200700000,NW 303,RESIDENTIAL,17200,0,17200,218000,0,235200
141725200800000,NW 303,RESIDENTIAL,14900,0,14900,216200,0,231100
141725200900000,NW 303,RESIDENTIAL,15000,0,15000,210600,0,225600
141725201000000,NW 303,RESIDENTIAL,15000,0,15000,219100,0,234100
141725201100000,NW 303,RESIDENTIAL,15000,0,15000,215600,0,230600
141725201200000,NW 303,RESIDENTIAL,15400,0,15400,214400,0,229800
141725201300000,NW 303,RESIDENTIAL,31500,0,31500,233600,0,265100
141725201400000,NW 303,RESIDENTIAL,15100,0,15100,208400,0,223500
141725201500000,NW 303,RESIDENTIAL,21500,0,21500,199200,0,220700
141725201600000,NW 303,RESIDENTIAL,13900,0,13900,214400,0,228300
141725201700000,NW 303,RESIDENTIAL,17100,0,17100,227300,0,244400
141725201800000,NW 303,RESIDENTIAL,16600,0,16600,187800,0,204400
141725201900000,NW 303,RESIDENTIAL,24400,0,24400,209000,0,233400
141725202000000,NW 303,RESIDENTIAL,27200,0,27200,232300,0,259500
141725202100000,NW 303,RESIDENTIAL,15100,0,15100,195100,0,210200
141725202200000,NW 303,RESIDENTIAL,15100,0,15100,205800,0,220900
141725202300000,NW 303,RESIDENTIAL,15100,0,15100,211700,0,226800
141725202400000,NW 303,RESIDENTIAL,33600,0,33600,259500,0,293100
141725202500000,NW 303,RESIDENTIAL,43200,0,43200,242900,0,286100
141725202600000,NW 303,RESIDENTIAL,18400,0,18400,205300,0,223700
141725202800000,NW 301,RESIDENTIAL,30200,0,30200,2200,0,32400
141725202900000,NW 301,RESIDENTIAL,22900,0,22900,0,0,22900
141725203000000,NW 301,RESIDENTIAL,4100,0,4100,0,0,4100
141725203100000,NW 301,RESIDENTIAL,32800,0,32800,271200,0,304000
141725203200000,NW 301,RESIDENTIAL,29500,0,29500,60000,0,89500
141725203400000,NW 301,RESIDENTIAL,29500,0,29500,85900,0,115400
141725203500000,NW 301,RESIDENTIAL,29500,0,29500,83400,0,112900
141725203600000,NW 301,RESIDENTIAL,29500,0,29500,72300,0,101800
141725203700000,NW 301,RESIDENTIAL,19300,0,19300,62700,0,82000
141725203800000,NW 301,RESIDENTIAL,17500,0,17500,0,0,17500
141725203900000,NW 301,RESIDENTIAL,31200,0,31200,91000,0,122200
141725204000000,NW 301,RESIDENTIAL,31200,0,31200,60900,0,92100
141725204100000,NW 301,RESIDENTIAL,27000,0,27000,86700,0,113700
141725204200000,NW 301,RESIDENTIAL,27000,0,27000,77700,0,104700
141725204300000,NW 301,RESIDENTIAL,18000,0,18000,57800,0,75800
141725204400000,NW 301,RESIDENTIAL,25500,0,25500,56400,0,81900
141725204500000,NW 301,RESIDENTIAL,31500,0,31500,76600,0,108100
141725204600000,NW 301,RESIDENTIAL,36100,0,36100,158900,0,195000
141725204800000,NW 301,RESIDENTIAL,46400,0,46400,129600,0,176000
141727600200000,CITY PROPERTY,EXEMPT,0,0,0,0,0,0
141730100100000,CITY PROPERTY,EXEMPT,0,0,0,0,0,0
141732600100000,CITY PROPERTY,EXEMPT,0,0,0,0,0,0
141735100100000,NW 307,RESIDENTIAL,42400,0,42400,174700,0,217100
141735100200000,NW 307,RESIDENTIAL,38400,0,38400,168200,0,206600
141735100300000,NW 307,RESIDENTIAL,38900,0,38900,167500,0,206400
141735100400000,NW 307,RESIDENTIAL,42000,0,42000,180500,0,222500
141735100500000,NW 307,RESIDENTIAL,42000,0,42000,147900,0,189900
141735100600000,NW 307,RESIDENTIAL,42100,0,42100,149100,0,191200
141735100700000,NW 307,RESIDENTIAL,42900,0,42900,178400,0,221300
141735100800000,NW 307,RESIDENTIAL,38700,0,38700,176000,0,214700
141735100900000,NW 307,RESIDENTIAL,37100,0,37100,218200,0,255300
141735101000000,NW 307,RESIDENTIAL,43000,0,43000,210200,0,253200
141735101100000,NW 307,RESIDENTIAL,42900,0,42900,184000,0,226900
141735101200000,NW 307,RESIDENTIAL,43900,0,43900,148400,0,192300
141735101300000,NW 307,RESIDENTIAL,33500,0,33500,146600,0,180100
141735101400000,NW 307,RESIDENTIAL,42000,0,42000,175500,0,217500
141735101500000,NW 307,RESIDENTIAL,44400,0,44400,170800,0,215200
141735101600000,NW 307,RESIDENTIAL,43700,0,43700,151100,0,194800
141735101700000,NW 307,RESIDENTIAL,37800,0,37800,179500,0,217300
141735101800000,NW 307,RESIDENTIAL,33300,0,33300,129100,0,162400
141735101900000,NW 307,RESIDENTIAL,33100,0,33100,178700,0,211800
141735102000000,NW 307,RESIDENTIAL,33000,0,33000,113900,0,146900
141735102100000,NW 307,RESIDENTIAL,33300,0,33300,127700,0,161000
141735102400000,NW 307,RESIDENTIAL,33700,0,33700,162000,0,195700
141735102500000,NW 307,RESIDENTIAL,33100,0,33100,145100,0,178200
141735102600000,NW 307,RESIDENTIAL,39200,0,39200,155500,0,194700
141735102700000,NW 307,RESIDENTIAL,40500,0,40500,212000,0,252500
141735102800000,NW 307,RESIDENTIAL,35000,0,35000,132800,0,167800
141735102900000,NW 307,RESIDENTIAL,35300,0,35300,130000,0,165300
141735103000000,NW 307,RESIDENTIAL,33600,0,33600,139000,0,172600
141735103100000,NW 307,RESIDENTIAL,36000,0,36000,151200,0,187200
141735103200000,NW 307,RESIDENTIAL,35300,0,35300,123200,0,158500
141735103300000,NW 307,RESIDENTIAL,68400,0,68400,155700,0,224100
141735200100000,NW 307,RESIDENTIAL,35500,0,35500,193700,0,229200
141735200200000,NW 307,RESIDENTIAL,33200,0,33200,129100,0,162300
141735200300000,NW 307,RESIDENTIAL,33200,0,33200,150400,0,183600
141735200400000,NW 307,RESIDENTIAL,33200,0,33200,144900,0,178100
141735200500000,NW 307,RESIDENTIAL,33200,0,33200,175000,0,208200
141735200600000,NW 307,RESIDENTIAL,35300,0,35300,150600,0,185900
141735200700000,NW 307,RESIDENTIAL,36000,0,36000,149700,0,185700
141735200800000,NW 307,RESIDENTIAL,34800,0,34800,171500,0,206300
141735200900000,NW 307,RESIDENTIAL,39600,0,39600,160500,0,200100
141735201000000,NW 307,RESIDENTIAL,38800,0,38800,160600,0,199400
141735201100000,NW 307,RESIDENTIAL,42800,0,42800,175800,0,218600
141735201200000,NW 307,RESIDENTIAL,43700,0,43700,148900,0,192600
141735201300000,NW 307,RESIDENTIAL,40900,0,40900,169000,0,209900
141735201400000,NW 307,RESIDENTIAL,36000,0,36000,152400,0,188400
141735201500000,NW 307,RESIDENTIAL,33700,0,33700,140500,0,174200
141735201600000,NW 307,RESIDENTIAL,36500,0,36500,131900,0,168400
141735201700000,NW 307,RESIDENTIAL,39700,0,39700,173900,0,213600
141735201800000,NW 307,RESIDENTIAL,38600,0,38600,157400,0,196000
141735201900000,NW 307,RESIDENTIAL,37600,0,37600,199100,0,236700
141735202000000,NW 307,RESIDENTIAL,40500,0,40500,159000,0,199500
141735202100000,NW 307,RESIDENTIAL,40000,0,40000,140100,0,180100
141735202200000,NW 307,RESIDENTIAL,35300,0,35300,118700,0,154000
141735202300000,NW 307,RESIDENTIAL,33200,0,33200,125700,0,158900
141735202400000,NW 307,RESIDENTIAL,33200,0,33200,125200,0,158400
141735202500000,NW 307,RESIDENTIAL,33200,0,33200,127200,0,160400
141735202600000,NW 307,RESIDENTIAL,33200,0,33200,123300,0,156500
141735202700000,NW 307,RESIDENTIAL,35500,0,35500,110100,0,145600
141735300100000,NW 307,RESIDENTIAL,35200,0,35200,118300,0,153500
141735300200000,NW 307,RESIDENTIAL,34600,0,34600,133100,0,167700
141735300300000,NW 307,RESIDENTIAL,34600,0,34600,127100,0,161700
141735300400000,NW 307,RESIDENTIAL,35500,0,35500,143600,0,179100
141735300500000,NW 307,RESIDENTIAL,33600,0,33600,132400,0,166000
141735300600000,NW 307,RESIDENTIAL,34600,0,34600,147900,0,182500
141735300700000,NW 307,RESIDENTIAL,34600,0,34600,163100,0,197700
141735300800000,NW 307,RESIDENTIAL,34600,0,34600,160500,0,195100
141735300900000,NW 307,RESIDENTIAL,34600,0,34600,170200,0,204800
141735301000000,NW 307,RESIDENTIAL,34600,0,34600,168600,0,203200
141735301100000,NW 307,RESIDENTIAL,34600,0,34600,139500,0,174100
141740200200000,CITY PROPERTY,EXEMPT,0,0,0,0,0,0
141745100100000,NW 310,RESIDENTIAL,47900,0,47900,54200,0,102100
141745100200000,NW 310,RESIDENTIAL,42300,0,42300,56600,0,98900
141745100300000,CITY PROPERTY,EXEMPT,0,0,0,0,0,0
141745100400000,CITY PROPERTY,EXEMPT,0,0,0,0,0,0
141745100500000,CITY PROPERTY,EXEMPT,0,0,0,0,0,0
141745100600000,CITY PROPERTY,EXEMPT,0,0,0,0,0,0
141745100700000,NW 310,RESIDENTIAL,69500,0,69500,109400,0,178900
141745100800000,NW 310,RESIDENTIAL,50600,0,50600,0,0,50600
141745100900000,NW 310,RESIDENTIAL,49700,0,49700,79000,0,128700
141745101000000,NW 310,RESIDENTIAL,48400,0,48400,80900,0,129300
141745101100000,NW 310,RESIDENTIAL,48400,0,48400,66100,0,114500
141745101200000,NW 310,RESIDENTIAL,47200,0,47200,82200,0,129400
141745101300000,NW 310,RESIDENTIAL,54500,0,54500,87200,0,141700
141745101400000,NW 310,RESIDENTIAL,51800,0,51800,41300,0,93100
141745101500000,NW 310,RESIDENTIAL,23300,0,23300,58000,0,81300
141745200100000,CITY PROPERTY,EXEMPT,0,0,0,0,0,0
141745200200000,CITY PROPERTY,EXEMPT,0,0,0,0,0,0
141745200300000,NW 310,RESIDENTIAL,20700,0,20700,83800,0,104500
141745200400000,CITY PROPERTY,EXEMPT,0,0,0,0,0,0
141745200700000,CITY PROPERTY,EXEMPT,0,0,0,0,0,0
141745200800000,CITY PROPERTY,EXEMPT,0,0,0,0,0,0
141745200900000,CITY PROPERTY,EXEMPT,0,0,0,0,0,0
141745201000000,CITY PROPERTY,EXEMPT,0,0,0,0,0,0
141745201100000,CITY PROPERTY,EXEMPT,0,0,0,0,0,0
141745201200000,CITY PROPERTY,EXEMPT,0,0,0,0,0,0
141745201300000,NW 310,RESIDENTIAL,23000,0,23000,67900,0,90900
141745201400000,CITY PROPERTY,EXEMPT,0,0,0,0,0,0
141745201500000,CITY PROPERTY,EXEMPT,0,0,0,0,0,0
141745201700000,NW 310,AG LAND,200,0,200,0,26600,26800
141745201800000,NW 310,AG LAND,200,0,200,0,121100,121300
141745201900000,NW 310,RESIDENTIAL,25900,0,25900,72500,0,98400
141745202000000,NW 310,RESIDENTIAL,21400,0,21400,75400,0,96800
141745202100000,CITY PROPERTY,EXEMPT,0,0,0,0,0,0
141745202200000,NW 310,RESIDENTIAL,15500,0,15500,83600,0,99100
141745202300000,CITY PROPERTY,EXEMPT,0,0,0,0,0,0
141745202400000,CITY PROPERTY,EXEMPT,0,0,0,0,0,0
141745202500000,NW 310,RESIDENTIAL,16100,0,16100,66300,0,82400
141745202600000,NW 310,RESIDENTIAL,17200,0,17200,63400,0,80600
141745202700000,NW 310,RESIDENTIAL,16800,0,16800,44600,0,61400
141745202800000,NW 310,AG LAND,200,0,200,0,0,200
141745300100000,CITY PROPERTY,EXEMPT,0,0,0,0,0,0
141745300200000,CITY PROPERTY,EXEMPT,0,0,0,0,0,0
141745300300000,NW 310,RESIDENTIAL,35000,0,35000,127800,0,162800
141745300400000,NW 310,RESIDENTIAL,25200,0,25200,112500,0,137700
141745300500000,CITY PROPERTY,EXEMPT,0,0,0,0,0,0
141745300600000,CITY PROPERTY,EXEMPT,0,0,0,0,0,0
141745300700000,CITY PROPERTY,EXEMPT,0,0,0,0,0,0
141745300800000,CITY PROPERTY,EXEMPT,0,0,0,0,0,0
141745300900000,CITY PROPERTY,EXEMPT,0,0,0,0,0,0
141745301000000,CITY PROPERTY,EXEMPT,0,0,0,0,0,0
141745301100000,CITY PROPERTY,EXEMPT,0,0,0,0,0,0
141745301200000,CITY PROPERTY,EXEMPT,0,0,0,0,0,0
141745301300000,CITY PROPERTY,EXEMPT,0,0,0,0,0,0
141745301400000,NW 310,RESIDENTIAL,20900,0,20900,0,0,20900
141745301500000,CITY PROPERTY,EXEMPT,0,0,0,0,0,0
141745301600000,CITY PROPERTY,EXEMPT,0,0,0,0,0,0
141745301700000,NW 310,RESIDENTIAL,20000,0,20000,56200,0,76200
141747600300000,NW 310,RESIDENTIAL,52700,0,52700,76700,0,129400
141747600600000,NW 310,RESIDENTIAL,83700,0,83700,119200,0,202900
141747600700000,CITY PROPERTY,EXEMPT,0,0,0,0,0,0
141747600800000,CITY PROPERTY,EXEMPT,0,0,0,0,0,0
141810100100000,CITY PROPERTY,EXEMPT,0,0,0,0,0,0
141810100200000,APARTMENT,MULTI-RES,745500,0,745500,4192400,0,4937900
141810300100000,APARTMENT,MULTI-RES,134800,0,134800,2736900,0,2871700
141812600100000,APARTMENT,MULTI-RES,25300,0,25300,357800,0,383100
141812600200000,APARTMENT,MULTI-RES,188500,0,188500,4468200,0,4656700
141812600300000,APARTMENT,MULTI-RES,161500,0,161500,5440400,0,5601900
141815100100000,NW 303,RESIDENTIAL,35300,0,35300,131500,0,166800
141815100200000,NW 303,RESIDENTIAL,13600,0,13600,82900,0,96500
141815100300000,NW 303,RESIDENTIAL,12700,0,12700,71200,0,83900
141815100400000,NW 303,RESIDENTIAL,13300,0,13300,91300,0,104600
141815100500000,NW 303,RESIDENTIAL,12600,0,12600,101300,0,113900
141815100600000,NW 303,RESIDENTIAL,12900,0,12900,104100,0,117000
141815100700000,NW 303,RESIDENTIAL,13000,0,13000,102400,0,115400
141815100800000,NW 303,RESIDENTIAL,12800,0,12800,101400,0,114200
141815100900000,NW 303,RESIDENTIAL,13000,0,13000,101000,0,114000
141815101000000,NW 303,RESIDENTIAL,16100,0,16100,106100,0,122200
141815101100000,NW 303,RESIDENTIAL,15900,0,15900,111800,0,127700
141815101200000,NW 303,RESIDENTIAL,13700,0,13700,116700,0,130400
141815101300000,NW 303,RESIDENTIAL,15900,0,15900,109500,0,125400
141815101400000,NW 303,RESIDENTIAL,31900,0,31900,145500,0,177400
141815101500000,NW 303,RESIDENTIAL,31200,0,31200,146400,0,177600
141815101600000,NW 303,RESIDENTIAL,14100,0,14100,137000,0,151100
141815101700000,NW 303,RESIDENTIAL,14200,0,14200,130100,0,144300
141815101800000,NW 303,RESIDENTIAL,25100,0,25100,117100,0,142200
141815101900000,NW 303,RESIDENTIAL,25100,0,25100,110400,0,135500
141815102000000,NW 303,RESIDENTIAL,25100,0,25100,64300,0,89400
141815102100000,NW 303,RESIDENTIAL,25100,0,25100,123500,0,148600
141815102200000,NW 303,RESIDENTIAL,26200,0,26200,116600,0,142800
141815102300000,NW 303,RESIDENTIAL,26600,0,26600,103200,0,129800
141815102400000,NW 303,RESIDENTIAL,24900,0,24900,127800,0,152700
141815102500000,NW 303,RESIDENTIAL,24900,0,24900,141100,0,166000
141815102600000,NW 303,RESIDENTIAL,24900,0,24900,128400,0,153300
141815102700000,NW 303,RESIDENTIAL,24900,0,24900,124300,0,149200
141815102800000,NW 303,RESIDENTIAL,24900,0,24900,139600,0,164500
141815102900000,NW 303,RESIDENTIAL,28600,0,28600,138900,0,167500
141815103000000,NW 303,RESIDENTIAL,29100,0,29100,154400,0,183500
141815103100000,NW 303,RESIDENTIAL,26400,0,26400,139800,0,166200
141815103200000,NW 303,RESIDENTIAL,27000,0,27000,137100,0,164100
141815103300000,NW 303,RESIDENTIAL,25800,0,25800,161700,0,187500
141815103400000,NW 303,RESIDENTIAL,27200,0,27200,153600,0,180800
141815103500000,NW 303,RESIDENTIAL,25700,0,25700,130300,0,156000
141815103600000,NW 303,RESIDENTIAL,27900,0,27900,62500,0,90400
141815103700000,NW 303,RESIDENTIAL,29100,0,29100,54300,0,83400
141815103800000,NW 303,RESIDENTIAL,24700,0,24700,43800,0,68500
141815103900000,NW 303,RESIDENTIAL,28400,0,28400,174300,0,202700
141815104000000,NW 303,RESIDENTIAL,26500,0,26500,172000,0,198500
141815104100000,NW 303,RESIDENTIAL,26500,0,26500,177000,0,203500
141815104200000,NW 303,RESIDENTIAL,26100,0,26100,192600,0,218700
141815104300000,NW 303,RESIDENTIAL,30700,0,30700,197700,0,228400
141815104400000,NW 303,RESIDENTIAL,3200,0,3200,43000,0,46200
141815104500000,NW 303,RESIDENTIAL,33800,0,33800,171100,0,204900
141815104600000,NW 303,RESIDENTIAL,33500,0,33500,281800,0,315300
141815104700000,NW 303,RESIDENTIAL,30200,0,30200,163100,0,193300
141815104800000,NW 303,RESIDENTIAL,26100,0,26100,187800,0,213900
141815104900000,NW 303,RESIDENTIAL,26500,0,26500,201000,0,227500
141815105000000,NW 303,RESIDENTIAL,26500,0,26500,171800,0,198300
141815105100000,NW 303,RESIDENTIAL,28400,0,28400,160300,0,188700
141815105200000,NW 303,RESIDENTIAL,63200,0,63200,90500,0,153700
141815105300000,CITY PROPERTY,EXEMPT,0,0,0,0,0,0
141817600100000,CITY PROPERTY,EXEMPT,0,0,0,0,0,0
141820100100000,ANTENNAS/TOWERS(BLL),COMMERCIAL,0,19000,19000,0,39800,58800
141820100200000,CITY PROPERTY,EXEMPT,0,0,0,0,0,0
141820200700000,SCHOOL,EXEMPT,0,0,0,0,0,0
141820300100000,NW 302,RESIDENTIAL,63200,0,63200,87300,0,150500
141822600100000,CITY PROPERTY,EXEMPT,0,0,0,0,0,0
141822600200000,NW 302,RESIDENTIAL,5000,0,5000,3700,0,8700
141822600300000,NW 302,RESIDENTIAL,64800,0,64800,173100,0,237900
141822600400000,CITY PROPERTY,EXEMPT,0,0,0,0,0,0
141822600500000,CITY PROPERTY,EXEMPT,0,0,0,0,0,0
141822600700000,CITY PROPERTY,EXEMPT,0,0,0,0,0,0
141822700200000,CITY PROPERTY,EXEMPT,0,0,0,0,0,0
141822700300000,NW 302,RESIDENTIAL,19100,0,19100,86500,0,105600
141822800100000,CITY PROPERTY,EXEMPT,0,0,0,0,0,0
141825100700000,NW 302,AG LAND,1800,0,1800,0,0,1800
141825100800000,NW 302,RESIDENTIAL,5600,0,5600,0,0,5600
141825101000000,NW 302,RESIDENTIAL,81600,0,81600,323100,0,404700
141825101500000,APARTMENT,RESIDENTIAL,233900,0,233900,3064300,0,3298200
141825101600000,APARTMENT,RESIDENTIAL,197200,0,197200,3065200,0,3262400
141825101700000,NW 302,RESIDENTIAL,36300,0,36300,3100,0,39400
141825101800000,NW 302,RESIDENTIAL,2700,0,2700,0,0,2700
141825200100000,APARTMENT,RESIDENTIAL,143400,0,143400,701100,0,844500
141825200200000,APARTMENT,RESIDENTIAL,68000,0,68000,666100,0,734100
141825200300000,APARTMENT,RESIDENTIAL,271200,0,271200,2851600,0,3122800
141825200400000,NW 302,RESIDENTIAL,54500,0,54500,0,0,54500
141825200500000,NW 302,RESIDENTIAL,9400,0,9400,0,0,9400
141825300100000,NW 302,RESIDENTIAL,1000,0,1000,0,0,1000
141827600100000,NW 302,RESIDENTIAL,42700,0,42700,111700,0,154400
141827600200000,NW 302,RESIDENTIAL,27800,0,27800,130600,0,158400
141827600500000,CHURCH,EXEMPT,0,464000,464000,0,704500,1168500
141827600600000,CHURCH,EXEMPT,0,470600,470600,0,613300,1083900
141827700500000,CHURCH,EXEMPT,0,403000,403000,0,401400,804400
141827800100000,VACANT LAND,EXEMPT,0,27800,27800,0,0,27800
141830100100000,NW 308,RESIDENTIAL,16900,0,16900,99600,0,116500
141830100200000,NW 308,RESIDENTIAL,17800,0,17800,117900,0,135700
141830100300000,NW 308,RESIDENTIAL,17500,0,17500,129300,0,146800
141830100400000,NW 302,RESIDENTIAL,60700,0,60700,62400,0,123100
141830100500000,NW 308,RESIDENTIAL,17100,0,17100,95700,0,112800
141830100600000,NW 308,RESIDENTIAL,17800,0,17800,126600,0,144400
141830100700000,NW 308,RESIDENTIAL,19900,0,19900,112800,0,132700
141830100800000,NW 308,RESIDENTIAL,22000,0,22000,102000,0,124000
141830200100000,APARTMENT,MULTI-RES,437800,0,437800,1993500,0,2431300
141830200200000,VACANT LAND,COMMERCIAL,0,44400,44400,0,0,44400
141830200500000,NW 302,RESIDENTIAL,54000,0,54000,0,0,54000
141830200600000,NW 302,RESIDENTIAL,56000,0,56000,0,0,56000
141830300100000,NW 308,RESIDENTIAL,22700,0,22700,111000,0,133700
141830300200000,NW 308,RESIDENTIAL,21200,0,21200,103400,0,124600
141832600400000,NW 302,AG LAND,21400,0,21400,0,0,21400
141832600500000,NW 302,RESIDENTIAL,58500,0,58500,0,0,58500
141835100100000,NW 302,RESIDENTIAL,62500,0,62500,0,0,62500
141835100400000,NW 302,RESIDENTIAL,30900,0,30900,92100,0,123000
141835100500000,NW 302,RESIDENTIAL,88000,0,88000,0,0,88000
141835100600000,NW 302,RESIDENTIAL,112500,0,112500,83200,0,195700
141835200100000,NW 308,RESIDENTIAL,72000,0,72000,0,0,72000
141835200200000,NW 308,RESIDENTIAL,65300,0,65300,167900,0,233200
141837600200000,NW 336,RESIDENTIAL,30100,0,30100,222600,0,252700
141837600300000,NW 336,RESIDENTIAL,34900,0,34900,244200,0,279100
141837600400000,NW 336,RESIDENTIAL,41000,0,41000,176200,0,217200
141837600500000,NW 336,RESIDENTIAL,33400,0,33400,198300,0,231700
141837600600000,NW 336,RESIDENTIAL,35400,0,35400,223000,0,258400
141837600700000,NW 336,RESIDENTIAL,37800,0,37800,271800,0,309600
141837600800000,NW 336,RESIDENTIAL,39200,0,39200,212200,0,251400
141837600900000,NW 336,RESIDENTIAL,37400,0,37400,259800,0,297200
141837601000000,NW 336,RESIDENTIAL,39300,0,39300,237300,0,276600
141837601100000,NW 336,RESIDENTIAL,37700,0,37700,213200,0,250900
141837601200000,NW 336,RESIDENTIAL,36500,0,36500,197000,0,233500
141837601300000,NW 336,RESIDENTIAL,36600,0,36600,231300,0,267900
141837601400000,NW 308,RESIDENTIAL,27600,0,27600,154700,0,182300
141837601500000,NW 308,RESIDENTIAL,24700,0,24700,174900,0,199600
141837601600000,NW 308,RESIDENTIAL,25400,0,25400,167000,0,192400
141837601700000,NW 308,RESIDENTIAL,25400,0,25400,150500,0,175900
141837601800000,NW 308,RESIDENTIAL,26600,0,26600,165800,0,192400
141837602100000,NW 308,RESIDENTIAL,24200,0,24200,171000,0,195200
141837602500000,NW 308,RESIDENTIAL,1200,0,1200,0,0,1200
141837602600000,NW 308,RESIDENTIAL,1100,0,1100,0,0,1100
141837602700000,NW 308,RESIDENTIAL,1200,0,1200,0,0,1200
141837602900000,NW 308,RESIDENTIAL,1100,0,1100,0,0,1100
141837603000000,NW 308,RESIDENTIAL,1200,0,1200,0,0,1200
141837603300000,NW 308,RESIDENTIAL,3600,0,3600,0,0,3600
141837603400000,NW 308,RESIDENTIAL,42100,0,42100,156400,0,198500
141837700100000,NW 336,RESIDENTIAL,39700,0,39700,201500,0,241200
141837700200000,NW 336,RESIDENTIAL,35800,0,35800,189000,0,224800
141837700300000,NW 336,RESIDENTIAL,52300,0,52300,250000,0,302300
141837700600000,NW 336,RESIDENTIAL,31800,0,31800,195500,0,227300
141837700700000,NW 336,RESIDENTIAL,38100,0,38100,193900,0,232000
141837700800000,NW 336,RESIDENTIAL,37800,0,37800,174500,0,212300
141837700900000,NW 336,RESIDENTIAL,35500,0,35500,261900,0,297400
141837701000000,NW 336,RESIDENTIAL,36500,0,36500,173900,0,210400
141837701100000,NW 336,RESIDENTIAL,38200,0,38200,213400,0,251600
141837701200000,NW 308,RESIDENTIAL,26800,0,26800,150100,0,176900
141837701300000,NW 308,RESIDENTIAL,27100,0,27100,184300,0,211400
141837701400000,NW 308,RESIDENTIAL,26100,0,26100,148300,0,174400
141837701500000,NW 308,RESIDENTIAL,24500,0,24500,143900,0,168400
141837701600000,NW 308,RESIDENTIAL,24900,0,24900,144200,0,169100
141837701700000,NW 308,RESIDENTIAL,21100,0,21100,144200,0,165300
141837701800000,NW 308,RESIDENTIAL,29100,0,29100,151100,0,180200
141837900100000,NW 336,RESIDENTIAL,39800,0,39800,287500,0,327300
141837900200000,NW 336,RESIDENTIAL,38200,0,38200,252900,0,291100
141837900300000,NW 336,RESIDENTIAL,42400,0,42400,251400,0,293800
141837900400000,NW 336,RESIDENTIAL,40100,0,40100,0,0,40100
141837900500000,NW 336,RESIDENTIAL,37800,0,37800,217600,0,255400
141837900600000,NW 336,RESIDENTIAL,36400,0,36400,234300,0,270700
141837900700000,NW 336,RESIDENTIAL,34600,0,34600,220500,0,255100
141837900800000,NW 336,RESIDENTIAL,35400,0,35400,212600,0,248000
141837900900000,NW 336,RESIDENTIAL,43300,0,43300,173200,0,216500
141837901000000,NW 336,RESIDENTIAL,33700,0,33700,153100,0,186800
141837901100000,NW 308,RESIDENTIAL,28100,0,28100,123500,0,151600
141837901200000,NW 308,RESIDENTIAL,29600,0,29600,113800,0,143400
141837901300000,NW 308,RESIDENTIAL,31200,0,31200,118400,0,149600
141837901400000,NW 308,RESIDENTIAL,31400,0,31400,113100,0,144500
141837901500000,NW 308,RESIDENTIAL,31400,0,31400,126700,0,158100
141837901600000,NW 308,RESIDENTIAL,31700,0,31700,136300,0,168000
141837901700000,NW 308,RESIDENTIAL,32400,0,32400,129500,0,161900
141837901800000,NW 308,RESIDENTIAL,34400,0,34400,135700,0,170100
141837901900000,NW 308,RESIDENTIAL,31200,0,31200,125900,0,157100
141837902000000,NW 308,RESIDENTIAL,33000,0,33000,108100,0,141100
141838000100000,NW 336,RESIDENTIAL,31600,0,31600,163300,0,194900
141838000200000,NW 336,RESIDENTIAL,37000,0,37000,231800,0,268800
141838000300000,NW 336,RESIDENTIAL,36200,0,36200,217800,0,254000
141838000400000,NW 336,RESIDENTIAL,35800,0,35800,264400,0,300200
141838000500000,NW 336,RESIDENTIAL,35200,0,35200,234300,0,269500
141838000600000,NW 336,RESIDENTIAL,34200,0,34200,206900,0,241100
141838000700000,NW 308,RESIDENTIAL,31500,0,31500,123700,0,155200
141838000800000,NW 308,RESIDENTIAL,31400,0,31400,107800,0,139200
141838000900000,NW 308,RESIDENTIAL,33600,0,33600,107600,0,141200
141838001000000,NW 308,RESIDENTIAL,31800,0,31800,114400,0,146200
141838001100000,NW 308,RESIDENTIAL,27900,0,27900,98900,0,126800
141838001200000,NW 308,RESIDENTIAL,27900,0,27900,107900,0,135800
141838001300000,NW 308,RESIDENTIAL,27700,0,27700,111200,0,138900
141838001400000,NW 308,RESIDENTIAL,27700,0,27700,126600,0,154300
141838100100000,NW 308,RESIDENTIAL,28300,0,28300,114600,0,142900
141838100200000,NW 308,RESIDENTIAL,27700,0,27700,111800,0,139500
141838100300000,NW 308,RESIDENTIAL,28600,0,28600,141100,0,169700
141838100400000,NW 308,RESIDENTIAL,27800,0,27800,130100,0,157900
141838100500000,NW 308,RESIDENTIAL,26800,0,26800,131200,0,158000
141838100600000,NW 308,RESIDENTIAL,27400,0,27400,121900,0,149300
141838100700000,NW 308,RESIDENTIAL,27900,0,27900,123700,0,151600
141838100800000,NW 308,RESIDENTIAL,26900,0,26900,136700,0,163600
141840100200000,NW 302,RESIDENTIAL,38100,0,38100,58600,0,96700
141840100500000,NW 307,RESIDENTIAL,38000,0,38000,122800,0,160800
141840100600000,NW 307,RESIDENTIAL,37500,0,37500,140900,0,178400
141840100700000,NW 307,RESIDENTIAL,37500,0,37500,132600,0,170100
141840100800000,NW 307,RESIDENTIAL,37500,0,37500,115800,0,153300
141840100900000,NW 307,RESIDENTIAL,0,0,0,0,0,0
141840101000000,NW 307,RESIDENTIAL,44400,0,44400,139800,0,184200
141840101100000,NW 307,RESIDENTIAL,52300,0,52300,203500,0,255800
141840101200000,NW 307,RESIDENTIAL,56200,0,56200,178900,0,235100
141840101300000,NW 307,RESIDENTIAL,41000,0,41000,191400,0,232400
141840101400000,NW 307,RESIDENTIAL,44900,0,44900,191300,0,236200
141840101500000,NW 307,RESIDENTIAL,45900,0,45900,151400,0,197300
141840101600000,NW 307,RESIDENTIAL,44800,0,44800,200400,0,245200
141840101700000,CITY PROPERTY,EXEMPT,0,0,0,0,0,0
141840102100000,CITY PROPERTY,EXEMPT,0,0,0,0,0,0
141840102200000,NW 302,RESIDENTIAL,42500,0,42500,158500,0,201000
141840102300000,NW 302,RESIDENTIAL,42500,0,42500,162500,0,205000
141840102400000,NW 302,RESIDENTIAL,103500,0,103500,194200,0,297700
141840102500000,NW 302,RESIDENTIAL,54900,0,54900,121500,0,176400
141840102600000,NW 302,RESIDENTIAL,136600,0,136600,169500,0,306100
141840200100000,NW 302,RESIDENTIAL,25700,0,25700,149100,0,174800
141840200200000,NW 302,RESIDENTIAL,66500,0,66500,144800,0,211300
141840200400000,NW 302,RESIDENTIAL,40700,0,40700,204100,0,244800
141840200700000,NW 302,RESIDENTIAL,64700,0,64700,178600,0,243300
141840200800000,NW 302,RESIDENTIAL,22300,0,22300,46500,0,68800
141840200900000,NW 302,RESIDENTIAL,22800,0,22800,96300,0,119100
141840201000000,NW 302,RESIDENTIAL,24500,0,24500,111300,0,135800
141840201100000,NW 302,RESIDENTIAL,24500,0,24500,120100,0,144600
141840201200000,NW 302,RESIDENTIAL,26000,0,26000,96900,0,122900
141840201300000,NW 302,RESIDENTIAL,62800,0,62800,235700,0,298500
141840201400000,NW 302,RESIDENTIAL,21900,0,21900,0,0,21900
141840201500000,NW 302,RESIDENTIAL,20900,0,20900,0,0,20900
141840201600000,NW 302,RESIDENTIAL,62200,0,62200,266100,0,328300
141840201700000,NW 302,RESIDENTIAL,62200,0,62200,258100,0,320300
141840201800000,NW 302,RESIDENTIAL,41800,0,41800,81600,0,123400
141840300100000,NW 307,RESIDENTIAL,46200,0,46200,167200,0,213400
141840300200000,NW 307,RESIDENTIAL,42400,0,42400,151200,0,193600
141840300300000,NW 307,RESIDENTIAL,41100,0,41100,156800,0,197900
141840300400000,NW 307,RESIDENTIAL,41600,0,41600,162000,0,203600
141840300500000,NW 307,RESIDENTIAL,43900,0,43900,157100,0,201000
141840300600000,NW 307,RESIDENTIAL,43900,0,43900,162800,0,206700
141840300700000,NW 307,RESIDENTIAL,41600,0,41600,170500,0,212100
141840300800000,NW 307,RESIDENTIAL,40500,0,40500,153300,0,193800
141840400100000,NW 307,RESIDENTIAL,38400,0,38400,175300,0,213700
141840400200000,NW 307,RESIDENTIAL,37500,0,37500,149500,0,187000
141840400300000,NW 307,RESIDENTIAL,35300,0,35300,165800,0,201100
141840400400000,NW 307,RESIDENTIAL,37300,0,37300,124100,0,161400
141840400500000,NW 307,RESIDENTIAL,42400,0,42400,157900,0,200300
141840400600000,NW 307,RESIDENTIAL,42600,0,42600,187900,0,230500
141842600200000,NW 302,RESIDENTIAL,34600,0,34600,46600,0,81200
141842600300000,NW 302,RESIDENTIAL,21100,0,21100,0,0,21100
141842600400000,NW 302,RESIDENTIAL,71200,0,71200,28700,0,99900
141842600500000,NW 302,RESIDENTIAL,35200,0,35200,63400,0,98600
141842600600000,NW 302,RESIDENTIAL,54500,0,54500,123000,0,177500
141842600700000,NW 308,RESIDENTIAL,30400,0,30400,124000,0,154400
141842600800000,NW 308,RESIDENTIAL,30400,0,30400,136700,0,167100
141842600900000,NW 308,RESIDENTIAL,33400,0,33400,206100,0,239500
141842601000000,NW 308,RESIDENTIAL,33400,0,33400,200100,0,233500
141842601100000,NW 308,RESIDENTIAL,33300,0,33300,207500,0,240800
141842601200000,NW 308,RESIDENTIAL,48400,0,48400,249300,0,297700
141842601300000,NW 308,RESIDENTIAL,72400,0,72400,87900,0,160300
141842601400000,NW 352,RESIDENTIAL,41300,0,41300,124500,0,165800
141842601500000,SECTION 42,RESIDENTIAL,8300,0,8300,34200,0,42500
141842601600000,SECTION 42,RESIDENTIAL,8500,0,8500,34200,0,42700
141842601700000,NW 352,RESIDENTIAL,36500,0,36500,112200,0,148700
141842601800000,NW 352,RESIDENTIAL,35000,0,35000,112200,0,147200
141842601900000,NW 352,RESIDENTIAL,37400,0,37400,115800,0,153200
141842602000000,NW 352,RESIDENTIAL,36100,0,36100,112200,0,148300
141842602100000,NW 352,RESIDENTIAL,36000,0,36000,117600,0,153600
141842602200000,NW 352,RESIDENTIAL,32300,0,32300,112800,0,145100
141842602300000,NW 352,RESIDENTIAL,30000,0,30000,112500,0,142500
141842602400000,NW 352,RESIDENTIAL,30000,0,30000,111600,0,141600
141842602500000,SECTION 42,RESIDENTIAL,8800,0,8800,36300,0,45100
141842602600000,SECTION 42,RESIDENTIAL,8900,0,8900,36300,0,45200
141842602700000,SECTION 42,RESIDENTIAL,8900,0,8900,36300,0,45200
141842602900000,NW 352,RESIDENTIAL,100,0,100,0,0,100
141842603000000,NW 352,RESIDENTIAL,100,0,100,0,0,100
141842603100000,NW 352,RESIDENTIAL,30300,0,30300,117500,0,147800
141842603600000,NW 352,RESIDENTIAL,200,0,200,0,0,200
141842603700000,NW 352,RESIDENTIAL,200,0,200,0,0,200
141842603800000,NW 352,RESIDENTIAL,300,0,300,0,0,300
141842603900000,NW 352,RESIDENTIAL,300,0,300,0,0,300
141842604000000,NW 352,RESIDENTIAL,200,0,200,0,0,200
141842604100000,NW 352,RESIDENTIAL,200,0,200,0,0,200
141842604500000,NW 302,AG LAND,3100,0,3100,0,0,3100
141842800100000,SECTION 42,RESIDENTIAL,10200,0,10200,34800,0,45000
141842800200000,SECTION 42,RESIDENTIAL,8900,0,8900,34700,0,43600
141842800300000,SECTION 42,RESIDENTIAL,8400,0,8400,35300,0,43700
141842800400000,SECTION 42,RESIDENTIAL,9400,0,9400,34200,0,43600
141842800500000,SECTION 42,RESIDENTIAL,9000,0,9000,35300,0,44300
141842800600000,SECTION 42,RESIDENTIAL,8800,0,8800,34200,0,43000
141842800700000,SECTION 42,RESIDENTIAL,9000,0,9000,37100,0,46100
141842800800000,NW 352,RESIDENTIAL,100,0,100,0,0,100
141842800900000,NW 352,RESIDENTIAL,36500,0,36500,140600,0,177100
141842801000000,NW 352,RESIDENTIAL,29700,0,29700,148400,0,178100
141842801100000,NW 352,RESIDENTIAL,35500,0,35500,145200,0,180700
141842801200000,SECTION 42,RESIDENTIAL,8600,0,8600,34200,0,42800
141842801300000,SECTION 42,RESIDENTIAL,8800,0,8800,34200,0,43000
141842801400000,SECTION 42,RESIDENTIAL,9100,0,9100,35300,0,44400
141842801500000,SECTION 42,RESIDENTIAL,9200,0,9200,35300,0,44500
141842801800000,SECTION 42,RESIDENTIAL,8300,0,8300,35300,0,43600
141842801900000,SECTION 42,RESIDENTIAL,8100,0,8100,35300,0,43400
141842802000000,SECTION 42,RESIDENTIAL,7400,0,7400,34800,0,42200
141842802100000,SECTION 42,RESIDENTIAL,9000,0,9000,34800,0,43800
141842900800000,NW 352,RESIDENTIAL,100,0,100,0,0,100
141842900900000,NW 352,RESIDENTIAL,100,0,100,0,0,100
141842901300000,NW 352,RESIDENTIAL,32200,0,32200,112200,0,144400
141842901400000,NW 352,RESIDENTIAL,28900,0,28900,156600,0,185500
141842901500000,NW 352,RESIDENTIAL,31100,0,31100,141500,0,172600
141842901600000,NW 352,RESIDENTIAL,27000,0,27000,139800,0,166800
141842901700000,NW 352,RESIDENTIAL,27000,0,27000,117100,0,144100
141842901900000,NW 352,RESIDENTIAL,31400,0,31400,115300,0,146700
141842902000000,NW 352,RESIDENTIAL,33600,0,33600,116700,0,150300
141842902100000,NW 352,RESIDENTIAL,32400,0,32400,142000,0,174400
141842902200000,NW 352,RESIDENTIAL,31200,0,31200,140900,0,172100
141842902300000,NW 352,RESIDENTIAL,30000,0,30000,158600,0,188600
141842902400000,NW 352,RESIDENTIAL,30000,0,30000,147000,0,177000
141842902500000,NW 352,RESIDENTIAL,30000,0,30000,143900,0,173900
141842902600000,NW 352,RESIDENTIAL,30000,0,30000,145800,0,175800
141842902700000,NW 352,RESIDENTIAL,30000,0,30000,158900,0,188900
141842902800000,NW 352,RESIDENTIAL,30000,0,30000,129000,0,159000
141842902900000,NW 352,RESIDENTIAL,30000,0,30000,136500,0,166500
141842903000000,NW 352,RESIDENTIAL,30000,0,30000,140900,0,170900
141842903100000,NW 352,RESIDENTIAL,30600,0,30600,4100,0,34700
141842903200000,NW 302,AG LAND,1300,0,1300,0,0,1300
141842903300000,NW 352,RESIDENTIAL,30700,0,30700,121300,0,152000
141842903700000,NW 352,RESIDENTIAL,35600,0,35600,135300,0,170900
141842903900000,NW 352,RESIDENTIAL,35900,0,35900,124500,0,160400
141842904100000,NW 352,RESIDENTIAL,26000,0,26000,118300,0,144300
141842904200000,NW 352,RESIDENTIAL,6800,0,6800,0,0,6800
141845100100000,NW 352,RESIDENTIAL,155000,0,155000,78100,0,233100
141845100300000,NW 302,RESIDENTIAL,155000,0,155000,135500,0,290500
141847600200000,NW 307,RESIDENTIAL,51200,0,51200,129000,0,180200
141847600300000,NW 307,RESIDENTIAL,42300,0,42300,201500,0,243800
141847600400000,NW 307,RESIDENTIAL,40100,0,40100,171200,0,211300
141847600500000,NW 307,RESIDENTIAL,41500,0,41500,166200,0,207700
141847600700000,NW 308,RESIDENTIAL,21600,0,21600,142100,0,163700
141847600800000,NW 308,RESIDENTIAL,32400,0,32400,96200,0,128600
141847600900000,NW 308,RESIDENTIAL,30500,0,30500,83000,0,113500
141847601000000,NW 308,RESIDENTIAL,27500,0,27500,116500,0,144000
141847601100000,NW 308,RESIDENTIAL,22500,0,22500,126600,0,149100
141847601200000,NW 308,RESIDENTIAL,27600,0,27600,106100,0,133700
141847601300000,NW 307,RESIDENTIAL,41600,0,41600,161500,0,203100
141847601400000,NW 307,RESIDENTIAL,40800,0,40800,141300,0,182100
141847601500000,NW 307,RESIDENTIAL,43600,0,43600,145000,0,188600
141847601600000,NW 307,RESIDENTIAL,41700,0,41700,146600,0,188300
141847601700000,NW 307,RESIDENTIAL,40300,0,40300,149700,0,190000
141847601800000,NW 307,RESIDENTIAL,41300,0,41300,141700,0,183000
141847601900000,NW 307,RESIDENTIAL,40100,0,40100,153600,0,193700
141847602000000,NW 307,RESIDENTIAL,43400,0,43400,202900,0,246300
141847602100000,NW 307,RESIDENTIAL,36200,0,36200,143800,0,180000
141847602200000,NW 307,RESIDENTIAL,41600,0,41600,146000,0,187600
141847602300000,NW 307,RESIDENTIAL,41800,0,41800,139300,0,181100
141847602400000,NW 307,RESIDENTIAL,38100,0,38100,138800,0,176900
141847602500000,NW 307,RESIDENTIAL,40700,0,40700,196500,0,237200
141847602600000,NW 307,RESIDENTIAL,43700,0,43700,160200,0,203900
141847602700000,NW 302,RESIDENTIAL,35000,0,35000,298000,0,333000
141847602800000,NW 302,RESIDENTIAL,35000,0,35000,235500,0,270500
141847602900000,NW 302,RESIDENTIAL,30600,0,30600,116300,0,146900
141847603000000,CITY PROPERTY,EXEMPT,0,0,0,0,0,0
141847700100000,NW 302,RESIDENTIAL,101300,0,101300,45700,0,147000
141847700300000,NW 308,RESIDENTIAL,24500,0,24500,113500,0,138000
141847700400000,NW 308,RESIDENTIAL,22500,0,22500,121300,0,143800
141847700500000,NW 308,RESIDENTIAL,22500,0,22500,87200,0,109700
141847700600000,NW 308,RESIDENTIAL,23900,0,23900,115500,0,139400
141847700700000,NW 308,RESIDENTIAL,21500,0,21500,77300,0,98800
141847700800000,NW 308,RESIDENTIAL,21800,0,21800,40600,0,62400
141847700900000,NW 308,RESIDENTIAL,22300,0,22300,133900,0,156200
141847701000000,NW 308,RESIDENTIAL,22600,0,22600,127700,0,150300
141847701100000,NW 308,RESIDENTIAL,20800,0,20800,89900,0,110700
141847701200000,NW 308,RESIDENTIAL,21000,0,21000,107600,0,128600
141847701300000,NW 302,RESIDENTIAL,43000,0,43000,0,0,43000
141847701400000,NW 302,RESIDENTIAL,49000,0,49000,278800,0,327800
141847701500000,NW 302,RESIDENTIAL,51100,0,51100,249600,0,300700
141847701600000,NW 302,RESIDENTIAL,43700,0,43700,257000,0,300700
141847701700000,NW 302,RESIDENTIAL,56900,0,56900,305200,0,362100
141847701800000,NW 302,RESIDENTIAL,54100,0,54100,239600,0,293700
141847701900000,NW 302,RESIDENTIAL,56400,0,56400,301700,0,358100
141847702000000,NW 302,RESIDENTIAL,53000,0,53000,0,0,53000
141847800100000,NW 307,RESIDENTIAL,43100,0,43100,148200,0,191300
141847800200000,NW 307,RESIDENTIAL,42200,0,42200,173600,0,215800
141847800300000,NW 307,RESIDENTIAL,41700,0,41700,151800,0,193500
141847800400000,NW 307,RESIDENTIAL,42400,0,42400,167600,0,210000
141847800500000,NW 307,RESIDENTIAL,40700,0,40700,173800,0,214500
141847800600000,NW 307,RESIDENTIAL,44900,0,44900,113500,0,158400
141847800700000,NW 308,RESIDENTIAL,18800,0,18800,98400,0,117200
141847800800000,NW 308,RESIDENTIAL,18600,0,18600,82000,0,100600
141847800900000,NW 308,RESIDENTIAL,23900,0,23900,127400,0,151300
141910100100000,NW 308,RESIDENTIAL,24400,0,24400,97500,0,121900
141910100200000,NW 308,RESIDENTIAL,24600,0,24600,111300,0,135900
141910100300000,NW 308,RESIDENTIAL,24600,0,24600,90500,0,115100
141910100400000,NW 308,RESIDENTIAL,24700,0,24700,114700,0,139400
141910100500000,NW 308,RESIDENTIAL,22800,0,22800,92000,0,114800
141910100600000,NW 308,RESIDENTIAL,30000,0,30000,86600,0,116600
141910100700000,NW 308,RESIDENTIAL,24700,0,24700,96200,0,120900
141910100800000,NW 308,RESIDENTIAL,30300,0,30300,83100,0,113400
141910200100000,NW 308,RESIDENTIAL,16600,0,16600,0,0,16600
141910200300000,NW 308,RESIDENTIAL,50100,0,50100,0,0,50100
141910200400000,NW 308,RESIDENTIAL,24200,0,24200,112600,0,136800
141910200500000,NW 308,RESIDENTIAL,23700,0,23700,97500,0,121200
141910200600000,NW 308,RESIDENTIAL,24400,0,24400,95300,0,119700
141910200700000,NW 308,RESIDENTIAL,26100,0,26100,129500,0,155600
141910200800000,NW 308,RESIDENTIAL,24400,0,24400,83100,0,107500
141910200900000,NW 308,RESIDENTIAL,24400,0,24400,105100,0,129500
141910201000000,NW 308,RESIDENTIAL,24500,0,24500,94500,0,119000
141910201100000,NW 308,RESIDENTIAL,23700,0,23700,101200,0,124900
141910201200000,NW 308,RESIDENTIAL,23200,0,23200,104500,0,127700
141910201300000,NW 308,RESIDENTIAL,26800,0,26800,102700,0,129500
141910201400000,NW 308,RESIDENTIAL,7300,0,7300,0,0,7300
141910300100000,NW 308,RESIDENTIAL,26400,0,26400,100900,0,127300
141910300200000,NW 308,RESIDENTIAL,26600,0,26600,93900,0,120500
141910300300000,NW 308,RESIDENTIAL,25900,0,25900,87000,0,112900
141910300400000,NW 308,RESIDENTIAL,24000,0,24000,103100,0,127100
141910300500000,NW 308,RESIDENTIAL,24300,0,24300,112800,0,137100
141910300600000,NW 308,RESIDENTIAL,26700,0,26700,53600,0,80300
141910300700000,NW 308,RESIDENTIAL,25500,0,25500,84200,0,109700
141910300800000,NW 308,RESIDENTIAL,24800,0,24800,117800,0,142600
141910300900000,NW 308,RESIDENTIAL,24500,0,24500,104700,0,129200
141910301000000,NW 308,RESIDENTIAL,25700,0,25700,106100,0,131800
141910301100000,NW 308,RESIDENTIAL,24300,0,24300,103600,0,127900
141910301200000,NW 308,RESIDENTIAL,24300,0,24300,106500,0,130800
141910301300000,NW 308,RESIDENTIAL,24300,0,24300,109700,0,134000
141910301400000,NW 308,RESIDENTIAL,24300,0,24300,100400,0,124700
141910301500000,NW 308,RESIDENTIAL,24300,0,24300,97900,0,122200
141910301600000,NW 308,RESIDENTIAL,25500,0,25500,104100,0,129600
141910301800000,NW 308,RESIDENTIAL,24900,0,24900,104700,0,129600
141910301900000,NW 308,RESIDENTIAL,36700,0,36700,110000,0,146700
141910302000000,NW 308,RESIDENTIAL,24700,0,24700,80600,0,105300
141910302100000,NW 308,RESIDENTIAL,28000,0,28000,99500,0,127500
141910302200000,NW 308,RESIDENTIAL,29200,0,29200,96300,0,125500
141910302300000,NW 308,RESIDENTIAL,25900,0,25900,117900,0,143800
141910302400000,NW 308,RESIDENTIAL,29500,0,29500,95500,0,125000
141910302500000,NW 308,RESIDENTIAL,26300,0,26300,121200,0,147500
141910302600000,NW 308,RESIDENTIAL,27100,0,27100,100500,0,127600
141910302700000,NW 308,RESIDENTIAL,24300,0,24300,97900,0,122200
141910302800000,NW 308,RESIDENTIAL,24300,0,24300,101200,0,125500
141910302900000,NW 308,RESIDENTIAL,24300,0,24300,114600,0,138900
141910303000000,NW 308,RESIDENTIAL,24500,0,24500,90700,0,115200
141910303100000,NW 308,RESIDENTIAL,28200,0,28200,93500,0,121700
141910303200000,NW 308,RESIDENTIAL,28200,0,28200,71200,0,99400
141910400100000,NW 308,RESIDENTIAL,24000,0,24000,93700,0,117700
141910400200000,NW 308,RESIDENTIAL,24000,0,24000,102800,0,126800
141910400300000,NW 308,RESIDENTIAL,24300,0,24300,92400,0,116700
141910400400000,NW 308,RESIDENTIAL,25700,0,25700,47100,0,72800
141910400500000,NW 308,RESIDENTIAL,27900,0,27900,109000,0,136900
141910400600000,NW 308,RESIDENTIAL,44000,0,44000,98300,0,142300
141910400700000,NW 308,RESIDENTIAL,27900,0,27900,101500,0,129400
141910400800000,NW 308,RESIDENTIAL,26900,0,26900,134000,0,160900
141910400900000,NW 308,RESIDENTIAL,24100,0,24100,120800,0,144900
141910401000000,NW 308,RESIDENTIAL,24100,0,24100,96800,0,120900
141910401100000,NW 308,RESIDENTIAL,24100,0,24100,104600,0,128700
141910401200000,NW 308,RESIDENTIAL,24100,0,24100,109300,0,133400
141910401300000,NW 308,RESIDENTIAL,24100,0,24100,99800,0,123900
141910401400000,NW 308,RESIDENTIAL,24100,0,24100,91500,0,115600
141910401500000,NW 308,RESIDENTIAL,24500,0,24500,98800,0,123300
141910401600000,NW 308,RESIDENTIAL,25800,0,25800,114400,0,140200
141910401700000,NW 308,RESIDENTIAL,24100,0,24100,86200,0,110300
141910401800000,NW 308,RESIDENTIAL,24100,0,24100,91800,0,115900
141910401900000,NW 308,RESIDENTIAL,24100,0,24100,99300,0,123400
141910402000000,NW 308,RESIDENTIAL,24100,0,24100,102900,0,127000
141910402100000,NW 308,RESIDENTIAL,24100,0,24100,96600,0,120700
141910402200000,NW 308,RESIDENTIAL,24100,0,24100,106500,0,130600
141910402300000,NW 308,RESIDENTIAL,24100,0,24100,71900,0,96000
141910402400000,NW 308,RESIDENTIAL,31000,0,31000,106300,0,137300
141910500100000,NW 308,RESIDENTIAL,39600,0,39600,127800,0,167400
141910500200000,NW 308,RESIDENTIAL,39800,0,39800,106100,0,145900
141910500300000,NW 308,RESIDENTIAL,8700,0,8700,0,0,8700
141910500400000,NW 308,RESIDENTIAL,40200,0,40200,111700,0,151900
141910500500000,NW 308,RESIDENTIAL,21200,0,21200,0,0,21200
141910500600000,NW 308,RESIDENTIAL,54200,0,54200,122200,0,176400
141910500700000,NW 308,RESIDENTIAL,33100,0,33100,102600,0,135700
141910500800000,NW 308,RESIDENTIAL,25800,0,25800,104100,0,129900
141910500900000,NW 308,RESIDENTIAL,24100,0,24100,92300,0,116400
141910501000000,NW 308,RESIDENTIAL,24100,0,24100,99800,0,123900
141910501100000,NW 308,RESIDENTIAL,24100,0,24100,99000,0,123100
141910501200000,NW 308,RESIDENTIAL,24100,0,24100,121600,0,145700
141910501300000,NW 308,RESIDENTIAL,24100,0,24100,100,0,24200
141910501400000,NW 308,RESIDENTIAL,24100,0,24100,118800,0,142900
141910501500000,NW 308,RESIDENTIAL,24100,0,24100,123200,0,147300
141910501600000,NW 308,RESIDENTIAL,24100,0,24100,113400,0,137500
141910501700000,NW 308,RESIDENTIAL,26000,0,26000,116800,0,142800
141912600100000,NW 308,RESIDENTIAL,37000,0,37000,204500,0,241500
141912600200000,NW 308,RESIDENTIAL,38400,0,38400,233300,0,271700
141912600300000,NW 308,RESIDENTIAL,38400,0,38400,211804,0,250204
141912600400000,NW 308,RESIDENTIAL,34600,0,34600,186500,0,221100
141912600500000,NW 308,RESIDENTIAL,36200,0,36200,222500,0,258700
141912600600000,NW 308,RESIDENTIAL,38100,0,38100,233094,0,271194
141912600700000,NW 308,RESIDENTIAL,35900,0,35900,197000,0,232900
141912600800000,NW 308,RESIDENTIAL,36700,0,36700,161000,0,197700
141912600900000,NW 308,RESIDENTIAL,27900,0,27900,126600,0,154500
141912601000000,NW 308,RESIDENTIAL,28000,0,28000,115600,0,143600
141912601100000,NW 308,RESIDENTIAL,27700,0,27700,105600,0,133300
141912601200000,NW 308,RESIDENTIAL,27900,0,27900,79700,0,107600
141912601300000,NW 308,RESIDENTIAL,27800,0,27800,82700,0,110500
141912601400000,NW 308,RESIDENTIAL,28300,0,28300,104800,0,133100
141912601500000,NW 308,RESIDENTIAL,28300,0,28300,103700,0,132000
141912601600000,NW 308,RESIDENTIAL,27500,0,27500,70800,0,98300
141912601700000,NW 308,RESIDENTIAL,28200,0,28200,77900,0,106100
141912601800000,NW 308,RESIDENTIAL,26500,0,26500,83400,0,109900
141912601900000,NW 308,RESIDENTIAL,23400,0,23400,70400,0,93800
141912700100000,NW 308,RESIDENTIAL,41300,0,41300,184500,0,225800
141912700200000,NW 338,RESIDENTIAL,36700,0,36700,160200,0,196900
141912700300000,NW 338,RESIDENTIAL,36600,0,36600,133400,0,170000
141912700400000,NW 338,RESIDENTIAL,36600,0,36600,158200,0,194800
141912700500000,NW 338,RESIDENTIAL,36600,0,36600,119100,0,155700
141912700600000,NW 338,RESIDENTIAL,33700,0,33700,144300,0,178000
141912700700000,NW 338,RESIDENTIAL,33700,0,33700,95100,0,128800
141912700800000,NW 338,RESIDENTIAL,33700,0,33700,123700,0,157400
141912700900000,NW 338,RESIDENTIAL,34100,0,34100,130700,0,164800
141912701000000,NW 338,RESIDENTIAL,34100,0,34100,111400,0,145500
141912701100000,NW 338,RESIDENTIAL,34100,0,34100,144700,0,178800
141912701200000,NW 338,RESIDENTIAL,34100,0,34100,131200,0,165300
141912701300000,NW 338,RESIDENTIAL,34100,0,34100,155000,0,189100
141912701400000,NW 338,RESIDENTIAL,34600,0,34600,145400,0,180000
141912701500000,NW 338,RESIDENTIAL,36000,0,36000,132800,0,168800
141912701600000,NW 338,RESIDENTIAL,31400,0,31400,178900,0,210300
141912701700000,NW 338,RESIDENTIAL,31400,0,31400,140200,0,171600
141912701800000,NW 308,RESIDENTIAL,25500,0,25500,95400,0,120900
141912701900000,NW 308,RESIDENTIAL,25800,0,25800,90100,0,115900
141912702000000,NW 308,RESIDENTIAL,19600,0,19600,109100,0,128700
141912702100000,NW 308,RESIDENTIAL,18400,0,18400,93400,0,111800
141912702200000,NW 308,RESIDENTIAL,23200,0,23200,90200,0,113400
141912702300000,NW 308,RESIDENTIAL,22700,0,22700,75200,0,97900
141912702400000,NW 308,RESIDENTIAL,23900,0,23900,123700,0,147600
141912702500000,NW 308,RESIDENTIAL,23700,0,23700,96800,0,120500
141912702600000,NW 308,RESIDENTIAL,25700,0,25700,98000,0,123700
141912702700000,NW 308,RESIDENTIAL,26100,0,26100,98700,0,124800
141912702800000,NW 308,RESIDENTIAL,26500,0,26500,55700,0,82200
141912702900000,NW 308,RESIDENTIAL,26600,0,26600,99500,0,126100
141912703000000,NW 308,RESIDENTIAL,26800,0,26800,93600,0,120400
141912703100000,NW 308,RESIDENTIAL,26800,0,26800,86800,0,113600
141912703200000,NW 308,RESIDENTIAL,26000,0,26000,84300,0,110300
141912703300000,NW 308,RESIDENTIAL,25500,0,25500,65600,0,91100
141912703400000,NW 308,RESIDENTIAL,26000,0,26000,82100,0,108100
141912703500000,NW 308,RESIDENTIAL,25900,0,25900,88900,0,114800
141912703600000,NW 308,RESIDENTIAL,68400,0,68400,221800,0,290200
141912703700000,NW 308,RESIDENTIAL,25100,0,25100,104200,0,129300
141912703800000,NW 308,RESIDENTIAL,25600,0,25600,84300,0,109900
141912703900000,NW 308,RESIDENTIAL,26800,0,26800,103000,0,129800
141912704000000,NW 308,RESIDENTIAL,26300,0,26300,94200,0,120500
141912704100000,NW 308,RESIDENTIAL,26300,0,26300,94500,0,120800
141912704200000,NW 308,RESIDENTIAL,26500,0,26500,98800,0,125300
141912704300000,NW 308,RESIDENTIAL,25700,0,25700,89700,0,115400
141912704400000,NW 308,RESIDENTIAL,26300,0,26300,110000,0,136300
141912704500000,NW 308,RESIDENTIAL,26100,0,26100,86600,0,112700
141912704600000,NW 308,RESIDENTIAL,26500,0,26500,103100,0,129600
141912704700000,NW 308,RESIDENTIAL,26600,0,26600,108400,0,135000
141912704800000,NW 308,RESIDENTIAL,26700,0,26700,80900,0,107600
141912704900000,NW 308,RESIDENTIAL,26700,0,26700,76700,0,103400
141912705000000,NW 308,RESIDENTIAL,27200,0,27200,106100,0,133300
141912705100000,NW 308,RESIDENTIAL,27300,0,27300,88100,0,115400
141912705200000,NW 308,RESIDENTIAL,26500,0,26500,112000,0,138500
141912705300000,NW 308,RESIDENTIAL,26700,0,26700,100600,0,127300
141912705400000,NW 308,RESIDENTIAL,27000,0,27000,81800,0,108800
141912705500000,NW 308,RESIDENTIAL,26900,0,26900,92500,0,119400
141912705600000,NW 308,RESIDENTIAL,36000,0,36000,152500,0,188500
141912705700000,NW 308,RESIDENTIAL,35300,0,35300,201600,0,236900
141912705800000,NW 308,RESIDENTIAL,36800,0,36800,197600,0,234400
141912705900000,NW 308,RESIDENTIAL,34900,0,34900,186900,0,221800
141912706000000,NW 308,RESIDENTIAL,36500,0,36500,236000,0,272500
141912706100000,NW 308,RESIDENTIAL,36100,0,36100,178600,0,214700
141912706200000,NW 308,RESIDENTIAL,42200,0,42200,243900,0,286100
141912800100000,NW 338,RESIDENTIAL,33700,0,33700,125800,0,159500
141912800200000,NW 308,RESIDENTIAL,26300,0,26300,136300,0,162600
141912800300000,NW 308,RESIDENTIAL,25500,0,25500,113200,0,138700
141912800400000,NW 308,RESIDENTIAL,25000,0,25000,113900,0,138900
141912800500000,NW 308,RESIDENTIAL,26100,0,26100,128000,0,154100
141912800600000,NW 308,RESIDENTIAL,26300,0,26300,111300,0,137600
141912800700000,NW 308,RESIDENTIAL,26300,0,26300,92900,0,119200
141912800800000,NW 308,RESIDENTIAL,26300,0,26300,111300,0,137600
141912800900000,NW 308,RESIDENTIAL,26300,0,26300,101500,0,127800
141912801000000,NW 308,RESIDENTIAL,26300,0,26300,116600,0,142900
141912801100000,NW 308,RESIDENTIAL,26300,0,26300,107600,0,133900
141912801200000,NW 308,RESIDENTIAL,26300,0,26300,102400,0,128700
141912801300000,NW 308,RESIDENTIAL,26300,0,26300,113500,0,139800
141912801400000,NW 308,RESIDENTIAL,26300,0,26300,106000,0,132300
141912801500000,NW 338,EXEMPT,0,34500,34500,0,108400,142900
141912801600000,NW 338,RESIDENTIAL,33700,0,33700,120200,0,153900
141912801700000,NW 338,RESIDENTIAL,33700,0,33700,137700,0,171400
141912801800000,NW 338,RESIDENTIAL,33700,0,33700,151200,0,184900
141912801900000,NW 338,RESIDENTIAL,33700,0,33700,151700,0,185400
141912802000000,NW 338,RESIDENTIAL,33700,0,33700,166800,0,200500
141912802100000,NW 338,RESIDENTIAL,33700,0,33700,151600,0,185300
141912802200000,NW 338,RESIDENTIAL,33700,0,33700,145300,0,179000
141912802300000,NW 338,RESIDENTIAL,33700,0,33700,155100,0,188800
141912802400000,NW 338,RESIDENTIAL,33700,0,33700,147200,0,180900
141912802500000,NW 338,RESIDENTIAL,33700,0,33700,133700,0,167400
141912802600000,NW 338,RESIDENTIAL,33700,0,33700,134100,0,167800
141912900100000,NW 308,RESIDENTIAL,27200,0,27200,125100,0,152300
141912900200000,NW 308,RESIDENTIAL,26700,0,26700,114500,0,141200
141912900300000,NW 308,RESIDENTIAL,26700,0,26700,114300,0,141000
141912900400000,NW 308,RESIDENTIAL,26700,0,26700,143900,0,170600
141912900500000,NW 308,RESIDENTIAL,25000,0,25000,133000,0,158000
141912900600000,NW 308,RESIDENTIAL,25000,0,25000,100400,0,125400
141912900700000,NW 308,RESIDENTIAL,25000,0,25000,93700,0,118700
141912900800000,NW 308,RESIDENTIAL,25000,0,25000,85700,0,110700
141912900900000,NW 308,RESIDENTIAL,25000,0,25000,100400,0,125400
141912901000000,NW 308,RESIDENTIAL,25000,0,25000,77600,0,102600
141912901100000,NW 308,RESIDENTIAL,25000,0,25000,106700,0,131700
141912901200000,NW 308,RESIDENTIAL,25000,0,25000,109600,0,134600
141912901300000,NW 308,RESIDENTIAL,25000,0,25000,84800,0,109800
141912901400000,NW 308,RESIDENTIAL,25000,0,25000,101200,0,126200
141912901500000,NW 308,RESIDENTIAL,25000,0,25000,86900,0,111900
141912901600000,NW 308,RESIDENTIAL,25000,0,25000,97800,0,122800
141912901700000,NW 308,RESIDENTIAL,25300,0,25300,114100,0,139400
141912901800000,NW 308,RESIDENTIAL,24300,0,24300,107600,0,131900
141915100100000,NW 306,RESIDENTIAL,38800,0,38800,110000,0,148800
141915100200000,NW 306,RESIDENTIAL,32300,0,32300,56600,0,88900
141915100300000,NW 306,RESIDENTIAL,57000,0,57000,134500,0,191500
141915100400000,NW 306,RESIDENTIAL,28000,0,28000,104300,0,132300
141915100500000,NW 306,RESIDENTIAL,26000,0,26000,102700,0,128700
141915100600000,NW 306,RESIDENTIAL,26000,0,26000,105400,0,131400
141915100700000,NW 306,RESIDENTIAL,26200,0,26200,102200,0,128400
141915100800000,NW 306,RESIDENTIAL,26500,0,26500,86000,0,112500
141915100900000,NW 306,RESIDENTIAL,27000,0,27000,93500,0,120500
141915101000000,NW 306,RESIDENTIAL,27700,0,27700,102800,0,130500
141915101100000,NW 306,RESIDENTIAL,27700,0,27700,95700,0,123400
141915101200000,NW 306,RESIDENTIAL,23200,0,23200,105100,0,128300
141915101300000,NW 306,RESIDENTIAL,23300,0,23300,82800,0,106100
141915101400000,NW 306,RESIDENTIAL,24800,0,24800,107500,0,132300
141915101500000,NW 306,RESIDENTIAL,26500,0,26500,90900,0,117400
141915101600000,NW 306,RESIDENTIAL,28200,0,28200,87700,0,115900
141915101700000,NW 306,RESIDENTIAL,32900,0,32900,109300,0,142200
141915200100000,NW 306,RESIDENTIAL,23900,0,23900,83100,0,107000
141915200200000,NW 306,RESIDENTIAL,21800,0,21800,76200,0,98000
141915200300000,NW 306,RESIDENTIAL,24900,0,24900,99600,0,124500
141915200400000,NW 306,RESIDENTIAL,26300,0,26300,75300,0,101600
141915200500000,NW 306,RESIDENTIAL,26300,0,26300,75200,0,101500
141915200600000,NW 306,RESIDENTIAL,26000,0,26000,54300,0,80300
141915200700000,NW 306,RESIDENTIAL,26000,0,26000,56900,0,82900
141915200800000,NW 306,RESIDENTIAL,26000,0,26000,67400,0,93400
141915200900000,NW 308,RESIDENTIAL,29400,0,29400,69700,0,99100
141915201000000,NW 308,RESIDENTIAL,23300,0,23300,96000,0,119300
141915201100000,NW 308,RESIDENTIAL,23000,0,23000,84100,0,107100
141915201200000,NW 308,RESIDENTIAL,20800,0,20800,88000,0,108800
141915201300000,NW 308,RESIDENTIAL,22300,0,22300,101900,0,124200
141915201400000,NW 308,RESIDENTIAL,23000,0,23000,122600,0,145600
141915201500000,NW 308,RESIDENTIAL,23000,0,23000,115000,0,138000
141915201600000,NW 308,RESIDENTIAL,23400,0,23400,100900,0,124300
141915201700000,NW 308,RESIDENTIAL,28300,0,28300,137400,0,165700
141915201800000,NW 308,RESIDENTIAL,24700,0,24700,102500,0,127200
141915201900000,NW 308,RESIDENTIAL,27000,0,27000,92700,0,119700
141915202000000,NW 308,RESIDENTIAL,26400,0,26400,88800,0,115200
141915202100000,NW 308,RESIDENTIAL,24800,0,24800,102000,0,126800
141915202200000,NW 308,RESIDENTIAL,24800,0,24800,95800,0,120600
141915202300000,NW 308,RESIDENTIAL,24400,0,24400,92800,0,117200
141915202400000,NW 306,RESIDENTIAL,63600,0,63600,191900,0,255500
141915202500000,NW 308,RESIDENTIAL,26400,0,26400,108200,0,134600
141915202600000,NW 308,RESIDENTIAL,25000,0,25000,111100,0,136100
141915202700000,NW 308,RESIDENTIAL,25500,0,25500,119200,0,144700
141915202800000,NW 308,RESIDENTIAL,27600,0,27600,123600,0,151200
141915202900000,NW 308,RESIDENTIAL,28500,0,28500,111600,0,140100
141915203000000,NW 308,RESIDENTIAL,28200,0,28200,123000,0,151200
141915203100000,NW 308,RESIDENTIAL,27200,0,27200,99500,0,126700
141915203200000,NW 308,RESIDENTIAL,27200,0,27200,92000,0,119200
141915203300000,NW 308,RESIDENTIAL,27200,0,27200,98800,0,126000
141915203400000,NW 308,RESIDENTIAL,27000,0,27000,106200,0,133200
141915203500000,NW 308,RESIDENTIAL,26900,0,26900,118200,0,145100
141915203600000,NW 308,RESIDENTIAL,26900,0,26900,112100,0,139000
141915203700000,NW 341,RESIDENTIAL,34200,0,34200,207400,0,241600
141915203800000,NW 341,RESIDENTIAL,34200,0,34200,160300,0,194500
141915203900000,NW 341,RESIDENTIAL,33600,0,33600,161100,0,194700
141915204000000,NW 341,RESIDENTIAL,34000,0,34000,167500,0,201500
141915204100000,NW 341,RESIDENTIAL,32600,0,32600,0,0,32600
141915204200000,NW 341,RESIDENTIAL,40200,0,40200,244500,0,284700
141915204300000,NW 341,RESIDENTIAL,36000,0,36000,248600,0,284600
141915204400000,NW 341,RESIDENTIAL,33800,0,33800,0,0,33800
141915204500000,NW 341,RESIDENTIAL,33000,0,33000,291000,0,324000
141915204600000,NW 341,RESIDENTIAL,40100,0,40100,208100,0,248200
141915204700000,NW 341,RESIDENTIAL,34400,0,34400,0,0,34400
141915204800000,NW 341,RESIDENTIAL,33300,0,33300,0,0,33300
141915204900000,NW 341,RESIDENTIAL,29700,0,29700,224200,0,253900
141915205000000,NW 306,RESIDENTIAL,33800,0,33800,89900,0,123700
141915205100000,NW 306,RESIDENTIAL,29100,0,29100,100400,0,129500
141915205200000,NW 306,RESIDENTIAL,29700,0,29700,96800,0,126500
141915205300000,NW 306,RESIDENTIAL,28500,0,28500,122200,0,150700
141915205400000,NW 306,RESIDENTIAL,28700,0,28700,100000,0,128700
141915205500000,NW 306,RESIDENTIAL,28900,0,28900,95600,0,124500
141915205600000,NW 306,RESIDENTIAL,34700,0,34700,84900,0,119600
141915205700000,NW 306,RESIDENTIAL,30600,0,30600,121700,0,152300
141915205800000,NW 306,RESIDENTIAL,21300,0,21300,85600,0,106900
141915205900000,NW 306,RESIDENTIAL,27300,0,27300,71700,0,99000
141915206000000,NW 306,RESIDENTIAL,27300,0,27300,73600,0,100900
141915206100000,NW 306,RESIDENTIAL,23400,0,23400,79800,0,103200
141915300100000,NW 308,RESIDENTIAL,26300,0,26300,98100,0,124400
141915300200000,NW 308,RESIDENTIAL,25500,0,25500,100600,0,126100
141915300300000,NW 308,RESIDENTIAL,26300,0,26300,95700,0,122000
141915300400000,NW 308,RESIDENTIAL,27000,0,27000,108400,0,135400
141915400100000,NW 308,RESIDENTIAL,26400,0,26400,85300,0,111700
141915400200000,NW 308,RESIDENTIAL,25700,0,25700,92800,0,118500
141915400300000,NW 308,RESIDENTIAL,25600,0,25600,96600,0,122200
141915400400000,NW 308,RESIDENTIAL,26400,0,26400,109300,0,135700
141915400500000,NW 308,RESIDENTIAL,26600,0,26600,114300,0,140900
141915400600000,NW 308,RESIDENTIAL,23800,0,23800,91300,0,115100
141915400700000,NW 308,RESIDENTIAL,24900,0,24900,94900,0,119800
141915400800000,NW 308,RESIDENTIAL,24400,0,24400,128700,0,153100
141915400900000,NW 308,RESIDENTIAL,25500,0,25500,124600,0,150100
141915401000000,NW 308,RESIDENTIAL,27500,0,27500,136300,0,163800
141915401100000,NW 308,RESIDENTIAL,27500,0,27500,125800,0,153300
141915401200000,NW 308,RESIDENTIAL,27500,0,27500,125700,0,153200
141915401300000,NW 308,RESIDENTIAL,29100,0,29100,125200,0,154300
141915401400000,NW 308,RESIDENTIAL,26500,0,26500,125300,0,151800
141915401500000,NW 308,RESIDENTIAL,26300,0,26300,99400,0,125700
141915401600000,NW 308,RESIDENTIAL,25000,0,25000,102900,0,127900
141915500100000,NW 341,RESIDENTIAL,37200,0,37200,246000,0,283200
141915500200000,NW 341,RESIDENTIAL,34200,0,34200,207800,0,242000
141915500300000,NW 341,RESIDENTIAL,34200,0,34200,172200,0,206400
141915500400000,NW 341,RESIDENTIAL,34200,0,34200,201600,0,235800
141915500500000,NW 341,RESIDENTIAL,34200,0,34200,176600,0,210800
141915500600000,NW 341,RESIDENTIAL,29400,0,29400,0,0,29400
141915500700000,NW 341,RESIDENTIAL,30500,0,30500,0,0,30500
141915500800000,NW 341,RESIDENTIAL,28800,0,28800,218000,0,246800
141915500900000,NW 341,RESIDENTIAL,33800,0,33800,233400,0,267200
141915501000000,NW 341,RESIDENTIAL,37200,0,37200,183500,0,220700
141917600100000,NW 306,RESIDENTIAL,43200,0,43200,95600,0,138800
141917600200000,NW 306,RESIDENTIAL,43100,0,43100,185200,0,228300
141917600300000,NW 306,RESIDENTIAL,23900,0,23900,66100,0,90000
141917600400000,NW 306,RESIDENTIAL,23900,0,23900,83000,0,106900
141917600500000,NW 306,RESIDENTIAL,23900,0,23900,72200,0,96100
141917600600000,NW 306,RESIDENTIAL,23900,0,23900,75000,0,98900
141917600700000,NW 306,RESIDENTIAL,42700,0,42700,58300,0,101000
141917600800000,NW 306,RESIDENTIAL,33500,0,33500,84200,0,117700
141917600900000,NW 306,RESIDENTIAL,49800,0,49800,55700,0,105500
141917601000000,NW 306,RESIDENTIAL,23700,0,23700,87500,0,111200
141917601100000,NW 306,RESIDENTIAL,5200,0,5200,0,0,5200
141917601200000,NW 306,RESIDENTIAL,24200,0,24200,81500,0,105700
141917601300000,NW 306,RESIDENTIAL,26200,0,26200,94400,0,120600
141917601400000,NW 306,RESIDENTIAL,26200,0,26200,42000,0,68200
141917601500000,NW 306,RESIDENTIAL,24300,0,24300,76400,0,100700
141917601600000,NW 306,RESIDENTIAL,22400,0,22400,73400,0,95800
141917601700000,NW 306,RESIDENTIAL,22400,0,22400,80100,0,102500
141917601800000,NW 306,RESIDENTIAL,22400,0,22400,82800,0,105200
141917601900000,NW 306,RESIDENTIAL,24400,0,24400,85300,0,109700
141917602000000,NW 306,RESIDENTIAL,63900,0,63900,125600,0,189500
141917602100000,NW 306,RESIDENTIAL,80600,0,80600,66600,0,147200
141917602200000,NW 306,RESIDENTIAL,75000,0,75000,0,0,75000
141917602300000,NW 306,RESIDENTIAL,45200,0,45200,142400,0,187600
141917602400000,NW 306,RESIDENTIAL,20700,0,20700,1200,0,21900
141917602500000,NW 306,RESIDENTIAL,19700,0,19700,88100,0,107800
141917602600000,NW 306,RESIDENTIAL,62000,0,62000,192700,0,254700
141917602700000,NW 313,RESIDENTIAL,38300,0,38300,224700,0,263000
141917602800000,NW 313,RESIDENTIAL,37800,0,37800,175000,0,212800
141917602900000,NW 313,RESIDENTIAL,38500,0,38500,198800,0,237300
141917603000000,NW 313,RESIDENTIAL,52800,0,52800,258800,0,311600
141917603100000,NW 313,RESIDENTIAL,46900,0,46900,224400,0,271300
141917603200000,NW 313,RESIDENTIAL,36200,0,36200,288900,0,325100
141917603300000,NW 313,RESIDENTIAL,33600,0,33600,232000,0,265600
141917603400000,NW 313,RESIDENTIAL,33600,0,33600,213600,0,247200
141917603500000,NW 313,RESIDENTIAL,39200,0,39200,248800,0,288000
141917603600000,NW 306,RESIDENTIAL,78800,0,78800,187500,0,266300
141917603700000,NW 306,RESIDENTIAL,3500,0,3500,0,0,3500
141917603800000,NW 306,RESIDENTIAL,7300,0,7300,0,0,7300
141917700100000,NW 306,RESIDENTIAL,34500,0,34500,27600,0,62100
141920100100000,NW 308,RESIDENTIAL,24500,0,24500,105200,0,129700
141920100200000,NW 308,RESIDENTIAL,25100,0,25100,112500,0,137600
141920100300000,NW 308,RESIDENTIAL,25100,0,25100,112500,0,137600
141920100400000,NW 308,RESIDENTIAL,25100,0,25100,112500,0,137600
141920100500000,NW 308,RESIDENTIAL,25100,0,25100,96700,0,121800
141920100600000,NW 308,RESIDENTIAL,25100,0,25100,108900,0,134000
141920100700000,NW 308,RESIDENTIAL,25100,0,25100,113500,0,138600
141920100800000,NW 308,RESIDENTIAL,25100,0,25100,119800,0,144900
141920100900000,NW 308,RESIDENTIAL,29400,0,29400,119200,0,148600
141920101000000,NW 308,RESIDENTIAL,26500,0,26500,103000,0,129500
141920101100000,NW 308,RESIDENTIAL,25300,0,25300,93800,0,119100
141920101200000,NW 308,RESIDENTIAL,26500,0,26500,114500,0,141000
141920101300000,NW 308,RESIDENTIAL,26500,0,26500,75900,0,102400
141920101400000,NW 308,RESIDENTIAL,26200,0,26200,117900,0,144100
141920101500000,NW 308,RESIDENTIAL,25300,0,25300,104000,0,129300
141920101600000,NW 308,RESIDENTIAL,25300,0,25300,106000,0,131300
141920101700000,NW 308,RESIDENTIAL,25800,0,25800,91100,0,116900
141920101800000,NW 308,RESIDENTIAL,24800,0,24800,90900,0,115700
141920101900000,NW 308,RESIDENTIAL,25600,0,25600,98500,0,124100
141920200100000,NW 308,RESIDENTIAL,26100,0,26100,96400,0,122500
141920200200000,NW 308,RESIDENTIAL,27100,0,27100,118300,0,145400
141920200300000,NW 308,RESIDENTIAL,27200,0,27200,126200,0,153400
141920200400000,NW 308,RESIDENTIAL,28500,0,28500,93300,0,121800
141920200500000,NW 308,RESIDENTIAL,36900,0,36900,118800,0,155700
141920200600000,NW 308,RESIDENTIAL,26500,0,26500,117300,0,143800
141920200700000,NW 308,RESIDENTIAL,26800,0,26800,105000,0,131800
141920200800000,NW 308,RESIDENTIAL,26200,0,26200,128200,0,154400
141920200900000,NW 308,RESIDENTIAL,26200,0,26200,115300,0,141500
141920201000000,NW 308,RESIDENTIAL,26300,0,26300,116500,0,142800
141920201100000,NW 308,RESIDENTIAL,25300,0,25300,122200,0,147500
141920201200000,NW 308,RESIDENTIAL,25000,0,25000,109100,0,134100
141920201300000,NW 308,RESIDENTIAL,25000,0,25000,129400,0,154400
141920201400000,NW 308,RESIDENTIAL,25000,0,25000,92100,0,117100
141920201500000,NW 308,RESIDENTIAL,25000,0,25000,134800,0,159800
141920201600000,NW 308,RESIDENTIAL,25000,0,25000,121600,0,146600
141920201700000,NW 308,RESIDENTIAL,25000,0,25000,103800,0,128800
141920201800000,NW 308,RESIDENTIAL,25000,0,25000,102700,0,127700
141920201900000,NW 308,RESIDENTIAL,25000,0,25000,108500,0,133500
141920202000000,NW 308,RESIDENTIAL,24500,0,24500,100100,0,124600
141920202100000,APARTMENT,RESIDENTIAL,48500,0,48500,300200,0,348700
141920202200000,APARTMENT,RESIDENTIAL,48100,0,48100,322300,0,370400
141920202300000,APARTMENT,RESIDENTIAL,51000,0,51000,309400,0,360400
141920202400000,APARTMENT,RESIDENTIAL,80800,0,80800,565000,0,645800
141920202600000,NW 308,RESIDENTIAL,20200,0,20200,85500,0,105700
141920202700000,NW 308,RESIDENTIAL,20200,0,20200,83600,0,103800
141920202800000,NW 308,RESIDENTIAL,25300,0,25300,92700,0,118000
141920202900000,NW 308,RESIDENTIAL,25800,0,25800,95300,0,121100
141920203000000,NW 308,RESIDENTIAL,25800,0,25800,90000,0,115800
141920203100000,NW 308,RESIDENTIAL,26700,0,26700,96800,0,123500
141920203200000,NW 308,RESIDENTIAL,27000,0,27000,116300,0,143300
141920203300000,NW 308,RESIDENTIAL,27000,0,27000,110100,0,137100
141920203400000,NW 308,RESIDENTIAL,25800,0,25800,94500,0,120300
141920203500000,NW 308,RESIDENTIAL,27000,0,27000,100800,0,127800
141920203600000,NW 308,RESIDENTIAL,27000,0,27000,102800,0,129800
141920203700000,NW 308,RESIDENTIAL,25600,0,25600,128800,0,154400
141920203800000,NW 308,RESIDENTIAL,25600,0,25600,126900,0,152500
141920203900000,NW 308,RESIDENTIAL,26600,0,26600,130800,0,157400
141920204000000,NW 308,RESIDENTIAL,33400,0,33400,169300,0,202700
141920204100000,NW 308,RESIDENTIAL,27000,0,27000,126600,0,153600
141920204200000,NW 308,RESIDENTIAL,29200,0,29200,112200,0,141400
141920204400000,NW 308,RESIDENTIAL,64700,0,64700,153600,0,218300
141920300100000,NW 308,RESIDENTIAL,28400,0,28400,118900,0,147300
141920300200000,NW 308,RESIDENTIAL,29000,0,29000,115900,0,144900
141920300300000,NW 308,RESIDENTIAL,28200,0,28200,108200,0,136400
141920300400000,NW 308,RESIDENTIAL,28600,0,28600,99600,0,128200
141920300500000,NW 308,RESIDENTIAL,27600,0,27600,109600,0,137200
141920300600000,NW 308,RESIDENTIAL,29800,0,29800,102600,0,132400
141920300700000,NW 308,RESIDENTIAL,24800,0,24800,100700,0,125500
141920300800000,NW 308,RESIDENTIAL,24800,0,24800,106300,0,131100
141920300900000,NW 308,RESIDENTIAL,24800,0,24800,101800,0,126600
141920301000000,NW 308,RESIDENTIAL,24800,0,24800,103300,0,128100
141920301100000,NW 308,RESIDENTIAL,24800,0,24800,113100,0,137900
141920301200000,NW 308,RESIDENTIAL,24800,0,24800,110500,0,135300
141920301300000,NW 308,RESIDENTIAL,24800,0,24800,108100,0,132900
141920301400000,NW 308,RESIDENTIAL,24800,0,24800,116400,0,141200
141920301500000,NW 308,RESIDENTIAL,25000,0,25000,97200,0,122200
141920301600000,NW 308,RESIDENTIAL,26000,0,26000,112700,0,138700
141920301700000,NW 308,RESIDENTIAL,24800,0,24800,103200,0,128000
141920301800000,NW 308,RESIDENTIAL,24800,0,24800,115300,0,140100
141920301900000,NW 308,RESIDENTIAL,24800,0,24800,115400,0,140200
141920302000000,NW 308,RESIDENTIAL,24800,0,24800,111400,0,136200
141920302100000,NW 308,RESIDENTIAL,28800,0,28800,123500,0,152300
141920302200000,NW 308,RESIDENTIAL,29100,0,29100,107400,0,136500
141920302300000,NW 308,RESIDENTIAL,31500,0,31500,114600,0,146100
141920302400000,NW 308,RESIDENTIAL,29200,0,29200,99900,0,129100
141920302500000,NW 308,RESIDENTIAL,25500,0,25500,113600,0,139100
141920302600000,NW 308,RESIDENTIAL,25500,0,25500,99800,0,125300
141920302700000,NW 308,RESIDENTIAL,25500,0,25500,113900,0,139400
141920302800000,NW 308,RESIDENTIAL,25500,0,25500,112100,0,137600
141920302900000,NW 308,RESIDENTIAL,25500,0,25500,101600,0,127100
141920303000000,NW 308,RESIDENTIAL,25500,0,25500,123400,0,148900
141920303100000,NW 308,RESIDENTIAL,25800,0,25800,116100,0,141900
141920303200000,NW 308,RESIDENTIAL,26700,0,26700,97900,0,124600
141920303300000,NW 308,RESIDENTIAL,25300,0,25300,100800,0,126100
141920303400000,NW 308,RESIDENTIAL,25300,0,25300,106400,0,131700
141920303500000,NW 308,RESIDENTIAL,25300,0,25300,109100,0,134400
141920303600000,NW 308,RESIDENTIAL,25300,0,25300,109100,0,134400
141920303700000,NW 308,RESIDENTIAL,25300,0,25300,117500,0,142800
141920303800000,NW 308,RESIDENTIAL,25300,0,25300,114400,0,139700
141920303900000,NW 308,RESIDENTIAL,25300,0,25300,114700,0,140000
141920304000000,NW 308,RESIDENTIAL,29000,0,29000,93200,0,122200
141920304100000,NW 308,RESIDENTIAL,27600,0,27600,147700,0,175300
141920304200000,NW 308,RESIDENTIAL,30700,0,30700,133100,0,163800
141920304300000,NW 308,RESIDENTIAL,28400,0,28400,124200,0,152600
141920400100000,APARTMENT,RESIDENTIAL,48600,0,48600,304800,0,353400
141920400200000,APARTMENT,RESIDENTIAL,25500,0,25500,141500,0,167000
141920400300000,APARTMENT,RESIDENTIAL,49700,0,49700,279000,0,328700
141922600100000,NW 308,RESIDENTIAL,27500,0,27500,100500,0,128000
141922600200000,NW 308,RESIDENTIAL,27600,0,27600,120000,0,147600
141922600300000,NW 308,RESIDENTIAL,27600,0,27600,117500,0,145100
141922600400000,NW 308,RESIDENTIAL,27800,0,27800,86200,0,114000
141922600500000,NW 308,RESIDENTIAL,31300,0,31300,96800,0,128100
141922600600000,NW 308,RESIDENTIAL,25300,0,25300,109800,0,135100
141922600700000,NW 308,RESIDENTIAL,25300,0,25300,117900,0,143200
141922600800000,NW 308,RESIDENTIAL,25300,0,25300,103800,0,129100
141922600900000,NW 308,RESIDENTIAL,25300,0,25300,104200,0,129500
141922601000000,NW 308,RESIDENTIAL,25300,0,25300,99300,0,124600
141922601100000,NW 308,RESIDENTIAL,25300,0,25300,90300,0,115600
141922601200000,NW 308,RESIDENTIAL,25300,0,25300,93600,0,118900
141922601300000,NW 308,RESIDENTIAL,25300,0,25300,97800,0,123100
141922601400000,NW 308,RESIDENTIAL,25300,0,25300,87500,0,112800
141922601500000,NW 308,RESIDENTIAL,25600,0,25600,80500,0,106100
141922601600000,NW 308,RESIDENTIAL,26400,0,26400,110400,0,136800
141922601700000,NW 308,RESIDENTIAL,25800,0,25800,111800,0,137600
141922601800000,NW 308,RESIDENTIAL,25800,0,25800,102800,0,128600
141922601900000,NW 308,RESIDENTIAL,25800,0,25800,106800,0,132600
141922602000000,NW 308,RESIDENTIAL,25800,0,25800,103500,0,129300
141922602100000,NW 308,RESIDENTIAL,25800,0,25800,112100,0,137900
141922602200000,NW 308,RESIDENTIAL,25800,0,25800,96200,0,122000
141922602300000,NW 308,RESIDENTIAL,25800,0,25800,97600,0,123400
141922602400000,NW 308,RESIDENTIAL,25800,0,25800,88300,0,114100
141922602500000,NW 308,RESIDENTIAL,26100,0,26100,104400,0,130500
141922602600000,NW 308,RESIDENTIAL,28800,0,28800,69700,0,98500
141922602700000,NW 308,RESIDENTIAL,27400,0,27400,111500,0,138900
141922700100000,NW 308,RESIDENTIAL,24500,0,24500,102900,0,127400
141922700200000,NW 308,RESIDENTIAL,29300,0,29300,116300,0,145600
141922700300000,NW 308,RESIDENTIAL,22400,0,22400,107400,0,129800
141922700400000,NW 308,RESIDENTIAL,23300,0,23300,91100,0,114400
141922700500000,NW 308,RESIDENTIAL,23300,0,23300,63200,0,86500
141922700600000,NW 308,RESIDENTIAL,24300,0,24300,105400,0,129700
141922700700000,NW 308,RESIDENTIAL,24300,0,24300,108700,0,133000
141922700800000,NW 308,RESIDENTIAL,24300,0,24300,82600,0,106900
141922700900000,NW 308,RESIDENTIAL,24500,0,24500,88100,0,112600
141922701000000,NW 308,RESIDENTIAL,24500,0,24500,79200,0,103700
141922701100000,NW 308,RESIDENTIAL,24500,0,24500,81300,0,105800
141922701200000,NW 308,RESIDENTIAL,24500,0,24500,98800,0,123300
141922701300000,NW 308,RESIDENTIAL,26200,0,26200,87700,0,113900
141922701400000,NW 308,RESIDENTIAL,25100,0,25100,93500,0,118600
141922701500000,NW 308,RESIDENTIAL,26200,0,26200,122100,0,148300
141922701600000,NW 308,RESIDENTIAL,26700,0,26700,115700,0,142400
141922701700000,NW 308,RESIDENTIAL,26300,0,26300,98900,0,125200
141922701800000,NW 308,RESIDENTIAL,25900,0,25900,111700,0,137600
141922701900000,NW 308,RESIDENTIAL,24300,0,24300,87000,0,111300
141922702000000,NW 308,RESIDENTIAL,24300,0,24300,93700,0,118000
141922702100000,NW 308,RESIDENTIAL,24300,0,24300,72800,0,97100
141922702200000,NW 308,RESIDENTIAL,24300,0,24300,99800,0,124100
141922702300000,NW 308,RESIDENTIAL,24300,0,24300,89600,0,113900
141922702400000,NW 308,RESIDENTIAL,24300,0,24300,87600,0,111900
141922702500000,NW 308,RESIDENTIAL,24300,0,24300,106000,0,130300
141922702600000,NW 308,RESIDENTIAL,24300,0,24300,93100,0,117400
141922702700000,NW 308,RESIDENTIAL,24300,0,24300,133600,0,157900
141922702800000,NW 308,RESIDENTIAL,24300,0,24300,110400,0,134700
141922800100000,NW 308,RESIDENTIAL,25600,0,25600,118000,0,143600
141922800200000,NW 308,RESIDENTIAL,26000,0,26000,91000,0,117000
141922800300000,NW 308,RESIDENTIAL,25400,0,25400,98200,0,123600
141922800400000,NW 308,RESIDENTIAL,26300,0,26300,90900,0,117200
141922800500000,NW 308,RESIDENTIAL,26800,0,26800,98500,0,125300
141922800600000,NW 308,RESIDENTIAL,25800,0,25800,116100,0,141900
141922800700000,NW 308,RESIDENTIAL,25000,0,25000,78400,0,103400
141922800800000,NW 308,RESIDENTIAL,26100,0,26100,86100,0,112200
141922800900000,NW 308,RESIDENTIAL,27700,0,27700,83500,0,111200
141922801000000,NW 308,RESIDENTIAL,21000,0,21000,108200,0,129200
141922801100000,NW 308,RESIDENTIAL,25200,0,25200,103800,0,129000
141922801200000,NW 308,RESIDENTIAL,25200,0,25200,109900,0,135100
141922801300000,NW 308,RESIDENTIAL,25200,0,25200,80700,0,105900
141922801400000,NW 308,RESIDENTIAL,25200,0,25200,77300,0,102500
141922801500000,NW 308,RESIDENTIAL,25000,0,25000,98900,0,123900
141922801600000,NW 308,RESIDENTIAL,25800,0,25800,94800,0,120600
141922801700000,NW 308,RESIDENTIAL,29100,0,29100,107900,0,137000
141922801800000,NW 308,RESIDENTIAL,27400,0,27400,102300,0,129700
141922801900000,NW 308,RESIDENTIAL,25800,0,25800,110200,0,136000
141922802000000,NW 308,RESIDENTIAL,26000,0,26000,88300,0,114300
141922802100000,NW 308,RESIDENTIAL,26000,0,26000,87200,0,113200
141922802200000,NW 308,RESIDENTIAL,26000,0,26000,89300,0,115300
141922802300000,NW 308,RESIDENTIAL,26300,0,26300,87100,0,113400
141922802400000,NW 308,RESIDENTIAL,30900,0,30900,80600,0,111500
141922802500000,NW 308,RESIDENTIAL,30700,0,30700,74600,0,105300
141922802600000,NW 308,RESIDENTIAL,29300,0,29300,79900,0,109200
141922802700000,NW 308,RESIDENTIAL,28400,0,28400,68900,0,97300
141922802800000,NW 308,RESIDENTIAL,28900,0,28900,103100,0,132000
141922802900000,NW 308,RESIDENTIAL,26000,0,26000,94600,0,120600
141922803000000,NW 308,RESIDENTIAL,21000,0,21000,100200,0,121200
141922803100000,NW 308,RESIDENTIAL,20700,0,20700,89300,0,110000
141922803200000,NW 308,RESIDENTIAL,24100,0,24100,84900,0,109000
141922803300000,NW 308,RESIDENTIAL,24400,0,24400,143200,0,167600
141922803400000,NW 308,RESIDENTIAL,24300,0,24300,80400,0,104700
141922803500000,NW 308,RESIDENTIAL,24300,0,24300,118600,0,142900
141922803600000,NW 308,RESIDENTIAL,24300,0,24300,99900,0,124200
141922803700000,NW 308,RESIDENTIAL,30500,0,30500,90000,0,120500
141922803800000,CITY PROPERTY,EXEMPT,0,0,0,0,0,0
141922900300000,APARTMENT,RESIDENTIAL,107200,0,107200,645500,0,752700
141923000100000,NW 308,RESIDENTIAL,25000,0,25000,98200,0,123200
141923000200000,NW 308,RESIDENTIAL,26900,0,26900,101500,0,128400
141923000300000,NW 308,RESIDENTIAL,25200,0,25200,96200,0,121400
141923000400000,NW 308,RESIDENTIAL,25700,0,25700,91300,0,117000
141923000500000,NW 308,RESIDENTIAL,26400,0,26400,76700,0,103100
141923000600000,NW 308,RESIDENTIAL,27800,0,27800,96900,0,124700
141923000700000,NW 308,RESIDENTIAL,25500,0,25500,104200,0,129700
141923000800000,NW 308,RESIDENTIAL,24800,0,24800,94100,0,118900
141923000900000,NW 308,RESIDENTIAL,24600,0,24600,95400,0,120000
141923001000000,NW 308,RESIDENTIAL,25000,0,25000,98800,0,123800
141923001100000,NW 308,RESIDENTIAL,25000,0,25000,94800,0,119800
141923001200000,NW 308,RESIDENTIAL,25000,0,25000,101100,0,126100
141923001300000,NW 308,RESIDENTIAL,25000,0,25000,93200,0,118200
141923100100000,APARTMENT,MULTI-RES,20400,0,20400,131600,0,152000
141923200100000,NW 308,RESIDENTIAL,28500,0,28500,97500,0,126000
141923200200000,NW 308,RESIDENTIAL,28500,0,28500,97700,0,126200
141923200300000,NW 308,RESIDENTIAL,28500,0,28500,103000,0,131500
141923200400000,NW 308,RESIDENTIAL,28500,0,28500,98300,0,126800
141923200500000,NW 308,RESIDENTIAL,27100,0,27100,104200,0,131300
141923200600000,NW 308,RESIDENTIAL,24500,0,24500,72100,0,96600
141923200700000,NW 308,RESIDENTIAL,26200,0,26200,134100,0,160300
141923200800000,NW 308,RESIDENTIAL,28200,0,28200,70300,0,98500
141925100100000,NW 314,RESIDENTIAL,24400,0,24400,108400,0,132800
141925100200000,NW 314,RESIDENTIAL,32800,0,32800,92100,0,124900
141925100300000,NW 314,RESIDENTIAL,30500,0,30500,104000,0,134500
141925100400000,NW 314,RESIDENTIAL,29700,0,29700,113500,0,143200
141925100500000,NW 314,RESIDENTIAL,27200,0,27200,107300,0,134500
141925100600000,NW 314,RESIDENTIAL,34600,0,34600,117300,0,151900
141925100700000,NW 314,RESIDENTIAL,50600,0,50600,104300,0,154900
141925100800000,NW 314,RESIDENTIAL,34200,0,34200,112300,0,146500
141925100900000,NW 314,RESIDENTIAL,32600,0,32600,185100,0,217700
141925101000000,NW 314,RESIDENTIAL,31500,0,31500,120600,0,152100
141925101200000,NW 314,RESIDENTIAL,21100,0,21100,93300,0,114400
141925101300000,NW 314,RESIDENTIAL,32500,0,32500,59800,0,92300
141925101400000,NW 314,RESIDENTIAL,32800,0,32800,92700,0,125500
141925101500000,NW 314,RESIDENTIAL,33900,0,33900,145100,0,179000
141925101600000,NW 314,RESIDENTIAL,30100,0,30100,95400,0,125500
141925101700000,NW 314,RESIDENTIAL,33700,0,33700,118800,0,152500
141925101800000,NW 314,RESIDENTIAL,27100,0,27100,95400,0,122500
141925101900000,NW 314,RESIDENTIAL,27200,0,27200,54500,0,81700
141925102000000,NW 314,RESIDENTIAL,22000,0,22000,98900,0,120900
141925102100000,NW 314,RESIDENTIAL,26000,0,26000,81700,0,107700
141925102200000,NW 314,RESIDENTIAL,26700,0,26700,100600,0,127300
141925102300000,NW 314,RESIDENTIAL,29000,0,29000,75100,0,104100
141925102400000,NW 314,RESIDENTIAL,28800,0,28800,92100,0,120900
141925102500000,NW 314,RESIDENTIAL,51400,0,51400,50300,0,101700
141925102600000,NW 314,RESIDENTIAL,26800,0,26800,70000,0,96800
141925102700000,NW 314,RESIDENTIAL,26700,0,26700,134600,0,161300
141925102800000,NW 314,RESIDENTIAL,28600,0,28600,127300,0,155900
141925102900000,NW 314,RESIDENTIAL,22600,0,22600,88200,0,110800
141925103000000,NW 314,RESIDENTIAL,22600,0,22600,95800,0,118400
141925103100000,NW 314,RESIDENTIAL,22600,0,22600,92500,0,115100
141925103200000,NW 314,RESIDENTIAL,22600,0,22600,86100,0,108700
141925103300000,NW 314,RESIDENTIAL,50100,0,50100,82200,0,132300
141925103400000,NW 314,RESIDENTIAL,26600,0,26600,113900,0,140500
141925200100000,NW 314,RESIDENTIAL,30900,0,30900,158400,0,189300
141925200200000,NW 314,RESIDENTIAL,26300,0,26300,68000,0,94300
141925200300000,NW 314,RESIDENTIAL,23200,0,23200,101100,0,124300
141925200400000,NW 314,EXEMPT,0,23200,23200,0,99200,122400
141925200500000,NW 314,RESIDENTIAL,23200,0,23200,88400,0,111600
141925200600000,NW 314,RESIDENTIAL,23200,0,23200,113800,0,137000
141925200700000,NW 314,RESIDENTIAL,24500,0,24500,96700,0,121200
141925200800000,NW 314,RESIDENTIAL,24500,0,24500,101500,0,126000
141925200900000,NW 314,RESIDENTIAL,24500,0,24500,101300,0,125800
141925201000000,NW 314,RESIDENTIAL,23000,0,23000,103400,0,126400
141925201100000,NW 314,RESIDENTIAL,7700,0,7700,600,0,8300
141925201300000,NW 314,RESIDENTIAL,54900,0,54900,123100,0,178000
141925201400000,NW 314,RESIDENTIAL,43000,0,43000,51300,0,94300
141925201500000,NW 314,RESIDENTIAL,28500,0,28500,60700,0,89200
141925201600000,NW 314,RESIDENTIAL,30100,0,30100,79400,0,109500
141925201700000,NW 314,RESIDENTIAL,31800,0,31800,105300,0,137100
141925201800000,NW 314,RESIDENTIAL,24200,0,24200,52800,0,77000
141925201900000,NW 314,RESIDENTIAL,30400,0,30400,65600,0,96000
141925202000000,NW 314,RESIDENTIAL,28200,0,28200,111900,0,140100
141925202100000,NW 314,RESIDENTIAL,31600,0,31600,118300,0,149900
141925202200000,NW 314,RESIDENTIAL,31500,0,31500,144900,0,176400
141925202300000,NW 314,RESIDENTIAL,35800,0,35800,64700,0,100500
141925202400000,NW 314,RESIDENTIAL,21600,0,21600,114600,0,136200
141925202500000,NW 314,RESIDENTIAL,20400,0,20400,100200,0,120600
141925202600000,NW 314,RESIDENTIAL,23100,0,23100,98100,0,121200
141925202700000,NW 314,RESIDENTIAL,23200,0,23200,104100,0,127300
141925202800000,NW 314,RESIDENTIAL,32000,0,32000,83700,0,115700
141925202900000,NW 314,RESIDENTIAL,53100,0,53100,18900,0,72000
141925203000000,NW 314,RESIDENTIAL,32000,0,32000,300,0,32300
141925203100000,NW 314,RESIDENTIAL,18900,0,18900,184700,0,203600
141925203200000,NW 314,RESIDENTIAL,41500,0,41500,111400,0,152900
141925203300000,NW 314,RESIDENTIAL,37200,0,37200,86500,0,123700
141925203400000,NW 314,RESIDENTIAL,46400,0,46400,81400,0,127800
141925203500000,NW 314,RESIDENTIAL,30200,0,30200,90900,0,121100
141927600100000,NW 308,RESIDENTIAL,45100,0,45100,50300,0,95400
141927600300000,NW 308,RESIDENTIAL,19800,0,19800,7500,0,27300
141927600400000,NW 308,RESIDENTIAL,17800,0,17800,68100,0,85900
141927600500000,NW 308,RESIDENTIAL,29000,0,29000,0,0,29000
141927600600000,NW 308,RESIDENTIAL,20100,0,20100,117100,0,137200
141927600700000,APARTMENT,MULTI-RES,20900,0,20900,134700,0,155600
141927600800000,APARTMENT,MULTI-RES,25600,0,25600,170000,0,195600
141927600900000,NW 308,RESIDENTIAL,24900,0,24900,103800,0,128700
141927601000000,NW 308,RESIDENTIAL,30200,0,30200,86500,0,116700
141927601100000,NW 308,RESIDENTIAL,24700,0,24700,89100,0,113800
141927601200000,NW 308,RESIDENTIAL,23400,0,23400,88200,0,111600
141927601300000,NW 308,RESIDENTIAL,27200,0,27200,122300,0,149500
141927601400000,NW 308,RESIDENTIAL,26800,0,26800,99000,0,125800
141927601500000,NW 308,RESIDENTIAL,29400,0,29400,76400,0,105800
141927601600000,NW 308,RESIDENTIAL,24600,0,24600,110400,0,135000
141927601700000,NW 308,RESIDENTIAL,24900,0,24900,119000,0,143900
141927700100000,NW 308,RESIDENTIAL,22800,0,22800,87000,0,109800
141927700200000,NW 308,RESIDENTIAL,22700,0,22700,122600,0,145300
141927700300000,NW 308,RESIDENTIAL,23300,0,23300,95600,0,118900
141927700400000,NW 308,RESIDENTIAL,26300,0,26300,91100,0,117400
141927700500000,NW 308,RESIDENTIAL,27600,0,27600,76900,0,104500
141927700600000,NW 308,RESIDENTIAL,31800,0,31800,119000,0,150800
141927700700000,NW 308,RESIDENTIAL,27600,0,27600,92800,0,120400
141927700800000,NW 308,RESIDENTIAL,24500,0,24500,90800,0,115300
141927700900000,NW 308,RESIDENTIAL,25800,0,25800,102400,0,128200
141927701000000,NW 308,RESIDENTIAL,25700,0,25700,86800,0,112500
141927701100000,NW 308,RESIDENTIAL,25900,0,25900,81500,0,107400
141927701200000,NW 308,RESIDENTIAL,26100,0,26100,98800,0,124900
141927701300000,NW 308,RESIDENTIAL,25800,0,25800,108700,0,134500
141927701400000,NW 308,RESIDENTIAL,25800,0,25800,102600,0,128400
141927701500000,NW 308,RESIDENTIAL,26700,0,26700,100000,0,126700
141927800100000,NW 308,RESIDENTIAL,27100,0,27100,124000,0,151100
141927800200000,NW 308,RESIDENTIAL,31400,0,31400,127200,0,158600
141927900100000,NW 308,RESIDENTIAL,24600,0,24600,117000,0,141600
141927900200000,NW 308,RESIDENTIAL,82500,0,82500,0,0,82500
141927900300000,NW 308,RESIDENTIAL,74400,0,74400,219400,0,293800
141927900400000,NW 308,RESIDENTIAL,22600,0,22600,91700,0,114300
141927900500000,NW 308,RESIDENTIAL,22600,0,22600,94900,0,117500
141927900600000,NW 308,RESIDENTIAL,22600,0,22600,111700,0,134300
141927900700000,NW 308,RESIDENTIAL,22600,0,22600,97000,0,119600
141927900800000,NW 308,RESIDENTIAL,22900,0,22900,101900,0,124800
141927900900000,NW 308,RESIDENTIAL,22800,0,22800,81900,0,104700
141927901000000,NW 308,RESIDENTIAL,22600,0,22600,101500,0,124100
141927901100000,NW 308,RESIDENTIAL,22600,0,22600,101000,0,123600
141927901200000,NW 308,RESIDENTIAL,22600,0,22600,85600,0,108200
141927901300000,NW 308,RESIDENTIAL,22700,0,22700,85500,0,108200
141927901400000,NW 308,RESIDENTIAL,25000,0,25000,83200,0,108200
141927901500000,NW 308,RESIDENTIAL,24800,0,24800,95200,0,120000
141927901600000,NW 308,RESIDENTIAL,24800,0,24800,92300,0,117100
141927901700000,NW 308,RESIDENTIAL,24800,0,24800,93000,0,117800
141927901800000,NW 308,RESIDENTIAL,24900,0,24900,103100,0,128000
141927901900000,NW 308,RESIDENTIAL,22700,0,22700,97000,0,119700
141927902000000,NW 308,RESIDENTIAL,22600,0,22600,78500,0,101100
141927902100000,NW 308,RESIDENTIAL,22600,0,22600,87400,0,110000
141927902200000,NW 308,RESIDENTIAL,22600,0,22600,83300,0,105900
141927902300000,NW 308,RESIDENTIAL,22800,0,22800,77300,0,100100
141927902400000,SCHOOL,EXEMPT,0,0,0,0,0,0
141927902500000,NW 308,RESIDENTIAL,29400,0,29400,140900,0,170300
141927902600000,NW 308,RESIDENTIAL,27400,0,27400,162600,0,190000
141927902700000,NW 308,RESIDENTIAL,28600,0,28600,130500,0,159100
141927902800000,NW 308,RESIDENTIAL,28600,0,28600,133100,0,161700
141927902900000,NW 308,RESIDENTIAL,28600,0,28600,135100,0,163700
141927903000000,NW 308,RESIDENTIAL,27200,0,27200,116200,0,143400
141927903100000,NW 308,RESIDENTIAL,23000,0,23000,93700,0,116700
141927903200000,NW 308,RESIDENTIAL,23300,0,23300,99200,0,122500
141927903300000,NW 308,RESIDENTIAL,23300,0,23300,104700,0,128000
141927903400000,NW 308,RESIDENTIAL,23300,0,23300,102600,0,125900
141927903500000,NW 308,RESIDENTIAL,23300,0,23300,113600,0,136900
141928000100000,NW 308,RESIDENTIAL,29300,0,29300,130900,0,160200
141928000200000,NW 308,RESIDENTIAL,30600,0,30600,191800,0,222400
141928100100000,NW 308,RESIDENTIAL,29700,0,29700,185900,0,215600
141930100100000,NW 308,RESIDENTIAL,29700,0,29700,140200,0,169900
141930100200000,NW 308,RESIDENTIAL,31600,0,31600,159900,0,191500
141930100300000,NW 308,RESIDENTIAL,33300,0,33300,130500,0,163800
141930100400000,NW 308,RESIDENTIAL,34800,0,34800,159800,0,194600
141930100500000,NW 308,RESIDENTIAL,23500,0,23500,136300,0,159800
141930100600000,NW 308,RESIDENTIAL,37600,0,37600,94900,0,132500
141930100700000,NW 308,RESIDENTIAL,38000,0,38000,40200,0,78200
141930100800000,NW 308,RESIDENTIAL,38300,0,38300,62500,0,100800
141930100900000,NW 308,RESIDENTIAL,38300,0,38300,61200,0,99500
141930101000000,NW 308,RESIDENTIAL,63600,0,63600,217200,0,280800
141930101100000,NW 308,RESIDENTIAL,38300,0,38300,87900,0,126200
141930101200000,NW 308,RESIDENTIAL,39000,0,39000,119200,0,158200
141930101300000,NW 308,RESIDENTIAL,30700,0,30700,86700,0,117400
141930101400000,NW 308,RESIDENTIAL,27700,0,27700,128900,0,156600
141930101500000,NW 308,RESIDENTIAL,27300,0,27300,98300,0,125600
141930101600000,NW 308,RESIDENTIAL,29300,0,29300,116500,0,145800
141930200100000,NW 308,RESIDENTIAL,21100,0,21100,115400,0,136500
141930200200000,NW 308,RESIDENTIAL,24600,0,24600,94200,0,118800
141930200300000,NW 308,RESIDENTIAL,24600,0,24600,100300,0,124900
141930200400000,NW 308,RESIDENTIAL,24600,0,24600,102500,0,127100
141930200500000,NW 308,RESIDENTIAL,24600,0,24600,105000,0,129600
141930200600000,NW 308,RESIDENTIAL,53000,0,53000,85500,0,138500
141930200700000,NW 308,RESIDENTIAL,23100,0,23100,123300,0,146400
141930200800000,NW 308,RESIDENTIAL,24800,0,24800,109700,0,134500
141930200900000,NW 308,RESIDENTIAL,24900,0,24900,92600,0,117500
141930201000000,NW 308,RESIDENTIAL,30600,0,30600,120100,0,150700
141930201100000,NW 308,RESIDENTIAL,31900,0,31900,144400,0,176300
141930201200000,NW 308,RESIDENTIAL,31500,0,31500,60700,0,92200
141930201300000,NW 308,RESIDENTIAL,31600,0,31600,44300,0,75900
141930201400000,NW 308,RESIDENTIAL,27800,0,27800,91100,0,118900
141930201500000,NW 308,RESIDENTIAL,28700,0,28700,111100,0,139800
141930201600000,NW 308,RESIDENTIAL,27200,0,27200,104700,0,131900
141930201700000,NW 308,RESIDENTIAL,27400,0,27400,98500,0,125900
141930201800000,NW 308,RESIDENTIAL,27200,0,27200,129200,0,156400
141930201900000,NW 308,RESIDENTIAL,26200,0,26200,93100,0,119300
141930202000000,NW 308,RESIDENTIAL,27300,0,27300,106600,0,133900
141930202100000,NW 308,RESIDENTIAL,30200,0,30200,172800,0,203000
141930202200000,NW 308,RESIDENTIAL,61700,0,61700,58800,0,120500
141930202300000,NW 308,RESIDENTIAL,58400,0,58400,60000,0,118400
141930202400000,NW 308,RESIDENTIAL,27200,0,27200,64600,0,91800
141930202500000,NW 308,RESIDENTIAL,25100,0,25100,45100,0,70200
141930202600000,NW 308,RESIDENTIAL,27300,0,27300,90400,0,117700
141930202700000,NW 308,RESIDENTIAL,37700,0,37700,40900,0,78600
141930202800000,NW 308,RESIDENTIAL,24200,0,24200,109500,0,133700
141930300100000,NW 308,RESIDENTIAL,24800,0,24800,115400,0,140200
141930300200000,NW 308,RESIDENTIAL,24800,0,24800,114300,0,139100
141930300300000,NW 308,RESIDENTIAL,24800,0,24800,119700,0,144500
141930300400000,NW 308,RESIDENTIAL,24800,0,24800,99900,0,124700
141930300500000,NW 308,RESIDENTIAL,24800,0,24800,111200,0,136000
141930300600000,NW 308,RESIDENTIAL,25400,0,25400,104300,0,129700
141930300700000,NW 323,RESIDENTIAL,31900,0,31900,177300,0,209200
141930300800000,NW 323,RESIDENTIAL,33000,0,33000,174100,0,207100
141930300900000,NW 323,RESIDENTIAL,28200,0,28200,119100,0,147300
141930301000000,NW 323,RESIDENTIAL,28200,0,28200,0,0,28200
141930301100000,NW 323,RESIDENTIAL,34400,0,34400,158100,0,192500
141930301200000,NW 323,RESIDENTIAL,33000,0,33000,151300,0,184300
141930301300000,NW 323,RESIDENTIAL,33100,0,33100,141700,0,174800
141930301400000,NW 323,RESIDENTIAL,31900,0,31900,158700,0,190600
141930301500000,NW 323,RESIDENTIAL,32800,0,32800,154500,0,187300
141930400100000,NW 323,RESIDENTIAL,33000,0,33000,129500,0,162500
141930400200000,NW 308,RESIDENTIAL,29400,0,29400,67800,0,97200
141930400300000,NW 308,RESIDENTIAL,29000,0,29000,66400,0,95400
141930400400000,NW 308,RESIDENTIAL,26000,0,26000,80300,0,106300
141930400500000,NW 308,RESIDENTIAL,26000,0,26000,103100,0,129100
141930400600000,NW 308,RESIDENTIAL,26000,0,26000,83600,0,109600
141930400700000,NW 308,RESIDENTIAL,26000,0,26000,105500,0,131500
141930400800000,NW 308,RESIDENTIAL,22600,0,22600,103900,0,126500
141930400900000,NW 308,RESIDENTIAL,22600,0,22600,100300,0,122900
141930401000000,NW 308,RESIDENTIAL,22600,0,22600,96900,0,119500
141930401100000,NW 308,RESIDENTIAL,22600,0,22600,100200,0,122800
141930401200000,NW 308,RESIDENTIAL,22500,0,22500,96600,0,119100
141930401300000,NW 308,RESIDENTIAL,30400,0,30400,0,0,30400
141930401400000,NW 308,RESIDENTIAL,30400,0,30400,0,0,30400
141930401500000,NW 323,RESIDENTIAL,29700,0,29700,130900,0,160600
141930401600000,NW 323,RESIDENTIAL,29800,0,29800,130800,0,160600
141930500100000,NW 323,RESIDENTIAL,30800,0,30800,207900,0,238700
141930500200000,NW 323,RESIDENTIAL,30500,0,30500,122100,0,152600
141930500300000,NW 323,RESIDENTIAL,29100,0,29100,137000,0,166100
141930500400000,NW 323,RESIDENTIAL,30400,0,30400,148100,0,178500
141930500500000,NW 323,RESIDENTIAL,30400,0,30400,162000,0,192400
141930500600000,NW 323,RESIDENTIAL,30400,0,30400,150200,0,180600
141930500700000,NW 323,RESIDENTIAL,30400,0,30400,129200,0,159600
141930500800000,NW 323,RESIDENTIAL,30400,0,30400,137500,0,167900
141930500900000,NW 308,RESIDENTIAL,23600,0,23600,91600,0,115200
141930501000000,NW 308,RESIDENTIAL,24200,0,24200,94200,0,118400
141930600100000,NW 308,RESIDENTIAL,20900,0,20900,94100,0,115000
141930600200000,NW 308,RESIDENTIAL,21600,0,21600,107800,0,129400
141932600100000,NW 308,RESIDENTIAL,31000,0,31000,103100,0,134100
141932700100000,NW 314,RESIDENTIAL,26600,0,26600,78100,0,104700
141932700200000,NW 314,RESIDENTIAL,30000,0,30000,124500,0,154500
141932800100000,NW 314,RESIDENTIAL,31100,0,31100,50500,0,81600
141932800200000,NW 314,RESIDENTIAL,28000,0,28000,92900,0,120900
141932800300000,NW 314,RESIDENTIAL,28800,0,28800,137900,0,166700
141932800400000,NW 314,RESIDENTIAL,28100,0,28100,54200,0,82300
141932900100000,NW 308,RESIDENTIAL,27800,0,27800,136900,0,164700
141932900200000,NW 314,RESIDENTIAL,26300,0,26300,183500,0,209800
141932900300000,NW 314,RESIDENTIAL,28000,0,28000,155500,0,183500
141932900400000,NW 314,RESIDENTIAL,30300,0,30300,109400,0,139700
141932900500000,NW 314,RESIDENTIAL,29300,0,29300,176100,0,205400
141932900600000,NW 314,RESIDENTIAL,28800,0,28800,152700,0,181500
141932900700000,NW 308,RESIDENTIAL,39600,0,39600,97800,0,137400
141932900800000,NW 308,RESIDENTIAL,34900,0,34900,8800,0,43700
141932900900000,NW 308,RESIDENTIAL,31100,0,31100,33400,0,64500
141933000200000,NW 314,RESIDENTIAL,39100,0,39100,92600,0,131700
141933000300000,NW 314,RESIDENTIAL,35000,0,35000,113200,0,148200
141933000400000,NW 314,RESIDENTIAL,24600,0,24600,91900,0,116500
141933000500000,NW 314,RESIDENTIAL,26500,0,26500,91700,0,118200
141933000600000,NW 314,RESIDENTIAL,24500,0,24500,103300,0,127800
141933000700000,NW 314,RESIDENTIAL,35100,0,35100,121100,0,156200
141933000800000,NW 314,RESIDENTIAL,28200,0,28200,112600,0,140800
141933000900000,NW 314,RESIDENTIAL,26700,0,26700,128600,0,155300
141933001000000,NW 314,RESIDENTIAL,30400,0,30400,159500,0,189900
141933001100000,NW 314,RESIDENTIAL,32900,0,32900,102900,0,135800
141933001200000,NW 314,RESIDENTIAL,32500,0,32500,197600,0,230100
141933001300000,NW 314,RESIDENTIAL,24000,0,24000,103700,0,127700
141933001400000,NW 314,RESIDENTIAL,25300,0,25300,92400,0,117700
141933001500000,NW 314,RESIDENTIAL,24600,0,24600,113600,0,138200
141933001600000,NW 314,RESIDENTIAL,24100,0,24100,92000,0,116100
141933001700000,NW 314,RESIDENTIAL,25500,0,25500,103400,0,128900
141933002100000,NW 314,RESIDENTIAL,4400,0,4400,0,0,4400
141933002200000,NW 314,RESIDENTIAL,25800,0,25800,143100,0,168900
141933002300000,NW 314,RESIDENTIAL,30500,0,30500,103400,0,133900
141933002400000,NW 314,RESIDENTIAL,26700,0,26700,105800,0,132500
141933002500000,NW 314,RESIDENTIAL,24000,0,24000,112800,0,136800
141933002600000,NW 314,RESIDENTIAL,24000,0,24000,116900,0,140900
141933002700000,NW 314,RESIDENTIAL,24000,0,24000,99600,0,123600
141933002800000,NW 314,RESIDENTIAL,31600,0,31600,98200,0,129800
141933003100000,NW 314,RESIDENTIAL,31200,0,31200,78400,0,109600
141933003200000,NW 314,RESIDENTIAL,26500,0,26500,107500,0,134000
141933003300000,NW 314,RESIDENTIAL,31400,0,31400,120900,0,152300
141933003400000,NW 314,RESIDENTIAL,28800,0,28800,111600,0,140400
141933003500000,NW 314,RESIDENTIAL,36500,0,36500,143200,0,179700
141933003600000,NW 314,RESIDENTIAL,42300,0,42300,70800,0,113100
141933003700000,NW 314,RESIDENTIAL,36000,0,36000,211200,0,247200
141933003800000,NW 314,RESIDENTIAL,34300,0,34300,56400,0,90700
141933003900000,NW 314,RESIDENTIAL,29400,0,29400,167700,0,197100
141933004000000,NW 314,RESIDENTIAL,32600,0,32600,0,0,32600
141933004100000,NW 314,RESIDENTIAL,32300,0,32300,108200,0,140500
141933004200000,NW 314,RESIDENTIAL,36700,0,36700,92700,0,129400
141933100100000,NW 314,RESIDENTIAL,26000,0,26000,98000,0,124000
141933100200000,NW 314,RESIDENTIAL,27200,0,27200,122000,0,149200
141933100300000,NW 314,RESIDENTIAL,26000,0,26000,95300,0,121300
141933100400000,NW 314,RESIDENTIAL,32100,0,32100,93100,0,125200
141933100600000,NW 314,RESIDENTIAL,26000,0,26000,82000,0,108000
141933100700000,NW 314,RESIDENTIAL,26000,0,26000,77500,0,103500
141933100800000,NW 314,RESIDENTIAL,26000,0,26000,94800,0,120800
141933100900000,NW 314,RESIDENTIAL,26000,0,26000,104500,0,130500
141933101000000,NW 314,RESIDENTIAL,24000,0,24000,85800,0,109800
141933101100000,NW 314,RESIDENTIAL,26500,0,26500,100500,0,127000
141933101200000,NW 314,RESIDENTIAL,26500,0,26500,0,0,26500
141933101300000,NW 314,RESIDENTIAL,29100,0,29100,0,0,29100
141933200100000,NW 308,RESIDENTIAL,26600,0,26600,101400,0,128000
141933200200000,NW 308,RESIDENTIAL,26600,0,26600,107500,0,134100
141933200300000,NW 314,RESIDENTIAL,29400,0,29400,88200,0,117600
141933200400000,NW 314,RESIDENTIAL,28000,0,28000,84700,0,112700
141933200500000,NW 314,RESIDENTIAL,42600,0,42600,112600,0,155200
141933200600000,NW 314,RESIDENTIAL,28900,0,28900,131400,0,160300
141933200700000,NW 314,RESIDENTIAL,26000,0,26000,75200,0,101200
141933200800000,NW 314,RESIDENTIAL,39000,0,39000,96800,0,135800
141933200900000,NW 314,RESIDENTIAL,42500,0,42500,117700,0,160200
141933201000000,NW 314,RESIDENTIAL,33300,0,33300,102200,0,135500
141933201100000,NW 314,RESIDENTIAL,39000,0,39000,86900,0,125900
141933201200000,NW 314,RESIDENTIAL,34100,0,34100,84000,0,118100
141933201300000,NW 314,RESIDENTIAL,24500,0,24500,113500,0,138000
141933201400000,NW 314,RESIDENTIAL,24400,0,24400,97900,0,122300
141933201500000,NW 314,RESIDENTIAL,24400,0,24400,106400,0,130800
141933201600000,NW 314,RESIDENTIAL,26400,0,26400,109300,0,135700
141933201700000,NW 314,RESIDENTIAL,25100,0,25100,117000,0,142100
141933201800000,NW 314,RESIDENTIAL,24200,0,24200,106100,0,130300
141933201900000,NW 314,RESIDENTIAL,24200,0,24200,89300,0,113500
141933202000000,NW 314,RESIDENTIAL,24200,0,24200,92000,0,116200
141933202100000,NW 314,RESIDENTIAL,24200,0,24200,90700,0,114900
141933202200000,NW 314,RESIDENTIAL,26200,0,26200,87700,0,113900
141933202300000,NW 314,RESIDENTIAL,28000,0,28000,156600,0,184600
141933202400000,NW 314,RESIDENTIAL,26300,0,26300,130800,0,157100
141933202500000,NW 308,RESIDENTIAL,23000,0,23000,94200,0,117200
141933202600000,NW 308,RESIDENTIAL,22600,0,22600,94300,0,116900
141933300100000,NW 308,RESIDENTIAL,21600,0,21600,78000,0,99600
141933300200000,NW 308,RESIDENTIAL,22000,0,22000,88300,0,110300
141933300300000,NW 314,RESIDENTIAL,27700,0,27700,108700,0,136400
141933300400000,NW 314,RESIDENTIAL,27700,0,27700,120100,0,147800
141933300500000,NW 314,RESIDENTIAL,25900,0,25900,111500,0,137400
141933300600000,NW 314,RESIDENTIAL,24200,0,24200,80400,0,104600
141933300700000,NW 314,RESIDENTIAL,24200,0,24200,103700,0,127900
141933300800000,NW 314,RESIDENTIAL,24200,0,24200,108300,0,132500
141933300900000,NW 314,RESIDENTIAL,24200,0,24200,81700,0,105900
141933301000000,NW 314,RESIDENTIAL,25000,0,25000,99700,0,124700
141935100300000,NW 322,EXEMPT,0,1500,1500,0,0,1500
141935100400000,NW 322,RESIDENTIAL,1500,0,1500,0,0,1500
141935101100000,FUNERAL HOME,COMMERCIAL,0,259100,259100,0,404700,663800
141935101200000,NW 324,RESIDENTIAL,2500,0,2500,0,0,2500
141935101300000,NW 324,RESIDENTIAL,26800,0,26800,108000,0,134800
141935101400000,NW 324,RESIDENTIAL,25200,0,25200,89000,0,114200
141935101500000,NW 324,RESIDENTIAL,25200,0,25200,102800,0,128000
141935101600000,NW 324,RESIDENTIAL,25200,0,25200,120300,0,145500
141935101700000,NW 324,RESIDENTIAL,24700,0,24700,102000,0,126700
141935101800000,APARTMENT,RESIDENTIAL,25500,0,25500,130900,0,156400
141935101900000,NW 324,RESIDENTIAL,24900,0,24900,93500,0,118400
141935102000000,NW 324,RESIDENTIAL,23300,0,23300,99400,0,122700
141935102100000,NW 324,RESIDENTIAL,23300,0,23300,116500,0,139800
141935102200000,NW 324,RESIDENTIAL,23000,0,23000,84800,0,107800
141935102300000,NW 324,RESIDENTIAL,25000,0,25000,90200,0,115200
141935102400000,NW 324,RESIDENTIAL,24400,0,24400,93400,0,117800
141935102500000,NW 324,RESIDENTIAL,23000,0,23000,91800,0,114800
141935102600000,NW 324,RESIDENTIAL,23300,0,23300,73900,0,97200
141935102700000,NW 324,RESIDENTIAL,23300,0,23300,77500,0,100800
141935102800000,NW 324,RESIDENTIAL,24300,0,24300,71500,0,95800
141935102900000,APARTMENT,RESIDENTIAL,24900,0,24900,118300,0,143200
141935103000000,APARTMENT,RESIDENTIAL,21600,0,21600,116300,0,137900
141935103100000,OFFICE,COMMERCIAL,0,56000,56000,0,209700,265700
141935103200000,NW 324,RESIDENTIAL,24000,0,24000,92500,0,116500
141935103300000,NW 324,RESIDENTIAL,23300,0,23300,77600,0,100900
141935103400000,NW 324,RESIDENTIAL,23300,0,23300,91500,0,114800
141935103500000,NW 324,RESIDENTIAL,23300,0,23300,91600,0,114900
141935103600000,NW 324,RESIDENTIAL,24100,0,24100,97100,0,121200
141935103800000,CHURCH,EXEMPT,0,473100,473100,0,694700,1167800
141935200300000,NW 324,RESIDENTIAL,56700,0,56700,115400,0,172100
141935200400000,SR/NURSING/ASSTD LIV,MULTI-RES,168800,0,168800,2892700,0,3061500
141935200500000,NW 324,RESIDENTIAL,31400,0,31400,54600,0,86000
141935200600000,SHOP,COMMERCIAL,0,125100,125100,0,371200,496300
141935200700000,CONVENIENCE STORE,COMMERCIAL,0,425700,425700,0,570200,995900
141935200800000,CHURCH,EXEMPT,0,996000,996000,0,429800,1425800
141935200900000,NW 324,RESIDENTIAL,29400,0,29400,111100,0,140500
141935201000000,OFFICE,COMMERCIAL,0,139100,139100,0,538400,677500
141935201100000,OFFICE,COMMERCIAL,0,148700,148700,0,533200,681900
141935201200000,WAREHOUSE;MINI STORG,COMMERCIAL,0,95200,95200,0,15800,111000
141935201300000,SR/NURSING/ASSTD LIV,MULTI-RES,320000,0,320000,7625600,0,7945600
141937600100000,NW 322,RESIDENTIAL,25800,0,25800,108400,0,134200
141937600200000,NW 323,RESIDENTIAL,30700,0,30700,191500,0,222200
141937600300000,NW 323,RESIDENTIAL,31700,0,31700,167600,0,199300
141937600400000,NW 323,RESIDENTIAL,31900,0,31900,149700,0,181600
141937600500000,NW 323,RESIDENTIAL,32900,0,32900,140700,0,173600
141937600600000,NW 323,RESIDENTIAL,33000,0,33000,168400,0,201400
141937600700000,NW 323,RESIDENTIAL,37700,0,37700,154200,0,191900
141937600800000,NW 323,RESIDENTIAL,31700,0,31700,163900,0,195600
141937600900000,NW 323,RESIDENTIAL,35200,0,35200,202900,0,238100
141937601000000,NW 323,RESIDENTIAL,37100,0,37100,204500,0,241600
141937601100000,NW 323,RESIDENTIAL,30700,0,30700,184600,0,215300
141937601200000,NW 323,RESIDENTIAL,28200,0,28200,174900,0,203100
141937601300000,NW 323,RESIDENTIAL,34300,0,34300,153100,0,187400
141937601400000,NW 323,RESIDENTIAL,94700,0,94700,250000,0,344700
141937601500000,NW 323,RESIDENTIAL,34300,0,34300,198000,0,232300
141937601600000,NW 323,RESIDENTIAL,34400,0,34400,169900,0,204300
141937601700000,NW 323,RESIDENTIAL,34000,0,34000,151600,0,185600
141937601800000,NW 323,RESIDENTIAL,33600,0,33600,149200,0,182800
141937601900000,NW 323,RESIDENTIAL,32700,0,32700,173200,0,205900
141937602000000,NW 323,RESIDENTIAL,28000,0,28000,190600,0,218600
141937602100000,NW 323,RESIDENTIAL,30000,0,30000,152200,0,182200
141937602200000,NW 323,RESIDENTIAL,32000,0,32000,147600,0,179600
141937602300000,NW 323,RESIDENTIAL,28300,0,28300,192900,0,221200
141937602400000,NW 322,RESIDENTIAL,25300,0,25300,104900,0,130200
141937602500000,NW 322,RESIDENTIAL,25400,0,25400,109000,0,134400
141937602600000,NW 323,RESIDENTIAL,28500,0,28500,135400,0,163900
141937602700000,NW 323,RESIDENTIAL,33000,0,33000,144200,0,177200
141937602800000,NW 323,RESIDENTIAL,32200,0,32200,164100,0,196300
141937602900000,NW 323,RESIDENTIAL,32300,0,32300,142800,0,175100
141937603000000,NW 323,RESIDENTIAL,31100,0,31100,136600,0,167700
141937603100000,NW 323,RESIDENTIAL,30900,0,30900,150500,0,181400
141937603200000,NW 323,RESIDENTIAL,30500,0,30500,133400,0,163900
141937603300000,NW 323,RESIDENTIAL,31000,0,31000,137600,0,168600
141937603400000,NW 323,RESIDENTIAL,31400,0,31400,139100,0,170500
141937603500000,NW 323,RESIDENTIAL,31700,0,31700,158200,0,189900
141937603600000,NW 323,RESIDENTIAL,31000,0,31000,120900,0,151900
141937603700000,NW 323,RESIDENTIAL,31000,0,31000,137200,0,168200
141937603800000,NW 323,RESIDENTIAL,31000,0,31000,138500,0,169500
141937700100000,NW 322,RESIDENTIAL,23900,0,23900,119200,0,143100
141937700200000,NW 322,RESIDENTIAL,23700,0,23700,109800,0,133500
141937700300000,NW 322,RESIDENTIAL,25300,0,25300,111300,0,136600
141937700400000,NW 322,RESIDENTIAL,23700,0,23700,93400,0,117100
141937700500000,NW 322,RESIDENTIAL,25300,0,25300,131600,0,156900
141937700600000,NW 322,RESIDENTIAL,23700,0,23700,117200,0,140900
141937700700000,NW 322,RESIDENTIAL,23700,0,23700,97700,0,121400
141937700800000,NW 322,RESIDENTIAL,23700,0,23700,100300,0,124000
141937701000000,NW 322,RESIDENTIAL,23700,0,23700,113500,0,137200
141937701100000,NW 322,RESIDENTIAL,24100,0,24100,99300,0,123400
141937701200000,NW 322,RESIDENTIAL,35200,0,35200,113600,0,148800
141937800100000,NW 323,RESIDENTIAL,30100,0,30100,149500,0,179600
141937800200000,NW 323,RESIDENTIAL,29300,0,29300,128200,0,157500
141937800300000,NW 323,RESIDENTIAL,29300,0,29300,133200,0,162500
141937800400000,NW 323,RESIDENTIAL,29600,0,29600,157900,0,187500
141937800500000,NW 323,RESIDENTIAL,30000,0,30000,181700,0,211700
141937800600000,NW 323,RESIDENTIAL,30300,0,30300,169500,0,199800
141937800700000,NW 323,RESIDENTIAL,31300,0,31300,155200,0,186500
141937800800000,NW 323,RESIDENTIAL,31000,0,31000,159900,0,190900
141937800900000,NW 323,RESIDENTIAL,31700,0,31700,162300,0,194000
141937801000000,NW 323,RESIDENTIAL,33300,0,33300,183500,0,216800
141937801100000,NW 323,RESIDENTIAL,33000,0,33000,141400,0,174400
141937801200000,NW 323,RESIDENTIAL,33600,0,33600,143100,0,176700
141937801300000,NW 323,EXEMPT,0,32300,32300,0,141500,173800
141937801400000,NW 322,RESIDENTIAL,25400,0,25400,102400,0,127800
141937801500000,NW 322,RESIDENTIAL,30500,0,30500,93500,0,124000
141937900100000,NW 322,RESIDENTIAL,22300,0,22300,85500,0,107800
141937900200000,NW 322,RESIDENTIAL,22300,0,22300,81100,0,103400
141937900300000,NW 322,RESIDENTIAL,23400,0,23400,82500,0,105900
141937900400000,NW 322,RESIDENTIAL,23400,0,23400,73000,0,96400
141937900500000,NW 322,RESIDENTIAL,24000,0,24000,99000,0,123000
141937900600000,NW 322,RESIDENTIAL,25400,0,25400,102600,0,128000
141937900700000,NW 322,RESIDENTIAL,25700,0,25700,131500,0,157200
141937900800000,NW 322,RESIDENTIAL,26500,0,26500,104300,0,130800
141937900900000,NW 322,RESIDENTIAL,26800,0,26800,127100,0,153900
141937901000000,NW 322,RESIDENTIAL,24700,0,24700,99500,0,124200
141937901100000,NW 322,RESIDENTIAL,24800,0,24800,112500,0,137300
141937901200000,NW 322,RESIDENTIAL,25100,0,25100,100100,0,125200
141937901300000,NW 322,RESIDENTIAL,24500,0,24500,102600,0,127100
141937901400000,NW 322,RESIDENTIAL,25800,0,25800,84000,0,109800
141937901500000,NW 322,RESIDENTIAL,24000,0,24000,99300,0,123300
141937901600000,NW 322,RESIDENTIAL,22300,0,22300,106600,0,128900
141937901700000,NW 322,RESIDENTIAL,24000,0,24000,103000,0,127000
141937901800000,NW 322,RESIDENTIAL,25700,0,25700,96800,0,122500
141937901900000,NW 322,RESIDENTIAL,25200,0,25200,103900,0,129100
141937902000000,NW 322,RESIDENTIAL,24600,0,24600,81700,0,106300
141937902100000,NW 322,RESIDENTIAL,24300,0,24300,82200,0,106500
141937902200000,NW 322,RESIDENTIAL,25100,0,25100,119800,0,144900
141937902300000,NW 322,RESIDENTIAL,25200,0,25200,132600,0,157800
141937902400000,NW 322,RESIDENTIAL,25400,0,25400,82500,0,107900
141938000100000,NW 322,RESIDENTIAL,26200,0,26200,121000,0,147200
141938000200000,NW 322,RESIDENTIAL,24600,0,24600,90100,0,114700
141938000300000,NW 322,RESIDENTIAL,24900,0,24900,88000,0,112900
141938000400000,NW 322,RESIDENTIAL,23200,0,23200,87900,0,111100
141938000500000,NW 322,RESIDENTIAL,22800,0,22800,137900,0,160700
141938000600000,NW 322,RESIDENTIAL,22900,0,22900,91700,0,114600
141938000700000,NW 322,RESIDENTIAL,27300,0,27300,104500,0,131800
141938000800000,NW 322,RESIDENTIAL,25900,0,25900,107200,0,133100
141938000900000,NW 322,RESIDENTIAL,42200,0,42200,129400,0,171600
141938001000000,NW 322,RESIDENTIAL,25900,0,25900,103500,0,129400
141938001100000,NW 322,RESIDENTIAL,27300,0,27300,110500,0,137800
141938001200000,NW 322,RESIDENTIAL,27400,0,27400,102700,0,130100
141938001300000,NW 322,RESIDENTIAL,24500,0,24500,106900,0,131400
141938001400000,NW 322,RESIDENTIAL,22600,0,22600,98300,0,120900
141938001500000,NW 322,RESIDENTIAL,22800,0,22800,92600,0,115400
141938001600000,NW 322,RESIDENTIAL,23500,0,23500,94900,0,118400
141938001700000,NW 322,RESIDENTIAL,24600,0,24600,97600,0,122200
141938001800000,NW 322,RESIDENTIAL,22300,0,22300,102000,0,124300
141938001900000,NW 322,RESIDENTIAL,22300,0,22300,74800,0,97100
141938002000000,NW 322,RESIDENTIAL,22300,0,22300,100900,0,123200
141938002100000,NW 322,RESIDENTIAL,22300,0,22300,81600,0,103900
141938002200000,NW 322,RESIDENTIAL,22300,0,22300,98900,0,121200
141938002300000,NW 322,RESIDENTIAL,22300,0,22300,93400,0,115700
141938002400000,NW 322,RESIDENTIAL,23300,0,23300,82900,0,106200
141938002500000,NW 322,RESIDENTIAL,35700,0,35700,76300,0,112000
141938002600000,NW 322,RESIDENTIAL,22900,0,22900,90500,0,113400
141938002700000,NW 322,RESIDENTIAL,40700,0,40700,112000,0,152700
141940100100000,CITY PROPERTY,EXEMPT,0,0,0,0,0,0
141940100200000,NW 313,RESIDENTIAL,38400,0,38400,193200,0,231600
141940100300000,NW 313,RESIDENTIAL,32200,0,32200,195900,0,228100
141940100400000,NW 313,RESIDENTIAL,32000,0,32000,206700,0,238700
141940100500000,NW 313,RESIDENTIAL,36600,0,36600,189500,0,226100
141940100600000,NW 313,RESIDENTIAL,40900,0,40900,243900,0,284800
141940100700000,NW 313,RESIDENTIAL,35900,0,35900,247100,0,283000
141940100800000,NW 313,RESIDENTIAL,40800,0,40800,237300,0,278100
141940100900000,NW 313,RESIDENTIAL,40100,0,40100,258400,0,298500
141940101000000,NW 313,RESIDENTIAL,39900,0,39900,203800,0,243700
141940101100000,NW 313,RESIDENTIAL,46100,0,46100,215400,0,261500
141940101200000,NW 313,RESIDENTIAL,45600,0,45600,205100,0,250700
141940101300000,NW 313,RESIDENTIAL,45800,0,45800,193800,0,239600
141940101400000,NW 313,RESIDENTIAL,47000,0,47000,238900,0,285900
141940101500000,NW 313,RESIDENTIAL,41200,0,41200,206200,0,247400
141940101600000,NW 313,RESIDENTIAL,35700,0,35700,218600,0,254300
141940101700000,NW 313,RESIDENTIAL,34300,0,34300,103400,0,137700
141940101800000,NW 313,RESIDENTIAL,45700,0,45700,129500,0,175200
141940101900000,NW 313,RESIDENTIAL,38800,0,38800,107600,0,146400
141940102000000,NW 313,RESIDENTIAL,67000,0,67000,130500,0,197500
141940102100000,NW 313,RESIDENTIAL,40700,0,40700,80600,0,121300
141940102200000,NW 313,RESIDENTIAL,29600,0,29600,117700,0,147300
141940102300000,NW 313,RESIDENTIAL,30200,0,30200,122600,0,152800
141942600100000,NW 313,RESIDENTIAL,38200,0,38200,70100,0,108300
141942600200000,NW 313,RESIDENTIAL,27700,0,27700,99100,0,126800
141942600300000,NW 313,RESIDENTIAL,23200,0,23200,74800,0,98000
141942600400000,NW 313,RESIDENTIAL,24800,0,24800,108200,0,133000
141942600500000,NW 313,RESIDENTIAL,25300,0,25300,101000,0,126300
141942600600000,NW 313,RESIDENTIAL,43900,0,43900,20300,0,64200
141942600700000,NW 313,RESIDENTIAL,24400,0,24400,0,0,24400
141942600800000,NW 313,RESIDENTIAL,27500,0,27500,126000,0,153500
141942600900000,NW 313,RESIDENTIAL,33400,0,33400,31900,0,65300
141942601000000,NW 313,RESIDENTIAL,29400,0,29400,108000,0,137400
141942601100000,NW 313,RESIDENTIAL,31000,0,31000,118600,0,149600
141942601200000,NW 313,RESIDENTIAL,50700,0,50700,85600,0,136300
141942601300000,NW 313,RESIDENTIAL,30100,0,30100,79700,0,109800
141942601400000,NW 313,RESIDENTIAL,31500,0,31500,99700,0,131200
141942601500000,NW 313,RESIDENTIAL,39000,0,39000,95700,0,134700
141942700100000,NW 313,RESIDENTIAL,35600,0,35600,44300,0,79900
141942700200000,NW 313,RESIDENTIAL,48200,0,48200,47700,0,95900
141942700300000,NW 313,RESIDENTIAL,34100,0,34100,65600,0,99700
141942700400000,NW 313,RESIDENTIAL,51600,0,51600,127500,0,179100
141942700500000,NW 313,RESIDENTIAL,39100,0,39100,500,0,39600
141942700600000,NW 313,RESIDENTIAL,60600,0,60600,108300,0,168900
141942700700000,NW 313,RESIDENTIAL,60300,0,60300,88700,0,149000
141942700800000,NW 313,RESIDENTIAL,37200,0,37200,114500,0,151700
141942700900000,NW 313,RESIDENTIAL,34300,0,34300,93700,0,128000
141942701000000,NW 313,RESIDENTIAL,32800,0,32800,50400,0,83200
141942701100000,NW 313,RESIDENTIAL,31000,0,31000,171700,0,202700
141942701200000,NW 313,RESIDENTIAL,28400,0,28400,137300,0,165700
141942701300000,NW 313,RESIDENTIAL,28400,0,28400,127400,0,155800
141942701400000,NW 308,RESIDENTIAL,30200,0,30200,0,0,30200
141942701500000,NW 308,RESIDENTIAL,15200,0,15200,0,0,15200
141942701600000,NW 308,RESIDENTIAL,33800,0,33800,123000,0,156800
141942701700000,NW 313,RESIDENTIAL,33300,0,33300,109000,0,142300
141942701800000,NW 313,RESIDENTIAL,25400,0,25400,150300,0,175700
141942701900000,NW 313,RESIDENTIAL,24300,0,24300,96700,0,121000
141942702000000,NW 313,RESIDENTIAL,20500,0,20500,119200,0,139700
141942702100000,NW 313,RESIDENTIAL,20200,0,20200,0,0,20200
141942702200000,NW 308,RESIDENTIAL,20800,0,20800,105200,0,126000
141942800100000,NW 313,RESIDENTIAL,41600,0,41600,130300,0,171900
141942800200000,NW 313,RESIDENTIAL,26000,0,26000,103800,0,129800
141942800300000,NW 313,RESIDENTIAL,45400,0,45400,93500,0,138900
141942800400000,NW 313,RESIDENTIAL,42500,0,42500,99000,0,141500
141942800500000,NW 313,RESIDENTIAL,31100,0,31100,72800,0,103900
141942800600000,NW 313,RESIDENTIAL,29700,0,29700,84000,0,113700
141942800700000,NW 313,RESIDENTIAL,30500,0,30500,87300,0,117800
141942800800000,NW 313,RESIDENTIAL,46200,0,46200,87900,0,134100
141942800900000,NW 313,RESIDENTIAL,43300,0,43300,30800,0,74100
141942801000000,NW 313,RESIDENTIAL,32600,0,32600,102100,0,134700
141942801100000,NW 313,RESIDENTIAL,30500,0,30500,126600,0,157100
141942801200000,NW 313,RESIDENTIAL,39300,0,39300,92700,0,132000
141942801300000,NW 313,RESIDENTIAL,31900,0,31900,113000,0,144900
141942801400000,NW 313,RESIDENTIAL,28400,0,28400,104700,0,133100
141942801500000,NW 313,RESIDENTIAL,29300,0,29300,60900,0,90200
141942801600000,NW 313,RESIDENTIAL,31500,0,31500,194300,0,225800
141942801700000,NW 313,RESIDENTIAL,27400,0,27400,97400,0,124800
141942900100000,NW 313,RESIDENTIAL,22100,0,22100,117100,0,139200
141942900200000,NW 308,RESIDENTIAL,20100,0,20100,119900,0,140000
141942900300000,NW 308,RESIDENTIAL,23000,0,23000,77300,0,100300
141942900400000,NW 308,RESIDENTIAL,25700,0,25700,62900,0,88600
141942900500000,NW 313,RESIDENTIAL,25200,0,25200,89600,0,114800
141942900600000,NW 313,RESIDENTIAL,21100,0,21100,90400,0,111500
141942900700000,NW 313,RESIDENTIAL,22200,0,22200,87200,0,109400
141943000100000,NW 308,RESIDENTIAL,26400,0,26400,130500,0,156900
141943000200000,NW 308,RESIDENTIAL,24800,0,24800,122600,0,147400
141943000300000,NW 308,RESIDENTIAL,24800,0,24800,113200,0,138000
141943000400000,NW 323,RESIDENTIAL,32700,0,32700,158900,0,191600
141943000500000,NW 323,RESIDENTIAL,33200,0,33200,194700,0,227900
141943000600000,NW 323,RESIDENTIAL,33600,0,33600,0,0,33600
141943000700000,NW 313,RESIDENTIAL,27500,0,27500,104000,0,131500
141943000800000,NW 313,RESIDENTIAL,28500,0,28500,105200,0,133700
141943000900000,NW 313,RESIDENTIAL,29000,0,29000,124000,0,153000
141945100100000,NW 313,RESIDENTIAL,32300,0,32300,96600,0,128900
141945100200000,NW 313,RESIDENTIAL,30400,0,30400,97600,0,128000
141945100300000,NW 313,RESIDENTIAL,31100,0,31100,91200,0,122300
141945100400000,NW 322,RESIDENTIAL,32300,0,32300,109300,0,141600
141945100500000,NW 322,RESIDENTIAL,30100,0,30100,122800,0,152900
141945100600000,NW 322,RESIDENTIAL,22400,0,22400,122800,0,145200
141945100700000,NW 322,RESIDENTIAL,21900,0,21900,124300,0,146200
141945100800000,NW 322,RESIDENTIAL,24800,0,24800,92800,0,117600
141945100900000,NW 322,RESIDENTIAL,25300,0,25300,88900,0,114200
141945101000000,NW 322,RESIDENTIAL,24700,0,24700,130700,0,155400
141945101100000,NW 322,RESIDENTIAL,50000,0,50000,184600,0,234600
141945200100000,NW 313,RESIDENTIAL,33800,0,33800,74100,0,107900
141945200200000,NW 313,RESIDENTIAL,31500,0,31500,83500,0,115000
141945200300000,NW 313,RESIDENTIAL,28100,0,28100,95700,0,123800
141945200400000,NW 313,RESIDENTIAL,28900,0,28900,137400,0,166300
141945200500000,NW 313,RESIDENTIAL,26800,0,26800,69400,0,96200
141945200600000,NW 322,RESIDENTIAL,28600,0,28600,169400,0,198000
141945200700000,NW 322,RESIDENTIAL,26200,0,26200,0,0,26200
141945200800000,NW 322,RESIDENTIAL,41600,0,41600,51000,0,92600
141945200900000,NW 322,RESIDENTIAL,28600,0,28600,113300,0,141900
141945201000000,NW 322,RESIDENTIAL,29200,0,29200,109200,0,138400
141945201100000,NW 313,RESIDENTIAL,41900,0,41900,70900,0,112800
141945300100000,NW 322,RESIDENTIAL,30500,0,30500,84600,0,115100
141945300200000,NW 322,RESIDENTIAL,27900,0,27900,92200,0,120100
141945300300000,NW 322,RESIDENTIAL,28900,0,28900,97100,0,126000
141945300400000,NW 322,RESIDENTIAL,27700,0,27700,123500,0,151200
141945300500000,NW 322,RESIDENTIAL,27400,0,27400,79800,0,107200
141945300600000,NW 322,RESIDENTIAL,27500,0,27500,145900,0,173400
141945300700000,NW 322,RESIDENTIAL,31300,0,31300,137500,0,168800
141945300800000,NW 322,RESIDENTIAL,29600,0,29600,121400,0,151000
141945300900000,NW 322,RESIDENTIAL,26900,0,26900,129500,0,156400
141945301000000,NW 322,RESIDENTIAL,26900,0,26900,103100,0,130000
141945301100000,NW 322,RESIDENTIAL,28600,0,28600,121500,0,150100
141945301200000,NW 323,RESIDENTIAL,32900,0,32900,154100,0,187000
141945301300000,NW 323,RESIDENTIAL,31600,0,31600,154500,0,186100
141945301400000,NW 323,RESIDENTIAL,31600,0,31600,150200,0,181800
141945301500000,NW 323,RESIDENTIAL,31600,0,31600,149900,0,181500
141945301600000,NW 323,RESIDENTIAL,32100,0,32100,155500,0,187600
141945301700000,NW 323,RESIDENTIAL,36300,0,36300,163000,0,199300
141945301800000,NW 323,RESIDENTIAL,36700,0,36700,171600,0,208300
141945301900000,NW 323,RESIDENTIAL,38700,0,38700,164800,0,203500
141945302000000,NW 323,EXEMPT,0,34200,34200,160700,0,194900
141945302100000,NW 323,RESIDENTIAL,33600,0,33600,161100,0,194700
141945302200000,NW 323,RESIDENTIAL,28800,0,28800,142800,0,171600
141945302300000,NW 323,RESIDENTIAL,29300,0,29300,149200,0,178500
141945302400000,NW 323,RESIDENTIAL,30100,0,30100,142800,0,172900
141945400100000,NW 323,RESIDENTIAL,31000,0,31000,160000,0,191000
141945400200000,NW 323,RESIDENTIAL,31000,0,31000,157700,0,188700
141945400300000,NW 323,RESIDENTIAL,31000,0,31000,160200,0,191200
141945400400000,NW 323,RESIDENTIAL,30400,0,30400,145000,0,175400
141945400500000,NW 323,RESIDENTIAL,30400,0,30400,129100,0,159500
141945400600000,NW 323,RESIDENTIAL,32900,0,32900,142600,0,175500
141945400700000,NW 323,RESIDENTIAL,33700,0,33700,164200,0,197900
141945400800000,NW 323,RESIDENTIAL,31000,0,31000,0,0,31000
141945400900000,NW 323,RESIDENTIAL,31000,0,31000,142100,0,173100
141945401000000,NW 323,RESIDENTIAL,31000,0,31000,126200,0,157200
141945500100000,NW 322,RESIDENTIAL,49200,0,49200,86300,0,135500
141945500200000,NW 322,RESIDENTIAL,48400,0,48400,0,0,48400
141945500300000,CITY PROPERTY,EXEMPT,0,0,0,0,0,0
141945500400000,NW 322,RESIDENTIAL,42700,0,42700,129500,0,172200
141945600100000,NW 322,RESIDENTIAL,30000,0,30000,130800,0,160800
141945600200000,NW 322,RESIDENTIAL,22600,0,22600,126600,0,149200
141945600300000,NW 322,RESIDENTIAL,25000,0,25000,113500,0,138500
141945600400000,NW 322,RESIDENTIAL,24700,0,24700,96700,0,121400
141945600500000,NW 322,RESIDENTIAL,24900,0,24900,117600,0,142500
141945600600000,NW 322,RESIDENTIAL,24700,0,24700,113200,0,137900
141945600700000,NW 322,RESIDENTIAL,25100,0,25100,138100,0,163200
141945600800000,NW 322,RESIDENTIAL,24600,0,24600,143200,0,167800
141945600900000,NW 322,RESIDENTIAL,25100,0,25100,117400,0,142500
141945601000000,NW 322,RESIDENTIAL,24400,0,24400,116800,0,141200
141945601100000,NW 322,RESIDENTIAL,23600,0,23600,104200,0,127800
141945601200000,NW 322,RESIDENTIAL,23900,0,23900,116900,0,140800
141945601300000,NW 322,RESIDENTIAL,24600,0,24600,93800,0,118400
141945601400000,NW 322,RESIDENTIAL,25100,0,25100,119000,0,144100
141945601500000,NW 322,RESIDENTIAL,25100,0,25100,100800,0,125900
141945601600000,NW 322,RESIDENTIAL,24500,0,24500,109200,0,133700
141945601700000,CITY PROPERTY,EXEMPT,0,0,0,0,0,0
141945601800000,NW 322,RESIDENTIAL,29700,0,29700,86200,0,115900
141945601900000,NW 322,RESIDENTIAL,22800,0,22800,100500,0,123300
141945602000000,NW 322,RESIDENTIAL,26800,0,26800,90000,0,116800
141945602100000,NW 322,RESIDENTIAL,38300,0,38300,113700,0,152000
141945602200000,NW 322,RESIDENTIAL,39000,0,39000,105000,0,144000
141945602300000,NW 322,RESIDENTIAL,28600,0,28600,107200,0,135800
141945700100000,NW 322,RESIDENTIAL,25700,0,25700,91800,0,117500
141945700200000,NW 322,RESIDENTIAL,24900,0,24900,73800,0,98700
141945700300000,NW 322,RESIDENTIAL,24900,0,24900,115800,0,140700
141945700400000,NW 322,RESIDENTIAL,34100,0,34100,122100,0,156200
141945700500000,NW 322,RESIDENTIAL,24900,0,24900,98600,0,123500
141945700600000,NW 322,RESIDENTIAL,22300,0,22300,79200,0,101500
141945700700000,NW 322,RESIDENTIAL,21600,0,21600,78600,0,100200
141947600100000,NW 312,RESIDENTIAL,26200,0,26200,100400,0,126600
141947600200000,NW 312,RESIDENTIAL,25700,0,25700,101000,0,126700
141947600300000,NW 312,RESIDENTIAL,26800,0,26800,131300,0,158100
141947600400000,NW 312,RESIDENTIAL,29100,0,29100,118200,0,147300
141947600500000,NW 312,RESIDENTIAL,26300,0,26300,121900,0,148200
141947600600000,NW 312,RESIDENTIAL,26300,0,26300,133800,0,160100
141947600700000,NW 312,RESIDENTIAL,29300,0,29300,136900,0,166200
141947600800000,NW 312,RESIDENTIAL,30400,0,30400,141100,0,171500
141947600900000,NW 312,RESIDENTIAL,28700,0,28700,107200,0,135900
141947601000000,NW 312,RESIDENTIAL,29000,0,29000,123700,0,152700
141947601100000,NW 312,RESIDENTIAL,29000,0,29000,124500,0,153500
141947601200000,NW 312,RESIDENTIAL,27100,0,27100,138200,0,165300
141947601300000,NW 312,RESIDENTIAL,27100,0,27100,102400,0,129500
141947601400000,NW 312,RESIDENTIAL,27100,0,27100,111100,0,138200
141947601500000,NW 312,RESIDENTIAL,27100,0,27100,122400,0,149500
141947601600000,NW 312,RESIDENTIAL,25900,0,25900,59400,0,85300
141947601700000,NW 312,RESIDENTIAL,26600,0,26600,88100,0,114700
141947601800000,NW 322,RESIDENTIAL,28600,0,28600,92000,0,120600
141947601900000,NW 322,RESIDENTIAL,28700,0,28700,89800,0,118500
141947602000000,NW 322,RESIDENTIAL,41700,0,41700,72300,0,114000
141947602100000,CHURCH,EXEMPT,0,272000,272000,0,193900,465900
141947700100000,NW 322,RESIDENTIAL,50400,0,50400,125500,0,175900
141947700200000,NW 322,RESIDENTIAL,50400,0,50400,132400,0,182800
141947700300000,CHURCH,EXEMPT,0,500600,500600,0,450300,950900
141947800100000,NW 322,RESIDENTIAL,42300,0,42300,163400,0,205700
141947800200000,NW 322,RESIDENTIAL,35800,0,35800,48000,0,83800
141947800300000,NW 322,RESIDENTIAL,49200,0,49200,66100,0,115300
141947800400000,NW 322,RESIDENTIAL,28100,0,28100,97400,0,125500
141947800500000,NW 322,RESIDENTIAL,32800,0,32800,86700,0,119500
141947800600000,NW 322,RESIDENTIAL,26300,0,26300,95300,0,121600
141947800700000,NW 322,RESIDENTIAL,24500,0,24500,108900,0,133400
141947800800000,NW 322,RESIDENTIAL,25300,0,25300,99100,0,124400
141947800900000,NW 322,RESIDENTIAL,29700,0,29700,119300,0,149000
141947801000000,NW 322,RESIDENTIAL,26200,0,26200,118000,0,144200
141947801100000,NW 322,RESIDENTIAL,33900,0,33900,59400,0,93300
141947900100000,CITY PROPERTY,EXEMPT,0,0,0,0,0,0
141947900200000,NW 322,RESIDENTIAL,65300,0,65300,149900,0,215200
141947900500000,NW 322,RESIDENTIAL,28500,0,28500,122900,0,151400
141947900600000,NW 322,RESIDENTIAL,30400,0,30400,68200,0,98600
141947900700000,NW 322,RESIDENTIAL,26200,0,26200,150300,0,176500
141947900800000,NW 322,RESIDENTIAL,26200,0,26200,105200,0,131400
141947900900000,NW 322,RESIDENTIAL,27600,0,27600,148900,0,176500
141947901000000,NW 322,RESIDENTIAL,31200,0,31200,63700,0,94900
141947901100000,NW 322,RESIDENTIAL,41300,0,41300,104900,0,146200
141947901200000,NW 322,RESIDENTIAL,68000,0,68000,148700,0,216700
141947901300000,NW 322,RESIDENTIAL,27500,0,27500,94600,0,122100
142010100300000,NW 310,RESIDENTIAL,47200,0,47200,53700,0,100900
142010100400000,CITY PROPERTY,EXEMPT,0,0,0,0,0,0
142010100500000,NW 310,RESIDENTIAL,86900,0,86900,0,0,86900
142010100800000,NW 310,RESIDENTIAL,31200,0,31200,46700,0,77900
142010100900000,NW 310,RESIDENTIAL,18200,0,18200,41600,0,59800
142010101000000,NW 310,RESIDENTIAL,17000,0,17000,51200,0,68200
142010101200000,NW 310,RESIDENTIAL,65900,0,65900,99500,0,165400
142010101300000,NW 310,RESIDENTIAL,37800,0,37800,40000,0,77800
142010101500000,CITY PROPERTY,EXEMPT,0,0,0,0,0,0
142010101600000,CITY PROPERTY,EXEMPT,0,0,0,0,0,0
142010200300000,CITY PROPERTY,EXEMPT,0,0,0,0,0,0
142010301600000,CITY PROPERTY,EXEMPT,0,0,0,0,0,0
142010301700000,CITY PROPERTY,EXEMPT,0,0,0,0,0,0
142010400200000,NW 310,RESIDENTIAL,19800,0,19800,72900,0,92700
142010402500000,CITY PROPERTY,EXEMPT,0,0,0,0,0,0
142010402600000,CITY PROPERTY,EXEMPT,0,0,0,0,0,0
142010500800000,NW 310,RESIDENTIAL,19800,0,19800,62800,0,82600
142010500900000,CITY PROPERTY,EXEMPT,0,0,0,0,0,0
142010501000000,CITY PROPERTY,EXEMPT,0,0,0,0,0,0
142010501100000,CITY PROPERTY,EXEMPT,0,0,0,0,0,0
142010501200000,CITY PROPERTY,EXEMPT,0,0,0,0,0,0
142010501300000,CITY PROPERTY,EXEMPT,0,0,0,0,0,0
142010501400000,SMALL RETAIL,COMMERCIAL,0,10800,10800,0,37000,47800
142010501500000,CITY PROPERTY,EXEMPT,0,0,0,0,0,0
142010501600000,CITY PROPERTY,EXEMPT,0,0,0,0,0,0
142010501700000,CITY PROPERTY,EXEMPT,0,0,0,0,0,0
142010501800000,CITY PROPERTY,EXEMPT,0,0,0,0,0,0
142010501900000,CITY PROPERTY,EXEMPT,0,0,0,0,0,0
142010502900000,CITY PROPERTY,EXEMPT,0,0,0,0,0,0
142010503000000,CITY PROPERTY,EXEMPT,0,0,0,0,0,0
142012600100000,NW 310,RESIDENTIAL,21400,0,21400,79400,0,100800
142012600200000,CITY PROPERTY,EXEMPT,0,0,0,0,0,0
142012600300000,CITY PROPERTY,EXEMPT,0,0,0,0,0,0
142012600400000,CITY PROPERTY,EXEMPT,0,0,0,0,0,0
142012600500000,CITY PROPERTY,EXEMPT,0,0,0,0,0,0
142012600600000,CITY PROPERTY,EXEMPT,0,0,0,0,0,0
142012600700000,CITY PROPERTY,EXEMPT,0,0,0,0,0,0
142012600800000,CITY PROPERTY,EXEMPT,0,0,0,0,0,0
142012600900000,NW 310,RESIDENTIAL,23700,0,23700,96600,0,120300
142012601000000,NW 310,RESIDENTIAL,6400,0,6400,4900,0,11300
142012601100000,NW 310,RESIDENTIAL,21400,0,21400,73600,0,95000
142012601200000,CITY PROPERTY,EXEMPT,0,0,0,0,0,0
142012601300000,CITY PROPERTY,EXEMPT,0,0,0,0,0,0
142012601400000,CITY PROPERTY,EXEMPT,0,0,0,0,0,0
142012601500000,NW 310,RESIDENTIAL,19800,0,19800,48100,0,67900
142012601600000,NW 310,RESIDENTIAL,19800,0,19800,78500,0,98300
142012601700000,NW 310,RESIDENTIAL,19800,0,19800,68200,0,88000
142012700100000,NW 310,RESIDENTIAL,22700,0,22700,82800,0,105500
142012700200000,NW 310,RESIDENTIAL,28500,0,28500,76800,0,105300
142012700300000,NW 310,RESIDENTIAL,29700,0,29700,97200,0,126900
142012700400000,NW 310,RESIDENTIAL,28900,0,28900,86400,0,115300
142012700500000,NW 310,RESIDENTIAL,29700,0,29700,84200,0,113900
142012700600000,CITY PROPERTY,EXEMPT,0,0,0,0,0,0
142012700700000,CITY PROPERTY,EXEMPT,0,0,0,0,0,0
142012700800000,CITY PROPERTY,EXEMPT,0,0,0,0,0,0
142012700900000,NW 310,RESIDENTIAL,19800,0,19800,80500,0,100300
142012701000000,NW 310,RESIDENTIAL,19800,0,19800,60200,0,80000
142012701100000,CITY PROPERTY,EXEMPT,0,0,0,0,0,0
142012701200000,NW 310,RESIDENTIAL,19800,0,19800,0,0,19800
142012701300000,CITY PROPERTY,EXEMPT,0,0,0,0,0,0
142012701400000,NW 310,RESIDENTIAL,19800,0,19800,66200,0,86000
142012800100000,NW 310,RESIDENTIAL,25500,0,25500,78700,0,104200
142012800200000,NW 310,RESIDENTIAL,24300,0,24300,94100,0,118400
142012800300000,NW 310,RESIDENTIAL,31400,0,31400,80300,0,111700
142012800400000,NW 310,RESIDENTIAL,27200,0,27200,90800,0,118000
142012800500000,NW 310,RESIDENTIAL,25200,0,25200,76700,0,101900
142012800600000,NW 310,RESIDENTIAL,26400,0,26400,97500,0,123900
142012800700000,NW 310,RESIDENTIAL,26600,0,26600,71300,0,97900
142012800800000,NW 310,RESIDENTIAL,25500,0,25500,76400,0,101900
142012800900000,NW 310,RESIDENTIAL,29100,0,29100,108100,0,137200
142012801000000,NW 310,RESIDENTIAL,25200,0,25200,120000,0,145200
142012801100000,NW 310,RESIDENTIAL,27200,0,27200,82700,0,109900
142012801200000,NW 310,RESIDENTIAL,27400,0,27400,79000,0,106400
142012900100000,NW 310,RESIDENTIAL,27200,0,27200,96300,0,123500
142012900200000,FRATERNAL,COMMERCIAL,0,121900,121900,0,121600,243500
142012900300000,NW 304,RESIDENTIAL,30800,0,30800,103000,0,133800
142012900400000,NW 304,RESIDENTIAL,28900,0,28900,104800,0,133700
142012900500000,NW 304,RESIDENTIAL,28900,0,28900,78600,0,107500
142012900600000,NW 304,RESIDENTIAL,28900,0,28900,105300,0,134200
142012900700000,NW 304,RESIDENTIAL,28900,0,28900,110800,0,139700
142012900800000,NW 304,RESIDENTIAL,28600,0,28600,114600,0,143200
142012900900000,NW 304,RESIDENTIAL,28400,0,28400,72400,0,100800
142012901000000,NW 304,RESIDENTIAL,22500,0,22500,83000,0,105500
142012901100000,NW 304,RESIDENTIAL,21900,0,21900,84400,0,106300
142012901200000,NW 304,RESIDENTIAL,23500,0,23500,95400,0,118900
142012901300000,NW 304,RESIDENTIAL,20700,0,20700,77300,0,98000
142012901400000,NW 304,RESIDENTIAL,18200,0,18200,55300,0,73500
142012901500000,NW 310,RESIDENTIAL,24500,0,24500,86400,0,110900
142012901600000,NW 310,RESIDENTIAL,22400,0,22400,81900,0,104300
142012901700000,NW 310,RESIDENTIAL,22400,0,22400,78000,0,100400
142012901800000,NW 310,RESIDENTIAL,22400,0,22400,75800,0,98200
142012901900000,NW 310,RESIDENTIAL,22400,0,22400,92700,0,115100
142012902000000,NW 310,RESIDENTIAL,25400,0,25400,69500,0,94900
142012902100000,NW 310,RESIDENTIAL,26200,0,26200,80900,0,107100
142012902200000,NW 310,RESIDENTIAL,26200,0,26200,72700,0,98900
142012902300000,NW 310,RESIDENTIAL,27600,0,27600,72400,0,100000
142012902400000,NW 310,RESIDENTIAL,29400,0,29400,72800,0,102200
142012902500000,NW 310,RESIDENTIAL,29400,0,29400,75700,0,105100
142012902600000,NW 310,RESIDENTIAL,29400,0,29400,76300,0,105700
142012902700000,NW 310,RESIDENTIAL,31100,0,31100,69200,0,100300
142012902800000,NW 304,RESIDENTIAL,27500,0,27500,102100,0,129600
142012902900000,NW 304,RESIDENTIAL,27800,0,27800,75500,0,103300
142012903000000,NW 310,RESIDENTIAL,31700,0,31700,90900,0,122600
142012903100000,NW 310,RESIDENTIAL,24000,0,24000,81000,0,105000
142012903200000,NW 310,RESIDENTIAL,25700,0,25700,76600,0,102300
142012903300000,NW 304,RESIDENTIAL,5400,0,5400,0,0,5400
142013000100000,CITY PROPERTY,EXEMPT,0,0,0,0,0,0
142013000200000,CITY PROPERTY,EXEMPT,0,0,0,0,0,0
142013000300000,NW 310,RESIDENTIAL,25700,0,25700,64100,0,89800
142013000400000,CITY PROPERTY,EXEMPT,0,0,0,0,0,0
142013000500000,NW 310,RESIDENTIAL,19800,0,19800,67800,0,87600
142013000600000,CITY PROPERTY,EXEMPT,0,0,0,0,0,0
142013000700000,NW 310,RESIDENTIAL,19800,0,19800,72900,0,92700
142013000800000,NW 310,RESIDENTIAL,19800,0,19800,59600,0,79400
142013000900000,CITY PROPERTY,EXEMPT,0,0,0,0,0,0
142013001000000,NW 310,RESIDENTIAL,19800,0,19800,73900,0,93700
142013001100000,NW 310,RESIDENTIAL,19800,0,19800,69500,0,89300
142013001200000,CITY PROPERTY,EXEMPT,0,0,0,0,0,0
142013001300000,NW 310,RESIDENTIAL,20700,0,20700,73500,0,94200
142013001400000,CITY PROPERTY,EXEMPT,0,0,0,0,0,0
142013001500000,CITY PROPERTY,EXEMPT,0,0,0,0,0,0
142013001600000,NW 310,RESIDENTIAL,19800,0,19800,67000,0,86800
142013001700000,CITY PROPERTY,EXEMPT,0,0,0,0,0,0
142013001800000,CITY PROPERTY,EXEMPT,0,0,0,0,0,0
142013001900000,CITY PROPERTY,EXEMPT,0,0,0,0,0,0
142013002000000,CITY PROPERTY,EXEMPT,0,0,0,0,0,0
142013002100000,CITY PROPERTY,EXEMPT,0,0,0,0,0,0
142013002200000,CITY PROPERTY,EXEMPT,0,0,0,0,0,0
142013002300000,CITY PROPERTY,EXEMPT,0,0,0,0,0,0
142013002400000,CITY PROPERTY,EXEMPT,0,0,0,0,0,0
142013002500000,CITY PROPERTY,EXEMPT,0,0,0,0,0,0
142013002600000,NW 310,RESIDENTIAL,19800,0,19800,56100,0,75900
142013002700000,NW 310,RESIDENTIAL,19800,0,19800,85800,0,105600
142013002800000,CITY PROPERTY,EXEMPT,0,0,0,0,0,0
142013002900000,NW 310,RESIDENTIAL,19800,0,19800,59800,0,79600
142013100100000,NW 310,RESIDENTIAL,21400,0,21400,67100,0,88500
142013100200000,NW 310,RESIDENTIAL,23500,0,23500,92600,0,116100
142013100300000,NW 310,RESIDENTIAL,23800,0,23800,78600,0,102400
142013100400000,NW 310,RESIDENTIAL,23800,0,23800,71400,0,95200
142013100500000,NW 310,RESIDENTIAL,23800,0,23800,90500,0,114300
142013100600000,NW 310,RESIDENTIAL,23800,0,23800,120500,0,144300
142013100700000,NW 310,RESIDENTIAL,23800,0,23800,68600,0,92400
142013100800000,NW 310,RESIDENTIAL,23800,0,23800,75900,0,99700
142013100900000,NW 310,RESIDENTIAL,29000,0,29000,69500,0,98500
142013101000000,NW 310,RESIDENTIAL,28300,0,28300,75600,0,103900
142013101100000,NW 310,RESIDENTIAL,20600,0,20600,73200,0,93800
142013101200000,NW 310,RESIDENTIAL,17800,0,17800,71400,0,89200
142013101300000,NW 310,RESIDENTIAL,26800,0,26800,124100,0,150900
142013101400000,NW 310,RESIDENTIAL,19800,0,19800,78300,0,98100
142013101500000,NW 310,RESIDENTIAL,19800,0,19800,125900,0,145700
142013101600000,NW 310,RESIDENTIAL,19800,0,19800,131900,0,151700
142013101700000,NW 310,RESIDENTIAL,19800,0,19800,73200,0,93000
142013101800000,NW 310,RESIDENTIAL,19800,0,19800,75300,0,95100
142013101900000,NW 310,RESIDENTIAL,19800,0,19800,48700,0,68500
142013102000000,NW 310,RESIDENTIAL,19800,0,19800,113200,0,133000
142013102100000,NW 310,RESIDENTIAL,19800,0,19800,105800,0,125600
142013102200000,NW 310,RESIDENTIAL,19800,0,19800,90900,0,110700
142013102300000,NW 310,RESIDENTIAL,19800,0,19800,86300,0,106100
142013102400000,CITY PROPERTY,EXEMPT,0,0,0,0,0,0
142013102500000,CITY PROPERTY,EXEMPT,0,0,0,0,0,0
142013102600000,NW 310,RESIDENTIAL,19800,0,19800,91600,0,111400
142013102700000,NW 310,RESIDENTIAL,19800,0,19800,50000,0,69800
142013200200000,NW 310,RESIDENTIAL,24600,0,24600,91900,0,116500
142013200300000,NW 310,RESIDENTIAL,23500,0,23500,98000,0,121500
142013200400000,NW 310,RESIDENTIAL,23500,0,23500,76400,0,99900
142013200500000,NW 310,RESIDENTIAL,23800,0,23800,88000,0,111800
142013200600000,NW 310,RESIDENTIAL,23800,0,23800,79200,0,103000
142013200700000,NW 310,RESIDENTIAL,23800,0,23800,70100,0,93900
142013200800000,NW 310,RESIDENTIAL,24000,0,24000,73900,0,97900
142013200900000,NW 310,RESIDENTIAL,25000,0,25000,79300,0,104300
142013201000000,CONVERSION-NW/SW,MULTI-RES,27500,0,27500,92600,0,120100
142013201100000,NW 310,RESIDENTIAL,24900,0,24900,106000,0,130900
142013201200000,NW 310,RESIDENTIAL,21600,0,21600,76300,0,97900
142013201300000,NW 310,RESIDENTIAL,21600,0,21600,66700,0,88300
142013201400000,NW 310,RESIDENTIAL,21600,0,21600,96900,0,118500
142013201500000,NW 310,RESIDENTIAL,21600,0,21600,71400,0,93000
142013201600000,NW 310,RESIDENTIAL,22000,0,22000,76400,0,98400
142013201700000,NW 310,RESIDENTIAL,24200,0,24200,75900,0,100100
142013201800000,NW 310,RESIDENTIAL,24000,0,24000,69800,0,93800
142013201900000,NW 310,RESIDENTIAL,24000,0,24000,71100,0,95100
142013202000000,NW 310,RESIDENTIAL,23800,0,23800,69100,0,92900
142013202100000,NW 310,RESIDENTIAL,23800,0,23800,74100,0,97900
142013202200000,NW 310,RESIDENTIAL,23500,0,23500,89600,0,113100
142013202300000,NW 310,RESIDENTIAL,23300,0,23300,74700,0,98000
142013202400000,NW 310,RESIDENTIAL,23300,0,23300,66200,0,89500
142013202500000,NW 310,RESIDENTIAL,25700,0,25700,115400,0,141100
142013202600000,NW 310,RESIDENTIAL,25800,0,25800,128800,0,154600
142015100100000,CONVENIENCE STORE,COMMERCIAL,0,102400,102400,0,307200,409600
142015100200000,NW 310,RESIDENTIAL,22000,0,22000,135800,0,157800
142015100300000,NW 310,RESIDENTIAL,22000,0,22000,129700,0,151700
142015100400000,NW 310,RESIDENTIAL,19900,0,19900,56500,0,76400
142015100500000,NW 310,RESIDENTIAL,20100,0,20100,117400,0,137500
142015100600000,NW 310,RESIDENTIAL,21600,0,21600,81300,0,102900
142015100700000,NW 310,RESIDENTIAL,22000,0,22000,85200,0,107200
142015100800000,NW 310,RESIDENTIAL,21900,0,21900,99700,0,121600
142015100900000,NW 310,RESIDENTIAL,23400,0,23400,96900,0,120300
142015101100000,NW 310,RESIDENTIAL,26100,0,26100,74200,0,100300
142015101200000,NW 310,RESIDENTIAL,16000,0,16000,47100,0,63100
142015101300000,NW 310,RESIDENTIAL,5000,0,5000,0,0,5000
142015101400000,NW 310,RESIDENTIAL,13100,0,13100,45800,0,58900
142015101500000,NW 310,RESIDENTIAL,17800,0,17800,58800,0,76600
142015101600000,NW 310,EXEMPT,0,21800,21800,0,84100,105900
142015101800000,CHURCH,EXEMPT,0,291200,291200,0,267900,559100
142015200100000,NW 310,RESIDENTIAL,21000,0,21000,0,0,21000
142015200200000,NW 310,RESIDENTIAL,18600,0,18600,66600,0,85200
142015200300000,NW 310,RESIDENTIAL,27000,0,27000,126200,0,153200
142015200400000,NW 310,RESIDENTIAL,18600,0,18600,59800,0,78400
142015200500000,NW 310,RESIDENTIAL,18900,0,18900,63400,0,82300
142015200600000,NW 310,RESIDENTIAL,18800,0,18800,68500,0,87300
142015200700000,NW 310,RESIDENTIAL,18000,0,18000,58500,0,76500
142015200800000,NW 310,RESIDENTIAL,22100,0,22100,82700,0,104800
142015200900000,NW 310,RESIDENTIAL,21400,0,21400,85300,0,106700
142015201000000,NW 310,RESIDENTIAL,26100,0,26100,81400,0,107500
142015201100000,NW 310,RESIDENTIAL,25900,0,25900,89600,0,115500
142015201200000,NW 310,RESIDENTIAL,21300,0,21300,80300,0,101600
142015201300000,NW 310,RESIDENTIAL,20600,0,20600,83100,0,103700
142015201400000,NW 310,RESIDENTIAL,20600,0,20600,90900,0,111500
142015201500000,NW 310,RESIDENTIAL,20900,0,20900,87600,0,108500
142015201600000,NW 310,RESIDENTIAL,16000,0,16000,59100,0,75100
142015201700000,NW 310,RESIDENTIAL,16700,0,16700,48800,0,65500
142015201800000,NW 310,RESIDENTIAL,16000,0,16000,82100,0,98100
142015201900000,NW 310,RESIDENTIAL,16000,0,16000,69400,0,85400
142015202000000,NW 310,RESIDENTIAL,26100,0,26100,99300,0,125400
142015202100000,NW 310,RESIDENTIAL,21300,0,21300,85900,0,107200
142015202200000,NW 310,RESIDENTIAL,20600,0,20600,86800,0,107400
142015202300000,NW 310,RESIDENTIAL,20600,0,20600,104800,0,125400
142015202400000,NW 310,RESIDENTIAL,20900,0,20900,91500,0,112400
142015202500000,NW 310,RESIDENTIAL,23300,0,23300,89700,0,113000
142015202600000,NW 310,RESIDENTIAL,23900,0,23900,105200,0,129100
142015202700000,NW 310,RESIDENTIAL,21400,0,21400,90800,0,112200
142015202800000,NW 310,RESIDENTIAL,21800,0,21800,77800,0,99600
142015202900000,NW 310,RESIDENTIAL,18700,0,18700,113800,0,132500
142015203000000,NW 310,RESIDENTIAL,18800,0,18800,61500,0,80300
142015300100000,NW 310,RESIDENTIAL,18700,0,18700,67700,0,86400
142015300200000,NW 310,RESIDENTIAL,18600,0,18600,66100,0,84700
142015300300000,NW 310,RESIDENTIAL,23800,0,23800,74200,0,98000
142015300400000,NW 310,RESIDENTIAL,18600,0,18600,72400,0,91000
142015300500000,NW 310,RESIDENTIAL,18900,0,18900,62900,0,81800
142015300600000,NW 310,RESIDENTIAL,18000,0,18000,64800,0,82800
142015300700000,NW 310,RESIDENTIAL,17700,0,17700,58800,0,76500
142015300800000,NW 310,RESIDENTIAL,22200,0,22200,85200,0,107400
142015300900000,NW 310,RESIDENTIAL,21400,0,21400,85400,0,106800
142015301000000,NW 310,RESIDENTIAL,26100,0,26100,84600,0,110700
142015301100000,NW 310,RESIDENTIAL,26600,0,26600,87900,0,114500
142015301200000,NW 310,RESIDENTIAL,20600,0,20600,110600,0,131200
142015301300000,NW 310,RESIDENTIAL,20600,0,20600,77600,0,98200
142015301400000,NW 310,RESIDENTIAL,23800,0,23800,88900,0,112700
142015301500000,NW 310,RESIDENTIAL,17500,0,17500,69600,0,87100
142015301600000,NW 310,RESIDENTIAL,16000,0,16000,52300,0,68300
142015301700000,NW 310,RESIDENTIAL,22900,0,22900,64200,0,87100
142015301800000,NW 310,RESIDENTIAL,21300,0,21300,58300,0,79600
142015301900000,NW 310,RESIDENTIAL,16700,0,16700,47100,0,63800
142015302000000,NW 310,RESIDENTIAL,16000,0,16000,80700,0,96700
142015302100000,NW 310,RESIDENTIAL,21800,0,21800,86800,0,108600
142015302200000,NW 310,RESIDENTIAL,20600,0,20600,90400,0,111000
142015302300000,NW 310,RESIDENTIAL,20600,0,20600,88800,0,109400
142015302400000,NW 310,RESIDENTIAL,20900,0,20900,75000,0,95900
142015302500000,NW 310,RESIDENTIAL,25900,0,25900,93600,0,119500
142015302600000,NW 310,RESIDENTIAL,26500,0,26500,81800,0,108300
142015302700000,NW 310,RESIDENTIAL,21400,0,21400,94000,0,115400
142015302800000,NW 310,RESIDENTIAL,21800,0,21800,111100,0,132900
142015302900000,NW 310,RESIDENTIAL,17600,0,17600,79100,0,96700
142015303000000,NW 310,RESIDENTIAL,18800,0,18800,62700,0,81500
142015400100000,NW 310,RESIDENTIAL,21400,0,21400,74900,0,96300
142015400200000,NW 310,RESIDENTIAL,20700,0,20700,55900,0,76600
142015400300000,NW 310,RESIDENTIAL,24200,0,24200,56600,0,80800
142015400400000,NW 310,RESIDENTIAL,23900,0,23900,59000,0,82900
142015400500000,NW 310,RESIDENTIAL,30500,0,30500,80300,0,110800
142015400600000,NW 310,RESIDENTIAL,21700,0,21700,81100,0,102800
142015400700000,NW 310,RESIDENTIAL,22200,0,22200,77300,0,99500
142015400800000,NW 310,RESIDENTIAL,22800,0,22800,83900,0,106700
142015400900000,NW 310,RESIDENTIAL,24300,0,24300,68700,0,93000
142015401000000,NW 310,RESIDENTIAL,18000,0,18000,61900,0,79900
142015401100000,NW 310,RESIDENTIAL,27600,0,27600,87800,0,115400
142015401200000,NW 310,RESIDENTIAL,27200,0,27200,77000,0,104200
142015401300000,NW 310,RESIDENTIAL,18000,0,18000,91900,0,109900
142015401400000,NW 310,RESIDENTIAL,16700,0,16700,46100,0,62800
142015401500000,NW 310,RESIDENTIAL,19000,0,19000,76400,0,95400
142015401600000,NW 310,RESIDENTIAL,16700,0,16700,40500,0,57200
142015401700000,NW 310,RESIDENTIAL,16000,0,16000,45300,0,61300
142015401800000,NW 310,RESIDENTIAL,16700,0,16700,35000,0,51700
142015401900000,NW 310,RESIDENTIAL,16000,0,16000,50200,0,66200
142015402000000,NW 310,RESIDENTIAL,21800,0,21800,100300,0,122100
142015402100000,NW 310,RESIDENTIAL,20600,0,20600,71400,0,92000
142015402200000,NW 310,RESIDENTIAL,20600,0,20600,81500,0,102100
142015402300000,NW 310,RESIDENTIAL,20800,0,20800,81600,0,102400
142015402400000,NW 310,RESIDENTIAL,26400,0,26400,75800,0,102200
142015402500000,NW 310,RESIDENTIAL,25700,0,25700,75400,0,101100
142015402600000,NW 310,RESIDENTIAL,21800,0,21800,80300,0,102100
142015402700000,NW 310,RESIDENTIAL,22200,0,22200,86100,0,108300
142015500100000,NW 310,RESIDENTIAL,19400,0,19400,63100,0,82500
142015500200000,NW 310,RESIDENTIAL,19400,0,19400,65500,0,84900
142015500300000,NW 310,RESIDENTIAL,15400,0,15400,81500,0,96900
142015500400000,NW 310,RESIDENTIAL,15000,0,15000,88700,0,103700
142015500500000,NW 310,RESIDENTIAL,15000,0,15000,53400,0,68400
142015500600000,NW 310,RESIDENTIAL,15000,0,15000,50100,0,65100
142015500700000,NW 310,RESIDENTIAL,15000,0,15000,75500,0,90500
142015500800000,NW 310,RESIDENTIAL,15000,0,15000,58400,0,73400
142015500900000,NW 310,RESIDENTIAL,24700,0,24700,126400,0,151100
142015501000000,NW 310,RESIDENTIAL,19800,0,19800,83700,0,103500
142015501200000,NW 310,RESIDENTIAL,9800,0,9800,0,0,9800
142015501300000,NW 310,RESIDENTIAL,15800,0,15800,120700,0,136500
142015501400000,NW 310,RESIDENTIAL,15800,0,15800,80700,0,96500
142015502100000,NW 310,RESIDENTIAL,19800,0,19800,121600,0,141400
142015502200000,NW 310,RESIDENTIAL,19800,0,19800,124100,0,143900
142015502500000,NW 310,RESIDENTIAL,12400,0,12400,116100,0,128500
142015502600000,NW 310,RESIDENTIAL,7600,0,7600,117400,0,125000
142015502700000,NW 310,RESIDENTIAL,7600,0,7600,117800,0,125400
142015502800000,NW 310,RESIDENTIAL,7600,0,7600,115200,0,122800
142015502900000,NW 310,RESIDENTIAL,12400,0,12400,115900,0,128300
142015600100000,NW 310,RESIDENTIAL,19400,0,19400,129600,0,149000
142015600200000,NW 310,EXEMPT,0,17000,17000,0,0,17000
142015600300000,NW 310,EXEMPT,0,13500,13500,0,0,13500
142015600400000,CHURCH,EXEMPT,0,63000,63000,0,19400,82400
142015600500000,NW 310,RESIDENTIAL,17300,0,17300,87000,0,104300
142015600600000,NW 310,RESIDENTIAL,11300,0,11300,0,0,11300
142015600700000,NW 310,RESIDENTIAL,11300,0,11300,102500,0,113800
142015600800000,NW 310,RESIDENTIAL,17300,0,17300,85500,0,102800
142015600900000,NW 310,RESIDENTIAL,25300,0,25300,90200,0,115500
142015601000000,NW 310,RESIDENTIAL,15800,0,15800,112300,0,128100
142015601100000,NW 310,RESIDENTIAL,15800,0,15800,71600,0,87400
142015601200000,NW 310,RESIDENTIAL,15800,0,15800,68200,0,84000
142015601300000,NW 310,RESIDENTIAL,19800,0,19800,60100,0,79900
142015601400000,NW 310,RESIDENTIAL,15600,0,15600,58500,0,74100
142015601500000,NW 310,RESIDENTIAL,15600,0,15600,59000,0,74600
142015601600000,NW 310,RESIDENTIAL,15600,0,15600,99500,0,115100
142015601700000,NW 310,RESIDENTIAL,12500,0,12500,0,0,12500
142015601800000,NW 310,RESIDENTIAL,17300,0,17300,138600,0,155900
142015700100000,NW 310,RESIDENTIAL,17000,0,17000,122700,0,139700
142015700200000,NW 310,RESIDENTIAL,19400,0,19400,96500,0,115900
142015700300000,NW 310,RESIDENTIAL,11900,0,11900,65100,0,77000
142015700400000,NW 310,RESIDENTIAL,14700,0,14700,27600,0,42300
142015700500000,NW 310,RESIDENTIAL,19800,0,19800,45200,0,65000
142015700600000,NW 310,RESIDENTIAL,19800,0,19800,66100,0,85900
142015700700000,NW 310,RESIDENTIAL,19800,0,19800,69700,0,89500
142015700800000,NW 310,RESIDENTIAL,19800,0,19800,34500,0,54300
142015700900000,NW 310,RESIDENTIAL,19800,0,19800,84800,0,104600
142015701000000,NW 310,RESIDENTIAL,19800,0,19800,67400,0,87200
142015701100000,NW 310,RESIDENTIAL,19800,0,19800,94600,0,114400
142015701200000,NW 310,RESIDENTIAL,17300,0,17300,60100,0,77400
142015701300000,NW 310,RESIDENTIAL,17300,0,17300,115600,0,132900
142015701400000,NW 310,RESIDENTIAL,17300,0,17300,55200,0,72500
142015701500000,NW 310,RESIDENTIAL,17300,0,17300,80500,0,97800
142015701600000,NW 310,RESIDENTIAL,17300,0,17300,0,0,17300
142015701700000,NW 310,RESIDENTIAL,17300,0,17300,84300,0,101600
142015701800000,NW 310,RESIDENTIAL,17300,0,17300,78200,0,95500
142015701900000,NW 310,RESIDENTIAL,22100,0,22100,120300,0,142400
142015800100000,NW 310,RESIDENTIAL,19400,0,19400,65100,0,84500
142015800200000,NW 310,RESIDENTIAL,20000,0,20000,88000,0,108000
142015800300000,NW 310,RESIDENTIAL,29600,0,29600,84100,0,113700
142015800400000,NW 310,RESIDENTIAL,20400,0,20400,79300,0,99700
142015800500000,NW 310,RESIDENTIAL,20400,0,20400,79800,0,100200
142015800600000,NW 310,RESIDENTIAL,20400,0,20400,50400,0,70800
142015800700000,NW 310,RESIDENTIAL,20400,0,20400,54300,0,74700
142015800800000,NW 310,RESIDENTIAL,20400,0,20400,63300,0,83700
142015800900000,NW 310,RESIDENTIAL,20400,0,20400,72800,0,93200
142015801000000,NW 310,RESIDENTIAL,20400,0,20400,67500,0,87900
142015801100000,NW 310,RESIDENTIAL,19800,0,19800,53400,0,73200
142015801200000,NW 310,RESIDENTIAL,19800,0,19800,51800,0,71600
142015801300000,NW 310,RESIDENTIAL,19800,0,19800,63500,0,83300
142015801400000,NW 310,RESIDENTIAL,19800,0,19800,58300,0,78100
142015801500000,NW 310,RESIDENTIAL,19800,0,19800,54600,0,74400
142015801600000,NW 310,RESIDENTIAL,19800,0,19800,64300,0,84100
142015801700000,NW 310,RESIDENTIAL,19800,0,19800,59300,0,79100
142015801800000,NW 310,RESIDENTIAL,27500,0,27500,88000,0,115500
142017601700000,CITY PROPERTY,EXEMPT,0,0,0,0,0,0
142017601800000,CITY PROPERTY,EXEMPT,0,0,0,0,0,0
142017700400000,NW 310,RESIDENTIAL,25700,0,25700,54400,0,80100
142017701100000,NW 310,RESIDENTIAL,6900,0,6900,0,0,6900
142017701400000,CITY PROPERTY,EXEMPT,0,0,0,0,0,0
142017701500000,CITY PROPERTY,EXEMPT,0,0,0,0,0,0
142017701600000,CITY PROPERTY,EXEMPT,0,0,0,0,0,0
142017701700000,CITY PROPERTY,EXEMPT,0,0,0,0,0,0
142017800200000,CITY PROPERTY,EXEMPT,0,0,0,0,0,0
142017800300000,CITY PROPERTY,EXEMPT,0,0,0,0,0,0
142017800400000,CITY PROPERTY,EXEMPT,0,0,0,0,0,0
142017800500000,CITY PROPERTY,EXEMPT,0,0,0,0,0,0
142017800600000,CITY PROPERTY,EXEMPT,0,0,0,0,0,0
142017800700000,CITY PROPERTY,EXEMPT,0,0,0,0,0,0
142017800800000,CITY PROPERTY,EXEMPT,0,0,0,0,0,0
142017801500000,CITY PROPERTY,EXEMPT,0,0,0,0,0,0
142017900100000,CITY PROPERTY,EXEMPT,0,0,0,0,0,0
142017900200000,NW 310,RESIDENTIAL,17800,0,17800,0,0,17800
142017900300000,CITY PROPERTY,EXEMPT,0,0,0,0,0,0
142017900400000,CITY PROPERTY,EXEMPT,0,0,0,0,0,0
142017900500000,CITY PROPERTY,EXEMPT,0,0,0,0,0,0
142017900600000,CITY PROPERTY,EXEMPT,0,0,0,0,0,0
142017900700000,CITY PROPERTY,EXEMPT,0,0,0,0,0,0
142017900800000,CITY PROPERTY,EXEMPT,0,0,0,0,0,0
142017900900000,NW 310,RESIDENTIAL,13900,0,13900,89300,0,103200
142017901000000,CITY PROPERTY,EXEMPT,0,0,0,0,0,0
142017901100000,NW 310,RESIDENTIAL,19800,0,19800,0,0,19800
142017901200000,NW 310,RESIDENTIAL,19800,0,19800,0,0,19800
142017901300000,CITY PROPERTY,EXEMPT,0,0,0,0,0,0
142018001500000,CITY PROPERTY,EXEMPT,0,0,0,0,0,0
142018001600000,CITY PROPERTY,EXEMPT,0,0,0,0,0,0
142018101500000,CITY PROPERTY,EXEMPT,0,0,0,0,0,0
142018101600000,CITY PROPERTY,EXEMPT,0,0,0,0,0,0
142018200200000,CITY PROPERTY,EXEMPT,0,0,0,0,0,0
142018200300000,CITY PROPERTY,EXEMPT,0,0,0,0,0,0
142018200400000,NW 310,RESIDENTIAL,15800,0,15800,55200,0,71000
142018200500000,CITY PROPERTY,EXEMPT,0,0,0,0,0,0
142018200600000,NW 310,RESIDENTIAL,19800,0,19800,74400,0,94200
142018200700000,CITY PROPERTY,EXEMPT,0,0,0,0,0,0
142018200800000,CITY PROPERTY,EXEMPT,0,0,0,0,0,0
142018200900000,CITY PROPERTY,EXEMPT,0,0,0,0,0,0
142018201000000,NW 310,RESIDENTIAL,2800,0,2800,0,0,2800
142018201100000,NW 310,RESIDENTIAL,17000,0,17000,36100,0,53100
142018201200000,CITY PROPERTY,EXEMPT,0,0,0,0,0,0
142018201300000,NW 310,RESIDENTIAL,19800,0,19800,60000,0,79800
142018201400000,CITY PROPERTY,EXEMPT,0,0,0,0,0,0
142018201700000,CITY PROPERTY,EXEMPT,0,0,0,0,0,0
142018300100000,CITY PROPERTY,EXEMPT,0,0,0,0,0,0
142018300200000,CITY PROPERTY,EXEMPT,0,0,0,0,0,0
142018300300000,NW 310,RESIDENTIAL,19800,0,19800,51700,0,71500
142018300400000,CITY PROPERTY,EXEMPT,0,0,0,0,0,0
142018300500000,CITY PROPERTY,EXEMPT,0,0,0,0,0,0
142018300600000,NW 310,RESIDENTIAL,19800,0,19800,120200,0,140000
142018300700000,NW 310,RESIDENTIAL,19800,0,19800,60400,0,80200
142018300800000,NW 310,RESIDENTIAL,19800,0,19800,63000,0,82800
142018300900000,CENTRALLY ASSESSED,OTHER,0,0,0,0,0,0
142018301000000,CITY PROPERTY,EXEMPT,0,0,0,0,0,0
142018301100000,NW 310,RESIDENTIAL,19800,0,19800,54900,0,74700
142018301200000,NW 310,RESIDENTIAL,19800,0,19800,49800,0,69600
142018301300000,CITY PROPERTY,EXEMPT,0,0,0,0,0,0
142018301400000,NW 310,RESIDENTIAL,19800,0,19800,73200,0,93000
142018400200000,CITY PROPERTY,EXEMPT,0,0,0,0,0,0
142018400300000,CITY PROPERTY,EXEMPT,0,0,0,0,0,0
142018400400000,CITY PROPERTY,EXEMPT,0,0,0,0,0,0
142018400500000,CITY PROPERTY,EXEMPT,0,0,0,0,0,0
142018400600000,CITY PROPERTY,EXEMPT,0,0,0,0,0,0
142018400700000,CITY PROPERTY,EXEMPT,0,0,0,0,0,0
142018400800000,CITY PROPERTY,EXEMPT,0,0,0,0,0,0
142018400900000,CITY PROPERTY,EXEMPT,0,0,0,0,0,0
142018401000000,CITY PROPERTY,EXEMPT,0,0,0,0,0,0
142018401100000,CITY PROPERTY,EXEMPT,0,0,0,0,0,0
142018402000000,CITY PROPERTY,EXEMPT,0,0,0,0,0,0
142018500200000,CITY PROPERTY,EXEMPT,0,0,0,0,0,0
142018500300000,CITY PROPERTY,EXEMPT,0,0,0,0,0,0
142018500400000,CITY PROPERTY,EXEMPT,0,0,0,0,0,0
142018500500000,CITY PROPERTY,EXEMPT,0,0,0,0,0,0
142018500600000,CITY PROPERTY,EXEMPT,0,0,0,0,0,0
142018500700000,CITY PROPERTY,EXEMPT,0,0,0,0,0,0
142018500800000,CITY PROPERTY,EXEMPT,0,0,0,0,0,0
142018500900000,CITY PROPERTY,EXEMPT,0,0,0,0,0,0
142018501000000,CITY PROPERTY,EXEMPT,0,0,0,0,0,0
142018501100000,CITY PROPERTY,EXEMPT,0,0,0,0,0,0
142018501200000,NW 310,RESIDENTIAL,24300,0,24300,63600,0,87900
142018501600000,NW 310,RESIDENTIAL,17300,0,17300,45700,0,63000
142018501900000,CITY PROPERTY,EXEMPT,0,0,0,0,0,0
142018502000000,CITY PROPERTY,EXEMPT,0,0,0,0,0,0
142018600100000,NW 310,RESIDENTIAL,13800,0,13800,60200,0,74000
142018600200000,NW 310,RESIDENTIAL,13000,0,13000,45400,0,58400
142018600300000,NW 310,RESIDENTIAL,13000,0,13000,42300,0,55300
142018600400000,CITY PROPERTY,EXEMPT,0,0,0,0,0,0
142018600500000,CITY PROPERTY,EXEMPT,0,0,0,0,0,0
142018600600000,CITY PROPERTY,EXEMPT,0,0,0,0,0,0
142018600700000,NW 310,RESIDENTIAL,19800,0,19800,67100,0,86900
142018600800000,CITY PROPERTY,EXEMPT,0,0,0,0,0,0
142018600900000,CITY PROPERTY,EXEMPT,0,0,0,0,0,0
142018601000000,CITY PROPERTY,EXEMPT,0,0,0,0,0,0
142018601100000,NW 310,RESIDENTIAL,7900,0,7900,0,0,7900
142018601200000,CITY PROPERTY,EXEMPT,0,0,0,0,0,0
142018601300000,CITY PROPERTY,EXEMPT,0,0,0,0,0,0
142018601400000,NW 310,RESIDENTIAL,19800,0,19800,85200,0,105000
142018601500000,NW 310,RESIDENTIAL,19800,0,19800,69900,0,89700
142018601600000,CITY PROPERTY,EXEMPT,0,0,0,0,0,0
142018601700000,CITY PROPERTY,EXEMPT,0,0,0,0,0,0
142018601800000,NW 310,RESIDENTIAL,19800,0,19800,91700,0,111500
142018601900000,NW 310,RESIDENTIAL,19800,0,19800,98300,0,118100
142018602000000,CITY PROPERTY,EXEMPT,0,0,0,0,0,0
142018602100000,CITY PROPERTY,EXEMPT,0,0,0,0,0,0
142018700100000,CITY PROPERTY,EXEMPT,0,0,0,0,0,0
142018700200000,NW 310,RESIDENTIAL,5000,0,5000,0,0,5000
142018700300000,CITY PROPERTY,EXEMPT,0,0,0,0,0,0
142018700400000,NW 310,RESIDENTIAL,15800,0,15800,76000,0,91800
142018700500000,CITY PROPERTY,EXEMPT,0,0,0,0,0,0
142018700600000,CITY PROPERTY,EXEMPT,0,0,0,0,0,0
142018700700000,NW 310,RESIDENTIAL,5000,0,5000,0,0,5000
142018700800000,CITY PROPERTY,EXEMPT,0,0,0,0,0,0
142018700900000,NW 310,RESIDENTIAL,13200,0,13200,73300,0,86500
142018701000000,CITY PROPERTY,EXEMPT,0,0,0,0,0,0
142018701100000,NW 310,RESIDENTIAL,21800,0,21800,88300,0,110100
142018701200000,NW 310,RESIDENTIAL,19800,0,19800,64000,0,83800
142018701300000,CITY PROPERTY,EXEMPT,0,0,0,0,0,0
142018701400000,CITY PROPERTY,EXEMPT,0,0,0,0,0,0
142018701500000,CITY PROPERTY,EXEMPT,0,0,0,0,0,0
142018701600000,NW 310,RESIDENTIAL,15800,0,15800,57400,0,73200
142018701700000,CITY PROPERTY,EXEMPT,0,0,0,0,0,0
142018701800000,NW 310,RESIDENTIAL,9900,0,9900,0,0,9900
142018701900000,NW 310,RESIDENTIAL,19800,0,19800,47300,0,67100
142018702000000,NW 310,RESIDENTIAL,19800,0,19800,49178,0,68978
142018702100000,NW 310,RESIDENTIAL,19800,0,19800,0,0,19800
142020100100000,NW 304,RESIDENTIAL,28700,0,28700,58300,0,87000
142020100200000,NW 304,RESIDENTIAL,18900,0,18900,54800,0,73700
142020100300000,NW 304,RESIDENTIAL,16800,0,16800,81600,0,98400
142020100400000,NW 304,RESIDENTIAL,18200,0,18200,157400,0,175600
142020100500000,NW 304,RESIDENTIAL,18600,0,18600,68200,0,86800
142020100600000,NW 304,RESIDENTIAL,18900,0,18900,93300,0,112200
142020100700000,NW 304,RESIDENTIAL,18900,0,18900,60400,0,79300
142020100900000,NW 304,RESIDENTIAL,22400,0,22400,136800,0,159200
142020101000000,NW 304,RESIDENTIAL,22600,0,22600,75600,0,98200
142020101100000,NW 304,RESIDENTIAL,22600,0,22600,79800,0,102400
142020101200000,NW 304,RESIDENTIAL,22600,0,22600,77600,0,100200
142020101300000,NW 304,RESIDENTIAL,22400,0,22400,81400,0,103800
142020101400000,NW 304,RESIDENTIAL,22200,0,22200,49300,0,71500
142020101500000,NW 304,RESIDENTIAL,21900,0,21900,82800,0,104700
142020101600000,NW 304,RESIDENTIAL,21500,0,21500,61800,0,83300
142020101700000,NW 304,RESIDENTIAL,29600,0,29600,83100,0,112700
142020101800000,NW 304,RESIDENTIAL,20300,0,20300,59100,0,79400
142020101900000,NW 304,RESIDENTIAL,22900,0,22900,35100,0,58000
142020102000000,NW 304,RESIDENTIAL,27800,0,27800,116100,0,143900
142020102100000,NW 304,RESIDENTIAL,25000,0,25000,0,0,25000
142020200300000,NW 304,RESIDENTIAL,28200,0,28200,95500,0,123700
142020200400000,NW 304,RESIDENTIAL,15600,0,15600,75100,0,90700
142020200500000,NW 304,RESIDENTIAL,25800,0,25800,110400,0,136200
142020200600000,NW 304,RESIDENTIAL,29600,0,29600,138800,0,168400
142020200700000,NW 304,RESIDENTIAL,28200,0,28200,30700,0,58900
142020300100000,NW 304,RESIDENTIAL,68300,0,68300,56500,0,124800
142020300200000,NW 304,RESIDENTIAL,68300,0,68300,102100,0,170400
142020300300000,NW 304,RESIDENTIAL,54400,0,54400,52400,0,106800
142020300400000,NW 304,RESIDENTIAL,32100,0,32100,134200,0,166300
142020300500000,NW 304,RESIDENTIAL,54300,0,54300,77500,0,131800
142020300600000,NW 304,RESIDENTIAL,1800,0,1800,0,0,1800
142020300700000,NW 304,RESIDENTIAL,1800,0,1800,0,0,1800
142020300800000,NW 304,RESIDENTIAL,26900,0,26900,89400,0,116300
142020300900000,NW 304,RESIDENTIAL,26200,0,26200,87800,0,114000
142020301000000,NW 304,RESIDENTIAL,26200,0,26200,74400,0,100600
142020301100000,NW 304,RESIDENTIAL,30700,0,30700,82400,0,113100
142020301200000,NW 304,RESIDENTIAL,55700,0,55700,214400,0,270100
142020301300000,NW 304,RESIDENTIAL,22900,0,22900,18300,0,41200
142020400100000,NW 304,RESIDENTIAL,27000,0,27000,85500,0,112500
142020400200000,NW 304,RESIDENTIAL,27700,0,27700,140400,0,168100
142020400300000,NW 304,RESIDENTIAL,30500,0,30500,118100,0,148600
142020400400000,NW 304,RESIDENTIAL,18400,0,18400,90700,0,109100
142020400500000,NW 304,RESIDENTIAL,32200,0,32200,93400,0,125600
142020400600000,NW 304,RESIDENTIAL,200,0,200,0,0,200
142020400700000,NW 304,RESIDENTIAL,21700,0,21700,45300,0,67000
142020400800000,NW 304,RESIDENTIAL,21400,0,21400,86500,0,107900
142020400900000,NW 304,RESIDENTIAL,13000,0,13000,0,0,13000
142020401000000,NW 304,RESIDENTIAL,26200,0,26200,74300,0,100500
142020401100000,NW 304,RESIDENTIAL,25500,0,25500,100900,0,126400
142020401200000,NW 304,RESIDENTIAL,17500,0,17500,85300,0,102800
142020401300000,NW 304,RESIDENTIAL,17700,0,17700,92500,0,110200
142020401400000,NW 304,RESIDENTIAL,18200,0,18200,62700,0,80900
142020401500000,NW 304,RESIDENTIAL,19300,0,19300,54900,0,74200
142020401600000,NW 304,RESIDENTIAL,19300,0,19300,43700,0,63000
142020401700000,NW 304,RESIDENTIAL,23800,0,23800,95500,0,119300
142020401800000,NW 304,RESIDENTIAL,21200,0,21200,95600,0,116800
142020401900000,NW 304,RESIDENTIAL,21000,0,21000,117800,0,138800
142020402000000,NW 304,RESIDENTIAL,21400,0,21400,90900,0,112300
142020402100000,NW 304,RESIDENTIAL,18700,0,18700,97300,0,116000
142020402200000,NW 304,RESIDENTIAL,19800,0,19800,88000,0,107800
142020402500000,NW 304,RESIDENTIAL,27400,0,27400,116700,0,144100
142020402600000,NW 304,RESIDENTIAL,24900,0,24900,87400,0,112300
142020402700000,SECTION 42,COMMERCIAL,0,188800,188800,0,829000,1017800
142022600100000,NW 304,RESIDENTIAL,166000,0,166000,0,0,166000
142022600200000,NW 304,RESIDENTIAL,34000,0,34000,252800,0,286800
142022600300000,NW 304,RESIDENTIAL,38300,0,38300,200700,0,239000
142022600400000,NW 304,RESIDENTIAL,35400,0,35400,143000,0,178400
142022600500000,NW 304,RESIDENTIAL,57400,0,57400,156500,0,213900
142022700100000,NW 304,RESIDENTIAL,45400,0,45400,103300,0,148700
142022700200000,NW 304,RESIDENTIAL,51700,0,51700,143900,0,195600
142022700300000,NW 304,RESIDENTIAL,4500,0,4500,0,0,4500
142022700400000,NW 304,RESIDENTIAL,49000,0,49000,84100,0,133100
142022700500000,NW 304,RESIDENTIAL,39400,0,39400,91000,0,130400
142022700700000,NW 304,RESIDENTIAL,1100,0,1100,0,0,1100
142022700800000,NW 304,RESIDENTIAL,18500,0,18500,73900,0,92400
142022700900000,NW 304,RESIDENTIAL,20000,0,20000,0,0,20000
142022701000000,NW 304,RESIDENTIAL,18100,0,18100,111000,0,129100
142022701300000,NW 304,RESIDENTIAL,26700,0,26700,136600,0,163300
142022701400000,NW 304,RESIDENTIAL,40900,0,40900,89300,0,130200
142022701500000,NW 304,RESIDENTIAL,38600,0,38600,180700,0,219300
142022701600000,NW 304,RESIDENTIAL,36500,0,36500,193400,0,229900
142022701700000,NW 304,RESIDENTIAL,36500,0,36500,172000,0,208500
142022701800000,NW 304,RESIDENTIAL,37400,0,37400,135800,0,173200
142022701900000,NW 304,RESIDENTIAL,35000,0,35000,103600,0,138600
142022702000000,NW 304,RESIDENTIAL,34600,0,34600,139100,0,173700
142022702100000,NW 304,RESIDENTIAL,73200,0,73200,59500,0,132700
142022702200000,NW 304,RESIDENTIAL,40200,0,40200,69500,0,109700
142022702300000,NW 304,RESIDENTIAL,30100,0,30100,105800,0,135900
142022702400000,NW 304,RESIDENTIAL,41200,0,41200,91600,0,132800
142022702500000,NW 304,RESIDENTIAL,39100,0,39100,128300,0,167400
142025100300000,NW 304,RESIDENTIAL,19900,0,19900,78500,0,98400
142025100400000,NW 304,RESIDENTIAL,19300,0,19300,87400,0,106700
142025100500000,NW 304,RESIDENTIAL,19300,0,19300,94400,0,113700
142025100600000,NW 304,RESIDENTIAL,19500,0,19500,85300,0,104800
142025100700000,NW 304,RESIDENTIAL,19500,0,19500,82400,0,101900
142025200100000,NW 304,RESIDENTIAL,25400,0,25400,91400,0,116800
142025200200000,NW 304,RESIDENTIAL,21400,0,21400,105500,0,126900
142025200300000,NW 304,RESIDENTIAL,21400,0,21400,99900,0,121300
142025200400000,NW 304,RESIDENTIAL,21200,0,21200,101400,0,122600
142025200500000,NW 304,RESIDENTIAL,25300,0,25300,75800,0,101100
142025200600000,SR/NURSING/ASSTD LIV,EXEMPT,0,738200,738200,0,4388700,5126900
142025200800000,DAY CARE CENTER,EXEMPT,0,193600,193600,0,704900,898500
142025300100000,VACANT LAND,COMMERCIAL,0,2900,2900,0,0,2900
142027600100000,NW 304,RESIDENTIAL,29100,0,29100,78300,0,107400
142027600200000,NW 304,RESIDENTIAL,20400,0,20400,73700,0,94100
142027600300000,NW 304,RESIDENTIAL,20400,0,20400,71700,0,92100
142027600400000,NW 304,RESIDENTIAL,20400,0,20400,86800,0,107200
142027600500000,NW 304,RESIDENTIAL,20400,0,20400,116900,0,137300
142027600600000,NW 304,RESIDENTIAL,20400,0,20400,92100,0,112500
142027600700000,NW 304,RESIDENTIAL,20400,0,20400,119900,0,140300
142027600800000,NW 304,RESIDENTIAL,25200,0,25200,96800,0,122000
142027600900000,NW 304,RESIDENTIAL,28000,0,28000,106100,0,134100
142027601000000,NW 304,RESIDENTIAL,34900,0,34900,92900,0,127800
142027601100000,NW 304,RESIDENTIAL,37100,0,37100,133800,0,170900
142027601200000,NW 304,RESIDENTIAL,30700,0,30700,111700,0,142400
142027601300000,NW 304,RESIDENTIAL,26900,0,26900,102400,0,129300
142027601400000,NW 304,RESIDENTIAL,29900,0,29900,0,0,29900
142027601700000,NW 304,RESIDENTIAL,23100,0,23100,105200,0,128300
142027601800000,NW 304,RESIDENTIAL,23800,0,23800,86100,0,109900
142027601900000,NW 304,RESIDENTIAL,22100,0,22100,88200,0,110300
142027602000000,NW 304,RESIDENTIAL,22100,0,22100,78300,0,100400
142027602100000,NW 304,RESIDENTIAL,22100,0,22100,76900,0,99000
142027602200000,NW 304,RESIDENTIAL,22500,0,22500,84000,0,106500
142027602300000,NW 304,RESIDENTIAL,24300,0,24300,86400,0,110700
142027602400000,NW 304,RESIDENTIAL,24500,0,24500,81300,0,105800
142027602500000,NW 304,RESIDENTIAL,22800,0,22800,77100,0,99900
142027602600000,NW 304,RESIDENTIAL,23000,0,23000,79700,0,102700
142027602700000,NW 304,RESIDENTIAL,22400,0,22400,79700,0,102100
142027602800000,NW 304,RESIDENTIAL,23400,0,23400,77400,0,100800
142027602900000,NW 304,RESIDENTIAL,27400,0,27400,73000,0,100400
142027603000000,NW 304,RESIDENTIAL,26800,0,26800,140100,0,166900
142027603100000,NW 304,RESIDENTIAL,24100,0,24100,75300,0,99400
142027603200000,NW 304,RESIDENTIAL,21400,0,21400,83200,0,104600
142027603300000,NW 304,RESIDENTIAL,21400,0,21400,82000,0,103400
142027603400000,NW 304,RESIDENTIAL,21400,0,21400,92800,0,114200
142027603500000,NW 304,RESIDENTIAL,21400,0,21400,69600,0,91000
142027603600000,NW 304,RESIDENTIAL,21400,0,21400,85500,0,106900
142027603700000,NW 304,RESIDENTIAL,21400,0,21400,84800,0,106200
142027603800000,NW 304,RESIDENTIAL,22100,0,22100,82300,0,104400
142027700100000,CITY PROPERTY,EXEMPT,0,0,0,0,0,0
142027700200000,NW 304,RESIDENTIAL,22100,0,22100,84900,0,107000
142027700300000,NW 304,RESIDENTIAL,22100,0,22100,92300,0,114400
142027700400000,NW 304,RESIDENTIAL,26800,0,26800,100800,0,127600
142027700500000,CITY PROPERTY,EXEMPT,0,0,0,0,0,0
142027700600000,SCHOOL,EXEMPT,0,0,0,0,0,0
142027700700000,NW 304,RESIDENTIAL,25000,0,25000,117600,0,142600
142027700800000,NW 304,RESIDENTIAL,19500,0,19500,0,0,19500
142027700900000,NW 304,RESIDENTIAL,25500,0,25500,117000,0,142500
142027701000000,NW 304,RESIDENTIAL,25000,0,25000,115600,0,140600
142027701100000,NW 304,RESIDENTIAL,22000,0,22000,89300,0,111300
142027701200000,NW 304,RESIDENTIAL,21300,0,21300,77500,0,98800
142027701300000,NW 304,RESIDENTIAL,21700,0,21700,94000,0,115700
142027701400000,NW 304,RESIDENTIAL,21700,0,21700,82000,0,103700
142027701500000,NW 304,RESIDENTIAL,21700,0,21700,84800,0,106500
142027701600000,NW 304,RESIDENTIAL,21400,0,21400,84500,0,105900
142027800100000,SCHOOL,EXEMPT,0,0,0,0,0,0
142027800200000,SCHOOL,EXEMPT,0,0,0,0,0,0
142027800400000,SCHOOL,EXEMPT,0,0,0,0,0,0
142027800500000,APARTMENT,RESIDENTIAL,889000,0,889000,12189100,0,13078100
142030100100000,NW 311,RESIDENTIAL,16000,0,16000,57700,0,73700
142030100200000,NW 311,RESIDENTIAL,21000,0,21000,87100,0,108100
142030100300000,NW 311,RESIDENTIAL,19900,0,19900,67700,0,87600
142030100400000,NW 311,RESIDENTIAL,19900,0,19900,75500,0,95400
142030100500000,NW 311,RESIDENTIAL,19900,0,19900,55000,0,74900
142030100600000,NW 311,RESIDENTIAL,19900,0,19900,54400,0,74300
142030100700000,NW 311,RESIDENTIAL,19900,0,19900,55700,0,75600
142030100800000,NW 311,RESIDENTIAL,19900,0,19900,60800,0,80700
142030100900000,NW 311,RESIDENTIAL,19900,0,19900,53800,0,73700
142030101000000,NW 311,RESIDENTIAL,20800,0,20800,73900,0,94700
142030101100000,NW 311,RESIDENTIAL,25900,0,25900,70500,0,96400
142030101200000,NW 311,RESIDENTIAL,20800,0,20800,82800,0,103600
142030101300000,NW 311,RESIDENTIAL,16000,0,16000,79400,0,95400
142030101400000,NW 311,RESIDENTIAL,27200,0,27200,84600,0,111800
142030101500000,NW 311,RESIDENTIAL,16000,0,16000,72200,0,88200
142030101600000,NW 311,RESIDENTIAL,16000,0,16000,58000,0,74000
142030101700000,NW 311,RESIDENTIAL,16000,0,16000,53600,0,69600
142030101800000,NW 311,RESIDENTIAL,16000,0,16000,62700,0,78700
142030101900000,NW 311,RESIDENTIAL,16000,0,16000,62100,0,78100
142030200300000,NW 312,RESIDENTIAL,21600,0,21600,80600,0,102200
142030200400000,NW 312,RESIDENTIAL,25600,0,25600,97600,0,123200
142030200500000,NW 312,RESIDENTIAL,29400,0,29400,98100,0,127500
142030200600000,NW 312,RESIDENTIAL,30200,0,30200,110300,0,140500
142030200700000,NW 312,RESIDENTIAL,30400,0,30400,91400,0,121800
142030200800000,NW 312,RESIDENTIAL,26200,0,26200,84600,0,110800
142030200900000,NW 312,RESIDENTIAL,26200,0,26200,108600,0,134800
142030201000000,NW 312,RESIDENTIAL,24800,0,24800,94000,0,118800
142030201100000,NW 312,RESIDENTIAL,27600,0,27600,86000,0,113600
142030201200000,NW 312,RESIDENTIAL,26200,0,26200,97200,0,123400
142030201300000,NW 312,RESIDENTIAL,26200,0,26200,103900,0,130100
142030201400000,NW 312,RESIDENTIAL,28100,0,28100,92700,0,120800
142030201500000,NW 312,RESIDENTIAL,28100,0,28100,102600,0,130700
142030201600000,NW 312,RESIDENTIAL,28100,0,28100,97200,0,125300
142030201700000,NW 311,RESIDENTIAL,33900,0,33900,98100,0,132000
142030201800000,NW 311,RESIDENTIAL,33900,0,33900,101300,0,135200
142030201900000,NW 311,RESIDENTIAL,32400,0,32400,76700,0,109100
142030202000000,NW 311,RESIDENTIAL,27600,0,27600,69200,0,96800
142030202100000,NW 311,RESIDENTIAL,33100,0,33100,123000,0,156100
142030202200000,NW 311,RESIDENTIAL,27600,0,27600,91300,0,118900
142030202300000,NW 311,RESIDENTIAL,27600,0,27600,70600,0,98200
142030202400000,NW 311,RESIDENTIAL,24800,0,24800,118200,0,143000
142030202500000,NW 311,RESIDENTIAL,24800,0,24800,114100,0,138900
142030203300000,NW 311,RESIDENTIAL,24800,0,24800,116100,0,140900
142030203400000,NW 311,RESIDENTIAL,25300,0,25300,114100,0,139400
142030203700000,SR/NURSING/ASSTD LIV,EXEMPT,0,153600,153600,0,1750600,1904200
142030300100000,NW 311,RESIDENTIAL,16500,0,16500,55700,0,72200
142030300200000,NW 311,RESIDENTIAL,16300,0,16300,52000,0,68300
142030300300000,NW 311,RESIDENTIAL,16300,0,16300,42700,0,59000
142030300400000,NW 311,RESIDENTIAL,16300,0,16300,81700,0,98000
142030300500000,NW 311,RESIDENTIAL,16300,0,16300,57400,0,73700
142030300600000,NW 311,RESIDENTIAL,16300,0,16300,62700,0,79000
142030300700000,NW 311,RESIDENTIAL,16300,0,16300,56200,0,72500
142030300800000,NW 311,RESIDENTIAL,16300,0,16300,56300,0,72600
142030300900000,NW 311,RESIDENTIAL,16500,0,16500,34400,0,50900
142030301000000,NW 311,RESIDENTIAL,16500,0,16500,76300,0,92800
142030301100000,NW 311,RESIDENTIAL,16500,0,16500,62300,0,78800
142030301200000,NW 311,RESIDENTIAL,16500,0,16500,61000,0,77500
142030301300000,NW 311,RESIDENTIAL,16500,0,16500,79500,0,96000
142030301400000,NW 311,RESIDENTIAL,16500,0,16500,61900,0,78400
142030301500000,NW 311,RESIDENTIAL,16100,0,16100,44500,0,60600
142030301600000,NW 311,RESIDENTIAL,16300,0,16300,53600,0,69900
142030301700000,NW 311,RESIDENTIAL,16300,0,16300,66200,0,82500
142030301800000,NW 311,RESIDENTIAL,16300,0,16300,49200,0,65500
142030301900000,NW 311,RESIDENTIAL,16300,0,16300,63100,0,79400
142030302000000,NW 311,RESIDENTIAL,16300,0,16300,80800,0,97100
142030302100000,NW 311,RESIDENTIAL,16300,0,16300,64200,0,80500
142030302200000,NW 311,RESIDENTIAL,16300,0,16300,73900,0,90200
142030302300000,NW 311,RESIDENTIAL,16300,0,16300,62800,0,79100
142030302400000,NW 311,RESIDENTIAL,16300,0,16300,44200,0,60500
142030302500000,NW 311,RESIDENTIAL,16300,0,16300,46900,0,63200
142030302600000,NW 311,RESIDENTIAL,16300,0,16300,53000,0,69300
142030302700000,NW 311,RESIDENTIAL,16300,0,16300,54000,0,70300
142030302800000,NW 311,RESIDENTIAL,16300,0,16300,62200,0,78500
142030302900000,NW 311,RESIDENTIAL,16800,0,16800,53100,0,69900
142030303000000,NW 311,RESIDENTIAL,12200,0,12200,49500,0,61700
142030303100000,NW 311,RESIDENTIAL,12200,0,12200,73200,0,85400
142030400100000,NW 312,RESIDENTIAL,25100,0,25100,93100,0,118200
142030400200000,NW 312,RESIDENTIAL,21800,0,21800,103000,0,124800
142030400300000,NW 312,RESIDENTIAL,23800,0,23800,89400,0,113200
142030400400000,NW 312,RESIDENTIAL,23800,0,23800,83700,0,107500
142030500100000,NW 311,RESIDENTIAL,16500,0,16500,80300,0,96800
142030500200000,NW 311,RESIDENTIAL,16500,0,16500,67400,0,83900
142030500300000,NW 311,RESIDENTIAL,16500,0,16500,67700,0,84200
142030500400000,NW 311,RESIDENTIAL,16500,0,16500,73900,0,90400
142030500500000,NW 311,RESIDENTIAL,16300,0,16300,58700,0,75000
142030500600000,NW 310,RESIDENTIAL,16600,0,16600,118000,0,134600
142030500700000,NW 311,RESIDENTIAL,16300,0,16300,38000,0,54300
142030500800000,NW 311,RESIDENTIAL,16300,0,16300,69700,0,86000
142030500900000,NW 311,RESIDENTIAL,19600,0,19600,70100,0,89700
142030501000000,NW 311,RESIDENTIAL,19600,0,19600,94500,0,114100
142030501100000,NW 311,RESIDENTIAL,16300,0,16300,65800,0,82100
142030501200000,NW 311,RESIDENTIAL,16200,0,16200,81100,0,97300
142030501300000,NW 311,RESIDENTIAL,21000,0,21000,67000,0,88000
142030501400000,NW 311,RESIDENTIAL,19900,0,19900,72700,0,92600
142030501500000,NW 311,RESIDENTIAL,19800,0,19800,73300,0,93100
142030501600000,NW 311,RESIDENTIAL,19600,0,19600,55200,0,74800
142030501700000,NW 311,RESIDENTIAL,14600,0,14600,61600,0,76200
142030501800000,NW 311,RESIDENTIAL,14600,0,14600,44500,0,59100
142030501900000,NW 311,RESIDENTIAL,14600,0,14600,106700,0,121300
142030502000000,NW 311,RESIDENTIAL,14600,0,14600,44000,0,58600
142030502100000,NW 311,RESIDENTIAL,14600,0,14600,57600,0,72200
142030502200000,NW 311,RESIDENTIAL,14600,0,14600,52400,0,67000
142030502300000,NW 311,RESIDENTIAL,14600,0,14600,96100,0,110700
142030502400000,NW 311,RESIDENTIAL,14600,0,14600,57700,0,72300
142030502500000,NW 311,RESIDENTIAL,14600,0,14600,85600,0,100200
142030502600000,NW 311,RESIDENTIAL,14600,0,14600,54200,0,68800
142030502700000,NW 311,RESIDENTIAL,21500,0,21500,67400,0,88900
142030502800000,NW 311,RESIDENTIAL,21000,0,21000,65900,0,86900
142030600100000,NW 312,RESIDENTIAL,25100,0,25100,105800,0,130900
142030600200000,NW 312,RESIDENTIAL,21200,0,21200,83900,0,105100
142030600300000,NW 312,RESIDENTIAL,22200,0,22200,83700,0,105900
142030600400000,NW 312,RESIDENTIAL,21400,0,21400,107900,0,129300
142030600500000,NW 312,RESIDENTIAL,20800,0,20800,95900,0,116700
142032600100000,NW 312,RESIDENTIAL,24400,0,24400,69900,0,94300
142032600200000,NW 312,RESIDENTIAL,26500,0,26500,119000,0,145500
142032600300000,NW 312,RESIDENTIAL,29400,0,29400,117800,0,147200
142032600400000,NW 312,RESIDENTIAL,25300,0,25300,78200,0,103500
142032600500000,NW 312,RESIDENTIAL,25000,0,25000,94600,0,119600
142032600600000,NW 312,RESIDENTIAL,27100,0,27100,97300,0,124400
142032600700000,NW 312,RESIDENTIAL,25700,0,25700,90600,0,116300
142032600800000,NW 312,RESIDENTIAL,24000,0,24000,104000,0,128000
142032600900000,NW 312,RESIDENTIAL,32400,0,32400,122900,0,155300
142032601000000,NW 312,RESIDENTIAL,24100,0,24100,104700,0,128800
142032601100000,NW 312,RESIDENTIAL,24000,0,24000,84600,0,108600
142032601200000,NW 312,RESIDENTIAL,24000,0,24000,90100,0,114100
142032601300000,NW 312,RESIDENTIAL,24000,0,24000,98500,0,122500
142032601400000,NW 312,RESIDENTIAL,24800,0,24800,88700,0,113500
142032700100000,NW 312,RESIDENTIAL,63600,0,63600,117300,0,180900
142032700200000,NW 312,RESIDENTIAL,31700,0,31700,100000,0,131700
142032700300000,NW 312,RESIDENTIAL,27900,0,27900,95500,0,123400
142032700400000,NW 312,RESIDENTIAL,25200,0,25200,106200,0,131400
142032700500000,NW 312,RESIDENTIAL,27700,0,27700,102000,0,129700
142032700600000,NW 312,RESIDENTIAL,28800,0,28800,94900,0,123700
142032700700000,NW 312,RESIDENTIAL,29800,0,29800,92900,0,122700
142032700800000,NW 312,RESIDENTIAL,27200,0,27200,106200,0,133400
142032701000000,NW 312,RESIDENTIAL,26700,0,26700,102900,0,129600
142032701100000,NW 312,RESIDENTIAL,26700,0,26700,109500,0,136200
142032701200000,NW 312,RESIDENTIAL,28100,0,28100,98300,0,126400
142032701300000,NW 312,RESIDENTIAL,28700,0,28700,95200,0,123900
142032702100000,NW 312,RESIDENTIAL,23500,0,23500,99800,0,123300
142032800100000,NW 312,RESIDENTIAL,23800,0,23800,103900,0,127700
142032800200000,NW 312,RESIDENTIAL,24000,0,24000,103000,0,127000
142032800300000,NW 312,RESIDENTIAL,24000,0,24000,96000,0,120000
142032800400000,NW 312,RESIDENTIAL,24000,0,24000,112200,0,136200
142032800500000,NW 312,RESIDENTIAL,24000,0,24000,78700,0,102700
142032800600000,NW 312,RESIDENTIAL,24000,0,24000,73500,0,97500
142032800700000,NW 312,RESIDENTIAL,24000,0,24000,84800,0,108800
142032800800000,NW 312,RESIDENTIAL,24000,0,24000,99500,0,123500
142032800900000,NW 312,RESIDENTIAL,24000,0,24000,89000,0,113000
142032801000000,NW 312,RESIDENTIAL,24000,0,24000,83100,0,107100
142032801100000,NW 312,RESIDENTIAL,24000,0,24000,95200,0,119200
142032801200000,NW 312,RESIDENTIAL,24000,0,24000,98900,0,122900
142032801300000,NW 312,RESIDENTIAL,24000,0,24000,86900,0,110900
142032801400000,NW 312,RESIDENTIAL,24000,0,24000,101300,0,125300
142032801500000,NW 312,RESIDENTIAL,25600,0,25600,97700,0,123300
142032801600000,NW 312,RESIDENTIAL,25600,0,25600,82500,0,108100
142032801700000,NW 312,RESIDENTIAL,25600,0,25600,56100,0,81700
142032801800000,NW 312,RESIDENTIAL,25600,0,25600,102200,0,127800
142032801900000,NW 312,RESIDENTIAL,25600,0,25600,102500,0,128100
142032802000000,NW 312,RESIDENTIAL,28000,0,28000,104500,0,132500
142032802100000,NW 312,RESIDENTIAL,28000,0,28000,119700,0,147700
142032900100000,NW 312,RESIDENTIAL,25700,0,25700,105400,0,131100
142032900200000,NW 312,RESIDENTIAL,26500,0,26500,98500,0,125000
142032900300000,NW 312,RESIDENTIAL,26500,0,26500,110800,0,137300
142032900400000,NW 312,RESIDENTIAL,26500,0,26500,81500,0,108000
142032900500000,NW 312,RESIDENTIAL,29000,0,29000,93600,0,122600
142032900600000,NW 312,RESIDENTIAL,28400,0,28400,87200,0,115600
142032900700000,NW 312,RESIDENTIAL,26800,0,26800,80300,0,107100
142032900800000,NW 312,RESIDENTIAL,28500,0,28500,96100,0,124600
142032900900000,NW 312,RESIDENTIAL,29700,0,29700,75200,0,104900
142032901000000,NW 312,RESIDENTIAL,29400,0,29400,86000,0,115400
142032901100000,NW 312,RESIDENTIAL,29400,0,29400,67300,0,96700
142032901200000,NW 312,RESIDENTIAL,31300,0,31300,90200,0,121500
142033000100000,NW 312,RESIDENTIAL,25500,0,25500,100600,0,126100
142033000200000,NW 312,RESIDENTIAL,29200,0,29200,87500,0,116700
142033000300000,NW 312,RESIDENTIAL,27400,0,27400,97600,0,125000
142033000400000,NW 312,RESIDENTIAL,26200,0,26200,66400,0,92600
142033000500000,NW 312,RESIDENTIAL,26400,0,26400,121000,0,147400
142033000600000,NW 312,RESIDENTIAL,29400,0,29400,73600,0,103000
142033000700000,NW 312,RESIDENTIAL,28300,0,28300,89300,0,117600
142033000800000,NW 312,RESIDENTIAL,28000,0,28000,89800,0,117800
142033000900000,NW 312,RESIDENTIAL,28000,0,28000,88900,0,116900
142033001000000,NW 312,RESIDENTIAL,28000,0,28000,91000,0,119000
142033001100000,NW 312,RESIDENTIAL,27700,0,27700,88200,0,115900
142033001200000,NW 312,RESIDENTIAL,27700,0,27700,100000,0,127700
142033001300000,NW 312,RESIDENTIAL,27200,0,27200,99900,0,127100
142033001400000,NW 312,RESIDENTIAL,30700,0,30700,90100,0,120800
142033001500000,NW 312,RESIDENTIAL,29200,0,29200,103000,0,132200
142033001600000,NW 312,RESIDENTIAL,25600,0,25600,93000,0,118600
142033001700000,NW 312,RESIDENTIAL,25600,0,25600,104600,0,130200
142033001800000,NW 312,RESIDENTIAL,25300,0,25300,94700,0,120000
142033001900000,NW 312,RESIDENTIAL,29200,0,29200,101500,0,130700
142033002000000,NW 312,RESIDENTIAL,30400,0,30400,88900,0,119300
142033002100000,NW 312,RESIDENTIAL,29300,0,29300,90700,0,120000
142033002200000,NW 312,RESIDENTIAL,30800,0,30800,103500,0,134300
142033002300000,NW 312,RESIDENTIAL,29400,0,29400,98900,0,128300
142033002400000,NW 312,RESIDENTIAL,26000,0,26000,95800,0,121800
142033002500000,NW 312,RESIDENTIAL,27700,0,27700,109100,0,136800
142033002600000,NW 312,RESIDENTIAL,28900,0,28900,70200,0,99100
142033002700000,NW 312,RESIDENTIAL,29100,0,29100,102500,0,131600
142033002800000,NW 312,RESIDENTIAL,27100,0,27100,104200,0,131300
142033002900000,NW 312,RESIDENTIAL,26400,0,26400,104800,0,131200
142033003000000,NW 312,RESIDENTIAL,28700,0,28700,85100,0,113800
142033100100000,NW 312,RESIDENTIAL,30400,0,30400,67800,0,98200
142033100200000,NW 312,RESIDENTIAL,29800,0,29800,100400,0,130200
142033100300000,NW 312,RESIDENTIAL,22100,0,22100,80700,0,102800
142033100400000,NW 312,RESIDENTIAL,23300,0,23300,81300,0,104600
142033100500000,NW 312,RESIDENTIAL,23300,0,23300,101800,0,125100
142033100600000,NW 312,RESIDENTIAL,23300,0,23300,84900,0,108200
142033100700000,NW 312,RESIDENTIAL,23300,0,23300,81300,0,104600
142033100800000,NW 312,RESIDENTIAL,23300,0,23300,86300,0,109600
142033100900000,NW 312,RESIDENTIAL,23300,0,23300,83100,0,106400
142033101000000,NW 312,RESIDENTIAL,23300,0,23300,85800,0,109100
142033101100000,NW 312,RESIDENTIAL,23300,0,23300,78800,0,102100
142033101200000,NW 312,RESIDENTIAL,23300,0,23300,95800,0,119100
142033101300000,NW 312,RESIDENTIAL,24800,0,24800,94300,0,119100
142033101400000,NW 312,RESIDENTIAL,24800,0,24800,70000,0,94800
142033101500000,NW 312,RESIDENTIAL,24800,0,24800,87100,0,111900
142033101600000,NW 312,RESIDENTIAL,24800,0,24800,68100,0,92900
142033101700000,NW 312,RESIDENTIAL,24800,0,24800,81900,0,106700
142033101800000,NW 312,RESIDENTIAL,27200,0,27200,95200,0,122400
142033101900000,NW 312,RESIDENTIAL,27200,0,27200,90000,0,117200
142033102000000,NW 312,RESIDENTIAL,28000,0,28000,73400,0,101400
142033102100000,NW 312,RESIDENTIAL,28200,0,28200,85300,0,113500
142033102200000,NW 312,RESIDENTIAL,27200,0,27200,69000,0,96200
142033102300000,NW 312,RESIDENTIAL,27200,0,27200,88300,0,115500
142033102400000,NW 312,RESIDENTIAL,27200,0,27200,81900,0,109100
142033102500000,NW 312,RESIDENTIAL,27200,0,27200,82000,0,109200
142033102600000,NW 312,RESIDENTIAL,24400,0,24400,113200,0,137600
142033102700000,NW 312,RESIDENTIAL,24400,0,24400,94600,0,119000
142033102800000,NW 312,RESIDENTIAL,23300,0,23300,99500,0,122800
142033102900000,NW 312,RESIDENTIAL,23300,0,23300,86000,0,109300
142033103000000,NW 312,RESIDENTIAL,23300,0,23300,92200,0,115500
142033103100000,NW 312,RESIDENTIAL,23300,0,23300,83100,0,106400
142033103200000,NW 312,RESIDENTIAL,21600,0,21600,109600,0,131200
142033200100000,NW 312,RESIDENTIAL,29700,0,29700,97800,0,127500
142033200200000,NW 312,RESIDENTIAL,31000,0,31000,83600,0,114600
142033200300000,NW 312,RESIDENTIAL,28200,0,28200,95600,0,123800
142033200400000,NW 312,RESIDENTIAL,29400,0,29400,84900,0,114300
142033200500000,NW 312,RESIDENTIAL,29600,0,29600,96500,0,126100
142033200600000,NW 312,RESIDENTIAL,28700,0,28700,111700,0,140400
142033200700000,NW 312,RESIDENTIAL,25200,0,25200,73100,0,98300
142033200800000,NW 312,RESIDENTIAL,25400,0,25400,93500,0,118900
142033200900000,NW 312,RESIDENTIAL,25900,0,25900,102100,0,128000
142033201000000,NW 312,RESIDENTIAL,29200,0,29200,124100,0,153300
142035100100000,APARTMENT,MULTI-RES,190900,0,190900,1268000,0,1458900
142035100200000,NW 312,RESIDENTIAL,29200,0,29200,92100,0,121300
142035100300000,NW 312,RESIDENTIAL,24000,0,24000,85700,0,109700
142035100400000,NW 312,RESIDENTIAL,24000,0,24000,73300,0,97300
142035100500000,NW 312,RESIDENTIAL,24000,0,24000,110100,0,134100
142035100600000,NW 312,RESIDENTIAL,24000,0,24000,99900,0,123900
142035100700000,NW 312,RESIDENTIAL,24000,0,24000,87900,0,111900
142035100800000,NW 312,RESIDENTIAL,25300,0,25300,89900,0,115200
142035100900000,NW 312,RESIDENTIAL,25600,0,25600,80600,0,106200
142035101800000,APARTMENT,MULTI-RES,181600,0,181600,1321400,0,1503000
142035101900000,NW 312,RESIDENTIAL,26600,0,26600,119800,0,146400
142035102000000,NW 312,RESIDENTIAL,20200,0,20200,89400,0,109600
142035102100000,NW 312,RESIDENTIAL,23800,0,23800,72200,0,96000
142035102200000,NW 312,RESIDENTIAL,17600,0,17600,155200,0,172800
142035102300000,NW 312,RESIDENTIAL,23800,0,23800,99000,0,122800
142035102400000,NW 312,RESIDENTIAL,23800,0,23800,91300,0,115100
142035102500000,NW 312,RESIDENTIAL,23800,0,23800,111800,0,135600
142035102600000,NW 312,RESIDENTIAL,31000,0,31000,117000,0,148000
142035102700000,NW 312,RESIDENTIAL,500,0,500,0,0,500
142035102800000,NW 312,RESIDENTIAL,28200,0,28200,111900,0,140100
142035102900000,NW 312,RESIDENTIAL,19200,0,19200,112500,0,131700
142035103000000,NW 312,RESIDENTIAL,900,0,900,0,0,900
142035103100000,NW 312,RESIDENTIAL,51200,0,51200,230000,0,281200
142035200100000,NW 312,RESIDENTIAL,28600,0,28600,95300,0,123900
142035200200000,NW 312,RESIDENTIAL,27700,0,27700,69500,0,97200
142035200300000,NW 312,RESIDENTIAL,28300,0,28300,67200,0,95500
142035200400000,NW 312,RESIDENTIAL,28600,0,28600,86700,0,115300
142035200500000,NW 312,RESIDENTIAL,28600,0,28600,104200,0,132800
142035200600000,NW 312,RESIDENTIAL,28700,0,28700,65600,0,94300
142035200700000,NW 312,RESIDENTIAL,29400,0,29400,90100,0,119500
142035200800000,NW 312,RESIDENTIAL,26100,0,26100,105400,0,131500
142035200900000,NW 312,RESIDENTIAL,25400,0,25400,87700,0,113100
142035201000000,NW 312,RESIDENTIAL,23300,0,23300,84200,0,107500
142035201100000,NW 312,RESIDENTIAL,23400,0,23400,86800,0,110200
142035201200000,NW 312,RESIDENTIAL,24800,0,24800,75000,0,99800
142035201300000,NW 312,RESIDENTIAL,28300,0,28300,93800,0,122100
142035201400000,NW 312,RESIDENTIAL,28300,0,28300,73500,0,101800
142035201500000,NW 312,RESIDENTIAL,28300,0,28300,86100,0,114400
142035201600000,NW 312,RESIDENTIAL,29500,0,29500,90200,0,119700
142035300100000,NW 312,RESIDENTIAL,28000,0,28000,99300,0,127300
142035300200000,NW 312,RESIDENTIAL,28000,0,28000,78500,0,106500
142035300300000,NW 312,RESIDENTIAL,28000,0,28000,91500,0,119500
142035300400000,NW 312,RESIDENTIAL,28000,0,28000,70000,0,98000
142035300500000,NW 312,RESIDENTIAL,28500,0,28500,91500,0,120000
142035300600000,NW 312,RESIDENTIAL,29700,0,29700,61700,0,91400
142035400100000,APARTMENT,MULTI-RES,17000,0,17000,93400,0,110400
142035400200000,NW 312,RESIDENTIAL,19000,0,19000,83300,0,102300
142035400300000,NW 312,RESIDENTIAL,20900,0,20900,108600,0,129500
142035501000000,NW 312,RESIDENTIAL,29300,0,29300,105500,0,134800
142035501100000,NW 312,RESIDENTIAL,23000,0,23000,69100,0,92100
142035501200000,NW 312,RESIDENTIAL,23000,0,23000,79600,0,102600
142035501300000,NW 312,RESIDENTIAL,23000,0,23000,86100,0,109100
142035501400000,NW 312,RESIDENTIAL,29100,0,29100,87400,0,116500
142035501500000,NW 312,RESIDENTIAL,29400,0,29400,93200,0,122600
142035501600000,NW 312,RESIDENTIAL,25600,0,25600,89300,0,114900
142035501700000,NW 312,RESIDENTIAL,26000,0,26000,103300,0,129300
142035600100000,NW 312,RESIDENTIAL,200,0,200,0,0,200
142035700100000,APARTMENT,RESIDENTIAL,38000,0,38000,467100,0,505100
142035700200000,APARTMENT,RESIDENTIAL,36300,0,36300,383000,0,419300
142035700300000,CITY PROPERTY,EXEMPT,0,0,0,0,0,0
142035700400000,NW 322,RESIDENTIAL,26700,0,26700,96300,0,123000
142035700500000,CITY PROPERTY,EXEMPT,0,0,0,0,0,0
142035700600000,NW 322,RESIDENTIAL,40800,0,40800,127100,0,167900
142035700700000,NW 322,RESIDENTIAL,30600,0,30600,78600,0,109200
142035700800000,NW 322,RESIDENTIAL,24700,0,24700,96900,0,121600
142035700900000,NW 322,RESIDENTIAL,23500,0,23500,88900,0,112400
142035701000000,NW 322,RESIDENTIAL,23300,0,23300,86900,0,110200
142035701100000,NW 322,RESIDENTIAL,29600,0,29600,108100,0,137700
142035701200000,NW 322,RESIDENTIAL,30700,0,30700,93700,0,124400
142035701300000,NW 322,RESIDENTIAL,28800,0,28800,87400,0,116200
142035701400000,NW 322,RESIDENTIAL,28500,0,28500,97200,0,125700
142035701500000,NW 322,RESIDENTIAL,24500,0,24500,92800,0,117300
142035701600000,NW 322,RESIDENTIAL,24400,0,24400,69500,0,93900
142035701700000,NW 322,RESIDENTIAL,26500,0,26500,75800,0,102300
142035701800000,NW 322,RESIDENTIAL,25900,0,25900,79600,0,105500
142035701900000,NW 322,RESIDENTIAL,26200,0,26200,56100,0,82300
142035702000000,NW 322,RESIDENTIAL,26400,0,26400,82100,0,108500
142035800100000,NW 322,RESIDENTIAL,22100,0,22100,71700,0,93800
142035800200000,NW 322,RESIDENTIAL,22600,0,22600,78300,0,100900
142035800300000,NW 322,RESIDENTIAL,22600,0,22600,87400,0,110000
142035800400000,NW 322,RESIDENTIAL,22600,0,22600,83200,0,105800
142035800500000,NW 322,RESIDENTIAL,22600,0,22600,71500,0,94100
142035800600000,NW 322,RESIDENTIAL,22600,0,22600,90500,0,113100
142035800700000,NW 322,RESIDENTIAL,23900,0,23900,113300,0,137200
142035800800000,NW 322,RESIDENTIAL,20000,0,20000,73100,0,93100
142035800900000,NW 322,RESIDENTIAL,19700,0,19700,100500,0,120200
142035801000000,NW 322,RESIDENTIAL,19700,0,19700,83900,0,103600
142035801100000,NW 322,RESIDENTIAL,19700,0,19700,94900,0,114600
142035801200000,NW 322,RESIDENTIAL,19700,0,19700,84200,0,103900
142035801300000,NW 322,RESIDENTIAL,19700,0,19700,98800,0,118500
142035801400000,NW 322,RESIDENTIAL,21400,0,21400,84000,0,105400
142037600100000,NW 311,RESIDENTIAL,20400,0,20400,70700,0,91100
142037600200000,NW 311,RESIDENTIAL,19800,0,19800,60200,0,80000
142037600300000,NW 311,RESIDENTIAL,12300,0,12300,55700,0,68000
142037600400000,NW 311,RESIDENTIAL,12300,0,12300,37600,0,49900
142037600500000,NW 311,RESIDENTIAL,14000,0,14000,72800,0,86800
142037600600000,NW 311,RESIDENTIAL,14000,0,14000,44300,0,58300
142037600700000,NW 311,RESIDENTIAL,14000,0,14000,123900,0,137900
142037600800000,NW 311,RESIDENTIAL,19600,0,19600,52700,0,72300
142037600900000,NW 311,RESIDENTIAL,14000,0,14000,57900,0,71900
142037601000000,NW 311,RESIDENTIAL,14000,0,14000,60100,0,74100
142037601100000,NW 311,RESIDENTIAL,13900,0,13900,54200,0,68100
142037601200000,NW 311,RESIDENTIAL,13900,0,13900,53600,0,67500
142037601300000,NW 311,RESIDENTIAL,19400,0,19400,87300,0,106700
142037601400000,NW 311,RESIDENTIAL,17000,0,17000,52000,0,69000
142037700100000,NW 311,RESIDENTIAL,28400,0,28400,83200,0,111600
142037700200000,NW 312,RESIDENTIAL,29100,0,29100,100100,0,129200
142037700300000,NW 312,RESIDENTIAL,29300,0,29300,70400,0,99700
142037700400000,NW 312,RESIDENTIAL,31000,0,31000,117200,0,148200
142037700500000,NW 312,RESIDENTIAL,29500,0,29500,99900,0,129400
142037700600000,NW 312,RESIDENTIAL,26400,0,26400,104900,0,131300
142037700700000,NW 312,RESIDENTIAL,27100,0,27100,101000,0,128100
142037700800000,NW 312,RESIDENTIAL,29500,0,29500,106400,0,135900
142037700900000,NW 312,RESIDENTIAL,29300,0,29300,100100,0,129400
142037701000000,NW 312,RESIDENTIAL,34600,0,34600,92200,0,126800
142037701100000,NW 312,RESIDENTIAL,29000,0,29000,99200,0,128200
142037701200000,NW 312,RESIDENTIAL,28800,0,28800,94900,0,123700
142037701300000,NW 312,RESIDENTIAL,29600,0,29600,105600,0,135200
142037701400000,NW 312,RESIDENTIAL,23600,0,23600,102300,0,125900
142037701500000,NW 312,RESIDENTIAL,23300,0,23300,90800,0,114100
142037701600000,NW 312,RESIDENTIAL,26000,0,26000,90500,0,116500
142037701700000,NW 312,RESIDENTIAL,28100,0,28100,88900,0,117000
142037701800000,NW 311,RESIDENTIAL,34200,0,34200,115900,0,150100
142037701900000,NW 311,RESIDENTIAL,25200,0,25200,63700,0,88900
142037702000000,NW 311,RESIDENTIAL,20700,0,20700,92200,0,112900
142037702100000,NW 311,RESIDENTIAL,23900,0,23900,104100,0,128000
142037702200000,NW 311,RESIDENTIAL,24000,0,24000,80900,0,104900
142037702300000,NW 311,RESIDENTIAL,24000,0,24000,86400,0,110400
142037702400000,NW 311,RESIDENTIAL,24000,0,24000,51200,0,75200
142037702500000,NW 311,RESIDENTIAL,24000,0,24000,70000,0,94000
142037702600000,NW 311,RESIDENTIAL,24000,0,24000,48700,0,72700
142037702700000,NW 311,RESIDENTIAL,24000,0,24000,81900,0,105900
142037702800000,NW 311,RESIDENTIAL,24200,0,24200,79200,0,103400
142037702900000,NW 311,RESIDENTIAL,24500,0,24500,61200,0,85700
142037703000000,NW 311,RESIDENTIAL,24700,0,24700,43600,0,68300
142037703100000,NW 311,RESIDENTIAL,28600,0,28600,90100,0,118700
142037703200000,NW 311,RESIDENTIAL,25000,0,25000,65600,0,90600
142037703300000,NW 311,RESIDENTIAL,27300,0,27300,81700,0,109000
142037800100000,NW 312,RESIDENTIAL,23500,0,23500,95600,0,119100
142037800300000,NW 312,RESIDENTIAL,22300,0,22300,120300,0,142600
142037800400000,NW 312,RESIDENTIAL,1200,0,1200,0,0,1200
142037900100000,NW 312,RESIDENTIAL,22600,0,22600,96600,0,119200
142037900200000,NW 312,RESIDENTIAL,1200,0,1200,0,0,1200
142037900300000,NW 312,RESIDENTIAL,23800,0,23800,105500,0,129300
142037900400000,NW 312,RESIDENTIAL,23800,0,23800,135200,0,159000
142037900500000,NW 312,RESIDENTIAL,27700,0,27700,89900,0,117600
142037900600000,NW 312,RESIDENTIAL,28000,0,28000,105600,0,133600
142037900700000,NW 312,RESIDENTIAL,27000,0,27000,107400,0,134400
142037900800000,NW 312,RESIDENTIAL,26800,0,26800,91900,0,118700
142037900900000,NW 312,RESIDENTIAL,29400,0,29400,98100,0,127500
142037901000000,NW 312,RESIDENTIAL,29100,0,29100,91600,0,120700
142038000100000,NW 311,RESIDENTIAL,14400,0,14400,93000,0,107400
142038000200000,NW 311,RESIDENTIAL,19600,0,19600,63700,0,83300
142038000300000,NW 311,RESIDENTIAL,18900,0,18900,47000,0,65900
142038000400000,NW 311,RESIDENTIAL,18900,0,18900,71000,0,89900
142038000500000,NW 311,RESIDENTIAL,14000,0,14000,72200,0,86200
142038000600000,NW 311,RESIDENTIAL,19600,0,19600,69900,0,89500
142038000700000,NW 311,RESIDENTIAL,27300,0,27300,82000,0,109300
142038000800000,NW 311,RESIDENTIAL,14000,0,14000,37500,0,51500
142038000900000,NW 311,RESIDENTIAL,19600,0,19600,52900,0,72500
142038001000000,NW 311,RESIDENTIAL,14000,0,14000,40100,0,54100
142038001100000,NW 311,RESIDENTIAL,19800,0,19800,77300,0,97100
142038001200000,NW 311,RESIDENTIAL,15000,0,15000,55300,0,70300
142038001300000,NW 311,RESIDENTIAL,11900,0,11900,59900,0,71800
142038001500000,NW 311,RESIDENTIAL,12900,0,12900,47000,0,59900
142038001600000,NW 311,RESIDENTIAL,20000,0,20000,79800,0,99800
142038001700000,NW 311,RESIDENTIAL,16000,0,16000,56600,0,72600
142038001800000,NW 311,RESIDENTIAL,16000,0,16000,66400,0,82400
142038001900000,NW 311,RESIDENTIAL,16000,0,16000,61700,0,77700
142038002000000,NW 311,RESIDENTIAL,16000,0,16000,69600,0,85600
142038002100000,NW 311,RESIDENTIAL,14000,0,14000,47400,0,61400
142038002200000,NW 311,RESIDENTIAL,16000,0,16000,64100,0,80100
142038002300000,NW 311,RESIDENTIAL,16000,0,16000,52200,0,68200
142038002400000,NW 311,RESIDENTIAL,19200,0,19200,37200,0,56400
142038002500000,NW 311,RESIDENTIAL,18700,0,18700,62900,0,81600
142038002600000,NW 311,RESIDENTIAL,16000,0,16000,69500,0,85500
142038002700000,NW 311,RESIDENTIAL,16000,0,16000,66800,0,82800
142038002800000,NW 311,RESIDENTIAL,16000,0,16000,64800,0,80800
142038002900000,NW 311,RESIDENTIAL,15600,0,15600,68400,0,84000
142038100100000,NW 311,RESIDENTIAL,16400,0,16400,52900,0,69300
142038100200000,NW 311,RESIDENTIAL,16000,0,16000,53700,0,69700
142038100300000,NW 311,RESIDENTIAL,16000,0,16000,61300,0,77300
142038100400000,NW 311,RESIDENTIAL,14000,0,14000,68300,0,82300
142038100500000,NW 311,RESIDENTIAL,16000,0,16000,75900,0,91900
142038100600000,NW 311,RESIDENTIAL,16000,0,16000,64000,0,80000
142038100700000,NW 311,RESIDENTIAL,16000,0,16000,67400,0,83400
142038100800000,NW 311,RESIDENTIAL,16000,0,16000,58000,0,74000
142038100900000,NW 311,RESIDENTIAL,14000,0,14000,50500,0,64500
142038101000000,NW 311,RESIDENTIAL,16000,0,16000,75200,0,91200
142038101100000,NW 311,RESIDENTIAL,16000,0,16000,61900,0,77900
142038101200000,NW 311,RESIDENTIAL,16000,0,16000,73100,0,89100
142038101300000,NW 311,RESIDENTIAL,16000,0,16000,73700,0,89700
142038101400000,NW 311,RESIDENTIAL,16000,0,16000,118900,0,134900
142038101500000,NW 311,RESIDENTIAL,14700,0,14700,60300,0,75000
142038101600000,NW 311,RESIDENTIAL,14800,0,14800,73200,0,88000
142038101700000,NW 311,RESIDENTIAL,17200,0,17200,62900,0,80100
142038101800000,NW 311,RESIDENTIAL,18900,0,18900,76400,0,95300
142038101900000,NW 311,RESIDENTIAL,14300,0,14300,74700,0,89000
142038102000000,NW 311,RESIDENTIAL,14000,0,14000,58700,0,72700
142038102100000,NW 311,RESIDENTIAL,16000,0,16000,53700,0,69700
142038102200000,NW 311,RESIDENTIAL,16000,0,16000,65500,0,81500
142038102300000,NW 311,RESIDENTIAL,16000,0,16000,58300,0,74300
142038102400000,NW 311,RESIDENTIAL,16000,0,16000,67500,0,83500
142038102500000,NW 311,RESIDENTIAL,16000,0,16000,55600,0,71600
142038102600000,NW 311,RESIDENTIAL,16000,0,16000,81000,0,97000
142038102700000,NW 311,RESIDENTIAL,16000,0,16000,61000,0,77000
142038102800000,NW 311,RESIDENTIAL,15600,0,15600,49700,0,65300
142038102900000,NW 311,RESIDENTIAL,17600,0,17600,70300,0,87900
142038103000000,NW 311,RESIDENTIAL,17600,0,17600,57500,0,75100
142038103100000,NW 311,RESIDENTIAL,17600,0,17600,66900,0,84500
142038103200000,NW 311,RESIDENTIAL,17600,0,17600,91700,0,109300
142038103300000,NW 311,RESIDENTIAL,17600,0,17600,64300,0,81900
142038200100000,NW 311,RESIDENTIAL,17600,0,17600,79300,0,96900
142038200200000,NW 311,RESIDENTIAL,17600,0,17600,63900,0,81500
142038200300000,NW 311,RESIDENTIAL,17600,0,17600,70200,0,87800
142038200400000,NW 311,RESIDENTIAL,19200,0,19200,48900,0,68100
142038200500000,NW 311,RESIDENTIAL,16000,0,16000,76800,0,92800
142038200600000,NW 311,RESIDENTIAL,16400,0,16400,72100,0,88500
142038200700000,NW 311,RESIDENTIAL,16000,0,16000,66000,0,82000
142038200800000,NW 311,RESIDENTIAL,16000,0,16000,46600,0,62600
142038200900000,NW 311,RESIDENTIAL,16000,0,16000,51900,0,67900
142038201000000,NW 311,RESIDENTIAL,16000,0,16000,67100,0,83100
142038201100000,NW 311,RESIDENTIAL,16000,0,16000,66800,0,82800
142038201200000,NW 311,RESIDENTIAL,16000,0,16000,69500,0,85500
142038201300000,NW 311,RESIDENTIAL,16000,0,16000,70300,0,86300
142038201400000,NW 311,RESIDENTIAL,18000,0,18000,52900,0,70900
142038201500000,NW 311,RESIDENTIAL,17800,0,17800,71300,0,89100
142038201600000,NW 311,RESIDENTIAL,12200,0,12200,47800,0,60000
142038201700000,NW 311,RESIDENTIAL,12600,0,12600,64300,0,76900
142038201800000,NW 311,RESIDENTIAL,19200,0,19200,74200,0,93400
142038201900000,NW 311,RESIDENTIAL,19600,0,19600,52400,0,72000
142038202000000,NW 311,RESIDENTIAL,16000,0,16000,0,0,16000
142038202100000,NW 311,RESIDENTIAL,16000,0,16000,43200,0,59200
142038202200000,NW 311,RESIDENTIAL,16000,0,16000,67800,0,83800
142038202300000,NW 311,RESIDENTIAL,16000,0,16000,52300,0,68300
142038202400000,NW 311,RESIDENTIAL,16000,0,16000,51000,0,67000
142038202500000,NW 311,RESIDENTIAL,17600,0,17600,81100,0,98700
142038202600000,NW 311,RESIDENTIAL,14000,0,14000,77100,0,91100
142038202700000,NW 311,RESIDENTIAL,17600,0,17600,71400,0,89000
142038202800000,NW 311,RESIDENTIAL,17600,0,17600,105700,0,123300
142038202900000,NW 311,RESIDENTIAL,17600,0,17600,71000,0,88600
142038203000000,NW 311,RESIDENTIAL,16000,0,16000,64500,0,80500
142038203100000,NW 311,RESIDENTIAL,19200,0,19200,62900,0,82100
142038300100000,NW 311,RESIDENTIAL,16700,0,16700,51700,0,68400
142038300200000,NW 311,RESIDENTIAL,16500,0,16500,69700,0,86200
142038300300000,NW 311,RESIDENTIAL,14300,0,14300,20800,0,35100
142038300400000,NW 311,RESIDENTIAL,21200,0,21200,53900,0,75100
142038300500000,NW 311,RESIDENTIAL,15300,0,15300,63900,0,79200
142038300600000,NW 311,RESIDENTIAL,15600,0,15600,59900,0,75500
142038300700000,NW 311,RESIDENTIAL,16600,0,16600,65200,0,81800
142038300800000,NW 311,RESIDENTIAL,16000,0,16000,54900,0,70900
142038300900000,NW 311,RESIDENTIAL,18100,0,18100,119900,0,138000
142038301000000,NW 311,RESIDENTIAL,20500,0,20500,61900,0,82400
142038301100000,NW 311,RESIDENTIAL,18200,0,18200,38600,0,56800
142038301200000,NW 311,RESIDENTIAL,21700,0,21700,63900,0,85600
142038301300000,NW 311,RESIDENTIAL,16000,0,16000,27300,0,43300
142038301400000,NW 311,RESIDENTIAL,20400,0,20400,61500,0,81900
142038301500000,NW 311,RESIDENTIAL,20400,0,20400,50800,0,71200
142038301600000,NW 311,RESIDENTIAL,21300,0,21300,76200,0,97500
142038301700000,NW 311,RESIDENTIAL,21000,0,21000,25400,0,46400
142038301800000,NW 311,RESIDENTIAL,12500,0,12500,49500,0,62000
142038400100000,APARTMENT,RESIDENTIAL,38300,0,38300,370400,0,408700
142040100500000,NW 317,RESIDENTIAL,13200,0,13200,0,0,13200
142040101100000,CITY PROPERTY,EXEMPT,0,0,0,0,0,0
142040101200000,CITY PROPERTY,EXEMPT,0,0,0,0,0,0
142040202200000,NW 317,RESIDENTIAL,17200,0,17200,80400,0,97600
142040202400000,CITY PROPERTY,EXEMPT,0,0,0,0,0,0
142040202500000,CITY PROPERTY,EXEMPT,0,0,0,0,0,0
142040202600000,CITY PROPERTY,EXEMPT,0,0,0,0,0,0
142040300200000,CITY PROPERTY,EXEMPT,0,0,0,0,0,0
142040300300000,CITY PROPERTY,EXEMPT,0,0,0,0,0,0
142040300400000,CITY PROPERTY,EXEMPT,0,0,0,0,0,0
142040300500000,CITY PROPERTY,EXEMPT,0,0,0,0,0,0
142040300600000,CITY PROPERTY,EXEMPT,0,0,0,0,0,0
142040300700000,CITY PROPERTY,EXEMPT,0,0,0,0,0,0
142040300800000,NW 317,RESIDENTIAL,13300,0,13300,79000,0,92300
142040300900000,VACANT LAND,COMMERCIAL,0,3500,3500,0,0,3500
142040301700000,NW 317,RESIDENTIAL,15000,0,15000,57700,0,72700
142040302000000,CITY PROPERTY,EXEMPT,0,0,0,0,0,0
142040302100000,CITY PROPERTY,EXEMPT,0,0,0,0,0,0
142040400100000,NW 310,RESIDENTIAL,17300,0,17300,81200,0,98500
142040400200000,CITY PROPERTY,EXEMPT,0,0,0,0,0,0
142040400300000,NW 310,RESIDENTIAL,14600,0,14600,48400,0,63000
142040400400000,NW 310,RESIDENTIAL,9700,0,9700,60700,0,70400
142040400600000,CITY PROPERTY,EXEMPT,0,0,0,0,0,0
142040400700000,CITY PROPERTY,EXEMPT,0,0,0,0,0,0
142040400800000,CITY PROPERTY,EXEMPT,0,0,0,0,0,0
142040400900000,CITY PROPERTY,EXEMPT,0,0,0,0,0,0
142040401000000,CITY PROPERTY,EXEMPT,0,0,0,0,0,0
142040401100000,CITY PROPERTY,EXEMPT,0,0,0,0,0,0
142040401200000,CITY PROPERTY,EXEMPT,0,0,0,0,0,0
142040401300000,CITY PROPERTY,EXEMPT,0,0,0,0,0,0
142040401400000,NW 310,RESIDENTIAL,17300,0,17300,66800,0,84100
142040401500000,NW 310,RESIDENTIAL,17300,0,17300,46200,0,63500
142040401600000,CITY PROPERTY,EXEMPT,0,0,0,0,0,0
142040401700000,CITY PROPERTY,EXEMPT,0,0,0,0,0,0
142040500100000,NW 310,RESIDENTIAL,17300,0,17300,50300,0,67600
142040500300000,NW 310,RESIDENTIAL,16800,0,16800,64500,0,81300
142040500400000,CITY PROPERTY,EXEMPT,0,0,0,0,0,0
142040500500000,NW 310,RESIDENTIAL,14900,0,14900,63300,0,78200
142040500600000,CITY PROPERTY,EXEMPT,0,0,0,0,0,0
142040500700000,CITY PROPERTY,EXEMPT,0,0,0,0,0,0
142040500800000,RESTAURANT,COMMERCIAL,0,57600,57600,0,150100,207700
142040500900000,FLAT PARKING,COMMERCIAL,0,8500,8500,0,5300,13800
142040501000000,CITY PROPERTY,EXEMPT,0,0,0,0,0,0
142040501100000,CITY PROPERTY,EXEMPT,0,0,0,0,0,0
142040501200000,NW 310,RESIDENTIAL,17300,0,17300,54300,0,71600
142040501300000,CITY PROPERTY,EXEMPT,0,0,0,0,0,0
142040501400000,NW 310,RESIDENTIAL,17300,0,17300,47800,0,65100
142040501500000,NW 310,RESIDENTIAL,17300,0,17300,50000,0,67300
142040501600000,NW 310,RESIDENTIAL,17300,0,17300,50400,0,67700
142040501700000,CITY PROPERTY,EXEMPT,0,0,0,0,0,0
142040501800000,CITY PROPERTY,EXEMPT,0,0,0,0,0,0
142040600100000,WAREHOUSE,COMMERCIAL,0,342800,342800,0,1424600,1767400
142040600200000,CITY PROPERTY,EXEMPT,0,0,0,0,0,0
142040600300000,CITY PROPERTY,EXEMPT,0,0,0,0,0,0
142040600400000,CITY PROPERTY,EXEMPT,0,0,0,0,0,0
142040600500000,CITY PROPERTY,EXEMPT,0,0,0,0,0,0
142040600600000,NW 310,RESIDENTIAL,17300,0,17300,30900,0,48200
142040600700000,NW 310,RESIDENTIAL,12300,0,12300,5500,0,17800
142040600800000,NW 310,RESIDENTIAL,17300,0,17300,68100,0,85400
142040600900000,CITY PROPERTY,EXEMPT,0,0,0,0,0,0
142040601000000,CITY PROPERTY,EXEMPT,0,0,0,0,0,0
142040601100000,CITY PROPERTY,EXEMPT,0,0,0,0,0,0
142040601200000,CITY PROPERTY,EXEMPT,0,0,0,0,0,0
142040601300000,CITY PROPERTY,EXEMPT,0,0,0,0,0,0
142040601400000,CITY PROPERTY,EXEMPT,0,0,0,0,0,0
142040601500000,CITY PROPERTY,EXEMPT,0,0,0,0,0,0
142040601600000,CITY PROPERTY,EXEMPT,0,0,0,0,0,0
142040603000000,CITY PROPERTY,EXEMPT,0,0,0,0,0,0
142040700100000,CITY PROPERTY,EXEMPT,0,0,0,0,0,0
142040700200000,SMALL RETAIL,COMMERCIAL,0,9200,9200,0,10000,19200
142040700300000,SMALL RETAIL,COMMERCIAL,0,2800,2800,0,0,2800
142040700400000,CITY PROPERTY,EXEMPT,0,0,0,0,0,0
142040700500000,CITY PROPERTY,EXEMPT,0,0,0,0,0,0
142040700600000,NW 310,RESIDENTIAL,19800,0,19800,67500,0,87300
142040700700000,CITY PROPERTY,EXEMPT,0,0,0,0,0,0
142040700800000,CITY PROPERTY,EXEMPT,0,0,0,0,0,0
142040700900000,CITY PROPERTY,EXEMPT,0,0,0,0,0,0
142040701000000,CITY PROPERTY,EXEMPT,0,0,0,0,0,0
142040701100000,CITY PROPERTY,EXEMPT,0,0,0,0,0,0
142040701200000,NW 310,RESIDENTIAL,4800,0,4800,0,0,4800
142040701300000,CITY PROPERTY,EXEMPT,0,0,0,0,0,0
142040701400000,CITY PROPERTY,EXEMPT,0,0,0,0,0,0
142040701500000,CITY PROPERTY,EXEMPT,0,0,0,0,0,0
142040701600000,CITY PROPERTY,EXEMPT,0,0,0,0,0,0
142040701700000,NW 310,RESIDENTIAL,5000,0,5000,0,0,5000
142040701800000,NW 310,RESIDENTIAL,17300,0,17300,57400,0,74700
142040701900000,CITY PROPERTY,EXEMPT,0,0,0,0,0,0
142040800400000,CITY PROPERTY,EXEMPT,0,0,0,0,0,0
142040800500000,CITY PROPERTY,EXEMPT,0,0,0,0,0,0
142040800600000,CITY PROPERTY,EXEMPT,0,0,0,0,0,0
142040800700000,CITY PROPERTY,EXEMPT,0,0,0,0,0,0
142040800800000,CITY PROPERTY,EXEMPT,0,0,0,0,0,0
142040800900000,CITY PROPERTY,EXEMPT,0,0,0,0,0,0
142040801000000,CITY PROPERTY,EXEMPT,0,0,0,0,0,0
142040801100000,COUNTY PROPERTY,EXEMPT,0,0,0,0,0,0
142040801200000,CITY PROPERTY,EXEMPT,0,0,0,0,0,0
142040801300000,CITY PROPERTY,EXEMPT,0,0,0,0,0,0
142040801400000,NW 317,RESIDENTIAL,14400,0,14400,48200,0,62600
142040801500000,CITY PROPERTY,EXEMPT,0,0,0,0,0,0
142040801600000,CITY PROPERTY,EXEMPT,0,0,0,0,0,0
142040801700000,CITY PROPERTY,EXEMPT,0,0,0,0,0,0
142040801800000,CITY PROPERTY,EXEMPT,0,0,0,0,0,0
142040901700000,CITY PROPERTY,EXEMPT,0,0,0,0,0,0
142040901800000,CITY PROPERTY,EXEMPT,0,0,0,0,0,0
142040901900000,NW 310,RESIDENTIAL,17300,0,17300,82300,0,99600
142040902000000,NW 310,RESIDENTIAL,17300,0,17300,0,0,17300
142040902100000,NW 310,RESIDENTIAL,12400,0,12400,66100,0,78500
142040902200000,CITY PROPERTY,EXEMPT,0,0,0,0,0,0
142040902300000,NW 310,RESIDENTIAL,12400,0,12400,48800,0,61200
142041000100000,CITY PROPERTY,EXEMPT,0,0,0,0,0,0
142041000200000,NW 310,RESIDENTIAL,13900,0,13900,0,0,13900
142041000300000,CITY PROPERTY,EXEMPT,0,0,0,0,0,0
142041000400000,CITY PROPERTY,EXEMPT,0,0,0,0,0,0
142041000500000,NW 310,RESIDENTIAL,19800,0,19800,0,0,19800
142041000600000,CITY PROPERTY,EXEMPT,0,0,0,0,0,0
142041000700000,CITY PROPERTY,EXEMPT,0,0,0,0,0,0
142041000800000,NW 310,RESIDENTIAL,15600,0,15600,81200,0,96800
142041000900000,CITY PROPERTY,EXEMPT,0,0,0,0,0,0
142041001000000,CITY PROPERTY,EXEMPT,0,0,0,0,0,0
142041001100000,NW 310,RESIDENTIAL,15600,0,15600,80300,0,95900
142041001200000,CITY PROPERTY,EXEMPT,0,0,0,0,0,0
142041001300000,NW 310,RESIDENTIAL,15600,0,15600,69000,0,84600
142041001400000,CITY PROPERTY,EXEMPT,0,0,0,0,0,0
142041001500000,CITY PROPERTY,EXEMPT,0,0,0,0,0,0
142041100500000,CENTRALLY ASSESSED,OTHER,0,0,0,0,0,0
142042600100000,NW 310,RESIDENTIAL,19800,0,19800,86400,0,106200
142042600200000,NW 310,RESIDENTIAL,19800,0,19800,82000,0,101800
142042600300000,CITY PROPERTY,EXEMPT,0,0,0,0,0,0
142042600400000,CITY PROPERTY,EXEMPT,0,0,0,0,0,0
142042600500000,NW 310,RESIDENTIAL,19800,0,19800,53100,0,72900
142042600600000,NW 310,RESIDENTIAL,19800,0,19800,88100,0,107900
142042600700000,NW 310,RESIDENTIAL,3000,0,3000,0,0,3000
142042600800000,SMALL RETAIL,COMMERCIAL,3648,41952,45600,12292,151808,209700
142042600900000,SHOP,COMMERCIAL,0,19200,19200,0,71100,90300
142042601000000,CONVERSION-NW/SW,MULTI-RES,19400,0,19400,59100,0,78500
142042601100000,FLAT PARKING,COMMERCIAL,0,14400,14400,0,17300,31700
142042601200000,CITY PROPERTY,EXEMPT,0,0,0,0,0,0
142042601300000,NW 310,RESIDENTIAL,19800,0,19800,65100,0,84900
142042601400000,NW 310,RESIDENTIAL,19800,0,19800,76400,0,96200
142042601500000,NW 310,RESIDENTIAL,19800,0,19800,63100,0,82900
142042700100000,NW 310,RESIDENTIAL,19800,0,19800,62000,0,81800
142042700200000,NW 310,RESIDENTIAL,19800,0,19800,52300,0,72100
142042700300000,NW 310,RESIDENTIAL,19800,0,19800,84800,0,104600
142042700400000,NW 310,RESIDENTIAL,19800,0,19800,52400,0,72200
142042700500000,NW 310,RESIDENTIAL,19800,0,19800,106800,0,126600
142042700600000,NW 310,RESIDENTIAL,19800,0,19800,90500,0,110300
142042700700000,NW 310,RESIDENTIAL,19800,0,19800,44400,0,64200
142042700800000,NW 310,RESIDENTIAL,19800,0,19800,121600,0,141400
142042700900000,NW 310,RESIDENTIAL,19800,0,19800,49000,0,68800
142042701000000,NW 310,RESIDENTIAL,19800,0,19800,114900,0,134700
142042701100000,NW 310,RESIDENTIAL,9900,0,9900,49400,0,59300
142042701200000,NW 310,RESIDENTIAL,9900,0,9900,52100,0,62000
142042701300000,NW 310,RESIDENTIAL,19800,0,19800,33200,0,53000
142042701400000,NW 310,RESIDENTIAL,19800,0,19800,47000,0,66800
142042701500000,NW 310,RESIDENTIAL,19800,0,19800,50800,0,70600
142042701600000,NW 310,RESIDENTIAL,19800,0,19800,46900,0,66700
142042701700000,NW 310,RESIDENTIAL,19800,0,19800,50400,0,70200
142042800100000,NW 310,RESIDENTIAL,19800,0,19800,45100,0,64900
142042800200000,NW 310,RESIDENTIAL,20800,0,20800,65900,0,86700
142042800300000,NW 310,RESIDENTIAL,15800,0,15800,123800,0,139600
142042800400000,NW 310,RESIDENTIAL,15800,0,15800,47800,0,63600
142042800500000,NW 310,RESIDENTIAL,19800,0,19800,67100,0,86900
142042800600000,NW 310,RESIDENTIAL,19800,0,19800,46700,0,66500
142042800700000,NW 310,RESIDENTIAL,19800,0,19800,55800,0,75600
142042800800000,NW 310,RESIDENTIAL,19800,0,19800,122900,0,142700
142042800900000,NW 310,RESIDENTIAL,19800,0,19800,47900,0,67700
142042801000000,NW 311,RESIDENTIAL,19400,0,19400,119300,0,138700
142042801100000,NW 310,RESIDENTIAL,19800,0,19800,48200,0,68000
142042801400000,NW 310,RESIDENTIAL,19800,0,19800,92100,0,111900
142042801500000,NW 310,RESIDENTIAL,19800,0,19800,128800,0,148600
142042801600000,NW 310,RESIDENTIAL,19800,0,19800,47400,0,67200
142042801700000,NW 310,RESIDENTIAL,19400,0,19400,65800,0,85200
142042801900000,NW 310,RESIDENTIAL,20200,0,20200,53100,0,73300
142042900100000,NW 310,RESIDENTIAL,19800,0,19800,115400,0,135200
142042900200000,NW 310,RESIDENTIAL,20400,0,20400,35600,0,56000
142042900300000,NW 310,RESIDENTIAL,20400,0,20400,85100,0,105500
142042900400000,NW 310,RESIDENTIAL,20400,0,20400,59000,0,79400
142042900500000,NW 310,RESIDENTIAL,20400,0,20400,67500,0,87900
142042900600000,NW 310,RESIDENTIAL,20400,0,20400,52800,0,73200
142042900700000,NW 310,RESIDENTIAL,20400,0,20400,61100,0,81500
142042900800000,NW 310,RESIDENTIAL,20400,0,20400,54200,0,74600
142042900900000,NW 310,RESIDENTIAL,20400,0,20400,116700,0,137100
142042901000000,NW 310,RESIDENTIAL,19800,0,19800,77800,0,97600
142042901100000,NW 310,RESIDENTIAL,19800,0,19800,119500,0,139300
142042901200000,NW 310,RESIDENTIAL,19800,0,19800,53100,0,72900
142042901300000,NW 310,RESIDENTIAL,19800,0,19800,71100,0,90900
142042901400000,NW 310,RESIDENTIAL,19800,0,19800,58200,0,78000
142042901500000,NW 310,RESIDENTIAL,19800,0,19800,77400,0,97200
142042901600000,NW 310,RESIDENTIAL,19800,0,19800,80500,0,100300
142043000100000,CITY PROPERTY,EXEMPT,0,0,0,0,0,0
142043000200000,NW 310,RESIDENTIAL,19800,0,19800,43400,0,63200
142043000300000,NW 310,RESIDENTIAL,19800,0,19800,38200,0,58000
142043000400000,CITY PROPERTY,EXEMPT,0,0,0,0,0,0
142043000500000,CITY PROPERTY,EXEMPT,0,0,0,0,0,0
142043000600000,NW 310,RESIDENTIAL,19800,0,19800,71200,0,91000
142043000700000,NW 310,RESIDENTIAL,19800,0,19800,64400,0,84200
142043001100000,CITY PROPERTY,EXEMPT,0,0,0,0,0,0
142043001200000,CITY PROPERTY,EXEMPT,0,0,0,0,0,0
142043001300000,NW 310,RESIDENTIAL,9900,0,9900,37600,0,47500
142043001400000,CITY PROPERTY,EXEMPT,0,0,0,0,0,0
142043001500000,NW 310,RESIDENTIAL,19800,0,19800,44800,0,64600
142043001600000,NW 310,RESIDENTIAL,13500,0,13500,51300,0,64800
142043001700000,NW 310,RESIDENTIAL,13100,0,13100,62700,0,75800
142043001800000,CITY PROPERTY,EXEMPT,0,0,0,0,0,0
142043001900000,CITY PROPERTY,EXEMPT,0,0,0,0,0,0
142043002000000,NW 310,RESIDENTIAL,29700,0,29700,63200,0,92900
142043100100000,NW 310,RESIDENTIAL,19800,0,19800,52200,0,72000
142043100200000,NW 310,RESIDENTIAL,19800,0,19800,98500,0,118300
142043100300000,NW 310,RESIDENTIAL,19800,0,19800,60100,0,79900
142043100400000,NW 310,RESIDENTIAL,19800,0,19800,20900,0,40700
142043100500000,NW 310,RESIDENTIAL,19800,0,19800,86400,0,106200
142043100600000,NW 310,RESIDENTIAL,19800,0,19800,72900,0,92700
142043100700000,NW 310,RESIDENTIAL,19800,0,19800,63900,0,83700
142043100800000,NW 310,RESIDENTIAL,19800,0,19800,127000,0,146800
142043100900000,NW 310,RESIDENTIAL,19800,0,19800,58500,0,78300
142043101000000,NW 310,RESIDENTIAL,19800,0,19800,65800,0,85600
142043101100000,CITY PROPERTY,EXEMPT,0,0,0,0,0,0
142043101200000,CITY PROPERTY,EXEMPT,0,0,0,0,0,0
142043101300000,NW 310,RESIDENTIAL,19800,0,19800,38100,0,57900
142043101400000,NW 310,RESIDENTIAL,19800,0,19800,19700,0,39500
142043101500000,NW 310,RESIDENTIAL,19800,0,19800,64000,0,83800
142043101600000,NW 310,RESIDENTIAL,19800,0,19800,53300,0,73100
142043200100000,NW 310,RESIDENTIAL,19800,0,19800,58300,0,78100
142043200200000,NW 310,RESIDENTIAL,19800,0,19800,90400,0,110200
142043200300000,NW 310,RESIDENTIAL,19800,0,19800,43300,0,63100
142043200400000,NW 310,RESIDENTIAL,19800,0,19800,74200,0,94000
142043200500000,NW 310,RESIDENTIAL,19800,0,19800,126200,0,146000
142043200600000,NW 310,RESIDENTIAL,19800,0,19800,82500,0,102300
142043200700000,NW 310,RESIDENTIAL,19800,0,19800,61500,0,81300
142043200800000,NW 310,RESIDENTIAL,19800,0,19800,57400,0,77200
142043200900000,NW 310,RESIDENTIAL,19800,0,19800,62800,0,82600
142043201000000,NW 310,RESIDENTIAL,7300,0,7300,36400,0,43700
142043201100000,NW 310,RESIDENTIAL,14800,0,14800,102400,0,117200
142043201200000,NW 310,RESIDENTIAL,19800,0,19800,125800,0,145600
142043201300000,NW 310,RESIDENTIAL,19800,0,19800,67700,0,87500
142043201400000,NW 310,RESIDENTIAL,19800,0,19800,64400,0,84200
142043201500000,NW 310,RESIDENTIAL,19800,0,19800,64100,0,83900
142043201600000,NW 310,RESIDENTIAL,19800,0,19800,110900,0,130700
142043201700000,NW 310,RESIDENTIAL,19800,0,19800,63500,0,83300
142043300100000,NW 310,RESIDENTIAL,19800,0,19800,61300,0,81100
142043300200000,NW 310,RESIDENTIAL,20400,0,20400,125000,0,145400
142043300300000,NW 310,RESIDENTIAL,20400,0,20400,60600,0,81000
142043300400000,NW 310,RESIDENTIAL,20400,0,20400,120500,0,140900
142043300500000,NW 310,RESIDENTIAL,20400,0,20400,54300,0,74700
142043300600000,NW 310,RESIDENTIAL,20400,0,20400,99900,0,120300
142043300700000,NW 310,RESIDENTIAL,20400,0,20400,111400,0,131800
142043300800000,NW 310,RESIDENTIAL,16000,0,16000,62600,0,78600
142043300900000,NW 310,RESIDENTIAL,16000,0,16000,66600,0,82600
142043301000000,NW 310,RESIDENTIAL,18500,0,18500,64600,0,83100
142043301100000,NW 310,RESIDENTIAL,20800,0,20800,17700,0,38500
142043301200000,NW 310,RESIDENTIAL,22300,0,22300,55300,0,77600
142043301300000,NW 310,RESIDENTIAL,19800,0,19800,63000,0,82800
142043301400000,NW 310,RESIDENTIAL,19800,0,19800,69700,0,89500
142043301500000,NW 310,RESIDENTIAL,19800,0,19800,79300,0,99100
142043301600000,NW 310,RESIDENTIAL,19800,0,19800,27000,0,46800
142043400100000,NW 310,RESIDENTIAL,19800,0,19800,100400,0,120200
142043400200000,CITY PROPERTY,EXEMPT,0,0,0,0,0,0
142043400300000,CITY PROPERTY,EXEMPT,0,0,0,0,0,0
142043400400000,CITY PROPERTY,EXEMPT,0,0,0,0,0,0
142043400500000,NW 310,RESIDENTIAL,19800,0,19800,53300,0,73100
142043400600000,NW 310,RESIDENTIAL,19800,0,19800,71100,0,90900
142043400700000,CITY PROPERTY,EXEMPT,0,0,0,0,0,0
142043400800000,CITY PROPERTY,EXEMPT,0,0,0,0,0,0
142043400900000,CITY PROPERTY,EXEMPT,0,0,0,0,0,0
142043401000000,CITY PROPERTY,EXEMPT,0,0,0,0,0,0
142043401100000,NW 310,RESIDENTIAL,19800,0,19800,51500,0,71300
142043401200000,APARTMENT,MULTI-RES,12800,0,12800,102800,0,115600
142043401300000,APARTMENT,MULTI-RES,12800,0,12800,104300,0,117100
142043401400000,CITY PROPERTY,EXEMPT,0,0,0,0,0,0
142043500100000,NW 310,RESIDENTIAL,14900,0,14900,119900,0,134800
142043500200000,NW 310,RESIDENTIAL,17300,0,17300,52700,0,70000
142043500300000,NW 310,RESIDENTIAL,17300,0,17300,72200,0,89500
142043500400000,NW 310,RESIDENTIAL,17300,0,17300,58700,0,76000
142043500500000,NW 310,RESIDENTIAL,17300,0,17300,87200,0,104500
142043500600000,NW 310,RESIDENTIAL,17300,0,17300,129700,0,147000
142043500700000,NW 310,RESIDENTIAL,17300,0,17300,75900,0,93200
142043500800000,NW 310,RESIDENTIAL,13900,0,13900,62500,0,76400
142043500900000,NW 310,RESIDENTIAL,15800,0,15800,76300,0,92100
142043501000000,NW 310,RESIDENTIAL,19800,0,19800,133700,0,153500
142043501100000,NW 310,RESIDENTIAL,19800,0,19800,25700,0,45500
142043501200000,NW 310,RESIDENTIAL,19800,0,19800,115300,0,135100
142043501300000,NW 310,RESIDENTIAL,15800,0,15800,114300,0,130100
142043501400000,NW 310,RESIDENTIAL,13900,0,13900,129000,0,142900
142043501500000,NW 310,RESIDENTIAL,14900,0,14900,123300,0,138200
142043600100000,NW 310,RESIDENTIAL,19800,0,19800,56600,0,76400
142043600200000,NW 310,RESIDENTIAL,19800,0,19800,0,0,19800
142043600300000,NW 310,RESIDENTIAL,19800,0,19800,115700,0,135500
142043600400000,NW 310,RESIDENTIAL,19800,0,19800,76500,0,96300
142043600500000,NW 310,RESIDENTIAL,19800,0,19800,89400,0,109200
142043600600000,NW 310,RESIDENTIAL,19800,0,19800,120600,0,140400
142043600700000,NW 310,RESIDENTIAL,19800,0,19800,123400,0,143200
142043600800000,NW 310,RESIDENTIAL,15800,0,15800,133500,0,149300
142043600900000,NW 310,RESIDENTIAL,13900,0,13900,99600,0,113500
142043601000000,NW 310,RESIDENTIAL,17300,0,17300,71100,0,88400
142043601100000,NW 310,RESIDENTIAL,17300,0,17300,67900,0,85200
142043601200000,NW 310,RESIDENTIAL,17300,0,17300,73700,0,91000
142043601300000,NW 310,RESIDENTIAL,17300,0,17300,71600,0,88900
142043601400000,NW 310,RESIDENTIAL,17300,0,17300,75700,0,93000
142043700100000,NW 310,RESIDENTIAL,19800,0,19800,121000,0,140800
142043700200000,NW 310,RESIDENTIAL,20400,0,20400,48000,0,68400
142043700300000,NW 310,RESIDENTIAL,20400,0,20400,125400,0,145800
142043700400000,NW 310,RESIDENTIAL,20400,0,20400,53600,0,74000
142043700500000,NW 310,RESIDENTIAL,20400,0,20400,88900,0,109300
142043700600000,NW 310,RESIDENTIAL,20400,0,20400,135200,0,155600
142043700700000,NW 310,RESIDENTIAL,20400,0,20400,70600,0,91000
142043700800000,NW 310,RESIDENTIAL,16300,0,16300,34800,0,51100
142043700900000,NW 310,RESIDENTIAL,15800,0,15800,79900,0,95700
142043701000000,NW 310,RESIDENTIAL,19800,0,19800,74000,0,93800
142043701100000,NW 310,RESIDENTIAL,19800,0,19800,92200,0,112000
142043701200000,NW 310,RESIDENTIAL,19800,0,19800,122200,0,142000
142043701300000,NW 310,RESIDENTIAL,19800,0,19800,46700,0,66500
142043701400000,NW 310,RESIDENTIAL,19800,0,19800,122700,0,142500
142045100100000,NW 311,RESIDENTIAL,13300,0,13300,39300,0,52600
142045100200000,NW 311,RESIDENTIAL,10600,0,10600,62500,0,73100
142045100300000,NW 311,RESIDENTIAL,10600,0,10600,42200,0,52800
142045100400000,NW 311,RESIDENTIAL,10900,0,10900,67400,0,78300
142045100500000,NW 311,RESIDENTIAL,14400,0,14400,54100,0,68500
142045100600000,NW 311,RESIDENTIAL,16000,0,16000,77300,0,93300
142045100700000,NW 311,RESIDENTIAL,16000,0,16000,93500,0,109500
142045100800000,NW 311,RESIDENTIAL,24000,0,24000,101800,0,125800
142045100900000,NW 311,RESIDENTIAL,24000,0,24000,84500,0,108500
142045200100000,NW 311,RESIDENTIAL,7400,0,7400,60500,0,67900
142045200200000,NW 311,RESIDENTIAL,13600,0,13600,54800,0,68400
142045200300000,NW 311,RESIDENTIAL,16000,0,16000,60800,0,76800
142045200400000,NW 311,RESIDENTIAL,16000,0,16000,75600,0,91600
142045200500000,NW 311,RESIDENTIAL,9900,0,9900,48100,0,58000
142045200600000,NW 311,RESIDENTIAL,11400,0,11400,48100,0,59500
142045200700000,NW 311,RESIDENTIAL,16000,0,16000,56500,0,72500
142045200800000,NW 311,RESIDENTIAL,16000,0,16000,54600,0,70600
142045200900000,NW 311,RESIDENTIAL,16000,0,16000,56700,0,72700
142045201000000,NW 311,RESIDENTIAL,16000,0,16000,89100,0,105100
142045300100000,NW 311,RESIDENTIAL,16000,0,16000,52800,0,68800
142045300200000,NW 311,RESIDENTIAL,16000,0,16000,72600,0,88600
142045300300000,NW 311,RESIDENTIAL,16000,0,16000,54600,0,70600
142045300400000,NW 311,RESIDENTIAL,16000,0,16000,58800,0,74800
142045300500000,NW 311,RESIDENTIAL,16000,0,16000,51500,0,67500
142045300600000,NW 311,RESIDENTIAL,16000,0,16000,45500,0,61500
142045300700000,NW 311,RESIDENTIAL,16000,0,16000,57100,0,73100
142045300800000,NW 311,RESIDENTIAL,16000,0,16000,64600,0,80600
142045400100000,NW 311,RESIDENTIAL,19800,0,19800,67600,0,87400
142045400200000,NW 311,RESIDENTIAL,16000,0,16000,76800,0,92800
142045400300000,NW 311,RESIDENTIAL,11400,0,11400,40700,0,52100
142045400400000,NW 311,RESIDENTIAL,9700,0,9700,59700,0,69400
142045500100000,NW 311,RESIDENTIAL,15200,0,15200,62300,0,77500
142045500200000,NW 311,RESIDENTIAL,16000,0,16000,57300,0,73300
142045500300000,NW 311,RESIDENTIAL,16000,0,16000,50700,0,66700
142045500400000,NW 311,RESIDENTIAL,16000,0,16000,111600,0,127600
142045500500000,NW 311,RESIDENTIAL,16000,0,16000,122700,0,138700
142045500600000,NW 311,RESIDENTIAL,14400,0,14400,67400,0,81800
142045500700000,NW 311,RESIDENTIAL,14400,0,14400,52300,0,66700
142045500900000,NW 311,RESIDENTIAL,10600,0,10600,54300,0,64900
142045501000000,CITY PROPERTY,EXEMPT,0,0,0,0,0,0
142045501100000,NW 311,RESIDENTIAL,11200,0,11200,52400,0,63600
142045501200000,NW 311,RESIDENTIAL,11200,0,11200,63300,0,74500
142045501300000,NW 311,RESIDENTIAL,16000,0,16000,81900,0,97900
142045501400000,NW 311,RESIDENTIAL,16000,0,16000,75000,0,91000
142045501500000,NW 311,RESIDENTIAL,16000,0,16000,97000,0,113000
142045501600000,NW 311,RESIDENTIAL,16000,0,16000,116400,0,132400
142045501700000,NW 311,RESIDENTIAL,12000,0,12000,121900,0,133900
142045501800000,NW 311,RESIDENTIAL,19400,0,19400,74300,0,93700
142045501900000,SMALL RETAIL,COMMERCIAL,0,4200,4200,0,28600,32800
142045502000000,CITY PROPERTY,EXEMPT,0,0,0,0,0,0
142045502100000,NW 311,RESIDENTIAL,13700,0,13700,61900,0,75600
142045502200000,NW 311,RESIDENTIAL,5300,0,5300,0,0,5300
142045502300000,NW 311,RESIDENTIAL,5300,0,5300,0,0,5300
142045600100000,NW 311,RESIDENTIAL,11200,0,11200,53900,0,65100
142045600200000,NW 311,RESIDENTIAL,11200,0,11200,55100,0,66300
142045600300000,NW 311,RESIDENTIAL,16000,0,16000,84400,0,100400
142045600400000,NW 311,RESIDENTIAL,16000,0,16000,94200,0,110200
142045600500000,NW 311,RESIDENTIAL,16000,0,16000,57900,0,73900
142045600600000,NW 311,RESIDENTIAL,16000,0,16000,45800,0,61800
142045600700000,NW 311,RESIDENTIAL,16000,0,16000,87500,0,103500
142045600800000,NW 311,RESIDENTIAL,16000,0,16000,70400,0,86400
142045600900000,NW 311,RESIDENTIAL,16000,0,16000,54600,0,70600
142045601000000,NW 311,RESIDENTIAL,16000,0,16000,58800,0,74800
142045601100000,NW 311,RESIDENTIAL,16000,0,16000,73300,0,89300
142045601200000,NW 311,RESIDENTIAL,16000,0,16000,61500,0,77500
142045601300000,NW 311,RESIDENTIAL,16000,0,16000,77400,0,93400
142045601400000,NW 311,RESIDENTIAL,16000,0,16000,76000,0,92000
142045601800000,NW 311,RESIDENTIAL,21300,0,21300,117600,0,138900
142045601900000,NW 311,RESIDENTIAL,16000,0,16000,118100,0,134100
142045602000000,NW 311,RESIDENTIAL,16000,0,16000,127800,0,143800
142045700100000,NW 311,RESIDENTIAL,11200,0,11200,34100,0,45300
142045700200000,NW 311,RESIDENTIAL,11200,0,11200,56100,0,67300
142045700300000,NW 311,RESIDENTIAL,16000,0,16000,63500,0,79500
142045700400000,NW 311,RESIDENTIAL,16000,0,16000,65100,0,81100
142045700500000,NW 311,RESIDENTIAL,16000,0,16000,47800,0,63800
142045700600000,NW 311,RESIDENTIAL,16000,0,16000,52200,0,68200
142045700700000,NW 311,RESIDENTIAL,11200,0,11200,45100,0,56300
142045700800000,NW 311,RESIDENTIAL,11200,0,11200,65300,0,76500
142045700900000,NW 311,RESIDENTIAL,10600,0,10600,47300,0,57900
142045701000000,NW 311,RESIDENTIAL,10600,0,10600,54600,0,65200
142045701100000,NW 311,RESIDENTIAL,16000,0,16000,67600,0,83600
142045701200000,NW 311,RESIDENTIAL,16000,0,16000,68300,0,84300
142045701300000,NW 311,RESIDENTIAL,16000,0,16000,98900,0,114900
142045701400000,NW 311,RESIDENTIAL,16000,0,16000,83600,0,99600
142045701500000,NW 311,RESIDENTIAL,16000,0,16000,118100,0,134100
142045701600000,NW 311,RESIDENTIAL,16000,0,16000,71100,0,87100
142045701700000,NW 311,RESIDENTIAL,22400,0,22400,58500,0,80900
142045701800000,NW 311,RESIDENTIAL,9300,0,9300,46800,0,56100
142045701900000,NW 311,RESIDENTIAL,9300,0,9300,57900,0,67200
142045702000000,NW 311,RESIDENTIAL,9300,0,9300,60000,0,69300
142045702100000,NW 311,RESIDENTIAL,9300,0,9300,62400,0,71700
142045800100000,NW 311,RESIDENTIAL,12000,0,12000,86100,0,98100
142045800200000,NW 311,RESIDENTIAL,11200,0,11200,50300,0,61500
142045800300000,NW 311,RESIDENTIAL,16000,0,16000,93600,0,109600
142045800400000,NW 311,RESIDENTIAL,16000,0,16000,53100,0,69100
142045800500000,NW 311,RESIDENTIAL,16000,0,16000,100600,0,116600
142045800600000,NW 311,RESIDENTIAL,17200,0,17200,81200,0,98400
142045800700000,NW 311,RESIDENTIAL,16000,0,16000,45100,0,61100
142045800800000,NW 311,RESIDENTIAL,16000,0,16000,70400,0,86400
142045800900000,NW 311,RESIDENTIAL,11100,0,11100,55900,0,67000
142045801000000,NW 311,RESIDENTIAL,11100,0,11100,49400,0,60500
142045900100000,NW 311,RESIDENTIAL,17600,0,17600,110900,0,128500
142045900200000,NW 311,RESIDENTIAL,19500,0,19500,117400,0,136900
142045900300000,NW 311,RESIDENTIAL,20000,0,20000,83100,0,103100
142045900400000,NW 311,RESIDENTIAL,16000,0,16000,58500,0,74500
142045900500000,NW 311,RESIDENTIAL,16000,0,16000,123900,0,139900
142045900600000,NW 311,RESIDENTIAL,18000,0,18000,60000,0,78000
142045900700000,NW 311,RESIDENTIAL,14900,0,14900,111200,0,126100
142045900800000,NW 311,RESIDENTIAL,5000,0,5000,0,0,5000
142045900900000,NW 311,RESIDENTIAL,16000,0,16000,70900,0,86900
142045901000000,NW 311,RESIDENTIAL,16000,0,16000,115700,0,131700
142045901100000,CONVERSION-NW/SW,MULTI-RES,18000,0,18000,75800,0,93800
142045901200000,NW 311,RESIDENTIAL,16000,0,16000,58300,0,74300
142045901300000,NW 311,RESIDENTIAL,16000,0,16000,109400,0,125400
142045901400000,CONVERSION-NW/SW,MULTI-RES,16000,0,16000,80900,0,96900
142045901500000,NW 311,RESIDENTIAL,30000,0,30000,70900,0,100900
142045901600000,NW 311,RESIDENTIAL,9900,0,9900,56700,0,66600
142046000100000,NW 311,RESIDENTIAL,14200,0,14200,70200,0,84400
142046000200000,NW 311,RESIDENTIAL,13600,0,13600,65400,0,79000
142046000300000,NW 311,RESIDENTIAL,16000,0,16000,99900,0,115900
142046000400000,NW 311,RESIDENTIAL,16000,0,16000,73900,0,89900
142046000500000,NW 311,RESIDENTIAL,16000,0,16000,75700,0,91700
142046000600000,NW 311,RESIDENTIAL,16000,0,16000,95900,0,111900
142046000700000,NW 311,RESIDENTIAL,16000,0,16000,95900,0,111900
142046000800000,NW 311,RESIDENTIAL,8700,0,8700,70000,0,78700
142046000900000,NW 311,RESIDENTIAL,14400,0,14400,74100,0,88500
142046001000000,NW 311,RESIDENTIAL,11200,0,11200,46200,0,57400
142046001100000,NW 311,RESIDENTIAL,12000,0,12000,118100,0,130100
142046001200000,NW 311,RESIDENTIAL,24000,0,24000,121100,0,145100
142046001300000,NW 311,RESIDENTIAL,16000,0,16000,93300,0,109300
142046001400000,NW 311,RESIDENTIAL,16000,0,16000,65400,0,81400
142046001500000,NW 311,RESIDENTIAL,16000,0,16000,54500,0,70500
142046001600000,NW 311,RESIDENTIAL,12200,0,12200,71300,0,83500
142046001700000,NW 311,RESIDENTIAL,10800,0,10800,64300,0,75100
142046001800000,NW 311,RESIDENTIAL,17700,0,17700,87300,0,105000
142046001900000,NW 311,RESIDENTIAL,14200,0,14200,79100,0,93300
142046100100000,NW 311,RESIDENTIAL,11200,0,11200,71600,0,82800
142046100200000,NW 311,RESIDENTIAL,11200,0,11200,76700,0,87900
142046100300000,NW 311,RESIDENTIAL,16000,0,16000,75200,0,91200
142046100400000,NW 311,RESIDENTIAL,16000,0,16000,86100,0,102100
142046100500000,NW 311,RESIDENTIAL,16000,0,16000,80400,0,96400
142046100600000,NW 311,RESIDENTIAL,16000,0,16000,70800,0,86800
142046100700000,NW 311,RESIDENTIAL,16000,0,16000,75800,0,91800
142046100800000,NW 311,RESIDENTIAL,16000,0,16000,63400,0,79400
142046100900000,NW 311,RESIDENTIAL,16000,0,16000,74100,0,90100
142046101000000,NW 311,RESIDENTIAL,18000,0,18000,119200,0,137200
142046101100000,NW 311,RESIDENTIAL,16000,0,16000,102800,0,118800
142046101200000,NW 311,RESIDENTIAL,16000,0,16000,94000,0,110000
142046101300000,NW 311,RESIDENTIAL,16000,0,16000,64200,0,80200
142046101400000,NW 311,RESIDENTIAL,16000,0,16000,83200,0,99200
142046101500000,NW 311,RESIDENTIAL,16000,0,16000,69500,0,85500
142046101600000,NW 311,RESIDENTIAL,16000,0,16000,58800,0,74800
142046101700000,NW 311,RESIDENTIAL,10600,0,10600,71100,0,81700
142046101800000,NW 311,RESIDENTIAL,5000,0,5000,0,0,5000
142046200100000,NW 311,RESIDENTIAL,17200,0,17200,60900,0,78100
142046200200000,NW 311,RESIDENTIAL,16000,0,16000,70600,0,86600
142046200300000,NW 311,RESIDENTIAL,16000,0,16000,57800,0,73800
142046200400000,NW 311,RESIDENTIAL,16800,0,16800,68100,0,84900
142046200500000,NW 311,RESIDENTIAL,16000,0,16000,56300,0,72300
142046200600000,NW 311,RESIDENTIAL,16000,0,16000,65700,0,81700
142046200700000,NW 311,RESIDENTIAL,17800,0,17800,69400,0,87200
142046200800000,NW 311,RESIDENTIAL,12000,0,12000,77000,0,89000
142046200900000,NW 311,RESIDENTIAL,11100,0,11100,59600,0,70700
142046300100000,CONVERSION-NW/SW,MULTI-RES,20000,0,20000,54300,0,74300
142046300200000,NW 311,RESIDENTIAL,16000,0,16000,54400,0,70400
142046300300000,NW 311,RESIDENTIAL,16000,0,16000,107600,0,123600
142046300400000,NW 311,RESIDENTIAL,16000,0,16000,49200,0,65200
142046300500000,NW 311,RESIDENTIAL,16000,0,16000,78500,0,94500
142046300600000,NW 311,RESIDENTIAL,16000,0,16000,56700,0,72700
142046300700000,NW 311,RESIDENTIAL,11700,0,11700,47700,0,59400
142046300800000,NW 311,RESIDENTIAL,11700,0,11700,61000,0,72700
142046300900000,NW 311,RESIDENTIAL,14000,0,14000,81900,0,95900
142046301000000,NW 311,RESIDENTIAL,14000,0,14000,50200,0,64200
142046301100000,CONVERSION-NW/SW,MULTI-RES,14000,0,14000,52800,0,66800
142046301200000,CONVERSION-NW/SW,MULTI-RES,14000,0,14000,44600,0,58600
142046301300000,NW 311,RESIDENTIAL,8800,0,8800,44700,0,53500
142046301400000,NW 311,RESIDENTIAL,8800,0,8800,50300,0,59100
142046301500000,NW 311,RESIDENTIAL,14000,0,14000,64000,0,78000
142046301600000,NW 311,RESIDENTIAL,11700,0,11700,0,0,11700
142046301700000,BARS/LOUNGE,COMMERCIAL,0,10500,10500,0,106600,117100
142046301800000,NW 311,RESIDENTIAL,9800,0,9800,64200,0,74000
142046302100000,NW 311,RESIDENTIAL,12300,0,12300,31000,0,43300
142046400100000,CITY PROPERTY,EXEMPT,0,0,0,0,0,0
142046400200000,NW 311,RESIDENTIAL,16000,0,16000,84500,0,100500
142046400300000,NW 311,RESIDENTIAL,16000,0,16000,92900,0,108900
142046400400000,NW 311,RESIDENTIAL,16000,0,16000,60400,0,76400
142046400500000,NW 311,RESIDENTIAL,16000,0,16000,67600,0,83600
142046400600000,NW 311,RESIDENTIAL,16000,0,16000,47700,0,63700
142046400700000,NW 311,RESIDENTIAL,16000,0,16000,68500,0,84500
142046400800000,NW 311,RESIDENTIAL,16000,0,16000,78400,0,94400
142046400900000,NW 311,RESIDENTIAL,16000,0,16000,76200,0,92200
142046401000000,NW 311,RESIDENTIAL,16000,0,16000,68700,0,84700
142046401100000,NW 311,RESIDENTIAL,33600,0,33600,71000,0,104600
142046401200000,NW 311,RESIDENTIAL,16000,0,16000,65900,0,81900
142046401300000,NW 311,RESIDENTIAL,16000,0,16000,80900,0,96900
142046401400000,NW 311,RESIDENTIAL,16000,0,16000,78700,0,94700
142046401500000,NW 311,RESIDENTIAL,12600,0,12600,70300,0,82900
142046500100000,NW 311,RESIDENTIAL,24000,0,24000,75300,0,99300
142046500200000,NW 311,RESIDENTIAL,24000,0,24000,81100,0,105100
142046500300000,NW 311,RESIDENTIAL,16000,0,16000,104000,0,120000
142046500400000,NW 311,RESIDENTIAL,16000,0,16000,114500,0,130500
142046500500000,CONVERSION-NW/SW,MULTI-RES,16000,0,16000,58900,0,74900
142046500600000,SMALL RETAIL,COMMERCIAL,0,11200,11200,0,72400,83600
142046500700000,NW 311,RESIDENTIAL,16000,0,16000,52600,0,68600
142046500800000,NW 311,RESIDENTIAL,16000,0,16000,71500,0,87500
142046500900000,NW 311,RESIDENTIAL,16000,0,16000,68000,0,84000
142046501000000,NW 311,RESIDENTIAL,25600,0,25600,81000,0,106600
142046501100000,NW 311,RESIDENTIAL,16000,0,16000,73400,0,89400
142046501200000,NW 311,RESIDENTIAL,16000,0,16000,56600,0,72600
142046501300000,NW 311,RESIDENTIAL,16000,0,16000,51600,0,67600
142046501400000,NW 311,RESIDENTIAL,16000,0,16000,68500,0,84500
142046600100000,NW 311,RESIDENTIAL,17200,0,17200,74300,0,91500
142046600200000,NW 311,RESIDENTIAL,16000,0,16000,99500,0,115500
142046600300000,NW 311,RESIDENTIAL,16000,0,16000,84400,0,100400
142046600400000,NW 311,RESIDENTIAL,16000,0,16000,73000,0,89000
142046600500000,NW 311,RESIDENTIAL,17200,0,17200,80300,0,97500
142046600600000,NW 311,RESIDENTIAL,16000,0,16000,72500,0,88500
142046600700000,NW 311,RESIDENTIAL,16000,0,16000,79100,0,95100
142046600800000,NW 311,RESIDENTIAL,16000,0,16000,61100,0,77100
142047600400000,CITY PROPERTY,EXEMPT,0,0,0,0,0,0
142047600500000,CITY PROPERTY,EXEMPT,0,0,0,0,0,0
142047600600000,CITY PROPERTY,EXEMPT,0,0,0,0,0,0
142047600700000,CITY PROPERTY,EXEMPT,0,0,0,0,0,0
142047600800000,NW 317,RESIDENTIAL,8000,0,8000,58800,0,66800
142047600900000,CITY PROPERTY,EXEMPT,0,0,0,0,0,0
142047601000000,CITY PROPERTY,EXEMPT,0,0,0,0,0,0
142047601100000,CITY PROPERTY,EXEMPT,0,0,0,0,0,0
142047601200000,CITY PROPERTY,EXEMPT,0,0,0,0,0,0
142047601300000,NW 317,RESIDENTIAL,6000,0,6000,0,0,6000
142047601400000,CITY PROPERTY,EXEMPT,0,0,0,0,0,0
142047601500000,CITY PROPERTY,EXEMPT,0,0,0,0,0,0
142047700100000,CITY PROPERTY,EXEMPT,0,0,0,0,0,0
142047700200000,CITY PROPERTY,EXEMPT,0,0,0,0,0,0
142047700300000,CITY PROPERTY,EXEMPT,0,0,0,0,0,0
142047700400000,CITY PROPERTY,EXEMPT,0,0,0,0,0,0
142047800100000,FEED/ADDITIVE;INDUST,INDUSTRIAL,0,191700,191700,0,1690100,1881800
142047900100000,NW 317,RESIDENTIAL,14000,0,14000,61900,0,75900
142047900200000,NW 317,RESIDENTIAL,9900,0,9900,52600,0,62500
142047900300000,CITY PROPERTY,EXEMPT,0,0,0,0,0,0
142047900400000,NW 317,RESIDENTIAL,14000,0,14000,64600,0,78600
142047900500000,CITY PROPERTY,EXEMPT,0,0,0,0,0,0
142047900600000,NW 317,RESIDENTIAL,9900,0,9900,71600,0,81500
142047900700000,CITY PROPERTY,EXEMPT,0,0,0,0,0,0
142047900800000,CITY PROPERTY,EXEMPT,0,0,0,0,0,0
142047901100000,CITY PROPERTY,EXEMPT,0,0,0,0,0,0
142047901200000,NW 317,RESIDENTIAL,15400,0,15400,90300,0,105700
142047901300000,NW 317,RESIDENTIAL,9900,0,9900,62700,0,72600
142047901400000,CITY PROPERTY,EXEMPT,0,0,0,0,0,0
142048000100000,CITY PROPERTY,EXEMPT,0,0,0,0,0,0
142048000200000,CITY PROPERTY,EXEMPT,0,0,0,0,0,0
142048000300000,CITY PROPERTY,EXEMPT,0,0,0,0,0,0
142048000400000,CITY PROPERTY,EXEMPT,0,0,0,0,0,0
142048000500000,CITY PROPERTY,EXEMPT,0,0,0,0,0,0
142048000600000,CITY PROPERTY,EXEMPT,0,0,0,0,0,0
142048000700000,NW 317,RESIDENTIAL,8000,0,8000,0,0,8000
142048000800000,CITY PROPERTY,EXEMPT,0,0,0,0,0,0
142048000900000,NW 317,RESIDENTIAL,12000,0,12000,0,0,12000
142048001100000,CITY PROPERTY,EXEMPT,0,0,0,0,0,0
142048001200000,CITY PROPERTY,EXEMPT,0,0,0,0,0,0
142048001300000,CITY PROPERTY,EXEMPT,0,0,0,0,0,0
142048001400000,CITY PROPERTY,EXEMPT,0,0,0,0,0,0
142048001500000,CITY PROPERTY,EXEMPT,0,0,0,0,0,0
142048001600000,CITY PROPERTY,EXEMPT,0,0,0,0,0,0
142048001700000,CITY PROPERTY,EXEMPT,0,0,0,0,0,0
142048001800000,CITY PROPERTY,EXEMPT,0,0,0,0,0,0
142048100100000,CITY PROPERTY,EXEMPT,0,0,0,0,0,0
142048100200000,CITY PROPERTY,EXEMPT,0,0,0,0,0,0
142048100300000,NW 317,EXEMPT,0,19600,19600,0,0,19600
142048100400000,NW 317,RESIDENTIAL,8000,0,8000,33100,0,41100
142048100500000,NW 317,EXEMPT,0,9600,9600,0,0,9600
142048100600000,NW 317,EXEMPT,0,15900,15900,0,0,15900
142048100700000,CONVERSION-NW/SW,MULTI-RES,12000,0,12000,37500,0,49500
142048100800000,NW 317,RESIDENTIAL,12000,0,12000,55000,0,67000
142048100900000,NW 317,RESIDENTIAL,12000,0,12000,58200,0,70200
142048101000000,NW 317,EXEMPT,0,12000,12000,0,0,12000
142048101100000,NW 317,EXEMPT,0,12000,12000,0,0,12000
142048101200000,CITY PROPERTY,EXEMPT,0,0,0,0,0,0
142048101300000,CITY PROPERTY,EXEMPT,0,0,0,0,0,0
142048101400000,CITY PROPERTY,EXEMPT,0,0,0,0,0,0
142048101500000,CITY PROPERTY,EXEMPT,0,0,0,0,0,0
142048101600000,NW 317,RESIDENTIAL,0,0,0,0,0,0
142048200100000,CITY PROPERTY,EXEMPT,0,0,0,0,0,0
142048200200000,NW 317,RESIDENTIAL,14000,0,14000,80400,0,94400
142048200300000,NW 317,RESIDENTIAL,14000,0,14000,82000,0,96000
142048200400000,NW 317,RESIDENTIAL,14000,0,14000,138000,0,152000
142048200500000,NW 317,RESIDENTIAL,14000,0,14000,134300,0,148300
142048200600000,NW 317,RESIDENTIAL,14000,0,14000,72100,0,86100
142048200700000,NW 317,RESIDENTIAL,15200,0,15200,78000,0,93200
142048200800000,NW 317,RESIDENTIAL,13700,0,13700,67100,0,80800
142048200900000,CITY PROPERTY,EXEMPT,0,0,0,0,0,0
142048201000000,NW 317,EXEMPT,0,7000,7000,0,0,7000
142048201100000,NW 317,RESIDENTIAL,7600,0,7600,58900,0,66500
142048201200000,NW 317,RESIDENTIAL,3000,0,3000,0,0,3000
142048201300000,NW 317,RESIDENTIAL,12000,0,12000,61200,0,73200
142048201400000,NW 317,RESIDENTIAL,5000,0,5000,0,0,5000
142048201500000,NW 317,RESIDENTIAL,12000,0,12000,0,0,12000
142048201600000,NW 317,RESIDENTIAL,12000,0,12000,134800,0,146800
142048201700000,NW 317,RESIDENTIAL,12000,0,12000,120200,0,132200
142048201800000,NW 317,RESIDENTIAL,12000,0,12000,65500,0,77500
142048201900000,NW 317,RESIDENTIAL,12000,0,12000,45300,0,57300
142048300100000,CITY PROPERTY,EXEMPT,0,0,0,0,0,0
142048300200000,CITY PROPERTY,EXEMPT,0,0,0,0,0,0
142048300300000,CITY PROPERTY,EXEMPT,0,0,0,0,0,0
142048300400000,CITY PROPERTY,EXEMPT,0,0,0,0,0,0
142048300500000,CONVERSION-NW/SW,MULTI-RES,12000,0,12000,36200,0,48200
142048300600000,CITY PROPERTY,EXEMPT,0,0,0,0,0,0
142048300700000,CITY PROPERTY,EXEMPT,0,0,0,0,0,0
142048300800000,CITY PROPERTY,EXEMPT,0,0,0,0,0,0
142048300900000,CITY PROPERTY,EXEMPT,0,0,0,0,0,0
142048301000000,CITY PROPERTY,EXEMPT,0,0,0,0,0,0
142048301100000,CITY PROPERTY,EXEMPT,0,0,0,0,0,0
142048301200000,CITY PROPERTY,EXEMPT,0,0,0,0,0,0
142048400100000,NW 317,EXEMPT,0,10000,10000,0,0,10000
142048400200000,NW 317,EXEMPT,0,9800,9800,0,0,9800
142048400300000,NW 317,RESIDENTIAL,12000,0,12000,55200,0,67200
142048400400000,NW 317,RESIDENTIAL,12000,0,12000,55700,0,67700
142048400500000,NW 317,EXEMPT,0,10200,10200,0,0,10200
142048400600000,NW 317,RESIDENTIAL,11400,0,11400,74500,0,85900
142048400700000,NW 317,EXEMPT,0,12000,12000,0,0,12000
142048400800000,NW 317,EXEMPT,0,12000,12000,0,0,12000
142048400900000,NW 317,EXEMPT,0,11100,11100,0,0,11100
142048401000000,NW 317,EXEMPT,0,15600,15600,0,0,15600
142048401100000,FEED/ADDITIVE;INDUST,INDUSTRIAL,0,26600,26600,0,5000,31600
142048401200000,NW 317,EXEMPT,0,8900,8900,0,0,8900
142048401300000,NW 317,EXEMPT,0,13200,13200,0,0,13200
142048401400000,NW 317,EXEMPT,0,12000,12000,0,0,12000
142048401500000,NW 317,EXEMPT,0,12000,12000,0,0,12000
142048401800000,FLAT PARKING,COMMERCIAL,0,40300,40300,0,5100,45400
142048401900000,NW 317,RESIDENTIAL,12000,0,12000,0,0,12000
142048402000000,BARS/LOUNGE,COMMERCIAL,22400,22400,44800,105792,109108,259700
142048402100000,NW 317,RESIDENTIAL,10900,0,10900,62000,0,72900
142048402200000,NW 317,RESIDENTIAL,19200,0,19200,97900,0,117100
142048500300000,NW 317,RESIDENTIAL,9500,0,9500,0,0,9500
142048500400000,CONVENIENCE STORE,COMMERCIAL,0,100800,100800,0,233700,334500
142048500500000,OFFICE,COMMERCIAL,0,89600,89600,0,114200,203800
142048500800000,APARTMENT,MULTI-RES,97500,0,97500,1027100,0,1124600
142048500900000,NW 317,EXEMPT,0,20700,20700,0,0,20700
142048600200000,CITY PROPERTY,EXEMPT,0,0,0,0,0,0
142048600300000,CITY PROPERTY,EXEMPT,0,0,0,0,0,0
142048600400000,CITY PROPERTY,EXEMPT,0,0,0,0,0,0
142048600500000,CITY PROPERTY,EXEMPT,0,0,0,0,0,0
142048600600000,CITY PROPERTY,EXEMPT,0,0,0,0,0,0
142048600700000,CITY PROPERTY,EXEMPT,0,0,0,0,0,0
142048600800000,CITY PROPERTY,EXEMPT,0,0,0,0,0,0
142048600900000,CITY PROPERTY,EXEMPT,0,0,0,0,0,0
142048601000000,CITY PROPERTY,EXEMPT,0,0,0,0,0,0
142048601100000,CITY PROPERTY,EXEMPT,0,0,0,0,0,0
142048601200000,CITY PROPERTY,EXEMPT,0,0,0,0,0,0
142048601300000,CITY PROPERTY,EXEMPT,0,0,0,0,0,0
142048601400000,NW 317,RESIDENTIAL,5700,0,5700,77500,0,83200
142048601500000,CITY PROPERTY,EXEMPT,0,0,0,0,0,0
142048601600000,CITY PROPERTY,EXEMPT,0,0,0,0,0,0
142048601700000,CITY PROPERTY,EXEMPT,0,0,0,0,0,0
142048601800000,CITY PROPERTY,EXEMPT,0,0,0,0,0,0
142048601900000,CITY PROPERTY,EXEMPT,0,0,0,0,0,0
142048602300000,BARS/LOUNGE,COMMERCIAL,0,44800,44800,0,143900,188700
142048700100000,CONVERSION-NW/SW,MULTI-RES,9600,0,9600,51900,0,61500
142048700200000,NW 317,RESIDENTIAL,12000,0,12000,92100,0,104100
142048700300000,NW 317,RESIDENTIAL,12000,0,12000,90300,0,102300
142048700400000,CITY PROPERTY,EXEMPT,0,0,0,0,0,0
142048700500000,NW 317,RESIDENTIAL,12000,0,12000,84000,0,96000
142048700600000,CITY PROPERTY,EXEMPT,0,0,0,0,0,0
142048700700000,NW 317,RESIDENTIAL,12000,0,12000,101000,0,113000
142048700800000,NW 317,RESIDENTIAL,8400,0,8400,71800,0,80200
142048700900000,NW 317,RESIDENTIAL,4700,0,4700,47400,0,52100
142048701000000,NW 317,RESIDENTIAL,4700,0,4700,46100,0,50800
142048701100000,NW 317,RESIDENTIAL,8600,0,8600,51000,0,59600
142048701200000,CITY PROPERTY,EXEMPT,0,0,0,0,0,0
142048701300000,CITY PROPERTY,EXEMPT,0,0,0,0,0,0
142048701400000,NW 317,RESIDENTIAL,7400,0,7400,56800,0,64200
142048701500000,CITY PROPERTY,EXEMPT,0,0,0,0,0,0
142048701600000,NW 317,RESIDENTIAL,5800,0,5800,53300,0,59100
142048701700000,CITY PROPERTY,EXEMPT,0,0,0,0,0,0
142048701800000,CITY PROPERTY,EXEMPT,0,0,0,0,0,0
142048701900000,CITY PROPERTY,EXEMPT,0,0,0,0,0,0
142048702000000,CITY PROPERTY,EXEMPT,0,0,0,0,0,0
142048800100000,WAREHOUSE,COMMERCIAL,0,19300,19300,0,29500,48800
142048800200000,EQUIPMENT MFG;INDUST,INDUSTRIAL,0,26900,26900,0,14600,41500
142048800300000,NW 317,RESIDENTIAL,6900,0,6900,45100,0,52000
142048800400000,NW 317,RESIDENTIAL,5000,0,5000,0,0,5000
142048800500000,CONVENIENCE STORE,COMMERCIAL,0,57300,57300,0,251800,309100
142048900300000,VACANT LAND,COMMERCIAL,0,25200,25200,0,0,25200
142048900400000,VACANT LAND,COMMERCIAL,0,25200,25200,0,0,25200
142048900500000,FLAT PARKING,COMMERCIAL,0,25200,25200,0,1300,26500
142048900600000,BARS/LOUNGE,COMMERCIAL,0,67200,67200,0,190300,257500
142048900700000,EQUIPMENT MFG;INDUST,INDUSTRIAL,0,91600,91600,0,375500,467100
142048900800000,WAREHOUSE,COMMERCIAL,0,68500,68500,0,116900,185400
142110100100000,VACANT LAND,EXEMPT,0,20400,20400,0,0,20400
142110100200000,NE 156,RESIDENTIAL,16900,0,16900,31000,0,47900
142110100300000,SHOP,COMMERCIAL,0,16200,16200,0,72300,88500
142110100400000,WAREHOUSE,COMMERCIAL,0,143000,143000,0,325700,468700
142110100500000,SHOP,EXEMPT,0,36000,36000,0,128500,164500
142110200100000,SMALL RETAIL,COMMERCIAL,0,36700,36700,0,133800,170500
142110200200000,WAREHOUSE,COMMERCIAL,0,53400,53400,0,155500,208900
142110200300000,SMALL RETAIL,COMMERCIAL,0,41100,41100,0,127300,168400
142110200400000,SHOP,COMMERCIAL,0,36100,36100,0,72100,108200
142110200500000,SHOP,COMMERCIAL,0,28900,28900,0,113400,142300
142110300100000,OFFICE,COMMERCIAL,0,33600,33600,0,243500,277100
142110300200000,WAREHOUSE,COMMERCIAL,0,25200,25200,0,120500,145700
142110300300000,FLAT PARKING,COMMERCIAL,0,12600,12600,0,1100,13700
142110300400000,FLAT PARKING,COMMERCIAL,0,12600,12600,0,2600,15200
142110300500000,SHOP,COMMERCIAL,0,25200,25200,0,157300,182500
142110300600000,OFFICE,EXEMPT,0,137300,137300,0,279600,416900
142110300602000,BILLBOARD(BLL),COMMERCIAL,0,0,0,0,44000,44000
142110400100000,VACANT LAND,COMMERCIAL,0,40800,40800,0,0,40800
142110400102000,BILLBOARD(BLL),COMMERCIAL,0,0,0,0,10300,10300
142110400200000,FLAT PARKING,COMMERCIAL,0,33600,33600,0,4800,38400
142110400300000,WAREHOUSE,COMMERCIAL,0,29400,29400,0,78000,107400
142110500100000,NE 156,EXEMPT,0,16000,16000,0,600,16600
142110500200000,NE 156,EXEMPT,0,16000,16000,0,35000,51000
142110500300000,NE 156,RESIDENTIAL,11000,0,11000,2000,0,13000
142110500400000,NE 156,RESIDENTIAL,16000,0,16000,31700,0,47700
142110500500000,NE 156,RESIDENTIAL,5400,0,5400,3500,0,8900
142110500600000,NE 156,RESIDENTIAL,8600,0,8600,0,0,8600
142110500700000,NE 156,RESIDENTIAL,8600,0,8600,0,0,8600
142110500800000,NE 156,EXEMPT,0,16000,16000,0,33500,49500
142110500900000,NE 156,RESIDENTIAL,16000,0,16000,35300,0,51300
142110501000000,APARTMENT,EXEMPT,0,33600,33600,0,165300,198900
142110501100000,AUTO REPAIR/SALES,COMMERCIAL,0,57400,57400,0,62200,119600
142110501200000,OFFICE,EXEMPT,0,6600,6600,0,41700,48300
142110501300000,APARTMENT,EXEMPT,0,246400,246400,0,194700,441100
142110501400000,SCHOOL,EXEMPT,0,0,0,0,0,0
142110600100000,VACANT LAND,COMMERCIAL,0,15000,15000,0,0,15000
142110600200000,VACANT LAND,COMMERCIAL,0,28300,28300,0,0,28300
142110600300000,BARS/LOUNGE,COMMERCIAL,0,40800,40800,0,115700,156500
142110600400000,SMALL RETAIL,COMMERCIAL,0,16300,16300,0,78400,94700
142110600500000,SMALL RETAIL,COMMERCIAL,0,16300,16300,0,55600,71900
142110600600000,AUTO REPAIR/SALES,COMMERCIAL,0,47700,47700,0,82800,130500
142110600700000,CENTRALLY ASSESSED,OTHER,0,0,0,0,0,0
142110700100000,NBHD SHOPPING CENTER,COMMERCIAL,0,264000,264000,0,293600,557600
142110700200000,CENTRALLY ASSESSED,OTHER,0,0,0,0,0,0
142110700300000,CENTRALLY ASSESSED,OTHER,0,0,0,0,0,0
142110700400000,CENTRALLY ASSESSED,OTHER,0,0,0,0,0,0
142110700500000,CENTRALLY ASSESSED,OTHER,0,0,0,0,0,0
142110700600000,VACANT LAND,EXEMPT,0,31800,31800,0,0,31800
142110700602000,BILLBOARD(BLL),COMMERCIAL,0,0,0,0,10300,10300
142110800100000,SCHOOL,EXEMPT,0,515000,515000,0,3309400,3824400
142110900100000,SCHOOL,EXEMPT,0,184000,184000,0,2113300,2297300
142112600100000,WAREHOUSE,COMMERCIAL,0,14400,14400,0,13200,27600
142112600200000,CENTRALLY ASSESSED,OTHER,0,0,0,0,0,0
142112600300000,CENTRALLY ASSESSED,OTHER,0,0,0,0,0,0
142112600400000,CENTRALLY ASSESSED,OTHER,0,0,0,0,0,0
142112700100000,CENTRALLY ASSESSED,OTHER,0,0,0,0,0,0
142112700200000,CENTRALLY ASSESSED,OTHER,0,0,0,0,0,0
142112700300000,CENTRALLY ASSESSED,OTHER,0,0,0,0,0,0
142112800100000,CENTRALLY ASSESSED,OTHER,0,0,0,0,0,0
142115100100000,CENTRALLY ASSESSED,OTHER,0,0,0,0,0,0
142115200100000,CENTRALLY ASSESSED,OTHER,0,0,0,0,0,0
142115200300000,FOOD GRADE;INDUST,INDUSTRIAL,0,35800,35800,0,536400,572200
142115200400000,VACANT LAND,INDUSTRIAL,0,5000,5000,0,0,5000
142115200700000,EQUIPMENT MFG;INDUST,INDUSTRIAL,0,1000,1000,0,0,1000
142115200800000,EQUIPMENT MFG;INDUST,INDUSTRIAL,0,11500,11500,0,0,11500
142115200900000,CENTRALLY ASSESSED,OTHER,0,0,0,0,0,0
142115300100000,CENTRALLY ASSESSED,OTHER,0,0,0,0,0,0
142117600200000,SCHOOL,EXEMPT,0,2844000,2844000,0,19419200,22263200
142117700100000,HOSPITAL,EXEMPT,0,898000,898000,0,18192400,19090400
142117700102001,BILLBOARD(BLL),COMMERCIAL,0,0,0,0,32400,32400
142117700200000,CITY PROPERTY,EXEMPT,0,0,0,0,0,0
142117800100000,HOSPITAL,COMMERCIAL,0,1003000,1003000,0,81545100,82548100
142120100100000,CENTRALLY ASSESSED,OTHER,0,0,0,0,0,0
142120100200000,VACANT LAND,AG LAND,800,0,800,0,0,800
142122600100000,CENTRALLY ASSESSED,OTHER,0,0,0,0,0,0
142125100100000,CITY PROPERTY,EXEMPT,0,0,0,0,0,0
142125100200000,NW 310,RESIDENTIAL,14900,0,14900,36200,0,51100
142125101200000,CITY PROPERTY,EXEMPT,0,0,0,0,0,0
142125200800000,NW 310,RESIDENTIAL,11200,0,11200,0,0,11200
142125200900000,CITY PROPERTY,EXEMPT,0,0,0,0,0,0
142125201900000,CITY PROPERTY,EXEMPT,0,0,0,0,0,0
142125202000000,CITY PROPERTY,EXEMPT,0,0,0,0,0,0
142127600100000,VACANT LAND,AG LAND,2300,0,2300,0,0,2300
142127600200000,VACANT LAND,AG LAND,400,0,400,0,0,400
142127600400000,VACANT LAND,COMMERCIAL,0,4400,4400,0,0,4400
142127600500000,WAREHOUSE,COMMERCIAL,0,273700,273700,0,984000,1257700
142130100100000,CENTRALLY ASSESSED,OTHER,0,0,0,0,0,0
142130100200000,VACANT LAND,INDUSTRIAL,0,4400,4400,0,0,4400
142130100400000,CENTRALLY ASSESSED,OTHER,0,0,0,0,0,0
142130100500000,CENTRALLY ASSESSED,OTHER,0,0,0,0,0,0
142130100600000,CENTRALLY ASSESSED,OTHER,0,0,0,0,0,0
142130200100000,FOOD GRADE;INDUST,INDUSTRIAL,0,40200,40200,0,30000,70200
142130200200000,CENTRALLY ASSESSED,OTHER,0,0,0,0,0,0
142130400100000,CENTRALLY ASSESSED,OTHER,0,0,0,0,0,0
142130400200000,CENTRALLY ASSESSED,OTHER,0,0,0,0,0,0
142130400300000,CENTRALLY ASSESSED,OTHER,0,0,0,0,0,0
142130400400000,FOOD GRADE;INDUST,INDUSTRIAL,0,47400,47400,0,284200,331600
142130500100000,CENTRALLY ASSESSED,OTHER,0,0,0,0,0,0
142130500200000,CENTRALLY ASSESSED,OTHER,0,0,0,0,0,0
142130600100000,FOOD GRADE;INDUST,INDUSTRIAL,0,1142800,1142800,0,7258700,8401500
142132600100000,SHOP,COMMERCIAL,0,72700,72700,0,241700,314400
142132600200000,WAREHOUSE,COMMERCIAL,0,18400,18400,0,5800,24200
142132601300000,WAREHOUSE,COMMERCIAL,0,21200,21200,0,137100,158300
142132601400000,CITY PROPERTY,EXEMPT,0,0,0,0,0,0
142132700200000,CITY PROPERTY,EXEMPT,0,0,0,0,0,0
142135100200000,CITY PROPERTY,EXEMPT,0,0,0,0,0,0
142135200500000,CITY PROPERTY,EXEMPT,0,0,0,0,0,0
142135300100000,HOTEL,COMMERCIAL,0,196300,196300,0,2096600,2292900
142135400100000,CITY PROPERTY,EXEMPT,0,0,0,0,0,0
142135500200000,VACANT LAND,COMMERCIAL,0,0,0,0,0,0
142135600300000,CITY PROPERTY,EXEMPT,0,0,0,0,0,0
142137600200000,FOOD GRADE;INDUST,INDUSTRIAL,0,6300,6300,0,2500,8800
142137600300000,FOOD GRADE;INDUST,INDUSTRIAL,0,6800,6800,0,2900,9700
142137600500000,FOOD GRADE;INDUST,INDUSTRIAL,0,41500,41500,0,1130000,1171500
142137700500000,STATE PROPERTY,EXEMPT,0,0,0,0,0,0
142137700600000,CITY PROPERTY,EXEMPT,0,0,0,0,0,0
142137700602000,HOTEL,COMMERCIAL,0,0,0,0,14650800,14650800
142137800401000,SMALL RET; CTRL CR,COMMERCIAL,0,44800,44800,0,1478100,1522900
142137800401001,SECTION 42,COMMERCIAL,0,403200,403200,0,2057000,2460200
142137900100000,BRNCH BK/CR; CTRL CR,COMMERCIAL,0,672000,672000,0,2989500,3661500
142137900200000,FLAT PARKING,COMMERCIAL,0,72500,72500,0,5000,77500
142137900300000,FLAT PARKING,COMMERCIAL,0,86000,86000,0,5500,91500
142137900501000,OFFICE; CTRL CR,COMMERCIAL,0,8000,8000,0,61600,69600
142137900501001,OFFICE; CTRL CR,COMMERCIAL,0,8000,8000,0,151400,159400
142137900501002,OFFICE; CTRL CR,COMMERCIAL,0,8000,8000,0,14400,22400
142137900501003,OFFICE; CTRL CR,COMMERCIAL,0,8000,8000,0,94600,102600
142137900501004,OFFICE; CTRL CR,COMMERCIAL,0,8600,8600,0,234100,242700
142137900501005,OFFICE; CTRL CR,COMMERCIAL,0,8000,8000,0,188400,196400
142138000100000,CITY PROPERTY,EXEMPT,0,0,0,0,0,0
142138100100000,FLAT PARKING,COMMERCIAL,0,476000,476000,0,22800,498800
142138100400000,RESTAURANT; CTRL CR,COMMERCIAL,0,98000,98000,0,249300,347300
142138100500000,OFFICE; CTRL CR,COMMERCIAL,0,44000,44000,0,103800,147800
142138100600000,OFFICE; CTRL CR,COMMERCIAL,0,120000,120000,0,643200,763200
142138100700000,RESTAURANT; CTRL CR,COMMERCIAL,15500,15500,31000,41300,41300,113600
142138100800000,RESTAURANT; CTRL CR,COMMERCIAL,15500,15500,31000,42550,42550,116100
142138100900000,OFFICE; CTRL CR,COMMERCIAL,0,80000,80000,0,382900,462900
142138101000000,OFFICE; CTRL CR,COMMERCIAL,0,120000,120000,0,724400,844400
142138101100000,OFFICE; CTRL CR,COMMERCIAL,0,96000,96000,0,543900,639900
142138101200000,OFFICE; CTRL CR,COMMERCIAL,0,112000,112000,0,772400,884400
142138101300000,BRNCH BK/CR; CTRL CR,COMMERCIAL,0,123200,123200,0,769200,892400
142138101400000,MISCELLANEOUS,COMMERCIAL,0,0,0,0,0,0
142138101501000,SMALL RET; CTRL CR,COMMERCIAL,0,8400,8400,0,91700,100100
142138101501001,SMALL RET; CTRL CR,COMMERCIAL,0,8400,8400,0,89600,98000
142138200100000,OFFICE; CTRL CR,COMMERCIAL,0,462300,462300,0,4271300,4733600
142138200200000,OFFICE; CTRL CR,COMMERCIAL,0,350000,350000,0,1302100,1652100
142138200300000,OFFICE; CTRL CR,COMMERCIAL,0,70000,70000,0,325200,395200
142138200400000,OFFICE; CTRL CR,COMMERCIAL,0,252000,252000,0,968700,1220700
142138200402000,BILLBOARD(BLL),COMMERCIAL,0,0,0,0,9700,9700
142138200500000,OFFICE; CTRL CR,COMMERCIAL,0,282800,282800,0,869500,1152300
142140100100000,RESTAURANT,COMMERCIAL,0,84000,84000,0,151800,235800
142140100200000,OFFICE,COMMERCIAL,0,84000,84000,0,444600,528600
142140100300000,FLAT PARKING,COMMERCIAL,0,84000,84000,0,8200,92200
142140300100000,PARKING STRUCTURE,COMMERCIAL,0,336000,336000,0,1898500,2234500
142140400200000,OFFICE; MEDICAL,COMMERCIAL,0,450000,450000,0,6329700,6779700
142140400700000,OFFICE; MED; CTRL CR,COMMERCIAL,0,1150000,1150000,0,17052500,18202500
142140500100000,OFFICE; CTRL CR,COMMERCIAL,0,33600,33600,0,212900,246500
142140500200000,FLAT PARKING,COMMERCIAL,0,32800,32800,0,2200,35000
142140500300000,FLAT PARKING,COMMERCIAL,0,21800,21800,0,0,21800
142140500600000,LAUNDROMAT/CLEANERS,COMMERCIAL,0,116500,116500,0,173400,289900
142140500602000,BILLBOARD(BLL),COMMERCIAL,0,0,0,0,12500,12500
142140500700000,FLAT PARKING,EXEMPT,0,367600,367600,0,29600,397200
142140500800000,FLAT PARKING,EXEMPT,0,32200,32200,0,2300,34500
142140500900000,OFFICE; CTRL CR,COMMERCIAL,0,168000,168000,0,404400,572400
142140501000000,OFFICE,EXEMPT,0,97400,97400,0,559400,656800
142140501100000,FLAT PARKING,EXEMPT,0,97400,97400,0,5700,103100
142140501200000,FLAT PARKING,EXEMPT,0,97400,97400,0,5700,103100
142140501300000,OFFICE,EXEMPT,0,97400,97400,0,1048300,1145700
142140501400000,BARS/LOUNGE; CTRL CR,COMMERCIAL,0,97400,97400,0,90300,187700
142140501500000,LAUNDROMAT/CLEANERS,COMMERCIAL,0,97400,97400,0,119400,216800
142140501600000,FLAT PARKING,COMMERCIAL,0,97400,97400,0,8600,106000
142140501700000,FLAT PARKING,COMMERCIAL,0,97400,97400,0,5600,103000
142140501800000,OFFICE; CTRL CR,COMMERCIAL,0,56200,56200,0,136200,192400
142140501900000,FLAT PARKING,COMMERCIAL,0,31900,31900,0,2100,34000
142140502000000,CITY PROPERTY,EXEMPT,0,0,0,0,0,0
142140502100000,OFFICE; MED; CTRL CR,COMMERCIAL,0,297500,297500,0,12045600,12343100
142140600200000,CHURCH,EXEMPT,0,448000,448000,0,2677100,3125100
142140700300000,APARTMENT,MULTI-RES,48500,0,48500,440400,0,488900
142140700400000,FRATERNAL,EXEMPT,0,573700,573700,0,2845300,3419000
142140700900000,LITERARY/LIBRARY/ART,EXEMPT,0,217200,217200,0,188200,405400
142140701000000,SMALL RET; CTRL CR,EXEMPT,0,69000,69000,0,282200,351200
142140701100000,FLAT PARKING,EXEMPT,0,76800,76800,0,4900,81700
142140701200000,PARKING STRUCTURE,COMMERCIAL,0,666500,666500,0,4981000,5647500
142140701300000,FLAT PARKING,COMMERCIAL,0,185200,185200,0,53800,239000
142140800900000,CITY PROPERTY,EXEMPT,0,0,0,0,0,0
142140801000000,CITY PROPERTY,EXEMPT,0,0,0,0,0,0
142140900200000,AUTO REP/SAL;CTRL CR,COMMERCIAL,0,216000,216000,0,294100,510100
142140900600000,PRINTING,INDUSTRIAL,0,109500,109500,0,166500,276000
142140900900000,SMALL RET; CTRL CR,COMMERCIAL,0,64700,64700,0,56200,120900
142140901000000,FLAT PARKING,COMMERCIAL,0,18300,18300,0,2600,20900
142140901100000,RESTAURANT; CTRL CR,COMMERCIAL,0,11800,11800,0,115500,127300
142140901200000,SMALL RET; CTRL CR,COMMERCIAL,0,156600,156600,0,177600,334200
142140901300000,CONVERSION-CENT CORE,MULTI-RES,14000,0,14000,94900,0,108900
142140901400000,PRINTING,INDUSTRIAL,0,41400,41400,0,40100,81500
142140901500000,CONVERSION-CENT CORE,MULTI-RES,15300,0,15300,67500,0,82800
142140901600000,VACANT LAND,EXEMPT,0,90000,90000,0,0,90000
142140901800000,SMALL RET; CTRL CR,COMMERCIAL,0,70500,70500,0,148400,218900
142140901802000,BILLBOARD(BLL),COMMERCIAL,0,0,0,0,17000,17000
142140901900000,FLAT PARKING,COMMERCIAL,0,1015000,1015000,0,176900,1191900
142141000100000,CHURCH,EXEMPT,0,268800,268800,0,1305200,1574000
142141000200000,CONVERSION-CENT CORE,RESIDENTIAL,18800,0,18800,116000,0,134800
142142600100000,CENTRALLY ASSESSED,OTHER,0,0,0,0,0,0
142142700100000,SHOP,COMMERCIAL,0,122800,122800,0,369200,492000
142142700200000,WAREHOUSE,COMMERCIAL,0,142500,142500,0,241000,383500
142142700300000,FOOD GRADE;INDUST,INDUSTRIAL,0,125500,125500,0,142100,267600
142142800200000,FOOD GRADE;INDUST,INDUSTRIAL,0,468000,468000,0,2830100,3298100
142142800300000,EQUIPMENT MFG;INDUST,INDUSTRIAL,0,29000,29000,0,0,29000
142142800400000,VACANT LAND,INDUSTRIAL,0,11000,11000,0,0,11000
142142900100000,OFFICE; MED; CTRL CR,COMMERCIAL,0,420000,420000,0,1075100,1495100
142142900200000,BRNCH BK/CR; CTRL CR,COMMERCIAL,0,490200,490200,0,2446500,2936700
142143000300000,BRANCH BANK/CU,COMMERCIAL,0,405100,405100,0,1118200,1523300
142143100100000,FAST FOOD,COMMERCIAL,0,302400,302400,0,522100,824500
142143100200000,WAREHOUSE,EXEMPT,0,168000,168000,0,592100,760100
142143100300000,FLAT PARKING,COMMERCIAL,0,67200,67200,0,6400,73600
142143100400000,FLAT PARKING,COMMERCIAL,0,67200,67200,0,6400,73600
142143100500000,FLAT PARKING,COMMERCIAL,0,67200,67200,0,6400,73600
142143100600000,FLAT PARKING,COMMERCIAL,0,126000,126000,0,10300,136300
142143100700000,FLAT PARKING,COMMERCIAL,0,75600,75600,0,4800,80400
142143200200000,VACANT LAND,EXEMPT,0,2300,2300,0,0,2300
142143200300000,FRATERNAL,EXEMPT,0,420700,420700,0,2156100,2576800
142143300100000,CHURCH,EXEMPT,0,187000,187000,0,572800,759800
142143300200000,VACANT LAND,EXEMPT,0,51000,51000,0,0,51000
142143400100000,FLAT PARKING,COMMERCIAL,0,232700,232700,0,22600,255300
142143500100000,SMALL RET; CTRL CR,COMMERCIAL,0,135400,135400,0,207300,342700
142145100300000,OFFICE; CTRL CR,COMMERCIAL,0,373400,373400,0,1131400,1504800
142145100400000,WAREHOUSE; CTRL CR,COMMERCIAL,0,76204,76204,0,95136,171340
142145100500000,SE 238,RESIDENTIAL,68900,0,68900,146300,0,215200
142145100600000,WAREHOUSE; CTRL CR,COMMERCIAL,0,68871,68871,80689,0,149560
142145100700000,BARS/LOUNGE; CTRL CR,COMMERCIAL,0,59600,59600,0,176600,236200
142145100900000,LG DISCOUNT/RETAIL,COMMERCIAL,0,205800,205800,0,471400,677200
142145200201000,OFFICE; CTRL CR,COMMERCIAL,0,140600,140600,0,1342800,1483400
142145200201001,BRNCH BK/CR; CTRL CR,COMMERCIAL,0,154100,154100,0,1834400,1988500
142145200201002,OFFICE; CTRL CR,COMMERCIAL,0,140600,140600,0,1329100,1469700
142145200201003,OFFICE; CTRL CR,COMMERCIAL,0,140600,140600,0,1391500,1532100
142145200300000,CHURCH,EXEMPT,0,182000,182000,0,102700,284700
142145300100000,WAREHOUSE; CTRL CR,COMMERCIAL,0,100800,100800,0,318900,419700
142145300200000,OFFICE,EXEMPT,0,151200,151200,0,596100,747300
142145400100000,OFFICE; CTRL CR,COMMERCIAL,0,134400,134400,0,607900,742300
142145400200000,PARKING STRUCTURE,COMMERCIAL,0,504000,504000,0,1090000,1594000
142145400300000,OFFICE,OTHER,0,0,0,0,0,0
142145500100000,OFFICE; CTRL CR,COMMERCIAL,0,142200,142200,0,1219000,1361200
142145500200000,CITY PROPERTY,EXEMPT,0,0,0,0,0,0
142145500300000,CITY PROPERTY,EXEMPT,0,0,0,0,0,0
142145600200000,PARKING STRUCTURE,COMMERCIAL,0,134400,134400,0,124900,259300
142145600300000,OFFICE; CTRL CR,COMMERCIAL,0,168000,168000,0,1129400,1297400
142145600500000,PARKING STRUCTURE,COMMERCIAL,0,201600,201600,0,181000,382600
142145600700000,FLAT PARKING,COMMERCIAL,0,36000,36000,0,4800,40800
142145600800000,OFFICE; CTRL CR,COMMERCIAL,0,504000,504000,0,615000,1119000
142145700100000,OFFICE; CTRL CR,COMMERCIAL,0,100800,100800,0,1328800,1429600
142145700200000,AUTO REP/SAL;CTRL CR,COMMERCIAL,0,154600,154600,0,155800,310400
142145700300000,OFFICE; CTRL CR,COMMERCIAL,0,80600,80600,0,549400,630000
142145700400000,OFFICE; CTRL CR,COMMERCIAL,0,168000,168000,0,860000,1028000
142145700500000,FLAT PARKING,COMMERCIAL,0,100800,100800,0,6700,107500
142145700600000,FLAT PARKING,COMMERCIAL,0,100800,100800,0,8200,109000
142145700700000,AUTO REP/SAL;CTRL CR,COMMERCIAL,0,252000,252000,0,416000,668000
142145700800000,SMALL RET; CTRL CR,COMMERCIAL,0,50400,50400,0,152000,202400
142145800300000,CHURCH,EXEMPT,0,504000,504000,0,2317800,2821800
142145900100000,CITY PROPERTY,EXEMPT,0,0,0,0,0,0
142145900200000,BARS/LOUNGE; CTRL CR,COMMERCIAL,0,100800,100800,0,310200,411000
142145900300000,FLAT PARKING,COMMERCIAL,0,50400,50400,0,3400,53800
142145900400000,SMALL RET; CTRL CR,COMMERCIAL,0,50400,50400,0,165200,215600
142145900500000,CITY PROPERTY,EXEMPT,0,0,0,0,0,0
142145900600000,FLAT PARKING,COMMERCIAL,0,100800,100800,0,8200,109000
142145900700000,LITERARY/LIBRARY/ART,EXEMPT,0,100800,100800,0,0,100800
142146000100000,CITY PROPERTY,EXEMPT,0,0,0,0,0,0
142146000200000,CITY PROPERTY,EXEMPT,0,0,0,0,0,0
142146000300000,CITY PROPERTY,EXEMPT,0,0,0,0,0,0
142146000400000,THEATER,EXEMPT,0,329500,329500,0,684500,1014000
142146000500000,OFFICE; CTRL CR,EXEMPT,0,173400,173400,0,290700,464100
142146000600000,PARKING STRUCTURE,COMMERCIAL,0,200000,200000,0,1842300,2042300
142146000700000,BRNCH BK/CR; CTRL CR,COMMERCIAL,0,84000,84000,0,0,84000
142146000800000,BRNCH BK/CR; CTRL CR,COMMERCIAL,0,47300,47300,0,0,47300
142146000900000,BRNCH BK/CR; CTRL CR,COMMERCIAL,0,47300,47300,0,0,47300
142146001000000,BRNCH BK/CR; CTRL CR,COMMERCIAL,0,52500,52500,0,0,52500
142146001100000,BARS/LOUNGE; CTRL CR,COMMERCIAL,18060,23940,42000,63081,83619,188700
142146001200000,CITY PROPERTY,EXEMPT,0,0,0,0,0,0
142146001300000,CITY PROPERTY,EXEMPT,0,0,0,0,0,0
142146001400000,CITY PROPERTY,EXEMPT,0,0,0,0,0,0
142146001500000,CITY PROPERTY,EXEMPT,0,0,0,0,0,0
142146100100000,CITY PROPERTY,EXEMPT,0,0,0,0,0,0
142146200300000,OFFICE; CTRL CR,COMMERCIAL,0,77400,77400,0,165300,242700
142146200500000,FLAT PARKING,COMMERCIAL,0,88200,88200,0,9700,97900
142146200600000,OFFICE; CTRL CR,COMMERCIAL,0,448000,448000,0,1231600,1679600
142146200700000,OFFICE; CTRL CR,COMMERCIAL,0,378000,378000,0,983500,1361500
142146200800000,WAREHOUSE; CTRL CR,COMMERCIAL,0,126000,126000,0,28900,154900
142146201000000,FLAT PARKING,COMMERCIAL,0,397300,397300,0,87500,484800
142146300100000,BRNCH BK/CR; CTRL CR,COMMERCIAL,0,294600,294600,0,4581100,4875700
142146300200000,BRNCH BK/CR; CTRL CR,COMMERCIAL,0,170200,170200,0,1892300,2062500
142146400100000,OFFICE; CTRL CR,COMMERCIAL,0,108000,108000,0,921100,1029100
142146400200000,SMALL RET; CTRL CR,COMMERCIAL,0,72000,72000,0,369400,441400
142146400400000,OFFICE; CTRL CR,COMMERCIAL,0,174600,174600,0,605900,780500
142146400500000,SMALL RET; CTRL CR,COMMERCIAL,0,126000,126000,0,706700,832700
142146400800000,SMALL RET; CTRL CR,COMMERCIAL,0,56000,56000,0,217700,273700
142146400900000,NE 101,COMMERCIAL,0,420000,420000,0,1080000,1500000
142146400902000,MISCELLANEOUS,COMMERCIAL,0,0,0,0,0,0
142146401001000,SMALL RET; CTRL CR,COMMERCIAL,0,40300,40300,0,249200,289500
142146401001001,OFFICE; CTRL CR,COMMERCIAL,0,37300,37300,0,205700,243000
142146401001002,OFFICE; CTRL CR,COMMERCIAL,0,37300,37300,0,235400,272700
142146401001003,OFFICE; CTRL CR,COMMERCIAL,0,37300,37300,0,82500,119800
142146401100000,OFFICE; CTRL CR,COMMERCIAL,0,51200,51200,0,142700,193900
142147600100000,OFFICE,EXEMPT,0,204400,204400,0,312600,517000
142147600200000,OFFICE; MED; CTRL CR,COMMERCIAL,0,330000,330000,0,447600,777600
142147600400000,RESTAURANT; CTRL CR,COMMERCIAL,34272,66528,100800,30090,61910,192800
142147600600000,SMALL RET; CTRL CR,COMMERCIAL,0,184800,184800,0,308100,492900
142147600700000,OFFICE; MED; CTRL CR,COMMERCIAL,0,455000,455000,0,1094000,1549000
142147700100000,SHOP,COMMERCIAL,0,51100,51100,0,31200,82300
142147700200000,FLAT PARKING,COMMERCIAL,0,25200,25200,0,1500,26700
142147800100000,SMALL RET; CTRL CR,COMMERCIAL,0,100800,100800,0,505200,606000
142147800200000,WAREHOUSE; CTRL CR,COMMERCIAL,0,23000,23000,0,74700,97700
142147800300000,AUTO REP/SAL;CTRL CR,COMMERCIAL,0,98800,98800,0,54200,153000
142147800302000,BILLBOARD(BLL),COMMERCIAL,0,0,0,0,18700,18700
142147800400000,FLAT PARKING,COMMERCIAL,0,74300,74300,0,4300,78600
142147800500000,BARS/LOUNGE; CTRL CR,COMMERCIAL,0,74300,74300,0,48800,123100
142147800600000,SMALL RET; CTRL CR,COMMERCIAL,0,100800,100800,0,309600,410400
142147800700000,FLAT PARKING,COMMERCIAL,0,100800,100800,0,5900,106700
142147800800000,FLAT PARKING,COMMERCIAL,0,100800,100800,0,5900,106700
142147800900000,FLAT PARKING,COMMERCIAL,0,100800,100800,0,5900,106700
142147801000000,SMALL RET; CTRL CR,COMMERCIAL,0,100800,100800,0,220500,321300
142147801100000,SMALL RET; CTRL CR,COMMERCIAL,0,100800,100800,0,194000,294800
142147900100000,SE 238,EXEMPT,0,15300,15300,0,1900,17200
142147900200000,FLAT PARKING,EXEMPT,0,432000,432000,0,77600,509600
142147900300000,SE 238,RESIDENTIAL,15300,0,15300,43300,0,58600
142147900400000,FLAT PARKING,EXEMPT,0,62000,62000,0,0,62000
142148000100000,CONVERSION-CENT CORE,MULTI-RES,9700,0,9700,38000,0,47700
142148000200000,CONVERSION-CENT CORE,MULTI-RES,14300,0,14300,46900,0,61200
142148000300000,CONVERSION-CENT CORE,MULTI-RES,9300,0,9300,55700,0,65000
142148000400000,FLAT PARKING,COMMERCIAL,0,57600,57600,0,3400,61000
142148000500000,SMALL RETAIL,EXEMPT,0,168000,168000,0,258900,426900
142148000600000,SMALL RET; CTRL CR,COMMERCIAL,0,16900,16900,0,51900,68800
142148000700000,SMALL RET; CTRL CR,COMMERCIAL,0,16800,16800,0,51900,68700
142148000800000,SMALL RET; CTRL CR,COMMERCIAL,0,16800,16800,0,51900,68700
142148000900000,SMALL RET; CTRL CR,COMMERCIAL,0,16800,16800,0,51900,68700
142148001000000,SMALL RET; CTRL CR,COMMERCIAL,0,16900,16900,0,51900,68800
142148001100000,SMALL RET; CTRL CR,COMMERCIAL,0,16800,16800,0,51900,68700
142148001200000,SMALL RET; CTRL CR,COMMERCIAL,0,33900,33900,0,56800,90700
142148001300000,FLAT PARKING,COMMERCIAL,0,101000,101000,0,5800,106800
142148001400000,FLAT PARKING,EXEMPT,0,141700,141700,0,14400,156100
142148001500000,APARTMENT; CNTRL CR,RESIDENTIAL,11100,0,11100,174700,0,185800
142148001600000,SE 238,RESIDENTIAL,8600,0,8600,28400,0,37000
142148100400000,FLAT PARKING,COMMERCIAL,0,50400,50400,0,0,50400
142148100700000,OFFICE; CTRL CR,COMMERCIAL,0,504000,504000,0,4328400,4832400
142148100800000,PARKING STRUCTURE,COMMERCIAL,0,201600,201600,0,415700,617300
142148200100000,OFFICE; MED; CTRL CR,COMMERCIAL,0,217800,217800,0,706400,924200
142148300100000,OFFICE; MED; CTRL CR,COMMERCIAL,0,268800,268800,0,473400,742200
142148301100000,FLAT PARKING,EXEMPT,0,67400,67400,0,13300,80700
142148301300000,FLAT PARKING,EXEMPT,0,216000,216000,0,63800,279800
142148400200000,CENTRALLY ASSESSED,OTHER,0,0,0,0,0,0
142148400300000,CENTRALLY ASSESSED,OTHER,0,0,0,0,0,0
142148400400000,CENTRALLY ASSESSED,OTHER,0,0,0,0,0,0
142148400500000,CENTRALLY ASSESSED,OTHER,0,0,0,0,0,0
142148400600000,SE 238,RESIDENTIAL,4400,0,4400,27700,0,32100
142148400700000,SE 238,RESIDENTIAL,4400,0,4400,27200,0,31600
142148400800000,FLAT PARKING,COMMERCIAL,0,35200,35200,0,3200,38400
142148400900000,CENTRALLY ASSESSED,OTHER,0,0,0,0,0,0
142148401000000,CONVERSIONS; NON-APT,COMMERCIAL,0,67200,67200,0,198100,265300
142148401200000,OFFICE; CTRL CR,COMMERCIAL,0,134400,134400,0,126200,260600
142148500100000,OFFICE; MED; CTRL CR,COMMERCIAL,0,995300,995300,0,8480700,9476000
142148500200000,VACANT LAND,EXEMPT,0,25200,25200,0,0,25200
142148600200000,VACANT LAND,EXEMPT,0,20700,20700,0,0,20700
142148600700000,FLAT PARKING,EXEMPT,0,43400,43400,0,2100,45500
142148600800000,FLAT PARKING,EXEMPT,0,113500,113500,0,9200,122700
142148600900000,CHURCH,EXEMPT,0,16500,16500,0,43000,59500
142148601100000,FLAT PARKING,COMMERCIAL,0,117600,117600,0,18200,135800
142148601300000,OFFICE; MED; CTRL CR,COMMERCIAL,0,270000,270000,0,2051600,2321600
142148700100000,SMALL RET; CTRL CR,COMMERCIAL,0,37800,37800,0,86300,124100
142148700200000,FLAT PARKING,EXEMPT,0,78600,78600,0,7100,85700
142148700300000,OFFICE,EXEMPT,0,289300,289300,0,513500,802800
142148700400000,VACANT LAND,EXEMPT,0,57900,57900,0,0,57900
142148700500000,SE 238,EXEMPT,0,7500,7500,0,66100,73600
142148700600000,WAREHOUSE; CTRL CR,COMMERCIAL,0,88200,88200,0,128100,216300
142148800400000,OFFICE,EXEMPT,0,176400,176400,0,1230400,1406800
142148800600000,OFFICE,EXEMPT,0,117600,117600,0,751400,869000
142148900100000,FLAT PARKING,COMMERCIAL,0,80400,80400,0,15700,96100
142148900300000,VACANT LAND,COMMERCIAL,0,58800,58800,0,0,58800
142148900400000,FLAT PARKING,COMMERCIAL,0,78400,78400,0,11200,89600
142148900500000,SMALL RET; CTRL CR,COMMERCIAL,0,39200,39200,0,30900,70100
142148900600000,FLAT PARKING,COMMERCIAL,0,29400,29400,0,2900,32300
142148900700000,SHOP,COMMERCIAL,0,29400,29400,0,53700,83100
142148900800000,BRNCH BK/CR; CTRL CR,COMMERCIAL,0,58800,58800,0,202100,260900
142148900900000,VACANT LAND,COMMERCIAL,0,21000,21000,0,0,21000
142148901000000,SHOP,COMMERCIAL,0,88200,88200,0,49600,137800
142148901300000,VACANT LAND,COMMERCIAL,0,37200,37200,0,0,37200
142210100100000,SE 248,RESIDENTIAL,74900,0,74900,251100,0,326000
142210100200000,SE 248,RESIDENTIAL,59900,0,59900,175400,0,235300
142210100300000,SE 248,RESIDENTIAL,75600,0,75600,268400,0,344000
142210100400000,SE 248,RESIDENTIAL,70100,0,70100,180400,0,250500
142210100500000,SE 248,RESIDENTIAL,84800,0,84800,316900,0,401700
142210100600000,SE 248,RESIDENTIAL,82500,0,82500,234100,0,316600
142210100700000,SE 248,RESIDENTIAL,36800,0,36800,215100,0,251900
142210100800000,SE 248,RESIDENTIAL,39400,0,39400,240500,0,279900
142210100900000,SE 248,RESIDENTIAL,92100,0,92100,179900,0,272000
142210200100000,SE 248,RESIDENTIAL,51800,0,51800,261600,0,313400
142210200200000,SE 248,RESIDENTIAL,56900,0,56900,338500,0,395400
142210200300000,SE 248,RESIDENTIAL,81800,0,81800,624800,0,706600
142210200400000,SE 248,RESIDENTIAL,77700,0,77700,378700,0,456400
142210200500000,SE 248,RESIDENTIAL,46600,0,46600,274300,0,320900
142210200600000,SE 248,RESIDENTIAL,41600,0,41600,305200,0,346800
142210200700000,SE 248,RESIDENTIAL,43200,0,43200,239600,0,282800
142210200800000,SE 248,RESIDENTIAL,57600,0,57600,438400,0,496000
142210200900000,SE 248,RESIDENTIAL,53200,0,53200,186900,0,240100
142210201000000,SE 248,RESIDENTIAL,54800,0,54800,180100,0,234900
142210201100000,SE 248,RESIDENTIAL,50900,0,50900,340100,0,391000
142210201200000,SE 248,RESIDENTIAL,36400,0,36400,324100,0,360500
142210201300000,SE 248,RESIDENTIAL,42600,0,42600,140400,0,183000
142210201400000,SE 248,RESIDENTIAL,46600,0,46600,215800,0,262400
142210201500000,SE 248,RESIDENTIAL,30900,0,30900,151800,0,182700
142210201600000,SE 248,RESIDENTIAL,64800,0,64800,454800,0,519600
142210201700000,SE 248,RESIDENTIAL,54600,0,54600,126700,0,181300
142210201800000,SE 248,RESIDENTIAL,44100,0,44100,212800,0,256900
142210201900000,SE 248,RESIDENTIAL,68900,0,68900,350200,0,419100
142210202000000,SE 248,RESIDENTIAL,55000,0,55000,371500,0,426500
142210300100000,SE 248,RESIDENTIAL,59400,0,59400,281600,0,341000
142210300200000,SE 248,RESIDENTIAL,33800,0,33800,234300,0,268100
142210300300000,SE 248,RESIDENTIAL,33800,0,33800,232500,0,266300
142210300400000,SE 248,RESIDENTIAL,64400,0,64400,367500,0,431900
142210300500000,SE 248,RESIDENTIAL,76000,0,76000,261600,0,337600
142210400100000,SE 248,EXEMPT,0,83500,83500,0,494500,578000
142210400200000,SE 248,RESIDENTIAL,52400,0,52400,311800,0,364200
142210400300000,SE 248,RESIDENTIAL,52400,0,52400,183500,0,235900
142210400400000,SE 248,RESIDENTIAL,21600,0,21600,140300,0,161900
142210400500000,SE 248,RESIDENTIAL,39300,0,39300,212100,0,251400
142210400600000,SE 248,RESIDENTIAL,24000,0,24000,159300,0,183300
142210400700000,SE 248,RESIDENTIAL,24000,0,24000,182100,0,206100
142210400800000,SE 248,RESIDENTIAL,28300,0,28300,190500,0,218800
142210400900000,SE 248,RESIDENTIAL,24500,0,24500,167000,0,191500
142210401000000,SE 248,RESIDENTIAL,38200,0,38200,146900,0,185100
142210401100000,SE 248,RESIDENTIAL,36300,0,36300,183300,0,219600
142210401200000,SE 248,RESIDENTIAL,31800,0,31800,183700,0,215500
142210401300000,SE 248,RESIDENTIAL,34400,0,34400,198000,0,232400
142210401400000,SE 248,RESIDENTIAL,32100,0,32100,122600,0,154700
142210401500000,SE 248,RESIDENTIAL,76800,0,76800,268500,0,345300
142210401600000,SE 248,RESIDENTIAL,81800,0,81800,695400,0,777200
142210401700000,SE 248,RESIDENTIAL,83000,0,83000,539800,0,622800
142210500100000,SE 216,RESIDENTIAL,37300,0,37300,99700,0,137000
142210600100000,SE 216,RESIDENTIAL,34500,0,34500,104700,0,139200
142210600200000,SE 216,RESIDENTIAL,25200,0,25200,129800,0,155000
142210600300000,SE 216,RESIDENTIAL,36000,0,36000,143300,0,179300
142210600400000,SE 216,RESIDENTIAL,36000,0,36000,124800,0,160800
142210600500000,SE 216,RESIDENTIAL,36000,0,36000,126400,0,162400
142210600600000,SE 216,RESIDENTIAL,38400,0,38400,131200,0,169600
142210600700000,SE 216,RESIDENTIAL,36000,0,36000,105800,0,141800
142210600800000,SE 216,RESIDENTIAL,30000,0,30000,120900,0,150900
142210600900000,SE 216,RESIDENTIAL,42000,0,42000,131500,0,173500
142210601000000,SE 216,RESIDENTIAL,36000,0,36000,134600,0,170600
142210601100000,SE 216,RESIDENTIAL,36000,0,36000,110600,0,146600
142210601200000,SE 216,RESIDENTIAL,36000,0,36000,122800,0,158800
142210601300000,SE 216,RESIDENTIAL,36000,0,36000,153800,0,189800
142210601400000,SE 216,RESIDENTIAL,36000,0,36000,148700,0,184700
142210601500000,SE 216,RESIDENTIAL,24000,0,24000,117600,0,141600
142210601600000,SE 216,RESIDENTIAL,24000,0,24000,113900,0,137900
142210601700000,SE 216,RESIDENTIAL,33000,0,33000,109000,0,142000
142210601800000,SE 216,RESIDENTIAL,29400,0,29400,132600,0,162000
142210601900000,SE 216,RESIDENTIAL,27400,0,27400,112500,0,139900
142210602000000,SE 216,RESIDENTIAL,12500,0,12500,97500,0,110000
142210900100000,SE 231,RESIDENTIAL,17500,0,17500,57700,0,75200
142210900800000,CONVERSION-CENT CORE,MULTI-RES,15300,0,15300,40400,0,55700
142212600100000,SE 218,RESIDENTIAL,39000,0,39000,115200,0,154200
142212600200000,SE 218,RESIDENTIAL,39000,0,39000,139600,0,178600
142212600300000,SE 218,RESIDENTIAL,36000,0,36000,0,0,36000
142212600400000,SE 218,RESIDENTIAL,36000,0,36000,146300,0,182300
142212600500000,SE 218,RESIDENTIAL,36000,0,36000,134500,0,170500
142212600600000,SE 218,RESIDENTIAL,36000,0,36000,158400,0,194400
142212600700000,SE 218,RESIDENTIAL,36000,0,36000,158300,0,194300
142212600800000,SE 218,RESIDENTIAL,36000,0,36000,0,0,36000
142212600900000,SE 218,RESIDENTIAL,36000,0,36000,203600,0,239600
142212601000000,SE 218,RESIDENTIAL,36000,0,36000,108500,0,144500
142212601100000,SE 218,RESIDENTIAL,36000,0,36000,165300,0,201300
142212601200000,SE 218,RESIDENTIAL,36000,0,36000,114700,0,150700
142212601300000,SE 218,RESIDENTIAL,36000,0,36000,140000,0,176000
142212601400000,SE 218,RESIDENTIAL,36000,0,36000,143600,0,179600
142212601500000,SE 218,RESIDENTIAL,36000,0,36000,116900,0,152900
142212601600000,SE 218,RESIDENTIAL,36000,0,36000,146700,0,182700
142212601700000,SE 218,RESIDENTIAL,36000,0,36000,101000,0,137000
142212601800000,SE 218,RESIDENTIAL,36000,0,36000,112800,0,148800
142212601900000,SE 218,RESIDENTIAL,36000,0,36000,122700,0,158700
142212602000000,SE 218,RESIDENTIAL,36000,0,36000,115000,0,151000
142212700100000,SE 218,RESIDENTIAL,60000,0,60000,216000,0,276000
142212700200000,SE 218,RESIDENTIAL,50500,0,50500,215300,0,265800
142212700300000,SE 218,RESIDENTIAL,50300,0,50300,212600,0,262900
142212700700000,OFFICE,COMMERCIAL,0,58800,58800,0,84800,143600
142212700800000,SE 218,RESIDENTIAL,36000,0,36000,156100,0,192100
142212700900000,SE 218,RESIDENTIAL,36000,0,36000,71700,0,107700
142212701000000,SE 218,RESIDENTIAL,36000,0,36000,161600,0,197600
142212701100000,SE 218,RESIDENTIAL,36000,0,36000,129200,0,165200
142212701300000,OFFICE; MEDICAL,COMMERCIAL,0,288000,288000,0,1045900,1333900
142212800100000,OFFICE,COMMERCIAL,0,105000,105000,0,130100,235100
142212900100000,SE 217,RESIDENTIAL,13700,0,13700,77500,0,91200
142212900200000,SE 217,RESIDENTIAL,21600,0,21600,71100,0,92700
142212900300000,SE 217,RESIDENTIAL,11900,0,11900,74300,0,86200
142212900400000,SE 217,RESIDENTIAL,7800,0,7800,91400,0,99200
142212900500000,SE 217,RESIDENTIAL,12600,0,12600,70400,0,83000
142212900600000,SE 217,RESIDENTIAL,30700,0,30700,90100,0,120800
142212900700000,SE 217,RESIDENTIAL,23200,0,23200,86600,0,109800
142212900800000,SE 217,RESIDENTIAL,16400,0,16400,88400,0,104800
142212900900000,SE 217,RESIDENTIAL,24000,0,24000,112052,0,136052
142212901000000,SE 217,RESIDENTIAL,9900,0,9900,73200,0,83100
142213000100000,SE 218,RESIDENTIAL,30600,0,30600,106600,0,137200
142213000200000,SE 218,RESIDENTIAL,24000,0,24000,97300,0,121300
142213000300000,SE 218,RESIDENTIAL,24000,0,24000,111900,0,135900
142213000400000,SE 218,RESIDENTIAL,24000,0,24000,82500,0,106500
142213000500000,SE 218,RESIDENTIAL,24000,0,24000,82400,0,106400
142213000600000,SE 218,RESIDENTIAL,24000,0,24000,97600,0,121600
142213000700000,SE 218,RESIDENTIAL,24000,0,24000,104600,0,128600
142213000800000,SE 218,RESIDENTIAL,24000,0,24000,139600,0,163600
142213000900000,CONVERSION-CENT CORE,MULTI-RES,24000,0,24000,47500,0,71500
142213001000000,SE 218,RESIDENTIAL,24000,0,24000,112200,0,136200
142213001100000,SE 218,RESIDENTIAL,24000,0,24000,149400,0,173400
142213001200000,SE 218,RESIDENTIAL,24000,0,24000,119600,0,143600
142213001300000,SE 218,RESIDENTIAL,24000,0,24000,82100,0,106100
142213001400000,SE 218,RESIDENTIAL,24000,0,24000,105100,0,129100
142213001500000,SE 218,RESIDENTIAL,24000,0,24000,115400,0,139400
142213001600000,SE 218,RESIDENTIAL,24000,0,24000,86700,0,110700
142213100100000,SE 218,EXEMPT,0,28000,28000,0,143200,171200
142213100200000,BRANCH BANK/CU,COMMERCIAL,0,231300,231300,0,777300,1008600
142213100300000,OFFICE,COMMERCIAL,0,173600,173600,0,770900,944500
142213100400000,FLAT PARKING,COMMERCIAL,0,57900,57900,0,3700,61600
142213100500000,SE 218,RESIDENTIAL,28000,0,28000,144500,0,172500
142213100600000,SE 218,RESIDENTIAL,20000,0,20000,101300,0,121300
142213100700000,SE 218,RESIDENTIAL,24000,0,24000,101200,0,125200
142213100800000,SE 218,RESIDENTIAL,24000,0,24000,124100,0,148100
142213100900000,SE 218,RESIDENTIAL,24000,0,24000,157000,0,181000
142213101000000,SE 218,RESIDENTIAL,22000,0,22000,110400,0,132400
142213101100000,SE 218,RESIDENTIAL,22000,0,22000,132600,0,154600
142213200100000,SE 231,RESIDENTIAL,17500,0,17500,110800,0,128300
142213200400000,SE 217,RESIDENTIAL,7600,0,7600,72200,0,79800
142213200500000,SE 217,RESIDENTIAL,8500,0,8500,79200,0,87700
142213200600000,SE 217,RESIDENTIAL,12500,0,12500,80600,0,93100
142213300100000,SE 217,RESIDENTIAL,19900,0,19900,95400,0,115300
142213300200000,SE 217,RESIDENTIAL,24000,0,24000,84400,0,108400
142213300300000,SE 217,RESIDENTIAL,16000,0,16000,99400,0,115400
142213300400000,SE 217,RESIDENTIAL,16000,0,16000,75700,0,91700
142213300500000,SE 217,RESIDENTIAL,16000,0,16000,71400,0,87400
142213300600000,SE 217,RESIDENTIAL,24000,0,24000,36400,0,60400
142213300700000,SE 217,RESIDENTIAL,24000,0,24000,76300,0,100300
142213300800000,SE 217,RESIDENTIAL,21100,0,21100,119800,0,140900
142213300900000,SE 217,RESIDENTIAL,12400,0,12400,58400,0,70800
142213301000000,SE 217,RESIDENTIAL,14900,0,14900,73900,0,88800
142213301100000,SE 217,RESIDENTIAL,25200,0,25200,96500,0,121700
142213301200000,SE 217,RESIDENTIAL,15000,0,15000,59900,0,74900
142213301300000,SE 217,RESIDENTIAL,15000,0,15000,61000,0,76000
142213301400000,SE 217,RESIDENTIAL,19400,0,19400,86200,0,105600
142213301500000,SE 217,RESIDENTIAL,600,0,600,5800,0,6400
142213301600000,SE 217,RESIDENTIAL,20000,0,20000,57200,0,77200
142213301700000,SE 217,RESIDENTIAL,20000,0,20000,87300,0,107300
142213301800000,SE 217,RESIDENTIAL,20000,0,20000,63000,0,83000
142213301900000,SE 217,RESIDENTIAL,22500,0,22500,85400,0,107900
142213302000000,SE 217,RESIDENTIAL,17500,0,17500,60000,0,77500
142213302100000,SE 217,RESIDENTIAL,24900,0,24900,84400,0,109300
142213302200000,SE 217,RESIDENTIAL,12400,0,12400,69900,0,82300
142213302300000,SE 217,RESIDENTIAL,12400,0,12400,88400,0,100800
142213400100000,SE 217,RESIDENTIAL,8700,0,8700,63500,0,72200
142213400200000,SE 217,RESIDENTIAL,8600,0,8600,66500,0,75100
142213400300000,SE 217,RESIDENTIAL,8300,0,8300,59000,0,67300
142213400700000,SE 217,RESIDENTIAL,13200,0,13200,64000,0,77200
142213400800000,SE 217,RESIDENTIAL,20000,0,20000,83900,0,103900
142213400900000,SE 217,RESIDENTIAL,20000,0,20000,77000,0,97000
142213401000000,SE 217,RESIDENTIAL,22100,0,22100,113200,0,135300
142213401100000,SE 217,RESIDENTIAL,17500,0,17500,61300,0,78800
142213401200000,SE 217,RESIDENTIAL,8800,0,8800,64200,0,73000
142213500100000,SE 231,RESIDENTIAL,8400,0,8400,61900,0,70300
142213500200000,SE 231,RESIDENTIAL,9300,0,9300,31700,0,41000
142213500300000,SE 231,RESIDENTIAL,9300,0,9300,33800,0,43100
142213500400000,CONVERSION-CENT CORE,MULTI-RES,8400,0,8400,45700,0,54100
142213500500000,CONVERSION-CENT CORE,MULTI-RES,29400,0,29400,84400,0,113800
142213500600000,CONVERSION-CENT CORE,EXEMPT,0,14000,14000,0,72100,86100
142213500700000,SE 231,RESIDENTIAL,17500,0,17500,28400,0,45900
142213500800000,SE 231,RESIDENTIAL,14000,0,14000,60200,0,74200
142213500900000,CONVERSION-CENT CORE,MULTI-RES,12000,0,12000,57600,0,69600
142213501000000,SE 231,RESIDENTIAL,12000,0,12000,47800,0,59800
142213501100000,SE 231,RESIDENTIAL,12000,0,12000,62400,0,74400
142213501200000,SE 231,RESIDENTIAL,12000,0,12000,57800,0,69800
142213501300000,SE 231,RESIDENTIAL,12000,0,12000,59700,0,71700
142213501400000,SE 231,RESIDENTIAL,12000,0,12000,82300,0,94300
142213501500000,SE 231,RESIDENTIAL,12000,0,12000,0,0,12000
142213501600000,SE 231,RESIDENTIAL,8400,0,8400,60700,0,69100
142213600100000,SE 217,RESIDENTIAL,21200,0,21200,63600,0,84800
142213600200000,SE 217,RESIDENTIAL,9300,0,9300,81300,0,90600
142213600300000,SE 217,RESIDENTIAL,25000,0,25000,76600,0,101600
142213600400000,SE 217,RESIDENTIAL,20000,0,20000,77300,0,97300
142213600500000,SE 217,RESIDENTIAL,20000,0,20000,78500,0,98500
142213600600000,SE 217,RESIDENTIAL,20000,0,20000,76600,0,96600
142213600700000,SE 217,RESIDENTIAL,20000,0,20000,79800,0,99800
142213600800000,SE 217,RESIDENTIAL,20000,0,20000,78800,0,98800
142213600900000,SE 217,RESIDENTIAL,24200,0,24200,83200,0,107400
142213601000000,SE 217,RESIDENTIAL,19400,0,19400,61700,0,81100
142213601100000,SE 217,RESIDENTIAL,17500,0,17500,63900,0,81400
142213700100000,SE 217,RESIDENTIAL,19300,0,19300,80100,0,99400
142213700200000,SE 217,RESIDENTIAL,18800,0,18800,71300,0,90100
142213700300000,SE 217,RESIDENTIAL,25500,0,25500,76500,0,102000
142213700400000,SE 217,RESIDENTIAL,20000,0,20000,82100,0,102100
142213700500000,SE 217,RESIDENTIAL,25000,0,25000,77100,0,102100
142213700600000,SE 217,RESIDENTIAL,22500,0,22500,82000,0,104500
142213700700000,SE 217,RESIDENTIAL,20800,0,20800,65700,0,86500
142213700800000,SE 217,RESIDENTIAL,17400,0,17400,68800,0,86200
142213700900000,SE 217,RESIDENTIAL,20700,0,20700,48400,0,69100
142213800100000,SE 217,RESIDENTIAL,17200,0,17200,42200,0,59400
142213800200000,SE 217,RESIDENTIAL,9000,0,9000,55200,0,64200
142215100100000,SE 217,RESIDENTIAL,9300,0,9300,66800,0,76100
142215100200000,SE 217,RESIDENTIAL,21200,0,21200,78900,0,100100
142215100300000,SE 217,RESIDENTIAL,20000,0,20000,91500,0,111500
142215100400000,SE 217,RESIDENTIAL,20000,0,20000,75900,0,95900
142215100500000,SE 217,RESIDENTIAL,20000,0,20000,86800,0,106800
142215100600000,SE 217,RESIDENTIAL,20000,0,20000,73200,0,93200
142215100700000,SE 217,RESIDENTIAL,20000,0,20000,75200,0,95200
142215100800000,SE 217,RESIDENTIAL,20000,0,20000,48100,0,68100
142215100900000,SE 217,RESIDENTIAL,24500,0,24500,95300,0,119800
142215101000000,SE 217,RESIDENTIAL,17900,0,17900,72200,0,90100
142215101100000,SE 217,RESIDENTIAL,19400,0,19400,73300,0,92700
142215200100000,SE 217,RESIDENTIAL,16000,0,16000,73800,0,89800
142215200200000,SE 217,RESIDENTIAL,1200,0,1200,0,0,1200
142215200300000,SE 217,RESIDENTIAL,19900,0,19900,80800,0,100700
142215200400000,SE 217,RESIDENTIAL,19400,0,19400,77200,0,96600
142215200500000,SE 217,RESIDENTIAL,20000,0,20000,83500,0,103500
142215200600000,SE 217,RESIDENTIAL,20000,0,20000,71100,0,91100
142215200700000,SE 217,RESIDENTIAL,20000,0,20000,77600,0,97600
142215200800000,SE 217,RESIDENTIAL,20000,0,20000,83700,0,103700
142215200900000,SE 217,RESIDENTIAL,25000,0,25000,102800,0,127800
142215201000000,SE 217,RESIDENTIAL,15800,0,15800,75200,0,91000
142215201100000,SE 217,RESIDENTIAL,19400,0,19400,101600,0,121000
142215300100000,SE 217,RESIDENTIAL,21300,0,21300,86500,0,107800
142215300200000,SE 217,RESIDENTIAL,14000,0,14000,76200,0,90200
142215300300000,SE 217,RESIDENTIAL,14000,0,14000,80300,0,94300
142215300400000,SE 217,RESIDENTIAL,20000,0,20000,47100,0,67100
142215300500000,SE 217,RESIDENTIAL,8900,0,8900,71100,0,80000
142215300600000,SE 217,RESIDENTIAL,17900,0,17900,84200,0,102100
142215300700000,SE 217,RESIDENTIAL,21900,0,21900,21800,0,43700
142215300800000,SE 217,RESIDENTIAL,8700,0,8700,68800,0,77500
142215400100000,SE 217,RESIDENTIAL,39200,0,39200,125400,0,164600
142215400200000,SE 217,RESIDENTIAL,24000,0,24000,77500,0,101500
142215400300000,SE 217,RESIDENTIAL,21000,0,21000,92400,0,113400
142215400400000,SE 217,RESIDENTIAL,20000,0,20000,90200,0,110200
142215400500000,SE 217,RESIDENTIAL,20000,0,20000,88300,0,108300
142215400600000,SE 217,RESIDENTIAL,25500,0,25500,85700,0,111200
142215400700000,SE 217,RESIDENTIAL,20000,0,20000,86300,0,106300
142215400800000,SE 217,RESIDENTIAL,12300,0,12300,49800,0,62100
142215400900000,SE 217,RESIDENTIAL,15800,0,15800,68200,0,84000
142215401000000,SE 217,RESIDENTIAL,15200,0,15200,43500,0,58700
142215401100000,SE 217,RESIDENTIAL,11400,0,11400,68300,0,79700
142215401200000,SE 217,RESIDENTIAL,13300,0,13300,49400,0,62700
142215401300000,SE 217,RESIDENTIAL,13300,0,13300,62800,0,76100
142215401400000,SE 217,RESIDENTIAL,15800,0,15800,69300,0,85100
142215401500000,SE 217,RESIDENTIAL,12300,0,12300,36600,0,48900
142215401600000,SE 217,RESIDENTIAL,20000,0,20000,67100,0,87100
142215401700000,SE 217,RESIDENTIAL,20000,0,20000,76100,0,96100
142215401800000,SE 217,RESIDENTIAL,20000,0,20000,52000,0,72000
142215401900000,SE 217,RESIDENTIAL,15000,0,15000,54700,0,69700
142215402000000,SE 217,RESIDENTIAL,25000,0,25000,91900,0,116900
142215402100000,SE 217,RESIDENTIAL,20000,0,20000,55700,0,75700
142215402200000,SE 217,RESIDENTIAL,20000,0,20000,92800,0,112800
142215402300000,SE 217,RESIDENTIAL,10800,0,10800,67300,0,78100
142215402400000,SE 217,RESIDENTIAL,10500,0,10500,35100,0,45600
142215402500000,SE 217,RESIDENTIAL,5600,0,5600,46800,0,52400
142215402600000,SE 217,RESIDENTIAL,7400,0,7400,25400,0,32800
142215402700000,SE 217,RESIDENTIAL,7400,0,7400,71200,0,78600
142215500100000,SE 217,RESIDENTIAL,16200,0,16200,102500,0,118700
142215500200000,SE 217,RESIDENTIAL,15100,0,15100,82800,0,97900
142215500300000,SE 217,RESIDENTIAL,20000,0,20000,75700,0,95700
142215500400000,SE 217,RESIDENTIAL,20000,0,20000,84600,0,104600
142215500500000,SE 217,RESIDENTIAL,20000,0,20000,41800,0,61800
142215500600000,SE 217,RESIDENTIAL,20000,0,20000,92800,0,112800
142215500700000,SE 217,RESIDENTIAL,20000,0,20000,84100,0,104100
142215500800000,SE 217,RESIDENTIAL,14600,0,14600,52600,0,67200
142215500900000,SE 217,RESIDENTIAL,14600,0,14600,98500,0,113100
142215501000000,SE 217,RESIDENTIAL,12400,0,12400,39100,0,51500
142215501100000,SE 217,RESIDENTIAL,12400,0,12400,55100,0,67500
142215501200000,SE 217,RESIDENTIAL,12300,0,12300,68700,0,81000
142215501300000,SE 217,RESIDENTIAL,12300,0,12300,49600,0,61900
142215501400000,SE 217,RESIDENTIAL,14000,0,14000,63800,0,77800
142215501500000,SE 217,RESIDENTIAL,10500,0,10500,58700,0,69200
142215501600000,SE 217,RESIDENTIAL,15000,0,15000,68900,0,83900
142215501700000,SE 217,RESIDENTIAL,20000,0,20000,58000,0,78000
142215501800000,SE 217,RESIDENTIAL,20000,0,20000,80300,0,100300
142215501900000,SE 217,RESIDENTIAL,20000,0,20000,72600,0,92600
142215502000000,SE 217,RESIDENTIAL,20000,0,20000,79400,0,99400
142215502100000,SE 217,RESIDENTIAL,20000,0,20000,75100,0,95100
142215502200000,SE 217,RESIDENTIAL,11400,0,11400,67400,0,78800
142215502300000,SE 217,RESIDENTIAL,11400,0,11400,61700,0,73100
142215502400000,SE 217,RESIDENTIAL,11700,0,11700,52900,0,64600
142215502500000,SE 217,RESIDENTIAL,11700,0,11700,36800,0,48500
142215502600000,SE 217,RESIDENTIAL,13000,0,13000,49600,0,62600
142215502700000,SE 217,RESIDENTIAL,13300,0,13300,59000,0,72300
142215600100000,APARTMENT,MULTI-RES,23800,0,23800,148600,0,172400
142215600200000,SE 231,RESIDENTIAL,14000,0,14000,64300,0,78300
142215600300000,SE 231,RESIDENTIAL,14000,0,14000,59800,0,73800
142215600400000,SE 231,RESIDENTIAL,14000,0,14000,61500,0,75500
142215600500000,SE 231,RESIDENTIAL,14000,0,14000,67600,0,81600
142215600600000,SE 231,RESIDENTIAL,14000,0,14000,61600,0,75600
142215600700000,APARTMENT,MULTI-RES,16800,0,16800,139500,0,156300
142215600800000,SE 231,RESIDENTIAL,9800,0,9800,71600,0,81400
142215600900000,SE 231,RESIDENTIAL,12800,0,12800,60900,0,73700
142215601000000,SE 231,RESIDENTIAL,17400,0,17400,30500,0,47900
142215601100000,SE 231,RESIDENTIAL,13200,0,13200,62700,0,75900
142215601200000,SE 231,RESIDENTIAL,14000,0,14000,68600,0,82600
142215601300000,SE 231,RESIDENTIAL,14000,0,14000,62400,0,76400
142215601400000,SE 231,RESIDENTIAL,14000,0,14000,72600,0,86600
142215601500000,SE 231,RESIDENTIAL,14000,0,14000,52200,0,66200
142215601600000,SE 231,RESIDENTIAL,14000,0,14000,56000,0,70000
142215601700000,SE 231,RESIDENTIAL,13500,0,13500,55700,0,69200
142215601800000,SE 231,RESIDENTIAL,8200,0,8200,46800,0,55000
142215601900000,SE 231,RESIDENTIAL,8200,0,8200,26773,0,34973
142215700100000,CHURCH,EXEMPT,0,28000,28000,0,284900,312900
142215700200000,SE 217,RESIDENTIAL,20000,0,20000,70500,0,90500
142215700300000,SE 217,RESIDENTIAL,20000,0,20000,79100,0,99100
142215700400000,SE 217,RESIDENTIAL,20000,0,20000,70900,0,90900
142215700500000,SE 217,RESIDENTIAL,25000,0,25000,63500,0,88500
142215700600000,SE 217,RESIDENTIAL,20000,0,20000,89100,0,109100
142215700700000,SE 217,RESIDENTIAL,20000,0,20000,59400,0,79400
142215700800000,SE 217,RESIDENTIAL,14000,0,14000,47300,0,61300
142215700900000,SE 217,RESIDENTIAL,10500,0,10500,50800,0,61300
142215701000000,SCHOOL,EXEMPT,0,0,0,0,0,0
142215701100000,SCHOOL,EXEMPT,0,0,0,0,0,0
142215701200000,SE 217,RESIDENTIAL,10100,0,10100,49200,0,59300
142215701300000,SE 217,RESIDENTIAL,18600,0,18600,55600,0,74200
142215701400000,SE 217,RESIDENTIAL,15000,0,15000,54600,0,69600
142215701500000,SE 217,RESIDENTIAL,15000,0,15000,58800,0,73800
142215701600000,SE 217,RESIDENTIAL,20000,0,20000,78400,0,98400
142215701700000,SE 217,RESIDENTIAL,20000,0,20000,66600,0,86600
142215701800000,SE 217,RESIDENTIAL,20000,0,20000,68300,0,88300
142215701900000,SE 217,RESIDENTIAL,20000,0,20000,70000,0,90000
142215702000000,SE 217,RESIDENTIAL,20000,0,20000,61400,0,81400
142215702100000,SE 217,RESIDENTIAL,20000,0,20000,73200,0,93200
142215702200000,SE 217,RESIDENTIAL,10500,0,10500,65100,0,75600
142215702300000,SE 217,RESIDENTIAL,10500,0,10500,66800,0,77300
142215702400000,SE 217,RESIDENTIAL,6500,0,6500,44000,0,50500
142215702500000,SE 217,RESIDENTIAL,6500,0,6500,35300,0,41800
142215800100000,SCHOOL,EXEMPT,0,0,0,0,0,0
142215900100000,SE 231,RESIDENTIAL,8300,0,8300,47400,0,55700
142215900200000,SE 231,RESIDENTIAL,8300,0,8300,52300,0,60600
142215900300000,SE 231,RESIDENTIAL,14000,0,14000,60300,0,74300
142215900400000,SE 231,RESIDENTIAL,21000,0,21000,61500,0,82500
142215900500000,SE 231,RESIDENTIAL,17900,0,17900,65000,0,82900
142215900600000,SE 231,RESIDENTIAL,14000,0,14000,66300,0,80300
142215900700000,SE 231,RESIDENTIAL,14000,0,14000,81200,0,95200
142215900800000,SE 231,RESIDENTIAL,11100,0,11100,58600,0,69700
142215900900000,SE 231,RESIDENTIAL,8700,0,8700,50600,0,59300
142215901000000,SE 231,RESIDENTIAL,8700,0,8700,53100,0,61800
142215901100000,SE 231,EXEMPT,0,23800,23800,0,0,23800
142215901200000,SE 231,EXEMPT,0,18200,18200,0,6500,24700
142215901600000,SE 231,RESIDENTIAL,7600,0,7600,46000,0,53600
142215901700000,SE 231,RESIDENTIAL,7600,0,7600,49200,0,56800
142215901800000,CHURCH,EXEMPT,0,113800,113800,0,841600,955400
142216000100000,SE 217,RESIDENTIAL,10700,0,10700,56200,0,66900
142216000200000,SE 217,RESIDENTIAL,12100,0,12100,65600,0,77700
142216000300000,SE 217,EXEMPT,0,16600,16600,74900,0,91500
142216000400000,SE 217,RESIDENTIAL,19300,0,19300,67700,0,87000
142216000500000,SE 217,RESIDENTIAL,17000,0,17000,71400,0,88400
142216000600000,SE 217,RESIDENTIAL,17000,0,17000,57900,0,74900
142216000700000,SE 217,RESIDENTIAL,16000,0,16000,73500,0,89500
142216000800000,SE 217,RESIDENTIAL,20000,0,20000,82800,0,102800
142216000900000,SE 217,RESIDENTIAL,20000,0,20000,63900,0,83900
142216001000000,SE 217,RESIDENTIAL,20000,0,20000,54400,0,74400
142216001100000,SE 217,RESIDENTIAL,10500,0,10500,32600,0,43100
142216001200000,SE 217,RESIDENTIAL,10500,0,10500,35000,0,45500
142216001300000,SE 217,RESIDENTIAL,10900,0,10900,61600,0,72500
142216001400000,SE 217,RESIDENTIAL,10900,0,10900,66300,0,77200
142216001500000,SE 217,RESIDENTIAL,10900,0,10900,62000,0,72900
142216001600000,SE 217,RESIDENTIAL,10900,0,10900,64500,0,75400
142216001700000,SE 217,RESIDENTIAL,17900,0,17900,83400,0,101300
142216001800000,SE 217,RESIDENTIAL,20000,0,20000,100900,0,120900
142216001900000,SE 217,RESIDENTIAL,18000,0,18000,81600,0,99600
142216002000000,SE 217,RESIDENTIAL,22000,0,22000,65900,0,87900
142216002100000,SE 217,RESIDENTIAL,20000,0,20000,74200,0,94200
142216002200000,SE 217,RESIDENTIAL,20000,0,20000,68200,0,88200
142216002300000,SE 217,RESIDENTIAL,20000,0,20000,76800,0,96800
142216002400000,SE 217,RESIDENTIAL,20000,0,20000,96700,0,116700
142216002500000,SE 217,RESIDENTIAL,19800,0,19800,70100,0,89900
142216002600000,SE 217,RESIDENTIAL,14600,0,14600,71800,0,86400
142216002700000,SE 217,RESIDENTIAL,10300,0,10300,58700,0,69000
142216002800000,SE 217,RESIDENTIAL,7600,0,7600,52300,0,59900
142216002900000,SE 217,RESIDENTIAL,8100,0,8100,82800,0,90900
142216100100000,CONVERSION-CENT CORE,MULTI-RES,18800,0,18800,30800,0,49600
142216100200000,SE 217,RESIDENTIAL,20000,0,20000,80200,0,100200
142216100300000,SE 217,RESIDENTIAL,20000,0,20000,72500,0,92500
142216100400000,SE 217,RESIDENTIAL,20000,0,20000,103300,0,123300
142216100500000,SE 217,RESIDENTIAL,20000,0,20000,80400,0,100400
142216100600000,SE 217,RESIDENTIAL,20000,0,20000,67400,0,87400
142216100700000,SE 217,RESIDENTIAL,20000,0,20000,116800,0,136800
142216100800000,SE 217,RESIDENTIAL,15700,0,15700,52000,0,67700
142216100900000,SE 217,RESIDENTIAL,12400,0,12400,50300,0,62700
142216101000000,SE 217,RESIDENTIAL,12400,0,12400,69800,0,82200
142216101100000,SE 217,RESIDENTIAL,11000,0,11000,69600,0,80600
142216101200000,SE 217,RESIDENTIAL,25700,0,25700,70300,0,96000
142216101300000,SE 217,RESIDENTIAL,20000,0,20000,85500,0,105500
142216101400000,SE 217,RESIDENTIAL,20000,0,20000,82900,0,102900
142216101500000,SE 217,EXEMPT,0,20000,20000,0,70600,90600
142216101600000,SE 217,RESIDENTIAL,20000,0,20000,108800,0,128800
142216101700000,SE 217,RESIDENTIAL,17500,0,17500,94400,0,111900
142216101800000,SE 217,RESIDENTIAL,25300,0,25300,99400,0,124700
142216101900000,SE 217,RESIDENTIAL,16200,0,16200,67900,0,84100
142216102000000,SE 217,RESIDENTIAL,13600,0,13600,68000,0,81600
142216102100000,SE 217,RESIDENTIAL,11900,0,11900,72200,0,84100
142216102200000,SE 217,RESIDENTIAL,11700,0,11700,75800,0,87500
142216102300000,SE 217,RESIDENTIAL,11700,0,11700,54900,0,66600
142216200100000,SE 231,RESIDENTIAL,12000,0,12000,70300,0,82300
142216200200000,SE 231,RESIDENTIAL,14000,0,14000,50000,0,64000
142216200300000,SE 231,RESIDENTIAL,14000,0,14000,58700,0,72700
142216200400000,SE 231,RESIDENTIAL,14000,0,14000,52000,0,66000
142216200500000,SE 231,RESIDENTIAL,14000,0,14000,42400,0,56400
142216200600000,SE 231,RESIDENTIAL,14000,0,14000,45800,0,59800
142216200700000,SE 231,RESIDENTIAL,14000,0,14000,50900,0,64900
142216200800000,SE 231,RESIDENTIAL,12500,0,12500,29900,0,42400
142216200900000,SE 231,RESIDENTIAL,7600,0,7600,42100,0,49700
142216201000000,SE 231,RESIDENTIAL,7600,0,7600,49400,0,57000
142216201100000,SE 231,RESIDENTIAL,10900,0,10900,48000,0,58900
142216201200000,SE 231,RESIDENTIAL,14800,0,14800,71200,0,86000
142216201300000,SE 231,RESIDENTIAL,17900,0,17900,61600,0,79500
142216201400000,CONVERSION-CENT CORE,MULTI-RES,17900,0,17900,51500,0,69400
142216201500000,SE 231,EXEMPT,0,14000,14000,0,46800,60800
142216201600000,SE 231,RESIDENTIAL,14000,0,14000,56900,0,70900
142216201700000,SE 231,RESIDENTIAL,14000,0,14000,63000,0,77000
142216201800000,SE 231,RESIDENTIAL,12800,0,12800,70700,0,83500
142216201900000,SE 231,RESIDENTIAL,8700,0,8700,47700,0,56400
142216202000000,SE 231,RESIDENTIAL,8200,0,8200,46100,0,54300
142216202100000,SE 231,RESIDENTIAL,9200,0,9200,25500,0,34700
142216202200000,SE 231,RESIDENTIAL,9300,0,9300,37700,0,47000
142217600100000,SE 216,RESIDENTIAL,25100,0,25100,132700,0,157800
142217600200000,SE 216,RESIDENTIAL,38400,0,38400,104000,0,142400
142217700100000,SE 216,RESIDENTIAL,37500,0,37500,78400,0,115900
142217700200000,SE 216,RESIDENTIAL,36000,0,36000,155600,0,191600
142217700300000,SE 216,RESIDENTIAL,36000,0,36000,146300,0,182300
142217700400000,SE 216,RESIDENTIAL,36000,0,36000,146200,0,182200
142217700500000,SE 216,RESIDENTIAL,36000,0,36000,147800,0,183800
142217700600000,SE 216,RESIDENTIAL,36000,0,36000,148300,0,184300
142217700700000,SE 216,RESIDENTIAL,36000,0,36000,144400,0,180400
142217700800000,SE 216,RESIDENTIAL,45000,0,45000,198400,0,243400
142217700900000,SE 216,RESIDENTIAL,39000,0,39000,168600,0,207600
142217701000000,SE 216,RESIDENTIAL,36000,0,36000,151500,0,187500
142217701100000,SE 216,RESIDENTIAL,36000,0,36000,121000,0,157000
142217701200000,SE 216,RESIDENTIAL,36000,0,36000,127700,0,163700
142217701300000,SE 216,RESIDENTIAL,36000,0,36000,122500,0,158500
142217701400000,SE 216,RESIDENTIAL,36000,0,36000,133900,0,169900
142217701500000,SE 216,RESIDENTIAL,36000,0,36000,104400,0,140400
142217701600000,SE 216,RESIDENTIAL,36000,0,36000,102400,0,138400
142217701700000,SE 216,RESIDENTIAL,36000,0,36000,116000,0,152000
142217701800000,SE 216,RESIDENTIAL,36000,0,36000,132000,0,168000
142217800100000,SE 216,RESIDENTIAL,21100,0,21100,88900,0,110000
142217800200000,SE 216,RESIDENTIAL,23300,0,23300,92600,0,115900
142217800300000,SE 216,RESIDENTIAL,22200,0,22200,92300,0,114500
142217800400000,SE 216,RESIDENTIAL,24600,0,24600,114800,0,139400
142217800500000,SE 216,RESIDENTIAL,24000,0,24000,103500,0,127500
142217800600000,SE 216,RESIDENTIAL,24000,0,24000,82000,0,106000
142217800700000,SE 216,RESIDENTIAL,22800,0,22800,88700,0,111500
142217800800000,SE 216,RESIDENTIAL,22800,0,22800,105300,0,128100
142217800900000,SE 216,RESIDENTIAL,22800,0,22800,101900,0,124700
142217801000000,SE 216,RESIDENTIAL,20400,0,20400,76400,0,96800
142217801100000,SE 216,RESIDENTIAL,21900,0,21900,125700,0,147600
142217801200000,SE 216,RESIDENTIAL,20200,0,20200,95000,0,115200
142217801300000,SE 216,RESIDENTIAL,16000,0,16000,62500,0,78500
142217801400000,SE 216,RESIDENTIAL,16000,0,16000,73400,0,89400
142217801500000,SE 216,RESIDENTIAL,16000,0,16000,87000,0,103000
142217801600000,SE 216,RESIDENTIAL,16800,0,16800,91900,0,108700
142217801700000,SE 216,RESIDENTIAL,16800,0,16800,59700,0,76500
142217801800000,SE 216,RESIDENTIAL,24000,0,24000,82800,0,106800
142217801900000,SE 216,RESIDENTIAL,24000,0,24000,104300,0,128300
142217802000000,SE 216,RESIDENTIAL,24000,0,24000,82700,0,106700
142217802100000,SE 216,RESIDENTIAL,17800,0,17800,83200,0,101000
142217802200000,SE 216,RESIDENTIAL,24000,0,24000,80700,0,104700
142217802300000,SE 216,RESIDENTIAL,24000,0,24000,90000,0,114000
142217802400000,SE 216,RESIDENTIAL,24000,0,24000,90200,0,114200
142217802500000,SE 216,RESIDENTIAL,24600,0,24600,115100,0,139700
142217802600000,SE 216,RESIDENTIAL,24000,0,24000,84400,0,108400
142217802700000,SE 216,RESIDENTIAL,16800,0,16800,48200,0,65000
142217802800000,SE 216,RESIDENTIAL,16900,0,16900,84400,0,101300
142217802900000,SE 216,RESIDENTIAL,20900,0,20900,97000,0,117900
142217803000000,SE 216,RESIDENTIAL,19900,0,19900,57800,0,77700
142217900100000,SE 216,RESIDENTIAL,20400,0,20400,92900,0,113300
142217900200000,SE 216,RESIDENTIAL,20400,0,20400,73500,0,93900
142217900300000,SE 216,RESIDENTIAL,24000,0,24000,104900,0,128900
142217900400000,SE 216,RESIDENTIAL,24000,0,24000,115400,0,139400
142217900500000,SE 216,RESIDENTIAL,21000,0,21000,88500,0,109500
142217900600000,SE 216,RESIDENTIAL,21000,0,21000,84800,0,105800
142217900700000,SE 216,RESIDENTIAL,24000,0,24000,95200,0,119200
142217900800000,SE 216,RESIDENTIAL,27000,0,27000,110000,0,137000
142217900900000,SE 216,RESIDENTIAL,27000,0,27000,102000,0,129000
142217901000000,SE 216,RESIDENTIAL,24000,0,24000,90700,0,114700
142217901100000,SE 216,RESIDENTIAL,26500,0,26500,77700,0,104200
142217901200000,SE 216,RESIDENTIAL,22800,0,22800,85300,0,108100
142217901300000,SE 216,RESIDENTIAL,28800,0,28800,113700,0,142500
142217901400000,SE 216,RESIDENTIAL,8000,0,8000,65000,0,73000
142217901500000,SE 216,RESIDENTIAL,8000,0,8000,79700,0,87700
142217901600000,SE 216,RESIDENTIAL,16800,0,16800,81900,0,98700
142217901700000,SE 216,RESIDENTIAL,16800,0,16800,88800,0,105600
142217901800000,SE 216,RESIDENTIAL,24000,0,24000,93600,0,117600
142217901900000,SE 216,RESIDENTIAL,24000,0,24000,89400,0,113400
142217902000000,SE 216,RESIDENTIAL,24000,0,24000,93400,0,117400
142217902100000,SE 216,RESIDENTIAL,24000,0,24000,87700,0,111700
142217902200000,SE 216,RESIDENTIAL,24000,0,24000,87600,0,111600
142217902300000,SE 216,RESIDENTIAL,24000,0,24000,89300,0,113300
142217902400000,SE 216,RESIDENTIAL,24000,0,24000,40500,0,64500
142217902500000,SE 216,RESIDENTIAL,24000,0,24000,105000,0,129000
142217902600000,SE 216,RESIDENTIAL,24000,0,24000,60700,0,84700
142217902700000,SE 216,RESIDENTIAL,24000,0,24000,85400,0,109400
142217902800000,SE 216,RESIDENTIAL,23100,0,23100,60200,0,83300
142217902900000,SE 216,RESIDENTIAL,16800,0,16800,75200,0,92000
142217903000000,SE 216,RESIDENTIAL,16800,0,16800,70900,0,87700
142217903100000,SE 216,RESIDENTIAL,16000,0,16000,80100,0,96100
142217903200000,SE 216,RESIDENTIAL,18100,0,18100,85000,0,103100
142217903300000,SE 216,RESIDENTIAL,19100,0,19100,86400,0,105500
142218000100000,SE 216,RESIDENTIAL,15700,0,15700,94200,0,109900
142218000200000,SE 216,RESIDENTIAL,16800,0,16800,74600,0,91400
142218000300000,SE 216,RESIDENTIAL,24000,0,24000,82200,0,106200
142218000400000,SE 216,RESIDENTIAL,24000,0,24000,74500,0,98500
142218000500000,SE 216,RESIDENTIAL,24000,0,24000,86600,0,110600
142218000600000,SE 216,RESIDENTIAL,24000,0,24000,85200,0,109200
142218000700000,SE 216,RESIDENTIAL,24000,0,24000,108500,0,132500
142218000800000,SE 216,RESIDENTIAL,24000,0,24000,60600,0,84600
142218000900000,SE 216,RESIDENTIAL,24000,0,24000,80500,0,104500
142218001000000,SE 216,RESIDENTIAL,24000,0,24000,29300,0,53300
142218001100000,SE 216,RESIDENTIAL,25500,0,25500,105600,0,131100
142218001200000,SE 216,RESIDENTIAL,16800,0,16800,67700,0,84500
142218001300000,SE 216,RESIDENTIAL,16800,0,16800,0,0,16800
142218001400000,SE 216,RESIDENTIAL,9600,0,9600,0,0,9600
142218001500000,SE 216,RESIDENTIAL,16000,0,16000,86400,0,102400
142218001600000,SE 216,RESIDENTIAL,16000,0,16000,81700,0,97700
142218001700000,SE 216,RESIDENTIAL,16000,0,16000,75000,0,91000
142218001800000,SE 216,RESIDENTIAL,16800,0,16800,86500,0,103300
142218001900000,SE 216,RESIDENTIAL,16800,0,16800,86600,0,103400
142218002000000,SE 216,RESIDENTIAL,24000,0,24000,82500,0,106500
142218002100000,SE 216,RESIDENTIAL,24000,0,24000,66500,0,90500
142218002200000,SE 216,RESIDENTIAL,21000,0,21000,78000,0,99000
142218002300000,SE 216,RESIDENTIAL,21000,0,21000,73900,0,94900
142218002400000,SE 216,RESIDENTIAL,24000,0,24000,68600,0,92600
142218002500000,SE 216,RESIDENTIAL,24000,0,24000,74800,0,98800
142218002600000,SE 216,RESIDENTIAL,24000,0,24000,56000,0,80000
142218002700000,SE 216,RESIDENTIAL,24000,0,24000,72300,0,96300
142218002800000,SE 216,RESIDENTIAL,24000,0,24000,100500,0,124500
142218002900000,SE 216,RESIDENTIAL,20100,0,20100,91600,0,111700
142218003000000,SE 216,RESIDENTIAL,19500,0,19500,93800,0,113300
142218003100000,SE 216,RESIDENTIAL,19900,0,19900,76500,0,96400
142218003200000,SE 216,RESIDENTIAL,14900,0,14900,74800,0,89700
142218003300000,SE 216,RESIDENTIAL,15100,0,15100,76200,0,91300
142218003400000,SE 216,RESIDENTIAL,16800,0,16800,84400,0,101200
142218003500000,SE 216,RESIDENTIAL,16400,0,16400,76300,0,92700
142218100100000,SE 216,RESIDENTIAL,21600,0,21600,96500,0,118100
142218100200000,SE 216,RESIDENTIAL,21600,0,21600,96400,0,118000
142218100300000,SE 216,RESIDENTIAL,24000,0,24000,97900,0,121900
142218100400000,SE 216,RESIDENTIAL,24000,0,24000,89400,0,113400
142218100500000,SE 216,RESIDENTIAL,24000,0,24000,100000,0,124000
142218100600000,SE 216,RESIDENTIAL,24000,0,24000,82000,0,106000
142218100700000,SE 216,RESIDENTIAL,24000,0,24000,87100,0,111100
142218100800000,SE 216,RESIDENTIAL,24000,0,24000,80900,0,104900
142218100900000,SE 216,RESIDENTIAL,24000,0,24000,89500,0,113500
142218101000000,SE 216,RESIDENTIAL,24000,0,24000,73200,0,97200
142218101100000,SE 216,RESIDENTIAL,24000,0,24000,96800,0,120800
142218101200000,SE 216,RESIDENTIAL,24000,0,24000,94100,0,118100
142218101300000,SE 216,RESIDENTIAL,23800,0,23800,85800,0,109600
142218101400000,SE 216,RESIDENTIAL,17000,0,17000,46600,0,63600
142218101500000,SE 216,RESIDENTIAL,16500,0,16500,81800,0,98300
142218101600000,SE 216,RESIDENTIAL,8000,0,8000,80300,0,88300
142218101700000,SE 216,RESIDENTIAL,8000,0,8000,77300,0,85300
142218101800000,SE 216,RESIDENTIAL,8000,0,8000,84700,0,92700
142218101900000,SE 216,RESIDENTIAL,21600,0,21600,81600,0,103200
142218102000000,SE 216,RESIDENTIAL,21600,0,21600,87600,0,109200
142218102100000,SE 216,RESIDENTIAL,24000,0,24000,65700,0,89700
142218102200000,SE 216,RESIDENTIAL,24000,0,24000,95500,0,119500
142218102300000,SE 216,RESIDENTIAL,24000,0,24000,86100,0,110100
142218102400000,SE 216,RESIDENTIAL,24000,0,24000,94900,0,118900
142218102500000,SE 216,RESIDENTIAL,24000,0,24000,110200,0,134200
142218102600000,SE 216,RESIDENTIAL,24000,0,24000,68000,0,92000
142218102700000,SE 216,RESIDENTIAL,24000,0,24000,98300,0,122300
142218102800000,SE 216,RESIDENTIAL,24000,0,24000,109900,0,133900
142218102900000,SE 216,RESIDENTIAL,24000,0,24000,100800,0,124800
142218103000000,SE 216,RESIDENTIAL,24000,0,24000,100900,0,124900
142218103100000,SE 216,RESIDENTIAL,24000,0,24000,69400,0,93400
142218103200000,SE 216,RESIDENTIAL,16800,0,16800,82400,0,99200
142218103300000,SE 216,RESIDENTIAL,16800,0,16800,82000,0,98800
142218103400000,SE 216,RESIDENTIAL,16000,0,16000,78700,0,94700
142218103500000,SE 216,RESIDENTIAL,16000,0,16000,92700,0,108700
142218103600000,SE 216,RESIDENTIAL,16000,0,16000,99200,0,115200
142218200100000,SE 216,RESIDENTIAL,19600,0,19600,66500,0,86100
142218200200000,SE 216,RESIDENTIAL,21600,0,21600,76400,0,98000
142218200300000,SE 216,RESIDENTIAL,24000,0,24000,93200,0,117200
142218200400000,SE 216,RESIDENTIAL,24000,0,24000,73300,0,97300
142218200500000,SE 216,RESIDENTIAL,24000,0,24000,71300,0,95300
142218200600000,SE 216,RESIDENTIAL,24000,0,24000,91200,0,115200
142218200700000,SE 216,RESIDENTIAL,24000,0,24000,103600,0,127600
142218200800000,SE 216,RESIDENTIAL,24000,0,24000,93900,0,117900
142218200900000,SE 216,RESIDENTIAL,24000,0,24000,96800,0,120800
142218201000000,SE 216,RESIDENTIAL,24000,0,24000,84700,0,108700
142218201100000,SE 216,RESIDENTIAL,25100,0,25100,84300,0,109400
142218201200000,SE 216,RESIDENTIAL,25100,0,25100,99500,0,124600
142218201300000,SE 216,RESIDENTIAL,17000,0,17000,73600,0,90600
142218201400000,SE 216,RESIDENTIAL,17000,0,17000,100400,0,117400
142218201500000,SE 216,RESIDENTIAL,16400,0,16400,60200,0,76600
142218201600000,SE 216,RESIDENTIAL,16400,0,16400,82000,0,98400
142218201700000,SE 216,RESIDENTIAL,20700,0,20700,91400,0,112100
142218201800000,SE 216,RESIDENTIAL,19600,0,19600,73100,0,92700
142218201900000,SE 216,RESIDENTIAL,20400,0,20400,102000,0,122400
142218202000000,SE 216,RESIDENTIAL,24000,0,24000,98800,0,122800
142218202100000,SE 216,RESIDENTIAL,24000,0,24000,79600,0,103600
142218202200000,SE 216,RESIDENTIAL,23900,0,23900,89800,0,113700
142218202300000,SE 216,RESIDENTIAL,24000,0,24000,124700,0,148700
142218202400000,SE 216,RESIDENTIAL,24000,0,24000,105900,0,129900
142218202500000,SE 216,RESIDENTIAL,25100,0,25100,103300,0,128400
142218202600000,SE 216,RESIDENTIAL,24000,0,24000,97000,0,121000
142218202700000,SE 216,RESIDENTIAL,24000,0,24000,113600,0,137600
142218202800000,SE 216,RESIDENTIAL,24000,0,24000,97600,0,121600
142218202900000,SE 216,RESIDENTIAL,24000,0,24000,107000,0,131000
142218203000000,SE 216,RESIDENTIAL,22300,0,22300,93200,0,115500
142218203100000,SE 216,RESIDENTIAL,21700,0,21700,133200,0,154900
142218203200000,SE 216,RESIDENTIAL,17100,0,17100,53000,0,70100
142218203300000,SE 216,RESIDENTIAL,16600,0,16600,101400,0,118000
142218300100000,SE 216,RESIDENTIAL,17900,0,17900,94900,0,112800
142218300200000,CHURCH,EXEMPT,0,44800,44800,0,131200,176000
142218300300000,SE 216,EXEMPT,0,17500,17500,0,63600,81100
142218300400000,SE 216,RESIDENTIAL,30000,0,30000,85000,0,115000
142218300500000,SE 216,RESIDENTIAL,25500,0,25500,89900,0,115400
142218300600000,SE 216,RESIDENTIAL,25500,0,25500,82700,0,108200
142218300700000,SE 216,RESIDENTIAL,24000,0,24000,96900,0,120900
142218300800000,SE 216,RESIDENTIAL,24000,0,24000,89500,0,113500
142218300900000,SE 216,RESIDENTIAL,24000,0,24000,88600,0,112600
142218301000000,SE 216,RESIDENTIAL,24000,0,24000,78400,0,102400
142218301100000,SE 216,RESIDENTIAL,16800,0,16800,73500,0,90300
142218301200000,SE 216,RESIDENTIAL,16800,0,16800,85800,0,102600
142218301300000,SE 216,RESIDENTIAL,8000,0,8000,97100,0,105100
142218301400000,SE 216,RESIDENTIAL,8000,0,8000,100200,0,108200
142218301500000,SE 216,RESIDENTIAL,8000,0,8000,60800,0,68800
142218301600000,SE 216,RESIDENTIAL,8000,0,8000,83500,0,91500
142218301700000,SE 216,RESIDENTIAL,16800,0,16800,102800,0,119600
142218301800000,SE 216,RESIDENTIAL,16800,0,16800,64300,0,81100
142218301900000,SE 216,RESIDENTIAL,24000,0,24000,53200,0,77200
142218302000000,SE 216,RESIDENTIAL,24000,0,24000,112600,0,136600
142218302100000,SE 216,RESIDENTIAL,24000,0,24000,93900,0,117900
142218302200000,SE 216,RESIDENTIAL,24300,0,24300,90300,0,114600
142218302300000,SE 216,RESIDENTIAL,24000,0,24000,84500,0,108500
142218302400000,SE 216,RESIDENTIAL,21000,0,21000,72400,0,93400
142218302500000,SE 216,RESIDENTIAL,24000,0,24000,84700,0,108700
142218302600000,SE 216,RESIDENTIAL,25500,0,25500,101600,0,127100
142218302700000,SE 216,RESIDENTIAL,25500,0,25500,73100,0,98600
142218302800000,SE 216,RESIDENTIAL,27000,0,27000,93800,0,120800
142218302900000,SE 216,RESIDENTIAL,16800,0,16800,73900,0,90700
142218303000000,SE 216,RESIDENTIAL,16800,0,16800,92800,0,109600
142218303100000,SE 216,RESIDENTIAL,16000,0,16000,95500,0,111500
142218303200000,SE 216,RESIDENTIAL,16000,0,16000,83800,0,99800
142218303300000,SE 216,RESIDENTIAL,16000,0,16000,102000,0,118000
142218303400000,SE 216,RESIDENTIAL,18500,0,18500,91900,0,110400
142220100100000,APARTMENT,MULTI-RES,30000,0,30000,108100,0,138100
142220100200000,NE 155,RESIDENTIAL,12800,0,12800,53200,0,66000
142220100300000,NE 155,RESIDENTIAL,12800,0,12800,39500,0,52300
142220100400000,NE 155,RESIDENTIAL,10200,0,10200,49100,0,59300
142220100500000,NE 155,RESIDENTIAL,10200,0,10200,49700,0,59900
142220100600000,NE 155,RESIDENTIAL,10200,0,10200,67100,0,77300
142220100700000,NE 155,RESIDENTIAL,10200,0,10200,53600,0,63800
142220100800000,NE 155,RESIDENTIAL,10200,0,10200,57700,0,67900
142220100900000,NE 155,RESIDENTIAL,13000,0,13000,48200,0,61200
142220101000000,NE 155,RESIDENTIAL,10200,0,10200,37300,0,47500
142220101100000,NE 155,RESIDENTIAL,5400,0,5400,48600,0,54000
142220101200000,NE 155,RESIDENTIAL,6900,0,6900,25900,0,32800
142220101300000,CONVERSION-CENT CORE,MULTI-RES,17600,0,17600,38200,0,55800
142220101400000,CONVERSION-CENT CORE,MULTI-RES,17600,0,17600,45900,0,63500
142220101500000,OFFICE; MEDICAL,COMMERCIAL,0,206700,206700,0,668100,874800
142220101600000,OFFICE; MEDICAL,COMMERCIAL,0,309000,309000,0,1445800,1754800
142220200100000,NE 155,RESIDENTIAL,12500,0,12500,57300,0,69800
142220200200000,NE 155,RESIDENTIAL,12500,0,12500,53300,0,65800
142220200300000,NE 155,RESIDENTIAL,12500,0,12500,53400,0,65900
142220200400000,NE 155,RESIDENTIAL,10000,0,10000,54400,0,64400
142220200500000,NE 155,RESIDENTIAL,5300,0,5300,40700,0,46000
142220200600000,NE 155,RESIDENTIAL,5300,0,5300,19200,0,24500
142220200700000,NE 155,RESIDENTIAL,5400,0,5400,45300,0,50700
142220200800000,NE 155,RESIDENTIAL,5400,0,5400,50100,0,55500
142220200900000,NE 155,RESIDENTIAL,12500,0,12500,61800,0,74300
142220300100000,NE 156,RESIDENTIAL,10500,0,10500,37900,0,48400
142220300200000,NE 156,RESIDENTIAL,12000,0,12000,30400,0,42400
142220300300000,NE 156,RESIDENTIAL,12000,0,12000,28600,0,40600
142220300400000,NE 156,RESIDENTIAL,11000,0,11000,35600,0,46600
142220300500000,NE 156,RESIDENTIAL,11000,0,11000,29400,0,40400
142220300600000,NE 156,RESIDENTIAL,4600,0,4600,20500,0,25100
142220300700000,NE 156,RESIDENTIAL,8300,0,8300,32200,0,40500
142220300800000,NE 156,RESIDENTIAL,10800,0,10800,47500,0,58300
142220300900000,NE 156,RESIDENTIAL,16500,0,16500,42700,0,59200
142220301000000,NE 156,RESIDENTIAL,13800,0,13800,55100,0,68900
142220301100000,CONVERSION-CENT CORE,MULTI-RES,20400,0,20400,37400,0,57800
142220301200000,NE 156,RESIDENTIAL,20400,0,20400,34000,0,54400
142220301300000,NE 156,RESIDENTIAL,20400,0,20400,37600,0,58000
142220301400000,CONVERSION-CENT CORE,MULTI-RES,20400,0,20400,51400,0,71800
142220301500000,NE 156,RESIDENTIAL,20400,0,20400,47000,0,67400
142220301600000,NE 156,RESIDENTIAL,20400,0,20400,47200,0,67600
142220301700000,NE 156,RESIDENTIAL,20400,0,20400,7700,0,28100
142220302000000,NE 156,RESIDENTIAL,16300,0,16300,60600,0,76900
142220302100000,NE 156,RESIDENTIAL,20400,0,20400,60400,0,80800
142220302200000,NE 156,RESIDENTIAL,20400,0,20400,38000,0,58400
142220302300000,NE 156,RESIDENTIAL,20400,0,20400,47500,0,67900
142220302400000,NE 156,RESIDENTIAL,20400,0,20400,48900,0,69300
142220302500000,NE 156,RESIDENTIAL,20400,0,20400,56400,0,76800
142220302600000,CONVERSION-CENT CORE,MULTI-RES,20400,0,20400,67200,0,87600
142220302700000,NE 156,RESIDENTIAL,15100,0,15100,34500,0,49600
142220302800000,NE 156,RESIDENTIAL,15100,0,15100,31000,0,46100
142220302900000,NE 156,RESIDENTIAL,9900,0,9900,31000,0,40900
142220303100000,NE 156,RESIDENTIAL,21100,0,21100,80500,0,101600
142220303200000,LAUNDROMAT/CLEANERS,COMMERCIAL,18350,18350,36700,92450,87150,216300
142220400100000,NE 156,RESIDENTIAL,20800,0,20800,66700,0,87500
142220400200000,NE 156,RESIDENTIAL,19800,0,19800,45300,0,65100
142220400300000,CONVERSION-CENT CORE,MULTI-RES,20800,0,20800,33700,0,54500
142220400400000,CONVERSION-CENT CORE,MULTI-RES,20800,0,20800,31800,0,52600
142220400500000,NE 156,RESIDENTIAL,20100,0,20100,49500,0,69600
142220400600000,NE 156,RESIDENTIAL,20100,0,20100,38300,0,58400
142220400700000,NE 156,RESIDENTIAL,20100,0,20100,55200,0,75300
142220400800000,NE 156,RESIDENTIAL,18100,0,18100,37500,0,55600
142220400900000,NE 156,RESIDENTIAL,8200,0,8200,31900,0,40100
142220401000000,NE 156,RESIDENTIAL,6800,0,6800,29600,0,36400
142220401100000,NE 156,RESIDENTIAL,9100,0,9100,48000,0,57100
142220401200000,NE 156,RESIDENTIAL,14100,0,14100,31300,0,45400
142220401300000,NE 156,RESIDENTIAL,20100,0,20100,40800,0,60900
142220401400000,NE 156,RESIDENTIAL,20100,0,20100,50600,0,70700
142220401500000,NE 156,RESIDENTIAL,20100,0,20100,69300,0,89400
142220500100000,CITY PROPERTY,EXEMPT,0,0,0,0,0,0
142220500200000,NE 156,RESIDENTIAL,6600,0,6600,41200,0,47800
142220500300000,NE 156,RESIDENTIAL,6600,0,6600,9400,0,16000
142220500400000,NE 156,RESIDENTIAL,19800,0,19800,52300,0,72100
142220600100000,SE 231,RESIDENTIAL,8400,0,8400,39900,0,48300
142220600200000,SE 231,RESIDENTIAL,4600,0,4600,36800,0,41400
142220600300000,SE 231,RESIDENTIAL,8400,0,8400,36000,0,44400
142220600400000,SE 231,RESIDENTIAL,11500,0,11500,47900,0,59400
142220600500000,APARTMENT,MULTI-RES,11200,0,11200,63600,0,74800
142220600600000,SE 231,RESIDENTIAL,9000,0,9000,33800,0,42800
142220600700000,SE 231,RESIDENTIAL,9000,0,9000,36300,0,45300
142220600801000,OFFICE,COMMERCIAL,0,68600,68600,0,241700,310300
142220600801001,OFFICE,COMMERCIAL,0,68600,68600,0,240100,308700
142220600900000,OFFICE; MEDICAL,COMMERCIAL,0,137200,137200,0,129800,267000
142220601000000,CONVERSION-CENT CORE,MULTI-RES,8800,0,8800,39300,0,48100
142220601100000,SE 231,RESIDENTIAL,9800,0,9800,59700,0,69500
142220601200000,SE 231,RESIDENTIAL,14000,0,14000,77700,0,91700
142220601300000,SE 231,RESIDENTIAL,14000,0,14000,65200,0,79200
142220601400000,SE 231,RESIDENTIAL,10500,0,10500,51800,0,62300
142220601500000,SE 231,RESIDENTIAL,10500,0,10500,56800,0,67300
142220601600000,SE 231,RESIDENTIAL,14000,0,14000,40900,0,54900
142220601700000,SE 231,RESIDENTIAL,14000,0,14000,69000,0,83000
142220601800000,SE 231,RESIDENTIAL,14000,0,14000,58300,0,72300
142220601900000,SE 231,RESIDENTIAL,14000,0,14000,69900,0,83900
142220602000000,SE 231,RESIDENTIAL,14000,0,14000,62200,0,76200
142220602100000,SE 231,RESIDENTIAL,17500,0,17500,39600,0,57100
142220700100000,OFFICE; MEDICAL,COMMERCIAL,0,606600,606600,0,2439900,3046500
142220700200000,APARTMENT,MULTI-RES,15000,0,15000,81400,0,96400
142220700300000,NE 156,RESIDENTIAL,20400,0,20400,31700,0,52100
142220700400000,NE 156,RESIDENTIAL,7400,0,7400,37800,0,45200
142220700500000,NE 156,RESIDENTIAL,7400,0,7400,33700,0,41100
142220700600000,NE 156,RESIDENTIAL,9900,0,9900,47600,0,57500
142220700700000,NE 156,RESIDENTIAL,13000,0,13000,48900,0,61900
142220700800000,CONVERSION-CENT CORE,MULTI-RES,14100,0,14100,40900,0,55000
142220700900000,VACANT LAND,COMMERCIAL,0,6800,6800,0,0,6800
142220701000000,CONVERSION-CENT CORE,MULTI-RES,14100,0,14100,98300,0,112400
142220701100000,SMALL RETAIL,COMMERCIAL,0,64000,64000,0,80600,144600
142220701200000,RESTAURANT,COMMERCIAL,0,120000,120000,0,102900,222900
142220701300000,FLAT PARKING,COMMERCIAL,0,56000,56000,0,5500,61500
142220701400000,OFFICE,COMMERCIAL,33075,19425,52500,98217,57683,208400
142220800100000,NE 156,RESIDENTIAL,9900,0,9900,26800,0,36700
142220800200000,NE 156,RESIDENTIAL,12000,0,12000,25900,0,37900
142220800300000,NE 156,RESIDENTIAL,17600,0,17600,46300,0,63900
142220800400000,CONVERSION-CENT CORE,MULTI-RES,22000,0,22000,34600,0,56600
142220800500000,NE 156,RESIDENTIAL,22000,0,22000,38100,0,60100
142220800600000,NE 156,RESIDENTIAL,20400,0,20400,55200,0,75600
142220800700000,NE 156,RESIDENTIAL,20400,0,20400,55800,0,76200
142220800800000,NE 156,RESIDENTIAL,20000,0,20000,43800,0,63800
142220800900000,NE 156,RESIDENTIAL,20400,0,20400,59000,0,79400
142220801000000,NE 156,RESIDENTIAL,16000,0,16000,21900,0,37900
142220801100000,NE 156,RESIDENTIAL,16000,0,16000,40600,0,56600
142220801200000,NE 156,RESIDENTIAL,16000,0,16000,33100,0,49100
142220801300000,NE 156,RESIDENTIAL,16000,0,16000,15200,0,31200
142220801400000,NE 156,RESIDENTIAL,16000,0,16000,19200,0,35200
142220801500000,NE 156,RESIDENTIAL,16500,0,16500,31159,0,47659
142220801600000,NE 156,RESIDENTIAL,14300,0,14300,40200,0,54500
142220801700000,CONVERSION-CENT CORE,MULTI-RES,18400,0,18400,39900,0,58300
142220801800000,NE 156,RESIDENTIAL,10600,0,10600,25400,0,36000
142220801900000,NE 156,EXEMPT,0,10600,10600,0,40000,50600
142220802000000,NE 156,RESIDENTIAL,9900,0,9900,50800,0,60700
142220900200000,SE 231,RESIDENTIAL,14000,0,14000,43400,0,57400
142220900300000,SE 231,RESIDENTIAL,14000,0,14000,48900,0,62900
142220900400000,SE 231,RESIDENTIAL,15700,0,15700,31700,0,47400
142220900500000,SE 231,RESIDENTIAL,8700,0,8700,43100,0,51800
142220900600000,SE 231,RESIDENTIAL,12200,0,12200,46200,0,58400
142220900700000,APARTMENT,MULTI-RES,8400,0,8400,91800,0,100200
142221000100000,CONVERSION-CENT CORE,MULTI-RES,16700,0,16700,80700,0,97400
142221000200000,SE 231,RESIDENTIAL,9200,0,9200,45100,0,54300
142221000300000,SE 231,RESIDENTIAL,10500,0,10500,35500,0,46000
142221100100000,APARTMENT,MULTI-RES,16800,0,16800,65600,0,82400
142221100200000,CONVENIENCE STORE,COMMERCIAL,0,112000,112000,0,204700,316700
142221100300000,FLAT PARKING,COMMERCIAL,0,44800,44800,0,9600,54400
142221100400000,SMALL RETAIL,COMMERCIAL,26880,6720,33600,57100,30000,120700
142221100500000,FAST FOOD,COMMERCIAL,0,117600,117600,0,232700,350300
142221100600000,CONVERSION-CENT CORE,MULTI-RES,7600,0,7600,44300,0,51900
142221100700000,VACANT LAND,COMMERCIAL,0,14300,14300,0,0,14300
142221100800000,SE 231,RESIDENTIAL,17900,0,17900,87100,0,105000
142221100900000,CONVERSION-CENT CORE,MULTI-RES,17900,0,17900,68000,0,85900
142221101000000,CONVERSION-CENT CORE,MULTI-RES,17900,0,17900,76400,0,94300
142221200100000,SE 231,RESIDENTIAL,1500,0,1500,0,0,1500
142221200200000,SE 231,RESIDENTIAL,2800,0,2800,0,0,2800
142221200300000,SMALL RETAIL,COMMERCIAL,0,21600,21600,0,49800,71400
142221200400000,SE 231,RESIDENTIAL,11300,0,11300,21700,0,33000
142221200500000,SMALL RETAIL,COMMERCIAL,15624,27776,43400,45792,81408,170600
142221200600000,SMALL RETAIL,COMMERCIAL,0,33600,33600,0,89200,122800
142221300100000,GROCERY STORE,COMMERCIAL,0,662900,662900,0,1124186,1787086
142221300500000,FLAT PARKING,COMMERCIAL,0,60200,60200,0,5700,65900
142221300600000,FAST FOOD,COMMERCIAL,0,420000,420000,0,743000,1163000
142221300700000,FLAT PARKING,COMMERCIAL,0,22500,22500,0,12200,34700
142221300800000,FLAT PARKING,COMMERCIAL,0,22500,22500,0,4800,27300
142221300900000,CONVERSION-CENT CORE,MULTI-RES,16600,0,16600,40700,0,57300
142221301000000,SMALL RETAIL,COMMERCIAL,0,7500,7500,0,33000,40500
142221301100000,CITY PROPERTY,EXEMPT,0,0,0,0,0,0
142221301200000,SMALL RETAIL,COMMERCIAL,0,90000,90000,0,232200,322200
142221301300000,SMALL RETAIL,COMMERCIAL,6240,17760,24000,15912,45288,85200
142221301400000,SMALL RETAIL,COMMERCIAL,9600,14400,24000,25160,37740,86900
142221301500000,SMALL RETAIL,COMMERCIAL,18240,29760,48000,50521,69779,168300
142222600100000,NE 156,RESIDENTIAL,8700,0,8700,48100,0,56800
142222600200000,NE 156,RESIDENTIAL,8700,0,8700,38000,0,46700
142222600300000,NE 156,RESIDENTIAL,7400,0,7400,43300,0,50700
142222600400000,NE 156,RESIDENTIAL,20000,0,20000,35700,0,55700
142222600500000,NE 156,RESIDENTIAL,16000,0,16000,40100,0,56100
142222600600000,NE 156,RESIDENTIAL,16000,0,16000,48500,0,64500
142222600700000,NE 156,RESIDENTIAL,12000,0,12000,49300,0,61300
142222600800000,NE 156,RESIDENTIAL,12000,0,12000,48200,0,60200
142222600900000,NE 156,RESIDENTIAL,12000,0,12000,49300,0,61300
142222601000000,NE 156,RESIDENTIAL,12000,0,12000,42000,0,54000
142222601100000,NE 156,RESIDENTIAL,12000,0,12000,41200,0,53200
142222601200000,NE 156,RESIDENTIAL,12000,0,12000,32000,0,44000
142222601300000,NE 156,RESIDENTIAL,16000,0,16000,42700,0,58700
142222601400000,NE 156,RESIDENTIAL,11200,0,11200,34100,0,45300
142222601500000,NE 156,RESIDENTIAL,11200,0,11200,44000,0,55200
142222601600000,NE 156,RESIDENTIAL,10600,0,10600,36900,0,47500
142222601700000,NE 156,RESIDENTIAL,10600,0,10600,40300,0,50900
142222601800000,NE 156,RESIDENTIAL,11200,0,11200,50800,0,62000
142222601900000,CONVERSION-CENT CORE,MULTI-RES,22500,0,22500,27500,0,50000
142222602000000,NE 156,RESIDENTIAL,20000,0,20000,56400,0,76400
142222602100000,NE 156,RESIDENTIAL,13600,0,13600,36600,0,50200
142222602200000,NE 156,RESIDENTIAL,10400,0,10400,65200,0,75600
142222602300000,NE 156,RESIDENTIAL,12000,0,12000,46400,0,58400
142222602400000,NE 156,RESIDENTIAL,14000,0,14000,62800,0,76800
142222602500000,NE 156,RESIDENTIAL,14000,0,14000,52500,0,66500
142222602600000,NE 156,RESIDENTIAL,16000,0,16000,40700,0,56700
142222602700000,NE 156,RESIDENTIAL,16000,0,16000,49600,0,65600
142222602800000,NE 156,RESIDENTIAL,12000,0,12000,57400,0,69400
142222602900000,NE 156,RESIDENTIAL,12000,0,12000,36700,0,48700
142222603000000,NE 156,RESIDENTIAL,12000,0,12000,35100,0,47100
142222603100000,NE 156,RESIDENTIAL,12000,0,12000,30800,0,42800
142222603200000,NE 156,RESIDENTIAL,12000,0,12000,38700,0,50700
142222603300000,NE 156,RESIDENTIAL,12000,0,12000,37900,0,49900
142222700100000,NE 156,RESIDENTIAL,12000,0,12000,46700,0,58700
142222700200000,NE 156,RESIDENTIAL,12000,0,12000,38900,0,50900
142222700300000,NE 156,RESIDENTIAL,12000,0,12000,22800,0,34800
142222700400000,NE 156,RESIDENTIAL,8500,0,8500,38600,0,47100
142222700500000,NE 156,RESIDENTIAL,13600,0,13600,36100,0,49700
142222700600000,NE 156,RESIDENTIAL,7700,0,7700,34300,0,42000
142222800100000,SCHOOL,EXEMPT,0,668500,668500,0,262700,931200
142222900100000,NE 156,RESIDENTIAL,19200,0,19200,41800,0,61000
142223000100000,NE 156,RESIDENTIAL,11800,0,11800,12000,0,23800
142223000200000,NE 156,RESIDENTIAL,15200,0,15200,54100,0,69300
142223000300000,NE 156,RESIDENTIAL,16000,0,16000,51200,0,67200
142223000400000,NE 156,RESIDENTIAL,13800,0,13800,32900,0,46700
142223000500000,NE 156,RESIDENTIAL,13700,0,13700,38124,0,51824
142223000600000,SCHOOL,EXEMPT,0,0,0,0,0,0
142223000700000,SCHOOL,EXEMPT,0,0,0,0,0,0
142223000800000,CITY PROPERTY,EXEMPT,0,0,0,0,0,0
142223000900000,SCHOOL,EXEMPT,0,0,0,0,0,0
142223001000000,NE 156,RESIDENTIAL,12000,0,12000,37000,0,49000
142223001100000,NE 156,RESIDENTIAL,16000,0,16000,60700,0,76700
142223001200000,NE 156,RESIDENTIAL,20400,0,20400,100900,0,121300
142223100100000,NE 156,RESIDENTIAL,20900,0,20900,59500,0,80400
142223100200000,NE 156,RESIDENTIAL,20400,0,20400,50500,0,70900
142223100300000,NE 156,RESIDENTIAL,20400,0,20400,54300,0,74700
142223100400000,NE 156,RESIDENTIAL,20400,0,20400,54900,0,75300
142223100500000,NE 156,RESIDENTIAL,14900,0,14900,46800,0,61700
142223100600000,NE 156,RESIDENTIAL,8200,0,8200,48200,0,56400
142223100700000,NE 156,RESIDENTIAL,8100,0,8100,50400,0,58500
142223100800000,NE 156,RESIDENTIAL,9800,0,9800,45700,0,55500
142223100900000,NE 156,RESIDENTIAL,9800,0,9800,47100,0,56900
142223101000000,NE 156,RESIDENTIAL,15700,0,15700,45400,0,61100
142223101100000,NE 156,RESIDENTIAL,16000,0,16000,61100,0,77100
142223101200000,NE 156,RESIDENTIAL,16000,0,16000,58200,0,74200
142223200100000,APARTMENT,EXEMPT,0,12000,12000,0,70200,82200
142223200200000,NE 156,EXEMPT,0,9900,9900,0,43200,53100
142223200300000,NE 156,EXEMPT,0,26600,26600,0,0,26600
142223200400000,NE 156,EXEMPT,0,26600,26600,0,61600,88200
142223200500000,NE 156,EXEMPT,0,12000,12000,0,0,12000
142223200600000,NE 156,EXEMPT,0,12000,12000,0,0,12000
142223200700000,NE 156,EXEMPT,0,12000,12000,0,0,12000
142223200800000,NE 156,EXEMPT,0,12000,12000,0,0,12000
142223200900000,NE 156,EXEMPT,0,12000,12000,0,0,12000
142223201000000,NE 156,EXEMPT,0,12000,12000,0,0,12000
142223201100000,NE 156,EXEMPT,0,12000,12000,0,0,12000
142223201200000,NE 156,EXEMPT,0,12000,12000,0,0,12000
142223201300000,NE 156,EXEMPT,0,14200,14200,0,0,14200
142223201400000,NE 156,EXEMPT,0,12700,12700,0,0,12700
142223201500000,NE 156,EXEMPT,0,11200,11200,0,0,11200
142223201600000,NE 156,EXEMPT,0,7900,7900,0,0,7900
142223201700000,NE 156,RESIDENTIAL,14400,0,14400,34400,0,48800
142223201800000,CONVERSION-CENT CORE,MULTI-RES,24000,0,24000,50900,0,74900
142223201900000,NE 156,RESIDENTIAL,24000,0,24000,61200,0,85200
142223202000000,NE 156,RESIDENTIAL,16000,0,16000,48000,0,64000
142223202100000,NE 156,EXEMPT,0,16000,16000,0,0,16000
142223202200000,VACANT LAND,EXEMPT,0,11200,11200,0,1500,12700
142223202300000,APARTMENT,EXEMPT,0,16800,16800,0,322000,338800
142223202400000,NE 156,EXEMPT,0,12000,12000,0,0,12000
142223202500000,NE 156,RESIDENTIAL,12000,0,12000,53300,0,65300
142223202600000,NE 156,EXEMPT,0,12000,12000,0,0,12000
142223202700000,NE 156,EXEMPT,0,12000,12000,0,0,12000
142223300100000,NE 156,EXEMPT,0,8700,8700,0,0,8700
142223300200000,NE 156,EXEMPT,0,8700,8700,0,0,8700
142223300300000,NE 156,EXEMPT,0,17500,17500,0,0,17500
142223300400000,NE 156,EXEMPT,0,23500,23500,0,0,23500
142223400100000,NE 156,EXEMPT,0,8400,8400,0,0,8400
142223400200000,NE 156,EXEMPT,0,8700,8700,0,0,8700
142223400300000,NE 156,EXEMPT,0,8700,8700,0,0,8700
142223400400000,NE 156,EXEMPT,0,10600,10600,0,0,10600
142223400500000,NE 156,RESIDENTIAL,10600,0,10600,37100,0,47700
142223400600000,SMALL RETAIL,COMMERCIAL,0,8400,8400,0,38200,46600
142223400700000,NE 156,EXEMPT,0,11200,11200,0,0,11200
142223400800000,NE 156,RESIDENTIAL,16000,0,16000,41700,0,57700
142223400900000,NE 156,EXEMPT,0,12000,12000,0,0,12000
142223401000000,NE 156,EXEMPT,0,16000,16000,0,0,16000
142223401100000,NE 156,RESIDENTIAL,16000,0,16000,57600,0,73600
142223401200000,NE 156,EXEMPT,0,16000,16000,0,0,16000
142223401300000,NE 156,EXEMPT,0,82900,82900,0,0,82900
142223401600000,NE 156,RESIDENTIAL,11800,0,11800,51900,0,63700
142223402000000,NE 156,EXEMPT,0,48000,48000,0,0,48000
142223402100000,NE 156,RESIDENTIAL,20400,0,20400,56500,0,76900
142223402200000,NE 156,RESIDENTIAL,20400,0,20400,58700,0,79100
142223402300000,CONVERSION-CENT CORE,MULTI-RES,20400,0,20400,35800,0,56200
142223402400000,NE 156,EXEMPT,0,16000,16000,0,0,16000
142223402500000,NE 156,EXEMPT,0,16800,16800,0,0,16800
142223402600000,NE 156,EXEMPT,0,15200,15200,0,0,15200
142223402700000,NE 156,EXEMPT,0,8400,8400,0,0,8400
142223500100000,NE 156,RESIDENTIAL,16000,0,16000,37800,0,53800
142225100100000,CONVENIENCE STORE,COMMERCIAL,0,294000,294000,0,339800,633800
142225100200000,NE 156,EXEMPT,0,48000,48000,0,0,48000
142225100400000,NE 156,EXEMPT,0,24000,24000,0,0,24000
142225101000000,OFFICE; MEDICAL,COMMERCIAL,0,13700,13700,0,110200,123900
142225101100000,SMALL RETAIL,COMMERCIAL,0,40500,40500,0,58100,98600
142225101200000,CONVERSION-CENT CORE,MULTI-RES,24000,0,24000,65500,0,89500
142225101400000,OFFICE,COMMERCIAL,0,191500,191500,0,513100,704600
142225101600000,FLAT PARKING,EXEMPT,0,29400,29400,0,8000,37400
142225101700000,NE 156,EXEMPT,0,48000,48000,0,0,48000
142225300100000,APARTMENT,EXEMPT,0,1103300,1103300,0,2953400,4056700
142225300200000,FRATERNAL,EXEMPT,0,264500,264500,0,824000,1088500
142225300300000,APARTMENT,EXEMPT,0,462000,462000,0,977400,1439400
142225300400000,FLAT PARKING,EXEMPT,0,168000,168000,0,5000,173000
142225301200000,SMALL RETAIL,COMMERCIAL,0,126000,126000,0,242200,368200
142225301300000,VACANT LAND,COMMERCIAL,0,42000,42000,0,5000,47000
142225301500000,FAST FOOD,COMMERCIAL,0,336000,336000,0,816700,1152700
142225400100000,FAST FOOD,COMMERCIAL,0,151200,151200,0,503000,654200
142225400200000,RESTAURANT,COMMERCIAL,0,85300,85300,0,95200,180500
142225400300000,OFFICE,COMMERCIAL,0,25600,25600,0,171700,197300
142225400400000,APARTMENT,MULTI-RES,36000,0,36000,860200,0,896200
142225500100000,CONVERSION-CENT CORE,MULTI-RES,14100,0,14100,52900,0,67000
142225500200000,OFFICE; MEDICAL,COMMERCIAL,0,11800,11800,0,107500,119300
142225500300000,RESTAURANT,COMMERCIAL,0,252000,252000,0,460200,712200
142225500400000,RESTAURANT,COMMERCIAL,17640,108360,126000,29648,159152,314800
142225500500000,CARWASH,COMMERCIAL,0,126000,126000,0,120900,246900
142225500502000,BILLBOARD(BLL),COMMERCIAL,0,0,0,0,27600,27600
142225500600000,BRANCH BANK/CU,COMMERCIAL,0,201600,201600,0,509400,711000
142225500700000,OFFICE; MEDICAL,COMMERCIAL,30912,36288,67200,144026,169074,380300
142225500800000,APARTMENT,RESIDENTIAL,42000,0,42000,310000,0,352000
142225500900000,OFFICE,EXEMPT,0,84000,84000,0,292600,376600
142225600100000,APARTMENT,MULTI-RES,17600,0,17600,258900,0,276500
142225600200000,APARTMENT,MULTI-RES,16000,0,16000,188900,0,204900
142225601200000,CONVERSION-CENT CORE,MULTI-RES,10000,0,10000,31100,0,41100
142225601300000,CONVERSION-CENT CORE,MULTI-RES,13800,0,13800,42400,0,56200
142225601400000,CONVERSION-CENT CORE,MULTI-RES,12500,0,12500,37300,0,49800
142225601500000,SE 232,EXEMPT,0,12500,12500,0,38900,51400
142225601600000,FLAT PARKING,EXEMPT,0,22400,22400,0,4000,26400
142225601800000,CHURCH,EXEMPT,0,312000,312000,0,2737900,3049900
142225601900000,FLAT PARKING,EXEMPT,0,10800,10800,0,3100,13900
142225700100000,OFFICE; MEDICAL,EXEMPT,0,100800,100800,0,838300,939100
142225700200000,SMALL RETAIL,COMMERCIAL,0,100800,100800,0,104500,205300
142225700202000,BILLBOARD(BLL),COMMERCIAL,0,0,0,0,39800,39800
142225700300000,APARTMENT,EXEMPT,0,168000,168000,0,1005100,1173100
142225700400000,FLAT PARKING,COMMERCIAL,0,70000,70000,0,5600,75600
142225700500000,OFFICE,COMMERCIAL,0,140000,140000,0,107700,247700
142225700600000,SMALL RETAIL,COMMERCIAL,0,84000,84000,0,259500,343500
142225700700000,SMALL RETAIL,COMMERCIAL,0,61000,61000,0,239200,300200
142225700800000,OFFICE,COMMERCIAL,0,51000,51000,0,133200,184200
142225700900000,OFFICE,COMMERCIAL,0,42000,42000,0,80700,122700
142225701000000,SMALL RETAIL,COMMERCIAL,34300,35700,70000,45815,47685,163500
142225701100000,SE 231,RESIDENTIAL,26000,0,26000,124300,0,150300
142225701200000,FLAT PARKING,EXEMPT,0,33600,33600,0,5800,39400
142225800100000,FLAT PARKING,COMMERCIAL,0,74100,74100,0,6200,80300
142227600100000,CONVERSION-CENT CORE,MULTI-RES,19800,0,19800,131300,0,151100
142227600200000,SE 231,RESIDENTIAL,14000,0,14000,60700,0,74700
142227600300000,SE 231,RESIDENTIAL,14000,0,14000,59500,0,73500
142227600400000,SE 231,RESIDENTIAL,14000,0,14000,50600,0,64600
142227600500000,SE 231,RESIDENTIAL,11100,0,11100,50400,0,61500
142227600600000,SE 231,RESIDENTIAL,9800,0,9800,49200,0,59000
142227600700000,SE 231,RESIDENTIAL,7600,0,7600,34900,0,42500
142227600800000,CONVERSION-CENT CORE,MULTI-RES,15600,0,15600,50400,0,66000
142227600900000,SE 231,RESIDENTIAL,18000,0,18000,98900,0,116900
142227700100000,OFFICE,COMMERCIAL,0,29400,29400,0,138500,167900
142227700200000,OFFICE,EXEMPT,0,33600,33600,0,111300,144900
142227700300000,CONVERSION-CENT CORE,RESIDENTIAL,17900,0,17900,51000,0,68900
142227700500000,SMALL RETAIL,COMMERCIAL,0,89600,89600,0,76800,166400
142227700600000,VACANT LAND,COMMERCIAL,0,15600,15600,0,0,15600
142227700700000,SMALL RETAIL,COMMERCIAL,10920,28080,39000,19120,50680,108800
142227700800000,SMALL RETAIL,COMMERCIAL,0,33600,33600,0,81400,115000
142227700900000,SMALL RETAIL,COMMERCIAL,0,33600,33600,0,74300,107900
142227701000000,SMALL RETAIL,COMMERCIAL,0,84000,84000,0,285900,369900
142227701100000,OFFICE,COMMERCIAL,0,144600,144600,0,426200,570800
142227701200000,OFFICE,COMMERCIAL,0,78400,78400,0,233400,311800
142227800100000,CITY PROPERTY,EXEMPT,0,0,0,0,0,0
142227900100000,SE 231,RESIDENTIAL,14300,0,14300,55600,0,69900
142227900200000,SE 231,RESIDENTIAL,11300,0,11300,52900,0,64200
142227900300000,SE 231,EXEMPT,0,7600,7600,0,58000,65600
142227900400000,SE 231,RESIDENTIAL,7600,0,7600,35500,0,43100
142227900500000,SE 231,RESIDENTIAL,7700,0,7700,55600,0,63300
142227900600000,SE 231,RESIDENTIAL,7600,0,7600,58900,0,66500
142227900700000,SE 231,RESIDENTIAL,10500,0,10500,0,0,10500
142227900800000,SE 231,RESIDENTIAL,10500,0,10500,31100,0,41600
142227900900000,SE 231,RESIDENTIAL,17600,0,17600,66800,0,84400
142227901000000,SE 231,RESIDENTIAL,17900,0,17900,21600,0,39500
142227901100000,SE 231,RESIDENTIAL,17900,0,17900,70200,0,88100
142227901200000,CONVERSION-CENT CORE,MULTI-RES,10500,0,10500,46600,0,57100
142227901300000,SE 231,RESIDENTIAL,10500,0,10500,33700,0,44200
142227901400000,CONVERSION-CENT CORE,MULTI-RES,17900,0,17900,60400,0,78300
142227901500000,CONVERSION-CENT CORE,MULTI-RES,17900,0,17900,52300,0,70200
142227901600000,SE 231,RESIDENTIAL,10700,0,10700,69700,0,80400
142227901700000,SE 231,RESIDENTIAL,17200,0,17200,85000,0,102200
142227901800000,CONVERSION-CENT CORE,MULTI-RES,17900,0,17900,41700,0,59600
142227901900000,SE 231,RESIDENTIAL,10500,0,10500,57100,0,67600
142227902000000,SE 231,RESIDENTIAL,10500,0,10500,52500,0,63000
142227902100000,SE 231,RESIDENTIAL,17900,0,17900,56100,0,74000
142227902200000,SE 231,RESIDENTIAL,17900,0,17900,80300,0,98200
142227902300000,APARTMENT,RESIDENTIAL,16800,0,16800,52900,0,69700
142227902400000,SE 231,RESIDENTIAL,17900,0,17900,29000,0,46900
142228000100000,OFFICE; MEDICAL,COMMERCIAL,0,67200,67200,0,248500,315700
142228000200000,SE 231,RESIDENTIAL,4800,0,4800,16600,0,21400
142228000300000,CONVERSION-CENT CORE,MULTI-RES,8200,0,8200,13800,0,22000
142228000400000,SMALL RETAIL,COMMERCIAL,0,28000,28000,0,61500,89500
142228000500000,SMALL RETAIL,COMMERCIAL,0,17500,17500,0,53700,71200
142228000600000,CONVERSION-CENT CORE,MULTI-RES,10500,0,10500,45300,0,55800
142228000700000,RESTAURANT,COMMERCIAL,0,100800,100800,0,87700,188500
142228000800000,FLAT PARKING,COMMERCIAL,0,75600,75600,0,12900,88500
142228000900000,FLAT PARKING,COMMERCIAL,0,25700,25700,0,8400,34100
142228001000000,FLAT PARKING,COMMERCIAL,0,15400,15400,0,4800,20200
142228001100000,SE 231,RESIDENTIAL,18000,0,18000,42900,0,60900
142228100100000,SE 231,RESIDENTIAL,7400,0,7400,68400,0,75800
142228100200000,SE 231,RESIDENTIAL,7400,0,7400,59100,0,66500
142228100300000,SE 231,RESIDENTIAL,14000,0,14000,43200,0,57200
142228100400000,SE 231,RESIDENTIAL,13800,0,13800,40200,0,54000
142228100500000,SE 231,RESIDENTIAL,14000,0,14000,33800,0,47800
142228100600000,SE 231,RESIDENTIAL,17900,0,17900,60500,0,78400
142228100700000,SE 231,RESIDENTIAL,15800,0,15800,56400,0,72200
142228100800000,SE 231,RESIDENTIAL,15800,0,15800,58300,0,74100
142228100900000,SE 231,RESIDENTIAL,17500,0,17500,65600,0,83100
142228101000000,SE 231,RESIDENTIAL,14000,0,14000,59900,0,73900
142228101100000,SE 231,RESIDENTIAL,14200,0,14200,51400,0,65600
142228101200000,SE 231,RESIDENTIAL,13200,0,13200,72900,0,86100
142228101300000,CONVERSION-CENT CORE,MULTI-RES,8900,0,8900,30700,0,39600
142228101400000,CONVERSION-CENT CORE,MULTI-RES,14600,0,14600,36800,0,51400
142228101600000,SE 231,RESIDENTIAL,19900,0,19900,54300,0,74200
142228101800000,SE 231,RESIDENTIAL,10800,0,10800,37200,0,48000
142228101900000,SE 231,RESIDENTIAL,17300,0,17300,68100,0,85400
142228102000000,APARTMENT,MULTI-RES,16800,0,16800,86100,0,102900
142228102100000,SE 231,RESIDENTIAL,14000,0,14000,65600,0,79600
142228102200000,SE 231,RESIDENTIAL,14000,0,14000,56600,0,70600
142228102300000,SE 231,EXEMPT,0,14000,14000,50900,0,64900
142228102400000,SE 231,RESIDENTIAL,10500,0,10500,53200,0,63700
142228102500000,SE 231,EXEMPT,0,10500,10500,56900,0,67400
142228102600000,SE 231,RESIDENTIAL,10500,0,10500,39900,0,50400
142228102700000,SE 231,RESIDENTIAL,10500,0,10500,29200,0,39700
142228102800000,CONVERSION-CENT CORE,MULTI-RES,17900,0,17900,61200,0,79100
142228102900000,SE 231,RESIDENTIAL,6900,0,6900,46300,0,53200
142228103000000,SE 231,RESIDENTIAL,8400,0,8400,58900,0,67300
142228103100000,SE 231,RESIDENTIAL,7200,0,7200,49100,0,56300
142228103200000,SE 231,RESIDENTIAL,7200,0,7200,48100,0,55300
142228103300000,SE 231,RESIDENTIAL,7400,0,7400,55300,0,62700
142228103400000,SE 231,RESIDENTIAL,7800,0,7800,46100,0,53900
142228103500000,SE 231,RESIDENTIAL,18000,0,18000,65500,0,83500
142228200100000,CITY PROPERTY,EXEMPT,0,0,0,0,0,0
142228300100000,SE 231,RESIDENTIAL,7400,0,7400,45600,0,53000
142228300200000,SE 231,RESIDENTIAL,7600,0,7600,26500,0,34100
142228300300000,SE 231,RESIDENTIAL,7600,0,7600,18900,0,26500
142228300400000,APARTMENT,MULTI-RES,7800,0,7800,36500,0,44300
142228300500000,CONVERSION-CENT CORE,MULTI-RES,16500,0,16500,44900,0,61400
142228300600000,CONVERSION-CENT CORE,MULTI-RES,15800,0,15800,43700,0,59500
142228300700000,SE 231,RESIDENTIAL,10500,0,10500,27800,0,38300
142228300800000,SE 231,RESIDENTIAL,10500,0,10500,52100,0,62600
142228300900000,CONVERSION-CENT CORE,MULTI-RES,17900,0,17900,48900,0,66800
142228301000000,CONVERSION-CENT CORE,MULTI-RES,14000,0,14000,60100,0,74100
142228301100000,FLAT PARKING,EXEMPT,0,44800,44800,0,7600,52400
142228301200000,CONVERSION-CENT CORE,MULTI-RES,17900,0,17900,47200,0,65100
142228301300000,SE 231,RESIDENTIAL,17900,0,17900,98700,0,116600
142228301400000,FLAT PARKING,EXEMPT,0,67200,67200,0,9600,76800
142228301500000,FLAT PARKING,EXEMPT,0,33600,33600,0,5000,38600
142228301600000,CONVERSION-CENT CORE,RESIDENTIAL,14000,0,14000,47200,0,61200
142228301700000,SE 231,RESIDENTIAL,14000,0,14000,0,0,14000
142228301800000,SE 231,RESIDENTIAL,14000,0,14000,42100,0,56100
142228301900000,SE 231,RESIDENTIAL,10500,0,10500,39300,0,49800
142228302000000,SE 231,RESIDENTIAL,11000,0,11000,47900,0,58900
142228302100000,SE 231,RESIDENTIAL,20900,0,20900,51200,0,72100
142228302200000,SE 231,RESIDENTIAL,7400,0,7400,48300,0,55700
142228400100000,SE 231,RESIDENTIAL,13500,0,13500,27900,0,41400
142228400200000,SE 231,RESIDENTIAL,11500,0,11500,26700,0,38200
142228400300000,SE 231,RESIDENTIAL,10500,0,10500,47700,0,58200
142228400400000,SE 231,RESIDENTIAL,9800,0,9800,35800,0,45600
142228400500000,SE 231,RESIDENTIAL,14700,0,14700,38600,0,53300
142228400600000,SE 231,RESIDENTIAL,17900,0,17900,56500,0,74400
142228400700000,SE 231,RESIDENTIAL,14000,0,14000,62100,0,76100
142228400800000,SE 231,RESIDENTIAL,14000,0,14000,57300,0,71300
142228400900000,SE 231,RESIDENTIAL,14000,0,14000,38500,0,52500
142228401000000,SE 231,RESIDENTIAL,14000,0,14000,47900,0,61900
142228401100000,SE 231,RESIDENTIAL,14000,0,14000,44000,0,58000
142228401200000,CONVERSION-CENT CORE,MULTI-RES,14000,0,14000,45600,0,59600
142228401300000,SE 231,RESIDENTIAL,17900,0,17900,31100,0,49000
142228401400000,SE 231,RESIDENTIAL,7400,0,7400,61900,0,69300
142228401500000,SE 231,RESIDENTIAL,7400,0,7400,48600,0,56000
142228401600000,SE 231,EXEMPT,0,7600,7600,0,34300,41900
142228401700000,SE 231,RESIDENTIAL,7600,0,7600,38100,0,45700
142228401800000,SE 231,RESIDENTIAL,7700,0,7700,44900,0,52600
142228401900000,SE 231,EXEMPT,0,7600,7600,47400,0,55000
142228402000000,SE 231,RESIDENTIAL,7400,0,7400,41700,0,49100
142228402100000,SE 231,EXEMPT,0,7400,7400,0,42100,49500
142228402200000,SE 231,RESIDENTIAL,17900,0,17900,50600,0,68500
142228402300000,SE 231,RESIDENTIAL,10500,0,10500,53400,0,63900
142228402400000,SE 231,RESIDENTIAL,10500,0,10500,53500,0,64000
142228402500000,SE 231,RESIDENTIAL,10500,0,10500,47500,0,58000
142228402600000,SE 231,RESIDENTIAL,12300,0,12300,59400,0,71700
142228402700000,SE 231,RESIDENTIAL,12300,0,12300,48500,0,60800
142228402800000,SE 231,RESIDENTIAL,14000,0,14000,69500,0,83500
142228402900000,SE 231,RESIDENTIAL,14000,0,14000,55400,0,69400
142228403000000,SE 231,RESIDENTIAL,14000,0,14000,50700,0,64700
142228403100000,SE 231,RESIDENTIAL,14000,0,14000,95300,0,109300
142228403200000,SE 231,RESIDENTIAL,14100,0,14100,38900,0,53000
142228403300000,SE 231,RESIDENTIAL,14000,0,14000,53400,0,67400
142228403400000,SE 231,RESIDENTIAL,9500,0,9500,49800,0,59300
142228403500000,SE 231,RESIDENTIAL,12300,0,12300,78500,0,90800
142228403600000,SE 231,RESIDENTIAL,7600,0,7600,39800,0,47400
142228403700000,SE 231,RESIDENTIAL,7600,0,7600,45600,0,53200
142228403800000,SE 231,RESIDENTIAL,9800,0,9800,37500,0,47300
142228500100000,CONVERSION-CENT CORE,MULTI-RES,13600,0,13600,30900,0,44500
142228500200000,SE 231,RESIDENTIAL,11400,0,11400,27400,0,38800
142228500300000,SE 231,RESIDENTIAL,17700,0,17700,30900,0,48600
142228500400000,SE 231,EXEMPT,0,17300,17300,0,44800,62100
142228500500000,SE 231,RESIDENTIAL,10500,0,10500,40000,0,50500
142228500600000,SE 231,RESIDENTIAL,6900,0,6900,31300,0,38200
142228500700000,SE 231,RESIDENTIAL,10900,0,10900,7800,0,18700
142228500800000,SE 231,RESIDENTIAL,10300,0,10300,33500,0,43800
142228500900000,SE 231,EXEMPT,0,9100,9100,0,44200,53300
142228501000000,SE 231,RESIDENTIAL,9300,0,9300,35800,0,45100
142228501100000,SE 231,EXEMPT,0,10200,10200,0,65300,75500
142228501200000,APARTMENT,EXEMPT,0,16200,16200,0,220200,236400
142228501300000,SE 231,EXEMPT,0,9100,9100,0,0,9100
142228501400000,SE 231,EXEMPT,0,14000,14000,0,0,14000
142228501500000,SE 231,RESIDENTIAL,14000,0,14000,56500,0,70500
142228501600000,SE 231,RESIDENTIAL,14000,0,14000,52400,0,66400
142228501700000,SE 231,RESIDENTIAL,10500,0,10500,37700,0,48200
142228501800000,SE 231,RESIDENTIAL,10500,0,10500,44800,0,55300
142228501900000,SE 231,RESIDENTIAL,14000,0,14000,12900,0,26900
142228502000000,SE 231,RESIDENTIAL,14000,0,14000,19600,0,33600
142228502100000,SE 231,RESIDENTIAL,17500,0,17500,49900,0,67400
142228502200000,SE 231,RESIDENTIAL,17100,0,17100,46300,0,63400
142228502300000,CONVERSION-CENT CORE,EXEMPT,0,13400,13400,0,71300,84700
142228502400000,SE 231,EXEMPT,0,8700,8700,0,0,8700
142228502500000,SE 231,EXEMPT,0,8700,8700,0,51000,59700
142228502600000,SE 231,RESIDENTIAL,7800,0,7800,69600,0,77400
142230100100000,CONVERSION-CENT CORE,MULTI-RES,10000,0,10000,40400,0,50400
142230100200000,CONVERSION-CENT CORE,MULTI-RES,10000,0,10000,38400,0,48400
142230100300000,SE 231,RESIDENTIAL,14000,0,14000,48700,0,62700
142230100400000,SE 231,RESIDENTIAL,14000,0,14000,56400,0,70400
142230100500000,SE 231,EXEMPT,0,21000,21000,0,41900,62900
142230100600000,SE 231,RESIDENTIAL,14000,0,14000,6700,0,20700
142230100700000,SE 231,RESIDENTIAL,14000,0,14000,54800,0,68800
142230100800000,SE 231,RESIDENTIAL,14000,0,14000,64000,0,78000
142230100900000,SE 231,RESIDENTIAL,14000,0,14000,51800,0,65800
142230101000000,SE 231,RESIDENTIAL,14000,0,14000,10400,0,24400
142230101100000,SE 231,RESIDENTIAL,14000,0,14000,74900,0,88900
142230101200000,SE 231,RESIDENTIAL,14000,0,14000,61100,0,75100
142230101300000,SE 231,RESIDENTIAL,14000,0,14000,49800,0,63800
142230101400000,SE 231,RESIDENTIAL,14000,0,14000,47200,0,61200
142230101500000,SE 231,RESIDENTIAL,14000,0,14000,39100,0,53100
142230101600000,SE 231,RESIDENTIAL,13000,0,13000,57100,0,70100
142230101700000,SE 231,EXEMPT,0,7100,7100,0,29800,36900
142230101800000,SE 231,RESIDENTIAL,7100,0,7100,34300,0,41400
142230101900000,SE 231,RESIDENTIAL,7400,0,7400,0,0,7400
142230102000000,SE 231,EXEMPT,0,7400,7400,0,33800,41200
142230102100000,SE 231,RESIDENTIAL,7500,0,7500,46200,0,53700
142230102200000,SE 231,RESIDENTIAL,7500,0,7500,48600,0,56100
142230102300000,SE 231,RESIDENTIAL,14000,0,14000,17000,0,31000
142230102400000,SE 231,RESIDENTIAL,14000,0,14000,61400,0,75400
142230102500000,SE 231,EXEMPT,0,14000,14000,0,44400,58400
142230102600000,SE 231,RESIDENTIAL,17900,0,17900,58300,0,76200
142230102700000,SE 231,RESIDENTIAL,14000,0,14000,59500,0,73500
142230102800000,SE 231,RESIDENTIAL,17500,0,17500,71500,0,89000
142230102900000,CONVERSION-CENT CORE,EXEMPT,0,17500,17500,0,44900,62400
142230103000000,SE 231,RESIDENTIAL,14000,0,14000,62200,0,76200
142230103100000,SE 231,RESIDENTIAL,14000,0,14000,65400,0,79400
142230103200000,SE 231,RESIDENTIAL,14000,0,14000,43800,0,57800
142230103300000,SE 231,RESIDENTIAL,14000,0,14000,49800,0,63800
142230103400000,SE 231,RESIDENTIAL,18500,0,18500,50200,0,68700
142230103500000,SE 231,EXEMPT,0,7700,7700,0,38700,46400
142230103800000,SE 231,RESIDENTIAL,6900,0,6900,41800,0,48700
142230103900000,SE 231,RESIDENTIAL,7500,0,7500,54200,0,61700
142230104000000,SE 231,RESIDENTIAL,12200,0,12200,59000,0,71200
142230200100000,SE 231,RESIDENTIAL,11100,0,11100,41400,0,52500
142230200200000,SE 231,RESIDENTIAL,14000,0,14000,45200,0,59200
142230200300000,SE 231,RESIDENTIAL,14000,0,14000,51800,0,65800
142230200400000,SE 231,RESIDENTIAL,14000,0,14000,50600,0,64600
142230200500000,SE 231,RESIDENTIAL,10500,0,10500,50600,0,61100
142230200600000,SE 231,RESIDENTIAL,10500,0,10500,45400,0,55900
142230200700000,SE 231,RESIDENTIAL,10500,0,10500,46200,0,56700
142230200800000,SE 231,EXEMPT,0,10500,10500,49700,0,60200
142230200900000,SE 231,EXEMPT,0,15800,15800,0,26500,42300
142230201100000,CONVERSION-CENT CORE,MULTI-RES,11200,0,11200,19900,0,31100
142230201200000,SE 231,EXEMPT,0,9800,9800,0,35800,45600
142230201300000,SE 231,RESIDENTIAL,7700,0,7700,0,0,7700
142230201400000,SE 231,RESIDENTIAL,8000,0,8000,23500,0,31500
142230201500000,SE 231,EXEMPT,0,7100,7100,45000,0,52100
142230201600000,SE 231,RESIDENTIAL,6500,0,6500,36900,0,43400
142230201700000,SE 231,RESIDENTIAL,7600,0,7600,42900,0,50500
142230202100000,SE 231,EXEMPT,0,10500,10500,0,29300,39800
142230202200000,SE 231,RESIDENTIAL,10500,0,10500,56900,0,67400
142230202300000,SE 231,EXEMPT,0,10500,10500,29000,0,39500
142230202400000,SE 231,EXEMPT,0,10500,10500,0,47400,57900
142230202500000,SE 231,EXEMPT,0,14000,14000,0,64000,78000
142230202600000,SE 231,RESIDENTIAL,14000,0,14000,34000,0,48000
142230202700000,SE 231,EXEMPT,0,14000,14000,0,34200,48200
142230202800000,SE 231,RESIDENTIAL,14300,0,14300,54500,0,68800
142230203100000,SE 231,RESIDENTIAL,7400,0,7400,43500,0,50900
142230203200000,SE 231,RESIDENTIAL,5100,0,5100,0,0,5100
142230203300000,SE 231,RESIDENTIAL,7600,0,7600,25600,0,33200
142230203400000,SE 231,RESIDENTIAL,7600,0,7600,45800,0,53400
142230203500000,CONVERSION-CENT CORE,MULTI-RES,8700,0,8700,16600,0,25300
142230203600000,SE 231,RESIDENTIAL,8700,0,8700,28000,0,36700
142230203700000,SE 231,RESIDENTIAL,14000,0,14000,66000,0,80000
142230203800000,SE 231,RESIDENTIAL,14000,0,14000,0,0,14000
142230203900000,SE 231,RESIDENTIAL,23300,0,23300,88800,0,112100
142230204000000,SE 231,EXEMPT,0,11600,11600,0,36500,48100
142230204100000,SE 231,EXEMPT,0,4000,4000,0,0,4000
142230204200000,SE 231,EXEMPT,0,13100,13100,0,0,13100
142230204300000,SE 231,EXEMPT,0,13100,13100,0,0,13100
142230300100000,SE 231,RESIDENTIAL,11000,0,11000,62600,0,73600
142230300200000,SE 231,RESIDENTIAL,10200,0,10200,51300,0,61500
142230300300000,SE 231,RESIDENTIAL,14000,0,14000,36000,0,50000
142230300400000,SE 231,RESIDENTIAL,14000,0,14000,62400,0,76400
142230300500000,SE 231,RESIDENTIAL,14000,0,14000,58300,0,72300
142230300600000,SE 231,RESIDENTIAL,14000,0,14000,66300,0,80300
142230300700000,SE 231,RESIDENTIAL,14000,0,14000,44600,0,58600
142230300800000,SE 231,RESIDENTIAL,14000,0,14000,56100,0,70100
142230300900000,SE 231,RESIDENTIAL,14000,0,14000,50600,0,64600
142230301000000,SE 231,RESIDENTIAL,14000,0,14000,58700,0,72700
142230301100000,SE 231,RESIDENTIAL,14000,0,14000,43800,0,57800
142230301200000,SE 231,RESIDENTIAL,14000,0,14000,53900,0,67900
142230301300000,SE 231,RESIDENTIAL,14000,0,14000,48000,0,62000
142230301400000,SE 231,RESIDENTIAL,14000,0,14000,46700,0,60700
142230301500000,SE 231,RESIDENTIAL,14000,0,14000,49400,0,63400
142230301600000,SE 231,RESIDENTIAL,7600,0,7600,36600,0,44200
142230301700000,SE 231,RESIDENTIAL,7900,0,7900,33500,0,41400
142230301800000,SE 231,EXEMPT,0,6500,6500,43700,0,50200
142230301900000,SE 231,RESIDENTIAL,6500,0,6500,39800,0,46300
142230302000000,SE 231,RESIDENTIAL,1100,0,1100,0,0,1100
142230302100000,SE 231,EXEMPT,0,7100,7100,0,51100,58200
142230302200000,SE 231,EXEMPT,0,7100,7100,48000,0,55100
142230302300000,SE 231,RESIDENTIAL,13000,0,13000,47500,0,60500
142230302400000,SE 231,RESIDENTIAL,14000,0,14000,68400,0,82400
142230302500000,SE 231,RESIDENTIAL,14300,0,14300,21000,0,35300
142230302600000,SE 231,RESIDENTIAL,17600,0,17600,62500,0,80100
142230302700000,SE 231,RESIDENTIAL,14000,0,14000,56400,0,70400
142230302900000,SE 231,RESIDENTIAL,12300,0,12300,27100,0,39400
142230303000000,CONVERSION-CENT CORE,MULTI-RES,15800,0,15800,45800,0,61600
142230303100000,SE 231,RESIDENTIAL,14000,0,14000,63500,0,77500
142230303200000,SE 231,RESIDENTIAL,14000,0,14000,63800,0,77800
142230303300000,SE 231,RESIDENTIAL,14000,0,14000,60900,0,74900
142230303400000,SE 231,RESIDENTIAL,14000,0,14000,62300,0,76300
142230303500000,SE 231,RESIDENTIAL,14000,0,14000,65700,0,79700
142230303600000,SE 231,RESIDENTIAL,14000,0,14000,53100,0,67100
142230303700000,CONVERSION-CENT CORE,MULTI-RES,12900,0,12900,27400,0,40300
142230303800000,SE 231,EXEMPT,0,7500,7500,37400,0,44900
142230303900000,SE 231,RESIDENTIAL,7500,0,7500,44200,0,51700
142230304000000,SE 231,RESIDENTIAL,9000,0,9000,51900,0,60900
142230304100000,SE 231,RESIDENTIAL,9000,0,9000,28600,0,37600
142230400100000,SE 231,EXEMPT,0,6500,6500,0,0,6500
142230400200000,SE 231,EXEMPT,0,6500,6500,0,0,6500
142230400300000,SE 231,RESIDENTIAL,14000,0,14000,43000,0,57000
142230400400000,SE 231,RESIDENTIAL,14000,0,14000,69600,0,83600
142230400500000,SE 231,RESIDENTIAL,14000,0,14000,57700,0,71700
142230400600000,SE 231,RESIDENTIAL,14000,0,14000,56700,0,70700
142230400700000,SE 231,EXEMPT,0,14000,14000,0,35000,49000
142230400800000,SE 231,RESIDENTIAL,14000,0,14000,29600,0,43600
142230400900000,SE 231,RESIDENTIAL,14000,0,14000,29499,0,43499
142230401000000,SE 231,RESIDENTIAL,14000,0,14000,41000,0,55000
142230401100000,SE 231,RESIDENTIAL,14000,0,14000,46500,0,60500
142230401200000,SE 231,RESIDENTIAL,200,0,200,0,0,200
142230401300000,SE 231,RESIDENTIAL,10300,0,10300,32700,0,43000
142230401400000,SE 231,RESIDENTIAL,10500,0,10500,46500,0,57000
142230401500000,SE 231,RESIDENTIAL,8500,0,8500,48400,0,56900
142230401600000,SE 231,RESIDENTIAL,6700,0,6700,50000,0,56700
142230401700000,APARTMENT,MULTI-RES,8400,0,8400,106100,0,114500
142230401800000,SE 231,RESIDENTIAL,10900,0,10900,52600,0,63500
142230401900000,SE 231,RESIDENTIAL,14800,0,14800,10400,0,25200
142230402000000,SE 231,RESIDENTIAL,10500,0,10500,0,0,10500
142230402100000,SE 231,RESIDENTIAL,10500,0,10500,17400,0,27900
142230402200000,SE 231,RESIDENTIAL,14000,0,14000,51300,0,65300
142230402300000,SE 231,RESIDENTIAL,14000,0,14000,49700,0,63700
142230402400000,SE 231,RESIDENTIAL,14300,0,14300,40500,0,54800
142230402500000,SE 231,RESIDENTIAL,14000,0,14000,60400,0,74400
142230402600000,SE 231,RESIDENTIAL,14000,0,14000,50700,0,64700
142230402700000,SE 231,RESIDENTIAL,14000,0,14000,33400,0,47400
142230402800000,SE 231,RESIDENTIAL,14000,0,14000,58100,0,72100
142230402900000,SE 231,RESIDENTIAL,14000,0,14000,54900,0,68900
142230403000000,SE 231,RESIDENTIAL,14000,0,14000,28300,0,42300
142230403100000,SE 231,RESIDENTIAL,7700,0,7700,33100,0,40800
142230403200000,SE 231,RESIDENTIAL,7700,0,7700,54900,0,62600
142230403300000,SE 231,RESIDENTIAL,7100,0,7100,25400,0,32500
142230403400000,SE 231,EXEMPT,0,7100,7100,33500,0,40600
142230403600000,SE 231,RESIDENTIAL,8700,0,8700,39900,0,48600
142230403700000,SE 231,RESIDENTIAL,8800,0,8800,34300,0,43100
142230500100000,SE 231,RESIDENTIAL,11200,0,11200,42500,0,53700
142230500200000,SE 231,RESIDENTIAL,10200,0,10200,51400,0,61600
142230500300000,SE 231,RESIDENTIAL,14000,0,14000,56400,0,70400
142230500400000,SE 231,RESIDENTIAL,14000,0,14000,53700,0,67700
142230500500000,SE 231,RESIDENTIAL,14000,0,14000,55800,0,69800
142230500600000,APARTMENT,MULTI-RES,11200,0,11200,77000,0,88200
142230500700000,SE 231,RESIDENTIAL,14000,0,14000,64500,0,78500
142230500800000,SE 231,RESIDENTIAL,14000,0,14000,49600,0,63600
142230500900000,SE 231,EXEMPT,0,14000,14000,58600,0,72600
142230501000000,SE 231,RESIDENTIAL,14000,0,14000,46900,0,60900
142230501100000,SE 231,RESIDENTIAL,14100,0,14100,22200,0,36300
142230501200000,SE 231,RESIDENTIAL,14000,0,14000,60900,0,74900
142230501300000,SE 231,RESIDENTIAL,14100,0,14100,58800,0,72900
142230501400000,SE 231,RESIDENTIAL,14000,0,14000,58800,0,72800
142230501500000,SE 231,RESIDENTIAL,14000,0,14000,54600,0,68600
142230501600000,SE 231,RESIDENTIAL,7400,0,7400,33300,0,40700
142230501700000,SE 231,EXEMPT,0,7400,7400,0,35700,43100
142230501800000,SE 231,EXEMPT,0,7600,7600,44300,0,51900
142230501900000,SE 231,RESIDENTIAL,7600,0,7600,45300,0,52900
142230502000000,SE 231,RESIDENTIAL,7900,0,7900,44800,0,52700
142230502100000,SE 231,RESIDENTIAL,7500,0,7500,37400,0,44900
142230502200000,SE 231,RESIDENTIAL,7400,0,7400,43700,0,51100
142230502300000,SE 231,RESIDENTIAL,8300,0,8300,15600,0,23900
142230502400000,SE 231,RESIDENTIAL,14000,0,14000,94400,0,108400
142230502500000,SE 231,RESIDENTIAL,14000,0,14000,47100,0,61100
142230502600000,SE 231,RESIDENTIAL,14000,0,14000,26700,0,40700
142230502700000,SE 231,RESIDENTIAL,14000,0,14000,42700,0,56700
142230502800000,SE 231,RESIDENTIAL,14000,0,14000,66700,0,80700
142230502900000,SE 231,RESIDENTIAL,14000,0,14000,63400,0,77400
142230503000000,SE 231,RESIDENTIAL,14000,0,14000,51600,0,65600
142230503100000,SE 231,RESIDENTIAL,14000,0,14000,46100,0,60100
142230503200000,SE 231,RESIDENTIAL,14000,0,14000,34500,0,48500
142230503300000,SE 231,RESIDENTIAL,14000,0,14000,42200,0,56200
142230503400000,SE 231,RESIDENTIAL,14000,0,14000,53800,0,67800
142230503500000,SE 231,RESIDENTIAL,14000,0,14000,51800,0,65800
142230503600000,SE 231,RESIDENTIAL,14000,0,14000,52000,0,66000
142230503700000,SE 231,RESIDENTIAL,10200,0,10200,27700,0,37900
142230503800000,SE 231,RESIDENTIAL,10900,0,10900,35800,0,46700
142230503900000,SE 231,RESIDENTIAL,8600,0,8600,38200,0,46800
142230504000000,SE 231,RESIDENTIAL,8600,0,8600,49500,0,58100
142230504100000,SE 231,EXEMPT,0,9000,9000,0,45800,54800
142230504200000,SE 231,RESIDENTIAL,9000,0,9000,41200,0,50200
142230600100000,SE 231,RESIDENTIAL,7700,0,7700,35300,0,43000
142230600200000,SE 231,RESIDENTIAL,7700,0,7700,43200,0,50900
142230600300000,SE 231,EXEMPT,0,14000,14000,0,61000,75000
142230600400000,SE 231,RESIDENTIAL,14000,0,14000,18300,0,32300
142230600500000,SE 231,EXEMPT,0,8400,8400,0,0,8400
142230600600000,SE 231,RESIDENTIAL,14000,0,14000,37800,0,51800
142230600700000,SE 231,RESIDENTIAL,14000,0,14000,37417,0,51417
142230600800000,SE 231,EXEMPT,0,13000,13000,57500,0,70500
142230600900000,SE 231,EXEMPT,0,7700,7700,42000,0,49700
142230601000000,SE 231,RESIDENTIAL,7800,0,7800,48100,0,55900
142230601100000,SE 231,RESIDENTIAL,6500,0,6500,51400,0,57900
142230601200000,SE 231,RESIDENTIAL,10200,0,10200,43100,0,53300
142230601300000,SE 231,RESIDENTIAL,11700,0,11700,50800,0,62500
142230601400000,SE 231,RESIDENTIAL,14600,0,14600,62000,0,76600
142230601500000,SE 231,RESIDENTIAL,14000,0,14000,56300,0,70300
142230601600000,SE 231,RESIDENTIAL,14000,0,14000,48300,0,62300
142230601700000,SE 231,RESIDENTIAL,17900,0,17900,43400,0,61300
142230601800000,SE 231,RESIDENTIAL,14000,0,14000,40900,0,54900
142230601900000,SE 231,RESIDENTIAL,14000,0,14000,42600,0,56600
142230602000000,SE 231,RESIDENTIAL,10300,0,10300,43200,0,53500
142230602100000,SE 231,EXEMPT,0,10600,10600,0,35700,46300
142230602200000,SE 231,RESIDENTIAL,13000,0,13000,51500,0,64500
142230602300000,SE 231,RESIDENTIAL,7100,0,7100,38100,0,45200
142230602400000,SE 231,RESIDENTIAL,7100,0,7100,39500,0,46600
142230700100000,SE 232,RESIDENTIAL,7800,0,7800,35300,0,43100
142230700200000,SE 232,EXEMPT,0,10100,10100,53600,0,63700
142230700300000,SE 232,RESIDENTIAL,9100,0,9100,45900,0,55000
142230700500000,SE 232,RESIDENTIAL,5900,0,5900,43400,0,49300
142230700600000,SE 232,RESIDENTIAL,4200,0,4200,45200,0,49400
142230700700000,SE 232,RESIDENTIAL,9200,0,9200,41100,0,50300
142230700800000,SE 232,RESIDENTIAL,9900,0,9900,25300,0,35200
142230700900000,SE 232,EXEMPT,0,9900,9900,0,31900,41800
142230701000000,SE 232,RESIDENTIAL,7700,0,7700,41200,0,48900
142230701100000,SE 232,RESIDENTIAL,7700,0,7700,47700,0,55400
142230701200000,SE 232,RESIDENTIAL,7700,0,7700,42500,0,50200
142230701300000,SE 232,EXEMPT,0,9900,9900,0,26400,36300
142230701400000,SE 232,RESIDENTIAL,6200,0,6200,48900,0,55100
142230701500000,SE 232,EXEMPT,0,7000,7000,0,35900,42900
142230701600000,SE 232,RESIDENTIAL,7600,0,7600,49600,0,57200
142230800100000,SE 231,RESIDENTIAL,10000,0,10000,33300,0,43300
142230800200000,SE 231,RESIDENTIAL,9000,0,9000,28800,0,37800
142230800300000,SE 231,RESIDENTIAL,8500,0,8500,34300,0,42800
142230800400000,SE 231,RESIDENTIAL,8600,0,8600,38600,0,47200
142230800500000,SE 231,RESIDENTIAL,14000,0,14000,45800,0,59800
142230800600000,SE 231,RESIDENTIAL,14000,0,14000,48800,0,62800
142230800700000,SE 231,RESIDENTIAL,14000,0,14000,35300,0,49300
142230800800000,SE 231,RESIDENTIAL,14000,0,14000,46000,0,60000
142230800900000,SE 231,RESIDENTIAL,14000,0,14000,39000,0,53000
142230801000000,SE 231,RESIDENTIAL,14000,0,14000,56400,0,70400
142230801100000,SE 231,RESIDENTIAL,17900,0,17900,47200,0,65100
142230801200000,SE 231,RESIDENTIAL,17900,0,17900,54300,0,72200
142230801300000,SE 231,RESIDENTIAL,14000,0,14000,42100,0,56100
142230801400000,SE 231,RESIDENTIAL,14000,0,14000,30700,0,44700
142230801500000,SE 231,RESIDENTIAL,14000,0,14000,42500,0,56500
142230801600000,SE 231,RESIDENTIAL,10000,0,10000,61500,0,71500
142230801700000,SE 231,EXEMPT,0,19300,19300,46100,0,65400
142230900100000,SE 231,RESIDENTIAL,13200,0,13200,58600,0,71800
142230900200000,SE 231,EXEMPT,0,12300,12300,0,28900,41200
142230900300000,SE 231,RESIDENTIAL,13900,0,13900,38800,0,52700
142230900400000,SE 231,RESIDENTIAL,14000,0,14000,52800,0,66800
142230900500000,SE 231,RESIDENTIAL,14000,0,14000,38800,0,52800
142230900600000,SE 231,EXEMPT,0,14000,14000,0,49100,63100
142230900700000,SE 231,RESIDENTIAL,14000,0,14000,31100,0,45100
142230900800000,SE 231,RESIDENTIAL,14000,0,14000,52800,0,66800
142230900900000,SE 231,RESIDENTIAL,8000,0,8000,47500,0,55500
142230901000000,SE 231,RESIDENTIAL,9300,0,9300,21900,0,31200
142230901100000,SE 231,RESIDENTIAL,7400,0,7400,44400,0,51800
142230901200000,SE 231,RESIDENTIAL,7300,0,7300,34200,0,41500
142232600100000,CHURCH,EXEMPT,0,195200,195200,0,2858200,3053400
142232600300000,SE 232,EXEMPT,0,10000,10000,0,0,10000
142232600400000,SE 232,EXEMPT,0,10000,10000,0,36900,46900
142232600500000,CONVERSION-CENT CORE,MULTI-RES,10000,0,10000,47900,0,57900
142232600600000,SE 232,RESIDENTIAL,10000,0,10000,36000,0,46000
142232600700000,SE 232,EXEMPT,0,10000,10000,0,71800,81800
142232600800000,APARTMENT,MULTI-RES,11200,0,11200,93700,0,104900
142232600900000,APARTMENT,MULTI-RES,11200,0,11200,93700,0,104900
142232601000000,SE 232,RESIDENTIAL,10000,0,10000,0,0,10000
142232601100000,OFFICE,COMMERCIAL,0,22400,22400,0,76900,99300
142232601201000,OFFICE,EXEMPT,0,56500,56500,0,273700,330200
142232601201001,OFFICE,EXEMPT,0,56500,56500,0,289000,345500
142232601300000,FLAT PARKING,EXEMPT,0,102800,102800,0,21300,124100
142232601400000,SE 232,RESIDENTIAL,12500,0,12500,0,0,12500
142232601700000,SE 232,RESIDENTIAL,12500,0,12500,78700,0,91200
142232601800000,SE 232,RESIDENTIAL,12500,0,12500,46000,0,58500
142232601900000,SE 232,RESIDENTIAL,10000,0,10000,40500,0,50500
142232602000000,FLAT PARKING,EXEMPT,0,44800,44800,0,13300,58100
142232602200000,SE 232,RESIDENTIAL,10000,0,10000,32900,0,42900
142232602300000,SE 232,RESIDENTIAL,10000,0,10000,45800,0,55800
142232602400000,FLAT PARKING,EXEMPT,0,22400,22400,0,8200,30600
142232602500000,FLAT PARKING,EXEMPT,0,83000,83000,0,29400,112400
142232602600000,SECTION 42,COMMERCIAL,0,22400,22400,0,65800,88200
142232700100000,OFFICE; MEDICAL,COMMERCIAL,0,125800,125800,0,803800,929600
142232700400000,APARTMENT,EXEMPT,0,30800,30800,0,131400,162200
142232700500000,SE 232,RESIDENTIAL,7600,0,7600,0,0,7600
142232700600000,SE 232,RESIDENTIAL,10000,0,10000,0,0,10000
142232700700000,CONVERSION-CENT CORE,MULTI-RES,10000,0,10000,56700,0,66700
142232700800000,SE 232,RESIDENTIAL,7500,0,7500,0,0,7500
142232700900000,SE 232,RESIDENTIAL,7900,0,7900,26700,0,34600
142232701000000,SE 232,RESIDENTIAL,7400,0,7400,0,0,7400
142232701100000,CONVERSION-CENT CORE,MULTI-RES,4300,0,4300,41000,0,45300
142232701200000,FLAT PARKING,COMMERCIAL,0,8300,8300,0,2100,10400
142232701300000,CONVERSION-CENT CORE,MULTI-RES,14100,0,14100,79400,0,93500
142232701500000,OFFICE,COMMERCIAL,41728,23472,65200,112368,54232,231800
142232701600000,CONVERSION-CENT CORE,MULTI-RES,12500,0,12500,42500,0,55000
142232701700000,CONVERSION-CENT CORE,MULTI-RES,17500,0,17500,91300,0,108800
142232701800000,SE 232,RESIDENTIAL,16800,0,16800,76500,0,93300
142232701900000,CONVERSION-CENT CORE,MULTI-RES,7500,0,7500,36700,0,44200
142232702000000,SE 232,RESIDENTIAL,7500,0,7500,46600,0,54100
142232702100000,SE 232,RESIDENTIAL,7500,0,7500,35100,0,42600
142232702200000,CONVERSION-CENT CORE,MULTI-RES,7500,0,7500,24900,0,32400
142232702300000,OFFICE; MEDICAL,COMMERCIAL,0,113100,113100,0,917000,1030100
142232702400000,CONVERSION-CENT CORE,MULTI-RES,9000,0,9000,44100,0,53100
142232800100000,FLAT PARKING,COMMERCIAL,0,32200,32200,0,5500,37700
142232800200000,VACANT LAND,COMMERCIAL,0,34200,34200,0,0,34200
142232800300000,FLAT PARKING,COMMERCIAL,0,23800,23800,0,4600,28400
142232800400000,FLAT PARKING,COMMERCIAL,0,23800,23800,0,2100,25900
142232800500000,SMALL RETAIL,COMMERCIAL,0,16800,16800,0,32200,49000
142232800600000,SMALL RETAIL,COMMERCIAL,0,16800,16800,0,30900,47700
142232800700000,SMALL RETAIL,COMMERCIAL,0,51800,51800,0,197900,249700
142232800800000,CONVENIENCE STORE,COMMERCIAL,0,201600,201600,0,256900,458500
142232800900000,FLAT PARKING,COMMERCIAL,0,100800,100800,0,6400,107200
142232900100000,RESTAURANT,COMMERCIAL,0,100800,100800,0,71400,172200
142232900102000,BILLBOARD(BLL),COMMERCIAL,0,0,0,0,40900,40900
142232900300000,VACANT LAND,COMMERCIAL,0,0,0,0,0,0
142232900400000,OFFICE,COMMERCIAL,0,100800,100800,0,340200,441000
142233000700000,VACANT LAND,COMMERCIAL,0,0,0,0,0,0
142233001100000,OFFICE; MED; CTRL CR,COMMERCIAL,0,552500,552500,0,8833800,9386300
142233100100000,SR/NURSING/ASSTD LIV,EXEMPT,0,488000,488000,0,2934000,3422000
142233100200000,FLAT PARKING,COMMERCIAL,0,28900,28900,0,6900,35800
142233100300000,FLAT PARKING,COMMERCIAL,0,22800,22800,0,10500,33300
142233100400000,FLAT PARKING,COMMERCIAL,0,25800,25800,0,11900,37700
142233100500000,FLAT PARKING,COMMERCIAL,0,30900,30900,0,14200,45100
142233100600000,FLAT PARKING,COMMERCIAL,0,30900,30900,0,17900,48800
142233100700000,FLAT PARKING,COMMERCIAL,0,20600,20600,0,5500,26100
142233100900000,FLAT PARKING,COMMERCIAL,0,64300,64300,0,7100,71400
142233101000000,FLAT PARKING,COMMERCIAL,0,77100,77100,0,8400,85500
142233101100000,FLAT PARKING,COMMERCIAL,0,77100,77100,0,7700,84800
142233101200000,OFFICE; MEDICAL,COMMERCIAL,0,323200,323200,0,2520800,2844000
142233101500000,VACANT LAND,EXEMPT,0,31200,31200,0,0,31200
142233101700000,OFFICE,EXEMPT,0,36600,36600,0,530000,566600
142233200600000,SE 232,EXEMPT,0,100800,100800,0,0,100800
142233200700000,VACANT LAND,COMMERCIAL,0,12600,12600,0,0,12600
142233200800000,WAREHOUSE,COMMERCIAL,0,16800,16800,0,87500,104300
142233201000000,OFFICE; MEDICAL,EXEMPT,0,20400,20400,0,149600,170000
142233201100000,VACANT LAND,EXEMPT,0,58000,58000,0,0,58000
142233201200000,SR/NURSING/ASSTD LIV,EXEMPT,0,278400,278400,0,2672000,2950400
142233201300000,SE 232,RESIDENTIAL,9700,0,9700,56600,0,66300
142233201400000,SE 232,RESIDENTIAL,10900,0,10900,42600,0,53500
142233201500000,APARTMENT,EXEMPT,0,125500,125500,0,193900,319400
142233300100000,SMALL RETAIL,COMMERCIAL,2650,2650,5300,54000,54000,113300
142233300200000,FLAT PARKING,COMMERCIAL,0,5200,5200,0,1400,6600
142233300300000,SE 232,RESIDENTIAL,4200,0,4200,41700,0,45900
142233300400000,SE 232,RESIDENTIAL,6800,0,6800,35100,0,41900
142233300500000,SE 232,RESIDENTIAL,5400,0,5400,35400,0,40800
142233300600000,OFFICE,COMMERCIAL,0,934000,934000,0,2996900,3930900
142233400100000,CONVERSION-CENT CORE,MULTI-RES,9200,0,9200,38100,0,47300
142233400200000,SE 232,RESIDENTIAL,10000,0,10000,53700,0,63700
142233400300000,SE 232,RESIDENTIAL,12800,0,12800,31400,0,44200
142233400400000,SE 232,RESIDENTIAL,7500,0,7500,39500,0,47000
142233400500000,SE 232,RESIDENTIAL,7500,0,7500,29500,0,37000
142233400600000,SE 232,RESIDENTIAL,12800,0,12800,54100,0,66900
142233400700000,CONVERSION-CENT CORE,RESIDENTIAL,7500,0,7500,39200,0,46700
142233400800000,SE 232,RESIDENTIAL,7500,0,7500,46000,0,53500
142233400900000,CONVERSION-CENT CORE,MULTI-RES,11000,0,11000,56400,0,67400
142233401000000,SE 232,RESIDENTIAL,7000,0,7000,35100,0,42100
142233401100000,SE 232,RESIDENTIAL,6700,0,6700,40300,0,47000
142233401200000,SE 232,RESIDENTIAL,6700,0,6700,52200,0,58900
142233401300000,SE 232,RESIDENTIAL,4500,0,4500,0,0,4500
142233401400000,SE 232,RESIDENTIAL,12800,0,12800,0,0,12800
142233401500000,SE 232,RESIDENTIAL,8000,0,8000,52400,0,60400
142233401600000,SE 232,RESIDENTIAL,6800,0,6800,30600,0,37400
142233401700000,SE 232,EXEMPT,0,7300,7300,0,27800,35100
142233500100000,SE 232,EXEMPT,0,12800,12800,0,61700,74500
142233500200000,SE 232,EXEMPT,0,7700,7700,0,38200,45900
142235100100000,SE 232,RESIDENTIAL,7000,0,7000,0,0,7000
142235100200000,SE 232,RESIDENTIAL,3400,0,3400,39700,0,43100
142235100300000,SE 232,RESIDENTIAL,4500,0,4500,26800,0,31300
142235200100000,SCHOOL,EXEMPT,0,0,0,0,0,0
142235200200000,SCHOOL,EXEMPT,0,0,0,0,0,0
142235200300000,SCHOOL,EXEMPT,0,0,0,0,0,0
142235200400000,SE 232,RESIDENTIAL,6200,0,6200,39500,0,45700
142235200500000,SCHOOL,EXEMPT,0,0,0,0,0,0
142235200600000,SCHOOL,EXEMPT,0,0,0,0,0,0
142235200700000,SE 232,RESIDENTIAL,5700,0,5700,38200,0,43900
142235200800000,SE 232,RESIDENTIAL,5700,0,5700,0,0,5700
142235200900000,SE 232,EXEMPT,0,12900,12900,0,0,12900
142235201000000,SE 232,RESIDENTIAL,4900,0,4900,0,0,4900
142235201100000,SE 232,RESIDENTIAL,7600,0,7600,36900,0,44500
142235201200000,SCHOOL,EXEMPT,0,0,0,0,0,0
142235201300000,SE 232,RESIDENTIAL,8800,0,8800,38100,0,46900
142235201400000,SCHOOL,EXEMPT,0,0,0,0,0,0
142235201500000,SCHOOL,EXEMPT,0,0,0,0,0,0
142235201600000,SCHOOL,EXEMPT,0,0,0,0,0,0
142235201700000,SCHOOL,EXEMPT,0,0,0,0,0,0
142235202000000,SE 232,RESIDENTIAL,9900,0,9900,0,0,9900
142235202100000,CITY PROPERTY,EXEMPT,0,0,0,0,0,0
142235202200000,CONVERSION-CENT CORE,MULTI-RES,8300,0,8300,59000,0,67300
142235202300000,SE 232,RESIDENTIAL,7400,0,7400,31900,0,39300
142235202400000,SE 232,RESIDENTIAL,7400,0,7400,28500,0,35900
142235202500000,SE 232,RESIDENTIAL,12500,0,12500,50800,0,63300
142235202600000,SE 232,RESIDENTIAL,7000,0,7000,37200,0,44200
142235202700000,SE 232,EXEMPT,0,8400,8400,0,66200,74600
142235202800000,CONVERSION-CENT CORE,MULTI-RES,11000,0,11000,51200,0,62200
142235202900000,SE 232,RESIDENTIAL,11500,0,11500,42100,0,53600
142235203000000,SE 232,RESIDENTIAL,12500,0,12500,0,0,12500
142235203100000,SCHOOL,EXEMPT,0,0,0,0,0,0
142235203200000,SCHOOL,EXEMPT,0,0,0,0,0,0
142235203300000,SCHOOL,EXEMPT,0,0,0,0,0,0
142235203500000,FLAT PARKING,EXEMPT,0,278800,278800,0,16700,295500
142235203600000,SE 232,RESIDENTIAL,8100,0,8100,34800,0,42900
142235203700000,VACANT LAND,EXEMPT,0,19800,19800,0,0,19800
142235203800000,OFFICE; MEDICAL,EXEMPT,0,260800,260800,0,407600,668400
142235203900000,FLAT PARKING,EXEMPT,0,37800,37800,0,3600,41400
142235204000000,OFFICE; MEDICAL,COMMERCIAL,0,159400,159400,0,255700,415100
142235204100000,VACANT LAND,EXEMPT,0,78500,78500,0,0,78500
142235204400000,OFFICE,COMMERCIAL,0,25400,25400,0,90800,116200
142235300100000,NBHD SHOPPING CENTER,COMMERCIAL,0,496000,496000,0,1046200,1542200
142235400100000,OFFICE; MED; CTRL CR,COMMERCIAL,0,142500,142500,0,400600,543100
142235400102000,BILLBOARD(BLL),COMMERCIAL,0,0,0,0,20300,20300
142235400200000,OFFICE; MED; CTRL CR,COMMERCIAL,0,854000,854000,0,2386300,3240300
142235500800000,FLAT PARKING,COMMERCIAL,0,62000,62000,0,8000,70000
142235500900000,HOSPITAL,COMMERCIAL,0,3510000,3510000,0,158341600,161851600
142235600100000,WAREHOUSE,EXEMPT,0,398900,398900,0,180800,579700
142235600400000,CITY PROPERTY,EXEMPT,0,0,0,0,0,0
142235600500000,CITY PROPERTY,EXEMPT,0,0,0,0,0,0
142235600600000,VACANT LAND,EXEMPT,0,3600,3600,0,0,3600
142235600900000,FLAT PARKING,EXEMPT,0,27000,27000,0,4200,31200
142237600100000,SE 231,RESIDENTIAL,8800,0,8800,40600,0,49400
142237600200000,SE 231,RESIDENTIAL,8900,0,8900,27300,0,36200
142237600300000,SE 231,RESIDENTIAL,11700,0,11700,53200,0,64900
142237600400000,SE 231,RESIDENTIAL,10200,0,10200,35600,0,45800
142237600500000,SE 231,RESIDENTIAL,14000,0,14000,26100,0,40100
142237600600000,SE 231,RESIDENTIAL,14000,0,14000,52300,0,66300
142237600700000,SE 231,RESIDENTIAL,14000,0,14000,63400,0,77400
142237600800000,SE 231,RESIDENTIAL,14000,0,14000,56300,0,70300
142237600900000,SE 231,RESIDENTIAL,14000,0,14000,60900,0,74900
142237601000000,SE 231,RESIDENTIAL,14000,0,14000,53800,0,67800
142237601100000,SE 231,RESIDENTIAL,14000,0,14000,55800,0,69800
142237601200000,SE 231,RESIDENTIAL,14000,0,14000,46700,0,60700
142237601300000,SE 231,RESIDENTIAL,14000,0,14000,52100,0,66100
142237601400000,SE 231,RESIDENTIAL,14000,0,14000,35100,0,49100
142237601500000,SE 231,RESIDENTIAL,14000,0,14000,35100,0,49100
142237601600000,SE 231,RESIDENTIAL,14000,0,14000,51700,0,65700
142237601700000,SE 231,RESIDENTIAL,14000,0,14000,7300,0,21300
142237601800000,SE 231,RESIDENTIAL,8100,0,8100,34100,0,42200
142237601900000,SE 231,RESIDENTIAL,7800,0,7800,35900,0,43700
142237602000000,SE 231,RESIDENTIAL,12900,0,12900,42200,0,55100
142237700100000,SE 231,RESIDENTIAL,10400,0,10400,42000,0,52400
142237700200000,SE 231,RESIDENTIAL,10500,0,10500,42800,0,53300
142237700300000,SE 231,RESIDENTIAL,11700,0,11700,21000,0,32700
142237700400000,SE 231,RESIDENTIAL,8400,0,8400,20000,0,28400
142237700500000,SE 231,RESIDENTIAL,8700,0,8700,39900,0,48600
142237700600000,SE 231,RESIDENTIAL,11600,0,11600,37900,0,49500
142237700700000,SE 231,RESIDENTIAL,14000,0,14000,38400,0,52400
142237700800000,SE 231,RESIDENTIAL,14000,0,14000,68400,0,82400
142237700900000,SE 231,RESIDENTIAL,14000,0,14000,33400,0,47400
142237701000000,SE 231,RESIDENTIAL,14000,0,14000,14100,0,28100
142237701100000,SE 231,EXEMPT,0,12600,12600,0,44800,57400
142237701300000,SE 231,EXEMPT,0,7100,7100,39200,0,46300
142237701400000,SE 231,EXEMPT,0,2600,2600,0,0,2600
142237701500000,SE 231,EXEMPT,0,5600,5600,0,0,5600
142237800100000,SMALL RETAIL,COMMERCIAL,23408,38192,61600,49916,104284,215800
142237800200000,SE 231,RESIDENTIAL,14000,0,14000,44700,0,58700
142237800300000,FLAT PARKING,COMMERCIAL,0,16800,16800,0,6700,23500
142237900100000,SE 231,RESIDENTIAL,10000,0,10000,49100,0,59100
142237900200000,SE 231,RESIDENTIAL,8900,0,8900,36400,0,45300
142237900300000,SE 231,RESIDENTIAL,14000,0,14000,63200,0,77200
142237900400000,SE 231,RESIDENTIAL,14000,0,14000,48300,0,62300
142237900500000,SE 231,RESIDENTIAL,14000,0,14000,54300,0,68300
142237900600000,SE 231,RESIDENTIAL,14000,0,14000,68600,0,82600
142237900700000,SE 231,RESIDENTIAL,14000,0,14000,55500,0,69500
142237900800000,SE 231,RESIDENTIAL,14000,0,14000,38400,0,52400
142237900900000,SE 231,RESIDENTIAL,14000,0,14000,40400,0,54400
142237901000000,SE 231,RESIDENTIAL,14000,0,14000,54300,0,68300
142237901100000,SE 231,RESIDENTIAL,14000,0,14000,48500,0,62500
142237901200000,SE 231,RESIDENTIAL,14000,0,14000,39800,0,53800
142237901300000,SE 231,RESIDENTIAL,14000,0,14000,70500,0,84500
142237901400000,SE 231,RESIDENTIAL,14000,0,14000,43900,0,57900
142237901500000,SE 231,RESIDENTIAL,14000,0,14000,50200,0,64200
142237901600000,SE 231,RESIDENTIAL,9000,0,9000,36500,0,45500
142237901700000,SE 231,RESIDENTIAL,8900,0,8900,41200,0,50100
142237901800000,SE 231,RESIDENTIAL,7800,0,7800,35400,0,43200
142237901900000,SE 231,RESIDENTIAL,7600,0,7600,41500,0,49100
142237902000000,SE 231,RESIDENTIAL,12900,0,12900,42600,0,55500
142237902100000,SE 231,RESIDENTIAL,7400,0,7400,44900,0,52300
142237902200000,SE 231,RESIDENTIAL,7100,0,7100,37200,0,44300
142237902300000,SE 231,RESIDENTIAL,14000,0,14000,46000,0,60000
142237902400000,SE 231,RESIDENTIAL,14000,0,14000,48000,0,62000
142237902500000,SE 231,RESIDENTIAL,14000,0,14000,40300,0,54300
142237902600000,SE 231,RESIDENTIAL,14000,0,14000,47700,0,61700
142237902700000,SE 231,RESIDENTIAL,14000,0,14000,58100,0,72100
142237902800000,SE 231,RESIDENTIAL,14000,0,14000,62300,0,76300
142237902900000,SE 231,RESIDENTIAL,14000,0,14000,39600,0,53600
142237903000000,SE 231,RESIDENTIAL,14000,0,14000,53900,0,67900
142237903100000,SE 231,RESIDENTIAL,14000,0,14000,56000,0,70000
142237903200000,SE 231,RESIDENTIAL,14000,0,14000,43500,0,57500
142237903300000,SE 231,RESIDENTIAL,14000,0,14000,42900,0,56900
142237903400000,SE 231,RESIDENTIAL,11700,0,11700,41800,0,53500
142237903500000,SE 231,RESIDENTIAL,11700,0,11700,39300,0,51000
142237903600000,SE 231,RESIDENTIAL,11700,0,11700,64300,0,76000
142237903700000,SE 231,RESIDENTIAL,13400,0,13400,57200,0,70600
142237903800000,SE 231,RESIDENTIAL,7300,0,7300,34500,0,41800
142237903900000,SE 231,RESIDENTIAL,7300,0,7300,45300,0,52600
142237904000000,SE 231,RESIDENTIAL,8600,0,8600,25600,0,34200
142237904100000,SE 231,RESIDENTIAL,8500,0,8500,26800,0,35300
142238000100000,SE 231,RESIDENTIAL,12600,0,12600,40800,0,53400
142238000200000,SE 231,RESIDENTIAL,14000,0,14000,44200,0,58200
142238000300000,SE 231,RESIDENTIAL,14000,0,14000,64000,0,78000
142238000400000,SE 231,RESIDENTIAL,14000,0,14000,45100,0,59100
142238000500000,SE 231,EXEMPT,0,14000,14000,0,24600,38600
142238000600000,SE 231,RESIDENTIAL,14000,0,14000,44000,0,58000
142238000700000,SE 231,RESIDENTIAL,14000,0,14000,45600,0,59600
142238000800000,SE 231,RESIDENTIAL,9200,0,9200,26700,0,35900
142238000900000,SE 231,RESIDENTIAL,9900,0,9900,47300,0,57200
142238001000000,SE 231,RESIDENTIAL,11200,0,11200,59700,0,70900
142238001100000,SE 231,RESIDENTIAL,7100,0,7100,46200,0,53300
142238001200000,SE 231,RESIDENTIAL,7600,0,7600,36200,0,43800
142238001300000,SE 231,RESIDENTIAL,12300,0,12300,51500,0,63800
142238001400000,SE 231,RESIDENTIAL,14000,0,14000,47700,0,61700
142238001500000,SE 231,RESIDENTIAL,14000,0,14000,57600,0,71600
142238001600000,SE 231,RESIDENTIAL,14000,0,14000,46200,0,60200
142238001700000,SE 231,RESIDENTIAL,17500,0,17500,55000,0,72500
142238001800000,SE 231,RESIDENTIAL,17500,0,17500,60200,0,77700
142238001900000,SE 231,RESIDENTIAL,15300,0,15300,59000,0,74300
142238002000000,SE 231,RESIDENTIAL,8800,0,8800,38200,0,47000
142238002100000,SE 231,RESIDENTIAL,8900,0,8900,7800,0,16700
142238002200000,SE 231,RESIDENTIAL,7600,0,7600,33700,0,41300
142238002300000,SE 231,RESIDENTIAL,7500,0,7500,45200,0,52700
142238100100000,SE 231,RESIDENTIAL,7800,0,7800,46000,0,53800
142238100200000,SE 231,RESIDENTIAL,8700,0,8700,37200,0,45900
142238100300000,SE 231,RESIDENTIAL,7600,0,7600,33000,0,40600
142238100400000,SE 231,RESIDENTIAL,7600,0,7600,38200,0,45800
142238100500000,SE 231,RESIDENTIAL,7100,0,7100,12000,0,19100
142238100600000,SE 231,RESIDENTIAL,7100,0,7100,16300,0,23400
142238100700000,SE 231,RESIDENTIAL,7700,0,7700,39600,0,47300
142238100800000,SE 231,RESIDENTIAL,7700,0,7700,36400,0,44100
142238100900000,SE 231,RESIDENTIAL,15600,0,15600,43800,0,59400
142238101000000,SE 231,RESIDENTIAL,14000,0,14000,52800,0,66800
142238101100000,SE 231,RESIDENTIAL,14000,0,14000,52300,0,66300
142238101200000,SE 231,RESIDENTIAL,14000,0,14000,26100,0,40100
142238101300000,SE 231,RESIDENTIAL,14000,0,14000,48000,0,62000
142238101400000,SE 231,RESIDENTIAL,14000,0,14000,37600,0,51600
142238101500000,SE 231,RESIDENTIAL,14000,0,14000,52100,0,66100
142238101600000,SE 231,RESIDENTIAL,17500,0,17500,11800,0,29300
142238101700000,SE 231,RESIDENTIAL,14000,0,14000,26800,0,40800
142238101800000,SE 231,RESIDENTIAL,14000,0,14000,46500,0,60500
142238101900000,SE 231,RESIDENTIAL,14000,0,14000,43400,0,57400
142238102000000,SE 231,RESIDENTIAL,17500,0,17500,68800,0,86300
142238102100000,SE 231,RESIDENTIAL,14000,0,14000,25800,0,39800
142238102200000,SE 231,RESIDENTIAL,14000,0,14000,35600,0,49600
142238102300000,SE 231,RESIDENTIAL,17900,0,17900,47200,0,65100
142238102400000,SE 231,RESIDENTIAL,18800,0,18800,60800,0,79600
142238102500000,SE 230,RESIDENTIAL,23900,0,23900,63000,0,86900
142238102600000,SE 231,RESIDENTIAL,5800,0,5800,29400,0,35200
142238102700000,SE 230,RESIDENTIAL,23400,0,23400,86200,0,109600
142238102800000,SE 230,RESIDENTIAL,19300,0,19300,77100,0,96400
142238102900000,SE 231,RESIDENTIAL,17300,0,17300,59600,0,76900
142238103000000,SE 231,RESIDENTIAL,13900,0,13900,58000,0,71900
142238103100000,SE 231,RESIDENTIAL,13900,0,13900,54400,0,68300
142238103200000,SE 231,RESIDENTIAL,13900,0,13900,43400,0,57300
142238103300000,SE 231,RESIDENTIAL,4500,0,4500,20000,0,24500
142238103400000,SE 231,RESIDENTIAL,9400,0,9400,47500,0,56900
142238200100000,SE 231,RESIDENTIAL,12100,0,12100,49100,0,61200
142238200200000,SE 231,RESIDENTIAL,11000,0,11000,38200,0,49200
142238200300000,SE 231,RESIDENTIAL,11000,0,11000,46700,0,57700
142238200400000,SE 231,RESIDENTIAL,8900,0,8900,42000,0,50900
142238200500000,SE 231,RESIDENTIAL,11800,0,11800,40200,0,52000
142238200600000,SE 231,RESIDENTIAL,14000,0,14000,56800,0,70800
142238200700000,SE 231,RESIDENTIAL,10500,0,10500,42200,0,52700
142238200800000,SE 231,RESIDENTIAL,10500,0,10500,38400,0,48900
142238200900000,SE 231,RESIDENTIAL,14000,0,14000,63800,0,77800
142238201000000,SE 231,RESIDENTIAL,14000,0,14000,51300,0,65300
142238201100000,SE 231,RESIDENTIAL,14000,0,14000,53600,0,67600
142238201200000,SE 231,RESIDENTIAL,14000,0,14000,45800,0,59800
142238201300000,SE 231,RESIDENTIAL,14000,0,14000,42900,0,56900
142238201400000,SE 231,RESIDENTIAL,14000,0,14000,46400,0,60400
142238201500000,SE 231,RESIDENTIAL,14000,0,14000,50500,0,64500
142238201600000,SE 231,RESIDENTIAL,14000,0,14000,50500,0,64500
142238201700000,SE 231,RESIDENTIAL,14000,0,14000,57000,0,71000
142238201800000,SE 231,RESIDENTIAL,14000,0,14000,35400,0,49400
142238201900000,SE 231,RESIDENTIAL,14000,0,14000,44600,0,58600
142238202000000,SE 231,RESIDENTIAL,17900,0,17900,54100,0,72000
142238202100000,AUTO REPAIR/SALES,COMMERCIAL,0,13000,13000,0,14000,27000
142238202200000,SMALL RETAIL,COMMERCIAL,0,18500,18500,0,63600,82100
142238202300000,SMALL RETAIL,COMMERCIAL,5040,6960,12000,24990,34510,71500
142238202400000,SE 231,RESIDENTIAL,14800,0,14800,44800,0,59600
142238202500000,SE 231,RESIDENTIAL,14000,0,14000,28200,0,42200
142238202600000,SE 231,RESIDENTIAL,14000,0,14000,40200,0,54200
142238202700000,SE 231,RESIDENTIAL,14000,0,14000,56900,0,70900
142238202800000,SE 231,RESIDENTIAL,14000,0,14000,38700,0,52700
142238202900000,SE 231,RESIDENTIAL,12600,0,12600,56900,0,69500
142238203000000,SE 231,RESIDENTIAL,15400,0,15400,45900,0,61300
142238203100000,SE 231,RESIDENTIAL,14000,0,14000,40900,0,54900
142238203200000,SE 231,RESIDENTIAL,14000,0,14000,39700,0,53700
142238203300000,SE 231,RESIDENTIAL,12600,0,12600,56700,0,69300
142238203400000,SE 231,RESIDENTIAL,14000,0,14000,34100,0,48100
142238203500000,SE 231,RESIDENTIAL,14000,0,14000,57200,0,71200
142238203600000,SE 231,RESIDENTIAL,14000,0,14000,43200,0,57200
142238203700000,SE 231,RESIDENTIAL,14000,0,14000,46700,0,60700
142238203800000,SE 231,RESIDENTIAL,12200,0,12200,42100,0,54300
142238300100000,SE 231,RESIDENTIAL,7000,0,7000,34800,0,41800
142238300200000,SE 231,RESIDENTIAL,7600,0,7600,46900,0,54500
142238300300000,SE 231,RESIDENTIAL,7600,0,7600,44600,0,52200
142238300400000,SE 231,RESIDENTIAL,7600,0,7600,49000,0,56600
142238300500000,SE 231,RESIDENTIAL,12200,0,12200,49800,0,62000
142238300600000,SE 231,RESIDENTIAL,14800,0,14800,55200,0,70000
142238300700000,SE 231,RESIDENTIAL,14800,0,14800,42000,0,56800
142238300800000,SE 231,RESIDENTIAL,14800,0,14800,55000,0,69800
142238300900000,SE 231,RESIDENTIAL,14800,0,14800,57100,0,71900
142238301000000,SE 231,RESIDENTIAL,14800,0,14800,62100,0,76900
142238301100000,SE 231,RESIDENTIAL,14800,0,14800,67600,0,82400
142238301200000,SE 231,RESIDENTIAL,14800,0,14800,47600,0,62400
142238301300000,SE 231,RESIDENTIAL,3300,0,3300,800,0,4100
142238301400000,SE 231,RESIDENTIAL,15200,0,15200,49600,0,64800
142238301500000,SMALL RETAIL,COMMERCIAL,7038,23562,30600,22011,73989,126600
142238302200000,SE 231,RESIDENTIAL,18900,0,18900,53800,0,72700
142238302300000,SE 231,RESIDENTIAL,15200,0,15200,49200,0,64400
142238302400000,SE 231,RESIDENTIAL,15400,0,15400,44600,0,60000
142238302500000,SE 231,RESIDENTIAL,14800,0,14800,42100,0,56900
142238302600000,SE 231,RESIDENTIAL,14800,0,14800,39300,0,54100
142238302700000,SE 231,RESIDENTIAL,11100,0,11100,46400,0,57500
142238302800000,SE 231,RESIDENTIAL,13000,0,13000,58200,0,71200
142238302900000,SE 231,RESIDENTIAL,13000,0,13000,32700,0,45700
142238303000000,SE 231,RESIDENTIAL,18900,0,18900,56600,0,75500
142238303100000,SE 231,RESIDENTIAL,7000,0,7000,27100,0,34100
142238303200000,SE 231,RESIDENTIAL,11900,0,11900,34200,0,46100
142238303300000,CONVENIENCE STORE,COMMERCIAL,0,270400,270400,0,1065200,1335600
142240100100000,SE 228,RESIDENTIAL,25700,0,25700,111900,0,137600
142240100200000,SE 228,RESIDENTIAL,26300,0,26300,109700,0,136000
142240100300000,SE 228,RESIDENTIAL,31500,0,31500,152600,0,184100
142240100400000,SE 228,RESIDENTIAL,31500,0,31500,133000,0,164500
142240100500000,SE 228,RESIDENTIAL,31500,0,31500,138500,0,170000
142240100600000,SE 228,RESIDENTIAL,31500,0,31500,123200,0,154700
142240100700000,SE 228,RESIDENTIAL,31500,0,31500,137900,0,169400
142240100800000,SE 228,RESIDENTIAL,31500,0,31500,140900,0,172400
142240100900000,SE 228,RESIDENTIAL,31500,0,31500,133200,0,164700
142240101000000,SE 228,RESIDENTIAL,32300,0,32300,214500,0,246800
142240101100000,SE 228,RESIDENTIAL,29100,0,29100,156000,0,185100
142240101200000,SE 228,RESIDENTIAL,31500,0,31500,177000,0,208500
142240101300000,SE 228,RESIDENTIAL,31500,0,31500,110900,0,142400
142240101400000,SE 228,RESIDENTIAL,31500,0,31500,93100,0,124600
142240101500000,SE 228,RESIDENTIAL,31500,0,31500,134500,0,166000
142240101600000,SE 228,RESIDENTIAL,31500,0,31500,145300,0,176800
142240101700000,SE 228,RESIDENTIAL,35400,0,35400,150800,0,186200
142240101800000,SE 228,RESIDENTIAL,35400,0,35400,122100,0,157500
142240101900000,SE 228,RESIDENTIAL,25200,0,25200,74100,0,99300
142240102000000,SE 228,RESIDENTIAL,21800,0,21800,94100,0,115900
142240102100000,SE 228,RESIDENTIAL,19900,0,19900,103600,0,123500
142240200100000,SE 228,RESIDENTIAL,32600,0,32600,156300,0,188900
142240200200000,SE 228,RESIDENTIAL,26300,0,26300,108900,0,135200
142240200300000,SE 228,RESIDENTIAL,31500,0,31500,132800,0,164300
142240200400000,SE 228,RESIDENTIAL,31500,0,31500,154400,0,185900
142240200500000,SE 228,RESIDENTIAL,31500,0,31500,108400,0,139900
142240200600000,SE 228,RESIDENTIAL,31500,0,31500,135700,0,167200
142240200700000,SE 228,RESIDENTIAL,33600,0,33600,94400,0,128000
142240200800000,SE 228,RESIDENTIAL,26300,0,26300,131200,0,157500
142240200900000,SE 228,RESIDENTIAL,26300,0,26300,102200,0,128500
142240201000000,SE 228,RESIDENTIAL,32300,0,32300,169500,0,201800
142240201100000,SE 228,RESIDENTIAL,19200,0,19200,78200,0,97400
142240201200000,SE 228,RESIDENTIAL,21700,0,21700,78700,0,100400
142240201300000,SE 228,RESIDENTIAL,31500,0,31500,97200,0,128700
142240201400000,SE 228,RESIDENTIAL,31500,0,31500,144000,0,175500
142240201500000,SE 228,RESIDENTIAL,31500,0,31500,156400,0,187900
142240201600000,SE 228,RESIDENTIAL,31500,0,31500,115300,0,146800
142240201700000,SE 228,RESIDENTIAL,31500,0,31500,165700,0,197200
142240201800000,SE 228,RESIDENTIAL,31500,0,31500,108800,0,140300
142240201900000,SE 228,RESIDENTIAL,31500,0,31500,101800,0,133300
142240202000000,SE 228,RESIDENTIAL,31500,0,31500,168300,0,199800
142240202100000,SE 228,RESIDENTIAL,27100,0,27100,127900,0,155000
142240202200000,SE 228,RESIDENTIAL,16800,0,16800,93900,0,110700
142240300100000,SE 228,RESIDENTIAL,27800,0,27800,96600,0,124400
142240300200000,SE 228,RESIDENTIAL,27100,0,27100,82700,0,109800
142240300300000,SE 228,RESIDENTIAL,31100,0,31100,121100,0,152200
142240300400000,SE 228,RESIDENTIAL,32100,0,32100,145900,0,178000
142240300500000,SE 228,RESIDENTIAL,31500,0,31500,211100,0,242600
142240300600000,SE 228,RESIDENTIAL,31500,0,31500,103200,0,134700
142240300700000,SE 228,RESIDENTIAL,31500,0,31500,117300,0,148800
142240300800000,SE 228,RESIDENTIAL,31500,0,31500,116200,0,147700
142240300900000,SE 228,RESIDENTIAL,27100,0,27100,109000,0,136100
142240301000000,SE 228,RESIDENTIAL,16800,0,16800,81600,0,98400
142240301100000,SE 228,RESIDENTIAL,16300,0,16300,98800,0,115100
142240301200000,SE 228,RESIDENTIAL,29400,0,29400,88900,0,118300
142240301300000,SE 228,RESIDENTIAL,39000,0,39000,114600,0,153600
142240301400000,SE 228,RESIDENTIAL,39000,0,39000,218300,0,257300
142240301500000,SE 228,RESIDENTIAL,39000,0,39000,167000,0,206000
142240301600000,SE 228,RESIDENTIAL,39000,0,39000,115600,0,154600
142240301700000,SE 228,RESIDENTIAL,38300,0,38300,192500,0,230800
142240301800000,SE 228,RESIDENTIAL,38300,0,38300,193400,0,231700
142240301900000,SE 228,RESIDENTIAL,40500,0,40500,179600,0,220100
142240302000000,SE 228,RESIDENTIAL,38800,0,38800,127600,0,166400
142240302100000,SE 228,RESIDENTIAL,37900,0,37900,148900,0,186800
142240400100000,SE 228,RESIDENTIAL,27600,0,27600,121800,0,149400
142240400200000,SE 228,RESIDENTIAL,31500,0,31500,72600,0,104100
142240400300000,SE 228,RESIDENTIAL,31500,0,31500,132300,0,163800
142240400400000,SE 228,RESIDENTIAL,31500,0,31500,126900,0,158400
142240400500000,SE 228,RESIDENTIAL,31500,0,31500,107300,0,138800
142240400600000,SE 228,RESIDENTIAL,31500,0,31500,94400,0,125900
142240400700000,SE 228,RESIDENTIAL,31500,0,31500,117100,0,148600
142240400800000,SE 228,RESIDENTIAL,31500,0,31500,129500,0,161000
142240400900000,SE 228,RESIDENTIAL,31500,0,31500,103900,0,135400
142240401000000,SE 228,RESIDENTIAL,28400,0,28400,127000,0,155400
142240401100000,SE 228,RESIDENTIAL,14400,0,14400,85500,0,99900
142240401200000,SE 228,RESIDENTIAL,29100,0,29100,74000,0,103100
142240401300000,SE 228,RESIDENTIAL,31500,0,31500,164000,0,195500
142240401400000,SE 228,RESIDENTIAL,31500,0,31500,118800,0,150300
142240401500000,SE 228,RESIDENTIAL,31500,0,31500,186100,0,217600
142240401600000,SE 228,RESIDENTIAL,31500,0,31500,128300,0,159800
142240401700000,SE 228,RESIDENTIAL,31500,0,31500,145400,0,176900
142240401800000,SE 228,RESIDENTIAL,31500,0,31500,118700,0,150200
142240401900000,SE 228,RESIDENTIAL,31500,0,31500,133700,0,165200
142240402000000,SE 228,RESIDENTIAL,31500,0,31500,160800,0,192300
142240402100000,SE 228,RESIDENTIAL,27100,0,27100,143100,0,170200
142240402200000,SE 228,RESIDENTIAL,16800,0,16800,89200,0,106000
142240500100000,CITY PROPERTY,EXEMPT,0,0,0,0,0,0
142240600100000,SE 247,RESIDENTIAL,73500,0,73500,199400,0,272900
142240600200000,SE 247,RESIDENTIAL,74500,0,74500,132800,0,207300
142240600300000,SE 247,RESIDENTIAL,76700,0,76700,141400,0,218100
142240600400000,SE 247,RESIDENTIAL,68500,0,68500,218800,0,287300
142240600500000,SE 247,RESIDENTIAL,71200,0,71200,163100,0,234300
142240600600000,SE 247,RESIDENTIAL,73500,0,73500,194500,0,268000
142240600700000,SE 247,RESIDENTIAL,64800,0,64800,141700,0,206500
142240600800000,SE 247,RESIDENTIAL,60700,0,60700,174400,0,235100
142240600900000,SE 247,RESIDENTIAL,77800,0,77800,222400,0,300200
142240601000000,CITY PROPERTY,EXEMPT,0,0,0,0,0,0
142240601100000,SE 247,RESIDENTIAL,177000,0,177000,288400,0,465400
142240601200000,SE 247,RESIDENTIAL,54700,0,54700,162200,0,216900
142240601300000,SE 247,RESIDENTIAL,70800,0,70800,230700,0,301500
142240601400000,SE 247,RESIDENTIAL,66200,0,66200,203900,0,270100
142240601500000,SE 247,RESIDENTIAL,70500,0,70500,352100,0,422600
142240601600000,SE 247,RESIDENTIAL,900,0,900,0,0,900
142240700100000,SE 247,RESIDENTIAL,175200,0,175200,131900,0,307100
142240800100000,SE 247,RESIDENTIAL,143000,0,143000,234000,0,377000
142240800200000,SE 247,RESIDENTIAL,83300,0,83300,217100,0,300400
142240800300000,SE 247,RESIDENTIAL,68000,0,68000,107900,0,175900
142240800400000,SE 247,RESIDENTIAL,60000,0,60000,105100,0,165100
142240800500000,SE 247,RESIDENTIAL,67500,0,67500,247600,0,315100
142242600100000,SE 230,RESIDENTIAL,19400,0,19400,79100,0,98500
142242600200000,SE 230,RESIDENTIAL,14000,0,14000,69700,0,83700
142242600300000,SE 230,RESIDENTIAL,15800,0,15800,31500,0,47300
142242600400000,SE 230,RESIDENTIAL,17500,0,17500,78400,0,95900
142242600500000,SE 230,RESIDENTIAL,14000,0,14000,60000,0,74000
142242600600000,SE 230,RESIDENTIAL,14000,0,14000,78200,0,92200
142242600700000,SE 230,RESIDENTIAL,14000,0,14000,60000,0,74000
142242600800000,SE 230,RESIDENTIAL,8400,0,8400,62400,0,70800
142242600900000,SE 230,RESIDENTIAL,9100,0,9100,46700,0,55800
142242601000000,SE 230,RESIDENTIAL,7600,0,7600,54100,0,61700
142242601100000,SE 230,RESIDENTIAL,7500,0,7500,51500,0,59000
142242601200000,SE 230,RESIDENTIAL,7800,0,7800,56300,0,64100
142242601300000,SE 230,RESIDENTIAL,7800,0,7800,16300,0,24100
142242601400000,SE 230,RESIDENTIAL,14000,0,14000,51300,0,65300
142242601500000,SE 230,RESIDENTIAL,14000,0,14000,41800,0,55800
142242601600000,SE 230,RESIDENTIAL,14000,0,14000,64200,0,78200
142242601700000,SE 230,RESIDENTIAL,17500,0,17500,44000,0,61500
142242601800000,SE 230,RESIDENTIAL,17500,0,17500,82100,0,99600
142242601900000,SE 230,RESIDENTIAL,14000,0,14000,71200,0,85200
142242602000000,SE 230,RESIDENTIAL,14000,0,14000,45200,0,59200
142242602100000,SE 230,RESIDENTIAL,12500,0,12500,44700,0,57200
142242602200000,SE 230,RESIDENTIAL,14400,0,14400,83100,0,97500
142242602300000,SE 230,RESIDENTIAL,19000,0,19000,56600,0,75600
142242602400000,SE 230,RESIDENTIAL,20300,0,20300,51500,0,71800
142242700100000,SE 230,RESIDENTIAL,11200,0,11200,56200,0,67400
142242700200000,SE 230,RESIDENTIAL,12800,0,12800,43000,0,55800
142242700300000,SE 230,RESIDENTIAL,15800,0,15800,54600,0,70400
142242700400000,CONVERSION-CENT CORE,EXEMPT,0,20800,20800,0,66800,87600
142242700500000,SE 230,RESIDENTIAL,13700,0,13700,43100,0,56800
142242700600000,SE 230,RESIDENTIAL,11700,0,11700,48100,0,59800
142242700700000,SE 230,RESIDENTIAL,17900,0,17900,45000,0,62900
142242700800000,SE 230,RESIDENTIAL,14000,0,14000,55700,0,69700
142242700900000,SE 230,EXEMPT,0,14000,14000,64200,0,78200
142242701000000,SE 230,RESIDENTIAL,14000,0,14000,66000,0,80000
142242701100000,APARTMENT,RESIDENTIAL,16800,0,16800,123600,0,140400
142242701200000,SMALL RETAIL,EXEMPT,0,12600,12600,0,60100,72700
142242701300000,SE 230,RESIDENTIAL,6500,0,6500,34100,0,40600
142242701400000,SE 230,RESIDENTIAL,8700,0,8700,51000,0,59700
142242701500000,SE 230,RESIDENTIAL,13900,0,13900,58800,0,72700
142242701600000,SE 230,RESIDENTIAL,13900,0,13900,78400,0,92300
142242701700000,SE 230,RESIDENTIAL,17300,0,17300,74600,0,91900
142242701800000,SE 230,RESIDENTIAL,13600,0,13600,71200,0,84800
142242701900000,SE 230,RESIDENTIAL,13200,0,13200,72400,0,85600
142242702000000,SE 230,RESIDENTIAL,7700,0,7700,48000,0,55700
142242702100000,SE 230,RESIDENTIAL,8300,0,8300,63900,0,72200
142242702200000,SE 230,RESIDENTIAL,7500,0,7500,43400,0,50900
142242702300000,SE 230,RESIDENTIAL,7300,0,7300,12700,0,20000
142242702400000,SE 230,RESIDENTIAL,10800,0,10800,68400,0,79200
142242702500000,SE 230,RESIDENTIAL,10800,0,10800,56800,0,67600
142242800100000,SE 230,RESIDENTIAL,21000,0,21000,67800,0,88800
142242800200000,SE 230,RESIDENTIAL,11300,0,11300,80100,0,91400
142242800600000,SE 230,RESIDENTIAL,12200,0,12200,50100,0,62300
142242800700000,SE 230,RESIDENTIAL,11900,0,11900,48200,0,60100
142242800800000,SMALL RETAIL,EXEMPT,0,33000,33000,0,122100,155100
142242800900000,SE 230,RESIDENTIAL,7100,0,7100,12000,0,19100
142242801000000,SE 230,EXEMPT,0,7100,7100,0,44500,51600
142242801100000,SE 230,EXEMPT,0,8100,8100,0,19500,27600
142242801200000,SE 230,EXEMPT,0,8100,8100,0,27600,35700
142242801300000,SE 230,RESIDENTIAL,17900,0,17900,58400,0,76300
142242801400000,SE 230,RESIDENTIAL,10500,0,10500,54700,0,65200
142242801500000,SE 230,RESIDENTIAL,10500,0,10500,57100,0,67600
142242801600000,SE 230,RESIDENTIAL,17900,0,17900,47300,0,65200
142242801700000,SE 230,RESIDENTIAL,37000,0,37000,83900,0,120900
142242900100000,SE 230,RESIDENTIAL,15000,0,15000,81400,0,96400
142242900200000,SE 230,RESIDENTIAL,14000,0,14000,39500,0,53500
142242900300000,SE 230,RESIDENTIAL,14000,0,14000,51400,0,65400
142242900400000,SE 230,RESIDENTIAL,14000,0,14000,59100,0,73100
142242900500000,SE 230,RESIDENTIAL,14000,0,14000,63400,0,77400
142242900600000,SE 230,RESIDENTIAL,14000,0,14000,41400,0,55400
142242900700000,SE 230,RESIDENTIAL,10500,0,10500,40100,0,50600
142242900800000,SE 230,RESIDENTIAL,10500,0,10500,41600,0,52100
142242900900000,SE 230,RESIDENTIAL,10500,0,10500,49500,0,60000
142242901000000,SE 230,RESIDENTIAL,11800,0,11800,40200,0,52000
142242901100000,SE 230,RESIDENTIAL,9400,0,9400,42900,0,52300
142242901200000,SE 230,RESIDENTIAL,7600,0,7600,43100,0,50700
142242901300000,SE 230,RESIDENTIAL,7500,0,7500,34400,0,41900
142242901400000,SE 230,RESIDENTIAL,7400,0,7400,55000,0,62400
142242901500000,SE 230,RESIDENTIAL,8300,0,8300,45900,0,54200
142242901600000,SE 230,RESIDENTIAL,8500,0,8500,27200,0,35700
142242901700000,SE 230,RESIDENTIAL,7900,0,7900,35000,0,42900
142242901800000,SE 230,RESIDENTIAL,14000,0,14000,34500,0,48500
142242901900000,SE 230,RESIDENTIAL,14000,0,14000,59200,0,73200
142242902000000,SE 230,RESIDENTIAL,17500,0,17500,57800,0,75300
142242902100000,SE 230,RESIDENTIAL,17500,0,17500,59800,0,77300
142242902200000,SE 230,RESIDENTIAL,14000,0,14000,32100,0,46100
142242902300000,SE 230,RESIDENTIAL,14000,0,14000,76700,0,90700
142242902400000,SE 230,RESIDENTIAL,14000,0,14000,76800,0,90800
142242902500000,SE 230,RESIDENTIAL,14900,0,14900,65500,0,80400
142242902600000,SE 230,RESIDENTIAL,12800,0,12800,55800,0,68600
142242902700000,SE 230,RESIDENTIAL,15500,0,15500,58400,0,73900
142243000100000,SE 230,RESIDENTIAL,8500,0,8500,52100,0,60600
142243000200000,SE 230,RESIDENTIAL,8200,0,8200,39700,0,47900
142243000300000,SE 230,RESIDENTIAL,13300,0,13300,59300,0,72600
142243000400000,SE 230,RESIDENTIAL,12800,0,12800,44100,0,56900
142243000500000,SE 230,RESIDENTIAL,10500,0,10500,55600,0,66100
142243000600000,SE 230,RESIDENTIAL,10500,0,10500,0,0,10500
142243000700000,SE 230,RESIDENTIAL,10500,0,10500,42800,0,53300
142243000800000,SE 230,RESIDENTIAL,14000,0,14000,43300,0,57300
142243000900000,OFFICE,EXEMPT,0,33600,33600,0,375800,409400
142243001000000,FLAT PARKING,EXEMPT,0,33600,33600,0,24800,58400
142243001100000,APARTMENT,MULTI-RES,16800,0,16800,121300,0,138100
142243001200000,SE 230,RESIDENTIAL,17900,0,17900,56000,0,73900
142243001300000,APARTMENT,MULTI-RES,7200,0,7200,97400,0,104600
142243001400000,SE 230,RESIDENTIAL,9800,0,9800,25600,0,35400
142243001500000,SE 230,RESIDENTIAL,7600,0,7600,43600,0,51200
142243001600000,SE 230,RESIDENTIAL,14000,0,14000,47100,0,61100
142243001700000,SE 230,RESIDENTIAL,17500,0,17500,40700,0,58200
142243001800000,SE 230,RESIDENTIAL,14000,0,14000,42900,0,56900
142243001900000,SE 230,RESIDENTIAL,13800,0,13800,66300,0,80100
142243002000000,SE 230,RESIDENTIAL,13300,0,13300,67400,0,80700
142243002100000,SE 230,RESIDENTIAL,12800,0,12800,58000,0,70800
142243002200000,SE 230,RESIDENTIAL,8400,0,8400,58000,0,66400
142243002300000,SE 230,RESIDENTIAL,7100,0,7100,37000,0,44100
142243002400000,SE 230,RESIDENTIAL,8000,0,8000,63800,0,71800
142243002500000,SE 230,RESIDENTIAL,7800,0,7800,34100,0,41900
142243100100000,SE 230,RESIDENTIAL,9800,0,9800,62500,0,72300
142243100200000,SE 230,RESIDENTIAL,9300,0,9300,50600,0,59900
142243100300000,SE 230,RESIDENTIAL,9300,0,9300,62500,0,71800
142243100400000,SE 230,EXEMPT,0,13300,13300,0,59800,73100
142243100500000,SE 230,RESIDENTIAL,9800,0,9800,54100,0,63900
142243100600000,SE 230,RESIDENTIAL,7000,0,7000,0,0,7000
142243100700000,SE 230,RESIDENTIAL,9800,0,9800,57800,0,67600
142243100800000,SE 230,RESIDENTIAL,12900,0,12900,57100,0,70000
142243100900000,SE 230,RESIDENTIAL,12900,0,12900,73000,0,85900
142243101000000,SE 230,RESIDENTIAL,12900,0,12900,53600,0,66500
142243101100000,SE 230,RESIDENTIAL,16400,0,16400,62300,0,78700
142243101200000,APARTMENT,MULTI-RES,9000,0,9000,83200,0,92200
142243101300000,SE 230,RESIDENTIAL,6400,0,6400,6200,0,12600
142243101400000,SE 230,EXEMPT,0,7700,7700,0,45600,53300
142243101500000,SE 230,RESIDENTIAL,10500,0,10500,38200,0,48700
142243101600000,SE 230,RESIDENTIAL,10500,0,10500,50300,0,60800
142243101700000,SE 230,RESIDENTIAL,17900,0,17900,61500,0,79400
142243101800000,SE 230,RESIDENTIAL,14000,0,14000,63800,0,77800
142243101900000,SE 230,RESIDENTIAL,9800,0,9800,55400,0,65200
142243200100000,SE 230,RESIDENTIAL,15100,0,15100,40800,0,55900
142243200200000,SE 230,RESIDENTIAL,13700,0,13700,36900,0,50600
142243200300000,SE 230,RESIDENTIAL,14000,0,14000,73900,0,87900
142243200400000,SE 230,RESIDENTIAL,14000,0,14000,43600,0,57600
142243200500000,SE 230,RESIDENTIAL,14000,0,14000,66000,0,80000
142243200600000,SE 230,RESIDENTIAL,14000,0,14000,69300,0,83300
142243200700000,SE 230,RESIDENTIAL,14000,0,14000,60300,0,74300
142243200800000,SE 230,RESIDENTIAL,10500,0,10500,45700,0,56200
142243200900000,SE 230,RESIDENTIAL,7700,0,7700,46300,0,54000
142243201000000,SE 230,RESIDENTIAL,14000,0,14000,58600,0,72600
142243201100000,SE 230,RESIDENTIAL,16400,0,16400,62700,0,79100
142243201200000,SE 230,RESIDENTIAL,7800,0,7800,46200,0,54000
142243201300000,SE 230,RESIDENTIAL,7800,0,7800,27400,0,35200
142243201400000,SE 230,RESIDENTIAL,8500,0,8500,62600,0,71100
142243201500000,SE 230,RESIDENTIAL,7900,0,7900,43100,0,51000
142243201600000,SE 230,RESIDENTIAL,14000,0,14000,42600,0,56600
142243201700000,SE 230,RESIDENTIAL,14000,0,14000,58000,0,72000
142243201800000,SE 230,RESIDENTIAL,10500,0,10500,39700,0,50200
142243201900000,SE 230,RESIDENTIAL,14000,0,14000,57000,0,71000
142243202000000,SE 230,RESIDENTIAL,10500,0,10500,37100,0,47600
142243202100000,SE 230,RESIDENTIAL,14000,0,14000,53000,0,67000
142243202200000,SE 230,RESIDENTIAL,14000,0,14000,47900,0,61900
142243202300000,SE 230,RESIDENTIAL,14000,0,14000,48500,0,62500
142243202400000,SE 230,RESIDENTIAL,20600,0,20600,53600,0,74200
142243202500000,SE 230,RESIDENTIAL,14300,0,14300,54400,0,68700
142243202600000,SE 230,RESIDENTIAL,16500,0,16500,40700,0,57200
142243300100000,SE 230,RESIDENTIAL,8600,0,8600,40700,0,49300
142243300200000,SE 230,RESIDENTIAL,8200,0,8200,46200,0,54400
142243300300000,SE 230,RESIDENTIAL,13300,0,13300,55100,0,68400
142243300400000,SE 230,RESIDENTIAL,12800,0,12800,65300,0,78100
142243300500000,SE 230,RESIDENTIAL,15800,0,15800,61800,0,77600
142243300600000,SE 230,RESIDENTIAL,12300,0,12300,54300,0,66600
142243300700000,SE 230,RESIDENTIAL,14000,0,14000,60600,0,74600
142243300800000,SE 230,RESIDENTIAL,14000,0,14000,51500,0,65500
142243300900000,SE 230,RESIDENTIAL,14000,0,14000,76300,0,90300
142243301000000,SE 230,EXEMPT,0,14500,14500,0,54600,69100
142243301100000,APARTMENT,RESIDENTIAL,13700,0,13700,115000,0,128700
142243301200000,SE 230,RESIDENTIAL,8600,0,8600,39000,0,47600
142243301300000,SE 230,RESIDENTIAL,8600,0,8600,49600,0,58200
142243301400000,SE 230,RESIDENTIAL,8600,0,8600,46300,0,54900
142243301500000,SE 230,RESIDENTIAL,8600,0,8600,49000,0,57600
142243301600000,SE 230,RESIDENTIAL,14000,0,14000,50500,0,64500
142243301700000,SE 230,RESIDENTIAL,14000,0,14000,70500,0,84500
142243301800000,SE 230,RESIDENTIAL,14000,0,14000,58800,0,72800
142243301900000,SE 230,RESIDENTIAL,15800,0,15800,70300,0,86100
142243302000000,CENTRALLY ASSESSED,OTHER,0,0,0,0,0,0
142243302100000,SE 230,RESIDENTIAL,16300,0,16300,33900,0,50200
142243302200000,SE 230,RESIDENTIAL,13800,0,13800,47000,0,60800
142243302300000,SE 230,RESIDENTIAL,12100,0,12100,37000,0,49100
142243302400000,SE 230,RESIDENTIAL,8200,0,8200,46600,0,54800
142243302500000,SE 230,RESIDENTIAL,8500,0,8500,41900,0,50400
142243302600000,SE 230,RESIDENTIAL,7300,0,7300,36400,0,43700
142243302700000,SE 230,RESIDENTIAL,9900,0,9900,59100,0,69000
142243302800000,SE 230,RESIDENTIAL,8600,0,8600,52100,0,60700
142243302900000,SE 230,RESIDENTIAL,7200,0,7200,26500,0,33700
142243400100000,SE 230,RESIDENTIAL,13900,0,13900,67900,0,81800
142243400200000,SE 230,RESIDENTIAL,14000,0,14000,57100,0,71100
142243400300000,SE 230,EXEMPT,0,14000,14000,0,56500,70500
142243400400000,SE 230,RESIDENTIAL,13700,0,13700,64800,0,78500
142243400500000,SE 230,RESIDENTIAL,14000,0,14000,5000,0,19000
142243400600000,SE 230,RESIDENTIAL,11800,0,11800,54800,0,66600
142243400700000,SE 230,EXEMPT,0,7500,7500,0,63300,70800
142243400800000,SE 230,RESIDENTIAL,7500,0,7500,36100,0,43600
142243400900000,SE 230,RESIDENTIAL,10800,0,10800,65700,0,76500
142243401000000,SE 230,EXEMPT,0,7000,7000,0,39300,46300
142243401100000,SE 230,RESIDENTIAL,7600,0,7600,41700,0,49300
142243401200000,SE 230,RESIDENTIAL,7600,0,7600,32800,0,40400
142243401300000,SE 230,RESIDENTIAL,14100,0,14100,30000,0,44100
142243401400000,SE 230,RESIDENTIAL,13900,0,13900,45900,0,59800
142243401500000,SE 230,RESIDENTIAL,13700,0,13700,47500,0,61200
142243401600000,SE 230,RESIDENTIAL,8600,0,8600,55500,0,64100
142243401700000,SE 230,RESIDENTIAL,11000,0,11000,61900,0,72900
142243401800000,SE 230,RESIDENTIAL,9300,0,9300,31300,0,40600
142243401900000,SE 230,RESIDENTIAL,9300,0,9300,45200,0,54500
142243402000000,SE 230,RESIDENTIAL,7000,0,7000,34700,0,41700
142243402100000,SE 230,RESIDENTIAL,4200,0,4200,23200,0,27400
142243500100000,SE 230,RESIDENTIAL,21500,0,21500,86600,0,108100
142243500200000,SE 230,RESIDENTIAL,15500,0,15500,37400,0,52900
142243500300000,SE 230,RESIDENTIAL,14000,0,14000,47500,0,61500
142243500400000,SE 230,RESIDENTIAL,14000,0,14000,55900,0,69900
142243500500000,SE 230,RESIDENTIAL,14000,0,14000,58400,0,72400
142243500600000,SE 230,RESIDENTIAL,14000,0,14000,69200,0,83200
142243500700000,SE 230,RESIDENTIAL,13900,0,13900,74700,0,88600
142243500800000,SE 230,RESIDENTIAL,14000,0,14000,72800,0,86800
142243500900000,SE 230,RESIDENTIAL,14000,0,14000,61900,0,75900
142243501000000,SE 230,RESIDENTIAL,10200,0,10200,41300,0,51500
142243501100000,SE 230,RESIDENTIAL,12500,0,12500,62200,0,74700
142243501200000,SE 230,RESIDENTIAL,9100,0,9100,52100,0,61200
142243501300000,SE 230,RESIDENTIAL,9000,0,9000,46100,0,55100
142243600100000,SE 230,RESIDENTIAL,8600,0,8600,64500,0,73100
142243600200000,SE 230,RESIDENTIAL,8200,0,8200,48300,0,56500
142243600300000,SE 230,RESIDENTIAL,13300,0,13300,59700,0,73000
142243600400000,SE 230,EXEMPT,0,12800,12800,0,53300,66100
142243600500000,SE 230,RESIDENTIAL,17600,0,17600,53000,0,70600
142243600600000,SE 230,RESIDENTIAL,14000,0,14000,59800,0,73800
142243600700000,SE 230,RESIDENTIAL,14000,0,14000,62100,0,76100
142243600800000,SE 230,RESIDENTIAL,14000,0,14000,55200,0,69200
142243600900000,SE 230,RESIDENTIAL,14000,0,14000,61600,0,75600
142243601000000,SE 230,RESIDENTIAL,14400,0,14400,71600,0,86000
142243601100000,SE 230,RESIDENTIAL,8900,0,8900,61800,0,70700
142243601200000,SE 230,RESIDENTIAL,14200,0,14200,64600,0,78800
142243601300000,SE 230,RESIDENTIAL,7700,0,7700,55200,0,62900
142243601400000,SE 230,RESIDENTIAL,8100,0,8100,51800,0,59900
142243700100000,SE 230,RESIDENTIAL,9800,0,9800,43700,0,53500
142243700200000,SE 230,RESIDENTIAL,9800,0,9800,58700,0,68500
142243700300000,SE 230,RESIDENTIAL,14000,0,14000,71000,0,85000
142243700400000,SE 230,RESIDENTIAL,14000,0,14000,62000,0,76000
142243700500000,SE 230,RESIDENTIAL,14000,0,14000,46700,0,60700
142243700600000,SE 230,EXEMPT,0,8600,8600,0,42300,50900
142243700700000,SE 230,RESIDENTIAL,8600,0,8600,75000,0,83600
142243700800000,SE 230,RESIDENTIAL,8600,0,8600,43100,0,51700
142243700900000,SE 230,EXEMPT,0,8600,8600,0,0,8600
142243701000000,SE 230,RESIDENTIAL,9300,0,9300,49800,0,59100
142243701100000,SE 230,RESIDENTIAL,9300,0,9300,58800,0,68100
142245100100000,SE 230,RESIDENTIAL,14300,0,14300,26000,0,40300
142245100200000,SE 230,RESIDENTIAL,15300,0,15300,73900,0,89200
142245100300000,SE 230,RESIDENTIAL,10500,0,10500,58900,0,69400
142245100400000,SE 230,RESIDENTIAL,10500,0,10500,56700,0,67200
142245100500000,SE 230,RESIDENTIAL,14000,0,14000,50300,0,64300
142245100600000,SE 230,RESIDENTIAL,14000,0,14000,55500,0,69500
142245100700000,SE 230,RESIDENTIAL,14000,0,14000,53400,0,67400
142245100800000,SE 230,RESIDENTIAL,14000,0,14000,65600,0,79600
142245100900000,SE 230,RESIDENTIAL,19600,0,19600,74500,0,94100
142245101000000,SE 230,RESIDENTIAL,7800,0,7800,44100,0,51900
142245101100000,SE 230,RESIDENTIAL,7800,0,7800,39300,0,47100
142245101200000,SE 230,RESIDENTIAL,8500,0,8500,44000,0,52500
142245101300000,SE 230,RESIDENTIAL,7900,0,7900,42200,0,50100
142245200100000,SE 230,RESIDENTIAL,8300,0,8300,54800,0,63100
142245200200000,SE 230,RESIDENTIAL,12200,0,12200,51900,0,64100
142245200300000,SE 230,RESIDENTIAL,10500,0,10500,46500,0,57000
142245200400000,SE 230,RESIDENTIAL,13800,0,13800,43700,0,57500
142245200500000,SE 230,RESIDENTIAL,20500,0,20500,45800,0,66300
142245200600000,SE 230,RESIDENTIAL,14000,0,14000,42000,0,56000
142245200700000,SE 230,RESIDENTIAL,12300,0,12300,55500,0,67800
142245200800000,SE 230,RESIDENTIAL,15800,0,15800,69100,0,84900
142245200900000,SE 230,RESIDENTIAL,14000,0,14000,59900,0,73900
142245201000000,SE 230,RESIDENTIAL,14200,0,14200,45500,0,59700
142245201100000,SE 230,RESIDENTIAL,11600,0,11600,57400,0,69000
142245201200000,SE 230,RESIDENTIAL,12100,0,12100,58900,0,71000
142245300100000,SE 230,EXEMPT,0,9300,9300,0,45100,54400
142245300200000,SE 230,RESIDENTIAL,9300,0,9300,42500,0,51800
142245300300000,SE 230,RESIDENTIAL,9800,0,9800,43800,0,53600
142245300400000,SE 230,RESIDENTIAL,9800,0,9800,47100,0,56900
142245300500000,SE 230,RESIDENTIAL,14000,0,14000,54000,0,68000
142245300600000,SE 230,RESIDENTIAL,14000,0,14000,55500,0,69500
142245300700000,SE 230,RESIDENTIAL,14000,0,14000,61100,0,75100
142245300800000,SE 230,RESIDENTIAL,8600,0,8600,41400,0,50000
142245300900000,SE 230,RESIDENTIAL,8600,0,8600,47100,0,55700
142245301100000,SE 230,RESIDENTIAL,8600,0,8600,44900,0,53500
142245302000000,SE 230,RESIDENTIAL,8600,0,8600,48200,0,56800
142245400100000,SE 230,RESIDENTIAL,13800,0,13800,63200,0,77000
142245400200000,SE 230,RESIDENTIAL,13700,0,13700,69000,0,82700
142245400300000,SE 230,RESIDENTIAL,13700,0,13700,64700,0,78400
142245400400000,SE 230,RESIDENTIAL,13700,0,13700,40400,0,54100
142245400500000,SE 230,RESIDENTIAL,10300,0,10300,52900,0,63200
142245400600000,SE 230,RESIDENTIAL,10300,0,10300,55600,0,65900
142245400700000,SE 230,RESIDENTIAL,13700,0,13700,39000,0,52700
142245400800000,SE 230,RESIDENTIAL,13700,0,13700,43000,0,56700
142245400900000,SE 230,RESIDENTIAL,13600,0,13600,78400,0,92000
142245401000000,SE 230,RESIDENTIAL,11000,0,11000,53600,0,64600
142245401100000,SE 230,RESIDENTIAL,11400,0,11400,60000,0,71400
142245401200000,SE 230,RESIDENTIAL,11200,0,11200,42200,0,53400
142245401300000,SE 230,RESIDENTIAL,7000,0,7000,50700,0,57700
142245401400000,SE 230,RESIDENTIAL,7700,0,7700,57700,0,65400
142245401500000,SE 230,RESIDENTIAL,8200,0,8200,57700,0,65900
142245401600000,SE 230,RESIDENTIAL,10500,0,10500,58300,0,68800
142245401700000,SE 230,RESIDENTIAL,11200,0,11200,47700,0,58900
142245401800000,SE 230,RESIDENTIAL,11900,0,11900,65000,0,76900
142245401900000,SE 230,RESIDENTIAL,15600,0,15600,61000,0,76600
142245402000000,SE 230,RESIDENTIAL,14600,0,14600,46900,0,61500
142245402100000,SE 230,RESIDENTIAL,17300,0,17300,36400,0,53700
142245402200000,SE 230,RESIDENTIAL,15300,0,15300,59400,0,74700
142245500100000,SE 230,RESIDENTIAL,10400,0,10400,59700,0,70100
142245500200000,SE 230,RESIDENTIAL,10700,0,10700,35600,0,46300
142245500300000,SE 230,RESIDENTIAL,14900,0,14900,79600,0,94500
142245500400000,SE 230,RESIDENTIAL,14000,0,14000,53600,0,67600
142245500500000,SE 230,RESIDENTIAL,14000,0,14000,39400,0,53400
142245500600000,SE 230,RESIDENTIAL,14000,0,14000,66500,0,80500
142245500700000,SE 230,RESIDENTIAL,14000,0,14000,72800,0,86800
142245500800000,SE 230,RESIDENTIAL,14400,0,14400,73500,0,87900
142245500900000,SE 230,RESIDENTIAL,14700,0,14700,62900,0,77600
142245501000000,SE 230,RESIDENTIAL,11200,0,11200,67000,0,78200
142245501100000,SE 230,RESIDENTIAL,15600,0,15600,52100,0,67700
142245501200000,SE 230,RESIDENTIAL,15000,0,15000,63500,0,78500
142245501300000,SE 230,RESIDENTIAL,11600,0,11600,46100,0,57700
142245501400000,SE 230,RESIDENTIAL,19600,0,19600,82600,0,102200
142245501500000,SE 230,RESIDENTIAL,16100,0,16100,54800,0,70900
142245501600000,SE 230,RESIDENTIAL,18800,0,18800,86100,0,104900
142245501700000,SE 230,RESIDENTIAL,13400,0,13400,60100,0,73500
142245501800000,SE 230,RESIDENTIAL,16100,0,16100,25700,0,41800
142245501900000,SE 230,RESIDENTIAL,15900,0,15900,66200,0,82100
142245502000000,SE 230,RESIDENTIAL,15100,0,15100,57300,0,72400
142245502100000,SE 230,RESIDENTIAL,14800,0,14800,49000,0,63800
142245502200000,SE 230,RESIDENTIAL,12300,0,12300,51800,0,64100
142245502300000,SE 230,RESIDENTIAL,12200,0,12200,48700,0,60900
142245502400000,SE 230,RESIDENTIAL,12000,0,12000,48700,0,60700
142245502500000,SE 230,RESIDENTIAL,11300,0,11300,45500,0,56800
142245502600000,SE 230,RESIDENTIAL,10400,0,10400,28700,0,39100
142245502700000,SE 230,RESIDENTIAL,10500,0,10500,46500,0,57000
142245502800000,SE 230,RESIDENTIAL,10500,0,10500,0,0,10500
142245502900000,SE 230,RESIDENTIAL,10200,0,10200,43400,0,53600
142245503000000,SE 230,RESIDENTIAL,12900,0,12900,59600,0,72500
142245503100000,SE 230,RESIDENTIAL,12700,0,12700,47100,0,59800
142245503200000,SE 230,RESIDENTIAL,12700,0,12700,49000,0,61700
142245503300000,SE 230,RESIDENTIAL,14200,0,14200,58600,0,72800
142245503400000,SE 230,RESIDENTIAL,15800,0,15800,51500,0,67300
142245503500000,SE 230,RESIDENTIAL,15600,0,15600,51800,0,67400
142245503600000,SE 230,RESIDENTIAL,14500,0,14500,45700,0,60200
142245503700000,SE 230,RESIDENTIAL,14700,0,14700,45300,0,60000
142245503800000,SE 230,RESIDENTIAL,18900,0,18900,53900,0,72800
142245503900000,SE 230,RESIDENTIAL,14400,0,14400,44900,0,59300
142245504000000,SE 230,RESIDENTIAL,14100,0,14100,37100,0,51200
142245504100000,SE 230,RESIDENTIAL,13900,0,13900,29000,0,42900
142245504200000,SE 230,RESIDENTIAL,9900,0,9900,57700,0,67600
142245504300000,SE 230,RESIDENTIAL,10200,0,10200,26900,0,37100
142245600100000,SE 230,RESIDENTIAL,14000,0,14000,52500,0,66500
142245600200000,SE 230,RESIDENTIAL,14000,0,14000,50600,0,64600
142245600300000,SE 230,RESIDENTIAL,14000,0,14000,65600,0,79600
142245600400000,SE 230,RESIDENTIAL,14000,0,14000,53600,0,67600
142245600500000,SE 230,RESIDENTIAL,14000,0,14000,38900,0,52900
142245600600000,SE 230,RESIDENTIAL,8600,0,8600,36000,0,44600
142245600700000,SE 230,RESIDENTIAL,8600,0,8600,43000,0,51600
142245600800000,SE 230,RESIDENTIAL,8600,0,8600,42900,0,51500
142245600900000,SE 230,RESIDENTIAL,8600,0,8600,33800,0,42400
142245601000000,SE 230,RESIDENTIAL,8000,0,8000,45700,0,53700
142245601100000,SE 230,RESIDENTIAL,8000,0,8000,52400,0,60400
142245601200000,SE 230,RESIDENTIAL,8900,0,8900,43700,0,52600
142245601300000,SE 230,RESIDENTIAL,8900,0,8900,40100,0,49000
142245601400000,SE 230,RESIDENTIAL,14000,0,14000,36000,0,50000
142245601500000,SE 230,RESIDENTIAL,14000,0,14000,71800,0,85800
142245601600000,SE 230,RESIDENTIAL,19600,0,19600,71500,0,91100
142245601700000,SE 230,RESIDENTIAL,14000,0,14000,56700,0,70700
142245700100000,SE 230,RESIDENTIAL,22800,0,22800,58600,0,81400
142245700200000,SE 230,RESIDENTIAL,13000,0,13000,52400,0,65400
142245700300000,SE 230,RESIDENTIAL,13400,0,13400,65000,0,78400
142245700400000,SE 230,RESIDENTIAL,13600,0,13600,56800,0,70400
142245700500000,SE 230,RESIDENTIAL,13900,0,13900,62500,0,76400
142245700600000,SE 230,RESIDENTIAL,12500,0,12500,41300,0,53800
142245700700000,SE 230,RESIDENTIAL,18700,0,18700,39500,0,58200
142245700800000,SE 230,RESIDENTIAL,10800,0,10800,37200,0,48000
142245700900000,SE 230,RESIDENTIAL,14400,0,14400,44500,0,58900
142245701000000,SE 230,RESIDENTIAL,14400,0,14400,48700,0,63100
142245701100000,SE 230,RESIDENTIAL,14400,0,14400,49600,0,64000
142245701200000,SE 230,RESIDENTIAL,14600,0,14600,48400,0,63000
142245701300000,SE 230,RESIDENTIAL,14600,0,14600,46200,0,60800
142245701400000,SE 230,RESIDENTIAL,11500,0,11500,47200,0,58700
142245701500000,SE 230,RESIDENTIAL,10800,0,10800,43300,0,54100
142245701600000,SE 230,RESIDENTIAL,10800,0,10800,51200,0,62000
142245701700000,SE 230,RESIDENTIAL,10300,0,10300,27100,0,37400
142245701800000,SE 230,RESIDENTIAL,14300,0,14300,35200,0,49500
142245701900000,SE 230,RESIDENTIAL,10800,0,10800,45400,0,56200
142245702000000,SE 230,RESIDENTIAL,10800,0,10800,40100,0,50900
142245702100000,SE 230,RESIDENTIAL,10700,0,10700,50300,0,61000
142245702200000,SE 230,RESIDENTIAL,18800,0,18800,54500,0,73300
142245702300000,SE 230,RESIDENTIAL,20800,0,20800,59200,0,80000
142245702400000,SE 230,RESIDENTIAL,20800,0,20800,67100,0,87900
142245702500000,SE 230,RESIDENTIAL,20800,0,20800,57200,0,78000
142245702600000,SE 230,RESIDENTIAL,20800,0,20800,58200,0,79000
142245702700000,SE 230,RESIDENTIAL,16600,0,16600,50700,0,67300
142245800100000,SE 230,RESIDENTIAL,16000,0,16000,47400,0,63400
142245800200000,SE 230,RESIDENTIAL,15400,0,15400,66300,0,81700
142245800300000,SE 230,RESIDENTIAL,15400,0,15400,39100,0,54500
142245800400000,SE 230,RESIDENTIAL,15400,0,15400,51200,0,66600
142245800500000,SE 230,RESIDENTIAL,17000,0,17000,71200,0,88200
142245800600000,SE 230,RESIDENTIAL,26600,0,26600,63300,0,89900
142245800700000,SE 230,RESIDENTIAL,26800,0,26800,87700,0,114500
142245800800000,SE 230,RESIDENTIAL,26800,0,26800,129300,0,156100
142245800900000,SE 230,RESIDENTIAL,27000,0,27000,98000,0,125000
142245801000000,SE 230,RESIDENTIAL,30000,0,30000,93900,0,123900
142245801100000,SR/NURSING/ASSTD LIV,MULTI-RES,136800,0,136800,1827800,0,1964600
142245801200000,SE 230,RESIDENTIAL,13200,0,13200,40600,0,53800
142245801300000,SE 230,RESIDENTIAL,13200,0,13200,75700,0,88900
142245801400000,SE 230,RESIDENTIAL,12600,0,12600,62400,0,75000
142245801500000,SE 230,RESIDENTIAL,8900,0,8900,34500,0,43400
142245801600000,SE 230,RESIDENTIAL,9700,0,9700,29000,0,38700
142245801700000,SE 230,RESIDENTIAL,8100,0,8100,43000,0,51100
142245801800000,SE 230,RESIDENTIAL,8000,0,8000,42700,0,50700
142245801900000,SE 230,RESIDENTIAL,14300,0,14300,70400,0,84700
142245802000000,SE 230,RESIDENTIAL,9600,0,9600,50900,0,60500
142245802100000,SE 230,RESIDENTIAL,9300,0,9300,26600,0,35900
142245802200000,SE 230,RESIDENTIAL,13400,0,13400,27900,0,41300
142245802300000,SE 230,RESIDENTIAL,13400,0,13400,49500,0,62900
142245802400000,SE 230,RESIDENTIAL,13400,0,13400,44500,0,57900
142245802500000,SE 230,RESIDENTIAL,12200,0,12200,40800,0,53000
142245802600000,SE 230,RESIDENTIAL,20000,0,20000,57700,0,77700
142245802700000,SE 230,RESIDENTIAL,22700,0,22700,60600,0,83300
142245802800000,SE 230,RESIDENTIAL,19100,0,19100,62100,0,81200
142245802900000,SE 230,RESIDENTIAL,19100,0,19100,51300,0,70400
142245803000000,SE 230,RESIDENTIAL,17700,0,17700,33400,0,51100
142245900100000,APARTMENT,MULTI-RES,13300,0,13300,71400,0,84700
142245900200000,SE 230,RESIDENTIAL,15400,0,15400,63300,0,78700
142245900300000,SE 230,RESIDENTIAL,10200,0,10200,30600,0,40800
142245900400000,SE 230,RESIDENTIAL,7700,0,7700,41400,0,49100
142245900500000,SE 230,RESIDENTIAL,8900,0,8900,30900,0,39800
142245900600000,SE 230,RESIDENTIAL,9500,0,9500,56000,0,65500
142245900700000,SE 230,RESIDENTIAL,13700,0,13700,42500,0,56200
142245900800000,SE 230,RESIDENTIAL,13300,0,13300,63000,0,76300
142245900900000,SE 230,RESIDENTIAL,13300,0,13300,67100,0,80400
142245901000000,SE 230,RESIDENTIAL,25200,0,25200,83800,0,109000
142245901100000,SE 230,RESIDENTIAL,21600,0,21600,68000,0,89600
142245901200000,SE 230,RESIDENTIAL,13000,0,13000,69100,0,82100
142245901300000,SE 230,RESIDENTIAL,15700,0,15700,69500,0,85200
142245901400000,SE 230,RESIDENTIAL,22700,0,22700,76500,0,99200
142245901500000,SE 230,RESIDENTIAL,64300,0,64300,196500,0,260800
142245901600000,APARTMENT,MULTI-RES,22200,0,22200,85000,0,107200
142245901700000,CONVERSION-CENT CORE,MULTI-RES,22400,0,22400,37000,0,59400
142246000100000,SE 230,RESIDENTIAL,9400,0,9400,43200,0,52600
142246000200000,SE 230,RESIDENTIAL,8900,0,8900,51600,0,60500
142246000300000,SE 230,RESIDENTIAL,14300,0,14300,50700,0,65000
142246000400000,SE 230,RESIDENTIAL,14100,0,14100,44300,0,58400
142246000500000,SE 230,RESIDENTIAL,14100,0,14100,29600,0,43700
142246000600000,SE 230,RESIDENTIAL,14600,0,14600,68000,0,82600
142246000700000,SE 230,RESIDENTIAL,14100,0,14100,79200,0,93300
142246000800000,SE 230,RESIDENTIAL,9200,0,9200,37500,0,46700
142246000900000,SE 230,RESIDENTIAL,8900,0,8900,51200,0,60100
142246001000000,SE 230,RESIDENTIAL,8400,0,8400,52200,0,60600
142246001100000,SE 230,RESIDENTIAL,8000,0,8000,44000,0,52000
142246001200000,SE 230,RESIDENTIAL,8000,0,8000,38300,0,46300
142246001300000,SE 230,RESIDENTIAL,8200,0,8200,52200,0,60400
142246001400000,SE 230,RESIDENTIAL,9100,0,9100,51700,0,60800
142246001500000,SE 230,RESIDENTIAL,9000,0,9000,12300,0,21300
142246001600000,SE 230,RESIDENTIAL,14100,0,14100,65100,0,79200
142246001700000,SE 230,RESIDENTIAL,13900,0,13900,50600,0,64500
142246001800000,SE 230,RESIDENTIAL,13900,0,13900,52700,0,66600
142246001900000,SE 230,RESIDENTIAL,13900,0,13900,74700,0,88600
142246002000000,SE 230,RESIDENTIAL,13900,0,13900,50500,0,64400
142246002100000,SE 230,RESIDENTIAL,13700,0,13700,52300,0,66000
142246002200000,SE 230,RESIDENTIAL,11900,0,11900,37200,0,49100
142246002300000,SE 230,RESIDENTIAL,11700,0,11700,39200,0,50900
142246002400000,SE 230,RESIDENTIAL,13300,0,13300,44300,0,57600
142246002500000,SE 230,RESIDENTIAL,13100,0,13100,38500,0,51600
142246100100000,SE 230,RESIDENTIAL,26000,0,26000,68300,0,94300
142246100200000,SE 230,RESIDENTIAL,31900,0,31900,97500,0,129400
142246100300000,SE 230,RESIDENTIAL,22600,0,22600,109700,0,132300
142246100400000,SE 230,RESIDENTIAL,17900,0,17900,56600,0,74500
142246100500000,SE 230,RESIDENTIAL,18800,0,18800,86300,0,105100
142246100600000,SE 230,RESIDENTIAL,23200,0,23200,67500,0,90700
142246100700000,SE 230,RESIDENTIAL,2400,0,2400,0,0,2400
142247600100000,SE 247,RESIDENTIAL,72500,0,72500,327200,0,399700
142247600200000,SE 247,RESIDENTIAL,69900,0,69900,432100,0,502000
142247600300000,SE 247,RESIDENTIAL,71300,0,71300,223000,0,294300
142247600400000,SE 247,RESIDENTIAL,72000,0,72000,221700,0,293700
142247700100000,SE 247,RESIDENTIAL,98000,0,98000,313900,0,411900
142247700200000,SE 247,RESIDENTIAL,70400,0,70400,204700,0,275100
142247700300000,SE 247,RESIDENTIAL,70300,0,70300,149300,0,219600
142247700400000,SE 247,RESIDENTIAL,68700,0,68700,171100,0,239800
142247700500000,SE 247,RESIDENTIAL,67900,0,67900,138600,0,206500
142247700600000,SE 247,RESIDENTIAL,98100,0,98100,203600,0,301700
142247800100000,SE 247,RESIDENTIAL,181600,0,181600,411800,0,593400
142247800200000,SE 247,RESIDENTIAL,68500,0,68500,262800,0,331300
142247800500000,SE 247,RESIDENTIAL,72000,0,72000,147100,0,219100
142247800600000,SE 247,RESIDENTIAL,180300,0,180300,282700,0,463000
142247900100000,SE 247,RESIDENTIAL,67500,0,67500,252800,0,320300
142247900200000,SE 247,RESIDENTIAL,60000,0,60000,130700,0,190700
142247900300000,SE 247,RESIDENTIAL,61800,0,61800,77400,0,139200
142247900400000,SE 247,RESIDENTIAL,70400,0,70400,196100,0,266500
142247900500000,SE 247,RESIDENTIAL,67500,0,67500,177800,0,245300
142248000100000,SE 247,RESIDENTIAL,36500,0,36500,96100,0,132600
142248000200000,SE 247,RESIDENTIAL,47000,0,47000,128500,0,175500
142248000300000,SE 247,RESIDENTIAL,48000,0,48000,119000,0,167000
142248000400000,SE 247,RESIDENTIAL,48600,0,48600,90000,0,138600
142248000500000,SE 229,RESIDENTIAL,35700,0,35700,54300,0,90000
142248000600000,SE 229,RESIDENTIAL,25000,0,25000,108900,0,133900
142248000700000,SE 229,RESIDENTIAL,26300,0,26300,99300,0,125600
142248100100000,SE 247,RESIDENTIAL,48400,0,48400,180400,0,228800
142248100200000,SE 247,RESIDENTIAL,59600,0,59600,165800,0,225400
142248100300000,SE 247,RESIDENTIAL,40500,0,40500,88600,0,129100
142248100400000,SE 247,RESIDENTIAL,38900,0,38900,89300,0,128200
142248100500000,SE 229,RESIDENTIAL,24800,0,24800,107100,0,131900
142248100600000,SE 229,RESIDENTIAL,24800,0,24800,63600,0,88400
142248100700000,SE 229,RESIDENTIAL,24800,0,24800,123700,0,148500
142248100800000,SE 247,RESIDENTIAL,34100,0,34100,85500,0,119600
142248100900000,SE 247,RESIDENTIAL,34100,0,34100,110500,0,144600
142248101000000,SE 247,RESIDENTIAL,36400,0,36400,117100,0,153500
142248101100000,SE 247,RESIDENTIAL,38900,0,38900,125500,0,164400
142248200100000,SE 247,RESIDENTIAL,65300,0,65300,211700,0,277000
142248200200000,SE 247,RESIDENTIAL,39700,0,39700,120800,0,160500
142248200300000,SE 247,RESIDENTIAL,39700,0,39700,130700,0,170400
142248200400000,SE 229,RESIDENTIAL,24800,0,24800,89000,0,113800
142248200500000,SE 229,RESIDENTIAL,24800,0,24800,91600,0,116400
142248200600000,SE 229,RESIDENTIAL,24800,0,24800,90900,0,115700
142248200700000,SE 229,RESIDENTIAL,24800,0,24800,72400,0,97200
142248200800000,SE 229,RESIDENTIAL,25200,0,25200,108400,0,133600
142248200900000,SE 229,RESIDENTIAL,19800,0,19800,84300,0,104100
142248201000000,CITY PROPERTY,EXEMPT,0,0,0,0,0,0
142248201100000,SE 229,RESIDENTIAL,24800,0,24800,93000,0,117800
142248201200000,SE 229,RESIDENTIAL,24800,0,24800,73100,0,97900
142248201300000,SE 229,RESIDENTIAL,24800,0,24800,107000,0,131800
142248201400000,SE 229,RESIDENTIAL,24800,0,24800,95100,0,119900
142248201500000,SE 229,RESIDENTIAL,24800,0,24800,131500,0,156300
142248300100000,SE 229,RESIDENTIAL,17600,0,17600,108100,0,125700
142248300200000,SE 229,RESIDENTIAL,30400,0,30400,130500,0,160900
142248300300000,SE 229,RESIDENTIAL,30400,0,30400,100200,0,130600
142248300400000,SE 229,RESIDENTIAL,30000,0,30000,79500,0,109500
142248300500000,SE 229,RESIDENTIAL,18600,0,18600,90400,0,109000
142248300600000,SE 229,RESIDENTIAL,16700,0,16700,70000,0,86700
142248300700000,SE 229,RESIDENTIAL,19600,0,19600,64700,0,84300
142248300800000,SE 229,RESIDENTIAL,19600,0,19600,99800,0,119400
142248300900000,SE 229,RESIDENTIAL,21600,0,21600,58800,0,80400
142248301000000,SE 229,RESIDENTIAL,18600,0,18600,107200,0,125800
142248301100000,SE 229,RESIDENTIAL,18600,0,18600,77900,0,96500
142248301200000,SE 229,RESIDENTIAL,18600,0,18600,75900,0,94500
142248301300000,SE 229,RESIDENTIAL,18600,0,18600,91900,0,110500
142248301400000,SE 229,RESIDENTIAL,18600,0,18600,89900,0,108500
142248301500000,SE 229,RESIDENTIAL,14400,0,14400,83600,0,98000
142248301600000,SE 229,RESIDENTIAL,14400,0,14400,64200,0,78600
142248301700000,SE 229,RESIDENTIAL,15200,0,15200,76800,0,92000
142248301800000,SE 229,RESIDENTIAL,22300,0,22300,80100,0,102400
142248301900000,SE 229,RESIDENTIAL,19400,0,19400,39900,0,59300
142248302000000,SE 229,RESIDENTIAL,23000,0,23000,62400,0,85400
142248302100000,SE 229,RESIDENTIAL,24500,0,24500,108000,0,132500
142248302200000,SE 229,RESIDENTIAL,20200,0,20200,78100,0,98300
142248302300000,SE 229,RESIDENTIAL,20000,0,20000,101900,0,121900
142248302400000,SE 229,RESIDENTIAL,16000,0,16000,78300,0,94300
142248302500000,SE 229,RESIDENTIAL,16000,0,16000,93100,0,109100
142248302600000,SE 229,RESIDENTIAL,26700,0,26700,140900,0,167600
142248302700000,SE 229,RESIDENTIAL,17600,0,17600,107300,0,124900
142248302800000,SE 229,RESIDENTIAL,17600,0,17600,60100,0,77700
142248302900000,SE 229,RESIDENTIAL,17600,0,17600,72400,0,90000
142248303000000,SE 229,RESIDENTIAL,17600,0,17600,84200,0,101800
142248303100000,SE 229,RESIDENTIAL,17600,0,17600,77400,0,95000
142248303200000,SE 229,RESIDENTIAL,17600,0,17600,87600,0,105200
142248400100000,SE 247,RESIDENTIAL,45100,0,45100,127800,0,172900
142248400200000,SE 247,RESIDENTIAL,36600,0,36600,143600,0,180200
142248400300000,SE 247,RESIDENTIAL,37700,0,37700,108800,0,146500
142248400400000,SE 247,RESIDENTIAL,39700,0,39700,150000,0,189700
142248400500000,SE 229,RESIDENTIAL,20000,0,20000,78100,0,98100
142248400600000,SE 229,RESIDENTIAL,21700,0,21700,67700,0,89400
142248400700000,SE 229,RESIDENTIAL,20900,0,20900,86100,0,107000
142248400800000,SE 229,RESIDENTIAL,16300,0,16300,86400,0,102700
142248400900000,SE 229,RESIDENTIAL,16300,0,16300,58100,0,74400
142248500100000,SE 229,RESIDENTIAL,17600,0,17600,98000,0,115600
142248500200000,SE 229,RESIDENTIAL,21300,0,21300,80300,0,101600
142248500300000,SE 229,RESIDENTIAL,21300,0,21300,102100,0,123400
142248500400000,SE 229,RESIDENTIAL,21300,0,21300,67400,0,88700
142248500500000,SE 229,RESIDENTIAL,15200,0,15200,76800,0,92000
142248500600000,SE 229,RESIDENTIAL,15200,0,15200,84200,0,99400
142248500700000,SE 229,RESIDENTIAL,25800,0,25800,100700,0,126500
142248500800000,SE 229,RESIDENTIAL,16000,0,16000,72700,0,88700
142248500900000,SE 229,RESIDENTIAL,16000,0,16000,72400,0,88400
142248501000000,SE 229,RESIDENTIAL,15200,0,15200,69200,0,84400
142248501100000,SE 229,RESIDENTIAL,15200,0,15200,74400,0,89600
142248501200000,SE 229,RESIDENTIAL,22600,0,22600,65300,0,87900
142248501300000,SE 229,RESIDENTIAL,18300,0,18300,73100,0,91400
142248501400000,SE 229,RESIDENTIAL,18300,0,18300,74100,0,92400
142248501500000,SE 229,RESIDENTIAL,23400,0,23400,63200,0,86600
142248501600000,CONVENIENCE STORE,COMMERCIAL,0,53800,53800,0,186700,240500
142248501700000,SMALL RETAIL,COMMERCIAL,0,47200,47200,0,107800,155000
142248501800000,FLAT PARKING,COMMERCIAL,0,58800,58800,0,4600,63400
142248501900000,SE 229,RESIDENTIAL,22800,0,22800,55700,0,78500
142248502000000,SE 229,RESIDENTIAL,31600,0,31600,77900,0,109500
142248502100000,SE 229,RESIDENTIAL,31600,0,31600,92100,0,123700
142248502200000,SE 229,RESIDENTIAL,30400,0,30400,48500,0,78900
142248502300000,SE 229,RESIDENTIAL,30400,0,30400,58800,0,89200
142248502400000,SE 229,RESIDENTIAL,23800,0,23800,56200,0,80000
142248502500000,SE 229,RESIDENTIAL,23800,0,23800,65000,0,88800
142248502600000,SE 229,RESIDENTIAL,17600,0,17600,87200,0,104800
142248502700000,SE 229,RESIDENTIAL,17600,0,17600,65600,0,83200
142248502800000,SE 229,RESIDENTIAL,17600,0,17600,65700,0,83300
142310100100000,SE 212,RESIDENTIAL,5500,0,5500,0,0,5500
142310100200000,SE 212,RESIDENTIAL,126200,0,126200,281800,0,408000
142310100300000,SE 212,RESIDENTIAL,118700,0,118700,581800,0,700500
142310100400000,SE 212,RESIDENTIAL,131000,0,131000,430200,0,561200
142310100500000,SE 212,RESIDENTIAL,94700,0,94700,284900,0,379600
142310100600000,SE 212,RESIDENTIAL,89700,0,89700,363400,0,453100
142310100700000,SE 212,RESIDENTIAL,94000,0,94000,336800,0,430800
142310100800000,SE 212,RESIDENTIAL,85400,0,85400,325100,0,410500
142310100900000,SE 212,RESIDENTIAL,91100,0,91100,315600,0,406700
142310101000000,SE 212,RESIDENTIAL,128300,0,128300,602600,0,730900
142310101100000,SE 212,RESIDENTIAL,89779,0,89779,341096,0,430875
142310101200000,SE 211,RESIDENTIAL,33700,0,33700,221300,0,255000
142310101300000,SE 211,RESIDENTIAL,32500,0,32500,182400,0,214900
142310101400000,SE 211,RESIDENTIAL,32500,0,32500,162400,0,194900
142310101500000,SE 211,RESIDENTIAL,32900,0,32900,192300,0,225200
142310101600000,SE 211,RESIDENTIAL,31700,0,31700,197400,0,229100
142310101700000,SE 211,RESIDENTIAL,34800,0,34800,229600,0,264400
142310101800000,SE 211,RESIDENTIAL,36500,0,36500,278000,0,314500
142310101900000,SE 212,RESIDENTIAL,70700,0,70700,348669,0,419369
142310102000000,SE 212,RESIDENTIAL,84000,0,84000,0,0,84000
142310102100000,SE 212,RESIDENTIAL,101400,0,101400,406500,0,507900
142310102200000,SE 212,RESIDENTIAL,103400,0,103400,285700,0,389100
142310102300000,SE 211,RESIDENTIAL,36100,0,36100,227700,0,263800
142310102400000,SE 211,RESIDENTIAL,35800,0,35800,263100,0,298900
142310102500000,SE 211,RESIDENTIAL,33700,0,33700,217000,0,250700
142310102600000,SE 211,RESIDENTIAL,32500,0,32500,202400,0,234900
142310102700000,SE 211,RESIDENTIAL,35500,0,35500,193400,0,228900
142310102800000,SE 211,RESIDENTIAL,35700,0,35700,243200,0,278900
142310102900000,SE 211,RESIDENTIAL,32100,0,32100,160500,0,192600
142310103000000,SE 211,RESIDENTIAL,32500,0,32500,151900,0,184400
142310103100000,SE 211,RESIDENTIAL,32500,0,32500,165700,0,198200
142310103200000,SE 211,RESIDENTIAL,32500,0,32500,178900,0,211400
142310103300000,SE 211,RESIDENTIAL,91800,0,91800,231500,0,323300
142310103400000,SE 212,RESIDENTIAL,139200,0,139200,282696,0,421896
142310103500000,SE 212,RESIDENTIAL,106600,0,106600,367100,0,473700
142310103600000,SE 211,RESIDENTIAL,38000,0,38000,251600,0,289600
142310103700000,SE 211,RESIDENTIAL,56600,0,56600,176200,0,232800
142310103800000,SE 211,RESIDENTIAL,64700,0,64700,214700,0,279400
142310104000000,SE 211,RESIDENTIAL,65400,0,65400,194200,0,259600
142310104100000,SE 211,RESIDENTIAL,61900,0,61900,0,0,61900
142310104200000,SE 212,RESIDENTIAL,2200,0,2200,0,0,2200
142310104300000,SE 212,RESIDENTIAL,0,0,0,0,0,0
142310104400000,SE 212,RESIDENTIAL,0,0,0,0,0,0
142312600100000,CITY PROPERTY,EXEMPT,0,0,0,0,0,0
142312600200000,CITY PROPERTY,EXEMPT,0,0,0,0,0,0
142312600300000,SE 211,RESIDENTIAL,35600,0,35600,192800,0,228400
142312600400000,SE 211,RESIDENTIAL,35900,0,35900,257000,0,292900
142312600500000,SE 211,RESIDENTIAL,36500,0,36500,254800,0,291300
142312600600000,SE 211,RESIDENTIAL,34800,0,34800,194300,0,229100
142312800100000,SE 211,RESIDENTIAL,33100,0,33100,179400,0,212500
142315100100000,SE 213,RESIDENTIAL,34800,0,34800,123400,0,158200
142315200100000,SE 213,RESIDENTIAL,39400,0,39400,120800,0,160200
142315200200000,SE 213,RESIDENTIAL,39400,0,39400,172900,0,212300
142315200300000,SE 213,RESIDENTIAL,38600,0,38600,123000,0,161600
142315200400000,SE 213,RESIDENTIAL,38300,0,38300,143500,0,181800
142315200500000,SE 213,RESIDENTIAL,35600,0,35600,173700,0,209300
142315200600000,SE 213,RESIDENTIAL,35600,0,35600,95800,0,131400
142315200700000,SE 213,RESIDENTIAL,35600,0,35600,85100,0,120700
142315200800000,SE 213,RESIDENTIAL,34900,0,34900,81700,0,116600
142315200900000,SE 213,RESIDENTIAL,20700,0,20700,94800,0,115500
142315201000000,SE 213,RESIDENTIAL,18000,0,18000,53400,0,71400
142315201100000,SE 213,RESIDENTIAL,18000,0,18000,73900,0,91900
142315201200000,SE 213,RESIDENTIAL,18000,0,18000,48200,0,66200
142315201300000,SE 213,RESIDENTIAL,26500,0,26500,41900,0,68400
142315201400000,SE 213,RESIDENTIAL,18500,0,18500,47900,0,66400
142315201500000,SE 213,RESIDENTIAL,18000,0,18000,43900,0,61900
142315201600000,SE 213,RESIDENTIAL,18000,0,18000,37600,0,55600
142315201700000,SE 213,RESIDENTIAL,18000,0,18000,43700,0,61700
142315201800000,SE 213,RESIDENTIAL,18000,0,18000,38700,0,56700
142315201900000,SE 213,RESIDENTIAL,18000,0,18000,35900,0,53900
142315202000000,SE 213,RESIDENTIAL,30400,0,30400,21700,0,52100
142315202100000,SE 213,RESIDENTIAL,22500,0,22500,43500,0,66000
142315300100000,SE 213,RESIDENTIAL,34800,0,34800,114500,0,149300
142315300200000,SE 213,RESIDENTIAL,34600,0,34600,143300,0,177900
142315300300000,SE 213,RESIDENTIAL,34600,0,34600,121700,0,156300
142315400100000,SE 213,RESIDENTIAL,35600,0,35600,111700,0,147300
142315400200000,SE 213,RESIDENTIAL,35000,0,35000,101400,0,136400
142315400300000,SE 213,RESIDENTIAL,20700,0,20700,36000,0,56700
142315400400000,SE 213,RESIDENTIAL,25200,0,25200,47400,0,72600
142315400500000,SE 213,RESIDENTIAL,32200,0,32200,108700,0,140900
142315400600000,SE 213,RESIDENTIAL,18000,0,18000,13700,0,31700
142315400700000,SE 213,RESIDENTIAL,18000,0,18000,34700,0,52700
142315400800000,SE 213,RESIDENTIAL,18000,0,18000,44000,0,62000
142315400900000,SE 213,RESIDENTIAL,25200,0,25200,50500,0,75700
142315401000000,SE 213,RESIDENTIAL,21800,0,21800,55000,0,76800
142315401100000,SE 213,RESIDENTIAL,28400,0,28400,58400,0,86800
142315401200000,SE 213,RESIDENTIAL,20900,0,20900,95700,0,116600
142315401300000,SE 213,RESIDENTIAL,31500,0,31500,66500,0,98000
142317600100000,SE 213,RESIDENTIAL,78100,0,78100,264900,0,343000
142317600200000,SE 213,RESIDENTIAL,40900,0,40900,133100,0,174000
142317600300000,SE 213,RESIDENTIAL,42000,0,42000,104300,0,146300
142317600400000,SE 213,RESIDENTIAL,41700,0,41700,161200,0,202900
142317600500000,SE 213,RESIDENTIAL,38800,0,38800,155900,0,194700
142317600600000,SE 213,RESIDENTIAL,35500,0,35500,116900,0,152400
142317600700000,SE 213,RESIDENTIAL,37000,0,37000,137300,0,174300
142317600800000,SE 213,RESIDENTIAL,35500,0,35500,115800,0,151300
142317600900000,SE 213,RESIDENTIAL,37200,0,37200,132600,0,169800
142317601000000,SE 213,RESIDENTIAL,35600,0,35600,142200,0,177800
142317601100000,SE 213,RESIDENTIAL,35300,0,35300,118600,0,153900
142317601200000,SE 213,RESIDENTIAL,35600,0,35600,143400,0,179000
142317601300000,SE 213,RESIDENTIAL,35700,0,35700,139400,0,175100
142317700100000,SE 213,RESIDENTIAL,38300,0,38300,114800,0,153100
142317700200000,SE 213,RESIDENTIAL,38600,0,38600,148600,0,187200
142317700300000,SE 213,RESIDENTIAL,38600,0,38600,114100,0,152700
142317700400000,SE 213,RESIDENTIAL,39000,0,39000,132600,0,171600
142317700500000,SE 213,RESIDENTIAL,39000,0,39000,130200,0,169200
142317700600000,SE 213,RESIDENTIAL,37200,0,37200,126400,0,163600
142317700700000,SE 213,RESIDENTIAL,36400,0,36400,142700,0,179100
142317700800000,SE 213,RESIDENTIAL,37300,0,37300,129700,0,167000
142317700900000,SE 213,RESIDENTIAL,37000,0,37000,118500,0,155500
142317701000000,SE 213,RESIDENTIAL,34400,0,34400,134700,0,169100
142317701100000,SE 213,RESIDENTIAL,35600,0,35600,102300,0,137900
142317701200000,SE 213,RESIDENTIAL,36500,0,36500,133200,0,169700
142317701300000,SE 213,RESIDENTIAL,36100,0,36100,77700,0,113800
142317701400000,SE 213,RESIDENTIAL,38300,0,38300,150100,0,188400
142317701500000,SE 213,RESIDENTIAL,38300,0,38300,158000,0,196300
142317701600000,SE 213,RESIDENTIAL,38300,0,38300,102600,0,140900
142317701700000,SE 213,RESIDENTIAL,38600,0,38600,144700,0,183300
142317701800000,SE 213,RESIDENTIAL,37900,0,37900,152300,0,190200
142317800100000,SE 213,RESIDENTIAL,93100,0,93100,259900,0,353000
142317800200000,SE 213,RESIDENTIAL,30500,0,30500,98600,0,129100
142317800300000,SE 213,RESIDENTIAL,41100,0,41100,132100,0,173200
142317800400000,SE 213,RESIDENTIAL,40000,0,40000,118200,0,158200
142317800500000,SE 213,RESIDENTIAL,38400,0,38400,150100,0,188500
142317800600000,SE 213,RESIDENTIAL,38500,0,38500,133600,0,172100
142317800700000,SE 213,RESIDENTIAL,37500,0,37500,139400,0,176900
142317800800000,SE 213,RESIDENTIAL,37500,0,37500,158900,0,196400
142317800900000,SE 213,RESIDENTIAL,37900,0,37900,117700,0,155600
142317801000000,SE 213,RESIDENTIAL,37600,0,37600,119900,0,157500
142317801100000,SE 213,RESIDENTIAL,35600,0,35600,122000,0,157600
142317801200000,SE 213,RESIDENTIAL,35600,0,35600,112700,0,148300
142317801300000,SE 213,RESIDENTIAL,39000,0,39000,95000,0,134000
142317801400000,SE 213,RESIDENTIAL,38100,0,38100,84900,0,123000
142317801500000,SE 213,RESIDENTIAL,35300,0,35300,81800,0,117100
142317801600000,SE 213,RESIDENTIAL,31400,0,31400,43700,0,75100
142317801700000,SE 213,RESIDENTIAL,32100,0,32100,25800,0,57900
142317801800000,SE 213,RESIDENTIAL,23900,0,23900,40700,0,64600
142317801900000,SE 213,RESIDENTIAL,31500,0,31500,66200,0,97700
142317802000000,SE 213,RESIDENTIAL,27000,0,27000,57100,0,84100
142317802100000,SE 213,RESIDENTIAL,37500,0,37500,0,0,37500
142317802200000,SE 213,RESIDENTIAL,34800,0,34800,0,0,34800
142317802300000,SE 213,RESIDENTIAL,36300,0,36300,113600,0,149900
142317802400000,SE 213,RESIDENTIAL,27800,0,27800,96800,0,124600
142317802500000,SE 213,RESIDENTIAL,27800,0,27800,52400,0,80200
142317802600000,SE 213,RESIDENTIAL,35700,0,35700,82800,0,118500
142317802700000,SE 213,RESIDENTIAL,35300,0,35300,69600,0,104900
142317802800000,SE 213,RESIDENTIAL,35300,0,35300,72600,0,107900
142317802900000,SE 213,RESIDENTIAL,36300,0,36300,127300,0,163600
142317803000000,SE 213,RESIDENTIAL,36700,0,36700,101400,0,138100
142317803100000,SE 213,RESIDENTIAL,34600,0,34600,138300,0,172900
142317803200000,SE 213,RESIDENTIAL,39100,0,39100,154800,0,193900
142317803300000,SE 213,RESIDENTIAL,49500,0,49500,170000,0,219500
142317803400000,SE 213,RESIDENTIAL,48700,0,48700,133500,0,182200
142317803500000,SE 213,RESIDENTIAL,36900,0,36900,127400,0,164300
142317803600000,SE 213,RESIDENTIAL,45900,0,45900,135600,0,181500
142317803700000,SE 213,RESIDENTIAL,46600,0,46600,103600,0,150200
142317803800000,SE 213,RESIDENTIAL,32300,0,32300,151500,0,183800
142317803900000,CHURCH,EXEMPT,0,304000,304000,0,907800,1211800
142317804000000,SE 213,RESIDENTIAL,32200,0,32200,85600,0,117800
142317804100000,SE 213,RESIDENTIAL,31300,0,31300,125700,0,157000
142317804200000,SE 213,RESIDENTIAL,31300,0,31300,93500,0,124800
142317804300000,SE 213,RESIDENTIAL,33100,0,33100,68600,0,101700
142317804400000,SE 213,RESIDENTIAL,37500,0,37500,123300,0,160800
142317804500000,SE 213,RESIDENTIAL,37500,0,37500,145400,0,182900
142317804600000,SE 213,RESIDENTIAL,77800,0,77800,193800,0,271600
142317804700000,SE 213,RESIDENTIAL,95400,0,95400,329200,0,424600
142317804800000,SE 213,RESIDENTIAL,65700,0,65700,211800,0,277500
142320100100000,SE 248,RESIDENTIAL,101400,0,101400,322000,0,423400
142320100200000,SE 248,RESIDENTIAL,107100,0,107100,1075700,0,1182800
142320100300000,SE 248,RESIDENTIAL,86100,0,86100,319000,0,405100
142320100400000,SE 248,RESIDENTIAL,89600,0,89600,490800,0,580400
142320100500000,SE 248,RESIDENTIAL,114500,0,114500,364100,0,478600
142320100600000,SE 248,RESIDENTIAL,87000,0,87000,341400,0,428400
142320100700000,SE 248,RESIDENTIAL,95100,0,95100,319500,0,414600
142320100800000,SE 248,RESIDENTIAL,136300,0,136300,540100,0,676400
142320100900000,SE 248,RESIDENTIAL,114400,0,114400,596700,0,711100
142320101000000,SE 248,RESIDENTIAL,38300,0,38300,150200,0,188500
142320101100000,SE 248,RESIDENTIAL,44500,0,44500,227100,0,271600
142320101200000,SE 248,RESIDENTIAL,41700,0,41700,204700,0,246400
142320101300000,SE 248,RESIDENTIAL,49100,0,49100,233600,0,282700
142320101400000,SE 248,RESIDENTIAL,49000,0,49000,228100,0,277100
142320101500000,SE 248,RESIDENTIAL,44400,0,44400,158800,0,203200
142320101600000,SE 248,RESIDENTIAL,50000,0,50000,227600,0,277600
142320101700000,SE 248,RESIDENTIAL,50000,0,50000,154100,0,204100
142320101800000,SE 248,RESIDENTIAL,102900,0,102900,260300,0,363200
142320101900000,SE 248,RESIDENTIAL,51800,0,51800,254600,0,306400
142320102000000,SE 248,RESIDENTIAL,103900,0,103900,509500,0,613400
142320102100000,SE 248,RESIDENTIAL,49700,0,49700,0,0,49700
142320102200000,SE 248,RESIDENTIAL,49600,0,49600,0,0,49600
142320102300000,SE 248,RESIDENTIAL,103600,0,103600,194800,0,298400
142320102400000,SE 248,RESIDENTIAL,59500,0,59500,167300,0,226800
142320102500000,SE 248,RESIDENTIAL,34000,0,34000,187200,0,221200
142320102600000,SE 248,RESIDENTIAL,35100,0,35100,191200,0,226300
142320102700000,SE 248,RESIDENTIAL,39100,0,39100,287600,0,326700
142320102800000,SE 248,RESIDENTIAL,57700,0,57700,211200,0,268900
142320200100000,SE 248,RESIDENTIAL,33000,0,33000,248000,0,281000
142320200200000,SE 248,RESIDENTIAL,33700,0,33700,171100,0,204800
142320200300000,SE 248,RESIDENTIAL,36200,0,36200,99200,0,135400
142320200400000,SE 248,RESIDENTIAL,38300,0,38300,142700,0,181000
142320300100000,SE 248,RESIDENTIAL,32700,0,32700,122900,0,155600
142320300200000,SE 248,RESIDENTIAL,33000,0,33000,192800,0,225800
142322600100000,SE 248,RESIDENTIAL,130900,0,130900,349300,0,480200
142322600200000,SE 248,RESIDENTIAL,98400,0,98400,291600,0,390000
142322700100000,SE 248,RESIDENTIAL,98000,0,98000,369500,0,467500
142322700200000,SE 248,RESIDENTIAL,110600,0,110600,355500,0,466100
142322700300000,SE 248,RESIDENTIAL,77300,0,77300,499000,0,576300
142322800100000,SE 248,RESIDENTIAL,71700,0,71700,241000,0,312700
142322800200000,SE 248,RESIDENTIAL,35000,0,35000,251100,0,286100
142322800300000,SE 248,RESIDENTIAL,48300,0,48300,174000,0,222300
142322800400000,SE 248,RESIDENTIAL,38400,0,38400,178700,0,217100
142322800500000,SE 248,RESIDENTIAL,31500,0,31500,193500,0,225000
142322800600000,SE 248,RESIDENTIAL,35000,0,35000,125500,0,160500
142322800700000,SE 248,RESIDENTIAL,61000,0,61000,165600,0,226600
142322800800000,SE 248,RESIDENTIAL,49200,0,49200,195300,0,244500
142322800900000,SE 248,RESIDENTIAL,53300,0,53300,191300,0,244600
142322801000000,SE 248,RESIDENTIAL,39200,0,39200,211500,0,250700
142322900100000,SE 248,RESIDENTIAL,99900,0,99900,578100,0,678000
142322900200000,SE 248,RESIDENTIAL,76200,0,76200,161700,0,237900
142322900300000,SE 248,RESIDENTIAL,90700,0,90700,348000,0,438700
142322900400000,SE 248,RESIDENTIAL,71200,0,71200,508500,0,579700
142322900500000,SE 248,RESIDENTIAL,86300,0,86300,359200,0,445500
142322900600000,SE 248,RESIDENTIAL,47300,0,47300,225500,0,272800
142322900700000,SE 248,RESIDENTIAL,27000,0,27000,150000,0,177000
142322900800000,SE 248,RESIDENTIAL,70400,0,70400,316600,0,387000
142322900900000,SE 248,RESIDENTIAL,53500,0,53500,310700,0,364200
142322901000000,SE 248,RESIDENTIAL,27300,0,27300,205900,0,233200
142322901100000,SE 248,RESIDENTIAL,27300,0,27300,151000,0,178300
142322901200000,SE 248,RESIDENTIAL,27300,0,27300,149700,0,177000
142322901300000,SE 248,RESIDENTIAL,27300,0,27300,177100,0,204400
142322901400000,SE 248,RESIDENTIAL,30000,0,30000,176100,0,206100
142322901500000,SE 248,RESIDENTIAL,30300,0,30300,126600,0,156900
142322901600000,SE 248,RESIDENTIAL,38500,0,38500,157200,0,195700
142322901700000,SE 248,RESIDENTIAL,104300,0,104300,390000,0,494300
142323000100000,SE 248,RESIDENTIAL,62000,0,62000,202500,0,264500
142323100100000,SE 248,RESIDENTIAL,34500,0,34500,235500,0,270000
142323200100000,SE 248,RESIDENTIAL,43700,0,43700,222700,0,266400
142323200200000,SE 248,RESIDENTIAL,34300,0,34300,219800,0,254100
142323200300000,SE 248,RESIDENTIAL,46100,0,46100,194200,0,240300
142323200400000,SE 248,RESIDENTIAL,104200,0,104200,310000,0,414200
142323200500000,SE 248,RESIDENTIAL,100900,0,100900,661400,0,762300
142323200600000,SE 248,RESIDENTIAL,76400,0,76400,219100,0,295500
142323200700000,SE 248,RESIDENTIAL,59000,0,59000,392400,0,451400
142323200800000,SE 248,RESIDENTIAL,69600,0,69600,258000,0,327600
142323200900000,SE 248,RESIDENTIAL,42400,0,42400,265400,0,307800
142323201000000,SE 248,RESIDENTIAL,30800,0,30800,185900,0,216700
142323201100000,SE 248,RESIDENTIAL,37100,0,37100,172800,0,209900
142323201200000,SE 248,RESIDENTIAL,34900,0,34900,192100,0,227000
142323201300000,SE 248,RESIDENTIAL,40400,0,40400,198300,0,238700
142323201400000,SE 248,RESIDENTIAL,29300,0,29300,152300,0,181600
142323201500000,SE 216,RESIDENTIAL,31400,0,31400,118500,0,149900
142325100100000,SE 248,RESIDENTIAL,36300,0,36300,195000,0,231300
142325100200000,SE 248,RESIDENTIAL,36300,0,36300,184400,0,220700
142325100300000,SE 248,RESIDENTIAL,57600,0,57600,203000,0,260600
142325100400000,SE 248,RESIDENTIAL,55000,0,55000,194000,0,249000
142325200100000,SE 248,RESIDENTIAL,35800,0,35800,216400,0,252200
142325200200000,SE 248,RESIDENTIAL,35100,0,35100,157600,0,192700
142325200300000,SE 248,RESIDENTIAL,43600,0,43600,212400,0,256000
142325200400000,SE 248,RESIDENTIAL,39400,0,39400,223100,0,262500
142325200500000,SE 248,RESIDENTIAL,38600,0,38600,218400,0,257000
142325200600000,SE 248,RESIDENTIAL,40600,0,40600,280300,0,320900
142325200700000,SE 248,RESIDENTIAL,39400,0,39400,168700,0,208100
142325200800000,SE 248,RESIDENTIAL,39400,0,39400,197800,0,237200
142325200900000,SE 248,RESIDENTIAL,39400,0,39400,190500,0,229900
142325201000000,SE 248,RESIDENTIAL,39400,0,39400,145700,0,185100
142325201100000,SE 248,RESIDENTIAL,39400,0,39400,383200,0,422600
142325201200000,SE 248,RESIDENTIAL,39400,0,39400,297500,0,336900
142325201300000,SE 248,RESIDENTIAL,47300,0,47300,206900,0,254200
142325201400000,SE 248,RESIDENTIAL,25200,0,25200,155900,0,181100
142325201500000,SE 248,RESIDENTIAL,22100,0,22100,112600,0,134700
142325201600000,SE 248,RESIDENTIAL,36800,0,36800,149200,0,186000
142325201700000,SE 248,RESIDENTIAL,36300,0,36300,144400,0,180700
142325201800000,SE 248,RESIDENTIAL,32200,0,32200,156000,0,188200
142325300100000,SE 248,RESIDENTIAL,81700,0,81700,214900,0,296600
142325300200000,SE 248,RESIDENTIAL,68900,0,68900,205100,0,274000
142325300300000,SE 248,RESIDENTIAL,71600,0,71600,269300,0,340900
142325300400000,SE 248,RESIDENTIAL,59400,0,59400,273300,0,332700
142325300500000,SE 248,RESIDENTIAL,64400,0,64400,354300,0,418700
142325300600000,SE 248,RESIDENTIAL,60500,0,60500,368400,0,428900
142325400100000,SE 248,RESIDENTIAL,52600,0,52600,287400,0,340000
142325400200000,SE 248,RESIDENTIAL,53000,0,53000,422200,0,475200
142325400300000,SE 248,RESIDENTIAL,51100,0,51100,513700,0,564800
142325400400000,SE 248,RESIDENTIAL,46100,0,46100,132900,0,179000
142325400500000,SE 248,RESIDENTIAL,48900,0,48900,180800,0,229700
142325400600000,SE 248,RESIDENTIAL,52700,0,52700,209000,0,261700
142325400700000,SE 248,RESIDENTIAL,50400,0,50400,198300,0,248700
142325400800000,SE 248,RESIDENTIAL,74200,0,74200,373700,0,447900
142325400900000,SE 248,RESIDENTIAL,40800,0,40800,222500,0,263300
142325401000000,SE 248,RESIDENTIAL,39800,0,39800,223600,0,263400
142325500100000,SE 248,RESIDENTIAL,39400,0,39400,276100,0,315500
142325500200000,SE 248,RESIDENTIAL,46500,0,46500,202900,0,249400
142325500300000,SE 248,RESIDENTIAL,53900,0,53900,211500,0,265400
142325500400000,SE 248,RESIDENTIAL,46600,0,46600,251700,0,298300
142325500500000,SE 248,RESIDENTIAL,37000,0,37000,208300,0,245300
142325500600000,SE 248,RESIDENTIAL,32200,0,32200,138500,0,170700
142325500700000,SE 248,RESIDENTIAL,39800,0,39800,136700,0,176500
142325500800000,SE 248,RESIDENTIAL,38200,0,38200,226700,0,264900
142325500900000,SE 248,RESIDENTIAL,42400,0,42400,178600,0,221000
142325501000000,SE 248,RESIDENTIAL,48400,0,48400,190400,0,238800
142325501100000,SE 248,RESIDENTIAL,43200,0,43200,151200,0,194400
142325501200000,SE 248,RESIDENTIAL,42600,0,42600,164300,0,206900
142325501300000,SE 248,RESIDENTIAL,39500,0,39500,176800,0,216300
142325501400000,SE 248,RESIDENTIAL,43000,0,43000,180700,0,223700
142325600100000,SE 248,RESIDENTIAL,115000,0,115000,835900,0,950900
142325600200000,SE 227,RESIDENTIAL,30100,0,30100,126100,0,156200
142325600300000,SE 227,RESIDENTIAL,27900,0,27900,124800,0,152700
142325600400000,SE 227,RESIDENTIAL,27600,0,27600,61100,0,88700
142325600500000,SE 227,RESIDENTIAL,27000,0,27000,119200,0,146200
142325600600000,SE 227,RESIDENTIAL,28500,0,28500,128600,0,157100
142325600700000,SE 227,RESIDENTIAL,27200,0,27200,94300,0,121500
142325600800000,SE 248,RESIDENTIAL,38800,0,38800,120600,0,159400
142325600900000,SE 248,RESIDENTIAL,53800,0,53800,272100,0,325900
142325601000000,SE 248,RESIDENTIAL,34300,0,34300,167600,0,201900
142325601100000,SE 248,RESIDENTIAL,22300,0,22300,139200,0,161500
142325601200000,SE 248,RESIDENTIAL,28300,0,28300,187400,0,215700
142325601300000,SE 248,RESIDENTIAL,47700,0,47700,148000,0,195700
142325700100000,SE 248,RESIDENTIAL,47200,0,47200,222400,0,269600
142325700200000,SE 248,RESIDENTIAL,50000,0,50000,217700,0,267700
142325700300000,SE 248,RESIDENTIAL,45500,0,45500,213200,0,258700
142325700400000,SE 248,RESIDENTIAL,45900,0,45900,168100,0,214000
142325700500000,SE 248,RESIDENTIAL,47800,0,47800,195100,0,242900
142325700600000,SE 248,RESIDENTIAL,49200,0,49200,206600,0,255800
142325700700000,SE 248,RESIDENTIAL,53900,0,53900,238600,0,292500
142325700800000,SE 248,RESIDENTIAL,46500,0,46500,146800,0,193300
142325700900000,SE 248,RESIDENTIAL,54300,0,54300,238700,0,293000
142325701000000,SE 227,RESIDENTIAL,35000,0,35000,168700,0,203700
142325701100000,SE 227,RESIDENTIAL,29800,0,29800,126400,0,156200
142325701200000,SE 227,RESIDENTIAL,30000,0,30000,134800,0,164800
142325701300000,SE 227,RESIDENTIAL,30000,0,30000,110100,0,140100
142325701400000,SE 227,RESIDENTIAL,30000,0,30000,129000,0,159000
142325701500000,SE 227,RESIDENTIAL,30000,0,30000,161700,0,191700
142325701600000,SE 227,RESIDENTIAL,30000,0,30000,140600,0,170600
142325701700000,SE 227,RESIDENTIAL,30000,0,30000,223800,0,253800
142325701800000,SE 227,RESIDENTIAL,30000,0,30000,165400,0,195400
142325701900000,SE 227,RESIDENTIAL,30000,0,30000,143100,0,173100
142325702000000,SE 227,RESIDENTIAL,30000,0,30000,140400,0,170400
142325702100000,SE 227,RESIDENTIAL,30000,0,30000,115500,0,145500
142325702200000,SE 227,RESIDENTIAL,33800,0,33800,158900,0,192700
142325702300000,SE 227,RESIDENTIAL,38500,0,38500,102800,0,141300
142325800100000,SE 227,RESIDENTIAL,34000,0,34000,112900,0,146900
142325800200000,SE 227,RESIDENTIAL,31300,0,31300,72400,0,103700
142325800300000,SE 227,RESIDENTIAL,30300,0,30300,121100,0,151400
142325800400000,SE 227,RESIDENTIAL,36900,0,36900,140900,0,177800
142325800500000,SE 227,RESIDENTIAL,26100,0,26100,103300,0,129400
142325800600000,SE 227,RESIDENTIAL,26100,0,26100,85500,0,111600
142325800700000,SE 227,RESIDENTIAL,29700,0,29700,117700,0,147400
142327600100000,SE 248,RESIDENTIAL,36900,0,36900,184500,0,221400
142327600200000,SE 248,RESIDENTIAL,28900,0,28900,181600,0,210500
142327600300000,SE 248,RESIDENTIAL,26100,0,26100,123600,0,149700
142327600400000,SE 248,RESIDENTIAL,30600,0,30600,151600,0,182200
142327600500000,SE 248,RESIDENTIAL,26100,0,26100,155700,0,181800
142327600600000,SE 248,RESIDENTIAL,28800,0,28800,154200,0,183000
142327600700000,SE 248,RESIDENTIAL,27800,0,27800,107700,0,135500
142327600800000,SE 248,RESIDENTIAL,43000,0,43000,183000,0,226000
142327700100000,SE 248,RESIDENTIAL,37400,0,37400,177400,0,214800
142327700200000,SE 248,RESIDENTIAL,30900,0,30900,167900,0,198800
142327700300000,SE 248,RESIDENTIAL,29200,0,29200,142300,0,171500
142327700400000,SE 248,RESIDENTIAL,29900,0,29900,149000,0,178900
142327700500000,SE 248,RESIDENTIAL,33100,0,33100,139000,0,172100
142327700600000,SE 248,RESIDENTIAL,28000,0,28000,151800,0,179800
142327800100000,SE 248,RESIDENTIAL,27400,0,27400,170200,0,197600
142327800200000,SE 248,RESIDENTIAL,27000,0,27000,151700,0,178700
142327800300000,SE 248,RESIDENTIAL,29200,0,29200,165400,0,194600
142327800400000,SE 248,RESIDENTIAL,29300,0,29300,111000,0,140300
142327800500000,SE 248,RESIDENTIAL,30200,0,30200,199200,0,229400
142327800600000,SE 248,RESIDENTIAL,30400,0,30400,224900,0,255300
142327800700000,SE 248,RESIDENTIAL,66000,0,66000,299900,0,365900
142327800800000,SE 248,RESIDENTIAL,46800,0,46800,212600,0,259400
142327800900000,SE 248,RESIDENTIAL,42900,0,42900,231300,0,274200
142327801000000,SE 248,RESIDENTIAL,41500,0,41500,164500,0,206000
142327801100000,SE 248,RESIDENTIAL,42700,0,42700,261800,0,304500
142327801200000,SE 248,RESIDENTIAL,34500,0,34500,158400,0,192900
142327801300000,SE 248,RESIDENTIAL,83700,0,83700,370200,0,453900
142327801400000,SE 248,RESIDENTIAL,49700,0,49700,181100,0,230800
142327801500000,SE 248,RESIDENTIAL,38400,0,38400,254200,0,292600
142327801600000,SE 248,RESIDENTIAL,57400,0,57400,338300,0,395700
142327801700000,SE 248,RESIDENTIAL,42500,0,42500,220800,0,263300
142327801800000,SE 248,RESIDENTIAL,42600,0,42600,188100,0,230700
142327801900000,SE 248,RESIDENTIAL,36000,0,36000,204200,0,240200
142327802000000,SE 248,RESIDENTIAL,33200,0,33200,182700,0,215900
142327802100000,SE 248,RESIDENTIAL,32900,0,32900,126700,0,159600
142327900100000,SE 248,RESIDENTIAL,84300,0,84300,459800,0,544100
142327900200000,SE 248,RESIDENTIAL,54500,0,54500,230600,0,285100
142327900300000,SE 248,RESIDENTIAL,66800,0,66800,199200,0,266000
142327900400000,SE 248,RESIDENTIAL,83900,0,83900,420400,0,504300
142327900500000,SE 248,RESIDENTIAL,73200,0,73200,311600,0,384800
142327900600000,SE 248,RESIDENTIAL,68400,0,68400,333200,0,401600
142327900700000,SE 248,RESIDENTIAL,64500,0,64500,243000,0,307500
142327900800000,SE 248,RESIDENTIAL,68000,0,68000,244800,0,312800
142327900900000,SE 248,RESIDENTIAL,40700,0,40700,169300,0,210000
142327901000000,SE 248,RESIDENTIAL,38300,0,38300,94200,0,132500
142327901100000,SE 248,RESIDENTIAL,30000,0,30000,139600,0,169600
142327901200000,SE 248,RESIDENTIAL,30000,0,30000,170800,0,200800
142327901300000,SE 248,RESIDENTIAL,30000,0,30000,139400,0,169400
142327901400000,SE 248,RESIDENTIAL,30800,0,30800,187000,0,217800
142328000100000,SE 248,RESIDENTIAL,42400,0,42400,179600,0,222000
142328000200000,SE 248,RESIDENTIAL,39600,0,39600,238900,0,278500
142328000300000,SE 248,RESIDENTIAL,40800,0,40800,190300,0,231100
142328000400000,SE 248,RESIDENTIAL,40500,0,40500,211400,0,251900
142328000500000,SE 248,RESIDENTIAL,45900,0,45900,221200,0,267100
142328000600000,SE 248,RESIDENTIAL,35500,0,35500,226800,0,262300
142328000700000,SE 248,RESIDENTIAL,31500,0,31500,161100,0,192600
142328000800000,SE 248,RESIDENTIAL,42800,0,42800,215700,0,258500
142328000900000,SE 248,RESIDENTIAL,28100,0,28100,244500,0,272600
142328001000000,SE 248,RESIDENTIAL,27800,0,27800,147400,0,175200
142328001100000,SE 248,RESIDENTIAL,30300,0,30300,103000,0,133300
142328001200000,SE 248,RESIDENTIAL,31100,0,31100,180500,0,211600
142328001300000,SE 248,RESIDENTIAL,33200,0,33200,166700,0,199900
142328001400000,SE 248,RESIDENTIAL,37300,0,37300,263800,0,301100
142328001500000,SE 248,RESIDENTIAL,39400,0,39400,262900,0,302300
142328001600000,SE 248,RESIDENTIAL,51500,0,51500,222100,0,273600
142328001700000,SE 227,RESIDENTIAL,32600,0,32600,99700,0,132300
142328001800000,SE 227,RESIDENTIAL,29500,0,29500,122000,0,151500
142328001900000,SE 227,RESIDENTIAL,30000,0,30000,152800,0,182800
142328002000000,SE 227,RESIDENTIAL,30000,0,30000,128600,0,158600
142328002100000,SE 227,RESIDENTIAL,30000,0,30000,125800,0,155800
142328002200000,SE 227,RESIDENTIAL,29200,0,29200,107900,0,137100
142328002300000,SE 248,RESIDENTIAL,44600,0,44600,143600,0,188200
142328100100000,SE 227,RESIDENTIAL,51000,0,51000,174300,0,225300
142328100200000,SE 248,RESIDENTIAL,52300,0,52300,244000,0,296300
142328100300000,SE 248,RESIDENTIAL,51400,0,51400,207300,0,258700
142328100400000,SE 248,RESIDENTIAL,104800,0,104800,686600,0,791400
142328100500000,SE 248,RESIDENTIAL,103400,0,103400,734100,0,837500
142328100600000,SE 248,RESIDENTIAL,68600,0,68600,524300,0,592900
142328100700000,SE 248,RESIDENTIAL,74100,0,74100,314200,0,388300
142328100800000,SE 248,RESIDENTIAL,51500,0,51500,367100,0,418600
142328100900000,SE 248,RESIDENTIAL,68600,0,68600,281300,0,349900
142328101000000,SE 248,RESIDENTIAL,64200,0,64200,0,0,64200
142328101100000,SE 227,RESIDENTIAL,43800,0,43800,164400,0,208200
142328101200000,SE 227,RESIDENTIAL,32800,0,32800,148900,0,181700
142328101300000,SE 227,RESIDENTIAL,31200,0,31200,117300,0,148500
142328101400000,SE 227,RESIDENTIAL,37500,0,37500,192500,0,230000
142328101500000,SE 227,RESIDENTIAL,33800,0,33800,106100,0,139900
142328101600000,SE 227,RESIDENTIAL,33800,0,33800,210600,0,244400
142328101700000,SE 227,RESIDENTIAL,31200,0,31200,93300,0,124500
142328101800000,SE 227,RESIDENTIAL,30000,0,30000,184700,0,214700
142328101900000,SE 227,RESIDENTIAL,33800,0,33800,143600,0,177400
142330100100000,SE 227,RESIDENTIAL,25800,0,25800,113200,0,139000
142330100200000,SE 227,RESIDENTIAL,24000,0,24000,91800,0,115800
142330100300000,SE 227,RESIDENTIAL,24000,0,24000,121900,0,145900
142330100400000,SE 227,RESIDENTIAL,23300,0,23300,120500,0,143800
142330100800000,SE 227,RESIDENTIAL,29300,0,29300,125700,0,155000
142330100900000,SE 227,RESIDENTIAL,25400,0,25400,102200,0,127600
142330101000000,SE 227,RESIDENTIAL,25200,0,25200,105900,0,131100
142330101100000,SE 227,RESIDENTIAL,20100,0,20100,95900,0,116000
142330101200000,SE 227,RESIDENTIAL,24500,0,24500,14500,0,39000
142330101300000,SE 227,RESIDENTIAL,24500,0,24500,100100,0,124600
142330101400000,SE 227,RESIDENTIAL,24500,0,24500,114800,0,139300
142330101500000,SE 227,RESIDENTIAL,26600,0,26600,122100,0,148700
142330101600000,SE 227,RESIDENTIAL,26600,0,26600,83800,0,110400
142330101700000,SE 227,RESIDENTIAL,24500,0,24500,104800,0,129300
142330101800000,SE 227,RESIDENTIAL,27000,0,27000,104500,0,131500
142330101900000,SE 227,RESIDENTIAL,24500,0,24500,121600,0,146100
142330102000000,SE 227,RESIDENTIAL,24500,0,24500,85300,0,109800
142330102100000,SE 227,RESIDENTIAL,23900,0,23900,102900,0,126800
142330102200000,SE 227,RESIDENTIAL,24500,0,24500,90500,0,115000
142330102300000,SE 227,RESIDENTIAL,27700,0,27700,107700,0,135400
142330102400000,SE 227,RESIDENTIAL,27300,0,27300,109500,0,136800
142330102500000,SE 227,RESIDENTIAL,26300,0,26300,55900,0,82200
142330102600000,SE 227,RESIDENTIAL,26300,0,26300,51600,0,77900
142330102700000,SE 227,RESIDENTIAL,26300,0,26300,92600,0,118900
142330102800000,SE 227,RESIDENTIAL,26300,0,26300,106200,0,132500
142330102900000,SE 227,RESIDENTIAL,23600,0,23600,132300,0,155900
142330103000000,SE 227,RESIDENTIAL,23300,0,23300,90800,0,114100
142330103100000,SE 227,RESIDENTIAL,28100,0,28100,134800,0,162900
142330103200000,SE 227,RESIDENTIAL,33300,0,33300,155500,0,188800
142330103300000,SE 227,RESIDENTIAL,32500,0,32500,113800,0,146300
142330103400000,SE 227,RESIDENTIAL,32800,0,32800,159900,0,192700
142330103500000,SE 227,RESIDENTIAL,27800,0,27800,101500,0,129300
142330103600000,SE 227,RESIDENTIAL,25000,0,25000,113200,0,138200
142330103700000,SE 227,RESIDENTIAL,25000,0,25000,86500,0,111500
142330103800000,SE 227,RESIDENTIAL,26000,0,26000,98100,0,124100
142330104000000,SE 227,RESIDENTIAL,28800,0,28800,114700,0,143500
142330104200000,SE 227,RESIDENTIAL,30300,0,30300,163400,0,193700
142330104400000,SE 227,RESIDENTIAL,9500,0,9500,0,0,9500
142330104500000,SE 227,RESIDENTIAL,31200,0,31200,112700,0,143900
142330200100000,SE 227,RESIDENTIAL,46000,0,46000,172200,0,218200
142330200200000,SE 227,RESIDENTIAL,30200,0,30200,158500,0,188700
142330200300000,SE 227,RESIDENTIAL,25500,0,25500,90100,0,115600
142330200400000,SE 227,RESIDENTIAL,21900,0,21900,83400,0,105300
142330200500000,SE 227,RESIDENTIAL,26200,0,26200,107500,0,133700
142330200600000,SE 227,RESIDENTIAL,26100,0,26100,130100,0,156200
142330200700000,SE 227,RESIDENTIAL,26000,0,26000,148000,0,174000
142330200800000,SE 227,RESIDENTIAL,24900,0,24900,125800,0,150700
142330200900000,SE 227,RESIDENTIAL,25500,0,25500,116300,0,141800
142330201000000,SE 227,RESIDENTIAL,25500,0,25500,168100,0,193600
142330201100000,SE 227,RESIDENTIAL,25500,0,25500,145500,0,171000
142330201200000,SE 227,RESIDENTIAL,26000,0,26000,96800,0,122800
142330201300000,SE 227,RESIDENTIAL,27300,0,27300,141300,0,168600
142330201400000,SE 227,RESIDENTIAL,27500,0,27500,123100,0,150600
142330201500000,SE 227,RESIDENTIAL,27300,0,27300,151900,0,179200
142330201600000,SE 227,RESIDENTIAL,22000,0,22000,91300,0,113300
142330201700000,SE 227,RESIDENTIAL,23400,0,23400,124900,0,148300
142330201800000,SE 227,RESIDENTIAL,22400,0,22400,106700,0,129100
142330201900000,SE 227,RESIDENTIAL,26600,0,26600,98700,0,125300
142330202000000,SE 227,RESIDENTIAL,22700,0,22700,158900,0,181600
142330202100000,SE 227,RESIDENTIAL,24500,0,24500,111200,0,135700
142330202200000,SE 227,RESIDENTIAL,25300,0,25300,105800,0,131100
142330202300000,SE 227,RESIDENTIAL,24100,0,24100,96700,0,120800
142330202400000,SE 227,RESIDENTIAL,20300,0,20300,130600,0,150900
142330202500000,SE 227,RESIDENTIAL,19700,0,19700,105000,0,124700
142330202600000,SE 227,RESIDENTIAL,19500,0,19500,102200,0,121700
142330202700000,SE 227,RESIDENTIAL,19200,0,19200,83600,0,102800
142330202800000,SE 227,RESIDENTIAL,24300,0,24300,94100,0,118400
142330202900000,SE 227,RESIDENTIAL,24300,0,24300,93900,0,118200
142330203000000,SE 227,RESIDENTIAL,24300,0,24300,100600,0,124900
142330203100000,SE 227,RESIDENTIAL,24300,0,24300,87100,0,111400
142330203200000,SE 227,RESIDENTIAL,24300,0,24300,94600,0,118900
142330203300000,SE 227,RESIDENTIAL,24300,0,24300,108100,0,132400
142330203400000,SE 227,RESIDENTIAL,24800,0,24800,75500,0,100300
142330203500000,SE 227,RESIDENTIAL,24300,0,24300,96000,0,120300
142330203600000,SE 227,RESIDENTIAL,24300,0,24300,136800,0,161100
142330203700000,SE 227,RESIDENTIAL,21800,0,21800,123700,0,145500
142330203800000,SE 227,RESIDENTIAL,25300,0,25300,117400,0,142700
142330203900000,SE 227,RESIDENTIAL,24300,0,24300,136900,0,161200
142330204000000,SE 227,RESIDENTIAL,24300,0,24300,72800,0,97100
142330204100000,SE 227,RESIDENTIAL,24300,0,24300,113800,0,138100
142330204200000,SE 227,RESIDENTIAL,24300,0,24300,89000,0,113300
142330204300000,SE 227,RESIDENTIAL,24300,0,24300,53600,0,77900
142330300100000,SE 227,RESIDENTIAL,26200,0,26200,128800,0,155000
142330300200000,SE 227,RESIDENTIAL,25000,0,25000,150200,0,175200
142330300300000,SE 227,RESIDENTIAL,25000,0,25000,102000,0,127000
142330300400000,SE 227,RESIDENTIAL,25000,0,25000,120600,0,145600
142330300500000,SE 227,RESIDENTIAL,25000,0,25000,99900,0,124900
142330300600000,SE 227,RESIDENTIAL,25000,0,25000,112900,0,137900
142330300700000,SE 227,RESIDENTIAL,25100,0,25100,126500,0,151600
142330300800000,SE 227,RESIDENTIAL,26300,0,26300,90600,0,116900
142330300900000,SE 227,RESIDENTIAL,25000,0,25000,109200,0,134200
142330301000000,SE 227,RESIDENTIAL,25000,0,25000,105900,0,130900
142330301100000,SE 227,RESIDENTIAL,25000,0,25000,97800,0,122800
142330301200000,SE 227,RESIDENTIAL,25000,0,25000,122700,0,147700
142330301300000,SE 227,RESIDENTIAL,25000,0,25000,136900,0,161900
142330301400000,SE 227,RESIDENTIAL,24600,0,24600,89600,0,114200
142330400100000,SE 227,RESIDENTIAL,25600,0,25600,142100,0,167700
142330400200000,SE 227,RESIDENTIAL,25000,0,25000,94300,0,119300
142330400300000,SE 227,RESIDENTIAL,25000,0,25000,136700,0,161700
142330400400000,SE 227,RESIDENTIAL,25000,0,25000,107300,0,132300
142330400500000,SE 227,RESIDENTIAL,25000,0,25000,132900,0,157900
142330400600000,SE 227,RESIDENTIAL,25000,0,25000,130400,0,155400
142330400700000,SE 227,RESIDENTIAL,25100,0,25100,135300,0,160400
142330400800000,SE 227,RESIDENTIAL,29100,0,29100,126400,0,155500
142330400900000,SE 227,RESIDENTIAL,28600,0,28600,112800,0,141400
142330401000000,SE 227,RESIDENTIAL,26200,0,26200,81900,0,108100
142330401100000,SE 227,RESIDENTIAL,26400,0,26400,128600,0,155000
142330401200000,SE 227,RESIDENTIAL,27300,0,27300,105300,0,132600
142330401300000,SE 227,RESIDENTIAL,25000,0,25000,117400,0,142400
142330500100000,SE 227,RESIDENTIAL,26700,0,26700,113200,0,139900
142330500200000,SE 227,RESIDENTIAL,27500,0,27500,115000,0,142500
142330500300000,SE 227,RESIDENTIAL,26700,0,26700,95300,0,122000
142330500400000,SE 227,RESIDENTIAL,26700,0,26700,72600,0,99300
142330600100000,SE 227,RESIDENTIAL,24400,0,24400,82000,0,106400
142330600200000,SE 227,RESIDENTIAL,30200,0,30200,149200,0,179400
142330600300000,SE 227,RESIDENTIAL,26300,0,26300,98900,0,125200
142330600400000,SE 227,RESIDENTIAL,26300,0,26300,89000,0,115300
142330600500000,SE 227,RESIDENTIAL,15800,0,15800,83800,0,99600
142330600600000,SE 227,RESIDENTIAL,15200,0,15200,0,0,15200
142330600700000,SE 227,RESIDENTIAL,25200,0,25200,105200,0,130400
142330600800000,SE 227,RESIDENTIAL,24500,0,24500,102400,0,126900
142330600900000,SE 227,RESIDENTIAL,25100,0,25100,84000,0,109100
142330601000000,SE 227,RESIDENTIAL,28100,0,28100,117400,0,145500
142330601100000,SE 227,RESIDENTIAL,27600,0,27600,86800,0,114400
142330601200000,SE 227,RESIDENTIAL,27600,0,27600,96000,0,123600
142330601300000,SE 227,RESIDENTIAL,27600,0,27600,161900,0,189500
142330601400000,SE 227,RESIDENTIAL,27600,0,27600,115100,0,142700
142330601500000,SE 227,RESIDENTIAL,27600,0,27600,108100,0,135700
142330601600000,SE 227,RESIDENTIAL,28800,0,28800,114900,0,143700
142330601700000,SE 227,RESIDENTIAL,35600,0,35600,140200,0,175800
142330601800000,SE 227,RESIDENTIAL,23300,0,23300,89700,0,113000
142330601900000,SE 227,RESIDENTIAL,22000,0,22000,80200,0,102200
142330700100000,SE 227,RESIDENTIAL,27800,0,27800,119700,0,147500
142330700200000,SE 227,RESIDENTIAL,28200,0,28200,123300,0,151500
142330700300000,SE 227,RESIDENTIAL,28200,0,28200,111300,0,139500
142330700400000,SE 227,RESIDENTIAL,28200,0,28200,57200,0,85400
142330700500000,SE 227,RESIDENTIAL,28200,0,28200,85100,0,113300
142330800100000,SE 227,RESIDENTIAL,24400,0,24400,103600,0,128000
142330800200000,SE 227,RESIDENTIAL,24400,0,24400,94600,0,119000
142330800300000,SE 227,RESIDENTIAL,24400,0,24400,94100,0,118500
142330800400000,SE 227,RESIDENTIAL,24400,0,24400,88400,0,112800
142330800500000,SE 227,RESIDENTIAL,24400,0,24400,63600,0,88000
142330800600000,SE 227,RESIDENTIAL,21700,0,21700,78700,0,100400
142330900100000,SE 227,RESIDENTIAL,23500,0,23500,112900,0,136400
142330900200000,SE 227,RESIDENTIAL,24800,0,24800,99700,0,124500
142330900300000,SE 227,RESIDENTIAL,24000,0,24000,126900,0,150900
142330900400000,SE 227,RESIDENTIAL,24300,0,24300,130000,0,154300
142330900500000,SE 227,RESIDENTIAL,26600,0,26600,123600,0,150200
142330900600000,SE 227,RESIDENTIAL,25700,0,25700,133700,0,159400
142330900700000,SE 227,RESIDENTIAL,28600,0,28600,87200,0,115800
142330900800000,SE 227,RESIDENTIAL,32200,0,32200,128300,0,160500
142330900900000,SE 227,RESIDENTIAL,26300,0,26300,92200,0,118500
142330901000000,SE 227,RESIDENTIAL,26300,0,26300,91900,0,118200
142330901100000,SE 227,RESIDENTIAL,26300,0,26300,103000,0,129300
142330901200000,SE 227,RESIDENTIAL,26300,0,26300,107900,0,134200
142330901300000,SE 227,RESIDENTIAL,26300,0,26300,124700,0,151000
142330901400000,SE 227,RESIDENTIAL,26900,0,26900,171300,0,198200
142330901500000,SE 227,RESIDENTIAL,34300,0,34300,119600,0,153900
142330901600000,SE 227,RESIDENTIAL,24400,0,24400,140200,0,164600
142330901700000,SE 227,RESIDENTIAL,23400,0,23400,127200,0,150600
142330901800000,SE 227,RESIDENTIAL,21900,0,21900,111500,0,133400
142330901900000,SE 227,RESIDENTIAL,30100,0,30100,157700,0,187800
142332600100000,SE 227,RESIDENTIAL,28500,0,28500,213200,0,241700
142332600200000,SE 227,RESIDENTIAL,28000,0,28000,153500,0,181500
142332600300000,SE 227,RESIDENTIAL,25000,0,25000,125100,0,150100
142332600400000,SE 227,RESIDENTIAL,25000,0,25000,136600,0,161600
142332600500000,SE 227,RESIDENTIAL,24300,0,24300,99700,0,124000
142332600600000,SE 227,RESIDENTIAL,25700,0,25700,127200,0,152900
142332600700000,SE 227,RESIDENTIAL,25000,0,25000,90400,0,115400
142332600800000,SE 227,RESIDENTIAL,25000,0,25000,101700,0,126700
142332600900000,SE 227,RESIDENTIAL,25000,0,25000,112900,0,137900
142332601000000,SE 227,RESIDENTIAL,25000,0,25000,102800,0,127800
142332601100000,SE 227,RESIDENTIAL,24300,0,24300,97300,0,121600
142332700100000,SE 227,RESIDENTIAL,25700,0,25700,99800,0,125500
142332700200000,SE 227,RESIDENTIAL,25000,0,25000,101500,0,126500
142332700300000,SE 227,RESIDENTIAL,25000,0,25000,100600,0,125600
142332700400000,SE 227,RESIDENTIAL,25000,0,25000,113200,0,138200
142332700500000,SE 227,RESIDENTIAL,25000,0,25000,119600,0,144600
142332700600000,SE 227,RESIDENTIAL,26100,0,26100,113700,0,139800
142332700700000,SE 227,RESIDENTIAL,27300,0,27300,142400,0,169700
142332700800000,SE 227,RESIDENTIAL,25200,0,25200,135000,0,160200
142332700900000,SE 227,RESIDENTIAL,25200,0,25200,109400,0,134600
142332701000000,SE 227,RESIDENTIAL,25000,0,25000,111700,0,136700
142332800100000,SE 227,RESIDENTIAL,23400,0,23400,101700,0,125100
142332800200000,SE 227,RESIDENTIAL,23700,0,23700,105200,0,128900
142332800300000,SE 227,RESIDENTIAL,23900,0,23900,92700,0,116600
142332800400000,SE 227,RESIDENTIAL,24200,0,24200,93300,0,117500
142332800500000,SE 227,RESIDENTIAL,29700,0,29700,117500,0,147200
142332800600000,SE 227,RESIDENTIAL,29700,0,29700,92500,0,122200
142332800700000,SE 227,RESIDENTIAL,29700,0,29700,106100,0,135800
142332800800000,SE 227,RESIDENTIAL,29700,0,29700,119600,0,149300
142332800900000,SE 227,RESIDENTIAL,29700,0,29700,118300,0,148000
142332801000000,SE 227,RESIDENTIAL,29700,0,29700,144500,0,174200
142332801100000,SE 227,RESIDENTIAL,29700,0,29700,120700,0,150400
142332801200000,SE 227,RESIDENTIAL,23700,0,23700,131200,0,154900
142332801300000,SE 227,RESIDENTIAL,23700,0,23700,131800,0,155500
142332801400000,SE 227,RESIDENTIAL,25800,0,25800,127900,0,153700
142332801500000,SE 227,RESIDENTIAL,25900,0,25900,114900,0,140800
142332801600000,SE 227,RESIDENTIAL,30000,0,30000,93600,0,123600
142332801700000,SE 227,RESIDENTIAL,29300,0,29300,181600,0,210900
142332801800000,SE 227,RESIDENTIAL,30000,0,30000,139100,0,169100
142332801900000,SE 227,RESIDENTIAL,29700,0,29700,121900,0,151600
142332802000000,SE 227,RESIDENTIAL,35600,0,35600,74500,0,110100
142332802100000,SE 227,RESIDENTIAL,29700,0,29700,103600,0,133300
142332900100000,SE 227,RESIDENTIAL,24000,0,24000,120500,0,144500
142332900200000,SE 227,RESIDENTIAL,22400,0,22400,121900,0,144300
142332900300000,SE 227,RESIDENTIAL,26700,0,26700,130000,0,156700
142333000100000,SE 227,RESIDENTIAL,25000,0,25000,158300,0,183300
142333000200000,SE 227,RESIDENTIAL,25000,0,25000,154500,0,179500
142333000300000,SE 227,RESIDENTIAL,25000,0,25000,78600,0,103600
142333000400000,SE 227,RESIDENTIAL,31900,0,31900,158400,0,190300
142333000500000,SE 227,RESIDENTIAL,31900,0,31900,85700,0,117600
142333000600000,SE 227,RESIDENTIAL,25000,0,25000,146400,0,171400
142333000700000,SE 227,RESIDENTIAL,25000,0,25000,142500,0,167500
142333000800000,SE 227,RESIDENTIAL,25000,0,25000,130200,0,155200
142333000900000,SE 227,RESIDENTIAL,25000,0,25000,107300,0,132300
142333001000000,SE 227,RESIDENTIAL,33600,0,33600,185500,0,219100
142333001100000,SE 227,RESIDENTIAL,32800,0,32800,164600,0,197400
142333001200000,SE 227,RESIDENTIAL,25000,0,25000,81500,0,106500
142333001300000,SE 227,RESIDENTIAL,25000,0,25000,120400,0,145400
142333001400000,SE 227,RESIDENTIAL,25000,0,25000,140000,0,165000
142333001500000,SE 227,RESIDENTIAL,25000,0,25000,131300,0,156300
142333001600000,SE 227,RESIDENTIAL,31900,0,31900,130300,0,162200
142333001700000,SE 227,RESIDENTIAL,31900,0,31900,110100,0,142000
142333001800000,SE 227,RESIDENTIAL,25000,0,25000,161200,0,186200
142333100100000,SE 227,RESIDENTIAL,26500,0,26500,134500,0,161000
142333100200000,SE 227,RESIDENTIAL,27000,0,27000,130500,0,157500
142333100300000,SE 227,RESIDENTIAL,26800,0,26800,123300,0,150100
142333100400000,SE 227,RESIDENTIAL,26500,0,26500,137200,0,163700
142333100500000,SE 227,RESIDENTIAL,26300,0,26300,150400,0,176700
142333100600000,SE 227,RESIDENTIAL,26000,0,26000,138200,0,164200
142333100700000,SE 227,RESIDENTIAL,25500,0,25500,134400,0,159900
142333100800000,SE 227,RESIDENTIAL,25000,0,25000,121800,0,146800
142333100900000,SE 227,RESIDENTIAL,25000,0,25000,120300,0,145300
142333101000000,SE 227,RESIDENTIAL,25000,0,25000,79100,0,104100
142333101100000,SE 227,RESIDENTIAL,25000,0,25000,138500,0,163500
142333101200000,SE 227,RESIDENTIAL,26100,0,26100,134200,0,160300
142333101300000,SE 227,RESIDENTIAL,22500,0,22500,148800,0,171300
142333101400000,SE 227,RESIDENTIAL,25000,0,25000,132600,0,157600
142333101500000,SE 227,RESIDENTIAL,25000,0,25000,132300,0,157300
142333101600000,SE 227,RESIDENTIAL,28000,0,28000,94200,0,122200
142333101700000,SE 227,RESIDENTIAL,27400,0,27400,113600,0,141000
142333200100000,SE 227,RESIDENTIAL,27700,0,27700,123200,0,150900
142333200200000,SE 227,RESIDENTIAL,27300,0,27300,138500,0,165800
142333200300000,SE 227,RESIDENTIAL,21900,0,21900,74000,0,95900
142333200400000,SE 227,RESIDENTIAL,21900,0,21900,152500,0,174400
142333200500000,SE 227,RESIDENTIAL,28800,0,28800,146500,0,175300
142333200600000,SE 227,RESIDENTIAL,25900,0,25900,142000,0,167900
142333300100000,SE 227,RESIDENTIAL,21900,0,21900,123900,0,145800
142333300200000,SE 227,RESIDENTIAL,21600,0,21600,116000,0,137600
142333300300000,SE 227,RESIDENTIAL,27300,0,27300,112200,0,139500
142333300400000,SE 227,RESIDENTIAL,26500,0,26500,95200,0,121700
142333300500000,SE 227,RESIDENTIAL,37400,0,37400,187800,0,225200
142333400100000,SE 227,RESIDENTIAL,26000,0,26000,138500,0,164500
142333400200000,SE 227,RESIDENTIAL,31200,0,31200,146000,0,177200
142333400300000,SE 227,RESIDENTIAL,29900,0,29900,138500,0,168400
142333400400000,SE 227,RESIDENTIAL,30600,0,30600,132700,0,163300
142333400500000,SE 227,RESIDENTIAL,30800,0,30800,136600,0,167400
142333400600000,SE 227,RESIDENTIAL,25000,0,25000,81600,0,106600
142333400700000,SE 227,RESIDENTIAL,25000,0,25000,123400,0,148400
142333400800000,SE 227,RESIDENTIAL,26400,0,26400,155800,0,182200
142333400900000,SE 227,RESIDENTIAL,30400,0,30400,108500,0,138900
142333401000000,SE 227,RESIDENTIAL,30500,0,30500,117200,0,147700
142333401100000,SE 227,RESIDENTIAL,31200,0,31200,100800,0,132000
142333401200000,SE 227,RESIDENTIAL,28400,0,28400,197800,0,226200
142333401300000,SE 227,RESIDENTIAL,25000,0,25000,122400,0,147400
142333401400000,SE 227,RESIDENTIAL,25000,0,25000,154800,0,179800
142333401500000,SE 227,RESIDENTIAL,26500,0,26500,158500,0,185000
142333500100000,SE 227,RESIDENTIAL,42600,0,42600,181900,0,224500
142333500200000,SE 227,RESIDENTIAL,40200,0,40200,147300,0,187500
142333500300000,SE 227,RESIDENTIAL,25000,0,25000,96800,0,121800
142333500400000,SE 227,RESIDENTIAL,25000,0,25000,89100,0,114100
142333500500000,SE 227,RESIDENTIAL,25000,0,25000,89600,0,114600
142333500600000,SE 227,RESIDENTIAL,25000,0,25000,97900,0,122900
142333500700000,SE 227,RESIDENTIAL,25000,0,25000,124700,0,149700
142333500800000,SE 227,RESIDENTIAL,25000,0,25000,114200,0,139200
142333500900000,SE 227,RESIDENTIAL,26700,0,26700,155300,0,182000
142333501000000,SE 227,RESIDENTIAL,27300,0,27300,22000,0,49300
142333501100000,SE 227,RESIDENTIAL,25000,0,25000,88400,0,113400
142333501200000,SE 227,RESIDENTIAL,25000,0,25000,117500,0,142500
142333501300000,SE 227,RESIDENTIAL,25000,0,25000,109500,0,134500
142333600100000,SE 227,RESIDENTIAL,138600,0,138600,174000,0,312600
142333600200000,SE 227,RESIDENTIAL,47600,0,47600,215300,0,262900
142333600300000,SE 227,RESIDENTIAL,59000,0,59000,335100,0,394100
142333600400000,SE 227,RESIDENTIAL,57300,0,57300,395300,0,452600
142335100100000,SE 243,RESIDENTIAL,60300,0,60300,170500,0,230800
142335100200000,SE 243,RESIDENTIAL,64100,0,64100,152800,0,216900
142335100300000,SE 243,RESIDENTIAL,54200,0,54200,43900,0,98100
142335100400000,SE 243,RESIDENTIAL,54200,0,54200,193600,0,247800
142335100500000,SE 243,RESIDENTIAL,85500,0,85500,245400,0,330900
142335100600000,SE 243,RESIDENTIAL,140000,0,140000,232900,0,372900
142335100700000,SE 243,RESIDENTIAL,63200,0,63200,252900,0,316100
142335100800000,SE 243,RESIDENTIAL,57400,0,57400,206500,0,263900
142335100900000,SE 243,RESIDENTIAL,59200,0,59200,189400,0,248600
142335101000000,SE 243,RESIDENTIAL,56900,0,56900,188900,0,245800
142335101100000,SE 243,RESIDENTIAL,63500,0,63500,251700,0,315200
142335101200000,SE 243,RESIDENTIAL,72000,0,72000,271700,0,343700
142335101300000,SE 243,RESIDENTIAL,68400,0,68400,281400,0,349800
142335101400000,SE 247,RESIDENTIAL,177700,0,177700,785500,0,963200
142335101500000,SE 247,RESIDENTIAL,51100,0,51100,170100,0,221200
142335101600000,SE 247,RESIDENTIAL,51900,0,51900,239400,0,291300
142335101700000,SE 247,RESIDENTIAL,56900,0,56900,346800,0,403700
142335101800000,SE 247,RESIDENTIAL,57700,0,57700,252000,0,309700
142335101900000,SE 243,RESIDENTIAL,82000,0,82000,297100,0,379100
142335102000000,SE 243,RESIDENTIAL,70200,0,70200,132700,0,202900
142335102100000,SE 243,RESIDENTIAL,70200,0,70200,297300,0,367500
142335102200000,SE 243,RESIDENTIAL,58800,0,58800,171000,0,229800
142335200100000,SE 247,RESIDENTIAL,54400,0,54400,101200,0,155600
142335200200000,SE 247,RESIDENTIAL,68300,0,68300,364000,0,432300
142335200300000,SE 247,RESIDENTIAL,65300,0,65300,218300,0,283600
142335200400000,SE 247,RESIDENTIAL,69500,0,69500,146200,0,215700
142335200500000,SE 247,RESIDENTIAL,82300,0,82300,304100,0,386400
142335200600000,SE 247,RESIDENTIAL,69200,0,69200,275700,0,344900
142335200700000,SE 247,RESIDENTIAL,69200,0,69200,292800,0,362000
142335300100000,SE 247,RESIDENTIAL,59500,0,59500,185000,0,244500
142335300200000,SE 247,RESIDENTIAL,59500,0,59500,211500,0,271000
142335300300000,SE 247,RESIDENTIAL,48700,0,48700,183000,0,231700
142335300400000,SE 247,RESIDENTIAL,135300,0,135300,394100,0,529400
142335300500000,SE 247,RESIDENTIAL,71500,0,71500,198600,0,270100
142335300600000,SE 247,RESIDENTIAL,70100,0,70100,252500,0,322600
142335300700000,SE 247,RESIDENTIAL,62100,0,62100,165500,0,227600
142335300800000,SE 247,RESIDENTIAL,57000,0,57000,108500,0,165500
142335300900000,SE 247,RESIDENTIAL,49800,0,49800,89300,0,139100
142335301000000,SE 229,RESIDENTIAL,30000,0,30000,83800,0,113800
142335301100000,SE 229,RESIDENTIAL,21200,0,21200,82900,0,104100
142335301200000,SE 229,RESIDENTIAL,25600,0,25600,46000,0,71600
142335301300000,SE 247,RESIDENTIAL,71300,0,71300,153300,0,224600
142335301400000,SE 247,RESIDENTIAL,61800,0,61800,149900,0,211700
142335301500000,SE 247,RESIDENTIAL,62900,0,62900,149300,0,212200
142335301600000,SE 247,RESIDENTIAL,58200,0,58200,115300,0,173500
142335301700000,SE 247,RESIDENTIAL,52800,0,52800,133300,0,186100
142335400200000,SE 247,RESIDENTIAL,69500,0,69500,146600,0,216100
142335400300000,SE 247,RESIDENTIAL,66800,0,66800,214800,0,281600
142335400400000,SE 247,RESIDENTIAL,67100,0,67100,228000,0,295100
142335400500000,SE 247,RESIDENTIAL,65600,0,65600,194100,0,259700
142335400600000,SE 247,RESIDENTIAL,70900,0,70900,229300,0,300200
142335400700000,SE 247,RESIDENTIAL,70600,0,70600,385800,0,456400
142335400800000,SE 247,RESIDENTIAL,73800,0,73800,181200,0,255000
142335400900000,SE 247,RESIDENTIAL,65400,0,65400,263500,0,328900
142335401000000,SE 247,RESIDENTIAL,72800,0,72800,159800,0,232600
142335401100000,SE 247,RESIDENTIAL,73400,0,73400,148600,0,222000
142335401200000,SE 229,RESIDENTIAL,23100,0,23100,107000,0,130100
142335401300000,SE 229,RESIDENTIAL,27600,0,27600,90400,0,118000
142335401400000,SE 229,RESIDENTIAL,19500,0,19500,87200,0,106700
142335401500000,SE 229,RESIDENTIAL,19500,0,19500,92200,0,111700
142335401600000,SE 229,RESIDENTIAL,19500,0,19500,73100,0,92600
142335401700000,SE 229,RESIDENTIAL,19500,0,19500,71300,0,90800
142335401800000,SE 229,RESIDENTIAL,19500,0,19500,66900,0,86400
142335402000000,SE 229,RESIDENTIAL,32100,0,32100,143100,0,175200
142335500100000,SE 247,RESIDENTIAL,54300,0,54300,151300,0,205600
142335500200000,SE 247,RESIDENTIAL,37900,0,37900,134400,0,172300
142335600100000,SE 229,RESIDENTIAL,34000,0,34000,102900,0,136900
142335600200000,SE 229,RESIDENTIAL,26000,0,26000,117500,0,143500
142335600300000,SE 247,RESIDENTIAL,52200,0,52200,159400,0,211600
142335600400000,SE 247,RESIDENTIAL,53600,0,53600,159500,0,213100
142335600500000,SE 247,RESIDENTIAL,56400,0,56400,190500,0,246900
142335600600000,SE 247,RESIDENTIAL,47300,0,47300,175600,0,222900
142335600700000,SE 247,RESIDENTIAL,46900,0,46900,178400,0,225300
142335600800000,SE 229,RESIDENTIAL,16300,0,16300,67500,0,83800
142335600900000,SE 229,RESIDENTIAL,16300,0,16300,89400,0,105700
142335601000000,SE 229,RESIDENTIAL,16300,0,16300,88400,0,104700
142335601100000,SE 229,RESIDENTIAL,16300,0,16300,118900,0,135200
142335601200000,SE 229,RESIDENTIAL,16300,0,16300,93300,0,109600
142337600100000,SE 224,RESIDENTIAL,31100,0,31100,95300,0,126400
142337600200000,SE 224,RESIDENTIAL,22200,0,22200,109400,0,131600
142337600300000,SE 224,RESIDENTIAL,21600,0,21600,77200,0,98800
142337600400000,SE 224,RESIDENTIAL,22900,0,22900,105300,0,128200
142337600500000,SE 224,RESIDENTIAL,21100,0,21100,98600,0,119700
142337600600000,SE 224,RESIDENTIAL,21500,0,21500,100700,0,122200
142337600700000,SE 224,RESIDENTIAL,22700,0,22700,85700,0,108400
142337600800000,SE 224,RESIDENTIAL,26600,0,26600,124100,0,150700
142337600900000,SE 224,RESIDENTIAL,31100,0,31100,114100,0,145200
142337601000000,SE 224,RESIDENTIAL,27200,0,27200,85900,0,113100
142337601100000,SE 224,RESIDENTIAL,27200,0,27200,85200,0,112400
142337700100000,SE 224,RESIDENTIAL,25800,0,25800,107300,0,133100
142337700200000,SE 224,RESIDENTIAL,22600,0,22600,100100,0,122700
142337700300000,SE 224,RESIDENTIAL,22600,0,22600,75600,0,98200
142337700400000,SE 224,RESIDENTIAL,22600,0,22600,73400,0,96000
142337700500000,SE 224,RESIDENTIAL,22600,0,22600,103600,0,126200
142337700600000,SE 224,RESIDENTIAL,21400,0,21400,66600,0,88000
142337700700000,SE 224,RESIDENTIAL,21400,0,21400,92800,0,114200
142337700800000,SE 224,RESIDENTIAL,21700,0,21700,76700,0,98400
142337700900000,SE 224,RESIDENTIAL,22000,0,22000,74500,0,96500
142337701000000,SE 224,RESIDENTIAL,22000,0,22000,75300,0,97300
142337701100000,SE 224,RESIDENTIAL,22900,0,22900,94700,0,117600
142337701200000,SE 224,RESIDENTIAL,22700,0,22700,76700,0,99400
142337701300000,SE 224,RESIDENTIAL,21600,0,21600,118700,0,140300
142337701400000,SE 224,RESIDENTIAL,22500,0,22500,94500,0,117000
142337800100000,SCHOOL,EXEMPT,0,0,0,0,0,0
142337800200000,SE 227,RESIDENTIAL,34700,0,34700,126900,0,161600
142337800300000,SE 227,RESIDENTIAL,26300,0,26300,122400,0,148700
142337800400000,SE 227,RESIDENTIAL,26300,0,26300,92700,0,119000
142337800500000,SE 227,RESIDENTIAL,26300,0,26300,126500,0,152800
142337800600000,SE 227,RESIDENTIAL,26300,0,26300,132500,0,158800
142337800700000,SE 227,RESIDENTIAL,26300,0,26300,145200,0,171500
142337800800000,SE 227,RESIDENTIAL,26300,0,26300,101300,0,127600
142337800900000,SE 227,RESIDENTIAL,26300,0,26300,151400,0,177700
142337801000000,SE 227,RESIDENTIAL,26300,0,26300,116400,0,142700
142337801100000,SE 227,RESIDENTIAL,26300,0,26300,108900,0,135200
142337801200000,SE 227,RESIDENTIAL,23100,0,23100,116100,0,139200
142337801300000,SE 227,RESIDENTIAL,26300,0,26300,92500,0,118800
142337801400000,SE 227,RESIDENTIAL,26300,0,26300,88300,0,114600
142337801500000,SE 227,RESIDENTIAL,26300,0,26300,113200,0,139500
142337801600000,SE 227,RESIDENTIAL,26300,0,26300,125000,0,151300
142337801700000,SE 227,RESIDENTIAL,26300,0,26300,102100,0,128400
142337801800000,SE 227,RESIDENTIAL,26300,0,26300,97500,0,123800
142337801900000,SE 227,RESIDENTIAL,26300,0,26300,78300,0,104600
142337802000000,SE 227,RESIDENTIAL,26300,0,26300,97700,0,124000
142337802100000,SE 227,RESIDENTIAL,26300,0,26300,113500,0,139800
142337802200000,SE 227,RESIDENTIAL,26300,0,26300,67700,0,94000
142337802300000,SE 227,RESIDENTIAL,26300,0,26300,116700,0,143000
142337802400000,SE 227,RESIDENTIAL,26300,0,26300,74100,0,100400
142337802500000,SE 227,RESIDENTIAL,26300,0,26300,80000,0,106300
142337802600000,SE 227,RESIDENTIAL,25700,0,25700,91600,0,117300
142337802700000,CITY PROPERTY,EXEMPT,0,0,0,0,0,0
142337802800000,SE 224,RESIDENTIAL,17400,0,17400,64800,0,82200
142337802900000,SE 224,RESIDENTIAL,21200,0,21200,75800,0,97000
142337803000000,SE 224,RESIDENTIAL,21200,0,21200,80700,0,101900
142337803100000,SE 224,RESIDENTIAL,21600,0,21600,97600,0,119200
142337803200000,SE 224,RESIDENTIAL,21900,0,21900,94700,0,116600
142337803300000,SE 224,RESIDENTIAL,20900,0,20900,95400,0,116300
142337803400000,SE 224,RESIDENTIAL,20300,0,20300,80300,0,100600
142337900100000,SE 224,RESIDENTIAL,24900,0,24900,75000,0,99900
142337900200000,SE 224,RESIDENTIAL,21600,0,21600,101900,0,123500
142337900300000,SE 224,RESIDENTIAL,21400,0,21400,90400,0,111800
142337900400000,SE 224,RESIDENTIAL,21400,0,21400,109800,0,131200
142337900500000,SE 224,RESIDENTIAL,21400,0,21400,96700,0,118100
142337900600000,SE 224,RESIDENTIAL,21800,0,21800,107300,0,129100
142337900700000,SE 224,RESIDENTIAL,21800,0,21800,98700,0,120500
142337900800000,SE 224,RESIDENTIAL,21400,0,21400,104900,0,126300
142337900900000,SE 224,RESIDENTIAL,23200,0,23200,118900,0,142100
142337901000000,SE 224,RESIDENTIAL,22800,0,22800,81100,0,103900
142337901100000,SE 224,RESIDENTIAL,27700,0,27700,115900,0,143600
142337901200000,SE 224,RESIDENTIAL,26700,0,26700,110900,0,137600
142337901300000,SE 224,RESIDENTIAL,22800,0,22800,88400,0,111200
142337901400000,SE 224,RESIDENTIAL,24800,0,24800,99100,0,123900
142337901500000,SE 224,RESIDENTIAL,21400,0,21400,79900,0,101300
142337901600000,SE 224,RESIDENTIAL,21800,0,21800,86300,0,108100
142337901700000,SE 224,RESIDENTIAL,21800,0,21800,108600,0,130400
142337901800000,SE 224,RESIDENTIAL,21400,0,21400,85300,0,106700
142337901900000,SE 224,RESIDENTIAL,21400,0,21400,75800,0,97200
142337902000000,SE 224,RESIDENTIAL,21300,0,21300,83200,0,104500
142337902100000,SE 224,RESIDENTIAL,22200,0,22200,101100,0,123300
142337902200000,SE 224,RESIDENTIAL,22000,0,22000,88600,0,110600
142337902300000,SE 224,RESIDENTIAL,22100,0,22100,102500,0,124600
142337902400000,SE 224,RESIDENTIAL,21400,0,21400,110500,0,131900
142337902500000,SE 224,RESIDENTIAL,21000,0,21000,90200,0,111200
142337902600000,SE 224,RESIDENTIAL,21200,0,21200,104500,0,125700
142337902700000,SE 224,RESIDENTIAL,21200,0,21200,61100,0,82300
142337902800000,SE 224,RESIDENTIAL,21200,0,21200,89900,0,111100
142337902900000,SE 224,RESIDENTIAL,21200,0,21200,68000,0,89200
142337903000000,SE 224,RESIDENTIAL,21200,0,21200,92200,0,113400
142337903100000,SE 224,RESIDENTIAL,21200,0,21200,82700,0,103900
142337903200000,SE 224,RESIDENTIAL,21200,0,21200,98300,0,119500
142337903300000,SE 224,RESIDENTIAL,21200,0,21200,76800,0,98000
142337903400000,SE 224,RESIDENTIAL,21200,0,21200,126100,0,147300
142337903500000,SE 224,RESIDENTIAL,21600,0,21600,104300,0,125900
142337903600000,SE 224,RESIDENTIAL,17400,0,17400,78600,0,96000
142337903700000,SE 224,RESIDENTIAL,17400,0,17400,94300,0,111700
142337903800000,SE 224,RESIDENTIAL,25300,0,25300,72700,0,98000
142337903900000,SE 224,RESIDENTIAL,25200,0,25200,87500,0,112700
142337904000000,SE 224,RESIDENTIAL,19600,0,19600,72400,0,92000
142337904100000,SE 224,RESIDENTIAL,16100,0,16100,89900,0,106000
142337904200000,SE 224,RESIDENTIAL,31200,0,31200,96400,0,127600
142337904300000,SE 224,RESIDENTIAL,21500,0,21500,58600,0,80100
142337904400000,SE 224,RESIDENTIAL,18600,0,18600,53600,0,72200
142337904500000,SE 224,RESIDENTIAL,22100,0,22100,43400,0,65500
142337904600000,SE 224,RESIDENTIAL,22200,0,22200,70600,0,92800
142337904700000,SE 224,RESIDENTIAL,21800,0,21800,58000,0,79800
142337904800000,SE 224,RESIDENTIAL,22200,0,22200,122400,0,144600
142337904900000,SE 224,RESIDENTIAL,26600,0,26600,91000,0,117600
142337905000000,SE 224,RESIDENTIAL,26400,0,26400,123200,0,149600
142337905100000,SE 224,RESIDENTIAL,19000,0,19000,65100,0,84100
142337905200000,SE 224,RESIDENTIAL,21100,0,21100,93800,0,114900
142337905300000,SE 224,RESIDENTIAL,20400,0,20400,77800,0,98200
142337905400000,SE 224,RESIDENTIAL,21800,0,21800,0,0,21800
142337905500000,SE 224,RESIDENTIAL,15200,0,15200,77700,0,92900
142337905600000,SE 224,RESIDENTIAL,24900,0,24900,111300,0,136200
142337905700000,SE 224,RESIDENTIAL,24900,0,24900,69400,0,94300
142337905800000,SE 224,RESIDENTIAL,24900,0,24900,108700,0,133600
142338000100000,SE 224,RESIDENTIAL,20200,0,20200,92300,0,112500
142338000200000,SE 224,RESIDENTIAL,20100,0,20100,80600,0,100700
142338000300000,SE 224,RESIDENTIAL,20200,0,20200,82100,0,102300
142338000400000,SE 224,RESIDENTIAL,19800,0,19800,87300,0,107100
142338000500000,SE 224,RESIDENTIAL,20500,0,20500,71100,0,91600
142338000600000,SE 224,RESIDENTIAL,16500,0,16500,84100,0,100600
142338000700000,SE 224,RESIDENTIAL,22800,0,22800,95400,0,118200
142338000800000,SE 224,RESIDENTIAL,18700,0,18700,66500,0,85200
142338000900000,SE 224,RESIDENTIAL,18700,0,18700,81500,0,100200
142338001000000,SE 224,RESIDENTIAL,19600,0,19600,74100,0,93700
142338001100000,SE 224,RESIDENTIAL,20000,0,20000,63900,0,83900
142338001200000,SE 224,RESIDENTIAL,20400,0,20400,78700,0,99100
142338001300000,SE 224,RESIDENTIAL,19600,0,19600,71200,0,90800
142340100100000,SE 210,RESIDENTIAL,7600,0,7600,0,0,7600
142340100200000,SE 210,RESIDENTIAL,54300,0,54300,472500,0,526800
142340100300000,SE 210,RESIDENTIAL,1300,0,1300,0,0,1300
142340100400000,SE 210,RESIDENTIAL,1000,0,1000,0,0,1000
142340100500000,SE 210,RESIDENTIAL,39600,0,39600,133600,0,173200
142340100600000,SE 210,RESIDENTIAL,27700,0,27700,162600,0,190300
142340100700000,SE 210,RESIDENTIAL,28400,0,28400,118700,0,147100
142340100800000,SE 210,RESIDENTIAL,35100,0,35100,163400,0,198500
142340100900000,SE 210,RESIDENTIAL,35400,0,35400,121600,0,157000
142340101000000,SE 210,RESIDENTIAL,38400,0,38400,223000,0,261400
142340101100000,SE 210,RESIDENTIAL,29000,0,29000,188400,0,217400
142340101200000,SE 210,RESIDENTIAL,26800,0,26800,139600,0,166400
142340101300000,SE 210,RESIDENTIAL,24300,0,24300,120200,0,144500
142340101400000,SE 224,RESIDENTIAL,31300,0,31300,138900,0,170200
142340101500000,SE 210,RESIDENTIAL,42000,0,42000,140400,0,182400
142340101600000,SE 210,RESIDENTIAL,28600,0,28600,130000,0,158600
142340101700000,SE 210,RESIDENTIAL,31000,0,31000,0,0,31000
142340101800000,SE 210,RESIDENTIAL,34000,0,34000,127600,0,161600
142340101900000,SE 210,RESIDENTIAL,28400,0,28400,114600,0,143000
142340102000000,SE 210,RESIDENTIAL,30400,0,30400,167100,0,197500
142340102100000,SE 210,RESIDENTIAL,31400,0,31400,127700,0,159100
142340102200000,SE 210,RESIDENTIAL,29400,0,29400,115300,0,144700
142340102300000,SE 210,RESIDENTIAL,29000,0,29000,159400,0,188400
142340102400000,SE 210,RESIDENTIAL,25400,0,25400,123800,0,149200
142340200100000,SE 224,RESIDENTIAL,29500,0,29500,117800,0,147300
142340200200000,SE 224,RESIDENTIAL,29500,0,29500,98500,0,128000
142340200300000,SE 224,RESIDENTIAL,34000,0,34000,98800,0,132800
142340200400000,SE 224,RESIDENTIAL,35400,0,35400,116400,0,151800
142340200500000,SE 224,RESIDENTIAL,22600,0,22600,104300,0,126900
142340200600000,SE 224,RESIDENTIAL,22600,0,22600,93900,0,116500
142340200700000,SE 224,RESIDENTIAL,23200,0,23200,95400,0,118600
142340200800000,SE 224,RESIDENTIAL,25300,0,25300,134300,0,159600
142340200900000,SE 224,RESIDENTIAL,25700,0,25700,92100,0,117800
142340300100000,SE 224,RESIDENTIAL,28500,0,28500,121200,0,149700
142340300200000,SE 224,RESIDENTIAL,38700,0,38700,100700,0,139400
142340300300000,SE 224,RESIDENTIAL,24800,0,24800,117000,0,141800
142340300400000,SE 224,RESIDENTIAL,26300,0,26300,110900,0,137200
142340300500000,SE 224,RESIDENTIAL,26300,0,26300,117600,0,143900
142340400100000,SE 210,RESIDENTIAL,28500,0,28500,159200,0,187700
142340400200000,SE 210,RESIDENTIAL,31500,0,31500,183700,0,215200
142340400300000,SE 210,RESIDENTIAL,29900,0,29900,140000,0,169900
142340400400000,SE 210,RESIDENTIAL,22900,0,22900,111300,0,134200
142340400500000,SE 210,RESIDENTIAL,21200,0,21200,102500,0,123700
142340400600000,SE 210,RESIDENTIAL,21800,0,21800,143900,0,165700
142340400700000,SE 210,RESIDENTIAL,21300,0,21300,119100,0,140400
142340400800000,SE 210,RESIDENTIAL,21200,0,21200,117600,0,138800
142340400900000,SE 210,RESIDENTIAL,19000,0,19000,104100,0,123100
142340401000000,SE 210,RESIDENTIAL,26900,0,26900,114200,0,141100
142340401100000,SE 224,RESIDENTIAL,21200,0,21200,107400,0,128600
142340401200000,SE 224,RESIDENTIAL,24500,0,24500,85400,0,109900
142340401300000,SE 224,RESIDENTIAL,24900,0,24900,106400,0,131300
142340401400000,SE 224,RESIDENTIAL,23800,0,23800,99500,0,123300
142340401500000,SE 224,RESIDENTIAL,30600,0,30600,97700,0,128300
142340401600000,SE 224,RESIDENTIAL,27000,0,27000,134900,0,161900
142340401700000,SE 224,RESIDENTIAL,25200,0,25200,93500,0,118700
142340401800000,SE 224,RESIDENTIAL,25200,0,25200,87300,0,112500
142340401900000,SE 224,RESIDENTIAL,31200,0,31200,125600,0,156800
142340402000000,SE 224,RESIDENTIAL,30100,0,30100,102300,0,132400
142340402100000,SE 224,RESIDENTIAL,34000,0,34000,107400,0,141400
142340402200000,SE 224,RESIDENTIAL,34000,0,34000,109600,0,143600
142340402300000,SE 224,RESIDENTIAL,31500,0,31500,103500,0,135000
142340500100000,SE 224,RESIDENTIAL,23800,0,23800,103300,0,127100
142340500200000,SE 224,RESIDENTIAL,23600,0,23600,81800,0,105400
142340500300000,SE 224,RESIDENTIAL,23600,0,23600,70700,0,94300
142340500400000,SE 224,RESIDENTIAL,23600,0,23600,91400,0,115000
142340500500000,SE 224,RESIDENTIAL,23600,0,23600,100100,0,123700
142340500600000,SE 224,RESIDENTIAL,23600,0,23600,78600,0,102200
142340500700000,SE 224,RESIDENTIAL,23800,0,23800,81300,0,105100
142340500800000,SE 224,RESIDENTIAL,23800,0,23800,87200,0,111000
142340500900000,SE 224,RESIDENTIAL,23800,0,23800,87300,0,111100
142340501000000,SE 224,RESIDENTIAL,23800,0,23800,103700,0,127500
142340600100000,SE 224,RESIDENTIAL,25800,0,25800,103100,0,128900
142340600200000,SE 224,RESIDENTIAL,25800,0,25800,74200,0,100000
142340600300000,SE 224,RESIDENTIAL,25800,0,25800,92100,0,117900
142340600400000,SE 224,RESIDENTIAL,25800,0,25800,115500,0,141300
142340600500000,SE 224,RESIDENTIAL,25800,0,25800,88500,0,114300
142340700100000,SE 224,RESIDENTIAL,26800,0,26800,115500,0,142300
142340700200000,SE 224,RESIDENTIAL,23900,0,23900,84500,0,108400
142340700300000,SE 224,RESIDENTIAL,24200,0,24200,80500,0,104700
142340700400000,SE 224,RESIDENTIAL,25700,0,25700,81900,0,107600
142340700500000,SE 224,RESIDENTIAL,23300,0,23300,101200,0,124500
142340700600000,SE 224,RESIDENTIAL,23500,0,23500,84400,0,107900
142340800100000,SE 224,RESIDENTIAL,30000,0,30000,138600,0,168600
142340800200000,SE 224,RESIDENTIAL,25200,0,25200,85300,0,110500
142340800300000,SE 224,RESIDENTIAL,24600,0,24600,98100,0,122700
142340800400000,SE 224,RESIDENTIAL,30000,0,30000,115800,0,145800
142340800500000,SE 224,RESIDENTIAL,22900,0,22900,83700,0,106600
142340800600000,SE 224,RESIDENTIAL,23500,0,23500,80800,0,104300
142340800700000,SE 224,RESIDENTIAL,23500,0,23500,86200,0,109700
142340800800000,SE 224,RESIDENTIAL,23500,0,23500,82600,0,106100
142340800900000,SE 224,RESIDENTIAL,22300,0,22300,80200,0,102500
142340801000000,SE 224,RESIDENTIAL,24600,0,24600,86500,0,111100
142340801100000,SE 224,RESIDENTIAL,22700,0,22700,85700,0,108400
142340900100000,SE 224,RESIDENTIAL,22800,0,22800,113900,0,136700
142340900200000,SE 224,RESIDENTIAL,23500,0,23500,117400,0,140900
142340900300000,SE 224,RESIDENTIAL,24600,0,24600,113600,0,138200
142340900400000,SE 224,RESIDENTIAL,24800,0,24800,106000,0,130800
142340900500000,SE 224,RESIDENTIAL,24000,0,24000,121200,0,145200
142340900600000,SE 224,RESIDENTIAL,24000,0,24000,107600,0,131600
142340900700000,SE 224,RESIDENTIAL,23800,0,23800,74900,0,98700
142340900800000,SE 224,RESIDENTIAL,24700,0,24700,103100,0,127800
142340900900000,SE 224,RESIDENTIAL,23900,0,23900,82000,0,105900
142340901000000,SE 224,RESIDENTIAL,24700,0,24700,97800,0,122500
142340901100000,SE 224,RESIDENTIAL,23900,0,23900,84800,0,108700
142340901200000,SE 224,RESIDENTIAL,24300,0,24300,89600,0,113900
142340901300000,SE 224,RESIDENTIAL,22800,0,22800,97000,0,119800
142340901400000,SE 224,RESIDENTIAL,22800,0,22800,76600,0,99400
142341000100000,SE 224,RESIDENTIAL,23700,0,23700,105600,0,129300
142341000200000,SE 224,RESIDENTIAL,24500,0,24500,89400,0,113900
142341000300000,SE 224,RESIDENTIAL,26400,0,26400,97500,0,123900
142341000400000,SE 224,RESIDENTIAL,25900,0,25900,76100,0,102000
142341000500000,SE 224,RESIDENTIAL,25200,0,25200,112700,0,137900
142341000600000,SE 224,RESIDENTIAL,25200,0,25200,132000,0,157200
142341000700000,SE 224,RESIDENTIAL,24700,0,24700,99200,0,123900
142341100100000,SE 224,RESIDENTIAL,23300,0,23300,68700,0,92000
142341100200000,SE 224,RESIDENTIAL,23000,0,23000,82400,0,105400
142341100300000,SE 224,RESIDENTIAL,23000,0,23000,71500,0,94500
142341100400000,SE 224,RESIDENTIAL,23600,0,23600,71500,0,95100
142341100500000,SE 224,RESIDENTIAL,23600,0,23600,74800,0,98400
142341100600000,SE 224,RESIDENTIAL,24000,0,24000,82400,0,106400
142341100700000,SE 224,RESIDENTIAL,22800,0,22800,116100,0,138900
142342600100000,SE 224,RESIDENTIAL,28400,0,28400,75500,0,103900
142342600200000,SE 224,RESIDENTIAL,15900,0,15900,48200,0,64100
142342600300000,SE 224,RESIDENTIAL,14100,0,14100,36000,0,50100
142342600400000,SE 224,RESIDENTIAL,16000,0,16000,56400,0,72400
142342600500000,SE 224,RESIDENTIAL,16000,0,16000,34200,0,50200
142342600600000,SE 224,RESIDENTIAL,16000,0,16000,28800,0,44800
142342601000000,SE 224,RESIDENTIAL,13200,0,13200,64700,0,77900
142342601100000,SE 224,EXEMPT,0,20500,20500,0,75800,96300
142342700100000,SE 224,RESIDENTIAL,33400,0,33400,92100,0,125500
142342700200000,SE 224,RESIDENTIAL,31700,0,31700,91300,0,123000
142342700300000,SE 224,RESIDENTIAL,26900,0,26900,85800,0,112700
142342700400000,SE 224,RESIDENTIAL,38000,0,38000,96900,0,134900
142342700500000,SE 224,RESIDENTIAL,33700,0,33700,66400,0,100100
142342700600000,SE 224,RESIDENTIAL,30000,0,30000,66400,0,96400
142342700700000,SE 224,RESIDENTIAL,30000,0,30000,88800,0,118800
142342700800000,SE 224,RESIDENTIAL,43700,0,43700,101500,0,145200
142342700900000,SE 224,RESIDENTIAL,31200,0,31200,53600,0,84800
142342701000000,SE 224,RESIDENTIAL,30600,0,30600,97200,0,127800
142342701100000,SE 224,RESIDENTIAL,30600,0,30600,67200,0,97800
142342701200000,SE 224,RESIDENTIAL,30600,0,30600,84000,0,114600
142342701300000,SE 224,RESIDENTIAL,36000,0,36000,82400,0,118400
142342701400000,SE 224,RESIDENTIAL,30000,0,30000,90688,0,120688
142342701500000,SE 224,RESIDENTIAL,30000,0,30000,74000,0,104000
142342701600000,SE 224,RESIDENTIAL,36000,0,36000,63100,0,99100
142342701700000,SE 224,RESIDENTIAL,36000,0,36000,71800,0,107800
142342702100000,SE 224,RESIDENTIAL,17800,0,17800,0,0,17800
142342702200000,SE 224,RESIDENTIAL,19800,0,19800,80800,0,100600
142342702300000,SE 224,RESIDENTIAL,17800,0,17800,100200,0,118000
142342702400000,SE 224,RESIDENTIAL,18400,0,18400,73500,0,91900
142342702500000,SE 224,RESIDENTIAL,24000,0,24000,68500,0,92500
142342702600000,SE 224,RESIDENTIAL,20000,0,20000,73500,0,93500
142342702700000,SE 224,RESIDENTIAL,20000,0,20000,86700,0,106700
142342702800000,SE 224,RESIDENTIAL,24000,0,24000,85600,0,109600
142342702900000,SE 224,RESIDENTIAL,20400,0,20400,92200,0,112600
142342703000000,SE 224,RESIDENTIAL,20400,0,20400,67900,0,88300
142342703100000,SE 224,RESIDENTIAL,20400,0,20400,94600,0,115000
142342703300000,SE 224,RESIDENTIAL,28000,0,28000,90700,0,118700
142342703400000,SE 224,RESIDENTIAL,20800,0,20800,48100,0,68900
142342703500000,SE 224,RESIDENTIAL,20800,0,20800,70500,0,91300
142342703600000,SE 224,RESIDENTIAL,22400,0,22400,59800,0,82200
142342703700000,SE 224,RESIDENTIAL,23900,0,23900,101900,0,125800
142342703800000,SE 224,RESIDENTIAL,23900,0,23900,53700,0,77600
142342703900000,SE 224,RESIDENTIAL,17100,0,17100,69200,0,86300
142342704000000,SE 224,RESIDENTIAL,16000,0,16000,103600,0,119600
142342704100000,SE 224,RESIDENTIAL,25600,0,25600,79200,0,104800
142342704200000,SE 224,RESIDENTIAL,16000,0,16000,53200,0,69200
142342704300000,BRANCH BANK/CU,COMMERCIAL,0,51000,51000,0,343400,394400
142342704400000,SE 224,RESIDENTIAL,20000,0,20000,105000,0,125000
142342800100000,SE 224,RESIDENTIAL,26800,0,26800,46300,0,73100
142342800200000,SE 224,RESIDENTIAL,25600,0,25600,125000,0,150600
142342800300000,SE 224,RESIDENTIAL,16000,0,16000,39100,0,55100
142342800400000,SE 224,RESIDENTIAL,16000,0,16000,67400,0,83400
142342800500000,SE 224,RESIDENTIAL,16000,0,16000,41600,0,57600
142342800600000,SE 224,RESIDENTIAL,18500,0,18500,71100,0,89600
142342900100000,SE 224,RESIDENTIAL,16900,0,16900,82500,0,99400
142342900200000,SE 224,RESIDENTIAL,27300,0,27300,69000,0,96300
142342900300000,SE 224,RESIDENTIAL,22600,0,22600,73300,0,95900
142342900400000,SE 224,RESIDENTIAL,24900,0,24900,82300,0,107200
142342900500000,SE 224,RESIDENTIAL,22400,0,22400,55100,0,77500
142342900600000,SE 224,RESIDENTIAL,22400,0,22400,85000,0,107400
142342900700000,SE 224,RESIDENTIAL,32500,0,32500,133400,0,165900
142342900900000,SE 224,RESIDENTIAL,23200,0,23200,76700,0,99900
142342901000000,SE 224,RESIDENTIAL,23200,0,23200,107900,0,131100
142342901100000,SE 224,RESIDENTIAL,23200,0,23200,70600,0,93800
142342901200000,SE 224,RESIDENTIAL,27100,0,27100,62100,0,89200
142342901300000,SE 224,RESIDENTIAL,20000,0,20000,94100,0,114100
142342901400000,SE 224,RESIDENTIAL,20000,0,20000,94300,0,114300
142342901500000,SE 224,RESIDENTIAL,24000,0,24000,81000,0,105000
142342901600000,SE 224,RESIDENTIAL,24000,0,24000,66600,0,90600
142342901700000,SE 224,RESIDENTIAL,19000,0,19000,105800,0,124800
142342901800000,SE 224,RESIDENTIAL,17100,0,17100,134200,0,151300
142342901900000,SE 224,RESIDENTIAL,17100,0,17100,84000,0,101100
142342902000000,SE 224,RESIDENTIAL,29700,0,29700,103300,0,133000
142342902100000,SE 224,RESIDENTIAL,27000,0,27000,122400,0,149400
142342902200000,SE 224,RESIDENTIAL,27400,0,27400,127100,0,154500
142342902300000,SE 224,RESIDENTIAL,22200,0,22200,106900,0,129100
142342902400000,SE 224,RESIDENTIAL,24200,0,24200,137800,0,162000
142342902500000,SE 224,RESIDENTIAL,32400,0,32400,74800,0,107200
142342902600000,SE 224,RESIDENTIAL,24700,0,24700,119100,0,143800
142342902700000,SE 224,RESIDENTIAL,24700,0,24700,137700,0,162400
142342902800000,SE 224,RESIDENTIAL,24700,0,24700,127600,0,152300
142342902900000,SE 224,RESIDENTIAL,24700,0,24700,118600,0,143300
142342903000000,SE 224,RESIDENTIAL,23100,0,23100,145200,0,168300
142342903100000,SE 224,RESIDENTIAL,27300,0,27300,147100,0,174400
142342903200000,SE 224,RESIDENTIAL,29700,0,29700,142200,0,171900
142342903300000,SE 224,RESIDENTIAL,32400,0,32400,142500,0,174900
142342903400000,SE 224,RESIDENTIAL,23800,0,23800,139700,0,163500
142342903500000,SE 224,RESIDENTIAL,21100,0,21100,104000,0,125100
142342903600000,SE 224,RESIDENTIAL,21100,0,21100,98000,0,119100
142342903700000,SE 224,RESIDENTIAL,22000,0,22000,117300,0,139300
142342903800000,SE 224,RESIDENTIAL,24700,0,24700,109700,0,134400
142342903900000,SE 224,RESIDENTIAL,24000,0,24000,122100,0,146100
142342904000000,SE 224,RESIDENTIAL,20400,0,20400,110400,0,130800
142342904100000,SE 224,RESIDENTIAL,21100,0,21100,119300,0,140400
142342904200000,SE 224,RESIDENTIAL,21100,0,21100,125100,0,146200
142342904300000,SE 224,RESIDENTIAL,21100,0,21100,102600,0,123700
142342904400000,SE 224,RESIDENTIAL,22500,0,22500,136000,0,158500
142342904500000,SE 224,RESIDENTIAL,27400,0,27400,123000,0,150400
142342904600000,SE 224,RESIDENTIAL,21400,0,21400,83900,0,105300
142342904700000,SE 224,RESIDENTIAL,20000,0,20000,85600,0,105600
142342904800000,SE 224,RESIDENTIAL,20400,0,20400,90600,0,111000
142342904900000,SE 223,RESIDENTIAL,19500,0,19500,87000,0,106500
142342905000000,SE 223,RESIDENTIAL,21100,0,21100,90400,0,111500
142342905100000,SE 223,RESIDENTIAL,21100,0,21100,97300,0,118400
142342905200000,SE 223,RESIDENTIAL,21100,0,21100,96700,0,117800
142342905300000,SE 223,RESIDENTIAL,21100,0,21100,77800,0,98900
142342905400000,SE 223,RESIDENTIAL,21100,0,21100,72200,0,93300
142342905500000,SE 223,RESIDENTIAL,20900,0,20900,74900,0,95800
142342905600000,SE 223,RESIDENTIAL,20900,0,20900,91700,0,112600
142342905700000,SE 223,RESIDENTIAL,21500,0,21500,65400,0,86900
142342905800000,SE 223,RESIDENTIAL,21900,0,21900,60200,0,82100
142342905900000,SE 223,RESIDENTIAL,21900,0,21900,82000,0,103900
142342906000000,SE 223,RESIDENTIAL,18200,0,18200,92600,0,110800
142342906100000,SE 223,RESIDENTIAL,21900,0,21900,66100,0,88000
142342906200000,SE 223,RESIDENTIAL,19900,0,19900,86400,0,106300
142342906300000,SE 223,RESIDENTIAL,19900,0,19900,84000,0,103900
142342906400000,SE 223,RESIDENTIAL,19000,0,19000,23100,0,42100
142342906500000,SE 223,RESIDENTIAL,17300,0,17300,94500,0,111800
142342906600000,SE 224,RESIDENTIAL,18600,0,18600,98400,0,117000
142342906700000,SE 224,RESIDENTIAL,28800,0,28800,85900,0,114700
142342906800000,SE 224,RESIDENTIAL,16000,0,16000,63800,0,79800
142342906900000,SE 224,RESIDENTIAL,26500,0,26500,114300,0,140800
142342907000000,SE 224,RESIDENTIAL,16800,0,16800,86200,0,103000
142342907100000,SE 224,RESIDENTIAL,16000,0,16000,71300,0,87300
142342907200000,SE 224,RESIDENTIAL,16000,0,16000,65400,0,81400
142342907300000,SE 224,RESIDENTIAL,16000,0,16000,78500,0,94500
142342907400000,SE 224,RESIDENTIAL,16900,0,16900,80400,0,97300
142342907500000,SE 224,RESIDENTIAL,28200,0,28200,110700,0,138900
142342907600000,SE 224,RESIDENTIAL,28200,0,28200,104500,0,132700
142342907700000,SE 224,RESIDENTIAL,19800,0,19800,96600,0,116400
142342907800000,SE 224,RESIDENTIAL,23000,0,23000,127300,0,150300
142342907900000,SE 224,RESIDENTIAL,24800,0,24800,102700,0,127500
142342908000000,SE 224,RESIDENTIAL,48800,0,48800,299800,0,348600
142342908100000,SE 224,RESIDENTIAL,21800,0,21800,60400,0,82200
142342908200000,SE 224,RESIDENTIAL,19200,0,19200,73200,0,92400
142342908300000,SE 224,RESIDENTIAL,19200,0,19200,73700,0,92900
142342908400000,SE 224,RESIDENTIAL,20900,0,20900,115200,0,136100
142342908500000,SE 224,RESIDENTIAL,20900,0,20900,110900,0,131800
142342908600000,SE 224,RESIDENTIAL,20900,0,20900,111400,0,132300
142342908700000,SE 224,RESIDENTIAL,19100,0,19100,65800,0,84900
142342908800000,SE 224,RESIDENTIAL,20000,0,20000,61400,0,81400
142342908900000,SE 224,RESIDENTIAL,24000,0,24000,94600,0,118600
142342909000000,SE 224,RESIDENTIAL,20000,0,20000,95800,0,115800
142342909100000,SE 224,RESIDENTIAL,25600,0,25600,83100,0,108700
142342909200000,SE 224,RESIDENTIAL,23200,0,23200,89700,0,112900
142343000100000,SE 224,RESIDENTIAL,17500,0,17500,67300,0,84800
142343000200000,SE 224,RESIDENTIAL,25600,0,25600,83200,0,108800
142343000300000,SE 224,RESIDENTIAL,16000,0,16000,64800,0,80800
142343000400000,SE 224,RESIDENTIAL,16000,0,16000,67000,0,83000
142343000500000,SE 224,RESIDENTIAL,16000,0,16000,77800,0,93800
142343000600000,SE 224,RESIDENTIAL,16000,0,16000,70900,0,86900
142343000700000,SE 224,RESIDENTIAL,16000,0,16000,79700,0,95700
142343000800000,SE 224,RESIDENTIAL,16000,0,16000,74200,0,90200
142343000900000,SE 224,RESIDENTIAL,25600,0,25600,84900,0,110500
142343001000000,SE 224,RESIDENTIAL,17900,0,17900,95100,0,113000
142345100100000,SE 223,RESIDENTIAL,17500,0,17500,0,0,17500
142345100200000,SE 223,RESIDENTIAL,26000,0,26000,119100,0,145100
142345100300000,SE 223,RESIDENTIAL,18100,0,18100,84500,0,102600
142345100400000,SE 223,RESIDENTIAL,18600,0,18600,84600,0,103200
142345100500000,SE 223,RESIDENTIAL,18900,0,18900,103400,0,122300
142345100600000,SE 223,RESIDENTIAL,19800,0,19800,89000,0,108800
142345100700000,SE 223,RESIDENTIAL,19000,0,19000,105600,0,124600
142345100800000,SE 223,RESIDENTIAL,17800,0,17800,82200,0,100000
142345100900000,SE 223,RESIDENTIAL,22700,0,22700,92300,0,115000
142345101000000,SE 223,RESIDENTIAL,22700,0,22700,80200,0,102900
142345101100000,SE 223,RESIDENTIAL,23100,0,23100,94900,0,118000
142345200100000,SE 223,RESIDENTIAL,17100,0,17100,121700,0,138800
142345200200000,SE 223,RESIDENTIAL,16600,0,16600,88000,0,104600
142345200300000,SE 223,RESIDENTIAL,17300,0,17300,65500,0,82800
142345200400000,SE 223,RESIDENTIAL,17500,0,17500,84300,0,101800
142345200500000,SE 223,RESIDENTIAL,16600,0,16600,86200,0,102800
142345200600000,SE 223,RESIDENTIAL,17000,0,17000,87200,0,104200
142345200700000,SE 223,RESIDENTIAL,16600,0,16600,57800,0,74400
142345200800000,SE 223,RESIDENTIAL,17000,0,17000,84200,0,101200
142345200900000,SE 223,RESIDENTIAL,21500,0,21500,96200,0,117700
142345201000000,SE 223,RESIDENTIAL,17500,0,17500,75300,0,92800
142345201100000,SE 223,RESIDENTIAL,16600,0,16600,87700,0,104300
142345201200000,SE 223,RESIDENTIAL,17000,0,17000,44700,0,61700
142345201300000,SE 223,RESIDENTIAL,21800,0,21800,87200,0,109000
142345201400000,SE 223,RESIDENTIAL,16600,0,16600,67200,0,83800
142345201500000,SE 223,RESIDENTIAL,16500,0,16500,33000,0,49500
142345201600000,SE 223,RESIDENTIAL,17800,0,17800,96700,0,114500
142345201700000,SE 223,RESIDENTIAL,23000,0,23000,106000,0,129000
142345300100000,SE 223,RESIDENTIAL,19900,0,19900,103200,0,123100
142345300200000,SE 223,RESIDENTIAL,23300,0,23300,90600,0,113900
142345300300000,SE 223,RESIDENTIAL,26700,0,26700,86400,0,113100
142345300400000,SE 223,RESIDENTIAL,18800,0,18800,90800,0,109600
142345300500000,SE 223,RESIDENTIAL,18600,0,18600,82600,0,101200
142345300600000,SE 223,RESIDENTIAL,18200,0,18200,87100,0,105300
142345300700000,SE 223,RESIDENTIAL,18200,0,18200,89900,0,108100
142345300800000,SE 223,RESIDENTIAL,18600,0,18600,69200,0,87800
142345300900000,SE 223,RESIDENTIAL,18200,0,18200,127800,0,146000
142345301000000,SE 223,RESIDENTIAL,18200,0,18200,94800,0,113000
142345301100000,SE 223,RESIDENTIAL,18200,0,18200,92200,0,110400
142345301200000,SE 223,RESIDENTIAL,18200,0,18200,82200,0,100400
142345301300000,SE 223,RESIDENTIAL,18800,0,18800,95400,0,114200
142345301400000,SE 223,RESIDENTIAL,18700,0,18700,110200,0,128900
142345301500000,SE 223,RESIDENTIAL,19600,0,19600,66500,0,86100
142345301600000,SE 223,RESIDENTIAL,19300,0,19300,90800,0,110100
142345301700000,SE 223,RESIDENTIAL,20500,0,20500,109100,0,129600
142345301800000,SE 223,RESIDENTIAL,20500,0,20500,83300,0,103800
142345301900000,SE 223,RESIDENTIAL,19700,0,19700,100200,0,119900
142345302000000,SE 223,RESIDENTIAL,19700,0,19700,96700,0,116400
142345302100000,SE 223,RESIDENTIAL,18900,0,18900,102900,0,121800
142345302200000,SE 223,RESIDENTIAL,19700,0,19700,85000,0,104700
142345302300000,SE 223,RESIDENTIAL,24800,0,24800,137400,0,162200
142345302400000,SE 223,RESIDENTIAL,21600,0,21600,135500,0,157100
142345302500000,SE 224,RESIDENTIAL,32700,0,32700,137000,0,169700
142345302600000,SE 224,RESIDENTIAL,28200,0,28200,73100,0,101300
142345302700000,SE 224,RESIDENTIAL,26500,0,26500,128700,0,155200
142345302800000,SE 224,RESIDENTIAL,29400,0,29400,85800,0,115200
142345302900000,SE 224,RESIDENTIAL,25300,0,25300,87100,0,112400
142345303000000,SE 224,RESIDENTIAL,24500,0,24500,75900,0,100400
142345303100000,SE 224,RESIDENTIAL,24500,0,24500,91300,0,115800
142345303200000,SE 224,RESIDENTIAL,25000,0,25000,87400,0,112400
142345303300000,SE 224,RESIDENTIAL,23700,0,23700,59000,0,82700
142345303400000,SE 224,RESIDENTIAL,23200,0,23200,57500,0,80700
142345303500000,SE 223,RESIDENTIAL,19100,0,19100,87200,0,106300
142345303600000,SE 223,RESIDENTIAL,19100,0,19100,87200,0,106300
142345303700000,SE 223,RESIDENTIAL,19100,0,19100,64500,0,83600
142345303800000,SE 223,RESIDENTIAL,19100,0,19100,96100,0,115200
142345303900000,SE 223,RESIDENTIAL,19100,0,19100,67400,0,86500
142345304000000,SE 223,RESIDENTIAL,19100,0,19100,96400,0,115500
142345304100000,SE 223,RESIDENTIAL,19000,0,19000,76600,0,95600
142345304200000,SE 223,RESIDENTIAL,19100,0,19100,68300,0,87400
142345304300000,SE 223,RESIDENTIAL,19100,0,19100,72000,0,91100
142345304400000,SE 223,RESIDENTIAL,19100,0,19100,100700,0,119800
142345304500000,SE 223,RESIDENTIAL,23500,0,23500,100300,0,123800
142345304600000,SE 223,RESIDENTIAL,15300,0,15300,71800,0,87100
142345304700000,SE 223,RESIDENTIAL,15300,0,15300,97900,0,113200
142345304800000,SE 223,RESIDENTIAL,23000,0,23000,98700,0,121700
142345304900000,SE 223,RESIDENTIAL,23000,0,23000,44800,0,67800
142345305000000,SE 223,RESIDENTIAL,15300,0,15300,85100,0,100400
142345305100000,SE 223,RESIDENTIAL,23000,0,23000,76400,0,99400
142345305200000,SE 223,RESIDENTIAL,24100,0,24100,89600,0,113700
142345305300000,SE 223,RESIDENTIAL,19100,0,19100,64600,0,83700
142345400100000,SE 223,RESIDENTIAL,18700,0,18700,42900,0,61600
142345400200000,SE 223,RESIDENTIAL,17500,0,17500,96500,0,114000
142345400300000,SE 223,RESIDENTIAL,16600,0,16600,81900,0,98500
142345400400000,SE 223,RESIDENTIAL,17000,0,17000,63200,0,80200
142345400500000,SE 223,RESIDENTIAL,16600,0,16600,83800,0,100400
142345400600000,SE 223,RESIDENTIAL,17000,0,17000,60800,0,77800
142345400700000,SE 223,RESIDENTIAL,16600,0,16600,64300,0,80900
142345400800000,SE 223,RESIDENTIAL,16500,0,16500,90900,0,107400
142345400900000,SE 223,RESIDENTIAL,17500,0,17500,88400,0,105900
142345401000000,SE 223,RESIDENTIAL,16600,0,16600,78200,0,94800
142345401100000,SE 223,RESIDENTIAL,17900,0,17900,85000,0,102900
142345401200000,SE 223,RESIDENTIAL,17900,0,17900,97300,0,115200
142345401300000,SE 223,RESIDENTIAL,17900,0,17900,90500,0,108400
142345401400000,SE 223,RESIDENTIAL,16400,0,16400,70600,0,87000
142345401500000,SE 223,RESIDENTIAL,17800,0,17800,71600,0,89400
142345401600000,SE 223,RESIDENTIAL,17000,0,17000,81500,0,98500
142345401700000,SE 223,RESIDENTIAL,17000,0,17000,70800,0,87800
142345401800000,SE 223,RESIDENTIAL,17000,0,17000,82500,0,99500
142345401900000,SE 223,RESIDENTIAL,17000,0,17000,65800,0,82800
142345500100000,SE 223,RESIDENTIAL,20300,0,20300,62700,0,83000
142345500200000,SE 223,RESIDENTIAL,21200,0,21200,98200,0,119400
142345500300000,SE 223,RESIDENTIAL,18600,0,18600,60600,0,79200
142345500400000,SE 223,RESIDENTIAL,18600,0,18600,70600,0,89200
142345500500000,SE 223,RESIDENTIAL,18600,0,18600,58600,0,77200
142345500600000,SE 223,RESIDENTIAL,18600,0,18600,101000,0,119600
142345500700000,SE 223,RESIDENTIAL,18600,0,18600,72100,0,90700
142345500800000,SE 223,RESIDENTIAL,18600,0,18600,73700,0,92300
142345500900000,SE 223,RESIDENTIAL,18600,0,18600,76400,0,95000
142345501000000,SE 223,RESIDENTIAL,18600,0,18600,78000,0,96600
142345501100000,OFFICE,COMMERCIAL,0,45400,45400,0,70200,115600
142345501200000,RESTAURANT,COMMERCIAL,0,37900,37900,0,58100,96000
142345600100000,SE 223,RESIDENTIAL,22000,0,22000,137900,0,159900
142345600200000,SE 223,RESIDENTIAL,20100,0,20100,76800,0,96900
142345600600000,SE 223,EXEMPT,0,25500,25500,0,0,25500
142345600700000,SE 223,RESIDENTIAL,19100,0,19100,87600,0,106700
142345600800000,SE 223,RESIDENTIAL,20300,0,20300,100900,0,121200
142345600900000,SE 223,RESIDENTIAL,18000,0,18000,76600,0,94600
142345601000000,SE 223,RESIDENTIAL,20300,0,20300,73400,0,93700
142345601100000,SE 224,RESIDENTIAL,23600,0,23600,68700,0,92300
142345601200000,SE 224,RESIDENTIAL,22100,0,22100,106400,0,128500
142345601300000,SE 224,RESIDENTIAL,24000,0,24000,22000,0,46000
142345601400000,SE 224,RESIDENTIAL,24000,0,24000,0,0,24000
142345601700000,SMALL RETAIL,COMMERCIAL,0,184000,184000,0,377600,561600
142345601800000,VACANT LAND,EXEMPT,0,13400,13400,0,0,13400
142345601900000,VACANT LAND,EXEMPT,0,14700,14700,0,0,14700
142345602000000,SMALL RETAIL,COMMERCIAL,0,54200,54200,0,25300,79500
142345602002000,ANTENNAS/TOWERS(BLL),COMMERCIAL,0,0,0,0,110800,110800
142345602100000,SMALL RETAIL,COMMERCIAL,0,113500,113500,0,171100,284600
142345602300000,SE 223,RESIDENTIAL,18600,0,18600,64400,0,83000
142345602400000,SE 223,RESIDENTIAL,18600,0,18600,98500,0,117100
142345602500000,SE 223,RESIDENTIAL,18600,0,18600,58800,0,77400
142345602600000,SE 223,RESIDENTIAL,18600,0,18600,87100,0,105700
142345602700000,SE 223,RESIDENTIAL,18600,0,18600,69800,0,88400
142345602800000,SE 223,RESIDENTIAL,18600,0,18600,61600,0,80200
142345602900000,SE 223,RESIDENTIAL,18600,0,18600,63000,0,81600
142345603000000,VACANT LAND,COMMERCIAL,0,63100,63100,0,0,63100
142345603100000,CHURCH,EXEMPT,0,766300,766300,0,6169200,6935500
142347600100000,SE 225,RESIDENTIAL,22800,0,22800,71400,0,94200
142347600200000,SE 225,RESIDENTIAL,21000,0,21000,68300,0,89300
142347600300000,SE 225,RESIDENTIAL,15900,0,15900,63900,0,79800
142347600400000,SE 225,RESIDENTIAL,23600,0,23600,82600,0,106200
142347700100000,SE 225,RESIDENTIAL,17200,0,17200,83700,0,100900
142347700200000,SE 225,RESIDENTIAL,17800,0,17800,59400,0,77200
142347700300000,SE 225,RESIDENTIAL,17500,0,17500,92200,0,109700
142347700400000,SE 225,RESIDENTIAL,17500,0,17500,69400,0,86900
142347700500000,SE 225,RESIDENTIAL,17500,0,17500,76200,0,93700
142347700600000,SE 225,RESIDENTIAL,17500,0,17500,75400,0,92900
142347700700000,SE 225,RESIDENTIAL,17500,0,17500,65300,0,82800
142347700800000,SE 225,RESIDENTIAL,17500,0,17500,71300,0,88800
142347700900000,SE 225,RESIDENTIAL,17200,0,17200,78100,0,95300
142347800100000,SE 225,RESIDENTIAL,20700,0,20700,92600,0,113300
142347800300000,CHURCH,EXEMPT,0,154900,154900,0,1074700,1229600
142347800400000,SE 223,RESIDENTIAL,20500,0,20500,99200,0,119700
142347800500000,SE 223,RESIDENTIAL,20500,0,20500,90200,0,110700
142347800600000,SE 223,RESIDENTIAL,20500,0,20500,89900,0,110400
142347800700000,SE 223,RESIDENTIAL,20500,0,20500,101200,0,121700
142347800800000,SE 223,RESIDENTIAL,20500,0,20500,73900,0,94400
142347800900000,SE 223,RESIDENTIAL,23200,0,23200,92600,0,115800
142347801000000,SE 223,RESIDENTIAL,22400,0,22400,80100,0,102500
142347801100000,SE 225,RESIDENTIAL,21400,0,21400,89600,0,111000
142347801200000,SE 225,RESIDENTIAL,17500,0,17500,78200,0,95700
142347801300000,SE 225,RESIDENTIAL,17500,0,17500,80600,0,98100
142347801400000,SE 225,RESIDENTIAL,17500,0,17500,85700,0,103200
142347801500000,SE 225,RESIDENTIAL,17500,0,17500,74500,0,92000
142347801600000,SE 225,RESIDENTIAL,17500,0,17500,93800,0,111300
142347801700000,SE 225,RESIDENTIAL,17500,0,17500,66700,0,84200
142347801800000,SE 225,RESIDENTIAL,17500,0,17500,63900,0,81400
142347802000000,SE 225,EXEMPT,0,17500,17500,0,51700,69200
142347900100000,SE 223,RESIDENTIAL,23200,0,23200,110900,0,134100
142347900200000,SE 223,RESIDENTIAL,22100,0,22100,82400,0,104500
142347900300000,SE 223,RESIDENTIAL,25500,0,25500,103600,0,129100
142347900400000,SE 223,RESIDENTIAL,22700,0,22700,81100,0,103800
142347900500000,SE 223,RESIDENTIAL,22700,0,22700,71600,0,94300
142347900600000,SE 223,RESIDENTIAL,22700,0,22700,90200,0,112900
142347900700000,SE 223,RESIDENTIAL,22700,0,22700,110800,0,133500
142347900800000,SE 223,RESIDENTIAL,22700,0,22700,89200,0,111900
142347900900000,SE 223,RESIDENTIAL,22600,0,22600,66900,0,89500
142347901000000,SE 223,RESIDENTIAL,22400,0,22400,95000,0,117400
142348000100000,SE 223,RESIDENTIAL,20800,0,20800,68500,0,89300
142348000200000,SE 225,RESIDENTIAL,16100,0,16100,75000,0,91100
142348000300000,SE 225,RESIDENTIAL,16100,0,16100,36900,0,53000
142348000400000,SE 225,RESIDENTIAL,16100,0,16100,55400,0,71500
142348000500000,SE 225,RESIDENTIAL,16100,0,16100,64900,0,81000
142348000600000,SE 225,RESIDENTIAL,16100,0,16100,53100,0,69200
142348000700000,SE 225,RESIDENTIAL,16100,0,16100,73900,0,90000
142348000800000,SE 225,RESIDENTIAL,16100,0,16100,89200,0,105300
142348001000000,SE 225,RESIDENTIAL,28900,0,28900,91100,0,120000
142348001200000,SE 225,RESIDENTIAL,16100,0,16100,89200,0,105300
142348001300000,SE 225,RESIDENTIAL,16100,0,16100,70600,0,86700
142348001400000,SE 223,RESIDENTIAL,20800,0,20800,80500,0,101300
142348001500000,SE 223,RESIDENTIAL,20100,0,20100,57400,0,77500
142348001600000,SE 223,RESIDENTIAL,20800,0,20800,75500,0,96300
142348001700000,SE 223,RESIDENTIAL,20800,0,20800,83800,0,104600
142348001800000,SE 223,RESIDENTIAL,20100,0,20100,92700,0,112800
142348001900000,SE 223,RESIDENTIAL,20100,0,20100,48700,0,68800
142348002000000,SE 223,RESIDENTIAL,20100,0,20100,80400,0,100500
142348002100000,SE 223,RESIDENTIAL,20100,0,20100,82100,0,102200
142348100100000,SE 225,RESIDENTIAL,17500,0,17500,69900,0,87400
142348100200000,SE 225,RESIDENTIAL,17500,0,17500,30900,0,48400
142348100300000,SE 225,RESIDENTIAL,17500,0,17500,66200,0,83700
142348100400000,SE 225,RESIDENTIAL,17500,0,17500,78900,0,96400
142348100500000,SE 225,RESIDENTIAL,17500,0,17500,76800,0,94300
142348100600000,SE 225,RESIDENTIAL,17500,0,17500,78000,0,95500
142348100700000,SE 225,RESIDENTIAL,17500,0,17500,124500,0,142000
142348100800000,SE 225,RESIDENTIAL,17500,0,17500,74600,0,92100
142348100900000,SE 225,RESIDENTIAL,17500,0,17500,74500,0,92000
142348101000000,SE 225,RESIDENTIAL,17500,0,17500,110300,0,127800
142348101100000,SE 225,RESIDENTIAL,17500,0,17500,73700,0,91200
142348101200000,SE 225,RESIDENTIAL,17500,0,17500,63200,0,80700
142348101300000,SE 225,RESIDENTIAL,17500,0,17500,74500,0,92000
142348101400000,SE 225,RESIDENTIAL,17500,0,17500,67400,0,84900
142348101500000,SE 225,RESIDENTIAL,17500,0,17500,51900,0,69400
142348101600000,SE 225,RESIDENTIAL,17500,0,17500,57800,0,75300
142348101700000,SE 225,RESIDENTIAL,17500,0,17500,75000,0,92500
142348101800000,SE 225,RESIDENTIAL,17500,0,17500,89700,0,107200
142348200100000,SE 225,RESIDENTIAL,17500,0,17500,90500,0,108000
142348200200000,SE 225,RESIDENTIAL,17500,0,17500,91400,0,108900
142348200300000,SE 225,RESIDENTIAL,17500,0,17500,83900,0,101400
142348200400000,SE 225,RESIDENTIAL,17500,0,17500,82100,0,99600
142348200500000,SE 225,RESIDENTIAL,17500,0,17500,73200,0,90700
142348200600000,SE 225,RESIDENTIAL,17500,0,17500,54500,0,72000
142348200700000,SE 225,RESIDENTIAL,17500,0,17500,87400,0,104900
142348200800000,SE 225,RESIDENTIAL,17500,0,17500,47500,0,65000
142348200900000,SE 225,RESIDENTIAL,17500,0,17500,90400,0,107900
142348201000000,SE 225,RESIDENTIAL,17500,0,17500,95400,0,112900
142348201100000,SE 225,RESIDENTIAL,17500,0,17500,92700,0,110200
142348201200000,SE 225,RESIDENTIAL,24500,0,24500,84400,0,108900
142348201300000,SE 225,RESIDENTIAL,17500,0,17500,72900,0,90400
142348201400000,SE 225,RESIDENTIAL,17500,0,17500,50300,0,67800
142348201500000,SE 225,RESIDENTIAL,17500,0,17500,46700,0,64200
142348201600000,SE 225,RESIDENTIAL,24500,0,24500,140700,0,165200
142348300100000,SE 223,RESIDENTIAL,21700,0,21700,96900,0,118600
142348300200000,SE 225,RESIDENTIAL,16400,0,16400,76300,0,92700
142348300300000,SE 225,RESIDENTIAL,16400,0,16400,80700,0,97100
142348300400000,SE 225,RESIDENTIAL,16400,0,16400,87300,0,103700
142348300500000,SE 225,RESIDENTIAL,16400,0,16400,79600,0,96000
142348300600000,SE 225,RESIDENTIAL,16400,0,16400,86600,0,103000
142348300700000,SE 225,RESIDENTIAL,16400,0,16400,92700,0,109100
142348300800000,SE 225,RESIDENTIAL,16400,0,16400,57000,0,73400
142348300900000,SE 225,RESIDENTIAL,16400,0,16400,55200,0,71600
142348301000000,SE 225,RESIDENTIAL,16400,0,16400,56100,0,72500
142348301100000,CARWASH,COMMERCIAL,0,94200,94200,0,106000,200200
142348301200000,BRANCH BANK/CU,COMMERCIAL,0,351000,351000,0,795100,1146100
142348301500000,SE 223,RESIDENTIAL,21700,0,21700,92800,0,114500
142348400100000,SE 225,RESIDENTIAL,17500,0,17500,54800,0,72300
142348400400000,SE 225,RESIDENTIAL,17500,0,17500,78400,0,95900
142348400500000,SE 225,RESIDENTIAL,17500,0,17500,75200,0,92700
142348400600000,SE 225,RESIDENTIAL,17500,0,17500,103000,0,120500
142348400700000,SE 225,RESIDENTIAL,17500,0,17500,80100,0,97600
142348400800000,SE 225,RESIDENTIAL,17500,0,17500,81000,0,98500
142348400900000,SE 225,RESIDENTIAL,17500,0,17500,82400,0,99900
142348401000000,SE 225,RESIDENTIAL,17500,0,17500,87300,0,104800
142348401100000,SE 225,RESIDENTIAL,17500,0,17500,94100,0,111600
142348401200000,SE 225,RESIDENTIAL,17500,0,17500,79800,0,97300
142348401300000,SE 225,RESIDENTIAL,17500,0,17500,62700,0,80200
142348401400000,SE 225,RESIDENTIAL,17500,0,17500,58000,0,75500
142348401500000,SE 225,RESIDENTIAL,17500,0,17500,63100,0,80600
142348401600000,SE 225,RESIDENTIAL,17500,0,17500,108500,0,126000
142348401700000,SE 225,RESIDENTIAL,17500,0,17500,65600,0,83100
142348401800000,SE 225,RESIDENTIAL,17200,0,17200,51900,0,69100
142348402000000,SE 225,RESIDENTIAL,24500,0,24500,87500,0,112000
142348500100000,SE 225,RESIDENTIAL,23300,0,23300,82200,0,105500
142348500200000,SE 223,RESIDENTIAL,19700,0,19700,67500,0,87200
142348500300000,SE 223,RESIDENTIAL,20000,0,20000,65600,0,85600
142348500400000,SE 223,RESIDENTIAL,19500,0,19500,42400,0,61900
142348500500000,SE 223,RESIDENTIAL,19500,0,19500,43500,0,63000
142348500600000,SE 223,RESIDENTIAL,19500,0,19500,99300,0,118800
142348500700000,SE 223,RESIDENTIAL,19700,0,19700,46800,0,66500
142348500800000,SE 223,RESIDENTIAL,19100,0,19100,42400,0,61500
142348500900000,SE 223,RESIDENTIAL,19100,0,19100,64300,0,83400
142348501000000,LAUNDROMAT/CLEANERS,COMMERCIAL,0,58400,58400,0,112400,170800
142348501200000,SE 225,RESIDENTIAL,17500,0,17500,74300,0,91800
142348501300000,SE 225,RESIDENTIAL,17500,0,17500,86100,0,103600
142348501400000,SE 225,RESIDENTIAL,17500,0,17500,59200,0,76700
142348501500000,SE 225,RESIDENTIAL,17500,0,17500,51400,0,68900
142348501600000,SE 225,RESIDENTIAL,17500,0,17500,59700,0,77200
142348501700000,SE 225,RESIDENTIAL,17500,0,17500,67700,0,85200
142348501800000,SE 225,RESIDENTIAL,17500,0,17500,53400,0,70900
142348502000000,SMALL RETAIL,COMMERCIAL,29097,25803,54900,157675,139825,352400
142348502100000,FITNESS CENTER,COMMERCIAL,0,86200,86200,0,223300,309500
142348600100000,SE 223,RESIDENTIAL,21500,0,21500,115200,0,136700
142348600200000,SE 223,RESIDENTIAL,21300,0,21300,62300,0,83600
142348600300000,SE 223,RESIDENTIAL,19900,0,19900,93900,0,113800
142348600400000,SE 223,RESIDENTIAL,19600,0,19600,63900,0,83500
142348600500000,SE 223,RESIDENTIAL,23000,0,23000,65900,0,88900
142348600600000,SE 223,RESIDENTIAL,23000,0,23000,74900,0,97900
142348600700000,FAST FOOD,COMMERCIAL,0,223300,223300,0,731500,954800
142348700100000,SE 225,RESIDENTIAL,17500,0,17500,110200,0,127700
142348700200000,SE 225,RESIDENTIAL,17500,0,17500,84700,0,102200
142348700300000,SE 225,RESIDENTIAL,17500,0,17500,82600,0,100100
142348700400000,SE 225,RESIDENTIAL,17500,0,17500,66000,0,83500
142348700500000,SE 225,RESIDENTIAL,17500,0,17500,79400,0,96900
142348700600000,SE 225,RESIDENTIAL,17500,0,17500,65300,0,82800
142348700700000,SE 225,RESIDENTIAL,17500,0,17500,78600,0,96100
142348700800000,SE 225,RESIDENTIAL,21000,0,21000,73500,0,94500
142348700900000,SE 225,RESIDENTIAL,11800,0,11800,67500,0,79300
142348701000000,SE 225,RESIDENTIAL,10100,0,10100,4200,0,14300
142348701100000,SE 225,RESIDENTIAL,15900,0,15900,44400,0,60300
142348701200000,SE 225,RESIDENTIAL,15900,0,15900,34400,0,50300
142348701300000,SE 225,RESIDENTIAL,15900,0,15900,59100,0,75000
142348701400000,SE 225,RESIDENTIAL,15900,0,15900,63300,0,79200
142348701500000,FAST FOOD,COMMERCIAL,0,101700,101700,0,279600,381300
142410200100000,SE 209,RESIDENTIAL,53600,0,53600,152100,0,205700
142410200200000,SE 209,RESIDENTIAL,51300,0,51300,164300,0,215600
142410200300000,SE 209,RESIDENTIAL,52400,0,52400,202400,0,254800
142410300100000,SE 221,RESIDENTIAL,46900,0,46900,0,0,46900
142412600100000,CITY PROPERTY,EXEMPT,0,0,0,0,0,0
142412600200000,SE 210,RESIDENTIAL,319700,0,319700,1371400,0,1691100
142412600500000,SE 221,RESIDENTIAL,154400,0,154400,205600,0,360000
142412700100000,SE 245,RESIDENTIAL,91600,0,91600,325100,0,416700
142412700200000,SE 245,RESIDENTIAL,100000,0,100000,318300,0,418300
142412700300000,SE 245,RESIDENTIAL,93800,0,93800,252400,0,346200
142415100100000,CHURCH,EXEMPT,0,359200,359200,0,758200,1117400
142415100200000,SE 245,RESIDENTIAL,67300,0,67300,428000,0,495300
142415100300000,SE 245,RESIDENTIAL,64200,0,64200,337000,0,401200
142415100400000,SE 245,RESIDENTIAL,58800,0,58800,237900,0,296700
142415100500000,SE 245,RESIDENTIAL,61900,0,61900,325600,0,387500
142415100600000,SE 245,RESIDENTIAL,71700,0,71700,450300,0,522000
142415100700000,SE 245,RESIDENTIAL,81100,0,81100,435500,0,516600
142415100800000,SE 245,RESIDENTIAL,71200,0,71200,344800,0,416000
142415100900000,SE 245,RESIDENTIAL,75800,0,75800,350900,0,426700
142415101000000,SE 245,RESIDENTIAL,73800,0,73800,291000,0,364800
142415101100000,SE 245,RESIDENTIAL,77400,0,77400,323200,0,400600
142415101200000,SE 245,RESIDENTIAL,80900,0,80900,256800,0,337700
142415101300000,SE 245,RESIDENTIAL,74900,0,74900,336200,0,411100
142415101400000,SE 245,RESIDENTIAL,79900,0,79900,317400,0,397300
142415101500000,SE 245,RESIDENTIAL,83400,0,83400,278700,0,362100
142415101600000,SE 245,RESIDENTIAL,75500,0,75500,268000,0,343500
142415101700000,SE 245,RESIDENTIAL,73700,0,73700,265700,0,339400
142415101800000,SE 245,RESIDENTIAL,83900,0,83900,327600,0,411500
142415101900000,SE 245,RESIDENTIAL,87600,0,87600,351300,0,438900
142415200100000,SE 220,RESIDENTIAL,37400,0,37400,128400,0,165800
142415200200000,SE 220,RESIDENTIAL,38800,0,38800,136800,0,175600
142415200400000,SE 221,RESIDENTIAL,32000,0,32000,137000,0,169000
142415200500000,SE 221,RESIDENTIAL,31700,0,31700,125800,0,157500
142415200600000,SE 221,RESIDENTIAL,31700,0,31700,131600,0,163300
142415200700000,SE 221,RESIDENTIAL,32200,0,32200,139100,0,171300
142415300100000,SE 221,RESIDENTIAL,32000,0,32000,141300,0,173300
142415300200000,SE 221,RESIDENTIAL,32000,0,32000,140400,0,172400
142415300300000,SE 221,RESIDENTIAL,32000,0,32000,167200,0,199200
142415301900000,SE 221,RESIDENTIAL,35000,0,35000,126000,0,161000
142415302000000,SE 221,RESIDENTIAL,35400,0,35400,140900,0,176300
142415302100000,SE 221,RESIDENTIAL,35600,0,35600,121700,0,157300
142415302200000,SE 221,RESIDENTIAL,37500,0,37500,206000,0,243500
142415302300000,SE 221,RESIDENTIAL,39000,0,39000,159700,0,198700
142415302400000,SE 221,RESIDENTIAL,34500,0,34500,153800,0,188300
142415302500000,SE 221,RESIDENTIAL,31700,0,31700,169500,0,201200
142415302600000,SE 221,RESIDENTIAL,31700,0,31700,134100,0,165800
142415400100000,SE 221,RESIDENTIAL,31700,0,31700,171600,0,203300
142415400200000,SE 221,RESIDENTIAL,31700,0,31700,116900,0,148600
142415400300000,SE 221,RESIDENTIAL,31700,0,31700,129300,0,161000
142415400400000,SE 221,RESIDENTIAL,31700,0,31700,116800,0,148500
142415400500000,SE 221,RESIDENTIAL,31700,0,31700,134100,0,165800
142415400600000,SE 221,RESIDENTIAL,30800,0,30800,134700,0,165500
142415400700000,SE 221,RESIDENTIAL,37600,0,37600,131700,0,169300
142415400800000,SE 221,RESIDENTIAL,33800,0,33800,149300,0,183100
142415400900000,SE 221,RESIDENTIAL,32600,0,32600,119900,0,152500
142415401000000,SE 221,RESIDENTIAL,35700,0,35700,91800,0,127500
142415401100000,SE 221,RESIDENTIAL,37700,0,37700,147200,0,184900
142415401200000,SE 221,RESIDENTIAL,36300,0,36300,127900,0,164200
142415401300000,SE 221,RESIDENTIAL,32600,0,32600,162200,0,194800
142415401400000,SE 221,RESIDENTIAL,32600,0,32600,137400,0,170000
142415401500000,SE 221,RESIDENTIAL,32600,0,32600,142900,0,175500
142415401600000,SE 221,RESIDENTIAL,32600,0,32600,139200,0,171800
142415401700000,SE 221,RESIDENTIAL,38000,0,38000,192000,0,230000
142415401800000,SE 221,RESIDENTIAL,39100,0,39100,135100,0,174200
142415402600000,SE 221,RESIDENTIAL,31700,0,31700,157500,0,189200
142415402700000,SE 221,RESIDENTIAL,31400,0,31400,165600,0,197000
142415402800000,SE 221,RESIDENTIAL,36000,0,36000,148400,0,184400
142415402900000,SE 221,RESIDENTIAL,34900,0,34900,142000,0,176900
142415403000000,SE 221,RESIDENTIAL,31700,0,31700,144800,0,176500
142415403100000,SE 221,RESIDENTIAL,31700,0,31700,141100,0,172800
142415403200000,SE 221,RESIDENTIAL,31700,0,31700,141400,0,173100
142415403300000,SE 221,RESIDENTIAL,31700,0,31700,119400,0,151100
142415403400000,SE 221,RESIDENTIAL,31700,0,31700,144000,0,175700
142415500100000,SE 221,RESIDENTIAL,37200,0,37200,128600,0,165800
142415500200000,SE 221,RESIDENTIAL,35600,0,35600,142800,0,178400
142415500300000,SE 221,RESIDENTIAL,33300,0,33300,139700,0,173000
142415500400000,SE 221,RESIDENTIAL,34600,0,34600,132500,0,167100
142415500500000,SE 221,RESIDENTIAL,37000,0,37000,131300,0,168300
142415500600000,SE 221,RESIDENTIAL,36700,0,36700,167800,0,204500
142415500700000,SE 221,RESIDENTIAL,34600,0,34600,188500,0,223100
142415500800000,SE 221,RESIDENTIAL,33300,0,33300,122700,0,156000
142415600100000,SE 221,RESIDENTIAL,32600,0,32600,161400,0,194000
142415600200000,SE 221,RESIDENTIAL,32600,0,32600,135800,0,168400
142415600300000,SE 221,RESIDENTIAL,32600,0,32600,162600,0,195200
142415600400000,SE 221,RESIDENTIAL,32600,0,32600,141100,0,173700
142415600500000,SE 221,RESIDENTIAL,34100,0,34100,139800,0,173900
142415600600000,SE 221,RESIDENTIAL,32600,0,32600,158900,0,191500
142415600700000,SE 221,RESIDENTIAL,32600,0,32600,149100,0,181700
142415600800000,SE 221,RESIDENTIAL,33200,0,33200,134400,0,167600
142417600100000,SE 219,RESIDENTIAL,105000,0,105000,727900,0,832900
142417600200000,SE 219,RESIDENTIAL,103600,0,103600,0,0,103600
142417600400000,SE 219,RESIDENTIAL,57000,0,57000,0,0,57000
142417600500000,SE 219,RESIDENTIAL,64800,0,64800,316800,0,381600
142417600600000,SE 219,RESIDENTIAL,64600,0,64600,271400,0,336000
142417600700000,SE 219,RESIDENTIAL,79700,0,79700,311700,0,391400
142417600800000,SE 219,RESIDENTIAL,66500,0,66500,372500,0,439000
142417600900000,SE 219,RESIDENTIAL,68400,0,68400,357600,0,426000
142417601000000,SE 219,RESIDENTIAL,59700,0,59700,0,0,59700
142417601100000,SE 219,RESIDENTIAL,75400,0,75400,380700,0,456100
142417601200000,SE 219,RESIDENTIAL,53800,0,53800,287000,0,340800
142417601300000,SE 219,RESIDENTIAL,76500,0,76500,269200,0,345700
142417601400000,SE 219,RESIDENTIAL,55900,0,55900,291800,0,347700
142417601500000,SE 219,RESIDENTIAL,109200,0,109200,407500,0,516700
142417601600000,CENTRALLY ASSESSED,OTHER,0,0,0,0,0,0
142417700100000,SE 220,RESIDENTIAL,36100,0,36100,133800,0,169900
142417700200000,SE 220,RESIDENTIAL,36500,0,36500,138600,0,175100
142417700300000,SE 220,RESIDENTIAL,42300,0,42300,193300,0,235600
142417700400000,SE 220,RESIDENTIAL,35900,0,35900,177700,0,213600
142417700500000,SE 220,RESIDENTIAL,34700,0,34700,158200,0,192900
142417800100000,SE 220,RESIDENTIAL,39200,0,39200,188100,0,227300
142417800200000,SE 220,RESIDENTIAL,42700,0,42700,169600,0,212300
142417800300000,SE 220,RESIDENTIAL,42000,0,42000,156800,0,198800
142417800400000,SE 220,RESIDENTIAL,41600,0,41600,193900,0,235500
142417800500000,SE 220,RESIDENTIAL,37000,0,37000,213600,0,250600
142417800600000,SE 220,RESIDENTIAL,34500,0,34500,174300,0,208800
142417800700000,SE 220,RESIDENTIAL,34200,0,34200,162600,0,196800
142417800800000,SE 220,RESIDENTIAL,46100,0,46100,223200,0,269300
142417900100000,SE 220,RESIDENTIAL,42800,0,42800,153000,0,195800
142417900200000,SE 220,RESIDENTIAL,52000,0,52000,182900,0,234900
142417900300000,SE 220,RESIDENTIAL,38500,0,38500,208500,0,247000
142417900400000,SE 220,RESIDENTIAL,39700,0,39700,115800,0,155500
142417900500000,SE 220,RESIDENTIAL,38300,0,38300,137700,0,176000
142417900600000,SE 220,RESIDENTIAL,42000,0,42000,128300,0,170300
142417900700000,SE 220,RESIDENTIAL,35100,0,35100,112300,0,147400
142417900800000,SE 220,RESIDENTIAL,33600,0,33600,135400,0,169000
142417900900000,SE 220,RESIDENTIAL,44300,0,44300,123300,0,167600
142417901000000,SE 220,RESIDENTIAL,44700,0,44700,226500,0,271200
142417901100000,SE 220,RESIDENTIAL,43000,0,43000,155400,0,198400
142417901200000,SE 220,RESIDENTIAL,39200,0,39200,161300,0,200500
142417901300000,SE 220,RESIDENTIAL,41300,0,41300,128600,0,169900
142417901400000,SE 220,RESIDENTIAL,38200,0,38200,188100,0,226300
142417901500000,SE 220,RESIDENTIAL,37400,0,37400,133400,0,170800
142417901600000,SE 220,RESIDENTIAL,36000,0,36000,251000,0,287000
142417901700000,SE 220,RESIDENTIAL,36000,0,36000,178900,0,214900
142417901800000,SE 220,RESIDENTIAL,36000,0,36000,126800,0,162800
142417901900000,SE 220,RESIDENTIAL,33100,0,33100,158600,0,191700
142417902000000,SE 220,RESIDENTIAL,35700,0,35700,176000,0,211700
142417902100000,SE 220,RESIDENTIAL,36400,0,36400,105600,0,142000
142417902200000,SE 220,RESIDENTIAL,36700,0,36700,133700,0,170400
142417902300000,SE 220,RESIDENTIAL,39500,0,39500,160300,0,199800
142418000100000,SE 220,RESIDENTIAL,0,0,0,0,0,0
142420100100000,SE 210,RESIDENTIAL,33800,0,33800,168000,0,201800
142420100200000,SE 210,RESIDENTIAL,33800,0,33800,176600,0,210400
142420100300000,SE 210,RESIDENTIAL,28200,0,28200,161700,0,189900
142420100400000,SE 210,RESIDENTIAL,27900,0,27900,180700,0,208600
142420100500000,SE 210,RESIDENTIAL,45700,0,45700,193800,0,239500
142420100600000,SE 210,RESIDENTIAL,43500,0,43500,196300,0,239800
142420100700000,SE 210,RESIDENTIAL,42600,0,42600,163100,0,205700
142420100800000,SE 210,RESIDENTIAL,36700,0,36700,237300,0,274000
142420100900000,SE 210,RESIDENTIAL,36700,0,36700,195200,0,231900
142420101000000,SE 210,RESIDENTIAL,36700,0,36700,193800,0,230500
142420101100000,SE 210,RESIDENTIAL,36300,0,36300,208800,0,245100
142420101200000,CENTRALLY ASSESSED,OTHER,0,0,0,0,0,0
142420101300000,SE 210,RESIDENTIAL,61200,0,61200,227500,0,288700
142420101400000,SE 210,RESIDENTIAL,44000,0,44000,270800,0,314800
142420101500000,SE 210,RESIDENTIAL,36800,0,36800,249200,0,286000
142420101600000,SE 210,RESIDENTIAL,37200,0,37200,228200,0,265400
142420101700000,SE 210,RESIDENTIAL,37600,0,37600,252800,0,290400
142420101800000,SE 210,RESIDENTIAL,43100,0,43100,172800,0,215900
142420101900000,SE 210,RESIDENTIAL,42700,0,42700,246000,0,288700
142420102000000,SE 210,RESIDENTIAL,49100,0,49100,230700,0,279800
142420102100000,SE 210,RESIDENTIAL,45300,0,45300,262000,0,307300
142420102200000,SE 210,RESIDENTIAL,51800,0,51800,300100,0,351900
142420200100000,SE 210,RESIDENTIAL,41100,0,41100,271600,0,312700
142420300100000,SE 210,RESIDENTIAL,36700,0,36700,193300,0,230000
142420400100000,SE 210,RESIDENTIAL,40300,0,40300,174500,0,214800
142420400200000,SE 210,RESIDENTIAL,34200,0,34200,119800,0,154000
142420400300000,SE 210,RESIDENTIAL,35000,0,35000,129900,0,164900
142420400400000,SE 210,RESIDENTIAL,36500,0,36500,131500,0,168000
142420400500000,SE 210,RESIDENTIAL,37800,0,37800,183800,0,221600
142420400600000,SE 210,RESIDENTIAL,39000,0,39000,133500,0,172500
142420400700000,SE 210,RESIDENTIAL,38400,0,38400,184300,0,222700
142420400800000,SE 210,RESIDENTIAL,41200,0,41200,108000,0,149200
142420400900000,SE 210,RESIDENTIAL,41000,0,41000,159000,0,200000
142420401000000,SE 210,RESIDENTIAL,40300,0,40300,135000,0,175300
142420500100000,SE 210,RESIDENTIAL,39000,0,39000,113000,0,152000
142420500200000,SE 210,RESIDENTIAL,38800,0,38800,131600,0,170400
142420500300000,SE 210,RESIDENTIAL,38100,0,38100,97900,0,136000
142420500400000,SE 210,RESIDENTIAL,38800,0,38800,179400,0,218200
142420500500000,SE 210,RESIDENTIAL,38800,0,38800,122000,0,160800
142420500600000,SE 210,RESIDENTIAL,39500,0,39500,173300,0,212800
142420500700000,SE 210,RESIDENTIAL,39600,0,39600,178400,0,218000
142420500800000,SE 210,RESIDENTIAL,39500,0,39500,133100,0,172600
142420500900000,SE 210,RESIDENTIAL,37400,0,37400,113100,0,150500
142420501000000,SE 210,RESIDENTIAL,35300,0,35300,170100,0,205400
142420501100000,SE 210,RESIDENTIAL,36400,0,36400,157200,0,193600
142420501200000,SE 210,RESIDENTIAL,35600,0,35600,132500,0,168100
142420501300000,SE 210,RESIDENTIAL,33700,0,33700,152900,0,186600
142420501400000,SE 210,RESIDENTIAL,36400,0,36400,142300,0,178700
142420501500000,SE 210,RESIDENTIAL,38500,0,38500,101500,0,140000
142420501600000,SE 210,RESIDENTIAL,38800,0,38800,201400,0,240200
142420501700000,SE 210,RESIDENTIAL,34900,0,34900,138500,0,173400
142420600100000,SE 210,RESIDENTIAL,35900,0,35900,158600,0,194500
142420600200000,SE 210,RESIDENTIAL,2800,0,2800,0,0,2800
142420600300000,SE 210,RESIDENTIAL,34800,0,34800,124300,0,159100
142420600400000,SE 210,RESIDENTIAL,36900,0,36900,107000,0,143900
142420600500000,SE 210,RESIDENTIAL,36900,0,36900,130200,0,167100
142420600600000,SE 210,RESIDENTIAL,38800,0,38800,142000,0,180800
142420600700000,SE 210,RESIDENTIAL,38800,0,38800,146000,0,184800
142420600800000,SE 210,RESIDENTIAL,38800,0,38800,150600,0,189400
142420600900000,SE 210,RESIDENTIAL,38800,0,38800,152600,0,191400
142420601000000,SE 210,RESIDENTIAL,39300,0,39300,107800,0,147100
142420601100000,SE 210,RESIDENTIAL,33800,0,33800,136500,0,170300
142420601200000,SE 210,RESIDENTIAL,34500,0,34500,154600,0,189100
142420601300000,SE 210,RESIDENTIAL,34900,0,34900,109500,0,144400
142420601400000,SE 210,RESIDENTIAL,34900,0,34900,180100,0,215000
142420601500000,SE 210,RESIDENTIAL,34900,0,34900,154400,0,189300
142420601600000,SE 210,RESIDENTIAL,34900,0,34900,136800,0,171700
142420700100000,SE 210,RESIDENTIAL,36500,0,36500,163100,0,199600
142420700200000,SE 210,RESIDENTIAL,34700,0,34700,107176,0,141876
142420700300000,SE 210,RESIDENTIAL,35300,0,35300,131200,0,166500
142420700400000,SE 210,RESIDENTIAL,35300,0,35300,186300,0,221600
142420700500000,SE 210,RESIDENTIAL,35300,0,35300,117600,0,152900
142420700600000,SE 210,RESIDENTIAL,36500,0,36500,139500,0,176000
142420700700000,SE 210,RESIDENTIAL,36500,0,36500,90600,0,127100
142420700800000,SE 210,RESIDENTIAL,36500,0,36500,163400,0,199900
142420700900000,SE 210,RESIDENTIAL,36500,0,36500,154000,0,190500
142420701000000,SE 210,RESIDENTIAL,36500,0,36500,150900,0,187400
142420701100000,SE 210,RESIDENTIAL,34800,0,34800,181300,0,216100
142420800100000,SE 210,RESIDENTIAL,44400,0,44400,204800,0,249200
142420800200000,SE 210,RESIDENTIAL,36400,0,36400,108900,0,145300
142420800300000,SE 210,RESIDENTIAL,36400,0,36400,119600,0,156000
142420800400000,SE 210,RESIDENTIAL,36400,0,36400,112100,0,148500
142422600100000,SE 211,RESIDENTIAL,100,0,100,0,0,100
142422600200000,SE 211,RESIDENTIAL,53100,0,53100,182600,0,235700
142422600300000,SE 211,RESIDENTIAL,54400,0,54400,193600,0,248000
142422600400000,SE 211,RESIDENTIAL,54400,0,54400,243000,0,297400
142422600500000,SE 211,RESIDENTIAL,53700,0,53700,181700,0,235400
142422600600000,SE 211,RESIDENTIAL,49500,0,49500,193800,0,243300
142422600700000,SE 211,RESIDENTIAL,58300,0,58300,132500,0,190800
142422600800000,SE 211,RESIDENTIAL,138600,0,138600,316400,0,455000
142422600900000,SE 211,RESIDENTIAL,53300,0,53300,172000,0,225300
142422601000000,SE 211,RESIDENTIAL,56700,0,56700,198100,0,254800
142422601100000,SE 211,RESIDENTIAL,61100,0,61100,184300,0,245400
142422601200000,SE 211,RESIDENTIAL,42200,0,42200,201900,0,244100
142422601300000,SE 211,RESIDENTIAL,44400,0,44400,137600,0,182000
142422601400000,SE 211,RESIDENTIAL,43500,0,43500,231000,0,274500
142422601500000,SE 211,RESIDENTIAL,51800,0,51800,214300,0,266100
142422601600000,SE 211,RESIDENTIAL,46700,0,46700,150900,0,197600
142422601700000,SE 211,RESIDENTIAL,45300,0,45300,144000,0,189300
142422601800000,SE 211,RESIDENTIAL,46500,0,46500,147400,0,193900
142422601900000,SE 211,RESIDENTIAL,47000,0,47000,139100,0,186100
142422602000000,SE 211,RESIDENTIAL,44400,0,44400,139800,0,184200
142422602100000,SE 211,RESIDENTIAL,37400,0,37400,193900,0,231300
142422602200000,SE 211,RESIDENTIAL,56000,0,56000,184900,0,240900
142422602300000,SE 211,RESIDENTIAL,54400,0,54400,232200,0,286600
142422602400000,SE 211,RESIDENTIAL,44100,0,44100,199900,0,244000
142422602500000,SE 211,RESIDENTIAL,44100,0,44100,185800,0,229900
142422602600000,SE 211,RESIDENTIAL,55900,0,55900,371300,0,427200
142422602700000,SE 211,RESIDENTIAL,54300,0,54300,210200,0,264500
142422602800000,SE 211,RESIDENTIAL,56400,0,56400,335100,0,391500
142422602900000,SE 211,RESIDENTIAL,59500,0,59500,237600,0,297100
142422603000000,SE 211,RESIDENTIAL,68300,0,68300,211000,0,279300
142422603100000,SE 211,RESIDENTIAL,64700,0,64700,239100,0,303800
142422603200000,SE 211,RESIDENTIAL,61200,0,61200,228700,0,289900
142422603300000,SE 211,RESIDENTIAL,47600,0,47600,230500,0,278100
142422603400000,SE 211,RESIDENTIAL,61200,0,61200,221400,0,282600
142422603500000,SE 211,RESIDENTIAL,63100,0,63100,267100,0,330200
142422603600000,SE 211,RESIDENTIAL,63700,0,63700,278300,0,342000
142422603700000,SE 211,RESIDENTIAL,4900,0,4900,0,0,4900
142422603800000,SE 211,RESIDENTIAL,57800,0,57800,236100,0,293900
142422603900000,SE 211,RESIDENTIAL,59300,0,59300,220800,0,280100
142422604000000,SE 211,RESIDENTIAL,50700,0,50700,351600,0,402300
142422604100000,SE 211,RESIDENTIAL,43700,0,43700,152200,0,195900
142422604200000,SE 211,RESIDENTIAL,45600,0,45600,154600,0,200200
142422604300000,SE 211,RESIDENTIAL,62300,0,62300,185800,0,248100
142422604400000,SE 211,RESIDENTIAL,59300,0,59300,187700,0,247000
142422604500000,SE 211,RESIDENTIAL,48200,0,48200,182200,0,230400
142422604600000,SE 211,RESIDENTIAL,37500,0,37500,192500,0,230000
142422604700000,SE 211,RESIDENTIAL,2100,0,2100,0,0,2100
142422700100000,SE 211,RESIDENTIAL,47500,0,47500,184400,0,231900
142422700200000,SE 211,RESIDENTIAL,49800,0,49800,153900,0,203700
142422700300000,SE 211,RESIDENTIAL,40400,0,40400,211200,0,251600
142422700400000,SE 211,RESIDENTIAL,40400,0,40400,188800,0,229200
142422700500000,SE 211,RESIDENTIAL,40400,0,40400,144300,0,184700
142422700600000,SE 211,RESIDENTIAL,47300,0,47300,152000,0,199300
142422700700000,SE 211,RESIDENTIAL,47500,0,47500,134600,0,182100
142422700800000,SE 211,RESIDENTIAL,48500,0,48500,161900,0,210400
142422700900000,SE 211,RESIDENTIAL,48500,0,48500,150500,0,199000
142422701000000,SE 211,RESIDENTIAL,48500,0,48500,168600,0,217100
142425100100000,SE 211,RESIDENTIAL,132900,0,132900,375500,0,508400
142425100200000,SE 211,RESIDENTIAL,98700,0,98700,411800,0,510500
142425100300000,SE 211,RESIDENTIAL,85000,0,85000,0,0,85000
142425100400000,SE 211,RESIDENTIAL,96300,0,96300,431700,0,528000
142425100500000,SE 211,RESIDENTIAL,87000,0,87000,377300,0,464300
142425100600000,SE 211,RESIDENTIAL,83500,0,83500,355700,0,439200
142425100700000,SE 211,RESIDENTIAL,88600,0,88600,411600,0,500200
142425100800000,SE 211,RESIDENTIAL,106900,0,106900,647500,0,754400
142425101200000,SE 211,RESIDENTIAL,128400,0,128400,568700,0,697100
142425101400000,SE 211,RESIDENTIAL,112500,0,112500,336300,0,448800
142425101500000,SE 211,RESIDENTIAL,100000,0,100000,257500,0,357500
142425101600000,SE 211,RESIDENTIAL,94700,0,94700,415600,0,510300
142425101700000,SE 211,RESIDENTIAL,93000,0,93000,286700,0,379700
142425101800000,SE 211,RESIDENTIAL,101400,0,101400,283500,0,384900
142425101900000,SE 211,RESIDENTIAL,100800,0,100800,296800,0,397600
142425102000000,SE 211,RESIDENTIAL,104400,0,104400,260700,0,365100
142425102100000,SE 211,RESIDENTIAL,104700,0,104700,313700,0,418400
142425102200000,SE 211,RESIDENTIAL,73200,0,73200,261300,0,334500
142425102300000,SE 211,EXEMPT,0,118000,118000,0,466700,584700
142425102400000,SE 211,RESIDENTIAL,58200,0,58200,220000,0,278200
142425102500000,SE 210,RESIDENTIAL,48300,0,48300,188600,0,236900
142425102600000,SE 210,RESIDENTIAL,53500,0,53500,255900,0,309400
142425102700000,SE 210,RESIDENTIAL,52400,0,52400,163300,0,215700
142425102800000,SE 210,RESIDENTIAL,52400,0,52400,134700,0,187100
142425102900000,SE 210,RESIDENTIAL,47100,0,47100,142700,0,189800
142425103000000,SE 210,RESIDENTIAL,43200,0,43200,122800,0,166000
142425103100000,SE 210,RESIDENTIAL,43400,0,43400,109700,0,153100
142425103200000,SE 210,RESIDENTIAL,44000,0,44000,153600,0,197600
142425103300000,SE 210,RESIDENTIAL,47500,0,47500,148500,0,196000
142425103400000,SE 210,RESIDENTIAL,60300,0,60300,186200,0,246500
142425103500000,SE 210,RESIDENTIAL,47800,0,47800,129700,0,177500
142425103700000,SE 211,RESIDENTIAL,74400,0,74400,0,0,74400
142425104000000,SE 211,RESIDENTIAL,135000,0,135000,734100,0,869100
142425104100000,SE 211,RESIDENTIAL,115400,0,115400,477700,0,593100
142425200100000,SE 210,RESIDENTIAL,41200,0,41200,186000,0,227200
142425200200000,SE 210,RESIDENTIAL,42800,0,42800,100100,0,142900
142425200300000,SE 210,RESIDENTIAL,41200,0,41200,76800,0,118000
142427600100000,SE 210,RESIDENTIAL,36400,0,36400,134700,0,171100
142427600200000,SE 210,RESIDENTIAL,36400,0,36400,127800,0,164200
142427600300000,SE 210,RESIDENTIAL,36400,0,36400,122800,0,159200
142427600400000,SE 210,RESIDENTIAL,36400,0,36400,109300,0,145700
142427600500000,SE 210,RESIDENTIAL,36400,0,36400,137100,0,173500
142427600600000,SE 210,RESIDENTIAL,41800,0,41800,136800,0,178600
142427700100000,SE 210,RESIDENTIAL,42800,0,42800,151500,0,194300
142427700200000,SE 210,RESIDENTIAL,35600,0,35600,136700,0,172300
142427700300000,SE 210,RESIDENTIAL,40100,0,40100,169900,0,210000
142427700400000,SE 210,RESIDENTIAL,37200,0,37200,190500,0,227700
142427700500000,SE 210,RESIDENTIAL,36800,0,36800,202200,0,239000
142427700600000,SE 210,RESIDENTIAL,36800,0,36800,134400,0,171200
142427800100000,SE 210,RESIDENTIAL,41000,0,41000,143400,0,184400
142427800200000,SE 210,RESIDENTIAL,35000,0,35000,129000,0,164000
142427800300000,SE 210,RESIDENTIAL,33700,0,33700,108100,0,141800
142427800400000,SE 210,RESIDENTIAL,36400,0,36400,113400,0,149800
142427800500000,SE 210,RESIDENTIAL,34800,0,34800,117900,0,152700
142427900100000,SE 210,RESIDENTIAL,34000,0,34000,107000,0,141000
142427900200000,SE 210,RESIDENTIAL,34000,0,34000,113100,0,147100
142427900300000,SE 210,RESIDENTIAL,34000,0,34000,109500,0,143500
142427900400000,SE 210,RESIDENTIAL,34000,0,34000,171200,0,205200
142427900500000,SE 210,RESIDENTIAL,34000,0,34000,119800,0,153800
142427900600000,SE 210,RESIDENTIAL,33900,0,33900,155100,0,189000
142427900700000,SE 210,RESIDENTIAL,37500,0,37500,134600,0,172100
142427900800000,SE 210,RESIDENTIAL,36000,0,36000,120900,0,156900
142427900900000,SE 210,RESIDENTIAL,36000,0,36000,118100,0,154100
142427901000000,SE 210,RESIDENTIAL,36000,0,36000,115400,0,151400
142427901100000,SE 210,RESIDENTIAL,36000,0,36000,112100,0,148100
142427901200000,SE 210,RESIDENTIAL,36000,0,36000,112400,0,148400
142427901300000,SE 210,RESIDENTIAL,36000,0,36000,131400,0,167400
142428000100000,SE 210,RESIDENTIAL,37600,0,37600,132800,0,170400
142428000200000,SE 210,RESIDENTIAL,45600,0,45600,182800,0,228400
142428000300000,SE 210,RESIDENTIAL,44100,0,44100,166800,0,210900
142428000400000,SE 210,RESIDENTIAL,39600,0,39600,110300,0,149900
142428000500000,SE 210,RESIDENTIAL,40000,0,40000,146200,0,186200
142428000600000,SE 210,RESIDENTIAL,41900,0,41900,117500,0,159400
142428000700000,SE 210,RESIDENTIAL,43800,0,43800,112100,0,155900
142428000800000,SE 210,RESIDENTIAL,45100,0,45100,341600,0,386700
142428000900000,SE 210,RESIDENTIAL,44500,0,44500,148600,0,193100
142428100100000,SE 210,RESIDENTIAL,33400,0,33400,121300,0,154700
142428100200000,SE 210,RESIDENTIAL,33800,0,33800,158400,0,192200
142428100300000,SE 210,RESIDENTIAL,34200,0,34200,145300,0,179500
142428100400000,SE 210,RESIDENTIAL,34300,0,34300,128700,0,163000
142428100500000,SE 210,RESIDENTIAL,34800,0,34800,112300,0,147100
142428100600000,SE 210,RESIDENTIAL,35300,0,35300,138200,0,173500
142428100700000,SE 210,RESIDENTIAL,35100,0,35100,127400,0,162500
142428200100000,SE 210,RESIDENTIAL,38200,0,38200,116500,0,154700
142428200200000,SE 210,RESIDENTIAL,37700,0,37700,137900,0,175600
142428200300000,SE 210,RESIDENTIAL,37700,0,37700,167900,0,205600
142428200400000,SE 210,RESIDENTIAL,37500,0,37500,87700,0,125200
142428200500000,SE 210,RESIDENTIAL,36700,0,36700,129200,0,165900
142428200600000,SE 210,RESIDENTIAL,36000,0,36000,119400,0,155400
142428200700000,SE 210,RESIDENTIAL,37500,0,37500,107600,0,145100
142428200800000,SE 210,RESIDENTIAL,40000,0,40000,157200,0,197200
142428200900000,SE 210,RESIDENTIAL,42100,0,42100,132100,0,174200
142428201000000,SE 210,RESIDENTIAL,46200,0,46200,153200,0,199400
142428201100000,SE 210,RESIDENTIAL,42400,0,42400,132800,0,175200
142428201200000,SE 210,RESIDENTIAL,41600,0,41600,134200,0,175800
142428201300000,SE 210,RESIDENTIAL,48600,0,48600,129500,0,178100
142428201400000,SE 210,RESIDENTIAL,46400,0,46400,153600,0,200000
142428201500000,SE 210,RESIDENTIAL,47200,0,47200,137300,0,184500
142428201600000,SE 210,RESIDENTIAL,48600,0,48600,184700,0,233300
142428201700000,SE 210,RESIDENTIAL,48500,0,48500,168800,0,217300
142428201800000,SE 210,RESIDENTIAL,46400,0,46400,126800,0,173200
142428201900000,SE 210,RESIDENTIAL,45600,0,45600,212400,0,258000
142428202000000,SE 210,RESIDENTIAL,49400,0,49400,241900,0,291300
142428202100000,SE 210,RESIDENTIAL,41200,0,41200,195100,0,236300
142428202200000,SE 210,RESIDENTIAL,43600,0,43600,192500,0,236100
142428202300000,SE 210,RESIDENTIAL,42600,0,42600,104100,0,146700
142428202400000,SE 210,RESIDENTIAL,43900,0,43900,102500,0,146400
142428202500000,SE 210,RESIDENTIAL,41600,0,41600,157100,0,198700
142428202600000,SE 210,RESIDENTIAL,45400,0,45400,124400,0,169800
142428300100000,SE 210,RESIDENTIAL,44700,0,44700,116200,0,160900
142428300200000,SE 210,RESIDENTIAL,40300,0,40300,133300,0,173600
142428300300000,SE 210,RESIDENTIAL,40700,0,40700,149000,0,189700
142428300400000,SE 210,RESIDENTIAL,40600,0,40600,105100,0,145700
142428300500000,SE 210,RESIDENTIAL,40700,0,40700,108700,0,149400
142428300600000,SE 210,RESIDENTIAL,38200,0,38200,101300,0,139500
142428300700000,SE 210,RESIDENTIAL,38300,0,38300,83200,0,121500
142430100100000,SE 210,RESIDENTIAL,37300,0,37300,77300,0,114600
142430100200000,SE 210,RESIDENTIAL,31400,0,31400,117700,0,149100
142430100300000,SE 210,RESIDENTIAL,29100,0,29100,113900,0,143000
142430100400000,SE 210,RESIDENTIAL,32300,0,32300,61900,0,94200
142430100500000,SE 210,RESIDENTIAL,31000,0,31000,99000,0,130000
142430100600000,SE 210,RESIDENTIAL,34500,0,34500,112200,0,146700
142430100700000,SE 210,RESIDENTIAL,27700,0,27700,115000,0,142700
142430100800000,SE 210,RESIDENTIAL,28100,0,28100,132700,0,160800
142430100900000,SE 210,RESIDENTIAL,28400,0,28400,84000,0,112400
142430101000000,SE 210,RESIDENTIAL,28400,0,28400,81400,0,109800
142430101100000,SE 210,RESIDENTIAL,28400,0,28400,85500,0,113900
142430101200000,SE 210,RESIDENTIAL,29000,0,29000,67500,0,96500
142430101300000,SE 210,RESIDENTIAL,28700,0,28700,97200,0,125900
142430101400000,SE 210,RESIDENTIAL,31400,0,31400,112400,0,143800
142430101500000,SE 210,RESIDENTIAL,28000,0,28000,75600,0,103600
142430200100000,SE 210,RESIDENTIAL,64400,0,64400,201300,0,265700
142430200200000,SE 210,RESIDENTIAL,61100,0,61100,122100,0,183200
142430200300000,SE 210,RESIDENTIAL,34600,0,34600,129000,0,163600
142430200400000,SE 210,RESIDENTIAL,35200,0,35200,133700,0,168900
142430200500000,SE 210,RESIDENTIAL,37600,0,37600,131300,0,168900
142430200600000,SE 210,RESIDENTIAL,34100,0,34100,147500,0,181600
142430200700000,SE 210,RESIDENTIAL,31000,0,31000,151000,0,182000
142430200800000,SE 210,RESIDENTIAL,29800,0,29800,146800,0,176600
142430200900000,SE 210,RESIDENTIAL,39300,0,39300,156600,0,195900
142430201000000,SE 210,RESIDENTIAL,37200,0,37200,153900,0,191100
142430201100000,SE 210,RESIDENTIAL,32700,0,32700,156900,0,189600
142430201200000,SE 210,RESIDENTIAL,34500,0,34500,154900,0,189400
142430201300000,SE 210,RESIDENTIAL,34200,0,34200,140300,0,174500
142430201400000,SE 210,RESIDENTIAL,32000,0,32000,183600,0,215600
142430201500000,SE 210,RESIDENTIAL,34300,0,34300,149000,0,183300
142430201600000,SE 210,RESIDENTIAL,36400,0,36400,116200,0,152600
142430201700000,SE 210,RESIDENTIAL,30500,0,30500,165800,0,196300
142430201800000,SE 210,RESIDENTIAL,30100,0,30100,156700,0,186800
142430201900000,SE 210,RESIDENTIAL,39000,0,39000,84300,0,123300
142430202100000,SE 210,RESIDENTIAL,28000,0,28000,88600,0,116600
142430202200000,SE 210,RESIDENTIAL,26800,0,26800,147800,0,174600
142430202300000,SE 210,RESIDENTIAL,30400,0,30400,107400,0,137800
142430202400000,SE 210,RESIDENTIAL,29500,0,29500,115900,0,145400
142430202500000,SE 210,RESIDENTIAL,34600,0,34600,133700,0,168300
142430202600000,SE 210,RESIDENTIAL,34000,0,34000,117300,0,151300
142430202700000,SE 210,RESIDENTIAL,33900,0,33900,110700,0,144600
142430202800000,SE 210,RESIDENTIAL,34200,0,34200,128500,0,162700
142430202900000,SE 210,RESIDENTIAL,33400,0,33400,103800,0,137200
142430203000000,SE 210,RESIDENTIAL,32800,0,32800,106300,0,139100
142430203100000,SE 210,RESIDENTIAL,34300,0,34300,169000,0,203300
142430203200000,SE 210,RESIDENTIAL,34600,0,34600,122100,0,156700
142430203300000,SE 210,RESIDENTIAL,35100,0,35100,106300,0,141400
142430203400000,SE 210,RESIDENTIAL,46800,0,46800,111000,0,157800
142430300100000,SE 210,RESIDENTIAL,36700,0,36700,158400,0,195100
142430300200000,SE 210,RESIDENTIAL,31400,0,31400,182700,0,214100
142430300300000,SE 210,RESIDENTIAL,31600,0,31600,167800,0,199400
142430300400000,SE 210,RESIDENTIAL,32200,0,32200,167100,0,199300
142430300500000,SE 210,RESIDENTIAL,32900,0,32900,100800,0,133700
142430300600000,SE 210,RESIDENTIAL,34600,0,34600,130700,0,165300
142430300700000,SE 210,RESIDENTIAL,33700,0,33700,112500,0,146200
142430300800000,SE 210,RESIDENTIAL,31500,0,31500,132900,0,164400
142430300900000,SE 210,RESIDENTIAL,30100,0,30100,188500,0,218600
142430301000000,SE 210,RESIDENTIAL,33900,0,33900,139800,0,173700
142430301100000,SE 210,RESIDENTIAL,38800,0,38800,106500,0,145300
142430400100000,SE 210,RESIDENTIAL,31800,0,31800,173200,0,205000
142430400200000,SE 210,RESIDENTIAL,28000,0,28000,131700,0,159700
142430400300000,SE 210,RESIDENTIAL,29200,0,29200,127400,0,156600
142430400400000,SE 210,RESIDENTIAL,32600,0,32600,101200,0,133800
142430400500000,SE 210,RESIDENTIAL,28400,0,28400,100700,0,129100
142430400600000,SE 210,RESIDENTIAL,28700,0,28700,113900,0,142600
142430400700000,SE 210,RESIDENTIAL,27200,0,27200,117700,0,144900
142430500100000,SE 210,RESIDENTIAL,33600,0,33600,118300,0,151900
142430500200000,SE 210,RESIDENTIAL,33000,0,33000,109200,0,142200
142430500300000,SE 210,RESIDENTIAL,28100,0,28100,175700,0,203800
142430500400000,SE 210,RESIDENTIAL,27400,0,27400,127100,0,154500
142430500500000,SE 210,RESIDENTIAL,25600,0,25600,155700,0,181300
142430500600000,SE 210,RESIDENTIAL,26700,0,26700,118300,0,145000
142430500700000,SE 210,RESIDENTIAL,22600,0,22600,94200,0,116800
142430500800000,SE 210,RESIDENTIAL,24800,0,24800,122000,0,146800
142430500900000,SE 210,RESIDENTIAL,25800,0,25800,130800,0,156600
142430501000000,SE 210,RESIDENTIAL,27200,0,27200,124100,0,151300
142430501100000,SE 210,RESIDENTIAL,30700,0,30700,111400,0,142100
142430501200000,SE 210,RESIDENTIAL,29500,0,29500,81400,0,110900
142430501300000,SE 210,RESIDENTIAL,29500,0,29500,100000,0,129500
142430501400000,SE 210,RESIDENTIAL,29500,0,29500,106500,0,136000
142430501500000,SE 210,RESIDENTIAL,29500,0,29500,115900,0,145400
142430501600000,SE 210,RESIDENTIAL,29500,0,29500,94400,0,123900
142430501700000,SE 210,RESIDENTIAL,29500,0,29500,104600,0,134100
142430501800000,SE 210,RESIDENTIAL,29500,0,29500,108800,0,138300
142430600100000,SE 210,RESIDENTIAL,26600,0,26600,103600,0,130200
142430600200000,SE 210,RESIDENTIAL,27500,0,27500,109700,0,137200
142430600300000,SE 210,RESIDENTIAL,26000,0,26000,91200,0,117200
142430600400000,SE 210,RESIDENTIAL,26200,0,26200,167800,0,194000
142430600600000,SE 210,RESIDENTIAL,30300,0,30300,27400,0,57700
142430600700000,SE 210,RESIDENTIAL,29800,0,29800,102600,0,132400
142430600800000,SE 210,RESIDENTIAL,29500,0,29500,91200,0,120700
142430600900000,SE 210,RESIDENTIAL,29500,0,29500,108400,0,137900
142430601000000,SE 210,RESIDENTIAL,29500,0,29500,124000,0,153500
142430601100000,SE 210,RESIDENTIAL,29500,0,29500,93100,0,122600
142430601200000,SE 210,RESIDENTIAL,29500,0,29500,94000,0,123500
142430601300000,SE 210,RESIDENTIAL,29500,0,29500,103900,0,133400
142430601400000,SE 210,RESIDENTIAL,29500,0,29500,95200,0,124700
142430601500000,SE 210,RESIDENTIAL,30600,0,30600,107600,0,138200
142430601700000,SE 210,RESIDENTIAL,21100,0,21100,42400,0,63500
142432600100000,SE 210,RESIDENTIAL,43100,0,43100,110400,0,153500
142432600200000,SE 210,RESIDENTIAL,46500,0,46500,151300,0,197800
142432700100000,SE 210,RESIDENTIAL,41700,0,41700,186400,0,228100
142432700400000,SE 210,RESIDENTIAL,43500,0,43500,134400,0,177900
142432700500000,SE 210,RESIDENTIAL,42300,0,42300,151700,0,194000
142432700600000,SE 210,RESIDENTIAL,46100,0,46100,190000,0,236100
142432700700000,SE 210,RESIDENTIAL,46100,0,46100,220100,0,266200
142432700800000,SE 210,RESIDENTIAL,46100,0,46100,165900,0,212000
142432700900000,SE 210,RESIDENTIAL,46100,0,46100,242900,0,289000
142432701000000,SE 210,RESIDENTIAL,31200,0,31200,91500,0,122700
142432701100000,SE 210,RESIDENTIAL,29400,0,29400,112800,0,142200
142432701200000,SE 210,RESIDENTIAL,27900,0,27900,104300,0,132200
142432701300000,SE 210,RESIDENTIAL,27900,0,27900,103400,0,131300
142432701400000,SE 210,RESIDENTIAL,32100,0,32100,114500,0,146600
142432701500000,SE 210,RESIDENTIAL,32100,0,32100,123000,0,155100
142432701600000,SE 210,RESIDENTIAL,32100,0,32100,85600,0,117700
142432701700000,SE 210,RESIDENTIAL,32100,0,32100,108200,0,140300
142432701800000,SE 210,RESIDENTIAL,32100,0,32100,132900,0,165000
142432701900000,SE 210,RESIDENTIAL,32700,0,32700,130300,0,163000
142432702000000,SE 210,RESIDENTIAL,32700,0,32700,107500,0,140200
142432702100000,SE 210,RESIDENTIAL,32700,0,32700,117500,0,150200
142432702200000,SE 210,RESIDENTIAL,41600,0,41600,139000,0,180600
142432800100000,SE 210,RESIDENTIAL,45900,0,45900,124500,0,170400
142432800200000,SE 210,RESIDENTIAL,20800,0,20800,90100,0,110900
142432800300000,SE 210,RESIDENTIAL,43600,0,43600,140200,0,183800
142432800400000,SE 210,RESIDENTIAL,39200,0,39200,122500,0,161700
142432800500000,SE 210,RESIDENTIAL,39200,0,39200,124300,0,163500
142432800600000,SE 210,RESIDENTIAL,38700,0,38700,112400,0,151100
142432800700000,SE 210,RESIDENTIAL,29100,0,29100,96400,0,125500
142432800800000,SE 210,RESIDENTIAL,29100,0,29100,97200,0,126300
142432800900000,SE 210,RESIDENTIAL,29100,0,29100,101600,0,130700
142432801000000,SE 210,RESIDENTIAL,28600,0,28600,98400,0,127000
142432801100000,SE 210,RESIDENTIAL,30000,0,30000,100000,0,130000
142432801200000,SE 210,RESIDENTIAL,33200,0,33200,126400,0,159600
142432801300000,SE 210,RESIDENTIAL,15800,0,15800,116300,0,132100
142432801400000,SE 210,RESIDENTIAL,30100,0,30100,107100,0,137200
142432900100000,SE 223,RESIDENTIAL,24500,0,24500,132500,0,157000
142432900200000,SE 223,RESIDENTIAL,21600,0,21600,114400,0,136000
142432900300000,SE 223,RESIDENTIAL,21000,0,21000,80000,0,101000
142432900400000,SE 223,RESIDENTIAL,21000,0,21000,104200,0,125200
142432900500000,SE 223,RESIDENTIAL,21000,0,21000,99400,0,120400
142432900600000,SE 223,RESIDENTIAL,21000,0,21000,92000,0,113000
142432900700000,SE 223,RESIDENTIAL,21600,0,21600,97600,0,119200
142432900800000,SE 223,RESIDENTIAL,21000,0,21000,71100,0,92100
142432900900000,SE 223,RESIDENTIAL,21000,0,21000,97400,0,118400
142432901000000,SE 223,RESIDENTIAL,21000,0,21000,85700,0,106700
142432901100000,SE 223,RESIDENTIAL,21000,0,21000,107500,0,128500
142432901200000,SE 223,RESIDENTIAL,21000,0,21000,122300,0,143300
142432901300000,SE 223,RESIDENTIAL,21000,0,21000,91800,0,112800
142432901400000,SE 223,RESIDENTIAL,21000,0,21000,93000,0,114000
142432901500000,SE 223,RESIDENTIAL,21000,0,21000,102900,0,123900
142432901600000,SE 223,RESIDENTIAL,21600,0,21600,116000,0,137600
142432901700000,SE 223,RESIDENTIAL,21600,0,21600,118600,0,140200
142432901800000,SE 223,RESIDENTIAL,21400,0,21400,120200,0,141600
142432901900000,SE 223,RESIDENTIAL,21400,0,21400,100000,0,121400
142433000100000,SE 223,RESIDENTIAL,21000,0,21000,104900,0,125900
142433000200000,SE 223,RESIDENTIAL,21000,0,21000,118400,0,139400
142433000300000,SE 223,RESIDENTIAL,21000,0,21000,120000,0,141000
142433000400000,SE 223,RESIDENTIAL,21000,0,21000,110900,0,131900
142433000500000,SE 223,RESIDENTIAL,21000,0,21000,54300,0,75300
142433000600000,SE 223,RESIDENTIAL,21000,0,21000,73800,0,94800
142433000700000,SE 223,RESIDENTIAL,21000,0,21000,75900,0,96900
142433000800000,SE 223,RESIDENTIAL,21000,0,21000,88500,0,109500
142433000900000,SE 223,RESIDENTIAL,21000,0,21000,72500,0,93500
142433001000000,SE 223,RESIDENTIAL,21000,0,21000,94300,0,115300
142433001100000,SE 223,RESIDENTIAL,22100,0,22100,90900,0,113000
142433001200000,CITY PROPERTY,EXEMPT,0,0,0,0,0,0
142433001300000,SE 223,RESIDENTIAL,21600,0,21600,75000,0,96600
142433001400000,SE 223,RESIDENTIAL,22100,0,22100,111000,0,133100
142433001500000,SE 223,RESIDENTIAL,21400,0,21400,92700,0,114100
142433001600000,SE 223,RESIDENTIAL,17700,0,17700,86400,0,104100
142433001700000,SE 223,RESIDENTIAL,23100,0,23100,94200,0,117300
142433001800000,SE 223,RESIDENTIAL,22100,0,22100,107800,0,129900
142433001900000,SE 223,RESIDENTIAL,21000,0,21000,101700,0,122700
142433002000000,SE 223,RESIDENTIAL,21000,0,21000,108900,0,129900
142433002100000,SE 223,RESIDENTIAL,21000,0,21000,100800,0,121800
142433002200000,SE 223,RESIDENTIAL,21000,0,21000,83600,0,104600
142433002300000,SE 223,RESIDENTIAL,21000,0,21000,108600,0,129600
142433002400000,SE 223,RESIDENTIAL,21000,0,21000,114000,0,135000
142433002500000,SE 223,RESIDENTIAL,21000,0,21000,103900,0,124900
142433002600000,SE 223,RESIDENTIAL,21000,0,21000,128000,0,149000
142433100100000,SE 210,RESIDENTIAL,32200,0,32200,92600,0,124800
142433100200000,SE 210,RESIDENTIAL,32200,0,32200,114100,0,146300
142433100300000,SE 210,RESIDENTIAL,32200,0,32200,63000,0,95200
142433100400000,SE 210,RESIDENTIAL,32200,0,32200,115600,0,147800
142433100500000,SE 210,RESIDENTIAL,30200,0,30200,106600,0,136800
142433100600000,SE 210,RESIDENTIAL,28000,0,28000,113200,0,141200
142433100700000,SE 210,RESIDENTIAL,29400,0,29400,121600,0,151000
142433100800000,SE 210,RESIDENTIAL,29400,0,29400,138500,0,167900
142433100900000,SE 210,RESIDENTIAL,29100,0,29100,82200,0,111300
142433101000000,SE 210,RESIDENTIAL,29100,0,29100,128000,0,157100
142433101100000,SE 210,RESIDENTIAL,29100,0,29100,111300,0,140400
142433101200000,SE 210,RESIDENTIAL,28500,0,28500,124200,0,152700
142433101300000,SE 210,RESIDENTIAL,33300,0,33300,77200,0,110500
142433101400000,SE 210,RESIDENTIAL,30200,0,30200,100200,0,130400
142433101500000,SE 210,RESIDENTIAL,30200,0,30200,109300,0,139500
142433101600000,SE 210,RESIDENTIAL,30000,0,30000,124600,0,154600
142433200100000,SE 223,RESIDENTIAL,19300,0,19300,108500,0,127800
142433200200000,SE 223,RESIDENTIAL,19000,0,19000,86700,0,105700
142433200300000,SE 223,RESIDENTIAL,21400,0,21400,95200,0,116600
142433200400000,SE 223,RESIDENTIAL,20600,0,20600,86200,0,106800
142433200500000,SE 223,RESIDENTIAL,19100,0,19100,106900,0,126000
142435100100000,SCHOOL,EXEMPT,0,0,0,0,0,0
142435200100000,SE 223,RESIDENTIAL,19100,0,19100,95500,0,114600
142435200200000,SE 223,RESIDENTIAL,21000,0,21000,88500,0,109500
142435200300000,SE 223,RESIDENTIAL,19100,0,19100,108300,0,127400
142435200400000,SE 223,RESIDENTIAL,19100,0,19100,91200,0,110300
142435200500000,SE 223,RESIDENTIAL,19100,0,19100,92800,0,111900
142435200600000,SE 223,RESIDENTIAL,19100,0,19100,95700,0,114800
142435200700000,SE 223,RESIDENTIAL,19100,0,19100,109900,0,129000
142435200800000,SE 223,RESIDENTIAL,19100,0,19100,86700,0,105800
142435200900000,SE 223,RESIDENTIAL,20700,0,20700,138300,0,159000
142435201000000,SE 223,RESIDENTIAL,20600,0,20600,144900,0,165500
142435201100000,SE 223,RESIDENTIAL,21700,0,21700,113900,0,135600
142435201200000,SE 223,RESIDENTIAL,20000,0,20000,93900,0,113900
142435201300000,SE 223,RESIDENTIAL,20300,0,20300,93300,0,113600
142435201400000,SE 223,RESIDENTIAL,20400,0,20400,86600,0,107000
142435201500000,SE 223,RESIDENTIAL,19100,0,19100,81100,0,100200
142435201600000,SE 223,RESIDENTIAL,19100,0,19100,86100,0,105200
142435201700000,SE 223,RESIDENTIAL,19100,0,19100,85800,0,104900
142435201800000,SE 223,RESIDENTIAL,19100,0,19100,90300,0,109400
142435201900000,SE 223,RESIDENTIAL,19100,0,19100,83700,0,102800
142435202000000,SE 223,RESIDENTIAL,19100,0,19100,109200,0,128300
142435202100000,SE 223,RESIDENTIAL,19100,0,19100,83400,0,102500
142435300100000,SE 223,RESIDENTIAL,23300,0,23300,102300,0,125600
142435300200000,SE 223,RESIDENTIAL,24200,0,24200,91500,0,115700
142435300300000,SE 223,RESIDENTIAL,25200,0,25200,97300,0,122500
142435300400000,SE 223,RESIDENTIAL,20400,0,20400,87700,0,108100
142435300500000,SE 223,RESIDENTIAL,20400,0,20400,86300,0,106700
142435300600000,SE 223,RESIDENTIAL,21500,0,21500,74000,0,95500
142435300700000,SE 223,RESIDENTIAL,28500,0,28500,67600,0,96100
142435300800000,SE 223,RESIDENTIAL,21900,0,21900,69900,0,91800
142435300900000,SE 223,RESIDENTIAL,21000,0,21000,78300,0,99300
142435301000000,SE 223,RESIDENTIAL,21000,0,21000,113600,0,134600
142435301100000,SE 223,RESIDENTIAL,20200,0,20200,75700,0,95900
142435301200000,SE 223,RESIDENTIAL,23000,0,23000,104000,0,127000
142435301300000,SE 223,RESIDENTIAL,20700,0,20700,78600,0,99300
142435301400000,SE 223,RESIDENTIAL,20000,0,20000,90300,0,110300
142435301500000,SE 223,RESIDENTIAL,19800,0,19800,88700,0,108500
142435301600000,SE 223,RESIDENTIAL,19800,0,19800,119200,0,139000
142435301700000,SE 223,RESIDENTIAL,19800,0,19800,98400,0,118200
142435301800000,SE 223,RESIDENTIAL,18700,0,18700,100500,0,119200
142435301900000,SE 223,RESIDENTIAL,18700,0,18700,92100,0,110800
142435302000000,SE 223,RESIDENTIAL,18500,0,18500,79500,0,98000
142435302100000,SE 223,RESIDENTIAL,23700,0,23700,127700,0,151400
142435302200000,SE 223,RESIDENTIAL,21800,0,21800,92500,0,114300
142435302300000,SE 223,RESIDENTIAL,1900,0,1900,0,0,1900
142435302400000,SE 223,RESIDENTIAL,22000,0,22000,94600,0,116600
142435400100000,SE 223,RESIDENTIAL,21200,0,21200,100400,0,121600
142435400200000,SE 223,RESIDENTIAL,21300,0,21300,100400,0,121700
142435400300000,SE 223,RESIDENTIAL,21400,0,21400,120800,0,142200
142435400400000,SE 223,RESIDENTIAL,21200,0,21200,110200,0,131400
142435400500000,SE 223,RESIDENTIAL,21300,0,21300,118000,0,139300
142435400600000,SE 223,RESIDENTIAL,21400,0,21400,95700,0,117100
142435500200000,APARTMENT,MULTI-RES,22500,0,22500,90300,0,112800
142435500300000,APARTMENT,RESIDENTIAL,21800,0,21800,105000,0,126800
142435500600000,CHURCH,EXEMPT,0,200000,200000,0,333900,533900
142435500700000,OFFICE; MEDICAL,COMMERCIAL,0,280000,280000,0,1004200,1284200
142435600100000,SE 223,RESIDENTIAL,19400,0,19400,82700,0,102100
142435600200000,SE 223,RESIDENTIAL,19800,0,19800,86700,0,106500
142435600300000,SE 223,RESIDENTIAL,19700,0,19700,96100,0,115800
142435600400000,SE 223,RESIDENTIAL,19700,0,19700,76400,0,96100
142435600500000,SE 223,RESIDENTIAL,20000,0,20000,123000,0,143000
142435600600000,SE 223,RESIDENTIAL,20400,0,20400,95800,0,116200
142435600700000,OFFICE; MEDICAL,COMMERCIAL,0,140800,140800,0,299500,440300
142435600800000,SE 223,RESIDENTIAL,15900,0,15900,105200,0,121100
142435600900000,SE 223,RESIDENTIAL,15900,0,15900,99600,0,115500
142435601000000,SE 223,RESIDENTIAL,19100,0,19100,93300,0,112400
142435601100000,SE 223,RESIDENTIAL,19100,0,19100,70000,0,89100
142435601200000,SE 223,RESIDENTIAL,19100,0,19100,86200,0,105300
142435601300000,SE 223,RESIDENTIAL,19100,0,19100,83700,0,102800
142435601400000,SE 223,RESIDENTIAL,19100,0,19100,89600,0,108700
142435700100000,SE 223,RESIDENTIAL,20900,0,20900,114300,0,135200
142435700200000,SE 223,RESIDENTIAL,21900,0,21900,129600,0,151500
142435700300000,SE 223,RESIDENTIAL,18400,0,18400,57700,0,76100
142435700400000,SE 223,RESIDENTIAL,18700,0,18700,70600,0,89300
142435700500000,SE 223,RESIDENTIAL,26000,0,26000,97900,0,123900
142435700600000,SE 223,RESIDENTIAL,27500,0,27500,0,0,27500
142435700700000,SMALL RETAIL,COMMERCIAL,0,78800,78800,0,204900,283700
142435700800000,RESTAURANT,COMMERCIAL,0,73000,73000,0,133300,206300
142435700900000,BRANCH BANK/CU,COMMERCIAL,0,205000,205000,0,601400,806400
142435701000000,SE 223,RESIDENTIAL,16600,0,16600,79800,0,96400
142435701100000,SE 223,RESIDENTIAL,16600,0,16600,85800,0,102400
142435701200000,SE 223,RESIDENTIAL,20300,0,20300,110500,0,130800
142435701300000,SE 223,RESIDENTIAL,20300,0,20300,94000,0,114300
142435701400000,SE 223,RESIDENTIAL,20300,0,20300,53300,0,73600
142435800100000,SE 223,RESIDENTIAL,21400,0,21400,97400,0,118800
142435800200000,SE 223,RESIDENTIAL,21500,0,21500,108600,0,130100
142435800300000,SE 223,RESIDENTIAL,21600,0,21600,91300,0,112900
142435800400000,SE 223,RESIDENTIAL,21400,0,21400,120700,0,142100
142435800500000,SE 223,RESIDENTIAL,21500,0,21500,114600,0,136100
142435800600000,SE 223,RESIDENTIAL,21600,0,21600,84500,0,106100
142437600100000,SE 223,RESIDENTIAL,20000,0,20000,99400,0,119400
142437600200000,SE 223,RESIDENTIAL,20000,0,20000,96500,0,116500
142437600300000,SE 223,RESIDENTIAL,20000,0,20000,110700,0,130700
142437600400000,SE 223,RESIDENTIAL,24300,0,24300,119500,0,143800
142437600500000,SE 223,RESIDENTIAL,24300,0,24300,130400,0,154700
142437600600000,SE 223,RESIDENTIAL,24300,0,24300,101800,0,126100
142437600700000,SE 223,RESIDENTIAL,24100,0,24100,98100,0,122200
142437600800000,SE 223,RESIDENTIAL,24100,0,24100,104000,0,128100
142437600900000,SE 223,RESIDENTIAL,24100,0,24100,91900,0,116000
142437601000000,SE 223,RESIDENTIAL,24100,0,24100,91800,0,115900
142437601100000,SE 223,RESIDENTIAL,20400,0,20400,102500,0,122900
142437601200000,SE 223,RESIDENTIAL,23700,0,23700,51800,0,75500
142437601300000,SE 223,RESIDENTIAL,23000,0,23000,102800,0,125800
142437601400000,SE 223,RESIDENTIAL,20600,0,20600,91000,0,111600
142437601500000,SE 223,RESIDENTIAL,20900,0,20900,117700,0,138600
142437601600000,SE 223,RESIDENTIAL,21000,0,21000,129900,0,150900
142437601700000,SE 223,RESIDENTIAL,20000,0,20000,68400,0,88400
142437601800000,SE 223,RESIDENTIAL,20400,0,20400,100000,0,120400
142437601900000,SE 223,RESIDENTIAL,20600,0,20600,110900,0,131500
142437602000000,SE 223,RESIDENTIAL,25100,0,25100,144000,0,169100
142437602100000,SE 223,RESIDENTIAL,23300,0,23300,102700,0,126000
142437602200000,SE 223,RESIDENTIAL,20600,0,20600,135800,0,156400
142437602300000,SE 223,RESIDENTIAL,19700,0,19700,123500,0,143200
142437602400000,SE 223,RESIDENTIAL,19900,0,19900,117700,0,137600
142437602500000,SE 223,RESIDENTIAL,21300,0,21300,113100,0,134400
142437602600000,SE 223,RESIDENTIAL,23500,0,23500,140300,0,163800
142437602700000,SE 223,RESIDENTIAL,23500,0,23500,144700,0,168200
142437602800000,SE 223,RESIDENTIAL,23400,0,23400,81800,0,105200
142437602900000,SE 223,RESIDENTIAL,23400,0,23400,116000,0,139400
142437603000000,SE 223,RESIDENTIAL,23400,0,23400,81500,0,104900
142437603100000,SE 223,RESIDENTIAL,23400,0,23400,114400,0,137800
142437603200000,SE 223,RESIDENTIAL,23400,0,23400,91700,0,115100
142437603300000,SE 223,RESIDENTIAL,23400,0,23400,89300,0,112700
142437603400000,SE 223,RESIDENTIAL,22600,0,22600,83300,0,105900
142437603500000,SE 223,RESIDENTIAL,22000,0,22000,87400,0,109400
142437603600000,SE 223,RESIDENTIAL,23900,0,23900,99500,0,123400
142437603700000,SE 223,RESIDENTIAL,24100,0,24100,103600,0,127700
142437603800000,SE 223,RESIDENTIAL,24100,0,24100,101700,0,125800
142437603900000,SE 223,RESIDENTIAL,20300,0,20300,113400,0,133700
142437604000000,SE 223,RESIDENTIAL,21300,0,21300,120200,0,141500
142437604100000,SE 223,RESIDENTIAL,24500,0,24500,112900,0,137400
142437604200000,SE 223,RESIDENTIAL,24500,0,24500,104400,0,128900
142437604300000,SE 223,RESIDENTIAL,20800,0,20800,85200,0,106000
142437604400000,SE 223,RESIDENTIAL,21600,0,21600,100900,0,122500
142437604500000,SE 223,RESIDENTIAL,21400,0,21400,122300,0,143700
142437604600000,SE 223,RESIDENTIAL,22300,0,22300,124400,0,146700
142437604700000,SE 223,RESIDENTIAL,25300,0,25300,122300,0,147600
142437604800000,SE 223,RESIDENTIAL,26000,0,26000,116400,0,142400
142437700100000,SE 223,RESIDENTIAL,23300,0,23300,78500,0,101800
142437700200000,SE 223,RESIDENTIAL,23300,0,23300,112600,0,135900
142437700300000,SE 223,RESIDENTIAL,23300,0,23300,67400,0,90700
142437700400000,SE 223,RESIDENTIAL,23300,0,23300,82900,0,106200
142437700500000,SE 223,RESIDENTIAL,23300,0,23300,94700,0,118000
142437700600000,SE 223,RESIDENTIAL,22700,0,22700,102100,0,124800
142437700700000,SE 223,RESIDENTIAL,22700,0,22700,97500,0,120200
142437700800000,SE 223,RESIDENTIAL,22700,0,22700,87600,0,110300
142437700900000,SE 223,RESIDENTIAL,22000,0,22000,103200,0,125200
142437701000000,SE 223,RESIDENTIAL,23100,0,23100,74800,0,97900
142437701100000,SE 223,RESIDENTIAL,22800,0,22800,116400,0,139200
142437701200000,SE 223,RESIDENTIAL,22900,0,22900,120800,0,143700
142437701300000,SE 223,RESIDENTIAL,22600,0,22600,99200,0,121800
142437701400000,SE 223,RESIDENTIAL,25800,0,25800,100300,0,126100
142437701500000,SE 223,RESIDENTIAL,26300,0,26300,117700,0,144000
142437701600000,SE 223,RESIDENTIAL,26200,0,26200,100000,0,126200
142437701700000,SE 223,RESIDENTIAL,31200,0,31200,108400,0,139600
142437701800000,SE 223,RESIDENTIAL,29000,0,29000,111300,0,140300
142437701900000,SE 223,RESIDENTIAL,29100,0,29100,116000,0,145100
142437702000000,SE 223,RESIDENTIAL,29100,0,29100,98800,0,127900
142437702100000,SE 223,RESIDENTIAL,29100,0,29100,122100,0,151200
142437702200000,SE 223,RESIDENTIAL,29100,0,29100,113900,0,143000
142437800100000,SE 223,RESIDENTIAL,29600,0,29600,158300,0,187900
142437800200000,SE 223,RESIDENTIAL,30800,0,30800,116700,0,147500
142437800300000,SE 223,RESIDENTIAL,30800,0,30800,129200,0,160000
142437800400000,SE 223,RESIDENTIAL,26100,0,26100,112100,0,138200
142437800500000,SE 223,RESIDENTIAL,23100,0,23100,120000,0,143100
142437800600000,SE 223,RESIDENTIAL,28500,0,28500,116600,0,145100
142437800700000,SE 223,RESIDENTIAL,23900,0,23900,108800,0,132700
142437800800000,SE 223,RESIDENTIAL,25600,0,25600,111400,0,137000
142437800900000,SE 223,RESIDENTIAL,26500,0,26500,87200,0,113700
142437801000000,SE 223,RESIDENTIAL,21800,0,21800,93800,0,115600
142437801100000,SE 223,RESIDENTIAL,22000,0,22000,103100,0,125100
142437801200000,SE 223,RESIDENTIAL,22300,0,22300,98700,0,121000
142437801300000,SE 223,RESIDENTIAL,22200,0,22200,115500,0,137700
142437801400000,SE 223,RESIDENTIAL,23100,0,23100,104400,0,127500
142437801500000,SE 223,RESIDENTIAL,25400,0,25400,84700,0,110100
142437801600000,SE 223,RESIDENTIAL,24500,0,24500,97000,0,121500
142437801700000,SE 223,RESIDENTIAL,25500,0,25500,101600,0,127100
142437801800000,SE 223,RESIDENTIAL,25600,0,25600,93100,0,118700
142437900100000,SE 223,RESIDENTIAL,22900,0,22900,71600,0,94500
142437900200000,SE 223,RESIDENTIAL,21200,0,21200,73100,0,94300
142437900300000,SE 223,RESIDENTIAL,20200,0,20200,119300,0,139500
142437900400000,SE 223,RESIDENTIAL,20200,0,20200,103600,0,123800
142437900500000,SE 223,RESIDENTIAL,20200,0,20200,118600,0,138800
142437900600000,SE 223,RESIDENTIAL,20200,0,20200,89000,0,109200
142437900700000,SE 223,RESIDENTIAL,20200,0,20200,115500,0,135700
142437900800000,SE 223,RESIDENTIAL,20900,0,20900,83000,0,103900
142437900900000,SE 223,RESIDENTIAL,21800,0,21800,159300,0,181100
142437901000000,SE 223,RESIDENTIAL,20200,0,20200,94400,0,114600
142437901100000,SE 223,RESIDENTIAL,20200,0,20200,96200,0,116400
142437901200000,SE 223,RESIDENTIAL,20200,0,20200,98100,0,118300
142437901300000,SE 223,RESIDENTIAL,20200,0,20200,88400,0,108600
142437901400000,SE 223,RESIDENTIAL,20200,0,20200,95400,0,115600
142437901500000,SE 223,RESIDENTIAL,21200,0,21200,90000,0,111200
142437901600000,SE 223,RESIDENTIAL,22900,0,22900,118300,0,141200
142437901700000,SE 223,RESIDENTIAL,21800,0,21800,93900,0,115700
142438000100000,SE 223,RESIDENTIAL,22400,0,22400,92300,0,114700
142438000200000,SE 223,RESIDENTIAL,22500,0,22500,94600,0,117100
142438000300000,SE 223,RESIDENTIAL,22500,0,22500,96700,0,119200
142438000400000,SE 223,RESIDENTIAL,22600,0,22600,66700,0,89300
142438000500000,SE 223,RESIDENTIAL,21400,0,21400,77500,0,98900
142438000600000,SE 223,RESIDENTIAL,21600,0,21600,97800,0,119400
142438000700000,SE 223,RESIDENTIAL,21300,0,21300,97800,0,119100
142438000800000,SE 223,RESIDENTIAL,22200,0,22200,87000,0,109200
142438000900000,SE 223,RESIDENTIAL,21500,0,21500,108600,0,130100
142438001000000,SE 223,RESIDENTIAL,21500,0,21500,64400,0,85900
142438001100000,SE 223,RESIDENTIAL,21300,0,21300,81100,0,102400
142438001200000,SE 223,RESIDENTIAL,21600,0,21600,85800,0,107400
142438001300000,SE 223,RESIDENTIAL,21600,0,21600,87300,0,108900
142438001400000,SE 223,RESIDENTIAL,20400,0,20400,93700,0,114100
142438001500000,SE 223,RESIDENTIAL,21600,0,21600,98000,0,119600
142438001600000,SE 223,RESIDENTIAL,21200,0,21200,86200,0,107400
142438001700000,SE 223,RESIDENTIAL,21300,0,21300,103000,0,124300
142438100100000,SE 223,RESIDENTIAL,23200,0,23200,126400,0,149600
142438100200000,SE 223,RESIDENTIAL,20400,0,20400,92300,0,112700
142438100300000,SE 223,RESIDENTIAL,20400,0,20400,97000,0,117400
142438100400000,SE 223,RESIDENTIAL,20400,0,20400,78500,0,98900
142438100500000,SE 223,RESIDENTIAL,20400,0,20400,93700,0,114100
142438100600000,SE 223,RESIDENTIAL,20400,0,20400,95800,0,116200
142438100700000,SE 223,RESIDENTIAL,21000,0,21000,101100,0,122100
142438100800000,SE 223,RESIDENTIAL,21700,0,21700,140800,0,162500
142438100900000,SE 223,RESIDENTIAL,21500,0,21500,86100,0,107600
142438101000000,SE 223,RESIDENTIAL,21000,0,21000,96500,0,117500
142438101100000,SE 223,RESIDENTIAL,20400,0,20400,82300,0,102700
142438101200000,SE 223,RESIDENTIAL,20400,0,20400,81600,0,102000
142438101300000,SE 223,RESIDENTIAL,20400,0,20400,85300,0,105700
142438101400000,SE 223,RESIDENTIAL,20400,0,20400,64400,0,84800
142438101500000,SE 223,RESIDENTIAL,20400,0,20400,100300,0,120700
142438101600000,SE 223,RESIDENTIAL,23500,0,23500,94100,0,117600
142438101700000,SE 223,RESIDENTIAL,22100,0,22100,115300,0,137400
142440100100000,SE 220,RESIDENTIAL,38900,0,38900,295700,0,334600
142440200100000,SE 220,RESIDENTIAL,44100,0,44100,177000,0,221100
142440200200000,SE 220,RESIDENTIAL,6700,0,6700,0,0,6700
142440200400000,SE 220,RESIDENTIAL,103800,0,103800,272100,0,375900
142440200500000,SE 220,RESIDENTIAL,152600,0,152600,474000,0,626600
142440200600000,SE 220,RESIDENTIAL,42700,0,42700,162800,0,205500
142440200700000,SE 220,RESIDENTIAL,43300,0,43300,233500,0,276800
142440200800000,SE 220,RESIDENTIAL,48300,0,48300,214100,0,262400
142440200900000,SE 220,RESIDENTIAL,63000,0,63000,241200,0,304200
142440201000000,SE 220,RESIDENTIAL,43900,0,43900,166600,0,210500
142440201100000,SE 220,RESIDENTIAL,44500,0,44500,230500,0,275000
142440201200000,SE 220,RESIDENTIAL,44100,0,44100,126200,0,170300
142440201300000,SE 220,RESIDENTIAL,41200,0,41200,190900,0,232100
142440201400000,SE 220,RESIDENTIAL,43900,0,43900,167900,0,211800
142440201500000,SE 220,RESIDENTIAL,42400,0,42400,203100,0,245500
142440201600000,SE 220,RESIDENTIAL,43000,0,43000,148300,0,191300
142440201700000,SE 220,RESIDENTIAL,46900,0,46900,162100,0,209000
142440201800000,SE 220,RESIDENTIAL,46400,0,46400,167300,0,213700
142440300100000,SE 220,RESIDENTIAL,34000,0,34000,204900,0,238900
142440300200000,SE 220,RESIDENTIAL,39300,0,39300,270200,0,309500
142440400100000,SE 220,RESIDENTIAL,33300,0,33300,157000,0,190300
142440400200000,SE 220,RESIDENTIAL,46700,0,46700,127800,0,174500
142440400300000,SE 220,RESIDENTIAL,41900,0,41900,195800,0,237700
142440400400000,SE 220,RESIDENTIAL,38400,0,38400,226400,0,264800
142440400500000,SE 220,RESIDENTIAL,35700,0,35700,245700,0,281400
142440400600000,SE 220,RESIDENTIAL,34900,0,34900,169200,0,204100
142440400700000,SE 220,RESIDENTIAL,33600,0,33600,169800,0,203400
142440400800000,SE 220,RESIDENTIAL,38200,0,38200,218400,0,256600
142440400900000,SE 220,RESIDENTIAL,37100,0,37100,219300,0,256400
142440401000000,SE 220,RESIDENTIAL,39300,0,39300,284900,0,324200
142440401100000,SE 220,RESIDENTIAL,4900,0,4900,0,0,4900
142440401200000,SE 220,RESIDENTIAL,40600,0,40600,202600,0,243200
142440401300000,SE 220,RESIDENTIAL,37600,0,37600,165700,0,203300
142442600200000,SE 220,RESIDENTIAL,80100,0,80100,206500,0,286600
142442600400000,SE 220,RESIDENTIAL,72300,0,72300,275700,0,348000
142442600500000,SE 220,RESIDENTIAL,100600,0,100600,280100,0,380700
142442600600000,SE 220,RESIDENTIAL,91300,0,91300,195700,0,287000
142442600700000,SE 220,RESIDENTIAL,106200,0,106200,242400,0,348600
142442600800000,SE 220,RESIDENTIAL,103900,0,103900,246000,0,349900
142442600900000,SE 220,RESIDENTIAL,78800,0,78800,210800,0,289600
142442601000000,SE 220,RESIDENTIAL,99800,0,99800,1087900,0,1187700
142442601100000,SE 220,RESIDENTIAL,120700,0,120700,443500,0,564200
142442700100000,SE 221,RESIDENTIAL,37700,0,37700,146600,0,184300
142442700200000,SE 221,RESIDENTIAL,35400,0,35400,150800,0,186200
142442700300000,SE 221,RESIDENTIAL,33600,0,33600,131400,0,165000
142442700400000,SE 221,RESIDENTIAL,33700,0,33700,163400,0,197100
142442700500000,SE 221,RESIDENTIAL,32000,0,32000,117200,0,149200
142442700600000,SE 221,RESIDENTIAL,75500,0,75500,224000,0,299500
142442700700000,SE 221,RESIDENTIAL,50500,0,50500,0,0,50500
142442700800000,SE 221,RESIDENTIAL,68500,0,68500,242300,0,310800
142442700900000,SE 221,RESIDENTIAL,65700,0,65700,225900,0,291600
142442701000000,SE 221,RESIDENTIAL,70600,0,70600,254500,0,325100
142442701100000,SE 221,RESIDENTIAL,65800,0,65800,264600,0,330400
142442701200000,SE 223,RESIDENTIAL,52600,0,52600,111500,0,164100
142442701600000,SE 221,RESIDENTIAL,52400,0,52400,0,0,52400
142442701800000,SE 221,RESIDENTIAL,34100,0,34100,54200,0,88300
142442701900000,SE 221,RESIDENTIAL,33700,0,33700,129300,0,163000
142442702200000,SE 221,RESIDENTIAL,49200,0,49200,264100,0,313300
142442702400000,SE 221,RESIDENTIAL,32000,0,32000,158100,0,190100
142442702500000,SE 221,RESIDENTIAL,32000,0,32000,162100,0,194100
142442702600000,SE 221,RESIDENTIAL,32500,0,32500,136100,0,168600
142442702700000,SE 221,RESIDENTIAL,35400,0,35400,164600,0,200000
142442702800000,SE 221,RESIDENTIAL,38500,0,38500,164800,0,203300
142442702900000,SE 221,RESIDENTIAL,38500,0,38500,136100,0,174600
142442703000000,SE 221,RESIDENTIAL,0,0,0,0,0,0
142442703100000,SE 221,RESIDENTIAL,0,0,0,0,0,0
142442703400000,SE 221,RESIDENTIAL,62800,0,62800,210500,0,273300
142442800200000,CITY PROPERTY,EXEMPT,0,0,0,0,0,0
142442800300000,SE 223,RESIDENTIAL,52700,0,52700,209400,0,262100
142445100100000,SE 220,RESIDENTIAL,101100,0,101100,340400,0,441500
142445100200000,SE 220,RESIDENTIAL,103800,0,103800,356900,0,460700
142445100300000,SE 220,RESIDENTIAL,106800,0,106800,258800,0,365600
142445100400000,SE 220,RESIDENTIAL,102500,0,102500,299900,0,402400
142445100700000,SE 220,RESIDENTIAL,101100,0,101100,417300,0,518400
142445100800000,SE 220,RESIDENTIAL,85800,0,85800,263200,0,349000
142445100900000,SE 220,RESIDENTIAL,82300,0,82300,325600,0,407900
142445200200000,SE 223,RESIDENTIAL,5200,0,5200,0,0,5200
142445200300000,SE 223,RESIDENTIAL,26300,0,26300,78700,0,105000
142445200400000,SE 223,RESIDENTIAL,25900,0,25900,76700,0,102600
142445200500000,SE 223,RESIDENTIAL,27200,0,27200,105000,0,132200
142445200600000,SE 223,RESIDENTIAL,28700,0,28700,124800,0,153500
142445200800000,SE 221,RESIDENTIAL,32100,0,32100,138400,0,170500
142445200900000,SE 223,RESIDENTIAL,37500,0,37500,33600,0,71100
142445300100000,SE 223,RESIDENTIAL,24100,0,24100,159600,0,183700
142445300200000,SE 223,RESIDENTIAL,24200,0,24200,148400,0,172600
142445300300000,SE 223,RESIDENTIAL,24900,0,24900,142200,0,167100
142445300400000,SE 223,RESIDENTIAL,24600,0,24600,170200,0,194800
142445300500000,SE 223,RESIDENTIAL,24700,0,24700,93600,0,118300
142445300600000,SE 223,RESIDENTIAL,23700,0,23700,94800,0,118500
142445300700000,SE 223,RESIDENTIAL,23400,0,23400,95200,0,118600
142445300800000,SE 223,RESIDENTIAL,23000,0,23000,112800,0,135800
142445300900000,SE 223,RESIDENTIAL,23600,0,23600,123000,0,146600
142445400100000,SE 223,RESIDENTIAL,21600,0,21600,116600,0,138200
142445400200000,SE 223,RESIDENTIAL,20800,0,20800,106000,0,126800
142445400300000,SE 223,RESIDENTIAL,20800,0,20800,110500,0,131300
142445400400000,SE 223,RESIDENTIAL,20800,0,20800,96800,0,117600
142445400500000,SE 223,RESIDENTIAL,20700,0,20700,103100,0,123800
142445400600000,SE 223,RESIDENTIAL,20900,0,20900,82300,0,103200
142445400700000,SE 223,RESIDENTIAL,21300,0,21300,117400,0,138700
142445400800000,SE 223,RESIDENTIAL,21300,0,21300,49200,0,70500
142445400900000,SE 223,RESIDENTIAL,21300,0,21300,99000,0,120300
142445401000000,SE 223,RESIDENTIAL,21200,0,21200,68700,0,89900
142447600100000,SE 220,RESIDENTIAL,40100,0,40100,208300,0,248400
142447600200000,SE 220,RESIDENTIAL,42900,0,42900,213000,0,255900
142447600300000,SE 220,RESIDENTIAL,34200,0,34200,231300,0,265500
142447600400000,SE 220,RESIDENTIAL,45800,0,45800,174900,0,220700
142447600500000,SE 220,RESIDENTIAL,13000,0,13000,50500,0,63500
142447600600000,SE 220,RESIDENTIAL,30400,0,30400,1000,0,31400
142447600700000,SE 220,RESIDENTIAL,42400,0,42400,191300,0,233700
142447600800000,SE 220,RESIDENTIAL,37600,0,37600,130200,0,167800
142447600900000,SE 220,RESIDENTIAL,33400,0,33400,145100,0,178500
142447601000000,SE 220,RESIDENTIAL,32700,0,32700,132800,0,165500
142447601100000,SE 220,RESIDENTIAL,43200,0,43200,228800,0,272000
142447601200000,SE 233,RESIDENTIAL,43700,0,43700,131800,0,175500
142447601300000,SE 233,RESIDENTIAL,1200,0,1200,0,0,1200
142447601400000,SHOP,COMMERCIAL,0,76000,76000,0,44800,120800
142447601700000,SHOP,COMMERCIAL,0,21400,21400,0,0,21400
142447601800000,SE 233,RESIDENTIAL,11600,0,11600,12900,0,24500
142447601900000,SHOP,COMMERCIAL,0,19100,19100,0,0,19100
142447602000000,SHOP,COMMERCIAL,0,67200,67200,0,268200,335400
142447700100000,SE 220,RESIDENTIAL,40100,0,40100,182200,0,222300
142447700200000,SE 220,RESIDENTIAL,140000,0,140000,585000,0,725000
142447700300000,SE 220,RESIDENTIAL,100700,0,100700,307600,0,408300
142447700400000,SE 220,RESIDENTIAL,82300,0,82300,504400,0,586700
142447700500000,SE 220,RESIDENTIAL,100900,0,100900,229600,0,330500
142447700600000,SE 220,RESIDENTIAL,99800,0,99800,378100,0,477900
142447700700000,SE 220,RESIDENTIAL,83000,0,83000,311500,0,394500
142447700800000,SE 220,RESIDENTIAL,78400,0,78400,321000,0,399400
142447700900000,CITY PROPERTY,EXEMPT,0,0,0,0,0,0
142447700902000,ANTENNAS/TOWERS(BLL),COMMERCIAL,0,0,0,0,49900,49900
142447700902001,ANTENNAS/TOWERS(BLL),COMMERCIAL,0,0,0,0,36900,36900
142447701000000,SE 233,RESIDENTIAL,41000,0,41000,84800,0,125800
142447701100000,SE 233,RESIDENTIAL,40200,0,40200,43200,0,83400
142447701300000,SE 220,RESIDENTIAL,41000,0,41000,235600,0,276600
142447701400000,SE 220,RESIDENTIAL,41300,0,41300,208900,0,250200
142447701500000,SE 220,RESIDENTIAL,39200,0,39200,157900,0,197100
142447701600000,SE 220,RESIDENTIAL,39200,0,39200,151100,0,190300
142447701700000,SE 220,RESIDENTIAL,39200,0,39200,155000,0,194200
142447701800000,SE 220,RESIDENTIAL,39200,0,39200,188000,0,227200
142510100400000,SE 233,RESIDENTIAL,37600,0,37600,0,0,37600
142510100700000,SE 233,RESIDENTIAL,36500,0,36500,0,0,36500
142510100800000,SE 233,RESIDENTIAL,37000,0,37000,229000,0,266000
142510100900000,SE 233,RESIDENTIAL,37000,0,37000,0,0,37000
142510101300000,SE 233,RESIDENTIAL,52500,0,52500,165800,0,218300
142510101800000,SE 233,RESIDENTIAL,56200,0,56200,248300,0,304500
142512600100000,VACANT LAND,COMMERCIAL,0,783300,783300,0,0,783300
142512600300000,AUTO REPAIR/SALES,COMMERCIAL,0,269200,269200,0,452400,721600
142512600400000,AUTO REPAIR/SALES,COMMERCIAL,0,123000,123000,0,135300,258300
142512600500000,CARWASH,COMMERCIAL,0,91900,91900,0,148800,240700
142512600600000,OFFICE; MEDICAL,COMMERCIAL,0,132500,132500,0,518500,651000
142515100200000,SE 246,RESIDENTIAL,60200,0,60200,0,0,60200
142515100700000,SE 246,RESIDENTIAL,74400,0,74400,262400,0,336800
142515100800000,SE 246,RESIDENTIAL,73600,0,73600,457900,0,531500
142515100900000,SE 246,RESIDENTIAL,92600,0,92600,230600,0,323200
142515101000000,SE 246,RESIDENTIAL,74700,0,74700,220500,0,295200
142515101100000,SE 246,RESIDENTIAL,67900,0,67900,214700,0,282600
142515101200000,SE 246,RESIDENTIAL,70700,0,70700,238600,0,309300
142520100100000,VACANT LAND,COMMERCIAL,0,193200,193200,0,0,193200
142520100200000,LG DISCOUNT/RETAIL,COMMERCIAL,0,906700,906700,0,3883800,4790500
142520100300000,OFFICE,COMMERCIAL,0,269500,269500,0,150400,419900
142520100400000,OFFICE; MEDICAL,COMMERCIAL,0,420000,420000,0,739700,1159700
142520100500000,SE 234,RESIDENTIAL,19100,0,19100,47800,0,66900
142520100600000,SE 234,RESIDENTIAL,17000,0,17000,34500,0,51500
142520100700000,SE 234,RESIDENTIAL,17000,0,17000,60800,0,77800
142520100800000,SE 234,RESIDENTIAL,17200,0,17200,42400,0,59600
142520100900000,SE 234,RESIDENTIAL,18900,0,18900,30200,0,49100
142520101000000,SE 234,RESIDENTIAL,18300,0,18300,71300,0,89600
142520101100000,SE 234,RESIDENTIAL,19300,0,19300,73800,0,93100
142520101200000,SE 234,RESIDENTIAL,18600,0,18600,86400,0,105000
142520101300000,SE 234,RESIDENTIAL,17300,0,17300,71500,0,88800
142520101400000,SE 234,RESIDENTIAL,16300,0,16300,73000,0,89300
142520101600000,SE 234,RESIDENTIAL,19300,0,19300,86100,0,105400
142520101700000,SE 234,RESIDENTIAL,20600,0,20600,80900,0,101500
142520101800000,SE 234,RESIDENTIAL,21400,0,21400,80400,0,101800
142520101900000,SE 234,RESIDENTIAL,21100,0,21100,78700,0,99800
142520102000000,SE 234,RESIDENTIAL,19500,0,19500,90900,0,110400
142520102100000,SE 234,RESIDENTIAL,20800,0,20800,79800,0,100600
142520102200000,SE 234,RESIDENTIAL,20800,0,20800,84300,0,105100
142520102300000,SE 234,RESIDENTIAL,20800,0,20800,101100,0,121900
142520102400000,SE 234,RESIDENTIAL,20800,0,20800,77700,0,98500
142520102500000,SE 234,RESIDENTIAL,20800,0,20800,93100,0,113900
142520102600000,SE 234,RESIDENTIAL,20800,0,20800,85200,0,106000
142520102700000,SE 234,RESIDENTIAL,20800,0,20800,65900,0,86700
142520102800000,SE 234,RESIDENTIAL,20800,0,20800,95200,0,116000
142520102900000,APARTMENT,EXEMPT,0,475000,475000,0,1801400,2276400
142520200100000,SE 234,RESIDENTIAL,17300,0,17300,69300,0,86600
142520200200000,SE 234,RESIDENTIAL,15800,0,15800,60300,0,76100
142520200300000,SE 234,RESIDENTIAL,17500,0,17500,55500,0,73000
142520200400000,SE 234,RESIDENTIAL,18600,0,18600,58900,0,77500
142520200500000,SE 234,RESIDENTIAL,17500,0,17500,84700,0,102200
142520200600000,SE 234,RESIDENTIAL,17500,0,17500,84400,0,101900
142520200700000,SE 234,RESIDENTIAL,17500,0,17500,56900,0,74400
142520200800000,SE 234,RESIDENTIAL,17500,0,17500,72400,0,89900
142520200900000,SE 234,RESIDENTIAL,17500,0,17500,66300,0,83800
142520201000000,SE 234,RESIDENTIAL,17500,0,17500,81000,0,98500
142520201100000,SE 234,RESIDENTIAL,17300,0,17300,80600,0,97900
142520201200000,SE 234,RESIDENTIAL,17300,0,17300,62200,0,79500
142520201300000,SE 234,RESIDENTIAL,17500,0,17500,67100,0,84600
142520201400000,SE 234,RESIDENTIAL,17500,0,17500,84600,0,102100
142520201500000,SE 234,RESIDENTIAL,17500,0,17500,80400,0,97900
142520201600000,SE 234,RESIDENTIAL,17500,0,17500,66700,0,84200
142520201700000,SE 234,RESIDENTIAL,20100,0,20100,85500,0,105600
142520201800000,SE 234,RESIDENTIAL,20200,0,20200,82300,0,102500
142520300100000,SE 234,RESIDENTIAL,19600,0,19600,74000,0,93600
142520300200000,SE 234,RESIDENTIAL,19700,0,19700,70500,0,90200
142520300300000,SE 234,RESIDENTIAL,19300,0,19300,92300,0,111600
142520300400000,SE 234,RESIDENTIAL,19300,0,19300,85800,0,105100
142520300500000,SE 234,RESIDENTIAL,21000,0,21000,82300,0,103300
142520300600000,SE 234,RESIDENTIAL,21000,0,21000,93000,0,114000
142520300700000,SE 234,RESIDENTIAL,21000,0,21000,92000,0,113000
142520300800000,SE 234,RESIDENTIAL,21000,0,21000,85500,0,106500
142520300900000,SE 234,RESIDENTIAL,21000,0,21000,82800,0,103800
142520301000000,SE 234,RESIDENTIAL,21000,0,21000,79900,0,100900
142520301100000,SE 234,RESIDENTIAL,21000,0,21000,78100,0,99100
142520301200000,SE 234,RESIDENTIAL,21000,0,21000,85900,0,106900
142520301300000,COUNTY PROPERTY,EXEMPT,0,0,0,0,0,0
142522600100000,SE 234,RESIDENTIAL,23200,0,23200,59700,0,82900
142522600200000,SE 234,RESIDENTIAL,20000,0,20000,62100,0,82100
142522600300000,SE 234,RESIDENTIAL,17500,0,17500,80600,0,98100
142522600400000,SE 234,RESIDENTIAL,17500,0,17500,68400,0,85900
142522700100000,SE 234,RESIDENTIAL,23700,0,23700,59500,0,83200
142522700200000,SE 234,RESIDENTIAL,20500,0,20500,48400,0,68900
142522700300000,SE 234,RESIDENTIAL,21600,0,21600,48900,0,70500
142522700400000,SE 234,RESIDENTIAL,21800,0,21800,69800,0,91600
142522700500000,SE 234,RESIDENTIAL,21800,0,21800,76400,0,98200
142522700600000,FRATERNAL,EXEMPT,0,168300,168300,0,102600,270900
142522700700000,OFFICE,COMMERCIAL,0,64800,64800,0,107200,172000
142522700800000,SE 234,RESIDENTIAL,20900,0,20900,98200,0,119100
142522700900000,SE 234,RESIDENTIAL,19700,0,19700,74100,0,93800
142522701000000,SE 234,RESIDENTIAL,20200,0,20200,100700,0,120900
142522701100000,SE 234,RESIDENTIAL,19800,0,19800,87200,0,107000
142522701200000,SE 234,RESIDENTIAL,19800,0,19800,98200,0,118000
142522701300000,SE 234,RESIDENTIAL,19900,0,19900,90800,0,110700
142522701400000,SE 234,RESIDENTIAL,24200,0,24200,53800,0,78000
142522701500000,SE 234,RESIDENTIAL,20100,0,20100,86100,0,106200
142522701600000,SE 234,RESIDENTIAL,20100,0,20100,78700,0,98800
142522701700000,SE 234,RESIDENTIAL,20100,0,20100,68800,0,88900
142522701800000,SE 234,RESIDENTIAL,20100,0,20100,90900,0,111000
142522701900000,SE 234,RESIDENTIAL,21300,0,21300,69300,0,90600
142522702000000,SE 234,RESIDENTIAL,21400,0,21400,92700,0,114100
142522702100000,SE 234,RESIDENTIAL,25100,0,25100,102300,0,127400
142522702200000,SE 234,RESIDENTIAL,23700,0,23700,97800,0,121500
142522702300000,SE 234,RESIDENTIAL,23700,0,23700,59000,0,82700
142522702400000,SE 234,RESIDENTIAL,23800,0,23800,101300,0,125100
142522702500000,SE 234,RESIDENTIAL,21000,0,21000,92000,0,113000
142522702600000,SE 234,RESIDENTIAL,20600,0,20600,96700,0,117300
142522702700000,SE 234,RESIDENTIAL,20500,0,20500,90000,0,110500
142522702800000,SE 234,RESIDENTIAL,21000,0,21000,89300,0,110300
142522702900000,SE 234,RESIDENTIAL,20300,0,20300,87700,0,108000
142522703000000,SE 234,RESIDENTIAL,20300,0,20300,79500,0,99800
142522703100000,SE 234,RESIDENTIAL,20300,0,20300,60500,0,80800
142522703200000,SE 234,RESIDENTIAL,20500,0,20500,90900,0,111400
142522703300000,SE 234,RESIDENTIAL,21200,0,21200,81600,0,102800
142522703400000,SE 234,RESIDENTIAL,21600,0,21600,87100,0,108700
142522703500000,SE 234,RESIDENTIAL,21000,0,21000,78100,0,99100
142522703600000,SE 234,RESIDENTIAL,21000,0,21000,69700,0,90700
142522703700000,SE 234,RESIDENTIAL,21000,0,21000,75200,0,96200
142522703800000,SE 234,RESIDENTIAL,21000,0,21000,68100,0,89100
142522703900000,SE 234,RESIDENTIAL,21000,0,21000,83400,0,104400
142522704000000,SE 234,RESIDENTIAL,22100,0,22100,85200,0,107300
142522704100000,SE 234,RESIDENTIAL,23000,0,23000,93300,0,116300
142522704200000,SE 234,RESIDENTIAL,23200,0,23200,94700,0,117900
142522704300000,SE 234,RESIDENTIAL,25000,0,25000,87800,0,112800
142522704400000,SE 234,RESIDENTIAL,23200,0,23200,86400,0,109600
142522704500000,SE 234,RESIDENTIAL,21200,0,21200,66600,0,87800
142522704600000,SE 234,RESIDENTIAL,20500,0,20500,56800,0,77300
142522800100000,LG DISCOUNT/RETAIL,COMMERCIAL,0,570000,570000,0,933900,1503900
142522800200000,BRANCH BANK/CU,COMMERCIAL,0,177600,177600,0,210400,388000
142522800300000,SE 234,RESIDENTIAL,25300,0,25300,90600,0,115900
142522800400000,SE 234,RESIDENTIAL,25600,0,25600,149400,0,175000
142522800500000,SE 234,RESIDENTIAL,26400,0,26400,121800,0,148200
142522800600000,SE 234,RESIDENTIAL,20600,0,20600,123500,0,144100
142522800700000,SE 234,RESIDENTIAL,22100,0,22100,84600,0,106700
142522800800000,SE 234,RESIDENTIAL,22900,0,22900,92700,0,115600
142522800900000,SE 234,RESIDENTIAL,22800,0,22800,92700,0,115500
142522801000000,SE 234,RESIDENTIAL,22000,0,22000,104400,0,126400
142522801100000,SE 234,RESIDENTIAL,20500,0,20500,112100,0,132600
142522801200000,SE 234,RESIDENTIAL,21000,0,21000,91200,0,112200
142522801300000,SE 234,RESIDENTIAL,25100,0,25100,81800,0,106900
142522801400000,SE 234,RESIDENTIAL,20400,0,20400,86200,0,106600
142522801500000,SE 234,RESIDENTIAL,25700,0,25700,112900,0,138600
142522801600000,SE 234,RESIDENTIAL,24600,0,24600,111000,0,135600
142522801700000,SE 234,RESIDENTIAL,26200,0,26200,107100,0,133300
142522802700000,SE 234,RESIDENTIAL,21000,0,21000,84900,0,105900
142522900100000,SE 234,RESIDENTIAL,24500,0,24500,103400,0,127900
142522900200000,SE 234,RESIDENTIAL,21600,0,21600,73000,0,94600
142522900300000,SE 234,RESIDENTIAL,21600,0,21600,56600,0,78200
142522900400000,SE 234,RESIDENTIAL,22100,0,22100,61300,0,83400
142522900500000,SE 234,RESIDENTIAL,21900,0,21900,76500,0,98400
142522900600000,SE 234,RESIDENTIAL,22100,0,22100,69900,0,92000
142522900700000,SE 234,RESIDENTIAL,19700,0,19700,90900,0,110600
142522900800000,SE 234,RESIDENTIAL,20100,0,20100,90400,0,110500
142522900900000,SE 234,RESIDENTIAL,20300,0,20300,79400,0,99700
142522901000000,SE 234,RESIDENTIAL,20300,0,20300,73800,0,94100
142522901100000,SE 234,RESIDENTIAL,20300,0,20300,85300,0,105600
142522901200000,SE 234,RESIDENTIAL,20800,0,20800,98300,0,119100
142522901300000,SE 234,RESIDENTIAL,20600,0,20600,90700,0,111300
142522901400000,SE 234,RESIDENTIAL,20600,0,20600,80900,0,101500
142522901500000,SE 234,RESIDENTIAL,20600,0,20600,84300,0,104900
142522901600000,SE 234,RESIDENTIAL,20200,0,20200,89900,0,110100
142522901700000,SE 234,RESIDENTIAL,20200,0,20200,81100,0,101300
142522901800000,SE 234,RESIDENTIAL,20200,0,20200,83200,0,103400
142522901900000,SE 234,RESIDENTIAL,20100,0,20100,79300,0,99400
142522902100000,SE 234,RESIDENTIAL,21700,0,21700,87100,0,108800
142522902200000,SE 234,RESIDENTIAL,20200,0,20200,78900,0,99100
142522902300000,SE 234,RESIDENTIAL,20200,0,20200,78300,0,98500
142522902400000,SE 234,RESIDENTIAL,20200,0,20200,91700,0,111900
142522902500000,SE 234,RESIDENTIAL,20200,0,20200,90800,0,111000
142522902600000,SE 234,RESIDENTIAL,20000,0,20000,81500,0,101500
142522902700000,SE 234,RESIDENTIAL,20800,0,20800,86000,0,106800
142522902900000,SE 234,RESIDENTIAL,20300,0,20300,72700,0,93000
142522903000000,SE 234,RESIDENTIAL,20300,0,20300,84500,0,104800
142522903100000,SE 234,RESIDENTIAL,20300,0,20300,79800,0,100100
142522903200000,SE 234,RESIDENTIAL,20300,0,20300,57700,0,78000
142522903300000,SE 234,RESIDENTIAL,19600,0,19600,74300,0,93900
142522903400000,SE 234,RESIDENTIAL,22400,0,22400,64700,0,87100
142522903500000,SE 234,RESIDENTIAL,22500,0,22500,71500,0,94000
142522903600000,SE 234,RESIDENTIAL,27700,0,27700,74600,0,102300
142523000100000,SE 234,RESIDENTIAL,19900,0,19900,74000,0,93900
142523000200000,SE 234,RESIDENTIAL,21700,0,21700,78500,0,100200
142523000300000,SE 234,RESIDENTIAL,21100,0,21100,79100,0,100200
142523000400000,SE 234,RESIDENTIAL,18100,0,18100,75800,0,93900
142523000500000,SE 234,RESIDENTIAL,18700,0,18700,62800,0,81500
142523000600000,SE 234,RESIDENTIAL,19100,0,19100,78400,0,97500
142523000700000,SE 234,RESIDENTIAL,22100,0,22100,78500,0,100600
142523000800000,SE 234,RESIDENTIAL,23200,0,23200,82000,0,105200
142523000900000,SE 234,RESIDENTIAL,23800,0,23800,130400,0,154200
142523001000000,CEMETERY,EXEMPT,0,80200,80200,0,0,80200
142523100100000,SE 234,RESIDENTIAL,20800,0,20800,109100,0,129900
142523100200000,SE 234,RESIDENTIAL,19700,0,19700,147700,0,167400
142523100300000,SE 234,RESIDENTIAL,20800,0,20800,86100,0,106900
142523100400000,SE 234,RESIDENTIAL,22500,0,22500,78900,0,101400
142523100500000,SE 234,RESIDENTIAL,22700,0,22700,100900,0,123600
142523100600000,SE 234,RESIDENTIAL,22500,0,22500,107000,0,129500
142523100700000,SE 234,RESIDENTIAL,20800,0,20800,102300,0,123100
142523100800000,SE 234,RESIDENTIAL,21700,0,21700,110500,0,132200
142523100900000,SE 234,RESIDENTIAL,22100,0,22100,96300,0,118400
142523101000000,SE 234,RESIDENTIAL,32900,0,32900,139600,0,172500
142523101100000,SE 234,RESIDENTIAL,33300,0,33300,163800,0,197100
142523101200000,SE 234,RESIDENTIAL,31400,0,31400,0,0,31400
142523101300000,SE 234,RESIDENTIAL,11100,0,11100,0,0,11100
142523101400000,SE 234,RESIDENTIAL,21700,0,21700,95400,0,117100
142523101500000,SE 234,RESIDENTIAL,21300,0,21300,99700,0,121000
142523101600000,SE 234,RESIDENTIAL,21300,0,21300,134100,0,155400
142523101700000,SE 234,RESIDENTIAL,22400,0,22400,112800,0,135200
142523101800000,SE 234,RESIDENTIAL,26900,0,26900,113400,0,140300
142523200100000,SE 234,RESIDENTIAL,18700,0,18700,0,0,18700
142523200200000,SE 234,RESIDENTIAL,30800,0,30800,315900,0,346700
142523200300000,SE 234,RESIDENTIAL,1200,0,1200,0,0,1200
142525100100000,SE 234,RESIDENTIAL,22900,0,22900,76000,0,98900
142525100200000,SE 234,RESIDENTIAL,23500,0,23500,90200,0,113700
142525100300000,SE 234,RESIDENTIAL,24200,0,24200,86200,0,110400
142525100400000,SE 234,RESIDENTIAL,22700,0,22700,78900,0,101600
142525100500000,SE 234,RESIDENTIAL,22400,0,22400,75500,0,97900
142525200100000,SE 234,RESIDENTIAL,23400,0,23400,83600,0,107000
142525200200000,SE 234,RESIDENTIAL,19900,0,19900,75900,0,95800
142525300100000,SE 234,RESIDENTIAL,22400,0,22400,81900,0,104300
142525300200000,SE 234,RESIDENTIAL,21400,0,21400,85900,0,107300
142525300300000,SE 234,RESIDENTIAL,21200,0,21200,84100,0,105300
142525300400000,SE 234,RESIDENTIAL,21000,0,21000,99200,0,120200
142525300500000,SE 234,RESIDENTIAL,21300,0,21300,86200,0,107500
142525300600000,SE 234,RESIDENTIAL,21000,0,21000,91100,0,112100
142525300700000,SE 234,RESIDENTIAL,21600,0,21600,96500,0,118100
142525300800000,SE 234,RESIDENTIAL,21800,0,21800,89600,0,111400
142525300900000,SE 234,RESIDENTIAL,20400,0,20400,90400,0,110800
142525301000000,SE 234,RESIDENTIAL,21100,0,21100,80700,0,101800
142525301100000,SE 234,RESIDENTIAL,20800,0,20800,113800,0,134600
142525301200000,SE 234,RESIDENTIAL,20800,0,20800,96000,0,116800
142525301300000,SE 234,RESIDENTIAL,20800,0,20800,78100,0,98900
142525301400000,SE 234,RESIDENTIAL,21900,0,21900,112400,0,134300
142525301500000,SE 234,RESIDENTIAL,22200,0,22200,95200,0,117400
142525301600000,SE 234,RESIDENTIAL,21800,0,21800,90700,0,112500
142525301700000,SE 234,RESIDENTIAL,21000,0,21000,95700,0,116700
142525301800000,SE 234,RESIDENTIAL,21700,0,21700,83300,0,105000
142525301900000,SE 234,RESIDENTIAL,21600,0,21600,89800,0,111400
142525302000000,SE 234,RESIDENTIAL,21300,0,21300,87400,0,108700
142525302100000,SE 234,RESIDENTIAL,20800,0,20800,94900,0,115700
142525302200000,SE 234,RESIDENTIAL,21000,0,21000,95800,0,116800
142525302300000,SE 234,RESIDENTIAL,21000,0,21000,125200,0,146200
142525302400000,SE 234,RESIDENTIAL,21000,0,21000,87800,0,108800
142525302500000,SE 234,RESIDENTIAL,21000,0,21000,81500,0,102500
142525302600000,SE 234,RESIDENTIAL,20000,0,20000,95500,0,115500
142525302700000,SE 234,RESIDENTIAL,20000,0,20000,84500,0,104500
142525302800000,SE 234,RESIDENTIAL,20200,0,20200,91300,0,111500
142525302900000,SE 234,RESIDENTIAL,20100,0,20100,71300,0,91400
142525303000000,SE 234,RESIDENTIAL,20100,0,20100,62200,0,82300
142525303100000,SE 234,RESIDENTIAL,20400,0,20400,88900,0,109300
142525400100000,SE 234,RESIDENTIAL,19800,0,19800,98800,0,118600
142525400200000,SE 234,RESIDENTIAL,30000,0,30000,187200,0,217200
142525400300000,SE 234,RESIDENTIAL,22500,0,22500,126900,0,149400
142525400400000,SE 234,RESIDENTIAL,22500,0,22500,152400,0,174900
142525400500000,SE 234,RESIDENTIAL,22500,0,22500,137100,0,159600
142525400600000,SE 234,RESIDENTIAL,22500,0,22500,155000,0,177500
142525400700000,SE 234,RESIDENTIAL,22500,0,22500,132300,0,154800
142525400800000,SE 234,RESIDENTIAL,24300,0,24300,129100,0,153400
142525400900000,SE 234,RESIDENTIAL,24500,0,24500,140200,0,164700
142525401000000,SE 234,RESIDENTIAL,24800,0,24800,163000,0,187800
142525401100000,SE 234,RESIDENTIAL,34500,0,34500,201200,0,235700
142525401200000,SE 234,RESIDENTIAL,23500,0,23500,90200,0,113700
142525401300000,SE 234,RESIDENTIAL,25800,0,25800,118300,0,144100
142525401400000,SE 234,RESIDENTIAL,23700,0,23700,104700,0,128400
142525401500000,SE 234,RESIDENTIAL,20600,0,20600,95900,0,116500
142525401600000,SE 234,RESIDENTIAL,22100,0,22100,74700,0,96800
142525401700000,SE 234,RESIDENTIAL,22300,0,22300,75100,0,97400
142525401800000,SE 234,RESIDENTIAL,24400,0,24400,117000,0,141400
142525401900000,SE 234,RESIDENTIAL,25400,0,25400,89200,0,114600
142525402000000,SE 234,RESIDENTIAL,24200,0,24200,86100,0,110300
142525402100000,SE 234,RESIDENTIAL,20800,0,20800,80200,0,101000
142525402200000,SE 234,RESIDENTIAL,22500,0,22500,86300,0,108800
142525402300000,SE 234,RESIDENTIAL,22100,0,22100,91000,0,113100
142525402400000,SE 234,RESIDENTIAL,21000,0,21000,74200,0,95200
142525402500000,SE 234,RESIDENTIAL,21000,0,21000,70800,0,91800
142525402600000,SE 234,RESIDENTIAL,21000,0,21000,76400,0,97400
142525402700000,SE 234,RESIDENTIAL,21000,0,21000,74500,0,95500
142525402800000,SE 234,RESIDENTIAL,22100,0,22100,75100,0,97200
142525402900000,SE 234,RESIDENTIAL,21800,0,21800,107100,0,128900
142525403000000,SE 234,RESIDENTIAL,21200,0,21200,110300,0,131500
142525403100000,SE 234,RESIDENTIAL,20700,0,20700,95900,0,116600
142525403200000,SE 234,RESIDENTIAL,19900,0,19900,86600,0,106500
142525403300000,SE 234,RESIDENTIAL,19700,0,19700,97800,0,117500
142525403400000,SE 234,RESIDENTIAL,19700,0,19700,81000,0,100700
142525403500000,SE 234,RESIDENTIAL,19700,0,19700,94800,0,114500
142525500100000,SE 234,RESIDENTIAL,30500,0,30500,211200,0,241700
142525500200000,SE 234,RESIDENTIAL,22900,0,22900,200000,0,222900
142525500300000,SE 234,RESIDENTIAL,22900,0,22900,0,0,22900
142525500400000,SE 234,RESIDENTIAL,22200,0,22200,207700,0,229900
142525500500000,SE 234,RESIDENTIAL,23400,0,23400,191700,0,215100
142525500600000,SE 234,RESIDENTIAL,22900,0,22900,184900,0,207800
142525500700000,SE 234,RESIDENTIAL,24800,0,24800,187400,0,212200
142525500800000,SE 234,RESIDENTIAL,24800,0,24800,150800,0,175600
142525500900000,SE 234,RESIDENTIAL,24100,0,24100,208400,0,232500
142525501000000,SE 234,RESIDENTIAL,21700,0,21700,127900,0,149600
142525501100000,SE 234,RESIDENTIAL,21200,0,21200,115200,0,136400
142525501200000,SE 234,RESIDENTIAL,21400,0,21400,76600,0,98000
142525600100000,SE 234,RESIDENTIAL,20600,0,20600,78100,0,98700
142525600200000,SE 234,RESIDENTIAL,20800,0,20800,84900,0,105700
142525600300000,SE 234,RESIDENTIAL,21000,0,21000,91800,0,112800
142525600400000,SE 234,RESIDENTIAL,21500,0,21500,78400,0,99900
142525600500000,SE 234,RESIDENTIAL,21500,0,21500,92400,0,113900
142525600600000,SE 234,RESIDENTIAL,21200,0,21200,72600,0,93800
142525600700000,SE 234,RESIDENTIAL,21500,0,21500,88500,0,110000
142525600800000,SE 234,RESIDENTIAL,21900,0,21900,93100,0,115000
142525600900000,SE 234,RESIDENTIAL,22100,0,22100,99200,0,121300
142525601000000,SE 234,RESIDENTIAL,22200,0,22200,78800,0,101000
142525601100000,SE 234,RESIDENTIAL,21000,0,21000,66000,0,87000
142525601200000,SE 234,RESIDENTIAL,20800,0,20800,86000,0,106800
142525601300000,SE 234,RESIDENTIAL,22300,0,22300,94700,0,117000
142525601400000,SE 234,RESIDENTIAL,23100,0,23100,99000,0,122100
142525601500000,SE 234,RESIDENTIAL,22100,0,22100,78600,0,100700
142525601600000,SE 234,RESIDENTIAL,21200,0,21200,84800,0,106000
142525601700000,SE 234,RESIDENTIAL,24500,0,24500,81700,0,106200
142525601800000,SE 234,RESIDENTIAL,26000,0,26000,118400,0,144400
142525601900000,SE 234,RESIDENTIAL,24000,0,24000,101600,0,125600
142525602000000,SE 234,RESIDENTIAL,23200,0,23200,132000,0,155200
142525602100000,SE 234,RESIDENTIAL,24300,0,24300,117600,0,141900
142525602200000,SE 234,RESIDENTIAL,23700,0,23700,125100,0,148800
142525602300000,SE 234,RESIDENTIAL,20700,0,20700,112800,0,133500
142525602400000,SE 234,RESIDENTIAL,21400,0,21400,97100,0,118500
142525602500000,SE 234,RESIDENTIAL,22300,0,22300,75700,0,98000
142525602600000,SE 234,RESIDENTIAL,20500,0,20500,91200,0,111700
142525602700000,SE 234,RESIDENTIAL,20400,0,20400,86000,0,106400
142525602800000,SE 234,RESIDENTIAL,20800,0,20800,54800,0,75600
142525700100000,SE 234,RESIDENTIAL,22700,0,22700,84200,0,106900
142525700200000,SE 234,RESIDENTIAL,22900,0,22900,83200,0,106100
142525700300000,SE 234,RESIDENTIAL,23700,0,23700,83900,0,107600
142525700400000,SE 234,RESIDENTIAL,23000,0,23000,79700,0,102700
142525700500000,SE 234,RESIDENTIAL,23000,0,23000,71600,0,94600
142525700600000,SE 234,RESIDENTIAL,22700,0,22700,97300,0,120000
142525700700000,SE 234,RESIDENTIAL,22100,0,22100,86400,0,108500
142525700800000,SE 234,RESIDENTIAL,23700,0,23700,80900,0,104600
142525700900000,SE 234,RESIDENTIAL,23300,0,23300,68500,0,91800
142525701000000,SE 234,RESIDENTIAL,22600,0,22600,93900,0,116500
142525701100000,SE 234,RESIDENTIAL,92400,0,92400,0,0,92400
142525800100000,SE 234,RESIDENTIAL,21000,0,21000,102000,0,123000
142525800200000,SE 234,RESIDENTIAL,21000,0,21000,94400,0,115400
142525800300000,SE 234,RESIDENTIAL,21000,0,21000,67900,0,88900
142525800400000,SE 234,RESIDENTIAL,21000,0,21000,96700,0,117700
142525800500000,SE 234,RESIDENTIAL,21000,0,21000,100600,0,121600
142525800600000,SE 234,RESIDENTIAL,20600,0,20600,96500,0,117100
142525800700000,SE 234,RESIDENTIAL,21000,0,21000,97800,0,118800
142525800800000,SE 234,RESIDENTIAL,21000,0,21000,91400,0,112400
142525800900000,SE 234,RESIDENTIAL,21000,0,21000,141300,0,162300
142525801000000,SE 234,RESIDENTIAL,20900,0,20900,101300,0,122200
142525801100000,SE 234,RESIDENTIAL,20800,0,20800,94500,0,115300
142525801200000,SE 234,RESIDENTIAL,20800,0,20800,81000,0,101800
142527600100000,SE 234,RESIDENTIAL,23500,0,23500,67000,0,90500
142527600200000,SE 234,RESIDENTIAL,21800,0,21800,122200,0,144000
142527600300000,SE 234,RESIDENTIAL,20000,0,20000,99800,0,119800
142527600400000,SE 234,RESIDENTIAL,19700,0,19700,84500,0,104200
142527600500000,SE 234,RESIDENTIAL,20700,0,20700,85500,0,106200
142527600600000,SE 234,RESIDENTIAL,20000,0,20000,96800,0,116800
142527600700000,SE 234,RESIDENTIAL,19700,0,19700,105500,0,125200
142527600800000,SE 234,RESIDENTIAL,19700,0,19700,114800,0,134500
142527600900000,SE 234,RESIDENTIAL,20000,0,20000,108600,0,128600
142527601000000,SE 234,RESIDENTIAL,19700,0,19700,81700,0,101400
142527601100000,SE 234,RESIDENTIAL,20300,0,20300,91300,0,111600
142527700100000,SE 234,RESIDENTIAL,20900,0,20900,103300,0,124200
142527700200000,SE 234,RESIDENTIAL,20800,0,20800,87500,0,108300
142527700300000,SE 234,RESIDENTIAL,20800,0,20800,82100,0,102900
142527700400000,SE 234,RESIDENTIAL,20800,0,20800,106700,0,127500
142527700500000,SE 234,RESIDENTIAL,20800,0,20800,73300,0,94100
142527700600000,SE 234,RESIDENTIAL,20800,0,20800,78400,0,99200
142527700700000,SE 234,RESIDENTIAL,21900,0,21900,87600,0,109500
142527700800000,SE 234,RESIDENTIAL,21300,0,21300,86600,0,107900
142527700900000,SE 234,RESIDENTIAL,14300,0,14300,90000,0,104300
142527701000000,SE 234,RESIDENTIAL,14800,0,14800,5900,0,20700
142527701100000,SE 234,RESIDENTIAL,21600,0,21600,94700,0,116300
142527701200000,SE 234,RESIDENTIAL,21400,0,21400,103500,0,124900
142527800100000,SE 234,RESIDENTIAL,21000,0,21000,88700,0,109700
142527800200000,SE 234,RESIDENTIAL,21000,0,21000,88800,0,109800
142527800300000,SE 234,RESIDENTIAL,21000,0,21000,72000,0,93000
142527800400000,SE 234,RESIDENTIAL,21000,0,21000,82500,0,103500
142527800500000,SE 234,RESIDENTIAL,21400,0,21400,73400,0,94800
142527800600000,SE 234,RESIDENTIAL,21500,0,21500,79600,0,101100
142527900100000,SE 234,RESIDENTIAL,21100,0,21100,66400,0,87500
142527900200000,SE 234,RESIDENTIAL,22000,0,22000,108500,0,130500
142527900300000,SE 234,RESIDENTIAL,21600,0,21600,109800,0,131400
142527900400000,SE 234,RESIDENTIAL,20800,0,20800,92500,0,113300
142527900500000,SE 234,RESIDENTIAL,20300,0,20300,75100,0,95400
142527900600000,SE 234,RESIDENTIAL,20600,0,20600,103300,0,123900
142527900700000,SE 234,RESIDENTIAL,20300,0,20300,90200,0,110500
142527900800000,SE 234,RESIDENTIAL,20300,0,20300,104900,0,125200
142527900900000,SE 234,RESIDENTIAL,20300,0,20300,85000,0,105300
142527901000000,SE 234,RESIDENTIAL,20300,0,20300,137600,0,157900
142527901100000,SE 234,RESIDENTIAL,20700,0,20700,90700,0,111400
142527901200000,SE 234,RESIDENTIAL,20500,0,20500,86200,0,106700
142527901300000,SE 234,RESIDENTIAL,20800,0,20800,90400,0,111200
142527901400000,SE 234,RESIDENTIAL,20700,0,20700,83900,0,104600
142527901500000,SE 234,RESIDENTIAL,22000,0,22000,66500,0,88500
142527901600000,SE 234,RESIDENTIAL,21700,0,21700,92800,0,114500
142527901700000,SE 234,RESIDENTIAL,21300,0,21300,101600,0,122900
142527901800000,SE 234,RESIDENTIAL,21200,0,21200,85700,0,106900
142527901900000,SE 234,RESIDENTIAL,21600,0,21600,114600,0,136200
142527902000000,SE 234,RESIDENTIAL,21300,0,21300,113100,0,134400
142527902100000,SE 234,RESIDENTIAL,21700,0,21700,63200,0,84900
142527902200000,SE 234,RESIDENTIAL,22800,0,22800,107300,0,130100
142527902300000,SE 234,RESIDENTIAL,22100,0,22100,51600,0,73700
142527902400000,SE 234,RESIDENTIAL,26200,0,26200,66800,0,93000
142527902500000,SE 234,RESIDENTIAL,20700,0,20700,93300,0,114000
142528000100000,SE 234,RESIDENTIAL,21000,0,21000,41600,0,62600
142528000200000,SE 234,RESIDENTIAL,21000,0,21000,90900,0,111900
142528000300000,SE 234,RESIDENTIAL,22300,0,22300,82600,0,104900
142528000400000,SE 234,RESIDENTIAL,23600,0,23600,122600,0,146200
142528000500000,SE 234,RESIDENTIAL,23600,0,23600,92400,0,116000
142528000600000,SE 234,RESIDENTIAL,25000,0,25000,74000,0,99000
142528000700000,SE 234,RESIDENTIAL,24900,0,24900,85800,0,110700
142528000800000,SE 234,RESIDENTIAL,24900,0,24900,81700,0,106600
142528000900000,SE 234,RESIDENTIAL,24700,0,24700,112400,0,137100
142528001000000,SE 234,RESIDENTIAL,24800,0,24800,87700,0,112500
142528001100000,SE 234,RESIDENTIAL,24200,0,24200,94000,0,118200
142528001200000,SE 234,RESIDENTIAL,23800,0,23800,66800,0,90600
142528001300000,SE 234,RESIDENTIAL,21700,0,21700,78500,0,100200
142528001400000,SE 234,RESIDENTIAL,23700,0,23700,84800,0,108500
142528001500000,SE 234,RESIDENTIAL,23000,0,23000,0,0,23000
142528001600000,SE 234,RESIDENTIAL,30500,0,30500,0,0,30500
142528001700000,SE 234,RESIDENTIAL,53400,0,53400,285100,0,338500
142528001800000,SE 234,RESIDENTIAL,54000,0,54000,202900,0,256900
142528001900000,SE 234,RESIDENTIAL,45800,0,45800,257200,0,303000
142528002000000,SE 234,RESIDENTIAL,27000,0,27000,0,0,27000
142528002100000,SE 234,RESIDENTIAL,27000,0,27000,0,0,27000
142528002200000,SE 234,RESIDENTIAL,52200,0,52200,264300,0,316500
142528002300000,SE 234,RESIDENTIAL,35500,0,35500,0,0,35500
142528002400000,SE 234,RESIDENTIAL,29600,0,29600,0,0,29600
142528002500000,SE 234,RESIDENTIAL,57900,0,57900,355500,0,413400
142528002600000,SE 234,RESIDENTIAL,55300,0,55300,318600,0,373900
142528002700000,SE 234,RESIDENTIAL,36600,0,36600,0,0,36600
142528002800000,SE 234,RESIDENTIAL,50000,0,50000,320400,0,370400
142528002900000,SE 234,RESIDENTIAL,60500,0,60500,352300,0,412800
142528003000000,SE 234,RESIDENTIAL,60400,0,60400,341000,0,401400
142528003100000,SE 234,RESIDENTIAL,52400,0,52400,270500,0,322900
142528003200000,SE 234,RESIDENTIAL,59400,0,59400,269400,0,328800
142528003300000,CITY PROPERTY,EXEMPT,0,0,0,0,0,0
142528100100000,SE 234,RESIDENTIAL,24500,0,24500,74200,0,98700
142528100200000,SE 234,RESIDENTIAL,20300,0,20300,88300,0,108600
142528100300000,SE 234,RESIDENTIAL,20800,0,20800,71300,0,92100
142528100400000,SE 234,RESIDENTIAL,20800,0,20800,72100,0,92900
142528100500000,SE 234,RESIDENTIAL,20800,0,20800,90500,0,111300
142528100600000,SE 234,RESIDENTIAL,20800,0,20800,80000,0,100800
142528100700000,SE 234,RESIDENTIAL,20800,0,20800,105900,0,126700
142528100800000,SE 234,RESIDENTIAL,20800,0,20800,59600,0,80400
142528100900000,SE 234,RESIDENTIAL,20800,0,20800,76500,0,97300
142528101000000,SE 234,RESIDENTIAL,24800,0,24800,80300,0,105100
142528101100000,SE 234,RESIDENTIAL,22400,0,22400,74400,0,96800
142528101200000,SE 234,RESIDENTIAL,33000,0,33000,0,0,33000
142528200100000,SE 234,RESIDENTIAL,22000,0,22000,85300,0,107300
142528200200000,SE 234,RESIDENTIAL,21000,0,21000,87500,0,108500
142528200300000,SE 234,RESIDENTIAL,20600,0,20600,76600,0,97200
142528200400000,SE 234,RESIDENTIAL,20800,0,20800,79100,0,99900
142528200500000,SE 234,RESIDENTIAL,20800,0,20800,81700,0,102500
142528200600000,SE 234,RESIDENTIAL,20800,0,20800,79000,0,99800
142528200700000,SE 234,RESIDENTIAL,20800,0,20800,77900,0,98700
142528200800000,SE 234,RESIDENTIAL,20800,0,20800,77600,0,98400
142528300100000,SE 234,RESIDENTIAL,20800,0,20800,81200,0,102000
142528300200000,SE 234,RESIDENTIAL,20800,0,20800,97500,0,118300
142528400100000,SE 234,RESIDENTIAL,20800,0,20800,79000,0,99800
142528400200000,SE 234,RESIDENTIAL,24100,0,24100,112900,0,137000
142530100100000,SE 239,RESIDENTIAL,59100,0,59100,0,0,59100
142530100300000,SE 239,RESIDENTIAL,71900,0,71900,147700,0,219600
142530100400000,SE 239,RESIDENTIAL,71900,0,71900,6400,0,78300
142530100500000,SE 239,RESIDENTIAL,45400,0,45400,262100,0,307500
142530100600000,SE 239,RESIDENTIAL,42400,0,42400,168900,0,211300
142530100700000,SE 239,RESIDENTIAL,50400,0,50400,259400,0,309800
142530100800000,SE 239,RESIDENTIAL,53100,0,53100,193500,0,246600
142530100900000,SE 239,RESIDENTIAL,63900,0,63900,207300,0,271200
142530101000000,SE 239,RESIDENTIAL,60600,0,60600,238600,0,299200
142530101100000,SE 239,RESIDENTIAL,56800,0,56800,256000,0,312800
142530101200000,SE 239,RESIDENTIAL,52400,0,52400,256700,0,309100
142530101300000,SE 239,RESIDENTIAL,53300,0,53300,250300,0,303600
142530101400000,SE 239,RESIDENTIAL,46600,0,46600,194200,0,240800
142530101500000,SE 246,RESIDENTIAL,62900,0,62900,207700,0,270600
142530101600000,SE 239,RESIDENTIAL,59900,0,59900,193800,0,253700
142530101700000,SE 239,RESIDENTIAL,54900,0,54900,193500,0,248400
142530101800000,SE 239,RESIDENTIAL,58900,0,58900,35000,0,93900
142530101900000,SE 239,RESIDENTIAL,56600,0,56600,229300,0,285900
142530102000000,CITY PROPERTY,EXEMPT,0,0,0,0,0,0
142530102100000,SE 239,RESIDENTIAL,54100,0,54100,269700,0,323800
142530102200000,SE 239,RESIDENTIAL,56700,0,56700,214600,0,271300
142530102300000,SE 239,RESIDENTIAL,56000,0,56000,236600,0,292600
142530200100000,SE 239,RESIDENTIAL,45800,0,45800,159900,0,205700
142530200200000,SE 239,RESIDENTIAL,56200,0,56200,200100,0,256300
142530300100000,SE 239,RESIDENTIAL,55600,0,55600,286700,0,342300
142530300200000,SE 239,RESIDENTIAL,52000,0,52000,225400,0,277400
142530300300000,SE 239,RESIDENTIAL,53100,0,53100,243300,0,296400
142530300400000,SE 239,RESIDENTIAL,52700,0,52700,209000,0,261700
142530300500000,SE 239,RESIDENTIAL,57100,0,57100,222000,0,279100
142530300600000,SE 239,RESIDENTIAL,57100,0,57100,195800,0,252900
142530300700000,SE 239,RESIDENTIAL,55200,0,55200,220200,0,275400
142530300800000,SE 239,RESIDENTIAL,55100,0,55100,229700,0,284800
142530300900000,SE 239,RESIDENTIAL,48400,0,48400,163200,0,211600
142530301000000,SE 239,RESIDENTIAL,50200,0,50200,195300,0,245500
142532600100000,SE 239,RESIDENTIAL,125700,0,125700,0,0,125700
142532600300000,SE 242,RESIDENTIAL,49600,0,49600,92500,0,142100
142532600600000,SE 242,RESIDENTIAL,49600,0,49600,125000,0,174600
142532600700000,SE 242,RESIDENTIAL,49800,0,49800,14500,0,64300
142532600900000,SE 242,RESIDENTIAL,40000,0,40000,120400,0,160400
142532601100000,SE 239,RESIDENTIAL,54700,0,54700,165500,0,220200
142532601200000,SE 239,RESIDENTIAL,39400,0,39400,0,0,39400
142532601300000,SE 239,RESIDENTIAL,43700,0,43700,205700,0,249400
142532601400000,SE 239,RESIDENTIAL,66100,0,66100,173400,0,239500
142532601500000,SE 239,RESIDENTIAL,54000,0,54000,177800,0,231800
142532601600000,SE 239,RESIDENTIAL,54500,0,54500,189200,0,243700
142532601700000,SE 239,RESIDENTIAL,43700,0,43700,156800,0,200500
142532601800000,SE 239,RESIDENTIAL,46300,0,46300,161200,0,207500
142532601900000,SE 239,RESIDENTIAL,51900,0,51900,168600,0,220500
142532602000000,SE 242,RESIDENTIAL,41500,0,41500,169500,0,211000
142532602100000,SE 242,RESIDENTIAL,17800,0,17800,0,0,17800
142540100500000,SE 246,RESIDENTIAL,99800,0,99800,93500,0,193300
142540100600000,SE 246,RESIDENTIAL,77100,0,77100,0,0,77100
142540100700000,SE 246,RESIDENTIAL,73300,0,73300,0,0,73300
142540100800000,SE 246,RESIDENTIAL,71900,0,71900,348900,0,420800
142540100900000,SE 246,RESIDENTIAL,71300,0,71300,98200,0,169500
142540101000000,SE 246,RESIDENTIAL,73300,0,73300,279000,0,352300
142540101100000,SE 246,RESIDENTIAL,71700,0,71700,349900,0,421600
142540101200000,SE 246,RESIDENTIAL,115900,0,115900,287600,0,403500
142540101300000,SE 246,RESIDENTIAL,87700,0,87700,269300,0,357000
142540101400000,SE 246,RESIDENTIAL,86000,0,86000,344600,0,430600
142540101500000,SE 246,RESIDENTIAL,82300,0,82300,0,0,82300
142540101700000,SE 246,RESIDENTIAL,85100,0,85100,251800,0,336900
142540101800000,SE 246,RESIDENTIAL,88300,0,88300,255000,0,343300
142540101900000,SE 246,RESIDENTIAL,125700,0,125700,647800,0,773500
142540200100000,SE 246,RESIDENTIAL,83000,0,83000,273500,0,356500
142540200200000,SE 246,RESIDENTIAL,92200,0,92200,259200,0,351400
142540200300000,SE 246,RESIDENTIAL,82000,0,82000,258200,0,340200
142540200400000,SE 246,RESIDENTIAL,80100,0,80100,379300,0,459400
142540200500000,SE 246,RESIDENTIAL,104900,0,104900,317500,0,422400
142540200600000,SE 246,RESIDENTIAL,6000,0,6000,0,0,6000
142540200700000,SE 246,RESIDENTIAL,5300,0,5300,0,0,5300
142540200800000,SE 246,RESIDENTIAL,5500,0,5500,0,0,5500
142540200900000,SE 246,RESIDENTIAL,9600,0,9600,0,0,9600
142540201000000,SE 246,RESIDENTIAL,6900,0,6900,0,0,6900
142540201100000,SE 246,RESIDENTIAL,97200,0,97200,320500,0,417700
142540201200000,SE 246,RESIDENTIAL,100300,0,100300,311800,0,412100
142540201300000,SE 246,RESIDENTIAL,97400,0,97400,360700,0,458100
142540201400000,SE 246,RESIDENTIAL,7900,0,7900,0,0,7900
142540201500000,SE 246,RESIDENTIAL,5600,0,5600,0,0,5600
142540201600000,SE 246,RESIDENTIAL,5700,0,5700,0,0,5700
142540201700000,SE 246,RESIDENTIAL,8000,0,8000,0,0,8000
142540201800000,SE 246,RESIDENTIAL,11600,0,11600,0,0,11600
142542600100000,SE 246,RESIDENTIAL,72100,0,72100,192500,0,264600
142542600200000,SE 246,RESIDENTIAL,69800,0,69800,297200,0,367000
142542600300000,SE 246,RESIDENTIAL,77900,0,77900,210100,0,288000
142542600400000,SE 246,RESIDENTIAL,73400,0,73400,226600,0,300000
142542600500000,SE 246,RESIDENTIAL,64500,0,64500,211900,0,276400
142542600600000,SE 246,RESIDENTIAL,55500,0,55500,0,0,55500
142542700100000,SE 246,RESIDENTIAL,71100,0,71100,238500,0,309600
142542700200000,SE 246,RESIDENTIAL,56900,0,56900,209200,0,266100
142542700300000,SE 246,RESIDENTIAL,55300,0,55300,231900,0,287200
142542700400000,SE 246,RESIDENTIAL,60100,0,60100,274000,0,334100
142542700500000,SE 246,RESIDENTIAL,71400,0,71400,309000,0,380400
142542700600000,SE 246,RESIDENTIAL,73500,0,73500,275000,0,348500
142542700700000,SE 246,RESIDENTIAL,71400,0,71400,222000,0,293400
142542700800000,SE 246,RESIDENTIAL,71800,0,71800,223200,0,295000
142542800100000,SE 246,RESIDENTIAL,80800,0,80800,246700,0,327500
142542800200000,SE 246,RESIDENTIAL,100100,0,100100,291000,0,391100
142542800300000,SE 246,RESIDENTIAL,72200,0,72200,222500,0,294700
142542800400000,SE 246,RESIDENTIAL,71300,0,71300,339700,0,411000
142542800500000,SE 246,RESIDENTIAL,72800,0,72800,237700,0,310500
142542800600000,SE 246,RESIDENTIAL,60600,0,60600,256700,0,317300
142542900300000,SE 246,RESIDENTIAL,125800,0,125800,0,0,125800
142542900400000,SE 246,RESIDENTIAL,60500,0,60500,195100,0,255600
142542900500000,SE 246,RESIDENTIAL,86200,0,86200,196600,0,282800
142542900600000,SE 246,RESIDENTIAL,83300,0,83300,180600,0,263900
142542900700000,SE 246,RESIDENTIAL,61300,0,61300,297600,0,358900
142542900800000,SE 246,RESIDENTIAL,61300,0,61300,196000,0,257300
142542900900000,SE 246,RESIDENTIAL,63800,0,63800,210500,0,274300
142542901000000,SE 246,RESIDENTIAL,66900,0,66900,203000,0,269900
142542901100000,CITY PROPERTY,EXEMPT,0,0,0,0,0,0
142542901200000,SE 246,RESIDENTIAL,99100,0,99100,222400,0,321500
142610100300000,NBHD SHOPPING CENTER,COMMERCIAL,0,119900,119900,0,372100,492000
142610100400000,SE 234,RESIDENTIAL,20400,0,20400,75200,0,95600
142610100500000,SE 234,RESIDENTIAL,18400,0,18400,90200,0,108600
142610100600000,SE 234,RESIDENTIAL,20400,0,20400,103500,0,123900
142610100700000,SE 234,RESIDENTIAL,21400,0,21400,82100,0,103500
142610100800000,SE 234,RESIDENTIAL,19000,0,19000,91800,0,110800
142610100900000,SE 234,RESIDENTIAL,17700,0,17700,89400,0,107100
142610101000000,SE 234,RESIDENTIAL,21000,0,21000,92100,0,113100
142610101100000,SE 234,RESIDENTIAL,21200,0,21200,40600,0,61800
142610101200000,CONVENIENCE STORE,COMMERCIAL,0,363000,363000,0,836200,1199200
142610200100000,RESTAURANT,COMMERCIAL,0,60200,60200,0,106500,166700
142610200200000,SE 234,RESIDENTIAL,15600,0,15600,69000,0,84600
142610200300000,SE 234,RESIDENTIAL,15200,0,15200,66000,0,81200
142610200400000,SE 234,RESIDENTIAL,15600,0,15600,78100,0,93700
142610200500000,SE 234,RESIDENTIAL,16400,0,16400,78300,0,94700
142610200600000,SE 234,RESIDENTIAL,16400,0,16400,83000,0,99400
142610200700000,SE 234,RESIDENTIAL,18200,0,18200,84200,0,102400
142610200800000,SE 234,RESIDENTIAL,19800,0,19800,78400,0,98200
142610200900000,SE 234,RESIDENTIAL,19800,0,19800,51300,0,71100
142610300100000,OFFICE,COMMERCIAL,20292,15308,35600,62689,47811,146100
142610300200000,NBHD SHOPPING CENTER,COMMERCIAL,0,185000,185000,0,440700,625700
142610300800000,SE 234,RESIDENTIAL,15600,0,15600,34900,0,50500
142610300900000,SE 234,RESIDENTIAL,15800,0,15800,40800,0,56600
142610301000000,SE 234,RESIDENTIAL,20400,0,20400,90500,0,110900
142610301100000,SE 234,RESIDENTIAL,18700,0,18700,58700,0,77400
142610301200000,SE 234,RESIDENTIAL,24100,0,24100,100200,0,124300
142610301300000,SE 234,RESIDENTIAL,19700,0,19700,92900,0,112600
142610301400000,SE 234,RESIDENTIAL,17200,0,17200,114400,0,131600
142610301500000,SE 234,RESIDENTIAL,17400,0,17400,80900,0,98300
142610301600000,SE 234,RESIDENTIAL,14700,0,14700,71700,0,86400
142610400100000,SE 234,RESIDENTIAL,61800,0,61800,108600,0,170400
142610400400000,SE 234,RESIDENTIAL,22400,0,22400,110100,0,132500
142610400500000,SE 234,RESIDENTIAL,22600,0,22600,112200,0,134800
142610400600000,SE 234,RESIDENTIAL,22600,0,22600,108200,0,130800
142610400700000,SE 234,RESIDENTIAL,22600,0,22600,99300,0,121900
142610400800000,SE 234,RESIDENTIAL,22600,0,22600,91400,0,114000
142610400900000,SE 234,RESIDENTIAL,23000,0,23000,136900,0,159900
142610401000000,SE 234,RESIDENTIAL,21000,0,21000,91100,0,112100
142610401100000,SE 234,RESIDENTIAL,21300,0,21300,67000,0,88300
142610401200000,SE 234,RESIDENTIAL,19400,0,19400,79700,0,99100
142610401300000,SE 234,RESIDENTIAL,19300,0,19300,82500,0,101800
142610401400000,SE 234,RESIDENTIAL,19300,0,19300,86800,0,106100
142610401500000,SE 234,RESIDENTIAL,19300,0,19300,91300,0,110600
142610401600000,SE 234,RESIDENTIAL,19300,0,19300,73600,0,92900
142610401700000,SE 234,RESIDENTIAL,19300,0,19300,103500,0,122800
142610401800000,SE 234,RESIDENTIAL,55000,0,55000,166800,0,221800
142610401900000,SE 234,RESIDENTIAL,19300,0,19300,89400,0,108700
142610402000000,SE 234,RESIDENTIAL,19300,0,19300,78700,0,98000
142610402100000,SE 234,RESIDENTIAL,19300,0,19300,82300,0,101600
142610402200000,SE 234,RESIDENTIAL,19300,0,19300,86200,0,105500
142610402300000,SE 234,RESIDENTIAL,19300,0,19300,113600,0,132900
142610402400000,SE 234,RESIDENTIAL,19400,0,19400,111200,0,130600
142610402500000,SE 234,RESIDENTIAL,17700,0,17700,109100,0,126800
142610402600000,SE 234,RESIDENTIAL,18400,0,18400,74800,0,93200
142610402700000,SE 234,RESIDENTIAL,18400,0,18400,48600,0,67000
142610402800000,SE 234,RESIDENTIAL,18400,0,18400,80100,0,98500
142610402900000,SE 234,RESIDENTIAL,18400,0,18400,105500,0,123900
142610403000000,SE 234,RESIDENTIAL,18400,0,18400,73600,0,92000
142610403100000,SE 234,RESIDENTIAL,18400,0,18400,70000,0,88400
142610403200000,SE 234,RESIDENTIAL,18400,0,18400,75300,0,93700
142610403300000,SE 234,RESIDENTIAL,18400,0,18400,113000,0,131400
142610403400000,SE 234,RESIDENTIAL,18400,0,18400,68000,0,86400
142610403500000,SE 234,RESIDENTIAL,25700,0,25700,113200,0,138900
142610403600000,SE 234,RESIDENTIAL,18400,0,18400,99900,0,118300
142610403700000,SE 234,RESIDENTIAL,24200,0,24200,68900,0,93100
142610403800000,SE 234,RESIDENTIAL,23500,0,23500,76100,0,99600
142610403900000,SE 234,RESIDENTIAL,23400,0,23400,79600,0,103000
142610404000000,SE 234,RESIDENTIAL,31200,0,31200,116300,0,147500
142610404100000,SE 234,RESIDENTIAL,35300,0,35300,130400,0,165700
142610500100000,SE 234,RESIDENTIAL,21000,0,21000,75400,0,96400
142610500200000,SE 234,RESIDENTIAL,21000,0,21000,64800,0,85800
142610500300000,SE 234,RESIDENTIAL,21000,0,21000,77400,0,98400
142610500400000,SE 234,RESIDENTIAL,21300,0,21300,63300,0,84600
142610500500000,SE 234,RESIDENTIAL,18200,0,18200,77400,0,95600
142610500600000,SE 234,RESIDENTIAL,17600,0,17600,86100,0,103700
142610500700000,SE 234,RESIDENTIAL,18900,0,18900,77400,0,96300
142610500800000,SE 234,RESIDENTIAL,19300,0,19300,91200,0,110500
142610500900000,SE 234,RESIDENTIAL,19400,0,19400,70400,0,89800
142610501000000,SE 234,RESIDENTIAL,24800,0,24800,116000,0,140800
142610501100000,SE 234,RESIDENTIAL,24500,0,24500,98100,0,122600
142610501200000,SE 234,RESIDENTIAL,23300,0,23300,107500,0,130800
142610501300000,SE 234,RESIDENTIAL,23300,0,23300,70100,0,93400
142610501400000,SE 234,RESIDENTIAL,18700,0,18700,86100,0,104800
142610501500000,SE 234,RESIDENTIAL,18700,0,18700,54700,0,73400
142610501600000,SE 234,RESIDENTIAL,18700,0,18700,86300,0,105000
142610501700000,SE 234,RESIDENTIAL,18700,0,18700,74200,0,92900
142610501800000,SE 234,RESIDENTIAL,18700,0,18700,78400,0,97100
142610501900000,SE 234,RESIDENTIAL,18700,0,18700,74300,0,93000
142610502000000,SE 234,RESIDENTIAL,18700,0,18700,80600,0,99300
142610502100000,SE 234,RESIDENTIAL,18700,0,18700,86000,0,104700
142610502200000,SE 234,RESIDENTIAL,18700,0,18700,67300,0,86000
142610600100000,SE 234,RESIDENTIAL,22000,0,22000,115000,0,137000
142610600200000,SE 234,RESIDENTIAL,24500,0,24500,113400,0,137900
142610600300000,SE 234,RESIDENTIAL,21700,0,21700,88000,0,109700
142610600400000,SE 234,RESIDENTIAL,26700,0,26700,120200,0,146900
142610600500000,SE 234,RESIDENTIAL,20200,0,20200,64400,0,84600
142610600600000,SE 234,RESIDENTIAL,18900,0,18900,78900,0,97800
142610600700000,SE 234,RESIDENTIAL,17300,0,17300,70200,0,87500
142610600800000,SE 234,RESIDENTIAL,19900,0,19900,67800,0,87700
142610600900000,SE 234,RESIDENTIAL,20100,0,20100,82600,0,102700
142610601000000,SE 234,RESIDENTIAL,16900,0,16900,86100,0,103000
142610601100000,SE 234,RESIDENTIAL,17000,0,17000,63200,0,80200
142610601200000,SE 234,RESIDENTIAL,21300,0,21300,110300,0,131600
142610601300000,SE 234,RESIDENTIAL,21400,0,21400,82100,0,103500
142610700100000,SE 234,RESIDENTIAL,22400,0,22400,79500,0,101900
142610700200000,SE 234,RESIDENTIAL,17900,0,17900,58000,0,75900
142610700300000,SE 234,RESIDENTIAL,17900,0,17900,83900,0,101800
142610700400000,SE 234,RESIDENTIAL,18200,0,18200,76600,0,94800
142610700500000,SE 234,RESIDENTIAL,18400,0,18400,70200,0,88600
142610700600000,SE 234,RESIDENTIAL,18900,0,18900,105100,0,124000
142610700700000,SE 234,RESIDENTIAL,23600,0,23600,115700,0,139300
142610700800000,SE 234,RESIDENTIAL,23600,0,23600,75400,0,99000
142610700900000,SE 234,RESIDENTIAL,20600,0,20600,71300,0,91900
142610701000000,SE 234,RESIDENTIAL,20400,0,20400,105500,0,125900
142610701100000,SE 234,RESIDENTIAL,36600,0,36600,121200,0,157800
142610800100000,SE 234,RESIDENTIAL,17600,0,17600,81000,0,98600
142610800200000,SE 234,RESIDENTIAL,25500,0,25500,91700,0,117200
142610800300000,SE 234,RESIDENTIAL,22200,0,22200,94700,0,116900
142610800400000,SE 234,RESIDENTIAL,22100,0,22100,118500,0,140600
142610800500000,SE 234,RESIDENTIAL,22900,0,22900,138300,0,161200
142610800600000,SE 234,RESIDENTIAL,21900,0,21900,83800,0,105700
142610800700000,SE 234,RESIDENTIAL,31000,0,31000,129500,0,160500
142610800800000,SE 234,RESIDENTIAL,30400,0,30400,99800,0,130200
142610800900000,SE 234,RESIDENTIAL,18700,0,18700,74100,0,92800
142610801000000,SE 234,RESIDENTIAL,23900,0,23900,95300,0,119200
142610801100000,SE 234,RESIDENTIAL,23900,0,23900,108300,0,132200
142610801200000,SE 234,RESIDENTIAL,25700,0,25700,113400,0,139100
142610801300000,SE 234,RESIDENTIAL,25700,0,25700,79500,0,105200
142612600100000,OFFICE,COMMERCIAL,0,92400,92400,0,284100,376500
142612600200000,OFFICE,COMMERCIAL,0,225000,225000,0,337600,562600
142612600300000,RESTAURANT,COMMERCIAL,0,151200,151200,0,247600,398800
142612600400000,SE 234,RESIDENTIAL,27700,0,27700,109200,0,136900
142612600500000,SMALL RETAIL,COMMERCIAL,0,101100,101100,0,63200,164300
142612600600000,SMALL RETAIL,COMMERCIAL,0,36200,36200,0,102200,138400
142612600700000,SMALL RETAIL,COMMERCIAL,0,52100,52100,0,415000,467100
142612600800000,SE 234,RESIDENTIAL,32100,0,32100,64200,0,96300
142612600900000,SE 234,RESIDENTIAL,20300,0,20300,93500,0,113800
142612601000000,SE 234,RESIDENTIAL,22300,0,22300,85500,0,107800
142612601100000,SE 234,RESIDENTIAL,21400,0,21400,118400,0,139800
142612601200000,SE 234,RESIDENTIAL,21400,0,21400,130400,0,151800
142612601300000,SE 234,RESIDENTIAL,20400,0,20400,115900,0,136300
142612601400000,SE 234,RESIDENTIAL,21800,0,21800,132700,0,154500
142612601500000,SE 234,RESIDENTIAL,21400,0,21400,99000,0,120400
142612601600000,SE 234,RESIDENTIAL,21900,0,21900,127500,0,149400
142612601700000,SE 234,RESIDENTIAL,21500,0,21500,141300,0,162800
142612601800000,SE 234,RESIDENTIAL,20100,0,20100,99600,0,119700
142612601900000,SE 234,RESIDENTIAL,20300,0,20300,117800,0,138100
142612602000000,SE 234,RESIDENTIAL,20300,0,20300,97700,0,118000
142612602100000,SE 234,RESIDENTIAL,22500,0,22500,87400,0,109900
142612602200000,SE 234,RESIDENTIAL,20000,0,20000,88600,0,108600
142612602300000,SE 234,RESIDENTIAL,20000,0,20000,98700,0,118700
142612602400000,SE 234,RESIDENTIAL,20000,0,20000,111300,0,131300
142612602500000,SE 234,RESIDENTIAL,20000,0,20000,116800,0,136800
142612602600000,SE 234,RESIDENTIAL,20000,0,20000,91400,0,111400
142612602700000,SE 234,RESIDENTIAL,20000,0,20000,74300,0,94300
142612602800000,SE 234,RESIDENTIAL,20000,0,20000,99100,0,119100
142612602900000,SE 234,RESIDENTIAL,20000,0,20000,88700,0,108700
142612603000000,SE 234,RESIDENTIAL,20000,0,20000,70500,0,90500
142612603100000,SE 234,RESIDENTIAL,20000,0,20000,79100,0,99100
142612603200000,SE 234,RESIDENTIAL,20000,0,20000,34400,0,54400
142612603300000,SE 234,RESIDENTIAL,20000,0,20000,70700,0,90700
142612603400000,CITY PROPERTY,EXEMPT,0,0,0,0,0,0
142612603500000,SE 234,RESIDENTIAL,21400,0,21400,82400,0,103800
142612603600000,SE 234,RESIDENTIAL,20600,0,20600,97200,0,117800
142612603700000,SE 234,RESIDENTIAL,20600,0,20600,86700,0,107300
142612603800000,SE 234,RESIDENTIAL,20600,0,20600,60700,0,81300
142612603900000,SE 234,RESIDENTIAL,20600,0,20600,65800,0,86400
142612604000000,SE 234,RESIDENTIAL,20600,0,20600,81900,0,102500
142612604100000,SE 234,RESIDENTIAL,20600,0,20600,84800,0,105400
142612604200000,SE 234,RESIDENTIAL,21200,0,21200,79400,0,100600
142612604300000,SE 234,RESIDENTIAL,21400,0,21400,102600,0,124000
142612604400000,SE 234,RESIDENTIAL,22100,0,22100,80100,0,102200
142612604500000,SE 234,RESIDENTIAL,22200,0,22200,70700,0,92900
142612604600000,SE 234,RESIDENTIAL,22000,0,22000,77000,0,99000
142612604700000,SE 234,RESIDENTIAL,21900,0,21900,79600,0,101500
142612604800000,SE 234,RESIDENTIAL,21800,0,21800,80100,0,101900
142612604900000,SE 234,RESIDENTIAL,22900,0,22900,67100,0,90000
142612605000000,SE 234,RESIDENTIAL,22600,0,22600,125600,0,148200
142612605100000,SE 234,RESIDENTIAL,22100,0,22100,100600,0,122700
142612605200000,SE 234,RESIDENTIAL,22400,0,22400,112400,0,134800
142612605300000,SE 234,RESIDENTIAL,23900,0,23900,115400,0,139300
142612605400000,SE 234,RESIDENTIAL,20800,0,20800,78700,0,99500
142612605500000,SE 234,RESIDENTIAL,21200,0,21200,82800,0,104000
142612605600000,SE 234,RESIDENTIAL,21000,0,21000,88800,0,109800
142612605700000,SE 234,RESIDENTIAL,21400,0,21400,76500,0,97900
142612605800000,SE 234,RESIDENTIAL,21900,0,21900,65300,0,87200
142612605900000,SE 234,RESIDENTIAL,40500,0,40500,139100,0,179600
142612606000000,SE 234,RESIDENTIAL,25700,0,25700,109200,0,134900
142612606100000,SE 234,RESIDENTIAL,23100,0,23100,100100,0,123200
142612700100000,SMALL RETAIL,COMMERCIAL,0,72600,72600,0,81300,153900
142612700200000,LG DISCOUNT/RETAIL,COMMERCIAL,0,577500,577500,0,1012200,1589700
142612700300000,VETERINARY CLINIC,COMMERCIAL,0,83300,83300,0,201100,284400
142612700600000,SE 234,RESIDENTIAL,27200,0,27200,72000,0,99200
142612700700000,SE 234,RESIDENTIAL,27200,0,27200,80100,0,107300
142612700800000,SE 234,RESIDENTIAL,27200,0,27200,88100,0,115300
142612700900000,SE 234,RESIDENTIAL,26600,0,26600,68800,0,95400
142612701000000,SE 234,RESIDENTIAL,21300,0,21300,112700,0,134000
142612701100000,SE 234,RESIDENTIAL,20700,0,20700,97600,0,118300
142612701200000,SE 234,RESIDENTIAL,22900,0,22900,92200,0,115100
142612701300000,SE 234,RESIDENTIAL,22500,0,22500,86000,0,108500
142612701400000,SE 234,RESIDENTIAL,21800,0,21800,108900,0,130700
142612701500000,SE 234,RESIDENTIAL,21300,0,21300,68300,0,89600
142612701600000,SE 234,RESIDENTIAL,21800,0,21800,85000,0,106800
142612701700000,SE 234,RESIDENTIAL,21800,0,21800,85000,0,106800
142612701800000,SE 234,RESIDENTIAL,22500,0,22500,106000,0,128500
142612701900000,SE 234,RESIDENTIAL,23200,0,23200,88300,0,111500
142612702000000,SE 234,RESIDENTIAL,22900,0,22900,90100,0,113000
142612702100000,SE 234,RESIDENTIAL,25700,0,25700,73400,0,99100
142612702200000,SE 234,RESIDENTIAL,22700,0,22700,129000,0,151700
142612702300000,CENTRALLY ASSESSED,OTHER,0,0,0,0,0,0
142612702400000,FLAT PARKING,COMMERCIAL,0,8800,8800,0,3500,12300
142612702500000,FLAT PARKING,COMMERCIAL,0,40600,40600,0,11300,51900
142612702600000,SE 234,RESIDENTIAL,24800,0,24800,39100,0,63900
142612702700000,APARTMENT,MULTI-RES,13500,0,13500,120800,0,134300
142612702900000,APARTMENT,MULTI-RES,212000,0,212000,1712700,0,1924700
142612703000000,SE 234,RESIDENTIAL,32100,0,32100,48300,0,80400
142612800100000,SE 234,RESIDENTIAL,24600,0,24600,94000,0,118600
142612800200000,SE 234,RESIDENTIAL,22400,0,22400,83700,0,106100
142612800300000,SE 234,RESIDENTIAL,23500,0,23500,134800,0,158300
142612800400000,SE 234,RESIDENTIAL,23400,0,23400,76800,0,100200
142612800500000,SE 234,RESIDENTIAL,22400,0,22400,89100,0,111500
142612800600000,SE 234,RESIDENTIAL,20600,0,20600,110900,0,131500
142612800700000,SE 234,RESIDENTIAL,23800,0,23800,110200,0,134000
142612800800000,SE 234,RESIDENTIAL,25200,0,25200,94500,0,119700
142612800900000,SE 234,RESIDENTIAL,20200,0,20200,96700,0,116900
142612801000000,SE 234,RESIDENTIAL,20400,0,20400,98100,0,118500
142612801100000,SE 234,RESIDENTIAL,20800,0,20800,71300,0,92100
142612801200000,SE 234,RESIDENTIAL,21200,0,21200,87100,0,108300
142612801300000,SE 234,RESIDENTIAL,21400,0,21400,77400,0,98800
142612801400000,SE 234,RESIDENTIAL,21800,0,21800,79700,0,101500
142612801500000,SE 234,RESIDENTIAL,22900,0,22900,91400,0,114300
142612801600000,SE 234,RESIDENTIAL,22500,0,22500,68800,0,91300
142612801700000,SE 234,RESIDENTIAL,22700,0,22700,87900,0,110600
142612801800000,SE 234,RESIDENTIAL,22700,0,22700,72000,0,94700
142612801900000,SE 234,RESIDENTIAL,22500,0,22500,96200,0,118700
142612802000000,SE 234,RESIDENTIAL,22300,0,22300,92800,0,115100
142615100100000,SE 234,RESIDENTIAL,22300,0,22300,84300,0,106600
142615100200000,SE 234,RESIDENTIAL,21800,0,21800,85300,0,107100
142615100300000,SE 234,RESIDENTIAL,21800,0,21800,90500,0,112300
142615100400000,SE 234,RESIDENTIAL,21800,0,21800,78400,0,100200
142615100500000,SE 234,RESIDENTIAL,21800,0,21800,80600,0,102400
142615100600000,SE 234,RESIDENTIAL,21800,0,21800,113900,0,135700
142615100700000,SE 234,RESIDENTIAL,21800,0,21800,84300,0,106100
142615100800000,SE 234,RESIDENTIAL,21800,0,21800,70600,0,92400
142615100900000,SE 234,RESIDENTIAL,24500,0,24500,98400,0,122900
142615101000000,SE 234,RESIDENTIAL,21100,0,21100,68100,0,89200
142615101100000,SE 234,RESIDENTIAL,21500,0,21500,88100,0,109600
142615101200000,SE 234,RESIDENTIAL,21500,0,21500,72000,0,93500
142615101300000,SE 234,RESIDENTIAL,21900,0,21900,72100,0,94000
142615101400000,SE 234,RESIDENTIAL,20500,0,20500,92500,0,113000
142615101500000,SE 234,RESIDENTIAL,24500,0,24500,112900,0,137400
142615101600000,SE 234,RESIDENTIAL,21800,0,21800,92900,0,114700
142615101700000,SE 234,RESIDENTIAL,21800,0,21800,105000,0,126800
142615101800000,SE 234,RESIDENTIAL,21800,0,21800,105900,0,127700
142615101900000,SE 234,RESIDENTIAL,21800,0,21800,100800,0,122600
142615102000000,SE 234,RESIDENTIAL,21800,0,21800,77400,0,99200
142615102100000,SE 234,RESIDENTIAL,21800,0,21800,114000,0,135800
142615102200000,SE 234,RESIDENTIAL,21800,0,21800,88800,0,110600
142615102300000,SE 234,RESIDENTIAL,21000,0,21000,103300,0,124300
142615102400000,SE 234,RESIDENTIAL,21000,0,21000,76200,0,97200
142615102500000,SE 234,RESIDENTIAL,22300,0,22300,97500,0,119800
142615200100000,SE 234,RESIDENTIAL,19600,0,19600,93800,0,113400
142615200200000,SE 234,RESIDENTIAL,20900,0,20900,102800,0,123700
142615200300000,SE 234,RESIDENTIAL,21500,0,21500,85300,0,106800
142615200400000,SE 234,RESIDENTIAL,20000,0,20000,97500,0,117500
142615200500000,SE 234,RESIDENTIAL,20000,0,20000,111200,0,131200
142615200600000,SE 234,RESIDENTIAL,16600,0,16600,76400,0,93000
142615200700000,SE 234,RESIDENTIAL,20800,0,20800,78900,0,99700
142615300100000,SE 234,RESIDENTIAL,21700,0,21700,85400,0,107100
142615300200000,SE 234,RESIDENTIAL,23000,0,23000,64300,0,87300
142615300300000,SE 234,RESIDENTIAL,22500,0,22500,81400,0,103900
142615300400000,SE 234,RESIDENTIAL,23300,0,23300,118900,0,142200
142615300500000,SE 234,RESIDENTIAL,21700,0,21700,100800,0,122500
142615300600000,SE 234,RESIDENTIAL,19700,0,19700,93500,0,113200
142615300700000,SE 234,RESIDENTIAL,17000,0,17000,84300,0,101300
142615300800000,SE 234,RESIDENTIAL,20600,0,20600,87600,0,108200
142615300900000,SE 234,RESIDENTIAL,19300,0,19300,65700,0,85000
142615301000000,SE 234,RESIDENTIAL,21700,0,21700,65400,0,87100
142615301100000,SE 234,RESIDENTIAL,25500,0,25500,94000,0,119500
142615301200000,SE 234,RESIDENTIAL,21300,0,21300,82700,0,104000
142615301300000,SE 234,RESIDENTIAL,21800,0,21800,94000,0,115800
142615301400000,SE 234,RESIDENTIAL,21400,0,21400,82200,0,103600
142615301500000,SE 234,RESIDENTIAL,21000,0,21000,57400,0,78400
142615301600000,SE 234,RESIDENTIAL,21000,0,21000,75400,0,96400
142615301700000,SE 234,RESIDENTIAL,21000,0,21000,90300,0,111300
142615301800000,SE 234,RESIDENTIAL,21000,0,21000,91400,0,112400
142615400100000,SE 234,RESIDENTIAL,20300,0,20300,90600,0,110900
142615400200000,SE 234,RESIDENTIAL,20000,0,20000,83500,0,103500
142615400300000,SE 234,RESIDENTIAL,20000,0,20000,94700,0,114700
142615400400000,SE 234,RESIDENTIAL,20000,0,20000,89700,0,109700
142615400500000,SE 234,RESIDENTIAL,20000,0,20000,61200,0,81200
142615400600000,SE 234,RESIDENTIAL,20000,0,20000,89300,0,109300
142615400700000,SE 234,RESIDENTIAL,20100,0,20100,89900,0,110000
142615400800000,SE 234,RESIDENTIAL,22000,0,22000,117700,0,139700
142615400900000,SE 234,RESIDENTIAL,24000,0,24000,105300,0,129300
142615401000000,SE 234,RESIDENTIAL,22300,0,22300,105200,0,127500
142615401100000,SE 234,RESIDENTIAL,22000,0,22000,77200,0,99200
142615401200000,SE 234,RESIDENTIAL,24200,0,24200,103700,0,127900
142615401300000,SE 234,RESIDENTIAL,22700,0,22700,119500,0,142200
142615401400000,SE 234,RESIDENTIAL,22500,0,22500,114100,0,136600
142615401500000,SE 234,RESIDENTIAL,22000,0,22000,86000,0,108000
142615500100000,SE 234,RESIDENTIAL,19600,0,19600,94200,0,113800
142615500200000,SE 234,RESIDENTIAL,19600,0,19600,101900,0,121500
142615500300000,SE 234,RESIDENTIAL,23100,0,23100,90800,0,113900
142615500400000,SE 234,RESIDENTIAL,27300,0,27300,121900,0,149200
142615500500000,SE 234,RESIDENTIAL,32000,0,32000,130900,0,162900
142615500600000,SE 234,RESIDENTIAL,40400,0,40400,167900,0,208300
142615500700000,SE 234,RESIDENTIAL,40100,0,40100,158800,0,198900
142615500800000,SE 234,RESIDENTIAL,21100,0,21100,135400,0,156500
142615500900000,SE 234,RESIDENTIAL,22900,0,22900,81400,0,104300
142615501000000,SE 234,RESIDENTIAL,27500,0,27500,97600,0,125100
142615501100000,SE 234,RESIDENTIAL,42600,0,42600,194000,0,236600
142615501200000,SE 234,RESIDENTIAL,30200,0,30200,178100,0,208300
142615501300000,SE 234,RESIDENTIAL,28200,0,28200,99700,0,127900
142615501400000,SE 234,RESIDENTIAL,23600,0,23600,113900,0,137500
142615501500000,SE 234,RESIDENTIAL,21800,0,21800,106700,0,128500
142615501600000,SE 234,RESIDENTIAL,21900,0,21900,84200,0,106100
142615501700000,SE 234,RESIDENTIAL,22500,0,22500,126800,0,149300
142615501800000,SE 234,RESIDENTIAL,25900,0,25900,84300,0,110200
142615501900000,SE 234,RESIDENTIAL,26600,0,26600,94400,0,121000
142615502000000,SE 234,RESIDENTIAL,19900,0,19900,82900,0,102800
142615502100000,SE 234,RESIDENTIAL,20000,0,20000,84200,0,104200
142615502200000,SE 234,RESIDENTIAL,40700,0,40700,65200,0,105900
142615502300000,SE 234,RESIDENTIAL,24500,0,24500,160400,0,184900
142615502400000,SE 234,RESIDENTIAL,41600,0,41600,257300,0,298900
142615502700000,SE 234,RESIDENTIAL,41100,0,41100,62700,0,103800
142615502800000,SE 234,RESIDENTIAL,31400,0,31400,41500,0,72900
142615502900000,SE 234,RESIDENTIAL,21600,0,21600,81400,0,103000
142615503000000,SE 234,RESIDENTIAL,21600,0,21600,62400,0,84000
142615503100000,SE 234,RESIDENTIAL,41400,0,41400,36600,0,78000
142615503300000,SE 234,RESIDENTIAL,47000,0,47000,76300,0,123300
142617600100000,SE 234,RESIDENTIAL,27200,0,27200,150000,0,177200
142617600200000,SE 234,RESIDENTIAL,17900,0,17900,70300,0,88200
142617600300000,SE 234,RESIDENTIAL,23000,0,23000,101900,0,124900
142617600400000,SE 234,RESIDENTIAL,36400,0,36400,132000,0,168400
142617600500000,SE 234,RESIDENTIAL,38100,0,38100,142200,0,180300
142617600600000,SE 234,RESIDENTIAL,36200,0,36200,106100,0,142300
142617600700000,SE 234,RESIDENTIAL,24200,0,24200,154300,0,178500
142617600800000,SE 234,RESIDENTIAL,24700,0,24700,105500,0,130200
142617600900000,SE 234,RESIDENTIAL,22900,0,22900,84500,0,107400
142617601000000,SE 234,RESIDENTIAL,23000,0,23000,132700,0,155700
142617601100000,SE 234,RESIDENTIAL,22400,0,22400,89000,0,111400
142617601200000,SE 234,RESIDENTIAL,23700,0,23700,97100,0,120800
142617601300000,CITY PROPERTY,EXEMPT,0,0,0,0,0,0
142617601400000,SE 234,RESIDENTIAL,18500,0,18500,113100,0,131600
142617601500000,SE 234,RESIDENTIAL,18500,0,18500,122000,0,140500
142617601600000,SE 234,RESIDENTIAL,18400,0,18400,91600,0,110000
142617601700000,SE 234,RESIDENTIAL,20800,0,20800,84300,0,105100
142617601800000,SE 234,RESIDENTIAL,20900,0,20900,85000,0,105900
142617601900000,SE 234,RESIDENTIAL,24200,0,24200,105500,0,129700
142617602000000,SE 234,RESIDENTIAL,22100,0,22100,85100,0,107200
142617602100000,SE 234,RESIDENTIAL,22200,0,22200,113900,0,136100
142617602200000,SE 234,RESIDENTIAL,34800,0,34800,106300,0,141100
142617602300000,SE 234,RESIDENTIAL,29400,0,29400,89500,0,118900
142617602400000,SE 234,RESIDENTIAL,32100,0,32100,143300,0,175400
142617602500000,SE 234,RESIDENTIAL,27800,0,27800,109600,0,137400
142617602600000,SE 234,RESIDENTIAL,30700,0,30700,158500,0,189200
142617603100000,SE 234,RESIDENTIAL,25400,0,25400,112700,0,138100
142617603200000,SE 234,RESIDENTIAL,25700,0,25700,134000,0,159700
142617603400000,SCHOOL,EXEMPT,0,507600,507600,0,342500,850100
142617603500000,SE 234,RESIDENTIAL,24700,0,24700,151900,0,176600
142617603600000,SE 234,RESIDENTIAL,23900,0,23900,0,0,23900
142617603700000,SE 234,RESIDENTIAL,25000,0,25000,0,0,25000
142617603800000,SE 234,RESIDENTIAL,21200,0,21200,0,0,21200
142617603900000,SE 234,RESIDENTIAL,21200,0,21200,124200,0,145400
142617604000000,SE 234,RESIDENTIAL,19400,0,19400,113400,0,132800
142617700100000,SE 234,RESIDENTIAL,25300,0,25300,91300,0,116600
142617700200000,SE 234,RESIDENTIAL,23200,0,23200,110800,0,134000
142617700300000,SE 234,RESIDENTIAL,25200,0,25200,78800,0,104000
142617700400000,SE 234,RESIDENTIAL,26100,0,26100,110200,0,136300
142617700500000,SE 234,RESIDENTIAL,25900,0,25900,88900,0,114800
142617700600000,SE 234,RESIDENTIAL,27600,0,27600,75700,0,103300
142617700700000,SE 234,RESIDENTIAL,25800,0,25800,144000,0,169800
142617700900000,SE 234,RESIDENTIAL,22400,0,22400,110500,0,132900
142617701000000,SE 234,RESIDENTIAL,22100,0,22100,107700,0,129800
142617701100000,SE 234,RESIDENTIAL,19400,0,19400,123000,0,142400
142617701200000,SE 234,RESIDENTIAL,20200,0,20200,72600,0,92800
142617701400000,SE 234,RESIDENTIAL,26700,0,26700,75800,0,102500
142617701500000,SE 234,RESIDENTIAL,23200,0,23200,66800,0,90000
142617800100000,SE 234,RESIDENTIAL,23900,0,23900,106500,0,130400
142617800200000,SE 234,RESIDENTIAL,21800,0,21800,66600,0,88400
142617800300000,SE 234,RESIDENTIAL,21800,0,21800,112500,0,134300
142617800400000,SE 234,RESIDENTIAL,21800,0,21800,83100,0,104900
142617800500000,SE 234,RESIDENTIAL,20700,0,20700,91600,0,112300
142617800600000,SE 234,RESIDENTIAL,20600,0,20600,63900,0,84500
142617800700000,SE 234,RESIDENTIAL,21000,0,21000,92700,0,113700
142617800800000,SE 234,RESIDENTIAL,21500,0,21500,89200,0,110700
142617800900000,SE 234,RESIDENTIAL,21500,0,21500,78600,0,100100
142617801000000,SE 234,RESIDENTIAL,22100,0,22100,77800,0,99900
142617801100000,SE 234,RESIDENTIAL,21400,0,21400,94500,0,115900
142617801200000,SE 234,RESIDENTIAL,22300,0,22300,65900,0,88200
142617801300000,SE 234,RESIDENTIAL,22300,0,22300,89000,0,111300
142617801400000,SE 234,RESIDENTIAL,23500,0,23500,116500,0,140000
142620100100000,VACANT LAND,COMMERCIAL,0,210000,210000,0,6600,216600
142620100200000,SE 235,RESIDENTIAL,16300,0,16300,71600,0,87900
142620100300000,SE 235,RESIDENTIAL,16300,0,16300,71100,0,87400
142620100400000,SE 235,RESIDENTIAL,16300,0,16300,104700,0,121000
142620100500000,SE 235,RESIDENTIAL,26600,0,26600,80000,0,106600
142620100600000,SE 235,RESIDENTIAL,24000,0,24000,89500,0,113500
142620100700000,SE 235,RESIDENTIAL,24500,0,24500,78300,0,102800
142620100800000,SE 235,RESIDENTIAL,24500,0,24500,132000,0,156500
142620100900000,SE 235,RESIDENTIAL,27400,0,27400,87600,0,115000
142620101000000,SE 235,RESIDENTIAL,27400,0,27400,107200,0,134600
142620101100000,SE 235,RESIDENTIAL,22800,0,22800,89300,0,112100
142620101200000,SE 235,RESIDENTIAL,27700,0,27700,74000,0,101700
142620101300000,SE 235,RESIDENTIAL,29500,0,29500,85000,0,114500
142620101400000,SE 235,RESIDENTIAL,49800,0,49800,87500,0,137300
142620101500000,SE 235,RESIDENTIAL,26700,0,26700,80600,0,107300
142620101600000,SE 235,RESIDENTIAL,26700,0,26700,83100,0,109800
142620101700000,SE 235,RESIDENTIAL,26700,0,26700,67300,0,94000
142620101800000,SE 235,RESIDENTIAL,26700,0,26700,57400,0,84100
142620101900000,SE 235,RESIDENTIAL,26600,0,26600,97000,0,123600
142620102000000,SE 235,RESIDENTIAL,22600,0,22600,69900,0,92500
142620102100000,SE 235,RESIDENTIAL,22600,0,22600,84300,0,106900
142620102200000,SE 235,RESIDENTIAL,19900,0,19900,143600,0,163500
142620102300000,SE 235,RESIDENTIAL,25700,0,25700,114400,0,140100
142620102400000,SE 235,RESIDENTIAL,24800,0,24800,123700,0,148500
142620200100000,SE 235,RESIDENTIAL,14000,0,14000,46500,0,60500
142620200200000,SE 235,RESIDENTIAL,15700,0,15700,65400,0,81100
142620200300000,SE 235,RESIDENTIAL,19700,0,19700,66000,0,85700
142620200400000,SE 235,RESIDENTIAL,19700,0,19700,97200,0,116900
142620200500000,SE 235,RESIDENTIAL,20700,0,20700,90900,0,111600
142620200600000,SE 235,RESIDENTIAL,21300,0,21300,84000,0,105300
142620200700000,SE 235,RESIDENTIAL,21300,0,21300,119200,0,140500
142620200800000,SE 235,RESIDENTIAL,21300,0,21300,98300,0,119600
142620200900000,SE 235,RESIDENTIAL,21300,0,21300,82500,0,103800
142620201000000,SE 235,RESIDENTIAL,21300,0,21300,61000,0,82300
142620201100000,SE 235,RESIDENTIAL,21300,0,21300,101900,0,123200
142620201200000,SE 235,RESIDENTIAL,21300,0,21300,105000,0,126300
142620201300000,SE 235,RESIDENTIAL,21300,0,21300,85500,0,106800
142620201400000,SE 235,RESIDENTIAL,21300,0,21300,70300,0,91600
142620201500000,SE 235,RESIDENTIAL,21300,0,21300,65500,0,86800
142620201600000,SE 235,RESIDENTIAL,21300,0,21300,82600,0,103900
142620201900000,SE 235,RESIDENTIAL,8700,0,8700,0,0,8700
142620202000000,SE 235,RESIDENTIAL,54700,0,54700,239900,0,294600
142620202100000,SE 235,RESIDENTIAL,27200,0,27200,107100,0,134300
142620202200000,SE 235,RESIDENTIAL,24100,0,24100,103400,0,127500
142620202300000,SE 235,RESIDENTIAL,23900,0,23900,81300,0,105200
142620202400000,SE 235,RESIDENTIAL,23900,0,23900,89300,0,113200
142620202500000,SE 235,RESIDENTIAL,21000,0,21000,72700,0,93700
142620202600000,SE 235,RESIDENTIAL,23600,0,23600,92200,0,115800
142620202700000,SE 235,RESIDENTIAL,21000,0,21000,100000,0,121000
142620202800000,SE 235,RESIDENTIAL,21000,0,21000,100200,0,121200
142620202900000,SE 235,RESIDENTIAL,21400,0,21400,85200,0,106600
142620203000000,SE 235,RESIDENTIAL,24500,0,24500,93200,0,117700
142620300100000,SE 235,RESIDENTIAL,17100,0,17100,78100,0,95200
142620300200000,SE 235,RESIDENTIAL,15900,0,15900,87900,0,103800
142620300300000,SE 235,RESIDENTIAL,17500,0,17500,66700,0,84200
142620300400000,SE 235,RESIDENTIAL,17700,0,17700,116800,0,134500
142620300500000,SE 235,RESIDENTIAL,23700,0,23700,95400,0,119100
142620300600000,SE 235,RESIDENTIAL,23500,0,23500,99100,0,122600
142620300700000,SE 235,RESIDENTIAL,23500,0,23500,79200,0,102700
142620300800000,SE 235,RESIDENTIAL,23500,0,23500,90900,0,114400
142620300900000,SE 235,RESIDENTIAL,23500,0,23500,85300,0,108800
142620301000000,SE 235,RESIDENTIAL,23500,0,23500,93700,0,117200
142620301100000,SE 235,RESIDENTIAL,23500,0,23500,96400,0,119900
142620301200000,SE 235,RESIDENTIAL,23500,0,23500,112000,0,135500
142620301300000,SE 235,RESIDENTIAL,23500,0,23500,95800,0,119300
142620301400000,SE 235,RESIDENTIAL,23500,0,23500,121500,0,145000
142620301500000,SE 235,RESIDENTIAL,23100,0,23100,106800,0,129900
142620301600000,SE 235,RESIDENTIAL,22400,0,22400,85200,0,107600
142620301700000,SE 235,RESIDENTIAL,1100,0,1100,0,0,1100
142620301800000,SE 236,RESIDENTIAL,32800,0,32800,208800,0,241600
142620301900000,SE 235,RESIDENTIAL,27600,0,27600,99600,0,127200
142620302000000,SE 235,RESIDENTIAL,19300,0,19300,81400,0,100700
142620302100000,SE 235,RESIDENTIAL,21500,0,21500,102900,0,124400
142620302200000,SE 235,RESIDENTIAL,21500,0,21500,84600,0,106100
142620302300000,SE 235,RESIDENTIAL,21500,0,21500,98600,0,120100
142620302400000,SE 235,RESIDENTIAL,21500,0,21500,90400,0,111900
142620302500000,SE 235,RESIDENTIAL,21500,0,21500,96700,0,118200
142620302600000,SE 235,RESIDENTIAL,21500,0,21500,94700,0,116200
142620302700000,SE 235,RESIDENTIAL,21500,0,21500,95400,0,116900
142620302800000,SE 235,RESIDENTIAL,21500,0,21500,123600,0,145100
142620302900000,SE 235,RESIDENTIAL,21500,0,21500,118600,0,140100
142620303000000,SE 235,RESIDENTIAL,21500,0,21500,138500,0,160000
142620303100000,SE 235,RESIDENTIAL,32200,0,32200,95000,0,127200
142620303200000,SE 235,RESIDENTIAL,18300,0,18300,87500,0,105800
142620400100000,SE 235,RESIDENTIAL,17700,0,17700,63500,0,81200
142620400200000,LG DISCOUNT/RETAIL,COMMERCIAL,0,317500,317500,0,483500,801000
142620400300000,APARTMENT,RESIDENTIAL,19000,0,19000,82400,0,101400
142620400400000,APARTMENT,RESIDENTIAL,20900,0,20900,100700,0,121600
142620400500000,APARTMENT,RESIDENTIAL,19900,0,19900,81800,0,101700
142620400600000,APARTMENT,RESIDENTIAL,21400,0,21400,88100,0,109500
142620400700000,SE 235,RESIDENTIAL,23100,0,23100,114300,0,137400
142620400800000,SE 235,RESIDENTIAL,23000,0,23000,84200,0,107200
142620400900000,SE 235,RESIDENTIAL,23000,0,23000,83300,0,106300
142620401000000,SE 235,RESIDENTIAL,23000,0,23000,96200,0,119200
142620401100000,SE 235,RESIDENTIAL,22800,0,22800,98700,0,121500
142620500100000,SE 235,RESIDENTIAL,22800,0,22800,98000,0,120800
142620500200000,SE 235,RESIDENTIAL,18300,0,18300,77500,0,95800
142620500300000,SE 235,RESIDENTIAL,20000,0,20000,74200,0,94200
142620500400000,SE 235,RESIDENTIAL,20400,0,20400,90200,0,110600
142620500500000,SE 235,RESIDENTIAL,20000,0,20000,104100,0,124100
142620500600000,SE 235,RESIDENTIAL,21200,0,21200,108400,0,129600
142620500700000,SE 235,RESIDENTIAL,38100,0,38100,142100,0,180200
142620500800000,SE 236,RESIDENTIAL,37500,0,37500,167400,0,204900
142620500900000,SE 235,RESIDENTIAL,4200,0,4200,0,0,4200
142620501000000,SE 235,RESIDENTIAL,23700,0,23700,127200,0,150900
142620501100000,SE 235,RESIDENTIAL,23000,0,23000,97500,0,120500
142620501200000,SE 235,RESIDENTIAL,23000,0,23000,74100,0,97100
142620501300000,SE 235,RESIDENTIAL,23000,0,23000,61400,0,84400
142620501400000,SE 235,RESIDENTIAL,23000,0,23000,91300,0,114300
142622600100000,NBHD SHOPPING CENTER,COMMERCIAL,0,272500,272500,0,459700,732200
142622600200000,SE 235,RESIDENTIAL,23700,0,23700,86900,0,110600
142622600300000,SE 235,RESIDENTIAL,14300,0,14300,59100,0,73400
142622600400000,SE 235,RESIDENTIAL,13900,0,13900,78300,0,92200
142622600500000,SE 235,RESIDENTIAL,19100,0,19100,57300,0,76400
142622600600000,SE 235,RESIDENTIAL,19100,0,19100,76800,0,95900
142622600700000,SE 235,RESIDENTIAL,18400,0,18400,56000,0,74400
142622600800000,SE 235,RESIDENTIAL,19100,0,19100,77500,0,96600
142622600900000,SE 235,RESIDENTIAL,23700,0,23700,98200,0,121900
142622601000000,SE 235,RESIDENTIAL,22300,0,22300,87500,0,109800
142622601100000,SE 235,EXEMPT,0,21800,21800,0,70200,92000
142622601200000,SE 235,RESIDENTIAL,24400,0,24400,80400,0,104800
142622700100000,SE 235,RESIDENTIAL,15400,0,15400,81800,0,97200
142622700200000,SE 235,RESIDENTIAL,18000,0,18000,62500,0,80500
142622700300000,SE 235,RESIDENTIAL,15300,0,15300,55600,0,70900
142622700400000,SE 235,RESIDENTIAL,21400,0,21400,61200,0,82600
142622700500000,SE 235,RESIDENTIAL,22700,0,22700,78800,0,101500
142622700600000,SE 235,RESIDENTIAL,17900,0,17900,74800,0,92700
142622700700000,SE 235,RESIDENTIAL,22700,0,22700,74900,0,97600
142622700800000,SE 235,RESIDENTIAL,19100,0,19100,78000,0,97100
142622700900000,SE 235,RESIDENTIAL,18200,0,18200,64800,0,83000
142622701000000,CENTRALLY ASSESSED,OTHER,0,0,0,0,0,0
142622701100000,SE 235,RESIDENTIAL,26000,0,26000,94100,0,120100
142622701200000,SE 235,RESIDENTIAL,21700,0,21700,76700,0,98400
142622701300000,SE 235,RESIDENTIAL,21700,0,21700,80900,0,102600
142622800100000,SE 235,RESIDENTIAL,16500,0,16500,41000,0,57500
142622800200000,SE 235,RESIDENTIAL,19100,0,19100,70500,0,89600
142622800300000,SE 235,RESIDENTIAL,18500,0,18500,67500,0,86000
142622800400000,SE 235,RESIDENTIAL,18500,0,18500,67700,0,86200
142622800500000,SE 235,RESIDENTIAL,18500,0,18500,77800,0,96300
142622800600000,SE 235,RESIDENTIAL,18500,0,18500,75900,0,94400
142622800700000,SE 235,RESIDENTIAL,18500,0,18500,66500,0,85000
142622800800000,SE 235,RESIDENTIAL,18900,0,18900,68000,0,86900
142622800900000,SE 235,RESIDENTIAL,18900,0,18900,101000,0,119900
142622801000000,SE 235,RESIDENTIAL,24000,0,24000,112900,0,136900
142622801100000,SE 235,RESIDENTIAL,24000,0,24000,75600,0,99600
142622801200000,SE 235,RESIDENTIAL,23600,0,23600,91500,0,115100
142622801300000,SE 235,RESIDENTIAL,22000,0,22000,87500,0,109500
142622900100000,SE 235,RESIDENTIAL,18500,0,18500,65300,0,83800
142622900200000,SE 235,RESIDENTIAL,18500,0,18500,72500,0,91000
142622900300000,SE 235,RESIDENTIAL,18500,0,18500,74100,0,92600
142622900400000,SE 235,RESIDENTIAL,19600,0,19600,88800,0,108400
142622900500000,SE 235,RESIDENTIAL,18700,0,18700,72200,0,90900
142622900600000,SE 235,RESIDENTIAL,18700,0,18700,80100,0,98800
142622900700000,SE 235,RESIDENTIAL,18700,0,18700,79800,0,98500
142622900800000,SE 235,RESIDENTIAL,19100,0,19100,81200,0,100300
142622900900000,SE 235,RESIDENTIAL,18900,0,18900,66800,0,85700
142622901000000,SE 235,RESIDENTIAL,18900,0,18900,74700,0,93600
142622901100000,SE 235,RESIDENTIAL,19100,0,19100,45600,0,64700
142622901200000,SE 235,RESIDENTIAL,18700,0,18700,62300,0,81000
142622901300000,SE 235,RESIDENTIAL,18700,0,18700,69600,0,88300
142622901400000,SE 235,RESIDENTIAL,18700,0,18700,82800,0,101500
142623000100000,SE 235,RESIDENTIAL,25200,0,25200,69000,0,94200
142623000200000,SE 235,RESIDENTIAL,500,0,500,0,0,500
142623000300000,SE 235,RESIDENTIAL,24400,0,24400,87100,0,111500
142623000400000,SE 235,RESIDENTIAL,24600,0,24600,113300,0,137900
142623000500000,SE 235,RESIDENTIAL,25000,0,25000,89300,0,114300
142623000600000,SE 235,RESIDENTIAL,37600,0,37600,89600,0,127200
142623000700000,SE 235,RESIDENTIAL,23600,0,23600,115700,0,139300
142623000800000,SE 235,RESIDENTIAL,37600,0,37600,90000,0,127600
142623000900000,SE 235,RESIDENTIAL,40100,0,40100,115400,0,155500
142623001000000,SE 235,RESIDENTIAL,23900,0,23900,97800,0,121700
142623001100000,SE 235,RESIDENTIAL,18100,0,18100,95300,0,113400
142623001200000,SE 235,RESIDENTIAL,20400,0,20400,48100,0,68500
142623001300000,SE 235,RESIDENTIAL,20800,0,20800,47700,0,68500
142623001400000,SE 235,RESIDENTIAL,20800,0,20800,70200,0,91000
142623001500000,SE 235,RESIDENTIAL,22100,0,22100,69100,0,91200
142623001600000,CITY PROPERTY,EXEMPT,0,0,0,0,0,0
142623001700000,COUNTY PROPERTY,EXEMPT,0,0,0,0,0,0
142623001800000,CENTRALLY ASSESSED,OTHER,0,0,0,0,0,0
142623001900000,CENTRALLY ASSESSED,OTHER,0,0,0,0,0,0
142623002000000,CENTRALLY ASSESSED,OTHER,0,0,0,0,0,0
142623002100000,SE 235,RESIDENTIAL,39800,0,39800,107800,0,147600
142625100100000,CITY PROPERTY,EXEMPT,0,0,0,0,0,0
142627600100000,SE 236,RESIDENTIAL,28600,0,28600,97000,0,125600
142627600200000,SE 236,RESIDENTIAL,31800,0,31800,151400,0,183200
142627600300000,SE 236,RESIDENTIAL,31000,0,31000,153200,0,184200
142627600400000,SE 236,RESIDENTIAL,28700,0,28700,113700,0,142400
142627600500000,SE 236,RESIDENTIAL,25900,0,25900,121900,0,147800
142627600600000,SE 236,RESIDENTIAL,20500,0,20500,109400,0,129900
142627600700000,SE 236,RESIDENTIAL,21900,0,21900,85700,0,107600
142627600800000,SE 236,RESIDENTIAL,28600,0,28600,114000,0,142600
142627600900000,SE 236,RESIDENTIAL,24400,0,24400,95100,0,119500
142627601000000,SE 236,RESIDENTIAL,23100,0,23100,107100,0,130200
142627601100000,SE 236,RESIDENTIAL,22300,0,22300,124200,0,146500
142627601200000,SE 236,RESIDENTIAL,23000,0,23000,107600,0,130600
142627601300000,SE 236,RESIDENTIAL,26400,0,26400,149500,0,175900
142627601400000,SE 236,RESIDENTIAL,23300,0,23300,92500,0,115800
142627601500000,SE 236,RESIDENTIAL,21800,0,21800,103300,0,125100
142627601600000,SE 236,RESIDENTIAL,21400,0,21400,108100,0,129500
142627601700000,SE 236,RESIDENTIAL,22700,0,22700,96400,0,119100
142627601800000,SE 236,RESIDENTIAL,22700,0,22700,101000,0,123700
142627601900000,SE 236,RESIDENTIAL,21300,0,21300,96600,0,117900
142627602000000,SE 236,RESIDENTIAL,22100,0,22100,90700,0,112800
142627602100000,SE 236,RESIDENTIAL,22100,0,22100,83900,0,106000
142627602200000,SE 236,RESIDENTIAL,22700,0,22700,71800,0,94500
142627602300000,SE 236,RESIDENTIAL,21800,0,21800,91600,0,113400
142627700100000,SE 236,RESIDENTIAL,32400,0,32400,186300,0,218700
142627700200000,SE 236,RESIDENTIAL,30300,0,30300,132200,0,162500
142627700300000,SE 236,RESIDENTIAL,27700,0,27700,121700,0,149400
142627700400000,SE 236,RESIDENTIAL,20800,0,20800,96600,0,117400
142627700500000,SE 236,RESIDENTIAL,20200,0,20200,103700,0,123900
142627700600000,SE 236,RESIDENTIAL,20000,0,20000,109600,0,129600
142627700700000,SE 236,RESIDENTIAL,19400,0,19400,84900,0,104300
142627700800000,SE 236,RESIDENTIAL,21700,0,21700,113200,0,134900
142627700900000,SE 236,RESIDENTIAL,24100,0,24100,108100,0,132200
142627701000000,SE 236,RESIDENTIAL,27200,0,27200,104900,0,132100
142627701100000,SE 236,RESIDENTIAL,24500,0,24500,105500,0,130000
142627701200000,SE 236,RESIDENTIAL,24400,0,24400,97400,0,121800
142627701300000,SE 236,RESIDENTIAL,23000,0,23000,93100,0,116100
142627701400000,SE 236,RESIDENTIAL,24700,0,24700,120200,0,144900
142627701500000,SE 236,RESIDENTIAL,24400,0,24400,87700,0,112100
142627701600000,SE 236,RESIDENTIAL,25200,0,25200,96100,0,121300
142627701700000,SE 236,RESIDENTIAL,26300,0,26300,106600,0,132900
142627701800000,SE 236,RESIDENTIAL,27800,0,27800,99000,0,126800
142627701900000,SE 236,RESIDENTIAL,26600,0,26600,127300,0,153900
142627702000000,SE 236,RESIDENTIAL,27900,0,27900,123300,0,151200
142627702100000,SE 236,RESIDENTIAL,26800,0,26800,112400,0,139200
142627800100000,SE 236,RESIDENTIAL,20300,0,20300,104500,0,124800
142627800200000,SE 236,RESIDENTIAL,24300,0,24300,103800,0,128100
142627800300000,SE 236,RESIDENTIAL,22500,0,22500,97900,0,120400
142627800400000,SE 236,RESIDENTIAL,24300,0,24300,105000,0,129300
142627800500000,SE 236,RESIDENTIAL,22800,0,22800,102600,0,125400
142627800600000,SE 236,RESIDENTIAL,21500,0,21500,110500,0,132000
142627800700000,SE 236,RESIDENTIAL,23000,0,23000,121900,0,144900
142627800800000,SE 236,RESIDENTIAL,26300,0,26300,120800,0,147100
142627800900000,SE 236,RESIDENTIAL,27500,0,27500,98300,0,125800
142627801000000,SE 236,RESIDENTIAL,48100,0,48100,117100,0,165200
142627801100000,SE 236,RESIDENTIAL,26800,0,26800,134700,0,161500
142627801200000,SE 236,RESIDENTIAL,26500,0,26500,102400,0,128900
142627801300000,SE 237,RESIDENTIAL,26300,0,26300,93100,0,119400
142627801400000,SE 236,RESIDENTIAL,25200,0,25200,103700,0,128900
142627801500000,SE 236,RESIDENTIAL,25900,0,25900,110200,0,136100
142627801600000,SE 236,RESIDENTIAL,28000,0,28000,125800,0,153800
142627801700000,SE 236,RESIDENTIAL,31800,0,31800,145700,0,177500
142627801800000,SE 236,RESIDENTIAL,26700,0,26700,104000,0,130700
142627900100000,SE 236,RESIDENTIAL,23000,0,23000,86700,0,109700
142627900200000,SE 236,RESIDENTIAL,23100,0,23100,109900,0,133000
142627900300000,SE 236,RESIDENTIAL,22800,0,22800,106400,0,129200
142627900400000,SE 236,RESIDENTIAL,22800,0,22800,96700,0,119500
142627900500000,SE 236,RESIDENTIAL,23000,0,23000,101200,0,124200
142627900600000,SE 236,RESIDENTIAL,23200,0,23200,105300,0,128500
142627900700000,SE 236,RESIDENTIAL,24300,0,24300,100100,0,124400
142627900800000,SE 236,RESIDENTIAL,23500,0,23500,96700,0,120200
142627900900000,SE 236,RESIDENTIAL,25000,0,25000,83000,0,108000
142627901000000,SE 236,RESIDENTIAL,24700,0,24700,92500,0,117200
142627901100000,SE 236,RESIDENTIAL,24300,0,24300,115200,0,139500
142627901200000,SE 236,RESIDENTIAL,23800,0,23800,96100,0,119900
142627901300000,SE 236,RESIDENTIAL,24900,0,24900,92300,0,117200
142627901400000,SE 236,RESIDENTIAL,25600,0,25600,112100,0,137700
142627901500000,SE 236,RESIDENTIAL,24200,0,24200,116600,0,140800
142627901600000,SE 236,RESIDENTIAL,26100,0,26100,108400,0,134500
142627901700000,SE 236,RESIDENTIAL,30000,0,30000,131400,0,161400
142627901800000,SE 236,RESIDENTIAL,30300,0,30300,148600,0,178900
142627901900000,SE 236,RESIDENTIAL,29300,0,29300,117300,0,146600
142627902000000,SE 236,RESIDENTIAL,25800,0,25800,107800,0,133600
142627902100000,SE 236,RESIDENTIAL,27100,0,27100,98000,0,125100
142627902200000,SE 236,RESIDENTIAL,27200,0,27200,114400,0,141600
142627902300000,SE 236,RESIDENTIAL,25700,0,25700,124200,0,149900
142627902400000,SE 236,RESIDENTIAL,25700,0,25700,93500,0,119200
142627902500000,SE 236,RESIDENTIAL,19300,0,19300,92500,0,111800
142627902600000,SE 236,RESIDENTIAL,21400,0,21400,85700,0,107100
142627902700000,SE 236,RESIDENTIAL,21400,0,21400,77400,0,98800
142628000100000,SE 236,RESIDENTIAL,19600,0,19600,114200,0,133800
142628000200000,SE 236,RESIDENTIAL,21300,0,21300,133500,0,154800
142628000300000,SE 236,RESIDENTIAL,20400,0,20400,88900,0,109300
142628000400000,SE 236,RESIDENTIAL,20400,0,20400,57900,0,78300
142628000500000,SE 236,RESIDENTIAL,20400,0,20400,89500,0,109900
142628000600000,SE 236,RESIDENTIAL,20400,0,20400,125400,0,145800
142628000700000,SE 236,RESIDENTIAL,21800,0,21800,120900,0,142700
142628000800000,SE 236,RESIDENTIAL,21400,0,21400,72600,0,94000
142628000900000,SE 236,RESIDENTIAL,21400,0,21400,108900,0,130300
142628001000000,SE 236,RESIDENTIAL,21400,0,21400,96600,0,118000
142628001100000,SE 236,RESIDENTIAL,20300,0,20300,73600,0,93900
142628001200000,SE 236,RESIDENTIAL,21300,0,21300,89800,0,111100
142628001300000,SE 236,RESIDENTIAL,8000,0,8000,0,0,8000
142628100100000,SE 236,RESIDENTIAL,24500,0,24500,108800,0,133300
142628100200000,SE 236,RESIDENTIAL,22500,0,22500,100200,0,122700
142628100300000,SE 236,RESIDENTIAL,22500,0,22500,104400,0,126900
142628100400000,SE 236,RESIDENTIAL,20500,0,20500,90700,0,111200
142628100500000,SE 236,RESIDENTIAL,20300,0,20300,80800,0,101100
142628100600000,SE 236,RESIDENTIAL,20300,0,20300,94700,0,115000
142628100700000,SE 236,RESIDENTIAL,20300,0,20300,83400,0,103700
142628100800000,SE 236,RESIDENTIAL,21200,0,21200,110900,0,132100
142628100900000,SE 236,RESIDENTIAL,23800,0,23800,99900,0,123700
142628101000000,SE 236,RESIDENTIAL,22600,0,22600,91400,0,114000
142628101100000,SE 236,RESIDENTIAL,23100,0,23100,102400,0,125500
142628101200000,SE 236,RESIDENTIAL,21500,0,21500,97300,0,118800
142628200100000,SE 236,RESIDENTIAL,25500,0,25500,107100,0,132600
142628200200000,SE 236,RESIDENTIAL,26400,0,26400,108800,0,135200
142628200300000,SE 236,RESIDENTIAL,26800,0,26800,95700,0,122500
142628200400000,SE 236,RESIDENTIAL,26300,0,26300,121800,0,148100
142628200500000,SE 236,RESIDENTIAL,26400,0,26400,100000,0,126400
142628200600000,SE 236,RESIDENTIAL,26600,0,26600,94400,0,121000
142628200700000,SE 236,RESIDENTIAL,27600,0,27600,108300,0,135900
142628200800000,SE 236,RESIDENTIAL,27800,0,27800,119900,0,147700
142628200900000,SE 236,RESIDENTIAL,22300,0,22300,100900,0,123200
142628201000000,SE 236,RESIDENTIAL,21600,0,21600,114400,0,136000
142628201100000,SE 236,RESIDENTIAL,20800,0,20800,93500,0,114300
142628201200000,SE 236,RESIDENTIAL,20200,0,20200,88500,0,108700
142628201300000,SE 236,RESIDENTIAL,20500,0,20500,90000,0,110500
142628201400000,SE 236,RESIDENTIAL,20200,0,20200,99600,0,119800
142630100100000,SE 240,RESIDENTIAL,22200,0,22200,105700,0,127900
142630100200000,SE 240,RESIDENTIAL,23200,0,23200,125300,0,148500
142630100300000,SE 240,RESIDENTIAL,23200,0,23200,89500,0,112700
142630100400000,SE 240,RESIDENTIAL,23200,0,23200,91300,0,114500
142630100500000,SE 240,RESIDENTIAL,29200,0,29200,109900,0,139100
142630100600000,SE 240,RESIDENTIAL,39300,0,39300,153600,0,192900
142630200100000,SE 240,RESIDENTIAL,27700,0,27700,94100,0,121800
142630200200000,SE 240,RESIDENTIAL,15300,0,15300,0,0,15300
142630200300000,SE 240,RESIDENTIAL,41000,0,41000,0,0,41000
142630200400000,SE 240,RESIDENTIAL,59300,0,59300,248600,0,307900
142630200500000,SE 240,RESIDENTIAL,22600,0,22600,3300,0,25900
142630200600000,SE 240,RESIDENTIAL,21000,0,21000,4600,0,25600
142630200700000,SE 240,RESIDENTIAL,20600,0,20600,4300,0,24900
142630200800000,SE 240,RESIDENTIAL,30600,0,30600,103200,0,133800
142630200900000,SE 240,RESIDENTIAL,46100,0,46100,0,0,46100
142630201000000,SE 240,RESIDENTIAL,40500,0,40500,131200,0,171700
142630201100000,SE 240,RESIDENTIAL,26400,0,26400,106700,0,133100
142630201200000,SE 240,RESIDENTIAL,42500,0,42500,243700,0,286200
142630201300000,SE 240,RESIDENTIAL,42800,0,42800,151100,0,193900
142630201400000,SE 240,RESIDENTIAL,29500,0,29500,112200,0,141700
142630201500000,SE 240,RESIDENTIAL,28600,0,28600,78400,0,107000
142630201600000,SE 240,RESIDENTIAL,29000,0,29000,126200,0,155200
142630201700000,SE 240,RESIDENTIAL,27900,0,27900,101100,0,129000
142630201800000,SE 240,RESIDENTIAL,26600,0,26600,99300,0,125900
142630300100000,SE 240,RESIDENTIAL,35200,0,35200,134100,0,169300
142630300200000,SE 240,RESIDENTIAL,31100,0,31100,72900,0,104000
142630300300000,SE 240,RESIDENTIAL,31000,0,31000,154600,0,185600
142632600100000,SE 240,RESIDENTIAL,67800,0,67800,205900,0,273700
142632600200000,CITY PROPERTY,EXEMPT,0,0,0,0,0,0
142632600300000,SE 240,RESIDENTIAL,39200,0,39200,19800,0,59000
142632601100000,SE 240,RESIDENTIAL,36300,0,36300,112000,0,148300
142632602100000,SE 240,RESIDENTIAL,35500,0,35500,145500,0,181000
142635100100000,SE 242,AG LAND,6400,0,6400,0,0,6400
142635100200000,SE 242,AG DWELLING,9700,0,9700,52300,2600,64600
142637600100000,SE 240,RESIDENTIAL,33700,0,33700,0,0,33700
142637600200000,SE 240,RESIDENTIAL,40000,0,40000,125200,0,165200
142637700100000,SE 240,RESIDENTIAL,42000,0,42000,66600,0,108600
142637700200000,SE 240,RESIDENTIAL,34700,0,34700,0,0,34700
142637700300000,CITY PROPERTY,EXEMPT,0,0,0,0,0,0
142637700400000,CITY PROPERTY,EXEMPT,0,0,0,0,0,0
142637700500000,SE 240,RESIDENTIAL,45300,0,45300,137800,0,183100
142637700600000,SE 240,RESIDENTIAL,28600,0,28600,80700,0,109300
142637700700000,SE 240,RESIDENTIAL,46500,0,46500,111700,0,158200
142637700800000,SE 240,RESIDENTIAL,42400,0,42400,128900,0,171300
142640100100000,APARTMENT,RESIDENTIAL,80800,0,80800,493800,0,574600
142640100200000,APARTMENT,RESIDENTIAL,73600,0,73600,475800,0,549400
142640100300000,APARTMENT,RESIDENTIAL,239600,0,239600,1353300,0,1592900
142640100400000,SE 242,RESIDENTIAL,37800,0,37800,105300,0,143100
142640100500000,SE 242,RESIDENTIAL,51700,0,51700,154300,0,206000
142640100600000,CHURCH,EXEMPT,0,37700,37700,0,54000,91700
142640100700000,SE 242,RESIDENTIAL,53500,0,53500,85800,0,139300
142640100800000,SE 242,RESIDENTIAL,50700,0,50700,0,0,50700
142640100900000,SE 242,RESIDENTIAL,50700,0,50700,0,0,50700
142640101400000,APARTMENT,RESIDENTIAL,176000,0,176000,866800,0,1042800
142640200100000,SE 242,EXEMPT,0,19900,19900,0,97400,117300
142640200200000,SE 242,RESIDENTIAL,18800,0,18800,118300,0,137100
142640200300000,SE 242,RESIDENTIAL,20400,0,20400,98800,0,119200
142640200400000,SE 242,RESIDENTIAL,20400,0,20400,98500,0,118900
142640200500000,SE 242,RESIDENTIAL,19700,0,19700,101300,0,121000
142640200600000,SE 242,RESIDENTIAL,17100,0,17100,0,0,17100
142640300100000,SE 242,RESIDENTIAL,53200,0,53200,169000,0,222200
142642600100000,SE 242,RESIDENTIAL,50000,0,50000,0,0,50000
142642600200000,SE 242,RESIDENTIAL,55800,0,55800,0,0,55800
142642600300000,SE 242,RESIDENTIAL,65400,0,65400,70000,0,135400
142642600400000,SE 242,RESIDENTIAL,32000,0,32000,74700,0,106700
142642600500000,SE 242,RESIDENTIAL,24400,0,24400,81000,0,105400
142642600600000,SE 242,RESIDENTIAL,7000,0,7000,0,0,7000
142642600700000,SE 242,RESIDENTIAL,33800,0,33800,0,0,33800
142642600800000,SE 242,RESIDENTIAL,6800,0,6800,0,0,6800
142642600900000,SE 240,RESIDENTIAL,56800,0,56800,0,0,56800
142642601000000,SE 240,RESIDENTIAL,48300,0,48300,278900,0,327200
142642601200000,SE 240,RESIDENTIAL,36100,0,36100,147000,0,183100
142642601300000,SE 240,RESIDENTIAL,36100,0,36100,191100,0,227200
142642601400000,SE 240,RESIDENTIAL,36300,0,36300,139400,0,175700
142642601500000,SE 240,RESIDENTIAL,33000,0,33000,164800,0,197800
142642601600000,SE 240,RESIDENTIAL,60700,0,60700,149200,0,209900
142642601700000,SE 240,RESIDENTIAL,53100,0,53100,159700,0,212800
142642601800000,SE 240,RESIDENTIAL,40000,0,40000,129900,0,169900
142642601900000,SE 240,RESIDENTIAL,40900,0,40900,135000,0,175900
142642602000000,SE 240,RESIDENTIAL,36200,0,36200,146600,0,182800
142642700100000,SE 242,RESIDENTIAL,50800,0,50800,150300,0,201100
142642700200000,SE 242,RESIDENTIAL,18900,0,18900,0,0,18900
142645100100000,SE 242,RESIDENTIAL,18000,0,18000,0,0,18000
142645100200000,SE 242,RESIDENTIAL,50000,0,50000,82200,0,132200
142645100300000,SE 240,RESIDENTIAL,55700,0,55700,120100,0,175800
142645100400000,SE 240,RESIDENTIAL,45900,0,45900,107600,0,153500
142645100500000,SE 240,RESIDENTIAL,47400,0,47400,56900,0,104300
142645100600000,SE 240,RESIDENTIAL,52100,0,52100,0,0,52100
142645100700000,SE 240,RESIDENTIAL,52200,0,52200,0,0,52200
142645100800000,SE 240,RESIDENTIAL,36400,0,36400,0,0,36400
142645100900000,SE 242,RESIDENTIAL,55100,0,55100,0,0,55100
142645101000000,SE 242,RESIDENTIAL,28000,0,28000,52700,0,80700
142645101100000,SE 242,RESIDENTIAL,26600,0,26600,65600,0,92200
142647600100000,SE 242,RESIDENTIAL,66100,0,66100,244700,0,310800
142647600200000,SE 242,RESIDENTIAL,31500,0,31500,77200,0,108700
142647600300000,SE 242,RESIDENTIAL,36400,0,36400,44200,0,80600
142647600400000,SE 242,RESIDENTIAL,72300,0,72300,194900,0,267200
142647600500000,SE 242,RESIDENTIAL,68000,0,68000,120800,0,188800
142647600600000,SE 242,RESIDENTIAL,42400,0,42400,33000,0,75400
142647600700000,SE 242,RESIDENTIAL,53500,0,53500,0,0,53500
142647600800000,COUNTY PROPERTY,EXEMPT,0,0,0,0,0,0
142647600900000,SE 242,RESIDENTIAL,5000,0,5000,0,0,5000
142710100100000,SE 235,RESIDENTIAL,17100,0,17100,44700,0,61800
142710100200000,SE 235,RESIDENTIAL,19200,0,19200,55000,0,74200
142710100300000,SE 235,RESIDENTIAL,20800,0,20800,77700,0,98500
142710100400000,SE 235,RESIDENTIAL,20800,0,20800,81000,0,101800
142710100500000,SE 235,RESIDENTIAL,21600,0,21600,48900,0,70500
142710100600000,SE 235,RESIDENTIAL,17600,0,17600,51300,0,68900
142710100700000,SE 235,RESIDENTIAL,41600,0,41600,116300,0,157900
142710100800000,SE 235,RESIDENTIAL,62400,0,62400,0,0,62400
142710100900000,SE 235,RESIDENTIAL,23600,0,23600,90600,0,114200
142710101000000,SE 235,RESIDENTIAL,22200,0,22200,108500,0,130700
142710101100000,SE 235,RESIDENTIAL,24300,0,24300,51300,0,75600
142710101200000,SE 235,RESIDENTIAL,20800,0,20800,85600,0,106400
142710101300000,SE 235,RESIDENTIAL,20800,0,20800,101700,0,122500
142710101600000,SE 235,RESIDENTIAL,49900,0,49900,84500,0,134400
142710200100000,SE 235,RESIDENTIAL,24100,0,24100,70300,0,94400
142710200200000,SE 235,RESIDENTIAL,14100,0,14100,81200,0,95300
142710200300000,SE 235,RESIDENTIAL,13300,0,13300,66200,0,79500
142710200400000,SE 235,RESIDENTIAL,12700,0,12700,91900,0,104600
142710200500000,SE 235,RESIDENTIAL,17500,0,17500,83000,0,100500
142710200600000,SE 235,RESIDENTIAL,17500,0,17500,82100,0,99600
142710200700000,SE 235,RESIDENTIAL,17500,0,17500,121400,0,138900
142710200800000,SE 235,RESIDENTIAL,17500,0,17500,94500,0,112000
142710200900000,SE 235,RESIDENTIAL,17500,0,17500,74900,0,92400
142710201000000,SE 235,RESIDENTIAL,17500,0,17500,81900,0,99400
142710201100000,SE 235,RESIDENTIAL,17500,0,17500,84000,0,101500
142710201200000,SE 235,RESIDENTIAL,17500,0,17500,93100,0,110600
142710201300000,SE 235,RESIDENTIAL,15400,0,15400,75300,0,90700
142710201400000,SE 235,RESIDENTIAL,13300,0,13300,89900,0,103200
142710201500000,SE 235,RESIDENTIAL,17900,0,17900,72700,0,90600
142710201600000,SE 235,RESIDENTIAL,22200,0,22200,49600,0,71800
142710201700000,SE 235,RESIDENTIAL,15600,0,15600,80500,0,96100
142710201800000,SE 235,RESIDENTIAL,20800,0,20800,117200,0,138000
142710201900000,SE 235,RESIDENTIAL,20800,0,20800,73700,0,94500
142710202000000,SE 235,RESIDENTIAL,20800,0,20800,90300,0,111100
142710202100000,SE 235,RESIDENTIAL,15600,0,15600,58700,0,74300
142710300100000,SE 235,RESIDENTIAL,18900,0,18900,97600,0,116500
142710300200000,SE 235,RESIDENTIAL,19400,0,19400,97400,0,116800
142710300300000,SE 235,RESIDENTIAL,25600,0,25600,106100,0,131700
142710300400000,SE 235,RESIDENTIAL,18900,0,18900,58600,0,77500
142710300500000,SE 235,RESIDENTIAL,10500,0,10500,51200,0,61700
142710300600000,SE 235,RESIDENTIAL,10500,0,10500,40900,0,51400
142710300700000,SE 235,RESIDENTIAL,17300,0,17300,0,0,17300
142710301000000,SE 235,RESIDENTIAL,15800,0,15800,34300,0,50100
142710301100000,SE 235,RESIDENTIAL,21100,0,21100,28600,0,49700
142710301200000,SE 235,RESIDENTIAL,21000,0,21000,44500,0,65500
142710301300000,SE 235,RESIDENTIAL,23600,0,23600,40900,0,64500
142710301400000,SE 235,RESIDENTIAL,14700,0,14700,56600,0,71300
142710301600000,SE 235,RESIDENTIAL,23400,0,23400,12500,0,35900
142710301700000,SE 235,RESIDENTIAL,23400,0,23400,45100,0,68500
142710301800000,SE 235,RESIDENTIAL,17300,0,17300,40000,0,57300
142710301900000,SE 235,RESIDENTIAL,17300,0,17300,45600,0,62900
142710302000000,SE 235,RESIDENTIAL,17300,0,17300,50500,0,67800
142710302100000,SE 235,RESIDENTIAL,17300,0,17300,33100,0,50400
142710302200000,SE 235,RESIDENTIAL,16400,0,16400,60300,0,76700
142710302300000,SE 235,RESIDENTIAL,17100,0,17100,53900,0,71000
142710302400000,SE 235,RESIDENTIAL,17300,0,17300,42200,0,59500
142710302500000,SE 235,RESIDENTIAL,17300,0,17300,68400,0,85700
142710302600000,SE 235,RESIDENTIAL,14600,0,14600,59900,0,74500
142710302700000,SE 235,RESIDENTIAL,18100,0,18100,83400,0,101500
142710302800000,SE 235,RESIDENTIAL,25000,0,25000,57000,0,82000
142710302900000,SE 235,RESIDENTIAL,25000,0,25000,52400,0,77400
142710303000000,SE 235,RESIDENTIAL,14000,0,14000,74600,0,88600
142710303100000,SE 235,RESIDENTIAL,14000,0,14000,63800,0,77800
142710303200000,SE 235,RESIDENTIAL,18100,0,18100,40200,0,58300
142710303300000,SE 235,RESIDENTIAL,22400,0,22400,105600,0,128000
142710303400000,SE 235,RESIDENTIAL,19700,0,19700,81400,0,101100
142710303500000,SE 235,RESIDENTIAL,17500,0,17500,70300,0,87800
142710303600000,SE 235,RESIDENTIAL,17500,0,17500,64000,0,81500
142710303700000,SE 235,RESIDENTIAL,17500,0,17500,68800,0,86300
142710303800000,SE 235,RESIDENTIAL,17500,0,17500,71100,0,88600
142710303900000,SE 235,RESIDENTIAL,17500,0,17500,77100,0,94600
142710304000000,SE 235,RESIDENTIAL,17500,0,17500,66200,0,83700
142710304100000,SE 235,RESIDENTIAL,17500,0,17500,71600,0,89100
142710304200000,SE 235,RESIDENTIAL,17500,0,17500,110200,0,127700
142710304300000,SE 235,RESIDENTIAL,17500,0,17500,0,0,17500
142710304400000,SE 235,RESIDENTIAL,17500,0,17500,103000,0,120500
142710304500000,SE 235,RESIDENTIAL,17500,0,17500,113200,0,130700
142710304600000,SE 235,RESIDENTIAL,17500,0,17500,112100,0,129600
142710304700000,SE 235,RESIDENTIAL,17500,0,17500,116800,0,134300
142710304800000,SE 235,RESIDENTIAL,17500,0,17500,31000,0,48500
142710304900000,SE 235,RESIDENTIAL,18800,0,18800,96100,0,114900
142710305000000,SE 235,RESIDENTIAL,5800,0,5800,0,0,5800
142710305100000,SMALL RETAIL,COMMERCIAL,0,31500,31500,0,74100,105600
142710400100000,VACANT LAND,COMMERCIAL,0,30600,30600,0,0,30600
142710400200000,SE 235,RESIDENTIAL,15200,0,15200,0,0,15200
142710400300000,SE 235,RESIDENTIAL,15200,0,15200,71000,0,86200
142710400400000,SE 235,RESIDENTIAL,24700,0,24700,54300,0,79000
142710400500000,SE 235,RESIDENTIAL,17700,0,17700,57800,0,75500
142710400600000,SE 235,RESIDENTIAL,17700,0,17700,23200,0,40900
142710400700000,CEMETERY,EXEMPT,0,6600,6600,0,0,6600
142710400800000,SE 235,RESIDENTIAL,17700,0,17700,49700,0,67400
142710400900000,SE 235,RESIDENTIAL,17700,0,17700,55300,0,73000
142710401000000,SE 235,RESIDENTIAL,17700,0,17700,15300,0,33000
142710401100000,SE 235,RESIDENTIAL,17700,0,17700,18700,0,36400
142710401200000,SE 235,RESIDENTIAL,22600,0,22600,60200,0,82800
142710401300000,SE 235,RESIDENTIAL,17700,0,17700,56900,0,74600
142710401400000,SE 235,RESIDENTIAL,17700,0,17700,56400,0,74100
142710401500000,SE 235,RESIDENTIAL,17700,0,17700,21200,0,38900
142710401600000,SE 235,RESIDENTIAL,21200,0,21200,60200,0,81400
142710401700000,SE 235,RESIDENTIAL,24700,0,24700,102500,0,127200
142710401800000,SE 235,RESIDENTIAL,17700,0,17700,26600,0,44300
142710401900000,SE 235,RESIDENTIAL,17500,0,17500,69000,0,86500
142710402000000,SE 235,RESIDENTIAL,19400,0,19400,64100,0,83500
142710500100000,SE 235,RESIDENTIAL,18600,0,18600,62000,0,80600
142710500200000,SE 235,RESIDENTIAL,19300,0,19300,87400,0,106700
142710500300000,SE 235,RESIDENTIAL,19300,0,19300,73900,0,93200
142710500400000,SE 235,RESIDENTIAL,20500,0,20500,104500,0,125000
142710500500000,SE 235,RESIDENTIAL,20100,0,20100,99100,0,119200
142710500600000,SE 235,RESIDENTIAL,19800,0,19800,66300,0,86100
142710500700000,SE 235,RESIDENTIAL,20800,0,20800,71500,0,92300
142710500800000,SE 235,RESIDENTIAL,21500,0,21500,58200,0,79700
142710500900000,SE 235,RESIDENTIAL,36900,0,36900,11100,0,48000
142710501000000,SE 235,RESIDENTIAL,27700,0,27700,116100,0,143800
142710501100000,SE 235,RESIDENTIAL,22000,0,22000,57300,0,79300
142710501200000,SE 235,RESIDENTIAL,19700,0,19700,75900,0,95600
142710501300000,SE 235,RESIDENTIAL,21300,0,21300,79400,0,100700
142710501400000,SE 235,RESIDENTIAL,21000,0,21000,73700,0,94700
142710501500000,SE 235,RESIDENTIAL,20300,0,20300,111800,0,132100
142712600100000,CEMETERY,EXEMPT,0,1766400,1766400,0,28500,1794900
142712600200000,SE 249,RESIDENTIAL,20200,0,20200,68600,0,88800
142712600300000,SE 249,RESIDENTIAL,20500,0,20500,72100,0,92600
142712600400000,SE 249,RESIDENTIAL,20900,0,20900,71300,0,92200
142712600500000,SE 249,RESIDENTIAL,13800,0,13800,71100,0,84900
142712600600000,SE 249,RESIDENTIAL,19700,0,19700,66100,0,85800
142712600700000,SE 249,RESIDENTIAL,19700,0,19700,83200,0,102900
142712600800000,SE 249,RESIDENTIAL,19700,0,19700,66300,0,86000
142712600900000,SE 249,RESIDENTIAL,13800,0,13800,96600,0,110400
142712601000000,SE 249,RESIDENTIAL,19700,0,19700,74700,0,94400
142712601100000,SE 249,RESIDENTIAL,19700,0,19700,70200,0,89900
142712601200000,SE 249,RESIDENTIAL,19700,0,19700,63700,0,83400
142712601300000,SE 249,RESIDENTIAL,19700,0,19700,66800,0,86500
142712601400000,SE 249,RESIDENTIAL,20700,0,20700,70100,0,90800
142712601500000,SE 249,RESIDENTIAL,20600,0,20600,58400,0,79000
142712601600000,SE 249,RESIDENTIAL,20500,0,20500,69500,0,90000
142712601700000,SE 249,RESIDENTIAL,20500,0,20500,86400,0,106900
142712700100000,SE 249,RESIDENTIAL,20200,0,20200,77700,0,97900
142712700200000,SE 249,RESIDENTIAL,20000,0,20000,66800,0,86800
142712700300000,SE 249,RESIDENTIAL,20000,0,20000,70200,0,90200
142712700400000,SE 249,RESIDENTIAL,20000,0,20000,75100,0,95100
142712700500000,SE 249,RESIDENTIAL,20000,0,20000,65200,0,85200
142712700600000,SE 249,RESIDENTIAL,20000,0,20000,71000,0,91000
142712700700000,SE 249,RESIDENTIAL,20000,0,20000,78500,0,98500
142712700800000,SE 249,RESIDENTIAL,20000,0,20000,62000,0,82000
142712700900000,SE 249,RESIDENTIAL,20200,0,20200,80600,0,100800
142715100100000,CEMETERY,EXEMPT,0,896200,896200,0,4700,900900
142715200100000,SE 237,RESIDENTIAL,9600,0,9600,69100,0,78700
142715200200000,SE 237,RESIDENTIAL,8000,0,8000,53900,0,61900
142715200300000,SE 237,RESIDENTIAL,8000,0,8000,56800,0,64800
142715200400000,SE 237,RESIDENTIAL,8000,0,8000,41500,0,49500
142715200500000,SE 237,RESIDENTIAL,8000,0,8000,63100,0,71100
142715200600000,SE 237,RESIDENTIAL,8200,0,8200,98500,0,106700
142715200700000,SE 237,RESIDENTIAL,6100,0,6100,47500,0,53600
142715200800000,SE 237,RESIDENTIAL,5800,0,5800,29000,0,34800
142715200900000,SE 237,RESIDENTIAL,7700,0,7700,47600,0,55300
142715201000000,SE 237,RESIDENTIAL,8000,0,8000,91900,0,99900
142715201100000,SE 237,RESIDENTIAL,8000,0,8000,51400,0,59400
142715201200000,SE 237,RESIDENTIAL,8000,0,8000,86000,0,94000
142715201300000,SE 237,RESIDENTIAL,8000,0,8000,70700,0,78700
142715201400000,SE 237,RESIDENTIAL,8000,0,8000,46700,0,54700
142715201500000,SE 237,RESIDENTIAL,8000,0,8000,50700,0,58700
142715201600000,SE 237,RESIDENTIAL,8000,0,8000,31600,0,39600
142715300100000,SE 237,RESIDENTIAL,6400,0,6400,64500,0,70900
142715300200000,SE 237,RESIDENTIAL,6400,0,6400,37100,0,43500
142715300300000,SE 237,RESIDENTIAL,9000,0,9000,34400,0,43400
142715300400000,SE 237,RESIDENTIAL,6400,0,6400,59900,0,66300
142715300500000,SE 237,RESIDENTIAL,8000,0,8000,52100,0,60100
142715300600000,SE 237,RESIDENTIAL,8000,0,8000,65000,0,73000
142715300700000,SE 237,RESIDENTIAL,6400,0,6400,55900,0,62300
142715300800000,SE 237,RESIDENTIAL,8100,0,8100,39600,0,47700
142715300900000,SE 237,RESIDENTIAL,8300,0,8300,51400,0,59700
142715301000000,SE 237,RESIDENTIAL,6400,0,6400,39500,0,45900
142715301100000,SE 237,RESIDENTIAL,6400,0,6400,44900,0,51300
142715301200000,SE 237,RESIDENTIAL,6400,0,6400,30400,0,36800
142715301300000,SE 237,RESIDENTIAL,9600,0,9600,15600,0,25200
142715301400000,SE 237,RESIDENTIAL,9600,0,9600,37700,0,47300
142715400100000,SE 237,RESIDENTIAL,18600,0,18600,47600,0,66200
142715400200000,SE 237,RESIDENTIAL,4300,0,4300,22600,0,26900
142715400300000,OFFICE,EXEMPT,0,13500,13500,0,22900,36400
142715400400000,VACANT LAND,EXEMPT,0,31500,31500,0,0,31500
142715400500000,SE 237,RESIDENTIAL,19200,0,19200,0,0,19200
142715500100000,SE 237,RESIDENTIAL,7000,0,7000,72700,0,79700
142715500200000,SE 237,RESIDENTIAL,7000,0,7000,80600,0,87600
142715500300000,SE 237,RESIDENTIAL,7000,0,7000,68600,0,75600
142715500400000,SE 237,RESIDENTIAL,8000,0,8000,78100,0,86100
142715500500000,SE 237,RESIDENTIAL,8000,0,8000,78800,0,86800
142715500600000,SE 237,RESIDENTIAL,8000,0,8000,66300,0,74300
142715500700000,SE 237,RESIDENTIAL,9600,0,9600,76700,0,86300
142715500800000,CITY PROPERTY,EXEMPT,0,0,0,0,0,0
142715500900000,SE 237,RESIDENTIAL,10000,0,10000,0,0,10000
142715501000000,SE 237,RESIDENTIAL,10000,0,10000,0,0,10000
142715501100000,SE 237,RESIDENTIAL,10000,0,10000,0,0,10000
142715501200000,CITY PROPERTY,EXEMPT,0,0,0,0,0,0
142715600100000,SE 237,RESIDENTIAL,8000,0,8000,55600,0,63600
142715600200000,SE 237,RESIDENTIAL,8000,0,8000,61700,0,69700
142715600300000,SE 237,RESIDENTIAL,12000,0,12000,33674,0,45674
142715600400000,SE 237,RESIDENTIAL,8000,0,8000,39900,0,47900
142715600500000,SE 237,RESIDENTIAL,8000,0,8000,54200,0,62200
142715600600000,SE 237,RESIDENTIAL,9000,0,9000,46800,0,55800
142715600700000,CITY PROPERTY,EXEMPT,0,0,0,0,0,0
142715700100000,CITY PROPERTY,EXEMPT,0,0,0,0,0,0
142717600100000,CITY PROPERTY,EXEMPT,0,0,0,0,0,0
142720100100000,CITY PROPERTY,EXEMPT,0,0,0,0,0,0
142720100200000,SE 237,RESIDENTIAL,9800,0,9800,0,0,9800
142720100300000,SE 237,RESIDENTIAL,9600,0,9600,63400,0,73000
142720100400000,SE 237,RESIDENTIAL,7800,0,7800,40600,0,48400
142720100500000,SE 237,RESIDENTIAL,10200,0,10200,49300,0,59500
142720100600000,SE 237,RESIDENTIAL,8000,0,8000,77100,0,85100
142720100700000,SE 237,RESIDENTIAL,8000,0,8000,67900,0,75900
142720100800000,CEMETERY,EXEMPT,0,182400,182400,0,0,182400
142720200100000,SE 237,RESIDENTIAL,8000,0,8000,78200,0,86200
142720200200000,SE 237,RESIDENTIAL,8000,0,8000,30100,0,38100
142720200300000,SE 237,RESIDENTIAL,8000,0,8000,70000,0,78000
142720200400000,CITY PROPERTY,EXEMPT,0,0,0,0,0,0
142720200500000,SE 237,RESIDENTIAL,8000,0,8000,0,0,8000
142720200600000,SE 237,RESIDENTIAL,8000,0,8000,28100,0,36100
142720200700000,SE 237,RESIDENTIAL,7900,0,7900,36100,0,44000
142720200800000,SE 237,RESIDENTIAL,9500,0,9500,54700,0,64200
142720200900000,SE 237,RESIDENTIAL,7900,0,7900,54200,0,62100
142720201000000,SE 237,RESIDENTIAL,9100,0,9100,75200,0,84300
142720201100000,SE 237,RESIDENTIAL,7900,0,7900,0,0,7900
142720201200000,SE 237,RESIDENTIAL,7700,0,7700,69700,0,77400
142720201300000,SE 237,RESIDENTIAL,7900,0,7900,78400,0,86300
142720201400000,SE 237,RESIDENTIAL,8000,0,8000,50700,0,58700
142720201500000,SE 237,RESIDENTIAL,8000,0,8000,57300,0,65300
142720201600000,SE 237,RESIDENTIAL,8000,0,8000,82500,0,90500
142720201700000,SE 237,RESIDENTIAL,8200,0,8200,24500,0,32700
142720201800000,SE 237,RESIDENTIAL,8600,0,8600,67000,0,75600
142720201900000,SE 237,RESIDENTIAL,7000,0,7000,49600,0,56600
142720202000000,SE 237,RESIDENTIAL,8000,0,8000,30200,0,38200
142720202100000,SE 237,RESIDENTIAL,8000,0,8000,61300,0,69300
142720202200000,CITY PROPERTY,EXEMPT,0,0,0,0,0,0
142720202300000,SE 237,RESIDENTIAL,11800,0,11800,32300,0,44100
142720300100000,SCHOOL,EXEMPT,0,54400,54400,0,81500,135900
142720300200000,AUTO REPAIR/SALES,COMMERCIAL,0,71900,71900,0,119400,191300
142720300202000,BILLBOARD(BLL),COMMERCIAL,0,0,0,0,14500,14500
142720300300000,FLAT PARKING,COMMERCIAL,0,95900,95900,0,15600,111500
142720300400000,FLAT PARKING,COMMERCIAL,0,13400,13400,0,3900,17300
142720300500000,FLAT PARKING,COMMERCIAL,0,5500,5500,0,1100,6600
142720300600000,SMALL RETAIL,COMMERCIAL,0,24500,24500,0,108500,133000
142720300700000,SE 237,RESIDENTIAL,7600,0,7600,24400,0,32000
142720300800000,VACANT LAND,COMMERCIAL,0,10600,10600,0,0,10600
142720301500000,SE 237,RESIDENTIAL,13500,0,13500,124400,0,137900
142720301600000,SE 237,RESIDENTIAL,5200,0,5200,41000,0,46200
142720301700000,SE 237,RESIDENTIAL,5200,0,5200,37800,0,43000
142720301800000,SE 237,RESIDENTIAL,5000,0,5000,41700,0,46700
142720301900000,SE 237,RESIDENTIAL,6200,0,6200,33000,0,39200
142720302000000,SE 237,RESIDENTIAL,5800,0,5800,52200,0,58000
142720302100000,CITY PROPERTY,EXEMPT,0,0,0,0,0,0
142720302200000,CITY PROPERTY,EXEMPT,0,0,0,0,0,0
142720302300000,CITY PROPERTY,EXEMPT,0,0,0,0,0,0
142720302400000,SE 237,RESIDENTIAL,5800,0,5800,0,0,5800
142720302500000,SE 237,RESIDENTIAL,7400,0,7400,129200,0,136600
142720302600000,SE 237,RESIDENTIAL,7700,0,7700,0,0,7700
142720302700000,SE 237,RESIDENTIAL,10800,0,10800,135900,0,146700
142720302800000,SE 237,RESIDENTIAL,12000,0,12000,39200,0,51200
142720302900000,SE 237,RESIDENTIAL,6000,0,6000,38400,0,44400
142720303000000,SE 237,RESIDENTIAL,6000,0,6000,50400,0,56400
142720303100000,SE 237,RESIDENTIAL,6000,0,6000,41700,0,47700
142720303200000,SE 237,RESIDENTIAL,6000,0,6000,44400,0,50400
142720303300000,SE 237,RESIDENTIAL,8400,0,8400,0,0,8400
142720303400000,SE 237,RESIDENTIAL,8700,0,8700,0,0,8700
142720303500000,RESTAURANT,COMMERCIAL,0,43500,43500,0,48500,92000
142720303600000,VACANT LAND,COMMERCIAL,0,4400,4400,0,0,4400
142720303700000,APARTMENT,MULTI-RES,53600,0,53600,2086000,0,2139600
142720400100000,CENTRALLY ASSESSED,OTHER,0,0,0,0,0,0
142720400200000,SE 237,RESIDENTIAL,6000,0,6000,0,0,6000
142720400300000,SE 237,RESIDENTIAL,5400,0,5400,85100,0,90500
142720400400000,SE 237,RESIDENTIAL,6000,0,6000,45900,0,51900
142720400500000,SE 237,RESIDENTIAL,6000,0,6000,56100,0,62100
142720400600000,SE 237,RESIDENTIAL,8000,0,8000,59600,0,67600
142720400700000,DAY CARE CENTER,COMMERCIAL,0,7800,7800,0,48300,56100
142720400800000,SE 237,RESIDENTIAL,8000,0,8000,55400,0,63400
142720400900000,SE 237,RESIDENTIAL,8000,0,8000,36700,0,44700
142720401000000,SE 237,RESIDENTIAL,8000,0,8000,17600,0,25600
142720401100000,SE 237,RESIDENTIAL,8000,0,8000,38900,0,46900
142720401200000,SE 237,RESIDENTIAL,8000,0,8000,45400,0,53400
142720401300000,SE 237,RESIDENTIAL,9600,0,9600,63500,0,73100
142720401400000,SE 237,RESIDENTIAL,7700,0,7700,45400,0,53100
142720401500000,SE 237,RESIDENTIAL,2800,0,2800,0,0,2800
142720401600000,SE 237,RESIDENTIAL,12500,0,12500,86400,0,98900
142720401800000,SE 237,RESIDENTIAL,8000,0,8000,78800,0,86800
142720401900000,SE 237,RESIDENTIAL,8000,0,8000,0,0,8000
142720402000000,SE 237,RESIDENTIAL,7600,0,7600,111400,0,119000
142720402100000,SE 237,RESIDENTIAL,8000,0,8000,48000,0,56000
142720402200000,SE 237,RESIDENTIAL,8100,0,8100,64900,0,73000
142720402300000,SE 237,RESIDENTIAL,8000,0,8000,70600,0,78600
142720402400000,SE 237,RESIDENTIAL,8000,0,8000,48600,0,56600
142720402500000,SE 237,RESIDENTIAL,8000,0,8000,80300,0,88300
142720402600000,CONVERSION-CENT CORE,RESIDENTIAL,8000,0,8000,25200,0,33200
142720402700000,CITY PROPERTY,EXEMPT,0,0,0,0,0,0
142720500100000,SE 237,RESIDENTIAL,8200,0,8200,116800,0,125000
142720600100000,SE 237,RESIDENTIAL,8400,0,8400,127200,0,135600
142720600200000,SE 237,RESIDENTIAL,8200,0,8200,124300,0,132500
142720600300000,SE 237,RESIDENTIAL,6000,0,6000,46200,0,52200
142720600400000,SE 237,RESIDENTIAL,6000,0,6000,62500,0,68500
142720600500000,SE 237,RESIDENTIAL,8400,0,8400,63500,0,71900
142720600600000,SE 237,RESIDENTIAL,8400,0,8400,52800,0,61200
142720600700000,SE 237,RESIDENTIAL,8400,0,8400,109300,0,117700
142720600800000,SE 237,RESIDENTIAL,8100,0,8100,46800,0,54900
142720600900000,SE 237,RESIDENTIAL,8000,0,8000,86300,0,94300
142720601000000,SE 237,RESIDENTIAL,6300,0,6300,114200,0,120500
142720601100000,SE 237,RESIDENTIAL,6700,0,6700,60200,0,66900
142720601200000,SE 237,RESIDENTIAL,8400,0,8400,76900,0,85300
142720601300000,SE 237,RESIDENTIAL,8000,0,8000,57300,0,65300
142720601400000,SE 237,RESIDENTIAL,8200,0,8200,75900,0,84100
142720601500000,SE 237,RESIDENTIAL,3800,0,3800,30337,0,34137
142720601600000,SMALL RETAIL,COMMERCIAL,2520,9480,12000,11760,44240,68000
142720601700000,SE 237,RESIDENTIAL,5200,0,5200,18380,0,23580
142720601800000,SE 237,RESIDENTIAL,4200,0,4200,43900,0,48100
142720601900000,SE 237,RESIDENTIAL,5600,0,5600,60100,0,65700
142720602000000,SE 237,RESIDENTIAL,8900,0,8900,71400,0,80300
142720602300000,SE 237,RESIDENTIAL,8000,0,8000,68800,0,76800
142720602400000,SE 237,RESIDENTIAL,7400,0,7400,51600,0,59000
142720602500000,SE 237,RESIDENTIAL,7900,0,7900,57100,0,65000
142720602600000,CITY PROPERTY,EXEMPT,0,0,0,0,0,0
142720602700000,SE 237,RESIDENTIAL,8500,0,8500,0,0,8500
142720602800000,SE 237,RESIDENTIAL,8000,0,8000,64100,0,72100
142720602900000,SE 237,RESIDENTIAL,7200,0,7200,106700,0,113900
142720603000000,SE 237,RESIDENTIAL,6000,0,6000,57000,0,63000
142720603100000,SE 237,RESIDENTIAL,6000,0,6000,69900,0,75900
142720603200000,SE 237,RESIDENTIAL,11500,0,11500,50000,0,61500
142720700100000,SE 237,RESIDENTIAL,6000,0,6000,30100,0,36100
142720700200000,SE 237,RESIDENTIAL,6000,0,6000,43100,0,49100
142720700300000,SE 237,RESIDENTIAL,8000,0,8000,40400,0,48400
142720700400000,SE 237,RESIDENTIAL,8000,0,8000,0,0,8000
142720700500000,SE 237,RESIDENTIAL,8000,0,8000,47200,0,55200
142720700600000,SE 237,RESIDENTIAL,8000,0,8000,60800,0,68800
142720700700000,SE 237,RESIDENTIAL,8300,0,8300,61700,0,70000
142720700800000,SE 237,RESIDENTIAL,6800,0,6800,32500,0,39300
142720700900000,CITY PROPERTY,EXEMPT,0,0,0,0,0,0
142720701000000,SE 237,RESIDENTIAL,11200,0,11200,69800,0,81000
142720701100000,SE 237,RESIDENTIAL,8000,0,8000,57400,0,65400
142720701200000,SE 237,RESIDENTIAL,8000,0,8000,121300,0,129300
142720701300000,SE 237,RESIDENTIAL,8000,0,8000,71600,0,79600
142720701400000,SE 237,RESIDENTIAL,7200,0,7200,116000,0,123200
142720701500000,SE 237,RESIDENTIAL,7200,0,7200,116000,0,123200
142720701600000,SE 237,RESIDENTIAL,7200,0,7200,120900,0,128100
142720701700000,SE 237,RESIDENTIAL,7200,0,7200,114700,0,121900
142720701800000,SE 237,RESIDENTIAL,8000,0,8000,42100,0,50100
142720701900000,SE 237,RESIDENTIAL,8000,0,8000,56000,0,64000
142720702000000,SE 237,RESIDENTIAL,3000,0,3000,0,0,3000
142720702100000,SMALL RETAIL,COMMERCIAL,0,7700,7700,0,21900,29600
142720702200000,SE 237,RESIDENTIAL,7800,0,7800,52100,0,59900
142720702300000,SE 237,RESIDENTIAL,4800,0,4800,0,0,4800
142720702400000,SE 237,RESIDENTIAL,4800,0,4800,43200,0,48000
142720702500000,CITY PROPERTY,EXEMPT,0,0,0,0,0,0
142720702600000,SE 237,RESIDENTIAL,8000,0,8000,62900,0,70900
142720702700000,SE 237,RESIDENTIAL,8000,0,8000,0,0,8000
142720800100000,SE 237,RESIDENTIAL,6300,0,6300,48900,0,55200
142720800200000,SE 237,RESIDENTIAL,6000,0,6000,60000,0,66000
142720801100000,SE 237,RESIDENTIAL,7100,0,7100,99900,0,107000
142720801200000,SE 237,RESIDENTIAL,7200,0,7200,105500,0,112700
142720801300000,SE 237,RESIDENTIAL,7600,0,7600,135500,0,143100
142720801400000,SE 237,RESIDENTIAL,7600,0,7600,113700,0,121300
142720801500000,SE 237,RESIDENTIAL,7600,0,7600,105700,0,113300
142720801600000,SE 237,RESIDENTIAL,7700,0,7700,131300,0,139000
142722700100000,OFFICE; MED; CTRL CR,COMMERCIAL,0,398400,398400,0,1050600,1449000
142722700200000,FLAT PARKING,EXEMPT,0,46400,46400,0,2300,48700
142722700300000,OFFICE; MED; CTRL CR,EXEMPT,0,326200,326200,0,2066800,2393000
142722900100000,SE 237,RESIDENTIAL,8200,0,8200,39100,0,47300
142722900200000,SE 237,RESIDENTIAL,6700,0,6700,105200,0,111900
142722900300000,SE 237,RESIDENTIAL,6200,0,6200,6600,0,12800
142722900400000,SE 237,RESIDENTIAL,5000,0,5000,29600,0,34600
142722900500000,SE 237,RESIDENTIAL,5000,0,5000,39500,0,44500
142722900600000,SE 237,RESIDENTIAL,9000,0,9000,0,0,9000
142722900700000,SE 237,RESIDENTIAL,8000,0,8000,83600,0,91600
142722900800000,SE 237,RESIDENTIAL,7000,0,7000,65300,0,72300
142722900900000,SE 237,RESIDENTIAL,8000,0,8000,114700,0,122700
142722901000000,SE 237,RESIDENTIAL,8000,0,8000,92100,0,100100
142722901100000,CHURCH,EXEMPT,0,5000,5000,0,30100,35100
142722901400000,SE 237,RESIDENTIAL,7400,0,7400,44200,0,51600
142722901500000,SE 237,RESIDENTIAL,6000,0,6000,76900,0,82900
142722901600000,SE 237,RESIDENTIAL,6000,0,6000,81600,0,87600
142722902000000,SE 237,RESIDENTIAL,7400,0,7400,119700,0,127100
142722902100000,SE 237,RESIDENTIAL,7200,0,7200,117800,0,125000
142722902200000,SE 237,RESIDENTIAL,7200,0,7200,109900,0,117100
142722902400000,SE 237,RESIDENTIAL,700,0,700,0,0,700
142722902500000,SE 237,RESIDENTIAL,7400,0,7400,85100,0,92500
142723000100000,FLAT PARKING,EXEMPT,0,279600,279600,0,32300,311900
142723000600000,FLAT PARKING,EXEMPT,0,330000,330000,0,92800,422800
142723100400000,OFFICE; MED; CTRL CR,COMMERCIAL,0,546000,546000,0,5219600,5765600
142723200100000,SE 237,RESIDENTIAL,6400,0,6400,92100,0,98500
142723200200000,SE 237,RESIDENTIAL,1500,0,1500,0,0,1500
142723200300000,SE 237,RESIDENTIAL,4700,0,4700,115500,0,120200
142723200600000,SE 237,RESIDENTIAL,8000,0,8000,121800,0,129800
142723200700000,SE 237,RESIDENTIAL,8000,0,8000,85500,0,93500
142723200800000,SE 237,RESIDENTIAL,6000,0,6000,61700,0,67700
142723200900000,SE 237,RESIDENTIAL,6000,0,6000,0,0,6000
142723201000000,SE 237,RESIDENTIAL,6300,0,6300,0,0,6300
142723201100000,SE 237,RESIDENTIAL,5900,0,5900,102400,0,108300
142723201200000,SE 237,RESIDENTIAL,8000,0,8000,130000,0,138000
142723201300000,SE 237,RESIDENTIAL,10400,0,10400,116300,0,126700
142723201400000,SE 237,RESIDENTIAL,6000,0,6000,72500,0,78500
142723201500000,SE 237,RESIDENTIAL,7000,0,7000,46700,0,53700
142723201800000,SE 237,RESIDENTIAL,7200,0,7200,141500,0,148700
142723202000000,SE 237,RESIDENTIAL,5400,0,5400,137000,0,142400
142723202100000,SE 237,RESIDENTIAL,8400,0,8400,124500,0,132900
142723202200000,SE 237,RESIDENTIAL,5400,0,5400,140500,0,145900
142723300100000,FLAT PARKING,COMMERCIAL,0,180000,180000,0,18000,198000
142723300200000,OFFICE,EXEMPT,0,318000,318000,0,741500,1059500
142723300300000,FLAT PARKING,EXEMPT,0,28900,28900,0,3400,32300
142723300400000,FLAT PARKING,EXEMPT,0,115700,115700,0,21100,136800
142723400100000,SE 237,RESIDENTIAL,6000,0,6000,142800,0,148800
142723400200000,SE 237,RESIDENTIAL,6000,0,6000,50400,0,56400
142723500200000,SE 237,RESIDENTIAL,3300,0,3300,0,0,3300
142723500300000,SE 237,RESIDENTIAL,5600,0,5600,52500,0,58100
142723500400000,SE 237,RESIDENTIAL,6800,0,6800,91000,0,97800
142723500500000,SE 237,RESIDENTIAL,8400,0,8400,145100,0,153500
142723500600000,SE 237,RESIDENTIAL,6000,0,6000,0,0,6000
142723500700000,SE 237,RESIDENTIAL,6000,0,6000,25400,0,31400
142723500800000,SE 237,RESIDENTIAL,6200,0,6200,58300,0,64500
142723500900000,SE 237,RESIDENTIAL,5800,0,5800,65700,0,71500
142723501000000,SE 237,RESIDENTIAL,8400,0,8400,94000,0,102400
142723501100000,SE 237,RESIDENTIAL,8400,0,8400,109200,0,117600
142723501200000,SE 237,RESIDENTIAL,6000,0,6000,49600,0,55600
142723501300000,SE 237,RESIDENTIAL,6000,0,6000,52900,0,58900
142723501400000,SE 237,RESIDENTIAL,8400,0,8400,94200,0,102600
142723501500000,SE 237,RESIDENTIAL,8400,0,8400,66300,0,74700
142723501700000,SE 237,RESIDENTIAL,5800,0,5800,104700,0,110500
142723600800000,SE 237,RESIDENTIAL,5000,0,5000,0,0,5000
142723600900000,SMALL RETAIL,EXEMPT,0,37800,37800,0,215100,252900
142723601300000,SECTION 42,COMMERCIAL,0,130400,130400,0,939100,1069500
142723700100000,SMALL RET; CTRL CR,COMMERCIAL,0,156800,156800,0,406500,563300
142723700700000,FLAT PARKING,COMMERCIAL,0,29400,29400,0,4500,33900
142723700800000,VACANT LAND,EXEMPT,0,6000,6000,0,0,6000
142723700900000,FLAT PARKING,EXEMPT,0,110700,110700,0,20600,131300
142723701000000,VACANT LAND,EXEMPT,0,11800,11800,0,0,11800
142723701100000,VACANT LAND,EXEMPT,0,10200,10200,0,0,10200
142723701200000,VACANT LAND,EXEMPT,0,4700,4700,0,0,4700
142723800100000,SE 237,RESIDENTIAL,6500,0,6500,53900,0,60400
142723800400000,SE 237,RESIDENTIAL,9000,0,9000,107100,0,116100
142723800500000,SE 237,RESIDENTIAL,7700,0,7700,127200,0,134900
142723800600000,SE 237,RESIDENTIAL,6800,0,6800,133100,0,139900
142723800700000,SE 237,RESIDENTIAL,7000,0,7000,115500,0,122500
142723900100000,OFFICE,EXEMPT,0,63000,63000,0,270800,333800
142723900200000,SE 237,EXEMPT,0,8300,8300,0,0,8300
142723900300000,SMALL RETAIL,COMMERCIAL,0,5400,5400,0,14000,19400
142723900400000,SE 237,RESIDENTIAL,5000,0,5000,110900,0,115900
142723900500000,SE 237,RESIDENTIAL,9000,0,9000,128400,0,137400
142723900600000,SE 237,RESIDENTIAL,9000,0,9000,117000,0,126000
142723900900000,SE 237,RESIDENTIAL,9000,0,9000,122500,0,131500
142723901000000,CHURCH,EXEMPT,0,25200,25200,0,23000,48200
142723901100000,SE 237,RESIDENTIAL,6100,0,6100,53600,0,59700
142723901200000,SE 237,RESIDENTIAL,6300,0,6300,62600,0,68900
142723901300000,SE 237,RESIDENTIAL,5800,0,5800,138500,0,144300
142723901400000,SE 237,RESIDENTIAL,6200,0,6200,138500,0,144700
142723901500000,SE 237,RESIDENTIAL,6000,0,6000,0,0,6000
142724000100000,CHURCH,EXEMPT,0,22800,22800,0,212900,235700
142724000200000,SE 237,RESIDENTIAL,7900,0,7900,52600,0,60500
142724000600000,SE 237,RESIDENTIAL,300,0,300,0,0,300
142724000700000,SE 237,RESIDENTIAL,6000,0,6000,65400,0,71400
142724000800000,SE 237,RESIDENTIAL,6000,0,6000,68300,0,74300
142724000900000,SE 237,RESIDENTIAL,5400,0,5400,48200,0,53600
142724001000000,SE 237,RESIDENTIAL,2000,0,2000,0,0,2000
142724001100000,CITY PROPERTY,EXEMPT,0,0,0,0,0,0
142724001200000,SE 237,RESIDENTIAL,9000,0,9000,68000,0,77000
142724001300000,SE 237,RESIDENTIAL,9000,0,9000,0,0,9000
142724001400000,SE 237,RESIDENTIAL,9000,0,9000,47100,0,56100
142724001500000,SE 237,RESIDENTIAL,9000,0,9000,42800,0,51800
142724001600000,SE 237,RESIDENTIAL,8000,0,8000,0,0,8000
142724001700000,SE 237,RESIDENTIAL,1800,0,1800,0,0,1800
142724001800000,SE 244,RESIDENTIAL,8700,0,8700,0,0,8700
142724001900000,SE 244,RESIDENTIAL,9300,0,9300,0,0,9300
142724200200000,HOSPITAL,EXEMPT,0,72900,72900,0,0,72900
142725100300000,SE 237,RESIDENTIAL,2700,0,2700,0,0,2700
142725100400000,SE 237,RESIDENTIAL,5000,0,5000,0,0,5000
142725100500000,SE 237,RESIDENTIAL,6400,0,6400,71000,0,77400
142725100600000,SE 237,RESIDENTIAL,9300,0,9300,101100,0,110400
142725100700000,SE 237,RESIDENTIAL,6000,0,6000,62200,0,68200
142725100800000,SE 237,RESIDENTIAL,6000,0,6000,0,0,6000
142725100900000,SE 237,RESIDENTIAL,6000,0,6000,65100,0,71100
142725101000000,SE 237,RESIDENTIAL,5000,0,5000,0,0,5000
142725101100000,SE 237,RESIDENTIAL,1100,0,1100,9058,0,10158
142725101200000,SE 237,RESIDENTIAL,7900,0,7900,83900,0,91800
142725101300000,SE 237,RESIDENTIAL,6600,0,6600,32600,0,39200
142725101400000,SE 237,RESIDENTIAL,5400,0,5400,48900,0,54300
142725101500000,SE 237,RESIDENTIAL,6000,0,6000,45900,0,51900
142725101600000,SE 237,RESIDENTIAL,6000,0,6000,0,0,6000
142725101700000,SE 237,RESIDENTIAL,6000,0,6000,57900,0,63900
142725101800000,SE 237,RESIDENTIAL,6000,0,6000,85900,0,91900
142725101900000,SE 237,RESIDENTIAL,8100,0,8100,128900,0,137000
142725200100000,COUNTY PROPERTY,EXEMPT,0,0,0,0,0,0
142725300200000,SE 237,RESIDENTIAL,5000,0,5000,0,0,5000
142725300300000,CITY PROPERTY,EXEMPT,0,0,0,0,0,0
142725300400000,SE 237,RESIDENTIAL,7500,0,7500,82700,0,90200
142725300600000,SECTION 42,COMMERCIAL,0,83200,83200,0,365200,448400
142725400100000,SCHOOL,EXEMPT,0,0,0,0,0,0
142725400200000,SCHOOL,EXEMPT,0,0,0,0,0,0
142725500100000,SE 237,RESIDENTIAL,6300,0,6300,83600,0,89900
142725500400000,SE 237,RESIDENTIAL,6300,0,6300,45300,0,51600
142725501300000,RESTAURANT,COMMERCIAL,0,14400,14400,0,64000,78400
142725501500000,SE 237,RESIDENTIAL,6400,0,6400,54800,0,61200
142725501700000,SE 237,RESIDENTIAL,6000,0,6000,29200,0,35200
142725501800000,SE 237,RESIDENTIAL,9000,0,9000,153200,0,162200
142725502000000,SECTION 42,COMMERCIAL,0,95000,95000,0,343700,438700
142725600100000,OFFICE,COMMERCIAL,0,25200,25200,0,31200,56400
142725600200000,CITY PROPERTY,EXEMPT,0,0,0,0,0,0
142725600300000,CITY PROPERTY,EXEMPT,0,0,0,0,0,0
142725600400000,VACANT LAND,COMMERCIAL,0,53300,53300,0,0,53300
142725600500000,SE 237,RESIDENTIAL,6600,0,6600,67800,0,74400
142725600600000,CITY PROPERTY,EXEMPT,0,0,0,0,0,0
142725600700000,VACANT LAND,COMMERCIAL,0,16800,16800,0,0,16800
142725601000000,SE 237,RESIDENTIAL,8000,0,8000,64800,0,72800
142725601100000,SE 237,RESIDENTIAL,8000,0,8000,33300,0,41300
142725601200000,SE 237,RESIDENTIAL,8000,0,8000,0,0,8000
142725601300000,SE 237,RESIDENTIAL,8000,0,8000,0,0,8000
142725700100000,RESTAURANT,COMMERCIAL,0,8800,8800,0,30700,39500
142725700200000,CITY PROPERTY,EXEMPT,0,0,0,0,0,0
142725700300000,CITY PROPERTY,EXEMPT,0,0,0,0,0,0
142725700500000,CITY PROPERTY,EXEMPT,0,0,0,0,0,0
142725700600000,CITY PROPERTY,EXEMPT,0,0,0,0,0,0
142725800701022,SMALL RETAIL,COMMERCIAL,0,7200,7200,0,78100,85300
142725800701023,SMALL RETAIL,COMMERCIAL,0,7200,7200,0,78100,85300
142725800701024,SMALL RETAIL,COMMERCIAL,0,7200,7200,0,78100,85300
142725800701025,SMALL RETAIL,COMMERCIAL,0,7200,7200,0,78100,85300
142725900500000,VACANT LAND,COMMERCIAL,0,86200,86200,0,0,86200
142725900600000,CITY PROPERTY,EXEMPT,0,0,0,0,0,0
142725900700000,VACANT LAND,COMMERCIAL,0,134300,134300,0,0,134300
142725900701000,OFFICE,COMMERCIAL,0,114100,114100,0,0,114100
142725900701001,VACANT LAND,COMMERCIAL,0,214600,214600,0,0,214600
142726000200000,CHURCH,EXEMPT,0,330000,330000,0,609700,939700
142726000602000,BILLBOARD(BLL),COMMERCIAL,0,0,0,0,10300,10300
142726000800000,CITY PROPERTY,EXEMPT,0,0,0,0,0,0
142726100100000,FLAT PARKING,EXEMPT,0,145500,145500,0,5100,150600
142726100300000,CITY PROPERTY,EXEMPT,0,0,0,0,0,0
142726100400000,SE 237,RESIDENTIAL,3200,0,3200,0,0,3200
142726100500000,SE 237,EXEMPT,0,6600,6600,0,0,6600
142726100700000,CITY PROPERTY,EXEMPT,0,0,0,0,0,0
142726100800000,CITY PROPERTY,EXEMPT,0,0,0,0,0,0
142726100900000,SE 237,RESIDENTIAL,2700,0,2700,0,0,2700
142726101000000,CITY PROPERTY,EXEMPT,0,0,0,0,0,0
142726101100000,CITY PROPERTY,EXEMPT,0,0,0,0,0,0
142726101200000,CITY PROPERTY,EXEMPT,0,0,0,0,0,0
142726101300000,CITY PROPERTY,EXEMPT,0,0,0,0,0,0
142726101500000,OFFICE,COMMERCIAL,0,310500,310500,0,3811800,4122300
142726101600000,VACANT LAND,COMMERCIAL,0,61300,61300,0,0,61300
142726300100000,VACANT LAND,COMMERCIAL,0,45700,45700,0,0,45700
142727600100000,APARTMENT,MULTI-RES,128400,0,128400,526200,0,654600
142727600200000,SE 237,RESIDENTIAL,8800,0,8800,115900,0,124700
142727700100000,APARTMENT,MULTI-RES,441200,0,441200,1758000,0,2199200
142727700200000,CHURCH,EXEMPT,0,29000,29000,0,148300,177300
142727700300000,FLAT PARKING,EXEMPT,0,162000,162000,0,3200,165200
142727700400000,CITY PROPERTY,EXEMPT,0,0,0,0,0,0
142727700500000,CITY PROPERTY,EXEMPT,0,0,0,0,0,0
142727700600000,SCHOOL,EXEMPT,0,116100,116100,0,1657400,1773500
142727700700000,CITY PROPERTY,EXEMPT,0,0,0,0,0,0
142727700800000,CITY PROPERTY,EXEMPT,0,0,0,0,0,0
142727700900000,APARTMENT,MULTI-RES,71400,0,71400,263100,0,334500
142727800100000,CITY PROPERTY,EXEMPT,0,0,0,0,0,0
142727900300000,SE 237,RESIDENTIAL,6300,0,6300,119600,0,125900
142727900400000,SE 237,RESIDENTIAL,6300,0,6300,105700,0,112000
142728000100000,SE 237,RESIDENTIAL,7900,0,7900,60000,0,67900
142728000200000,SE 237,RESIDENTIAL,7900,0,7900,72700,0,80600
142728000300000,SE 237,RESIDENTIAL,7900,0,7900,73400,0,81300
142728000400000,SE 237,RESIDENTIAL,7900,0,7900,76300,0,84200
142728000500000,APARTMENT,MULTI-RES,76200,0,76200,257100,0,333300
142728100100000,FLAT PARKING,INDUSTRIAL,0,6600,6600,0,29200,35800
142728100200000,FLAT PARKING,INDUSTRIAL,0,3500,3500,0,14100,17600
142728100300000,FLAT PARKING,INDUSTRIAL,0,3600,3600,0,14400,18000
142728100400000,WAREHOUSE,INDUSTRIAL,0,10300,10300,0,150500,160800
142728100500000,VACANT LAND,INDUSTRIAL,0,1400,1400,0,0,1400
142728100600000,VACANT LAND,INDUSTRIAL,0,1800,1800,0,0,1800
142728100700000,VACANT LAND,INDUSTRIAL,0,1700,1700,0,0,1700
142728100800000,FLAT PARKING,INDUSTRIAL,0,4800,4800,0,5000,9800
142728100900000,FLAT PARKING,INDUSTRIAL,0,12300,12300,0,44400,56700
142728101000000,FLAT PARKING,INDUSTRIAL,0,21500,21500,0,70200,91700
142728200100000,SE 237,RESIDENTIAL,3800,0,3800,0,0,3800
142728200200000,SE 237,RESIDENTIAL,3900,0,3900,0,0,3900
142728200300000,SE 237,RESIDENTIAL,2600,0,2600,48700,0,51300
142728200400000,SE 237,RESIDENTIAL,3100,0,3100,0,0,3100
142728200500000,SE 237,RESIDENTIAL,7400,0,7400,0,0,7400
142728200600000,SE 237,RESIDENTIAL,3900,0,3900,0,0,3900
142728200700000,SE 237,RESIDENTIAL,2800,0,2800,0,0,2800
142728200800000,CITY PROPERTY,EXEMPT,0,0,0,0,0,0
142728200900000,SE 237,RESIDENTIAL,5800,0,5800,0,0,5800
142728300100000,VACANT LAND,COMMERCIAL,0,5400,5400,0,0,5400
142728300200000,SE 237,RESIDENTIAL,3000,0,3000,0,0,3000
142728300300000,VACANT LAND,COMMERCIAL,0,10700,10700,0,0,10700
142728300400000,SE 237,RESIDENTIAL,6000,0,6000,0,0,6000
142728300500000,CITY PROPERTY,EXEMPT,0,0,0,0,0,0
142728300600000,SE 237,RESIDENTIAL,6000,0,6000,25000,0,31000
142728300700000,CITY PROPERTY,EXEMPT,0,0,0,0,0,0
142730100200000,FOOD GRADE;INDUST,INDUSTRIAL,0,46300,46300,0,8900,55200
142730200100000,FLAT PARKING,INDUSTRIAL,0,2400,2400,0,9700,12100
142730200200000,FLAT PARKING,INDUSTRIAL,0,2400,2400,0,9700,12100
142730200300000,FLAT PARKING,INDUSTRIAL,0,4800,4800,0,19600,24400
142730200400000,FLAT PARKING,INDUSTRIAL,0,4800,4800,0,18300,23100
142730200500000,FLAT PARKING,INDUSTRIAL,0,4800,4800,0,5200,10000
142730200600000,VACANT LAND,INDUSTRIAL,0,4800,4800,0,0,4800
142730300100000,SE 237,RESIDENTIAL,2700,0,2700,0,0,2700
142730300200000,SE 237,RESIDENTIAL,6000,0,6000,0,0,6000
142730300300000,SE 237,RESIDENTIAL,1200,0,1200,0,0,1200
142730300400000,SE 237,RESIDENTIAL,6000,0,6000,0,0,6000
142730300500000,CITY PROPERTY,EXEMPT,0,0,0,0,0,0
142730300600000,CITY PROPERTY,EXEMPT,0,0,0,0,0,0
142730300700000,CITY PROPERTY,EXEMPT,0,0,0,0,0,0
142730300800000,SE 237,RESIDENTIAL,2700,0,2700,0,0,2700
142730300900000,SE 237,RESIDENTIAL,3300,0,3300,0,0,3300
142730301000000,CITY PROPERTY,EXEMPT,0,0,0,0,0,0
142730400100000,SE 237,RESIDENTIAL,5000,0,5000,0,0,5000
142730400200000,SE 237,RESIDENTIAL,5000,0,5000,0,0,5000
142730400300000,CITY PROPERTY,EXEMPT,0,0,0,0,0,0
142730400400000,CITY PROPERTY,EXEMPT,0,0,0,0,0,0
142730400500000,SE 237,RESIDENTIAL,3000,0,3000,0,0,3000
142730400600000,SE 237,RESIDENTIAL,3000,0,3000,0,0,3000
142730400700000,SE 237,RESIDENTIAL,3000,0,3000,0,0,3000
142730400800000,SE 237,RESIDENTIAL,3000,0,3000,0,0,3000
142730400900000,SE 237,RESIDENTIAL,1200,0,1200,0,0,1200
142730401000000,SE 237,RESIDENTIAL,3000,0,3000,0,0,3000
142730401100000,SE 237,RESIDENTIAL,3100,0,3100,0,0,3100
142730500100000,CENTRALLY ASSESSED,OTHER,0,0,0,0,0,0
142730500300000,CITY PROPERTY,EXEMPT,0,0,0,0,0,0
142730500400000,CENTRALLY ASSESSED,OTHER,0,0,0,0,0,0
142730600600000,FOOD GRADE;INDUST,INDUSTRIAL,0,81800,81800,0,409300,491100
142730700100000,SE 237,RESIDENTIAL,3800,0,3800,0,0,3800
142730700200000,SE 237,RESIDENTIAL,3800,0,3800,0,0,3800
142730700300000,CITY PROPERTY,EXEMPT,0,0,0,0,0,0
142730700400000,SE 237,RESIDENTIAL,6100,0,6100,0,0,6100
142730700500000,SE 237,RESIDENTIAL,2900,0,2900,0,0,2900
142730700600000,SE 237,RESIDENTIAL,2900,0,2900,0,0,2900
142730700700000,SE 237,RESIDENTIAL,3800,0,3800,5500,0,9300
142730700800000,SE 237,RESIDENTIAL,1300,0,1300,0,0,1300
142730700900000,SE 237,RESIDENTIAL,2600,0,2600,0,0,2600
142730701000000,CITY PROPERTY,EXEMPT,0,0,0,0,0,0
142732600100000,WAREHOUSE,COMMERCIAL,0,50000,50000,0,72600,122600
142732600200000,FLAT PARKING,COMMERCIAL,0,72000,72000,0,2200,74200
142732700800000,VACANT LAND,COMMERCIAL,0,12600,12600,0,0,12600
142732700900000,WAREHOUSE,COMMERCIAL,0,25200,25200,0,22100,47300
142732701000000,SE 237,RESIDENTIAL,6000,0,6000,16500,0,22500
142732701200000,CITY PROPERTY,EXEMPT,0,0,0,0,0,0
142732701300000,CITY PROPERTY,EXEMPT,0,0,0,0,0,0
142732701400000,SE 237,RESIDENTIAL,3500,0,3500,0,0,3500
142732701500000,AUTO REPAIR/SALES,COMMERCIAL,0,25600,25600,0,51900,77500
142732701600000,CITY PROPERTY,EXEMPT,0,0,0,0,0,0
142732702300000,FLAT PARKING,COMMERCIAL,0,174000,174000,0,50400,224400
142732800100000,CITY PROPERTY,EXEMPT,0,0,0,0,0,0
142732800200000,WAREHOUSE,COMMERCIAL,0,65500,65500,0,141200,206700
142732800600000,CITY PROPERTY,EXEMPT,0,0,0,0,0,0
142732800700000,VACANT LAND,COMMERCIAL,0,22500,22500,0,0,22500
142732800800000,VACANT LAND,COMMERCIAL,0,15900,15900,0,0,15900
142732801000000,CITY PROPERTY,EXEMPT,0,0,0,0,0,0
142732801100000,RESTAURANT,COMMERCIAL,0,44400,44400,0,95500,139900
142732801200000,CITY PROPERTY,EXEMPT,0,0,0,0,0,0
142732801300000,CITY PROPERTY,EXEMPT,0,0,0,0,0,0
142732900100000,SMALL RETAIL,COMMERCIAL,0,12600,12600,0,63000,75600
142732900200000,CITY PROPERTY,EXEMPT,0,0,0,0,0,0
142732900300000,SE 237,RESIDENTIAL,1400,0,1400,0,0,1400
142732900400000,SE 237,RESIDENTIAL,2600,0,2600,0,0,2600
142732900500000,BARS/LOUNGE,COMMERCIAL,0,23300,23300,0,58000,81300
142732900600000,FLAT PARKING,COMMERCIAL,0,9400,9400,0,2000,11400
142733000100000,OFFICE,COMMERCIAL,0,47600,47600,0,4500,52100
142733000200000,VACANT LAND,COMMERCIAL,0,10300,10300,0,0,10300
142733000300000,WAREHOUSE,COMMERCIAL,0,51700,51700,0,87400,139100
142733000400000,SMALL RETAIL,COMMERCIAL,0,18900,18900,0,82600,101500
142733000500000,VACANT LAND,COMMERCIAL,0,8200,8200,0,0,8200
142733000600000,BARS/LOUNGE,COMMERCIAL,0,9800,9800,0,25000,34800
142733000800000,RESTAURANT,COMMERCIAL,0,30800,30800,0,92900,123700
142733001000000,SE 237,RESIDENTIAL,6100,0,6100,0,0,6100
142733001100000,SE 237,RESIDENTIAL,6100,0,6100,9400,0,15500
142733001200000,SE 237,RESIDENTIAL,7300,0,7300,0,0,7300
142733001300000,CITY PROPERTY,EXEMPT,0,0,0,0,0,0
142733001400000,CITY PROPERTY,EXEMPT,0,0,0,0,0,0
142733001500000,SE 237,RESIDENTIAL,1200,0,1200,0,0,1200
142733001600000,CITY PROPERTY,EXEMPT,0,0,0,0,0,0
142733001700000,CITY PROPERTY,EXEMPT,0,0,0,0,0,0
142733001800000,CITY PROPERTY,EXEMPT,0,0,0,0,0,0
142733001900000,CITY PROPERTY,EXEMPT,0,0,0,0,0,0
142733002000000,THEATER,COMMERCIAL,0,32700,32700,0,30500,63200
142733100100000,CITY PROPERTY,EXEMPT,0,0,0,0,0,0
142733100200000,CITY PROPERTY,EXEMPT,0,0,0,0,0,0
142733100300000,CITY PROPERTY,EXEMPT,0,0,0,0,0,0
142733100400000,CITY PROPERTY,EXEMPT,0,0,0,0,0,0
142733100500000,CITY PROPERTY,EXEMPT,0,0,0,0,0,0
142733100600000,CITY PROPERTY,EXEMPT,0,0,0,0,0,0
142733100700000,CITY PROPERTY,EXEMPT,0,0,0,0,0,0
142733100800000,CITY PROPERTY,EXEMPT,0,0,0,0,0,0
142733100900000,CITY PROPERTY,EXEMPT,0,0,0,0,0,0
142733101000000,CITY PROPERTY,EXEMPT,0,0,0,0,0,0
142733101100000,CITY PROPERTY,EXEMPT,0,0,0,0,0,0
142733101200000,CITY PROPERTY,EXEMPT,0,0,0,0,0,0
142733101300000,CITY PROPERTY,EXEMPT,0,0,0,0,0,0
142733101400000,CITY PROPERTY,EXEMPT,0,0,0,0,0,0
142733101500000,CITY PROPERTY,EXEMPT,0,0,0,0,0,0
142733101600000,CITY PROPERTY,EXEMPT,0,0,0,0,0,0
142733101700000,CITY PROPERTY,EXEMPT,0,0,0,0,0,0
142733101800000,VACANT LAND,COMMERCIAL,0,5200,5200,0,0,5200
142733101900000,CITY PROPERTY,EXEMPT,0,0,0,0,0,0
142733102000000,CITY PROPERTY,EXEMPT,0,0,0,0,0,0
142733200100000,CITY PROPERTY,EXEMPT,0,0,0,0,0,0
142735100100000,CITY PROPERTY,EXEMPT,0,0,0,0,0,0
142735200100000,CITY PROPERTY,EXEMPT,0,0,0,0,0,0
142735200200000,WAREHOUSE,COMMERCIAL,0,16500,16500,0,0,16500
142735300100000,WAREHOUSE,COMMERCIAL,0,26800,26800,0,14500,41300
142735300400000,CITY PROPERTY,EXEMPT,0,0,0,0,0,0
142735300500000,CITY PROPERTY,EXEMPT,0,0,0,0,0,0
142735300600000,CITY PROPERTY,EXEMPT,0,0,0,0,0,0
142735300800000,CITY PROPERTY,EXEMPT,0,0,0,0,0,0
142735300900000,CITY PROPERTY,EXEMPT,0,0,0,0,0,0
142735400300000,CITY PROPERTY,EXEMPT,0,0,0,0,0,0
142735400400000,CITY PROPERTY,EXEMPT,0,0,0,0,0,0
142735400500000,SW 402,RESIDENTIAL,17500,0,17500,79400,0,96900
142735400600000,CITY PROPERTY,EXEMPT,0,0,0,0,0,0
142735400700000,CITY PROPERTY,EXEMPT,0,0,0,0,0,0
142735400800000,CITY PROPERTY,EXEMPT,0,0,0,0,0,0
142735400900000,CITY PROPERTY,EXEMPT,0,0,0,0,0,0
142735401400000,CITY PROPERTY,EXEMPT,0,0,0,0,0,0
142737600100000,CITY PROPERTY,EXEMPT,0,0,0,0,0,0
142740100100000,CENTRALLY ASSESSED,OTHER,0,0,0,0,0,0
142742600100000,FOOD GRADE;INDUST,INDUSTRIAL,0,644900,644900,0,7663500,8308400
142745100100000,CITY PROPERTY,EXEMPT,0,0,0,0,0,0
142747600100000,CENTRALLY ASSESSED,OTHER,0,0,0,0,0,0
142810100100000,FEDERAL PROPERTY,EXEMPT,0,0,0,0,0,0
142810300300000,FLAT PARKING,COMMERCIAL,0,96400,96400,0,65300,161700
142810300500000,WAREHOUSE; CTRL CR,COMMERCIAL,0,84400,84400,0,444300,528700
142810300600000,FLAT PARKING,COMMERCIAL,0,12100,12100,0,11200,23300
142810300700000,VACANT LAND,COMMERCIAL,0,24100,24100,0,0,24100
142810300800000,CONVERSION-CENT CORE,COMMERCIAL,20244,3856,24100,123293,14307,161700
142810400100000,WAREHOUSE; CTRL CR,COMMERCIAL,0,72300,72300,0,165500,237800
142810400200000,WAREHOUSE; CTRL CR,COMMERCIAL,0,186300,186300,0,1034300,1220600
142810500100000,CONVERSION-CENT CORE,EXEMPT,0,34000,34000,0,166500,200500
142810500300000,FLAT PARKING,COMMERCIAL,0,36300,36300,0,0,36300
142810500400000,CITY PROPERTY,EXEMPT,0,0,0,0,0,0
142810500500000,FLAT PARKING,COMMERCIAL,0,36300,36300,0,62600,98900
142810500600000,VACANT LAND,COMMERCIAL,0,26300,26300,0,0,26300
142810500700000,VACANT LAND,COMMERCIAL,0,23800,23800,0,0,23800
142810500800000,FLAT PARKING,COMMERCIAL,0,58800,58800,0,38500,97300
142810500900000,VACANT LAND,COMMERCIAL,0,12500,12500,0,0,12500
142810501000000,FLAT PARKING,COMMERCIAL,0,10300,10300,0,2900,13200
142810501100000,CITY PROPERTY,EXEMPT,0,0,0,0,0,0
142810600100000,OFFICE; MED; CTRL CR,COMMERCIAL,0,75600,75600,0,408500,484100
142810600200000,SMALL RET; CTRL CR,COMMERCIAL,0,50400,50400,0,356300,406700
142810600400000,OFFICE; MED; CTRL CR,COMMERCIAL,0,240000,240000,0,1628300,1868300
142810700100000,OFFICE; CTRL CR,COMMERCIAL,0,94400,94400,0,1256600,1351000
142810700200000,WAREHOUSE; CTRL CR,COMMERCIAL,65065,53235,118300,231440,189360,539100
142810700300000,WAREHOUSE; CTRL CR,COMMERCIAL,0,45900,45900,0,217100,263000
142810800100000,OFFICE; CTRL CR,EXEMPT,0,88200,88200,0,269500,357700
142810900100000,FLAT PARKING,COMMERCIAL,0,77200,77200,0,8700,85900
142810900300000,WAREHOUSE; CTRL CR,COMMERCIAL,0,37800,37800,0,127200,165000
142810900400000,WAREHOUSE; CTRL CR,COMMERCIAL,0,37800,37800,0,98400,136200
142810900500000,RESTAURANT; CTRL CR,COMMERCIAL,0,50400,50400,0,76200,126600
142810900600000,VACANT LAND,EXEMPT,0,18400,18400,0,0,18400
142810900700000,FLAT PARKING,EXEMPT,0,98900,98900,0,40600,139500
142810900800000,SE 238,RESIDENTIAL,4000,0,4000,0,0,4000
142810900900000,SE 238,RESIDENTIAL,3500,0,3500,0,0,3500
142810901000000,SE 238,RESIDENTIAL,5300,0,5300,21200,0,26500
142811000100000,WAREHOUSE; CTRL CR,COMMERCIAL,0,120000,120000,0,331200,451200
142811000400000,FLAT PARKING,COMMERCIAL,0,96400,96400,0,7800,104200
142811000402000,BILLBOARD(BLL),COMMERCIAL,0,0,0,0,48700,48700
142811000500000,AUTO REP/SAL;CTRL CR,COMMERCIAL,0,48200,48200,0,42700,90900
142811000600000,AUTO REP/SAL;CTRL CR,COMMERCIAL,0,48200,48200,0,67100,115300
142811000700000,AUTO REP/SAL;CTRL CR,COMMERCIAL,0,24100,24100,0,42700,66800
142811000800000,BARS/LOUNGE; CTRL CR,COMMERCIAL,0,12600,12600,0,82600,95200
142811000900000,CENTRALLY ASSESSED,OTHER,0,0,0,0,0,0
142811100100000,FLAT PARKING,COMMERCIAL,0,39300,39300,0,18900,58200
142811100200000,FLAT PARKING,COMMERCIAL,0,27500,27500,0,13100,40600
142811100300000,WAREHOUSE; CTRL CR,COMMERCIAL,0,50400,50400,0,191100,241500
142811100400000,FLAT PARKING,COMMERCIAL,0,34400,34400,0,16000,50400
142811300100000,SHOP,COMMERCIAL,0,100800,100800,0,196700,297500
142811300200000,OFFICE; CTRL CR,COMMERCIAL,0,151200,151200,0,591800,743000
142811300300000,OFFICE,EXEMPT,0,75600,75600,0,1002900,1078500
142811400300000,WAREHOUSE; CTRL CR,COMMERCIAL,0,16800,16800,0,93200,110000
142811400400000,WAREHOUSE; CTRL CR,COMMERCIAL,0,47500,47500,0,71900,119400
142811400500000,WAREHOUSE; CTRL CR,COMMERCIAL,0,19700,19700,0,78000,97700
142811401100000,OFFICE; CTRL CR,EXEMPT,0,464000,464000,0,6513900,6977900
142811500100000,BARS/LOUNGE; CTRL CR,COMMERCIAL,0,37800,37800,0,21000,58800
142812600400000,CITY PROPERTY,EXEMPT,0,0,0,0,0,0
142812700100000,OFFICE; CTRL CR,COMMERCIAL,0,126000,126000,0,479500,605500
142812700200000,OFFICE; CTRL CR,COMMERCIAL,0,126000,126000,0,1003400,1129400
142812700300000,OFFICE; CTRL CR,COMMERCIAL,0,210000,210000,0,645100,855100
142812700400000,OFFICE,EXEMPT,0,64500,64500,0,561700,626200
142812700500000,BRNCH BK/CR; CTRL CR,COMMERCIAL,0,274900,274900,0,755500,1030400
142812700600000,CITY PROPERTY,EXEMPT,0,0,0,0,0,0
142812800100000,OFFICE; CTRL CR,COMMERCIAL,0,90000,90000,0,740600,830600
142812800200000,OFFICE; CTRL CR,COMMERCIAL,0,168000,168000,0,1309300,1477300
142812800300000,OFFICE; CTRL CR,COMMERCIAL,0,179200,179200,0,1063500,1242700
142812800400000,OFFICE; CTRL CR,COMMERCIAL,0,301000,301000,0,1478900,1779900
142812800402000,MISCELLANEOUS,COMMERCIAL,0,0,0,0,0,0
142812900100000,CITY PROPERTY,EXEMPT,0,0,0,0,0,0
142812900200000,FLAT PARKING,COMMERCIAL,0,241000,241000,0,59400,300400
142812900300000,BARS/LOUNGE; CTRL CR,COMMERCIAL,0,13200,13200,0,52000,65200
142812900400000,FLAT PARKING,COMMERCIAL,0,89200,89200,0,31000,120200
142812900500000,SR/NURSING/ASSTD LIV,EXEMPT,0,76800,76800,0,3570200,3647000
142813000100000,OFFICE; CTRL CR,COMMERCIAL,0,546000,546000,0,6490800,7036800
142813000200000,OFFICE; CTRL CR,COMMERCIAL,0,378000,378000,0,3510800,3888800
142813000300000,OFFICE; CTRL CR,COMMERCIAL,0,336000,336000,0,1447000,1783000
142813000400000,OFFICE; CTRL CR,COMMERCIAL,115020,46980,162000,800738,327062,1289800
142813000500000,FLAT PARKING,COMMERCIAL,0,27000,27000,0,1000,28000
142813100101000,OFFICE; CTRL CR,COMMERCIAL,0,27400,27400,0,111500,138900
142813100101001,SMALL RET; CTRL CR,COMMERCIAL,0,18300,18300,0,145300,163600
142813100101002,OFFICE; CTRL CR,COMMERCIAL,0,27400,27400,0,295700,323100
142813100101003,OFFICE; CTRL CR,COMMERCIAL,0,29600,29600,0,261200,290800
142813100101004,OFFICE; CTRL CR,COMMERCIAL,0,18300,18300,0,148600,166900
142813100101005,OFFICE; CTRL CR,COMMERCIAL,0,53600,53600,0,506400,560000
142813100101006,OFFICE; CTRL CR,COMMERCIAL,0,53600,53600,0,506400,560000
142813100102000,THEATER,EXEMPT,0,0,0,0,0,0
142813100400000,CITY PROPERTY,EXEMPT,0,0,0,0,0,0
142813100500000,OFFICE; CTRL CR,COMMERCIAL,0,84000,84000,0,239600,323600
142813100600000,OFFICE; CTRL CR,COMMERCIAL,0,84000,84000,0,267700,351700
142813101100000,OFFICE; CTRL CR,COMMERCIAL,0,44800,44800,0,214700,259500
142813101200000,CITY PROPERTY,EXEMPT,0,0,0,0,0,0
142813101300000,CITY PROPERTY,EXEMPT,0,0,0,0,0,0
142813101400000,OFFICE; CTRL CR,COMMERCIAL,0,89600,89600,0,665900,755500
142813101500000,THEATER,EXEMPT,0,370000,370000,0,0,370000
142813101504000,CITY PROPERTY,EXEMPT,0,0,0,0,0,0
142813200100000,FLAT PARKING,COMMERCIAL,0,26300,26300,0,10500,36800
142813200200000,FLAT PARKING,COMMERCIAL,0,28900,28900,0,6700,35600
142813200300000,FLAT PARKING,COMMERCIAL,0,9600,9600,0,2200,11800
142813200400000,SMALL RET; CTRL CR,COMMERCIAL,0,70000,70000,0,457800,527800
142813200500000,PRINTING,INDUSTRIAL,0,42000,42000,0,129500,171500
142813200600000,FLAT PARKING,COMMERCIAL,0,67200,67200,0,10300,77500
142813200700000,OFFICE; CTRL CR,COMMERCIAL,0,144600,144600,0,1526100,1670700
142813300100000,OFFICE; CTRL CR,COMMERCIAL,0,84000,84000,0,2277100,2361100
142813300200000,FLAT PARKING,COMMERCIAL,0,84000,84000,0,27600,111600
142813300300000,OFFICE; CTRL CR,COMMERCIAL,0,84200,84200,0,1061300,1145500
142813300400000,CITY PROPERTY,EXEMPT,0,0,0,0,0,0
142813300500000,CITY PROPERTY,EXEMPT,0,0,0,0,0,0
142813300501001,OFFICE; CTRL CR,COMMERCIAL,0,0,0,0,273700,273700
142813300501002,OFFICE; CTRL CR,COMMERCIAL,0,0,0,0,120600,120600
142813300501003,OFFICE; CTRL CR,COMMERCIAL,0,0,0,0,120600,120600
142813300501004,OFFICE; CTRL CR,COMMERCIAL,0,0,0,0,126600,126600
142813300501005,OFFICE; CTRL CR,COMMERCIAL,0,0,0,0,123200,123200
142813300501006,OFFICE; CTRL CR,COMMERCIAL,0,0,0,0,120600,120600
142813300501007,OFFICE; CTRL CR,COMMERCIAL,0,0,0,0,80400,80400
142813300501008,OFFICE; CTRL CR,COMMERCIAL,0,0,0,0,80400,80400
142813300501010,OFFICE; CTRL CR,COMMERCIAL,0,0,0,0,386600,386600
142813300501011,OFFICE; CTRL CR,COMMERCIAL,0,0,0,0,238500,238500
142813300501012,OFFICE; CTRL CR,COMMERCIAL,0,0,0,0,273600,273600
142813300501013,OFFICE; CTRL CR,COMMERCIAL,0,0,0,0,239400,239400
142813300501014,OFFICE; CTRL CR,COMMERCIAL,0,0,0,0,451000,451000
142813300501015,OFFICE; CTRL CR,COMMERCIAL,0,0,0,0,515400,515400
142813300501016,OFFICE; CTRL CR,COMMERCIAL,0,0,0,0,514000,514000
142813300501017,OFFICE; CTRL CR,COMMERCIAL,0,0,0,0,238500,238500
142813300501018,OFFICE; CTRL CR,COMMERCIAL,0,0,0,0,476900,476900
142813300501019,OFFICE; CTRL CR,COMMERCIAL,0,0,0,0,107800,107800
142813300501020,OFFICE; CTRL CR,COMMERCIAL,0,0,0,0,203700,203700
142813300501063,OFFICE; CTRL CR,COMMERCIAL,0,0,0,0,273600,273600
142813300501065,OFFICE; CTRL CR,COMMERCIAL,0,0,0,0,120600,120600
142813300501066,OFFICE; CTRL CR,COMMERCIAL,0,0,0,0,120600,120600
142813300501067,OFFICE; CTRL CR,COMMERCIAL,0,0,0,0,120600,120600
142813300501068,OFFICE; CTRL CR,COMMERCIAL,0,0,0,0,120600,120600
142813300502002,SCHOOL,EXEMPT,0,0,0,0,1420500,1420500
142813300700000,OFFICE; CTRL CR,COMMERCIAL,0,163200,163200,0,1277900,1441100
142813300800000,OFFICE; CTRL CR,COMMERCIAL,16128,22272,38400,66486,91814,196700
142813400100000,CHURCH,EXEMPT,0,405000,405000,0,1279800,1684800
142813400200000,OFFICE; CTRL CR,COMMERCIAL,0,229300,229300,0,974600,1203900
142813400300000,OFFICE,EXEMPT,0,99600,99600,0,931300,1030900
142813400400000,OFFICE; CTRL CR,COMMERCIAL,0,415200,415200,0,5928700,6343900
142813400500000,FLAT PARKING,EXEMPT,0,173800,173800,0,39700,213500
142813400600000,FLAT PARKING,EXEMPT,0,100600,100600,0,22400,123000
142813500700000,OFFICE; CTRL CR,COMMERCIAL,0,848000,848000,0,6726300,7574300
142813600100000,BARS/LOUNGE; CTRL CR,COMMERCIAL,0,51000,51000,0,334200,385200
142813600200000,OFFICE; CTRL CR,COMMERCIAL,0,65400,65400,0,88200,153600
142813600500000,OFFICE; CTRL CR,COMMERCIAL,0,31400,31400,0,262700,294100
142813600600000,OFFICE; CTRL CR,COMMERCIAL,0,148800,148800,0,51100,199900
142813600700000,VACANT LAND,COMMERCIAL,0,40600,40600,0,0,40600
142813600900000,OFFICE; CTRL CR,COMMERCIAL,0,108900,108900,0,1288000,1396900
142813700100000,FLAT PARKING,COMMERCIAL,0,27500,27500,0,9800,37300
142813700200000,WAREHOUSE; CTRL CR,COMMERCIAL,0,33600,33600,0,35900,69500
142813700300000,OFFICE; CTRL CR,COMMERCIAL,0,33600,33600,0,547200,580800
142813700400000,AUTO REP/SAL;CTRL CR,COMMERCIAL,0,100800,100800,0,159700,260500
142815100200000,FITNESS CENTER,EXEMPT,0,744800,744800,0,6447200,7192000
142815200500000,CITY PROPERTY,EXEMPT,0,0,0,0,0,0
142815200600000,SMALL RET; CTRL CR,COMMERCIAL,96000,288000,384000,1296025,467675,2147700
142815300100000,CITY PROPERTY,EXEMPT,0,0,0,0,0,0
142815300200000,FLAT PARKING,COMMERCIAL,0,406000,406000,0,96000,502000
142815300300000,CITY PROPERTY,EXEMPT,0,0,0,0,0,0
142815300400000,OFFICE; CTRL CR,COMMERCIAL,0,420000,420000,0,14279000,14699000
142815400200000,FEDERAL PROPERTY,EXEMPT,0,0,0,0,0,0
142815600100000,CITY PROPERTY,EXEMPT,0,0,0,0,0,0
142815600300000,CITY PROPERTY,EXEMPT,0,0,0,0,0,0
142815700100000,CITY PROPERTY,EXEMPT,0,0,0,0,0,0
142815800300000,CITY PROPERTY,EXEMPT,0,0,0,0,0,0
142816400202000,OFFICE; CTRL CR,COMMERCIAL,0,0,0,0,35200,35200
142817600100000,SE 237,RESIDENTIAL,2400,0,2400,0,0,2400
142817600200000,SE 237,RESIDENTIAL,1900,0,1900,0,0,1900
142817600300000,VACANT LAND,COMMERCIAL,0,5200,5200,0,0,5200
142817600400000,CITY PROPERTY,EXEMPT,0,0,0,0,0,0
142817600500000,CITY PROPERTY,EXEMPT,0,0,0,0,0,0
142817600600000,SE 237,RESIDENTIAL,3600,0,3600,0,0,3600
142817600700000,CITY PROPERTY,EXEMPT,0,0,0,0,0,0
142817600800000,SE 237,RESIDENTIAL,6600,0,6600,70900,0,77500
142817700100000,WAREHOUSE; CTRL CR,COMMERCIAL,0,25200,25200,0,127000,152200
142817700200000,WAREHOUSE; CTRL CR,COMMERCIAL,0,25200,25200,0,93100,118300
142817800200000,SMALL RET; CTRL CR,COMMERCIAL,0,63000,63000,0,201900,264900
142817900200000,WAREHOUSE; CTRL CR,COMMERCIAL,0,35600,35600,0,94700,130300
142817900202000,BILLBOARD(BLL),COMMERCIAL,0,0,0,0,12800,12800
142818000300000,CENTRALLY ASSESSED,OTHER,0,0,0,0,0,0
142818000400000,MATERIALS MFG;INDUST,COMMERCIAL,0,77200,77200,0,482300,559500
142818000500000,VACANT LAND,COMMERCIAL,0,6300,6300,0,0,6300
142818000600000,FLAT PARKING,COMMERCIAL,0,25200,25200,0,2100,27300
142818000700000,FLAT PARKING,COMMERCIAL,0,12600,12600,0,1900,14500
142818000800000,FLAT PARKING,COMMERCIAL,0,12600,12600,0,1700,14300
142818000900000,SE 237,RESIDENTIAL,6100,0,6100,48700,0,54800
142818001000000,VACANT LAND,COMMERCIAL,0,12100,12100,0,4600,16700
142818001100000,VACANT LAND,COMMERCIAL,0,12100,12100,0,10100,22200
142818001200000,CENTRALLY ASSESSED,OTHER,0,0,0,0,0,0
142818001300000,CENTRALLY ASSESSED,OTHER,0,0,0,0,0,0
142818100100000,WAREHOUSE; CTRL CR,COMMERCIAL,0,30000,30000,0,143600,173600
142818100300000,CENTRALLY ASSESSED,OTHER,0,0,0,0,0,0
142818200100000,SMALL RET; CTRL CR,COMMERCIAL,0,348400,348400,0,608500,956900
142818200300000,CENTRALLY ASSESSED,OTHER,0,0,0,0,0,0
142818300100000,WAREHOUSE; CTRL CR,COMMERCIAL,0,7400,7400,0,11400,18800
142818300200000,WAREHOUSE; CTRL CR,COMMERCIAL,0,49000,49000,0,64900,113900
142818300300000,WAREHOUSE; CTRL CR,COMMERCIAL,0,15400,15400,0,37200,52600
142818300400000,WAREHOUSE; CTRL CR,COMMERCIAL,0,80600,80600,0,57800,138400
142818300500000,VACANT LAND,COMMERCIAL,0,11800,11800,0,0,11800
142818300600000,FLAT PARKING,COMMERCIAL,0,4500,4500,0,800,5300
142818300700000,WAREHOUSE; CTRL CR,COMMERCIAL,0,46200,46200,0,3500,49700
142818300800000,FLAT PARKING,COMMERCIAL,0,103700,103700,0,7800,111500
142818300900000,FLAT PARKING,COMMERCIAL,0,10200,10200,0,0,10200
142818400400000,AUTO REP/SAL;CTRL CR,COMMERCIAL,0,154200,154200,0,451100,605300
142818400500000,CONVENIENCE STORE,COMMERCIAL,0,417300,417300,0,839200,1256500
142818500100000,OFFICE; CTRL CR,COMMERCIAL,14460,106040,120500,235128,1725972,2081600
142818500200000,FLAT PARKING,COMMERCIAL,0,16800,16800,0,2400,19200
142818500300000,SMALL RET; CTRL CR,COMMERCIAL,0,17000,17000,0,194100,211100
142818501200000,SMALL RET; CTRL CR,COMMERCIAL,0,24000,24000,0,126900,150900
142818501300000,SMALL RET; CTRL CR,COMMERCIAL,0,25400,25400,0,19900,45300
142818501400000,SMALL RET; CTRL CR,COMMERCIAL,0,19400,19400,0,116600,136000
142818501500000,OFFICE; CTRL CR,COMMERCIAL,33600,33600,67200,381500,381500,830200
142818501700000,VACANT LAND,COMMERCIAL,0,51000,51000,0,0,51000
142818600102000,ANTENNAS/TOWERS(BLL),COMMERCIAL,0,0,0,0,11300,11300
142818600102001,ANTENNAS/TOWERS(BLL),COMMERCIAL,0,0,0,0,8400,8400
142818600201000,OFFICE; CTRL CR,COMMERCIAL,0,17600,17600,0,127300,144900
142818600201001,OFFICE; CTRL CR,COMMERCIAL,0,17600,17600,0,123600,141200
142818600201002,OFFICE; CTRL CR,COMMERCIAL,0,17600,17600,0,129100,146700
142818600201003,OFFICE; CTRL CR,COMMERCIAL,0,17600,17600,0,215100,232700
142818600300000,FLAT PARKING,COMMERCIAL,0,166400,166400,0,49500,215900
142818600400000,FLAT PARKING,COMMERCIAL,0,47200,47200,0,12700,59900
142818700800000,LG DISCOUNT/RETAIL,EXEMPT,0,251200,251200,0,1030300,1281500
142818800100000,VACANT LAND,EXEMPT,0,23100,23100,0,0,23100
142818800200000,VACANT LAND,EXEMPT,0,23100,23100,0,0,23100
142818800300000,SE 250,RESIDENTIAL,25200,0,25200,0,0,25200
142818800900000,SMALL RET; CTRL CR,COMMERCIAL,0,33600,33600,0,135900,169500
142818801000000,SE 250,RESIDENTIAL,2400,0,2400,0,0,2400
142818801100000,SE 250,RESIDENTIAL,5900,0,5900,0,0,5900
142818801200000,SE 250,RESIDENTIAL,5900,0,5900,2000,0,7900
142818801300000,SE 250,RESIDENTIAL,5900,0,5900,0,0,5900
142818801400000,SE 250,RESIDENTIAL,5900,0,5900,0,0,5900
142818801500000,VACANT LAND,EXEMPT,0,11600,11600,0,0,11600
142818801700000,OFFICE; CTRL CR,COMMERCIAL,10100,10100,20200,10100,10100,40400
142818801800000,SE 250,RESIDENTIAL,56700,0,56700,296800,0,353500
142818801900000,SE 250,RESIDENTIAL,42000,0,42000,248700,0,290700
142818802000000,SE 250,RESIDENTIAL,42000,0,42000,270400,0,312400
142818802100000,SE 250,RESIDENTIAL,42000,0,42000,274200,0,316200
142818802200000,SE 250,RESIDENTIAL,42000,0,42000,270400,0,312400
142818802300000,SE 250,RESIDENTIAL,56700,0,56700,329200,0,385900
142818900100000,WAREHOUSE; CTRL CR,COMMERCIAL,0,25200,25200,0,105300,130500
142818900200000,RESTAURANT; CTRL CR,COMMERCIAL,0,25200,25200,0,172700,197900
142819000100000,LITERARY/LIBRARY/ART,COMMERCIAL,0,44800,44800,0,1332800,1377600
142819000200000,LITERARY/LIBRARY/ART,EXEMPT,0,15700,15700,0,69400,85100
142819000400000,CONVERSIONS; NON-APT,COMMERCIAL,25620,16380,42000,51581,63719,157300
142820100100000,OFFICE; CTRL CR,COMMERCIAL,0,214800,214800,0,1592600,1807400
142820100200000,OFFICE; CTRL CR,COMMERCIAL,0,96000,96000,0,6200,102200
142820100300000,OFFICE,OTHER,0,0,0,0,0,0
142820100400000,OFFICE; CTRL CR,COMMERCIAL,0,24000,24000,0,103400,127400
142820100500000,OFFICE; CTRL CR,COMMERCIAL,0,180000,180000,0,1197800,1377800
142820100600000,OFFICE; CTRL CR,COMMERCIAL,0,168000,168000,0,1426300,1594300
142820100700000,SMALL RET; CTRL CR,COMMERCIAL,0,168000,168000,0,122300,290300
142820100800000,SMALL RET; CTRL CR,COMMERCIAL,0,64800,64800,0,125600,190400
142820200100000,OFFICE; CTRL CR,COMMERCIAL,0,168000,168000,0,0,168000
142820200200000,PARKING STRUCTURE,COMMERCIAL,0,390300,390300,0,2317700,2708000
142820300100000,CITY PROPERTY,EXEMPT,0,0,0,0,0,0
142820400100000,CITY PROPERTY,EXEMPT,0,0,0,0,0,0
142820400107000,MISCELLANEOUS,COMMERCIAL,0,0,0,0,5692746,5692746
142820400107001,MISCELLANEOUS,COMMERCIAL,0,0,0,0,90624,90624
142820400107002,MISCELLANEOUS,COMMERCIAL,0,0,0,0,1445599,1445599
142820400107003,MISCELLANEOUS,COMMERCIAL,0,0,0,0,1807121,1807121
142820400107004,MISCELLANEOUS,COMMERCIAL,0,0,0,0,585672,585672
142820400107005,MISCELLANEOUS,COMMERCIAL,0,0,0,0,22759,22759
142820400107008,MISCELLANEOUS,COMMERCIAL,0,0,0,0,9104,9104
142820400107010,MISCELLANEOUS,COMMERCIAL,0,0,0,0,12897,12897
142820500400000,OFFICE; CTRL CR,COMMERCIAL,0,435600,435600,0,17564400,18000000
142820600100000,CITY PROPERTY,EXEMPT,0,0,0,0,0,0
142820600200000,CITY PROPERTY,EXEMPT,0,0,0,0,0,0
142820700100000,SMALL RET; CTRL CR,COMMERCIAL,0,437400,437400,0,1961000,2398400
142820800100000,COUNTY PROPERTY,EXEMPT,0,0,0,0,0,0
142820900100000,CITY PROPERTY,EXEMPT,0,0,0,0,0,0
142821000100000,OFFICE; CTRL CR,COMMERCIAL,0,153600,153600,0,2928900,3082500
142822600100000,CITY PROPERTY,EXEMPT,0,0,0,0,0,0
142822700100000,CITY PROPERTY,EXEMPT,0,0,0,0,0,0
142822800100000,CITY PROPERTY,EXEMPT,0,0,0,0,0,0
142822800200000,CITY PROPERTY,EXEMPT,0,0,0,0,0,0
142822800300000,CITY PROPERTY,EXEMPT,0,0,0,0,0,0
142822800500000,CITY PROPERTY,EXEMPT,0,0,0,0,0,0
142822800600000,CITY PROPERTY,EXEMPT,0,0,0,0,0,0
142822800700000,CITY PROPERTY,EXEMPT,0,0,0,0,0,0
142822800800000,CITY PROPERTY,EXEMPT,0,0,0,0,0,0
142822800900000,CITY PROPERTY,EXEMPT,0,0,0,0,0,0
142822801000000,CITY PROPERTY,EXEMPT,0,0,0,0,0,0
142822801100000,CITY PROPERTY,EXEMPT,0,0,0,0,0,0
142822801200000,CITY PROPERTY,EXEMPT,0,0,0,0,0,0
142822801300000,CITY PROPERTY,EXEMPT,0,0,0,0,0,0
142822900100000,CITY PROPERTY,EXEMPT,0,0,0,0,0,0
142822900300000,CITY PROPERTY,EXEMPT,0,0,0,0,0,0
142823000100000,CITY PROPERTY,EXEMPT,0,0,0,0,0,0
142823100100000,CITY PROPERTY,EXEMPT,0,0,0,0,0,0
142823100700000,CITY PROPERTY,EXEMPT,0,0,0,0,0,0
142823101100000,CITY PROPERTY,EXEMPT,0,0,0,0,0,0
142823101200000,CITY PROPERTY,EXEMPT,0,0,0,0,0,0
142823101300000,CITY PROPERTY,EXEMPT,0,0,0,0,0,0
142823101400000,CITY PROPERTY,EXEMPT,0,0,0,0,0,0
142823101500000,CITY PROPERTY,EXEMPT,0,0,0,0,0,0
142823200100000,CITY PROPERTY,EXEMPT,0,0,0,0,0,0
142823200200000,CITY PROPERTY,EXEMPT,0,0,0,0,0,0
142823200300000,CITY PROPERTY,EXEMPT,0,0,0,0,0,0
142823200400000,CITY PROPERTY,EXEMPT,0,0,0,0,0,0
142823200500000,VACANT LAND,COMMERCIAL,0,18500,18500,0,0,18500
142823200600000,AUTO REP/SAL;CTRL CR,COMMERCIAL,0,33600,33600,0,58300,91900
142823200800000,CITY PROPERTY,EXEMPT,0,0,0,0,0,0
142823201100000,CITY PROPERTY,EXEMPT,0,0,0,0,0,0
142823201200000,CITY PROPERTY,EXEMPT,0,0,0,0,0,0
142823201300000,CITY PROPERTY,EXEMPT,0,0,0,0,0,0
142823300300000,COUNTY PROPERTY,EXEMPT,0,0,0,0,0,0
142823300400000,STATE PROPERTY,EXEMPT,0,0,0,0,0,0
142823300500000,STATE PROPERTY,EXEMPT,0,0,0,0,0,0
142823400100000,BRNCH BK/CR; CTRL CR,COMMERCIAL,0,142800,142800,0,484500,627300
142823400200000,FLAT PARKING,COMMERCIAL,0,50400,50400,0,4600,55000
142823400300000,CITY PROPERTY,EXEMPT,0,0,0,0,0,0
142823400500000,SMALL RET; CTRL CR,COMMERCIAL,0,56000,56000,0,60300,116300
142823400700000,SMALL RET; CTRL CR,COMMERCIAL,0,13400,13400,0,140100,153500
142823400800000,OFFICE; CTRL CR,COMMERCIAL,0,10100,10100,0,96500,106600
142823400900000,SMALL RET; CTRL CR,COMMERCIAL,0,12100,12100,0,218000,230100
142823401000000,SMALL RET; CTRL CR,COMMERCIAL,0,5300,5300,0,81700,87000
142823401100000,CITY PROPERTY,EXEMPT,0,0,0,0,0,0
142823500100000,SMALL RET; CTRL CR,COMMERCIAL,0,33600,33600,0,185400,219000
142823500500000,VACANT LAND,COMMERCIAL,0,18100,18100,0,0,18100
142823500600000,SW 401,RESIDENTIAL,13600,0,13600,73400,0,87000
142823500700000,SW 401,RESIDENTIAL,8500,0,8500,0,0,8500
142823500800000,SW 401,RESIDENTIAL,9100,0,9100,0,0,9100
142823501200000,WAREHOUSE; CTRL CR,COMMERCIAL,0,67200,67200,0,209100,276300
142823700200000,CITY PROPERTY,EXEMPT,0,0,0,0,0,0
142823700300000,SW 401,RESIDENTIAL,6900,0,6900,34400,0,41300
142823900100000,CITY PROPERTY,EXEMPT,0,0,0,0,0,0
142825100400000,BRNCH BK/CR; CTRL CR,COMMERCIAL,0,103000,103000,0,190400,293400
142825100500000,OFFICE; CTRL CR,COMMERCIAL,0,144600,144600,0,2409100,2553700
142825200100000,SMALL RET; CTRL CR,COMMERCIAL,0,67200,67200,0,239700,306900
142825300100000,SW 401,RESIDENTIAL,8200,0,8200,36200,0,44400
142825300500000,BARS/LOUNGE; CTRL CR,COMMERCIAL,0,67200,67200,0,126400,193600
142825300502000,BILLBOARD(BLL),COMMERCIAL,0,0,0,0,50500,50500
142825400100000,VACANT LAND,COMMERCIAL,0,116500,116500,0,0,116500
142825400200000,SCHOOL,EXEMPT,0,84000,84000,0,345500,429500
142825400300000,CONVERSIONS; NON-APT,COMMERCIAL,11140,44560,55700,45508,158992,260200
142825500100000,OFFICE; CTRL CR,EXEMPT,0,56000,56000,0,448000,504000
142825500200000,OFFICE; CTRL CR,COMMERCIAL,0,11200,11200,0,142000,153200
142825500300000,OFFICE; CTRL CR,COMMERCIAL,0,33600,33600,0,129400,163000
142825500400000,SMALL RET; CTRL CR,COMMERCIAL,0,33600,33600,0,178000,211600
142825500500000,SHOP,COMMERCIAL,0,33600,33600,0,45600,79200
142825500502000,BILLBOARD(BLL),COMMERCIAL,0,0,0,0,18700,18700
142825500600000,WAREHOUSE; CTRL CR,COMMERCIAL,0,65500,65500,0,44900,110400
142825500700000,FLAT PARKING,COMMERCIAL,0,35300,35300,0,4600,39900
142825500800000,SW 401,RESIDENTIAL,5600,0,5600,45100,0,50700
142825500900000,CITY PROPERTY,EXEMPT,0,0,0,0,0,0
142825501000000,OFFICE; CTRL CR,COMMERCIAL,0,14400,14400,0,65300,79700
142825600100000,CITY PROPERTY,EXEMPT,0,0,0,0,0,0
142825600200000,CITY PROPERTY,EXEMPT,0,0,0,0,0,0
142825600300000,SW 401,RESIDENTIAL,15000,0,15000,56300,0,71300
142825600400000,CITY PROPERTY,EXEMPT,0,0,0,0,0,0
142825600500000,CITY PROPERTY,EXEMPT,0,0,0,0,0,0
142825600600000,CITY PROPERTY,EXEMPT,0,0,0,0,0,0
142825600700000,SW 401,RESIDENTIAL,6000,0,6000,60500,0,66500
142825601000000,SW 401,RESIDENTIAL,6300,0,6300,0,0,6300
142825601100000,CONVERSIONS; NON-APT,COMMERCIAL,7200,10800,18000,18400,29000,65400
142825601200000,CONVERSION-NW/SW,MULTI-RES,18000,0,18000,43900,0,61900
142825601300000,OFFICE; MED; CTRL CR,COMMERCIAL,0,12600,12600,0,80400,93000
142825601400000,SW 401,RESIDENTIAL,9000,0,9000,53000,0,62000
142825601900000,SW 401,RESIDENTIAL,6200,0,6200,55100,0,61300
142825602000000,SW 401,RESIDENTIAL,6300,0,6300,58200,0,64500
142825602100000,SW 401,RESIDENTIAL,6500,0,6500,43600,0,50100
142825602300000,SW 401,RESIDENTIAL,11200,0,11200,30200,0,41400
142825700100000,NBHD SHOPPING CENTER,COMMERCIAL,0,56000,56000,0,480600,536600
142825700400000,FLAT PARKING,EXEMPT,0,47600,47600,0,10100,57700
142825700500000,SW 401,RESIDENTIAL,15000,0,15000,89000,0,104000
142825700600000,SW 401,RESIDENTIAL,15000,0,15000,60400,0,75400
142825700700000,SW 401,RESIDENTIAL,5000,0,5000,0,0,5000
142825700800000,SW 401,RESIDENTIAL,15000,0,15000,120200,0,135200
142825700900000,SW 401,RESIDENTIAL,9000,0,9000,0,0,9000
142825701000000,SW 401,RESIDENTIAL,14700,0,14700,66100,0,80800
142825701100000,FLAT PARKING,COMMERCIAL,0,14700,14700,0,2100,16800
142825701200000,CITY PROPERTY,EXEMPT,0,0,0,0,0,0
142825800100000,SW 401,RESIDENTIAL,12600,0,12600,63500,0,76100
142825800900000,SW 401,RESIDENTIAL,5000,0,5000,0,0,5000
142825801000000,SW 401,RESIDENTIAL,10600,0,10600,68300,0,78900
142825801400000,FRATERNAL,EXEMPT,0,75800,75800,0,211900,287700
142825801600000,VACANT LAND,COMMERCIAL,0,1600,1600,0,0,1600
142825900100000,SW 401,RESIDENTIAL,10100,0,10100,71600,0,81700
142825900200000,SW 401,RESIDENTIAL,18900,0,18900,95700,0,114600
142825900300000,SW 401,RESIDENTIAL,15000,0,15000,84000,0,99000
142825900400000,SW 401,RESIDENTIAL,15000,0,15000,33900,0,48900
142825900500000,SW 401,RESIDENTIAL,15000,0,15000,69900,0,84900
142825900600000,APARTMENT; CNTRL CR,MULTI-RES,14000,0,14000,141500,0,155500
142825900700000,CONVERSION-NW/SW,MULTI-RES,10500,0,10500,64000,0,74500
142825900800000,SW 401,RESIDENTIAL,8100,0,8100,26300,0,34400
142825900900000,SW 401,RESIDENTIAL,11300,0,11300,88400,0,99700
142825901000000,CITY PROPERTY,EXEMPT,0,0,0,0,0,0
142825901100000,CITY PROPERTY,EXEMPT,0,0,0,0,0,0
142825901200000,CITY PROPERTY,EXEMPT,0,0,0,0,0,0
142825901300000,CITY PROPERTY,EXEMPT,0,0,0,0,0,0
142825901400000,CITY PROPERTY,EXEMPT,0,0,0,0,0,0
142825901500000,CITY PROPERTY,EXEMPT,0,0,0,0,0,0
142825901600000,SW 401,RESIDENTIAL,15000,0,15000,57500,0,72500
142825901700000,SW 401,RESIDENTIAL,15000,0,15000,90300,0,105300
142825901800000,SW 401,RESIDENTIAL,15000,0,15000,68900,0,83900
142825901900000,SW 401,RESIDENTIAL,7300,0,7300,45500,0,52800
142825902000000,CITY PROPERTY,EXEMPT,0,0,0,0,0,0
142825902100000,SW 401,RESIDENTIAL,15000,0,15000,66500,0,81500
142825902200000,SW 401,RESIDENTIAL,7500,0,7500,49800,0,57300
142825902300000,SW 401,RESIDENTIAL,7500,0,7500,46700,0,54200
142825902600000,SW 401,RESIDENTIAL,6500,0,6500,31200,0,37700
142825902700000,SW 401,RESIDENTIAL,6300,0,6300,54000,0,60300
142825902800000,SW 401,RESIDENTIAL,10200,0,10200,60500,0,70700
142825902900000,SW 401,RESIDENTIAL,21200,0,21200,116700,0,137900
142826000100000,SW 403,RESIDENTIAL,20100,0,20100,44500,0,64600
142826000200000,SW 403,RESIDENTIAL,11800,0,11800,51300,0,63100
142826000300000,SW 403,RESIDENTIAL,11700,0,11700,40100,0,51800
142826000400000,SW 403,RESIDENTIAL,5000,0,5000,0,0,5000
142826000500000,CITY PROPERTY,EXEMPT,0,0,0,0,0,0
142826000600000,CITY PROPERTY,EXEMPT,0,0,0,0,0,0
142826000700000,CITY PROPERTY,EXEMPT,0,0,0,0,0,0
142826100100000,SW 401,RESIDENTIAL,13700,0,13700,90000,0,103700
142827600500000,CITY PROPERTY,EXEMPT,0,0,0,0,0,0
142827801700000,FLAT PARKING,COMMERCIAL,0,126000,126000,0,67100,193100
142827801800000,VACANT LAND,MULTI-RES,111100,0,111100,0,0,111100
142827900100000,CITY PROPERTY,EXEMPT,0,0,0,0,0,0
142827900200000,CITY PROPERTY,EXEMPT,0,0,0,0,0,0
142827900300000,CITY PROPERTY,EXEMPT,0,0,0,0,0,0
142827900900000,CITY PROPERTY,EXEMPT,0,0,0,0,0,0
142827901000000,SMALL RETAIL,COMMERCIAL,52900,26000,78900,517800,255100,851800
142827901100000,FLAT PARKING,COMMERCIAL,0,82300,82300,0,67000,149300
142828000100000,CITY PROPERTY,EXEMPT,0,0,0,0,0,0
142828000200000,CITY PROPERTY,EXEMPT,0,0,0,0,0,0
142828000300000,CITY PROPERTY,EXEMPT,0,0,0,0,0,0
142828000400000,SW 401,RESIDENTIAL,9600,0,9600,19400,0,29000
142828000500000,SW 401,RESIDENTIAL,8700,0,8700,56500,0,65200
142828000600000,CITY PROPERTY,EXEMPT,0,0,0,0,0,0
142828000700000,SW 401,RESIDENTIAL,5000,0,5000,0,0,5000
142828000800000,CITY PROPERTY,EXEMPT,0,0,0,0,0,0
142828000900000,SW 401,RESIDENTIAL,8400,0,8400,45600,0,54000
142828001000000,SW 401,RESIDENTIAL,9600,0,9600,19600,0,29200
142828001100000,CONVERSION-NW/SW,MULTI-RES,13500,0,13500,36900,0,50400
142828001200000,SW 401,RESIDENTIAL,13500,0,13500,34900,0,48400
142828001300000,SW 401,RESIDENTIAL,8400,0,8400,50000,0,58400
142828001400000,SW 401,RESIDENTIAL,6300,0,6300,36700,0,43000
142828001500000,OFFICE; CTRL CR,COMMERCIAL,0,117600,117600,0,348700,466300
142828002000000,SW 401,RESIDENTIAL,6800,0,6800,0,0,6800
142828002100000,CITY PROPERTY,EXEMPT,0,0,0,0,0,0
142828100100000,SW 401,RESIDENTIAL,6900,0,6900,59100,0,66000
142828100200000,CITY PROPERTY,EXEMPT,0,0,0,0,0,0
142828100300000,SW 401,RESIDENTIAL,10000,0,10000,81200,0,91200
142828100400000,SW 401,RESIDENTIAL,10000,0,10000,71800,0,81800
142828101100000,APARTMENT; CNTRL CR,MULTI-RES,132800,0,132800,4880400,0,5013200
142828200100000,CITY PROPERTY,EXEMPT,0,0,0,0,0,0
142828300100000,CONVERSION-NW/SW,MULTI-RES,15800,0,15800,35700,0,51500
142828300200000,SW 401,RESIDENTIAL,7400,0,7400,49800,0,57200
142828300300000,SW 401,RESIDENTIAL,18000,0,18000,80200,0,98200
142828300700000,OFFICE; CTRL CR,COMMERCIAL,0,94100,94100,0,358600,452700
142828301000000,CONVERSIONS; NON-APT,COMMERCIAL,0,63000,63000,0,70900,133900
142828301200000,SHOP,COMMERCIAL,0,33600,33600,0,61600,95200
142828301300000,CITY PROPERTY,EXEMPT,0,0,0,0,0,0
142828301400000,CITY PROPERTY,EXEMPT,0,0,0,0,0,0
142830100100000,SW 401,RESIDENTIAL,7800,0,7800,39000,0,46800
142830100200000,CITY PROPERTY,EXEMPT,0,0,0,0,0,0
142830200100000,AUTO REPAIR/SALES,COMMERCIAL,0,91400,91400,0,154700,246100
142830200200000,CITY PROPERTY,EXEMPT,0,0,0,0,0,0
142830200500000,CITY PROPERTY,EXEMPT,0,0,0,0,0,0
142830200600000,SW 401,RESIDENTIAL,15000,0,15000,66100,0,81100
142830200700000,SW 401,RESIDENTIAL,15000,0,15000,52900,0,67900
142830200800000,SW 401,RESIDENTIAL,15000,0,15000,42600,0,57600
142830200900000,FLAT PARKING,COMMERCIAL,0,18100,18100,0,5400,23500
142830201000000,VACANT LAND,COMMERCIAL,0,2300,2300,0,0,2300
142830201100000,SW 401,RESIDENTIAL,4100,0,4100,0,0,4100
142830201200000,VACANT LAND,COMMERCIAL,0,2300,2300,0,0,2300
142830201300000,VACANT LAND,COMMERCIAL,0,8600,8600,0,0,8600
142830201400000,VACANT LAND,COMMERCIAL,0,5400,5400,0,0,5400
142830201500000,VACANT LAND,COMMERCIAL,0,27300,27300,0,0,27300
142830300100000,SW 401,RESIDENTIAL,13400,0,13400,70100,0,83500
142830300200000,SW 401,RESIDENTIAL,13500,0,13500,68100,0,81600
142830300300000,CITY PROPERTY,EXEMPT,0,0,0,0,0,0
142830300400000,CITY PROPERTY,EXEMPT,0,0,0,0,0,0
142830300500000,CITY PROPERTY,EXEMPT,0,0,0,0,0,0
142830300600000,SW 401,RESIDENTIAL,6500,0,6500,52900,0,59400
142830300700000,SW 401,RESIDENTIAL,6500,0,6500,45500,0,52000
142830400100000,FOOD GRADE;INDUST,INDUSTRIAL,0,241300,241300,0,689500,930800
142830500100000,RESTAURANT,COMMERCIAL,0,28800,28800,0,53300,82100
142830500500000,CENTRALLY ASSESSED,OTHER,0,0,0,0,0,0
142830500600000,VACANT LAND,COMMERCIAL,0,2500,2500,0,0,2500
142830500700000,FLAT PARKING,COMMERCIAL,0,28800,28800,0,4300,33100
142830500800000,BRANCH BANK/CU,COMMERCIAL,0,110200,110200,0,524200,634400
142830600100000,SMALL RETAIL,COMMERCIAL,1224,2376,3600,13452,25248,42300
142830600200000,SW 401,RESIDENTIAL,10300,0,10300,29200,0,39500
142830600300000,SW 401,RESIDENTIAL,7200,0,7200,25400,0,32600
142830600600000,SW 401,RESIDENTIAL,18700,0,18700,0,0,18700
142830600800000,CITY PROPERTY,EXEMPT,0,0,0,0,0,0
142830600900000,APARTMENT,MULTI-RES,16800,0,16800,163100,0,179900
142830601000000,SMALL RETAIL,COMMERCIAL,0,5900,5900,0,50300,56200
142830601100000,SW 401,RESIDENTIAL,9600,0,9600,49500,0,59100
142830601200000,SW 401,RESIDENTIAL,15800,0,15800,42900,0,58700
142830601300000,SW 401,RESIDENTIAL,7400,0,7400,35900,0,43300
142830601500000,SW 401,RESIDENTIAL,8400,0,8400,33800,0,42200
142830601600000,SW 401,RESIDENTIAL,9300,0,9300,27200,0,36500
142830601800000,CITY PROPERTY,EXEMPT,0,0,0,0,0,0
142830601900000,SW 401,RESIDENTIAL,12000,0,12000,58300,0,70300
142830602000000,SW 401,RESIDENTIAL,12000,0,12000,76000,0,88000
142830602100000,SW 401,RESIDENTIAL,16500,0,16500,44600,0,61100
142830602200000,CITY PROPERTY,EXEMPT,0,0,0,0,0,0
142830602300000,SW 401,RESIDENTIAL,11500,0,11500,51000,0,62500
142830701400000,COUNTY PROPERTY,EXEMPT,0,0,0,0,0,0
142830800100000,FOOD GRADE;INDUST,INDUSTRIAL,0,19900,19900,0,456500,476400
142830800200000,COUNTY PROPERTY,EXEMPT,0,0,0,0,0,0
142830900100000,VACANT LAND,COMMERCIAL,0,25200,25200,0,0,25200
142830900102000,SMALL RETAIL,COMMERCIAL,0,0,0,0,157700,157700
142830900200000,VACANT LAND,COMMERCIAL,0,16200,16200,0,0,16200
142830900300000,COUNTY PROPERTY,EXEMPT,0,0,0,0,0,0
142830900400000,COUNTY PROPERTY,EXEMPT,0,0,0,0,0,0
142830900500000,COUNTY PROPERTY,EXEMPT,0,0,0,0,0,0
142830900600000,COUNTY PROPERTY,EXEMPT,0,0,0,0,0,0
142830900700000,COUNTY PROPERTY,EXEMPT,0,0,0,0,0,0
142830900800000,SHOP,COMMERCIAL,0,25200,25200,0,69700,94900
142830900900000,FLAT PARKING,COMMERCIAL,0,18900,18900,0,28800,47700
142830901000000,COUNTY PROPERTY,EXEMPT,0,0,0,0,0,0
142830901100000,COUNTY PROPERTY,EXEMPT,0,0,0,0,0,0
142831000100000,FOOD GRADE;INDUST,INDUSTRIAL,0,28500,28500,0,97500,126000
142831000200000,FOOD GRADE;INDUST,INDUSTRIAL,0,32700,32700,0,111100,143800
142831100200000,SW 402,RESIDENTIAL,7400,0,7400,47200,0,54600
142831100300000,SW 402,RESIDENTIAL,11400,0,11400,0,0,11400
142831100600000,SW 402,RESIDENTIAL,13100,0,13100,0,0,13100
142831100700000,SW 402,RESIDENTIAL,15900,0,15900,136800,0,152700
142831100800000,SW 402,RESIDENTIAL,15300,0,15300,59900,0,75200
142831101300000,CITY PROPERTY,EXEMPT,0,0,0,0,0,0
142831101400000,COUNTY PROPERTY,EXEMPT,0,0,0,0,0,0
142831101500000,SMALL RETAIL,COMMERCIAL,0,28800,28800,0,112600,141400
142831101600000,SW 402,RESIDENTIAL,11400,0,11400,30000,0,41400
142831200100000,BARS/LOUNGE,COMMERCIAL,16128,17472,33600,40300,59700,133600
142831300100000,CENTRALLY ASSESSED,OTHER,0,0,0,0,0,0
142832600200000,SW 401,RESIDENTIAL,15400,0,15400,45300,0,60700
142832600300000,CITY PROPERTY,EXEMPT,0,0,0,0,0,0
142832600400000,SW 401,RESIDENTIAL,13300,0,13300,43600,0,56900
142832700300000,APARTMENT,MULTI-RES,8400,0,8400,80800,0,89200
142832700400000,SW 403,RESIDENTIAL,13600,0,13600,77300,0,90900
142832700500000,SW 403,RESIDENTIAL,17700,0,17700,41100,0,58800
142832700600000,SW 403,RESIDENTIAL,5000,0,5000,0,0,5000
142832700900000,SW 403,RESIDENTIAL,13600,0,13600,0,0,13600
142832701000000,CITY PROPERTY,EXEMPT,0,0,0,0,0,0
142832701100000,OFFICE; CTRL CR,COMMERCIAL,0,48800,48800,0,125000,173800
142832701200000,FLAT PARKING,COMMERCIAL,0,13500,13500,0,6200,19700
142832701300000,CONVENIENCE STORE,COMMERCIAL,0,58100,58100,0,243400,301500
142832701400000,SW 403,RESIDENTIAL,21500,0,21500,66400,0,87900
142832701500000,SW 403,RESIDENTIAL,20500,0,20500,107000,0,127500
142832701700000,SW 403,RESIDENTIAL,20500,0,20500,107000,0,127500
142832800100000,SW 403,RESIDENTIAL,20100,0,20100,43400,0,63500
142832800200000,SW 403,RESIDENTIAL,13600,0,13600,46900,0,60500
142832800300000,CITY PROPERTY,EXEMPT,0,0,0,0,0,0
142832800400000,SW 403,RESIDENTIAL,18200,0,18200,64400,0,82600
142832800500000,SW 403,RESIDENTIAL,16600,0,16600,59900,0,76500
142832800600000,CONVERSION-NW/SW,MULTI-RES,13700,0,13700,34800,0,48500
142832800700000,SW 403,RESIDENTIAL,15100,0,15100,43200,0,58300
142832800800000,SW 403,RESIDENTIAL,11000,0,11000,59100,0,70100
142832800900000,CONVERSION-NW/SW,MULTI-RES,20600,0,20600,35600,0,56200
142832801000000,SW 403,RESIDENTIAL,22000,0,22000,55600,0,77600
142832801100000,SW 403,RESIDENTIAL,20500,0,20500,110300,0,130800
142832801200000,SW 403,RESIDENTIAL,13600,0,13600,63200,0,76800
142832801300000,SW 403,RESIDENTIAL,16000,0,16000,35200,0,51200
142832801400000,SW 403,RESIDENTIAL,13200,0,13200,50200,0,63400
142832801500000,CITY PROPERTY,EXEMPT,0,0,0,0,0,0
142832801600000,SW 403,RESIDENTIAL,11400,0,11400,33400,0,44800
142832801700000,CITY PROPERTY,EXEMPT,0,0,0,0,0,0
142832900100000,SW 403,RESIDENTIAL,20000,0,20000,46500,0,66500
142832900200000,SW 403,RESIDENTIAL,13600,0,13600,43500,0,57100
142832900300000,SW 403,RESIDENTIAL,15900,0,15900,117900,0,133800
142832900400000,SW 403,RESIDENTIAL,20000,0,20000,63400,0,83400
142832900500000,SW 403,RESIDENTIAL,21800,0,21800,0,0,21800
142832900600000,SW 403,RESIDENTIAL,21800,0,21800,122600,0,144400
142832900700000,CONVERSION-NW/SW,MULTI-RES,20700,0,20700,39000,0,59700
142832900800000,SW 403,RESIDENTIAL,14500,0,14500,53300,0,67800
142832900900000,SW 403,RESIDENTIAL,29900,0,29900,57000,0,86900
142832901000000,SW 403,RESIDENTIAL,5000,0,5000,0,0,5000
142832901100000,SW 403,RESIDENTIAL,12900,0,12900,54000,0,66900
142833000100000,SW 403,RESIDENTIAL,21800,0,21800,113800,0,135600
142833000200000,SW 403,RESIDENTIAL,21800,0,21800,0,0,21800
142833000300000,SW 403,RESIDENTIAL,21800,0,21800,73700,0,95500
142833000400000,SW 403,RESIDENTIAL,13600,0,13600,51700,0,65300
142833000700000,SW 403,RESIDENTIAL,18800,0,18800,0,0,18800
142833000800000,SW 403,RESIDENTIAL,13600,0,13600,39200,0,52800
142833000900000,SW 403,RESIDENTIAL,13600,0,13600,35600,0,49200
142833001000000,CONVERSION-NW/SW,MULTI-RES,20700,0,20700,40000,0,60700
142833001100000,CONVERSION-NW/SW,MULTI-RES,13000,0,13000,33700,0,46700
142833001200000,SW 403,RESIDENTIAL,13600,0,13600,67300,0,80900
142833001300000,SW 403,RESIDENTIAL,22100,0,22100,118900,0,141000
142833001400000,SW 403,RESIDENTIAL,9500,0,9500,0,0,9500
142833001500000,SW 403,RESIDENTIAL,24400,0,24400,72600,0,97000
142833100100000,CITY PROPERTY,EXEMPT,0,0,0,0,0,0
142833100200000,CITY PROPERTY,EXEMPT,0,0,0,0,0,0
142833100300000,SW 403,RESIDENTIAL,21400,0,21400,39900,0,61300
142833100400000,SW 403,RESIDENTIAL,19300,0,19300,67300,0,86600
142833100500000,SW 403,RESIDENTIAL,20500,0,20500,85000,0,105500
142833100600000,SW 403,RESIDENTIAL,20000,0,20000,59000,0,79000
142833100700000,SW 403,RESIDENTIAL,12600,0,12600,45800,0,58400
142833100800000,SW 403,RESIDENTIAL,13600,0,13600,44900,0,58500
142833100900000,CITY PROPERTY,EXEMPT,0,0,0,0,0,0
142833101000000,SW 403,RESIDENTIAL,20500,0,20500,109400,0,129900
142833101100000,SW 403,RESIDENTIAL,18200,0,18200,37700,0,55900
142833101200000,SW 403,RESIDENTIAL,18200,0,18200,59900,0,78100
142833101300000,SW 403,RESIDENTIAL,18200,0,18200,71500,0,89700
142833101400000,SW 403,RESIDENTIAL,18200,0,18200,62100,0,80300
142833101500000,SW 403,RESIDENTIAL,18000,0,18000,68100,0,86100
142833101600000,CITY PROPERTY,EXEMPT,0,0,0,0,0,0
142833101700000,SW 403,RESIDENTIAL,16900,0,16900,64700,0,81600
142833101800000,SW 403,RESIDENTIAL,23400,0,23400,62000,0,85400
142833101900000,SW 403,RESIDENTIAL,18900,0,18900,120700,0,139600
142833102000000,SW 403,RESIDENTIAL,21300,0,21300,75900,0,97200
142833102100000,SW 403,RESIDENTIAL,14200,0,14200,47800,0,62000
142833102200000,CITY PROPERTY,EXEMPT,0,0,0,0,0,0
142833200100000,SW 403,RESIDENTIAL,21800,0,21800,79600,0,101400
142833200200000,SW 403,RESIDENTIAL,21800,0,21800,71100,0,92900
142833200300000,CITY PROPERTY,EXEMPT,0,0,0,0,0,0
142833200400000,SW 403,RESIDENTIAL,15000,0,15000,0,0,15000
142833200500000,SW 403,RESIDENTIAL,13600,0,13600,40700,0,54300
142833200800000,CONVERSION-NW/SW,MULTI-RES,9300,0,9300,47300,0,56600
142833200900000,SW 403,RESIDENTIAL,18200,0,18200,0,0,18200
142833201000000,SW 403,RESIDENTIAL,18200,0,18200,67800,0,86000
142833201100000,SW 403,RESIDENTIAL,18200,0,18200,119100,0,137300
142833201200000,SW 403,RESIDENTIAL,20500,0,20500,37100,0,57600
142833201500000,CONVERSION-NW/SW,MULTI-RES,23000,0,23000,54000,0,77000
142833201600000,SW 403,RESIDENTIAL,11300,0,11300,43400,0,54700
142833201700000,SW 403,RESIDENTIAL,18200,0,18200,54700,0,72900
142833201800000,SW 403,RESIDENTIAL,18200,0,18200,54900,0,73100
142833201900000,SW 403,RESIDENTIAL,18200,0,18200,48300,0,66500
142833202000000,SW 403,RESIDENTIAL,18200,0,18200,44500,0,62700
142833202100000,SW 403,RESIDENTIAL,18200,0,18200,35500,0,53700
142833202200000,SW 403,RESIDENTIAL,20700,0,20700,74300,0,95000
142833202300000,SW 403,RESIDENTIAL,18200,0,18200,54800,0,73000
142833202400000,SW 403,RESIDENTIAL,18200,0,18200,41100,0,59300
142833202500000,SW 403,RESIDENTIAL,18200,0,18200,39600,0,57800
142833202600000,SW 403,RESIDENTIAL,21800,0,21800,77000,0,98800
142833202700000,SW 403,RESIDENTIAL,21800,0,21800,96900,0,118700
142833202800000,SW 403,RESIDENTIAL,21800,0,21800,64000,0,85800
142833202900000,SW 403,RESIDENTIAL,28600,0,28600,119700,0,148300
142833300100000,CHURCH,EXEMPT,0,25200,25200,0,176900,202100
142833300200000,SW 403,RESIDENTIAL,14400,0,14400,57700,0,72100
142833300300000,SW 403,RESIDENTIAL,16400,0,16400,35700,0,52100
142833300400000,CITY PROPERTY,EXEMPT,0,0,0,0,0,0
142833300500000,SW 403,RESIDENTIAL,18700,0,18700,54300,0,73000
142833300600000,CITY PROPERTY,EXEMPT,0,0,0,0,0,0
142833300700000,VACANT LAND,COMMERCIAL,0,19100,19100,0,0,19100
142833300800000,FLAT PARKING,EXEMPT,0,14000,14000,0,3300,17300
142833300900000,FLAT PARKING,EXEMPT,0,14100,14100,0,1700,15800
142833301000000,SW 403,RESIDENTIAL,24600,0,24600,0,0,24600
142833301100000,FLAT PARKING,EXEMPT,0,18100,18100,0,4200,22300
142833400100000,SW 403,RESIDENTIAL,12600,0,12600,47000,0,59600
142833400200000,SW 403,RESIDENTIAL,14700,0,14700,49500,0,64200
142833400300000,SW 403,RESIDENTIAL,18200,0,18200,88800,0,107000
142833400400000,SW 403,RESIDENTIAL,18200,0,18200,51200,0,69400
142833400500000,SW 403,RESIDENTIAL,18200,0,18200,74500,0,92700
142833400600000,SW 403,RESIDENTIAL,18200,0,18200,14400,0,32600
142833400700000,SW 403,RESIDENTIAL,18200,0,18200,58800,0,77000
142833400800000,SW 403,RESIDENTIAL,18200,0,18200,39000,0,57200
142833400900000,SW 403,RESIDENTIAL,14800,0,14800,68900,0,83700
142833401000000,WAREHOUSE;MINI STORG,COMMERCIAL,0,32400,32400,0,81400,113800
142833401100000,SHOP,COMMERCIAL,10127,14573,24700,48790,70210,143700
142833401200000,SW 403,RESIDENTIAL,18200,0,18200,47700,0,65900
142833401300000,SW 403,RESIDENTIAL,18200,0,18200,63700,0,81900
142833401400000,SW 403,RESIDENTIAL,18200,0,18200,67500,0,85700
142833401500000,SW 403,RESIDENTIAL,18200,0,18200,49000,0,67200
142833401600000,SW 403,RESIDENTIAL,18200,0,18200,48100,0,66300
142833500100000,SW 403,RESIDENTIAL,23800,0,23800,79400,0,103200
142833500200000,SW 403,RESIDENTIAL,18200,0,18200,62500,0,80700
142833500300000,SW 403,RESIDENTIAL,18200,0,18200,91300,0,109500
142833500400000,SW 403,RESIDENTIAL,18200,0,18200,84300,0,102500
142833500500000,SW 403,RESIDENTIAL,18200,0,18200,60700,0,78900
142833500600000,SW 403,RESIDENTIAL,18200,0,18200,80100,0,98300
142833500700000,SW 403,RESIDENTIAL,18200,0,18200,69800,0,88000
142833500800000,SW 403,RESIDENTIAL,18200,0,18200,43700,0,61900
142833500900000,SW 403,RESIDENTIAL,18200,0,18200,112000,0,130200
142833501000000,SW 403,RESIDENTIAL,18200,0,18200,55500,0,73700
142833501100000,SW 403,RESIDENTIAL,18200,0,18200,4000,0,22200
142833501200000,SW 403,RESIDENTIAL,18200,0,18200,60600,0,78800
142833501300000,SW 403,RESIDENTIAL,19100,0,19100,66800,0,85900
142833501400000,SW 403,RESIDENTIAL,18900,0,18900,0,0,18900
142833501500000,SW 403,RESIDENTIAL,19100,0,19100,78500,0,97600
142833501600000,SW 403,RESIDENTIAL,19100,0,19100,28800,0,47900
142833501700000,SW 403,RESIDENTIAL,18200,0,18200,27500,0,45700
142833501800000,SW 403,RESIDENTIAL,18200,0,18200,55100,0,73300
142833501900000,SW 403,RESIDENTIAL,18200,0,18200,77100,0,95300
142833502000000,SW 403,RESIDENTIAL,18200,0,18200,65700,0,83900
142833502100000,SW 403,RESIDENTIAL,18200,0,18200,0,0,18200
142833502200000,SW 403,RESIDENTIAL,18200,0,18200,41000,0,59200
142833502300000,SW 403,RESIDENTIAL,18200,0,18200,61100,0,79300
142833502400000,SW 403,RESIDENTIAL,18200,0,18200,19700,0,37900
142833502500000,SW 403,RESIDENTIAL,18200,0,18200,86900,0,105100
142833502600000,SW 403,RESIDENTIAL,18200,0,18200,80000,0,98200
142833502700000,SW 403,RESIDENTIAL,18200,0,18200,74000,0,92200
142833502800000,SW 403,RESIDENTIAL,15000,0,15000,53500,0,68500
142833502900000,SW 403,RESIDENTIAL,13600,0,13600,53700,0,67300
142833503000000,SW 403,RESIDENTIAL,14500,0,14500,53800,0,68300
142833600100000,VACANT LAND,COMMERCIAL,0,7600,7600,0,0,7600
142833600200000,SW 403,RESIDENTIAL,16200,0,16200,26500,0,42700
142833600300000,SW 403,RESIDENTIAL,17300,0,17300,89200,0,106500
142833600400000,SW 403,RESIDENTIAL,17900,0,17900,32200,0,50100
142833600500000,CITY PROPERTY,EXEMPT,0,0,0,0,0,0
142833600600000,SW 403,RESIDENTIAL,18200,0,18200,41600,0,59800
142833600700000,SW 403,RESIDENTIAL,18200,0,18200,44700,0,62900
142833600800000,SW 403,RESIDENTIAL,27300,0,27300,55000,0,82300
142833600900000,SW 403,RESIDENTIAL,18200,0,18200,65400,0,83600
142833601000000,SW 403,RESIDENTIAL,18200,0,18200,79600,0,97800
142833601100000,SW 403,RESIDENTIAL,18200,0,18200,57800,0,76000
142833601200000,SW 403,RESIDENTIAL,19100,0,19100,83600,0,102700
142833601300000,SW 403,RESIDENTIAL,19100,0,19100,0,0,19100
142833700100000,VACANT LAND,COMMERCIAL,0,169800,169800,0,0,169800
142833700200000,CENTRALLY ASSESSED,OTHER,0,0,0,0,0,0
142833700300000,CENTRALLY ASSESSED,OTHER,0,0,0,0,0,0
142835100100000,VACANT LAND,COMMERCIAL,0,20400,20400,0,0,20400
142835100200000,SW 403,RESIDENTIAL,18400,0,18400,41600,0,60000
142835100300000,SW 403,RESIDENTIAL,22000,0,22000,47500,0,69500
142835100400000,SW 403,RESIDENTIAL,22000,0,22000,125400,0,147400
142835100500000,SW 403,RESIDENTIAL,18400,0,18400,49700,0,68100
142835100600000,SW 403,RESIDENTIAL,22000,0,22000,38700,0,60700
142835100900000,SW 403,RESIDENTIAL,18400,0,18400,44200,0,62600
142835101000000,SW 403,RESIDENTIAL,12200,0,12200,23800,0,36000
142835101100000,SW 403,RESIDENTIAL,5000,0,5000,0,0,5000
142835101200000,SW 403,RESIDENTIAL,21400,0,21400,35300,0,56700
142835101400000,SW 403,RESIDENTIAL,18400,0,18400,32000,0,50400
142835101500000,SW 403,RESIDENTIAL,18400,0,18400,0,0,18400
142835101600000,SW 403,RESIDENTIAL,18400,0,18400,0,0,18400
142835101700000,SW 403,RESIDENTIAL,18400,0,18400,38200,0,56600
142835101800000,VACANT LAND,COMMERCIAL,0,10200,10200,0,0,10200
142835101900000,CITY PROPERTY,EXEMPT,0,0,0,0,0,0
142835200100000,SW 403,RESIDENTIAL,18200,0,18200,84700,0,102900
142835200200000,SW 403,RESIDENTIAL,5000,0,5000,0,0,5000
142835200300000,SW 403,RESIDENTIAL,18200,0,18200,4000,0,22200
142835200400000,SW 403,RESIDENTIAL,18200,0,18200,24500,0,42700
142835200500000,SW 403,RESIDENTIAL,18200,0,18200,112700,0,130900
142835200600000,SW 403,RESIDENTIAL,18200,0,18200,45300,0,63500
142835200700000,SW 403,RESIDENTIAL,18200,0,18200,117200,0,135400
142835200800000,SW 403,RESIDENTIAL,18200,0,18200,46200,0,64400
142835200900000,SW 403,RESIDENTIAL,18200,0,18200,59300,0,77500
142835201000000,SW 403,RESIDENTIAL,18200,0,18200,59600,0,77800
142835201100000,SW 403,RESIDENTIAL,18200,0,18200,111700,0,129900
142835201200000,SW 403,RESIDENTIAL,18200,0,18200,111100,0,129300
142835201300000,SW 403,RESIDENTIAL,18200,0,18200,29900,0,48100
142835201400000,SW 403,RESIDENTIAL,18200,0,18200,45200,0,63400
142835201500000,SW 403,RESIDENTIAL,18200,0,18200,97800,0,116000
142835201600000,SW 403,RESIDENTIAL,18200,0,18200,107500,0,125700
142835201700000,SW 403,RESIDENTIAL,18200,0,18200,0,0,18200
142835201800000,SW 403,RESIDENTIAL,18200,0,18200,0,0,18200
142835300100000,CENTRALLY ASSESSED,OTHER,0,0,0,0,0,0
142835301500000,CITY PROPERTY,EXEMPT,0,0,0,0,0,0
142835400100000,VACANT LAND,COMMERCIAL,0,1100,1100,0,0,1100
142835400200000,VACANT LAND,COMMERCIAL,0,89600,89600,0,0,89600
142835400300000,CENTRALLY ASSESSED,OTHER,0,0,0,0,0,0
142835400400000,VACANT LAND,COMMERCIAL,0,5500,5500,0,0,5500
142835500100000,SW 403,RESIDENTIAL,20700,0,20700,0,0,20700
142835500200000,SW 403,RESIDENTIAL,9100,0,9100,33800,0,42900
142835500500000,SW 403,RESIDENTIAL,5000,0,5000,0,0,5000
142835500600000,SW 403,RESIDENTIAL,18400,0,18400,50100,0,68500
142835500700000,SW 403,RESIDENTIAL,18400,0,18400,0,0,18400
142835500800000,SW 403,RESIDENTIAL,21500,0,21500,47800,0,69300
142835500900000,SW 403,RESIDENTIAL,18400,0,18400,70600,0,89000
142835501000000,SW 403,RESIDENTIAL,20700,0,20700,45800,0,66500
142835501100000,SW 403,RESIDENTIAL,18400,0,18400,113800,0,132200
142835501200000,SW 403,RESIDENTIAL,18400,0,18400,30700,0,49100
142835501300000,SW 403,RESIDENTIAL,18400,0,18400,5500,0,23900
142835501400000,SW 403,RESIDENTIAL,20700,0,20700,42900,0,63600
142835501500000,SW 403,RESIDENTIAL,20700,0,20700,40300,0,61000
142835501600000,SW 403,RESIDENTIAL,18400,0,18400,29400,0,47800
142835501700000,SW 403,RESIDENTIAL,18400,0,18400,40300,0,58700
142835501800000,SW 403,RESIDENTIAL,18400,0,18400,49200,0,67600
142835501900000,SW 403,RESIDENTIAL,18400,0,18400,129900,0,148300
142835502000000,SW 403,RESIDENTIAL,22000,0,22000,34000,0,56000
142835502100000,SW 403,RESIDENTIAL,18400,0,18400,54100,0,72500
142835502200000,SW 403,RESIDENTIAL,18400,0,18400,23900,0,42300
142835502300000,SW 403,RESIDENTIAL,18400,0,18400,41000,0,59400
142835502400000,SW 403,RESIDENTIAL,18400,0,18400,48800,0,67200
142835502500000,SW 403,RESIDENTIAL,18400,0,18400,114800,0,133200
142835600100000,SW 403,RESIDENTIAL,24500,0,24500,87500,0,112000
142835600200000,SW 403,RESIDENTIAL,28600,0,28600,105200,0,133800
142835600300000,SW 403,RESIDENTIAL,18200,0,18200,34000,0,52200
142835600400000,SW 403,RESIDENTIAL,18200,0,18200,43000,0,61200
142835600500000,SW 403,RESIDENTIAL,18200,0,18200,60600,0,78800
142835600600000,SW 403,RESIDENTIAL,18200,0,18200,50600,0,68800
142835600700000,SW 403,RESIDENTIAL,18200,0,18200,58000,0,76200
142835600800000,SW 403,RESIDENTIAL,18200,0,18200,45900,0,64100
142835600900000,SW 403,RESIDENTIAL,18200,0,18200,43300,0,61500
142835601000000,SW 403,RESIDENTIAL,18200,0,18200,0,0,18200
142835601100000,SW 403,RESIDENTIAL,17300,0,17300,12100,0,29400
142835601200000,SW 403,RESIDENTIAL,21300,0,21300,98700,0,120000
142835601300000,SW 403,RESIDENTIAL,19300,0,19300,44700,0,64000
142835601400000,SW 403,RESIDENTIAL,18200,0,18200,61800,0,80000
142835601500000,SW 403,RESIDENTIAL,18200,0,18200,36000,0,54200
142835601600000,SW 403,RESIDENTIAL,18200,0,18200,112800,0,131000
142835601700000,SW 403,RESIDENTIAL,18200,0,18200,120400,0,138600
142835601800000,SW 403,RESIDENTIAL,18200,0,18200,111200,0,129400
142835601900000,SW 403,RESIDENTIAL,18200,0,18200,48700,0,66900
142835602000000,SW 403,RESIDENTIAL,18200,0,18200,43500,0,61700
142835602100000,SW 403,RESIDENTIAL,21800,0,21800,108600,0,130400
142835700100000,SW 403,RESIDENTIAL,20700,0,20700,52000,0,72700
142835700200000,SW 403,RESIDENTIAL,19500,0,19500,132500,0,152000
142835700300000,SW 403,RESIDENTIAL,20700,0,20700,44800,0,65500
142835700400000,SW 403,RESIDENTIAL,17200,0,17200,41900,0,59100
142835700500000,SW 403,RESIDENTIAL,17200,0,17200,45800,0,63000
142835700600000,SW 403,RESIDENTIAL,17200,0,17200,29400,0,46600
142835700700000,SW 403,RESIDENTIAL,17200,0,17200,57600,0,74800
142835700800000,SW 403,RESIDENTIAL,20700,0,20700,25700,0,46400
142835700900000,SW 403,RESIDENTIAL,20700,0,20700,31600,0,52300
142835701000000,SW 403,RESIDENTIAL,18400,0,18400,46700,0,65100
142835701100000,SW 403,RESIDENTIAL,18400,0,18400,33800,0,52200
142835701200000,SW 403,RESIDENTIAL,18400,0,18400,42800,0,61200
142835701300000,SW 403,RESIDENTIAL,18400,0,18400,39200,0,57600
142835701400000,SW 403,RESIDENTIAL,18400,0,18400,116100,0,134500
142835800100000,SW 403,RESIDENTIAL,17000,0,17000,27200,0,44200
142835800200000,SW 403,RESIDENTIAL,20500,0,20500,66900,0,87400
142835800300000,SW 403,RESIDENTIAL,20500,0,20500,38300,0,58800
142835800400000,SW 403,RESIDENTIAL,20500,0,20500,46800,0,67300
142835800500000,SW 403,RESIDENTIAL,20500,0,20500,128400,0,148900
142835800600000,SW 403,RESIDENTIAL,20500,0,20500,39500,0,60000
142835800700000,SW 403,RESIDENTIAL,20500,0,20500,67500,0,88000
142835800800000,SW 403,RESIDENTIAL,22700,0,22700,59800,0,82500
142835800900000,SW 403,RESIDENTIAL,22700,0,22700,52900,0,75600
142835801000000,SW 403,RESIDENTIAL,22700,0,22700,91500,0,114200
142835801100000,SW 403,RESIDENTIAL,17000,0,17000,43300,0,60300
142835801200000,SW 403,RESIDENTIAL,17000,0,17000,0,0,17000
142835801300000,SW 403,RESIDENTIAL,17000,0,17000,104500,0,121500
142837600100000,SW 402,RESIDENTIAL,12000,0,12000,51200,0,63200
142837600200000,SW 402,RESIDENTIAL,24000,0,24000,81300,0,105300
142837600300000,SW 402,RESIDENTIAL,12000,0,12000,40500,0,52500
142837600400000,SW 402,RESIDENTIAL,16800,0,16800,35900,0,52700
142837600500000,SW 402,RESIDENTIAL,13000,0,13000,51600,0,64600
142837600600000,SW 402,RESIDENTIAL,12000,0,12000,67600,0,79600
142837600700000,SW 402,RESIDENTIAL,18000,0,18000,49000,0,67000
142837600800000,SW 402,RESIDENTIAL,18000,0,18000,40200,0,58200
142837600900000,SW 402,RESIDENTIAL,24000,0,24000,14600,0,38600
142837601000000,SW 402,RESIDENTIAL,12000,0,12000,36000,0,48000
142837601100000,SW 402,RESIDENTIAL,12000,0,12000,22000,0,34000
142837700100000,CITY PROPERTY,EXEMPT,0,0,0,0,0,0
142837700200000,SW 402,RESIDENTIAL,21800,0,21800,71200,0,93000
142837700300000,SW 402,RESIDENTIAL,21800,0,21800,136100,0,157900
142837700400000,SW 402,RESIDENTIAL,10900,0,10900,45800,0,56700
142837700500000,SW 402,RESIDENTIAL,10900,0,10900,0,0,10900
142837700600000,APARTMENT,RESIDENTIAL,19200,0,19200,143000,0,162200
142837700700000,CONVERSION-NW/SW,MULTI-RES,16000,0,16000,37700,0,53700
142837700800000,SW 402,RESIDENTIAL,19800,0,19800,58700,0,78500
142837700900000,SW 402,RESIDENTIAL,8700,0,8700,0,0,8700
142837701000000,SW 402,RESIDENTIAL,9000,0,9000,40700,0,49700
142837701100000,SW 402,RESIDENTIAL,6500,0,6500,30000,0,36500
142837701200000,SW 402,RESIDENTIAL,8900,0,8900,36100,0,45000
142837701500000,SW 402,RESIDENTIAL,18000,0,18000,130100,0,148100
142837701600000,SW 402,RESIDENTIAL,15000,0,15000,0,0,15000
142837701700000,SW 402,RESIDENTIAL,12000,0,12000,0,0,12000
142837701800000,SW 402,RESIDENTIAL,18000,0,18000,77000,0,95000
142837800100000,VACANT LAND,COMMERCIAL,0,10800,10800,0,0,10800
142837800200000,SW 403,RESIDENTIAL,18700,0,18700,73600,0,92300
142837800300000,SW 403,RESIDENTIAL,5000,0,5000,0,0,5000
142837800400000,SW 403,RESIDENTIAL,9400,0,9400,26000,0,35400
142837800500000,SW 403,RESIDENTIAL,9400,0,9400,6700,0,16100
142837800600000,APARTMENT,MULTI-RES,16200,0,16200,73300,0,89500
142837900100000,SW 402,RESIDENTIAL,18800,0,18800,63800,0,82600
142837900200000,SW 402,RESIDENTIAL,5000,0,5000,0,0,5000
142837900300000,SW 402,RESIDENTIAL,16000,0,16000,87400,0,103400
142837900400000,SW 402,RESIDENTIAL,16800,0,16800,41300,0,58100
142838000300000,SW 402,RESIDENTIAL,13400,0,13400,49400,0,62800
142838000400000,SW 402,RESIDENTIAL,14700,0,14700,40800,0,55500
142838000500000,SW 402,RESIDENTIAL,15800,0,15800,44300,0,60100
142838000600000,SW 402,RESIDENTIAL,16000,0,16000,46700,0,62700
142838000700000,SW 402,RESIDENTIAL,12000,0,12000,62800,0,74800
142838000800000,SW 402,RESIDENTIAL,12000,0,12000,0,0,12000
142838000900000,SW 402,RESIDENTIAL,12000,0,12000,50800,0,62800
142838001000000,SW 402,RESIDENTIAL,9000,0,9000,2300,0,11300
142838001100000,SW 402,RESIDENTIAL,8000,0,8000,0,0,8000
142838001200000,SW 402,RESIDENTIAL,24000,0,24000,87200,0,111200
142838001300000,SW 402,RESIDENTIAL,22700,0,22700,72100,0,94800
142838001400000,SW 402,RESIDENTIAL,18200,0,18200,73300,0,91500
142838001500000,SW 402,RESIDENTIAL,10400,0,10400,0,0,10400
142838001600000,SW 402,RESIDENTIAL,12900,0,12900,49300,0,62200
142838001700000,SW 402,RESIDENTIAL,19800,0,19800,60700,0,80500
142838100100000,SW 402,RESIDENTIAL,16100,0,16100,48500,0,64600
142838100200000,SW 402,RESIDENTIAL,9900,0,9900,52900,0,62800
142838100300000,SW 402,RESIDENTIAL,8700,0,8700,43400,0,52100
142838100400000,SW 402,RESIDENTIAL,12100,0,12100,74400,0,86500
142838100600000,SW 402,RESIDENTIAL,17900,0,17900,128200,0,146100
142838100800000,SW 402,RESIDENTIAL,21800,0,21800,49000,0,70800
142838100900000,SW 402,RESIDENTIAL,21800,0,21800,51900,0,73700
142838101000000,SW 402,RESIDENTIAL,21800,0,21800,55200,0,77000
142838101100000,SW 402,RESIDENTIAL,24000,0,24000,61600,0,85600
142838101200000,SW 402,RESIDENTIAL,12000,0,12000,37500,0,49500
142838101300000,SW 402,RESIDENTIAL,12000,0,12000,57700,0,69700
142838101400000,SW 402,RESIDENTIAL,24000,0,24000,78700,0,102700
142838101500000,SW 402,RESIDENTIAL,24000,0,24000,68500,0,92500
142838101600000,SW 402,RESIDENTIAL,24500,0,24500,57800,0,82300
142838200300000,SW 403,RESIDENTIAL,16100,0,16100,50100,0,66200
142838200400000,SW 403,RESIDENTIAL,11900,0,11900,37200,0,49100
142838200500000,SW 403,RESIDENTIAL,11600,0,11600,37200,0,48800
142838200600000,SW 403,RESIDENTIAL,15100,0,15100,54800,0,69900
142838200900000,SW 403,RESIDENTIAL,9000,0,9000,20900,0,29900
142838201000000,SW 403,RESIDENTIAL,13200,0,13200,44300,0,57500
142838201100000,SW 403,RESIDENTIAL,19300,0,19300,93100,0,112400
142838201200000,SW 403,RESIDENTIAL,15700,0,15700,117600,0,133300
142838300600000,SW 402,RESIDENTIAL,24000,0,24000,66300,0,90300
142838300700000,SW 402,RESIDENTIAL,12800,0,12800,60400,0,73200
142838300800000,CITY PROPERTY,EXEMPT,0,0,0,0,0,0
142838300900000,SW 402,RESIDENTIAL,24000,0,24000,135300,0,159300
142838301000000,SW 402,RESIDENTIAL,24000,0,24000,97500,0,121500
142838301100000,SW 402,RESIDENTIAL,24500,0,24500,54900,0,79400
142838301200000,SW 402,RESIDENTIAL,12200,0,12200,62600,0,74800
142838301300000,SW 402,RESIDENTIAL,12200,0,12200,65200,0,77400
142838301400000,SW 402,RESIDENTIAL,11700,0,11700,76300,0,88000
142838301500000,SW 402,RESIDENTIAL,12700,0,12700,58800,0,71500
142838301600000,SW 402,RESIDENTIAL,24500,0,24500,75900,0,100400
142838301700000,SW 402,RESIDENTIAL,23600,0,23600,70600,0,94200
142838301800000,SW 402,RESIDENTIAL,24000,0,24000,50200,0,74200
142838400100000,SW 402,RESIDENTIAL,24000,0,24000,82400,0,106400
142838400200000,SW 402,RESIDENTIAL,14600,0,14600,66300,0,80900
142838400300000,SW 402,RESIDENTIAL,14600,0,14600,66900,0,81500
142838400400000,SW 402,RESIDENTIAL,14600,0,14600,133600,0,148200
142838400500000,SW 402,RESIDENTIAL,19300,0,19300,39500,0,58800
142838400600000,SW 402,RESIDENTIAL,2500,0,2500,18200,0,20700
142838400700000,SW 402,RESIDENTIAL,19700,0,19700,66700,0,86400
142838400800000,SW 402,RESIDENTIAL,22400,0,22400,113700,0,136100
142838400900000,SW 402,RESIDENTIAL,8200,0,8200,36600,0,44800
142838401100000,SW 402,RESIDENTIAL,24000,0,24000,0,0,24000
142838401200000,SW 402,RESIDENTIAL,24000,0,24000,49700,0,73700
142838401300000,SW 402,RESIDENTIAL,24000,0,24000,141400,0,165400
142838401400000,SW 402,RESIDENTIAL,24000,0,24000,4500,0,28500
142838500100000,CITY PROPERTY,EXEMPT,0,0,0,0,0,0
142838500200000,SW 403,RESIDENTIAL,14700,0,14700,55900,0,70600
142838500300000,SW 403,RESIDENTIAL,15400,0,15400,68800,0,84200
142838500400000,SW 403,RESIDENTIAL,9400,0,9400,66300,0,75700
142838500500000,SW 403,RESIDENTIAL,13400,0,13400,0,0,13400
142838500600000,CITY PROPERTY,EXEMPT,0,0,0,0,0,0
142838500700000,SW 403,RESIDENTIAL,18100,0,18100,43400,0,61500
142838500800000,SW 403,RESIDENTIAL,18100,0,18100,44800,0,62900
142838500900000,SW 403,RESIDENTIAL,14500,0,14500,45300,0,59800
142838600100000,SW 402,RESIDENTIAL,24500,0,24500,88800,0,113300
142838600200000,CONVERSION-NW/SW,MULTI-RES,24000,0,24000,49700,0,73700
142838600300000,SW 402,RESIDENTIAL,16000,0,16000,60900,0,76900
142838600400000,SW 402,RESIDENTIAL,16000,0,16000,74500,0,90500
142838600500000,SW 402,RESIDENTIAL,18000,0,18000,64900,0,82900
142838600600000,SW 402,RESIDENTIAL,26500,0,26500,83700,0,110200
142838600700000,SW 402,RESIDENTIAL,24500,0,24500,85600,0,110100
142838700100000,SW 402,RESIDENTIAL,18200,0,18200,81400,0,99600
142838700200000,SW 402,RESIDENTIAL,13000,0,13000,74900,0,87900
142838700300000,SW 402,RESIDENTIAL,12600,0,12600,18700,0,31300
142838700400000,SW 402,RESIDENTIAL,12600,0,12600,41100,0,53700
142838700500000,SW 402,RESIDENTIAL,22700,0,22700,74400,0,97100
142838700600000,SW 402,RESIDENTIAL,14600,0,14600,80200,0,94800
142838700700000,SW 402,RESIDENTIAL,13800,0,13800,47100,0,60900
142838700800000,SW 402,RESIDENTIAL,26000,0,26000,90600,0,116600
142838700900000,SW 402,RESIDENTIAL,24000,0,24000,65100,0,89100
142838800100000,SW 403,RESIDENTIAL,18000,0,18000,64400,0,82400
142838800200000,SW 403,RESIDENTIAL,18000,0,18000,47700,0,65700
142838800300000,SW 403,RESIDENTIAL,18000,0,18000,52200,0,70200
142838800400000,SW 403,RESIDENTIAL,20100,0,20100,85300,0,105400
142840100100000,BARS/LOUNGE,COMMERCIAL,0,115700,115700,0,161600,277300
142840200400000,FLAT PARKING,EXEMPT,0,23100,23100,0,25400,48500
142840200500000,FLAT PARKING,EXEMPT,0,11600,11600,0,6300,17900
142840200600000,FLAT PARKING,EXEMPT,0,11600,11600,0,12500,24100
142840200700000,FLAT PARKING,COMMERCIAL,0,25200,25200,0,14000,39200
142840200800000,SE 237,RESIDENTIAL,5900,0,5900,140000,0,145900
142840200900000,SMALL RET; CTRL CR,COMMERCIAL,0,8500,8500,0,70800,79300
142840201000000,WAREHOUSE; CTRL CR,COMMERCIAL,0,33600,33600,0,253600,287200
142840201200000,BARS/LOUNGE; CTRL CR,COMMERCIAL,12096,55104,67200,104522,449178,620900
142840300100000,CITY PROPERTY,EXEMPT,0,0,0,0,0,0
142840300200000,CENTRALLY ASSESSED,OTHER,0,0,0,0,0,0
142840400200000,RESTAURANT,COMMERCIAL,0,228600,228600,0,358300,586900
142840400300000,CITY PROPERTY,EXEMPT,0,0,0,0,0,0
142840400400000,SE 237,RESIDENTIAL,3000,0,3000,85900,0,88900
142840400500000,CITY PROPERTY,EXEMPT,0,0,0,0,0,0
142840400600000,FUNERAL HOME,COMMERCIAL,8064,17136,25200,53184,113016,191400
142840400700000,FLAT PARKING,COMMERCIAL,0,25200,25200,0,900,26100
142840400800000,WAREHOUSE,COMMERCIAL,0,25200,25200,0,35800,61000
142840500100000,SE 237,RESIDENTIAL,3300,0,3300,55700,0,59000
142840500200000,FLAT PARKING,COMMERCIAL,0,15300,15300,0,4600,19900
142840500300000,VACANT LAND,COMMERCIAL,0,13900,13900,0,0,13900
142840500400000,CITY PROPERTY,EXEMPT,0,0,0,0,0,0
142840500500000,SE 237,RESIDENTIAL,3000,0,3000,0,0,3000
142840500600000,SE 237,RESIDENTIAL,3000,0,3000,0,0,3000
142840500700000,BARS/LOUNGE,COMMERCIAL,0,27700,27700,0,0,27700
142840600100000,CITY PROPERTY,EXEMPT,0,0,0,0,0,0
142840600200000,CITY PROPERTY,EXEMPT,0,0,0,0,0,0
142840600202000,LITERARY/LIBRARY/ART,EXEMPT,0,0,0,0,771600,771600
142840600300000,CITY PROPERTY,EXEMPT,0,0,0,0,0,0
142840600400000,CITY PROPERTY,EXEMPT,0,0,0,0,0,0
142840600500000,CITY PROPERTY,EXEMPT,0,0,0,0,0,0
142840600600000,CITY PROPERTY,EXEMPT,0,0,0,0,0,0
142840600700000,CITY PROPERTY,EXEMPT,0,0,0,0,0,0
142840600800000,CITY PROPERTY,EXEMPT,0,0,0,0,0,0
142840600900000,SE 237,RESIDENTIAL,3300,0,3300,129900,0,133200
142840601000000,CITY PROPERTY,EXEMPT,0,0,0,0,0,0
142840601100000,SE 237,RESIDENTIAL,3000,0,3000,0,0,3000
142840601200000,CITY PROPERTY,EXEMPT,0,0,0,0,0,0
142840601300000,CITY PROPERTY,EXEMPT,0,0,0,0,0,0
142840601400000,CITY PROPERTY,EXEMPT,0,0,0,0,0,0
142840601500000,CITY PROPERTY,EXEMPT,0,0,0,0,0,0
142840601600000,CITY PROPERTY,EXEMPT,0,0,0,0,0,0
142840700100000,CITY PROPERTY,EXEMPT,0,0,0,0,0,0
142840700200000,CITY PROPERTY,EXEMPT,0,0,0,0,0,0
142840700300000,CITY PROPERTY,EXEMPT,0,0,0,0,0,0
142842600100000,FOOD GRADE;INDUST,INDUSTRIAL,0,1154300,1154300,0,8727100,9881400
142842700100000,FOOD GRADE;INDUST,INDUSTRIAL,0,100200,100200,0,1235000,1335200
142842800100000,CENTRALLY ASSESSED,OTHER,0,0,0,0,0,0
142845100200000,FOOD GRADE;INDUST,INDUSTRIAL,0,16200,16200,0,14500,30700
142845100600000,CITY PROPERTY,EXEMPT,0,0,0,0,0,0
142845200100000,SW 402,RESIDENTIAL,24000,0,24000,87100,0,111100
142845200200000,SW 402,RESIDENTIAL,24000,0,24000,74500,0,98500
142845300100000,SW 402,RESIDENTIAL,17900,0,17900,0,0,17900
142845300200000,SW 402,RESIDENTIAL,17400,0,17400,0,0,17400
142845300300000,SW 402,RESIDENTIAL,17000,0,17000,0,0,17000
142845300400000,SW 402,RESIDENTIAL,20200,0,20200,0,0,20200
142845300500000,SW 402,RESIDENTIAL,18600,0,18600,0,0,18600
142845300600000,SW 402,RESIDENTIAL,12100,0,12100,0,0,12100
142845300700000,CITY PROPERTY,EXEMPT,0,0,0,0,0,0
142845300800000,CITY PROPERTY,EXEMPT,0,0,0,0,0,0
142845400100000,OFFICE; MED; CTRL CR,COMMERCIAL,0,10500,10500,0,3600,14100
142845400200000,SW 402,RESIDENTIAL,10900,0,10900,33200,0,44100
142845400300000,SW 402,RESIDENTIAL,17100,0,17100,31600,0,48700
142845400400000,SW 402,RESIDENTIAL,12400,0,12400,39700,0,52100
142845400500000,SW 402,RESIDENTIAL,15700,0,15700,0,0,15700
142845400600000,SW 402,RESIDENTIAL,14600,0,14600,62900,0,77500
142845400700000,SW 402,RESIDENTIAL,17600,0,17600,46600,0,64200
142845400800000,CITY PROPERTY,EXEMPT,0,0,0,0,0,0
142845400900000,CITY PROPERTY,EXEMPT,0,0,0,0,0,0
142845500100000,SW 402,RESIDENTIAL,22400,0,22400,77100,0,99500
142845500200000,SW 402,RESIDENTIAL,6100,0,6100,5700,0,11800
142845500300000,SW 402,RESIDENTIAL,14000,0,14000,134200,0,148200
142845500400000,SW 402,RESIDENTIAL,27200,0,27200,98500,0,125700
142845500500000,SW 402,RESIDENTIAL,14900,0,14900,59800,0,74700
142845500600000,SW 402,RESIDENTIAL,9700,0,9700,72000,0,81700
142845500700000,SW 402,RESIDENTIAL,8500,0,8500,53200,0,61700
142845500800000,SW 402,RESIDENTIAL,12000,0,12000,63400,0,75400
142845500900000,SW 402,RESIDENTIAL,12000,0,12000,42700,0,54700
142845501000000,SW 402,RESIDENTIAL,24000,0,24000,104100,0,128100
142845501100000,SW 402,RESIDENTIAL,24300,0,24300,101400,0,125700
142845600200000,SW 402,RESIDENTIAL,22500,0,22500,62200,0,84700
142845600300000,SW 402,RESIDENTIAL,18900,0,18900,92600,0,111500
142845600400000,SW 402,RESIDENTIAL,14700,0,14700,56800,0,71500
142845600500000,OFFICE,COMMERCIAL,0,81200,81200,0,277300,358500
142845600600000,CITY PROPERTY,EXEMPT,0,0,0,0,0,0
142845700100000,SW 402,RESIDENTIAL,10200,0,10200,28900,0,39100
142845700200000,SW 402,RESIDENTIAL,20400,0,20400,66500,0,86900
142845700300000,SW 402,RESIDENTIAL,20400,0,20400,102800,0,123200
142845700400000,APARTMENT,MULTI-RES,15000,0,15000,121100,0,136100
142845700500000,SW 402,RESIDENTIAL,17600,0,17600,28400,0,46000
142845700600000,SW 402,RESIDENTIAL,17600,0,17600,87900,0,105500
142845700700000,SW 402,RESIDENTIAL,17600,0,17600,44000,0,61600
142845700800000,SW 402,RESIDENTIAL,17600,0,17600,54500,0,72100
142845700900000,SW 402,RESIDENTIAL,12300,0,12300,38200,0,50500
142845701000000,SW 402,RESIDENTIAL,22900,0,22900,52800,0,75700
142845701100000,SW 402,RESIDENTIAL,20400,0,20400,62800,0,83200
142845701200000,SW 402,RESIDENTIAL,20400,0,20400,73900,0,94300
142845701300000,SW 402,RESIDENTIAL,20400,0,20400,50900,0,71300
142845701400000,SW 402,RESIDENTIAL,20400,0,20400,39300,0,59700
142845701500000,CONVERSION-NW/SW,MULTI-RES,23400,0,23400,45300,0,68700
142845701600000,SW 402,RESIDENTIAL,16100,0,16100,53000,0,69100
142845701700000,SW 402,RESIDENTIAL,16400,0,16400,40500,0,56900
142845701800000,SW 402,RESIDENTIAL,16600,0,16600,39300,0,55900
142845701900000,SW 402,RESIDENTIAL,16700,0,16700,36400,0,53100
142845800100000,SW 402,RESIDENTIAL,17200,0,17200,76300,0,93500
142845800200000,SW 402,RESIDENTIAL,17200,0,17200,91400,0,108600
142845800300000,SW 402,RESIDENTIAL,17700,0,17700,74900,0,92600
142845800400000,SW 402,RESIDENTIAL,19000,0,19000,132400,0,151400
142845800500000,SW 402,RESIDENTIAL,12600,0,12600,64100,0,76700
142845800600000,SW 402,RESIDENTIAL,15400,0,15400,83200,0,98600
142845800700000,SW 402,RESIDENTIAL,17600,0,17600,64600,0,82200
142845800800000,SW 402,RESIDENTIAL,23000,0,23000,7900,0,30900
142845800900000,SW 402,RESIDENTIAL,14900,0,14900,65900,0,80800
142845801000000,SW 402,RESIDENTIAL,19800,0,19800,85000,0,104800
142845801100000,SW 402,RESIDENTIAL,12000,0,12000,144200,0,156200
142845801200000,SW 402,RESIDENTIAL,18800,0,18800,55900,0,74700
142845801300000,CONVERSION-NW/SW,MULTI-RES,23200,0,23200,59300,0,82500
142845801400000,SW 402,RESIDENTIAL,26500,0,26500,79600,0,106100
142845801500000,SW 402,RESIDENTIAL,19100,0,19100,78100,0,97200
142845801600000,SW 402,RESIDENTIAL,10400,0,10400,48900,0,59300
142845801700000,CITY PROPERTY,EXEMPT,0,0,0,0,0,0
142845801800000,SW 402,RESIDENTIAL,11900,0,11900,49300,0,61200
142845801900000,SW 402,RESIDENTIAL,400,0,400,0,0,400
142845900100000,CITY PROPERTY,EXEMPT,0,0,0,0,0,0
142845900200000,CITY PROPERTY,EXEMPT,0,0,0,0,0,0
142845900300000,CITY PROPERTY,EXEMPT,0,0,0,0,0,0
142845900400000,SW 402,RESIDENTIAL,14100,0,14100,0,0,14100
142845900500000,SW 402,RESIDENTIAL,14100,0,14100,0,0,14100
142845900600000,SW 402,RESIDENTIAL,28100,0,28100,82800,0,110900
142845900700000,SW 402,RESIDENTIAL,17400,0,17400,67500,0,84900
142845900800000,SW 402,RESIDENTIAL,15700,0,15700,70200,0,85900
142845900900000,SW 402,RESIDENTIAL,13900,0,13900,49600,0,63500
142845901000000,SW 402,RESIDENTIAL,14100,0,14100,60700,0,74800
142845901100000,CITY PROPERTY,EXEMPT,0,0,0,0,0,0
142845901200000,CITY PROPERTY,EXEMPT,0,0,0,0,0,0
142845901300000,CITY PROPERTY,EXEMPT,0,0,0,0,0,0
142845901400000,SW 402,RESIDENTIAL,24000,0,24000,91600,0,115600
142845901500000,SW 402,RESIDENTIAL,14000,0,14000,0,0,14000
142845901600000,SW 402,RESIDENTIAL,14000,0,14000,40800,0,54800
142846000100000,SW 402,RESIDENTIAL,14900,0,14900,57400,0,72300
142846000200000,SW 402,RESIDENTIAL,9900,0,9900,1200,0,11100
142846000300000,SW 402,RESIDENTIAL,26600,0,26600,59600,0,86200
142846000400000,SW 402,RESIDENTIAL,15200,0,15200,56900,0,72100
142846000500000,SW 402,RESIDENTIAL,11200,0,11200,74600,0,85800
142846000600000,SW 402,RESIDENTIAL,11200,0,11200,37400,0,48600
142846000700000,SW 402,RESIDENTIAL,15200,0,15200,77400,0,92600
142846000800000,SW 402,RESIDENTIAL,23900,0,23900,109800,0,133700
142846000900000,SW 402,RESIDENTIAL,15200,0,15200,55500,0,70700
142846001000000,SW 402,RESIDENTIAL,22800,0,22800,66300,0,89100
142846001100000,SW 402,RESIDENTIAL,20100,0,20100,58800,0,78900
142846001200000,SW 402,RESIDENTIAL,19900,0,19900,64500,0,84400
142846001300000,SW 402,RESIDENTIAL,25900,0,25900,60200,0,86100
142846001400000,SW 402,RESIDENTIAL,13000,0,13000,60600,0,73600
142846001500000,SW 402,RESIDENTIAL,12900,0,12900,48300,0,61200
142846001600000,SW 402,RESIDENTIAL,8600,0,8600,33400,0,42000
142846001700000,SW 402,RESIDENTIAL,12500,0,12500,35200,0,47700
142846100100000,SW 402,RESIDENTIAL,25500,0,25500,94100,0,119600
142846100200000,SW 402,RESIDENTIAL,21600,0,21600,88000,0,109600
142846100300000,SW 402,RESIDENTIAL,19000,0,19000,35800,0,54800
142846100400000,SW 402,RESIDENTIAL,26800,0,26800,66000,0,92800
142846100500000,SW 402,RESIDENTIAL,19200,0,19200,46200,0,65400
142846100600000,SW 402,RESIDENTIAL,17100,0,17100,107300,0,124400
142846100700000,SW 402,RESIDENTIAL,17100,0,17100,59200,0,76300
142846100800000,SW 402,RESIDENTIAL,17100,0,17100,67200,0,84300
142846100900000,SW 402,RESIDENTIAL,16400,0,16400,54300,0,70700
142846101000000,SW 402,RESIDENTIAL,17500,0,17500,63500,0,81000
142846101100000,SW 402,RESIDENTIAL,17500,0,17500,73300,0,90800
142846101200000,SW 402,RESIDENTIAL,17700,0,17700,80500,0,98200
142846101300000,SW 402,RESIDENTIAL,21200,0,21200,57400,0,78600
142846200100000,SW 402,RESIDENTIAL,10100,0,10100,40700,0,50800
142846200200000,SW 402,RESIDENTIAL,11700,0,11700,53100,0,64800
142846200300000,SW 402,RESIDENTIAL,5600,0,5600,40800,0,46400
142846300100000,SW 402,RESIDENTIAL,22800,0,22800,81500,0,104300
142846300200000,SW 402,RESIDENTIAL,14100,0,14100,50400,0,64500
142846300300000,SW 402,RESIDENTIAL,22500,0,22500,64000,0,86500
142846300400000,SW 402,RESIDENTIAL,12200,0,12200,28500,0,40700
142846300500000,SW 402,RESIDENTIAL,21200,0,21200,30900,0,52100
142846300600000,SW 402,RESIDENTIAL,21200,0,21200,51800,0,73000
142846300700000,SW 402,RESIDENTIAL,21200,0,21200,51800,0,73000
142846300800000,SW 402,RESIDENTIAL,21200,0,21200,56400,0,77600
142846400100000,SW 402,RESIDENTIAL,20900,0,20900,47100,0,68000
142846500100000,SW 402,RESIDENTIAL,19000,0,19000,60900,0,79900
142846500200000,SW 402,RESIDENTIAL,15200,0,15200,56300,0,71500
142846500300000,SW 402,RESIDENTIAL,18200,0,18200,49700,0,67900
142846500400000,SW 402,RESIDENTIAL,24000,0,24000,91500,0,115500
142847600300000,CITY PROPERTY,EXEMPT,0,0,0,0,0,0
142847700100000,CITY PROPERTY,EXEMPT,0,0,0,0,0,0
142847700600000,CITY PROPERTY,EXEMPT,0,0,0,0,0,0
142847800300000,FLAT PARKING,EXEMPT,0,65300,65300,0,12600,77900
142847800500000,CITY PROPERTY,EXEMPT,0,0,0,0,0,0
142847800600000,CITY PROPERTY,EXEMPT,0,0,0,0,0,0
142847800700000,CITY PROPERTY,EXEMPT,0,0,0,0,0,0
142847800900000,CITY PROPERTY,EXEMPT,0,0,0,0,0,0
142847801000000,CITY PROPERTY,EXEMPT,0,0,0,0,0,0
142847801100000,SMALL RETAIL,COMMERCIAL,0,31200,31200,0,277700,308900
142847801200000,CITY PROPERTY,EXEMPT,0,0,0,0,0,0
142847801300000,CITY PROPERTY,EXEMPT,0,0,0,0,0,0
142847801400000,LITERARY/LIBRARY/ART,EXEMPT,0,0,0,0,0,0
142847801500000,CITY PROPERTY,EXEMPT,0,0,0,0,0,0
142847801700000,CITY PROPERTY,EXEMPT,0,0,0,0,0,0
142847802000000,CITY PROPERTY,EXEMPT,0,0,0,0,0,0
142847900100000,OFFICE,COMMERCIAL,0,50400,50400,0,37500,87900
142847900200000,SMALL RETAIL,COMMERCIAL,0,36000,36000,0,132700,168700
142847900300000,FLAT PARKING,COMMERCIAL,0,30000,30000,0,4000,34000
142847900500000,SMALL RETAIL,COMMERCIAL,0,20000,20000,0,89100,109100
142847900600000,BARS/LOUNGE,COMMERCIAL,4000,12000,16000,31450,94350,141800
142847900800000,SMALL RETAIL,COMMERCIAL,0,30000,30000,0,87900,117900
142847900900000,OFFICE,COMMERCIAL,9990,8510,18500,37144,29256,84900
142847901000000,SMALL RETAIL,COMMERCIAL,0,11600,11600,0,36100,47700
142847901100000,OFFICE,COMMERCIAL,0,30000,30000,0,82400,112400
142847901200000,SMALL RETAIL,EXEMPT,0,30000,30000,0,576400,606400
142847901300000,RESTAURANT,COMMERCIAL,0,57900,57900,0,91200,149100
142847901400000,SMALL RETAIL,COMMERCIAL,8784,9516,18300,89424,96876,204600
142847901500000,SW 402,RESIDENTIAL,5000,0,5000,0,0,5000
142847901600000,OFFICE,COMMERCIAL,0,20800,20800,0,172700,193500
142847901800000,CITY PROPERTY,EXEMPT,0,0,0,0,0,0
142847901900000,CITY PROPERTY,EXEMPT,0,0,0,0,0,0
142847902000000,CITY PROPERTY,EXEMPT,0,0,0,0,0,0
142847902100000,CITY PROPERTY,EXEMPT,0,0,0,0,0,0
142847902200000,CITY PROPERTY,EXEMPT,0,0,0,0,0,0
142847902300000,CITY PROPERTY,EXEMPT,0,0,0,0,0,0
142847902400000,CITY PROPERTY,EXEMPT,0,0,0,0,0,0
142847902500000,WAREHOUSE,COMMERCIAL,0,15000,15000,0,17900,32900
142847902600000,SMALL RETAIL,COMMERCIAL,0,83600,83600,0,324100,407700
142847902700000,BARS/LOUNGE,COMMERCIAL,0,51200,51200,0,111000,162200
142848000100000,CITY PROPERTY,EXEMPT,0,0,0,0,0,0
142848000200000,CITY PROPERTY,EXEMPT,0,0,0,0,0,0
142848000300000,CITY PROPERTY,EXEMPT,0,0,0,0,0,0
142848000400000,CITY PROPERTY,EXEMPT,0,0,0,0,0,0
142848000500000,SHOP,COMMERCIAL,0,15000,15000,0,97700,112700
142848000600000,CITY PROPERTY,EXEMPT,0,0,0,0,0,0
142848000700000,FLAT PARKING,COMMERCIAL,0,6900,6900,0,1600,8500
142848000800000,FLAT PARKING,COMMERCIAL,0,8100,8100,0,1900,10000
142848000900000,CITY PROPERTY,EXEMPT,0,0,0,0,0,0
142848001000000,SMALL RETAIL,COMMERCIAL,0,24000,24000,0,157500,181500
142848001100000,SMALL RETAIL,COMMERCIAL,11700,18300,30000,63141,98759,191900
142848001200000,SMALL RETAIL,COMMERCIAL,0,24000,24000,0,130300,154300
142848001300000,BARS/LOUNGE,COMMERCIAL,0,12000,12000,0,85900,97900
142848001400000,BARS/LOUNGE,COMMERCIAL,7826,10374,18200,64199,85101,167500
142848001500000,SMALL RETAIL,COMMERCIAL,0,10900,10900,0,55500,66400
142848001600000,SMALL RETAIL,COMMERCIAL,0,24000,24000,0,78900,102900
142848001700000,SMALL RETAIL,COMMERCIAL,0,30000,30000,0,102000,132000
142848002000000,BARS/LOUNGE,COMMERCIAL,22620,64380,87000,59960,182840,329800
142848100300000,CITY PROPERTY,EXEMPT,0,0,0,0,0,0
142848100400000,CITY PROPERTY,EXEMPT,0,0,0,0,0,0
142848100500000,CITY PROPERTY,EXEMPT,0,0,0,0,0,0
142848100600000,CITY PROPERTY,EXEMPT,0,0,0,0,0,0
142848100700000,CITY PROPERTY,EXEMPT,0,0,0,0,0,0
142848100800000,CITY PROPERTY,EXEMPT,0,0,0,0,0,0
142848100900000,CITY PROPERTY,EXEMPT,0,0,0,0,0,0
142848101100000,CITY PROPERTY,EXEMPT,0,0,0,0,0,0
142848200300000,CITY PROPERTY,EXEMPT,0,0,0,0,0,0
142848200400000,CITY PROPERTY,EXEMPT,0,0,0,0,0,0
142848200500000,CITY PROPERTY,EXEMPT,0,0,0,0,0,0
142848200600000,CITY PROPERTY,EXEMPT,0,0,0,0,0,0
142848200700000,CITY PROPERTY,EXEMPT,0,0,0,0,0,0
142848200800000,CITY PROPERTY,EXEMPT,0,0,0,0,0,0
142848200900000,CITY PROPERTY,EXEMPT,0,0,0,0,0,0
142848201000000,CITY PROPERTY,EXEMPT,0,0,0,0,0,0
142848201100000,CITY PROPERTY,EXEMPT,0,0,0,0,0,0
142848201200000,CITY PROPERTY,EXEMPT,0,0,0,0,0,0
142848201300000,CITY PROPERTY,EXEMPT,0,0,0,0,0,0
142848201400000,CITY PROPERTY,EXEMPT,0,0,0,0,0,0
142848201500000,CITY PROPERTY,EXEMPT,0,0,0,0,0,0
142848201600000,CITY PROPERTY,EXEMPT,0,0,0,0,0,0
142848201700000,SW 402,RESIDENTIAL,6000,0,6000,0,0,6000
142848300100000,CITY PROPERTY,EXEMPT,0,0,0,0,0,0
142848300200000,CITY PROPERTY,EXEMPT,0,0,0,0,0,0
142848300300000,CITY PROPERTY,EXEMPT,0,0,0,0,0,0
142848300400000,CITY PROPERTY,EXEMPT,0,0,0,0,0,0
142848300500000,CITY PROPERTY,EXEMPT,0,0,0,0,0,0
142848300600000,CITY PROPERTY,EXEMPT,0,0,0,0,0,0
142848300700000,CITY PROPERTY,EXEMPT,0,0,0,0,0,0
142848300800000,CITY PROPERTY,EXEMPT,0,0,0,0,0,0
142848300900000,CITY PROPERTY,EXEMPT,0,0,0,0,0,0
142848301000000,CITY PROPERTY,EXEMPT,0,0,0,0,0,0
142848301100000,CITY PROPERTY,EXEMPT,0,0,0,0,0,0
142848301200000,CITY PROPERTY,EXEMPT,0,0,0,0,0,0
142848301300000,CITY PROPERTY,EXEMPT,0,0,0,0,0,0
142848301400000,CITY PROPERTY,EXEMPT,0,0,0,0,0,0
142848301500000,CITY PROPERTY,EXEMPT,0,0,0,0,0,0
142848301600000,CITY PROPERTY,EXEMPT,0,0,0,0,0,0
142848301700000,CITY PROPERTY,EXEMPT,0,0,0,0,0,0
142848400100000,CITY PROPERTY,EXEMPT,0,0,0,0,0,0
142848400200000,CITY PROPERTY,EXEMPT,0,0,0,0,0,0
142848400300000,CITY PROPERTY,EXEMPT,0,0,0,0,0,0
142848400400000,CITY PROPERTY,EXEMPT,0,0,0,0,0,0
142848400500000,CITY PROPERTY,EXEMPT,0,0,0,0,0,0
142848500100000,CITY PROPERTY,EXEMPT,0,0,0,0,0,0
142848500200000,CITY PROPERTY,EXEMPT,0,0,0,0,0,0
142848500300000,CITY PROPERTY,EXEMPT,0,0,0,0,0,0
142848500400000,CITY PROPERTY,EXEMPT,0,0,0,0,0,0
142848500500000,CITY PROPERTY,EXEMPT,0,0,0,0,0,0
142848500600000,CITY PROPERTY,EXEMPT,0,0,0,0,0,0
142848500700000,SW 402,RESIDENTIAL,17600,0,17600,69800,0,87400
142848500800000,SW 402,RESIDENTIAL,17600,0,17600,86100,0,103700
142848500900000,CITY PROPERTY,EXEMPT,0,0,0,0,0,0
142848501000000,CITY PROPERTY,EXEMPT,0,0,0,0,0,0
142848501100000,CITY PROPERTY,EXEMPT,0,0,0,0,0,0
142848501200000,CITY PROPERTY,EXEMPT,0,0,0,0,0,0
142848600100000,CITY PROPERTY,EXEMPT,0,0,0,0,0,0
142848600200000,CITY PROPERTY,EXEMPT,0,0,0,0,0,0
142848600300000,CITY PROPERTY,EXEMPT,0,0,0,0,0,0
142848600400000,CITY PROPERTY,EXEMPT,0,0,0,0,0,0
142848600500000,CITY PROPERTY,EXEMPT,0,0,0,0,0,0
142848600600000,WAREHOUSE,COMMERCIAL,0,20000,20000,0,88500,108500
142848600700000,CITY PROPERTY,EXEMPT,0,0,0,0,0,0
142848600800000,SW 402,RESIDENTIAL,17600,0,17600,73500,0,91100
142848600900000,CITY PROPERTY,EXEMPT,0,0,0,0,0,0
142848601000000,CITY PROPERTY,EXEMPT,0,0,0,0,0,0
142848601100000,VACANT LAND,EXEMPT,0,0,0,0,0,0
142848601200000,CITY PROPERTY,EXEMPT,0,0,0,0,0,0
142848700100000,AUTO REPAIR/SALES,COMMERCIAL,0,26500,26500,0,44500,71000
142848700200000,CITY PROPERTY,EXEMPT,0,0,0,0,0,0
142848700300000,SW 402,RESIDENTIAL,20000,0,20000,69000,0,89000
142848700400000,SW 402,RESIDENTIAL,21200,0,21200,62500,0,83700
142848700700000,SMALL RETAIL,COMMERCIAL,46368,64032,110400,87636,120864,318900
142848700800000,SW 402,RESIDENTIAL,13300,0,13300,75300,0,88600
142848700900000,SW 402,RESIDENTIAL,25000,0,25000,120700,0,145700
142848701000000,SW 402,RESIDENTIAL,30800,0,30800,0,0,30800
142848701400000,CITY PROPERTY,EXEMPT,0,0,0,0,0,0
142848701501000,SMALL RETAIL,COMMERCIAL,0,19500,19500,0,129100,148600
142848800100000,SMALL RETAIL,COMMERCIAL,10500,10500,21000,37750,37750,96500
142848800200000,SW 402,RESIDENTIAL,23600,0,23600,44100,0,67700
142848800300000,SW 402,RESIDENTIAL,27600,0,27600,1900,0,29500
142910100100000,CITY PROPERTY,EXEMPT,0,0,0,0,0,0
142910100200000,CITY PROPERTY,EXEMPT,0,0,0,0,0,0
142910100300000,CITY PROPERTY,EXEMPT,0,0,0,0,0,0
142910100400000,CITY PROPERTY,EXEMPT,0,0,0,0,0,0
142910100500000,CITY PROPERTY,EXEMPT,0,0,0,0,0,0
142910100600000,CITY PROPERTY,EXEMPT,0,0,0,0,0,0
142910100700000,CITY PROPERTY,EXEMPT,0,0,0,0,0,0
142910100800000,CITY PROPERTY,EXEMPT,0,0,0,0,0,0
142910100900000,CITY PROPERTY,EXEMPT,0,0,0,0,0,0
142910101000000,CITY PROPERTY,EXEMPT,0,0,0,0,0,0
142910200100000,CITY PROPERTY,EXEMPT,0,0,0,0,0,0
142910200200000,NW 318,RESIDENTIAL,9000,0,9000,34700,0,43700
142910200300000,NW 318,RESIDENTIAL,9000,0,9000,36700,0,45700
142910200400000,CITY PROPERTY,EXEMPT,0,0,0,0,0,0
142910200500000,CITY PROPERTY,EXEMPT,0,0,0,0,0,0
142910200600000,NW 318,RESIDENTIAL,6500,0,6500,50200,0,56700
142910200700000,CITY PROPERTY,EXEMPT,0,0,0,0,0,0
142910200800000,NW 318,RESIDENTIAL,6500,0,6500,42100,0,48600
142910200900000,NW 318,RESIDENTIAL,6500,0,6500,45200,0,51700
142910201000000,NW 318,RESIDENTIAL,18000,0,18000,85100,0,103100
142910201100000,APARTMENT,EXEMPT,0,22400,22400,0,81000,103400
142910201200000,NW 318,RESIDENTIAL,12000,0,12000,78600,0,90600
142910201300000,NW 318,RESIDENTIAL,12000,0,12000,64200,0,76200
142910201400000,NW 318,RESIDENTIAL,18000,0,18000,67500,0,85500
142910201500000,NW 318,RESIDENTIAL,12600,0,12600,47700,0,60300
142910201600000,CITY PROPERTY,EXEMPT,0,0,0,0,0,0
142910201700000,NW 318,RESIDENTIAL,8700,0,8700,45500,0,54200
142910300400000,SMALL RETAIL,COMMERCIAL,0,12100,12100,0,75400,87500
142910400100000,CITY PROPERTY,EXEMPT,0,0,0,0,0,0
142910400200000,CITY PROPERTY,EXEMPT,0,0,0,0,0,0
142910400300000,NW 318,RESIDENTIAL,11600,0,11600,0,0,11600
142910400400000,CENTRALLY ASSESSED,OTHER,0,0,0,0,0,0
142910400500000,NW 318,RESIDENTIAL,8700,0,8700,0,0,8700
142910400600000,NW 318,RESIDENTIAL,10100,0,10100,0,0,10100
142910400700000,NW 318,RESIDENTIAL,7300,0,7300,21500,0,28800
142910400800000,CITY PROPERTY,EXEMPT,0,0,0,0,0,0
142910500300000,CENTRALLY ASSESSED,OTHER,0,0,0,0,0,0
142910600100000,CITY PROPERTY,EXEMPT,0,0,0,0,0,0
142910700100000,NW 318,RESIDENTIAL,3300,0,3300,0,0,3300
142910700200000,CITY PROPERTY,EXEMPT,0,0,0,0,0,0
142910700300000,NW 318,RESIDENTIAL,18000,0,18000,67200,0,85200
142910700400000,NW 318,RESIDENTIAL,18000,0,18000,48000,0,66000
142910700500000,NW 318,RESIDENTIAL,6500,0,6500,51000,0,57500
142910700600000,NW 318,RESIDENTIAL,6200,0,6200,51800,0,58000
142910700700000,NW 318,RESIDENTIAL,7400,0,7400,45700,0,53100
142910700800000,NW 318,RESIDENTIAL,5600,0,5600,37400,0,43000
142910700900000,CITY PROPERTY,EXEMPT,0,0,0,0,0,0
142910701000000,CITY PROPERTY,EXEMPT,0,0,0,0,0,0
142910701100000,NW 318,RESIDENTIAL,13700,0,13700,43500,0,57200
142910701200000,NW 318,RESIDENTIAL,12000,0,12000,42100,0,54100
142910701300000,NW 318,RESIDENTIAL,12000,0,12000,46600,0,58600
142910701400000,NW 318,RESIDENTIAL,15000,0,15000,63500,0,78500
142910701500000,NW 318,RESIDENTIAL,15000,0,15000,7000,0,22000
142910701600000,NW 318,RESIDENTIAL,12600,0,12600,56100,0,68700
142910701700000,CITY PROPERTY,EXEMPT,0,0,0,0,0,0
142910701800000,BOWLING ALLEY,EXEMPT,0,0,0,0,0,0
142910701900000,CITY PROPERTY,EXEMPT,0,0,0,0,0,0
142910702000000,CITY PROPERTY,EXEMPT,0,0,0,0,0,0
142910702100000,NW 318,RESIDENTIAL,2500,0,2500,0,0,2500
142910800100000,NW 318,RESIDENTIAL,12600,0,12600,51000,0,63600
142910800200000,VACANT LAND,RESIDENTIAL,11200,0,11200,0,0,11200
142910800300000,APARTMENT,RESIDENTIAL,22400,0,22400,246700,0,269100
142910800400000,FLAT PARKING,COMMERCIAL,0,25100,25100,0,2900,28000
142910800500000,CITY PROPERTY,EXEMPT,0,0,0,0,0,0
142910800600000,FLAT PARKING,INDUSTRIAL,0,1700,1700,0,0,1700
142910800700000,SHOP,COMMERCIAL,0,13600,13600,0,69600,83200
142910800800000,NW 318,RESIDENTIAL,18000,0,18000,74400,0,92400
142910801000000,NW 318,RESIDENTIAL,12000,0,12000,70700,0,82700
142910801100000,NW 318,RESIDENTIAL,12000,0,12000,51400,0,63400
142910801200000,NW 318,RESIDENTIAL,6600,0,6600,46200,0,52800
142910801300000,NW 318,RESIDENTIAL,11400,0,11400,61300,0,72700
142910801400000,NW 318,RESIDENTIAL,14000,0,14000,52100,0,66100
142910801500000,NW 318,RESIDENTIAL,13000,0,13000,72400,0,85400
142910801600000,NW 318,RESIDENTIAL,13700,0,13700,91300,0,105000
142910801700000,NW 318,RESIDENTIAL,10800,0,10800,95700,0,106500
142910900100000,CITY PROPERTY,EXEMPT,0,0,0,0,0,0
142910900200000,CITY PROPERTY,EXEMPT,0,0,0,0,0,0
142910900300000,CITY PROPERTY,EXEMPT,0,0,0,0,0,0
142911000100000,CITY PROPERTY,EXEMPT,0,0,0,0,0,0
142911000200000,NW 318,RESIDENTIAL,12100,0,12100,48700,0,60800
142911000300000,NW 318,RESIDENTIAL,12300,0,12300,57900,0,70200
142911000600000,CITY PROPERTY,EXEMPT,0,0,0,0,0,0
142911000700000,CITY PROPERTY,EXEMPT,0,0,0,0,0,0
142911000800000,NW 318,RESIDENTIAL,6500,0,6500,43400,0,49900
142911000900000,NW 318,RESIDENTIAL,5000,0,5000,32800,0,37800
142911001000000,RESTAURANT,COMMERCIAL,0,72200,72200,0,95300,167500
142911001300000,NW 318,RESIDENTIAL,7200,0,7200,34900,0,42100
142911001400000,CITY PROPERTY,EXEMPT,0,0,0,0,0,0
142911001500000,CITY PROPERTY,EXEMPT,0,0,0,0,0,0
142911001600000,NW 318,RESIDENTIAL,7900,0,7900,66300,0,74200
142911001700000,SMALL RETAIL,COMMERCIAL,0,124400,124400,0,283200,407600
142911100100000,NW 318,RESIDENTIAL,6300,0,6300,50400,0,56700
142911100200000,NW 318,RESIDENTIAL,6300,0,6300,50600,0,56900
142911100300000,NW 318,RESIDENTIAL,12000,0,12000,64900,0,76900
142911100400000,NW 318,RESIDENTIAL,12000,0,12000,51300,0,63300
142911100500000,NW 318,RESIDENTIAL,12000,0,12000,62400,0,74400
142911100600000,NW 318,RESIDENTIAL,9000,0,9000,38700,0,47700
142911100700000,NW 318,RESIDENTIAL,9000,0,9000,3200,0,12200
142911100800000,NW 318,RESIDENTIAL,18000,0,18000,29700,0,47700
142911101100000,CHURCH,EXEMPT,0,631100,631100,0,2802900,3434000
142911101200000,CHURCH,EXEMPT,0,15500,15500,0,0,15500
142911101400000,NW 318,EXEMPT,0,12000,12000,0,48400,60400
142911101500000,NW 318,RESIDENTIAL,12000,0,12000,57400,0,69400
142911102100000,NW 318,RESIDENTIAL,8400,0,8400,26900,0,35300
142911102200000,NW 318,RESIDENTIAL,11300,0,11300,34100,0,45400
142911102300000,CITY PROPERTY,EXEMPT,0,0,0,0,0,0
142911102400000,NW 318,RESIDENTIAL,5000,0,5000,0,0,5000
142911200100000,CITY PROPERTY,EXEMPT,0,0,0,0,0,0
142911200200000,VACANT LAND,INDUSTRIAL,0,9100,9100,0,0,9100
142911200600000,NW 318,RESIDENTIAL,12000,0,12000,48000,0,60000
142911200900000,NW 318,RESIDENTIAL,12000,0,12000,96200,0,108200
142911201000000,NW 318,RESIDENTIAL,12000,0,12000,50500,0,62500
142911201100000,NW 318,RESIDENTIAL,12000,0,12000,97400,0,109400
142911201200000,NW 318,RESIDENTIAL,13800,0,13800,95300,0,109100
142911201300000,NW 318,RESIDENTIAL,13700,0,13700,97900,0,111600
142911201400000,NW 318,RESIDENTIAL,18000,0,18000,45300,0,63300
142911300100000,EQUIPMENT MFG;INDUST,INDUSTRIAL,0,27100,27100,0,4500,31600
142911400100000,WAREHOUSE; CTRL CR,COMMERCIAL,0,45600,45600,0,134900,180500
142911400200000,SMALL RET; CTRL CR,COMMERCIAL,21432,24168,45600,114489,128511,288600
142911400300000,BRNCH BK/CR; CTRL CR,COMMERCIAL,0,148200,148200,0,211300,359500
142911400400000,SMALL RET; CTRL CR,COMMERCIAL,2597,2303,4900,60328,41172,106400
142911500100000,NW 318,RESIDENTIAL,12000,0,12000,45400,0,57400
142911500200000,NW 318,RESIDENTIAL,12000,0,12000,47700,0,59700
142911500300000,NW 318,RESIDENTIAL,12000,0,12000,53400,0,65400
142911500400000,NW 318,RESIDENTIAL,12300,0,12300,97200,0,109500
142911500500000,NW 318,RESIDENTIAL,11700,0,11700,56900,0,68600
142911500600000,NW 318,RESIDENTIAL,12000,0,12000,51400,0,63400
142911500700000,NW 318,RESIDENTIAL,12000,0,12000,44800,0,56800
142911500800000,CONVERSION-NW/SW,MULTI-RES,12000,0,12000,82100,0,94100
142911500900000,WAREHOUSE,COMMERCIAL,0,16100,16100,0,118200,134300
142911501000000,EQUIPMENT MFG;INDUST,INDUSTRIAL,0,36000,36000,0,0,36000
142911501100000,SMALL RETAIL,COMMERCIAL,0,33600,33600,0,119900,153500
142911501200000,SMALL RETAIL,COMMERCIAL,0,33600,33600,0,75500,109100
142911501300000,SMALL RETAIL,COMMERCIAL,11775,3925,15700,55850,24850,96400
142911501400000,CITY PROPERTY,EXEMPT,0,0,0,0,0,0
142911501500000,NW 318,RESIDENTIAL,7400,0,7400,66500,0,73900
142911501600000,FLAT PARKING,COMMERCIAL,0,9600,9600,0,3800,13400
142911501700000,OFFICE,COMMERCIAL,0,8400,8400,0,64400,72800
142911501800000,NW 318,RESIDENTIAL,9500,0,9500,40900,0,50400
142912700300000,NW 311,RESIDENTIAL,11200,0,11200,116500,0,127700
142912700400000,NW 311,RESIDENTIAL,4800,0,4800,0,0,4800
142912700500000,NW 311,RESIDENTIAL,16000,0,16000,75200,0,91200
142912700600000,NW 311,RESIDENTIAL,16000,0,16000,62100,0,78100
142912700700000,NW 311,RESIDENTIAL,16000,0,16000,49900,0,65900
142912700800000,NW 311,RESIDENTIAL,11700,0,11700,59800,0,71500
142912700900000,NW 311,RESIDENTIAL,11200,0,11200,38100,0,49300
142912701000000,NW 311,RESIDENTIAL,9000,0,9000,77100,0,86100
142912701100000,NW 311,RESIDENTIAL,9300,0,9300,66300,0,75600
142912701200000,CITY PROPERTY,EXEMPT,0,0,0,0,0,0
142912701300000,NW 311,RESIDENTIAL,9300,0,9300,52700,0,62000
142912701400000,NW 311,RESIDENTIAL,8400,0,8400,67900,0,76300
142912701500000,NW 311,RESIDENTIAL,8400,0,8400,62400,0,70800
142912701600000,NW 311,RESIDENTIAL,12000,0,12000,41600,0,53600
142912701700000,NW 311,RESIDENTIAL,12000,0,12000,77000,0,89000
142912701800000,NW 311,RESIDENTIAL,12000,0,12000,45100,0,57100
142912701900000,NW 311,RESIDENTIAL,12000,0,12000,54300,0,66300
142912702000000,NW 311,RESIDENTIAL,8900,0,8900,49700,0,58600
142912702100000,NW 311,RESIDENTIAL,10800,0,10800,40200,0,51000
142912702200000,NW 311,RESIDENTIAL,12000,0,12000,92800,0,104800
142912702300000,NW 311,RESIDENTIAL,8000,0,8000,53500,0,61500
142912702400000,NW 311,RESIDENTIAL,8000,0,8000,54500,0,62500
142912702500000,NW 311,RESIDENTIAL,13600,0,13600,93200,0,106800
142912800100000,CONVERSION-NW/SW,MULTI-RES,22000,0,22000,53300,0,75300
142912800200000,NW 311,RESIDENTIAL,22000,0,22000,81300,0,103300
142912800300000,NW 311,RESIDENTIAL,25200,0,25200,85900,0,111100
142912800400000,NW 311,RESIDENTIAL,17600,0,17600,95600,0,113200
142912800500000,NW 311,RESIDENTIAL,12300,0,12300,64800,0,77100
142912800600000,NW 311,RESIDENTIAL,14200,0,14200,71200,0,85400
142912800700000,NW 311,RESIDENTIAL,15000,0,15000,79100,0,94100
142912800800000,NW 311,RESIDENTIAL,15000,0,15000,48400,0,63400
142912800900000,NW 311,RESIDENTIAL,15000,0,15000,106200,0,121200
142912801000000,NW 311,RESIDENTIAL,13500,0,13500,47300,0,60800
142912801100000,NW 311,RESIDENTIAL,6600,0,6600,66100,0,72700
142912900100000,NW 311,RESIDENTIAL,16600,0,16600,50700,0,67300
142912900200000,NW 311,RESIDENTIAL,20000,0,20000,30200,0,50200
142912900300000,NW 311,RESIDENTIAL,20000,0,20000,58100,0,78100
142912900400000,NW 311,RESIDENTIAL,20000,0,20000,45600,0,65600
142912900500000,NW 311,RESIDENTIAL,20000,0,20000,82600,0,102600
142912900600000,NW 311,RESIDENTIAL,20800,0,20800,50000,0,70800
142912900700000,NW 311,RESIDENTIAL,18000,0,18000,61700,0,79700
142912900800000,NW 311,RESIDENTIAL,17500,0,17500,89000,0,106500
142912900900000,NW 311,RESIDENTIAL,17500,0,17500,65300,0,82800
142912901000000,NW 311,RESIDENTIAL,14000,0,14000,51800,0,65800
142912901100000,NW 311,RESIDENTIAL,17500,0,17500,81200,0,98700
142912901200000,NW 311,RESIDENTIAL,21000,0,21000,76200,0,97200
142912901300000,NW 311,RESIDENTIAL,9500,0,9500,73300,0,82800
142913000100000,CITY PROPERTY,EXEMPT,0,0,0,0,0,0
142913000200000,NW 311,RESIDENTIAL,9500,0,9500,29100,0,38600
142913000300000,NW 311,RESIDENTIAL,8400,0,8400,41700,0,50100
142913000400000,NW 311,RESIDENTIAL,12000,0,12000,58800,0,70800
142913000500000,NW 311,RESIDENTIAL,12000,0,12000,54500,0,66500
142913000600000,NW 311,RESIDENTIAL,8800,0,8800,44200,0,53000
142913000700000,NW 311,RESIDENTIAL,9000,0,9000,51700,0,60700
142913000800000,CITY PROPERTY,EXEMPT,0,0,0,0,0,0
142913100100000,NW 311,RESIDENTIAL,12000,0,12000,67900,0,79900
142913100200000,NW 311,RESIDENTIAL,12000,0,12000,64200,0,76200
142913100300000,NW 311,RESIDENTIAL,12000,0,12000,49300,0,61300
142913100400000,NW 311,RESIDENTIAL,12000,0,12000,117700,0,129700
142913100500000,NW 311,RESIDENTIAL,12000,0,12000,39500,0,51500
142913100600000,NW 311,RESIDENTIAL,10500,0,10500,52100,0,62600
142913100700000,NW 311,RESIDENTIAL,12000,0,12000,41800,0,53800
142913100800000,NW 311,RESIDENTIAL,7700,0,7700,54700,0,62400
142913100900000,NW 311,RESIDENTIAL,6900,0,6900,57000,0,63900
142913101000000,NW 311,RESIDENTIAL,6500,0,6500,39500,0,46000
142913101100000,NW 311,RESIDENTIAL,15000,0,15000,109700,0,124700
142913101200000,NW 311,RESIDENTIAL,9000,0,9000,47200,0,56200
142913101300000,NW 311,RESIDENTIAL,12000,0,12000,66100,0,78100
142913101400000,NW 311,RESIDENTIAL,18000,0,18000,75000,0,93000
142913101500000,NW 311,RESIDENTIAL,18000,0,18000,63400,0,81400
142913101600000,CITY PROPERTY,EXEMPT,0,0,0,0,0,0
142913101700000,CITY PROPERTY,EXEMPT,0,0,0,0,0,0
142913200200000,NW 311,RESIDENTIAL,15000,0,15000,86400,0,101400
142913200300000,NW 311,RESIDENTIAL,15000,0,15000,63300,0,78300
142913200400000,NW 311,RESIDENTIAL,15000,0,15000,64600,0,79600
142913200500000,NW 311,RESIDENTIAL,8100,0,8100,58200,0,66300
142913200800000,NW 311,RESIDENTIAL,15000,0,15000,50600,0,65600
142913200900000,NW 311,RESIDENTIAL,15000,0,15000,34400,0,49400
142913201000000,NW 311,RESIDENTIAL,15000,0,15000,120300,0,135300
142913201100000,APARTMENT,MULTI-RES,14000,0,14000,111800,0,125800
142913201200000,NW 311,RESIDENTIAL,15000,0,15000,76700,0,91700
142913201300000,NW 311,RESIDENTIAL,6900,0,6900,36200,0,43100
142913201400000,NW 311,RESIDENTIAL,7700,0,7700,36000,0,43700
142913201500000,NW 311,RESIDENTIAL,9100,0,9100,55400,0,64500
142913201600000,NW 311,RESIDENTIAL,14600,0,14600,110400,0,125000
142913300100000,NW 311,RESIDENTIAL,14600,0,14600,75100,0,89700
142913300200000,NW 311,RESIDENTIAL,15700,0,15700,83600,0,99300
142913300300000,NW 311,RESIDENTIAL,17500,0,17500,63400,0,80900
142913300400000,NW 311,RESIDENTIAL,17500,0,17500,36800,0,54300
142913300500000,NW 311,RESIDENTIAL,15600,0,15600,55400,0,71000
142913300600000,NW 311,RESIDENTIAL,12500,0,12500,0,0,12500
142913300700000,NW 311,RESIDENTIAL,15600,0,15600,19300,0,34900
142913300800000,FRATERNAL,EXEMPT,0,154700,154700,0,307100,461800
142913300900000,NW 311,RESIDENTIAL,11400,0,11400,87600,0,99000
142913400100000,EQUIPMENT MFG;INDUST,INDUSTRIAL,0,238800,238800,0,602400,841200
142913500100000,NW 311,RESIDENTIAL,9100,0,9100,74900,0,84000
142913500200000,NW 311,RESIDENTIAL,12000,0,12000,64500,0,76500
142913500300000,NW 311,RESIDENTIAL,12000,0,12000,67900,0,79900
142913500400000,NW 311,RESIDENTIAL,18000,0,18000,56800,0,74800
142913500500000,NW 311,RESIDENTIAL,18000,0,18000,62100,0,80100
142913500600000,NW 311,RESIDENTIAL,12000,0,12000,57200,0,69200
142913500700000,NW 311,RESIDENTIAL,12000,0,12000,120100,0,132100
142913500800000,NW 311,RESIDENTIAL,11700,0,11700,130500,0,142200
142913500900000,NW 311,RESIDENTIAL,14700,0,14700,59800,0,74500
142913501000000,NW 311,RESIDENTIAL,13500,0,13500,33500,0,47000
142913501100000,OFFICE,COMMERCIAL,0,5000,5000,0,0,5000
142913501200000,NW 311,RESIDENTIAL,8100,0,8100,83500,0,91600
142913600200000,NW 311,RESIDENTIAL,10800,0,10800,58500,0,69300
142913600300000,NW 311,RESIDENTIAL,12000,0,12000,60400,0,72400
142913600400000,NW 311,RESIDENTIAL,9000,0,9000,79200,0,88200
142913600500000,NW 311,RESIDENTIAL,12000,0,12000,62300,0,74300
142913600600000,NW 311,RESIDENTIAL,13200,0,13200,62900,0,76100
142913600700000,NW 311,RESIDENTIAL,6500,0,6500,56300,0,62800
142913600800000,NW 311,RESIDENTIAL,15000,0,15000,64200,0,79200
142913600900000,NW 311,RESIDENTIAL,15000,0,15000,53300,0,68300
142913601000000,NW 311,RESIDENTIAL,15000,0,15000,70200,0,85200
142913601100000,NW 311,RESIDENTIAL,15000,0,15000,66400,0,81400
142913601200000,NW 311,RESIDENTIAL,15000,0,15000,113900,0,128900
142913601400000,NW 311,RESIDENTIAL,8700,0,8700,61600,0,70300
142913601600000,NW 311,RESIDENTIAL,13500,0,13500,60500,0,74000
142913700100000,NW 311,RESIDENTIAL,17500,0,17500,69200,0,86700
142913700200000,NW 311,RESIDENTIAL,17500,0,17500,78000,0,95500
142913700300000,NW 311,RESIDENTIAL,17500,0,17500,78600,0,96100
142913700400000,NW 311,RESIDENTIAL,17500,0,17500,67300,0,84800
142913700500000,NW 311,RESIDENTIAL,15800,0,15800,70000,0,85800
142913700600000,NW 311,RESIDENTIAL,16100,0,16100,59600,0,75700
142913700700000,NW 311,RESIDENTIAL,21000,0,21000,42200,0,63200
142913700800000,NW 311,RESIDENTIAL,14000,0,14000,57300,0,71300
142913700900000,NW 311,RESIDENTIAL,14000,0,14000,68800,0,82800
142913701000000,CITY PROPERTY,EXEMPT,0,0,0,0,0,0
142913701100000,NW 311,RESIDENTIAL,9100,0,9100,41900,0,51000
142913701200000,NW 311,RESIDENTIAL,16800,0,16800,50000,0,66800
142913701300000,NW 311,RESIDENTIAL,17500,0,17500,55200,0,72700
142913800300000,WAREHOUSE,COMMERCIAL,0,140600,140600,0,776800,917400
142913900100000,NW 311,RESIDENTIAL,12400,0,12400,55600,0,68000
142913900200000,NW 311,RESIDENTIAL,15000,0,15000,62700,0,77700
142913900300000,CHURCH,EXEMPT,0,28000,28000,0,237600,265600
142913900400000,NW 311,RESIDENTIAL,12100,0,12100,67300,0,79400
142913900500000,NW 311,RESIDENTIAL,12400,0,12400,0,0,12400
142914000100000,DAY CARE CENTER,EXEMPT,0,27700,27700,0,382600,410300
142914000200000,CENTRALLY ASSESSED,OTHER,0,0,0,0,0,0
142914000300000,NW 311,RESIDENTIAL,17500,0,17500,71000,0,88500
142914000400000,NW 311,RESIDENTIAL,14500,0,14500,55500,0,70000
142914000500000,NW 311,RESIDENTIAL,14500,0,14500,62400,0,76900
142914000600000,NW 311,RESIDENTIAL,11600,0,11600,56000,0,67600
142914000700000,FLAT PARKING,EXEMPT,0,0,0,0,0,0
142915100100000,EQUIPMENT MFG;INDUST,INDUSTRIAL,0,260000,260000,0,160500,420500
142915100200000,SMALL RETAIL,COMMERCIAL,0,134300,134300,0,126800,261100
142915100300000,WAREHOUSE,COMMERCIAL,0,21000,21000,0,23000,44000
142915100400000,NW 311,RESIDENTIAL,10500,0,10500,59700,0,70200
142915100500000,NW 311,RESIDENTIAL,10900,0,10900,53000,0,63900
142915100600000,CITY PROPERTY,EXEMPT,0,0,0,0,0,0
142915100700000,NW 311,RESIDENTIAL,15200,0,15200,43600,0,58800
142915100800000,FLAT PARKING,COMMERCIAL,0,26900,26900,0,8300,35200
142915100900000,DAY CARE CENTER,COMMERCIAL,10080,40320,50400,36500,146000,232900
142915101000000,FLAT PARKING,COMMERCIAL,0,10800,10800,0,200,11000
142915101100000,VACANT LAND,COMMERCIAL,0,4000,4000,0,0,4000
142915200200000,THEATER,COMMERCIAL,0,9100,9100,0,0,9100
142915200300000,VACANT LAND,COMMERCIAL,0,10400,10400,0,0,10400
142915200400000,VACANT LAND,COMMERCIAL,0,13000,13000,0,0,13000
142915200500000,VACANT LAND,COMMERCIAL,0,15000,15000,0,0,15000
142915300300000,NW 311,RESIDENTIAL,8600,0,8600,52000,0,60600
142915300400000,CONVERSION-NW/SW,MULTI-RES,11000,0,11000,40300,0,51300
142915300500000,NW 311,RESIDENTIAL,11000,0,11000,40300,0,51300
142915300600000,NW 311,RESIDENTIAL,9600,0,9600,43700,0,53300
142915300700000,NW 311,RESIDENTIAL,10500,0,10500,30400,0,40900
142915300800000,NW 311,RESIDENTIAL,12000,0,12000,36400,0,48400
142915300900000,NW 311,RESIDENTIAL,7500,0,7500,38000,0,45500
142915301000000,NW 311,RESIDENTIAL,13200,0,13200,56500,0,69700
142915301100000,NW 311,RESIDENTIAL,13200,0,13200,18800,0,32000
142915301200000,NW 311,RESIDENTIAL,8400,0,8400,43500,0,51900
142915301300000,NW 311,RESIDENTIAL,7800,0,7800,60000,0,67800
142915301400000,NW 311,RESIDENTIAL,12200,0,12200,72100,0,84300
142915400100000,FLAT PARKING,EXEMPT,0,23400,23400,0,15000,38400
142915400200000,NW 311,RESIDENTIAL,19300,0,19300,120100,0,139400
142915400300000,NW 311,RESIDENTIAL,9700,0,9700,57600,0,67300
142915400400000,NW 311,RESIDENTIAL,9700,0,9700,36700,0,46400
142915400500000,NW 311,RESIDENTIAL,9700,0,9700,71500,0,81200
142915400600000,NW 311,RESIDENTIAL,9700,0,9700,54200,0,63900
142915400700000,NW 311,RESIDENTIAL,9700,0,9700,48000,0,57700
142915401000000,NW 311,RESIDENTIAL,11600,0,11600,52200,0,63800
142915401100000,NW 311,RESIDENTIAL,15400,0,15400,62100,0,77500
142915401200000,NW 311,RESIDENTIAL,12300,0,12300,51260,0,63560
142915401300000,NW 311,RESIDENTIAL,17500,0,17500,55300,0,72800
142915401400000,NW 311,RESIDENTIAL,17500,0,17500,68500,0,86000
142915401500000,NW 311,RESIDENTIAL,17500,0,17500,65000,0,82500
142915401600000,VACANT LAND,EXEMPT,0,18000,18000,0,0,18000
142915401700000,NW 311,RESIDENTIAL,13500,0,13500,38600,0,52100
142915500100000,CITY PROPERTY,EXEMPT,0,0,0,0,0,0
142915500200000,NW 311,RESIDENTIAL,8600,0,8600,50300,0,58900
142915500300000,NW 311,RESIDENTIAL,14000,0,14000,26000,0,40000
142915500400000,NW 311,RESIDENTIAL,14000,0,14000,42800,0,56800
142915500500000,NW 311,RESIDENTIAL,13000,0,13000,79700,0,92700
142915500600000,NW 311,RESIDENTIAL,8600,0,8600,53100,0,61700
142915600100000,NW 311,RESIDENTIAL,10100,0,10100,66400,0,76500
142915600200000,NW 311,RESIDENTIAL,15000,0,15000,82900,0,97900
142915600300000,NW 311,RESIDENTIAL,9000,0,9000,45200,0,54200
142915600400000,NW 311,RESIDENTIAL,10500,0,10500,57200,0,67700
142915600500000,NW 311,RESIDENTIAL,10500,0,10500,69400,0,79900
142915600600000,NW 311,RESIDENTIAL,15000,0,15000,62000,0,77000
142915600700000,CITY PROPERTY,EXEMPT,0,0,0,0,0,0
142915600800000,CITY PROPERTY,EXEMPT,0,0,0,0,0,0
142915600900000,BARS/LOUNGE,COMMERCIAL,7980,34020,42000,29299,123201,194500
142915601000000,SMALL RETAIL,COMMERCIAL,0,60000,60000,0,94900,154900
142915601100000,NW 311,RESIDENTIAL,10600,0,10600,72100,0,82700
142915601200000,NW 311,RESIDENTIAL,5700,0,5700,58300,0,64000
142915601300000,NW 311,RESIDENTIAL,6500,0,6500,55100,0,61600
142915700100000,NW 311,RESIDENTIAL,11300,0,11300,66400,0,77700
142915700200000,NW 311,RESIDENTIAL,14200,0,14200,49600,0,63800
142915700300000,NW 311,RESIDENTIAL,17500,0,17500,71000,0,88500
142915700400000,NW 311,RESIDENTIAL,17500,0,17500,75100,0,92600
142915700500000,NW 311,RESIDENTIAL,14000,0,14000,73800,0,87800
142915700600000,NW 311,RESIDENTIAL,5500,0,5500,40300,0,45800
142915700700000,NW 311,RESIDENTIAL,13200,0,13200,65200,0,78400
142915700800000,NW 311,RESIDENTIAL,20000,0,20000,108500,0,128500
142915700900000,NW 311,RESIDENTIAL,20000,0,20000,0,0,20000
142915701000000,NW 311,RESIDENTIAL,20000,0,20000,0,0,20000
142915701100000,OFFICE,COMMERCIAL,5796,8004,13800,26352,37048,77200
142915701200000,NW 311,RESIDENTIAL,7800,0,7800,55900,0,63700
142915701300000,NW 311,RESIDENTIAL,11100,0,11100,61000,0,72100
142915701400000,NW 311,RESIDENTIAL,5700,0,5700,36800,0,42500
142915800100000,NW 311,RESIDENTIAL,12100,0,12100,51300,0,63400
142915800200000,NW 311,RESIDENTIAL,10500,0,10500,70900,0,81400
142915800300000,NW 311,RESIDENTIAL,10600,0,10600,57000,0,67600
142915800400000,NW 311,RESIDENTIAL,20000,0,20000,66300,0,86300
142915800500000,NW 311,RESIDENTIAL,400,0,400,0,0,400
142915800600000,NW 311,RESIDENTIAL,20400,0,20400,63500,0,83900
142915800700000,NW 311,RESIDENTIAL,16300,0,16300,52700,0,69000
142915800800000,NW 311,RESIDENTIAL,20400,0,20400,57800,0,78200
142915800900000,NW 311,RESIDENTIAL,20400,0,20400,77700,0,98100
142915801000000,NW 311,RESIDENTIAL,20400,0,20400,81100,0,101500
142915801100000,APARTMENT,RESIDENTIAL,12000,0,12000,101000,0,113000
142915801200000,NW 311,RESIDENTIAL,10900,0,10900,87200,0,98100
142915801300000,NW 311,RESIDENTIAL,11800,0,11800,56900,0,68700
142915801400000,NW 311,RESIDENTIAL,11600,0,11600,58400,0,70000
142915900100000,SMALL RETAIL,COMMERCIAL,0,240800,240800,0,84400,325200
142915900200000,VACANT LAND,COMMERCIAL,0,19400,19400,0,0,19400
142916000100000,AUTO REPAIR/SALES,COMMERCIAL,0,84000,84000,0,97300,181300
142916000102000,BILLBOARD(BLL),COMMERCIAL,0,0,0,0,47100,47100
142916000200000,LG DISCOUNT/RETAIL,COMMERCIAL,0,272500,272500,0,196800,469300
142916000300000,WAREHOUSE,COMMERCIAL,0,136300,136300,0,288400,424700
142916100100000,CONVENIENCE STORE,COMMERCIAL,0,67200,67200,0,192800,260000
142916100200000,NW 311,RESIDENTIAL,8000,0,8000,60600,0,68600
142916100300000,NW 311,RESIDENTIAL,8000,0,8000,700,0,8700
142916100400000,OFFICE,COMMERCIAL,35616,31584,67200,46390,52910,166500
142916100500000,APARTMENT,MULTI-RES,14000,0,14000,99100,0,113100
142916100800000,NW 311,RESIDENTIAL,15000,0,15000,39800,0,54800
142916100900000,NW 311,RESIDENTIAL,7100,0,7100,47000,0,54100
142916101000000,NW 311,RESIDENTIAL,7200,0,7200,39800,0,47000
142916101100000,NW 311,RESIDENTIAL,8400,0,8400,59400,0,67800
142916101200000,BARS/LOUNGE,COMMERCIAL,0,37800,37800,0,65900,103700
142916200100000,NW 311,RESIDENTIAL,19900,0,19900,36300,0,56200
142916200200000,NW 311,RESIDENTIAL,20000,0,20000,75700,0,95700
142916200300000,NW 311,RESIDENTIAL,20000,0,20000,64800,0,84800
142916200400000,NW 311,RESIDENTIAL,20000,0,20000,78800,0,98800
142916200500000,NW 311,RESIDENTIAL,20000,0,20000,73200,0,93200
142916200600000,NW 311,RESIDENTIAL,16000,0,16000,60500,0,76500
142916200700000,CONVERSION-NW/SW,MULTI-RES,24000,0,24000,73600,0,97600
142916200800000,NW 311,RESIDENTIAL,7300,0,7300,49900,0,57200
142916200900000,NW 311,RESIDENTIAL,11400,0,11400,37000,0,48400
142916201000000,NW 311,RESIDENTIAL,15100,0,15100,79100,0,94200
142916201100000,NW 311,RESIDENTIAL,15000,0,15000,52500,0,67500
142916201200000,NW 311,RESIDENTIAL,15000,0,15000,45000,0,60000
142916201300000,NW 311,RESIDENTIAL,15000,0,15000,36400,0,51400
142916201400000,NW 311,RESIDENTIAL,15000,0,15000,62300,0,77300
142916201500000,NW 311,RESIDENTIAL,13700,0,13700,40500,0,54200
142916201600000,OFFICE,COMMERCIAL,5616,5184,10800,51896,47904,110600
142916201700000,NW 311,RESIDENTIAL,9300,0,9300,48900,0,58200
142916300100000,SHOP,COMMERCIAL,0,77900,77900,0,260700,338600
142916300200000,VACANT LAND,COMMERCIAL,0,19300,19300,0,0,19300
142916300300000,SHOP,COMMERCIAL,0,50400,50400,0,176000,226400
142916300400000,SHOP,COMMERCIAL,0,17600,17600,0,31300,48900
142916300500000,CITY PROPERTY,EXEMPT,0,0,0,0,0,0
142916300600000,NW 318,RESIDENTIAL,11600,0,11600,46000,0,57600
142916300700000,NW 318,RESIDENTIAL,11400,0,11400,0,0,11400
142916400100000,VACANT LAND,COMMERCIAL,0,10000,10000,0,0,10000
142916400200000,SHOP,COMMERCIAL,0,57100,57100,0,169700,226800
142916400300000,FLAT PARKING,COMMERCIAL,0,19400,19400,0,4000,23400
142916400400000,FLAT PARKING,COMMERCIAL,0,8800,8800,0,1400,10200
142916400500000,FLAT PARKING,COMMERCIAL,0,10900,10900,0,2100,13000
142916400800000,NW 311,RESIDENTIAL,10100,0,10100,40500,0,50600
142916400900000,NW 311,RESIDENTIAL,7600,0,7600,51200,0,58800
142916401000000,NW 311,RESIDENTIAL,11300,0,11300,47100,0,58400
142916401100000,NW 311,RESIDENTIAL,6200,0,6200,41500,0,47700
142916401200000,NW 311,RESIDENTIAL,8500,0,8500,33600,0,42100
142916401300000,NW 311,RESIDENTIAL,11000,0,11000,40900,0,51900
142916401400000,CITY PROPERTY,EXEMPT,0,0,0,0,0,0
142916401500000,FLAT PARKING,COMMERCIAL,0,14500,14500,0,2900,17400
142916401600000,WAREHOUSE,COMMERCIAL,0,59700,59700,0,202100,261800
142916401700000,VACANT LAND,COMMERCIAL,0,7800,7800,0,0,7800
142916401800000,OFFICE,COMMERCIAL,0,21800,21800,0,282600,304400
142917600100000,OFFICE; CTRL CR,COMMERCIAL,112530,8470,121000,640677,48223,809900
142917700100000,AUTO REP/SAL;CTRL CR,COMMERCIAL,0,100600,100600,0,44400,145000
142917700200000,SMALL RET; CTRL CR,COMMERCIAL,22780,10720,33500,54360,39440,127300
142917700202000,BILLBOARD(BLL),COMMERCIAL,0,0,0,0,18500,18500
142917700300000,CITY PROPERTY,EXEMPT,0,0,0,0,0,0
142917700400000,CITY PROPERTY,EXEMPT,0,0,0,0,0,0
142917700500000,AUTO REP/SAL;CTRL CR,COMMERCIAL,0,42000,42000,0,20500,62500
142917700600000,AUTO REP/SAL;CTRL CR,COMMERCIAL,0,30900,30900,0,36200,67100
142917700700000,CITY PROPERTY,EXEMPT,0,0,0,0,0,0
142917700800000,CITY PROPERTY,EXEMPT,0,0,0,0,0,0
142917700900000,CONVERSION-NW/SW,MULTI-RES,12200,0,12200,46500,0,58700
142917701000000,CONVERSION-NW/SW,MULTI-RES,12200,0,12200,68900,0,81100
142917701100000,SW 401,RESIDENTIAL,12200,0,12200,0,0,12200
142917800100000,SMALL RETAIL,COMMERCIAL,16800,16800,33600,10550,18150,62300
142917800200000,CITY PROPERTY,EXEMPT,0,0,0,0,0,0
142917800300000,FLAT PARKING,COMMERCIAL,0,33600,33600,0,4500,38100
142917800400000,RESTAURANT,COMMERCIAL,14448,19152,33600,58045,69255,160900
142917800500000,FLAT PARKING,COMMERCIAL,0,33600,33600,0,4500,38100
142917800600000,FLAT PARKING,COMMERCIAL,0,33600,33600,0,4500,38100
142917800700000,SMALL RETAIL,COMMERCIAL,0,67200,67200,0,211700,278900
142917800800000,CITY PROPERTY,EXEMPT,0,0,0,0,0,0
142917901100000,CITY PROPERTY,EXEMPT,0,0,0,0,0,0
142917901200000,CONVERSION-NW/SW,COMMERCIAL,9954,2646,12600,28900,16100,57600
142917901300000,CONVERSION-NW/SW,MULTI-RES,13000,0,13000,48700,0,61700
142917901400000,COUNTY PROPERTY,EXEMPT,0,0,0,0,0,0
142917901500000,SW 401,RESIDENTIAL,12300,0,12300,79500,0,91800
142917901700000,FLAT PARKING,EXEMPT,0,63700,63700,0,5300,69000
142917901800000,CHURCH,EXEMPT,0,99300,99300,0,500400,599700
142917901900000,APARTMENT; CNTRL CR,MULTI-RES,101100,0,101100,0,0,101100
142918000100000,NW 318,RESIDENTIAL,9800,0,9800,59100,0,68900
142918000200000,CONVERSION-NW/SW,MULTI-RES,11800,0,11800,61100,0,72900
142918000300000,OFFICE,COMMERCIAL,58342,35758,94100,353772,216828,664700
142918000400000,FAST FOOD,COMMERCIAL,0,33600,33600,0,63000,96600
142918000500000,OFFICE,COMMERCIAL,0,31900,31900,0,141900,173800
142918000600000,FLAT PARKING,COMMERCIAL,0,10700,10700,0,3300,14000
142918000700000,FLAT PARKING,COMMERCIAL,0,10700,10700,0,3300,14000
142918000800000,NW 318,RESIDENTIAL,6500,0,6500,58600,0,65100
142918000900000,NW 318,RESIDENTIAL,6500,0,6500,0,0,6500
142918001000000,NW 318,RESIDENTIAL,12600,0,12600,0,0,12600
142918001100000,NW 318,RESIDENTIAL,9000,0,9000,0,0,9000
142918001500000,NW 318,RESIDENTIAL,9000,0,9000,3200,0,12200
142918001600000,NW 318,RESIDENTIAL,14400,0,14400,0,0,14400
142918001700000,NW 318,RESIDENTIAL,7100,0,7100,53900,0,61000
142918001800000,CITY PROPERTY,EXEMPT,0,0,0,0,0,0
142918001900000,CITY PROPERTY,EXEMPT,0,0,0,0,0,0
142918002000000,FLAT PARKING,COMMERCIAL,0,100800,100800,0,22700,123500
142918100100000,FLAT PARKING,COMMERCIAL,0,47300,47300,0,6800,54100
142918100200000,RESTAURANT,COMMERCIAL,0,96500,96500,0,178000,274500
142918100300000,FLAT PARKING,COMMERCIAL,0,32300,32300,0,3400,35700
142918100400000,SMALL RETAIL,COMMERCIAL,0,33600,33600,0,24800,58400
142918100500000,BARS/LOUNGE,COMMERCIAL,15456,18144,33600,31786,37314,102700
142918100600000,VACANT LAND,COMMERCIAL,0,16000,16000,0,0,16000
142918100700000,NW 318,RESIDENTIAL,12000,0,12000,59900,0,71900
142918100800000,NW 318,RESIDENTIAL,12000,0,12000,47300,0,59300
142918100900000,NW 318,RESIDENTIAL,12000,0,12000,99300,0,111300
142918101000000,NW 318,RESIDENTIAL,12000,0,12000,51400,0,63400
142918101100000,NW 318,RESIDENTIAL,12000,0,12000,86600,0,98600
142918101200000,NW 318,RESIDENTIAL,12000,0,12000,0,0,12000
142918101300000,CONVERSION-NW/SW,MULTI-RES,12000,0,12000,43900,0,55900
142918101400000,CONVERSION-NW/SW,MULTI-RES,12000,0,12000,51800,0,63800
142918101500000,NW 318,RESIDENTIAL,12000,0,12000,45400,0,57400
142918101600000,NW 318,RESIDENTIAL,9100,0,9100,19400,0,28500
142918101700000,NW 318,RESIDENTIAL,8100,0,8100,49100,0,57200
142918101800000,FLAT PARKING,COMMERCIAL,0,17800,17800,0,8000,25800
142918200100000,OFFICE; CTRL CR,EXEMPT,0,147800,147800,0,503200,651000
142918200300000,FLAT PARKING,EXEMPT,0,52700,52700,0,3900,56600
142918200400000,FLAT PARKING,EXEMPT,0,24400,24400,0,1800,26200
142918200500000,CITY PROPERTY,EXEMPT,0,0,0,0,0,0
142918300100000,NW 318,RESIDENTIAL,7200,0,7200,69600,0,76800
142918300200000,SMALL RETAIL,COMMERCIAL,0,75600,75600,0,305700,381300
142918300300000,NW 318,RESIDENTIAL,6300,0,6300,28200,0,34500
142918300400000,BARS/LOUNGE,COMMERCIAL,0,6300,6300,0,84600,90900
142918300700000,NW 318,RESIDENTIAL,6000,0,6000,41200,0,47200
142918300800000,NW 318,RESIDENTIAL,8000,0,8000,53500,0,61500
142918300900000,NW 318,RESIDENTIAL,6200,0,6200,53400,0,59600
142918301000000,NW 318,RESIDENTIAL,5900,0,5900,61200,0,67100
142918301300000,FLAT PARKING,COMMERCIAL,0,63000,63000,0,6700,69700
142918301400000,AUTO REPAIR/SALES,COMMERCIAL,0,63000,63000,0,77300,140300
142918301500000,NW 318,RESIDENTIAL,6000,0,6000,34100,0,40100
142918301900000,NW 318,RESIDENTIAL,13500,0,13500,77000,0,90500
142918302000000,NW 318,RESIDENTIAL,10400,0,10400,67100,0,77500
142918302100000,NW 318,RESIDENTIAL,13000,0,13000,42400,0,55400
142918400100000,NW 318,RESIDENTIAL,10000,0,10000,37100,0,47100
142918400200000,CITY PROPERTY,EXEMPT,0,0,0,0,0,0
142918400300000,NW 318,RESIDENTIAL,12000,0,12000,42800,0,54800
142918400400000,NW 318,RESIDENTIAL,5000,0,5000,0,0,5000
142918400500000,NW 318,RESIDENTIAL,12000,0,12000,51200,0,63200
142918400600000,NW 318,RESIDENTIAL,12000,0,12000,38400,0,50400
142918400700000,NW 318,RESIDENTIAL,12000,0,12000,55100,0,67100
142918400800000,NW 318,RESIDENTIAL,8100,0,8100,40000,0,48100
142918400900000,NW 318,RESIDENTIAL,9100,0,9100,37500,0,46600
142918401000000,NW 318,RESIDENTIAL,12000,0,12000,74500,0,86500
142918401200000,NW 318,RESIDENTIAL,24000,0,24000,73800,0,97800
142918401300000,NW 318,RESIDENTIAL,8400,0,8400,45500,0,53900
142918401400000,NW 318,RESIDENTIAL,9600,0,9600,58100,0,67700
142918401500000,NW 318,RESIDENTIAL,18600,0,18600,34600,0,53200
142918401600000,NW 318,RESIDENTIAL,7400,0,7400,60300,0,67700
142918401700000,SMALL RETAIL,COMMERCIAL,0,6200,6200,0,48100,54300
142918401800000,NW 318,RESIDENTIAL,9100,0,9100,40900,0,50000
142918500100000,NW 318,RESIDENTIAL,12000,0,12000,75700,0,87700
142918500200000,NW 318,RESIDENTIAL,12000,0,12000,49200,0,61200
142918500300000,NW 318,RESIDENTIAL,12000,0,12000,16000,0,28000
142918500400000,NW 318,RESIDENTIAL,12000,0,12000,31500,0,43500
142918500500000,NW 318,RESIDENTIAL,12000,0,12000,96600,0,108600
142918500600000,SHOP,COMMERCIAL,0,16100,16100,0,129800,145900
142918500700000,NW 318,RESIDENTIAL,4600,0,4600,0,0,4600
142918500800000,NW 318,RESIDENTIAL,12000,0,12000,37800,0,49800
142918500900000,NW 318,RESIDENTIAL,12000,0,12000,87700,0,99700
142918501000000,NW 318,RESIDENTIAL,12000,0,12000,61500,0,73500
142918501100000,NW 318,RESIDENTIAL,12000,0,12000,97500,0,109500
142918501200000,APARTMENT,MULTI-RES,11200,0,11200,120600,0,131800
142918501300000,NW 318,RESIDENTIAL,12000,0,12000,33500,0,45500
142918501400000,NW 318,RESIDENTIAL,12000,0,12000,96200,0,108200
142918501500000,NW 318,RESIDENTIAL,12000,0,12000,24300,0,36300
142918600100000,NW 318,RESIDENTIAL,10700,0,10700,100700,0,111400
142918600200000,NW 318,RESIDENTIAL,15000,0,15000,88200,0,103200
142918600300000,NW 318,RESIDENTIAL,15000,0,15000,93300,0,108300
142918600400000,NW 322,RESIDENTIAL,12000,0,12000,0,0,12000
142918600500000,NW 318,RESIDENTIAL,9000,0,9000,46100,0,55100
142918600600000,NW 318,RESIDENTIAL,9000,0,9000,3200,0,12200
142918600700000,NW 318,RESIDENTIAL,15000,0,15000,92500,0,107500
142918600800000,NW 318,RESIDENTIAL,7200,0,7200,51100,0,58300
142918600900000,NW 318,RESIDENTIAL,7200,0,7200,40500,0,47700
142918601000000,NW 318,RESIDENTIAL,6500,0,6500,41500,0,48000
142918601100000,NW 318,RESIDENTIAL,7800,0,7800,76000,0,83800
142918601200000,NW 318,RESIDENTIAL,9600,0,9600,49100,0,58700
142918601300000,NW 318,RESIDENTIAL,10200,0,10200,60500,0,70700
142918601400000,NW 318,RESIDENTIAL,10200,0,10200,47900,0,58100
142918601500000,NW 318,RESIDENTIAL,9600,0,9600,38600,0,48200
142918601600000,NW 318,RESIDENTIAL,9000,0,9000,50900,0,59900
142918601700000,NW 318,RESIDENTIAL,7400,0,7400,45800,0,53200
142918602100000,NW 318,RESIDENTIAL,5100,0,5100,51700,0,56800
142918602200000,CITY PROPERTY,EXEMPT,0,0,0,0,0,0
142918700100000,BARS/LOUNGE,COMMERCIAL,0,20000,20000,0,93500,113500
142918700400000,NW 318,RESIDENTIAL,7300,0,7300,21800,0,29100
142918700500000,NW 318,RESIDENTIAL,7300,0,7300,31700,0,39000
142918700600000,NW 318,RESIDENTIAL,7700,0,7700,26900,0,34600
142918700700000,NW 318,RESIDENTIAL,10100,0,10100,1600,0,11700
142918700800000,NW 318,RESIDENTIAL,7900,0,7900,37800,0,45700
142918700900000,NW 318,RESIDENTIAL,8600,0,8600,56600,0,65200
142918701000000,CITY PROPERTY,EXEMPT,0,0,0,0,0,0
142918701100000,CITY PROPERTY,EXEMPT,0,0,0,0,0,0
142918701200000,NW 318,RESIDENTIAL,10400,0,10400,41500,0,51900
142918701300000,CITY PROPERTY,EXEMPT,0,0,0,0,0,0
142918701400000,NW 318,RESIDENTIAL,8300,0,8300,44200,0,52500
142918701500000,CITY PROPERTY,EXEMPT,0,0,0,0,0,0
142918701600000,NW 318,RESIDENTIAL,13700,0,13700,23600,0,37300
142918800100000,NW 318,RESIDENTIAL,12000,0,12000,37900,0,49900
142918800200000,NW 318,RESIDENTIAL,12000,0,12000,85900,0,97900
142918800300000,NW 318,RESIDENTIAL,12000,0,12000,84500,0,96500
142918800400000,NW 318,RESIDENTIAL,12000,0,12000,46000,0,58000
142918800500000,NW 318,RESIDENTIAL,12000,0,12000,41700,0,53700
142918800600000,NW 318,RESIDENTIAL,12000,0,12000,57700,0,69700
142918800900000,NW 318,RESIDENTIAL,11600,0,11600,39300,0,50900
142918801000000,NW 318,RESIDENTIAL,8400,0,8400,48600,0,57000
142918801100000,NW 318,RESIDENTIAL,10000,0,10000,52300,0,62300
142918801200000,NW 318,RESIDENTIAL,11800,0,11800,43700,0,55500
142918801300000,NW 318,RESIDENTIAL,700,0,700,2200,0,2900
142918801400000,CENTRALLY ASSESSED,OTHER,0,0,0,0,0,0
142918801500000,NW 318,RESIDENTIAL,12000,0,12000,59600,0,71600
142918801600000,NW 318,RESIDENTIAL,12000,0,12000,76400,0,88400
142918801700000,NW 318,RESIDENTIAL,12000,0,12000,88100,0,100100
142918801800000,NW 318,RESIDENTIAL,12000,0,12000,0,0,12000
142918801900000,NW 318,RESIDENTIAL,14900,0,14900,101000,0,115900
142918900100000,NW 318,RESIDENTIAL,8000,0,8000,42500,0,50500
142918900200000,NW 318,RESIDENTIAL,11400,0,11400,96600,0,108000
142918900300000,NW 318,RESIDENTIAL,11400,0,11400,80700,0,92100
142918900400000,CITY PROPERTY,EXEMPT,0,0,0,0,0,0
142918900500000,NW 318,RESIDENTIAL,32600,0,32600,0,0,32600
142918900600000,NW 318,RESIDENTIAL,10700,0,10700,0,0,10700
142918900700000,VACANT LAND,COMMERCIAL,0,17400,17400,0,7500,24900
142918900800000,CITY PROPERTY,EXEMPT,0,0,0,0,0,0
142918900900000,NW 318,RESIDENTIAL,9000,0,9000,40200,0,49200
142918901000000,CITY PROPERTY,EXEMPT,0,0,0,0,0,0
142918901100000,NW 318,RESIDENTIAL,11300,0,11300,46500,0,57800
142918901200000,NW 318,RESIDENTIAL,7400,0,7400,36600,0,44000
142920100300000,CONVERSION-NW/SW,MULTI-RES,16600,0,16600,59500,0,76100
142920100400000,NW 311,RESIDENTIAL,16300,0,16300,61300,0,77600
142920100500000,NW 311,RESIDENTIAL,16000,0,16000,65600,0,81600
142920100600000,NW 311,RESIDENTIAL,16000,0,16000,42700,0,58700
142920100700000,NW 311,RESIDENTIAL,16000,0,16000,49700,0,65700
142920100800000,NW 311,RESIDENTIAL,16000,0,16000,72100,0,88100
142920100900000,NW 311,RESIDENTIAL,16000,0,16000,69100,0,85100
142920101000000,NW 311,RESIDENTIAL,16000,0,16000,65000,0,81000
142920101100000,NW 311,RESIDENTIAL,16000,0,16000,64100,0,80100
142920101200000,NW 311,RESIDENTIAL,16000,0,16000,54700,0,70700
142920101300000,NW 311,RESIDENTIAL,16000,0,16000,62700,0,78700
142920101400000,NW 311,RESIDENTIAL,16000,0,16000,60200,0,76200
142920101500000,NW 311,RESIDENTIAL,16000,0,16000,61500,0,77500
142920101600000,NW 311,RESIDENTIAL,15000,0,15000,58700,0,73700
142920101700000,NW 311,RESIDENTIAL,14000,0,14000,59500,0,73500
142920101800000,NW 311,RESIDENTIAL,9900,0,9900,33400,0,43300
142920101900000,SCHOOL,EXEMPT,0,0,0,0,0,0
142920102100000,COUNTY PROPERTY,EXEMPT,0,0,0,0,0,0
142920200100000,SCHOOL,EXEMPT,0,0,0,0,0,0
142920300100000,NW 311,RESIDENTIAL,11200,0,11200,65800,0,77000
142920300200000,NW 311,RESIDENTIAL,16000,0,16000,63500,0,79500
142920300300000,NW 311,RESIDENTIAL,16000,0,16000,65200,0,81200
142920300400000,CITY PROPERTY,EXEMPT,0,0,0,0,0,0
142920300500000,CITY PROPERTY,EXEMPT,0,0,0,0,0,0
142920300600000,CITY PROPERTY,EXEMPT,0,0,0,0,0,0
142920300700000,NW 311,RESIDENTIAL,16000,0,16000,45700,0,61700
142920300800000,NW 311,RESIDENTIAL,16000,0,16000,36200,0,52200
142920300900000,NW 311,RESIDENTIAL,16000,0,16000,39800,0,55800
142920301000000,NW 311,RESIDENTIAL,16000,0,16000,70600,0,86600
142920301100000,NW 311,RESIDENTIAL,16000,0,16000,69500,0,85500
142920301200000,NW 311,RESIDENTIAL,20800,0,20800,50800,0,71600
142920301300000,NW 311,RESIDENTIAL,14100,0,14100,70700,0,84800
142920301400000,NW 311,RESIDENTIAL,14100,0,14100,83900,0,98000
142920301500000,NW 311,RESIDENTIAL,12200,0,12200,42900,0,55100
142920301600000,NW 311,RESIDENTIAL,16000,0,16000,52300,0,68300
142920301700000,NW 311,RESIDENTIAL,16000,0,16000,47800,0,63800
142920301800000,NW 311,RESIDENTIAL,12600,0,12600,81900,0,94500
142920301900000,NW 311,RESIDENTIAL,12800,0,12800,77600,0,90400
142920302000000,NW 311,RESIDENTIAL,12200,0,12200,73800,0,86000
142920302100000,NW 311,RESIDENTIAL,13400,0,13400,55800,0,69200
142920302200000,NW 311,RESIDENTIAL,13000,0,13000,69300,0,82300
142920302300000,NW 311,RESIDENTIAL,17500,0,17500,58500,0,76000
142920302400000,NW 311,RESIDENTIAL,11400,0,11400,50600,0,62000
142920302500000,NW 311,RESIDENTIAL,16000,0,16000,67200,0,83200
142920302600000,NW 311,RESIDENTIAL,16000,0,16000,33300,0,49300
142920302700000,NW 311,RESIDENTIAL,16000,0,16000,46800,0,62800
142920302800000,NW 311,RESIDENTIAL,16000,0,16000,31100,0,47100
142920302900000,NW 311,RESIDENTIAL,16000,0,16000,64400,0,80400
142920303000000,NW 311,RESIDENTIAL,20800,0,20800,73800,0,94600
142920303100000,NW 311,RESIDENTIAL,11300,0,11300,59600,0,70900
142920400100000,NW 311,RESIDENTIAL,16000,0,16000,68800,0,84800
142920400200000,NW 311,RESIDENTIAL,10800,0,10800,63200,0,74000
142920400300000,NW 311,RESIDENTIAL,11200,0,11200,34200,0,45400
142920400400000,NW 311,RESIDENTIAL,15700,0,15700,81700,0,97400
142920400500000,NW 311,RESIDENTIAL,15700,0,15700,56900,0,72600
142920400600000,NW 311,RESIDENTIAL,15700,0,15700,37300,0,53000
142920400700000,NW 311,RESIDENTIAL,16000,0,16000,50300,0,66300
142920400800000,NW 311,RESIDENTIAL,16000,0,16000,52500,0,68500
142920400900000,NW 311,RESIDENTIAL,16000,0,16000,75100,0,91100
142920500100000,NW 311,RESIDENTIAL,13700,0,13700,61700,0,75400
142920500200000,NW 311,RESIDENTIAL,11200,0,11200,65000,0,76200
142920500300000,NW 311,RESIDENTIAL,14800,0,14800,29000,0,43800
142920500400000,NW 311,RESIDENTIAL,15300,0,15300,72500,0,87800
142920500500000,NW 311,RESIDENTIAL,15000,0,15000,57000,0,72000
142920500600000,NW 311,RESIDENTIAL,16000,0,16000,35800,0,51800
142920500700000,NW 311,RESIDENTIAL,18000,0,18000,43700,0,61700
142920600100000,NW 320,RESIDENTIAL,18900,0,18900,73100,0,92000
142920600200000,NW 320,RESIDENTIAL,18500,0,18500,46000,0,64500
142920600300000,NW 320,RESIDENTIAL,15600,0,15600,63600,0,79200
142920600400000,NW 320,RESIDENTIAL,12800,0,12800,47800,0,60600
142920600500000,NW 320,RESIDENTIAL,18000,0,18000,47400,0,65400
142920600600000,NW 320,RESIDENTIAL,18000,0,18000,51200,0,69200
142920600700000,NW 320,RESIDENTIAL,18000,0,18000,32100,0,50100
142920600800000,NW 320,RESIDENTIAL,18000,0,18000,23200,0,41200
142920600900000,NW 320,RESIDENTIAL,18000,0,18000,33500,0,51500
142920601000000,NW 320,RESIDENTIAL,18000,0,18000,56800,0,74800
142920601100000,NW 320,RESIDENTIAL,18000,0,18000,52300,0,70300
142920601200000,NW 320,RESIDENTIAL,18000,0,18000,65100,0,83100
142920601300000,NW 320,RESIDENTIAL,15800,0,15800,60900,0,76700
142920601400000,NW 320,RESIDENTIAL,18000,0,18000,43400,0,61400
142920601500000,NW 320,RESIDENTIAL,18000,0,18000,36200,0,54200
142920601600000,NW 320,RESIDENTIAL,18000,0,18000,34200,0,52200
142922600100000,NW 320,RESIDENTIAL,29300,0,29300,75400,0,104700
142922600200000,NW 320,RESIDENTIAL,30100,0,30100,69900,0,100000
142922600300000,NW 320,RESIDENTIAL,25700,0,25700,59900,0,85600
142922600400000,NW 320,RESIDENTIAL,16600,0,16600,89600,0,106200
142922600500000,NW 320,RESIDENTIAL,21200,0,21200,74200,0,95400
142922600600000,NW 320,RESIDENTIAL,20800,0,20800,56600,0,77400
142922600700000,NW 320,RESIDENTIAL,20000,0,20000,74900,0,94900
142922600800000,NW 320,RESIDENTIAL,34200,0,34200,0,0,34200
142922600900000,NW 320,RESIDENTIAL,34200,0,34200,76100,0,110300
142922601000000,NW 320,RESIDENTIAL,19800,0,19800,46500,0,66300
142922601100000,NW 320,RESIDENTIAL,21600,0,21600,73200,0,94800
142922601200000,NW 320,RESIDENTIAL,32200,0,32200,112200,0,144400
142922601300000,NW 320,RESIDENTIAL,30000,0,30000,85200,0,115200
142922601400000,NW 320,RESIDENTIAL,31200,0,31200,176300,0,207500
142922601500000,NW 320,RESIDENTIAL,24300,0,24300,88100,0,112400
142922601600000,NW 320,RESIDENTIAL,24200,0,24200,94000,0,118200
142922601700000,NW 320,RESIDENTIAL,24300,0,24300,90800,0,115100
142922601800000,NW 320,RESIDENTIAL,27600,0,27600,83600,0,111200
142922601900000,NW 320,RESIDENTIAL,27800,0,27800,82300,0,110100
142922602000000,NW 320,RESIDENTIAL,28300,0,28300,108200,0,136500
142922602100000,NW 320,RESIDENTIAL,60300,0,60300,135300,0,195600
142922602200000,CITY PROPERTY,EXEMPT,0,0,0,0,0,0
142922602300000,NW 320,RESIDENTIAL,27300,0,27300,84900,0,112200
142922602400000,NW 320,RESIDENTIAL,28100,0,28100,106100,0,134200
142922602500000,NW 320,RESIDENTIAL,28700,0,28700,120100,0,148800
142922602600000,NW 320,RESIDENTIAL,22700,0,22700,73000,0,95700
142922602700000,NW 320,RESIDENTIAL,27200,0,27200,112200,0,139400
142922602800000,NW 320,RESIDENTIAL,27200,0,27200,68900,0,96100
142922602900000,NW 320,RESIDENTIAL,27200,0,27200,91400,0,118600
142922603000000,NW 320,RESIDENTIAL,27200,0,27200,110800,0,138000
142922603100000,NW 320,RESIDENTIAL,46300,0,46300,131700,0,178000
142922603200000,NW 320,RESIDENTIAL,44600,0,44600,128600,0,173200
142922603300000,NW 320,RESIDENTIAL,43200,0,43200,99400,0,142600
142922603400000,NW 320,RESIDENTIAL,29700,0,29700,101000,0,130700
142922603500000,NW 320,RESIDENTIAL,30400,0,30400,138300,0,168700
142922603600000,NW 320,RESIDENTIAL,27700,0,27700,77200,0,104900
142922603700000,NW 320,RESIDENTIAL,35300,0,35300,94700,0,130000
142922603800000,NW 320,RESIDENTIAL,35300,0,35300,92000,0,127300
142922603900000,NW 320,RESIDENTIAL,30200,0,30200,73100,0,103300
142922604000000,NW 320,RESIDENTIAL,47400,0,47400,81500,0,128900
142922604100000,NW 320,RESIDENTIAL,33900,0,33900,62700,0,96600
142922604200000,NW 320,RESIDENTIAL,33900,0,33900,78300,0,112200
142922604300000,NW 320,RESIDENTIAL,34500,0,34500,59800,0,94300
142922700100000,NW 320,RESIDENTIAL,21600,0,21600,65300,0,86900
142922700200000,NW 320,RESIDENTIAL,18000,0,18000,51300,0,69300
142922700300000,NW 320,RESIDENTIAL,18000,0,18000,53300,0,71300
142922700400000,NW 320,RESIDENTIAL,18000,0,18000,47400,0,65400
142922700500000,NW 320,RESIDENTIAL,18000,0,18000,57500,0,75500
142922700600000,NW 320,RESIDENTIAL,21200,0,21200,71800,0,93000
142922700700000,NW 320,RESIDENTIAL,13200,0,13200,62800,0,76000
142922700800000,NW 320,RESIDENTIAL,13100,0,13100,57300,0,70400
142922700900000,NW 320,RESIDENTIAL,12400,0,12400,63500,0,75900
142922701000000,NW 320,RESIDENTIAL,20900,0,20900,76500,0,97400
142922701100000,NW 320,RESIDENTIAL,16700,0,16700,83900,0,100600
142922701200000,NW 320,RESIDENTIAL,18000,0,18000,68500,0,86500
142922701300000,NW 320,RESIDENTIAL,18000,0,18000,77200,0,95200
142922701400000,NW 320,RESIDENTIAL,18000,0,18000,72300,0,90300
142922701500000,NW 320,RESIDENTIAL,18000,0,18000,61800,0,79800
142922701600000,NW 320,RESIDENTIAL,16600,0,16600,55300,0,71900
142922701700000,NW 320,RESIDENTIAL,13500,0,13500,42500,0,56000
142922800100000,NW 320,RESIDENTIAL,24600,0,24600,58600,0,83200
142922800200000,NW 320,RESIDENTIAL,18000,0,18000,59900,0,77900
142922800300000,NW 320,RESIDENTIAL,15800,0,15800,68200,0,84000
142922800400000,NW 320,RESIDENTIAL,18000,0,18000,89600,0,107600
142922800500000,NW 320,RESIDENTIAL,18000,0,18000,85300,0,103300
142922800600000,NW 320,RESIDENTIAL,15800,0,15800,85900,0,101700
142922800700000,NW 320,RESIDENTIAL,18000,0,18000,64700,0,82700
142922800800000,NW 320,RESIDENTIAL,18000,0,18000,66300,0,84300
142922800900000,NW 320,RESIDENTIAL,22800,0,22800,121600,0,144400
142922801000000,NW 320,RESIDENTIAL,24200,0,24200,44100,0,68300
142922801100000,NW 320,RESIDENTIAL,18000,0,18000,45000,0,63000
142922801200000,NW 320,RESIDENTIAL,18000,0,18000,42900,0,60900
142922801300000,NW 320,RESIDENTIAL,15800,0,15800,63000,0,78800
142922801400000,NW 320,RESIDENTIAL,18000,0,18000,75000,0,93000
142922801500000,NW 320,RESIDENTIAL,18000,0,18000,54600,0,72600
142922801600000,NW 320,RESIDENTIAL,15800,0,15800,48800,0,64600
142922801700000,NW 320,RESIDENTIAL,18000,0,18000,76700,0,94700
142922801800000,NW 320,RESIDENTIAL,15800,0,15800,61400,0,77200
142922801900000,NW 320,RESIDENTIAL,21000,0,21000,63000,0,84000
142922802000000,NW 320,RESIDENTIAL,15100,0,15100,54500,0,69600
142922802100000,NW 320,RESIDENTIAL,10400,0,10400,46900,0,57300
142922900100000,NW 320,RESIDENTIAL,24200,0,24200,105500,0,129700
142922900400000,NW 320,RESIDENTIAL,18000,0,18000,66900,0,84900
142922900500000,NW 320,RESIDENTIAL,18000,0,18000,100600,0,118600
142922900600000,NW 320,RESIDENTIAL,18000,0,18000,52000,0,70000
142922900700000,NW 320,RESIDENTIAL,18000,0,18000,76400,0,94400
142922900800000,NW 320,RESIDENTIAL,18000,0,18000,66300,0,84300
142922900900000,NW 320,RESIDENTIAL,18000,0,18000,73800,0,91800
142922901000000,NW 320,RESIDENTIAL,23800,0,23800,77900,0,101700
142922901100000,NW 320,RESIDENTIAL,22700,0,22700,49800,0,72500
142922901200000,SMALL RETAIL,COMMERCIAL,0,11500,11500,0,49800,61300
142922901300000,SMALL RETAIL,COMMERCIAL,0,11700,11700,0,31000,42700
142922901400000,NW 320,RESIDENTIAL,18000,0,18000,47800,0,65800
142922901500000,NW 320,RESIDENTIAL,18000,0,18000,72200,0,90200
142922901600000,NW 320,RESIDENTIAL,18000,0,18000,56400,0,74400
142922901700000,NW 320,RESIDENTIAL,18000,0,18000,76600,0,94600
142922901800000,NW 320,RESIDENTIAL,18000,0,18000,56500,0,74500
142922901900000,NW 320,RESIDENTIAL,18000,0,18000,73000,0,91000
142922902000000,NW 320,RESIDENTIAL,18000,0,18000,63200,0,81200
142922902100000,NW 320,RESIDENTIAL,17400,0,17400,63100,0,80500
142922902200000,NW 320,RESIDENTIAL,15100,0,15100,72900,0,88000
142922902300000,NW 320,RESIDENTIAL,36000,0,36000,74500,0,110500
142923000100000,NW 320,RESIDENTIAL,22100,0,22100,65300,0,87400
142923000200000,NW 320,RESIDENTIAL,22400,0,22400,60400,0,82800
142923000300000,NW 320,RESIDENTIAL,21700,0,21700,74500,0,96200
142923000400000,NW 320,RESIDENTIAL,21700,0,21700,60500,0,82200
142923000500000,NW 320,RESIDENTIAL,18000,0,18000,63700,0,81700
142923000600000,NW 320,RESIDENTIAL,18000,0,18000,53100,0,71100
142923000700000,NW 320,RESIDENTIAL,18000,0,18000,45700,0,63700
142923000800000,NW 320,RESIDENTIAL,18000,0,18000,66700,0,84700
142923100100000,NW 320,RESIDENTIAL,22200,0,22200,75500,0,97700
142923100200000,NW 320,RESIDENTIAL,22300,0,22300,68800,0,91100
142923100300000,NW 320,RESIDENTIAL,18000,0,18000,77000,0,95000
142923100400000,NW 320,RESIDENTIAL,18000,0,18000,61400,0,79400
142923100500000,NW 320,RESIDENTIAL,17100,0,17100,68700,0,85800
142923100600000,NW 320,RESIDENTIAL,18000,0,18000,80600,0,98600
142923100700000,NW 320,RESIDENTIAL,18000,0,18000,53500,0,71500
142923100800000,NW 320,RESIDENTIAL,17100,0,17100,56100,0,73200
142923100900000,NW 320,RESIDENTIAL,18000,0,18000,57000,0,75000
142923101000000,NW 320,RESIDENTIAL,18000,0,18000,58800,0,76800
142923101100000,NW 320,RESIDENTIAL,17700,0,17700,54900,0,72600
142923101200000,NW 320,RESIDENTIAL,19200,0,19200,56700,0,75900
142923101300000,NW 320,RESIDENTIAL,17600,0,17600,61900,0,79500
142923101400000,NW 320,RESIDENTIAL,23100,0,23100,86900,0,110000
142923101500000,NW 320,RESIDENTIAL,14700,0,14700,58700,0,73400
142923101600000,NW 320,RESIDENTIAL,14400,0,14400,54700,0,69100
142923101700000,NW 320,RESIDENTIAL,19400,0,19400,80100,0,99500
142923101800000,NW 320,RESIDENTIAL,20200,0,20200,78500,0,98700
142923200100000,SMALL RETAIL,COMMERCIAL,0,12800,12800,0,38000,50800
142923200200000,VACANT LAND,COMMERCIAL,0,10700,10700,0,0,10700
142923200300000,SMALL RETAIL,COMMERCIAL,0,10500,10500,0,26700,37200
142923200600000,OFFICE,EXEMPT,0,37800,37800,0,150100,187900
142925100100000,NW 320,RESIDENTIAL,18000,0,18000,38900,0,56900
142925100200000,NW 320,RESIDENTIAL,18000,0,18000,93300,0,111300
142925100300000,NW 320,RESIDENTIAL,18000,0,18000,72900,0,90900
142925100400000,NW 320,RESIDENTIAL,22200,0,22200,79000,0,101200
142925100500000,NW 320,RESIDENTIAL,22700,0,22700,76600,0,99300
142925100600000,NW 320,RESIDENTIAL,21700,0,21700,63400,0,85100
142925100700000,NW 320,RESIDENTIAL,22100,0,22100,95900,0,118000
142925100800000,NW 320,RESIDENTIAL,18000,0,18000,55900,0,73900
142925200100000,NW 320,RESIDENTIAL,21700,0,21700,85700,0,107400
142925200200000,NW 320,RESIDENTIAL,22100,0,22100,101300,0,123400
142925200300000,NW 320,RESIDENTIAL,18000,0,18000,72800,0,90800
142925200400000,NW 320,RESIDENTIAL,18000,0,18000,91000,0,109000
142925200500000,NW 320,RESIDENTIAL,18000,0,18000,74700,0,92700
142925200600000,NW 320,RESIDENTIAL,18000,0,18000,77200,0,95200
142925200700000,NW 320,RESIDENTIAL,18000,0,18000,58200,0,76200
142925200800000,NW 320,RESIDENTIAL,18000,0,18000,66600,0,84600
142925200900000,NW 320,RESIDENTIAL,18000,0,18000,64500,0,82500
142925201000000,NW 320,RESIDENTIAL,18400,0,18400,41300,0,59700
142925201100000,NW 320,RESIDENTIAL,24500,0,24500,82200,0,106700
142925201200000,NW 320,RESIDENTIAL,22800,0,22800,60700,0,83500
142925201300000,NW 320,RESIDENTIAL,20900,0,20900,70800,0,91700
142925300100000,NW 320,RESIDENTIAL,23600,0,23600,65400,0,89000
142925300200000,OFFICE,COMMERCIAL,0,18400,18400,0,70600,89000
142925300300000,NW 320,RESIDENTIAL,23300,0,23300,51800,0,75100
142925300400000,NW 320,RESIDENTIAL,22500,0,22500,77100,0,99600
142925300500000,NW 320,RESIDENTIAL,23100,0,23100,72700,0,95800
142925300600000,NW 320,RESIDENTIAL,22500,0,22500,80500,0,103000
142925300700000,NW 320,RESIDENTIAL,22700,0,22700,74500,0,97200
142925300800000,NW 320,RESIDENTIAL,22700,0,22700,40000,0,62700
142925300900000,NW 320,RESIDENTIAL,22700,0,22700,69200,0,91900
142925301000000,NW 320,RESIDENTIAL,20300,0,20300,74700,0,95000
142925301100000,NW 320,RESIDENTIAL,22900,0,22900,89400,0,112300
142925301200000,NW 320,RESIDENTIAL,22900,0,22900,94600,0,117500
142925301300000,NW 320,RESIDENTIAL,23100,0,23100,60100,0,83200
142925301400000,NW 320,RESIDENTIAL,23100,0,23100,95300,0,118400
142925301500000,NW 320,RESIDENTIAL,23100,0,23100,55800,0,78900
142925301600000,NW 320,RESIDENTIAL,21400,0,21400,66300,0,87700
142925301700000,NW 320,RESIDENTIAL,21600,0,21600,79000,0,100600
142925301800000,NW 320,RESIDENTIAL,24000,0,24000,66900,0,90900
142925301900000,NW 320,RESIDENTIAL,23100,0,23100,90600,0,113700
142925302000000,NW 320,RESIDENTIAL,25800,0,25800,101400,0,127200
142925302100000,NW 320,RESIDENTIAL,48100,0,48100,104400,0,152500
142925302200000,NW 320,RESIDENTIAL,23400,0,23400,134300,0,157700
142925302300000,NW 320,RESIDENTIAL,23300,0,23300,93200,0,116500
142925302400000,NW 320,RESIDENTIAL,23700,0,23700,95800,0,119500
142925302500000,NW 320,RESIDENTIAL,23500,0,23500,111800,0,135300
142925302600000,NW 320,RESIDENTIAL,23300,0,23300,95700,0,119000
142925302700000,NW 320,RESIDENTIAL,23200,0,23200,86600,0,109800
142925302800000,NW 320,RESIDENTIAL,23200,0,23200,84800,0,108000
142925302900000,NW 320,RESIDENTIAL,22800,0,22800,99000,0,121800
142925303000000,NW 320,RESIDENTIAL,22600,0,22600,78900,0,101500
142925303100000,NW 320,RESIDENTIAL,22500,0,22500,89000,0,111500
142925303200000,NW 320,RESIDENTIAL,22700,0,22700,65800,0,88500
142925303300000,NW 320,RESIDENTIAL,22600,0,22600,102000,0,124600
142925303400000,NW 320,RESIDENTIAL,21400,0,21400,64900,0,86300
142925303500000,NW 320,RESIDENTIAL,21500,0,21500,41500,0,63000
142925303600000,NW 320,RESIDENTIAL,23100,0,23100,29600,0,52700
142925400100000,NW 320,RESIDENTIAL,19200,0,19200,41800,0,61000
142925400200000,NW 320,RESIDENTIAL,21800,0,21800,64900,0,86700
142925400300000,NW 320,RESIDENTIAL,20900,0,20900,65900,0,86800
142925400400000,NW 320,RESIDENTIAL,19400,0,19400,74600,0,94000
142925400500000,NW 320,RESIDENTIAL,18700,0,18700,64500,0,83200
142925400600000,NW 320,RESIDENTIAL,15600,0,15600,109000,0,124600
142925400700000,NW 320,RESIDENTIAL,16200,0,16200,57600,0,73800
142925400800000,NW 320,RESIDENTIAL,15600,0,15600,54900,0,70500
142925400900000,NW 320,RESIDENTIAL,21100,0,21100,97800,0,118900
142925401000000,NW 320,RESIDENTIAL,21600,0,21600,55800,0,77400
142925401100000,NW 320,RESIDENTIAL,15600,0,15600,66400,0,82000
142925401200000,NW 320,RESIDENTIAL,15000,0,15000,62700,0,77700
142925401300000,NW 320,RESIDENTIAL,14700,0,14700,73300,0,88000
142925401400000,NW 320,RESIDENTIAL,21400,0,21400,81000,0,102400
142925401500000,NW 320,RESIDENTIAL,12900,0,12900,76100,0,89000
142925401600000,NW 320,RESIDENTIAL,15200,0,15200,62700,0,77900
142925401700000,NW 320,RESIDENTIAL,21200,0,21200,80400,0,101600
142925401800000,NW 320,RESIDENTIAL,21500,0,21500,96400,0,117900
142925401900000,NW 320,RESIDENTIAL,19700,0,19700,73900,0,93600
142925402000000,NW 320,RESIDENTIAL,13700,0,13700,39100,0,52800
142925402100000,NW 320,RESIDENTIAL,14300,0,14300,82700,0,97000
142925402200000,NW 320,RESIDENTIAL,20000,0,20000,85800,0,105800
142925402300000,NW 320,RESIDENTIAL,15000,0,15000,77800,0,92800
142925402400000,NW 320,RESIDENTIAL,15700,0,15700,40400,0,56100
142925402500000,NW 320,RESIDENTIAL,21800,0,21800,74600,0,96400
142925402600000,NW 320,RESIDENTIAL,20400,0,20400,91200,0,111600
142925402700000,NW 320,RESIDENTIAL,20500,0,20500,85900,0,106400
142925402800000,NW 320,RESIDENTIAL,21200,0,21200,72300,0,93500
142925402900000,NW 320,RESIDENTIAL,20300,0,20300,66000,0,86300
142925403000000,NW 320,RESIDENTIAL,20300,0,20300,74300,0,94600
142925403100000,NW 320,RESIDENTIAL,15400,0,15400,53400,0,68800
142925500100000,NW 320,RESIDENTIAL,24000,0,24000,63400,0,87400
142925500200000,NW 320,RESIDENTIAL,22200,0,22200,82500,0,104700
142925500300000,NW 320,RESIDENTIAL,12600,0,12600,59800,0,72400
142925500400000,NW 320,RESIDENTIAL,21200,0,21200,69700,0,90900
142925500500000,NW 320,RESIDENTIAL,16900,0,16900,63500,0,80400
142925500600000,NW 320,RESIDENTIAL,25500,0,25500,86800,0,112300
142925500700000,NW 320,RESIDENTIAL,21100,0,21100,94100,0,115200
142925500800000,NW 320,RESIDENTIAL,21600,0,21600,103500,0,125100
142925500900000,NW 320,RESIDENTIAL,21600,0,21600,110900,0,132500
142925501000000,NW 320,RESIDENTIAL,19900,0,19900,82900,0,102800
142925501100000,NW 320,RESIDENTIAL,22000,0,22000,79600,0,101600
142925501200000,NW 320,RESIDENTIAL,21600,0,21600,97100,0,118700
142925501300000,NW 320,RESIDENTIAL,21500,0,21500,106900,0,128400
142925501400000,NW 320,RESIDENTIAL,23800,0,23800,64600,0,88400
142925501500000,NW 320,RESIDENTIAL,23500,0,23500,72300,0,95800
142925501600000,NW 320,RESIDENTIAL,22100,0,22100,76300,0,98400
142925501700000,NW 320,RESIDENTIAL,21800,0,21800,77800,0,99600
142925501800000,NW 320,RESIDENTIAL,20000,0,20000,80400,0,100400
142925501900000,NW 320,RESIDENTIAL,20300,0,20300,82200,0,102500
142925502000000,NW 320,RESIDENTIAL,20300,0,20300,58500,0,78800
142925502100000,NW 320,RESIDENTIAL,28400,0,28400,120300,0,148700
142925502200000,NW 320,RESIDENTIAL,15000,0,15000,61800,0,76800
142925502300000,NW 320,RESIDENTIAL,14700,0,14700,55200,0,69900
142925502400000,NW 320,RESIDENTIAL,20700,0,20700,93900,0,114600
142925502500000,NW 320,RESIDENTIAL,21500,0,21500,54400,0,75900
142925502600000,NW 320,RESIDENTIAL,18700,0,18700,65900,0,84600
142925502700000,NW 320,RESIDENTIAL,24300,0,24300,107500,0,131800
142925502800000,NW 320,RESIDENTIAL,21100,0,21100,89800,0,110900
142925502900000,NW 320,RESIDENTIAL,21100,0,21100,77400,0,98500
142925503000000,NW 320,RESIDENTIAL,21600,0,21600,103500,0,125100
142925503100000,NW 320,RESIDENTIAL,21800,0,21800,65500,0,87300
142925600100000,CITY PROPERTY,EXEMPT,0,0,0,0,0,0
142925700100000,CHURCH,EXEMPT,0,405000,405000,0,444800,849800
142925700400000,NW 320,RESIDENTIAL,30300,0,30300,139700,0,170000
142925700500000,OFFICE,COMMERCIAL,0,27000,27000,0,107100,134100
142925800100000,NW 320,RESIDENTIAL,20300,0,20300,89100,0,109400
142925800200000,NW 320,RESIDENTIAL,15900,0,15900,80400,0,96300
142925800300000,NW 320,RESIDENTIAL,13800,0,13800,90900,0,104700
142925800400000,NW 320,RESIDENTIAL,16200,0,16200,83500,0,99700
142925800500000,NW 320,RESIDENTIAL,21100,0,21100,106500,0,127600
142925800600000,NW 320,RESIDENTIAL,21100,0,21100,52100,0,73200
142925800700000,NW 320,RESIDENTIAL,21100,0,21100,67800,0,88900
142925800800000,NW 320,RESIDENTIAL,20100,0,20100,74600,0,94700
142925800900000,NW 320,RESIDENTIAL,9700,0,9700,52600,0,62300
142925801000000,NW 320,RESIDENTIAL,20000,0,20000,77400,0,97400
142925801100000,NW 320,RESIDENTIAL,20300,0,20300,81500,0,101800
142925801200000,NW 320,RESIDENTIAL,20300,0,20300,76900,0,97200
142925801300000,NW 320,RESIDENTIAL,20300,0,20300,82100,0,102400
142925801400000,NW 320,RESIDENTIAL,20300,0,20300,64100,0,84400
142925801500000,NW 320,RESIDENTIAL,20300,0,20300,72600,0,92900
142925801600000,NW 320,RESIDENTIAL,20300,0,20300,100000,0,120300
142925900100000,NW 320,RESIDENTIAL,20500,0,20500,76200,0,96700
142925900200000,NW 320,RESIDENTIAL,20000,0,20000,75300,0,95300
142925900300000,NW 320,RESIDENTIAL,20000,0,20000,67300,0,87300
142925900400000,NW 320,RESIDENTIAL,20000,0,20000,60600,0,80600
142925900500000,NW 320,RESIDENTIAL,20000,0,20000,61900,0,81900
142925900600000,NW 320,RESIDENTIAL,20000,0,20000,70300,0,90300
142925900700000,NW 320,RESIDENTIAL,19100,0,19100,55500,0,74600
142925900800000,NW 320,RESIDENTIAL,19900,0,19900,32800,0,52700
142925900900000,NW 320,RESIDENTIAL,16200,0,16200,50800,0,67000
142925901000000,NW 320,RESIDENTIAL,21000,0,21000,82600,0,103600
142925901100000,NW 320,RESIDENTIAL,20000,0,20000,103100,0,123100
142925901200000,NW 320,RESIDENTIAL,20000,0,20000,64300,0,84300
142925901300000,NW 320,RESIDENTIAL,20000,0,20000,67500,0,87500
142925901400000,NW 320,RESIDENTIAL,20000,0,20000,63100,0,83100
142925901500000,NW 320,RESIDENTIAL,20000,0,20000,82300,0,102300
142925901600000,NW 320,RESIDENTIAL,20000,0,20000,60400,0,80400
142925901700000,NW 320,RESIDENTIAL,20000,0,20000,77500,0,97500
142927600100000,NW 311,RESIDENTIAL,15600,0,15600,32900,0,48500
142927600200000,NW 311,RESIDENTIAL,16100,0,16100,71200,0,87300
142927600300000,NW 311,RESIDENTIAL,13700,0,13700,58300,0,72000
142927600400000,NW 311,RESIDENTIAL,19300,0,19300,90500,0,109800
142927600500000,NW 311,RESIDENTIAL,15800,0,15800,82100,0,97900
142927600600000,NW 311,RESIDENTIAL,16000,0,16000,82000,0,98000
142927600700000,NW 311,RESIDENTIAL,16400,0,16400,64900,0,81300
142927600800000,NW 311,RESIDENTIAL,16300,0,16300,38100,0,54400
142927600900000,NW 311,RESIDENTIAL,18000,0,18000,99900,0,117900
142927601000000,NW 311,RESIDENTIAL,17700,0,17700,51600,0,69300
142927601100000,NW 311,RESIDENTIAL,16400,0,16400,49400,0,65800
142927601200000,NW 311,RESIDENTIAL,20000,0,20000,52300,0,72300
142927601300000,NW 311,RESIDENTIAL,20000,0,20000,57400,0,77400
142927601400000,NW 311,RESIDENTIAL,20000,0,20000,50100,0,70100
142927601500000,NW 311,RESIDENTIAL,20000,0,20000,54000,0,74000
142927601600000,NW 311,RESIDENTIAL,16000,0,16000,55000,0,71000
142927601700000,NW 311,RESIDENTIAL,16300,0,16300,61700,0,78000
142927601800000,NW 311,RESIDENTIAL,16300,0,16300,63900,0,80200
142927601900000,NW 311,RESIDENTIAL,16000,0,16000,71600,0,87600
142927602000000,NW 311,RESIDENTIAL,15900,0,15900,79000,0,94900
142927602100000,NW 311,RESIDENTIAL,15800,0,15800,56200,0,72000
142927602200000,NW 311,RESIDENTIAL,16400,0,16400,71300,0,87700
142927602300000,NW 311,RESIDENTIAL,14800,0,14800,59800,0,74600
142927700100000,NW 311,RESIDENTIAL,16400,0,16400,66300,0,82700
142927700200000,NW 311,RESIDENTIAL,15000,0,15000,63000,0,78000
142927700300000,NW 311,RESIDENTIAL,13800,0,13800,77600,0,91400
142927700400000,NW 311,RESIDENTIAL,14400,0,14400,56600,0,71000
142927700500000,NW 311,RESIDENTIAL,15200,0,15200,58300,0,73500
142927700600000,NW 311,RESIDENTIAL,14700,0,14700,79800,0,94500
142927700700000,NW 311,RESIDENTIAL,15500,0,15500,60800,0,76300
142927700800000,NW 311,RESIDENTIAL,15800,0,15800,53600,0,69400
142927700900000,NW 311,RESIDENTIAL,20000,0,20000,59500,0,79500
142927701000000,NW 311,RESIDENTIAL,20000,0,20000,73900,0,93900
142927701100000,NW 311,RESIDENTIAL,20000,0,20000,65800,0,85800
142927701200000,NW 311,RESIDENTIAL,20000,0,20000,74100,0,94100
142927701300000,NW 311,RESIDENTIAL,20500,0,20500,59600,0,80100
142927701400000,SR/NURSING/ASSTD LIV,MULTI-RES,77100,0,77100,1119100,0,1196200
142927701500000,NW 311,RESIDENTIAL,15700,0,15700,45200,0,60900
142927701600000,NW 311,RESIDENTIAL,12000,0,12000,44900,0,56900
142927701700000,NW 311,RESIDENTIAL,20000,0,20000,70600,0,90600
142927701800000,NW 311,RESIDENTIAL,21600,0,21600,85500,0,107100
142927701900000,NW 311,RESIDENTIAL,18000,0,18000,69400,0,87400
142927702000000,NW 311,RESIDENTIAL,16300,0,16300,59900,0,76200
142927702100000,NW 311,RESIDENTIAL,16300,0,16300,102500,0,118800
142927702200000,NW 311,RESIDENTIAL,16300,0,16300,84800,0,101100
142927702300000,NW 311,RESIDENTIAL,16100,0,16100,72400,0,88500
142927702400000,NW 311,RESIDENTIAL,16100,0,16100,69400,0,85500
142927702500000,NW 311,RESIDENTIAL,14000,0,14000,61800,0,75800
142927800100000,NW 320,RESIDENTIAL,18000,0,18000,64300,0,82300
142927800200000,NW 320,RESIDENTIAL,18000,0,18000,64400,0,82400
142927800300000,NW 320,RESIDENTIAL,18000,0,18000,54700,0,72700
142927800400000,NW 320,RESIDENTIAL,18000,0,18000,26000,0,44000
142927800500000,NW 320,RESIDENTIAL,18000,0,18000,27000,0,45000
142927800600000,NW 320,RESIDENTIAL,18000,0,18000,82600,0,100600
142927800700000,NW 320,RESIDENTIAL,18000,0,18000,45500,0,63500
142927800800000,NW 320,RESIDENTIAL,18000,0,18000,77900,0,95900
142927800900000,NW 320,RESIDENTIAL,18000,0,18000,52200,0,70200
142927801000000,NW 320,RESIDENTIAL,18000,0,18000,41400,0,59400
142927801100000,NW 320,RESIDENTIAL,18000,0,18000,48700,0,66700
142927801200000,NW 320,RESIDENTIAL,15800,0,15800,39900,0,55700
142927801300000,NW 320,RESIDENTIAL,18000,0,18000,58100,0,76100
142927801400000,NW 320,RESIDENTIAL,15200,0,15200,79700,0,94900
142927801500000,NW 320,RESIDENTIAL,17200,0,17200,72600,0,89800
142927801600000,NW 320,RESIDENTIAL,11500,0,11500,43700,0,55200
142927900100000,NW 320,RESIDENTIAL,25200,0,25200,105600,0,130800
142927900200000,NW 320,RESIDENTIAL,18000,0,18000,48800,0,66800
142927900300000,NW 320,RESIDENTIAL,18000,0,18000,46300,0,64300
142927900400000,NW 320,RESIDENTIAL,18000,0,18000,64800,0,82800
142927900500000,NW 320,RESIDENTIAL,18000,0,18000,78100,0,96100
142927900600000,NW 320,RESIDENTIAL,18000,0,18000,62000,0,80000
142927900700000,NW 320,RESIDENTIAL,18000,0,18000,47600,0,65600
142927900800000,NW 320,RESIDENTIAL,18000,0,18000,72300,0,90300
142927900900000,NW 320,RESIDENTIAL,18000,0,18000,57000,0,75000
142927901000000,NW 320,RESIDENTIAL,18000,0,18000,75500,0,93500
142927901100000,NW 320,RESIDENTIAL,17600,0,17600,42400,0,60000
142927901200000,NW 320,RESIDENTIAL,16200,0,16200,49100,0,65300
142927901300000,NW 320,RESIDENTIAL,18000,0,18000,37400,0,55400
142927901400000,NW 320,RESIDENTIAL,12600,0,12600,43300,0,55900
142927901500000,NW 320,RESIDENTIAL,12600,0,12600,66600,0,79200
142927901600000,NW 320,RESIDENTIAL,18000,0,18000,65600,0,83600
142927901700000,NW 320,RESIDENTIAL,18000,0,18000,75100,0,93100
142927901800000,NW 320,RESIDENTIAL,18000,0,18000,61200,0,79200
142927901900000,NW 320,RESIDENTIAL,15800,0,15800,77200,0,93000
142927902000000,NW 320,RESIDENTIAL,18000,0,18000,79100,0,97100
142927902100000,NW 320,RESIDENTIAL,18000,0,18000,72400,0,90400
142927902200000,NW 320,RESIDENTIAL,18000,0,18000,58500,0,76500
142927902300000,NW 320,RESIDENTIAL,18000,0,18000,70900,0,88900
142927902400000,NW 320,RESIDENTIAL,18000,0,18000,74900,0,92900
142927902500000,NW 320,RESIDENTIAL,18000,0,18000,59000,0,77000
142927902600000,NW 320,RESIDENTIAL,18000,0,18000,101100,0,119100
142927902700000,NW 320,RESIDENTIAL,18000,0,18000,20200,0,38200
142927902800000,NW 320,RESIDENTIAL,18000,0,18000,72200,0,90200
142927902900000,NW 320,RESIDENTIAL,18000,0,18000,51700,0,69700
142927903000000,NW 320,RESIDENTIAL,18000,0,18000,77700,0,95700
142928000100000,NW 320,RESIDENTIAL,18700,0,18700,33600,0,52300
142928000200000,NW 320,RESIDENTIAL,20400,0,20400,85000,0,105400
142928000300000,NW 320,RESIDENTIAL,17500,0,17500,73400,0,90900
142928000400000,NW 320,RESIDENTIAL,18000,0,18000,34000,0,52000
142928000500000,NW 320,RESIDENTIAL,18000,0,18000,77600,0,95600
142928000600000,NW 320,RESIDENTIAL,18000,0,18000,84000,0,102000
142928000700000,NW 320,RESIDENTIAL,18000,0,18000,85500,0,103500
142928000800000,NW 320,RESIDENTIAL,18000,0,18000,74600,0,92600
142928000900000,NW 320,RESIDENTIAL,18000,0,18000,64500,0,82500
142928001000000,NW 320,RESIDENTIAL,18000,0,18000,64900,0,82900
142928001100000,NW 320,RESIDENTIAL,25300,0,25300,104300,0,129600
142928001200000,NW 320,RESIDENTIAL,15300,0,15300,52300,0,67600
142928001300000,NW 320,RESIDENTIAL,19000,0,19000,71800,0,90800
142928001400000,NW 320,RESIDENTIAL,16100,0,16100,50900,0,67000
142928001500000,NW 320,RESIDENTIAL,20700,0,20700,88000,0,108700
142928001600000,NW 320,RESIDENTIAL,20300,0,20300,69100,0,89400
142928001700000,NW 320,RESIDENTIAL,20300,0,20300,91500,0,111800
142928001800000,NW 320,RESIDENTIAL,20300,0,20300,80300,0,100600
142928001900000,NW 320,RESIDENTIAL,20300,0,20300,81200,0,101500
142928002000000,NW 320,RESIDENTIAL,15000,0,15000,54700,0,69700
142928002100000,NW 320,RESIDENTIAL,15000,0,15000,70600,0,85600
142928002200000,NW 320,RESIDENTIAL,15000,0,15000,67700,0,82700
142928002300000,NW 320,RESIDENTIAL,18000,0,18000,78300,0,96300
142928002400000,NW 320,RESIDENTIAL,24800,0,24800,131000,0,155800
142928002500000,NW 320,RESIDENTIAL,20300,0,20300,81900,0,102200
142928002600000,NW 320,RESIDENTIAL,20300,0,20300,74000,0,94300
142928002700000,NW 320,RESIDENTIAL,22500,0,22500,101500,0,124000
142928002800000,NW 320,RESIDENTIAL,20300,0,20300,103400,0,123700
142928100100000,NW 311,RESIDENTIAL,20400,0,20400,73600,0,94000
142928100200000,NW 311,RESIDENTIAL,17600,0,17600,54600,0,72200
142928100300000,NW 311,RESIDENTIAL,17600,0,17600,127700,0,145300
142928100400000,NW 311,RESIDENTIAL,17600,0,17600,74900,0,92500
142928100500000,NW 311,RESIDENTIAL,24500,0,24500,126400,0,150900
142928100600000,NW 311,RESIDENTIAL,20400,0,20400,83400,0,103800
142928200100000,NW 311,RESIDENTIAL,17600,0,17600,74600,0,92200
142928200200000,NW 311,RESIDENTIAL,20400,0,20400,74100,0,94500
142928200300000,NW 311,RESIDENTIAL,16000,0,16000,62800,0,78800
142928200400000,NW 311,RESIDENTIAL,12000,0,12000,57900,0,69900
142928200500000,NW 311,RESIDENTIAL,10600,0,10600,57200,0,67800
142928200600000,NW 311,RESIDENTIAL,10600,0,10600,70500,0,81100
142928200700000,NW 311,RESIDENTIAL,21300,0,21300,77700,0,99000
142928200800000,NW 311,RESIDENTIAL,20400,0,20400,130100,0,150500
142928200900000,NW 311,RESIDENTIAL,20400,0,20400,104000,0,124400
142928201000000,NW 311,RESIDENTIAL,20400,0,20400,64800,0,85200
142928201100000,CONVERSION-NW/SW,MULTI-RES,38600,0,38600,96600,0,135200
142928201200000,NW 311,RESIDENTIAL,16300,0,16300,83900,0,100200
142928201300000,NW 311,RESIDENTIAL,17600,0,17600,77600,0,95200
142928201400000,NW 311,RESIDENTIAL,17600,0,17600,78100,0,95700
142928300100000,NW 320,RESIDENTIAL,27000,0,27000,50600,0,77600
142928300200000,NW 320,RESIDENTIAL,18000,0,18000,69300,0,87300
142928300300000,NW 320,RESIDENTIAL,22500,0,22500,91200,0,113700
142928300400000,NW 320,RESIDENTIAL,22500,0,22500,104000,0,126500
142928300500000,NW 320,RESIDENTIAL,22500,0,22500,85100,0,107600
142928300600000,NW 320,RESIDENTIAL,10400,0,10400,57000,0,67400
142928300700000,NW 320,RESIDENTIAL,11500,0,11500,46600,0,58100
142928300800000,NW 320,RESIDENTIAL,13400,0,13400,25200,0,38600
142928300900000,NW 320,RESIDENTIAL,13200,0,13200,42400,0,55600
142928301000000,NW 320,RESIDENTIAL,7300,0,7300,52000,0,59300
142928301100000,NW 320,RESIDENTIAL,7300,0,7300,43300,0,50600
142928301200000,NW 320,RESIDENTIAL,17100,0,17100,41600,0,58700
142928301300000,NW 320,RESIDENTIAL,31000,0,31000,81100,0,112100
142928301400000,NW 320,RESIDENTIAL,22500,0,22500,96000,0,118500
142928301500000,CONVERSION-NW/SW,MULTI-RES,20000,0,20000,56900,0,76900
142928301600000,NW 320,RESIDENTIAL,22500,0,22500,102400,0,124900
142928301700000,NW 320,RESIDENTIAL,27900,0,27900,116200,0,144100
142928301800000,CONVERSION-NW/SW,MULTI-RES,31700,0,31700,66300,0,98000
142928400100000,NW 320,RESIDENTIAL,27000,0,27000,95700,0,122700
142928400200000,NW 320,RESIDENTIAL,20300,0,20300,76900,0,97200
142928400300000,NW 320,RESIDENTIAL,20300,0,20300,68700,0,89000
142928400400000,NW 320,RESIDENTIAL,20300,0,20300,67100,0,87400
142928400500000,NW 320,RESIDENTIAL,20300,0,20300,72900,0,93200
142928400600000,NW 320,RESIDENTIAL,13400,0,13400,55400,0,68800
142928400700000,NW 320,RESIDENTIAL,20000,0,20000,64500,0,84500
142928400800000,NW 320,RESIDENTIAL,12000,0,12000,47300,0,59300
142928401200000,NW 320,RESIDENTIAL,15600,0,15600,31100,0,46700
142928401300000,NW 320,RESIDENTIAL,15800,0,15800,50200,0,66000
142928401400000,NW 320,RESIDENTIAL,20300,0,20300,65400,0,85700
142928401500000,NW 320,RESIDENTIAL,20300,0,20300,42700,0,63000
142928401600000,NW 320,RESIDENTIAL,20300,0,20300,76500,0,96800
142928401700000,NW 320,RESIDENTIAL,18700,0,18700,45700,0,64400
142928401800000,NW 320,RESIDENTIAL,12200,0,12200,46800,0,59000
142928401900000,NW 320,RESIDENTIAL,19600,0,19600,46500,0,66100
142928500100000,NW 311,RESIDENTIAL,20000,0,20000,84100,0,104100
142928500200000,FUNERAL HOME,COMMERCIAL,0,187900,187900,0,390500,578400
142928500300000,CITY PROPERTY,EXEMPT,0,0,0,0,0,0
142930100200000,SW 405,RESIDENTIAL,16000,0,16000,48800,0,64800
142930100300000,SW 405,RESIDENTIAL,16300,0,16300,57600,0,73900
142930100600000,SW 405,RESIDENTIAL,19300,0,19300,51300,0,70600
142930100700000,SW 405,RESIDENTIAL,20800,0,20800,60500,0,81300
142930101000000,SW 405,RESIDENTIAL,22300,0,22300,54600,0,76900
142930101100000,SW 405,RESIDENTIAL,22700,0,22700,69600,0,92300
142930101200000,SW 405,RESIDENTIAL,20300,0,20300,60200,0,80500
142930101300000,SW 405,RESIDENTIAL,18500,0,18500,75600,0,94100
142930101400000,SW 405,RESIDENTIAL,19300,0,19300,47200,0,66500
142930101500000,SW 405,RESIDENTIAL,21800,0,21800,71200,0,93000
142930200100000,SW 405,RESIDENTIAL,18500,0,18500,90200,0,108700
142930200200000,SW 405,RESIDENTIAL,18200,0,18200,80500,0,98700
142930200300000,SW 405,RESIDENTIAL,18200,0,18200,11700,0,29900
142930200400000,SW 405,RESIDENTIAL,23800,0,23800,71900,0,95700
142930200500000,SW 405,RESIDENTIAL,19200,0,19200,94200,0,113400
142930200600000,SW 405,RESIDENTIAL,19200,0,19200,91900,0,111100
142930200700000,SW 405,RESIDENTIAL,19200,0,19200,89300,0,108500
142930200900000,SW 405,RESIDENTIAL,20800,0,20800,82600,0,103400
142930201000000,SW 405,EXEMPT,0,19600,19600,0,0,19600
142930201100000,SW 405,RESIDENTIAL,20400,0,20400,60700,0,81100
142930201200000,SW 405,RESIDENTIAL,24000,0,24000,45600,0,69600
142930201300000,SW 405,RESIDENTIAL,17200,0,17200,55100,0,72300
142930201400000,SW 405,RESIDENTIAL,21500,0,21500,62400,0,83900
142930201500000,CONVERSION-NW/SW,MULTI-RES,21500,0,21500,28900,0,50400
142930201600000,SW 405,RESIDENTIAL,1500,0,1500,3300,0,4800
142930300100000,CHURCH,EXEMPT,0,6300,6300,0,0,6300
142930300200000,CHURCH,EXEMPT,0,357500,357500,0,810900,1168400
142930300300000,SW 405,RESIDENTIAL,23600,0,23600,101900,0,125500
142930300400000,SW 405,RESIDENTIAL,23000,0,23000,22700,0,45700
142930300600000,SW 405,RESIDENTIAL,19200,0,19200,81300,0,100500
142930300700000,SW 405,RESIDENTIAL,23000,0,23000,106100,0,129100
142930300800000,SW 405,RESIDENTIAL,23000,0,23000,80100,0,103100
142930300900000,SW 405,RESIDENTIAL,23000,0,23000,92100,0,115100
142930301100000,APARTMENT,MULTI-RES,18800,0,18800,109800,0,128600
142930400100000,SW 405,RESIDENTIAL,20600,0,20600,74700,0,95300
142930400200000,SW 405,RESIDENTIAL,20600,0,20600,78100,0,98700
142930400300000,SW 405,RESIDENTIAL,20600,0,20600,71900,0,92500
142930400400000,SW 405,RESIDENTIAL,20600,0,20600,94700,0,115300
142930400500000,SW 405,RESIDENTIAL,17200,0,17200,58400,0,75600
142930400600000,SW 405,RESIDENTIAL,17200,0,17200,79800,0,97000
142930400700000,VACANT LAND,EXEMPT,0,167300,167300,0,0,167300
142930500100000,SCHOOL,EXEMPT,0,505000,505000,0,1073200,1578200
142930500200000,SW 405,RESIDENTIAL,26700,0,26700,88800,0,115500
142930500300000,SW 405,RESIDENTIAL,25300,0,25300,119600,0,144900
142930500400000,SW 405,RESIDENTIAL,20700,0,20700,78800,0,99500
142930500500000,SW 405,RESIDENTIAL,20700,0,20700,78000,0,98700
142930500600000,SW 405,RESIDENTIAL,24900,0,24900,90600,0,115500
142930500700000,SW 405,RESIDENTIAL,20700,0,20700,83000,0,103700
142930500800000,SW 405,RESIDENTIAL,27300,0,27300,68500,0,95800
142930500900000,SW 405,RESIDENTIAL,26700,0,26700,108900,0,135600
142930600100000,CITY PROPERTY,EXEMPT,0,0,0,0,0,0
142932600100000,CITY PROPERTY,EXEMPT,0,0,0,0,0,0
142932600200000,SW 405,RESIDENTIAL,20200,0,20200,71000,0,91200
142932600300000,SW 405,RESIDENTIAL,20600,0,20600,111800,0,132400
142932600400000,SW 405,RESIDENTIAL,17900,0,17900,75300,0,93200
142932600500000,SW 405,RESIDENTIAL,17100,0,17100,61900,0,79000
142932600600000,SW 405,RESIDENTIAL,17100,0,17100,74900,0,92000
142932600700000,SW 405,RESIDENTIAL,17100,0,17100,90200,0,107300
142932600800000,SW 405,RESIDENTIAL,17100,0,17100,75000,0,92100
142932600900000,SW 405,RESIDENTIAL,17100,0,17100,69800,0,86900
142932601000000,SW 405,RESIDENTIAL,16300,0,16300,62800,0,79100
142932601100000,SW 405,RESIDENTIAL,16300,0,16300,70200,0,86500
142932601200000,SW 405,RESIDENTIAL,16300,0,16300,66500,0,82800
142932601300000,SW 405,RESIDENTIAL,16300,0,16300,63300,0,79600
142932601400000,SW 405,RESIDENTIAL,16300,0,16300,65000,0,81300
142932601500000,SW 405,RESIDENTIAL,18200,0,18200,121600,0,139800
142932700100000,SW 405,RESIDENTIAL,17500,0,17500,97900,0,115400
142932700200000,SW 405,RESIDENTIAL,19400,0,19400,105500,0,124900
142932700300000,SW 405,RESIDENTIAL,19400,0,19400,59100,0,78500
142932700400000,SW 405,RESIDENTIAL,19400,0,19400,54700,0,74100
142932700500000,SW 405,RESIDENTIAL,19400,0,19400,53600,0,73000
142932700600000,SW 405,RESIDENTIAL,23300,0,23300,78900,0,102200
142932700700000,SW 405,RESIDENTIAL,21300,0,21300,76000,0,97300
142932700800000,SW 405,RESIDENTIAL,20500,0,20500,72900,0,93400
142932700900000,SW 405,RESIDENTIAL,20000,0,20000,68100,0,88100
142932701000000,SW 405,RESIDENTIAL,19600,0,19600,63000,0,82600
142932701100000,SW 405,RESIDENTIAL,19400,0,19400,67200,0,86600
142932701200000,SW 405,RESIDENTIAL,19400,0,19400,79600,0,99000
142932701300000,SW 405,RESIDENTIAL,19400,0,19400,72500,0,91900
142932701400000,SW 405,RESIDENTIAL,19400,0,19400,66200,0,85600
142932701500000,SW 405,RESIDENTIAL,19600,0,19600,79400,0,99000
142932701600000,SW 405,RESIDENTIAL,18200,0,18200,79400,0,97600
142932701700000,SW 405,RESIDENTIAL,16300,0,16300,69300,0,85600
142932701800000,SW 405,RESIDENTIAL,16300,0,16300,68200,0,84500
142932701900000,SW 405,RESIDENTIAL,16300,0,16300,75700,0,92000
142932702000000,SW 405,RESIDENTIAL,16300,0,16300,73000,0,89300
142932702100000,SW 405,RESIDENTIAL,16300,0,16300,87100,0,103400
142932702200000,SW 405,RESIDENTIAL,17100,0,17100,89400,0,106500
142932702300000,SW 405,RESIDENTIAL,17100,0,17100,75900,0,93000
142932702400000,SW 405,RESIDENTIAL,17100,0,17100,68000,0,85100
142932702500000,SW 405,RESIDENTIAL,17100,0,17100,71900,0,89000
142932702600000,SW 405,RESIDENTIAL,17100,0,17100,68600,0,85700
142932702700000,SW 405,RESIDENTIAL,18400,0,18400,76500,0,94900
142932800100000,SW 405,RESIDENTIAL,23600,0,23600,71400,0,95000
142932900100000,SW 405,RESIDENTIAL,20500,0,20500,74300,0,94800
142932900200000,SW 405,RESIDENTIAL,19800,0,19800,94000,0,113800
142932900300000,SW 405,RESIDENTIAL,21200,0,21200,89100,0,110300
142932900400000,SW 405,RESIDENTIAL,19400,0,19400,66600,0,86000
142932900500000,SW 405,RESIDENTIAL,19600,0,19600,82500,0,102100
142932900600000,SW 405,RESIDENTIAL,19400,0,19400,69300,0,88700
142933000100000,SW 405,RESIDENTIAL,26200,0,26200,104900,0,131100
142933000200000,SW 405,RESIDENTIAL,28400,0,28400,115900,0,144300
142933000300000,SW 405,RESIDENTIAL,28500,0,28500,122000,0,150500
142933000400000,SW 405,RESIDENTIAL,25800,0,25800,90000,0,115800
142933000500000,SW 405,RESIDENTIAL,19500,0,19500,91600,0,111100
142933000600000,SW 405,RESIDENTIAL,27900,0,27900,101100,0,129000
142933000700000,SW 405,RESIDENTIAL,17600,0,17600,28000,0,45600
142933000800000,SW 405,RESIDENTIAL,17100,0,17100,57900,0,75000
142933000900000,SW 405,RESIDENTIAL,17100,0,17100,62700,0,79800
142933001000000,SW 405,RESIDENTIAL,23300,0,23300,87700,0,111000
142933001100000,SW 405,RESIDENTIAL,18000,0,18000,70200,0,88200
142933001200000,SW 405,RESIDENTIAL,20700,0,20700,86000,0,106700
142933001300000,SW 405,RESIDENTIAL,21100,0,21100,105100,0,126200
142933001400000,SW 405,RESIDENTIAL,23300,0,23300,89200,0,112500
142933001500000,SW 405,RESIDENTIAL,23300,0,23300,77200,0,100500
142933001600000,SW 405,RESIDENTIAL,21900,0,21900,74300,0,96200
142933001700000,SW 405,RESIDENTIAL,21900,0,21900,88200,0,110100
142933001800000,SW 405,RESIDENTIAL,23300,0,23300,107700,0,131000
142933001900000,SW 405,RESIDENTIAL,20300,0,20300,100300,0,120600
142933002000000,SW 405,RESIDENTIAL,25300,0,25300,97900,0,123200
142933002100000,SW 405,RESIDENTIAL,22300,0,22300,100000,0,122300
142933002200000,SW 405,RESIDENTIAL,23300,0,23300,74700,0,98000
142933002300000,SW 405,RESIDENTIAL,26200,0,26200,92800,0,119000
142933100100000,SW 405,RESIDENTIAL,15100,0,15100,67900,0,83000
142933100200000,SW 405,RESIDENTIAL,17700,0,17700,70300,0,88000
142933100300000,SW 405,RESIDENTIAL,20600,0,20600,60400,0,81000
142933100400000,SW 405,RESIDENTIAL,20600,0,20600,59100,0,79700
142933100500000,SW 405,RESIDENTIAL,20800,0,20800,77300,0,98100
142933100600000,SW 405,RESIDENTIAL,21400,0,21400,90300,0,111700
142933100700000,SW 405,RESIDENTIAL,21400,0,21400,77500,0,98900
142933100800000,SW 405,RESIDENTIAL,21800,0,21800,92500,0,114300
142933100900000,SW 405,RESIDENTIAL,21600,0,21600,88600,0,110200
142933101000000,SW 405,RESIDENTIAL,21800,0,21800,83000,0,104800
142933101100000,SW 405,RESIDENTIAL,21800,0,21800,92700,0,114500
142933101200000,SW 405,RESIDENTIAL,21800,0,21800,91800,0,113600
142933101300000,SW 405,RESIDENTIAL,19400,0,19400,52700,0,72100
142933101500000,SW 405,RESIDENTIAL,23600,0,23600,109300,0,132900
142933101600000,SW 405,RESIDENTIAL,16300,0,16300,65100,0,81400
142933101700000,SW 405,RESIDENTIAL,16300,0,16300,50500,0,66800
142933101800000,SW 405,RESIDENTIAL,18000,0,18000,71400,0,89400
142933101900000,SW 405,RESIDENTIAL,18000,0,18000,78100,0,96100
142933102200000,SW 405,RESIDENTIAL,23300,0,23300,64000,0,87300
142933102300000,SW 405,RESIDENTIAL,18000,0,18000,76600,0,94600
142933102400000,SW 405,RESIDENTIAL,15100,0,15100,65700,0,80800
142933102500000,SW 405,RESIDENTIAL,26900,0,26900,91100,0,118000
142933200100000,SW 405,RESIDENTIAL,22400,0,22400,90000,0,112400
142933200200000,SW 405,RESIDENTIAL,22200,0,22200,87900,0,110100
142933200300000,SW 405,RESIDENTIAL,20500,0,20500,85900,0,106400
142933200400000,SW 405,RESIDENTIAL,21200,0,21200,63900,0,85100
142933300100000,SW 405,RESIDENTIAL,24000,0,24000,92000,0,116000
142933300200000,SW 405,RESIDENTIAL,24100,0,24100,73200,0,97300
142933300300000,SW 405,RESIDENTIAL,24800,0,24800,86600,0,111400
142933300400000,SW 405,RESIDENTIAL,24800,0,24800,95800,0,120600
142933300500000,SW 405,RESIDENTIAL,25000,0,25000,88000,0,113000
142933300600000,SW 405,RESIDENTIAL,25000,0,25000,69400,0,94400
142933300700000,SW 405,RESIDENTIAL,25000,0,25000,75400,0,100400
142933300800000,SW 405,RESIDENTIAL,24200,0,24200,72000,0,96200
142933300900000,SW 405,RESIDENTIAL,12400,0,12400,61000,0,73400
142933301000000,SW 405,RESIDENTIAL,12400,0,12400,58400,0,70800
142933301100000,SW 405,RESIDENTIAL,20500,0,20500,67400,0,87900
142933301200000,SW 405,RESIDENTIAL,16300,0,16300,63600,0,79900
142933301300000,SW 405,RESIDENTIAL,18400,0,18400,112100,0,130500
142933301400000,SW 405,RESIDENTIAL,19400,0,19400,103600,0,123000
142933301500000,SW 405,RESIDENTIAL,19100,0,19100,85800,0,104900
142933301600000,SW 405,RESIDENTIAL,21400,0,21400,93900,0,115300
142933301700000,SW 405,RESIDENTIAL,21200,0,21200,80900,0,102100
142933301800000,SW 405,RESIDENTIAL,21200,0,21200,72300,0,93500
142933301900000,SW 405,RESIDENTIAL,21200,0,21200,73700,0,94900
142933302000000,SW 405,RESIDENTIAL,21200,0,21200,88900,0,110100
142933302100000,SW 405,RESIDENTIAL,21200,0,21200,77600,0,98800
142933302200000,SW 405,RESIDENTIAL,21200,0,21200,84000,0,105200
142933302300000,SW 405,RESIDENTIAL,20700,0,20700,98300,0,119000
142933302400000,SW 405,RESIDENTIAL,24600,0,24600,88800,0,113400
142933302500000,SW 405,RESIDENTIAL,23000,0,23000,84600,0,107600
142933302600000,SW 405,RESIDENTIAL,24000,0,24000,83100,0,107100
142933302700000,SW 405,RESIDENTIAL,21800,0,21800,92200,0,114000
142933400100000,SW 405,RESIDENTIAL,21200,0,21200,81400,0,102600
142933400200000,SW 405,RESIDENTIAL,20800,0,20800,107500,0,128300
142933400300000,SW 405,RESIDENTIAL,20800,0,20800,79100,0,99900
142933400400000,SW 405,RESIDENTIAL,20800,0,20800,86000,0,106800
142933400500000,SW 405,RESIDENTIAL,19600,0,19600,98900,0,118500
142935100100000,SW 405,RESIDENTIAL,21500,0,21500,46100,0,67600
142935100200000,SW 405,RESIDENTIAL,18200,0,18200,58000,0,76200
142935100300000,SW 405,RESIDENTIAL,19300,0,19300,52500,0,71800
142935100400000,SW 405,RESIDENTIAL,18200,0,18200,57900,0,76100
142935100500000,SW 405,RESIDENTIAL,19300,0,19300,61100,0,80400
142935100600000,SW 405,RESIDENTIAL,18200,0,18200,54600,0,72800
142935100700000,SW 405,RESIDENTIAL,19300,0,19300,64000,0,83300
142935100800000,SW 405,RESIDENTIAL,18200,0,18200,63100,0,81300
142935100900000,SW 405,RESIDENTIAL,19300,0,19300,65800,0,85100
142935101000000,SW 405,RESIDENTIAL,19700,0,19700,71300,0,91000
142935101100000,SW 405,RESIDENTIAL,20600,0,20600,57300,0,77900
142935101200000,SW 405,RESIDENTIAL,21400,0,21400,65200,0,86600
142935101300000,SW 405,RESIDENTIAL,19300,0,19300,59100,0,78400
142935101400000,SW 405,RESIDENTIAL,21600,0,21600,68700,0,90300
142935101500000,SW 405,RESIDENTIAL,20300,0,20300,58600,0,78900
142935101600000,SW 405,RESIDENTIAL,21200,0,21200,71200,0,92400
142935101700000,SW 405,RESIDENTIAL,21100,0,21100,74900,0,96000
142935101800000,SW 405,RESIDENTIAL,20400,0,20400,59600,0,80000
142935101900000,SW 405,RESIDENTIAL,20000,0,20000,87700,0,107700
142935102000000,SW 405,RESIDENTIAL,20900,0,20900,85000,0,105900
142935102100000,SW 405,RESIDENTIAL,20600,0,20600,60500,0,81100
142935102200000,SW 405,RESIDENTIAL,20600,0,20600,57200,0,77800
142935102300000,SW 405,RESIDENTIAL,20000,0,20000,58200,0,78200
142935102400000,SW 405,RESIDENTIAL,20000,0,20000,57600,0,77600
142935102500000,SW 405,RESIDENTIAL,20000,0,20000,58600,0,78600
142935102600000,SW 405,RESIDENTIAL,20000,0,20000,63400,0,83400
142935102700000,SW 405,RESIDENTIAL,20000,0,20000,50500,0,70500
142935102800000,SW 405,RESIDENTIAL,20700,0,20700,66600,0,87300
142935200100000,SW 405,RESIDENTIAL,20800,0,20800,74000,0,94800
142935200200000,SW 405,RESIDENTIAL,20700,0,20700,59100,0,79800
142935200300000,SW 405,RESIDENTIAL,20500,0,20500,58700,0,79200
142935200400000,SW 405,RESIDENTIAL,20900,0,20900,70700,0,91600
142935200500000,SW 405,RESIDENTIAL,20500,0,20500,63400,0,83900
142935200600000,SW 405,RESIDENTIAL,20200,0,20200,55900,0,76100
142935200700000,SW 405,RESIDENTIAL,20800,0,20800,56200,0,77000
142935200800000,SW 405,RESIDENTIAL,21200,0,21200,64300,0,85500
142935200900000,SW 405,RESIDENTIAL,20800,0,20800,59000,0,79800
142935201000000,SW 405,RESIDENTIAL,20200,0,20200,60100,0,80300
142935201100000,SW 405,RESIDENTIAL,21400,0,21400,65800,0,87200
142935201200000,SW 405,RESIDENTIAL,19900,0,19900,65100,0,85000
142935201300000,SW 405,RESIDENTIAL,21800,0,21800,50500,0,72300
142935201400000,SW 405,RESIDENTIAL,20500,0,20500,63000,0,83500
142935201500000,SW 405,RESIDENTIAL,23400,0,23400,50300,0,73700
142935201600000,SW 405,RESIDENTIAL,19700,0,19700,58100,0,77800
142935201700000,SW 405,RESIDENTIAL,20200,0,20200,62500,0,82700
142935201800000,SW 405,RESIDENTIAL,20000,0,20000,56100,0,76100
142935201900000,SW 405,RESIDENTIAL,20900,0,20900,60200,0,81100
142935300100000,SW 405,RESIDENTIAL,21100,0,21100,61700,0,82800
142935300200000,SW 405,RESIDENTIAL,19400,0,19400,58700,0,78100
142935300300000,SW 405,RESIDENTIAL,20600,0,20600,62700,0,83300
142935300400000,SW 405,RESIDENTIAL,19400,0,19400,57100,0,76500
142935300500000,SW 405,RESIDENTIAL,20600,0,20600,62900,0,83500
142935300600000,SW 405,RESIDENTIAL,19400,0,19400,59600,0,79000
142935300700000,SW 405,RESIDENTIAL,20600,0,20600,58400,0,79000
142935300800000,SW 405,RESIDENTIAL,19400,0,19400,58200,0,77600
142935300900000,SW 405,RESIDENTIAL,21000,0,21000,51900,0,72900
142935400100000,SW 405,RESIDENTIAL,22100,0,22100,59800,0,81900
142935400200000,SW 405,RESIDENTIAL,21100,0,21100,48200,0,69300
142935400300000,SW 405,RESIDENTIAL,21100,0,21100,59400,0,80500
142935400400000,SW 405,RESIDENTIAL,18800,0,18800,57200,0,76000
142935400500000,SW 405,RESIDENTIAL,19400,0,19400,78300,0,97700
142935400600000,SW 405,RESIDENTIAL,19400,0,19400,57700,0,77100
142935400700000,SW 405,RESIDENTIAL,21300,0,21300,60100,0,81400
142935400800000,SW 405,RESIDENTIAL,19400,0,19400,48400,0,67800
142935400900000,SW 405,RESIDENTIAL,19400,0,19400,54200,0,73600
142935401000000,SW 405,RESIDENTIAL,21300,0,21300,61600,0,82900
142935401100000,SW 405,RESIDENTIAL,19400,0,19400,88900,0,108300
142935401200000,SW 405,RESIDENTIAL,19400,0,19400,56000,0,75400
142935401300000,SW 405,RESIDENTIAL,18900,0,18900,74200,0,93100
142935401400000,SW 405,RESIDENTIAL,20800,0,20800,63400,0,84200
142935401500000,SW 405,RESIDENTIAL,21100,0,21100,59100,0,80200
142935401600000,SW 405,RESIDENTIAL,20500,0,20500,53400,0,73900
142935401700000,SW 405,RESIDENTIAL,18800,0,18800,63500,0,82300
142935401800000,SW 405,RESIDENTIAL,19400,0,19400,56700,0,76100
142935401900000,SW 405,RESIDENTIAL,19400,0,19400,68200,0,87600
142935402000000,SW 405,RESIDENTIAL,21300,0,21300,67400,0,88700
142935402100000,SW 405,RESIDENTIAL,19400,0,19400,59400,0,78800
142935402200000,SW 405,RESIDENTIAL,19400,0,19400,55100,0,74500
142935402300000,SW 405,RESIDENTIAL,21300,0,21300,66000,0,87300
142935402400000,SW 405,RESIDENTIAL,19400,0,19400,64000,0,83400
142935402500000,SW 405,RESIDENTIAL,19400,0,19400,57800,0,77200
142935402600000,SW 405,RESIDENTIAL,18900,0,18900,63300,0,82200
142935500100000,SW 405,RESIDENTIAL,22700,0,22700,65500,0,88200
142935500200000,SW 405,RESIDENTIAL,20400,0,20400,62900,0,83300
142935500300000,SW 405,RESIDENTIAL,19900,0,19900,87300,0,107200
142935500400000,SW 405,RESIDENTIAL,21800,0,21800,75300,0,97100
142935500500000,SW 405,RESIDENTIAL,20600,0,20600,57800,0,78400
142935500600000,SW 405,RESIDENTIAL,20600,0,20600,75300,0,95900
142935500700000,SW 405,RESIDENTIAL,20800,0,20800,74200,0,95000
142935500800000,SW 405,RESIDENTIAL,20800,0,20800,62500,0,83300
142935500900000,SW 405,RESIDENTIAL,21500,0,21500,56400,0,77900
142935501000000,SW 405,RESIDENTIAL,21300,0,21300,62900,0,84200
142935501100000,SW 405,RESIDENTIAL,20900,0,20900,59200,0,80100
142935501200000,SW 405,RESIDENTIAL,20500,0,20500,50900,0,71400
142935501300000,SW 405,RESIDENTIAL,20100,0,20100,53400,0,73500
142935501400000,SW 405,RESIDENTIAL,21100,0,21100,67500,0,88600
142935501500000,SW 405,RESIDENTIAL,18800,0,18800,71000,0,89800
142935501600000,SW 405,RESIDENTIAL,21500,0,21500,75700,0,97200
142935501700000,SW 405,RESIDENTIAL,19400,0,19400,103100,0,122500
142935501800000,SW 405,RESIDENTIAL,20800,0,20800,49000,0,69800
142935501900000,SW 405,RESIDENTIAL,20100,0,20100,63300,0,83400
142935502000000,SW 405,RESIDENTIAL,20000,0,20000,63100,0,83100
142935502100000,SW 405,RESIDENTIAL,20500,0,20500,62100,0,82600
142935502200000,SW 405,RESIDENTIAL,20900,0,20900,61500,0,82400
142935502300000,SW 405,RESIDENTIAL,21600,0,21600,66200,0,87800
142935502400000,SW 405,RESIDENTIAL,22000,0,22000,58900,0,80900
142935502500000,SW 405,RESIDENTIAL,20100,0,20100,61700,0,81800
142935502600000,SW 405,RESIDENTIAL,20000,0,20000,55600,0,75600
142935502700000,SW 405,RESIDENTIAL,21300,0,21300,55100,0,76400
142935502800000,SW 405,RESIDENTIAL,21200,0,21200,76200,0,97400
142935502900000,SW 405,RESIDENTIAL,23800,0,23800,57600,0,81400
142935503000000,SW 405,RESIDENTIAL,20300,0,20300,57400,0,77700
142935600100000,SW 405,RESIDENTIAL,21000,0,21000,84300,0,105300
142935600200000,SW 405,RESIDENTIAL,19400,0,19400,73500,0,92900
142935600300000,SW 405,RESIDENTIAL,20200,0,20200,73500,0,93700
142935600400000,SW 405,RESIDENTIAL,20200,0,20200,70400,0,90600
142935600500000,SW 405,RESIDENTIAL,20200,0,20200,68700,0,88900
142935600600000,SW 405,RESIDENTIAL,20200,0,20200,70900,0,91100
142935600700000,SW 405,RESIDENTIAL,20200,0,20200,78100,0,98300
142935600800000,SW 405,RESIDENTIAL,19400,0,19400,72200,0,91600
142935600900000,SW 405,RESIDENTIAL,21000,0,21000,60300,0,81300
142935700100000,SW 405,RESIDENTIAL,21400,0,21400,71700,0,93100
142935700200000,SW 405,RESIDENTIAL,20700,0,20700,80400,0,101100
142935700300000,SW 405,RESIDENTIAL,20500,0,20500,59000,0,79500
142935700400000,SW 405,RESIDENTIAL,20100,0,20100,58500,0,78600
142935700500000,SW 405,RESIDENTIAL,20700,0,20700,70600,0,91300
142935700600000,SW 405,RESIDENTIAL,20800,0,20800,55000,0,75800
142935700700000,SW 405,RESIDENTIAL,19800,0,19800,45800,0,65600
142935700800000,SW 405,RESIDENTIAL,19200,0,19200,74800,0,94000
142935700900000,SW 405,RESIDENTIAL,18400,0,18400,70000,0,88400
142935701000000,SW 405,RESIDENTIAL,18000,0,18000,81200,0,99200
142935701100000,SW 405,RESIDENTIAL,17800,0,17800,74800,0,92600
142935701200000,SW 405,RESIDENTIAL,18400,0,18400,81400,0,99800
142935701300000,SW 405,RESIDENTIAL,19000,0,19000,78700,0,97700
142935701400000,SW 405,RESIDENTIAL,19800,0,19800,79200,0,99000
142935701500000,SW 405,RESIDENTIAL,22000,0,22000,85900,0,107900
142935701600000,SW 405,RESIDENTIAL,18200,0,18200,79800,0,98000
142935701700000,SW 405,RESIDENTIAL,22000,0,22000,74800,0,96800
142935701800000,SW 405,RESIDENTIAL,21400,0,21400,81200,0,102600
142935701900000,SW 405,RESIDENTIAL,21500,0,21500,75400,0,96900
142935702000000,SW 405,RESIDENTIAL,20800,0,20800,89700,0,110500
142935702100000,SW 405,RESIDENTIAL,20500,0,20500,74900,0,95400
142935702200000,SW 405,RESIDENTIAL,17800,0,17800,85600,0,103400
142935702300000,SW 405,RESIDENTIAL,18000,0,18000,81300,0,99300
142935702400000,SW 405,RESIDENTIAL,18800,0,18800,69300,0,88100
142935702500000,SW 405,RESIDENTIAL,19200,0,19200,69400,0,88600
142935702600000,SW 405,RESIDENTIAL,20000,0,20000,68700,0,88700
142935702700000,SW 405,RESIDENTIAL,20600,0,20600,70900,0,91500
142935702800000,SW 405,RESIDENTIAL,21000,0,21000,80700,0,101700
142935702900000,SW 405,RESIDENTIAL,19600,0,19600,73600,0,93200
142935703000000,SW 405,RESIDENTIAL,21400,0,21400,50700,0,72100
142935703100000,SW 405,RESIDENTIAL,20800,0,20800,78600,0,99400
142935703200000,SW 405,RESIDENTIAL,21000,0,21000,76400,0,97400
142935703300000,SW 405,RESIDENTIAL,19800,0,19800,77100,0,96900
142935703400000,SW 405,RESIDENTIAL,21100,0,21100,71100,0,92200
142935800100000,SW 405,RESIDENTIAL,21100,0,21100,69200,0,90300
142935800200000,SW 405,RESIDENTIAL,18800,0,18800,73900,0,92700
142935800300000,SW 405,RESIDENTIAL,20000,0,20000,69400,0,89400
142935800400000,SW 405,RESIDENTIAL,20000,0,20000,69100,0,89100
142935800500000,SW 405,RESIDENTIAL,20000,0,20000,74500,0,94500
142935800600000,SW 405,RESIDENTIAL,20000,0,20000,85200,0,105200
142935800700000,SW 405,RESIDENTIAL,20000,0,20000,74400,0,94400
142935800800000,SW 405,RESIDENTIAL,20000,0,20000,76600,0,96600
142935800900000,SW 405,RESIDENTIAL,19800,0,19800,68500,0,88300
142935801000000,SW 405,RESIDENTIAL,19800,0,19800,78500,0,98300
142935801100000,SW 405,RESIDENTIAL,19800,0,19800,68900,0,88700
142935801200000,SW 405,RESIDENTIAL,19800,0,19800,74100,0,93900
142935801300000,SW 405,RESIDENTIAL,19800,0,19800,87100,0,106900
142935801400000,SW 405,RESIDENTIAL,20900,0,20900,77100,0,98000
142935801500000,SW 405,RESIDENTIAL,25700,0,25700,85700,0,111400
142935801600000,SW 405,RESIDENTIAL,18200,0,18200,69000,0,87200
142935801700000,SW 405,RESIDENTIAL,22000,0,22000,58100,0,80100
142935801800000,SW 405,RESIDENTIAL,21900,0,21900,75200,0,97100
142935801900000,SW 405,RESIDENTIAL,19800,0,19800,77200,0,97000
142935802000000,SW 405,RESIDENTIAL,19800,0,19800,73900,0,93700
142935802100000,SW 405,RESIDENTIAL,19800,0,19800,69400,0,89200
142935802200000,SW 405,RESIDENTIAL,19800,0,19800,74400,0,94200
142935802300000,SW 405,RESIDENTIAL,19800,0,19800,59000,0,78800
142935802400000,SW 405,RESIDENTIAL,19800,0,19800,69100,0,88900
142935802500000,SW 405,RESIDENTIAL,19800,0,19800,77000,0,96800
142935802600000,SW 405,RESIDENTIAL,19800,0,19800,71700,0,91500
142935802700000,SW 405,RESIDENTIAL,19800,0,19800,69800,0,89600
142935802800000,SW 405,RESIDENTIAL,19800,0,19800,76400,0,96200
142935802900000,SW 405,RESIDENTIAL,19800,0,19800,78900,0,98700
142935803000000,SW 405,RESIDENTIAL,19000,0,19000,69500,0,88500
142935803100000,SW 405,RESIDENTIAL,20900,0,20900,105600,0,126500
142935803200000,SW 405,RESIDENTIAL,18800,0,18800,82100,0,100900
142935803300000,SW 405,RESIDENTIAL,18500,0,18500,73400,0,91900
142935900100000,SW 405,RESIDENTIAL,21900,0,21900,60400,0,82300
142935900200000,SW 405,RESIDENTIAL,20600,0,20600,57800,0,78400
142935900300000,SW 405,RESIDENTIAL,18800,0,18800,74000,0,92800
142935900400000,SW 405,RESIDENTIAL,19200,0,19200,71300,0,90500
142935900500000,SW 405,RESIDENTIAL,19400,0,19400,68200,0,87600
142935900600000,SW 405,RESIDENTIAL,20000,0,20000,64000,0,84000
142935900700000,SW 405,RESIDENTIAL,18800,0,18800,85700,0,104500
142936000100000,SW 405,RESIDENTIAL,20400,0,20400,72900,0,93300
142936000200000,SW 405,RESIDENTIAL,20600,0,20600,71600,0,92200
142936000300000,SW 405,RESIDENTIAL,20600,0,20600,69900,0,90500
142936000400000,SW 405,RESIDENTIAL,19900,0,19900,88600,0,108500
142937600100000,CITY PROPERTY,EXEMPT,0,0,0,0,0,0
142937600200000,SCHOOL,EXEMPT,0,0,0,0,0,0
142937600202000,ANTENNAS/TOWERS(BLL),COMMERCIAL,0,0,0,0,102500,102500
142937600300000,CITY PROPERTY,EXEMPT,0,0,0,0,0,0
142937700100000,WAREHOUSE,COMMERCIAL,0,133800,133800,0,366200,500000
142937700200000,WAREHOUSE,COMMERCIAL,0,113400,113400,0,404300,517700
142937700300000,FLAT PARKING,COMMERCIAL,0,16900,16900,0,9900,26800
142937700400000,SHOP,COMMERCIAL,0,74900,74900,0,456500,531400
142937700500000,FLAT PARKING,COMMERCIAL,0,13100,13100,0,8300,21400
142937700600000,SHOP,COMMERCIAL,0,47500,47500,0,192800,240300
142937700700000,SHOP,COMMERCIAL,0,32300,32300,0,129400,161700
142937800100000,CENTRALLY ASSESSED,OTHER,0,0,0,0,0,0
142940100100000,SCHOOL,EXEMPT,0,0,0,0,0,0
142940100200000,CITY PROPERTY,EXEMPT,0,0,0,0,0,0
142940200100000,SW 403,RESIDENTIAL,15800,0,15800,57700,0,73500
142940200200000,SW 403,RESIDENTIAL,15800,0,15800,99100,0,114900
142940200300000,SW 403,RESIDENTIAL,15800,0,15800,45400,0,61200
142940200400000,SW 403,RESIDENTIAL,17000,0,17000,45300,0,62300
142940200500000,SW 403,RESIDENTIAL,12600,0,12600,50700,0,63300
142940200600000,CITY PROPERTY,EXEMPT,0,0,0,0,0,0
142940200700000,SW 403,RESIDENTIAL,5000,0,5000,0,0,5000
142940200800000,SW 403,RESIDENTIAL,18400,0,18400,67900,0,86300
142940200900000,SW 403,RESIDENTIAL,13800,0,13800,59100,0,72900
142940201000000,SW 403,RESIDENTIAL,11800,0,11800,75400,0,87200
142940201100000,SW 403,RESIDENTIAL,11800,0,11800,35800,0,47600
142940201200000,SW 403,RESIDENTIAL,11800,0,11800,0,0,11800
142940201300000,SW 403,RESIDENTIAL,18900,0,18900,67700,0,86600
142940201400000,SW 403,RESIDENTIAL,14400,0,14400,72400,0,86800
142940201500000,SW 403,RESIDENTIAL,17800,0,17800,58600,0,76400
142940201600000,SW 403,RESIDENTIAL,18900,0,18900,121400,0,140300
142940201700000,SW 403,RESIDENTIAL,15800,0,15800,71500,0,87300
142940201800000,SW 403,RESIDENTIAL,15800,0,15800,23400,0,39200
142940201900000,SW 403,RESIDENTIAL,18900,0,18900,54500,0,73400
142940300100000,SW 403,RESIDENTIAL,16100,0,16100,69600,0,85700
142940300200000,SW 403,RESIDENTIAL,16100,0,16100,48900,0,65000
142940300300000,SW 403,RESIDENTIAL,19300,0,19300,109800,0,129100
142940300400000,SW 403,RESIDENTIAL,17500,0,17500,116900,0,134400
142940300500000,SW 403,RESIDENTIAL,18900,0,18900,125200,0,144100
142940300600000,SW 403,RESIDENTIAL,17700,0,17700,121800,0,139500
142940300700000,SW 403,RESIDENTIAL,17700,0,17700,51500,0,69200
142940300800000,SW 403,RESIDENTIAL,17700,0,17700,58300,0,76000
142940300900000,SW 403,RESIDENTIAL,17700,0,17700,47200,0,64900
142940301000000,CONVERSION-NW/SW,MULTI-RES,16500,0,16500,33700,0,50200
142940301100000,SW 403,RESIDENTIAL,16600,0,16600,23900,0,40500
142940301200000,SW 403,RESIDENTIAL,17300,0,17300,45000,0,62300
142940301300000,SW 403,RESIDENTIAL,18100,0,18100,53700,0,71800
142940301400000,SW 403,RESIDENTIAL,17700,0,17700,63900,0,81600
142940301500000,SW 403,RESIDENTIAL,18500,0,18500,76200,0,94700
142940400100000,SW 403,RESIDENTIAL,16700,0,16700,106800,0,123500
142940400200000,SW 403,RESIDENTIAL,11000,0,11000,33100,0,44100
142940400300000,SW 403,RESIDENTIAL,16500,0,16500,87100,0,103600
142940400400000,SW 403,RESIDENTIAL,17700,0,17700,52500,0,70200
142940400500000,SW 403,RESIDENTIAL,15000,0,15000,48800,0,63800
142940400600000,SW 403,RESIDENTIAL,14200,0,14200,56100,0,70300
142940400700000,SW 403,RESIDENTIAL,13400,0,13400,46300,0,59700
142940400800000,SW 403,RESIDENTIAL,14600,0,14600,43300,0,57900
142940400900000,SW 403,RESIDENTIAL,14900,0,14900,74100,0,89000
142940401000000,SMALL RETAIL,COMMERCIAL,0,72200,72200,0,165300,237500
142940401100000,SW 403,RESIDENTIAL,12600,0,12600,71100,0,83700
142940401200000,CITY PROPERTY,EXEMPT,0,0,0,0,0,0
142940401300000,SW 403,RESIDENTIAL,8300,0,8300,0,0,8300
142940500100000,SW 403,RESIDENTIAL,16900,0,16900,64400,0,81300
142940500200000,SW 403,RESIDENTIAL,10500,0,10500,46400,0,56900
142940500300000,SW 403,RESIDENTIAL,18200,0,18200,63800,0,82000
142940500400000,SW 403,RESIDENTIAL,16000,0,16000,103900,0,119900
142940500500000,SW 403,RESIDENTIAL,15800,0,15800,76400,0,92200
142940500600000,SW 403,RESIDENTIAL,17400,0,17400,64900,0,82300
142940500700000,SW 403,RESIDENTIAL,17700,0,17700,114500,0,132200
142940500800000,SW 403,RESIDENTIAL,14800,0,14800,73100,0,87900
142940500900000,CHURCH,EXEMPT,0,11900,11900,0,20600,32500
142940501000000,SW 403,RESIDENTIAL,18900,0,18900,43500,0,62400
142940501100000,SW 403,RESIDENTIAL,16300,0,16300,69600,0,85900
142940501200000,SW 403,RESIDENTIAL,16100,0,16100,121200,0,137300
142940501300000,SW 403,RESIDENTIAL,11800,0,11800,119300,0,131100
142940501400000,SW 403,RESIDENTIAL,14100,0,14100,49200,0,63300
142940600100000,SW 403,RESIDENTIAL,17000,0,17000,42700,0,59700
142940600200000,SW 403,RESIDENTIAL,12100,0,12100,44100,0,56200
142940600300000,SW 403,RESIDENTIAL,12100,0,12100,34700,0,46800
142940600400000,SW 403,RESIDENTIAL,9200,0,9200,57000,0,66200
142940600500000,SW 403,RESIDENTIAL,9200,0,9200,42900,0,52100
142940600600000,SW 403,RESIDENTIAL,8800,0,8800,55700,0,64500
142940600700000,SW 403,RESIDENTIAL,8800,0,8800,57900,0,66700
142940600800000,SW 403,RESIDENTIAL,15800,0,15800,33700,0,49500
142940600900000,SW 403,RESIDENTIAL,16500,0,16500,63700,0,80200
142940601000000,SW 403,RESIDENTIAL,16500,0,16500,62700,0,79200
142940601100000,SW 403,RESIDENTIAL,10900,0,10900,36700,0,47600
142940601200000,SW 403,RESIDENTIAL,9700,0,9700,34800,0,44500
142940601300000,SW 403,RESIDENTIAL,9700,0,9700,37400,0,47100
142940601400000,SW 403,RESIDENTIAL,10900,0,10900,47900,0,58800
142940601500000,SW 403,RESIDENTIAL,8600,0,8600,44700,0,53300
142940601600000,SW 403,RESIDENTIAL,5000,0,5000,0,0,5000
142940601700000,SW 403,RESIDENTIAL,8600,0,8600,35000,0,43600
142940601800000,SW 403,RESIDENTIAL,8600,0,8600,52800,0,61400
142940601900000,SW 403,RESIDENTIAL,14600,0,14600,54200,0,68800
142940602000000,SW 403,RESIDENTIAL,13800,0,13800,59800,0,73600
142940602100000,SW 403,RESIDENTIAL,14200,0,14200,65100,0,79300
142940602200000,SW 403,RESIDENTIAL,11100,0,11100,41500,0,52600
142940700500000,SW 403,RESIDENTIAL,19500,0,19500,117200,0,136700
142940700600000,SW 403,RESIDENTIAL,17000,0,17000,68100,0,85100
142940700700000,SW 403,RESIDENTIAL,13800,0,13800,78600,0,92400
142940701000000,CITY PROPERTY,EXEMPT,0,0,0,0,0,0
142940701100000,SW 403,RESIDENTIAL,19500,0,19500,65100,0,84600
142940701200000,NBHD SHOPPING CENTER,COMMERCIAL,0,158800,158800,0,574200,733000
142940701300000,SW 403,RESIDENTIAL,22400,0,22400,66700,0,89100
142940800100000,SW 403,RESIDENTIAL,19500,0,19500,65800,0,85300
142940800200000,SW 403,RESIDENTIAL,16300,0,16300,31600,0,47900
142940800300000,SW 403,RESIDENTIAL,16300,0,16300,0,0,16300
142940800400000,SW 403,RESIDENTIAL,13000,0,13000,49000,0,62000
142940800500000,SW 403,RESIDENTIAL,13000,0,13000,67600,0,80600
142940800600000,SW 403,RESIDENTIAL,3300,0,3300,8800,0,12100
142940800700000,CITY PROPERTY,EXEMPT,0,0,0,0,0,0
142940800800000,CITY PROPERTY,EXEMPT,0,0,0,0,0,0
142940800900000,SW 403,RESIDENTIAL,15000,0,15000,73200,0,88200
142940801000000,SW 403,RESIDENTIAL,12300,0,12300,57800,0,70100
142940801100000,SW 403,RESIDENTIAL,12300,0,12300,70100,0,82400
142940801200000,SW 403,RESIDENTIAL,17700,0,17700,69100,0,86800
142940801300000,SW 403,RESIDENTIAL,17700,0,17700,65300,0,83000
142940801400000,SW 403,RESIDENTIAL,20500,0,20500,70100,0,90600
142940801500000,SW 403,RESIDENTIAL,15800,0,15800,46600,0,62400
142940900100000,SW 403,RESIDENTIAL,17700,0,17700,44100,0,61800
142940900200000,SW 403,RESIDENTIAL,9500,0,9500,39500,0,49000
142940900300000,SW 403,RESIDENTIAL,17100,0,17100,59500,0,76600
142940900400000,SW 403,RESIDENTIAL,13000,0,13000,60400,0,73400
142940900500000,SW 403,RESIDENTIAL,13400,0,13400,61000,0,74400
142940900600000,SW 403,RESIDENTIAL,13400,0,13400,68200,0,81600
142940900700000,SW 403,RESIDENTIAL,17700,0,17700,63600,0,81300
142940900800000,SW 403,RESIDENTIAL,17700,0,17700,40500,0,58200
142940900900000,SW 403,RESIDENTIAL,11000,0,11000,65800,0,76800
142940901000000,SW 403,RESIDENTIAL,9800,0,9800,53900,0,63700
142940901100000,SW 403,RESIDENTIAL,13300,0,13300,62100,0,75400
142940901200000,SW 403,RESIDENTIAL,15800,0,15800,45100,0,60900
142940901300000,SW 403,RESIDENTIAL,17700,0,17700,61700,0,79400
142940901400000,SW 403,RESIDENTIAL,12800,0,12800,24900,0,37700
142940901500000,SW 403,RESIDENTIAL,12800,0,12800,58500,0,71300
142941000100000,SW 403,RESIDENTIAL,21600,0,21600,104300,0,125900
142941000200000,SW 403,RESIDENTIAL,11000,0,11000,42700,0,53700
142941000300000,SW 403,RESIDENTIAL,16600,0,16600,41700,0,58300
142941000400000,SW 403,RESIDENTIAL,16900,0,16900,73500,0,90400
142941000500000,SW 404,RESIDENTIAL,0,0,0,0,0,0
142941000600000,SW 403,RESIDENTIAL,14800,0,14800,60700,0,75500
142941000700000,SW 403,RESIDENTIAL,14400,0,14400,45000,0,59400
142941000800000,SW 403,RESIDENTIAL,16200,0,16200,37400,0,53600
142941000900000,SW 403,RESIDENTIAL,14000,0,14000,64600,0,78600
142941001000000,SW 403,RESIDENTIAL,14000,0,14000,48300,0,62300
142941001100000,SW 403,RESIDENTIAL,14400,0,14400,46000,0,60400
142941001200000,COUNTY PROPERTY,EXEMPT,0,0,0,0,0,0
142941001300000,SW 403,RESIDENTIAL,14000,0,14000,65800,0,79800
142941001400000,SW 403,RESIDENTIAL,14000,0,14000,60800,0,74800
142941001500000,SW 403,RESIDENTIAL,12000,0,12000,46800,0,58800
142941100200000,SW 403,RESIDENTIAL,20200,0,20200,0,0,20200
142941100300000,SW 403,RESIDENTIAL,13200,0,13200,57600,0,70800
142941100600000,SW 403,RESIDENTIAL,13200,0,13200,58400,0,71600
142941100700000,SW 403,RESIDENTIAL,13400,0,13400,78100,0,91500
142941100800000,SW 403,RESIDENTIAL,13400,0,13400,61100,0,74500
142941100900000,SW 403,RESIDENTIAL,12300,0,12300,50200,0,62500
142941101100000,SW 403,RESIDENTIAL,17400,0,17400,57900,0,75300
142941101200000,SW 403,RESIDENTIAL,26400,0,26400,0,0,26400
142941200100000,SW 403,RESIDENTIAL,19200,0,19200,49100,0,68300
142941200200000,SW 403,RESIDENTIAL,10500,0,10500,68300,0,78800
142941200300000,SW 403,RESIDENTIAL,11700,0,11700,52800,0,64500
142941200400000,SW 403,RESIDENTIAL,12000,0,12000,54400,0,66400
142941200500000,SW 403,RESIDENTIAL,12000,0,12000,55300,0,67300
142941200600000,SW 403,RESIDENTIAL,12000,0,12000,45600,0,57600
142941200700000,SW 403,RESIDENTIAL,15800,0,15800,47900,0,63700
142941201000000,SW 403,RESIDENTIAL,18400,0,18400,38800,0,57200
142941201100000,SW 403,RESIDENTIAL,16400,0,16400,92100,0,108500
142941300100000,SW 403,RESIDENTIAL,17700,0,17700,58200,0,75900
142941300200000,SMALL RETAIL,COMMERCIAL,0,15100,15100,0,36300,51400
142941300300000,SW 403,RESIDENTIAL,16500,0,16500,39200,0,55700
142941300400000,SW 403,RESIDENTIAL,15800,0,15800,59900,0,75700
142941300500000,SW 403,RESIDENTIAL,15000,0,15000,51500,0,66500
142941300600000,SW 403,RESIDENTIAL,18400,0,18400,44500,0,62900
142941300700000,SW 403,RESIDENTIAL,15800,0,15800,45100,0,60900
142942600300000,SW 403,RESIDENTIAL,12900,0,12900,32000,0,44900
142942600400000,SW 403,RESIDENTIAL,15800,0,15800,48500,0,64300
142942600500000,SW 403,RESIDENTIAL,17700,0,17700,65600,0,83300
142942600600000,SW 403,RESIDENTIAL,15800,0,15800,55200,0,71000
142942600700000,SW 403,RESIDENTIAL,15800,0,15800,46500,0,62300
142942600800000,APARTMENT,MULTI-RES,11200,0,11200,96900,0,108100
142942600900000,SW 403,RESIDENTIAL,15800,0,15800,63000,0,78800
142942601000000,SW 403,RESIDENTIAL,15800,0,15800,41400,0,57200
142942601100000,SW 403,RESIDENTIAL,15800,0,15800,64300,0,80100
142942601200000,SW 403,RESIDENTIAL,15800,0,15800,56500,0,72300
142942601300000,SW 403,RESIDENTIAL,15800,0,15800,121200,0,137000
142942601400000,SW 403,RESIDENTIAL,15800,0,15800,49400,0,65200
142942601500000,SW 403,RESIDENTIAL,15800,0,15800,59500,0,75300
142942601600000,SW 403,RESIDENTIAL,15800,0,15800,54500,0,70300
142942601700000,SW 403,RESIDENTIAL,15800,0,15800,43100,0,58900
142942601800000,SW 403,RESIDENTIAL,15800,0,15800,50400,0,66200
142942601900000,SW 403,RESIDENTIAL,15900,0,15900,34300,0,50200
142942602000000,OFFICE,COMMERCIAL,0,37400,37400,0,87100,124500
142942700200000,CENTRALLY ASSESSED,OTHER,0,0,0,0,0,0
142942700300000,VACANT LAND,COMMERCIAL,0,67600,67600,0,0,67600
142942700302000,WAREHOUSE,COMMERCIAL,0,0,0,0,110200,110200
142942700400000,WAREHOUSE,COMMERCIAL,0,108800,108800,0,180000,288800
142942700500000,CENTRALLY ASSESSED,OTHER,0,0,0,0,0,0
142942800100000,SMALL RETAIL,COMMERCIAL,0,111300,111300,0,38700,150000
142942800200000,SW 405,RESIDENTIAL,21600,0,21600,88900,0,110500
142942800300000,SW 405,RESIDENTIAL,17100,0,17100,60100,0,77200
142942800400000,SW 405,RESIDENTIAL,11800,0,11800,61700,0,73500
142942800500000,SW 405,RESIDENTIAL,18300,0,18300,84900,0,103200
142942800600000,SW 405,RESIDENTIAL,14800,0,14800,72300,0,87100
142942800700000,SW 405,RESIDENTIAL,17200,0,17200,69100,0,86300
142942800800000,SW 405,RESIDENTIAL,22700,0,22700,85800,0,108500
142942800900000,SW 405,RESIDENTIAL,22700,0,22700,70300,0,93000
142942801000000,SW 405,RESIDENTIAL,22700,0,22700,36300,0,59000
142942801100000,SW 405,RESIDENTIAL,22700,0,22700,54700,0,77400
142942801200000,SW 405,RESIDENTIAL,22700,0,22700,56600,0,79300
142942801300000,SW 405,RESIDENTIAL,22700,0,22700,50300,0,73000
142942801400000,SW 405,RESIDENTIAL,22700,0,22700,81000,0,103700
142942801500000,SW 405,RESIDENTIAL,22700,0,22700,68700,0,91400
142942801600000,SW 405,RESIDENTIAL,23200,0,23200,29000,0,52200
142942801700000,SW 405,RESIDENTIAL,13200,0,13200,55000,0,68200
142942801800000,SW 405,RESIDENTIAL,13900,0,13900,34800,0,48700
142942801900000,SW 405,RESIDENTIAL,14000,0,14000,0,0,14000
142942802000000,SW 405,RESIDENTIAL,21800,0,21800,34700,0,56500
142942802100000,SW 405,RESIDENTIAL,22400,0,22400,121500,0,143900
142942802200000,SW 405,RESIDENTIAL,21000,0,21000,0,0,21000
142942900100000,SW 405,RESIDENTIAL,22700,0,22700,69400,0,92100
142942900200000,SW 405,RESIDENTIAL,22700,0,22700,60500,0,83200
142942900300000,SW 405,RESIDENTIAL,22200,0,22200,43800,0,66000
142942900400000,SW 405,RESIDENTIAL,21900,0,21900,96300,0,118200
142942900500000,SW 405,RESIDENTIAL,15300,0,15300,91900,0,107200
142942900600000,SW 405,RESIDENTIAL,21500,0,21500,65800,0,87300
142942900700000,SW 405,RESIDENTIAL,21500,0,21500,48200,0,69700
142942900800000,SW 405,RESIDENTIAL,21500,0,21500,51900,0,73400
142942900900000,SW 405,RESIDENTIAL,21500,0,21500,79300,0,100800
142942901000000,SW 405,RESIDENTIAL,21500,0,21500,54600,0,76100
142942901100000,SW 405,RESIDENTIAL,21500,0,21500,81000,0,102500
142942901200000,SW 405,RESIDENTIAL,21500,0,21500,49400,0,70900
142942901300000,SW 405,RESIDENTIAL,21500,0,21500,74600,0,96100
142942901400000,SW 405,RESIDENTIAL,20000,0,20000,108900,0,128900
142942901500000,SW 405,RESIDENTIAL,26400,0,26400,74300,0,100700
142942901600000,SW 405,RESIDENTIAL,22000,0,22000,49400,0,71400
142942901700000,SW 405,RESIDENTIAL,21300,0,21300,56000,0,77300
142942901800000,SW 405,RESIDENTIAL,21300,0,21300,59800,0,81100
142942901900000,SW 405,RESIDENTIAL,21300,0,21300,53300,0,74600
142942902000000,SW 405,RESIDENTIAL,21300,0,21300,38200,0,59500
142942902100000,SW 405,RESIDENTIAL,24300,0,24300,88000,0,112300
142942902200000,SW 405,RESIDENTIAL,21300,0,21300,59400,0,80700
142943000200000,SW 405,RESIDENTIAL,21500,0,21500,50900,0,72400
142943000300000,SW 405,RESIDENTIAL,21500,0,21500,62300,0,83800
142943000400000,SW 405,RESIDENTIAL,21500,0,21500,77400,0,98900
142943000500000,SW 405,RESIDENTIAL,21500,0,21500,72800,0,94300
142943000600000,SW 405,RESIDENTIAL,21500,0,21500,58800,0,80300
142943000700000,SW 405,RESIDENTIAL,21500,0,21500,58600,0,80100
142943000800000,SW 405,RESIDENTIAL,20000,0,20000,75500,0,95500
142943000900000,CHURCH,EXEMPT,0,150000,150000,0,527600,677600
142943100100000,SW 403,RESIDENTIAL,20300,0,20300,59900,0,80200
142943100200000,SW 403,RESIDENTIAL,16500,0,16500,61500,0,78000
142943100300000,SW 403,RESIDENTIAL,16500,0,16500,42300,0,58800
142943100400000,SW 403,RESIDENTIAL,16500,0,16500,41300,0,57800
142943100500000,SW 403,RESIDENTIAL,16500,0,16500,68200,0,84700
142943100600000,SW 403,RESIDENTIAL,16500,0,16500,72800,0,89300
142943100700000,SW 403,RESIDENTIAL,12400,0,12400,29300,0,41700
142943100800000,SW 403,RESIDENTIAL,12400,0,12400,55200,0,67600
142943100900000,SW 403,RESIDENTIAL,12400,0,12400,37400,0,49800
142943101000000,SW 403,RESIDENTIAL,12400,0,12400,47600,0,60000
142943101100000,SW 403,RESIDENTIAL,16500,0,16500,42700,0,59200
142943200100000,SW 403,RESIDENTIAL,17600,0,17600,52100,0,69700
142943200200000,VACANT LAND,INDUSTRIAL,0,3900,3900,0,0,3900
142943200300000,VACANT LAND,INDUSTRIAL,0,39500,39500,0,0,39500
142943200400000,SW 403,RESIDENTIAL,19600,0,19600,44400,0,64000
142943200500000,SW 403,RESIDENTIAL,17600,0,17600,32200,0,49800
142943200600000,SW 403,RESIDENTIAL,17600,0,17600,56600,0,74200
142943200700000,SW 403,RESIDENTIAL,17600,0,17600,45400,0,63000
142943200800000,SW 403,RESIDENTIAL,17600,0,17600,43500,0,61100
142943200900000,SW 403,RESIDENTIAL,17600,0,17600,67100,0,84700
142943201000000,SW 403,RESIDENTIAL,17800,0,17800,119800,0,137600
142943201100000,SW 403,RESIDENTIAL,15500,0,15500,0,0,15500
142943201300000,SW 403,RESIDENTIAL,17600,0,17600,96600,0,114200
142943201400000,SW 403,RESIDENTIAL,17600,0,17600,96600,0,114200
142943300100000,OFFICE,COMMERCIAL,0,22600,22600,0,88900,111500
142943300200000,SHOP,COMMERCIAL,0,11900,11900,0,47400,59300
142943300300000,SHOP,COMMERCIAL,0,12300,12300,0,26900,39200
142943300400000,SHOP,COMMERCIAL,0,21300,21300,0,102700,124000
142943300500000,WAREHOUSE,COMMERCIAL,0,41400,41400,0,108200,149600
142943300600000,WAREHOUSE,COMMERCIAL,0,48000,48000,0,194300,242300
142943300700000,SW 405,RESIDENTIAL,13100,0,13100,0,0,13100
142943300800000,SW 405,RESIDENTIAL,13200,0,13200,31400,0,44600
142945100100000,SW 403,RESIDENTIAL,16100,0,16100,31200,0,47300
142945100200000,SW 403,RESIDENTIAL,16900,0,16900,62700,0,79600
142945100300000,SW 403,RESIDENTIAL,16500,0,16500,44700,0,61200
142945200100000,CITY PROPERTY,EXEMPT,0,0,0,0,0,0
142945200200000,VACANT LAND,INDUSTRIAL,0,2400,2400,0,0,2400
142945300100000,FOOD GRADE;INDUST,INDUSTRIAL,0,678200,678200,0,3272900,3951100
142945300102000,BILLBOARD(BLL),COMMERCIAL,0,0,0,0,16000,16000
142945400100000,SW 405,RESIDENTIAL,18700,0,18700,48500,0,67200
142945400200000,BARS/LOUNGE,COMMERCIAL,0,49000,49000,0,109200,158200
142945400300000,SW 405,RESIDENTIAL,65600,0,65600,98800,0,164400
142945400400000,WAREHOUSE,COMMERCIAL,0,183800,183800,0,807300,991100
142945500100000,SW 403,RESIDENTIAL,16800,0,16800,33800,0,50600
142945500200000,SW 403,RESIDENTIAL,16800,0,16800,35800,0,52600
142945500300000,SW 403,RESIDENTIAL,16800,0,16800,25300,0,42100
142945500400000,SW 403,RESIDENTIAL,16800,0,16800,28400,0,45200
142945500500000,SW 403,RESIDENTIAL,16800,0,16800,36200,0,53000
142945500600000,SW 403,RESIDENTIAL,16800,0,16800,40200,0,57000
142945500700000,SW 403,RESIDENTIAL,16800,0,16800,44700,0,61500
142945500800000,SW 403,RESIDENTIAL,16800,0,16800,43900,0,60700
142945500900000,WAREHOUSE,COMMERCIAL,0,16800,16800,0,125800,142600
142945501000000,VACANT LAND,COMMERCIAL,0,16800,16800,0,0,16800
142945501002000,WAREHOUSE,COMMERCIAL,0,0,0,0,118600,118600
142945501100000,VACANT LAND,COMMERCIAL,0,41000,41000,0,0,41000
142945501202000,WAREHOUSE,COMMERCIAL,0,0,0,0,112500,112500
142945600100000,WAREHOUSE,COMMERCIAL,0,16800,16800,0,131100,147900
142945600200000,FOOD GRADE;INDUST,INDUSTRIAL,0,19300,19300,0,84500,103800
142945600300000,WAREHOUSE,COMMERCIAL,0,80400,80400,0,342400,422800
142945600400000,SW 403,RESIDENTIAL,16800,0,16800,44100,0,60900
142945600500000,SW 403,RESIDENTIAL,16800,0,16800,76400,0,93200
142945600600000,SW 403,RESIDENTIAL,16800,0,16800,23800,0,40600
142945600700000,SW 403,RESIDENTIAL,16800,0,16800,28800,0,45600
142945600800000,SW 403,RESIDENTIAL,16800,0,16800,77600,0,94400
142945600900000,SW 403,RESIDENTIAL,16800,0,16800,60600,0,77400
142945601000000,SW 403,RESIDENTIAL,16800,0,16800,58600,0,75400
142945601100000,SW 403,RESIDENTIAL,16800,0,16800,65500,0,82300
142945601200000,SW 403,RESIDENTIAL,16800,0,16800,71800,0,88600
142945601300000,SW 403,RESIDENTIAL,16800,0,16800,53600,0,70400
142945601400000,VACANT LAND,INDUSTRIAL,0,5300,5300,0,0,5300
142945700100000,CENTRALLY ASSESSED,OTHER,0,0,0,0,0,0
142945800100000,FOOD GRADE;INDUST,INDUSTRIAL,0,43000,43000,0,1078100,1121100
142945800200000,VACANT LAND,INDUSTRIAL,0,1300,1300,0,0,1300
142945800300000,FOOD GRADE;INDUST,INDUSTRIAL,0,44500,44500,0,0,44500
142945800400000,CENTRALLY ASSESSED,OTHER,0,0,0,0,0,0
142945900100000,CENTRALLY ASSESSED,OTHER,0,0,0,0,0,0
142945900200000,VACANT LAND,COMMERCIAL,0,50400,50400,0,0,50400
142945900300000,CENTRALLY ASSESSED,OTHER,0,0,0,0,0,0
142945900400000,VACANT LAND,COMMERCIAL,0,55400,55400,0,0,55400
142946000100000,CENTRALLY ASSESSED,OTHER,0,0,0,0,0,0
142946000200000,CENTRALLY ASSESSED,OTHER,0,0,0,0,0,0
142946000300000,CENTRALLY ASSESSED,OTHER,0,0,0,0,0,0
142946000400000,CENTRALLY ASSESSED,OTHER,0,0,0,0,0,0
142946000500000,VACANT LAND,COMMERCIAL,0,67200,67200,0,0,67200
142946000600000,VACANT LAND,COMMERCIAL,0,33600,33600,0,0,33600
142946000700000,CENTRALLY ASSESSED,OTHER,0,0,0,0,0,0
142946000800000,VACANT LAND,COMMERCIAL,0,16700,16700,0,0,16700
142946100200000,SW 404,RESIDENTIAL,8600,0,8600,34200,0,42800
142946100300000,SHOP,COMMERCIAL,0,23600,23600,0,50000,73600
142946100400000,BARS/LOUNGE,COMMERCIAL,0,18200,18200,0,60100,78300
142946100500000,SW 404,RESIDENTIAL,19100,0,19100,57800,0,76900
142946100600000,SW 404,RESIDENTIAL,16900,0,16900,33000,0,49900
142946100700000,SW 404,RESIDENTIAL,16900,0,16900,60100,0,77000
142946200100000,SW 404,RESIDENTIAL,23000,0,23000,83000,0,106000
142946200200000,SW 404,RESIDENTIAL,15400,0,15400,57800,0,73200
142946200300000,SW 404,RESIDENTIAL,64300,0,64300,0,0,64300
142946200400000,CENTRALLY ASSESSED,OTHER,0,0,0,0,0,0
142947600100000,SW 403,RESIDENTIAL,12285,0,12285,57615,0,69900
142947600200000,CITY PROPERTY,EXEMPT,0,0,0,0,0,0
142947600300000,SW 403,RESIDENTIAL,12600,0,12600,42900,0,55500
142947600400000,SW 403,RESIDENTIAL,11500,0,11500,68900,0,80400
142947600500000,SW 403,RESIDENTIAL,11500,0,11500,54400,0,65900
142947600600000,SW 403,RESIDENTIAL,11500,0,11500,59300,0,70800
142947600700000,SW 403,RESIDENTIAL,11500,0,11500,67900,0,79400
142947700200000,SW 403,RESIDENTIAL,15800,0,15800,39500,0,55300
142947700300000,SW 403,RESIDENTIAL,13700,0,13700,60000,0,73700
142947700400000,SW 403,RESIDENTIAL,17200,0,17200,66100,0,83300
142947700500000,SW 403,RESIDENTIAL,15000,0,15000,39700,0,54700
142947700700000,SW 403,RESIDENTIAL,16800,0,16800,78900,0,95700
142947700800000,SW 403,RESIDENTIAL,16400,0,16400,42500,0,58900
142947701100000,SW 403,RESIDENTIAL,16800,0,16800,118900,0,135700
142947800100000,SW 403,RESIDENTIAL,15800,0,15800,58400,0,74200
142947800200000,SW 403,RESIDENTIAL,18000,0,18000,114900,0,132900
142947800300000,SW 403,RESIDENTIAL,12100,0,12100,48100,0,60200
142947800400000,SW 403,RESIDENTIAL,11600,0,11600,59100,0,70700
142947800500000,SW 403,RESIDENTIAL,11000,0,11000,62800,0,73800
142947800600000,SW 403,RESIDENTIAL,16100,0,16100,33100,0,49200
142947800700000,SW 403,RESIDENTIAL,15800,0,15800,34700,0,50500
142947900100000,SW 403,RESIDENTIAL,12000,0,12000,46800,0,58800
142947900200000,SW 403,RESIDENTIAL,17200,0,17200,39200,0,56400
142947900300000,SW 403,RESIDENTIAL,18100,0,18100,113800,0,131900
142948000400000,VACANT LAND,COMMERCIAL,0,25500,25500,0,0,25500
142948000500000,CENTRALLY ASSESSED,OTHER,0,0,0,0,0,0
142948000600000,CENTRALLY ASSESSED,OTHER,0,0,0,0,0,0
142948000602000,BILLBOARD(BLL),COMMERCIAL,0,0,0,0,10300,10300
142948100100000,SHOP,COMMERCIAL,0,65700,65700,0,85500,151200
142948100200000,SHOP,COMMERCIAL,0,22000,22000,0,80500,102500
142948100300000,SW 403,RESIDENTIAL,18600,0,18600,41600,0,60200
142948100400000,CITY PROPERTY,EXEMPT,0,0,0,0,0,0
142948100500000,SHOP,COMMERCIAL,0,19100,19100,0,77600,96700
142948100600000,VACANT LAND,COMMERCIAL,0,20600,20600,0,0,20600
142948100800000,CENTRALLY ASSESSED,OTHER,0,0,0,0,0,0
142948200100000,SW 403,RESIDENTIAL,16800,0,16800,79500,0,96300
142948200200000,SW 403,RESIDENTIAL,16800,0,16800,91500,0,108300
142948200300000,SW 403,RESIDENTIAL,16800,0,16800,55000,0,71800
142948200400000,SW 403,RESIDENTIAL,16800,0,16800,61500,0,78300
142948200500000,SW 403,RESIDENTIAL,16800,0,16800,42400,0,59200
142948200600000,SW 403,RESIDENTIAL,16800,0,16800,48800,0,65600
142948200700000,SW 403,RESIDENTIAL,16800,0,16800,54300,0,71100
142948201100000,VACANT LAND,COMMERCIAL,0,19300,19300,0,0,19300
142948201200000,VACANT LAND,COMMERCIAL,0,16000,16000,0,0,16000
142948201300000,SW 403,RESIDENTIAL,16800,0,16800,41000,0,57800
142948201400000,SW 403,RESIDENTIAL,16800,0,16800,46200,0,63000
142948201500000,SW 403,RESIDENTIAL,16800,0,16800,42200,0,59000
142948201600000,SW 403,RESIDENTIAL,16800,0,16800,72300,0,89100
142948201700000,CENTRALLY ASSESSED,OTHER,0,0,0,0,0,0
142948201800000,CENTRALLY ASSESSED,OTHER,0,0,0,0,0,0
142948201900000,EDUCATIONAL/COLLEGE,COMMERCIAL,0,38100,38100,0,35700,73800
142948202000000,VACANT LAND,COMMERCIAL,0,7800,7800,0,0,7800
142948300100000,SW 403,RESIDENTIAL,11800,0,11800,47000,0,58800
142948300200000,SW 403,RESIDENTIAL,11000,0,11000,26600,0,37600
142948300300000,SW 403,RESIDENTIAL,11000,0,11000,24100,0,35100
142948300400000,SW 403,RESIDENTIAL,13400,0,13400,29300,0,42700
142948300500000,SW 403,RESIDENTIAL,17100,0,17100,73500,0,90600
142948300600000,SW 403,RESIDENTIAL,17100,0,17100,55600,0,72700
142948300700000,SW 403,RESIDENTIAL,17100,0,17100,56600,0,73700
142948300800000,SW 403,RESIDENTIAL,15000,0,15000,56400,0,71400
142948300900000,SW 403,RESIDENTIAL,15000,0,15000,70600,0,85600
142948301000000,SW 403,RESIDENTIAL,15000,0,15000,64200,0,79200
142948301100000,SW 403,RESIDENTIAL,13100,0,13100,54800,0,67900
142948301200000,CITY PROPERTY,EXEMPT,0,0,0,0,0,0
142948301300000,VACANT LAND,COMMERCIAL,0,18000,18000,0,0,18000
142948301400000,VACANT LAND,COMMERCIAL,0,20300,20300,0,0,20300
142948400200000,WAREHOUSE,COMMERCIAL,0,179000,179000,0,310300,489300
142948500300000,WAREHOUSE,INDUSTRIAL,0,207000,207000,0,1125400,1332400
142948500500000,WAREHOUSE,COMMERCIAL,0,86100,86100,0,181900,268000
142948500600000,VACANT LAND,COMMERCIAL,0,136800,136800,0,0,136800
142948500602000,WAREHOUSE,COMMERCIAL,0,0,0,0,120600,120600
142948500602001,WAREHOUSE,COMMERCIAL,0,0,0,0,106800,106800
142948500700000,MATERIALS MFG;INDUST,INDUSTRIAL,0,185400,185400,0,429200,614600
142948500900000,VACANT LAND,COMMERCIAL,0,36000,36000,0,0,36000
142948501000000,VACANT LAND,COMMERCIAL,0,59200,59200,0,0,59200
142948501200000,VACANT LAND,INDUSTRIAL,0,8000,8000,0,0,8000
142948501400000,CONC/ASPH;INDUSTRIAL,INDUSTRIAL,0,39200,39200,0,19900,59100
142948501600000,VACANT LAND,INDUSTRIAL,0,14000,14000,0,0,14000
142948501700000,CENTRALLY ASSESSED,OTHER,0,0,0,0,0,0
142948501900000,CONC/ASPH;INDUSTRIAL,INDUSTRIAL,0,566400,566400,0,699300,1265700
142948502000000,OFFICE,COMMERCIAL,0,245000,245000,0,435100,680100
142948600100000,VACANT LAND,INDUSTRIAL,0,92600,92600,0,0,92600
142948600200000,CENTRALLY ASSESSED,OTHER,0,0,0,0,0,0
142948600300000,WAREHOUSE,COMMERCIAL,0,56000,56000,0,181400,237400
142948600400000,CENTRALLY ASSESSED,OTHER,0,0,0,0,0,0
142948600500000,CENTRALLY ASSESSED,OTHER,0,0,0,0,0,0
142948700600000,OFFICE,COMMERCIAL,0,111100,111100,0,129400,240500
142948800300000,SHOP,COMMERCIAL,0,87500,87500,0,462700,550200
143010100100000,NW 324,RESIDENTIAL,26200,0,26200,115200,0,141400
143010100200000,NW 324,RESIDENTIAL,51100,0,51100,158300,0,209400
143010100300000,NW 324,RESIDENTIAL,19000,0,19000,83600,0,102600
143010100400000,NW 324,RESIDENTIAL,19000,0,19000,61900,0,80900
143010100500000,NW 324,RESIDENTIAL,18900,0,18900,74900,0,93800
143010100600000,NW 324,RESIDENTIAL,20400,0,20400,81000,0,101400
143010100700000,NW 324,RESIDENTIAL,20400,0,20400,87900,0,108300
143010100800000,NW 324,RESIDENTIAL,20400,0,20400,88200,0,108600
143010100900000,NW 324,RESIDENTIAL,20400,0,20400,76400,0,96800
143010101000000,NW 324,RESIDENTIAL,20400,0,20400,83800,0,104200
143010101100000,NW 324,RESIDENTIAL,20400,0,20400,53400,0,73800
143010101200000,NW 324,RESIDENTIAL,20400,0,20400,97000,0,117400
143010101300000,NW 324,RESIDENTIAL,26500,0,26500,143700,0,170200
143010101400000,NW 324,RESIDENTIAL,20400,0,20400,67000,0,87400
143010101500000,NW 324,RESIDENTIAL,20400,0,20400,97800,0,118200
143010101600000,NW 324,RESIDENTIAL,20400,0,20400,84300,0,104700
143010101700000,NW 324,RESIDENTIAL,23000,0,23000,92100,0,115100
143010101800000,NW 324,RESIDENTIAL,23000,0,23000,95000,0,118000
143010101900000,NW 324,RESIDENTIAL,20400,0,20400,47700,0,68100
143010102000000,NW 324,RESIDENTIAL,20400,0,20400,99200,0,119600
143010102100000,NW 324,RESIDENTIAL,20400,0,20400,71900,0,92300
143010102200000,NW 324,RESIDENTIAL,20400,0,20400,115800,0,136200
143010102300000,NW 324,RESIDENTIAL,19700,0,19700,108400,0,128100
143010102400000,NW 324,RESIDENTIAL,19900,0,19900,81200,0,101100
143010102500000,NW 324,RESIDENTIAL,27400,0,27400,79000,0,106400
143010102600000,NW 324,RESIDENTIAL,24800,0,24800,97100,0,121900
143010102700000,NW 324,RESIDENTIAL,26700,0,26700,109200,0,135900
143010102800000,NW 324,RESIDENTIAL,29300,0,29300,111900,0,141200
143010102900000,NW 324,RESIDENTIAL,29300,0,29300,28300,0,57600
143010103000000,NW 324,RESIDENTIAL,32500,0,32500,87100,0,119600
143010103100000,NW 324,RESIDENTIAL,24400,0,24400,109000,0,133400
143010103200000,NW 324,RESIDENTIAL,31400,0,31400,114600,0,146000
143010103300000,NW 324,RESIDENTIAL,29300,0,29300,123800,0,153100
143010103400000,NW 324,RESIDENTIAL,24400,0,24400,100800,0,125200
143010103500000,NW 324,RESIDENTIAL,24400,0,24400,93400,0,117800
143010103600000,NW 324,RESIDENTIAL,29300,0,29300,95400,0,124700
143010103700000,NW 324,RESIDENTIAL,24400,0,24400,92800,0,117200
143010103800000,NW 324,RESIDENTIAL,26800,0,26800,114600,0,141400
143010103900000,NW 324,RESIDENTIAL,27700,0,27700,89800,0,117500
143010104000000,NW 324,RESIDENTIAL,25000,0,25000,82500,0,107500
143010104100000,NW 324,RESIDENTIAL,28000,0,28000,94000,0,122000
143010104200000,NW 324,RESIDENTIAL,27700,0,27700,110600,0,138300
143010200100000,NW 324,RESIDENTIAL,18900,0,18900,74500,0,93400
143010200200000,NW 324,RESIDENTIAL,24700,0,24700,68000,0,92700
143010200300000,CHURCH,EXEMPT,0,455400,455400,0,3381800,3837200
143010200400000,NW 324,RESIDENTIAL,50300,0,50300,116000,0,166300
143010200500000,NW 324,RESIDENTIAL,24200,0,24200,96200,0,120400
143010200600000,NW 324,RESIDENTIAL,24200,0,24200,75500,0,99700
143010200700000,NW 324,RESIDENTIAL,21400,0,21400,92700,0,114100
143010200800000,NW 324,RESIDENTIAL,21400,0,21400,105800,0,127200
143010200900000,NW 324,RESIDENTIAL,21400,0,21400,91000,0,112400
143010201000000,NW 324,RESIDENTIAL,30100,0,30100,136000,0,166100
143010201100000,NW 324,RESIDENTIAL,28100,0,28100,107100,0,135200
143010201200000,NW 324,RESIDENTIAL,24500,0,24500,60900,0,85400
143010201300000,NW 324,RESIDENTIAL,24500,0,24500,81800,0,106300
143010201400000,NW 324,RESIDENTIAL,24500,0,24500,64100,0,88600
143010201500000,NW 324,RESIDENTIAL,24500,0,24500,86700,0,111200
143010201600000,NW 324,RESIDENTIAL,24500,0,24500,65000,0,89500
143010201700000,NW 324,RESIDENTIAL,26900,0,26900,74900,0,101800
143010201800000,NW 324,RESIDENTIAL,26500,0,26500,86100,0,112600
143010201900000,NW 324,RESIDENTIAL,31900,0,31900,46000,0,77900
143010202000000,NW 324,RESIDENTIAL,51700,0,51700,119300,0,171000
143010202100000,NW 324,RESIDENTIAL,30200,0,30200,69500,0,99700
143010202200000,NW 324,RESIDENTIAL,25000,0,25000,85600,0,110600
143010202300000,NW 324,EXEMPT,0,59100,59100,0,80500,139600
143010202400000,NW 324,RESIDENTIAL,20100,0,20100,89800,0,109900
143010202500000,NW 324,RESIDENTIAL,19400,0,19400,87900,0,107300
143010202600000,NW 324,RESIDENTIAL,18800,0,18800,89900,0,108700
143010202700000,NW 324,RESIDENTIAL,20400,0,20400,88000,0,108400
143010202800000,NW 324,RESIDENTIAL,20400,0,20400,85000,0,105400
143010202900000,NW 324,RESIDENTIAL,20400,0,20400,79900,0,100300
143010203000000,NW 324,RESIDENTIAL,23000,0,23000,97200,0,120200
143010203100000,NW 324,RESIDENTIAL,23000,0,23000,119800,0,142800
143010203200000,NW 324,RESIDENTIAL,20400,0,20400,113700,0,134100
143010203300000,NW 324,RESIDENTIAL,20400,0,20400,84200,0,104600
143010203400000,NW 324,RESIDENTIAL,20400,0,20400,109100,0,129500
143010203500000,NW 324,RESIDENTIAL,20400,0,20400,91900,0,112300
143010203600000,NW 324,RESIDENTIAL,20400,0,20400,81100,0,101500
143010203700000,NW 324,RESIDENTIAL,20400,0,20400,71400,0,91800
143010203800000,NW 324,RESIDENTIAL,20400,0,20400,86000,0,106400
143010203900000,NW 324,RESIDENTIAL,20400,0,20400,90100,0,110500
143010204000000,NW 324,RESIDENTIAL,23000,0,23000,106400,0,129400
143010204100000,NW 324,RESIDENTIAL,23000,0,23000,84500,0,107500
143010204200000,NW 324,RESIDENTIAL,20400,0,20400,68500,0,88900
143010204300000,NW 324,RESIDENTIAL,20400,0,20400,88900,0,109300
143010300100000,NW 324,RESIDENTIAL,40300,0,40300,29500,0,69800
143010300200000,NW 324,RESIDENTIAL,22900,0,22900,97600,0,120500
143010300300000,NW 324,RESIDENTIAL,27100,0,27100,102300,0,129400
143010300400000,NW 324,RESIDENTIAL,27400,0,27400,89100,0,116500
143010300500000,NW 324,RESIDENTIAL,27300,0,27300,83400,0,110700
143010300600000,NW 324,RESIDENTIAL,21400,0,21400,85500,0,106900
143010300700000,NW 324,RESIDENTIAL,21400,0,21400,102800,0,124200
143010300800000,NW 324,RESIDENTIAL,24500,0,24500,92600,0,117100
143010300900000,NW 324,RESIDENTIAL,24500,0,24500,69300,0,93800
143010301000000,NW 324,RESIDENTIAL,24500,0,24500,46400,0,70900
143010301100000,NW 324,RESIDENTIAL,24500,0,24500,81000,0,105500
143010301200000,NW 324,RESIDENTIAL,24500,0,24500,73400,0,97900
143010301300000,NW 324,RESIDENTIAL,24500,0,24500,63500,0,88000
143010301400000,NW 324,RESIDENTIAL,31900,0,31900,87700,0,119600
143010301500000,NW 324,RESIDENTIAL,27600,0,27600,78700,0,106300
143010301600000,NW 324,RESIDENTIAL,24900,0,24900,26700,0,51600
143010400100000,CARWASH,COMMERCIAL,0,62000,62000,0,148800,210800
143012600100000,NW 324,RESIDENTIAL,52200,0,52200,107000,0,159200
143012600200000,NW 324,RESIDENTIAL,31700,0,31700,133400,0,165100
143012600300000,NW 324,RESIDENTIAL,24300,0,24300,100500,0,124800
143012600400000,NW 324,RESIDENTIAL,28900,0,28900,137000,0,165900
143012600500000,NW 324,RESIDENTIAL,28900,0,28900,99900,0,128800
143012600600000,NW 324,RESIDENTIAL,24700,0,24700,74400,0,99100
143012600700000,NW 324,RESIDENTIAL,24000,0,24000,98500,0,122500
143012600800000,NW 324,RESIDENTIAL,24000,0,24000,65200,0,89200
143012600900000,NW 324,RESIDENTIAL,24000,0,24000,108300,0,132300
143012601000000,NW 324,RESIDENTIAL,24000,0,24000,101000,0,125000
143012601100000,NW 324,RESIDENTIAL,24000,0,24000,87600,0,111600
143012601200000,NW 324,RESIDENTIAL,24000,0,24000,92000,0,116000
143012601300000,NW 324,RESIDENTIAL,26200,0,26200,114800,0,141000
143012601400000,NW 324,RESIDENTIAL,28000,0,28000,107900,0,135900
143012601500000,NW 324,RESIDENTIAL,24500,0,24500,75200,0,99700
143012700100000,NW 324,RESIDENTIAL,23100,0,23100,101500,0,124600
143012700200000,NW 324,RESIDENTIAL,23500,0,23500,115000,0,138500
143012700300000,NW 324,RESIDENTIAL,30500,0,30500,116400,0,146900
143012700400000,NW 324,RESIDENTIAL,22300,0,22300,99100,0,121400
143012700500000,NW 324,RESIDENTIAL,22600,0,22600,95300,0,117900
143012700600000,NW 324,RESIDENTIAL,22600,0,22600,88700,0,111300
143012700700000,NW 324,RESIDENTIAL,22600,0,22600,79400,0,102000
143012700800000,NW 324,RESIDENTIAL,22600,0,22600,89600,0,112200
143012700900000,NW 324,RESIDENTIAL,22600,0,22600,94400,0,117000
143012701000000,NW 324,RESIDENTIAL,22600,0,22600,95500,0,118100
143012701100000,NW 324,RESIDENTIAL,21800,0,21800,99600,0,121400
143012701200000,NW 324,RESIDENTIAL,21100,0,21100,78600,0,99700
143012701300000,NW 324,RESIDENTIAL,25500,0,25500,84100,0,109600
143012701400000,NW 324,RESIDENTIAL,24800,0,24800,94000,0,118800
143012701500000,NW 324,RESIDENTIAL,21600,0,21600,93000,0,114600
143012701600000,NW 324,RESIDENTIAL,22700,0,22700,97800,0,120500
143012701700000,NW 324,RESIDENTIAL,22600,0,22600,67100,0,89700
143012701800000,NW 324,RESIDENTIAL,22600,0,22600,77400,0,100000
143012701900000,NW 324,RESIDENTIAL,22600,0,22600,93800,0,116400
143012702000000,NW 324,RESIDENTIAL,22600,0,22600,104900,0,127500
143012702100000,NW 324,RESIDENTIAL,22800,0,22800,79900,0,102700
143012702200000,NW 324,RESIDENTIAL,27000,0,27000,118900,0,145900
143012702300000,NW 324,RESIDENTIAL,26400,0,26400,113600,0,140000
143012702400000,NW 324,RESIDENTIAL,22300,0,22300,95000,0,117300
143012702500000,NW 324,RESIDENTIAL,22300,0,22300,96800,0,119100
143012702600000,NW 324,RESIDENTIAL,22300,0,22300,91200,0,113500
143012702700000,NW 324,RESIDENTIAL,22300,0,22300,126200,0,148500
143012702800000,NW 324,RESIDENTIAL,22300,0,22300,80300,0,102600
143012702900000,NW 324,RESIDENTIAL,22300,0,22300,76400,0,98700
143012703000000,NW 324,RESIDENTIAL,22500,0,22500,94300,0,116800
143012703100000,NW 324,RESIDENTIAL,20400,0,20400,97100,0,117500
143012703200000,NW 324,RESIDENTIAL,27800,0,27800,89600,0,117400
143012703300000,NW 324,RESIDENTIAL,25700,0,25700,88800,0,114500
143012703400000,NW 324,RESIDENTIAL,24500,0,24500,103000,0,127500
143012703500000,NW 324,RESIDENTIAL,24500,0,24500,91400,0,115900
143012703600000,NW 324,RESIDENTIAL,24500,0,24500,95200,0,119700
143012703700000,NW 324,RESIDENTIAL,24500,0,24500,76200,0,100700
143012703800000,NW 324,RESIDENTIAL,24500,0,24500,92300,0,116800
143012703900000,NW 324,RESIDENTIAL,24500,0,24500,106100,0,130600
143012704000000,NW 324,RESIDENTIAL,24900,0,24900,87700,0,112600
143012704100000,NW 324,RESIDENTIAL,25700,0,25700,108700,0,134400
143012704200000,NW 324,RESIDENTIAL,26100,0,26100,113100,0,139200
143012704300000,NW 324,RESIDENTIAL,26000,0,26000,109300,0,135300
143012704400000,NW 324,RESIDENTIAL,26300,0,26300,115000,0,141300
143012704500000,NW 324,RESIDENTIAL,23000,0,23000,101500,0,124500
143012704600000,NW 324,RESIDENTIAL,23100,0,23100,126300,0,149400
143012800100000,NW 324,RESIDENTIAL,22800,0,22800,88500,0,111300
143012800200000,NW 324,RESIDENTIAL,23400,0,23400,71900,0,95300
143012800300000,NW 324,RESIDENTIAL,22600,0,22600,108800,0,131400
143012800400000,NW 324,RESIDENTIAL,22600,0,22600,80600,0,103200
143012800500000,NW 324,RESIDENTIAL,22600,0,22600,81100,0,103700
143012800600000,NW 324,RESIDENTIAL,22600,0,22600,79000,0,101600
143012800700000,NW 324,RESIDENTIAL,22600,0,22600,77600,0,100200
143012800800000,NW 324,RESIDENTIAL,22600,0,22600,75000,0,97600
143012800900000,NW 324,RESIDENTIAL,22600,0,22600,80100,0,102700
143012801000000,NW 324,RESIDENTIAL,22600,0,22600,85700,0,108300
143012801100000,NW 324,RESIDENTIAL,22600,0,22600,71100,0,93700
143012801200000,NW 324,RESIDENTIAL,22600,0,22600,76900,0,99500
143012801300000,NW 324,RESIDENTIAL,22600,0,22600,86800,0,109400
143012801400000,NW 324,RESIDENTIAL,22500,0,22500,52400,0,74900
143012801500000,NW 324,RESIDENTIAL,22300,0,22300,86800,0,109100
143012801600000,NW 324,RESIDENTIAL,22600,0,22600,108800,0,131400
143012801700000,NW 324,RESIDENTIAL,22600,0,22600,84700,0,107300
143012801800000,NW 324,RESIDENTIAL,22600,0,22600,101100,0,123700
143012801900000,NW 324,RESIDENTIAL,22600,0,22600,75600,0,98200
143012802000000,NW 324,RESIDENTIAL,22600,0,22600,91500,0,114100
143012802100000,NW 324,RESIDENTIAL,22600,0,22600,95300,0,117900
143012802200000,NW 324,RESIDENTIAL,22600,0,22600,77300,0,99900
143012802300000,NW 324,RESIDENTIAL,22600,0,22600,91000,0,113600
143012802400000,NW 324,RESIDENTIAL,22600,0,22600,87000,0,109600
143012802500000,NW 324,RESIDENTIAL,22600,0,22600,79700,0,102300
143012802600000,NW 324,RESIDENTIAL,22600,0,22600,79900,0,102500
143012900100000,NW 324,RESIDENTIAL,24000,0,24000,89500,0,113500
143012900200000,NW 324,RESIDENTIAL,23700,0,23700,100400,0,124100
143012900300000,NW 324,RESIDENTIAL,23200,0,23200,105600,0,128800
143012900400000,NW 324,RESIDENTIAL,22800,0,22800,119200,0,142000
143012900500000,NW 324,RESIDENTIAL,22600,0,22600,92300,0,114900
143012900600000,NW 324,RESIDENTIAL,22600,0,22600,98500,0,121100
143012900700000,NW 324,RESIDENTIAL,22600,0,22600,85900,0,108500
143012900800000,NW 324,RESIDENTIAL,22600,0,22600,79700,0,102300
143012900900000,NW 324,RESIDENTIAL,22600,0,22600,78100,0,100700
143012901000000,NW 324,RESIDENTIAL,21800,0,21800,79000,0,100800
143012901100000,NW 324,RESIDENTIAL,19400,0,19400,79300,0,98700
143012901200000,NW 324,RESIDENTIAL,22500,0,22500,89600,0,112100
143012901300000,NW 324,RESIDENTIAL,22300,0,22300,80200,0,102500
143012901400000,NW 324,RESIDENTIAL,22300,0,22300,75500,0,97800
143012901500000,NW 324,RESIDENTIAL,22300,0,22300,84300,0,106600
143012901600000,NW 324,RESIDENTIAL,22300,0,22300,93900,0,116200
143012901700000,NW 324,RESIDENTIAL,22300,0,22300,90200,0,112500
143012901800000,NW 324,RESIDENTIAL,22300,0,22300,85800,0,108100
143012901900000,NW 324,RESIDENTIAL,21800,0,21800,93700,0,115500
143013000100000,NW 324,RESIDENTIAL,24500,0,24500,80500,0,105000
143013000200000,NW 324,RESIDENTIAL,22600,0,22600,77500,0,100100
143013000300000,CITY PROPERTY,EXEMPT,0,0,0,0,0,0
143013000400000,NW 324,RESIDENTIAL,24100,0,24100,81800,0,105900
143013000500000,NW 324,RESIDENTIAL,24400,0,24400,80300,0,104700
143013000600000,NW 324,RESIDENTIAL,28000,0,28000,72700,0,100700
143013000700000,NW 324,RESIDENTIAL,27100,0,27100,73400,0,100500
143013000800000,NW 324,RESIDENTIAL,23100,0,23100,84700,0,107800
143013000900000,NW 324,RESIDENTIAL,23400,0,23400,87300,0,110700
143013001000000,NW 324,RESIDENTIAL,23400,0,23400,86700,0,110100
143013001100000,NW 324,RESIDENTIAL,23400,0,23400,81900,0,105300
143013001200000,NW 324,RESIDENTIAL,23400,0,23400,81000,0,104400
143013001300000,NW 324,RESIDENTIAL,23400,0,23400,76800,0,100200
143013001400000,NW 324,RESIDENTIAL,23400,0,23400,61500,0,84900
143013001500000,NW 324,RESIDENTIAL,23100,0,23100,87500,0,110600
143013001600000,NW 324,RESIDENTIAL,22600,0,22600,90200,0,112800
143013001700000,NW 324,RESIDENTIAL,23000,0,23000,84300,0,107300
143013001800000,NW 324,RESIDENTIAL,24200,0,24200,90100,0,114300
143013001900000,NW 324,RESIDENTIAL,25200,0,25200,113900,0,139100
143013002000000,NW 324,RESIDENTIAL,25700,0,25700,79400,0,105100
143013002100000,NW 324,RESIDENTIAL,30500,0,30500,124300,0,154800
143013002200000,NW 324,RESIDENTIAL,32500,0,32500,0,0,32500
143013100100000,NW 324,RESIDENTIAL,23900,0,23900,73800,0,97700
143013100200000,NW 324,RESIDENTIAL,23700,0,23700,75300,0,99000
143013100300000,NW 324,RESIDENTIAL,23700,0,23700,88900,0,112600
143013100400000,NW 324,RESIDENTIAL,23700,0,23700,89300,0,113000
143013100500000,NW 324,RESIDENTIAL,24500,0,24500,97100,0,121600
143013100600000,SCHOOL,EXEMPT,0,121600,121600,0,1049000,1170600
143013100700000,NW 324,RESIDENTIAL,27900,0,27900,78600,0,106500
143013100800000,NW 324,RESIDENTIAL,23800,0,23800,73100,0,96900
143013100900000,NW 324,RESIDENTIAL,23300,0,23300,81400,0,104700
143013101000000,NW 324,RESIDENTIAL,27900,0,27900,121600,0,149500
143013101100000,OFFICE,COMMERCIAL,0,41600,41600,0,157400,199000
143013101200000,OFFICE; MEDICAL,COMMERCIAL,0,135500,135500,0,259700,395200
143013101300000,SR/NURSING/ASSTD LIV,MULTI-RES,68000,0,68000,1528800,0,1596800
143013101400000,APARTMENT,MULTI-RES,29900,0,29900,364100,0,394000
143013101500000,NW 324,RESIDENTIAL,25200,0,25200,94900,0,120100
143015100100000,NW 324,RESIDENTIAL,26300,0,26300,63300,0,89600
143015100200000,NW 324,RESIDENTIAL,26800,0,26800,104800,0,131600
143015100300000,NW 324,RESIDENTIAL,24700,0,24700,93400,0,118100
143015100400000,NW 324,RESIDENTIAL,24800,0,24800,61400,0,86200
143015100500000,NW 324,RESIDENTIAL,21800,0,21800,74400,0,96200
143015100600000,NW 324,RESIDENTIAL,24700,0,24700,87600,0,112300
143015100700000,NW 324,RESIDENTIAL,24700,0,24700,83000,0,107700
143015100800000,NW 324,RESIDENTIAL,24700,0,24700,91100,0,115800
143015100900000,NW 324,RESIDENTIAL,24700,0,24700,59700,0,84400
143015101000000,NW 324,RESIDENTIAL,24700,0,24700,78300,0,103000
143015200100000,NW 324,RESIDENTIAL,28800,0,28800,76600,0,105400
143015200200000,NW 324,RESIDENTIAL,28300,0,28300,76800,0,105100
143015200300000,NW 324,RESIDENTIAL,28800,0,28800,82200,0,111000
143015200400000,NW 324,RESIDENTIAL,29200,0,29200,97800,0,127000
143015200500000,NW 324,RESIDENTIAL,25000,0,25000,112400,0,137400
143015200600000,NW 324,RESIDENTIAL,25000,0,25000,94100,0,119100
143015200700000,NW 324,RESIDENTIAL,25200,0,25200,102600,0,127800
143015200800000,NW 324,RESIDENTIAL,25200,0,25200,95400,0,120600
143015200900000,NW 324,RESIDENTIAL,25200,0,25200,64000,0,89200
143015201000000,NW 324,RESIDENTIAL,25200,0,25200,85400,0,110600
143015201100000,NW 324,RESIDENTIAL,23700,0,23700,74000,0,97700
143015201200000,NW 324,RESIDENTIAL,23000,0,23000,81900,0,104900
143015201300000,NW 324,RESIDENTIAL,37100,0,37100,140800,0,177900
143015201500000,NW 324,RESIDENTIAL,24700,0,24700,64500,0,89200
143015201600000,NW 324,RESIDENTIAL,22200,0,22200,94800,0,117000
143015201700000,NW 324,RESIDENTIAL,30300,0,30300,59100,0,89400
143015201800000,NW 324,RESIDENTIAL,27800,0,27800,133900,0,161700
143015300100000,NW 324,RESIDENTIAL,35700,0,35700,107800,0,143500
143015300200000,NW 324,RESIDENTIAL,24300,0,24300,75900,0,100200
143015300300000,NW 324,RESIDENTIAL,24900,0,24900,93000,0,117900
143015300400000,NW 324,RESIDENTIAL,24900,0,24900,85600,0,110500
143015300500000,NW 324,RESIDENTIAL,24600,0,24600,97400,0,122000
143015300600000,NW 324,RESIDENTIAL,22600,0,22600,73300,0,95900
143015300700000,NW 324,RESIDENTIAL,23800,0,23800,80200,0,104000
143015300800000,NW 324,RESIDENTIAL,23800,0,23800,70500,0,94300
143015300900000,NW 324,RESIDENTIAL,23800,0,23800,86400,0,110200
143015301000000,NW 324,RESIDENTIAL,23800,0,23800,89600,0,113400
143015301100000,NW 324,RESIDENTIAL,21900,0,21900,93900,0,115800
143015301200000,NW 324,RESIDENTIAL,23000,0,23000,92000,0,115000
143015301300000,NW 324,RESIDENTIAL,23300,0,23300,85300,0,108600
143015301400000,NW 324,RESIDENTIAL,25000,0,25000,82700,0,107700
143015301500000,NW 324,RESIDENTIAL,25000,0,25000,83300,0,108300
143015301600000,NW 324,RESIDENTIAL,25200,0,25200,68300,0,93500
143015301700000,NW 324,RESIDENTIAL,25200,0,25200,100700,0,125900
143015301800000,NW 324,RESIDENTIAL,25200,0,25200,94300,0,119500
143015301900000,NW 324,RESIDENTIAL,25200,0,25200,88500,0,113700
143015400100000,NW 324,RESIDENTIAL,25200,0,25200,84200,0,109400
143015400200000,NW 324,RESIDENTIAL,24600,0,24600,109500,0,134100
143015400300000,NW 324,RESIDENTIAL,24900,0,24900,86300,0,111200
143015400400000,NW 324,RESIDENTIAL,25200,0,25200,99700,0,124900
143015400500000,NW 324,RESIDENTIAL,24600,0,24600,104900,0,129500
143015400600000,NW 324,RESIDENTIAL,23800,0,23800,79900,0,103700
143015400700000,NW 324,RESIDENTIAL,23800,0,23800,90100,0,113900
143015400800000,NW 324,RESIDENTIAL,22200,0,22200,84600,0,106800
143015400900000,NW 324,RESIDENTIAL,23800,0,23800,90400,0,114200
143015401000000,NW 324,RESIDENTIAL,24400,0,24400,89300,0,113700
143015401100000,NW 324,RESIDENTIAL,22200,0,22200,116600,0,138800
143015401200000,NW 324,RESIDENTIAL,22200,0,22200,103600,0,125800
143015401300000,NW 324,RESIDENTIAL,23800,0,23800,84800,0,108600
143015401400000,NW 324,RESIDENTIAL,23800,0,23800,98500,0,122300
143015401500000,NW 324,RESIDENTIAL,22200,0,22200,73500,0,95700
143015401600000,NW 324,RESIDENTIAL,23800,0,23800,82800,0,106600
143015401700000,NW 324,RESIDENTIAL,24900,0,24900,86700,0,111600
143015401800000,NW 324,RESIDENTIAL,24100,0,24100,85300,0,109400
143015401900000,NW 324,RESIDENTIAL,26000,0,26000,84400,0,110400
143015402000000,NW 324,RESIDENTIAL,26300,0,26300,88500,0,114800
143015500100000,NW 324,RESIDENTIAL,23800,0,23800,86300,0,110100
143015500200000,NW 324,RESIDENTIAL,23500,0,23500,78900,0,102400
143015500300000,NW 324,RESIDENTIAL,25000,0,25000,87500,0,112500
143015500400000,NW 324,RESIDENTIAL,23500,0,23500,88300,0,111800
143015500500000,NW 324,RESIDENTIAL,23500,0,23500,74200,0,97700
143015500600000,NW 324,RESIDENTIAL,25000,0,25000,81000,0,106000
143015500700000,NW 324,RESIDENTIAL,23500,0,23500,74600,0,98100
143015500800000,NW 324,RESIDENTIAL,22000,0,22000,74400,0,96400
143015500900000,NW 324,RESIDENTIAL,23500,0,23500,91500,0,115000
143015501000000,NW 324,RESIDENTIAL,22000,0,22000,75500,0,97500
143015501100000,NW 324,RESIDENTIAL,21600,0,21600,86000,0,107600
143015501200000,NW 324,RESIDENTIAL,119500,0,119500,225100,0,344600
143015501300000,SCHOOL,EXEMPT,0,0,0,0,0,0
143017600100000,GROCERY STORE,COMMERCIAL,0,554000,554000,0,3302700,3856700
143017600200000,NW 324,RESIDENTIAL,24400,0,24400,88000,0,112400
143017600300000,NW 324,RESIDENTIAL,24400,0,24400,84400,0,108800
143017600400000,NW 324,RESIDENTIAL,33800,0,33800,89200,0,123000
143017600500000,NW 324,RESIDENTIAL,33800,0,33800,92600,0,126400
143017600600000,NW 324,RESIDENTIAL,32900,0,32900,96600,0,129500
143017600700000,NW 324,RESIDENTIAL,29300,0,29300,104500,0,133800
143017600800000,NW 324,RESIDENTIAL,31700,0,31700,90500,0,122200
143017600900000,NW 324,RESIDENTIAL,32400,0,32400,96900,0,129300
143017601000000,NW 324,RESIDENTIAL,21800,0,21800,97700,0,119500
143017601100000,NW 324,RESIDENTIAL,19400,0,19400,41000,0,60400
143017601200000,NW 324,RESIDENTIAL,19400,0,19400,92600,0,112000
143017601300000,NW 324,RESIDENTIAL,22000,0,22000,49000,0,71000
143017601400000,NW 324,RESIDENTIAL,24400,0,24400,69200,0,93600
143017601500000,NW 324,RESIDENTIAL,20000,0,20000,69600,0,89600
143017601600000,NW 324,RESIDENTIAL,28800,0,28800,93100,0,121900
143017601700000,NW 324,RESIDENTIAL,21800,0,21800,90300,0,112100
143017601800000,NW 324,RESIDENTIAL,21800,0,21800,101100,0,122900
143017601900000,NW 324,RESIDENTIAL,21800,0,21800,92500,0,114300
143017602000000,NW 324,RESIDENTIAL,30400,0,30400,92200,0,122600
143017602100000,NW 324,RESIDENTIAL,24400,0,24400,94400,0,118800
143017602200000,NW 324,RESIDENTIAL,24400,0,24400,101400,0,125800
143017602300000,NW 324,RESIDENTIAL,36600,0,36600,122500,0,159100
143017602400000,NW 324,RESIDENTIAL,24400,0,24400,29300,0,53700
143017602500000,NW 324,RESIDENTIAL,24400,0,24400,75100,0,99500
143017602600000,NW 324,RESIDENTIAL,24400,0,24400,62300,0,86700
143017602700000,NW 324,RESIDENTIAL,24400,0,24400,95000,0,119400
143017602800000,NW 324,RESIDENTIAL,33800,0,33800,108200,0,142000
143017602900000,NW 324,RESIDENTIAL,33800,0,33800,103100,0,136900
143017603000000,NW 324,RESIDENTIAL,36600,0,36600,57500,0,94100
143017603100000,NW 324,RESIDENTIAL,36600,0,36600,95400,0,132000
143017603200000,NW 324,RESIDENTIAL,24400,0,24400,72100,0,96500
143017700100000,NW 324,RESIDENTIAL,24800,0,24800,65600,0,90400
143017700200000,NW 324,RESIDENTIAL,21400,0,21400,48800,0,70200
143017700300000,NW 324,RESIDENTIAL,22700,0,22700,71800,0,94500
143017700400000,NW 324,RESIDENTIAL,27700,0,27700,91300,0,119000
143017700500000,NW 324,RESIDENTIAL,26200,0,26200,83200,0,109400
143017700600000,NW 324,RESIDENTIAL,29200,0,29200,66900,0,96100
143017700700000,NW 324,RESIDENTIAL,29400,0,29400,72900,0,102300
143017700800000,NW 324,RESIDENTIAL,24300,0,24300,80600,0,104900
143017700900000,NW 324,RESIDENTIAL,23300,0,23300,82700,0,106000
143017701000000,NW 324,RESIDENTIAL,24700,0,24700,54500,0,79200
143017701100000,NW 324,RESIDENTIAL,24700,0,24700,77200,0,101900
143017701200000,NW 324,RESIDENTIAL,24700,0,24700,93200,0,117900
143017701300000,NW 324,RESIDENTIAL,24700,0,24700,100800,0,125500
143017701400000,NW 324,RESIDENTIAL,24700,0,24700,96600,0,121300
143017701500000,NW 324,RESIDENTIAL,24700,0,24700,44500,0,69200
143017701600000,NW 324,RESIDENTIAL,24200,0,24200,44900,0,69100
143017701700000,NW 324,RESIDENTIAL,27400,0,27400,103300,0,130700
143017701800000,NW 324,RESIDENTIAL,27400,0,27400,85700,0,113100
143017701900000,NW 324,RESIDENTIAL,25900,0,25900,64300,0,90200
143017702000000,NW 324,RESIDENTIAL,26500,0,26500,46600,0,73100
143017702100000,NW 324,RESIDENTIAL,33200,0,33200,44500,0,77700
143017702200000,NW 324,RESIDENTIAL,23500,0,23500,58700,0,82200
143017702300000,NW 324,RESIDENTIAL,25400,0,25400,76600,0,102000
143017702400000,NW 324,RESIDENTIAL,25400,0,25400,90100,0,115500
143017702500000,NW 324,RESIDENTIAL,22600,0,22600,104500,0,127100
143017702600000,NW 324,RESIDENTIAL,11400,0,11400,35100,0,46500
143017800100000,NW 324,RESIDENTIAL,24700,0,24700,80400,0,105100
143017800200000,NW 324,RESIDENTIAL,24900,0,24900,78100,0,103000
143017800300000,NW 324,RESIDENTIAL,23500,0,23500,71700,0,95200
143017800400000,NW 324,RESIDENTIAL,23500,0,23500,74800,0,98300
143017800500000,NW 324,RESIDENTIAL,23500,0,23500,94800,0,118300
143017800600000,NW 324,RESIDENTIAL,23500,0,23500,74600,0,98100
143017800700000,NW 324,RESIDENTIAL,23500,0,23500,72300,0,95800
143017800800000,NW 324,RESIDENTIAL,23500,0,23500,82600,0,106100
143017800900000,NW 324,RESIDENTIAL,23500,0,23500,90100,0,113600
143017801000000,NW 324,RESIDENTIAL,23300,0,23300,57100,0,80400
143017900100000,NW 324,RESIDENTIAL,28100,0,28100,96300,0,124400
143017900200000,NW 324,RESIDENTIAL,27300,0,27300,99900,0,127200
143017900300000,NW 324,RESIDENTIAL,26500,0,26500,95000,0,121500
143017900400000,NW 324,RESIDENTIAL,26500,0,26500,84600,0,111100
143017900500000,NW 324,RESIDENTIAL,26100,0,26100,69400,0,95500
143017900600000,NW 324,RESIDENTIAL,30000,0,30000,112000,0,142000
143017900700000,NW 324,RESIDENTIAL,26400,0,26400,124600,0,151000
143017900800000,NW 324,RESIDENTIAL,26800,0,26800,83500,0,110300
143017900900000,NW 324,RESIDENTIAL,26800,0,26800,68700,0,95500
143017901000000,NW 324,RESIDENTIAL,26800,0,26800,97400,0,124200
143017901100000,NW 324,RESIDENTIAL,24200,0,24200,117100,0,141300
143017901200000,NW 324,RESIDENTIAL,24200,0,24200,89600,0,113800
143017901300000,NW 324,RESIDENTIAL,26300,0,26300,101000,0,127300
143017901400000,NW 324,RESIDENTIAL,28200,0,28200,109200,0,137400
143017901500000,CHURCH,EXEMPT,0,330400,330400,0,475100,805500
143017901600000,NW 324,RESIDENTIAL,24600,0,24600,59400,0,84000
143017901700000,NW 324,RESIDENTIAL,18100,0,18100,86300,0,104400
143017901800000,NW 324,RESIDENTIAL,18600,0,18600,55300,0,73900
143017901900000,NW 324,RESIDENTIAL,23200,0,23200,86000,0,109200
143017902000000,NW 324,RESIDENTIAL,36600,0,36600,73600,0,110200
143017902100000,NW 324,RESIDENTIAL,21200,0,21200,27400,0,48600
143017902200000,NW 324,RESIDENTIAL,21200,0,21200,111900,0,133100
143017902300000,NW 324,RESIDENTIAL,25400,0,25400,96500,0,121900
143017902400000,NW 324,RESIDENTIAL,25400,0,25400,103600,0,129000
143017902500000,NW 324,RESIDENTIAL,29100,0,29100,93200,0,122300
143020100100000,NW 324,RESIDENTIAL,24800,0,24800,95900,0,120700
143020100200000,NW 324,RESIDENTIAL,25200,0,25200,97200,0,122400
143020100300000,NW 324,RESIDENTIAL,26000,0,26000,89900,0,115900
143020100400000,NW 324,RESIDENTIAL,24500,0,24500,84000,0,108500
143020100500000,NW 324,RESIDENTIAL,25000,0,25000,89700,0,114700
143020100600000,NW 324,RESIDENTIAL,29200,0,29200,115100,0,144300
143020100700000,NW 324,RESIDENTIAL,29200,0,29200,114800,0,144000
143020100800000,NW 324,RESIDENTIAL,25300,0,25300,71700,0,97000
143020100900000,NW 324,RESIDENTIAL,25800,0,25800,75200,0,101000
143020101000000,NW 324,RESIDENTIAL,25800,0,25800,74700,0,100500
143020101100000,NW 324,RESIDENTIAL,26600,0,26600,95900,0,122500
143020101200000,NW 324,RESIDENTIAL,26300,0,26300,75000,0,101300
143020101300000,NW 324,RESIDENTIAL,25800,0,25800,80500,0,106300
143020101400000,NW 324,RESIDENTIAL,25800,0,25800,80600,0,106400
143020101500000,NW 324,RESIDENTIAL,26400,0,26400,81400,0,107800
143020101600000,NW 324,RESIDENTIAL,29200,0,29200,92000,0,121200
143020101700000,NW 324,RESIDENTIAL,28900,0,28900,100400,0,129300
143020101800000,NW 324,RESIDENTIAL,24100,0,24100,89100,0,113200
143020101900000,NW 324,RESIDENTIAL,23900,0,23900,96100,0,120000
143020102000000,NW 324,RESIDENTIAL,24500,0,24500,82900,0,107400
143020102100000,NW 324,RESIDENTIAL,29900,0,29900,113600,0,143500
143020102200000,NW 324,RESIDENTIAL,27200,0,27200,100200,0,127400
143020102300000,NW 324,RESIDENTIAL,27500,0,27500,90600,0,118100
143020102400000,NW 324,RESIDENTIAL,24600,0,24600,79100,0,103700
143020102500000,NW 324,RESIDENTIAL,24600,0,24600,84000,0,108600
143020102600000,NW 324,RESIDENTIAL,24600,0,24600,81000,0,105600
143020102700000,NW 324,RESIDENTIAL,24600,0,24600,86000,0,110600
143020102800000,NW 324,RESIDENTIAL,24600,0,24600,87400,0,112000
143020102900000,NW 324,RESIDENTIAL,24600,0,24600,102400,0,127000
143020103000000,NW 324,RESIDENTIAL,24600,0,24600,100000,0,124600
143020103100000,NW 324,RESIDENTIAL,24600,0,24600,91300,0,115900
143020103200000,NW 324,RESIDENTIAL,24600,0,24600,100500,0,125100
143020103300000,NW 324,RESIDENTIAL,24600,0,24600,94200,0,118800
143020103400000,NW 324,RESIDENTIAL,25000,0,25000,82000,0,107000
143020103500000,NW 324,RESIDENTIAL,24200,0,24200,71100,0,95300
143020103600000,NW 324,RESIDENTIAL,31500,0,31500,75900,0,107400
143020200100000,NW 324,RESIDENTIAL,25900,0,25900,130700,0,156600
143020200200000,NW 324,RESIDENTIAL,23300,0,23300,73600,0,96900
143020200300000,NW 324,RESIDENTIAL,23300,0,23300,86100,0,109400
143020200400000,NW 324,RESIDENTIAL,23300,0,23300,107200,0,130500
143020200500000,NW 324,RESIDENTIAL,23300,0,23300,81500,0,104800
143020200600000,NW 324,RESIDENTIAL,23300,0,23300,86000,0,109300
143020200700000,NW 324,RESIDENTIAL,23300,0,23300,113900,0,137200
143020200800000,NW 324,RESIDENTIAL,23300,0,23300,95500,0,118800
143020200900000,NW 324,RESIDENTIAL,23300,0,23300,116200,0,139500
143020201000000,NW 324,RESIDENTIAL,23300,0,23300,106300,0,129600
143020201100000,NW 324,RESIDENTIAL,23300,0,23300,95700,0,119000
143020201200000,NW 324,RESIDENTIAL,23300,0,23300,72700,0,96000
143020201300000,NW 324,RESIDENTIAL,25100,0,25100,89800,0,114900
143020201400000,APARTMENT,MULTI-RES,45800,0,45800,120600,0,166400
143020201500000,NW 324,RESIDENTIAL,28400,0,28400,89500,0,117900
143020201600000,NW 324,RESIDENTIAL,26900,0,26900,99700,0,126600
143020201700000,NW 324,RESIDENTIAL,25600,0,25600,102700,0,128300
143020201800000,NW 324,RESIDENTIAL,25100,0,25100,85400,0,110500
143020201900000,NW 324,RESIDENTIAL,24800,0,24800,103200,0,128000
143020202000000,NW 324,RESIDENTIAL,24800,0,24800,82200,0,107000
143020202100000,NW 324,RESIDENTIAL,24800,0,24800,107200,0,132000
143020202200000,NW 324,RESIDENTIAL,24800,0,24800,116400,0,141200
143020202300000,NW 324,RESIDENTIAL,24800,0,24800,114700,0,139500
143020202400000,NW 324,RESIDENTIAL,24800,0,24800,96100,0,120900
143020202500000,NW 324,RESIDENTIAL,24800,0,24800,101200,0,126000
143020300100000,CITY PROPERTY,EXEMPT,0,0,0,0,0,0
143020300200000,NW 324,RESIDENTIAL,11600,0,11600,0,0,11600
143020300300000,NW 324,RESIDENTIAL,22900,0,22900,118000,0,140900
143020300400000,NW 324,RESIDENTIAL,22900,0,22900,98300,0,121200
143020300500000,NW 324,RESIDENTIAL,22600,0,22600,97700,0,120300
143020300600000,NW 324,RESIDENTIAL,22600,0,22600,92600,0,115200
143020300700000,NW 324,RESIDENTIAL,22600,0,22600,76800,0,99400
143020300800000,NW 324,RESIDENTIAL,22600,0,22600,91800,0,114400
143020300900000,NW 324,RESIDENTIAL,22600,0,22600,92900,0,115500
143020301000000,NW 324,RESIDENTIAL,24500,0,24500,117700,0,142200
143020301100000,NW 324,RESIDENTIAL,24900,0,24900,83000,0,107900
143020301200000,NW 324,RESIDENTIAL,22600,0,22600,89900,0,112500
143020301300000,NW 324,RESIDENTIAL,22600,0,22600,93200,0,115800
143020301400000,NW 324,RESIDENTIAL,22600,0,22600,87500,0,110100
143020301500000,NW 324,RESIDENTIAL,22600,0,22600,81500,0,104100
143020301600000,NW 324,RESIDENTIAL,22600,0,22600,88800,0,111400
143020301700000,NW 324,RESIDENTIAL,22900,0,22900,80400,0,103300
143020301800000,NW 324,RESIDENTIAL,22900,0,22900,96000,0,118900
143020400100000,NW 324,RESIDENTIAL,26100,0,26100,72800,0,98900
143020400200000,CITY PROPERTY,EXEMPT,0,0,0,0,0,0
143020400300000,CITY PROPERTY,EXEMPT,0,0,0,0,0,0
143020400400000,NW 324,RESIDENTIAL,25700,0,25700,96600,0,122300
143020400500000,NW 324,RESIDENTIAL,24800,0,24800,93500,0,118300
143020400600000,NW 324,RESIDENTIAL,24800,0,24800,94000,0,118800
143020400700000,NW 324,RESIDENTIAL,24800,0,24800,106400,0,131200
143020400800000,NW 324,RESIDENTIAL,24800,0,24800,102100,0,126900
143020400900000,NW 324,RESIDENTIAL,24800,0,24800,107000,0,131800
143020401000000,NW 324,RESIDENTIAL,24800,0,24800,90100,0,114900
143020401100000,NW 324,RESIDENTIAL,24800,0,24800,106800,0,131600
143020401200000,NW 324,RESIDENTIAL,24800,0,24800,100200,0,125000
143020401300000,NW 324,RESIDENTIAL,23800,0,23800,126000,0,149800
143020401500000,NW 324,RESIDENTIAL,24300,0,24300,53700,0,78000
143020401600000,NW 324,RESIDENTIAL,31500,0,31500,61300,0,92800
143020401700000,NW 324,RESIDENTIAL,23300,0,23300,79400,0,102700
143020401800000,NW 324,RESIDENTIAL,26200,0,26200,86600,0,112800
143020401900000,NW 324,RESIDENTIAL,25000,0,25000,78800,0,103800
143020402000000,NW 324,RESIDENTIAL,24900,0,24900,89100,0,114000
143020402100000,NW 324,RESIDENTIAL,24200,0,24200,97900,0,122100
143020402200000,NW 324,RESIDENTIAL,24200,0,24200,97400,0,121600
143020402300000,NW 324,RESIDENTIAL,24200,0,24200,87500,0,111700
143020402400000,NW 324,RESIDENTIAL,24200,0,24200,98700,0,122900
143020402500000,NW 324,RESIDENTIAL,24200,0,24200,100300,0,124500
143020402600000,NW 324,RESIDENTIAL,24200,0,24200,107100,0,131300
143020402700000,NW 324,RESIDENTIAL,24600,0,24600,81900,0,106500
143020402800000,NW 324,RESIDENTIAL,24600,0,24600,108000,0,132600
143020402900000,NW 324,RESIDENTIAL,24600,0,24600,90500,0,115100
143020403000000,NW 324,RESIDENTIAL,24600,0,24600,122900,0,147500
143020500100000,NW 324,RESIDENTIAL,23500,0,23500,89100,0,112600
143020500200000,NW 324,RESIDENTIAL,22300,0,22300,109500,0,131800
143020500300000,NW 324,RESIDENTIAL,22600,0,22600,97900,0,120500
143020500400000,NW 324,RESIDENTIAL,22600,0,22600,93300,0,115900
143020500500000,NW 324,RESIDENTIAL,22600,0,22600,79300,0,101900
143020500600000,NW 324,RESIDENTIAL,22700,0,22700,80500,0,103200
143022600100000,NW 324,RESIDENTIAL,22600,0,22600,94100,0,116700
143022600200000,NW 324,RESIDENTIAL,22600,0,22600,107700,0,130300
143022600300000,NW 324,RESIDENTIAL,22600,0,22600,117600,0,140200
143022600400000,NW 324,RESIDENTIAL,22300,0,22300,93700,0,116000
143022600500000,NW 324,RESIDENTIAL,22300,0,22300,78400,0,100700
143022600600000,NW 324,RESIDENTIAL,22300,0,22300,90800,0,113100
143022600700000,NW 324,RESIDENTIAL,22300,0,22300,95800,0,118100
143022600800000,NW 324,RESIDENTIAL,22300,0,22300,95200,0,117500
143022600900000,NW 324,RESIDENTIAL,22300,0,22300,92300,0,114600
143022601000000,NW 324,RESIDENTIAL,21800,0,21800,92000,0,113800
143022601100000,NW 324,RESIDENTIAL,22000,0,22000,96800,0,118800
143022601200000,NW 324,RESIDENTIAL,11200,0,11200,0,0,11200
143022601300000,NW 324,RESIDENTIAL,31800,0,31800,73400,0,105200
143022601400000,NW 324,RESIDENTIAL,22900,0,22900,86200,0,109100
143022601500000,NW 324,RESIDENTIAL,22600,0,22600,101500,0,124100
143022601600000,NW 324,RESIDENTIAL,23500,0,23500,76000,0,99500
143022601700000,NW 324,RESIDENTIAL,22700,0,22700,82600,0,105300
143022601800000,NW 324,RESIDENTIAL,22300,0,22300,88300,0,110600
143022601900000,NW 324,RESIDENTIAL,22300,0,22300,88900,0,111200
143022602000000,NW 324,RESIDENTIAL,22300,0,22300,96600,0,118900
143022602100000,NW 324,RESIDENTIAL,22300,0,22300,82400,0,104700
143022602200000,NW 324,RESIDENTIAL,22300,0,22300,95200,0,117500
143022602300000,NW 324,RESIDENTIAL,22300,0,22300,86000,0,108300
143022602400000,NW 324,RESIDENTIAL,22600,0,22600,90400,0,113000
143022700100000,CENTRALLY ASSESSED,OTHER,0,0,0,0,0,0
143022700200000,NW 324,RESIDENTIAL,26500,0,26500,88200,0,114700
143022700300000,NW 324,RESIDENTIAL,26700,0,26700,85100,0,111800
143022700400000,NW 324,RESIDENTIAL,27500,0,27500,108800,0,136300
143022700500000,NW 324,RESIDENTIAL,25900,0,25900,94000,0,119900
143022700600000,NW 324,RESIDENTIAL,28400,0,28400,90700,0,119100
143022700700000,NW 324,RESIDENTIAL,28300,0,28300,103800,0,132100
143022700800000,NW 324,RESIDENTIAL,29100,0,29100,99000,0,128100
143022700900000,NW 324,RESIDENTIAL,34300,0,34300,81800,0,116100
143022701000000,NW 324,RESIDENTIAL,23000,0,23000,92500,0,115500
143022701100000,NW 324,RESIDENTIAL,22800,0,22800,113800,0,136600
143022701200000,NW 324,RESIDENTIAL,22800,0,22800,91800,0,114600
143022701300000,NW 324,RESIDENTIAL,22800,0,22800,95800,0,118600
143022701400000,NW 324,RESIDENTIAL,22800,0,22800,78100,0,100900
143022701500000,NW 324,RESIDENTIAL,22800,0,22800,106000,0,128800
143022701600000,NW 324,RESIDENTIAL,22800,0,22800,92800,0,115600
143022701700000,NW 324,RESIDENTIAL,22800,0,22800,88200,0,111000
143022701800000,NW 324,RESIDENTIAL,22800,0,22800,120300,0,143100
143022701900000,NW 324,RESIDENTIAL,22800,0,22800,94400,0,117200
143022702000000,NW 324,RESIDENTIAL,22800,0,22800,84600,0,107400
143022702100000,NW 324,RESIDENTIAL,22800,0,22800,112200,0,135000
143022702200000,NW 324,RESIDENTIAL,22800,0,22800,83500,0,106300
143022800100000,FLAT PARKING,COMMERCIAL,0,51300,51300,0,2100,53400
143022800400000,NBHD SHOPPING CENTER,COMMERCIAL,0,961000,961000,0,2767700,3728700
143022800500000,NBHD SHOPPING CENTER,COMMERCIAL,0,582400,582400,0,1055000,1637400
143022800600000,CARWASH,COMMERCIAL,17496,176904,194400,13806,150094,358300
143022800900000,LG DISCOUNT/RETAIL,COMMERCIAL,0,39600,39600,0,166900,206500
143022801000000,SMALL RETAIL,COMMERCIAL,0,151900,151900,0,113700,265600
143022801100000,SMALL RETAIL,COMMERCIAL,0,155000,155000,0,110800,265800
143022801200000,RESTAURANT,COMMERCIAL,24393,27507,51900,86144,86656,224700
143022801300000,SMALL RETAIL,COMMERCIAL,0,49000,49000,0,81700,130700
143022801400000,NW 324,RESIDENTIAL,27700,0,27700,57700,0,85400
143022801500000,NW 324,RESIDENTIAL,22300,0,22300,88700,0,111000
143022801600000,NW 324,RESIDENTIAL,28300,0,28300,93700,0,122000
143022801700000,NW 324,RESIDENTIAL,29100,0,29100,101000,0,130100
143022801800000,NW 324,RESIDENTIAL,28300,0,28300,84800,0,113100
143022801900000,NW 324,RESIDENTIAL,26300,0,26300,77200,0,103500
143022802000000,NW 324,RESIDENTIAL,25900,0,25900,100600,0,126500
143022802100000,NW 324,RESIDENTIAL,25900,0,25900,83500,0,109400
143022802200000,NW 324,RESIDENTIAL,27100,0,27100,100200,0,127300
143022802300000,NW 324,RESIDENTIAL,26100,0,26100,141400,0,167500
143022802400000,VACANT LAND,COMMERCIAL,0,3000,3000,0,0,3000
143022802500000,VACANT LAND,COMMERCIAL,0,37300,37300,0,0,37300
143022802600000,VACANT LAND,COMMERCIAL,0,18400,18400,0,0,18400
143022802700000,VACANT LAND,COMMERCIAL,0,18400,18400,0,0,18400
143022802800000,VACANT LAND,COMMERCIAL,0,20400,20400,0,0,20400
143022802900000,VACANT LAND,COMMERCIAL,0,20200,20200,0,0,20200
143022803000000,VACANT LAND,COMMERCIAL,0,17400,17400,0,0,17400
143022803100000,FAST FOOD,COMMERCIAL,0,133200,133200,0,208700,341900
143022900700000,VACANT LAND,COMMERCIAL,0,200,200,0,0,200
143022900800000,VACANT LAND,COMMERCIAL,0,0,0,0,0,0
143025100100000,OFFICE,COMMERCIAL,53674,60526,114200,56412,58088,228700
143025100200000,OFFICE,COMMERCIAL,42588,66612,109200,47000,118600,274800
143025100500000,APARTMENT,MULTI-RES,15000,0,15000,109000,0,124000
143025100600000,APARTMENT,MULTI-RES,16400,0,16400,101300,0,117700
143025100700000,APARTMENT,RESIDENTIAL,16600,0,16600,120000,0,136600
143025100800000,NW 333,RESIDENTIAL,28600,0,28600,96200,0,124800
143025100900000,NW 333,RESIDENTIAL,36000,0,36000,133000,0,169000
143025101000000,NW 333,RESIDENTIAL,44800,0,44800,149900,0,194700
143025101100000,NW 333,RESIDENTIAL,33000,0,33000,122700,0,155700
143025101200000,NW 333,RESIDENTIAL,33200,0,33200,100600,0,133800
143025101300000,NW 333,RESIDENTIAL,35100,0,35100,105600,0,140700
143025101400000,NW 333,RESIDENTIAL,35100,0,35100,95800,0,130900
143025101500000,NW 333,RESIDENTIAL,35100,0,35100,101500,0,136600
143025101600000,NW 333,RESIDENTIAL,35100,0,35100,78200,0,113300
143025101700000,NW 333,RESIDENTIAL,35800,0,35800,122000,0,157800
143025101800000,NW 333,RESIDENTIAL,32800,0,32800,103200,0,136000
143025101900000,NW 333,RESIDENTIAL,31200,0,31200,98600,0,129800
143025102000000,NW 333,RESIDENTIAL,31900,0,31900,89800,0,121700
143025102100000,NW 333,RESIDENTIAL,31200,0,31200,138500,0,169700
143025102200000,NW 333,RESIDENTIAL,31800,0,31800,174200,0,206000
143025102300000,NW 333,RESIDENTIAL,31800,0,31800,160100,0,191900
143025102400000,NW 333,RESIDENTIAL,31000,0,31000,166000,0,197000
143025102500000,NW 333,RESIDENTIAL,52000,0,52000,354700,0,406700
143025102600000,NW 324,RESIDENTIAL,57900,0,57900,0,0,57900
143025200100000,APARTMENT,MULTI-RES,18000,0,18000,116000,0,134000
143025200200000,APARTMENT,RESIDENTIAL,18000,0,18000,116900,0,134900
143025200300000,VACANT LAND,COMMERCIAL,0,304500,304500,0,0,304500
143025200302000,ANTENNAS/TOWERS(BLL),COMMERCIAL,0,0,0,0,86000,86000
143025200400000,NW 333,RESIDENTIAL,31400,0,31400,129300,0,160700
143025200500000,NW 333,RESIDENTIAL,37200,0,37200,132100,0,169300
143025200600000,NW 333,RESIDENTIAL,36000,0,36000,98000,0,134000
143025200700000,NW 333,RESIDENTIAL,30500,0,30500,119100,0,149600
143025200800000,NW 333,RESIDENTIAL,30500,0,30500,91800,0,122300
143025200900000,NW 333,RESIDENTIAL,30500,0,30500,83100,0,113600
143025201000000,NW 333,RESIDENTIAL,30500,0,30500,101800,0,132300
143025201100000,NW 333,RESIDENTIAL,30500,0,30500,88000,0,118500
143025201200000,NW 333,RESIDENTIAL,30800,0,30800,107400,0,138200
143025201300000,NW 333,RESIDENTIAL,30000,0,30000,93300,0,123300
143025201400000,NW 333,RESIDENTIAL,29700,0,29700,93600,0,123300
143025201500000,NW 333,RESIDENTIAL,29700,0,29700,89400,0,119100
143025201600000,NW 333,RESIDENTIAL,30200,0,30200,118000,0,148200
143025201700000,NW 333,RESIDENTIAL,30200,0,30200,104100,0,134300
143025201800000,NW 333,RESIDENTIAL,30200,0,30200,119500,0,149700
143025201900000,NW 333,RESIDENTIAL,29700,0,29700,101100,0,130800
143025202000000,NW 333,RESIDENTIAL,30000,0,30000,114800,0,144800
143025202100000,NW 333,RESIDENTIAL,29600,0,29600,119600,0,149200
143025202200000,NW 333,RESIDENTIAL,29100,0,29100,97800,0,126900
143025202300000,NW 333,RESIDENTIAL,30000,0,30000,100200,0,130200
143025202400000,NW 333,RESIDENTIAL,27000,0,27000,113800,0,140800
143025202500000,NW 333,RESIDENTIAL,29600,0,29600,124700,0,154300
143025202600000,NW 333,RESIDENTIAL,29500,0,29500,101200,0,130700
143025202700000,NW 333,RESIDENTIAL,29100,0,29100,109700,0,138800
143025202800000,APARTMENT,RESIDENTIAL,17900,0,17900,138200,0,156100
143025300200000,CONVENIENCE STORE,COMMERCIAL,0,637000,637000,0,595800,1232800
143025300300000,NBHD SHOPPING CENTER,COMMERCIAL,0,294800,294800,0,240100,534900
143025300400000,NW 333,RESIDENTIAL,29000,0,29000,70800,0,99800
143025300500000,NW 333,RESIDENTIAL,29100,0,29100,81200,0,110300
143025300600000,NW 333,RESIDENTIAL,29100,0,29100,89600,0,118700
143025300700000,NW 333,RESIDENTIAL,29100,0,29100,97700,0,126800
143025300800000,NW 333,RESIDENTIAL,29100,0,29100,76900,0,106000
143025300900000,NW 333,RESIDENTIAL,30700,0,30700,87400,0,118100
143025301000000,NW 333,RESIDENTIAL,29100,0,29100,83700,0,112800
143025301100000,NW 333,RESIDENTIAL,29100,0,29100,80200,0,109300
143025301200000,NW 333,RESIDENTIAL,29100,0,29100,65000,0,94100
143025301300000,NW 333,RESIDENTIAL,29100,0,29100,95100,0,124200
143025301400000,NW 333,RESIDENTIAL,30300,0,30300,92200,0,122500
143025400100000,NW 333,RESIDENTIAL,29600,0,29600,124300,0,153900
143025400200000,NW 333,RESIDENTIAL,30100,0,30100,106700,0,136800
143025400300000,NW 333,RESIDENTIAL,29700,0,29700,96300,0,126000
143025400400000,NW 333,RESIDENTIAL,30200,0,30200,97000,0,127200
143025400500000,NW 333,RESIDENTIAL,29700,0,29700,88600,0,118300
143025400600000,NW 333,RESIDENTIAL,30200,0,30200,97600,0,127800
143025400700000,NW 333,RESIDENTIAL,29700,0,29700,102400,0,132100
143025400800000,NW 333,RESIDENTIAL,30200,0,30200,97600,0,127800
143025400900000,NW 333,RESIDENTIAL,29700,0,29700,97300,0,127000
143025401000000,NW 333,RESIDENTIAL,28400,0,28400,97400,0,125800
143025401100000,NW 333,RESIDENTIAL,31400,0,31400,130100,0,161500
143025401200000,NW 333,RESIDENTIAL,30200,0,30200,92600,0,122800
143025401300000,NW 333,RESIDENTIAL,29700,0,29700,90200,0,119900
143025401400000,NW 333,RESIDENTIAL,30400,0,30400,103100,0,133500
143025401500000,NW 333,RESIDENTIAL,31800,0,31800,112900,0,144700
143025401600000,NW 333,RESIDENTIAL,30000,0,30000,99300,0,129300
143025401700000,NW 333,RESIDENTIAL,30200,0,30200,130300,0,160500
143025401800000,NW 333,RESIDENTIAL,29700,0,29700,114500,0,144200
143025401900000,NW 333,RESIDENTIAL,30200,0,30200,96900,0,127100
143025402000000,NW 333,RESIDENTIAL,29700,0,29700,143100,0,172800
143025402100000,NW 333,RESIDENTIAL,30200,0,30200,145000,0,175200
143025402200000,NW 333,RESIDENTIAL,29700,0,29700,124800,0,154500
143025402300000,NW 333,RESIDENTIAL,30200,0,30200,95900,0,126100
143025402400000,NW 333,RESIDENTIAL,29700,0,29700,130700,0,160400
143025402500000,NW 333,RESIDENTIAL,30200,0,30200,132100,0,162300
143025402600000,NW 333,RESIDENTIAL,29700,0,29700,128100,0,157800
143025500100000,NW 333,RESIDENTIAL,29100,0,29100,88500,0,117600
143025500200000,NW 333,RESIDENTIAL,29100,0,29100,111200,0,140300
143025500300000,NW 333,RESIDENTIAL,29100,0,29100,123800,0,152900
143025500400000,NW 333,RESIDENTIAL,29100,0,29100,84300,0,113400
143025500500000,NW 333,RESIDENTIAL,28200,0,28200,69500,0,97700
143025500600000,NW 333,RESIDENTIAL,28200,0,28200,104900,0,133100
143025500700000,NW 333,RESIDENTIAL,28100,0,28100,84300,0,112400
143025500800000,NW 333,RESIDENTIAL,29200,0,29200,104700,0,133900
143025500900000,NW 333,RESIDENTIAL,28200,0,28200,75400,0,103600
143025501000000,NW 333,RESIDENTIAL,28200,0,28200,112600,0,140800
143025600100000,NW 333,RESIDENTIAL,33300,0,33300,164300,0,197600
143025600200000,NW 333,RESIDENTIAL,33300,0,33300,166200,0,199500
143025600300000,NW 333,RESIDENTIAL,30900,0,30900,105600,0,136500
143025600400000,NW 333,RESIDENTIAL,28800,0,28800,123700,0,152500
143025600500000,NW 333,RESIDENTIAL,28000,0,28000,123900,0,151900
143027600100000,NW 324,RESIDENTIAL,33800,0,33800,89300,0,123100
143027600200000,NW 324,RESIDENTIAL,24200,0,24200,81700,0,105900
143027600300000,NW 324,RESIDENTIAL,24200,0,24200,39000,0,63200
143027600400000,NW 324,RESIDENTIAL,24200,0,24200,79800,0,104000
143027600500000,NW 324,RESIDENTIAL,24200,0,24200,71000,0,95200
143027600600000,NW 324,RESIDENTIAL,24200,0,24200,88500,0,112700
143027600700000,NW 324,RESIDENTIAL,28300,0,28300,78800,0,107100
143027600800000,NW 324,RESIDENTIAL,28300,0,28300,149300,0,177600
143027600900000,NW 324,RESIDENTIAL,29100,0,29100,85700,0,114800
143027601000000,NW 324,RESIDENTIAL,28300,0,28300,109100,0,137400
143027601100000,NW 324,RESIDENTIAL,28300,0,28300,85600,0,113900
143027601200000,NW 324,RESIDENTIAL,28300,0,28300,85500,0,113800
143027601300000,NW 324,RESIDENTIAL,28300,0,28300,84400,0,112700
143027601400000,NW 324,RESIDENTIAL,30300,0,30300,134100,0,164400
143027700200000,NW 324,RESIDENTIAL,24700,0,24700,77500,0,102200
143027700300000,NW 324,RESIDENTIAL,18400,0,18400,45500,0,63900
143027700400000,NW 324,RESIDENTIAL,18400,0,18400,98500,0,116900
143027700500000,NW 324,RESIDENTIAL,18400,0,18400,65200,0,83600
143027700600000,NW 324,RESIDENTIAL,24200,0,24200,0,0,24200
143027700700000,NW 324,RESIDENTIAL,24200,0,24200,63000,0,87200
143027700800000,NW 324,RESIDENTIAL,24200,0,24200,23500,0,47700
143027700900000,NW 324,RESIDENTIAL,45400,0,45400,144600,0,190000
143027701000000,NW 324,RESIDENTIAL,33000,0,33000,69800,0,102800
143027701100000,NW 324,RESIDENTIAL,31100,0,31100,81900,0,113000
143027701200000,NW 324,RESIDENTIAL,40200,0,40200,96800,0,137000
143027701300000,NW 324,RESIDENTIAL,30300,0,30300,154100,0,184400
143027701400000,NW 324,RESIDENTIAL,30300,0,30300,85300,0,115600
143027701500000,NW 324,RESIDENTIAL,29100,0,29100,80700,0,109800
143027701600000,NW 324,RESIDENTIAL,29100,0,29100,91100,0,120200
143027701700000,NW 324,RESIDENTIAL,24200,0,24200,76500,0,100700
143027701800000,NW 324,RESIDENTIAL,24200,0,24200,83000,0,107200
143027701900000,NW 324,RESIDENTIAL,20200,0,20200,80700,0,100900
143027702000000,NW 324,RESIDENTIAL,28300,0,28300,109100,0,137400
143027702100000,NW 324,RESIDENTIAL,24200,0,24200,94200,0,118400
143027702200000,NW 324,RESIDENTIAL,24200,0,24200,97500,0,121700
143027702300000,NW 324,RESIDENTIAL,24200,0,24200,60800,0,85000
143027702400000,NW 324,RESIDENTIAL,24200,0,24200,70900,0,95100
143027702600000,NW 324,RESIDENTIAL,34000,0,34000,0,0,34000
143027702800000,NW 324,RESIDENTIAL,26600,0,26600,68300,0,94900
143027703000000,NW 324,RESIDENTIAL,100,0,100,0,0,100
143027703100000,NW 324,RESIDENTIAL,30700,0,30700,90100,0,120800
143027800100000,NW 324,RESIDENTIAL,18400,0,18400,111600,0,130000
143027800200000,NW 324,RESIDENTIAL,18400,0,18400,64700,0,83100
143027800300000,NW 324,RESIDENTIAL,18400,0,18400,69000,0,87400
143027800400000,AUTO REPAIR/SALES,COMMERCIAL,48720,67280,116000,50516,36084,202600
143027800402000,CARWASH,COMMERCIAL,0,0,0,0,41500,41500
143027800500000,FAST FOOD,COMMERCIAL,0,102900,102900,0,200000,302900
143027800600000,OFFICE,COMMERCIAL,0,101400,101400,0,168700,270100
143027800700000,MFG HOME PARK,MULTI-RES,326000,0,326000,249600,0,575600
143027800800000,NW 333,RESIDENTIAL,31000,0,31000,152400,0,183400
143027800900000,NW 333,RESIDENTIAL,31800,0,31800,153000,0,184800
143027801000000,NW 333,RESIDENTIAL,31800,0,31800,178100,0,209900
143027801100000,NW 324,RESIDENTIAL,57500,0,57500,84800,0,142300
143027801200000,NW 324,RESIDENTIAL,5000,0,5000,0,0,5000
143027801300000,NW 324,RESIDENTIAL,31200,0,31200,85600,0,116800
143027801400000,NW 324,RESIDENTIAL,23100,0,23100,73600,0,96700
143027801500000,NW 324,RESIDENTIAL,28500,0,28500,69900,0,98400
143027801600000,NW 324,RESIDENTIAL,28200,0,28200,70800,0,99000
143027801700000,NW 324,RESIDENTIAL,900,0,900,0,0,900
143027801800000,APARTMENT,MULTI-RES,70900,0,70900,171900,0,242800
143027801900000,NW 324,RESIDENTIAL,9500,0,9500,0,0,9500
143027802000000,NW 324,RESIDENTIAL,24200,0,24200,25800,0,50000
143027802100000,NW 324,RESIDENTIAL,24200,0,24200,77600,0,101800
143027802200000,NW 324,RESIDENTIAL,24200,0,24200,29000,0,53200
143027802400000,NW 333,RESIDENTIAL,31000,0,31000,164700,0,195700
143027802500000,NW 333,RESIDENTIAL,31000,0,31000,157700,0,188700
143027802600000,NW 333,RESIDENTIAL,31000,0,31000,164400,0,195400
143027802700000,NW 333,RESIDENTIAL,31000,0,31000,159300,0,190300
143027900100000,NW 324,RESIDENTIAL,36700,0,36700,102900,0,139600
143027900200000,NW 324,RESIDENTIAL,36600,0,36600,106300,0,142900
143027900300000,NW 324,RESIDENTIAL,36600,0,36600,86400,0,123000
143027900400000,NW 324,RESIDENTIAL,36700,0,36700,108600,0,145300
143027900500000,NW 324,RESIDENTIAL,23300,0,23300,135700,0,159000
143028000100000,NW 333,RESIDENTIAL,33800,0,33800,176100,0,209900
143028000200000,NW 333,RESIDENTIAL,33600,0,33600,168900,0,202500
143028000300000,NW 333,RESIDENTIAL,30700,0,30700,161600,0,192300
143028000400000,NW 333,RESIDENTIAL,28800,0,28800,174300,0,203100
143028000500000,NW 333,RESIDENTIAL,28800,0,28800,198200,0,227000
143028000600000,CITY PROPERTY,EXEMPT,0,0,0,0,0,0
143028100100000,NW 333,RESIDENTIAL,1300,0,1300,0,0,1300
143030100100000,CHURCH,EXEMPT,0,367200,367200,0,819300,1186500
143030100200000,NW 333,RESIDENTIAL,25900,0,25900,109600,0,135500
143030100300000,NW 333,RESIDENTIAL,25900,0,25900,121800,0,147700
143030100400000,NW 333,RESIDENTIAL,26000,0,26000,100300,0,126300
143030100500000,NW 333,RESIDENTIAL,26200,0,26200,107000,0,133200
143030100600000,NW 333,RESIDENTIAL,26200,0,26200,122500,0,148700
143030100700000,NW 333,RESIDENTIAL,26200,0,26200,116800,0,143000
143030100800000,NW 333,RESIDENTIAL,37300,0,37300,137300,0,174600
143030100900000,NW 333,RESIDENTIAL,28300,0,28300,96900,0,125200
143030101000000,CITY PROPERTY,EXEMPT,0,0,0,0,0,0
143030101100000,NW 333,RESIDENTIAL,32100,0,32100,118500,0,150600
143030101200000,NW 333,RESIDENTIAL,29200,0,29200,138900,0,168100
143030101300000,NW 333,RESIDENTIAL,27500,0,27500,94600,0,122100
143030101400000,NW 333,RESIDENTIAL,24200,0,24200,91600,0,115800
143030101500000,NW 333,RESIDENTIAL,27500,0,27500,108300,0,135800
143030200100000,NW 333,RESIDENTIAL,26000,0,26000,117200,0,143200
143030200200000,NW 333,RESIDENTIAL,25300,0,25300,93300,0,118600
143030200300000,NW 333,RESIDENTIAL,24800,0,24800,87800,0,112600
143030200400000,NW 333,RESIDENTIAL,26700,0,26700,97200,0,123900
143030200500000,NW 333,RESIDENTIAL,28900,0,28900,92200,0,121100
143030200600000,NW 333,EXEMPT,0,39200,39200,0,122900,162100
143030300100000,NW 333,RESIDENTIAL,29000,0,29000,143000,0,172000
143030300200000,NW 333,RESIDENTIAL,30600,0,30600,108500,0,139100
143030300300000,NW 333,RESIDENTIAL,33300,0,33300,133700,0,167000
143030300400000,NW 333,RESIDENTIAL,32900,0,32900,125600,0,158500
143030300500000,NW 333,RESIDENTIAL,28900,0,28900,122900,0,151800
143030300600000,NW 333,RESIDENTIAL,29100,0,29100,112700,0,141800
143030300700000,NW 333,RESIDENTIAL,26600,0,26600,93700,0,120300
143030300800000,NW 333,RESIDENTIAL,26600,0,26600,99400,0,126000
143030300900000,NW 333,RESIDENTIAL,26600,0,26600,102100,0,128700
143030301000000,NW 333,RESIDENTIAL,26600,0,26600,92400,0,119000
143030301100000,NW 333,RESIDENTIAL,26600,0,26600,91400,0,118000
143030301200000,NW 333,RESIDENTIAL,26600,0,26600,86400,0,113000
143030301300000,NW 333,RESIDENTIAL,27700,0,27700,91500,0,119200
143030301400000,NW 333,RESIDENTIAL,27500,0,27500,93200,0,120700
143030301500000,NW 333,RESIDENTIAL,56300,0,56300,153400,0,209700
143030301600000,NW 333,RESIDENTIAL,39900,0,39900,103500,0,143400
143030301700000,NW 333,RESIDENTIAL,32100,0,32100,143600,0,175700
143030301800000,NW 333,RESIDENTIAL,31500,0,31500,73200,0,104700
143030301900000,NW 333,RESIDENTIAL,28000,0,28000,130400,0,158400
143030302000000,NW 333,RESIDENTIAL,26500,0,26500,109100,0,135600
143030302100000,NW 333,RESIDENTIAL,29500,0,29500,141800,0,171300
143030302200000,NW 333,RESIDENTIAL,26600,0,26600,121200,0,147800
143030400100000,NW 333,RESIDENTIAL,56700,0,56700,900,0,57600
143030400200000,NW 333,RESIDENTIAL,36600,0,36600,149000,0,185600
143030400300000,NW 333,RESIDENTIAL,30000,0,30000,112900,0,142900
143030400400000,NW 333,RESIDENTIAL,28000,0,28000,151700,0,179700
143030400500000,NW 333,RESIDENTIAL,28200,0,28200,135900,0,164100
143030400600000,NW 333,RESIDENTIAL,24300,0,24300,102400,0,126700
143030400700000,NW 333,RESIDENTIAL,48300,0,48300,83000,0,131300
143030400800000,NW 333,RESIDENTIAL,23800,0,23800,95600,0,119400
143030400900000,NW 333,RESIDENTIAL,28900,0,28900,93300,0,122200
143030401000000,NW 333,RESIDENTIAL,51200,0,51200,199200,0,250400
143030401100000,NW 333,RESIDENTIAL,57400,0,57400,190100,0,247500
143030401200000,NW 333,RESIDENTIAL,31100,0,31100,135900,0,167000
143030401300000,NW 333,RESIDENTIAL,31400,0,31400,127800,0,159200
143030401400000,NW 333,RESIDENTIAL,30700,0,30700,127000,0,157700
143030401500000,NW 333,RESIDENTIAL,30300,0,30300,118900,0,149200
143030401600000,NW 333,RESIDENTIAL,30700,0,30700,99000,0,129700
143030500200000,CHURCH,EXEMPT,0,422400,422400,0,1040400,1462800
143030500300000,NW 333,RESIDENTIAL,35800,0,35800,96600,0,132400
143030500400000,NW 333,RESIDENTIAL,59200,0,59200,353600,0,412800
143030500500000,NW 333,RESIDENTIAL,28400,0,28400,65600,0,94000
143030500600000,NW 333,RESIDENTIAL,25700,0,25700,64900,0,90600
143030500700000,NW 333,RESIDENTIAL,34000,0,34000,90600,0,124600
143030500800000,NW 333,RESIDENTIAL,22900,0,22900,97100,0,120000
143032600100000,NW 333,RESIDENTIAL,29200,0,29200,124900,0,154100
143032600200000,NW 333,RESIDENTIAL,27700,0,27700,103500,0,131200
143032600300000,NW 333,RESIDENTIAL,27700,0,27700,107000,0,134700
143032600400000,NW 333,RESIDENTIAL,27700,0,27700,101100,0,128800
143032700100000,NW 333,RESIDENTIAL,24700,0,24700,96000,0,120700
143032700200000,NW 333,RESIDENTIAL,26200,0,26200,93200,0,119400
143032700300000,NW 333,RESIDENTIAL,26000,0,26000,97300,0,123300
143032700400000,NW 333,RESIDENTIAL,28200,0,28200,104100,0,132300
143032800100000,NW 333,RESIDENTIAL,31600,0,31600,89300,0,120900
143032800200000,NW 333,RESIDENTIAL,29100,0,29100,101100,0,130200
143032800300000,NW 333,RESIDENTIAL,29400,0,29400,104400,0,133800
143032900100000,NW 333,RESIDENTIAL,28900,0,28900,118200,0,147100
143032900200000,NW 333,RESIDENTIAL,29100,0,29100,111300,0,140400
143032900300000,NW 333,RESIDENTIAL,29100,0,29100,105100,0,134200
143032900400000,NW 333,RESIDENTIAL,29400,0,29400,99000,0,128400
143033000100000,NW 333,RESIDENTIAL,29400,0,29400,110700,0,140100
143033000200000,NW 333,RESIDENTIAL,26100,0,26100,106300,0,132400
143033000300000,NW 333,RESIDENTIAL,26400,0,26400,111100,0,137500
143033000400000,NW 333,RESIDENTIAL,27700,0,27700,110100,0,137800
143033000500000,NW 333,RESIDENTIAL,26200,0,26200,90500,0,116700
143033000600000,NW 333,RESIDENTIAL,27700,0,27700,112400,0,140100
143033000700000,NW 333,RESIDENTIAL,27700,0,27700,95100,0,122800
143033000800000,NW 333,RESIDENTIAL,29600,0,29600,129900,0,159500
143033000900000,NW 333,RESIDENTIAL,30000,0,30000,86700,0,116700
143033001000000,NW 333,RESIDENTIAL,30000,0,30000,91000,0,121000
143033001100000,NW 333,RESIDENTIAL,30000,0,30000,92500,0,122500
143033001200000,NW 333,RESIDENTIAL,29100,0,29100,105600,0,134700
143033001300000,NW 333,RESIDENTIAL,30000,0,30000,86500,0,116500
143033001400000,NW 333,RESIDENTIAL,30000,0,30000,86800,0,116800
143033001500000,NW 333,RESIDENTIAL,30000,0,30000,82300,0,112300
143033001600000,NW 333,RESIDENTIAL,30000,0,30000,84200,0,114200
143033001700000,NW 333,RESIDENTIAL,30000,0,30000,85200,0,115200
143033001800000,NW 333,RESIDENTIAL,29700,0,29700,84900,0,114600
143033001900000,NW 333,RESIDENTIAL,25800,0,25800,88100,0,113900
143033002000000,NW 333,RESIDENTIAL,25500,0,25500,80500,0,106000
143033002100000,NW 333,RESIDENTIAL,25500,0,25500,92200,0,117700
143033002200000,NW 333,RESIDENTIAL,25500,0,25500,83500,0,109000
143033002300000,NW 333,RESIDENTIAL,25500,0,25500,88800,0,114300
143033002400000,NW 333,RESIDENTIAL,25500,0,25500,91200,0,116700
143033002500000,NW 333,RESIDENTIAL,24700,0,24700,89700,0,114400
143033002600000,NW 333,RESIDENTIAL,28800,0,28800,112400,0,141200
143033002700000,NW 333,RESIDENTIAL,28600,0,28600,110300,0,138900
143033002800000,NW 333,RESIDENTIAL,26000,0,26000,118200,0,144200
143033002900000,NW 333,RESIDENTIAL,25400,0,25400,73100,0,98500
143033003000000,NW 333,RESIDENTIAL,29800,0,29800,107400,0,137200
143033003100000,NW 333,RESIDENTIAL,28000,0,28000,94500,0,122500
143033003200000,NW 333,RESIDENTIAL,28000,0,28000,82400,0,110400
143033003300000,NW 333,RESIDENTIAL,26400,0,26400,100900,0,127300
143033003400000,NW 333,RESIDENTIAL,28000,0,28000,89400,0,117400
143033003500000,NW 333,RESIDENTIAL,28000,0,28000,85500,0,113500
143033003600000,NW 333,RESIDENTIAL,28000,0,28000,104100,0,132100
143033003700000,NW 333,RESIDENTIAL,28000,0,28000,119800,0,147800
143033100100000,NW 333,RESIDENTIAL,28000,0,28000,85200,0,113200
143033100200000,NW 333,RESIDENTIAL,28000,0,28000,91700,0,119700
143033100300000,NW 333,RESIDENTIAL,28000,0,28000,110400,0,138400
143033100400000,NW 333,RESIDENTIAL,28000,0,28000,135400,0,163400
143033100500000,NW 333,RESIDENTIAL,26400,0,26400,89700,0,116100
143033100600000,NW 333,RESIDENTIAL,28000,0,28000,105800,0,133800
143033100700000,NW 333,RESIDENTIAL,28000,0,28000,102200,0,130200
143033100800000,NW 333,RESIDENTIAL,29800,0,29800,95500,0,125300
143033100900000,NW 333,RESIDENTIAL,29400,0,29400,96700,0,126100
143033101000000,NW 333,RESIDENTIAL,29800,0,29800,98100,0,127900
143033101100000,NW 333,RESIDENTIAL,29700,0,29700,96500,0,126200
143033101200000,NW 333,RESIDENTIAL,24700,0,24700,94600,0,119300
143033101300000,NW 333,RESIDENTIAL,25100,0,25100,74800,0,99900
143033101400000,NW 333,RESIDENTIAL,25500,0,25500,85500,0,111000
143033101500000,NW 333,RESIDENTIAL,25500,0,25500,112400,0,137900
143033101600000,NW 333,RESIDENTIAL,25500,0,25500,109300,0,134800
143033101700000,NW 333,RESIDENTIAL,25500,0,25500,89700,0,115200
143033101800000,NW 333,RESIDENTIAL,25500,0,25500,80500,0,106000
143033101900000,NW 333,RESIDENTIAL,25300,0,25300,104800,0,130100
143033102000000,NW 333,RESIDENTIAL,25800,0,25800,89100,0,114900
143033102100000,NW 333,RESIDENTIAL,25500,0,25500,96100,0,121600
143033102200000,NW 333,RESIDENTIAL,25500,0,25500,89400,0,114900
143033102300000,NW 333,RESIDENTIAL,25500,0,25500,104900,0,130400
143033102400000,NW 333,RESIDENTIAL,25500,0,25500,88700,0,114200
143033102500000,NW 333,RESIDENTIAL,24700,0,24700,99100,0,123800
143033102600000,NW 333,RESIDENTIAL,28600,0,28600,107100,0,135700
143033102700000,NW 333,RESIDENTIAL,28800,0,28800,91900,0,120700
143033102800000,NW 333,RESIDENTIAL,26800,0,26800,112900,0,139700
143033102900000,NW 333,RESIDENTIAL,25900,0,25900,99100,0,125000
143033103000000,NW 333,RESIDENTIAL,28600,0,28600,105900,0,134500
143033103100000,NW 333,RESIDENTIAL,29700,0,29700,110500,0,140200
143033103200000,NW 333,RESIDENTIAL,29700,0,29700,119300,0,149000
143033103300000,NW 333,RESIDENTIAL,29900,0,29900,115400,0,145300
143033103400000,NW 333,RESIDENTIAL,29700,0,29700,116900,0,146600
143033103500000,NW 333,RESIDENTIAL,31000,0,31000,125100,0,156100
143033103600000,NW 333,RESIDENTIAL,28900,0,28900,119200,0,148100
143033103700000,NW 333,RESIDENTIAL,25800,0,25800,123800,0,149600
143033103800000,NW 333,RESIDENTIAL,27300,0,27300,98700,0,126000
143033103900000,NW 333,RESIDENTIAL,28500,0,28500,106700,0,135200
143033104000000,NW 333,RESIDENTIAL,28500,0,28500,104700,0,133200
143033104100000,NW 333,RESIDENTIAL,31000,0,31000,106100,0,137100
143033200100000,NW 333,RESIDENTIAL,31200,0,31200,96100,0,127300
143033200200000,NW 333,RESIDENTIAL,29900,0,29900,93800,0,123700
143033200300000,NW 333,RESIDENTIAL,29700,0,29700,86400,0,116100
143033200400000,NW 333,RESIDENTIAL,29700,0,29700,119900,0,149600
143033200500000,NW 333,RESIDENTIAL,30400,0,30400,136400,0,166800
143033200600000,NW 333,RESIDENTIAL,32600,0,32600,117400,0,150000
143033200700000,NW 333,RESIDENTIAL,28500,0,28500,109300,0,137800
143033200800000,NW 333,RESIDENTIAL,28500,0,28500,115300,0,143800
143033200900000,NW 333,RESIDENTIAL,31100,0,31100,99300,0,130400
143033201000000,NW 333,RESIDENTIAL,28800,0,28800,112400,0,141200
143033201100000,NW 333,RESIDENTIAL,28800,0,28800,97100,0,125900
143033201200000,NW 333,RESIDENTIAL,38600,0,38600,121400,0,160000
143033201300000,NW 333,RESIDENTIAL,30100,0,30100,103900,0,134000
143033201400000,NW 333,RESIDENTIAL,24700,0,24700,95300,0,120000
143033201500000,NW 333,RESIDENTIAL,25200,0,25200,83000,0,108200
143033201600000,NW 333,RESIDENTIAL,28500,0,28500,85500,0,114000
143033201700000,NW 333,RESIDENTIAL,25400,0,25400,105400,0,130800
143033201800000,NW 333,RESIDENTIAL,25200,0,25200,75000,0,100200
143033201900000,NW 333,RESIDENTIAL,23300,0,23300,37300,0,60600
143033202000000,NW 333,RESIDENTIAL,27000,0,27000,86400,0,113400
143033202100000,NW 333,RESIDENTIAL,21400,0,21400,0,0,21400
143033202200000,NW 333,RESIDENTIAL,17000,0,17000,73200,0,90200
143033202400000,NW 333,RESIDENTIAL,28400,0,28400,82400,0,110800
143033202500000,NW 333,RESIDENTIAL,27700,0,27700,97100,0,124800
143033202600000,NW 333,RESIDENTIAL,28200,0,28200,89300,0,117500
143033202700000,NW 333,RESIDENTIAL,34400,0,34400,58900,0,93300
143033202800000,NW 333,RESIDENTIAL,34000,0,34000,109100,0,143100
143033202900000,NW 333,RESIDENTIAL,39500,0,39500,96800,0,136300
143033203000000,NW 333,RESIDENTIAL,30300,0,30300,117100,0,147400
143033203100000,NW 333,RESIDENTIAL,28800,0,28800,92800,0,121600
143033203200000,NW 333,RESIDENTIAL,40200,0,40200,187500,0,227700
143033203300000,NW 333,RESIDENTIAL,41200,0,41200,78400,0,119600
143033300100000,NW 333,RESIDENTIAL,34300,0,34300,89100,0,123400
143033300200000,NW 333,RESIDENTIAL,32400,0,32400,101200,0,133600
143033300300000,NW 333,RESIDENTIAL,37800,0,37800,156600,0,194400
143033300400000,NW 333,RESIDENTIAL,37800,0,37800,132900,0,170700
143033300500000,NW 333,RESIDENTIAL,37800,0,37800,105900,0,143700
143033300600000,NW 333,RESIDENTIAL,37600,0,37600,139600,0,177200
143033400100000,NW 333,RESIDENTIAL,31100,0,31100,88400,0,119500
143033400200000,NW 333,RESIDENTIAL,29700,0,29700,91800,0,121500
143033400300000,NW 333,RESIDENTIAL,35200,0,35200,112300,0,147500
143033400400000,NW 333,RESIDENTIAL,35000,0,35000,129300,0,164300
143033400500000,NW 333,RESIDENTIAL,34000,0,34000,114500,0,148500
143033400600000,CHURCH,EXEMPT,0,326400,326400,0,642100,968500
143033400700000,NW 333,RESIDENTIAL,45100,0,45100,73200,0,118300
143033400800000,NW 333,RESIDENTIAL,38800,0,38800,127400,0,166200
143033400900000,NW 333,RESIDENTIAL,38900,0,38900,101100,0,140000
143033401000000,NW 333,RESIDENTIAL,4500,0,4500,0,0,4500
143033500100000,NW 333,RESIDENTIAL,31600,0,31600,98800,0,130400
143035100100000,NW 333,RESIDENTIAL,36700,0,36700,122400,0,159100
143035100200000,NW 333,RESIDENTIAL,35600,0,35600,98600,0,134200
143035100300000,NW 333,RESIDENTIAL,34200,0,34200,96500,0,130700
143035100400000,NW 333,RESIDENTIAL,33000,0,33000,121200,0,154200
143035100500000,NW 333,RESIDENTIAL,29100,0,29100,93700,0,122800
143035200100000,NW 333,RESIDENTIAL,29700,0,29700,131800,0,161500
143035200200000,NW 333,RESIDENTIAL,29700,0,29700,92800,0,122500
143035200300000,NW 333,RESIDENTIAL,27000,0,27000,79900,0,106900
143035200400000,NW 333,RESIDENTIAL,27100,0,27100,94000,0,121100
143035200500000,NW 333,RESIDENTIAL,28100,0,28100,73100,0,101200
143035200600000,NW 333,RESIDENTIAL,29100,0,29100,87400,0,116500
143035200700000,NW 333,RESIDENTIAL,31000,0,31000,90700,0,121700
143035200800000,NW 333,RESIDENTIAL,31000,0,31000,90500,0,121500
143035300100000,NW 333,RESIDENTIAL,29300,0,29300,95300,0,124600
143035300200000,NW 333,RESIDENTIAL,43800,0,43800,134900,0,178700
143035300300000,NW 333,RESIDENTIAL,35000,0,35000,106900,0,141900
143035300400000,NW 333,RESIDENTIAL,20400,0,20400,97700,0,118100
143035300500000,NW 333,RESIDENTIAL,23100,0,23100,95400,0,118500
143035300600000,NW 333,RESIDENTIAL,23100,0,23100,82600,0,105700
143035300700000,DAY CARE CENTER,COMMERCIAL,0,97600,97600,0,84600,182200
143035300800000,SR/NURSING/ASSTD LIV,MULTI-RES,52900,0,52900,631400,0,684300
143035300900000,NW 333,RESIDENTIAL,26300,0,26300,77900,0,104200
143035301000000,NW 333,RESIDENTIAL,26300,0,26300,62600,0,88900
143035301100000,NW 333,RESIDENTIAL,30800,0,30800,91600,0,122400
143035301200000,NW 333,RESIDENTIAL,29300,0,29300,95700,0,125000
143035301300000,NW 333,RESIDENTIAL,29300,0,29300,82600,0,111900
143035301400000,NW 333,RESIDENTIAL,29300,0,29300,91500,0,120800
143035301500000,NW 333,RESIDENTIAL,29300,0,29300,87400,0,116700
143035301600000,NW 333,RESIDENTIAL,29300,0,29300,96300,0,125600
143035301700000,NW 333,RESIDENTIAL,29300,0,29300,76400,0,105700
143035301800000,NW 333,RESIDENTIAL,29300,0,29300,99100,0,128400
143035301900000,NW 333,RESIDENTIAL,29300,0,29300,80800,0,110100
143035400100000,NW 333,RESIDENTIAL,29700,0,29700,96800,0,126500
143035400200000,NW 333,RESIDENTIAL,29700,0,29700,93000,0,122700
143035400300000,NW 333,EXEMPT,0,56500,56500,0,139200,195700
143035400400000,NW 333,RESIDENTIAL,29100,0,29100,84200,0,113300
143035400500000,NW 333,RESIDENTIAL,28700,0,28700,94100,0,122800
143035400600000,NW 333,RESIDENTIAL,27300,0,27300,81200,0,108500
143035400700000,NW 333,RESIDENTIAL,27000,0,27000,94200,0,121200
143035400800000,NW 333,RESIDENTIAL,32300,0,32300,110500,0,142800
143035400900000,NW 333,RESIDENTIAL,29300,0,29300,95700,0,125000
143035401000000,NW 333,RESIDENTIAL,29300,0,29300,65000,0,94300
143035401100000,NW 333,RESIDENTIAL,29300,0,29300,100600,0,129900
143035401200000,NW 333,RESIDENTIAL,29300,0,29300,111400,0,140700
143035401300000,NW 333,RESIDENTIAL,30700,0,30700,95400,0,126100
143035401400000,NW 333,RESIDENTIAL,32800,0,32800,122900,0,155700
143035401500000,NW 333,RESIDENTIAL,30600,0,30600,101100,0,131700
143035401600000,NW 333,RESIDENTIAL,24500,0,24500,85900,0,110400
143035401700000,NW 333,RESIDENTIAL,24300,0,24300,110900,0,135200
143035401800000,NW 333,RESIDENTIAL,31100,0,31100,97400,0,128500
143035401900000,NW 333,RESIDENTIAL,31100,0,31100,89600,0,120700
143035402000000,NW 333,RESIDENTIAL,31100,0,31100,93400,0,124500
143035402100000,NW 333,RESIDENTIAL,31100,0,31100,94800,0,125900
143035500100000,NW 333,RESIDENTIAL,30000,0,30000,77600,0,107600
143035500200000,NW 333,RESIDENTIAL,30000,0,30000,95000,0,125000
143035500300000,NW 333,RESIDENTIAL,35000,0,35000,106900,0,141900
143035500400000,NW 333,RESIDENTIAL,35100,0,35100,90200,0,125300
143035600100000,OFFICE,EXEMPT,0,89500,89500,0,422500,512000
143035600200000,NW 333,RESIDENTIAL,29500,0,29500,122100,0,151600
143035600300000,NW 333,RESIDENTIAL,29500,0,29500,71900,0,101400
143035600400000,NW 333,RESIDENTIAL,28500,0,28500,124000,0,152500
143035600500000,NW 333,RESIDENTIAL,33000,0,33000,101400,0,134400
143035600600000,NW 333,RESIDENTIAL,29300,0,29300,111200,0,140500
143035600700000,NW 333,RESIDENTIAL,26400,0,26400,89500,0,115900
143035600800000,NW 333,RESIDENTIAL,26500,0,26500,0,0,26500
143035600900000,OFFICE,COMMERCIAL,0,185300,185300,0,283200,468500
143035601000000,BRANCH BANK/CU,COMMERCIAL,0,286400,286400,0,373500,659900
143035601100000,FAST FOOD,COMMERCIAL,0,370800,370800,0,511400,882200
143035601200000,STATE PROPERTY,EXEMPT,0,0,0,0,0,0
143035601300000,CONVENIENCE STORE,COMMERCIAL,0,291437,291437,0,211857,503294
143035601400000,BARS/LOUNGE,COMMERCIAL,0,89700,89700,0,81200,170900
143035601500000,NBHD SHOPPING CENTER,COMMERCIAL,0,421800,421800,0,934200,1356000
143035601600000,SMALL RETAIL,COMMERCIAL,0,160800,160800,0,427400,588200
143035601602000,BILLBOARD(BLL),COMMERCIAL,0,0,0,0,21400,21400
143035601700000,RESTAURANT,COMMERCIAL,0,226000,226000,0,230100,456100
143035601800000,VACANT LAND,COMMERCIAL,0,53900,53900,0,0,53900
143035601900000,HOTEL,COMMERCIAL,0,495000,495000,0,673900,1168900
143037600100000,NW 333,RESIDENTIAL,31100,0,31100,97400,0,128500
143037600200000,NW 333,RESIDENTIAL,30800,0,30800,109600,0,140400
143037600300000,NW 333,RESIDENTIAL,30500,0,30500,105200,0,135700
143037600400000,NW 333,RESIDENTIAL,31100,0,31100,113500,0,144600
143037600500000,NW 333,RESIDENTIAL,30200,0,30200,122500,0,152700
143037600600000,NW 333,RESIDENTIAL,30500,0,30500,106300,0,136800
143037600700000,NW 333,RESIDENTIAL,31000,0,31000,94700,0,125700
143037600800000,NW 333,RESIDENTIAL,30500,0,30500,104500,0,135000
143037600900000,NW 333,RESIDENTIAL,29700,0,29700,110200,0,139900
143037601000000,NW 333,RESIDENTIAL,29700,0,29700,90000,0,119700
143037601100000,NW 333,RESIDENTIAL,30600,0,30600,93200,0,123800
143037700100000,CITY PROPERTY,EXEMPT,0,0,0,0,0,0
143037700200000,NW 333,RESIDENTIAL,29700,0,29700,98100,0,127800
143037700300000,NW 333,RESIDENTIAL,31700,0,31700,140900,0,172600
143037700400000,NW 333,RESIDENTIAL,23500,0,23500,0,0,23500
143037700500000,NW 333,RESIDENTIAL,23500,0,23500,77200,0,100700
143037700600000,NW 333,RESIDENTIAL,24600,0,24600,74400,0,99000
143037700700000,NW 333,RESIDENTIAL,24600,0,24600,83100,0,107700
143037700800000,NW 333,RESIDENTIAL,26300,0,26300,128700,0,155000
143037700900000,NW 333,RESIDENTIAL,22300,0,22300,90100,0,112400
143037701000000,NW 333,RESIDENTIAL,25800,0,25800,133000,0,158800
143037701100000,NW 333,RESIDENTIAL,25900,0,25900,136900,0,162800
143037701300000,NW 333,RESIDENTIAL,31200,0,31200,103800,0,135000
143037701400000,NW 333,RESIDENTIAL,30400,0,30400,101200,0,131600
143037701500000,NW 333,RESIDENTIAL,30400,0,30400,131300,0,161700
143037701600000,NW 333,RESIDENTIAL,31600,0,31600,130200,0,161800
143037701700000,NW 333,RESIDENTIAL,31800,0,31800,95700,0,127500
143037701800000,NW 333,RESIDENTIAL,31600,0,31600,114300,0,145900
143037701900000,NW 333,RESIDENTIAL,32000,0,32000,119200,0,151200
143037702000000,NW 333,RESIDENTIAL,30700,0,30700,112300,0,143000
143037702100000,NW 333,RESIDENTIAL,34100,0,34100,118200,0,152300
143037702200000,NW 333,RESIDENTIAL,30200,0,30200,127000,0,157200
143037702300000,NW 333,RESIDENTIAL,30400,0,30400,111000,0,141400
143037800100000,NW 333,RESIDENTIAL,24400,0,24400,136200,0,160600
143037800200000,NW 333,RESIDENTIAL,55800,0,55800,233100,0,288900
143037800300000,NW 333,RESIDENTIAL,30700,0,30700,92000,0,122700
143037900100000,NW 333,RESIDENTIAL,25400,0,25400,92300,0,117700
143037900200000,NW 333,RESIDENTIAL,31500,0,31500,93100,0,124600
143037900300000,NW 333,RESIDENTIAL,25700,0,25700,80700,0,106400
143037900400000,NW 333,RESIDENTIAL,21600,0,21600,74000,0,95600
143037900500000,NW 333,RESIDENTIAL,28100,0,28100,66700,0,94800
143037900600000,NW 333,RESIDENTIAL,25900,0,25900,75100,0,101000
143037900700000,NW 333,RESIDENTIAL,25900,0,25900,133300,0,159200
143037900800000,NW 333,RESIDENTIAL,26100,0,26100,110600,0,136700
143037900900000,NW 333,RESIDENTIAL,25900,0,25900,80200,0,106100
143037901000000,NW 333,RESIDENTIAL,25400,0,25400,82500,0,107900
143038000100000,SMALL RETAIL,COMMERCIAL,0,110000,110000,0,120500,230500
143038000200000,NW 333,RESIDENTIAL,25800,0,25800,51400,0,77200
143038000300000,NW 333,RESIDENTIAL,26100,0,26100,74300,0,100400
143038000500000,NW 333,RESIDENTIAL,31400,0,31400,75200,0,106600
143038000600000,NW 333,RESIDENTIAL,27800,0,27800,49200,0,77000
143038000700000,NW 333,RESIDENTIAL,27000,0,27000,101900,0,128900
143038000800000,NW 333,RESIDENTIAL,43500,0,43500,76600,0,120100
143038000802000,BILLBOARD(BLL),COMMERCIAL,0,0,0,0,24000,24000
143038001000000,SMALL RETAIL,COMMERCIAL,0,180000,180000,0,556900,736900
143038001100000,WAREHOUSE;MINI STORG,COMMERCIAL,0,194000,194000,0,393500,587500
143038001200000,AUTO REPAIR/SALES,COMMERCIAL,0,117000,117000,0,228100,345100
143038001300000,SMALL RETAIL,COMMERCIAL,0,53000,53000,0,91500,144500
143038001400000,SECTION 42,COMMERCIAL,0,10000,10000,0,34500,44500
143038001500000,RESTAURANT,COMMERCIAL,0,268500,268500,0,116900,385400
143038001600000,VACANT LAND,COMMERCIAL,0,5600,5600,0,0,5600
143038100100000,CONVENIENCE STORE,COMMERCIAL,0,114200,114200,0,257000,371200
143038100300000,FLAT PARKING,COMMERCIAL,0,5300,5300,0,1100,6400
143038100400000,FAST FOOD,COMMERCIAL,0,222000,222000,0,775700,997700
143040100100000,SW 405,RESIDENTIAL,20600,0,20600,86900,0,107500
143040100200000,SW 405,RESIDENTIAL,19900,0,19900,77200,0,97100
143040100300000,SW 405,RESIDENTIAL,19900,0,19900,69900,0,89800
143040100400000,SW 405,RESIDENTIAL,19900,0,19900,77000,0,96900
143040100500000,SW 405,RESIDENTIAL,19900,0,19900,83000,0,102900
143040100600000,SW 405,RESIDENTIAL,19900,0,19900,73500,0,93400
143040100700000,SW 405,RESIDENTIAL,19900,0,19900,63000,0,82900
143040100800000,SW 405,RESIDENTIAL,19900,0,19900,67500,0,87400
143040100900000,SW 405,RESIDENTIAL,19900,0,19900,73400,0,93300
143040101000000,SW 405,RESIDENTIAL,19900,0,19900,62200,0,82100
143040101100000,SW 405,RESIDENTIAL,20200,0,20200,72800,0,93000
143040101200000,SW 405,RESIDENTIAL,19900,0,19900,66300,0,86200
143040101300000,SW 405,RESIDENTIAL,19900,0,19900,75200,0,95100
143040101400000,SW 405,RESIDENTIAL,19900,0,19900,72100,0,92000
143040101500000,SW 405,RESIDENTIAL,19900,0,19900,102300,0,122200
143040101600000,SW 405,RESIDENTIAL,19900,0,19900,55600,0,75500
143040101700000,SW 405,RESIDENTIAL,19600,0,19600,66700,0,86300
143040101800000,SW 405,RESIDENTIAL,19600,0,19600,80400,0,100000
143040101900000,SW 405,RESIDENTIAL,19600,0,19600,71500,0,91100
143040102000000,SW 405,RESIDENTIAL,24200,0,24200,57000,0,81200
143040102100000,SW 405,RESIDENTIAL,21000,0,21000,97200,0,118200
143040102200000,SW 405,RESIDENTIAL,20000,0,20000,67100,0,87100
143040102300000,SW 405,RESIDENTIAL,20000,0,20000,76000,0,96000
143040102400000,SW 405,RESIDENTIAL,20000,0,20000,66400,0,86400
143040102500000,SW 405,RESIDENTIAL,20000,0,20000,74100,0,94100
143040102600000,SW 405,RESIDENTIAL,20000,0,20000,69600,0,89600
143040102700000,SW 405,RESIDENTIAL,20000,0,20000,59900,0,79900
143040102800000,SW 405,RESIDENTIAL,20000,0,20000,76000,0,96000
143040102900000,SW 405,RESIDENTIAL,20000,0,20000,78400,0,98400
143040103000000,SW 405,RESIDENTIAL,20000,0,20000,75900,0,95900
143040103100000,SW 405,RESIDENTIAL,20000,0,20000,63900,0,83900
143040103200000,SW 405,RESIDENTIAL,20000,0,20000,97900,0,117900
143040103300000,SW 405,RESIDENTIAL,20000,0,20000,63900,0,83900
143040103400000,SW 405,RESIDENTIAL,20000,0,20000,54700,0,74700
143040103500000,SW 405,RESIDENTIAL,20000,0,20000,65800,0,85800
143040200100000,SW 405,RESIDENTIAL,22200,0,22200,77000,0,99200
143040200200000,SW 405,RESIDENTIAL,24200,0,24200,78700,0,102900
143040200300000,SW 405,RESIDENTIAL,21600,0,21600,61000,0,82600
143040200400000,SW 405,RESIDENTIAL,20700,0,20700,54700,0,75400
143040200500000,SW 405,RESIDENTIAL,20800,0,20800,74500,0,95300
143040200600000,SW 405,RESIDENTIAL,21400,0,21400,80600,0,102000
143040200700000,SW 405,RESIDENTIAL,20600,0,20600,79300,0,99900
143040200800000,SW 405,RESIDENTIAL,21900,0,21900,105600,0,127500
143040200900000,SW 405,RESIDENTIAL,27600,0,27600,54300,0,81900
143040201000000,SW 405,RESIDENTIAL,36200,0,36200,153700,0,189900
143040201100000,SW 405,RESIDENTIAL,32900,0,32900,99000,0,131900
143040201200000,SW 405,RESIDENTIAL,24300,0,24300,102900,0,127200
143040201300000,SW 405,RESIDENTIAL,26200,0,26200,106600,0,132800
143040201400000,SW 405,RESIDENTIAL,26400,0,26400,87500,0,113900
143040201500000,SW 405,RESIDENTIAL,24700,0,24700,86200,0,110900
143040201600000,SW 405,RESIDENTIAL,24900,0,24900,90300,0,115200
143040201700000,SW 405,RESIDENTIAL,24100,0,24100,70700,0,94800
143040201800000,SW 405,RESIDENTIAL,21500,0,21500,96700,0,118200
143040201900000,SW 405,RESIDENTIAL,21400,0,21400,92000,0,113400
143040202000000,SW 405,RESIDENTIAL,22900,0,22900,73200,0,96100
143040202100000,SW 405,RESIDENTIAL,22600,0,22600,57600,0,80200
143040202200000,SW 405,RESIDENTIAL,23000,0,23000,72500,0,95500
143040202300000,SW 405,RESIDENTIAL,22400,0,22400,56700,0,79100
143040202400000,SW 405,RESIDENTIAL,22400,0,22400,100000,0,122400
143040202500000,SW 405,RESIDENTIAL,23500,0,23500,82400,0,105900
143040202600000,SW 405,RESIDENTIAL,22200,0,22200,89700,0,111900
143040202700000,SW 405,RESIDENTIAL,22400,0,22400,69000,0,91400
143040202800000,SW 405,RESIDENTIAL,22400,0,22400,74500,0,96900
143040202900000,SW 405,RESIDENTIAL,21800,0,21800,81600,0,103400
143040203000000,SW 405,RESIDENTIAL,23200,0,23200,54700,0,77900
143040203100000,SW 405,RESIDENTIAL,21500,0,21500,83900,0,105400
143040300100000,SW 405,RESIDENTIAL,20600,0,20600,67400,0,88000
143040300200000,SW 405,RESIDENTIAL,20700,0,20700,74900,0,95600
143040300300000,SW 405,RESIDENTIAL,21100,0,21100,81500,0,102600
143040300400000,SW 405,RESIDENTIAL,20700,0,20700,79200,0,99900
143040300500000,SW 405,RESIDENTIAL,21100,0,21100,67800,0,88900
143040300600000,SW 405,RESIDENTIAL,20800,0,20800,59400,0,80200
143040300700000,SW 405,RESIDENTIAL,20100,0,20100,63300,0,83400
143040300800000,SW 405,RESIDENTIAL,21100,0,21100,72900,0,94000
143040300900000,SW 405,RESIDENTIAL,20900,0,20900,68800,0,89700
143040301000000,SW 405,RESIDENTIAL,20300,0,20300,71400,0,91700
143040301100000,SW 405,RESIDENTIAL,20400,0,20400,83900,0,104300
143040301200000,SW 405,RESIDENTIAL,20600,0,20600,68600,0,89200
143040301300000,SW 405,RESIDENTIAL,20000,0,20000,72900,0,92900
143040301400000,SW 405,RESIDENTIAL,21200,0,21200,84900,0,106100
143040400100000,SW 405,RESIDENTIAL,22200,0,22200,79800,0,102000
143040400200000,SW 405,RESIDENTIAL,22200,0,22200,68800,0,91000
143040400300000,SW 405,RESIDENTIAL,22200,0,22200,69800,0,92000
143040400400000,SW 405,RESIDENTIAL,22200,0,22200,98700,0,120900
143040400500000,SW 405,RESIDENTIAL,22200,0,22200,71700,0,93900
143040400600000,SW 405,RESIDENTIAL,22200,0,22200,73200,0,95400
143040400700000,SW 405,RESIDENTIAL,22200,0,22200,76700,0,98900
143040400800000,SW 405,RESIDENTIAL,22200,0,22200,63200,0,85400
143040400900000,SW 405,RESIDENTIAL,22900,0,22900,85000,0,107900
143040401000000,SW 405,RESIDENTIAL,22400,0,22400,99800,0,122200
143040401100000,SW 405,RESIDENTIAL,21900,0,21900,92400,0,114300
143040401200000,SW 405,RESIDENTIAL,22100,0,22100,57200,0,79300
143040401300000,SW 405,RESIDENTIAL,22800,0,22800,105700,0,128500
143040401400000,SW 405,RESIDENTIAL,22400,0,22400,78600,0,101000
143040401500000,SW 405,RESIDENTIAL,23100,0,23100,75800,0,98900
143040401600000,SW 405,RESIDENTIAL,21700,0,21700,92500,0,114200
143040401700000,SW 405,RESIDENTIAL,20700,0,20700,69100,0,89800
143040401800000,SW 405,RESIDENTIAL,21200,0,21200,75600,0,96800
143040401900000,SW 405,RESIDENTIAL,22200,0,22200,103800,0,126000
143040402000000,SW 405,RESIDENTIAL,22200,0,22200,86200,0,108400
143040402100000,SW 405,RESIDENTIAL,22200,0,22200,104100,0,126300
143040402200000,SW 405,RESIDENTIAL,22200,0,22200,77300,0,99500
143040402300000,SW 405,RESIDENTIAL,22200,0,22200,104400,0,126600
143040402400000,SW 405,RESIDENTIAL,22200,0,22200,93300,0,115500
143040402500000,SW 405,RESIDENTIAL,22200,0,22200,82800,0,105000
143040402600000,SW 405,RESIDENTIAL,22200,0,22200,90200,0,112400
143040402700000,SW 405,RESIDENTIAL,22200,0,22200,91600,0,113800
143040402800000,SW 405,RESIDENTIAL,21000,0,21000,87000,0,108000
143040500100000,SW 405,RESIDENTIAL,24000,0,24000,98300,0,122300
143040500200000,SW 405,RESIDENTIAL,23200,0,23200,66500,0,89700
143040500300000,SW 405,RESIDENTIAL,21100,0,21100,51500,0,72600
143040500400000,SW 405,RESIDENTIAL,23500,0,23500,57600,0,81100
143040500500000,SW 405,RESIDENTIAL,21200,0,21200,71500,0,92700
143040500600000,SW 405,RESIDENTIAL,23500,0,23500,67100,0,90600
143040500700000,SW 405,RESIDENTIAL,23500,0,23500,73800,0,97300
143040500800000,SW 405,RESIDENTIAL,23100,0,23100,81900,0,105000
143040500900000,SW 405,RESIDENTIAL,23100,0,23100,82600,0,105700
143040501000000,SW 405,RESIDENTIAL,23100,0,23100,70400,0,93500
143040501100000,SW 405,RESIDENTIAL,21700,0,21700,62900,0,84600
143040501200000,SW 405,RESIDENTIAL,21700,0,21700,67200,0,88900
143040501300000,SW 405,RESIDENTIAL,21700,0,21700,72200,0,93900
143040501400000,SW 405,RESIDENTIAL,21700,0,21700,73400,0,95100
143040501500000,SW 405,RESIDENTIAL,21700,0,21700,72900,0,94600
143040501600000,SW 405,RESIDENTIAL,22100,0,22100,69200,0,91300
143040501700000,SW 405,RESIDENTIAL,21300,0,21300,81700,0,103000
143040501800000,SW 405,RESIDENTIAL,21300,0,21300,81900,0,103200
143040501900000,SW 405,RESIDENTIAL,21300,0,21300,72600,0,93900
143040502000000,SW 405,RESIDENTIAL,21300,0,21300,83500,0,104800
143040502100000,SW 405,RESIDENTIAL,21300,0,21300,79900,0,101200
143040502200000,SW 405,RESIDENTIAL,21300,0,21300,76100,0,97400
143040600100000,CITY PROPERTY,EXEMPT,0,0,0,0,0,0
143040700100000,SW 405,RESIDENTIAL,21000,0,21000,70000,0,91000
143040700200000,SW 405,RESIDENTIAL,21300,0,21300,78100,0,99400
143040700300000,SW 405,RESIDENTIAL,21300,0,21300,82800,0,104100
143040700400000,SW 405,RESIDENTIAL,21300,0,21300,93800,0,115100
143040700500000,SW 405,RESIDENTIAL,21300,0,21300,78500,0,99800
143040700600000,SW 405,RESIDENTIAL,21300,0,21300,97400,0,118700
143040700700000,SW 405,RESIDENTIAL,21300,0,21300,77000,0,98300
143040700800000,SW 405,RESIDENTIAL,21300,0,21300,86400,0,107700
143040700900000,SW 405,RESIDENTIAL,21300,0,21300,88500,0,109800
143040701000000,SW 405,RESIDENTIAL,19400,0,19400,80400,0,99800
143040701100000,SW 405,RESIDENTIAL,21000,0,21000,76900,0,97900
143040701200000,SW 405,RESIDENTIAL,21300,0,21300,87600,0,108900
143040701300000,SW 405,RESIDENTIAL,21000,0,21000,95800,0,116800
143040701400000,SW 405,RESIDENTIAL,21600,0,21600,118400,0,140000
143040701500000,SW 405,RESIDENTIAL,21000,0,21000,109400,0,130400
143040701600000,SW 405,RESIDENTIAL,20800,0,20800,69700,0,90500
143040701700000,SW 405,RESIDENTIAL,23300,0,23300,80500,0,103800
143040701800000,SW 405,RESIDENTIAL,24100,0,24100,70700,0,94800
143040701900000,SW 405,RESIDENTIAL,24500,0,24500,79500,0,104000
143040702000000,SW 405,RESIDENTIAL,27000,0,27000,68000,0,95000
143042600100000,SW 405,RESIDENTIAL,22500,0,22500,89800,0,112300
143042600200000,SW 405,RESIDENTIAL,24000,0,24000,65200,0,89200
143042600300000,SW 405,RESIDENTIAL,24700,0,24700,85200,0,109900
143042600400000,SW 405,RESIDENTIAL,24700,0,24700,100700,0,125400
143042600500000,SW 405,RESIDENTIAL,24700,0,24700,79900,0,104600
143042600600000,SW 405,RESIDENTIAL,24700,0,24700,67900,0,92600
143042600700000,SW 405,RESIDENTIAL,24700,0,24700,98200,0,122900
143042600800000,SW 405,EXEMPT,0,24700,24700,0,105100,129800
143042600900000,SW 405,RESIDENTIAL,20900,0,20900,67200,0,88100
143042601000000,SW 405,RESIDENTIAL,20900,0,20900,69300,0,90200
143042601100000,SW 405,RESIDENTIAL,21600,0,21600,76200,0,97800
143042601200000,SW 405,RESIDENTIAL,21600,0,21600,66700,0,88300
143042601300000,SW 405,RESIDENTIAL,21600,0,21600,59000,0,80600
143042601400000,SW 405,RESIDENTIAL,22400,0,22400,109400,0,131800
143042601500000,SW 405,RESIDENTIAL,21600,0,21600,87800,0,109400
143042601600000,SW 405,RESIDENTIAL,21600,0,21600,92600,0,114200
143042601700000,SW 405,RESIDENTIAL,22500,0,22500,79500,0,102000
143042601800000,SW 405,RESIDENTIAL,22500,0,22500,100500,0,123000
143042601900000,SW 405,RESIDENTIAL,22500,0,22500,76900,0,99400
143042602000000,SW 405,RESIDENTIAL,22500,0,22500,95000,0,117500
143042700100000,SW 405,RESIDENTIAL,25600,0,25600,108600,0,134200
143042700200000,SW 405,RESIDENTIAL,21600,0,21600,59000,0,80600
143042700300000,SW 405,RESIDENTIAL,21900,0,21900,71300,0,93200
143042700400000,SW 405,RESIDENTIAL,23000,0,23000,80400,0,103400
143042700500000,SW 405,RESIDENTIAL,23000,0,23000,101400,0,124400
143042700600000,SW 405,RESIDENTIAL,27600,0,27600,96200,0,123800
143042700700000,SW 405,RESIDENTIAL,23000,0,23000,86300,0,109300
143042700800000,SW 405,RESIDENTIAL,23000,0,23000,62300,0,85300
143042700900000,SW 405,RESIDENTIAL,23000,0,23000,61400,0,84400
143042701000000,SW 405,RESIDENTIAL,22900,0,22900,34300,0,57200
143042701100000,SW 405,RESIDENTIAL,22800,0,22800,87800,0,110600
143042701200000,SW 405,RESIDENTIAL,20500,0,20500,54800,0,75300
143042701300000,SW 405,RESIDENTIAL,20600,0,20600,60100,0,80700
143042701400000,SW 405,RESIDENTIAL,19400,0,19400,55200,0,74600
143042701500000,SW 405,RESIDENTIAL,22100,0,22100,49200,0,71300
143042701600000,SW 405,RESIDENTIAL,24000,0,24000,61500,0,85500
143042701700000,SW 405,RESIDENTIAL,21300,0,21300,76300,0,97600
143042701800000,SW 405,RESIDENTIAL,20600,0,20600,57800,0,78400
143042701900000,SW 405,RESIDENTIAL,21800,0,21800,55900,0,77700
143042702000000,SW 405,RESIDENTIAL,21800,0,21800,58000,0,79800
143042702100000,SW 405,RESIDENTIAL,21800,0,21800,62300,0,84100
143042702200000,SW 405,RESIDENTIAL,21800,0,21800,55700,0,77500
143042702300000,SW 405,RESIDENTIAL,22300,0,22300,60300,0,82600
143042702400000,SW 405,RESIDENTIAL,22500,0,22500,38700,0,61200
143042800100000,NW 333,RESIDENTIAL,45700,0,45700,80300,0,126000
143042800200000,NW 333,RESIDENTIAL,43700,0,43700,115000,0,158700
143042900100000,SW 405,RESIDENTIAL,23300,0,23300,69800,0,93100
143042900200000,SW 405,RESIDENTIAL,19400,0,19400,57300,0,76700
143042900300000,SW 405,RESIDENTIAL,19400,0,19400,56900,0,76300
143042900400000,SW 405,RESIDENTIAL,19400,0,19400,60300,0,79700
143042900500000,SW 405,RESIDENTIAL,19400,0,19400,61900,0,81300
143042900600000,SW 405,RESIDENTIAL,19400,0,19400,60800,0,80200
143042900700000,SW 405,RESIDENTIAL,19400,0,19400,50100,0,69500
143042900800000,SW 405,RESIDENTIAL,21000,0,21000,79100,0,100100
143042900900000,SW 405,RESIDENTIAL,20600,0,20600,60700,0,81300
143042901000000,SW 405,RESIDENTIAL,21100,0,21100,62800,0,83900
143042901100000,SW 405,RESIDENTIAL,21100,0,21100,58700,0,79800
143042901200000,SW 405,RESIDENTIAL,20200,0,20200,65600,0,85800
143042901300000,SW 405,RESIDENTIAL,20200,0,20200,71300,0,91500
143042901400000,SW 405,RESIDENTIAL,20200,0,20200,57700,0,77900
143042901500000,SW 405,RESIDENTIAL,20200,0,20200,52500,0,72700
143042901600000,SW 405,RESIDENTIAL,20200,0,20200,55400,0,75600
143042901700000,SW 405,RESIDENTIAL,20200,0,20200,46000,0,66200
143042901800000,SW 405,RESIDENTIAL,20200,0,20200,79500,0,99700
143042901900000,SW 405,RESIDENTIAL,20200,0,20200,58600,0,78800
143042902000000,SW 405,RESIDENTIAL,23300,0,23300,63100,0,86400
143042902100000,SW 405,RESIDENTIAL,23300,0,23300,71600,0,94900
143042902200000,SW 405,RESIDENTIAL,23300,0,23300,36300,0,59600
143043000100000,SW 405,RESIDENTIAL,23900,0,23900,59800,0,83700
143043000200000,SW 405,RESIDENTIAL,23800,0,23800,63200,0,87000
143043000300000,SW 405,RESIDENTIAL,24400,0,24400,66400,0,90800
143043000400000,SW 405,RESIDENTIAL,23600,0,23600,46300,0,69900
143043000500000,SW 405,RESIDENTIAL,24200,0,24200,60100,0,84300
143043000600000,SW 405,RESIDENTIAL,23400,0,23400,69000,0,92400
143043000700000,SW 405,RESIDENTIAL,24000,0,24000,61600,0,85600
143043000800000,SW 405,RESIDENTIAL,21800,0,21800,56800,0,78600
143043000900000,SW 405,RESIDENTIAL,24500,0,24500,67400,0,91900
143043001000000,SW 405,RESIDENTIAL,23900,0,23900,56000,0,79900
143043100100000,SW 405,RESIDENTIAL,22100,0,22100,79200,0,101300
143043100200000,SW 405,RESIDENTIAL,23300,0,23300,103500,0,126800
143043100300000,SW 405,RESIDENTIAL,23400,0,23400,57600,0,81000
143043100400000,SW 405,RESIDENTIAL,22400,0,22400,64800,0,87200
143043100500000,SW 405,RESIDENTIAL,24100,0,24100,61100,0,85200
143043100600000,SW 405,RESIDENTIAL,23600,0,23600,48100,0,71700
143043100700000,SW 405,RESIDENTIAL,23600,0,23600,68400,0,92000
143043100800000,SW 405,RESIDENTIAL,23600,0,23600,53600,0,77200
143043100900000,SW 405,RESIDENTIAL,23400,0,23400,77400,0,100800
143043101000000,SW 405,RESIDENTIAL,20700,0,20700,45300,0,66000
143043101100000,SW 405,RESIDENTIAL,24200,0,24200,93400,0,117600
143043101200000,SW 405,RESIDENTIAL,25600,0,25600,87400,0,113000
143043101300000,SW 405,RESIDENTIAL,25100,0,25100,108600,0,133700
143043101400000,SW 405,RESIDENTIAL,25000,0,25000,153000,0,178000
143043101500000,SW 405,RESIDENTIAL,24000,0,24000,69700,0,93700
143043101600000,SW 405,RESIDENTIAL,24000,0,24000,109800,0,133800
143043101700000,SW 405,RESIDENTIAL,24000,0,24000,83500,0,107500
143043101800000,SW 405,RESIDENTIAL,24000,0,24000,69100,0,93100
143043101900000,SW 405,RESIDENTIAL,24000,0,24000,99600,0,123600
143043102000000,SW 405,RESIDENTIAL,24800,0,24800,103000,0,127800
143043102100000,SW 405,RESIDENTIAL,25900,0,25900,64600,0,90500
143043200100000,SW 405,RESIDENTIAL,22300,0,22300,60300,0,82600
143043200200000,SW 405,RESIDENTIAL,23400,0,23400,57200,0,80600
143043200300000,SW 405,RESIDENTIAL,23900,0,23900,58100,0,82000
143043200400000,SW 405,RESIDENTIAL,25500,0,25500,76200,0,101700
143043200500000,SW 405,RESIDENTIAL,26100,0,26100,63200,0,89300
143043200600000,SW 405,RESIDENTIAL,23000,0,23000,58500,0,81500
143043300100000,SW 405,RESIDENTIAL,20800,0,20800,75900,0,96700
143043300200000,SW 405,RESIDENTIAL,20600,0,20600,63300,0,83900
143043300300000,SW 405,RESIDENTIAL,20600,0,20600,60000,0,80600
143043300400000,SW 405,RESIDENTIAL,20600,0,20600,56600,0,77200
143043300500000,SW 405,RESIDENTIAL,20600,0,20600,63600,0,84200
143043300600000,SW 405,RESIDENTIAL,20600,0,20600,52300,0,72900
143043300700000,SW 405,RESIDENTIAL,20600,0,20600,60600,0,81200
143043300800000,SW 405,RESIDENTIAL,20600,0,20600,56300,0,76900
143043300900000,SW 405,RESIDENTIAL,20600,0,20600,65500,0,86100
143043301000000,SW 405,RESIDENTIAL,20600,0,20600,67900,0,88500
143043301100000,SW 405,RESIDENTIAL,20600,0,20600,62100,0,82700
143043301200000,SW 405,RESIDENTIAL,20600,0,20600,72400,0,93000
143043301300000,SW 405,RESIDENTIAL,20700,0,20700,61800,0,82500
143043301400000,SW 405,RESIDENTIAL,21000,0,21000,55700,0,76700
143043301500000,SW 405,RESIDENTIAL,20000,0,20000,59100,0,79100
143043301600000,SW 405,RESIDENTIAL,20000,0,20000,47000,0,67000
143043301700000,SW 405,RESIDENTIAL,20000,0,20000,55600,0,75600
143043301800000,SW 405,RESIDENTIAL,20000,0,20000,56300,0,76300
143043301900000,SW 405,RESIDENTIAL,20000,0,20000,56600,0,76600
143043302000000,SW 405,RESIDENTIAL,20000,0,20000,70300,0,90300
143043302100000,SW 405,RESIDENTIAL,20000,0,20000,55600,0,75600
143043302200000,SW 405,RESIDENTIAL,20000,0,20000,50500,0,70500
143043302300000,SW 405,RESIDENTIAL,20000,0,20000,49900,0,69900
143043302400000,SW 405,RESIDENTIAL,20000,0,20000,67600,0,87600
143043302500000,SW 405,RESIDENTIAL,20000,0,20000,58700,0,78700
143043302600000,SW 405,RESIDENTIAL,19800,0,19800,61800,0,81600
143043400100000,SW 405,RESIDENTIAL,23100,0,23100,66700,0,89800
143043400200000,SW 405,RESIDENTIAL,23100,0,23100,66800,0,89900
143043400300000,SW 405,RESIDENTIAL,20900,0,20900,66100,0,87000
143043400400000,SW 405,RESIDENTIAL,20900,0,20900,69000,0,89900
143043400500000,SW 405,RESIDENTIAL,26200,0,26200,85600,0,111800
143043400600000,SW 405,RESIDENTIAL,25000,0,25000,99100,0,124100
143043500100000,SW 405,RESIDENTIAL,19600,0,19600,54700,0,74300
143043500200000,SW 405,RESIDENTIAL,19400,0,19400,60200,0,79600
143043500300000,SW 405,RESIDENTIAL,19400,0,19400,66800,0,86200
143043500400000,SW 405,RESIDENTIAL,19400,0,19400,71900,0,91300
143043500500000,SW 405,RESIDENTIAL,19400,0,19400,67900,0,87300
143043500600000,SW 405,RESIDENTIAL,19400,0,19400,61400,0,80800
143043500700000,SW 405,RESIDENTIAL,19400,0,19400,68300,0,87700
143043500800000,SW 405,RESIDENTIAL,19400,0,19400,62100,0,81500
143043500900000,SW 405,RESIDENTIAL,19400,0,19400,63000,0,82400
143043501000000,SW 405,RESIDENTIAL,19400,0,19400,62100,0,81500
143043501100000,SW 405,RESIDENTIAL,19400,0,19400,61900,0,81300
143043501200000,SW 405,RESIDENTIAL,19400,0,19400,62200,0,81600
143043501300000,SW 405,RESIDENTIAL,20600,0,20600,71500,0,92100
143043501400000,NW 333,RESIDENTIAL,30600,0,30600,100800,0,131400
143043501500000,NW 333,RESIDENTIAL,30700,0,30700,133900,0,164600
143043501600000,NW 333,RESIDENTIAL,35900,0,35900,171700,0,207600
143043501700000,NW 333,RESIDENTIAL,31100,0,31100,149400,0,180500
143043501800000,SW 405,RESIDENTIAL,24200,0,24200,61300,0,85500
143043501900000,SW 405,RESIDENTIAL,24200,0,24200,81800,0,106000
143043502000000,SW 405,RESIDENTIAL,24200,0,24200,80100,0,104300
143043502100000,SW 405,RESIDENTIAL,24200,0,24200,73100,0,97300
143043502200000,SW 405,RESIDENTIAL,24200,0,24200,91700,0,115900
143045100100000,SW 405,RESIDENTIAL,24000,0,24000,62100,0,86100
143045200100000,SW 405,RESIDENTIAL,26400,0,26400,96800,0,123200
143045200200000,SW 405,RESIDENTIAL,25800,0,25800,88800,0,114600
143045200300000,SW 405,RESIDENTIAL,23500,0,23500,80300,0,103800
143045200400000,SW 405,RESIDENTIAL,23500,0,23500,115500,0,139000
143045200500000,SW 405,RESIDENTIAL,23500,0,23500,83000,0,106500
143045200600000,SW 405,RESIDENTIAL,23500,0,23500,81700,0,105200
143045200700000,SW 405,RESIDENTIAL,23500,0,23500,84900,0,108400
143045200800000,SW 405,RESIDENTIAL,26300,0,26300,102800,0,129100
143045200900000,NW 333,RESIDENTIAL,33300,0,33300,260800,0,294100
143045201000000,NW 333,RESIDENTIAL,57200,0,57200,125200,0,182400
143045201100000,WAREHOUSE;MINI STORG,COMMERCIAL,0,55800,55800,0,29400,85200
143045201200000,SERVICE STATION,COMMERCIAL,0,81700,81700,0,58600,140300
143045201300000,FLAT PARKING,COMMERCIAL,0,476400,476400,0,0,476400
143045201400000,SHOP,COMMERCIAL,0,302300,302300,0,635800,938100
143045201500000,SW 405,RESIDENTIAL,25900,0,25900,87000,0,112900
143045201600000,SW 405,RESIDENTIAL,25300,0,25300,68000,0,93300
143045201700000,SW 405,RESIDENTIAL,24900,0,24900,130200,0,155100
143045201800000,SW 405,RESIDENTIAL,25500,0,25500,88900,0,114400
143045201900000,SW 405,RESIDENTIAL,24000,0,24000,74200,0,98200
143045202000000,SW 405,RESIDENTIAL,24700,0,24700,79100,0,103800
143045202100000,SW 405,RESIDENTIAL,24500,0,24500,72200,0,96700
143045202200000,SW 405,RESIDENTIAL,24500,0,24500,91400,0,115900
143045202300000,SW 405,RESIDENTIAL,24500,0,24500,75900,0,100400
143045202400000,SW 405,RESIDENTIAL,24500,0,24500,76000,0,100500
143045202500000,CITY PROPERTY,EXEMPT,0,0,0,0,0,0
143045202600000,CITY PROPERTY,EXEMPT,0,0,0,0,0,0
143045202700000,SW 405,RESIDENTIAL,26000,0,26000,74400,0,100400
143045202800000,SW 405,RESIDENTIAL,25400,0,25400,82800,0,108200
143045202900000,SW 405,RESIDENTIAL,25600,0,25600,77200,0,102800
143045203000000,SW 405,RESIDENTIAL,24800,0,24800,106700,0,131500
143045203100000,SW 405,RESIDENTIAL,24600,0,24600,82800,0,107400
143045203200000,SW 405,RESIDENTIAL,24300,0,24300,82000,0,106300
143045203300000,SW 405,RESIDENTIAL,23300,0,23300,77500,0,100800
143045203400000,SW 405,RESIDENTIAL,23300,0,23300,69800,0,93100
143045203500000,SW 405,RESIDENTIAL,23300,0,23300,84300,0,107600
143045203600000,SW 405,RESIDENTIAL,23300,0,23300,77000,0,100300
143045203700000,SW 405,EXEMPT,0,23300,23300,0,66100,89400
143045203800000,SW 405,RESIDENTIAL,23300,0,23300,73900,0,97200
143045203900000,SW 405,RESIDENTIAL,21000,0,21000,72900,0,93900
143045300100000,NW 333,RESIDENTIAL,24200,0,24200,73000,0,97200
143045300200000,NW 333,RESIDENTIAL,26400,0,26400,93600,0,120000
143045300300000,NW 333,RESIDENTIAL,26400,0,26400,91100,0,117500
143045300400000,NW 333,RESIDENTIAL,26400,0,26400,120400,0,146800
143045300500000,NW 333,RESIDENTIAL,26400,0,26400,82700,0,109100
143045300700000,NW 333,RESIDENTIAL,30200,0,30200,101400,0,131600
143045300800000,NW 333,RESIDENTIAL,30200,0,30200,108000,0,138200
143045300900000,NW 333,RESIDENTIAL,28200,0,28200,112600,0,140800
143045301000000,NW 333,RESIDENTIAL,31800,0,31800,130100,0,161900
143045301100000,NW 333,RESIDENTIAL,36400,0,36400,82700,0,119100
143045301200000,NW 333,RESIDENTIAL,30200,0,30200,111800,0,142000
143045301300000,NW 333,RESIDENTIAL,29400,0,29400,114900,0,144300
143045301600000,NW 333,RESIDENTIAL,24300,0,24300,131800,0,156100
143045301700000,NW 333,RESIDENTIAL,28000,0,28000,114000,0,142000
143045301800000,NW 333,RESIDENTIAL,24300,0,24300,109800,0,134100
143045302000000,NW 333,RESIDENTIAL,27100,0,27100,0,0,27100
143045302100000,NW 333,RESIDENTIAL,24600,0,24600,94200,0,118800
143045400100000,NW 333,RESIDENTIAL,31500,0,31500,104400,0,135900
143045400200000,NW 333,RESIDENTIAL,31400,0,31400,112800,0,144200
143045400300000,NW 333,RESIDENTIAL,30900,0,30900,118000,0,148900
143045500100000,SW 405,RESIDENTIAL,24100,0,24100,62300,0,86400
143045500200000,SW 405,RESIDENTIAL,24100,0,24100,64500,0,88600
143045500300000,SW 405,RESIDENTIAL,24100,0,24100,67100,0,91200
143045500400000,SW 405,RESIDENTIAL,24100,0,24100,73400,0,97500
143045500500000,SW 405,RESIDENTIAL,24700,0,24700,83400,0,108100
143045500600000,SW 405,RESIDENTIAL,24000,0,24000,86200,0,110200
143045500700000,SW 405,RESIDENTIAL,24000,0,24000,91700,0,115700
143045600800000,SW 405,RESIDENTIAL,26600,0,26600,106000,0,132600
143045600900000,SW 405,RESIDENTIAL,24000,0,24000,91000,0,115000
143045601000000,SW 405,RESIDENTIAL,24400,0,24400,86800,0,111200
143045601100000,SW 405,RESIDENTIAL,26200,0,26200,109300,0,135500
143045601200000,SW 405,RESIDENTIAL,24500,0,24500,101200,0,125700
143045601300000,SW 405,RESIDENTIAL,24200,0,24200,96800,0,121000
143045601400000,SW 405,RESIDENTIAL,24200,0,24200,95700,0,119900
143045601500000,SW 405,RESIDENTIAL,24200,0,24200,73700,0,97900
143045601600000,SW 405,RESIDENTIAL,24200,0,24200,84200,0,108400
143045601700000,SW 405,RESIDENTIAL,24200,0,24200,76800,0,101000
143045601800000,SW 405,RESIDENTIAL,24200,0,24200,94400,0,118600
143045601900000,SW 405,RESIDENTIAL,24200,0,24200,85900,0,110100
143045602000000,SW 405,RESIDENTIAL,24000,0,24000,89100,0,113100
143045602100000,SW 405,RESIDENTIAL,23800,0,23800,85200,0,109000
143045602200000,SW 405,RESIDENTIAL,23800,0,23800,88800,0,112600
143045602300000,SW 405,RESIDENTIAL,23800,0,23800,101800,0,125600
143045602400000,SW 405,RESIDENTIAL,23800,0,23800,90700,0,114500
143045602500000,SW 405,RESIDENTIAL,23800,0,23800,88300,0,112100
143045602600000,SW 405,RESIDENTIAL,24800,0,24800,90100,0,114900
143045602700000,SW 405,RESIDENTIAL,24500,0,24500,110900,0,135400
143045700100000,VACANT LAND,COMMERCIAL,0,10900,10900,0,0,10900
143047600100000,SCHOOL,EXEMPT,0,0,0,0,0,0
143047600200000,CONVERSION-NW/SW,MULTI-RES,18000,0,18000,76600,0,94600
143047600300000,SW 405,RESIDENTIAL,25200,0,25200,75700,0,100900
143047600400000,SW 405,RESIDENTIAL,24000,0,24000,100000,0,124000
143047600500000,SW 405,RESIDENTIAL,24000,0,24000,85000,0,109000
143047600600000,SW 405,RESIDENTIAL,24000,0,24000,78000,0,102000
143047600700000,SW 405,RESIDENTIAL,24000,0,24000,107800,0,131800
143047600800000,SW 405,RESIDENTIAL,24300,0,24300,91800,0,116100
143047600900000,SW 405,RESIDENTIAL,24300,0,24300,98700,0,123000
143047601000000,SW 405,RESIDENTIAL,24300,0,24300,94500,0,118800
143047601100000,SW 405,RESIDENTIAL,24300,0,24300,77300,0,101600
143047601200000,SW 405,RESIDENTIAL,24300,0,24300,73400,0,97700
143047601300000,SW 405,RESIDENTIAL,24100,0,24100,62200,0,86300
143047700100000,SW 405,RESIDENTIAL,25900,0,25900,59300,0,85200
143047700200000,SW 405,RESIDENTIAL,24500,0,24500,72600,0,97100
143047700300000,SW 405,RESIDENTIAL,24200,0,24200,72500,0,96700
143047700400000,SW 405,RESIDENTIAL,23800,0,23800,81300,0,105100
143047700500000,SW 405,RESIDENTIAL,23800,0,23800,70300,0,94100
143047700600000,SW 405,RESIDENTIAL,23800,0,23800,85300,0,109100
143047700700000,SW 405,RESIDENTIAL,24600,0,24600,119000,0,143600
143047700800000,SW 405,RESIDENTIAL,25700,0,25700,93300,0,119000
143047700900000,SW 405,RESIDENTIAL,25200,0,25200,92800,0,118000
143047800100000,SW 405,RESIDENTIAL,24700,0,24700,82200,0,106900
143047800200000,SW 405,RESIDENTIAL,24300,0,24300,80200,0,104500
143047800300000,SW 405,RESIDENTIAL,23300,0,23300,77900,0,101200
143047800400000,SW 405,RESIDENTIAL,25000,0,25000,109800,0,134800
143047800500000,SW 405,RESIDENTIAL,24600,0,24600,76900,0,101500
143047800600000,SW 405,RESIDENTIAL,23800,0,23800,76600,0,100400
143047800700000,SW 405,RESIDENTIAL,24800,0,24800,87300,0,112100
143047800800000,SW 405,RESIDENTIAL,24900,0,24900,62900,0,87800
143110100100000,WAREHOUSE,COMMERCIAL,0,111300,111300,0,251100,362400
143110100200000,CENTRALLY ASSESSED,OTHER,0,0,0,0,0,0
143110100300000,WAREHOUSE,COMMERCIAL,0,178500,178500,0,70700,249200
143110100400000,OFFICE,COMMERCIAL,0,288000,288000,0,274100,562100
143110100500000,SHOP,COMMERCIAL,0,324800,324800,0,134800,459600
143110200100000,FLAT PARKING,COMMERCIAL,0,138000,138000,0,27600,165600
143110200200000,LG DISCOUNT/RETAIL,COMMERCIAL,0,344000,344000,0,559500,903500
143110300100000,SHOP,COMMERCIAL,0,238000,238000,0,245100,483100
143110300200000,VETERINARY CLINIC,EXEMPT,0,130000,130000,0,117300,247300
143110300300000,OFFICE,COMMERCIAL,0,75000,75000,0,126800,201800
143110300400000,FRATERNAL,COMMERCIAL,0,75000,75000,0,67800,142800
143110300402000,BILLBOARD(BLL),COMMERCIAL,0,0,0,0,12800,12800
143110300500000,WAREHOUSE,COMMERCIAL,0,192800,192800,0,298700,491500
143110300600000,SHOP,COMMERCIAL,0,110000,110000,0,126000,236000
143110300700000,VACANT LAND,COMMERCIAL,0,27600,27600,0,0,27600
143110300800000,SHOP,COMMERCIAL,0,206000,206000,0,357200,563200
143110300900000,RESTAURANT,COMMERCIAL,0,136300,136300,0,118700,255000
143110301000000,SMALL RETAIL,COMMERCIAL,0,49300,49300,0,191700,241000
143110301100000,AUTO REPAIR/SALES,COMMERCIAL,0,173500,173500,0,200900,374400
143110301700000,FLAT PARKING,COMMERCIAL,0,276000,276000,0,50900,326900
143110301702000,BILLBOARD(BLL),COMMERCIAL,0,0,0,0,30700,30700
143110301900000,SW 420,RESIDENTIAL,62700,0,62700,0,0,62700
143110400100000,SW 420,RESIDENTIAL,12600,0,12600,0,0,12600
143110400200000,SW 420,RESIDENTIAL,10800,0,10800,0,0,10800
143110400300000,SW 420,RESIDENTIAL,10800,0,10800,0,0,10800
143110400400000,SW 420,RESIDENTIAL,10800,0,10800,0,0,10800
143110400500000,SW 420,RESIDENTIAL,10800,0,10800,0,0,10800
143110400600000,SW 420,RESIDENTIAL,10800,0,10800,0,0,10800
143110400700000,SW 420,RESIDENTIAL,10800,0,10800,0,0,10800
143110400800000,SW 420,RESIDENTIAL,10800,0,10800,0,0,10800
143110400900000,SW 420,RESIDENTIAL,10900,0,10900,0,0,10900
143110401000000,SW 420,RESIDENTIAL,12800,0,12800,0,0,12800
143110401100000,SW 420,RESIDENTIAL,13300,0,13300,0,0,13300
143110401200000,SW 420,RESIDENTIAL,35300,0,35300,149800,0,185100
143110401300000,SW 420,RESIDENTIAL,35300,0,35300,148900,0,184200
143110401400000,SW 420,RESIDENTIAL,10700,0,10700,0,0,10700
143110401500000,SW 420,RESIDENTIAL,10700,0,10700,0,0,10700
143110401600000,SW 420,RESIDENTIAL,10700,0,10700,0,0,10700
143110401700000,SW 420,RESIDENTIAL,10700,0,10700,0,0,10700
143110500100000,SW 420,RESIDENTIAL,14300,0,14300,0,0,14300
143110500200000,SW 420,RESIDENTIAL,12100,0,12100,0,0,12100
143110500300000,SW 420,RESIDENTIAL,12300,0,12300,0,0,12300
143110500400000,SW 420,RESIDENTIAL,14200,0,14200,0,0,14200
143110500500000,SW 420,RESIDENTIAL,15600,0,15600,0,0,15600
143110500600000,SW 420,RESIDENTIAL,15700,0,15700,0,0,15700
143110500700000,SW 420,RESIDENTIAL,15700,0,15700,0,0,15700
143110500800000,SW 420,RESIDENTIAL,14300,0,14300,0,0,14300
143110500900000,SW 420,RESIDENTIAL,16000,0,16000,0,0,16000
143110600100000,SW 420,RESIDENTIAL,15200,0,15200,0,0,15200
143110600200000,SW 420,RESIDENTIAL,14700,0,14700,0,0,14700
143110600300000,SW 420,RESIDENTIAL,42400,0,42400,164800,0,207200
143110600400000,SW 420,RESIDENTIAL,14700,0,14700,0,0,14700
143110600500000,SW 420,RESIDENTIAL,14700,0,14700,0,0,14700
143110600600000,SW 420,RESIDENTIAL,14700,0,14700,0,0,14700
143112600100000,WAREHOUSE,COMMERCIAL,0,186000,186000,0,469900,655900
143112600200000,AUTO REPAIR/SALES,COMMERCIAL,0,128600,128600,0,81700,210300
143112600300000,RESTAURANT,COMMERCIAL,0,132000,132000,0,90000,222000
143112600400000,RESTAURANT,COMMERCIAL,0,123400,123400,0,166500,289900
143112601000000,VETERINARY CLINIC,COMMERCIAL,0,244500,244500,0,711000,955500
143112601100000,WAREHOUSE,COMMERCIAL,0,225000,225000,0,487700,712700
143112700100000,AUTO REPAIR/SALES,COMMERCIAL,0,109100,109100,0,209800,318900
143112700200000,RESTAURANT,COMMERCIAL,0,181000,181000,0,147200,328200
143112700300000,SMALL RETAIL,COMMERCIAL,0,216900,216900,0,379900,596800
143112700400000,SW 420,RESIDENTIAL,36900,0,36900,0,0,36900
143112700500000,SW 420,RESIDENTIAL,41200,0,41200,140700,0,181900
143112700600000,SW 420,RESIDENTIAL,41600,0,41600,140700,0,182300
143112700700000,SW 420,RESIDENTIAL,40100,0,40100,159700,0,199800
143112700800000,SW 420,RESIDENTIAL,39600,0,39600,139000,0,178600
143112700900000,SW 420,RESIDENTIAL,34000,0,34000,138800,0,172800
143112701000000,SW 420,RESIDENTIAL,10700,0,10700,0,0,10700
143112701100000,SW 420,RESIDENTIAL,10700,0,10700,0,0,10700
143112701200000,SW 420,RESIDENTIAL,10700,0,10700,0,0,10700
143112701300000,SW 420,RESIDENTIAL,10700,0,10700,0,0,10700
143112800100000,CHURCH,EXEMPT,0,206600,206600,0,200400,407000
143112800200000,SHOP,COMMERCIAL,0,248000,248000,0,236900,484900
143112800300000,SHOP,COMMERCIAL,0,292800,292800,0,181900,474700
143112800400000,AUTO REPAIR/SALES,COMMERCIAL,0,307200,307200,0,152400,459600
143112800402000,BILLBOARD(BLL),COMMERCIAL,0,0,0,0,30700,30700
143112800500000,CHURCH,EXEMPT,0,172900,172900,0,82600,255500
143112800600000,SW 420,RESIDENTIAL,39400,0,39400,156900,0,196300
143112800700000,SW 420,RESIDENTIAL,39200,0,39200,156300,0,195500
143112800800000,SW 420,RESIDENTIAL,39200,0,39200,138700,0,177900
143112800900000,SW 420,RESIDENTIAL,38600,0,38600,135500,0,174100
143112801000000,SW 420,RESIDENTIAL,41200,0,41200,141000,0,182200
143112801100000,SW 420,RESIDENTIAL,40900,0,40900,167300,0,208200
143112801200000,SW 420,RESIDENTIAL,42000,0,42000,157900,0,199900
143112801300000,SW 420,RESIDENTIAL,39000,0,39000,150200,0,189200
143112801400000,SW 420,RESIDENTIAL,36700,0,36700,137400,0,174100
143112801500000,SW 420,RESIDENTIAL,36700,0,36700,141300,0,178000
143112801600000,SW 420,RESIDENTIAL,36700,0,36700,137100,0,173800
143112801900000,SW 420,RESIDENTIAL,27800,0,27800,125200,0,153000
143112802000000,SW 420,RESIDENTIAL,27800,0,27800,125700,0,153500
143112802100000,SW 420,RESIDENTIAL,27800,0,27800,140700,0,168500
143112802200000,SW 420,RESIDENTIAL,27800,0,27800,129400,0,157200
143112802300000,SW 420,RESIDENTIAL,27800,0,27800,129000,0,156800
143112802400000,SW 420,RESIDENTIAL,29900,0,29900,143900,0,173800
143112802500000,SW 420,RESIDENTIAL,41300,0,41300,164300,0,205600
143112802600000,SW 420,RESIDENTIAL,46500,0,46500,148900,0,195400
143112802700000,SW 420,RESIDENTIAL,38800,0,38800,163300,0,202100
143112802800000,SW 420,RESIDENTIAL,30200,0,30200,154400,0,184600
143112802900000,SW 420,RESIDENTIAL,27800,0,27800,133500,0,161300
143112803000000,SW 420,RESIDENTIAL,27800,0,27800,125000,0,152800
143112803100000,SW 420,RESIDENTIAL,27800,0,27800,123200,0,151000
143112803200000,SW 420,RESIDENTIAL,27800,0,27800,123200,0,151000
143112803300000,SW 420,RESIDENTIAL,27800,0,27800,123100,0,150900
143112900100000,SW 420,RESIDENTIAL,37500,0,37500,139400,0,176900
143112900200000,SW 420,RESIDENTIAL,37900,0,37900,136900,0,174800
143112900300000,SW 420,RESIDENTIAL,41800,0,41800,135200,0,177000
143112900400000,SW 420,RESIDENTIAL,41300,0,41300,149100,0,190400
143112900500000,SW 420,RESIDENTIAL,40700,0,40700,153600,0,194300
143112900600000,SW 420,RESIDENTIAL,39900,0,39900,140000,0,179900
143112900700000,SW 420,RESIDENTIAL,14000,0,14000,0,0,14000
143112900800000,SW 420,RESIDENTIAL,10500,0,10500,0,0,10500
143113000100000,SW 420,RESIDENTIAL,15600,0,15600,0,0,15600
143115100400000,SW 420,RESIDENTIAL,25400,0,25400,101100,0,126500
143115100500000,SW 420,RESIDENTIAL,25400,0,25400,73700,0,99100
143115100600000,SW 420,RESIDENTIAL,25400,0,25400,112000,0,137400
143115100700000,SW 420,RESIDENTIAL,25400,0,25400,102000,0,127400
143115100800000,SW 420,RESIDENTIAL,25400,0,25400,111900,0,137300
143115100900000,SW 420,RESIDENTIAL,25400,0,25400,80400,0,105800
143115101000000,SW 420,RESIDENTIAL,25200,0,25200,56000,0,81200
143115101100000,SW 420,RESIDENTIAL,29500,0,29500,95100,0,124600
143115101200000,SW 420,RESIDENTIAL,25700,0,25700,57200,0,82900
143115101300000,SW 420,RESIDENTIAL,40200,0,40200,78100,0,118300
143115101400000,SW 420,RESIDENTIAL,40200,0,40200,92500,0,132700
143115101500000,SW 420,RESIDENTIAL,40200,0,40200,156900,0,197100
143115101600000,SW 420,RESIDENTIAL,42400,0,42400,3500,0,45900
143115101800000,SW 420,RESIDENTIAL,48300,0,48300,229100,0,277400
143115101900000,SW 420,RESIDENTIAL,44400,0,44400,202400,0,246800
143115102000000,SW 420,RESIDENTIAL,42100,0,42100,0,0,42100
143115102200000,SW 420,RESIDENTIAL,65400,0,65400,296500,0,361900
143115102300000,SW 420,RESIDENTIAL,46200,0,46200,177700,0,223900
143115102400000,SW 420,RESIDENTIAL,45000,0,45000,191000,0,236000
143115102500000,SW 420,RESIDENTIAL,45000,0,45000,201700,0,246700
143115102600000,SW 420,RESIDENTIAL,45000,0,45000,162200,0,207200
143115102700000,SW 420,RESIDENTIAL,40000,0,40000,200300,0,240300
143115102800000,SW 420,RESIDENTIAL,39100,0,39100,157100,0,196200
143115200200000,SW 420,RESIDENTIAL,31000,0,31000,118400,0,149400
143115200300000,SW 420,RESIDENTIAL,30100,0,30100,122000,0,152100
143115200400000,SW 420,RESIDENTIAL,30600,0,30600,113000,0,143600
143115200500000,SW 420,RESIDENTIAL,30600,0,30600,130900,0,161500
143115200600000,SW 420,RESIDENTIAL,30600,0,30600,83600,0,114200
143115200700000,SW 420,RESIDENTIAL,30600,0,30600,93600,0,124200
143115200800000,SW 420,RESIDENTIAL,30600,0,30600,98100,0,128700
143115200900000,SW 420,RESIDENTIAL,30600,0,30600,106600,0,137200
143115201000000,SW 420,RESIDENTIAL,30600,0,30600,157000,0,187600
143115201100000,SW 420,RESIDENTIAL,32600,0,32600,121600,0,154200
143115201200000,SW 420,RESIDENTIAL,43400,0,43400,172400,0,215800
143115201300000,SW 420,RESIDENTIAL,40800,0,40800,0,0,40800
143115201400000,SW 420,RESIDENTIAL,40800,0,40800,169500,0,210300
143115201500000,SW 420,RESIDENTIAL,45800,0,45800,189100,0,234900
143115201600000,SW 420,RESIDENTIAL,54800,0,54800,298000,0,352800
143115201700000,SW 420,RESIDENTIAL,45500,0,45500,253400,0,298900
143115201800000,SW 420,RESIDENTIAL,45500,0,45500,178300,0,223800
143115201900000,SW 420,RESIDENTIAL,45600,0,45600,200300,0,245900
143115202000000,SW 420,RESIDENTIAL,30300,0,30300,142400,0,172700
143115202100000,SW 420,RESIDENTIAL,30300,0,30300,138200,0,168500
143115202200000,SW 420,RESIDENTIAL,30300,0,30300,160500,0,190800
143115202300000,SW 420,RESIDENTIAL,30300,0,30300,145300,0,175600
143115202400000,SW 420,RESIDENTIAL,30300,0,30300,164900,0,195200
143115202500000,SW 420,RESIDENTIAL,30300,0,30300,135900,0,166200
143115202600000,SW 420,RESIDENTIAL,30300,0,30300,150300,0,180600
143115202700000,SW 420,RESIDENTIAL,30300,0,30300,151800,0,182100
143115202800000,SW 420,RESIDENTIAL,32800,0,32800,163000,0,195800
143115202900000,CITY PROPERTY,EXEMPT,0,0,0,0,0,0
143115203000000,SW 420,RESIDENTIAL,32800,0,32800,182500,0,215300
143115203100000,SW 420,RESIDENTIAL,32800,0,32800,171900,0,204700
143115203200000,SW 420,RESIDENTIAL,32800,0,32800,177800,0,210600
143115203300000,SW 420,RESIDENTIAL,32100,0,32100,141200,0,173300
143115203400000,SW 420,RESIDENTIAL,30300,0,30300,181800,0,212100
143115203500000,SW 420,RESIDENTIAL,30300,0,30300,154800,0,185100
143115203600000,SW 420,RESIDENTIAL,30300,0,30300,149700,0,180000
143115203700000,SW 420,RESIDENTIAL,30300,0,30300,152800,0,183100
143115203800000,SW 420,RESIDENTIAL,35600,0,35600,134100,0,169700
143115203900000,SW 420,RESIDENTIAL,35600,0,35600,175200,0,210800
143115204000000,SW 420,RESIDENTIAL,32800,0,32800,141200,0,174000
143115204100000,SW 420,RESIDENTIAL,32800,0,32800,146100,0,178900
143115204200000,SW 420,RESIDENTIAL,32800,0,32800,155800,0,188600
143115204300000,SW 420,RESIDENTIAL,32800,0,32800,173100,0,205900
143115204500000,SW 420,RESIDENTIAL,39900,0,39900,154000,0,193900
143115204700000,SW 420,RESIDENTIAL,30300,0,30300,148300,0,178600
143115204800000,SW 420,RESIDENTIAL,30300,0,30300,147400,0,177700
143115204900000,SW 420,RESIDENTIAL,30300,0,30300,142400,0,172700
143115205000000,SW 420,RESIDENTIAL,30300,0,30300,142600,0,172900
143115205100000,SW 420,RESIDENTIAL,30300,0,30300,147100,0,177400
143115205200000,SW 420,RESIDENTIAL,30300,0,30300,143800,0,174100
143115205300000,SW 420,RESIDENTIAL,30300,0,30300,138100,0,168400
143115205400000,SW 420,RESIDENTIAL,30300,0,30300,137500,0,167800
143115205500000,SW 420,RESIDENTIAL,30300,0,30300,150600,0,180900
143115205600000,SW 420,RESIDENTIAL,30300,0,30300,148800,0,179100
143115205700000,SW 420,RESIDENTIAL,30300,0,30300,147100,0,177400
143115205800000,SW 420,RESIDENTIAL,42600,0,42600,156900,0,199500
143115205900000,SW 420,RESIDENTIAL,33800,0,33800,157400,0,191200
143115206000000,SW 420,RESIDENTIAL,30300,0,30300,145700,0,176000
143115206100000,SW 420,RESIDENTIAL,30300,0,30300,144400,0,174700
143115206200000,SW 420,RESIDENTIAL,30300,0,30300,139500,0,169800
143115206300000,SW 420,RESIDENTIAL,30300,0,30300,134400,0,164700
143115206400000,SW 420,RESIDENTIAL,30300,0,30300,143900,0,174200
143115206500000,SW 420,RESIDENTIAL,30300,0,30300,150500,0,180800
143115206600000,SW 420,RESIDENTIAL,30300,0,30300,144900,0,175200
143115206700000,SW 420,RESIDENTIAL,30300,0,30300,153400,0,183700
143115206800000,SW 420,RESIDENTIAL,32800,0,32800,149100,0,181900
143115300900000,SW 420,RESIDENTIAL,43200,0,43200,233800,0,277000
143115400100000,SW 420,RESIDENTIAL,45000,0,45000,195900,0,240900
143115400200000,SW 420,RESIDENTIAL,42000,0,42000,177200,0,219200
143115400300000,SW 420,RESIDENTIAL,45000,0,45000,176600,0,221600
143115500100000,SW 420,RESIDENTIAL,34700,0,34700,156600,0,191300
143115500200000,SW 420,RESIDENTIAL,30000,0,30000,140700,0,170700
143115500300000,SW 420,RESIDENTIAL,32200,0,32200,157200,0,189400
143115500400000,SW 420,RESIDENTIAL,31000,0,31000,125900,0,156900
143115500500000,SW 420,RESIDENTIAL,31000,0,31000,155500,0,186500
143115500600000,SW 420,RESIDENTIAL,30000,0,30000,131100,0,161100
143115500700000,SW 420,RESIDENTIAL,30000,0,30000,173900,0,203900
143115500800000,SW 420,RESIDENTIAL,30000,0,30000,158400,0,188400
143115500900000,SW 420,RESIDENTIAL,30000,0,30000,158900,0,188900
143115501000000,SW 420,RESIDENTIAL,30000,0,30000,142100,0,172100
143115501100000,SW 420,RESIDENTIAL,29600,0,29600,144400,0,174000
143115600100000,SW 420,RESIDENTIAL,36300,0,36300,167300,0,203600
143115600200000,SW 420,RESIDENTIAL,36300,0,36300,160400,0,196700
143115600300000,SW 420,RESIDENTIAL,35800,0,35800,134300,0,170100
143115600400000,SW 420,RESIDENTIAL,27800,0,27800,126500,0,154300
143115700100000,SW 420,RESIDENTIAL,35400,0,35400,133700,0,169100
143115700200000,SW 420,RESIDENTIAL,27800,0,27800,124400,0,152200
143115800100000,SW 420,RESIDENTIAL,38100,0,38100,131100,0,169200
143115800200000,SW 420,RESIDENTIAL,35400,0,35400,133900,0,169300
143115800300000,SW 420,RESIDENTIAL,37600,0,37600,140300,0,177900
143117600200000,SW 420,RESIDENTIAL,25700,0,25700,81800,0,107500
143117600300000,SW 420,RESIDENTIAL,25700,0,25700,60600,0,86300
143117600400000,SW 420,RESIDENTIAL,23800,0,23800,100900,0,124700
143117600500000,SW 420,RESIDENTIAL,31700,0,31700,37300,0,69000
143117600600000,SW 420,RESIDENTIAL,25700,0,25700,98600,0,124300
143117600700000,SW 420,RESIDENTIAL,27700,0,27700,60000,0,87700
143117600800000,SW 420,RESIDENTIAL,25700,0,25700,74700,0,100400
143117600900000,SW 420,RESIDENTIAL,20200,0,20200,43300,0,63500
143117601000000,SW 420,RESIDENTIAL,33700,0,33700,73000,0,106700
143117601100000,SW 420,RESIDENTIAL,20600,0,20600,24600,0,45200
143117601300000,SW 420,RESIDENTIAL,32100,0,32100,0,0,32100
143117601400000,SW 420,RESIDENTIAL,32300,0,32300,185600,0,217900
143117601500000,SW 420,RESIDENTIAL,32300,0,32300,166100,0,198400
143117601600000,SW 420,RESIDENTIAL,32600,0,32600,176700,0,209300
143117601700000,SW 420,RESIDENTIAL,38500,0,38500,152200,0,190700
143117601800000,SW 420,RESIDENTIAL,31200,0,31200,149800,0,181000
143117601900000,SW 420,RESIDENTIAL,29500,0,29500,173800,0,203300
143117602000000,SW 420,RESIDENTIAL,29900,0,29900,230300,0,260200
143117602100000,SW 420,RESIDENTIAL,38100,0,38100,144200,0,182300
143117602400000,SW 420,RESIDENTIAL,36200,0,36200,228200,0,264400
143117602500000,SW 420,RESIDENTIAL,28700,0,28700,172900,0,201600
143117602600000,SW 420,RESIDENTIAL,28600,0,28600,155200,0,183800
143117602700000,SW 420,RESIDENTIAL,29400,0,29400,168500,0,197900
143117602800000,SW 420,RESIDENTIAL,29400,0,29400,156100,0,185500
143117602900000,SW 420,RESIDENTIAL,30400,0,30400,185500,0,215900
143117603000000,SW 420,RESIDENTIAL,32000,0,32000,154600,0,186600
143117603100000,SW 420,RESIDENTIAL,32300,0,32300,173200,0,205500
143117603200000,SW 420,RESIDENTIAL,32300,0,32300,186400,0,218700
143117603300000,SW 420,RESIDENTIAL,32300,0,32300,179900,0,212200
143117603400000,SW 420,RESIDENTIAL,30500,0,30500,136600,0,167100
143117603500000,SW 420,RESIDENTIAL,30900,0,30900,157800,0,188700
143117603600000,SW 420,RESIDENTIAL,30300,0,30300,78400,0,108700
143117603700000,SW 420,RESIDENTIAL,30300,0,30300,100300,0,130600
143117603800000,SW 420,RESIDENTIAL,30300,0,30300,100400,0,130700
143117603900000,SW 420,RESIDENTIAL,30700,0,30700,145900,0,176600
143117604000000,SW 420,RESIDENTIAL,31100,0,31100,101300,0,132400
143117604100000,SW 420,RESIDENTIAL,31100,0,31100,122400,0,153500
143117604200000,SW 420,RESIDENTIAL,31800,0,31800,144100,0,175900
143117604300000,SW 420,RESIDENTIAL,32600,0,32600,156000,0,188600
143117604400000,SW 420,RESIDENTIAL,30200,0,30200,132900,0,163100
143117604500000,SW 420,RESIDENTIAL,31300,0,31300,162900,0,194200
143117604600000,SW 420,RESIDENTIAL,31600,0,31600,138200,0,169800
143117604800000,CITY PROPERTY,EXEMPT,0,0,0,0,0,0
143117604900000,CITY PROPERTY,EXEMPT,0,0,0,0,0,0
143117605000000,CITY PROPERTY,EXEMPT,0,0,0,0,0,0
143117605100000,SW 420,RESIDENTIAL,25500,0,25500,166800,0,192300
143117605200000,SW 420,RESIDENTIAL,25500,0,25500,133000,0,158500
143117605300000,SW 420,RESIDENTIAL,25500,0,25500,150700,0,176200
143117605400000,SW 420,RESIDENTIAL,25100,0,25100,186300,0,211400
143117605600000,SW 420,RESIDENTIAL,58000,0,58000,231500,0,289500
143117605700000,CITY PROPERTY,EXEMPT,0,0,0,0,0,0
143117605800000,CITY PROPERTY,EXEMPT,0,0,0,0,0,0
143117605900000,SW 420,RESIDENTIAL,62400,0,62400,43500,0,105900
143117606200000,SW 420,RESIDENTIAL,42200,0,42200,207300,0,249500
143117700100000,SW 420,RESIDENTIAL,34300,0,34300,197700,0,232000
143117700300000,SW 420,RESIDENTIAL,68200,0,68200,64100,0,132300
143117700500000,SW 420,RESIDENTIAL,33800,0,33800,219300,0,253100
143117700600000,SW 420,RESIDENTIAL,30300,0,30300,124700,0,155000
143117700700000,SW 420,RESIDENTIAL,27300,0,27300,104800,0,132100
143117700800000,SW 420,RESIDENTIAL,30300,0,30300,123800,0,154100
143117700900000,CITY PROPERTY,EXEMPT,0,0,0,0,0,0
143117701000000,SW 420,RESIDENTIAL,30300,0,30300,120200,0,150500
143117701100000,SW 420,RESIDENTIAL,30400,0,30400,161700,0,192100
143117701200000,SW 420,RESIDENTIAL,30300,0,30300,104500,0,134800
143117701300000,SW 420,RESIDENTIAL,36400,0,36400,162300,0,198700
143117701400000,SW 420,RESIDENTIAL,500,0,500,0,0,500
143117701500000,SW 420,RESIDENTIAL,32600,0,32600,194100,0,226700
143117701600000,SW 420,RESIDENTIAL,32300,0,32300,177000,0,209300
143117701700000,SW 420,RESIDENTIAL,46000,0,46000,226700,0,272700
143117701800000,SW 420,RESIDENTIAL,40700,0,40700,195000,0,235700
143117701900000,SW 420,RESIDENTIAL,80400,0,80400,0,0,80400
143117800100000,SW 420,RESIDENTIAL,37400,0,37400,154300,0,191700
143117800200000,SW 420,RESIDENTIAL,34300,0,34300,178400,0,212700
143117800300000,SW 420,RESIDENTIAL,34300,0,34300,184800,0,219100
143117800400000,SW 420,RESIDENTIAL,36400,0,36400,187600,0,224000
143117800500000,SW 420,RESIDENTIAL,36400,0,36400,204200,0,240600
143117800600000,SW 420,RESIDENTIAL,38400,0,38400,179600,0,218000
143117900100000,SW 420,RESIDENTIAL,45900,0,45900,165300,0,211200
143117900200000,SW 420,RESIDENTIAL,42800,0,42800,201200,0,244000
143117900300000,SW 420,RESIDENTIAL,45500,0,45500,192900,0,238400
143120100400000,CONVENIENCE STORE,COMMERCIAL,0,480600,480600,0,1048100,1528700
143120200100000,AUTO REPAIR/SALES,COMMERCIAL,0,360600,360600,0,257300,617900
143120200300000,RESTAURANT,COMMERCIAL,0,131800,131800,0,227800,359600
143120200600000,WAREHOUSE,COMMERCIAL,0,1822500,1822500,0,694200,2516700
143120200700000,RESTAURANT,COMMERCIAL,0,155000,155000,0,218000,373000
143120200800000,SMALL RETAIL,COMMERCIAL,0,563800,563800,0,598800,1162600
143122600200000,BRANCH BANK/CU,COMMERCIAL,0,468000,468000,0,486000,954000
143122600300000,LG DISCOUNT/RETAIL,COMMERCIAL,0,776500,776500,0,2284400,3060900
143122600400000,AUTO REPAIR/SALES,COMMERCIAL,0,534600,534600,0,1070600,1605200
143122700100000,AUTO REPAIR/SALES,COMMERCIAL,0,275400,275400,0,291000,566400
143122700200000,VACANT LAND,COMMERCIAL,0,131400,131400,0,0,131400
143122700300000,SMALL RETAIL,COMMERCIAL,0,120800,120800,0,243800,364600
143122700400000,WAREHOUSE,COMMERCIAL,0,45100,45100,0,114800,159900
143122700500000,LG DISCOUNT/RETAIL,COMMERCIAL,0,815000,815000,0,879900,1694900
143122700600000,SHOP,COMMERCIAL,0,253900,253900,0,166800,420700
143122700900000,FLAT PARKING,COMMERCIAL,0,70500,70500,0,20400,90900
143122701100000,FLAT PARKING,COMMERCIAL,0,158400,158400,0,5200,163600
143122701102000,ANTENNAS/TOWERS(BLL),COMMERCIAL,0,0,0,0,100400,100400
143122701200000,AUTO REPAIR/SALES,COMMERCIAL,0,254800,254800,0,344400,599200
143122701300000,BOWLING ALLEY,COMMERCIAL,0,211300,211300,0,518000,729300
143122701400000,VACANT LAND,COMMERCIAL,0,240100,240100,0,0,240100
143122701500000,WAREHOUSE,COMMERCIAL,0,526000,526000,0,1459000,1985000
143122701502000,BILLBOARD(BLL),COMMERCIAL,0,0,0,0,24100,24100
143122701700000,VACANT LAND,COMMERCIAL,0,18300,18300,0,0,18300
143122701702000,ANTENNAS/TOWERS(BLL),COMMERCIAL,0,0,0,0,88200,88200
143122701800000,OFFICE; MEDICAL,COMMERCIAL,0,906000,906000,0,2555200,3461200
143125100100000,VACANT LAND,COMMERCIAL,0,0,0,0,0,0
143125100700000,APARTMENT,RESIDENTIAL,48800,0,48800,451600,0,500400
143125100800000,APARTMENT,RESIDENTIAL,49400,0,49400,451300,0,500700
143125100900000,APARTMENT,RESIDENTIAL,38400,0,38400,216800,0,255200
143125101000000,VACANT LAND,COMMERCIAL,0,2200,2200,0,0,2200
143125101100000,NBHD SHOPPING CENTER,COMMERCIAL,0,725000,725000,0,2310000,3035000
143125101200000,VACANT LAND,COMMERCIAL,0,35800,35800,0,0,35800
143125101300000,VACANT LAND,COMMERCIAL,0,289000,289000,0,0,289000
143125101400000,NBHD SHOPPING CENTER,COMMERCIAL,0,375000,375000,0,529800,904800
143125101500000,OFFICE; MEDICAL,COMMERCIAL,0,216000,216000,0,276400,492400
143125101600000,OFFICE; MEDICAL,COMMERCIAL,0,252500,252500,0,228400,480900
143125101700000,FAST FOOD,COMMERCIAL,0,324000,324000,0,725700,1049700
143125101702000,BILLBOARD(BLL),COMMERCIAL,0,0,0,0,41100,41100
143125101800000,BRANCH BANK/CU,COMMERCIAL,0,488000,488000,0,1111800,1599800
143125102000000,VACANT LAND,COMMERCIAL,0,186400,186400,0,0,186400
143125102002000,BILLBOARD(BLL),COMMERCIAL,0,0,0,0,82500,82500
143125102100000,OFFICE,COMMERCIAL,0,318000,318000,0,759900,1077900
143125102200000,VACANT LAND,COMMERCIAL,0,364800,364800,0,0,364800
143125102300000,OFFICE; MEDICAL,COMMERCIAL,0,353200,353200,0,583900,937100
143125200100000,WAREHOUSE,COMMERCIAL,0,794200,794200,0,490000,1284200
143125300100000,SW 420,RESIDENTIAL,31900,0,31900,91200,0,123100
143125300200000,SW 420,RESIDENTIAL,31800,0,31800,83600,0,115400
143125300300000,SW 420,RESIDENTIAL,32500,0,32500,79700,0,112200
143125300400000,SW 420,RESIDENTIAL,32900,0,32900,79200,0,112100
143125300500000,APARTMENT,RESIDENTIAL,16700,0,16700,99700,0,116400
143125300600000,APARTMENT,MULTI-RES,39800,0,39800,299800,0,339600
143127600100000,SW 420,RESIDENTIAL,26700,0,26700,81100,0,107800
143127600200000,SW 420,RESIDENTIAL,26900,0,26900,94400,0,121300
143127600300000,SW 420,RESIDENTIAL,26900,0,26900,83500,0,110400
143127600400000,SW 420,RESIDENTIAL,26100,0,26100,112800,0,138900
143127600500000,SW 420,RESIDENTIAL,26100,0,26100,91600,0,117700
143127600600000,SW 420,RESIDENTIAL,26100,0,26100,86300,0,112400
143127600700000,SW 420,RESIDENTIAL,26100,0,26100,77300,0,103400
143127600800000,SW 420,RESIDENTIAL,26100,0,26100,87200,0,113300
143127600900000,SW 420,RESIDENTIAL,27700,0,27700,61000,0,88700
143127601000000,SW 420,RESIDENTIAL,29200,0,29200,91600,0,120800
143127601400000,CHURCH,EXEMPT,0,65500,65500,0,89200,154700
143127601500000,SW 420,RESIDENTIAL,33300,0,33300,65300,0,98600
143127601600000,SW 420,RESIDENTIAL,24000,0,24000,77000,0,101000
143127601700000,SW 420,RESIDENTIAL,24000,0,24000,108100,0,132100
143127601800000,SW 420,RESIDENTIAL,27200,0,27200,107700,0,134900
143127601900000,SW 420,RESIDENTIAL,27300,0,27300,94700,0,122000
143127602000000,SW 420,RESIDENTIAL,28600,0,28600,81800,0,110400
143127602100000,SW 420,RESIDENTIAL,26100,0,26100,81400,0,107500
143127602200000,SW 420,RESIDENTIAL,26800,0,26800,82300,0,109100
143127602300000,SW 420,RESIDENTIAL,26500,0,26500,102300,0,128800
143127602400000,SW 420,RESIDENTIAL,28800,0,28800,92600,0,121400
143127602500000,SW 420,RESIDENTIAL,23700,0,23700,103700,0,127400
143127602600000,SW 420,RESIDENTIAL,24300,0,24300,85600,0,109900
143127602700000,SW 420,RESIDENTIAL,24400,0,24400,79900,0,104300
143127602800000,SW 420,RESIDENTIAL,26200,0,26200,82300,0,108500
143127602900000,SW 420,RESIDENTIAL,28800,0,28800,97400,0,126200
143127603000000,SECTION 42,COMMERCIAL,0,619200,619200,0,1691000,2310200
143127700100000,SW 420,RESIDENTIAL,26000,0,26000,79700,0,105700
143127700200000,SW 420,RESIDENTIAL,26300,0,26300,93400,0,119700
143127700300000,SW 420,RESIDENTIAL,26300,0,26300,84000,0,110300
143127700400000,SW 420,RESIDENTIAL,26300,0,26300,85100,0,111400
143127700500000,SW 420,RESIDENTIAL,24300,0,24300,79600,0,103900
143127700600000,SW 420,RESIDENTIAL,24300,0,24300,92500,0,116800
143127700700000,SW 420,RESIDENTIAL,24300,0,24300,91700,0,116000
143127700800000,SW 420,RESIDENTIAL,24300,0,24300,94700,0,119000
143127700900000,SW 420,RESIDENTIAL,26100,0,26100,99900,0,126000
143127701000000,SW 420,RESIDENTIAL,24800,0,24800,84800,0,109600
143127701100000,SW 420,RESIDENTIAL,24300,0,24300,83100,0,107400
143127701200000,SW 420,RESIDENTIAL,22600,0,22600,89700,0,112300
143127701300000,SW 420,RESIDENTIAL,26600,0,26600,91700,0,118300
143127701400000,SW 420,RESIDENTIAL,26300,0,26300,91400,0,117700
143127701500000,SW 420,RESIDENTIAL,26300,0,26300,109800,0,136100
143127701600000,SW 420,RESIDENTIAL,26300,0,26300,81400,0,107700
143127701700000,SW 420,RESIDENTIAL,26300,0,26300,90100,0,116400
143127701800000,SW 420,RESIDENTIAL,26600,0,26600,81400,0,108000
143127800100000,SW 420,RESIDENTIAL,30600,0,30600,90200,0,120800
143127800200000,SW 420,RESIDENTIAL,30900,0,30900,80400,0,111300
143127800300000,SW 420,RESIDENTIAL,30900,0,30900,100900,0,131800
143127800400000,SW 420,RESIDENTIAL,30900,0,30900,81600,0,112500
143127800500000,SW 420,RESIDENTIAL,30900,0,30900,87700,0,118600
143127800600000,SW 420,RESIDENTIAL,31200,0,31200,81000,0,112200
143127800700000,SW 420,RESIDENTIAL,29800,0,29800,85300,0,115100
143127800800000,SW 420,RESIDENTIAL,25600,0,25600,90700,0,116300
143127800900000,SW 420,RESIDENTIAL,28200,0,28200,80800,0,109000
143127801000000,SW 420,RESIDENTIAL,28200,0,28200,110000,0,138200
143127900100000,SW 420,RESIDENTIAL,26900,0,26900,92400,0,119300
143127900200000,SW 420,RESIDENTIAL,27700,0,27700,108100,0,135800
143127900300000,SW 420,RESIDENTIAL,27000,0,27000,91300,0,118300
143127900400000,SW 420,RESIDENTIAL,27300,0,27300,89200,0,116500
143127900500000,SW 420,RESIDENTIAL,27300,0,27300,104700,0,132000
143127900600000,SW 420,RESIDENTIAL,30500,0,30500,90000,0,120500
143127900700000,SW 420,RESIDENTIAL,30400,0,30400,76700,0,107100
143127900800000,SW 420,RESIDENTIAL,31100,0,31100,94800,0,125900
143127900900000,SW 420,RESIDENTIAL,31100,0,31100,110400,0,141500
143127901000000,SW 420,RESIDENTIAL,29200,0,29200,89400,0,118600
143127901100000,SW 420,RESIDENTIAL,28500,0,28500,76600,0,105100
143127901200000,SW 420,RESIDENTIAL,30400,0,30400,74900,0,105300
143127901300000,SW 420,RESIDENTIAL,31000,0,31000,97800,0,128800
143127901400000,SW 420,RESIDENTIAL,30800,0,30800,79000,0,109800
143127901500000,SW 420,RESIDENTIAL,26900,0,26900,81400,0,108300
143128000100000,SW 420,RESIDENTIAL,30900,0,30900,80700,0,111600
143128000200000,SW 420,RESIDENTIAL,26700,0,26700,97500,0,124200
143128000300000,SW 420,RESIDENTIAL,27700,0,27700,99200,0,126900
143128000400000,SW 420,RESIDENTIAL,25500,0,25500,109800,0,135300
143128000500000,SW 420,RESIDENTIAL,29600,0,29600,90100,0,119700
143128000600000,SW 420,RESIDENTIAL,28200,0,28200,85300,0,113500
143128000700000,SW 420,RESIDENTIAL,28200,0,28200,84900,0,113100
143128000800000,SW 420,RESIDENTIAL,28200,0,28200,98300,0,126500
143128000900000,SW 420,RESIDENTIAL,30100,0,30100,85900,0,116000
143128001000000,SW 420,RESIDENTIAL,30100,0,30100,99700,0,129800
143128001100000,SW 420,RESIDENTIAL,30100,0,30100,84000,0,114100
143128001200000,SW 420,RESIDENTIAL,30100,0,30100,90800,0,120900
143128001300000,SW 420,RESIDENTIAL,27200,0,27200,92600,0,119800
143128001400000,SW 420,RESIDENTIAL,30100,0,30100,93100,0,123200
143128001500000,SW 420,RESIDENTIAL,30500,0,30500,100300,0,130800
143128001600000,SW 420,RESIDENTIAL,32800,0,32800,92500,0,125300
143128001700000,SW 420,RESIDENTIAL,32800,0,32800,107400,0,140200
143128001800000,SW 420,RESIDENTIAL,32800,0,32800,89000,0,121800
143128001900000,SW 420,RESIDENTIAL,31000,0,31000,106700,0,137700
143128100100000,SW 420,RESIDENTIAL,29100,0,29100,101600,0,130700
143128100200000,SW 420,RESIDENTIAL,31300,0,31300,79500,0,110800
143128100300000,SW 420,RESIDENTIAL,29300,0,29300,94200,0,123500
143128100400000,SW 420,RESIDENTIAL,29300,0,29300,114200,0,143500
143128100500000,SW 420,RESIDENTIAL,29300,0,29300,108400,0,137700
143128100600000,SW 420,RESIDENTIAL,30300,0,30300,106000,0,136300
143128100700000,SW 420,RESIDENTIAL,28300,0,28300,83500,0,111800
143128100800000,SW 420,RESIDENTIAL,28200,0,28200,117500,0,145700
143128100900000,SW 420,RESIDENTIAL,27200,0,27200,105800,0,133000
143128101000000,SW 420,RESIDENTIAL,28200,0,28200,114800,0,143000
143128101100000,SW 420,RESIDENTIAL,31700,0,31700,108400,0,140100
143128101200000,SW 420,RESIDENTIAL,30000,0,30000,101600,0,131600
143130100100000,SW 420,RESIDENTIAL,33800,0,33800,124600,0,158400
143130100200000,SW 420,RESIDENTIAL,33800,0,33800,88400,0,122200
143130100300000,SW 420,RESIDENTIAL,32300,0,32300,112800,0,145100
143130100400000,SW 420,RESIDENTIAL,35900,0,35900,72800,0,108700
143130100500000,SW 420,RESIDENTIAL,33100,0,33100,96000,0,129100
143130100600000,SW 420,RESIDENTIAL,33100,0,33100,148900,0,182000
143130100700000,SW 420,RESIDENTIAL,49800,0,49800,110500,0,160300
143130100800000,SW 420,RESIDENTIAL,53900,0,53900,82100,0,136000
143130100900000,SW 420,RESIDENTIAL,2400,0,2400,0,0,2400
143130101000000,SW 420,RESIDENTIAL,54400,0,54400,237100,0,291500
143130101100000,SW 420,RESIDENTIAL,46800,0,46800,114800,0,161600
143130101200000,SW 420,RESIDENTIAL,37800,0,37800,121100,0,158900
143130200100000,SW 420,RESIDENTIAL,26100,0,26100,58300,0,84400
143130200200000,SW 420,RESIDENTIAL,43600,0,43600,74500,0,118100
143130200300000,SW 420,RESIDENTIAL,39000,0,39000,120100,0,159100
143130200400000,SW 420,RESIDENTIAL,39000,0,39000,93100,0,132100
143130200500000,SW 420,RESIDENTIAL,31000,0,31000,72000,0,103000
143130200600000,SW 420,RESIDENTIAL,33300,0,33300,48800,0,82100
143130200700000,SW 420,RESIDENTIAL,33200,0,33200,59700,0,92900
143130200800000,SW 420,RESIDENTIAL,24400,0,24400,68900,0,93300
143130200900000,SW 420,RESIDENTIAL,25300,0,25300,57300,0,82600
143130201000000,SW 420,RESIDENTIAL,32200,0,32200,38100,0,70300
143130201100000,SW 420,RESIDENTIAL,48300,0,48300,55200,0,103500
143130201200000,SW 420,RESIDENTIAL,60900,0,60900,90900,0,151800
143130201300000,SCHOOL,EXEMPT,0,0,0,0,0,0
143130201500000,SW 420,RESIDENTIAL,48700,0,48700,85800,0,134500
143130201600000,SW 420,RESIDENTIAL,39800,0,39800,105400,0,145200
143130201700000,SW 420,RESIDENTIAL,39800,0,39800,138600,0,178400
143130201800000,SW 420,RESIDENTIAL,41500,0,41500,124300,0,165800
143130201900000,SW 420,RESIDENTIAL,27900,0,27900,116400,0,144300
143130202000000,SW 420,EXEMPT,0,27900,27900,0,110800,138700
143130202200000,SW 420,RESIDENTIAL,66900,0,66900,231100,0,298000
143130202500000,SW 420,RESIDENTIAL,60500,0,60500,131500,0,192000
143130202600000,SW 420,RESIDENTIAL,60400,0,60400,0,0,60400
143130300100000,SW 420,RESIDENTIAL,23200,0,23200,70100,0,93300
143130300200000,SW 420,RESIDENTIAL,39400,0,39400,61300,0,100700
143130300300000,SW 420,RESIDENTIAL,35100,0,35100,85300,0,120400
143130300400000,SW 420,RESIDENTIAL,31000,0,31000,139700,0,170700
143130300500000,SW 420,RESIDENTIAL,29100,0,29100,166500,0,195600
143130300600000,SW 420,RESIDENTIAL,29100,0,29100,113500,0,142600
143130300700000,SW 420,RESIDENTIAL,29200,0,29200,129600,0,158800
143130300800000,SW 420,RESIDENTIAL,21900,0,21900,65200,0,87100
143130300900000,SW 420,RESIDENTIAL,23800,0,23800,87800,0,111600
143130301000000,SW 420,RESIDENTIAL,22200,0,22200,74100,0,96300
143130301100000,SW 420,RESIDENTIAL,23800,0,23800,78900,0,102700
143130400100000,SW 420,RESIDENTIAL,32100,0,32100,124300,0,156400
143130400200000,SW 420,RESIDENTIAL,32400,0,32400,155100,0,187500
143130400300000,SW 420,RESIDENTIAL,33200,0,33200,137400,0,170600
143130400400000,SW 420,RESIDENTIAL,31000,0,31000,103400,0,134400
143130400500000,SW 420,RESIDENTIAL,31000,0,31000,106500,0,137500
143130400600000,SW 420,RESIDENTIAL,32800,0,32800,116900,0,149700
143130400700000,SW 420,RESIDENTIAL,31600,0,31600,121200,0,152800
143130500100000,SW 420,RESIDENTIAL,32300,0,32300,103000,0,135300
143130500200000,SW 420,RESIDENTIAL,29100,0,29100,116000,0,145100
143130500300000,SW 420,RESIDENTIAL,28400,0,28400,77900,0,106300
143130500400000,SW 420,RESIDENTIAL,30800,0,30800,96000,0,126800
143130500500000,SW 420,RESIDENTIAL,30000,0,30000,101100,0,131100
143130500600000,SW 420,RESIDENTIAL,30000,0,30000,104700,0,134700
143130500700000,SW 420,RESIDENTIAL,30000,0,30000,98800,0,128800
143130500800000,SW 420,RESIDENTIAL,30400,0,30400,97100,0,127500
143132600100000,SW 420,RESIDENTIAL,36200,0,36200,97800,0,134000
143132600200000,SW 420,RESIDENTIAL,36200,0,36200,109800,0,146000
143132600300000,SW 420,RESIDENTIAL,31300,0,31300,89000,0,120300
143132600400000,SW 420,RESIDENTIAL,25000,0,25000,116800,0,141800
143132600500000,SW 420,RESIDENTIAL,31900,0,31900,130300,0,162200
143132600600000,SW 420,RESIDENTIAL,32700,0,32700,104100,0,136800
143132600700000,SW 420,RESIDENTIAL,32700,0,32700,114300,0,147000
143132600800000,SW 420,RESIDENTIAL,100,0,100,0,0,100
143132600900000,SW 420,RESIDENTIAL,30400,0,30400,120900,0,151300
143132601000000,SW 420,RESIDENTIAL,30700,0,30700,114800,0,145500
143132700100000,SW 420,RESIDENTIAL,25700,0,25700,0,0,25700
143132700200000,SW 420,RESIDENTIAL,32200,0,32200,84900,0,117100
143132700300000,SW 420,EXEMPT,0,50100,50100,0,149600,199700
143132700400000,SW 420,RESIDENTIAL,32700,0,32700,142200,0,174900
143132700500000,SW 420,RESIDENTIAL,36000,0,36000,146300,0,182300
143132700600000,SW 420,RESIDENTIAL,36700,0,36700,154200,0,190900
143132700700000,SW 420,RESIDENTIAL,36700,0,36700,163300,0,200000
143132700800000,SW 420,RESIDENTIAL,35600,0,35600,142200,0,177800
143132700900000,SW 420,RESIDENTIAL,40000,0,40000,150600,0,190600
143132701000000,SW 420,RESIDENTIAL,41100,0,41100,153200,0,194300
143132701100000,SW 420,RESIDENTIAL,35600,0,35600,153200,0,188800
143132701200000,SW 420,RESIDENTIAL,37300,0,37300,152300,0,189600
143132701300000,SW 420,RESIDENTIAL,36700,0,36700,154900,0,191600
143132701400000,SW 420,RESIDENTIAL,36700,0,36700,0,0,36700
143132701500000,SW 420,RESIDENTIAL,31700,0,31700,88400,0,120100
143132701600000,SW 420,RESIDENTIAL,31700,0,31700,80300,0,112000
143132701700000,SW 420,RESIDENTIAL,31900,0,31900,77300,0,109200
143132702700000,THEATER,COMMERCIAL,0,1542000,1542000,0,4601500,6143500
143132702800000,FAST FOOD,COMMERCIAL,0,406800,406800,0,778100,1184900
143132702900000,RESTAURANT,COMMERCIAL,0,420000,420000,0,668200,1088200
143132703000000,SW 420,RESIDENTIAL,41300,0,41300,161600,0,202900
143132703100000,SW 420,RESIDENTIAL,40900,0,40900,221100,0,262000
143132703200000,SW 420,RESIDENTIAL,36700,0,36700,188000,0,224700
143132703300000,SW 420,RESIDENTIAL,39000,0,39000,169500,0,208500
143132703400000,SW 420,RESIDENTIAL,36700,0,36700,136000,0,172700
143132703500000,SW 420,RESIDENTIAL,39000,0,39000,196000,0,235000
143132703600000,SW 420,RESIDENTIAL,37000,0,37000,231900,0,268900
143132703700000,SW 420,RESIDENTIAL,28500,0,28500,153000,0,181500
143132703800000,SW 420,RESIDENTIAL,29100,0,29100,121900,0,151000
143132703900000,SW 420,RESIDENTIAL,31700,0,31700,99000,0,130700
143132704000000,SW 420,RESIDENTIAL,31500,0,31500,143600,0,175100
143132704100000,SW 420,RESIDENTIAL,32300,0,32300,114500,0,146800
143132704200000,SW 420,RESIDENTIAL,32300,0,32300,124500,0,156800
143132704300000,SW 420,RESIDENTIAL,30300,0,30300,110000,0,140300
143132704400000,SW 420,RESIDENTIAL,26200,0,26200,142700,0,168900
143132704500000,OFFICE; MEDICAL,COMMERCIAL,0,1288300,1288300,0,3145200,4433500
143132800100000,SW 420,RESIDENTIAL,33800,0,33800,153200,0,187000
143132800200000,SW 420,RESIDENTIAL,32400,0,32400,144700,0,177100
143132800500000,SW 420,RESIDENTIAL,28200,0,28200,104300,0,132500
143132800600000,SW 420,RESIDENTIAL,29900,0,29900,99900,0,129800
143132800700000,SW 420,RESIDENTIAL,29100,0,29100,103200,0,132300
143132800800000,SW 420,RESIDENTIAL,29100,0,29100,110700,0,139800
143132800900000,SW 420,RESIDENTIAL,51800,0,51800,177600,0,229400
143132900100000,SW 420,RESIDENTIAL,29100,0,29100,108200,0,137300
143132900200000,SW 420,RESIDENTIAL,34500,0,34500,103200,0,137700
143132900300000,SW 420,RESIDENTIAL,38300,0,38300,111800,0,150100
143132900400000,SW 420,RESIDENTIAL,35500,0,35500,103800,0,139300
143133000100000,SW 420,RESIDENTIAL,31300,0,31300,135700,0,167000
143133000200000,SW 420,RESIDENTIAL,31000,0,31000,107300,0,138300
143133000300000,SW 420,RESIDENTIAL,31300,0,31300,117400,0,148700
143133000400000,SW 420,RESIDENTIAL,35600,0,35600,161100,0,196700
143133000500000,SW 420,RESIDENTIAL,37900,0,37900,152100,0,190000
143133000600000,SW 420,RESIDENTIAL,37900,0,37900,156200,0,194100
143133000700000,SW 420,RESIDENTIAL,37900,0,37900,120800,0,158700
143133000800000,SW 420,RESIDENTIAL,37900,0,37900,142900,0,180800
143133000900000,SW 420,RESIDENTIAL,31700,0,31700,100000,0,131700
143133001000000,SW 420,RESIDENTIAL,29700,0,29700,104300,0,134000
143133001100000,SW 420,RESIDENTIAL,30400,0,30400,105800,0,136200
143133100600000,SW 420,RESIDENTIAL,40900,0,40900,101200,0,142100
143135100100000,SW 420,RESIDENTIAL,39800,0,39800,122900,0,162700
143135100200000,SW 420,RESIDENTIAL,37000,0,37000,127500,0,164500
143135200100000,SW 420,RESIDENTIAL,37900,0,37900,152800,0,190700
143135200200000,SW 420,RESIDENTIAL,34600,0,34600,144600,0,179200
143135200300000,SW 420,RESIDENTIAL,34100,0,34100,145300,0,179400
143135200400000,SW 420,RESIDENTIAL,34500,0,34500,173200,0,207700
143135200500000,SW 420,RESIDENTIAL,36900,0,36900,162400,0,199300
143135200600000,SW 420,RESIDENTIAL,37900,0,37900,142300,0,180200
143135200700000,SW 420,RESIDENTIAL,38400,0,38400,144800,0,183200
143135200800000,SW 420,RESIDENTIAL,39500,0,39500,163900,0,203400
143135200900000,SW 420,RESIDENTIAL,38100,0,38100,171400,0,209500
143135201000000,SW 420,RESIDENTIAL,37900,0,37900,192600,0,230500
143135201100000,SW 420,RESIDENTIAL,38100,0,38100,189400,0,227500
143135201200000,SW 420,RESIDENTIAL,38100,0,38100,139900,0,178000
143135201300000,SW 420,RESIDENTIAL,37900,0,37900,153100,0,191000
143135201400000,SW 420,RESIDENTIAL,35600,0,35600,161900,0,197500
143135201500000,SW 420,RESIDENTIAL,39200,0,39200,123000,0,162200
143135201600000,SW 420,RESIDENTIAL,38000,0,38000,182300,0,220300
143135201700000,SW 420,RESIDENTIAL,35600,0,35600,163900,0,199500
143135201800000,SW 420,RESIDENTIAL,37900,0,37900,124900,0,162800
143135201900000,SW 420,RESIDENTIAL,37300,0,37300,165700,0,203000
143135202000000,SW 420,RESIDENTIAL,40200,0,40200,175700,0,215900
143135300100000,SW 420,RESIDENTIAL,39700,0,39700,165000,0,204700
143135300200000,RESTAURANT,COMMERCIAL,0,580000,580000,0,841300,1421300
143135300400000,SW 420,RESIDENTIAL,46900,0,46900,278600,0,325500
143135300500000,SW 420,RESIDENTIAL,44800,0,44800,195300,0,240100
143135300600000,SW 420,RESIDENTIAL,41200,0,41200,216200,0,257400
143135300700000,SW 420,RESIDENTIAL,38600,0,38600,189700,0,228300
143135300800000,SW 420,RESIDENTIAL,43100,0,43100,189000,0,232100
143135300900000,SW 420,RESIDENTIAL,44100,0,44100,222400,0,266500
143135301000000,SW 420,RESIDENTIAL,41400,0,41400,203300,0,244700
143135301100000,SW 420,RESIDENTIAL,43700,0,43700,204200,0,247900
143135301200000,NBHD SHOPPING CENTER,COMMERCIAL,0,601500,601500,0,1218900,1820400
143135301300000,VACANT LAND,COMMERCIAL,0,0,0,0,0,0
143135301400000,RESTAURANT,COMMERCIAL,0,563200,563200,0,904500,1467700
143135301500000,RESTAURANT,COMMERCIAL,0,504000,504000,0,652700,1156700
143135301600000,FAST FOOD,COMMERCIAL,0,376300,376300,0,583600,959900
143135301700000,BRANCH BANK/CU,COMMERCIAL,0,360300,360300,0,1712700,2073000
143135301800000,OFFICE; MEDICAL,COMMERCIAL,0,800000,800000,0,1411600,2211600
143135302100000,SCHOOL,COMMERCIAL,0,895500,895500,0,1610600,2506100
143135302200000,VACANT LAND,COMMERCIAL,0,3700,3700,0,0,3700
143135302300000,FAST FOOD,COMMERCIAL,0,222300,222300,0,31300,253600
143135302400000,BRANCH BANK/CU,COMMERCIAL,0,402600,402600,0,1259700,1662300
143135302600000,SW 420,RESIDENTIAL,29400,0,29400,154800,0,184200
143135302700000,SW 420,RESIDENTIAL,33600,0,33600,169800,0,203400
143135302800000,SW 420,RESIDENTIAL,28500,0,28500,155100,0,183600
143135302900000,SW 420,RESIDENTIAL,33700,0,33700,159000,0,192700
143135303000000,SW 420,RESIDENTIAL,39900,0,39900,155200,0,195100
143135303100000,SW 420,RESIDENTIAL,32100,0,32100,165100,0,197200
143135303200000,SW 420,RESIDENTIAL,31100,0,31100,150900,0,182000
143135303300000,SW 420,RESIDENTIAL,32100,0,32100,145500,0,177600
143137600100000,CITY PROPERTY,EXEMPT,0,0,0,0,0,0
143137700100000,SW 420,RESIDENTIAL,62500,0,62500,85300,0,147800
143137700200000,SW 420,RESIDENTIAL,29800,0,29800,134800,0,164600
143137700300000,SW 420,RESIDENTIAL,30000,0,30000,128800,0,158800
143137700400000,SW 420,RESIDENTIAL,30000,0,30000,0,0,30000
143137700500000,SW 420,RESIDENTIAL,32000,0,32000,132900,0,164900
143137700600000,SW 420,RESIDENTIAL,37400,0,37400,179700,0,217100
143137700700000,SW 420,RESIDENTIAL,26200,0,26200,127200,0,153400
143137700800000,SW 420,RESIDENTIAL,26600,0,26600,110300,0,136900
143137700900000,SW 420,RESIDENTIAL,25200,0,25200,121600,0,146800
143137701000000,SW 420,RESIDENTIAL,25000,0,25000,124700,0,149700
143137701200000,CITY PROPERTY,EXEMPT,0,0,0,0,0,0
143137701300000,SW 420,RESIDENTIAL,30800,0,30800,130800,0,161600
143137701400000,SW 420,RESIDENTIAL,30900,0,30900,113900,0,144800
143137701500000,SW 420,RESIDENTIAL,31200,0,31200,113600,0,144800
143137701600000,SW 420,RESIDENTIAL,31200,0,31200,109900,0,141100
143137701700000,SW 420,RESIDENTIAL,31200,0,31200,97100,0,128300
143137701800000,SW 420,RESIDENTIAL,31400,0,31400,97100,0,128500
143137701900000,SW 420,RESIDENTIAL,31200,0,31200,85500,0,116700
143137702000000,CITY PROPERTY,EXEMPT,0,0,0,0,0,0
143137702100000,CITY PROPERTY,EXEMPT,0,0,0,0,0,0
143137800100000,SW 420,RESIDENTIAL,32100,0,32100,93900,0,126000
143137800200000,SW 420,RESIDENTIAL,38500,0,38500,165400,0,203900
143137800300000,SW 420,RESIDENTIAL,36300,0,36300,148000,0,184300
143137800400000,SW 420,RESIDENTIAL,37400,0,37400,148900,0,186300
143137800500000,SW 420,RESIDENTIAL,38100,0,38100,164300,0,202400
143137800600000,SW 420,RESIDENTIAL,38500,0,38500,178700,0,217200
143137800700000,SW 420,RESIDENTIAL,38500,0,38500,176200,0,214700
143137800800000,SW 420,RESIDENTIAL,42800,0,42800,132700,0,175500
143137800900000,SW 420,RESIDENTIAL,29100,0,29100,105000,0,134100
143137801000000,SW 420,RESIDENTIAL,30000,0,30000,130900,0,160900
143137801100000,SW 420,RESIDENTIAL,30000,0,30000,131900,0,161900
143137801200000,SW 420,RESIDENTIAL,30000,0,30000,129700,0,159700
143137801300000,SW 420,RESIDENTIAL,32000,0,32000,118000,0,150000
143137801400000,SW 420,EXEMPT,0,33500,33500,0,102200,135700
143137801500000,SW 420,RESIDENTIAL,100,0,100,0,0,100
143137801600000,SW 420,RESIDENTIAL,30000,0,30000,104500,0,134500
143137801700000,SW 420,RESIDENTIAL,30000,0,30000,112400,0,142400
143137801800000,SW 420,RESIDENTIAL,30000,0,30000,85800,0,115800
143137900400000,SW 420,RESIDENTIAL,33600,0,33600,162300,0,195900
143137900500000,SW 420,RESIDENTIAL,33600,0,33600,199400,0,233000
143137900600000,SW 420,RESIDENTIAL,28500,0,28500,169000,0,197500
143137900700000,SW 420,RESIDENTIAL,33600,0,33600,156200,0,189800
143137900800000,SW 420,RESIDENTIAL,32700,0,32700,139800,0,172500
143137900900000,SW 420,RESIDENTIAL,33100,0,33100,208100,0,241200
143137901000000,SW 420,RESIDENTIAL,33600,0,33600,5100,0,38700
143137901100000,SW 420,RESIDENTIAL,33600,0,33600,172200,0,205800
143137901200000,SW 420,RESIDENTIAL,32700,0,32700,158300,0,191000
143137901300000,SW 420,RESIDENTIAL,33600,0,33600,176600,0,210200
143137901400000,SW 420,RESIDENTIAL,35400,0,35400,177900,0,213300
143137901500000,SW 420,RESIDENTIAL,33600,0,33600,166600,0,200200
143137901600000,SW 420,RESIDENTIAL,34500,0,34500,183300,0,217800
143137901700000,SW 420,RESIDENTIAL,33600,0,33600,166700,0,200300
143137901800000,SW 420,RESIDENTIAL,35700,0,35700,152400,0,188100
143137901900000,SW 420,RESIDENTIAL,31600,0,31600,180600,0,212200
143137902000000,SW 420,RESIDENTIAL,32100,0,32100,144700,0,176800
143137902100000,SW 420,RESIDENTIAL,37300,0,37300,179000,0,216300
143137902200000,SW 420,RESIDENTIAL,37300,0,37300,151500,0,188800
143137902300000,SW 420,RESIDENTIAL,33600,0,33600,178300,0,211900
143137902400000,SW 420,RESIDENTIAL,35700,0,35700,176000,0,211700
143137902500000,SW 420,RESIDENTIAL,32100,0,32100,192600,0,224700
143137902600000,SW 420,RESIDENTIAL,33600,0,33600,140800,0,174400
143137902700000,SW 420,RESIDENTIAL,34700,0,34700,176700,0,211400
143137902800000,SW 420,RESIDENTIAL,35700,0,35700,186000,0,221700
143137902900000,SW 420,RESIDENTIAL,30600,0,30600,172500,0,203100
143137903000000,SW 420,RESIDENTIAL,35400,0,35400,182800,0,218200
143140100100000,SW 405,RESIDENTIAL,20300,0,20300,62700,0,83000
143140100200000,SW 405,RESIDENTIAL,32300,0,32300,42400,0,74700
143140100300000,SW 405,RESIDENTIAL,21400,0,21400,119900,0,141300
143140100400000,SW 405,RESIDENTIAL,21400,0,21400,41000,0,62400
143140100500000,SW 405,RESIDENTIAL,21400,0,21400,109500,0,130900
143140100600000,SW 405,RESIDENTIAL,21400,0,21400,48900,0,70300
143140100700000,SW 405,RESIDENTIAL,32000,0,32000,95300,0,127300
143140100800000,SW 405,RESIDENTIAL,32000,0,32000,76800,0,108800
143140100900000,SW 405,RESIDENTIAL,32000,0,32000,65500,0,97500
143140101000000,SW 405,RESIDENTIAL,31700,0,31700,74400,0,106100
143140101100000,SW 405,RESIDENTIAL,31700,0,31700,47200,0,78900
143140101200000,SW 405,RESIDENTIAL,28200,0,28200,84000,0,112200
143140101300000,SW 405,RESIDENTIAL,26500,0,26500,46500,0,73000
143140101400000,SW 405,RESIDENTIAL,29900,0,29900,81900,0,111800
143140101500000,SW 405,RESIDENTIAL,28200,0,28200,41400,0,69600
143140101600000,SW 405,RESIDENTIAL,28200,0,28200,112200,0,140400
143140101700000,SW 405,RESIDENTIAL,39500,0,39500,49800,0,89300
143140102000000,SW 405,AG DWELLING,5800,0,5800,148500,5500,159800
143140102100000,SW 405,RESIDENTIAL,46300,0,46300,96700,0,143000
143140102200000,SW 405,RESIDENTIAL,40000,0,40000,74200,0,114200
143140102300000,SW 405,RESIDENTIAL,2600,0,2600,0,0,2600
143140102400000,SW 405,RESIDENTIAL,53000,0,53000,153100,0,206100
143140102700000,SW 419,RESIDENTIAL,3900,0,3900,0,0,3900
143140102800000,SW 419,RESIDENTIAL,4400,0,4400,0,0,4400
143140102900000,SW 419,RESIDENTIAL,5600,0,5600,0,0,5600
143140103000000,SW 419,RESIDENTIAL,5900,0,5900,0,0,5900
143140103100000,SW 419,RESIDENTIAL,3400,0,3400,0,0,3400
143140103200000,SW 419,RESIDENTIAL,3700,0,3700,0,0,3700
143140103300000,SW 419,RESIDENTIAL,5800,0,5800,0,0,5800
143140103400000,SW 419,RESIDENTIAL,8800,0,8800,0,0,8800
143140103500000,SW 419,RESIDENTIAL,5900,0,5900,0,0,5900
143140103600000,SW 419,RESIDENTIAL,4200,0,4200,0,0,4200
143140103700000,SW 419,RESIDENTIAL,4100,0,4100,0,0,4100
143140103800000,SW 419,RESIDENTIAL,5600,0,5600,0,0,5600
143140103900000,SW 419,RESIDENTIAL,9200,0,9200,0,0,9200
143140104000000,SW 419,RESIDENTIAL,6300,0,6300,0,0,6300
143140104100000,SW 419,RESIDENTIAL,4400,0,4400,0,0,4400
143140104200000,SW 419,RESIDENTIAL,3600,0,3600,0,0,3600
143140104300000,SW 419,RESIDENTIAL,3600,0,3600,0,0,3600
143140104400000,SW 419,RESIDENTIAL,3600,0,3600,0,0,3600
143140104500000,SW 419,RESIDENTIAL,3600,0,3600,0,0,3600
143140104600000,SW 419,RESIDENTIAL,3600,0,3600,0,0,3600
143140104700000,SW 419,RESIDENTIAL,3600,0,3600,0,0,3600
143140104800000,SW 419,RESIDENTIAL,3600,0,3600,0,0,3600
143140104900000,SW 419,RESIDENTIAL,3600,0,3600,0,0,3600
143140105000000,SW 419,RESIDENTIAL,3600,0,3600,0,0,3600
143140105100000,SW 419,RESIDENTIAL,48000,0,48000,0,0,48000
143140200200000,SW 419,RESIDENTIAL,22600,0,22600,0,0,22600
143140300100000,SW 419,RESIDENTIAL,21000,0,21000,0,0,21000
143140300200000,SW 419,RESIDENTIAL,61000,0,61000,0,0,61000
143142600100000,SW 420,RESIDENTIAL,33100,0,33100,116600,0,149700
143142600200000,SW 420,RESIDENTIAL,29400,0,29400,97400,0,126800
143142600300000,SW 420,RESIDENTIAL,25800,0,25800,101500,0,127300
143142600400000,SW 420,RESIDENTIAL,30700,0,30700,88600,0,119300
143142600500000,SW 420,RESIDENTIAL,33400,0,33400,97300,0,130700
143142600600000,SW 420,RESIDENTIAL,33400,0,33400,93900,0,127300
143142600700000,SW 420,RESIDENTIAL,33400,0,33400,90200,0,123600
143142600800000,SW 420,RESIDENTIAL,33400,0,33400,87700,0,121100
143142600900000,SW 420,RESIDENTIAL,33400,0,33400,101600,0,135000
143142601000000,SW 420,RESIDENTIAL,33400,0,33400,95400,0,128800
143142601100000,SW 420,RESIDENTIAL,33400,0,33400,86000,0,119400
143142601200000,SW 420,RESIDENTIAL,33400,0,33400,94900,0,128300
143142601300000,SW 420,RESIDENTIAL,33400,0,33400,90400,0,123800
143142601400000,SW 420,RESIDENTIAL,33400,0,33400,102500,0,135900
143142601500000,SW 420,RESIDENTIAL,33400,0,33400,99600,0,133000
143142700100000,SW 420,RESIDENTIAL,26900,0,26900,111800,0,138700
143142700200000,SMALL RETAIL,COMMERCIAL,0,115900,115900,0,98700,214600
143142700300000,SW 420,AG DWELLING,6800,0,6800,9200,9900,25900
143142700400000,SW 420,RESIDENTIAL,26000,0,26000,90100,0,116100
143142700500000,SW 420,RESIDENTIAL,24200,0,24200,95000,0,119200
143142700600000,SW 420,RESIDENTIAL,24200,0,24200,76800,0,101000
143142700700000,SW 420,RESIDENTIAL,24200,0,24200,85400,0,109600
143142700800000,SW 420,RESIDENTIAL,24200,0,24200,88700,0,112900
143142700900000,SW 420,RESIDENTIAL,24200,0,24200,89500,0,113700
143142701000000,SW 420,RESIDENTIAL,24200,0,24200,102900,0,127100
143142701100000,SW 420,RESIDENTIAL,24200,0,24200,86600,0,110800
143142701200000,SW 420,RESIDENTIAL,24200,0,24200,103800,0,128000
143142701300000,SW 420,RESIDENTIAL,24200,0,24200,102000,0,126200
143142701400000,SW 420,RESIDENTIAL,25900,0,25900,131700,0,157600
143142701500000,SW 420,RESIDENTIAL,25900,0,25900,97700,0,123600
143142701600000,SW 420,RESIDENTIAL,25900,0,25900,105100,0,131000
143142701700000,SW 420,RESIDENTIAL,25900,0,25900,68600,0,94500
143142701800000,SW 420,RESIDENTIAL,25900,0,25900,98700,0,124600
143142701900000,SW 420,RESIDENTIAL,25900,0,25900,77800,0,103700
143142702000000,SW 420,RESIDENTIAL,25900,0,25900,85500,0,111400
143142702100000,SW 420,RESIDENTIAL,25900,0,25900,91100,0,117000
143142702200000,SW 420,RESIDENTIAL,25900,0,25900,139600,0,165500
143142702300000,SW 420,RESIDENTIAL,26200,0,26200,110800,0,137000
143142702400000,SW 420,RESIDENTIAL,34100,0,34100,97500,0,131600
143142702500000,SW 420,RESIDENTIAL,34100,0,34100,83000,0,117100
143142702600000,SW 420,RESIDENTIAL,34100,0,34100,94000,0,128100
143142702700000,SW 420,RESIDENTIAL,34100,0,34100,107100,0,141200
143142702800000,SW 420,RESIDENTIAL,33800,0,33800,108400,0,142200
143142702900000,SW 420,RESIDENTIAL,33800,0,33800,108400,0,142200
143142703000000,SW 420,RESIDENTIAL,33800,0,33800,99300,0,133100
143142703100000,SW 420,RESIDENTIAL,33600,0,33600,96400,0,130000
143142703200000,SW 420,RESIDENTIAL,33600,0,33600,14100,0,47700
143142703300000,SW 420,RESIDENTIAL,31500,0,31500,0,0,31500
143142703400000,SW 420,RESIDENTIAL,31500,0,31500,110100,0,141600
143142703500000,SW 420,RESIDENTIAL,33400,0,33400,120900,0,154300
143142703600000,SW 420,RESIDENTIAL,30000,0,30000,112900,0,142900
143142703700000,SW 420,RESIDENTIAL,26200,0,26200,105100,0,131300
143142800100000,SW 420,RESIDENTIAL,29000,0,29000,91800,0,120800
143142800200000,SW 420,RESIDENTIAL,26900,0,26900,72900,0,99800
143142800300000,SW 420,RESIDENTIAL,30100,0,30100,137100,0,167200
143142800400000,SW 420,RESIDENTIAL,30300,0,30300,0,0,30300
143142800500000,SW 420,RESIDENTIAL,33800,0,33800,94900,0,128700
143142800600000,SW 420,RESIDENTIAL,34100,0,34100,114800,0,148900
143142800700000,SW 420,RESIDENTIAL,33600,0,33600,107800,0,141400
143142800800000,SW 420,RESIDENTIAL,33600,0,33600,98800,0,132400
143142800900000,SW 420,RESIDENTIAL,34100,0,34100,111700,0,145800
143142801000000,SW 420,RESIDENTIAL,34100,0,34100,131500,0,165600
143142801100000,SW 420,RESIDENTIAL,34100,0,34100,131400,0,165500
143142801200000,SW 420,RESIDENTIAL,53900,0,53900,0,0,53900
143142801300000,SW 420,RESIDENTIAL,27000,0,27000,105700,0,132700
143142801400000,SW 420,RESIDENTIAL,24600,0,24600,114200,0,138800
143142801500000,SW 420,RESIDENTIAL,24600,0,24600,106800,0,131400
143142801600000,SW 420,RESIDENTIAL,24600,0,24600,98900,0,123500
143142801700000,SW 420,RESIDENTIAL,24600,0,24600,91000,0,115600
143142801800000,SW 420,RESIDENTIAL,26400,0,26400,106600,0,133000
143142801900000,SW 420,RESIDENTIAL,28300,0,28300,99500,0,127800
143142802000000,SW 420,RESIDENTIAL,27300,0,27300,103800,0,131100
143142802100000,SW 420,RESIDENTIAL,25900,0,25900,100400,0,126300
143142802200000,SW 420,RESIDENTIAL,26900,0,26900,111500,0,138400
143142802300000,SW 420,RESIDENTIAL,24200,0,24200,74000,0,98200
143142802400000,SW 420,RESIDENTIAL,24200,0,24200,71100,0,95300
143142802500000,SW 420,RESIDENTIAL,24200,0,24200,90800,0,115000
143142802600000,SW 420,RESIDENTIAL,24200,0,24200,84700,0,108900
143142802700000,SW 420,RESIDENTIAL,24200,0,24200,92400,0,116600
143142802800000,SW 420,RESIDENTIAL,24200,0,24200,119100,0,143300
143142802900000,SW 420,RESIDENTIAL,24200,0,24200,82500,0,106700
143142803000000,SW 420,RESIDENTIAL,24200,0,24200,75800,0,100000
143142900100000,SW 420,RESIDENTIAL,32400,0,32400,100200,0,132600
143142900200000,SW 420,RESIDENTIAL,30200,0,30200,98600,0,128800
143142900300000,SW 420,RESIDENTIAL,32600,0,32600,111600,0,144200
143142900400000,SW 420,RESIDENTIAL,32300,0,32300,99700,0,132000
143142900500000,SW 420,RESIDENTIAL,32300,0,32300,106400,0,138700
143142900600000,SW 420,RESIDENTIAL,32300,0,32300,110900,0,143200
143142900700000,SW 420,RESIDENTIAL,33600,0,33600,128200,0,161800
143143000100000,SW 420,RESIDENTIAL,24500,0,24500,0,0,24500
143145100100000,SW 420,AG LAND,66600,0,66600,0,0,66600
143145100200000,SW 405,AG DWELLING,23500,0,23500,58200,0,81700
143145100300000,SW 405,RESIDENTIAL,32500,0,32500,29900,0,62400
143145100400000,SW 405,AG LAND,9200,0,9200,0,0,9200
143147600100000,SW 405,AG LAND,39100,0,39100,0,9300,48400
143147600200000,SW 405,AG DWELLING,1300,0,1300,95100,0,96400
143147600400000,SW 405,AG DWELLING,26200,0,26200,98800,13000,138000
143147600500000,SW 405,AG DWELLING,3200,0,3200,76000,0,79200
143147600600000,SW 405,AG DWELLING,26000,0,26000,98100,0,124100
143210100100000,RESTAURANT,COMMERCIAL,0,28600,28600,0,78300,106900
143210100200000,FLAT PARKING,COMMERCIAL,0,25000,25000,0,3800,28800
143210100300000,SW 404,RESIDENTIAL,16000,0,16000,51800,0,67800
143210100400000,SW 404,RESIDENTIAL,15000,0,15000,64300,0,79300
143210100500000,SW 404,RESIDENTIAL,15000,0,15000,41200,0,56200
143210100600000,SW 404,RESIDENTIAL,15000,0,15000,59000,0,74000
143210100700000,SW 404,RESIDENTIAL,15000,0,15000,69300,0,84300
143210100800000,SW 404,RESIDENTIAL,15000,0,15000,42200,0,57200
143210100900000,SW 404,RESIDENTIAL,15000,0,15000,55200,0,70200
143210101000000,SW 404,RESIDENTIAL,15000,0,15000,51100,0,66100
143210101100000,SW 404,RESIDENTIAL,15000,0,15000,50400,0,65400
143210101200000,SW 404,RESIDENTIAL,15000,0,15000,65200,0,80200
143210101300000,SW 404,RESIDENTIAL,15000,0,15000,66000,0,81000
143210101400000,SW 404,RESIDENTIAL,15000,0,15000,53400,0,68400
143210101500000,SW 404,RESIDENTIAL,15000,0,15000,58800,0,73800
143210101600000,SW 404,RESIDENTIAL,15000,0,15000,72800,0,87800
143210200500000,SW 404,RESIDENTIAL,15000,0,15000,79400,0,94400
143210200600000,APARTMENT,MULTI-RES,23500,0,23500,212500,0,236000
143210200700000,APARTMENT,RESIDENTIAL,52600,0,52600,679400,0,732000
143210300100000,SW 404,RESIDENTIAL,17100,0,17100,42000,0,59100
143210300200000,SW 404,RESIDENTIAL,15000,0,15000,52600,0,67600
143210300300000,SW 404,RESIDENTIAL,17100,0,17100,79600,0,96700
143210300400000,SW 404,RESIDENTIAL,17100,0,17100,0,0,17100
143210400100000,LG DISCOUNT/RETAIL,COMMERCIAL,0,498300,498300,0,1392100,1890400
143210400600000,SW 404,RESIDENTIAL,18000,0,18000,64100,0,82100
143210400700000,SW 404,RESIDENTIAL,18000,0,18000,58900,0,76900
143210400800000,SW 404,RESIDENTIAL,15000,0,15000,54000,0,69000
143210400900000,SW 404,RESIDENTIAL,15000,0,15000,36200,0,51200
143210401000000,SW 404,RESIDENTIAL,15000,0,15000,50500,0,65500
143210401100000,SW 404,RESIDENTIAL,15700,0,15700,52500,0,68200
143210401200000,SW 404,RESIDENTIAL,19100,0,19100,82400,0,101500
143210401300000,SW 404,RESIDENTIAL,17600,0,17600,44700,0,62300
143210401400000,SW 404,RESIDENTIAL,17800,0,17800,73100,0,90900
143210401500000,SW 404,RESIDENTIAL,15000,0,15000,29500,0,44500
143210401600000,APARTMENT,MULTI-RES,33600,0,33600,291700,0,325300
143210401700000,SW 404,RESIDENTIAL,15000,0,15000,63200,0,78200
143210401800000,CONVERSION-NW/SW,MULTI-RES,15000,0,15000,60800,0,75800
143210500100000,SW 404,RESIDENTIAL,15900,0,15900,71800,0,87700
143210500200000,SW 404,RESIDENTIAL,15800,0,15800,64300,0,80100
143210500300000,SW 404,RESIDENTIAL,16900,0,16900,79900,0,96800
143210500400000,SW 404,RESIDENTIAL,16900,0,16900,76200,0,93100
143210500500000,SW 404,RESIDENTIAL,15800,0,15800,63000,0,78800
143210500600000,SW 404,RESIDENTIAL,14900,0,14900,59400,0,74300
143210500700000,SW 404,RESIDENTIAL,14400,0,14400,66500,0,80900
143210500800000,SW 404,RESIDENTIAL,14400,0,14400,60400,0,74800
143210500900000,SW 404,RESIDENTIAL,19300,0,19300,93900,0,113200
143210501000000,SW 404,RESIDENTIAL,16900,0,16900,56900,0,73800
143210501100000,SW 404,RESIDENTIAL,16900,0,16900,77300,0,94200
143210501200000,SW 404,RESIDENTIAL,15800,0,15800,80400,0,96200
143210501300000,SW 404,RESIDENTIAL,15000,0,15000,75200,0,90200
143210501400000,SW 404,RESIDENTIAL,14600,0,14600,75100,0,89700
143210501500000,SW 404,RESIDENTIAL,14400,0,14400,66200,0,80600
143210600100000,SW 404,RESIDENTIAL,7400,0,7400,0,0,7400
143210600200000,SW 404,RESIDENTIAL,18000,0,18000,79200,0,97200
143210600300000,SW 404,RESIDENTIAL,15000,0,15000,53100,0,68100
143210600400000,SW 404,RESIDENTIAL,14800,0,14800,51400,0,66200
143210600500000,SW 404,RESIDENTIAL,17800,0,17800,53000,0,70800
143210600600000,SW 404,RESIDENTIAL,14700,0,14700,134700,0,149400
143210600700000,SW 404,RESIDENTIAL,7400,0,7400,4900,0,12300
143210700300000,FLAT PARKING,COMMERCIAL,0,20800,20800,0,3000,23800
143210700400000,SW 404,RESIDENTIAL,15000,0,15000,52900,0,67900
143210700500000,SW 404,RESIDENTIAL,15000,0,15000,35000,0,50000
143210700600000,SW 404,RESIDENTIAL,15000,0,15000,59500,0,74500
143210700700000,SW 404,RESIDENTIAL,15000,0,15000,51200,0,66200
143210700800000,SW 404,RESIDENTIAL,15000,0,15000,69200,0,84200
143210700900000,SW 404,RESIDENTIAL,15000,0,15000,48800,0,63800
143210701000000,SW 404,RESIDENTIAL,15000,0,15000,0,0,15000
143210701100000,SW 404,RESIDENTIAL,15000,0,15000,60400,0,75400
143210701200000,SW 404,RESIDENTIAL,11400,0,11400,79600,0,91000
143210701300000,SW 404,RESIDENTIAL,10100,0,10100,86100,0,96200
143210701400000,SW 404,RESIDENTIAL,20400,0,20400,70600,0,91000
143210701500000,SW 404,RESIDENTIAL,19100,0,19100,54400,0,73500
143210701600000,SW 404,RESIDENTIAL,21000,0,21000,103500,0,124500
143210701700000,SW 404,RESIDENTIAL,17000,0,17000,75100,0,92100
143210701800000,SW 404,RESIDENTIAL,17000,0,17000,40100,0,57100
143210701900000,SW 404,RESIDENTIAL,17000,0,17000,49700,0,66700
143210702000000,SW 404,RESIDENTIAL,17000,0,17000,57500,0,74500
143210702100000,SW 404,RESIDENTIAL,17000,0,17000,54700,0,71700
143210702200000,SW 404,RESIDENTIAL,17000,0,17000,41900,0,58900
143210702300000,FLAT PARKING,COMMERCIAL,0,40300,40300,0,12600,52900
143210702600000,FLAT PARKING,COMMERCIAL,0,38300,38300,0,4800,43100
143210702700000,AUTO REPAIR/SALES,COMMERCIAL,0,88900,88900,0,128300,217200
143210702800000,BARS/LOUNGE,COMMERCIAL,0,44400,44400,0,111700,156100
143210702900000,SW 401,RESIDENTIAL,10500,0,10500,34000,0,44500
143210800100000,SW 404,RESIDENTIAL,15700,0,15700,75400,0,91100
143210800200000,SW 404,RESIDENTIAL,15000,0,15000,61400,0,76400
143210800300000,SW 404,RESIDENTIAL,18000,0,18000,66900,0,84900
143210800500000,SW 404,RESIDENTIAL,15000,0,15000,40000,0,55000
143210800600000,SW 404,RESIDENTIAL,15000,0,15000,35500,0,50500
143210800700000,SW 404,RESIDENTIAL,15000,0,15000,0,0,15000
143210800800000,SW 404,RESIDENTIAL,15000,0,15000,76000,0,91000
143210800900000,SW 404,RESIDENTIAL,8300,0,8300,39900,0,48200
143210801000000,SW 404,RESIDENTIAL,7800,0,7800,39400,0,47200
143210801300000,SW 404,RESIDENTIAL,17000,0,17000,48200,0,65200
143210801400000,SW 404,RESIDENTIAL,17000,0,17000,48800,0,65800
143210801500000,SW 404,RESIDENTIAL,17000,0,17000,98000,0,115000
143210801600000,SW 404,RESIDENTIAL,17000,0,17000,36400,0,53400
143210801700000,SW 404,RESIDENTIAL,17000,0,17000,80600,0,97600
143210801800000,SW 404,RESIDENTIAL,17800,0,17800,33700,0,51500
143210801900000,APARTMENT,MULTI-RES,16300,0,16300,105200,0,121500
143210900300000,CHURCH,EXEMPT,0,255000,255000,0,265700,520700
143211000100000,RESTAURANT,COMMERCIAL,0,100800,100800,0,129400,230200
143211000200000,SW 404,RESIDENTIAL,17000,0,17000,27300,0,44300
143211000300000,SW 404,RESIDENTIAL,17000,0,17000,55200,0,72200
143211000400000,SW 404,RESIDENTIAL,17000,0,17000,45500,0,62500
143211000500000,SW 404,RESIDENTIAL,20400,0,20400,43400,0,63800
143211000600000,SW 404,RESIDENTIAL,20400,0,20400,70600,0,91000
143211000700000,SW 404,RESIDENTIAL,17000,0,17000,66000,0,83000
143211000800000,SW 404,RESIDENTIAL,17000,0,17000,68600,0,85600
143211000900000,SW 404,RESIDENTIAL,20400,0,20400,78800,0,99200
143211001000000,SW 404,RESIDENTIAL,20400,0,20400,59300,0,79700
143211001100000,SW 404,RESIDENTIAL,17000,0,17000,74100,0,91100
143211001200000,SW 404,RESIDENTIAL,17000,0,17000,57100,0,74100
143211001300000,SW 404,RESIDENTIAL,17000,0,17000,75100,0,92100
143211001400000,SW 404,RESIDENTIAL,17000,0,17000,63000,0,80000
143211001500000,SW 404,RESIDENTIAL,17000,0,17000,50800,0,67800
143211001600000,SW 404,RESIDENTIAL,17000,0,17000,91900,0,108900
143211001700000,SW 404,RESIDENTIAL,17000,0,17000,90100,0,107100
143211001800000,SW 404,RESIDENTIAL,17000,0,17000,0,0,17000
143211001900000,SW 404,RESIDENTIAL,17000,0,17000,45700,0,62700
143211002000000,SW 404,RESIDENTIAL,17000,0,17000,60900,0,77900
143211002100000,SW 404,RESIDENTIAL,17000,0,17000,63100,0,80100
143211002200000,SW 404,RESIDENTIAL,17000,0,17000,60800,0,77800
143211002300000,AUTO REPAIR/SALES,COMMERCIAL,0,100800,100800,0,65500,166300
143211100100000,FLAT PARKING,EXEMPT,0,51800,51800,0,4300,56100
143211100200000,SW 404,EXEMPT,0,34000,34000,0,90000,124000
143211100300000,CHURCH,EXEMPT,0,50400,50400,0,353300,403700
143211100400000,SW 404,RESIDENTIAL,14200,0,14200,56000,0,70200
143211100500000,SW 404,RESIDENTIAL,20200,0,20200,72000,0,92200
143211100600000,SW 404,RESIDENTIAL,17000,0,17000,72000,0,89000
143211100700000,SW 404,RESIDENTIAL,20400,0,20400,114200,0,134600
143211100800000,SW 404,RESIDENTIAL,20400,0,20400,107500,0,127900
143211100900000,SW 404,RESIDENTIAL,17000,0,17000,82600,0,99600
143211101000000,SW 404,RESIDENTIAL,17800,0,17800,76600,0,94400
143211200100000,SW 404,RESIDENTIAL,18100,0,18100,65400,0,83500
143211200200000,SW 404,RESIDENTIAL,20400,0,20400,81300,0,101700
143211200300000,SW 404,RESIDENTIAL,20400,0,20400,103000,0,123400
143211200400000,SW 404,RESIDENTIAL,17000,0,17000,67100,0,84100
143211200500000,SW 404,RESIDENTIAL,18600,0,18600,58000,0,76600
143211200600000,SW 404,RESIDENTIAL,15500,0,15500,44000,0,59500
143211200700000,SW 404,RESIDENTIAL,18100,0,18100,70500,0,88600
143212600100000,SW 404,RESIDENTIAL,15000,0,15000,51000,0,66000
143212600200000,SW 404,RESIDENTIAL,15000,0,15000,77200,0,92200
143212600300000,SW 404,RESIDENTIAL,15000,0,15000,51400,0,66400
143212600400000,SW 404,RESIDENTIAL,15000,0,15000,50200,0,65200
143212600500000,SW 404,RESIDENTIAL,15000,0,15000,62500,0,77500
143212600600000,SW 404,RESIDENTIAL,27000,0,27000,67500,0,94500
143212600700000,SW 404,RESIDENTIAL,19500,0,19500,78900,0,98400
143212700100000,SW 404,RESIDENTIAL,16600,0,16600,49800,0,66400
143212700200000,SW 404,RESIDENTIAL,10500,0,10500,39600,0,50100
143212700300000,SW 404,RESIDENTIAL,15000,0,15000,43000,0,58000
143212700400000,SW 404,RESIDENTIAL,15000,0,15000,64100,0,79100
143212700500000,SW 404,RESIDENTIAL,15000,0,15000,42900,0,57900
143212700600000,SW 404,RESIDENTIAL,15000,0,15000,15300,0,30300
143212700700000,SW 404,RESIDENTIAL,15000,0,15000,81500,0,96500
143212700800000,SW 404,RESIDENTIAL,15000,0,15000,41100,0,56100
143212700900000,VACANT LAND,COMMERCIAL,0,15100,15100,0,0,15100
143212701000000,VACANT LAND,COMMERCIAL,0,15100,15100,0,0,15100
143212701100000,SW 404,RESIDENTIAL,15000,0,15000,102100,0,117100
143212701200000,SW 404,RESIDENTIAL,15000,0,15000,82500,0,97500
143212701300000,SW 404,RESIDENTIAL,15000,0,15000,76600,0,91600
143212800200000,SERVICE STATION,COMMERCIAL,0,41500,41500,0,35400,76900
143212800300000,CENTRALLY ASSESSED,OTHER,0,0,0,0,0,0
143212900100000,SW 404,RESIDENTIAL,18000,0,18000,72500,0,90500
143212900200000,SW 404,RESIDENTIAL,15000,0,15000,51600,0,66600
143212900300000,SW 404,RESIDENTIAL,15000,0,15000,43500,0,58500
143212900400000,SW 404,RESIDENTIAL,15000,0,15000,48200,0,63200
143212900500000,SW 404,RESIDENTIAL,15000,0,15000,78600,0,93600
143212900800000,SW 404,RESIDENTIAL,15000,0,15000,59400,0,74400
143212900900000,SW 404,RESIDENTIAL,15000,0,15000,41700,0,56700
143212901000000,SW 404,RESIDENTIAL,15000,0,15000,42000,0,57000
143212901100000,SW 404,RESIDENTIAL,15000,0,15000,41400,0,56400
143212901200000,SW 404,RESIDENTIAL,15000,0,15000,19600,0,34600
143212901300000,SW 404,RESIDENTIAL,15000,0,15000,30200,0,45200
143212901400000,SW 404,RESIDENTIAL,15000,0,15000,39000,0,54000
143212901500000,SW 404,RESIDENTIAL,15000,0,15000,76500,0,91500
143212901600000,SW 404,RESIDENTIAL,9000,0,9000,0,0,9000
143212901700000,SW 404,RESIDENTIAL,9000,0,9000,70900,0,79900
143212901800000,SW 404,RESIDENTIAL,15000,0,15000,62100,0,77100
143212901900000,SW 404,RESIDENTIAL,18000,0,18000,103800,0,121800
143213000100000,SW 404,RESIDENTIAL,15000,0,15000,70800,0,85800
143213000200000,SW 404,RESIDENTIAL,15000,0,15000,84600,0,99600
143213000300000,SW 404,RESIDENTIAL,9000,0,9000,63800,0,72800
143213000400000,SW 404,RESIDENTIAL,9000,0,9000,0,0,9000
143213000500000,SW 404,RESIDENTIAL,15000,0,15000,68200,0,83200
143213000600000,SW 404,RESIDENTIAL,18000,0,18000,37900,0,55900
143213000700000,SW 404,RESIDENTIAL,18000,0,18000,43200,0,61200
143213000800000,SW 404,RESIDENTIAL,15000,0,15000,0,0,15000
143213000900000,SW 404,RESIDENTIAL,15000,0,15000,40400,0,55400
143213001000000,SW 404,RESIDENTIAL,15000,0,15000,13500,0,28500
143213001100000,SW 404,RESIDENTIAL,15000,0,15000,24800,0,39800
143213001200000,SW 404,RESIDENTIAL,15000,0,15000,54100,0,69100
143213001300000,SW 404,RESIDENTIAL,15000,0,15000,49800,0,64800
143213001400000,SW 404,RESIDENTIAL,15000,0,15000,53300,0,68300
143213001500000,VACANT LAND,COMMERCIAL,0,16800,16800,0,0,16800
143213001600000,SW 404,RESIDENTIAL,18000,0,18000,91100,0,109100
143213001700000,SW 404,RESIDENTIAL,15000,0,15000,61000,0,76000
143213001800000,SW 404,RESIDENTIAL,18000,0,18000,68500,0,86500
143213001900000,SW 404,RESIDENTIAL,18000,0,18000,70300,0,88300
143213002000000,SW 404,RESIDENTIAL,15000,0,15000,27100,0,42100
143213002100000,SW 404,RESIDENTIAL,15000,0,15000,35400,0,50400
143213002200000,SW 404,RESIDENTIAL,17700,0,17700,55800,0,73500
143213100100000,VACANT LAND,COMMERCIAL,0,6900,6900,0,0,6900
143213100200000,SMALL RETAIL,COMMERCIAL,0,142000,142000,0,468500,610500
143213100300000,VACANT LAND,COMMERCIAL,0,12000,12000,0,0,12000
143213200100000,SW 404,RESIDENTIAL,15000,0,15000,29000,0,44000
143213200200000,SW 404,RESIDENTIAL,15000,0,15000,0,0,15000
143213200300000,SW 404,RESIDENTIAL,15000,0,15000,46700,0,61700
143213200400000,SW 404,RESIDENTIAL,15000,0,15000,57600,0,72600
143213200500000,SW 404,RESIDENTIAL,15000,0,15000,68400,0,83400
143213200600000,SW 404,RESIDENTIAL,15000,0,15000,0,0,15000
143213200700000,SW 404,RESIDENTIAL,15000,0,15000,52400,0,67400
143213200800000,SW 404,RESIDENTIAL,15000,0,15000,73200,0,88200
143213200900000,SW 404,RESIDENTIAL,17000,0,17000,78800,0,95800
143213201000000,SW 404,RESIDENTIAL,17000,0,17000,67500,0,84500
143213201100000,SW 404,RESIDENTIAL,17000,0,17000,62600,0,79600
143213201200000,SW 404,RESIDENTIAL,17000,0,17000,68300,0,85300
143213201300000,SW 404,RESIDENTIAL,17000,0,17000,41300,0,58300
143213300100000,SW 404,RESIDENTIAL,15000,0,15000,65500,0,80500
143213300200000,SW 404,RESIDENTIAL,15000,0,15000,50200,0,65200
143213300300000,SW 404,RESIDENTIAL,15000,0,15000,49900,0,64900
143213300400000,SW 404,RESIDENTIAL,15000,0,15000,34800,0,49800
143213300500000,SW 404,RESIDENTIAL,15000,0,15000,55600,0,70600
143213300600000,SW 404,RESIDENTIAL,15000,0,15000,68000,0,83000
143213300700000,SW 404,RESIDENTIAL,15000,0,15000,81700,0,96700
143213300800000,SW 404,RESIDENTIAL,15000,0,15000,53700,0,68700
143213300900000,WAREHOUSE;MINI STORG,COMMERCIAL,0,104000,104000,0,182100,286100
143213301000000,SW 404,RESIDENTIAL,17000,0,17000,10300,0,27300
143213301100000,SW 404,RESIDENTIAL,17000,0,17000,76800,0,93800
143213301200000,SW 404,RESIDENTIAL,17000,0,17000,87200,0,104200
143213301300000,SW 404,RESIDENTIAL,17000,0,17000,52900,0,69900
143213301400000,SW 404,RESIDENTIAL,17000,0,17000,41900,0,58900
143213301500000,SW 404,RESIDENTIAL,17000,0,17000,74800,0,91800
143213301600000,SW 404,RESIDENTIAL,17000,0,17000,40700,0,57700
143213301700000,SW 404,RESIDENTIAL,17000,0,17000,33500,0,50500
143213301800000,SW 404,RESIDENTIAL,17000,0,17000,47700,0,64700
143213301900000,SW 404,RESIDENTIAL,20400,0,20400,67400,0,87800
143213302000000,SW 404,RESIDENTIAL,17000,0,17000,50900,0,67900
143213302100000,SW 404,RESIDENTIAL,17000,0,17000,37800,0,54800
143213400100000,SW 404,RESIDENTIAL,17000,0,17000,41800,0,58800
143213400200000,SW 404,RESIDENTIAL,25500,0,25500,72600,0,98100
143213400300000,SW 404,RESIDENTIAL,17000,0,17000,50900,0,67900
143213400400000,SW 404,RESIDENTIAL,19500,0,19500,44400,0,63900
143213400500000,SW 404,RESIDENTIAL,19500,0,19500,82500,0,102000
143213400600000,SW 404,RESIDENTIAL,17000,0,17000,20300,0,37300
143213400700000,SW 404,RESIDENTIAL,17000,0,17000,20300,0,37300
143213400800000,SW 404,RESIDENTIAL,19700,0,19700,75300,0,95000
143213400900000,SW 404,RESIDENTIAL,21100,0,21100,78900,0,100000
143213500100000,SW 404,RESIDENTIAL,17000,0,17000,39900,0,56900
143213500200000,SW 404,RESIDENTIAL,17200,0,17200,80900,0,98100
143213500300000,SW 404,RESIDENTIAL,14900,0,14900,48800,0,63700
143213500400000,SW 404,RESIDENTIAL,20400,0,20400,69000,0,89400
143213500500000,SW 404,RESIDENTIAL,20400,0,20400,116300,0,136700
143213500600000,SW 404,RESIDENTIAL,17000,0,17000,56800,0,73800
143213500700000,SW 404,RESIDENTIAL,17000,0,17000,62300,0,79300
143213500800000,SW 404,RESIDENTIAL,17000,0,17000,80300,0,97300
143213500900000,SW 404,RESIDENTIAL,15000,0,15000,46100,0,61100
143213501000000,SW 404,RESIDENTIAL,11900,0,11900,61900,0,73800
143213501100000,SW 404,RESIDENTIAL,15500,0,15500,53900,0,69400
143213501200000,SW 404,RESIDENTIAL,17000,0,17000,51800,0,68800
143213501300000,SW 404,RESIDENTIAL,17000,0,17000,43900,0,60900
143213501400000,SW 404,RESIDENTIAL,17000,0,17000,57500,0,74500
143213501500000,SW 404,RESIDENTIAL,17000,0,17000,48500,0,65500
143213501600000,SW 404,RESIDENTIAL,17000,0,17000,59700,0,76700
143213501700000,SW 404,RESIDENTIAL,17000,0,17000,78500,0,95500
143213501800000,SW 404,RESIDENTIAL,17000,0,17000,54100,0,71100
143213600100000,SW 404,RESIDENTIAL,20400,0,20400,43900,0,64300
143213600200000,SW 404,RESIDENTIAL,17000,0,17000,123800,0,140800
143213600300000,SW 404,RESIDENTIAL,17000,0,17000,69700,0,86700
143213600400000,SW 404,RESIDENTIAL,17000,0,17000,59100,0,76100
143213600500000,SW 404,RESIDENTIAL,17000,0,17000,61700,0,78700
143213600600000,SW 404,RESIDENTIAL,17200,0,17200,79600,0,96800
143213600700000,SW 404,RESIDENTIAL,19100,0,19100,91900,0,111000
143213600800000,SW 404,RESIDENTIAL,17000,0,17000,54100,0,71100
143213600900000,SW 404,RESIDENTIAL,17000,0,17000,56900,0,73900
143213601000000,SW 404,RESIDENTIAL,17000,0,17000,62500,0,79500
143213601100000,SW 404,RESIDENTIAL,17000,0,17000,53900,0,70900
143213601200000,SW 404,RESIDENTIAL,17000,0,17000,63100,0,80100
143213601300000,SW 404,RESIDENTIAL,17000,0,17000,54700,0,71700
143213601400000,SW 404,RESIDENTIAL,17000,0,17000,54700,0,71700
143213601500000,SW 404,RESIDENTIAL,17000,0,17000,95000,0,112000
143213601600000,SW 404,RESIDENTIAL,17000,0,17000,11700,0,28700
143213601700000,SW 404,RESIDENTIAL,17000,0,17000,53300,0,70300
143213601800000,SW 404,RESIDENTIAL,17000,0,17000,46700,0,63700
143213601900000,SW 404,RESIDENTIAL,17000,0,17000,51900,0,68900
143213602000000,SW 404,RESIDENTIAL,17000,0,17000,47900,0,64900
143213602100000,SW 404,RESIDENTIAL,17000,0,17000,45200,0,62200
143213602200000,SW 404,RESIDENTIAL,20400,0,20400,44100,0,64500
143213602300000,SW 404,RESIDENTIAL,17000,0,17000,87200,0,104200
143213700100000,SW 404,RESIDENTIAL,17000,0,17000,59400,0,76400
143213700200000,SW 404,RESIDENTIAL,17000,0,17000,31200,0,48200
143213700300000,SW 404,RESIDENTIAL,17000,0,17000,75300,0,92300
143213700400000,SW 404,RESIDENTIAL,17000,0,17000,43400,0,60400
143213700500000,SW 404,RESIDENTIAL,17000,0,17000,83200,0,100200
143213700600000,SW 404,RESIDENTIAL,19500,0,19500,48200,0,67700
143213700700000,SW 404,RESIDENTIAL,19500,0,19500,63700,0,83200
143213700800000,SW 404,RESIDENTIAL,17000,0,17000,92100,0,109100
143213700900000,SW 404,RESIDENTIAL,17000,0,17000,36000,0,53000
143213701000000,SW 404,RESIDENTIAL,17000,0,17000,54400,0,71400
143213701100000,SW 404,RESIDENTIAL,17000,0,17000,56700,0,73700
143213701200000,SW 404,RESIDENTIAL,17000,0,17000,47200,0,64200
143215100100000,SW 404,RESIDENTIAL,20400,0,20400,62900,0,83300
143215100200000,SW 404,RESIDENTIAL,20400,0,20400,83800,0,104200
143215100300000,SW 404,RESIDENTIAL,17000,0,17000,18500,0,35500
143215100400000,SW 404,RESIDENTIAL,17000,0,17000,21000,0,38000
143215100500000,SW 404,RESIDENTIAL,17000,0,17000,59800,0,76800
143215100600000,SW 404,RESIDENTIAL,17000,0,17000,48400,0,65400
143215100700000,SW 404,RESIDENTIAL,17000,0,17000,48400,0,65400
143215100800000,SW 404,RESIDENTIAL,17000,0,17000,61400,0,78400
143215100900000,SW 404,RESIDENTIAL,17000,0,17000,55300,0,72300
143215101000000,SW 404,RESIDENTIAL,17000,0,17000,66900,0,83900
143215101100000,SW 404,RESIDENTIAL,17000,0,17000,55300,0,72300
143215101200000,SW 404,RESIDENTIAL,17000,0,17000,51800,0,68800
143215101300000,SW 404,RESIDENTIAL,17000,0,17000,50700,0,67700
143215101400000,SW 404,RESIDENTIAL,17000,0,17000,45300,0,62300
143215101500000,SW 404,RESIDENTIAL,17000,0,17000,61000,0,78000
143215101600000,SW 404,RESIDENTIAL,20400,0,20400,77500,0,97900
143215101700000,SW 404,RESIDENTIAL,20400,0,20400,50100,0,70500
143215200100000,SW 404,RESIDENTIAL,17000,0,17000,23900,0,40900
143215200200000,SW 404,RESIDENTIAL,17000,0,17000,62400,0,79400
143215200300000,SW 404,RESIDENTIAL,17000,0,17000,63400,0,80400
143215200400000,SW 404,RESIDENTIAL,17000,0,17000,60500,0,77500
143215200500000,SW 404,RESIDENTIAL,17000,0,17000,40900,0,57900
143215200600000,SW 404,RESIDENTIAL,20400,0,20400,72100,0,92500
143215200700000,SW 404,RESIDENTIAL,17000,0,17000,41800,0,58800
143215200800000,SW 404,RESIDENTIAL,17000,0,17000,82500,0,99500
143215200900000,SW 404,RESIDENTIAL,17000,0,17000,40800,0,57800
143215201000000,SW 404,RESIDENTIAL,17000,0,17000,57800,0,74800
143215201100000,SW 404,RESIDENTIAL,17000,0,17000,61200,0,78200
143215201200000,SW 404,RESIDENTIAL,17000,0,17000,38300,0,55300
143215201300000,SW 404,RESIDENTIAL,17000,0,17000,75900,0,92900
143215201400000,SW 404,RESIDENTIAL,17000,0,17000,68400,0,85400
143215201500000,SW 404,RESIDENTIAL,17000,0,17000,73100,0,90100
143215201600000,SW 404,RESIDENTIAL,17000,0,17000,106500,0,123500
143215201700000,SW 404,RESIDENTIAL,17000,0,17000,118400,0,135400
143215201800000,SW 404,RESIDENTIAL,20400,0,20400,83700,0,104100
143215201900000,SW 404,RESIDENTIAL,17000,0,17000,75400,0,92400
143215202000000,SW 404,RESIDENTIAL,17000,0,17000,40800,0,57800
143215202100000,SW 404,RESIDENTIAL,17000,0,17000,20100,0,37100
143215202200000,SW 404,RESIDENTIAL,17000,0,17000,61500,0,78500
143215202300000,SW 404,RESIDENTIAL,20400,0,20400,15500,0,35900
143215300100000,SW 404,RESIDENTIAL,17000,0,17000,59700,0,76700
143215300200000,SW 404,RESIDENTIAL,17000,0,17000,50300,0,67300
143215300300000,SW 404,RESIDENTIAL,17000,0,17000,41100,0,58100
143215300400000,SW 404,RESIDENTIAL,17000,0,17000,42400,0,59400
143215300500000,SW 404,RESIDENTIAL,17000,0,17000,45600,0,62600
143215300600000,SW 404,RESIDENTIAL,19500,0,19500,67600,0,87100
143215300700000,SW 404,RESIDENTIAL,15800,0,15800,49600,0,65400
143215300800000,SW 404,RESIDENTIAL,17000,0,17000,28700,0,45700
143215300900000,SW 404,RESIDENTIAL,17000,0,17000,45600,0,62600
143215301000000,SW 404,RESIDENTIAL,17000,0,17000,45700,0,62700
143215301100000,SW 404,RESIDENTIAL,17000,0,17000,56200,0,73200
143215400100000,SW 404,RESIDENTIAL,20400,0,20400,54900,0,75300
143215400200000,SW 404,RESIDENTIAL,17000,0,17000,50000,0,67000
143215400300000,SW 404,RESIDENTIAL,20400,0,20400,61800,0,82200
143215400400000,SW 404,RESIDENTIAL,20400,0,20400,59500,0,79900
143215400500000,SW 404,RESIDENTIAL,17000,0,17000,49900,0,66900
143215400600000,SW 404,RESIDENTIAL,20400,0,20400,113200,0,133600
143215400700000,SW 404,RESIDENTIAL,20400,0,20400,103500,0,123900
143215400800000,SW 404,RESIDENTIAL,17000,0,17000,42600,0,59600
143215400900000,SW 404,RESIDENTIAL,17000,0,17000,102100,0,119100
143215401000000,SW 404,RESIDENTIAL,17000,0,17000,40700,0,57700
143215401100000,SW 404,RESIDENTIAL,20400,0,20400,87700,0,108100
143215401200000,SW 404,RESIDENTIAL,17000,0,17000,74400,0,91400
143215401300000,SW 404,RESIDENTIAL,17000,0,17000,65200,0,82200
143215401400000,SW 404,RESIDENTIAL,20400,0,20400,65500,0,85900
143215500100000,SW 404,RESIDENTIAL,17000,0,17000,81000,0,98000
143215500200000,SW 404,RESIDENTIAL,20400,0,20400,0,0,20400
143215500300000,SW 404,RESIDENTIAL,20400,0,20400,86500,0,106900
143215500400000,SW 404,RESIDENTIAL,17000,0,17000,46200,0,63200
143215500500000,SW 404,RESIDENTIAL,17000,0,17000,85200,0,102200
143215500600000,SW 404,RESIDENTIAL,17000,0,17000,79100,0,96100
143215500700000,SW 404,RESIDENTIAL,17000,0,17000,51500,0,68500
143215500800000,SW 404,RESIDENTIAL,17000,0,17000,45500,0,62500
143215500900000,SW 404,RESIDENTIAL,17000,0,17000,52100,0,69100
143215501000000,SW 404,RESIDENTIAL,20400,0,20400,59100,0,79500
143215501100000,SW 404,RESIDENTIAL,25500,0,25500,84000,0,109500
143215501200000,SW 404,RESIDENTIAL,10200,0,10200,0,0,10200
143215501300000,SW 404,RESIDENTIAL,10200,0,10200,45000,0,55200
143215501400000,SW 404,RESIDENTIAL,20400,0,20400,44200,0,64600
143215501500000,SW 404,RESIDENTIAL,17000,0,17000,70500,0,87500
143215501600000,SW 404,RESIDENTIAL,20400,0,20400,42800,0,63200
143215501700000,SW 404,RESIDENTIAL,17000,0,17000,74500,0,91500
143215501800000,SW 404,RESIDENTIAL,17000,0,17000,56300,0,73300
143215501900000,SW 404,RESIDENTIAL,17000,0,17000,73100,0,90100
143215600100000,SW 404,RESIDENTIAL,17000,0,17000,37600,0,54600
143215600200000,SW 404,RESIDENTIAL,17000,0,17000,30800,0,47800
143215600300000,SW 404,RESIDENTIAL,20400,0,20400,44800,0,65200
143215600400000,SW 404,RESIDENTIAL,17000,0,17000,39800,0,56800
143215600500000,SW 404,RESIDENTIAL,19000,0,19000,78400,0,97400
143215600600000,SW 404,RESIDENTIAL,19600,0,19600,108000,0,127600
143215600700000,SW 404,RESIDENTIAL,20400,0,20400,15300,0,35700
143215600800000,SW 404,RESIDENTIAL,17000,0,17000,46700,0,63700
143215600900000,SW 404,RESIDENTIAL,17000,0,17000,51300,0,68300
143215601000000,SW 404,RESIDENTIAL,17000,0,17000,53100,0,70100
143215700100000,SW 404,RESIDENTIAL,20400,0,20400,51100,0,71500
143215700200000,SW 404,RESIDENTIAL,17000,0,17000,82700,0,99700
143215700300000,SW 404,RESIDENTIAL,17000,0,17000,51700,0,68700
143215700400000,SW 404,RESIDENTIAL,17000,0,17000,51900,0,68900
143215700500000,SW 404,RESIDENTIAL,17000,0,17000,28800,0,45800
143215700600000,SW 404,RESIDENTIAL,17000,0,17000,43900,0,60900
143215700700000,SW 404,RESIDENTIAL,17000,0,17000,61800,0,78800
143215700800000,SW 404,RESIDENTIAL,17000,0,17000,62400,0,79400
143215700900000,SW 404,RESIDENTIAL,15000,0,15000,44100,0,59100
143215701000000,SW 404,RESIDENTIAL,22500,0,22500,58900,0,81400
143215701100000,SW 404,RESIDENTIAL,15000,0,15000,43200,0,58200
143215701200000,SW 404,RESIDENTIAL,15000,0,15000,78700,0,93700
143215701300000,SW 404,RESIDENTIAL,15000,0,15000,62300,0,77300
143215701400000,SW 404,RESIDENTIAL,15000,0,15000,89000,0,104000
143215701500000,SW 404,RESIDENTIAL,15000,0,15000,80600,0,95600
143215800100000,SW 404,RESIDENTIAL,17000,0,17000,60400,0,77400
143215800200000,SW 404,RESIDENTIAL,20400,0,20400,60900,0,81300
143215800300000,SW 404,RESIDENTIAL,19300,0,19300,74800,0,94100
143215800400000,SW 404,RESIDENTIAL,19300,0,19300,111500,0,130800
143215800500000,SW 404,RESIDENTIAL,17000,0,17000,81000,0,98000
143215800600000,SW 404,RESIDENTIAL,17000,0,17000,79900,0,96900
143215800700000,SW 404,RESIDENTIAL,17000,0,17000,85200,0,102200
143215800800000,SW 404,RESIDENTIAL,17000,0,17000,30700,0,47700
143215800900000,SW 404,RESIDENTIAL,17000,0,17000,55400,0,72400
143215801000000,SW 404,RESIDENTIAL,17000,0,17000,40800,0,57800
143215801100000,SW 404,RESIDENTIAL,17000,0,17000,65400,0,82400
143215801200000,SW 404,RESIDENTIAL,15000,0,15000,56500,0,71500
143215801300000,SW 404,RESIDENTIAL,15000,0,15000,42900,0,57900
143215801400000,SW 404,RESIDENTIAL,18000,0,18000,62300,0,80300
143215801600000,SW 404,RESIDENTIAL,18000,0,18000,89500,0,107500
143215801700000,SW 404,RESIDENTIAL,15000,0,15000,65400,0,80400
143215801800000,SW 404,RESIDENTIAL,15000,0,15000,35100,0,50100
143215802100000,SW 404,RESIDENTIAL,15000,0,15000,62300,0,77300
143215802200000,SW 404,RESIDENTIAL,15000,0,15000,66900,0,81900
143215802300000,SW 404,RESIDENTIAL,15000,0,15000,46800,0,61800
143215802400000,SW 404,RESIDENTIAL,18000,0,18000,68600,0,86600
143215900100000,SW 404,RESIDENTIAL,20400,0,20400,74100,0,94500
143215900200000,SW 404,RESIDENTIAL,17000,0,17000,57900,0,74900
143215900300000,SW 404,RESIDENTIAL,20400,0,20400,46600,0,67000
143215900400000,SW 404,RESIDENTIAL,19500,0,19500,83800,0,103300
143215900500000,SW 404,RESIDENTIAL,16800,0,16800,77600,0,94400
143215900600000,SW 404,RESIDENTIAL,15000,0,15000,56100,0,71100
143215900700000,SW 404,RESIDENTIAL,18000,0,18000,91400,0,109400
143215900800000,SW 404,RESIDENTIAL,18000,0,18000,104300,0,122300
143216000100000,SW 404,RESIDENTIAL,18800,0,18800,3700,0,22500
143216000200000,SW 404,RESIDENTIAL,17600,0,17600,48100,0,65700
143216000300000,SW 404,RESIDENTIAL,14700,0,14700,62400,0,77100
143216000400000,SW 404,RESIDENTIAL,14700,0,14700,30300,0,45000
143216000500000,SW 404,RESIDENTIAL,17600,0,17600,64900,0,82500
143216000600000,SW 404,RESIDENTIAL,14700,0,14700,87200,0,101900
143216000700000,SW 404,RESIDENTIAL,17600,0,17600,46500,0,64100
143216100100000,SW 404,RESIDENTIAL,14700,0,14700,39300,0,54000
143216100200000,SW 404,RESIDENTIAL,14700,0,14700,77300,0,92000
143216100300000,SW 404,RESIDENTIAL,17600,0,17600,87400,0,105000
143216100500000,SW 404,RESIDENTIAL,17600,0,17600,98800,0,116400
143216100600000,SW 404,RESIDENTIAL,18800,0,18800,64400,0,83200
143216100700000,SW 404,RESIDENTIAL,15700,0,15700,68500,0,84200
143216100800000,SW 404,RESIDENTIAL,14700,0,14700,30000,0,44700
143216100900000,SW 404,RESIDENTIAL,14700,0,14700,41300,0,56000
143216101000000,SW 404,RESIDENTIAL,18800,0,18800,67000,0,85800
143216200100000,SW 404,RESIDENTIAL,17700,0,17700,46300,0,64000
143216200200000,SW 404,RESIDENTIAL,15700,0,15700,52500,0,68200
143216200300000,SW 404,RESIDENTIAL,14700,0,14700,70400,0,85100
143216200400000,SW 404,RESIDENTIAL,18800,0,18800,77100,0,95900
143216200500000,SW 404,RESIDENTIAL,17300,0,17300,105700,0,123000
143217600100000,OFFICE,COMMERCIAL,0,100800,100800,0,155900,256700
143217600200000,SW 404,RESIDENTIAL,17000,0,17000,54700,0,71700
143217600300000,SW 404,RESIDENTIAL,17000,0,17000,81900,0,98900
143217600400000,SW 404,RESIDENTIAL,17000,0,17000,54400,0,71400
143217600500000,SW 404,RESIDENTIAL,17000,0,17000,57500,0,74500
143217600600000,SW 404,RESIDENTIAL,17000,0,17000,94700,0,111700
143217600700000,SW 404,RESIDENTIAL,20400,0,20400,90900,0,111300
143217600800000,SW 404,RESIDENTIAL,17000,0,17000,86200,0,103200
143217600900000,SW 404,RESIDENTIAL,17000,0,17000,50400,0,67400
143217601000000,SW 404,RESIDENTIAL,17000,0,17000,59100,0,76100
143217601100000,SW 404,RESIDENTIAL,12900,0,12900,81200,0,94100
143217601200000,SW 404,RESIDENTIAL,11500,0,11500,46700,0,58200
143217601300000,SW 404,RESIDENTIAL,14100,0,14100,54600,0,68700
143217601400000,SW 404,RESIDENTIAL,16200,0,16200,57600,0,73800
143217601500000,SW 404,RESIDENTIAL,14100,0,14100,53100,0,67200
143217601600000,SW 404,RESIDENTIAL,17000,0,17000,53200,0,70200
143217601700000,SW 404,RESIDENTIAL,17000,0,17000,119200,0,136200
143217601800000,SW 404,RESIDENTIAL,17000,0,17000,50800,0,67800
143217601900000,SW 404,RESIDENTIAL,17000,0,17000,66100,0,83100
143217602000000,SW 404,RESIDENTIAL,17000,0,17000,19200,0,36200
143217602100000,SW 404,RESIDENTIAL,20400,0,20400,62500,0,82900
143217602200000,SW 404,RESIDENTIAL,17000,0,17000,63400,0,80400
143217602300000,SW 404,RESIDENTIAL,17000,0,17000,37800,0,54800
143217602400000,SW 404,RESIDENTIAL,17000,0,17000,53000,0,70000
143217602500000,AUTO REPAIR/SALES,COMMERCIAL,0,100800,100800,0,102700,203500
143217700100000,SW 404,RESIDENTIAL,17800,0,17800,67600,0,85400
143217700200000,SW 404,RESIDENTIAL,17000,0,17000,53000,0,70000
143217700300000,SW 404,RESIDENTIAL,17000,0,17000,49300,0,66300
143217700400000,SW 404,RESIDENTIAL,17000,0,17000,64900,0,81900
143217700500000,SW 404,RESIDENTIAL,17000,0,17000,68200,0,85200
143217700600000,SW 404,RESIDENTIAL,17000,0,17000,36400,0,53400
143217700700000,SW 404,RESIDENTIAL,17000,0,17000,59300,0,76300
143217700800000,SW 404,RESIDENTIAL,17800,0,17800,97900,0,115700
143217700900000,SW 404,RESIDENTIAL,17600,0,17600,71100,0,88700
143217701000000,SW 404,RESIDENTIAL,17600,0,17600,80600,0,98200
143217701100000,SW 404,RESIDENTIAL,17000,0,17000,47500,0,64500
143217701200000,SW 404,RESIDENTIAL,17000,0,17000,54200,0,71200
143217701300000,SW 404,RESIDENTIAL,17000,0,17000,50500,0,67500
143217701400000,SW 404,RESIDENTIAL,20400,0,20400,93900,0,114300
143217701500000,SW 404,RESIDENTIAL,17800,0,17800,71000,0,88800
143217800100000,SW 404,RESIDENTIAL,21000,0,21000,69800,0,90800
143217800200000,SW 404,RESIDENTIAL,17000,0,17000,63000,0,80000
143217800300000,SW 404,RESIDENTIAL,17000,0,17000,66900,0,83900
143217800400000,SW 404,RESIDENTIAL,17000,0,17000,85700,0,102700
143217800500000,SW 404,RESIDENTIAL,17000,0,17000,70200,0,87200
143217800600000,SW 404,RESIDENTIAL,19100,0,19100,48800,0,67900
143217900100000,BRANCH BANK/CU,COMMERCIAL,0,134400,134400,0,204100,338500
143217900200000,FLAT PARKING,COMMERCIAL,0,33600,33600,0,1700,35300
143217900300000,SW 404,RESIDENTIAL,25500,0,25500,52000,0,77500
143217900400000,SW 404,RESIDENTIAL,20400,0,20400,68000,0,88400
143217900500000,SW 404,RESIDENTIAL,17000,0,17000,87400,0,104400
143217900600000,SW 404,RESIDENTIAL,17000,0,17000,81400,0,98400
143217900700000,SW 404,RESIDENTIAL,17000,0,17000,88700,0,105700
143217900800000,SW 404,RESIDENTIAL,17000,0,17000,90000,0,107000
143217900900000,SW 404,RESIDENTIAL,17000,0,17000,79300,0,96300
143217901000000,SW 404,RESIDENTIAL,20400,0,20400,68400,0,88800
143217901100000,SW 404,RESIDENTIAL,17000,0,17000,67700,0,84700
143217901200000,SW 404,RESIDENTIAL,17000,0,17000,74400,0,91400
143217901300000,SW 404,RESIDENTIAL,17000,0,17000,73900,0,90900
143217901400000,SW 404,RESIDENTIAL,17000,0,17000,73700,0,90700
143217901500000,SW 404,RESIDENTIAL,17000,0,17000,60800,0,77800
143217901600000,SW 404,RESIDENTIAL,17000,0,17000,48600,0,65600
143217901700000,SW 404,RESIDENTIAL,17000,0,17000,57600,0,74600
143217901800000,SW 404,RESIDENTIAL,17000,0,17000,48800,0,65800
143217901900000,SW 404,RESIDENTIAL,17000,0,17000,78400,0,95400
143217902000000,SW 404,RESIDENTIAL,17000,0,17000,31800,0,48800
143217902100000,SW 404,RESIDENTIAL,17000,0,17000,65000,0,82000
143217902200000,SW 404,RESIDENTIAL,34000,0,34000,63700,0,97700
143217902300000,SMALL RETAIL,COMMERCIAL,0,67200,67200,0,78300,145500
143218000100000,SW 404,RESIDENTIAL,13700,0,13700,68800,0,82500
143218000200000,SW 404,RESIDENTIAL,17000,0,17000,59800,0,76800
143218000300000,SW 404,RESIDENTIAL,17000,0,17000,46400,0,63400
143218000400000,SW 404,RESIDENTIAL,17000,0,17000,70400,0,87400
143218000500000,SW 404,RESIDENTIAL,17000,0,17000,64200,0,81200
143218000600000,SW 404,RESIDENTIAL,17000,0,17000,46500,0,63500
143218000700000,SW 404,RESIDENTIAL,17000,0,17000,100400,0,117400
143218000800000,SW 404,RESIDENTIAL,17800,0,17800,103800,0,121600
143218000900000,SW 404,RESIDENTIAL,17800,0,17800,62000,0,79800
143218001000000,SW 404,RESIDENTIAL,17000,0,17000,54300,0,71300
143218001100000,SW 404,RESIDENTIAL,17000,0,17000,45800,0,62800
143218001200000,SW 404,RESIDENTIAL,17000,0,17000,63500,0,80500
143218001300000,SW 404,RESIDENTIAL,20400,0,20400,69600,0,90000
143218001400000,SW 404,RESIDENTIAL,21400,0,21400,99200,0,120600
143218001500000,SW 404,RESIDENTIAL,13300,0,13300,41100,0,54400
143218100100000,SW 404,RESIDENTIAL,19100,0,19100,79900,0,99000
143218100300000,SW 404,RESIDENTIAL,17000,0,17000,88900,0,105900
143218100400000,SW 404,RESIDENTIAL,21000,0,21000,51000,0,72000
143218100500000,SW 404,RESIDENTIAL,17000,0,17000,83400,0,100400
143218100600000,SW 404,RESIDENTIAL,17000,0,17000,86000,0,103000
143218100700000,SW 404,RESIDENTIAL,20400,0,20400,112900,0,133300
143218200100000,FAST FOOD,COMMERCIAL,0,28000,28000,0,188200,216200
143218200200000,SW 404,RESIDENTIAL,17000,0,17000,37800,0,54800
143218200300000,SW 404,RESIDENTIAL,17000,0,17000,54700,0,71700
143218200400000,SW 404,RESIDENTIAL,17000,0,17000,49600,0,66600
143218200500000,SW 404,RESIDENTIAL,17000,0,17000,29400,0,46400
143218200600000,SW 404,RESIDENTIAL,17000,0,17000,51400,0,68400
143218200700000,SW 404,RESIDENTIAL,17000,0,17000,64800,0,81800
143218200800000,SW 404,RESIDENTIAL,17000,0,17000,42200,0,59200
143218200900000,SW 404,RESIDENTIAL,17000,0,17000,38800,0,55800
143218201000000,SW 404,RESIDENTIAL,17000,0,17000,60600,0,77600
143218201100000,SW 404,RESIDENTIAL,17000,0,17000,45300,0,62300
143218201200000,SW 404,RESIDENTIAL,17000,0,17000,26800,0,43800
143218201300000,SW 404,RESIDENTIAL,17000,0,17000,53200,0,70200
143218201400000,SW 404,RESIDENTIAL,17000,0,17000,61300,0,78300
143218201500000,SW 404,RESIDENTIAL,17000,0,17000,42900,0,59900
143218201600000,SW 404,RESIDENTIAL,16300,0,16300,40200,0,56500
143218201700000,SW 404,RESIDENTIAL,17400,0,17400,72100,0,89500
143218201800000,SW 404,RESIDENTIAL,17000,0,17000,69000,0,86000
143218201900000,SW 404,RESIDENTIAL,17000,0,17000,47500,0,64500
143218202000000,SW 404,RESIDENTIAL,17000,0,17000,35800,0,52800
143218202100000,SW 404,RESIDENTIAL,17000,0,17000,78700,0,95700
143218202200000,SW 404,RESIDENTIAL,17000,0,17000,74000,0,91000
143218202300000,SW 404,RESIDENTIAL,17000,0,17000,64000,0,81000
143218202400000,SW 404,RESIDENTIAL,17000,0,17000,55400,0,72400
143218202500000,SW 404,RESIDENTIAL,17000,0,17000,50900,0,67900
143218202600000,SW 404,RESIDENTIAL,17000,0,17000,48400,0,65400
143218202700000,SW 404,RESIDENTIAL,17000,0,17000,37600,0,54600
143218202800000,SW 404,RESIDENTIAL,17000,0,17000,101500,0,118500
143218202900000,SERVICE STATION,COMMERCIAL,0,67200,67200,0,71900,139100
143218300100000,SW 404,RESIDENTIAL,17800,0,17800,42300,0,60100
143218300200000,SW 404,RESIDENTIAL,17000,0,17000,72100,0,89100
143218300300000,SW 404,RESIDENTIAL,17000,0,17000,43900,0,60900
143218300400000,SW 404,RESIDENTIAL,17000,0,17000,65000,0,82000
143218300500000,SW 404,RESIDENTIAL,17000,0,17000,37900,0,54900
143218300600000,SW 404,RESIDENTIAL,17000,0,17000,62200,0,79200
143218300700000,SW 404,RESIDENTIAL,17000,0,17000,47200,0,64200
143218300800000,SW 404,RESIDENTIAL,13100,0,13100,72900,0,86000
143218300900000,SW 404,RESIDENTIAL,14300,0,14300,58400,0,72700
143218301000000,SW 404,RESIDENTIAL,20400,0,20400,73300,0,93700
143218301100000,SW 404,RESIDENTIAL,20400,0,20400,72700,0,93100
143218301200000,SW 404,RESIDENTIAL,17000,0,17000,82100,0,99100
143218301300000,SW 404,RESIDENTIAL,20400,0,20400,68100,0,88500
143218301400000,SW 404,RESIDENTIAL,17000,0,17000,51100,0,68100
143218301500000,SW 404,RESIDENTIAL,17800,0,17800,51600,0,69400
143218400100000,SW 404,RESIDENTIAL,19100,0,19100,46200,0,65300
143218400200000,SW 404,RESIDENTIAL,17000,0,17000,47300,0,64300
143218400300000,SW 404,RESIDENTIAL,15000,0,15000,44300,0,59300
143218400400000,SW 404,RESIDENTIAL,19100,0,19100,54100,0,73200
143218400500000,SW 404,RESIDENTIAL,17000,0,17000,52800,0,69800
143218400600000,SW 404,RESIDENTIAL,17000,0,17000,57800,0,74800
143218400700000,SW 404,RESIDENTIAL,20400,0,20400,88200,0,108600
143218400800000,SW 404,RESIDENTIAL,17000,0,17000,59700,0,76700
143218500100000,CENTRALLY ASSESSED,OTHER,0,0,0,0,0,0
143218500200000,CITY PROPERTY,EXEMPT,0,0,0,0,0,0
143218500300000,SW 404,RESIDENTIAL,15700,0,15700,54500,0,70200
143218500400000,SW 404,RESIDENTIAL,18300,0,18300,43400,0,61700
143218500500000,SW 404,RESIDENTIAL,16900,0,16900,100200,0,117100
143218500600000,SW 404,RESIDENTIAL,16700,0,16700,83300,0,100000
143218500700000,SW 404,RESIDENTIAL,15700,0,15700,46500,0,62200
143218500800000,SW 404,RESIDENTIAL,16700,0,16700,29300,0,46000
143218500900000,SW 404,RESIDENTIAL,15700,0,15700,47600,0,63300
143218501000000,SW 404,RESIDENTIAL,15700,0,15700,63300,0,79000
143218501100000,SW 404,RESIDENTIAL,15500,0,15500,64300,0,79800
143218501200000,SW 404,RESIDENTIAL,15500,0,15500,46400,0,61900
143218501300000,SW 404,RESIDENTIAL,16500,0,16500,62000,0,78500
143218501400000,SW 404,RESIDENTIAL,15600,0,15600,98200,0,113800
143218600100000,OFFICE,COMMERCIAL,0,83200,83200,0,182100,265300
143218600200000,SW 404,RESIDENTIAL,15500,0,15500,86900,0,102400
143218600300000,SW 404,RESIDENTIAL,15500,0,15500,0,0,15500
143218600400000,SW 404,RESIDENTIAL,19600,0,19600,30400,0,50000
143218700100000,SW 404,RESIDENTIAL,21200,0,21200,54000,0,75200
143218700200000,SW 404,RESIDENTIAL,16800,0,16800,89200,0,106000
143220100100000,SW 404,RESIDENTIAL,20000,0,20000,53300,0,73300
143220200100000,VACANT LAND,COMMERCIAL,0,700,700,0,0,700
143220200200000,VACANT LAND,COMMERCIAL,0,28800,28800,0,0,28800
143220300200000,SHOP,COMMERCIAL,0,112500,112500,0,264400,376900
143220300400000,STATE PROPERTY,EXEMPT,0,0,0,0,0,0
143220400100000,SW 404,RESIDENTIAL,17000,0,17000,50700,0,67700
143220400200000,SW 404,RESIDENTIAL,17000,0,17000,49900,0,66900
143220400300000,SW 404,RESIDENTIAL,20400,0,20400,56100,0,76500
143220400400000,SW 404,RESIDENTIAL,17000,0,17000,60700,0,77700
143220400500000,SW 404,RESIDENTIAL,17000,0,17000,29700,0,46700
143220400600000,SW 404,RESIDENTIAL,17000,0,17000,79200,0,96200
143220400700000,SW 404,RESIDENTIAL,17000,0,17000,53600,0,70600
143220401000000,SW 404,RESIDENTIAL,17000,0,17000,43400,0,60400
143220401100000,SW 404,RESIDENTIAL,17000,0,17000,49800,0,66800
143220401200000,SW 404,RESIDENTIAL,17000,0,17000,81700,0,98700
143220401300000,SW 404,RESIDENTIAL,17000,0,17000,84100,0,101100
143220401400000,SW 404,RESIDENTIAL,17000,0,17000,60200,0,77200
143220401500000,SW 404,RESIDENTIAL,17000,0,17000,81900,0,98900
143220401600000,SW 404,RESIDENTIAL,17000,0,17000,60900,0,77900
143220401700000,SW 404,RESIDENTIAL,17000,0,17000,37800,0,54800
143220401800000,SW 404,RESIDENTIAL,17000,0,17000,57700,0,74700
143220401900000,SW 404,RESIDENTIAL,17000,0,17000,64800,0,81800
143220402000000,SW 404,RESIDENTIAL,20400,0,20400,57100,0,77500
143220402100000,SW 404,RESIDENTIAL,20400,0,20400,36000,0,56400
143220402200000,SW 404,RESIDENTIAL,23800,0,23800,63400,0,87200
143220500100000,STATE PROPERTY,EXEMPT,0,0,0,0,0,0
143220500200000,SW 404,RESIDENTIAL,26800,0,26800,78200,0,105000
143220500202000,BILLBOARD(BLL),COMMERCIAL,0,0,0,0,31700,31700
143220500300000,SW 404,RESIDENTIAL,19600,0,19600,47600,0,67200
143220500400000,SW 404,RESIDENTIAL,20400,0,20400,60400,0,80800
143220500500000,SW 404,RESIDENTIAL,17000,0,17000,77300,0,94300
143220500800000,SW 404,RESIDENTIAL,20400,0,20400,28800,0,49200
143220500900000,SW 404,RESIDENTIAL,17000,0,17000,67400,0,84400
143220501000000,SW 404,RESIDENTIAL,13700,0,13700,45700,0,59400
143220501100000,SW 404,RESIDENTIAL,14100,0,14100,45300,0,59400
143220501200000,SW 404,RESIDENTIAL,13700,0,13700,48200,0,61900
143220501300000,SW 404,RESIDENTIAL,19500,0,19500,76200,0,95700
143220501400000,SW 404,RESIDENTIAL,22500,0,22500,88000,0,110500
143220600100000,SW 404,RESIDENTIAL,20400,0,20400,48600,0,69000
143220600200000,SW 404,RESIDENTIAL,17000,0,17000,59700,0,76700
143220600300000,SW 404,RESIDENTIAL,20400,0,20400,51500,0,71900
143220600400000,SW 404,RESIDENTIAL,20400,0,20400,82700,0,103100
143220600500000,SW 404,RESIDENTIAL,17000,0,17000,54000,0,71000
143220600600000,SW 404,RESIDENTIAL,20400,0,20400,39800,0,60200
143220600700000,SW 404,RESIDENTIAL,17000,0,17000,82500,0,99500
143220600800000,SW 404,RESIDENTIAL,17000,0,17000,41100,0,58100
143220600900000,SW 404,RESIDENTIAL,20400,0,20400,83900,0,104300
143220601000000,SW 404,RESIDENTIAL,17000,0,17000,59300,0,76300
143220601100000,SW 404,RESIDENTIAL,17000,0,17000,93700,0,110700
143220601200000,SW 404,RESIDENTIAL,20400,0,20400,56200,0,76600
143220601300000,SW 404,RESIDENTIAL,17000,0,17000,62000,0,79000
143220601400000,SW 404,RESIDENTIAL,17000,0,17000,74000,0,91000
143220601500000,SW 404,RESIDENTIAL,17000,0,17000,108700,0,125700
143220601600000,SW 404,RESIDENTIAL,17000,0,17000,62400,0,79400
143220601700000,SW 404,RESIDENTIAL,17000,0,17000,44900,0,61900
143220601800000,SW 404,RESIDENTIAL,17000,0,17000,94400,0,111400
143220700100000,SW 404,RESIDENTIAL,17000,0,17000,53900,0,70900
143220700200000,SW 404,RESIDENTIAL,17000,0,17000,48900,0,65900
143220700300000,SW 404,RESIDENTIAL,17000,0,17000,38200,0,55200
143220700400000,SW 404,RESIDENTIAL,20400,0,20400,90400,0,110800
143220700500000,SW 404,RESIDENTIAL,17000,0,17000,85400,0,102400
143220700600000,SW 404,RESIDENTIAL,17000,0,17000,55400,0,72400
143220700700000,SW 404,RESIDENTIAL,20400,0,20400,11100,0,31500
143220700800000,SW 404,RESIDENTIAL,17000,0,17000,46200,0,63200
143220700900000,SW 404,RESIDENTIAL,20400,0,20400,52400,0,72800
143220701000000,SW 404,RESIDENTIAL,17000,0,17000,60200,0,77200
143220701100000,SW 404,RESIDENTIAL,22200,0,22200,81300,0,103500
143220701200000,SW 404,RESIDENTIAL,24800,0,24800,91200,0,116000
143220701300000,SW 404,RESIDENTIAL,17000,0,17000,0,0,17000
143220701400000,SW 404,RESIDENTIAL,25500,0,25500,87800,0,113300
143220701500000,SW 404,RESIDENTIAL,20400,0,20400,44300,0,64700
143220701600000,SW 404,RESIDENTIAL,20400,0,20400,57300,0,77700
143220701700000,SW 404,RESIDENTIAL,17000,0,17000,66200,0,83200
143220701800000,SW 404,RESIDENTIAL,17000,0,17000,56500,0,73500
143220701900000,SW 404,RESIDENTIAL,19900,0,19900,57200,0,77100
143220702000000,SW 404,RESIDENTIAL,20700,0,20700,64300,0,85000
143220702100000,SW 404,RESIDENTIAL,17000,0,17000,60800,0,77800
143220702200000,SW 404,RESIDENTIAL,20400,0,20400,64000,0,84400
143220800100000,FLAT PARKING,COMMERCIAL,0,5200,5200,0,3400,8600
143220800200000,VACANT LAND,COMMERCIAL,0,16300,16300,0,0,16300
143222600100000,SW 405,RESIDENTIAL,18400,0,18400,76800,0,95200
143222600200000,SW 405,RESIDENTIAL,18600,0,18600,79200,0,97800
143222600300000,SW 405,RESIDENTIAL,18800,0,18800,61300,0,80100
143222600400000,SW 405,RESIDENTIAL,19200,0,19200,80100,0,99300
143222600500000,SW 405,RESIDENTIAL,19400,0,19400,59100,0,78500
143222600600000,SW 405,RESIDENTIAL,19400,0,19400,74300,0,93700
143222600700000,SW 405,RESIDENTIAL,19200,0,19200,61100,0,80300
143222600800000,SW 405,RESIDENTIAL,19200,0,19200,65300,0,84500
143222600900000,SW 405,RESIDENTIAL,19000,0,19000,58900,0,77900
143222601000000,SW 405,RESIDENTIAL,18800,0,18800,52700,0,71500
143222601100000,SW 405,RESIDENTIAL,18600,0,18600,64600,0,83200
143222601200000,SW 405,RESIDENTIAL,18400,0,18400,54800,0,73200
143222601300000,SW 405,RESIDENTIAL,18200,0,18200,54900,0,73100
143222601400000,SW 405,RESIDENTIAL,18000,0,18000,73300,0,91300
143222601500000,SW 405,RESIDENTIAL,20700,0,20700,57700,0,78400
143222601600000,SW 405,RESIDENTIAL,20300,0,20300,58100,0,78400
143222601700000,SW 405,RESIDENTIAL,22600,0,22600,85300,0,107900
143222601800000,SW 405,RESIDENTIAL,21700,0,21700,64400,0,86100
143222601900000,SW 405,RESIDENTIAL,19800,0,19800,58400,0,78200
143222602000000,SW 405,RESIDENTIAL,20500,0,20500,63500,0,84000
143222602100000,BARS/LOUNGE,COMMERCIAL,0,62000,62000,0,146500,208500
143222602200000,RESTAURANT,COMMERCIAL,0,127500,127500,0,222500,350000
143222602300000,FLAT PARKING,COMMERCIAL,0,46500,46500,0,9200,55700
143222602400000,AUTO REPAIR/SALES,COMMERCIAL,0,150000,150000,0,196200,346200
143222602500000,CARWASH,COMMERCIAL,0,125900,125900,0,81400,207300
143222602502000,BILLBOARD(BLL),COMMERCIAL,0,0,0,0,56000,56000
143222602700000,STATE PROPERTY,EXEMPT,0,0,0,0,0,0
143222602800000,WAREHOUSE;MINI STORG,COMMERCIAL,9410,461090,470500,66006,791494,1328000
143222700100000,SW 405,RESIDENTIAL,19400,0,19400,85600,0,105000
143222700200000,SW 405,RESIDENTIAL,20000,0,20000,75400,0,95400
143222700300000,VACANT LAND,COMMERCIAL,0,37800,37800,0,0,37800
143222700400000,AUTO REPAIR/SALES,COMMERCIAL,0,140300,140300,0,124400,264700
143222800100000,SMALL RETAIL,COMMERCIAL,0,213800,213800,0,476000,689800
143222800200000,VACANT LAND,COMMERCIAL,0,74300,74300,0,0,74300
143222800300000,APARTMENT,MULTI-RES,157000,0,157000,117800,0,274800
143222800400000,SW 405,AG LAND,1600,0,1600,0,0,1600
143222800500000,SW 405,AG DWELLING,1600,0,1600,32500,2700,36800
143225100100000,WAREHOUSE,COMMERCIAL,0,347800,347800,0,49100,396900
143225100102001,BILLBOARD(BLL),COMMERCIAL,0,0,0,0,15500,15500
143225200300000,SW 405,RESIDENTIAL,39000,0,39000,89300,0,128300
143225200400000,SW 405,RESIDENTIAL,24900,0,24900,75500,0,100400
143225200500000,SW 405,RESIDENTIAL,22600,0,22600,63800,0,86400
143225200600000,SW 405,RESIDENTIAL,24600,0,24600,76100,0,100700
143225200700000,SW 405,RESIDENTIAL,28700,0,28700,52200,0,80900
143225300300000,SW 405,RESIDENTIAL,49200,0,49200,126400,0,175600
143225300400000,SW 405,RESIDENTIAL,31500,0,31500,0,0,31500
143225300500000,SW 405,RESIDENTIAL,33600,0,33600,105200,0,138800
143225300600000,SW 405,RESIDENTIAL,24500,0,24500,92900,0,117400
143225300700000,SW 405,RESIDENTIAL,23700,0,23700,98400,0,122100
143225300800000,SW 405,RESIDENTIAL,23700,0,23700,87700,0,111400
143225300900000,CITY PROPERTY,EXEMPT,0,0,0,0,0,0
143225301000000,SW 405,RESIDENTIAL,22400,0,22400,69300,0,91700
143225301100000,SW 405,RESIDENTIAL,22400,0,22400,0,0,22400
143225301200000,SW 405,RESIDENTIAL,22400,0,22400,118300,0,140700
143225301300000,SW 405,RESIDENTIAL,52700,0,52700,60400,0,113100
143225301600000,WAREHOUSE,COMMERCIAL,0,70000,70000,0,101400,171400
143225301700000,SW 405,RESIDENTIAL,48400,0,48400,61500,0,109900
143225301800000,SW 405,RESIDENTIAL,46100,0,46100,44900,0,91000
143227600100000,SW 404,RESIDENTIAL,17000,0,17000,0,0,17000
143227600200000,SW 404,RESIDENTIAL,17000,0,17000,27400,0,44400
143227600300000,SW 404,RESIDENTIAL,20400,0,20400,90400,0,110800
143227600400000,SW 404,RESIDENTIAL,10200,0,10200,0,0,10200
143227600500000,SW 404,RESIDENTIAL,10200,0,10200,64800,0,75000
143227600600000,SW 404,RESIDENTIAL,17000,0,17000,50100,0,67100
143227600700000,SW 404,RESIDENTIAL,17000,0,17000,67000,0,84000
143227600800000,SW 404,RESIDENTIAL,20400,0,20400,72300,0,92700
143227600900000,SW 404,RESIDENTIAL,18400,0,18400,58800,0,77200
143227601000000,SW 404,RESIDENTIAL,12900,0,12900,59100,0,72000
143227601100000,SW 404,RESIDENTIAL,12900,0,12900,53800,0,66700
143227601200000,SW 404,RESIDENTIAL,17000,0,17000,56400,0,73400
143227601400000,SW 404,RESIDENTIAL,20400,0,20400,79600,0,100000
143227601500000,SW 404,RESIDENTIAL,20400,0,20400,50400,0,70800
143227601600000,SW 404,RESIDENTIAL,17000,0,17000,73500,0,90500
143227601700000,SW 404,RESIDENTIAL,17000,0,17000,51400,0,68400
143227601800000,SW 404,RESIDENTIAL,17000,0,17000,53800,0,70800
143227601900000,CITY PROPERTY,EXEMPT,0,0,0,0,0,0
143227602000000,SW 404,RESIDENTIAL,2100,0,2100,0,0,2100
143227602100000,SW 404,RESIDENTIAL,17000,0,17000,63400,0,80400
143227602200000,SW 404,RESIDENTIAL,17000,0,17000,0,0,17000
143227700100000,SW 404,RESIDENTIAL,20400,0,20400,0,0,20400
143227700200000,SW 404,RESIDENTIAL,17000,0,17000,70300,0,87300
143227700300000,SW 404,RESIDENTIAL,20400,0,20400,72800,0,93200
143227700400000,SW 404,RESIDENTIAL,17000,0,17000,66600,0,83600
143227700500000,SW 404,RESIDENTIAL,17000,0,17000,86400,0,103400
143227700600000,SW 404,RESIDENTIAL,17000,0,17000,59100,0,76100
143227700700000,SW 404,RESIDENTIAL,17000,0,17000,49000,0,66000
143227700800000,SW 404,RESIDENTIAL,20400,0,20400,111800,0,132200
143227700900000,SW 404,RESIDENTIAL,21300,0,21300,52100,0,73400
143227701000000,SW 404,RESIDENTIAL,21300,0,21300,58000,0,79300
143227701100000,SW 404,RESIDENTIAL,21300,0,21300,140000,0,161300
143227701200000,SW 404,RESIDENTIAL,21000,0,21000,47000,0,68000
143227701300000,SW 404,RESIDENTIAL,20400,0,20400,84200,0,104600
143227701400000,SW 404,RESIDENTIAL,20400,0,20400,80300,0,100700
143227701500000,SW 404,RESIDENTIAL,20400,0,20400,77300,0,97700
143227701600000,SW 404,RESIDENTIAL,17000,0,17000,81400,0,98400
143227701700000,SW 404,RESIDENTIAL,20400,0,20400,86800,0,107200
143227701800000,SW 404,RESIDENTIAL,17000,0,17000,19700,0,36700
143227701900000,SW 404,RESIDENTIAL,8500,0,8500,0,0,8500
143227702000000,SW 404,RESIDENTIAL,17000,0,17000,101400,0,118400
143227702100000,SW 404,RESIDENTIAL,19100,0,19100,112100,0,131200
143227702200000,SW 404,RESIDENTIAL,18200,0,18200,102000,0,120200
143227800100000,SW 404,RESIDENTIAL,17000,0,17000,25400,0,42400
143227800200000,SW 404,RESIDENTIAL,20400,0,20400,33500,0,53900
143227800300000,CITY PROPERTY,EXEMPT,0,0,0,0,0,0
143227800400000,SW 404,RESIDENTIAL,20400,0,20400,74300,0,94700
143227800500000,SW 404,RESIDENTIAL,20400,0,20400,33100,0,53500
143227800600000,SW 404,RESIDENTIAL,20400,0,20400,58900,0,79300
143227800700000,SW 404,RESIDENTIAL,10200,0,10200,900,0,11100
143227800800000,SW 404,RESIDENTIAL,10200,0,10200,77900,0,88100
143227800900000,SW 404,RESIDENTIAL,20400,0,20400,84500,0,104900
143227801000000,SW 404,RESIDENTIAL,17000,0,17000,80400,0,97400
143227801100000,SW 404,RESIDENTIAL,20400,0,20400,83700,0,104100
143227801200000,CITY PROPERTY,EXEMPT,0,0,0,0,0,0
143227801300000,SW 404,RESIDENTIAL,17000,0,17000,32800,0,49800
143227801400000,SW 404,RESIDENTIAL,20400,0,20400,51100,0,71500
143227801500000,SW 404,RESIDENTIAL,20400,0,20400,0,0,20400
143227801600000,SW 404,RESIDENTIAL,17000,0,17000,81500,0,98500
143227900100000,SW 404,RESIDENTIAL,17000,0,17000,70400,0,87400
143227900200000,SW 404,RESIDENTIAL,17000,0,17000,80800,0,97800
143227900300000,SW 404,RESIDENTIAL,17000,0,17000,26300,0,43300
143227900400000,SW 404,RESIDENTIAL,17000,0,17000,37700,0,54700
143227900500000,SW 404,RESIDENTIAL,17000,0,17000,20000,0,37000
143227900600000,SW 404,RESIDENTIAL,17000,0,17000,54600,0,71600
143227900700000,SW 404,RESIDENTIAL,17000,0,17000,57200,0,74200
143227900800000,SW 404,RESIDENTIAL,17000,0,17000,90500,0,107500
143227900900000,SW 404,RESIDENTIAL,17000,0,17000,85200,0,102200
143227901000000,SW 404,RESIDENTIAL,17000,0,17000,95500,0,112500
143227901100000,SW 404,RESIDENTIAL,23800,0,23800,114700,0,138500
143227901200000,SW 404,RESIDENTIAL,17000,0,17000,66500,0,83500
143227901300000,SW 404,RESIDENTIAL,17000,0,17000,80400,0,97400
143227901400000,SW 404,RESIDENTIAL,17000,0,17000,75300,0,92300
143227901700000,SW 404,RESIDENTIAL,19700,0,19700,47300,0,67000
143227901800000,SW 404,RESIDENTIAL,19400,0,19400,51800,0,71200
143227901900000,SW 404,RESIDENTIAL,20400,0,20400,63300,0,83700
143227902000000,SW 404,RESIDENTIAL,23400,0,23400,114700,0,138100
143227902100000,SW 404,RESIDENTIAL,17000,0,17000,64900,0,81900
143227902200000,SW 404,RESIDENTIAL,17000,0,17000,60900,0,77900
143227902300000,SW 404,RESIDENTIAL,17000,0,17000,65700,0,82700
143227902400000,SW 404,RESIDENTIAL,17000,0,17000,68100,0,85100
143227902500000,SW 404,RESIDENTIAL,17000,0,17000,31500,0,48500
143227902600000,SW 404,RESIDENTIAL,20400,0,20400,42700,0,63100
143227902700000,SW 404,RESIDENTIAL,17000,0,17000,73000,0,90000
143227902800000,SW 404,RESIDENTIAL,22100,0,22100,70400,0,92500
143227902900000,SW 404,RESIDENTIAL,17000,0,17000,76200,0,93200
143227903000000,SW 404,RESIDENTIAL,17000,0,17000,66600,0,83600
143227903100000,SW 404,RESIDENTIAL,17000,0,17000,50200,0,67200
143227903200000,SW 404,RESIDENTIAL,25500,0,25500,84500,0,110000
143228000100000,CITY PROPERTY,EXEMPT,0,0,0,0,0,0
143228000200000,SW 404,RESIDENTIAL,17000,0,17000,64400,0,81400
143228000300000,SW 404,RESIDENTIAL,25500,0,25500,29200,0,54700
143228000400000,SW 404,RESIDENTIAL,17000,0,17000,76400,0,93400
143228000500000,SW 404,RESIDENTIAL,15000,0,15000,75200,0,90200
143228000600000,SW 404,RESIDENTIAL,15000,0,15000,56600,0,71600
143228000700000,SW 404,RESIDENTIAL,15000,0,15000,70800,0,85800
143228000800000,SW 404,RESIDENTIAL,15000,0,15000,19900,0,34900
143228000900000,SW 404,RESIDENTIAL,15000,0,15000,61700,0,76700
143228001000000,SW 404,RESIDENTIAL,15000,0,15000,0,0,15000
143228100100000,SW 404,RESIDENTIAL,17000,0,17000,75600,0,92600
143228100200000,SW 404,RESIDENTIAL,17000,0,17000,84400,0,101400
143228100300000,SW 404,RESIDENTIAL,17000,0,17000,75200,0,92200
143228100400000,SW 404,RESIDENTIAL,22100,0,22100,73800,0,95900
143228100500000,SW 404,RESIDENTIAL,17000,0,17000,89800,0,106800
143228100600000,SW 404,RESIDENTIAL,17000,0,17000,94100,0,111100
143228100700000,SW 404,RESIDENTIAL,17000,0,17000,38300,0,55300
143228100800000,SW 404,RESIDENTIAL,17000,0,17000,30000,0,47000
143228100900000,SW 404,RESIDENTIAL,17000,0,17000,50800,0,67800
143228101000000,SW 404,RESIDENTIAL,17000,0,17000,92400,0,109400
143228101100000,SW 404,RESIDENTIAL,17000,0,17000,59500,0,76500
143228101200000,SW 404,RESIDENTIAL,17000,0,17000,35600,0,52600
143228101300000,SW 404,RESIDENTIAL,20400,0,20400,89000,0,109400
143228101400000,SW 404,RESIDENTIAL,20400,0,20400,91500,0,111900
143228101700000,SW 404,RESIDENTIAL,17600,0,17600,22100,0,39700
143228101800000,SW 404,RESIDENTIAL,19500,0,19500,74400,0,93900
143228101900000,SW 404,RESIDENTIAL,15000,0,15000,69600,0,84600
143228102000000,SW 404,RESIDENTIAL,15000,0,15000,57800,0,72800
143228102100000,SW 404,RESIDENTIAL,15000,0,15000,77200,0,92200
143228102200000,SW 404,RESIDENTIAL,15000,0,15000,68200,0,83200
143228102300000,SW 404,RESIDENTIAL,15000,0,15000,49400,0,64400
143228102400000,SW 404,RESIDENTIAL,15000,0,15000,27900,0,42900
143228102500000,SW 404,RESIDENTIAL,15000,0,15000,63000,0,78000
143228102600000,SW 404,RESIDENTIAL,15000,0,15000,74300,0,89300
143228102700000,SW 404,RESIDENTIAL,19500,0,19500,63100,0,82600
143228102800000,SW 404,RESIDENTIAL,15000,0,15000,37400,0,52400
143228102900000,SW 404,RESIDENTIAL,15000,0,15000,43900,0,58900
143228103000000,SW 404,RESIDENTIAL,15000,0,15000,55000,0,70000
143228103100000,SW 404,RESIDENTIAL,19500,0,19500,28000,0,47500
143228103200000,SW 404,RESIDENTIAL,22500,0,22500,91100,0,113600
143228200100000,CITY PROPERTY,EXEMPT,0,0,0,0,0,0
143228200200000,SW 404,RESIDENTIAL,15700,0,15700,59000,0,74700
143228200300000,SW 404,RESIDENTIAL,15700,0,15700,37000,0,52700
143228200400000,SW 404,RESIDENTIAL,15700,0,15700,61000,0,76700
143228200500000,SW 404,RESIDENTIAL,14700,0,14700,49600,0,64300
143228200600000,SW 404,RESIDENTIAL,15700,0,15700,57900,0,73600
143228200700000,SW 404,RESIDENTIAL,15700,0,15700,42100,0,57800
143228200800000,SW 404,RESIDENTIAL,14700,0,14700,28000,0,42700
143228200900000,SW 404,RESIDENTIAL,15700,0,15700,50500,0,66200
143228201200000,CHURCH,EXEMPT,0,109000,109000,0,144600,253600
143228300100000,SW 404,RESIDENTIAL,14700,0,14700,83400,0,98100
143228300200000,SW 404,RESIDENTIAL,14700,0,14700,67900,0,82600
143228300300000,SW 404,RESIDENTIAL,14700,0,14700,76400,0,91100
143228300400000,SW 404,RESIDENTIAL,10100,0,10100,35900,0,46000
143228300500000,SW 404,RESIDENTIAL,10700,0,10700,30200,0,40900
143228300600000,SW 404,RESIDENTIAL,10100,0,10100,37200,0,47300
143228300700000,SW 404,RESIDENTIAL,10700,0,10700,31700,0,42400
143228300900000,SW 404,RESIDENTIAL,20400,0,20400,97300,0,117700
143228301000000,SW 404,RESIDENTIAL,19800,0,19800,46000,0,65800
143228301100000,SW 404,RESIDENTIAL,10100,0,10100,35700,0,45800
143228301200000,SW 404,RESIDENTIAL,10100,0,10100,31200,0,41300
143228301300000,SW 404,RESIDENTIAL,10700,0,10700,38400,0,49100
143228301400000,SW 404,RESIDENTIAL,23500,0,23500,62200,0,85700
143228301500000,SW 404,RESIDENTIAL,19300,0,19300,40600,0,59900
143228301600000,SW 404,RESIDENTIAL,17100,0,17100,29700,0,46800
143228301700000,SW 404,RESIDENTIAL,21200,0,21200,78800,0,100000
143228301800000,SW 404,RESIDENTIAL,17300,0,17300,38900,0,56200
143230100100000,CENTRALLY ASSESSED,OTHER,0,0,0,0,0,0
143230100300000,VACANT LAND,COMMERCIAL,0,2300,2300,0,0,2300
143230100500000,WAREHOUSE,COMMERCIAL,0,415000,415000,0,2015300,2430300
143230100600000,COUNTY PROPERTY,EXEMPT,0,0,0,0,0,0
143230100700000,VACANT LAND,COMMERCIAL,0,676600,676600,0,0,676600
143232600100000,SMALL RETAIL,COMMERCIAL,32571,122529,155100,122882,135718,413700
143232600200000,SW 404,RESIDENTIAL,36900,0,36900,0,0,36900
143232600300000,SW 404,RESIDENTIAL,39400,0,39400,57900,0,97300
143232600400000,SW 404,RESIDENTIAL,30700,0,30700,42700,0,73400
143232700100000,CENTRALLY ASSESSED,OTHER,0,0,0,0,0,0
143232800100000,SW 405,RESIDENTIAL,26700,0,26700,28400,0,55100
143232800200000,SW 405,RESIDENTIAL,20900,0,20900,33400,0,54300
143232800300000,SW 405,RESIDENTIAL,18600,0,18600,67400,0,86000
143232800400000,SW 405,RESIDENTIAL,18600,0,18600,85000,0,103600
143232800500000,SW 405,RESIDENTIAL,18600,0,18600,75300,0,93900
143232800600000,SW 405,RESIDENTIAL,18600,0,18600,72700,0,91300
143232800700000,SW 405,RESIDENTIAL,31500,0,31500,94100,0,125600
143232800800000,SW 405,RESIDENTIAL,18600,0,18600,93600,0,112200
143232800900000,SW 405,RESIDENTIAL,13200,0,13200,56700,0,69900
143232801000000,SW 405,RESIDENTIAL,20700,0,20700,59700,0,80400
143232801100000,SW 405,RESIDENTIAL,31300,0,31300,36600,0,67900
143232801200000,SW 405,RESIDENTIAL,200,0,200,0,0,200
143232801300000,SW 405,RESIDENTIAL,25500,0,25500,61500,0,87000
143232801400000,SW 405,RESIDENTIAL,22200,0,22200,47500,0,69700
143232801500000,SW 405,RESIDENTIAL,16000,0,16000,84200,0,100200
143232801600000,SHOP,COMMERCIAL,0,561100,561100,0,798600,1359700
143232801700000,SW 405,RESIDENTIAL,35500,0,35500,600,0,36100
143232801800000,SW 405,RESIDENTIAL,16000,0,16000,33200,0,49200
143235100300000,CENTRALLY ASSESSED,OTHER,0,0,0,0,0,0
143235100400000,SW 418,AG LAND,9800,0,9800,0,0,9800
143235100500000,SW 418,AG LAND,38000,0,38000,0,0,38000
143235200100000,SW 418,AG DWELLING,17700,0,17700,108200,0,125900
143235200200000,CENTRALLY ASSESSED,OTHER,0,0,0,0,0,0
143237600200000,WAREHOUSE,COMMERCIAL,0,315100,315100,0,863000,1178100
143237600500000,VACANT LAND,INDUSTRIAL,0,149000,149000,0,0,149000
143237600600000,VACANT LAND,COMMERCIAL,0,3400,3400,0,0,3400
143237600700000,WAREHOUSE,EXEMPT,0,275600,275600,0,914100,1189700
143237600900000,VACANT LAND,COMMERCIAL,0,115000,115000,0,0,115000
143240100100000,EQUIPMENT MFG;INDUST,INDUSTRIAL,0,1022300,1022300,0,2972300,3994600
143242600100000,EQUIPMENT MFG;INDUST,INDUSTRIAL,0,939500,939500,0,1328700,2268200
143242600200000,CENTRALLY ASSESSED,OTHER,0,0,0,0,0,0
143242600300000,VACANT LAND,INDUSTRIAL,0,59400,59400,0,0,59400
143242600400000,VACANT LAND,INDUSTRIAL,0,238800,238800,0,0,238800
143242600500000,CENTRALLY ASSESSED,OTHER,0,0,0,0,0,0
143242600600000,WAREHOUSE,COMMERCIAL,0,55000,55000,0,47200,102200
143242600700000,OFFICE,COMMERCIAL,0,127000,127000,0,314600,441600
143242600900000,ANTENNAS/TOWERS(BLL),COMMERCIAL,0,182700,182700,0,349200,531900
143245100100000,WAREHOUSE,COMMERCIAL,0,658400,658400,0,1480600,2139000
143245100200000,WAREHOUSE,COMMERCIAL,0,200000,200000,0,592200,792200
143245100300000,OFFICE,COMMERCIAL,0,49100,49100,0,122700,171800
143245100400000,VACANT LAND,COMMERCIAL,0,35900,35900,0,0,35900
143245100500000,WAREHOUSE,COMMERCIAL,0,28700,28700,0,69800,98500
143245200100000,WAREHOUSE,COMMERCIAL,0,92800,92800,0,449800,542600
143245200200000,ANTENNAS/TOWERS(BLL),COMMERCIAL,0,83100,83100,0,451100,534200
143245200300000,WAREHOUSE,COMMERCIAL,0,99600,99600,0,352100,451700
143245200400000,WAREHOUSE,COMMERCIAL,0,66000,66000,0,342000,408000
143245200500000,FLAT PARKING,COMMERCIAL,0,28700,28700,0,1800,30500
143245200600000,SHOP,COMMERCIAL,0,117100,117100,0,304500,421600
143245200700000,OFFICE,COMMERCIAL,0,75800,75800,0,66200,142000
143245300100000,WAREHOUSE,COMMERCIAL,0,559600,559600,0,1393300,1952900
143245300200000,OFFICE,COMMERCIAL,0,219000,219000,0,563400,782400
143245400100000,WAREHOUSE,COMMERCIAL,0,252600,252600,0,266900,519500
143245400400000,WAREHOUSE,COMMERCIAL,0,50000,50000,0,154600,204600
143245400500000,AUTO REPAIR/SALES,COMMERCIAL,0,42200,42200,0,106500,148700
143245400600000,WAREHOUSE,COMMERCIAL,0,287000,287000,0,283600,570600
143245400700000,WAREHOUSE,COMMERCIAL,0,142000,142000,0,314200,456200
143245400800000,FOOD GRADE;INDUST,INDUSTRIAL,0,92000,92000,0,366700,458700
143247600100000,AUTO REPAIR/SALES,COMMERCIAL,0,932800,932800,0,2062200,2995000
143247600200000,VACANT LAND,COMMERCIAL,0,288300,288300,0,0,288300
143247600300000,SHOP,COMMERCIAL,0,327000,327000,0,939800,1266800
143247700100000,AUTO REPAIR/SALES,COMMERCIAL,0,138600,138600,0,52200,190800
143247700200000,AUTO REPAIR/SALES,COMMERCIAL,0,107300,107300,0,304000,411300
143247700300000,VACANT LAND,COMMERCIAL,0,65800,65800,0,0,65800
143247700400000,AUTO REPAIR/SALES,COMMERCIAL,0,321300,321300,0,601700,923000
143247700700000,FLAT PARKING,COMMERCIAL,0,63100,63100,0,15300,78400
143247700800000,WAREHOUSE,INDUSTRIAL,0,185000,185000,0,765300,950300
143247800100000,SHOP,COMMERCIAL,0,103000,103000,0,346100,449100
143247800200000,WAREHOUSE,COMMERCIAL,0,103000,103000,0,52300,155300
143247800300000,VACANT LAND,COMMERCIAL,0,56000,56000,0,0,56000
143247800400000,SHOP,COMMERCIAL,0,40400,40400,0,74200,114600
143247800500000,VACANT LAND,COMMERCIAL,0,123000,123000,0,0,123000
143247800600000,VACANT LAND,COMMERCIAL,0,120000,120000,0,0,120000
143247800700000,FLAT PARKING,COMMERCIAL,0,69000,69000,0,2700,71700
143247800800000,AUTO REPAIR/SALES,COMMERCIAL,0,405000,405000,0,838100,1243100
143310100100000,CITY PROPERTY,EXEMPT,0,0,0,0,0,0
143310100200000,CITY PROPERTY,EXEMPT,0,0,0,0,0,0
143310100300000,CITY PROPERTY,EXEMPT,0,0,0,0,0,0
143310100400000,CITY PROPERTY,EXEMPT,0,0,0,0,0,0
143310100500000,CITY PROPERTY,EXEMPT,0,0,0,0,0,0
143310100600000,CITY PROPERTY,EXEMPT,0,0,0,0,0,0
143310100700000,SW 402,RESIDENTIAL,20000,0,20000,0,0,20000
143310200100000,CITY PROPERTY,EXEMPT,0,0,0,0,0,0
143310200200000,CITY PROPERTY,EXEMPT,0,0,0,0,0,0
143310200300000,CITY PROPERTY,EXEMPT,0,0,0,0,0,0
143310200400000,CITY PROPERTY,EXEMPT,0,0,0,0,0,0
143310200500000,CITY PROPERTY,EXEMPT,0,0,0,0,0,0
143310200600000,CITY PROPERTY,EXEMPT,0,0,0,0,0,0
143310300100000,SW 412,RESIDENTIAL,19300,0,19300,101200,0,120500
143310300200000,SW 412,RESIDENTIAL,19300,0,19300,41500,0,60800
143310300300000,SW 412,RESIDENTIAL,19300,0,19300,122300,0,141600
143310300400000,SW 412,RESIDENTIAL,19300,0,19300,128800,0,148100
143310300500000,SW 412,RESIDENTIAL,19300,0,19300,130000,0,149300
143310300600000,SW 412,RESIDENTIAL,19300,0,19300,123700,0,143000
143310300700000,CITY PROPERTY,EXEMPT,0,0,0,0,0,0
143310300800000,SW 412,RESIDENTIAL,9600,0,9600,44000,0,53600
143310300900000,SW 412,RESIDENTIAL,22000,0,22000,65700,0,87700
143310301000000,SW 412,RESIDENTIAL,23400,0,23400,49100,0,72500
143310301100000,SW 412,RESIDENTIAL,14900,0,14900,81400,0,96300
143310301200000,SW 412,RESIDENTIAL,14900,0,14900,83300,0,98200
143310301300000,SW 412,RESIDENTIAL,17000,0,17000,108700,0,125700
143310301400000,SW 412,RESIDENTIAL,23400,0,23400,53700,0,77100
143310301500000,SW 412,RESIDENTIAL,23400,0,23400,51800,0,75200
143310301600000,SW 412,RESIDENTIAL,23400,0,23400,66800,0,90200
143310301700000,SW 412,RESIDENTIAL,23400,0,23400,78600,0,102000
143310301800000,SW 412,RESIDENTIAL,23400,0,23400,100500,0,123900
143310400100000,SW 402,RESIDENTIAL,17200,0,17200,68200,0,85400
143310400200000,SW 402,RESIDENTIAL,14000,0,14000,23700,0,37700
143310400300000,SW 402,RESIDENTIAL,24900,0,24900,64700,0,89600
143310400400000,SW 402,RESIDENTIAL,30000,0,30000,72000,0,102000
143310400500000,SW 402,RESIDENTIAL,29100,0,29100,58900,0,88000
143310400600000,SW 402,RESIDENTIAL,12900,0,12900,49100,0,62000
143310400700000,SW 402,RESIDENTIAL,11700,0,11700,63100,0,74800
143310500100000,FLAT PARKING,COMMERCIAL,0,39300,39300,0,5500,44800
143310500200000,SW 412,RESIDENTIAL,20900,0,20900,57100,0,78000
143310500300000,BRANCH BANK/CU,COMMERCIAL,0,45400,45400,0,38600,84000
143310600100000,SW 412,RESIDENTIAL,18300,0,18300,85800,0,104100
143310600200000,SW 412,RESIDENTIAL,14600,0,14600,97800,0,112400
143310600300000,SW 412,RESIDENTIAL,14000,0,14000,87100,0,101100
143310600400000,SW 412,RESIDENTIAL,14000,0,14000,102900,0,116900
143310600500000,SW 412,RESIDENTIAL,14000,0,14000,93500,0,107500
143310600600000,SW 412,RESIDENTIAL,14000,0,14000,87800,0,101800
143310600700000,SW 412,RESIDENTIAL,14000,0,14000,105100,0,119100
143310600800000,SW 412,RESIDENTIAL,14000,0,14000,93500,0,107500
143310600900000,SW 412,RESIDENTIAL,14000,0,14000,85200,0,99200
143310601000000,SW 412,RESIDENTIAL,19900,0,19900,86800,0,106700
143310601100000,SW 412,RESIDENTIAL,16900,0,16900,64600,0,81500
143310601200000,SW 412,RESIDENTIAL,17000,0,17000,80200,0,97200
143310601300000,SW 412,RESIDENTIAL,17000,0,17000,68800,0,85800
143310601400000,SW 412,RESIDENTIAL,17000,0,17000,75100,0,92100
143310601500000,SW 412,RESIDENTIAL,17000,0,17000,72200,0,89200
143310601600000,SW 412,RESIDENTIAL,17000,0,17000,72900,0,89900
143310601700000,SW 412,RESIDENTIAL,17000,0,17000,57600,0,74600
143310601800000,SW 412,RESIDENTIAL,20000,0,20000,94300,0,114300
143310601900000,SW 412,RESIDENTIAL,17000,0,17000,121100,0,138100
143310602000000,SW 412,RESIDENTIAL,17000,0,17000,64200,0,81200
143310602100000,SW 412,RESIDENTIAL,19200,0,19200,85900,0,105100
143310700100000,SCHOOL,EXEMPT,0,388800,388800,0,571400,960200
143310700200000,CONVERSION-NW/SW,MULTI-RES,7700,0,7700,33000,0,40700
143310700300000,SW 412,RESIDENTIAL,17300,0,17300,35100,0,52400
143310700400000,SW 412,RESIDENTIAL,15000,0,15000,44700,0,59700
143310700500000,SW 412,RESIDENTIAL,18400,0,18400,55600,0,74000
143310700600000,SW 412,RESIDENTIAL,20800,0,20800,107500,0,128300
143310700700000,SW 412,RESIDENTIAL,20800,0,20800,48300,0,69100
143310700800000,SW 412,RESIDENTIAL,20800,0,20800,71100,0,91900
143310700900000,SW 412,RESIDENTIAL,20800,0,20800,52200,0,73000
143310701000000,SW 412,RESIDENTIAL,20800,0,20800,116200,0,137000
143310701100000,SW 412,RESIDENTIAL,20800,0,20800,119900,0,140700
143310800100000,SW 412,RESIDENTIAL,23300,0,23300,65600,0,88900
143310800200000,SW 412,RESIDENTIAL,23300,0,23300,103400,0,126700
143310800300000,SW 412,RESIDENTIAL,20800,0,20800,67700,0,88500
143310800400000,SW 412,RESIDENTIAL,16700,0,16700,82700,0,99400
143310800500000,SW 412,RESIDENTIAL,22700,0,22700,51400,0,74100
143310800600000,SW 412,RESIDENTIAL,21300,0,21300,60800,0,82100
143310800700000,SW 412,RESIDENTIAL,21300,0,21300,75400,0,96700
143310800800000,SW 412,RESIDENTIAL,21300,0,21300,88300,0,109600
143310800900000,SW 412,RESIDENTIAL,21300,0,21300,103100,0,124400
143310801000000,SW 412,RESIDENTIAL,21300,0,21300,61700,0,83000
143310801100000,SW 412,RESIDENTIAL,21300,0,21300,76700,0,98000
143310801200000,SW 412,RESIDENTIAL,20800,0,20800,78200,0,99000
143310801300000,SW 412,RESIDENTIAL,20800,0,20800,70500,0,91300
143310801400000,SW 412,RESIDENTIAL,20800,0,20800,84000,0,104800
143310801500000,SW 412,RESIDENTIAL,20800,0,20800,78100,0,98900
143310801600000,SW 412,RESIDENTIAL,20800,0,20800,101900,0,122700
143310801700000,SW 412,RESIDENTIAL,17900,0,17900,69900,0,87800
143310801800000,SW 412,RESIDENTIAL,15400,0,15400,0,0,15400
143310801900000,SW 412,RESIDENTIAL,12500,0,12500,0,0,12500
143310900100000,SW 412,RESIDENTIAL,16600,0,16600,110900,0,127500
143310900200000,SW 412,RESIDENTIAL,16800,0,16800,106100,0,122900
143310900300000,SW 412,RESIDENTIAL,17000,0,17000,100600,0,117600
143310900400000,SW 412,RESIDENTIAL,17000,0,17000,0,0,17000
143310900500000,SW 412,RESIDENTIAL,17000,0,17000,102700,0,119700
143310900600000,SW 412,RESIDENTIAL,17000,0,17000,74800,0,91800
143310900700000,SW 412,RESIDENTIAL,25000,0,25000,107100,0,132100
143310900800000,SW 412,RESIDENTIAL,21800,0,21800,69600,0,91400
143310900900000,SW 412,RESIDENTIAL,17500,0,17500,57400,0,74900
143310901000000,SW 412,RESIDENTIAL,17500,0,17500,82500,0,100000
143310901100000,SW 412,RESIDENTIAL,17500,0,17500,55600,0,73100
143310901200000,SW 412,RESIDENTIAL,17500,0,17500,82400,0,99900
143310901300000,SW 412,RESIDENTIAL,17500,0,17500,90400,0,107900
143310901400000,SW 412,RESIDENTIAL,17500,0,17500,88800,0,106300
143310901500000,SW 412,RESIDENTIAL,26500,0,26500,72800,0,99300
143310901600000,SW 412,RESIDENTIAL,23300,0,23300,97000,0,120300
143310901700000,SW 412,RESIDENTIAL,14400,0,14400,60400,0,74800
143310901800000,SW 412,RESIDENTIAL,14400,0,14400,31600,0,46000
143310901900000,SW 412,RESIDENTIAL,14400,0,14400,89400,0,103800
143310902000000,SW 412,RESIDENTIAL,14400,0,14400,77400,0,91800
143310902100000,SW 412,RESIDENTIAL,14400,0,14400,82500,0,96900
143310902200000,SW 412,RESIDENTIAL,14400,0,14400,91100,0,105500
143310902300000,SW 412,RESIDENTIAL,14400,0,14400,79100,0,93500
143310902400000,SW 412,RESIDENTIAL,14400,0,14400,90700,0,105100
143311000100000,CITY PROPERTY,EXEMPT,0,0,0,0,0,0
143311000200000,SW 412,RESIDENTIAL,22900,0,22900,57800,0,80700
143311000300000,SW 412,RESIDENTIAL,27000,0,27000,129400,0,156400
143311000400000,SW 412,RESIDENTIAL,22900,0,22900,57900,0,80800
143311000500000,SW 412,RESIDENTIAL,22900,0,22900,88300,0,111200
143311000600000,SW 412,RESIDENTIAL,22900,0,22900,90200,0,113100
143311000700000,SW 412,RESIDENTIAL,22900,0,22900,98500,0,121400
143311000800000,SW 412,RESIDENTIAL,22900,0,22900,67300,0,90200
143311000900000,SW 412,RESIDENTIAL,22900,0,22900,74700,0,97600
143311001000000,SW 412,RESIDENTIAL,22100,0,22100,70300,0,92400
143311100100000,SW 412,RESIDENTIAL,22900,0,22900,64500,0,87400
143311100200000,SW 412,RESIDENTIAL,21300,0,21300,95500,0,116800
143311100300000,SW 412,RESIDENTIAL,21300,0,21300,74500,0,95800
143311100400000,SW 412,RESIDENTIAL,21300,0,21300,65400,0,86700
143311100500000,SW 412,RESIDENTIAL,21300,0,21300,58600,0,79900
143311100600000,SW 412,RESIDENTIAL,21300,0,21300,97600,0,118900
143311100700000,SW 412,RESIDENTIAL,21300,0,21300,72300,0,93600
143311100800000,SW 412,RESIDENTIAL,21300,0,21300,65700,0,87000
143311100900000,SW 412,RESIDENTIAL,21300,0,21300,85300,0,106600
143311101000000,SW 412,RESIDENTIAL,21300,0,21300,66100,0,87400
143311101100000,SW 412,RESIDENTIAL,18100,0,18100,89000,0,107100
143311101400000,SW 412,RESIDENTIAL,22900,0,22900,72300,0,95200
143311101500000,SW 412,RESIDENTIAL,22900,0,22900,68200,0,91100
143311101600000,SW 412,RESIDENTIAL,22900,0,22900,95900,0,118800
143311101700000,SW 412,RESIDENTIAL,22900,0,22900,87300,0,110200
143311101800000,SW 412,RESIDENTIAL,22900,0,22900,63200,0,86100
143311101900000,SW 412,RESIDENTIAL,22900,0,22900,73900,0,96800
143311102000000,SW 412,RESIDENTIAL,33700,0,33700,132700,0,166400
143312600100000,BRANCH BANK/CU,COMMERCIAL,0,34700,34700,0,358100,392800
143312700100000,CITY PROPERTY,EXEMPT,0,0,0,0,0,0
143312700200000,CITY PROPERTY,EXEMPT,0,0,0,0,0,0
143312700500000,SW 402,RESIDENTIAL,21200,0,21200,43900,0,65100
143312700600000,SW 402,RESIDENTIAL,20200,0,20200,88300,0,108500
143312700700000,SW 402,RESIDENTIAL,17100,0,17100,60600,0,77700
143312700800000,SW 402,RESIDENTIAL,21200,0,21200,87600,0,108800
143312800100000,SW 402,RESIDENTIAL,16800,0,16800,65700,0,82500
143312800200000,SW 402,RESIDENTIAL,17400,0,17400,28800,0,46200
143312800300000,SW 402,RESIDENTIAL,20900,0,20900,67000,0,87900
143312800400000,SW 402,RESIDENTIAL,21700,0,21700,38400,0,60100
143312800500000,SW 402,RESIDENTIAL,18900,0,18900,58700,0,77600
143312800600000,SW 402,RESIDENTIAL,12600,0,12600,47300,0,59900
143312800700000,SW 402,RESIDENTIAL,11300,0,11300,44900,0,56200
143312800800000,SW 402,RESIDENTIAL,11300,0,11300,58200,0,69500
143312800900000,SW 402,RESIDENTIAL,17700,0,17700,164600,0,182300
143312801000000,SW 402,RESIDENTIAL,9300,0,9300,47100,0,56400
143312801100000,SW 402,RESIDENTIAL,24000,0,24000,56500,0,80500
143312801200000,SW 402,RESIDENTIAL,24000,0,24000,89400,0,113400
143312801300000,SW 402,RESIDENTIAL,24000,0,24000,61400,0,85400
143312801400000,SW 402,RESIDENTIAL,24000,0,24000,58200,0,82200
143312900100000,SW 402,RESIDENTIAL,24000,0,24000,68700,0,92700
143312900200000,SW 402,RESIDENTIAL,24000,0,24000,55700,0,79700
143312900300000,CHURCH,EXEMPT,0,33600,33600,0,45600,79200
143312900700000,SW 402,RESIDENTIAL,12500,0,12500,0,0,12500
143312900800000,SW 402,RESIDENTIAL,18700,0,18700,0,0,18700
143312901100000,SW 402,RESIDENTIAL,24000,0,24000,81400,0,105400
143312901200000,SW 402,RESIDENTIAL,12000,0,12000,61400,0,73400
143312901300000,SW 402,RESIDENTIAL,12000,0,12000,61700,0,73700
143312901400000,SW 402,RESIDENTIAL,24000,0,24000,69800,0,93800
143312901500000,RESTAURANT,COMMERCIAL,0,98300,98300,0,144100,242400
143312901600000,SW 402,RESIDENTIAL,22300,0,22300,0,0,22300
143312901700000,SW 402,RESIDENTIAL,100,0,100,0,0,100
143313000100000,SW 402,RESIDENTIAL,16000,0,16000,137600,0,153600
143313000200000,SW 402,RESIDENTIAL,16100,0,16100,68100,0,84200
143313000300000,SW 402,RESIDENTIAL,6000,0,6000,0,0,6000
143313000400000,SW 402,RESIDENTIAL,25100,0,25100,0,0,25100
143313100100000,FLAT PARKING,COMMERCIAL,0,30200,30200,0,3800,34000
143313100200000,FLAT PARKING,COMMERCIAL,0,30200,30200,0,6700,36900
143313100300000,SW 412,RESIDENTIAL,21000,0,21000,69700,0,90700
143313100400000,SW 412,RESIDENTIAL,21000,0,21000,135800,0,156800
143313100500000,SW 412,RESIDENTIAL,21000,0,21000,67800,0,88800
143313100600000,SW 412,RESIDENTIAL,21300,0,21300,72700,0,94000
143313100700000,SW 412,RESIDENTIAL,21300,0,21300,38000,0,59300
143313100800000,SW 412,RESIDENTIAL,21300,0,21300,46300,0,67600
143313100900000,SW 412,RESIDENTIAL,21300,0,21300,76600,0,97900
143313101000000,SW 412,RESIDENTIAL,21300,0,21300,63900,0,85200
143313101100000,SW 412,RESIDENTIAL,21300,0,21300,88000,0,109300
143313200100000,APARTMENT,RESIDENTIAL,16200,0,16200,119300,0,135500
143313200200000,APARTMENT,RESIDENTIAL,16200,0,16200,119900,0,136100
143313200300000,SW 412,RESIDENTIAL,5000,0,5000,0,0,5000
143313200400000,WAREHOUSE,COMMERCIAL,0,12600,12600,0,61800,74400
143313200500000,SW 412,RESIDENTIAL,15800,0,15800,60600,0,76400
143313200600000,SW 412,RESIDENTIAL,16800,0,16800,41800,0,58600
143313200700000,SW 412,RESIDENTIAL,11900,0,11900,50300,0,62200
143313200800000,CITY PROPERTY,EXEMPT,0,0,0,0,0,0
143313200900000,SW 412,RESIDENTIAL,9000,0,9000,31300,0,40300
143313201000000,SW 412,RESIDENTIAL,11300,0,11300,59300,0,70600
143313201100000,SW 412,RESIDENTIAL,13200,0,13200,61200,0,74400
143313201400000,SW 412,RESIDENTIAL,17000,0,17000,88300,0,105300
143313201500000,SW 412,RESIDENTIAL,17000,0,17000,77200,0,94200
143313201600000,SW 412,RESIDENTIAL,21700,0,21700,91900,0,113600
143313201700000,SW 412,RESIDENTIAL,23800,0,23800,141400,0,165200
143313300100000,SW 412,RESIDENTIAL,21000,0,21000,88900,0,109900
143313300200000,SW 412,RESIDENTIAL,21000,0,21000,72600,0,93600
143313300300000,SW 412,RESIDENTIAL,21000,0,21000,90800,0,111800
143313300400000,SW 412,RESIDENTIAL,21000,0,21000,76800,0,97800
143313300500000,SW 412,RESIDENTIAL,21000,0,21000,121500,0,142500
143313300600000,BARS/LOUNGE,COMMERCIAL,0,30800,30800,0,161700,192500
143313300700000,FLAT PARKING,COMMERCIAL,0,25100,25100,0,7600,32700
143313300800000,FLAT PARKING,COMMERCIAL,0,33600,33600,0,8400,42000
143313300900000,GROCERY STORE,COMMERCIAL,0,135800,135800,0,447700,583500
143313301000000,SW 412,RESIDENTIAL,10000,0,10000,0,0,10000
143313301100000,SW 412,RESIDENTIAL,23800,0,23800,23400,0,47200
143313301200000,SW 412,RESIDENTIAL,17000,0,17000,77500,0,94500
143313301300000,SW 412,RESIDENTIAL,17000,0,17000,39700,0,56700
143313301400000,SW 412,RESIDENTIAL,17000,0,17000,89000,0,106000
143313400100000,SW 412,RESIDENTIAL,23400,0,23400,82300,0,105700
143313400200000,SW 412,RESIDENTIAL,19800,0,19800,69500,0,89300
143313400300000,SW 412,RESIDENTIAL,23000,0,23000,84900,0,107900
143313400400000,SW 412,RESIDENTIAL,17500,0,17500,78000,0,95500
143313400500000,SW 412,RESIDENTIAL,17500,0,17500,57200,0,74700
143313400600000,SW 412,RESIDENTIAL,21300,0,21300,59700,0,81000
143313400700000,SW 412,RESIDENTIAL,21300,0,21300,74300,0,95600
143313400800000,SW 412,RESIDENTIAL,21300,0,21300,81500,0,102800
143313400900000,SW 412,RESIDENTIAL,21300,0,21300,117900,0,139200
143313500100000,SW 412,RESIDENTIAL,20000,0,20000,95100,0,115100
143313500200000,SW 412,RESIDENTIAL,18300,0,18300,103900,0,122200
143313600100000,SW 412,RESIDENTIAL,18400,0,18400,74500,0,92900
143313600200000,SW 412,RESIDENTIAL,13200,0,13200,113600,0,126800
143313600300000,SW 412,RESIDENTIAL,12200,0,12200,68700,0,80900
143313600400000,SW 412,RESIDENTIAL,22200,0,22200,75400,0,97600
143313700100000,SW 412,RESIDENTIAL,17600,0,17600,92800,0,110400
143313700200000,SW 412,RESIDENTIAL,9200,0,9200,69200,0,78400
143313700300000,SW 412,RESIDENTIAL,9200,0,9200,63100,0,72300
143313700400000,SW 412,RESIDENTIAL,11500,0,11500,54000,0,65500
143313700500000,SW 412,RESIDENTIAL,17600,0,17600,82700,0,100300
143313700600000,SW 412,RESIDENTIAL,21300,0,21300,102600,0,123900
143313700700000,SW 412,RESIDENTIAL,21300,0,21300,80200,0,101500
143313700800000,SW 412,RESIDENTIAL,21300,0,21300,86900,0,108200
143313700900000,SW 412,RESIDENTIAL,21300,0,21300,99500,0,120800
143313701000000,SW 412,RESIDENTIAL,21300,0,21300,82000,0,103300
143313701100000,SW 412,RESIDENTIAL,21300,0,21300,71200,0,92500
143313701200000,SW 412,RESIDENTIAL,19700,0,19700,98700,0,118400
143313701300000,SW 412,RESIDENTIAL,19700,0,19700,79200,0,98900
143313701400000,SW 412,RESIDENTIAL,19700,0,19700,85800,0,105500
143313701500000,SW 412,RESIDENTIAL,17800,0,17800,73800,0,91600
143313701600000,SW 412,RESIDENTIAL,21300,0,21300,69600,0,90900
143313701700000,SW 412,RESIDENTIAL,21300,0,21300,63800,0,85100
143313701800000,SW 412,RESIDENTIAL,21300,0,21300,73800,0,95100
143313701900000,SW 412,RESIDENTIAL,25000,0,25000,68800,0,93800
143313702000000,SW 412,RESIDENTIAL,21300,0,21300,75100,0,96400
143313702100000,SW 412,RESIDENTIAL,21300,0,21300,80100,0,101400
143313702200000,SW 412,RESIDENTIAL,21300,0,21300,57000,0,78300
143313702300000,SW 412,RESIDENTIAL,17000,0,17000,80500,0,97500
143313800100000,SW 412,RESIDENTIAL,14000,0,14000,118900,0,132900
143313800200000,SW 412,RESIDENTIAL,14000,0,14000,84400,0,98400
143313800300000,SW 412,RESIDENTIAL,19600,0,19600,0,0,19600
143313900100000,SW 412,RESIDENTIAL,17000,0,17000,92800,0,109800
143313900200000,SW 412,RESIDENTIAL,17000,0,17000,94600,0,111600
143313900300000,SW 412,RESIDENTIAL,17000,0,17000,74400,0,91400
143313900400000,SW 412,RESIDENTIAL,17000,0,17000,99300,0,116300
143313900500000,SW 412,RESIDENTIAL,21300,0,21300,67000,0,88300
143313900600000,SW 412,RESIDENTIAL,21300,0,21300,77100,0,98400
143313900700000,SW 412,RESIDENTIAL,25500,0,25500,91300,0,116800
143314000100000,SW 412,RESIDENTIAL,22300,0,22300,79000,0,101300
143314000200000,SW 412,RESIDENTIAL,21000,0,21000,97600,0,118600
143314000300000,SW 412,RESIDENTIAL,17000,0,17000,57800,0,74800
143314000400000,SW 412,RESIDENTIAL,17000,0,17000,62700,0,79700
143314000500000,SW 412,RESIDENTIAL,17000,0,17000,70200,0,87200
143314000600000,SW 412,RESIDENTIAL,17000,0,17000,72600,0,89600
143314000700000,SW 412,RESIDENTIAL,17000,0,17000,0,0,17000
143314000800000,SW 412,RESIDENTIAL,17000,0,17000,53500,0,70500
143314000900000,SW 412,RESIDENTIAL,17000,0,17000,73200,0,90200
143314001000000,SW 412,RESIDENTIAL,17000,0,17000,71700,0,88700
143314001100000,SW 412,RESIDENTIAL,17000,0,17000,87200,0,104200
143314001200000,SW 412,RESIDENTIAL,17000,0,17000,91000,0,108000
143314001300000,SW 412,RESIDENTIAL,17000,0,17000,37600,0,54600
143314001400000,SW 412,RESIDENTIAL,17000,0,17000,80500,0,97500
143314001500000,SW 412,RESIDENTIAL,17000,0,17000,62200,0,79200
143314001600000,SW 412,RESIDENTIAL,17000,0,17000,86300,0,103300
143314100100000,SW 412,RESIDENTIAL,19100,0,19100,70900,0,90000
143314100200000,SW 412,RESIDENTIAL,17000,0,17000,80800,0,97800
143314100300000,SW 412,RESIDENTIAL,17000,0,17000,59300,0,76300
143314100400000,SW 412,RESIDENTIAL,17000,0,17000,69800,0,86800
143314100500000,SW 412,RESIDENTIAL,34000,0,34000,37000,0,71000
143314100600000,SW 412,RESIDENTIAL,17000,0,17000,90500,0,107500
143314100700000,SW 412,RESIDENTIAL,17000,0,17000,72700,0,89700
143314100800000,WAREHOUSE,COMMERCIAL,0,11200,11200,0,81500,92700
143314100900000,SW 412,RESIDENTIAL,17000,0,17000,106800,0,123800
143314101000000,SW 412,RESIDENTIAL,17000,0,17000,72100,0,89100
143314101100000,SW 412,RESIDENTIAL,17000,0,17000,66900,0,83900
143314101200000,SW 412,RESIDENTIAL,17000,0,17000,45900,0,62900
143314101300000,SW 412,RESIDENTIAL,17000,0,17000,127300,0,144300
143314101400000,SW 412,RESIDENTIAL,17000,0,17000,84400,0,101400
143314101500000,SW 412,RESIDENTIAL,14900,0,14900,72600,0,87500
143315100100000,SW 412,RESIDENTIAL,19400,0,19400,82100,0,101500
143315100200000,SW 412,RESIDENTIAL,18700,0,18700,69700,0,88400
143315100300000,SW 412,RESIDENTIAL,29200,0,29200,83000,0,112200
143315100400000,SW 412,RESIDENTIAL,29200,0,29200,62200,0,91400
143315100500000,SW 412,RESIDENTIAL,29500,0,29500,96000,0,125500
143315100600000,SW 412,RESIDENTIAL,29500,0,29500,87200,0,116700
143315100700000,SW 412,RESIDENTIAL,28300,0,28300,91400,0,119700
143315100800000,SW 412,RESIDENTIAL,28300,0,28300,70800,0,99100
143315100900000,SW 412,RESIDENTIAL,22900,0,22900,86400,0,109300
143315101000000,SW 412,RESIDENTIAL,22900,0,22900,74000,0,96900
143315101100000,SW 412,RESIDENTIAL,31200,0,31200,105800,0,137000
143315101200000,SW 412,RESIDENTIAL,23800,0,23800,69100,0,92900
143315101300000,SW 412,RESIDENTIAL,23800,0,23800,56100,0,79900
143315101400000,SW 412,RESIDENTIAL,24000,0,24000,62700,0,86700
143315101500000,SW 412,RESIDENTIAL,24000,0,24000,67600,0,91600
143315101600000,SW 412,RESIDENTIAL,22700,0,22700,99000,0,121700
143315101700000,SW 412,RESIDENTIAL,22700,0,22700,103900,0,126600
143315101800000,SW 412,RESIDENTIAL,22700,0,22700,121600,0,144300
143315101900000,SW 412,RESIDENTIAL,15100,0,15100,64000,0,79100
143315200100000,SW 412,RESIDENTIAL,20800,0,20800,74500,0,95300
143315200200000,SW 412,RESIDENTIAL,20400,0,20400,74500,0,94900
143315200300000,SW 412,RESIDENTIAL,28900,0,28900,60200,0,89100
143315200400000,SW 412,RESIDENTIAL,28900,0,28900,99500,0,128400
143315200500000,SW 412,RESIDENTIAL,30800,0,30800,87700,0,118500
143315200600000,SW 412,RESIDENTIAL,30800,0,30800,89600,0,120400
143315200700000,SW 412,RESIDENTIAL,45300,0,45300,96500,0,141800
143315200800000,SW 412,RESIDENTIAL,25800,0,25800,92200,0,118000
143315200900000,SW 412,RESIDENTIAL,23200,0,23200,105400,0,128600
143315201000000,SW 412,RESIDENTIAL,21500,0,21500,81200,0,102700
143315201100000,SW 412,RESIDENTIAL,21500,0,21500,71300,0,92800
143315201200000,SW 412,RESIDENTIAL,21500,0,21500,98600,0,120100
143315201300000,SW 412,RESIDENTIAL,30800,0,30800,60700,0,91500
143315201400000,SW 412,RESIDENTIAL,30800,0,30800,59900,0,90700
143315201500000,SW 412,RESIDENTIAL,30800,0,30800,29300,0,60100
143315201600000,SW 412,RESIDENTIAL,29300,0,29300,87100,0,116400
143315201700000,SW 412,RESIDENTIAL,29500,0,29500,73600,0,103100
143315201800000,SW 412,RESIDENTIAL,16200,0,16200,58200,0,74400
143315201900000,SW 412,RESIDENTIAL,23600,0,23600,69700,0,93300
143315202000000,SW 412,RESIDENTIAL,30600,0,30600,116700,0,147300
143315202100000,SW 412,RESIDENTIAL,28500,0,28500,75300,0,103800
143315202200000,SW 412,RESIDENTIAL,24900,0,24900,83500,0,108400
143315202300000,SW 412,RESIDENTIAL,24900,0,24900,79200,0,104100
143315202400000,SW 412,RESIDENTIAL,24700,0,24700,68900,0,93600
143315202500000,SW 412,RESIDENTIAL,32600,0,32600,69300,0,101900
143315202600000,SW 412,RESIDENTIAL,21300,0,21300,52200,0,73500
143315202700000,SW 412,RESIDENTIAL,21300,0,21300,26700,0,48000
143315202800000,SW 412,RESIDENTIAL,21300,0,21300,80800,0,102100
143315202900000,SW 412,RESIDENTIAL,200,0,200,0,0,200
143315203000000,SW 412,RESIDENTIAL,7100,0,7100,0,0,7100
143315203100000,SW 412,RESIDENTIAL,12500,0,12500,0,0,12500
143315203300000,SW 412,RESIDENTIAL,22400,0,22400,101300,0,123700
143315203400000,SW 412,RESIDENTIAL,22400,0,22400,76300,0,98700
143315203500000,SW 412,RESIDENTIAL,22400,0,22400,79800,0,102200
143315300100000,SW 412,RESIDENTIAL,21300,0,21300,71200,0,92500
143315300200000,SW 412,RESIDENTIAL,20000,0,20000,73300,0,93300
143315300300000,SW 412,RESIDENTIAL,21000,0,21000,107100,0,128100
143315300400000,SW 412,RESIDENTIAL,20500,0,20500,76500,0,97000
143315300500000,SW 412,RESIDENTIAL,21300,0,21300,70000,0,91300
143315300600000,SW 412,RESIDENTIAL,21300,0,21300,59600,0,80900
143315300700000,SW 412,RESIDENTIAL,21300,0,21300,101300,0,122600
143315300800000,SW 412,RESIDENTIAL,21300,0,21300,89300,0,110600
143315300900000,SW 412,RESIDENTIAL,22200,0,22200,75000,0,97200
143315301000000,SW 412,RESIDENTIAL,26100,0,26100,79600,0,105700
143315301100000,SW 412,RESIDENTIAL,25600,0,25600,97600,0,123200
143315301200000,SW 412,RESIDENTIAL,26400,0,26400,106100,0,132500
143315301300000,SW 412,RESIDENTIAL,22700,0,22700,75200,0,97900
143315301400000,SW 412,RESIDENTIAL,30300,0,30300,97700,0,128000
143315301500000,SW 412,RESIDENTIAL,21300,0,21300,103900,0,125200
143315301600000,SW 412,RESIDENTIAL,21300,0,21300,71500,0,92800
143315400100000,SW 412,RESIDENTIAL,14800,0,14800,21800,0,36600
143315400200000,SW 412,RESIDENTIAL,19800,0,19800,71100,0,90900
143315400300000,SW 412,RESIDENTIAL,18600,0,18600,84500,0,103100
143315400400000,SW 412,RESIDENTIAL,19800,0,19800,78600,0,98400
143315400500000,SW 412,RESIDENTIAL,20900,0,20900,77100,0,98000
143315400600000,SW 412,RESIDENTIAL,20900,0,20900,69000,0,89900
143315400700000,SW 412,RESIDENTIAL,19800,0,19800,82800,0,102600
143315400800000,SW 412,RESIDENTIAL,18600,0,18600,80300,0,98900
143315400900000,SW 412,RESIDENTIAL,19800,0,19800,80900,0,100700
143315401000000,SW 412,RESIDENTIAL,19600,0,19600,103200,0,122800
143315401100000,SW 412,RESIDENTIAL,20200,0,20200,75100,0,95300
143315401200000,SW 412,RESIDENTIAL,19800,0,19800,73200,0,93000
143315401300000,SW 412,RESIDENTIAL,19800,0,19800,74400,0,94200
143315401400000,SW 412,RESIDENTIAL,19800,0,19800,72000,0,91800
143315401500000,SW 412,RESIDENTIAL,19800,0,19800,89100,0,108900
143315401600000,SW 412,RESIDENTIAL,19800,0,19800,100800,0,120600
143315401700000,SW 412,RESIDENTIAL,19800,0,19800,63700,0,83500
143315401800000,SW 412,RESIDENTIAL,19800,0,19800,59300,0,79100
143315401900000,SW 412,RESIDENTIAL,19800,0,19800,73900,0,93700
143315402000000,SW 412,RESIDENTIAL,19500,0,19500,78600,0,98100
143315500100000,SCHOOL,EXEMPT,0,547600,547600,0,3279400,3827000
143315500200000,SW 412,EXEMPT,0,28100,28100,0,107100,135200
143315500300000,SW 412,RESIDENTIAL,21300,0,21300,70000,0,91300
143315500400000,SW 412,RESIDENTIAL,21300,0,21300,47600,0,68900
143315500500000,SW 412,RESIDENTIAL,21300,0,21300,77300,0,98600
143315500600000,SW 412,RESIDENTIAL,21300,0,21300,89400,0,110700
143315500700000,SW 412,RESIDENTIAL,21300,0,21300,96400,0,117700
143315500800000,SW 412,RESIDENTIAL,21600,0,21600,67400,0,89000
143315500900000,SW 412,RESIDENTIAL,30700,0,30700,79700,0,110400
143315501000000,SW 412,RESIDENTIAL,16900,0,16900,121200,0,138100
143315501100000,SW 412,RESIDENTIAL,16900,0,16900,88000,0,104900
143315501200000,SW 412,RESIDENTIAL,17100,0,17100,97100,0,114200
143315501300000,SW 412,RESIDENTIAL,17100,0,17100,90000,0,107100
143315501400000,SW 412,RESIDENTIAL,17100,0,17100,85300,0,102400
143315501500000,SW 412,RESIDENTIAL,17100,0,17100,55100,0,72200
143315501600000,SW 412,RESIDENTIAL,24300,0,24300,62300,0,86600
143315501700000,SW 412,RESIDENTIAL,29900,0,29900,68900,0,98800
143315501800000,SW 412,RESIDENTIAL,18700,0,18700,59600,0,78300
143315501900000,SW 412,RESIDENTIAL,31800,0,31800,85600,0,117400
143315502000000,SW 412,RESIDENTIAL,34500,0,34500,121300,0,155800
143315502100000,VACANT LAND,EXEMPT,0,200,200,0,0,200
143315600100000,SW 412,RESIDENTIAL,21700,0,21700,122100,0,143800
143315600200000,SW 412,RESIDENTIAL,21700,0,21700,69800,0,91500
143315600300000,SW 412,RESIDENTIAL,21700,0,21700,75200,0,96900
143315600400000,SW 412,RESIDENTIAL,21700,0,21700,87800,0,109500
143315600500000,SW 412,RESIDENTIAL,21700,0,21700,75800,0,97500
143315600600000,SW 412,RESIDENTIAL,21700,0,21700,85100,0,106800
143315600700000,SW 412,RESIDENTIAL,28600,0,28600,96300,0,124900
143315600800000,SW 412,RESIDENTIAL,31900,0,31900,105300,0,137200
143315600900000,SW 412,RESIDENTIAL,18700,0,18700,49100,0,67800
143315601000000,SW 412,RESIDENTIAL,16700,0,16700,70600,0,87300
143315601100000,SW 412,RESIDENTIAL,17700,0,17700,82500,0,100200
143315601200000,SW 412,RESIDENTIAL,30900,0,30900,66900,0,97800
143315601300000,SW 412,RESIDENTIAL,23600,0,23600,77100,0,100700
143315601400000,SW 412,RESIDENTIAL,25000,0,25000,75900,0,100900
143315601500000,SW 412,RESIDENTIAL,21400,0,21400,60500,0,81900
143315601600000,SW 412,RESIDENTIAL,25000,0,25000,86100,0,111100
143315601700000,SW 412,RESIDENTIAL,19600,0,19600,79400,0,99000
143315601800000,SW 412,RESIDENTIAL,16100,0,16100,81200,0,97300
143316500500000,SW 402,RESIDENTIAL,12500,0,12500,60100,0,72600
143316500600000,CITY PROPERTY,EXEMPT,0,0,0,0,0,0
143317600100000,SW 412,RESIDENTIAL,18300,0,18300,57400,0,75700
143317600200000,SW 412,RESIDENTIAL,22000,0,22000,62000,0,84000
143317600300000,SW 412,RESIDENTIAL,25500,0,25500,80700,0,106200
143317600400000,SW 412,RESIDENTIAL,25500,0,25500,74200,0,99700
143317600500000,SW 412,RESIDENTIAL,25500,0,25500,73800,0,99300
143317600600000,SW 412,RESIDENTIAL,26000,0,26000,114700,0,140700
143317600700000,SW 412,RESIDENTIAL,26000,0,26000,82400,0,108400
143317600800000,SW 412,RESIDENTIAL,27200,0,27200,96600,0,123800
143317600900000,SW 412,RESIDENTIAL,25300,0,25300,84000,0,109300
143317601000000,SW 412,RESIDENTIAL,24100,0,24100,75600,0,99700
143317601100000,SW 412,RESIDENTIAL,25300,0,25300,91800,0,117100
143317601200000,SW 412,RESIDENTIAL,24100,0,24100,89300,0,113400
143317601300000,SW 412,RESIDENTIAL,26000,0,26000,81600,0,107600
143317601400000,SW 412,RESIDENTIAL,26000,0,26000,99200,0,125200
143317601500000,SW 412,RESIDENTIAL,24500,0,24500,90800,0,115300
143317601600000,SW 412,RESIDENTIAL,24000,0,24000,89200,0,113200
143317601700000,SW 412,RESIDENTIAL,29300,0,29300,98100,0,127400
143317601800000,SW 412,RESIDENTIAL,29000,0,29000,101900,0,130900
143317601900000,SW 412,RESIDENTIAL,29000,0,29000,104800,0,133800
143317602000000,SW 412,RESIDENTIAL,29000,0,29000,106700,0,135700
143317602100000,SW 412,RESIDENTIAL,29000,0,29000,94100,0,123100
143317602200000,SW 412,RESIDENTIAL,27300,0,27300,98900,0,126200
143317602300000,SW 412,RESIDENTIAL,25900,0,25900,114100,0,140000
143317602400000,SW 412,RESIDENTIAL,25100,0,25100,115700,0,140800
143317602500000,SW 412,RESIDENTIAL,29000,0,29000,78700,0,107700
143317602600000,SW 412,RESIDENTIAL,29000,0,29000,92000,0,121000
143317602700000,SW 412,RESIDENTIAL,29000,0,29000,88600,0,117600
143317602800000,SW 412,RESIDENTIAL,29000,0,29000,72700,0,101700
143317602900000,SW 412,RESIDENTIAL,29000,0,29000,89100,0,118100
143317603000000,SW 412,RESIDENTIAL,29000,0,29000,104100,0,133100
143317603100000,SW 412,RESIDENTIAL,29500,0,29500,121000,0,150500
143317603200000,SW 412,RESIDENTIAL,25400,0,25400,80200,0,105600
143317603300000,SW 413,RESIDENTIAL,25500,0,25500,112800,0,138300
143317603400000,SW 413,RESIDENTIAL,23900,0,23900,107000,0,130900
143317603500000,SW 413,RESIDENTIAL,25900,0,25900,84600,0,110500
143317603600000,SW 413,RESIDENTIAL,20400,0,20400,84300,0,104700
143317603700000,APARTMENT,MULTI-RES,20300,0,20300,95800,0,116100
143317603800000,APARTMENT,RESIDENTIAL,22800,0,22800,182400,0,205200
143317604000000,APARTMENT,MULTI-RES,22300,0,22300,108100,0,130400
143317604100000,APARTMENT,RESIDENTIAL,23200,0,23200,126900,0,150100
143317604200000,APARTMENT,RESIDENTIAL,48400,0,48400,308000,0,356400
143317604300000,APARTMENT,RESIDENTIAL,48100,0,48100,312600,0,360700
143317700100000,SW 412,RESIDENTIAL,25000,0,25000,56900,0,81900
143317700200000,SW 412,RESIDENTIAL,16700,0,16700,97300,0,114000
143317700300000,SW 412,RESIDENTIAL,16700,0,16700,50500,0,67200
143317700400000,SW 412,RESIDENTIAL,16700,0,16700,63600,0,80300
143317700500000,SW 412,RESIDENTIAL,16700,0,16700,35300,0,52000
143317700600000,SW 412,RESIDENTIAL,16700,0,16700,87200,0,103900
143317700700000,SW 412,RESIDENTIAL,25000,0,25000,47100,0,72100
143317700800000,SW 412,RESIDENTIAL,25000,0,25000,73400,0,98400
143317700900000,SW 412,RESIDENTIAL,16700,0,16700,58200,0,74900
143317701000000,SW 412,RESIDENTIAL,16700,0,16700,69200,0,85900
143317701100000,SW 412,RESIDENTIAL,16700,0,16700,53500,0,70200
143317701200000,SW 412,RESIDENTIAL,16700,0,16700,75000,0,91700
143317701300000,SW 412,RESIDENTIAL,16700,0,16700,77200,0,93900
143317701400000,SW 412,RESIDENTIAL,29900,0,29900,56800,0,86700
143317701500000,SW 412,RESIDENTIAL,30200,0,30200,69700,0,99900
143317701600000,SW 412,RESIDENTIAL,16700,0,16700,70000,0,86700
143317701700000,SW 412,RESIDENTIAL,16700,0,16700,58300,0,75000
143317701800000,SW 412,RESIDENTIAL,16700,0,16700,68400,0,85100
143317701900000,SW 412,RESIDENTIAL,16700,0,16700,96900,0,113600
143317702000000,SW 412,RESIDENTIAL,16700,0,16700,67900,0,84600
143317702100000,SW 412,RESIDENTIAL,16700,0,16700,59500,0,76200
143317702200000,SW 412,RESIDENTIAL,16700,0,16700,68600,0,85300
143317702300000,SW 412,RESIDENTIAL,16700,0,16700,61500,0,78200
143317702400000,SW 412,RESIDENTIAL,16700,0,16700,33600,0,50300
143317702500000,SW 412,RESIDENTIAL,16700,0,16700,74400,0,91100
143317702600000,SW 412,RESIDENTIAL,25000,0,25000,73100,0,98100
143317800200000,SW 413,RESIDENTIAL,22700,0,22700,100700,0,123400
143317800300000,SW 413,RESIDENTIAL,24600,0,24600,98900,0,123500
143317800400000,SW 413,RESIDENTIAL,22500,0,22500,74400,0,96900
143317800500000,SW 413,RESIDENTIAL,24700,0,24700,86100,0,110800
143317800600000,SW 413,RESIDENTIAL,22500,0,22500,79600,0,102100
143317800700000,SW 413,RESIDENTIAL,22500,0,22500,82000,0,104500
143317800800000,SW 413,RESIDENTIAL,24500,0,24500,88200,0,112700
143317800900000,SW 413,RESIDENTIAL,26000,0,26000,84900,0,110900
143317801000000,SW 413,RESIDENTIAL,21600,0,21600,71900,0,93500
143317801100000,GROCERY STORE,COMMERCIAL,0,709300,709300,0,4434300,5143600
143317900100000,SW 413,RESIDENTIAL,25600,0,25600,88200,0,113800
143317900200000,SW 413,RESIDENTIAL,23300,0,23300,93000,0,116300
143317900300000,SW 413,RESIDENTIAL,23300,0,23300,95600,0,118900
143317900400000,SW 413,RESIDENTIAL,23000,0,23000,79200,0,102200
143317900500000,SW 413,RESIDENTIAL,24700,0,24700,127400,0,152100
143317900600000,SW 413,RESIDENTIAL,25200,0,25200,124000,0,149200
143317900700000,SW 413,RESIDENTIAL,20200,0,20200,69000,0,89200
143317900800000,SW 413,RESIDENTIAL,20200,0,20200,87300,0,107500
143317900900000,SW 413,RESIDENTIAL,21600,0,21600,62100,0,83700
143317901000000,SW 413,RESIDENTIAL,20800,0,20800,62400,0,83200
143317901100000,SW 413,RESIDENTIAL,23800,0,23800,97200,0,121000
143317901200000,SW 413,RESIDENTIAL,22500,0,22500,93100,0,115600
143317901300000,SW 413,RESIDENTIAL,20400,0,20400,81000,0,101400
143317901400000,SW 413,RESIDENTIAL,21400,0,21400,117700,0,139100
143317901500000,SW 413,RESIDENTIAL,25700,0,25700,73000,0,98700
143317901600000,SW 413,RESIDENTIAL,22500,0,22500,81900,0,104400
143317901700000,SW 413,RESIDENTIAL,24300,0,24300,88900,0,113200
143317901800000,SW 413,RESIDENTIAL,21400,0,21400,82900,0,104300
143317904700000,APARTMENT,MULTI-RES,29600,0,29600,194300,0,223900
143317904800000,APARTMENT,RESIDENTIAL,16200,0,16200,123500,0,139700
143317904900000,APARTMENT,RESIDENTIAL,48100,0,48100,356000,0,404100
143317905000000,APARTMENT,RESIDENTIAL,47100,0,47100,354400,0,401500
143318000100000,SW 412,RESIDENTIAL,34900,0,34900,77600,0,112500
143318000200000,SW 412,RESIDENTIAL,20900,0,20900,119500,0,140400
143318000300000,SW 412,RESIDENTIAL,19100,0,19100,75200,0,94300
143318000400000,SW 412,RESIDENTIAL,19100,0,19100,114500,0,133600
143318000500000,SW 412,RESIDENTIAL,19100,0,19100,71500,0,90600
143318000600000,SW 412,RESIDENTIAL,21300,0,21300,54600,0,75900
143318000700000,SW 412,RESIDENTIAL,21300,0,21300,68100,0,89400
143318000800000,SW 412,RESIDENTIAL,21300,0,21300,99300,0,120600
143318000900000,SW 412,RESIDENTIAL,21300,0,21300,72900,0,94200
143318001000000,SW 412,RESIDENTIAL,21300,0,21300,71600,0,92900
143318001100000,SW 412,RESIDENTIAL,20400,0,20400,71300,0,91700
143318001200000,SW 412,RESIDENTIAL,21900,0,21900,83600,0,105500
143318001300000,SW 412,RESIDENTIAL,25500,0,25500,89800,0,115300
143318001400000,SW 412,RESIDENTIAL,25500,0,25500,89300,0,114800
143318001500000,SW 412,RESIDENTIAL,22900,0,22900,108800,0,131700
143318001600000,SW 412,RESIDENTIAL,21300,0,21300,61400,0,82700
143318001700000,SW 412,RESIDENTIAL,21300,0,21300,74800,0,96100
143318001800000,SW 412,RESIDENTIAL,21300,0,21300,103600,0,124900
143318001900000,SW 412,RESIDENTIAL,21300,0,21300,85500,0,106800
143318002000000,SW 412,RESIDENTIAL,21300,0,21300,83200,0,104500
143318002100000,SW 412,RESIDENTIAL,32300,0,32300,116800,0,149100
143320100100000,SW 402,RESIDENTIAL,20400,0,20400,50300,0,70700
143320100200000,SW 402,RESIDENTIAL,20000,0,20000,72800,0,92800
143320100300000,SW 402,RESIDENTIAL,20000,0,20000,67400,0,87400
143320100400000,SW 402,RESIDENTIAL,20000,0,20000,72800,0,92800
143320100500000,SW 402,RESIDENTIAL,20000,0,20000,66900,0,86900
143320100600000,SW 402,RESIDENTIAL,20400,0,20400,53300,0,73700
143320100700000,SW 402,RESIDENTIAL,20400,0,20400,65700,0,86100
143320100800000,SW 402,RESIDENTIAL,20400,0,20400,89200,0,109600
143320200100000,SW 402,RESIDENTIAL,20000,0,20000,62500,0,82500
143320200200000,SW 402,RESIDENTIAL,12700,0,12700,54600,0,67300
143320200300000,SW 402,RESIDENTIAL,12000,0,12000,47600,0,59600
143320200400000,SW 402,RESIDENTIAL,12400,0,12400,48600,0,61000
143320200500000,SW 402,RESIDENTIAL,13300,0,13300,54200,0,67500
143320200600000,SW 402,RESIDENTIAL,13300,0,13300,58500,0,71800
143320200700000,SW 402,RESIDENTIAL,25300,0,25300,58400,0,83700
143320200800000,SW 402,RESIDENTIAL,20000,0,20000,30200,0,50200
143320200900000,SW 402,RESIDENTIAL,20000,0,20000,73200,0,93200
143320201000000,SW 402,RESIDENTIAL,20000,0,20000,56500,0,76500
143320300100000,SW 403,RESIDENTIAL,16700,0,16700,54900,0,71600
143320300200000,SW 403,RESIDENTIAL,16700,0,16700,119900,0,136600
143320300300000,SW 403,RESIDENTIAL,16700,0,16700,35400,0,52100
143320300400000,OFFICE,COMMERCIAL,0,21800,21800,0,78300,100100
143320400100000,SW 402,RESIDENTIAL,20400,0,20400,125900,0,146300
143320400200000,SW 402,RESIDENTIAL,20000,0,20000,38900,0,58900
143320400300000,SW 402,RESIDENTIAL,20000,0,20000,39000,0,59000
143320400400000,SW 402,RESIDENTIAL,20000,0,20000,55900,0,75900
143320400500000,SW 402,RESIDENTIAL,20000,0,20000,52800,0,72800
143320400600000,SW 402,RESIDENTIAL,20000,0,20000,121600,0,141600
143320400700000,SW 402,RESIDENTIAL,20000,0,20000,29500,0,49500
143320400800000,CONVENIENCE STORE,COMMERCIAL,0,60000,60000,0,273000,333000
143320400900000,FLAT PARKING,COMMERCIAL,0,30000,30000,0,11500,41500
143320401000000,SW 402,RESIDENTIAL,20400,0,20400,113900,0,134300
143320401100000,SW 402,RESIDENTIAL,20400,0,20400,132500,0,152900
143320500100000,SW 402,RESIDENTIAL,20000,0,20000,61400,0,81400
143320500200000,SW 402,RESIDENTIAL,18200,0,18200,31400,0,49600
143320500300000,SW 402,RESIDENTIAL,18200,0,18200,58000,0,76200
143320500400000,SW 402,RESIDENTIAL,18200,0,18200,66200,0,84400
143320500500000,SW 402,RESIDENTIAL,18200,0,18200,90100,0,108300
143320500600000,SW 402,RESIDENTIAL,21800,0,21800,62900,0,84700
143320500700000,SW 402,RESIDENTIAL,14600,0,14600,41600,0,56200
143320500800000,SW 402,RESIDENTIAL,20000,0,20000,104200,0,124200
143320500900000,SW 402,RESIDENTIAL,20000,0,20000,125900,0,145900
143320501000000,SW 402,RESIDENTIAL,20000,0,20000,52000,0,72000
143320501100000,SW 402,RESIDENTIAL,20000,0,20000,47600,0,67600
143320501200000,SW 402,RESIDENTIAL,20000,0,20000,35800,0,55800
143320600100000,SW 403,RESIDENTIAL,13700,0,13700,30800,0,44500
143320600400000,SW 403,RESIDENTIAL,16000,0,16000,43700,0,59700
143320600500000,SW 403,RESIDENTIAL,14000,0,14000,40800,0,54800
143320600600000,SW 403,RESIDENTIAL,5000,0,5000,0,0,5000
143320600700000,SW 403,RESIDENTIAL,16700,0,16700,50600,0,67300
143320600800000,SW 403,RESIDENTIAL,16700,0,16700,0,0,16700
143320600900000,SW 403,RESIDENTIAL,21100,0,21100,119700,0,140800
143320700100000,FUNERAL HOME,COMMERCIAL,20240,23760,44000,126316,148284,318600
143320700200000,FLAT PARKING,COMMERCIAL,0,16000,16000,0,6700,22700
143320700300000,SW 402,RESIDENTIAL,20400,0,20400,0,0,20400
143320700400000,SW 402,RESIDENTIAL,20000,0,20000,78300,0,98300
143320700500000,SW 402,RESIDENTIAL,20000,0,20000,46400,0,66400
143320700600000,SW 402,RESIDENTIAL,20000,0,20000,60000,0,80000
143320700700000,SW 402,RESIDENTIAL,20000,0,20000,94800,0,114800
143320700800000,SW 402,RESIDENTIAL,16200,0,16200,39700,0,55900
143320700900000,SW 402,RESIDENTIAL,20800,0,20800,71500,0,92300
143320701000000,SW 402,RESIDENTIAL,25500,0,25500,82300,0,107800
143320701100000,SW 402,RESIDENTIAL,25500,0,25500,40000,0,65500
143320701200000,SW 402,RESIDENTIAL,25500,0,25500,45600,0,71100
143320800100000,SW 402,RESIDENTIAL,10000,0,10000,0,0,10000
143320800200000,SW 402,RESIDENTIAL,23400,0,23400,51200,0,74600
143320800300000,SW 402,RESIDENTIAL,23400,0,23400,51300,0,74700
143320800400000,SW 402,RESIDENTIAL,23400,0,23400,49600,0,73000
143320800500000,SW 402,RESIDENTIAL,23400,0,23400,122400,0,145800
143320800600000,SW 402,RESIDENTIAL,23400,0,23400,56800,0,80200
143320800700000,SW 402,RESIDENTIAL,23400,0,23400,73000,0,96400
143320800800000,SW 402,RESIDENTIAL,20000,0,20000,74600,0,94600
143320800900000,SW 402,RESIDENTIAL,20000,0,20000,71400,0,91400
143320801000000,SW 402,RESIDENTIAL,20000,0,20000,59600,0,79600
143320801100000,SW 402,RESIDENTIAL,20000,0,20000,102700,0,122700
143320801200000,SW 402,RESIDENTIAL,20000,0,20000,70700,0,90700
143320900100000,SW 403,RESIDENTIAL,15600,0,15600,54900,0,70500
143320900200000,SW 403,RESIDENTIAL,16900,0,16900,43500,0,60400
143320900300000,SW 403,RESIDENTIAL,15600,0,15600,62200,0,77800
143320900400000,SW 403,RESIDENTIAL,16700,0,16700,51600,0,68300
143320900500000,SW 403,RESIDENTIAL,16700,0,16700,35200,0,51900
143320900600000,APARTMENT,MULTI-RES,28000,0,28000,166600,0,194600
143321000100000,SW 402,RESIDENTIAL,25500,0,25500,95000,0,120500
143321000200000,SW 402,RESIDENTIAL,30000,0,30000,45200,0,75200
143321000300000,SW 402,RESIDENTIAL,30000,0,30000,62200,0,92200
143321000400000,SW 402,RESIDENTIAL,16000,0,16000,63400,0,79400
143321000500000,SW 402,RESIDENTIAL,16000,0,16000,0,0,16000
143321000600000,SW 402,RESIDENTIAL,25000,0,25000,84300,0,109300
143321000700000,SW 402,RESIDENTIAL,25000,0,25000,61800,0,86800
143321000800000,SW 402,RESIDENTIAL,17500,0,17500,50800,0,68300
143321000900000,SW 402,RESIDENTIAL,18900,0,18900,46200,0,65100
143321001000000,SW 402,RESIDENTIAL,25500,0,25500,47200,0,72700
143321001100000,SW 402,RESIDENTIAL,25500,0,25500,49000,0,74500
143321001200000,SW 402,RESIDENTIAL,25500,0,25500,61200,0,86700
143321001300000,SW 402,RESIDENTIAL,25500,0,25500,71000,0,96500
143321001400000,SW 402,RESIDENTIAL,25500,0,25500,68500,0,94000
143321001500000,SW 402,RESIDENTIAL,25500,0,25500,112400,0,137900
143321100100000,SW 402,RESIDENTIAL,25000,0,25000,116400,0,141400
143321100200000,SW 402,RESIDENTIAL,15800,0,15800,36200,0,52000
143321100300000,SW 402,RESIDENTIAL,15800,0,15800,29900,0,45700
143321100400000,SW 402,RESIDENTIAL,15800,0,15800,36200,0,52000
143321100500000,SW 402,RESIDENTIAL,15800,0,15800,41800,0,57600
143321100600000,SW 402,RESIDENTIAL,23400,0,23400,89700,0,113100
143321100700000,SW 402,RESIDENTIAL,23400,0,23400,62600,0,86000
143321100800000,SW 402,RESIDENTIAL,23400,0,23400,32800,0,56200
143321100900000,SW 402,RESIDENTIAL,23400,0,23400,29800,0,53200
143321101000000,SW 402,RESIDENTIAL,23400,0,23400,91800,0,115200
143321101100000,SW 402,RESIDENTIAL,25000,0,25000,58600,0,83600
143321101200000,SW 402,RESIDENTIAL,25000,0,25000,45600,0,70600
143321101300000,SW 402,RESIDENTIAL,25000,0,25000,76100,0,101100
143321101400000,SW 402,RESIDENTIAL,25000,0,25000,60800,0,85800
143321101500000,SW 402,RESIDENTIAL,25000,0,25000,70600,0,95600
143321101600000,SW 402,RESIDENTIAL,25000,0,25000,57500,0,82500
143321200100000,SW 403,RESIDENTIAL,16700,0,16700,38500,0,55200
143321200200000,SW 403,RESIDENTIAL,18600,0,18600,59100,0,77700
143321200300000,SW 403,RESIDENTIAL,18600,0,18600,54300,0,72900
143321200400000,SW 403,RESIDENTIAL,16700,0,16700,57200,0,73900
143322600100000,SW 403,RESIDENTIAL,20700,0,20700,31600,0,52300
143322600200000,SW 403,RESIDENTIAL,15100,0,15100,47200,0,62300
143322600300000,SW 403,RESIDENTIAL,20000,0,20000,79800,0,99800
143322600400000,SW 403,RESIDENTIAL,20700,0,20700,52500,0,73200
143322600500000,SW 403,RESIDENTIAL,20700,0,20700,52600,0,73300
143322600600000,SW 403,RESIDENTIAL,19000,0,19000,51200,0,70200
143322600700000,SW 403,RESIDENTIAL,21200,0,21200,27800,0,49000
143322600800000,SW 403,RESIDENTIAL,20700,0,20700,44400,0,65100
143322700100000,SW 403,RESIDENTIAL,18200,0,18200,51500,0,69700
143322700200000,SW 403,RESIDENTIAL,18200,0,18200,52600,0,70800
143322700300000,SW 403,RESIDENTIAL,18200,0,18200,47800,0,66000
143322700400000,SW 403,RESIDENTIAL,18200,0,18200,46500,0,64700
143322700500000,SW 403,RESIDENTIAL,18200,0,18200,62300,0,80500
143322700600000,SW 403,RESIDENTIAL,18200,0,18200,47100,0,65300
143322700700000,SW 403,RESIDENTIAL,18200,0,18200,49300,0,67500
143322700800000,SW 403,RESIDENTIAL,18200,0,18200,65900,0,84100
143322700900000,SW 403,RESIDENTIAL,18200,0,18200,45700,0,63900
143322701000000,SW 403,RESIDENTIAL,18200,0,18200,41500,0,59700
143322900100000,SW 403,RESIDENTIAL,25200,0,25200,64300,0,89500
143322900200000,SW 403,RESIDENTIAL,21300,0,21300,36700,0,58000
143322900300000,SW 403,RESIDENTIAL,20300,0,20300,37500,0,57800
143322900400000,SW 403,RESIDENTIAL,20700,0,20700,50200,0,70900
143322900500000,SW 403,RESIDENTIAL,20700,0,20700,74800,0,95500
143322900600000,SW 403,RESIDENTIAL,20700,0,20700,63500,0,84200
143322900700000,SW 403,RESIDENTIAL,20700,0,20700,59000,0,79700
143322900800000,SW 403,RESIDENTIAL,20700,0,20700,52200,0,72900
143322900900000,SW 403,RESIDENTIAL,20700,0,20700,43000,0,63700
143322901000000,SW 403,RESIDENTIAL,20700,0,20700,94900,0,115600
143322901100000,SW 403,RESIDENTIAL,20700,0,20700,39300,0,60000
143323000200000,SW 403,RESIDENTIAL,18900,0,18900,27600,0,46500
143323000300000,SW 403,RESIDENTIAL,18900,0,18900,68000,0,86900
143323000400000,SW 403,RESIDENTIAL,18900,0,18900,39700,0,58600
143323000500000,SCHOOL,EXEMPT,0,0,0,0,0,0
143323000600000,SW 403,RESIDENTIAL,18900,0,18900,54400,0,73300
143323000700000,SW 403,RESIDENTIAL,18900,0,18900,51400,0,70300
143323000800000,SW 403,RESIDENTIAL,22700,0,22700,49200,0,71900
143323000900000,SW 403,RESIDENTIAL,16400,0,16400,37100,0,53500
143323001000000,SW 403,RESIDENTIAL,18600,0,18600,44100,0,62700
143323001100000,SW 403,RESIDENTIAL,18600,0,18600,35600,0,54200
143323001200000,SW 403,RESIDENTIAL,15900,0,15900,40600,0,56500
143323001300000,SW 403,RESIDENTIAL,19100,0,19100,73600,0,92700
143323001400000,SW 403,RESIDENTIAL,19500,0,19500,70000,0,89500
143323001500000,SW 403,RESIDENTIAL,19500,0,19500,108100,0,127600
143323001600000,SW 403,RESIDENTIAL,19500,0,19500,108100,0,127600
143323100100000,SW 403,RESIDENTIAL,20900,0,20900,83100,0,104000
143323100200000,OFFICE,COMMERCIAL,0,196900,196900,0,195600,392500
143323100300000,SW 403,RESIDENTIAL,20900,0,20900,0,0,20900
143323100400000,FAST FOOD,COMMERCIAL,0,102000,102000,0,575900,677900
143323100500000,FLAT PARKING,COMMERCIAL,0,70800,70800,0,9300,80100
143323100600000,SW 403,RESIDENTIAL,18000,0,18000,52900,0,70900
143323100700000,SW 403,RESIDENTIAL,18400,0,18400,55700,0,74100
143323100800000,SW 403,RESIDENTIAL,17500,0,17500,58100,0,75600
143323100900000,SW 403,RESIDENTIAL,17500,0,17500,32200,0,49700
143323101000000,SW 403,RESIDENTIAL,18400,0,18400,51900,0,70300
143323101100000,SW 403,RESIDENTIAL,18500,0,18500,42100,0,60600
143323200100000,SW 403,RESIDENTIAL,20700,0,20700,57900,0,78600
143323200200000,SW 403,RESIDENTIAL,20700,0,20700,56000,0,76700
143323200300000,SW 403,RESIDENTIAL,20700,0,20700,63500,0,84200
143323200400000,SW 403,RESIDENTIAL,20700,0,20700,86600,0,107300
143323200500000,SW 403,RESIDENTIAL,20700,0,20700,44400,0,65100
143323200600000,SW 403,RESIDENTIAL,18400,0,18400,49800,0,68200
143323200700000,SW 403,RESIDENTIAL,22000,0,22000,51800,0,73800
143323200800000,SW 403,RESIDENTIAL,20700,0,20700,48800,0,69500
143323200900000,SW 403,RESIDENTIAL,20700,0,20700,38000,0,58700
143323201000000,SW 403,RESIDENTIAL,20700,0,20700,50100,0,70800
143323201100000,SW 403,RESIDENTIAL,20700,0,20700,44300,0,65000
143323201200000,SW 403,RESIDENTIAL,20700,0,20700,42000,0,62700
143323300100000,SW 403,RESIDENTIAL,20700,0,20700,31600,0,52300
143323300200000,SW 403,RESIDENTIAL,20700,0,20700,11200,0,31900
143323300300000,SW 403,RESIDENTIAL,23000,0,23000,43100,0,66100
143323300400000,SW 403,RESIDENTIAL,20700,0,20700,22700,0,43400
143323300500000,SW 403,RESIDENTIAL,700,0,700,0,0,700
143323300600000,SW 403,RESIDENTIAL,20700,0,20700,20300,0,41000
143323300700000,SW 403,RESIDENTIAL,20700,0,20700,46100,0,66800
143323300800000,SW 403,RESIDENTIAL,23500,0,23500,53500,0,77000
143323300900000,SW 403,RESIDENTIAL,19400,0,19400,48100,0,67500
143323301000000,SW 403,RESIDENTIAL,18200,0,18200,70200,0,88400
143323301100000,SW 403,RESIDENTIAL,19500,0,19500,55700,0,75200
143323301200000,SW 403,RESIDENTIAL,23500,0,23500,64600,0,88100
143323301300000,SW 402,RESIDENTIAL,21600,0,21600,55300,0,76900
143323301400000,SW 403,RESIDENTIAL,2500,0,2500,0,0,2500
143323301500000,SW 403,RESIDENTIAL,2500,0,2500,0,0,2500
143323301600000,SW 403,RESIDENTIAL,18900,0,18900,43900,0,62800
143323301700000,SW 403,RESIDENTIAL,18900,0,18900,40900,0,59800
143323301800000,SW 403,RESIDENTIAL,18900,0,18900,32900,0,51800
143323301900000,SW 403,RESIDENTIAL,18900,0,18900,35800,0,54700
143323302000000,SW 403,RESIDENTIAL,17900,0,17900,38000,0,55900
143323302100000,SW 403,RESIDENTIAL,17600,0,17600,41500,0,59100
143323302200000,SW 403,RESIDENTIAL,21200,0,21200,55800,0,77000
143323302300000,SW 403,RESIDENTIAL,21200,0,21200,48200,0,69400
143323302400000,SW 403,RESIDENTIAL,20000,0,20000,46600,0,66600
143323302500000,SW 403,RESIDENTIAL,17600,0,17600,56100,0,73700
143323302600000,SW 403,RESIDENTIAL,24400,0,24400,119400,0,143800
143323302700000,SW 403,RESIDENTIAL,20600,0,20600,58400,0,79000
143323302800000,SW 403,RESIDENTIAL,17600,0,17600,0,0,17600
143323303100000,SMALL RETAIL,COMMERCIAL,0,59900,59900,0,118600,178500
143325100100000,CEMETERY,EXEMPT,0,1971000,1971000,0,7300,1978300
143325100200000,CONVENIENCE STORE,COMMERCIAL,0,399000,399000,0,339400,738400
143325100300000,FUNERAL HOME,COMMERCIAL,0,219200,219200,0,841400,1060600
143325100400000,FLAT PARKING,COMMERCIAL,0,131200,131200,0,48000,179200
143325100500000,SW 403,RESIDENTIAL,24300,0,24300,70900,0,95200
143325100600000,SW 403,RESIDENTIAL,23500,0,23500,59100,0,82600
143325100700000,SW 403,RESIDENTIAL,23500,0,23500,28800,0,52300
143325100800000,SW 403,RESIDENTIAL,23600,0,23600,55600,0,79200
143325100900000,SW 403,RESIDENTIAL,23600,0,23600,70800,0,94400
143325101000000,SW 403,RESIDENTIAL,25700,0,25700,55100,0,80800
143325101100000,SW 403,RESIDENTIAL,24100,0,24100,34800,0,58900
143325101200000,SW 403,RESIDENTIAL,23400,0,23400,47200,0,70600
143325101300000,SW 403,RESIDENTIAL,23400,0,23400,52200,0,75600
143325101400000,SW 403,RESIDENTIAL,23400,0,23400,56900,0,80300
143325101500000,SW 403,RESIDENTIAL,23400,0,23400,78600,0,102000
143325200100000,SW 403,RESIDENTIAL,18500,0,18500,54600,0,73100
143325200200000,SW 403,RESIDENTIAL,19700,0,19700,55200,0,74900
143325200300000,SW 403,RESIDENTIAL,22100,0,22100,29200,0,51300
143325200400000,SW 403,RESIDENTIAL,22100,0,22100,48700,0,70800
143325200500000,SW 403,RESIDENTIAL,22800,0,22800,50700,0,73500
143325200600000,SW 403,RESIDENTIAL,22800,0,22800,40800,0,63600
143325200700000,SW 403,RESIDENTIAL,22100,0,22100,47000,0,69100
143325200800000,SW 403,RESIDENTIAL,22100,0,22100,56100,0,78200
143325200900000,SW 403,RESIDENTIAL,24300,0,24300,70100,0,94400
143325201000000,SW 403,RESIDENTIAL,18500,0,18500,56500,0,75000
143327600100000,SW 412,RESIDENTIAL,22100,0,22100,75300,0,97400
143327600200000,SW 412,RESIDENTIAL,11900,0,11900,25600,0,37500
143327600300000,SW 412,RESIDENTIAL,18000,0,18000,55400,0,73400
143327600400000,SW 412,RESIDENTIAL,17000,0,17000,61000,0,78000
143327600500000,SW 412,RESIDENTIAL,17000,0,17000,94800,0,111800
143327600600000,SW 412,RESIDENTIAL,17000,0,17000,51600,0,68600
143327600700000,SW 412,RESIDENTIAL,17000,0,17000,57800,0,74800
143327600800000,SW 412,RESIDENTIAL,17000,0,17000,79500,0,96500
143327600900000,SW 412,RESIDENTIAL,21700,0,21700,72000,0,93700
143327601000000,SW 412,RESIDENTIAL,22100,0,22100,108000,0,130100
143327601100000,SW 412,RESIDENTIAL,17300,0,17300,69100,0,86400
143327601200000,SW 412,RESIDENTIAL,17300,0,17300,94500,0,111800
143327601300000,SW 412,RESIDENTIAL,17300,0,17300,71900,0,89200
143327601400000,SW 412,RESIDENTIAL,17300,0,17300,36300,0,53600
143327601500000,SW 412,RESIDENTIAL,17300,0,17300,94900,0,112200
143327700100000,SW 412,RESIDENTIAL,21700,0,21700,62200,0,83900
143327700200000,SW 412,RESIDENTIAL,17900,0,17900,70700,0,88600
143327700300000,SW 412,RESIDENTIAL,19700,0,19700,83600,0,103300
143327700400000,SW 412,RESIDENTIAL,18000,0,18000,64700,0,82700
143327700500000,SW 412,RESIDENTIAL,18700,0,18700,78300,0,97000
143327700600000,SW 412,RESIDENTIAL,18700,0,18700,84800,0,103500
143327700700000,SW 412,RESIDENTIAL,18700,0,18700,75900,0,94600
143327700800000,SW 412,RESIDENTIAL,18700,0,18700,79900,0,98600
143327700900000,SW 412,RESIDENTIAL,23900,0,23900,36700,0,60600
143327701000000,SW 412,RESIDENTIAL,21700,0,21700,95700,0,117400
143327701100000,SW 412,RESIDENTIAL,17000,0,17000,77800,0,94800
143327701200000,SW 412,RESIDENTIAL,17000,0,17000,60000,0,77000
143327701300000,SW 412,RESIDENTIAL,17000,0,17000,83700,0,100700
143327701400000,SW 412,RESIDENTIAL,17000,0,17000,81400,0,98400
143327701500000,SW 412,RESIDENTIAL,17000,0,17000,69000,0,86000
143327800100000,SW 412,RESIDENTIAL,26000,0,26000,46300,0,72300
143327800200000,SW 412,RESIDENTIAL,28400,0,28400,46000,0,74400
143327800300000,SW 412,RESIDENTIAL,26600,0,26600,124400,0,151000
143327800400000,SW 412,RESIDENTIAL,25500,0,25500,43900,0,69400
143327800500000,SW 412,RESIDENTIAL,25500,0,25500,99600,0,125100
143327800600000,SW 412,RESIDENTIAL,25500,0,25500,82100,0,107600
143327800700000,SW 412,RESIDENTIAL,17300,0,17300,96900,0,114200
143327800800000,SW 412,RESIDENTIAL,17300,0,17300,71800,0,89100
143327800900000,SW 412,RESIDENTIAL,17300,0,17300,35600,0,52900
143327801000000,SW 412,RESIDENTIAL,26000,0,26000,14200,0,40200
143327801100000,SW 412,RESIDENTIAL,26000,0,26000,69500,0,95500
143327900100000,SW 412,RESIDENTIAL,23200,0,23200,55200,0,78400
143327900200000,SW 412,RESIDENTIAL,9200,0,9200,19300,0,28500
143327900300000,SW 412,RESIDENTIAL,28100,0,28100,27100,0,55200
143327900400000,SW 412,RESIDENTIAL,28100,0,28100,79700,0,107800
143327900500000,SW 412,RESIDENTIAL,28100,0,28100,25900,0,54000
143327900600000,SW 412,RESIDENTIAL,18700,0,18700,64800,0,83500
143327900700000,SW 412,RESIDENTIAL,18700,0,18700,61800,0,80500
143327900800000,SW 412,RESIDENTIAL,18700,0,18700,47300,0,66000
143327900900000,SW 412,RESIDENTIAL,25500,0,25500,93800,0,119300
143327901000000,SW 412,RESIDENTIAL,30600,0,30600,44900,0,75500
143327901100000,SW 412,RESIDENTIAL,12800,0,12800,35700,0,48500
143327901200000,SW 412,RESIDENTIAL,12800,0,12800,56900,0,69700
143327901300000,SW 412,RESIDENTIAL,12800,0,12800,53200,0,66000
143328000100000,SW 403,RESIDENTIAL,21800,0,21800,50300,0,72100
143328000200000,SW 403,RESIDENTIAL,21800,0,21800,61500,0,83300
143328000300000,SW 403,RESIDENTIAL,22900,0,22900,81900,0,104800
143328000400000,SW 403,RESIDENTIAL,21800,0,21800,72600,0,94400
143328000500000,SW 403,RESIDENTIAL,21800,0,21800,59500,0,81300
143328000600000,SW 403,RESIDENTIAL,23700,0,23700,35000,0,58700
143328000700000,SW 403,RESIDENTIAL,20000,0,20000,57000,0,77000
143328000800000,SW 403,RESIDENTIAL,21800,0,21800,36000,0,57800
143328000900000,SW 403,RESIDENTIAL,24800,0,24800,123200,0,148000
143328100100000,SW 412,RESIDENTIAL,28200,0,28200,92100,0,120300
143328100200000,SW 412,RESIDENTIAL,17000,0,17000,47600,0,64600
143328100300000,SW 412,RESIDENTIAL,27200,0,27200,89800,0,117000
143328100500000,SW 412,RESIDENTIAL,20200,0,20200,80900,0,101100
143328100600000,SW 412,RESIDENTIAL,22400,0,22400,81400,0,103800
143328100700000,SW 412,RESIDENTIAL,22400,0,22400,79400,0,101800
143328100800000,SW 412,RESIDENTIAL,13900,0,13900,0,0,13900
143328100900000,SW 412,RESIDENTIAL,13900,0,13900,90300,0,104200
143328101000000,SW 412,RESIDENTIAL,23000,0,23000,78500,0,101500
143328101100000,SW 412,RESIDENTIAL,25100,0,25100,144300,0,169400
143328101200000,SW 412,RESIDENTIAL,25100,0,25100,46100,0,71200
143328200100000,SW 412,RESIDENTIAL,23000,0,23000,116800,0,139800
143328200200000,SW 412,RESIDENTIAL,25300,0,25300,69800,0,95100
143328200300000,SW 412,RESIDENTIAL,25300,0,25300,72400,0,97700
143328200400000,SW 412,RESIDENTIAL,25300,0,25300,82100,0,107400
143328200500000,SW 412,RESIDENTIAL,25800,0,25800,35400,0,61200
143328200600000,SW 412,RESIDENTIAL,25800,0,25800,74900,0,100700
143328200700000,SW 412,RESIDENTIAL,23000,0,23000,120200,0,143200
143328200800000,SW 412,RESIDENTIAL,23000,0,23000,45800,0,68800
143328200900000,SW 412,RESIDENTIAL,23000,0,23000,93900,0,116900
143328201000000,SW 412,RESIDENTIAL,23000,0,23000,58600,0,81600
143328300100000,SW 412,RESIDENTIAL,15200,0,15200,75700,0,90900
143328300200000,SW 412,RESIDENTIAL,22600,0,22600,96700,0,119300
143328300300000,SW 412,RESIDENTIAL,19400,0,19400,77500,0,96900
143328300400000,SW 412,RESIDENTIAL,19400,0,19400,82700,0,102100
143328300500000,SW 412,RESIDENTIAL,16200,0,16200,90600,0,106800
143328300600000,SW 412,RESIDENTIAL,16200,0,16200,67300,0,83500
143328300700000,SW 412,RESIDENTIAL,16200,0,16200,90800,0,107000
143328300800000,SW 412,RESIDENTIAL,16200,0,16200,72000,0,88200
143328300900000,SW 412,RESIDENTIAL,23300,0,23300,83100,0,106400
143328301000000,SW 412,RESIDENTIAL,22300,0,22300,90400,0,112700
143328301100000,SW 412,RESIDENTIAL,19200,0,19200,73600,0,92800
143328301200000,SW 412,RESIDENTIAL,19200,0,19200,109500,0,128700
143328301300000,SW 412,RESIDENTIAL,13300,0,13300,73700,0,87000
143328301400000,SW 412,RESIDENTIAL,13300,0,13300,95800,0,109100
143328301500000,SW 412,RESIDENTIAL,14600,0,14600,84200,0,98800
143328301600000,SW 412,RESIDENTIAL,14600,0,14600,86200,0,100800
143328301700000,SW 412,RESIDENTIAL,14600,0,14600,78900,0,93500
143328301800000,SW 412,RESIDENTIAL,14600,0,14600,76200,0,90800
143328301900000,SW 412,RESIDENTIAL,16000,0,16000,85800,0,101800
143328302000000,SW 412,RESIDENTIAL,16700,0,16700,66200,0,82900
143328302100000,SW 412,RESIDENTIAL,16500,0,16500,35500,0,52000
143328302200000,SW 412,RESIDENTIAL,12600,0,12600,0,0,12600
143328302300000,SW 412,RESIDENTIAL,17300,0,17300,75900,0,93200
143328400100000,SW 403,RESIDENTIAL,22500,0,22500,62400,0,84900
143328400200000,SW 403,RESIDENTIAL,24800,0,24800,86900,0,111700
143330100100000,SW 416,RESIDENTIAL,50100,0,50100,134600,0,184700
143330100200000,SW 416,RESIDENTIAL,22500,0,22500,110800,0,133300
143330100300000,SW 416,RESIDENTIAL,27800,0,27800,67200,0,95000
143330100400000,SW 416,RESIDENTIAL,2700,0,2700,40500,0,43200
143330100500000,SW 416,RESIDENTIAL,15000,0,15000,80000,0,95000
143330100600000,SW 416,RESIDENTIAL,18700,0,18700,72100,0,90800
143330100700000,SW 416,RESIDENTIAL,18700,0,18700,106900,0,125600
143330100800000,SW 416,RESIDENTIAL,22500,0,22500,82900,0,105400
143330100900000,SW 416,RESIDENTIAL,26200,0,26200,113500,0,139700
143330101000000,SW 416,RESIDENTIAL,26000,0,26000,60200,0,86200
143330101100000,SW 416,RESIDENTIAL,29700,0,29700,71300,0,101000
143330101200000,SW 416,RESIDENTIAL,18600,0,18600,96700,0,115300
143330101300000,SW 416,RESIDENTIAL,26400,0,26400,34300,0,60700
143330101400000,SW 416,RESIDENTIAL,26400,0,26400,87000,0,113400
143330101500000,SW 416,RESIDENTIAL,18600,0,18600,82500,0,101100
143330101600000,SW 416,RESIDENTIAL,18600,0,18600,91200,0,109800
143330101700000,SW 416,RESIDENTIAL,18600,0,18600,111200,0,129800
143330101800000,SW 416,RESIDENTIAL,18600,0,18600,101500,0,120100
143330101900000,SW 416,RESIDENTIAL,15300,0,15300,73100,0,88400
143330102000000,SW 416,RESIDENTIAL,26100,0,26100,86000,0,112100
143330102100000,SW 416,RESIDENTIAL,26700,0,26700,92500,0,119200
143330102200000,SW 416,RESIDENTIAL,26700,0,26700,103900,0,130600
143330200100000,SW 417,RESIDENTIAL,28100,0,28100,72400,0,100500
143330200200000,SW 417,RESIDENTIAL,20200,0,20200,93300,0,113500
143330200300000,SW 417,RESIDENTIAL,21500,0,21500,126300,0,147800
143330300100000,SW 416,RESIDENTIAL,19700,0,19700,127500,0,147200
143330300200000,SW 416,RESIDENTIAL,22300,0,22300,109200,0,131500
143330300300000,SW 416,RESIDENTIAL,18600,0,18600,80300,0,98900
143330300400000,SW 416,RESIDENTIAL,18600,0,18600,104800,0,123400
143330300500000,SW 416,RESIDENTIAL,18600,0,18600,103700,0,122300
143330300600000,SW 416,RESIDENTIAL,18600,0,18600,101000,0,119600
143330300700000,SW 416,RESIDENTIAL,27800,0,27800,96600,0,124400
143330300800000,SW 416,RESIDENTIAL,18600,0,18600,78600,0,97200
143330300900000,SW 416,RESIDENTIAL,15400,0,15400,84900,0,100300
143330301000000,SW 416,RESIDENTIAL,26200,0,26200,82000,0,108200
143330301100000,SW 416,RESIDENTIAL,26100,0,26100,108600,0,134700
143330301200000,SW 416,RESIDENTIAL,20400,0,20400,85700,0,106100
143330301300000,SW 416,RESIDENTIAL,20400,0,20400,93000,0,113400
143330301400000,SW 416,RESIDENTIAL,20400,0,20400,114600,0,135000
143330301500000,SW 416,RESIDENTIAL,20400,0,20400,79300,0,99700
143330301600000,SW 416,RESIDENTIAL,20400,0,20400,92400,0,112800
143330301700000,SW 416,RESIDENTIAL,20400,0,20400,102400,0,122800
143330301800000,SW 416,RESIDENTIAL,20400,0,20400,78300,0,98700
143330301900000,SW 416,RESIDENTIAL,20400,0,20400,91900,0,112300
143330302000000,SW 416,RESIDENTIAL,20400,0,20400,117600,0,138000
143330302100000,SW 416,RESIDENTIAL,21200,0,21200,81100,0,102300
143330302200000,SW 416,RESIDENTIAL,26400,0,26400,93400,0,119800
143330302300000,SW 416,RESIDENTIAL,23800,0,23800,89100,0,112900
143330302400000,SW 416,RESIDENTIAL,18300,0,18300,61200,0,79500
143330400100000,SW 417,RESIDENTIAL,21800,0,21800,112000,0,133800
143330400200000,SW 417,RESIDENTIAL,19500,0,19500,117800,0,137300
143330400300000,SW 417,RESIDENTIAL,18700,0,18700,70700,0,89400
143330500100000,SW 416,RESIDENTIAL,23800,0,23800,95200,0,119000
143330500200000,SW 416,RESIDENTIAL,26300,0,26300,77600,0,103900
143330500300000,SW 416,RESIDENTIAL,20400,0,20400,53000,0,73400
143330500400000,SW 416,RESIDENTIAL,27200,0,27200,112800,0,140000
143330500500000,SW 416,RESIDENTIAL,24100,0,24100,90600,0,114700
143330500600000,SW 416,RESIDENTIAL,22800,0,22800,96100,0,118900
143330500700000,SW 416,RESIDENTIAL,24500,0,24500,109500,0,134000
143330500800000,SW 416,RESIDENTIAL,21000,0,21000,82700,0,103700
143330500900000,SW 416,RESIDENTIAL,24500,0,24500,121400,0,145900
143330501000000,SW 416,RESIDENTIAL,29600,0,29600,96300,0,125900
143330501100000,SW 416,RESIDENTIAL,26300,0,26300,94800,0,121100
143330501200000,SW 416,RESIDENTIAL,32200,0,32200,138200,0,170400
143330600100000,SW 416,RESIDENTIAL,25800,0,25800,93000,0,118800
143330600200000,SW 416,RESIDENTIAL,20400,0,20400,93200,0,113600
143330600300000,SW 416,RESIDENTIAL,20400,0,20400,110500,0,130900
143330600400000,SW 416,RESIDENTIAL,20400,0,20400,89400,0,109800
143330600500000,SW 416,RESIDENTIAL,20400,0,20400,90200,0,110600
143330600600000,SW 416,RESIDENTIAL,23200,0,23200,600,0,23800
143330600700000,SW 416,RESIDENTIAL,22800,0,22800,99600,0,122400
143330600800000,SW 416,RESIDENTIAL,22800,0,22800,156000,0,178800
143330600900000,SW 416,RESIDENTIAL,22800,0,22800,114000,0,136800
143330601000000,SW 416,RESIDENTIAL,26900,0,26900,116200,0,143100
143330601100000,SW 416,RESIDENTIAL,31000,0,31000,277400,0,308400
143330601200000,SW 416,RESIDENTIAL,13800,0,13800,8600,0,22400
143330601300000,SW 416,RESIDENTIAL,24700,0,24700,89800,0,114500
143330601400000,SW 416,RESIDENTIAL,24100,0,24100,91100,0,115200
143330700100000,SW 417,RESIDENTIAL,18700,0,18700,98200,0,116900
143330700200000,SW 417,RESIDENTIAL,19500,0,19500,125100,0,144600
143330700300000,SW 417,RESIDENTIAL,25000,0,25000,108200,0,133200
143330700400000,SW 417,RESIDENTIAL,19800,0,19800,102000,0,121800
143330700500000,SW 417,RESIDENTIAL,18300,0,18300,85100,0,103400
143332600100000,SW 417,RESIDENTIAL,20400,0,20400,78000,0,98400
143332600200000,SW 417,RESIDENTIAL,19700,0,19700,89100,0,108800
143332600300000,SW 417,RESIDENTIAL,23100,0,23100,88900,0,112000
143332600400000,SW 417,RESIDENTIAL,22000,0,22000,106400,0,128400
143332600500000,SW 417,RESIDENTIAL,16900,0,16900,64000,0,80900
143332600600000,SW 417,RESIDENTIAL,20800,0,20800,55600,0,76400
143332600700000,SW 417,RESIDENTIAL,17100,0,17100,51400,0,68500
143332600800000,SW 417,RESIDENTIAL,19600,0,19600,58700,0,78300
143332600900000,SW 417,RESIDENTIAL,20700,0,20700,51900,0,72600
143332601000000,SW 417,RESIDENTIAL,19600,0,19600,62000,0,81600
143332601100000,SW 417,RESIDENTIAL,18400,0,18400,66900,0,85300
143332700100000,SW 417,RESIDENTIAL,18400,0,18400,70900,0,89300
143332700200000,SW 417,RESIDENTIAL,18400,0,18400,63900,0,82300
143332700300000,SW 417,RESIDENTIAL,18400,0,18400,67400,0,85800
143332700400000,SW 417,RESIDENTIAL,18400,0,18400,94900,0,113300
143332700500000,SW 417,RESIDENTIAL,18400,0,18400,74500,0,92900
143332800100000,SW 417,RESIDENTIAL,18700,0,18700,94800,0,113500
143332800200000,SW 417,RESIDENTIAL,19900,0,19900,60300,0,80200
143332800300000,CITY PROPERTY,EXEMPT,0,0,0,0,0,0
143332800400000,SW 417,RESIDENTIAL,20900,0,20900,95100,0,116000
143332800500000,SERVICE STATION,COMMERCIAL,0,135200,135200,0,51900,187100
143332800600000,SW 417,RESIDENTIAL,17400,0,17400,64300,0,81700
143332800700000,SW 417,RESIDENTIAL,17900,0,17900,72400,0,90300
143332800800000,SW 417,RESIDENTIAL,18700,0,18700,48000,0,66700
143332800900000,SW 417,RESIDENTIAL,16900,0,16900,56500,0,73400
143332801000000,SW 417,RESIDENTIAL,16900,0,16900,83700,0,100600
143332801100000,SW 417,RESIDENTIAL,16900,0,16900,102300,0,119200
143332801200000,SW 417,RESIDENTIAL,16900,0,16900,54700,0,71600
143332801300000,SW 417,RESIDENTIAL,17700,0,17700,60800,0,78500
143332801400000,SW 417,RESIDENTIAL,17800,0,17800,56900,0,74700
143332801500000,SW 417,RESIDENTIAL,18700,0,18700,55200,0,73900
143332900100000,SW 417,RESIDENTIAL,19600,0,19600,83500,0,103100
143332900200000,SW 417,RESIDENTIAL,17500,0,17500,78400,0,95900
143332900300000,SW 417,RESIDENTIAL,17500,0,17500,68200,0,85700
143332900400000,SW 417,RESIDENTIAL,17500,0,17500,64100,0,81600
143332900500000,SW 417,RESIDENTIAL,19100,0,19100,77300,0,96400
143333000100000,SW 417,RESIDENTIAL,19200,0,19200,67800,0,87000
143333000200000,SW 417,RESIDENTIAL,19300,0,19300,56400,0,75700
143333000300000,SW 417,RESIDENTIAL,19200,0,19200,67600,0,86800
143333000400000,SW 417,RESIDENTIAL,19800,0,19800,62300,0,82100
143333000500000,SW 417,RESIDENTIAL,20300,0,20300,60600,0,80900
143333000600000,SW 417,RESIDENTIAL,16900,0,16900,53900,0,70800
143333000700000,SW 417,RESIDENTIAL,16900,0,16900,61900,0,78800
143333000800000,SW 417,RESIDENTIAL,16900,0,16900,64100,0,81000
143333000900000,SW 417,RESIDENTIAL,16900,0,16900,52500,0,69400
143333001000000,SW 417,RESIDENTIAL,19500,0,19500,60100,0,79600
143333001100000,SW 417,RESIDENTIAL,20900,0,20900,86000,0,106900
143333001200000,SW 417,RESIDENTIAL,19900,0,19900,67800,0,87700
143333001300000,SW 417,RESIDENTIAL,20100,0,20100,63100,0,83200
143333001400000,SW 417,RESIDENTIAL,16900,0,16900,66800,0,83700
143333001500000,SW 417,RESIDENTIAL,16900,0,16900,67100,0,84000
143333001600000,SW 417,RESIDENTIAL,17900,0,17900,71700,0,89600
143333001700000,SW 417,RESIDENTIAL,19200,0,19200,70300,0,89500
143333001800000,SW 417,RESIDENTIAL,19800,0,19800,74000,0,93800
143333001900000,SW 417,RESIDENTIAL,20800,0,20800,63600,0,84400
143333002000000,SW 417,RESIDENTIAL,19700,0,19700,75200,0,94900
143333002100000,SW 417,RESIDENTIAL,19100,0,19100,68400,0,87500
143333002200000,SW 417,RESIDENTIAL,16900,0,16900,62000,0,78900
143333002300000,SW 417,RESIDENTIAL,16900,0,16900,72900,0,89800
143333002400000,SW 417,RESIDENTIAL,16900,0,16900,65400,0,82300
143333002500000,SW 417,RESIDENTIAL,19500,0,19500,86000,0,105500
143333002600000,SW 417,RESIDENTIAL,19500,0,19500,47500,0,67000
143333002700000,SW 417,RESIDENTIAL,20500,0,20500,82100,0,102600
143333002800000,SW 417,RESIDENTIAL,20000,0,20000,57100,0,77100
143333002900000,SW 417,RESIDENTIAL,16900,0,16900,64400,0,81300
143333003000000,SW 417,RESIDENTIAL,16900,0,16900,55900,0,72800
143333003100000,SW 417,RESIDENTIAL,16900,0,16900,63700,0,80600
143333003200000,SW 417,RESIDENTIAL,16900,0,16900,61900,0,78800
143333003300000,SW 417,RESIDENTIAL,16900,0,16900,73000,0,89900
143333003400000,SW 417,RESIDENTIAL,19100,0,19100,48600,0,67700
143333100100000,SW 417,RESIDENTIAL,21100,0,21100,86800,0,107900
143333100200000,SW 417,RESIDENTIAL,19900,0,19900,77200,0,97100
143333100300000,SW 417,RESIDENTIAL,18900,0,18900,43300,0,62200
143333100400000,SW 417,RESIDENTIAL,18400,0,18400,78900,0,97300
143333100500000,SW 417,RESIDENTIAL,18400,0,18400,57600,0,76000
143333100600000,SW 417,RESIDENTIAL,19800,0,19800,53900,0,73700
143333100700000,SW 417,RESIDENTIAL,19500,0,19500,66500,0,86000
143333100800000,SW 417,RESIDENTIAL,20100,0,20100,64900,0,85000
143333100900000,SW 417,RESIDENTIAL,16100,0,16100,93400,0,109500
143333101000000,SW 417,RESIDENTIAL,17800,0,17800,67700,0,85500
143333101100000,SW 417,RESIDENTIAL,19900,0,19900,77200,0,97100
143333101200000,SW 417,RESIDENTIAL,19400,0,19400,75000,0,94400
143333101300000,SW 417,RESIDENTIAL,19100,0,19100,65800,0,84900
143333101400000,SW 417,RESIDENTIAL,19400,0,19400,65800,0,85200
143333101500000,SW 417,RESIDENTIAL,19800,0,19800,49100,0,68900
143333101600000,SW 417,RESIDENTIAL,18300,0,18300,57300,0,75600
143333101700000,SW 417,RESIDENTIAL,17800,0,17800,60300,0,78100
143333101800000,SW 417,RESIDENTIAL,18900,0,18900,63300,0,82200
143333101900000,SW 417,RESIDENTIAL,20200,0,20200,74400,0,94600
143333102000000,SW 417,RESIDENTIAL,18200,0,18200,94500,0,112700
143333102100000,SW 417,RESIDENTIAL,20400,0,20400,68200,0,88600
143333102200000,SW 417,RESIDENTIAL,20700,0,20700,60100,0,80800
143333102300000,SW 417,RESIDENTIAL,19500,0,19500,50700,0,70200
143333200100000,SW 417,RESIDENTIAL,17300,0,17300,61100,0,78400
143333200200000,SW 417,RESIDENTIAL,17500,0,17500,58600,0,76100
143333200300000,SW 417,RESIDENTIAL,17500,0,17500,59900,0,77400
143333200400000,SW 417,RESIDENTIAL,17500,0,17500,74300,0,91800
143333200500000,SW 417,RESIDENTIAL,17500,0,17500,49200,0,66700
143333200600000,SW 417,RESIDENTIAL,18300,0,18300,61100,0,79400
143333200700000,SW 417,RESIDENTIAL,18600,0,18600,62300,0,80900
143333300100000,SW 417,RESIDENTIAL,18000,0,18000,55000,0,73000
143333300200000,SW 417,RESIDENTIAL,19200,0,19200,58500,0,77700
143333300300000,SW 417,RESIDENTIAL,22100,0,22100,68800,0,90900
143333300400000,SW 417,RESIDENTIAL,20000,0,20000,56600,0,76600
143333300500000,SW 417,RESIDENTIAL,18400,0,18400,80000,0,98400
143333300600000,SW 417,RESIDENTIAL,19600,0,19600,65400,0,85000
143333300700000,SW 417,RESIDENTIAL,21000,0,21000,64500,0,85500
143333300800000,SW 417,RESIDENTIAL,19100,0,19100,60500,0,79600
143333300900000,SW 417,RESIDENTIAL,19200,0,19200,83800,0,103000
143333301000000,SW 417,RESIDENTIAL,19000,0,19000,62600,0,81600
143333301100000,SW 417,RESIDENTIAL,19100,0,19100,100300,0,119400
143333301200000,SW 417,RESIDENTIAL,17600,0,17600,67000,0,84600
143333301300000,SW 417,RESIDENTIAL,19200,0,19200,60100,0,79300
143333301400000,SW 417,RESIDENTIAL,18900,0,18900,53500,0,72400
143333301500000,SW 417,RESIDENTIAL,18300,0,18300,61800,0,80100
143333301600000,SW 417,RESIDENTIAL,18300,0,18300,69600,0,87900
143333301700000,SW 417,RESIDENTIAL,18400,0,18400,56900,0,75300
143333301800000,SW 417,RESIDENTIAL,18700,0,18700,56300,0,75000
143333301900000,SW 417,RESIDENTIAL,19400,0,19400,51600,0,71000
143333302000000,SW 417,RESIDENTIAL,18700,0,18700,88500,0,107200
143333400100000,SW 417,RESIDENTIAL,19000,0,19000,57600,0,76600
143333400200000,SW 417,RESIDENTIAL,18900,0,18900,65200,0,84100
143333400300000,SW 417,RESIDENTIAL,17800,0,17800,62700,0,80500
143333400400000,SW 417,RESIDENTIAL,17000,0,17000,71500,0,88500
143333400500000,SW 417,RESIDENTIAL,17800,0,17800,58500,0,76300
143333400600000,SW 417,RESIDENTIAL,19400,0,19400,63000,0,82400
143333400700000,SW 417,RESIDENTIAL,19700,0,19700,65200,0,84900
143333400800000,SW 417,RESIDENTIAL,19600,0,19600,69100,0,88700
143333400900000,SW 417,RESIDENTIAL,19800,0,19800,59400,0,79200
143333401000000,SW 417,RESIDENTIAL,20200,0,20200,73600,0,93800
143333401100000,SW 417,RESIDENTIAL,20700,0,20700,104300,0,125000
143333401200000,SW 417,RESIDENTIAL,19500,0,19500,59700,0,79200
143333401300000,SW 417,RESIDENTIAL,17700,0,17700,67800,0,85500
143333401400000,SW 417,RESIDENTIAL,18300,0,18300,58700,0,77000
143333401500000,SW 417,RESIDENTIAL,19300,0,19300,76700,0,96000
143333401600000,SW 417,RESIDENTIAL,19200,0,19200,81400,0,100600
143333401700000,SW 417,RESIDENTIAL,17400,0,17400,78000,0,95400
143333401800000,SW 417,RESIDENTIAL,19400,0,19400,65600,0,85000
143333401900000,SW 417,RESIDENTIAL,19100,0,19100,68700,0,87800
143333402000000,SW 417,RESIDENTIAL,17300,0,17300,90300,0,107600
143333500100000,SW 417,RESIDENTIAL,18600,0,18600,78000,0,96600
143333500200000,SW 417,RESIDENTIAL,18400,0,18400,54600,0,73000
143333500300000,SW 417,RESIDENTIAL,19600,0,19600,64400,0,84000
143333500400000,SW 417,RESIDENTIAL,20600,0,20600,49900,0,70500
143333500500000,SW 417,RESIDENTIAL,19700,0,19700,55100,0,74800
143333500600000,SW 417,RESIDENTIAL,20000,0,20000,85400,0,105400
143333500700000,SW 417,RESIDENTIAL,23300,0,23300,63400,0,86700
143335100200000,SW 417,RESIDENTIAL,18400,0,18400,57500,0,75900
143335100300000,SW 417,RESIDENTIAL,18400,0,18400,55400,0,73800
143335100400000,SW 417,RESIDENTIAL,18400,0,18400,68300,0,86700
143335100500000,SW 417,RESIDENTIAL,18400,0,18400,54400,0,72800
143335100600000,SW 417,RESIDENTIAL,18400,0,18400,53100,0,71500
143335100800000,SW 417,RESIDENTIAL,18400,0,18400,87300,0,105700
143335100900000,SW 417,RESIDENTIAL,18400,0,18400,65900,0,84300
143335101000000,SW 417,RESIDENTIAL,18400,0,18400,56500,0,74900
143335101100000,SW 417,RESIDENTIAL,18400,0,18400,51400,0,69800
143335101200000,SW 417,RESIDENTIAL,18400,0,18400,65700,0,84100
143335200100000,SW 417,RESIDENTIAL,19600,0,19600,130400,0,150000
143335200200000,SW 417,RESIDENTIAL,16100,0,16100,73500,0,89600
143335200300000,SW 417,RESIDENTIAL,22100,0,22100,99000,0,121100
143335200400000,SW 417,RESIDENTIAL,22100,0,22100,72700,0,94800
143335200500000,SW 417,RESIDENTIAL,22100,0,22100,107900,0,130000
143335200600000,SW 417,RESIDENTIAL,22100,0,22100,67000,0,89100
143335200700000,SW 417,RESIDENTIAL,22100,0,22100,81200,0,103300
143335200800000,SW 417,RESIDENTIAL,22100,0,22100,93900,0,116000
143335200900000,SW 417,RESIDENTIAL,22100,0,22100,115300,0,137400
143335201000000,SW 417,RESIDENTIAL,22100,0,22100,104000,0,126100
143335201100000,SW 417,RESIDENTIAL,22100,0,22100,47400,0,69500
143335201200000,SW 417,RESIDENTIAL,20900,0,20900,91700,0,112600
143335201300000,SW 417,RESIDENTIAL,18100,0,18100,57300,0,75400
143335201400000,OFFICE; MEDICAL,COMMERCIAL,0,118300,118300,0,194300,312600
143335201500000,RESTAURANT,COMMERCIAL,0,178000,178000,0,131900,309900
143335201600000,VETERINARY CLINIC,COMMERCIAL,0,153300,153300,0,158300,311600
143335201700000,CARWASH,COMMERCIAL,0,281300,281300,0,147600,428900
143335201800000,SW 417,RESIDENTIAL,22100,0,22100,109000,0,131100
143335201900000,SW 417,RESIDENTIAL,21600,0,21600,2400,0,24000
143335202000000,SW 417,RESIDENTIAL,18800,0,18800,84700,0,103500
143335202100000,SW 417,RESIDENTIAL,18500,0,18500,61800,0,80300
143335202200000,SW 417,RESIDENTIAL,18500,0,18500,37900,0,56400
143335202300000,SW 417,RESIDENTIAL,18500,0,18500,37200,0,55700
143335202400000,SW 417,RESIDENTIAL,18500,0,18500,107600,0,126100
143335202500000,SW 417,RESIDENTIAL,18500,0,18500,96000,0,114500
143335202600000,SW 417,RESIDENTIAL,22100,0,22100,97100,0,119200
143335202700000,SW 417,RESIDENTIAL,22100,0,22100,79100,0,101200
143335202800000,SW 417,RESIDENTIAL,22100,0,22100,135200,0,157300
143335202900000,SW 417,RESIDENTIAL,18500,0,18500,88700,0,107200
143335203000000,SW 417,RESIDENTIAL,18500,0,18500,122100,0,140600
143335203100000,SW 417,RESIDENTIAL,24400,0,24400,90600,0,115000
143335300100000,SW 417,RESIDENTIAL,16100,0,16100,69300,0,85400
143335300200000,SW 417,RESIDENTIAL,2400,0,2400,0,0,2400
143335300300000,SW 417,RESIDENTIAL,18500,0,18500,82200,0,100700
143335300400000,SW 417,RESIDENTIAL,16100,0,16100,100200,0,116300
143335300500000,SW 417,RESIDENTIAL,18800,0,18800,89800,0,108600
143335300700000,SW 417,RESIDENTIAL,22100,0,22100,99500,0,121600
143335300800000,SW 417,RESIDENTIAL,22100,0,22100,27200,0,49300
143335300900000,SW 417,RESIDENTIAL,15300,0,15300,65600,0,80900
143335301000000,SW 417,RESIDENTIAL,15300,0,15300,47900,0,63200
143335301100000,SW 417,RESIDENTIAL,6300,0,6300,0,0,6300
143335301200000,SW 417,RESIDENTIAL,18500,0,18500,53000,0,71500
143335301300000,SW 417,RESIDENTIAL,18500,0,18500,56300,0,74800
143335301400000,SW 417,RESIDENTIAL,18500,0,18500,78200,0,96700
143335301800000,APARTMENT,MULTI-RES,18000,0,18000,112900,0,130900
143335301900000,FLAT PARKING,COMMERCIAL,0,51200,51200,0,4500,55700
143335302000000,FLAT PARKING,COMMERCIAL,0,51700,51700,0,5200,56900
143335302300000,RESTAURANT,COMMERCIAL,0,172300,172300,0,143500,315800
143335302400000,OFFICE,COMMERCIAL,0,166500,166500,0,406000,572500
143335302500000,STATE PROPERTY,EXEMPT,0,0,0,0,0,0
143335302600000,SW 417,RESIDENTIAL,19200,0,19200,58100,0,77300
143335302700000,SW 417,RESIDENTIAL,15600,0,15600,85400,0,101000
143335400100000,CHURCH,EXEMPT,0,227200,227200,0,313300,540500
143335400700000,SW 417,RESIDENTIAL,21800,0,21800,90900,0,112700
143335401300000,SW 417,RESIDENTIAL,21000,0,21000,80300,0,101300
143335401400000,SW 417,RESIDENTIAL,21100,0,21100,108900,0,130000
143335401500000,SW 417,RESIDENTIAL,18800,0,18800,50000,0,68800
143335401600000,SW 417,RESIDENTIAL,18800,0,18800,68300,0,87100
143335401700000,SW 417,RESIDENTIAL,4100,0,4100,0,0,4100
143335401800000,VACANT LAND,COMMERCIAL,0,38800,38800,0,0,38800
143335401900000,SW 417,RESIDENTIAL,14600,0,14600,88200,0,102800
143335402000000,SW 417,RESIDENTIAL,21800,0,21800,123900,0,145700
143335402100000,SW 417,RESIDENTIAL,21800,0,21800,132500,0,154300
143335402200000,SW 417,RESIDENTIAL,21800,0,21800,106200,0,128000
143335402300000,SW 417,RESIDENTIAL,21400,0,21400,87100,0,108500
143335402400000,SW 417,RESIDENTIAL,21600,0,21600,55700,0,77300
143335402500000,SR/NURSING/ASSTD LIV,EXEMPT,0,124200,124200,0,485800,610000
143337600100000,SW 416,RESIDENTIAL,27600,0,27600,92400,0,120000
143337600200000,SW 416,RESIDENTIAL,26500,0,26500,89900,0,116400
143337600300000,SW 416,RESIDENTIAL,45500,0,45500,78600,0,124100
143337600400000,SW 416,RESIDENTIAL,22400,0,22400,114200,0,136600
143337600500000,SW 416,RESIDENTIAL,22100,0,22100,111300,0,133400
143337600600000,SW 416,RESIDENTIAL,22100,0,22100,79600,0,101700
143337600700000,SW 416,RESIDENTIAL,22100,0,22100,82300,0,104400
143337600800000,SW 416,RESIDENTIAL,22600,0,22600,87700,0,110300
143337600900000,SW 416,RESIDENTIAL,23800,0,23800,112600,0,136400
143337601000000,SW 416,RESIDENTIAL,23600,0,23600,98500,0,122100
143337601100000,SW 416,RESIDENTIAL,28800,0,28800,113400,0,142200
143337601200000,SW 416,RESIDENTIAL,26100,0,26100,75000,0,101100
143337601300000,SW 416,RESIDENTIAL,25800,0,25800,83100,0,108900
143337601400000,SW 416,RESIDENTIAL,29200,0,29200,50500,0,79700
143337700100000,SW 417,RESIDENTIAL,25500,0,25500,110400,0,135900
143337700200000,SW 417,EXEMPT,0,22500,22500,0,113200,135700
143337800100000,SW 416,RESIDENTIAL,20700,0,20700,68100,0,88800
143337800200000,SW 416,RESIDENTIAL,20700,0,20700,73700,0,94400
143337800300000,SW 416,RESIDENTIAL,20700,0,20700,81000,0,101700
143337800400000,SW 416,RESIDENTIAL,20700,0,20700,85000,0,105700
143337800500000,SW 416,RESIDENTIAL,20700,0,20700,88100,0,108800
143337800600000,SW 416,RESIDENTIAL,26800,0,26800,38700,0,65500
143337800700000,SW 416,RESIDENTIAL,15500,0,15500,92000,0,107500
143337800900000,SW 416,RESIDENTIAL,23200,0,23200,108100,0,131300
143337801000000,SW 416,RESIDENTIAL,20700,0,20700,130400,0,151100
143337801100000,SW 416,RESIDENTIAL,20700,0,20700,92400,0,113100
143337801200000,SW 416,RESIDENTIAL,23000,0,23000,59200,0,82200
143337801300000,SW 416,RESIDENTIAL,26600,0,26600,74100,0,100700
143337801400000,SW 416,RESIDENTIAL,21600,0,21600,87200,0,108800
143337801500000,SW 416,RESIDENTIAL,26800,0,26800,99100,0,125900
143337801600000,SW 416,RESIDENTIAL,26800,0,26800,78700,0,105500
143337801700000,SW 416,RESIDENTIAL,26800,0,26800,75200,0,102000
143337801800000,SW 416,RESIDENTIAL,26800,0,26800,123700,0,150500
143337801900000,SW 416,RESIDENTIAL,26800,0,26800,43800,0,70600
143337802000000,SW 416,RESIDENTIAL,28400,0,28400,75600,0,104000
143337802200000,SW 416,RESIDENTIAL,19400,0,19400,73300,0,92700
143337802300000,SW 416,RESIDENTIAL,19400,0,19400,70800,0,90200
143337802400000,SW 416,RESIDENTIAL,25900,0,25900,103300,0,129200
143337802500000,SW 416,RESIDENTIAL,26400,0,26400,54500,0,80900
143337802600000,SW 416,RESIDENTIAL,7700,0,7700,0,0,7700
143337900100000,SW 417,RESIDENTIAL,24400,0,24400,56500,0,80900
143337900200000,SW 417,RESIDENTIAL,23000,0,23000,0,0,23000
143337900300000,SW 417,RESIDENTIAL,23000,0,23000,83900,0,106900
143338000100000,SW 416,RESIDENTIAL,25500,0,25500,67600,0,93100
143338000200000,SW 416,RESIDENTIAL,17500,0,17500,63000,0,80500
143338000300000,SW 416,EXEMPT,0,30700,30700,0,214200,244900
143338000400000,SW 416,RESIDENTIAL,20700,0,20700,15800,0,36500
143338000500000,SW 416,RESIDENTIAL,20700,0,20700,100900,0,121600
143338000600000,SW 416,RESIDENTIAL,26800,0,26800,81300,0,108100
143338000700000,SW 416,RESIDENTIAL,17500,0,17500,63500,0,81000
143338000800000,SW 416,RESIDENTIAL,21400,0,21400,87000,0,108400
143338000900000,SW 416,RESIDENTIAL,26800,0,26800,67500,0,94300
143338001000000,SW 416,RESIDENTIAL,26800,0,26800,107900,0,134700
143338001100000,SW 416,RESIDENTIAL,24500,0,24500,122300,0,146800
143338001200000,SW 416,RESIDENTIAL,9300,0,9300,0,0,9300
143338100100000,SW 417,RESIDENTIAL,18800,0,18800,61100,0,79900
143340100700000,SW 414,RESIDENTIAL,22200,0,22200,55100,0,77300
143340100800000,SW 414,RESIDENTIAL,22200,0,22200,76300,0,98500
143340100900000,SW 414,RESIDENTIAL,22200,0,22200,56500,0,78700
143340101000000,SW 414,RESIDENTIAL,24200,0,24200,46800,0,71000
143340101100000,SW 414,RESIDENTIAL,24200,0,24200,80600,0,104800
143340101200000,SW 414,RESIDENTIAL,38800,0,38800,80300,0,119100
143340101300000,SW 414,RESIDENTIAL,22200,0,22200,60500,0,82700
143340101400000,SW 414,RESIDENTIAL,37800,0,37800,96300,0,134100
143340101600000,SW 414,RESIDENTIAL,38900,0,38900,137400,0,176300
143340101800000,CONVENIENCE STORE,COMMERCIAL,0,258000,258000,0,919200,1177200
143340200100000,SW 414,RESIDENTIAL,30000,0,30000,75500,0,105500
143340200200000,SW 414,RESIDENTIAL,30500,0,30500,88400,0,118900
143340200300000,SW 414,RESIDENTIAL,29700,0,29700,100100,0,129800
143340200400000,SW 414,RESIDENTIAL,29400,0,29400,116400,0,145800
143340200500000,SW 414,RESIDENTIAL,17800,0,17800,124700,0,142500
143340200600000,SW 414,RESIDENTIAL,32600,0,32600,111800,0,144400
143340200700000,SW 414,RESIDENTIAL,32600,0,32600,103600,0,136200
143340200800000,SW 414,RESIDENTIAL,22200,0,22200,97800,0,120000
143340200900000,SW 414,RESIDENTIAL,23000,0,23000,78300,0,101300
143340201000000,SW 414,RESIDENTIAL,13100,0,13100,60400,0,73500
143340201100000,SW 414,RESIDENTIAL,26300,0,26300,83900,0,110200
143340201200000,SW 414,RESIDENTIAL,30400,0,30400,93200,0,123600
143340201300000,SW 414,RESIDENTIAL,29700,0,29700,77100,0,106800
143340201400000,SW 414,RESIDENTIAL,29700,0,29700,107100,0,136800
143340201500000,SW 414,RESIDENTIAL,30100,0,30100,76900,0,107000
143340201600000,SW 414,RESIDENTIAL,24300,0,24300,91100,0,115400
143340201700000,SW 414,RESIDENTIAL,24000,0,24000,98500,0,122500
143340201800000,SW 414,RESIDENTIAL,24000,0,24000,86000,0,110000
143340201900000,SW 414,RESIDENTIAL,24000,0,24000,72900,0,96900
143340202000000,SW 414,RESIDENTIAL,24500,0,24500,79700,0,104200
143340202100000,SW 414,RESIDENTIAL,34300,0,34300,82900,0,117200
143340300100000,SW 414,RESIDENTIAL,29500,0,29500,106100,0,135600
143340300200000,SW 414,RESIDENTIAL,36600,0,36600,53400,0,90000
143340300300000,SW 414,RESIDENTIAL,35200,0,35200,122700,0,157900
143340300400000,SW 414,RESIDENTIAL,38100,0,38100,53500,0,91600
143340300500000,SW 414,RESIDENTIAL,24500,0,24500,139700,0,164200
143340300600000,SW 414,RESIDENTIAL,29300,0,29300,143200,0,172500
143340300700000,SW 414,RESIDENTIAL,23300,0,23300,114800,0,138100
143340300800000,SW 414,RESIDENTIAL,23600,0,23600,106600,0,130200
143340300900000,SW 414,RESIDENTIAL,29900,0,29900,171600,0,201500
143340301000000,SW 414,RESIDENTIAL,29600,0,29600,151500,0,181100
143340301100000,CITY PROPERTY,EXEMPT,0,0,0,0,0,0
143340301200000,SW 414,RESIDENTIAL,32400,0,32400,126000,0,158400
143340301300000,SW 414,RESIDENTIAL,29600,0,29600,128800,0,158400
143340301400000,SW 414,RESIDENTIAL,27400,0,27400,134500,0,161900
143340301500000,SW 414,RESIDENTIAL,27400,0,27400,130400,0,157800
143340301600000,SW 414,RESIDENTIAL,29700,0,29700,126300,0,156000
143340301700000,SW 414,RESIDENTIAL,31400,0,31400,79900,0,111300
143340301800000,SW 414,RESIDENTIAL,27900,0,27900,87900,0,115800
143340301900000,SW 414,RESIDENTIAL,28600,0,28600,111300,0,139900
143340302000000,SW 414,RESIDENTIAL,29200,0,29200,104700,0,133900
143340302100000,SW 414,RESIDENTIAL,29100,0,29100,94800,0,123900
143340302200000,SW 414,RESIDENTIAL,29100,0,29100,117700,0,146800
143340302300000,SW 414,RESIDENTIAL,29500,0,29500,99700,0,129200
143340302400000,SW 414,RESIDENTIAL,29500,0,29500,93200,0,122700
143340302500000,SW 414,RESIDENTIAL,26600,0,26600,89300,0,115900
143340302600000,SW 414,RESIDENTIAL,26600,0,26600,79300,0,105900
143340302700000,SW 414,RESIDENTIAL,28300,0,28300,99200,0,127500
143340302800000,SW 414,RESIDENTIAL,25300,0,25300,86400,0,111700
143340302900000,SW 414,RESIDENTIAL,25000,0,25000,125800,0,150800
143340303000000,SW 414,RESIDENTIAL,29600,0,29600,111900,0,141500
143340303100000,SW 414,RESIDENTIAL,24600,0,24600,101300,0,125900
143340303200000,SW 414,RESIDENTIAL,29100,0,29100,108800,0,137900
143340400100000,SW 414,RESIDENTIAL,27500,0,27500,84500,0,112000
143340400200000,SW 414,RESIDENTIAL,27200,0,27200,109700,0,136900
143340400300000,SW 414,RESIDENTIAL,27200,0,27200,113400,0,140600
143340400400000,SW 414,RESIDENTIAL,26900,0,26900,125400,0,152300
143340400500000,SW 414,RESIDENTIAL,30500,0,30500,120900,0,151400
143340400600000,SW 414,RESIDENTIAL,26600,0,26600,119000,0,145600
143340400700000,SW 414,RESIDENTIAL,26600,0,26600,111500,0,138100
143340400800000,SW 414,RESIDENTIAL,25400,0,25400,84600,0,110000
143340400900000,SW 414,RESIDENTIAL,23600,0,23600,87800,0,111400
143340401000000,SW 414,RESIDENTIAL,28500,0,28500,98900,0,127400
143340401100000,SW 414,RESIDENTIAL,27300,0,27300,98400,0,125700
143340401200000,SW 414,RESIDENTIAL,23400,0,23400,86300,0,109700
143340401300000,SW 414,RESIDENTIAL,21200,0,21200,104300,0,125500
143340401400000,SW 414,RESIDENTIAL,24500,0,24500,121000,0,145500
143340401500000,SW 414,RESIDENTIAL,26900,0,26900,120100,0,147000
143340401600000,SW 414,RESIDENTIAL,32600,0,32600,85400,0,118000
143340500100000,SW 414,RESIDENTIAL,27500,0,27500,94600,0,122100
143340500200000,SW 414,RESIDENTIAL,27200,0,27200,85500,0,112700
143340500300000,SW 414,RESIDENTIAL,27200,0,27200,84000,0,111200
143340500400000,SW 414,RESIDENTIAL,27300,0,27300,92700,0,120000
143340500500000,SW 414,RESIDENTIAL,29900,0,29900,114300,0,144200
143340500600000,SW 414,RESIDENTIAL,31500,0,31500,95600,0,127100
143340500700000,SW 414,RESIDENTIAL,31500,0,31500,100100,0,131600
143340500800000,SW 414,RESIDENTIAL,31500,0,31500,84800,0,116300
143340500900000,SW 414,RESIDENTIAL,31700,0,31700,97600,0,129300
143340501000000,SW 414,RESIDENTIAL,31400,0,31400,110300,0,141700
143340501100000,SW 414,RESIDENTIAL,30200,0,30200,126500,0,156700
143340501200000,SW 414,RESIDENTIAL,30000,0,30000,112600,0,142600
143340501300000,SW 414,RESIDENTIAL,31600,0,31600,89500,0,121100
143340501400000,SW 414,RESIDENTIAL,29900,0,29900,106000,0,135900
143340600100000,SW 414,RESIDENTIAL,32300,0,32300,86700,0,119000
143340600200000,SW 414,RESIDENTIAL,32300,0,32300,102400,0,134700
143340600300000,SW 414,RESIDENTIAL,24200,0,24200,124700,0,148900
143340600400000,SW 414,RESIDENTIAL,24300,0,24300,70100,0,94400
143340600500000,SW 414,RESIDENTIAL,25100,0,25100,81400,0,106500
143340600600000,SW 414,RESIDENTIAL,26000,0,26000,76700,0,102700
143340700100000,SW 414,RESIDENTIAL,26500,0,26500,117400,0,143900
143340700200000,SW 414,RESIDENTIAL,25300,0,25300,91500,0,116800
143340700300000,SW 414,RESIDENTIAL,25000,0,25000,91800,0,116800
143340700400000,SW 414,RESIDENTIAL,22600,0,22600,93300,0,115900
143340700500000,SW 414,RESIDENTIAL,22000,0,22000,91400,0,113400
143340700600000,SW 414,RESIDENTIAL,23100,0,23100,94500,0,117600
143340700700000,SW 414,RESIDENTIAL,22300,0,22300,81100,0,103400
143340700800000,SW 414,RESIDENTIAL,28200,0,28200,96100,0,124300
143340800100000,SW 414,RESIDENTIAL,22900,0,22900,92500,0,115400
143340800200000,SW 414,RESIDENTIAL,28800,0,28800,96000,0,124800
143340800300000,SW 414,RESIDENTIAL,26900,0,26900,99200,0,126100
143340800400000,SW 414,RESIDENTIAL,25700,0,25700,92000,0,117700
143340800500000,SW 414,RESIDENTIAL,25200,0,25200,95300,0,120500
143340800600000,SW 414,RESIDENTIAL,27600,0,27600,101300,0,128900
143340800700000,SW 414,RESIDENTIAL,27800,0,27800,111200,0,139000
143340800800000,SW 414,RESIDENTIAL,23100,0,23100,108400,0,131500
143340900100000,SW 414,RESIDENTIAL,26100,0,26100,82800,0,108900
143340900200000,SW 414,RESIDENTIAL,29200,0,29200,94500,0,123700
143340900300000,SW 414,RESIDENTIAL,31300,0,31300,88400,0,119700
143340900400000,SW 414,RESIDENTIAL,29000,0,29000,95300,0,124300
143340900500000,SW 414,RESIDENTIAL,26600,0,26600,87900,0,114500
143340900600000,SW 414,RESIDENTIAL,27300,0,27300,82100,0,109400
143340900700000,SW 414,RESIDENTIAL,24600,0,24600,89000,0,113600
143340900800000,SW 414,RESIDENTIAL,27600,0,27600,76300,0,103900
143340900900000,SW 414,RESIDENTIAL,25300,0,25300,103500,0,128800
143340901000000,SW 414,RESIDENTIAL,26100,0,26100,80000,0,106100
143340901100000,SW 414,RESIDENTIAL,25300,0,25300,96200,0,121500
143340901200000,SW 414,RESIDENTIAL,25600,0,25600,109300,0,134900
143340901300000,SW 414,RESIDENTIAL,25800,0,25800,81200,0,107000
143341000100000,SW 414,RESIDENTIAL,32600,0,32600,94600,0,127200
143341000200000,SW 414,RESIDENTIAL,25500,0,25500,97400,0,122900
143341000300000,SW 414,RESIDENTIAL,25400,0,25400,116400,0,141800
143341000400000,SW 414,RESIDENTIAL,24900,0,24900,121900,0,146800
143341000500000,SW 414,RESIDENTIAL,28600,0,28600,92200,0,120800
143341000600000,SW 414,RESIDENTIAL,26300,0,26300,103500,0,129800
143342600100000,SW 416,RESIDENTIAL,30200,0,30200,113100,0,143300
143342600200000,SW 416,RESIDENTIAL,25200,0,25200,81800,0,107000
143342600300000,SW 416,RESIDENTIAL,23400,0,23400,61000,0,84400
143342600400000,SW 416,RESIDENTIAL,23400,0,23400,99400,0,122800
143342600500000,SW 416,RESIDENTIAL,23800,0,23800,76800,0,100600
143342600600000,SW 416,RESIDENTIAL,23800,0,23800,63900,0,87700
143342600700000,SW 416,RESIDENTIAL,23800,0,23800,97700,0,121500
143342600800000,SW 416,RESIDENTIAL,22600,0,22600,114400,0,137000
143342600900000,SW 416,RESIDENTIAL,29700,0,29700,89200,0,118900
143342601000000,SW 416,RESIDENTIAL,18900,0,18900,129200,0,148100
143342601100000,SW 416,RESIDENTIAL,13000,0,13000,42200,0,55200
143342601200000,SW 416,RESIDENTIAL,13000,0,13000,55800,0,68800
143342601300000,SW 416,RESIDENTIAL,13000,0,13000,37300,0,50300
143342601400000,SW 416,RESIDENTIAL,13000,0,13000,80200,0,93200
143342601500000,SW 416,RESIDENTIAL,13000,0,13000,106800,0,119800
143342601600000,SW 416,RESIDENTIAL,24700,0,24700,75500,0,100200
143342601700000,SW 416,RESIDENTIAL,23800,0,23800,122200,0,146000
143342601800000,SW 416,RESIDENTIAL,23800,0,23800,79800,0,103600
143342601900000,SW 416,RESIDENTIAL,23800,0,23800,69300,0,93100
143342602000000,SW 416,RESIDENTIAL,22600,0,22600,0,0,22600
143342602100000,SW 416,RESIDENTIAL,24200,0,24200,151300,0,175500
143342700100000,SCHOOL,EXEMPT,0,0,0,0,0,0
143342700102000,ANTENNAS/TOWERS(BLL),COMMERCIAL,0,0,0,0,5300,5300
143342700200000,SW 416,RESIDENTIAL,24000,0,24000,95800,0,119800
143342700300000,SW 416,RESIDENTIAL,15400,0,15400,68000,0,83400
143342700400000,SW 416,RESIDENTIAL,13700,0,13700,60000,0,73700
143342700500000,SW 416,RESIDENTIAL,20600,0,20600,69300,0,89900
143342700600000,SW 416,RESIDENTIAL,20600,0,20600,65400,0,86000
143342700700000,SW 416,RESIDENTIAL,13700,0,13700,48400,0,62100
143342700800000,SW 416,RESIDENTIAL,28800,0,28800,76900,0,105700
143342700900000,SW 416,RESIDENTIAL,13700,0,13700,105300,0,119000
143342701000000,SW 416,RESIDENTIAL,13700,0,13700,96800,0,110500
143342701100000,SW 416,RESIDENTIAL,13700,0,13700,73300,0,87000
143342701200000,SW 416,RESIDENTIAL,13700,0,13700,69500,0,83200
143342701300000,SW 416,RESIDENTIAL,13700,0,13700,77000,0,90700
143342701400000,SW 416,RESIDENTIAL,13700,0,13700,72100,0,85800
143342701500000,SW 416,RESIDENTIAL,27400,0,27400,63500,0,90900
143342701600000,SW 416,RESIDENTIAL,27400,0,27400,88500,0,115900
143342701700000,SW 416,RESIDENTIAL,13700,0,13700,71400,0,85100
143342800100000,SW 414,RESIDENTIAL,31400,0,31400,180700,0,212100
143342800200000,SW 416,RESIDENTIAL,20400,0,20400,98400,0,118800
143342800300000,SW 416,RESIDENTIAL,20700,0,20700,80400,0,101100
143342800400000,SW 416,RESIDENTIAL,20700,0,20700,80500,0,101200
143342800500000,SW 416,RESIDENTIAL,22300,0,22300,108100,0,130400
143342800600000,SW 416,RESIDENTIAL,22300,0,22300,82500,0,104800
143342800700000,SW 416,RESIDENTIAL,20700,0,20700,81100,0,101800
143342800800000,SW 416,RESIDENTIAL,20500,0,20500,84600,0,105100
143342800900000,SW 416,RESIDENTIAL,20500,0,20500,120900,0,141400
143342801000000,SW 416,RESIDENTIAL,20500,0,20500,102600,0,123100
143342801100000,SW 416,RESIDENTIAL,20500,0,20500,109000,0,129500
143342801200000,SW 416,RESIDENTIAL,20500,0,20500,124700,0,145200
143342801300000,SW 416,RESIDENTIAL,19200,0,19200,100000,0,119200
143342801600000,SW 414,RESIDENTIAL,28200,0,28200,147200,0,175400
143342801700000,SW 414,RESIDENTIAL,25200,0,25200,143800,0,169000
143342801800000,SW 414,RESIDENTIAL,25200,0,25200,139100,0,164300
143342801900000,SW 414,RESIDENTIAL,27400,0,27400,110000,0,137400
143342802000000,SW 414,RESIDENTIAL,32100,0,32100,178600,0,210700
143342802100000,SW 416,RESIDENTIAL,22900,0,22900,193900,0,216800
143342802200000,SW 416,RESIDENTIAL,21100,0,21100,213600,0,234700
143342900100000,SW 416,RESIDENTIAL,24800,0,24800,88400,0,113200
143342900200000,SW 416,RESIDENTIAL,17900,0,17900,78000,0,95900
143342900300000,SW 416,RESIDENTIAL,15300,0,15300,49400,0,64700
143342900400000,SW 416,RESIDENTIAL,12900,0,12900,64000,0,76900
143342900500000,SW 416,RESIDENTIAL,12900,0,12900,55200,0,68100
143342900600000,SW 416,RESIDENTIAL,13700,0,13700,65900,0,79600
143342900700000,SW 416,RESIDENTIAL,16000,0,16000,62300,0,78300
143342900800000,SW 416,RESIDENTIAL,14800,0,14800,117200,0,132000
143342900900000,SW 416,RESIDENTIAL,14800,0,14800,80900,0,95700
143342901000000,SW 416,RESIDENTIAL,14800,0,14800,91100,0,105900
143342901100000,SW 416,RESIDENTIAL,14800,0,14800,87800,0,102600
143342901200000,SW 416,RESIDENTIAL,22300,0,22300,93600,0,115900
143342901300000,SW 416,RESIDENTIAL,22300,0,22300,140200,0,162500
143342901400000,SW 416,RESIDENTIAL,14800,0,14800,87200,0,102000
143342901500000,SW 416,RESIDENTIAL,22300,0,22300,78800,0,101100
143342901600000,SW 416,RESIDENTIAL,22300,0,22300,100000,0,122300
143342901700000,SW 416,RESIDENTIAL,14800,0,14800,78400,0,93200
143342901800000,SW 416,RESIDENTIAL,14800,0,14800,60200,0,75000
143342901900000,SW 416,RESIDENTIAL,22300,0,22300,99400,0,121700
143342902000000,SW 416,RESIDENTIAL,18600,0,18600,106200,0,124800
143342902100000,SW 416,RESIDENTIAL,18600,0,18600,76600,0,95200
143342902200000,SW 416,RESIDENTIAL,23900,0,23900,91200,0,115100
143342902300000,SW 416,RESIDENTIAL,17100,0,17100,25600,0,42700
143342902400000,SW 416,RESIDENTIAL,21100,0,21100,70500,0,91600
143342902500000,SW 416,RESIDENTIAL,20700,0,20700,90400,0,111100
143342902600000,SW 416,RESIDENTIAL,26700,0,26700,80100,0,106800
143342902700000,SW 416,RESIDENTIAL,26700,0,26700,91200,0,117900
143342902800000,SW 416,RESIDENTIAL,26700,0,26700,92800,0,119500
143342902900000,SW 416,RESIDENTIAL,26700,0,26700,73900,0,100600
143342903000000,SW 416,RESIDENTIAL,14800,0,14800,32000,0,46800
143342903100000,SW 416,RESIDENTIAL,14800,0,14800,93900,0,108700
143342903200000,SW 416,RESIDENTIAL,26700,0,26700,86300,0,113000
143342903300000,SW 416,RESIDENTIAL,14800,0,14800,89400,0,104200
143342903400000,SW 416,RESIDENTIAL,14800,0,14800,38400,0,53200
143342903500000,SW 416,RESIDENTIAL,14800,0,14800,33200,0,48000
143342903600000,SW 416,RESIDENTIAL,14800,0,14800,68000,0,82800
143342903900000,SW 416,RESIDENTIAL,14800,0,14800,27500,0,42300
143342904000000,SW 416,RESIDENTIAL,22300,0,22300,96700,0,119000
143345100100000,SW 416,RESIDENTIAL,18200,0,18200,81700,0,99900
143345100200000,SW 416,RESIDENTIAL,23700,0,23700,79500,0,103200
143345100300000,SW 416,RESIDENTIAL,22000,0,22000,73300,0,95300
143345100400000,SW 416,RESIDENTIAL,25700,0,25700,147200,0,172900
143345100500000,SW 416,RESIDENTIAL,21600,0,21600,103300,0,124900
143345100600000,SW 416,RESIDENTIAL,18700,0,18700,68600,0,87300
143345100700000,SW 416,RESIDENTIAL,19100,0,19100,51700,0,70800
143345100800000,SW 416,RESIDENTIAL,19400,0,19400,75000,0,94400
143345200100000,SW 416,RESIDENTIAL,26500,0,26500,119100,0,145600
143345200200000,SW 416,RESIDENTIAL,26100,0,26100,105300,0,131400
143345200400000,SW 416,RESIDENTIAL,22400,0,22400,52700,0,75100
143345200500000,SW 416,RESIDENTIAL,16100,0,16100,65800,0,81900
143345200600000,SW 416,RESIDENTIAL,17000,0,17000,68900,0,85900
143345200700000,SW 416,RESIDENTIAL,17000,0,17000,95400,0,112400
143345200800000,SW 416,RESIDENTIAL,17000,0,17000,141400,0,158400
143345200900000,SW 416,RESIDENTIAL,20000,0,20000,86100,0,106100
143345201000000,SW 416,RESIDENTIAL,17200,0,17200,96600,0,113800
143345201100000,SW 416,RESIDENTIAL,22900,0,22900,105300,0,128200
143345201200000,SW 416,RESIDENTIAL,18700,0,18700,88100,0,106800
143345201300000,SW 416,RESIDENTIAL,25500,0,25500,77300,0,102800
143345201400000,SW 416,RESIDENTIAL,2600,0,2600,1400,0,4000
143345300100000,SW 416,RESIDENTIAL,21100,0,21100,111500,0,132600
143345300200000,SW 416,RESIDENTIAL,27600,0,27600,70700,0,98300
143345300300000,SW 416,RESIDENTIAL,24500,0,24500,46600,0,71100
143345300400000,SW 416,RESIDENTIAL,23800,0,23800,86900,0,110700
143345300500000,SW 416,RESIDENTIAL,45900,0,45900,151000,0,196900
143345300600000,SW 416,RESIDENTIAL,45900,0,45900,0,0,45900
143345300700000,SCHOOL,EXEMPT,0,0,0,0,0,0
143345300800000,SW 416,RESIDENTIAL,25800,0,25800,71100,0,96900
143345300900000,SW 416,RESIDENTIAL,17200,0,17200,92800,0,110000
143345301000000,SW 416,RESIDENTIAL,20600,0,20600,91500,0,112100
143345301100000,SW 416,RESIDENTIAL,20600,0,20600,68200,0,88800
143345301200000,SW 416,RESIDENTIAL,22300,0,22300,105800,0,128100
143345301300000,SW 416,RESIDENTIAL,18900,0,18900,76100,0,95000
143345301400000,SW 416,RESIDENTIAL,20600,0,20600,66600,0,87200
143345301500000,SW 416,RESIDENTIAL,25700,0,25700,72400,0,98100
143345301600000,SW 416,RESIDENTIAL,29800,0,29800,94000,0,123800
143345301700000,SW 416,RESIDENTIAL,27100,0,27100,57800,0,84900
143345301800000,SW 416,RESIDENTIAL,28800,0,28800,94800,0,123600
143345301900000,SW 416,RESIDENTIAL,29100,0,29100,88900,0,118000
143345302000000,SW 416,RESIDENTIAL,30700,0,30700,83600,0,114300
143345302100000,SW 416,RESIDENTIAL,31100,0,31100,78600,0,109700
143345302200000,SW 416,RESIDENTIAL,31100,0,31100,96000,0,127100
143345302300000,SW 416,RESIDENTIAL,24600,0,24600,105800,0,130400
143345302400000,SW 416,RESIDENTIAL,28600,0,28600,40000,0,68600
143345302500000,SW 416,RESIDENTIAL,34400,0,34400,77800,0,112200
143345302600000,SW 416,RESIDENTIAL,37000,0,37000,79100,0,116100
143345302700000,SW 416,RESIDENTIAL,17700,0,17700,73900,0,91600
143345302800000,SW 416,RESIDENTIAL,18400,0,18400,32700,0,51100
143345400100000,SW 416,RESIDENTIAL,25700,0,25700,58100,0,83800
143345400200000,SW 416,RESIDENTIAL,29000,0,29000,80100,0,109100
143345400300000,SW 416,RESIDENTIAL,31100,0,31100,58700,0,89800
143345400400000,SW 416,RESIDENTIAL,30900,0,30900,37300,0,68200
143345400500000,SW 416,RESIDENTIAL,32100,0,32100,40800,0,72900
143345400600000,SW 416,RESIDENTIAL,25100,0,25100,58300,0,83400
143345400700000,SW 416,RESIDENTIAL,21500,0,21500,81500,0,103000
143345400800000,SW 416,RESIDENTIAL,22100,0,22100,99600,0,121700
143345400900000,SW 416,RESIDENTIAL,19500,0,19500,33300,0,52800
143345401000000,SW 416,RESIDENTIAL,25000,0,25000,78900,0,103900
143345401100000,SW 416,RESIDENTIAL,22100,0,22100,79000,0,101100
143345401200000,SW 416,RESIDENTIAL,24100,0,24100,93200,0,117300
143345401300000,SW 416,RESIDENTIAL,19100,0,19100,60900,0,80000
143345401400000,SW 416,RESIDENTIAL,19100,0,19100,67900,0,87000
143345401500000,SW 416,RESIDENTIAL,19500,0,19500,53100,0,72600
143345401600000,SW 416,RESIDENTIAL,19600,0,19600,61300,0,80900
143345401700000,SW 416,RESIDENTIAL,20100,0,20100,75700,0,95800
143345401800000,SW 416,RESIDENTIAL,20100,0,20100,63900,0,84000
143345401900000,SW 416,RESIDENTIAL,20100,0,20100,86600,0,106700
143345402000000,SW 416,RESIDENTIAL,20100,0,20100,85100,0,105200
143345402100000,SW 416,RESIDENTIAL,20100,0,20100,106000,0,126100
143345402200000,SW 416,RESIDENTIAL,16800,0,16800,62800,0,79600
143345402300000,SW 416,RESIDENTIAL,24600,0,24600,61700,0,86300
143345402400000,SW 416,RESIDENTIAL,23700,0,23700,86700,0,110400
143345402500000,SW 416,RESIDENTIAL,24900,0,24900,86400,0,111300
143345402600000,SW 416,RESIDENTIAL,20700,0,20700,107900,0,128600
143345402700000,SW 416,RESIDENTIAL,20500,0,20500,80800,0,101300
143345402800000,SW 416,RESIDENTIAL,30500,0,30500,51700,0,82200
143345402900000,SW 416,RESIDENTIAL,28500,0,28500,138300,0,166800
143345403000000,SW 416,RESIDENTIAL,27000,0,27000,82300,0,109300
143345403100000,SW 416,RESIDENTIAL,28100,0,28100,88900,0,117000
143345403200000,SW 416,RESIDENTIAL,27300,0,27300,115600,0,142900
143345403300000,SW 416,RESIDENTIAL,24100,0,24100,84000,0,108100
143345403400000,SW 416,RESIDENTIAL,22500,0,22500,80600,0,103100
143345403500000,SW 416,RESIDENTIAL,22300,0,22300,97200,0,119500
143345403600000,SW 416,RESIDENTIAL,28700,0,28700,106500,0,135200
143347600100000,SW 414,RESIDENTIAL,31700,0,31700,94700,0,126400
143347600200000,SW 414,RESIDENTIAL,25500,0,25500,91700,0,117200
143347600300000,SW 414,RESIDENTIAL,31800,0,31800,129100,0,160900
143347600400000,SW 414,RESIDENTIAL,25900,0,25900,133000,0,158900
143347600500000,SW 414,RESIDENTIAL,27500,0,27500,90400,0,117900
143347600600000,SW 414,RESIDENTIAL,29100,0,29100,114700,0,143800
143347700100000,SW 414,RESIDENTIAL,26600,0,26600,105800,0,132400
143347700200000,SW 414,RESIDENTIAL,29000,0,29000,101600,0,130600
143347700300000,SW 414,RESIDENTIAL,29000,0,29000,111800,0,140800
143347700400000,SW 414,RESIDENTIAL,32100,0,32100,63300,0,95400
143347700500000,SW 414,RESIDENTIAL,28800,0,28800,90200,0,119000
143347700600000,SW 414,RESIDENTIAL,33700,0,33700,74100,0,107800
143347700700000,SW 414,RESIDENTIAL,33000,0,33000,141000,0,174000
143347700800000,SW 414,RESIDENTIAL,37400,0,37400,164500,0,201900
143347700900000,SW 414,RESIDENTIAL,28800,0,28800,101800,0,130600
143347701000000,SW 414,RESIDENTIAL,36000,0,36000,100800,0,136800
143347701100000,SW 414,RESIDENTIAL,36000,0,36000,129700,0,165700
143347701200000,SW 414,RESIDENTIAL,24000,0,24000,88800,0,112800
143347701300000,SW 414,RESIDENTIAL,36000,0,36000,115700,0,151700
143347701400000,SW 414,RESIDENTIAL,32400,0,32400,65100,0,97500
143347701500000,SW 414,RESIDENTIAL,32400,0,32400,136300,0,168700
143347701600000,SW 414,RESIDENTIAL,33000,0,33000,114600,0,147600
143347701700000,SW 414,RESIDENTIAL,33000,0,33000,47500,0,80500
143347701800000,SW 414,RESIDENTIAL,32200,0,32200,90300,0,122500
143347701900000,SW 414,RESIDENTIAL,24200,0,24200,165900,0,190100
143347702000000,SW 414,RESIDENTIAL,32800,0,32800,159100,0,191900
143347702100000,SW 414,RESIDENTIAL,24600,0,24600,80100,0,104700
143347702200000,SW 414,RESIDENTIAL,24600,0,24600,85000,0,109600
143347702300000,SW 414,RESIDENTIAL,24600,0,24600,101100,0,125700
143347702400000,SW 414,RESIDENTIAL,23900,0,23900,90500,0,114400
143347702500000,SW 414,RESIDENTIAL,34400,0,34400,95000,0,129400
143347702600000,SW 414,RESIDENTIAL,34100,0,34100,107900,0,142000
143347702700000,SW 414,RESIDENTIAL,33300,0,33300,110200,0,143500
143347702800000,SW 414,RESIDENTIAL,31600,0,31600,97800,0,129400
143347702900000,SW 414,RESIDENTIAL,31600,0,31600,108800,0,140400
143347703000000,SW 414,RESIDENTIAL,31600,0,31600,119000,0,150600
143347703100000,SW 414,RESIDENTIAL,31200,0,31200,92800,0,124000
143347703200000,SW 414,RESIDENTIAL,31200,0,31200,107400,0,138600
143347703300000,SW 414,RESIDENTIAL,26000,0,26000,133700,0,159700
143347703400000,SW 414,RESIDENTIAL,32200,0,32200,101800,0,134000
143347703500000,SW 414,RESIDENTIAL,29700,0,29700,111000,0,140700
143347703600000,SW 414,RESIDENTIAL,30200,0,30200,94100,0,124300
143347703700000,SW 414,RESIDENTIAL,30000,0,30000,92400,0,122400
143347703800000,SW 414,RESIDENTIAL,29100,0,29100,93000,0,122100
143347800200000,SW 416,RESIDENTIAL,20300,0,20300,57100,0,77400
143347800300000,SW 416,RESIDENTIAL,20300,0,20300,36100,0,56400
143347800400000,SW 416,RESIDENTIAL,20300,0,20300,105600,0,125900
143347800500000,SW 416,RESIDENTIAL,18200,0,18200,54500,0,72700
143347800600000,SW 416,RESIDENTIAL,19800,0,19800,71000,0,90800
143347800700000,SW 416,RESIDENTIAL,33700,0,33700,119000,0,152700
143347800800000,SW 416,RESIDENTIAL,26200,0,26200,86800,0,113000
143347800900000,SW 416,RESIDENTIAL,24600,0,24600,100400,0,125000
143347801000000,SW 416,RESIDENTIAL,21000,0,21000,97100,0,118100
143347801100000,SW 416,RESIDENTIAL,21000,0,21000,28700,0,49700
143347801200000,SW 416,RESIDENTIAL,17500,0,17500,73200,0,90700
143347801300000,SW 416,RESIDENTIAL,17500,0,17500,98700,0,116200
143347801400000,SW 416,RESIDENTIAL,25000,0,25000,185700,0,210700
143347801500000,SW 416,RESIDENTIAL,26800,0,26800,173700,0,200500
143347900100000,SW 414,RESIDENTIAL,33000,0,33000,93100,0,126100
143347900200000,SW 414,RESIDENTIAL,30200,0,30200,121100,0,151300
143347900300000,SW 414,RESIDENTIAL,31500,0,31500,97700,0,129200
143347900400000,SW 414,RESIDENTIAL,26200,0,26200,95700,0,121900
143347900500000,SW 414,RESIDENTIAL,28300,0,28300,105000,0,133300
143347900600000,SW 414,RESIDENTIAL,28300,0,28300,96700,0,125000
143347900700000,SW 414,RESIDENTIAL,30700,0,30700,111600,0,142300
143347900800000,SW 414,RESIDENTIAL,30500,0,30500,110000,0,140500
143347900900000,SW 414,RESIDENTIAL,33100,0,33100,113700,0,146800
143347901000000,SW 414,RESIDENTIAL,27900,0,27900,105700,0,133600
143347901100000,SW 414,RESIDENTIAL,31400,0,31400,88000,0,119400
143347901200000,SW 414,RESIDENTIAL,29600,0,29600,107000,0,136600
143347901300000,SW 414,RESIDENTIAL,27900,0,27900,116100,0,144000
143347901400000,SW 414,RESIDENTIAL,27900,0,27900,104000,0,131900
143347901500000,SW 414,RESIDENTIAL,31200,0,31200,120100,0,151300
143347901600000,SW 414,RESIDENTIAL,28400,0,28400,124100,0,152500
143347901700000,SW 414,RESIDENTIAL,33700,0,33700,117400,0,151100
143347901800000,SW 414,RESIDENTIAL,33900,0,33900,75400,0,109300
143347901900000,SW 414,RESIDENTIAL,21800,0,21800,102400,0,124200
143347902000000,SW 414,RESIDENTIAL,21800,0,21800,0,0,21800
143347902100000,CHURCH,EXEMPT,0,277600,277600,0,915900,1193500
143347902200000,DAY CARE CENTER,COMMERCIAL,0,69500,69500,0,230900,300400
143348000100000,SW 416,RESIDENTIAL,19700,0,19700,20100,0,39800
143348000200000,SW 416,RESIDENTIAL,25600,0,25600,73900,0,99500
143348000300000,SW 416,RESIDENTIAL,26000,0,26000,95200,0,121200
143348000400000,SW 416,RESIDENTIAL,26800,0,26800,52400,0,79200
143348000500000,SW 416,RESIDENTIAL,27600,0,27600,117400,0,145000
143348000600000,SW 416,RESIDENTIAL,25000,0,25000,89500,0,114500
143348000700000,VACANT LAND,EXEMPT,0,55100,55100,0,0,55100
143348000800000,SW 416,RESIDENTIAL,33000,0,33000,65700,0,98700
143348000900000,SW 416,RESIDENTIAL,17300,0,17300,83400,0,100700
143348001000000,CHURCH,EXEMPT,0,109600,109600,0,597000,706600
143410100100000,SE 242,RESIDENTIAL,21000,0,21000,31400,0,52400
143415100100000,CITY PROPERTY,EXEMPT,0,0,0,0,0,0
143415100200000,SCHOOL,EXEMPT,0,1686400,1686400,0,3655900,5342300
143415100300000,CENTRALLY ASSESSED,OTHER,0,0,0,0,0,0
143417700200000,CITY PROPERTY,EXEMPT,0,0,0,0,0,0
143420100100000,CITY PROPERTY,EXEMPT,0,0,0,0,0,0
143420100200000,CITY PROPERTY,EXEMPT,0,0,0,0,0,0
143422600100000,CITY PROPERTY,EXEMPT,0,0,0,0,0,0
143422600200000,CITY PROPERTY,EXEMPT,0,0,0,0,0,0
143422600300000,CITY PROPERTY,EXEMPT,0,0,0,0,0,0
143422600400000,CITY PROPERTY,EXEMPT,0,0,0,0,0,0
143422600500000,SW 412,RESIDENTIAL,16700,0,16700,73200,0,89900
143422600600000,SW 412,RESIDENTIAL,5000,0,5000,0,0,5000
143422600700000,CITY PROPERTY,EXEMPT,0,0,0,0,0,0
143422600800000,CITY PROPERTY,EXEMPT,0,0,0,0,0,0
143422600900000,CITY PROPERTY,EXEMPT,0,0,0,0,0,0
143422601000000,CITY PROPERTY,EXEMPT,0,0,0,0,0,0
143422601100000,CITY PROPERTY,EXEMPT,0,0,0,0,0,0
143422601200000,SW 412,RESIDENTIAL,16700,0,16700,85700,0,102400
143422601300000,SW 412,RESIDENTIAL,16700,0,16700,71100,0,87800
143422601400000,SW 412,RESIDENTIAL,16700,0,16700,109900,0,126600
143422601500000,SW 412,RESIDENTIAL,23800,0,23800,68400,0,92200
143422601600000,SW 412,RESIDENTIAL,23900,0,23900,106700,0,130600
143422601700000,CITY PROPERTY,EXEMPT,0,0,0,0,0,0
143422601800000,CITY PROPERTY,EXEMPT,0,0,0,0,0,0
143422700200000,CITY PROPERTY,EXEMPT,0,0,0,0,0,0
143422700300000,CITY PROPERTY,EXEMPT,0,0,0,0,0,0
143422700400000,CITY PROPERTY,EXEMPT,0,0,0,0,0,0
143422700500000,CITY PROPERTY,EXEMPT,0,0,0,0,0,0
143422700600000,SW 412,RESIDENTIAL,21300,0,21300,80900,0,102200
143422700700000,SW 412,RESIDENTIAL,19100,0,19100,1700,0,20800
143422700800000,CITY PROPERTY,EXEMPT,0,0,0,0,0,0
143422700900000,CITY PROPERTY,EXEMPT,0,0,0,0,0,0
143422701000000,CITY PROPERTY,EXEMPT,0,0,0,0,0,0
143422701100000,CITY PROPERTY,EXEMPT,0,0,0,0,0,0
143422701200000,CITY PROPERTY,EXEMPT,0,0,0,0,0,0
143422701300000,CITY PROPERTY,EXEMPT,0,0,0,0,0,0
143422701400000,CITY PROPERTY,EXEMPT,0,0,0,0,0,0
143422701500000,APARTMENT,MULTI-RES,10400,0,10400,71900,0,82300
143422701600000,CITY PROPERTY,EXEMPT,0,0,0,0,0,0
143422701700000,SW 412,RESIDENTIAL,16700,0,16700,76000,0,92700
143422701800000,SW 412,RESIDENTIAL,16700,0,16700,52000,0,68700
143422701900000,SW 412,RESIDENTIAL,16700,0,16700,80200,0,96900
143422702000000,CITY PROPERTY,EXEMPT,0,0,0,0,0,0
143422702100000,CITY PROPERTY,EXEMPT,0,0,0,0,0,0
143422702200000,CITY PROPERTY,EXEMPT,0,0,0,0,0,0
143422702300000,CITY PROPERTY,EXEMPT,0,0,0,0,0,0
143422702400000,CITY PROPERTY,EXEMPT,0,0,0,0,0,0
143422702500000,CITY PROPERTY,EXEMPT,0,0,0,0,0,0
143422800100000,CITY PROPERTY,EXEMPT,0,0,0,0,0,0
143422900100000,CITY PROPERTY,EXEMPT,0,0,0,0,0,0
143422900200000,CITY PROPERTY,EXEMPT,0,0,0,0,0,0
143422900300000,CITY PROPERTY,EXEMPT,0,0,0,0,0,0
143422900400000,CITY PROPERTY,EXEMPT,0,0,0,0,0,0
143423000100000,SW 412,RESIDENTIAL,16900,0,16900,61600,0,78500
143423000200000,SW 412,RESIDENTIAL,18400,0,18400,92700,0,111100
143423000400000,SW 412,RESIDENTIAL,17600,0,17600,95600,0,113200
143423000500000,SW 412,RESIDENTIAL,19300,0,19300,113600,0,132900
143423000600000,SW 412,RESIDENTIAL,20600,0,20600,86000,0,106600
143423000700000,SW 412,RESIDENTIAL,21400,0,21400,64600,0,86000
143423000800000,SW 412,RESIDENTIAL,22300,0,22300,65900,0,88200
143423000900000,SW 412,RESIDENTIAL,22900,0,22900,67800,0,90700
143423001000000,SW 412,RESIDENTIAL,19300,0,19300,90100,0,109400
143423001100000,SW 412,RESIDENTIAL,17300,0,17300,59400,0,76700
143423001200000,SW 412,RESIDENTIAL,20800,0,20800,84100,0,104900
143423001300000,SW 412,RESIDENTIAL,14600,0,14600,70800,0,85400
143423001400000,SW 412,RESIDENTIAL,27900,0,27900,131700,0,159600
143423001500000,SW 412,RESIDENTIAL,23400,0,23400,95100,0,118500
143423001600000,SW 412,RESIDENTIAL,23400,0,23400,119200,0,142600
143423001700000,SW 412,RESIDENTIAL,23400,0,23400,111100,0,134500
143423001800000,APARTMENT,MULTI-RES,24600,0,24600,157800,0,182400
143423001900000,SW 412,RESIDENTIAL,23300,0,23300,93800,0,117100
143423002000000,SW 412,RESIDENTIAL,25000,0,25000,90100,0,115100
143423002100000,SW 412,RESIDENTIAL,24800,0,24800,89700,0,114500
143423002200000,SW 412,RESIDENTIAL,23500,0,23500,110300,0,133800
143423002300000,SW 412,RESIDENTIAL,25000,0,25000,83300,0,108300
143423002400000,SW 412,RESIDENTIAL,20600,0,20600,82200,0,102800
143423002500000,SW 412,RESIDENTIAL,19300,0,19300,60400,0,79700
143423002600000,SW 412,RESIDENTIAL,17600,0,17600,73000,0,90600
143423002700000,SW 412,RESIDENTIAL,15400,0,15400,68300,0,83700
143423002800000,SW 412,RESIDENTIAL,15400,0,15400,5800,0,21200
143423100100000,SW 412,RESIDENTIAL,14000,0,14000,96500,0,110500
143423100200000,SW 412,RESIDENTIAL,14000,0,14000,56200,0,70200
143423100300000,SW 412,RESIDENTIAL,14000,0,14000,64500,0,78500
143423100400000,SW 412,RESIDENTIAL,14000,0,14000,69600,0,83600
143423100500000,SW 412,RESIDENTIAL,14000,0,14000,51700,0,65700
143423100600000,SW 412,RESIDENTIAL,14000,0,14000,75500,0,89500
143423100700000,SW 412,RESIDENTIAL,14000,0,14000,67100,0,81100
143423100800000,SW 412,RESIDENTIAL,14000,0,14000,0,0,14000
143423100900000,CITY PROPERTY,EXEMPT,0,0,0,0,0,0
143423101000000,CITY PROPERTY,EXEMPT,0,0,0,0,0,0
143423101100000,CITY PROPERTY,EXEMPT,0,0,0,0,0,0
143423101200000,CITY PROPERTY,EXEMPT,0,0,0,0,0,0
143423101300000,SW 412,RESIDENTIAL,26800,0,26800,49900,0,76700
143423101400000,SW 412,RESIDENTIAL,17000,0,17000,92800,0,109800
143423101500000,SW 412,RESIDENTIAL,17000,0,17000,88600,0,105600
143423101600000,SW 412,RESIDENTIAL,17000,0,17000,114000,0,131000
143423101700000,SW 412,RESIDENTIAL,17000,0,17000,118400,0,135400
143423101800000,SW 412,RESIDENTIAL,17000,0,17000,67500,0,84500
143423101900000,SW 412,RESIDENTIAL,17000,0,17000,80100,0,97100
143423102000000,SW 412,RESIDENTIAL,17000,0,17000,72500,0,89500
143423200100000,SW 412,RESIDENTIAL,17000,0,17000,112200,0,129200
143423200200000,SW 412,RESIDENTIAL,17000,0,17000,65700,0,82700
143423200300000,SW 412,RESIDENTIAL,17000,0,17000,84900,0,101900
143423200400000,SW 412,RESIDENTIAL,17000,0,17000,84200,0,101200
143423200500000,SW 412,RESIDENTIAL,19400,0,19400,90700,0,110100
143423200600000,SW 412,RESIDENTIAL,20000,0,20000,41500,0,61500
143423200700000,SW 412,RESIDENTIAL,17300,0,17300,75900,0,93200
143425100200000,CEMETERY,EXEMPT,0,324000,324000,0,0,324000
143425100400000,SECTION 42,COMMERCIAL,0,26800,26800,0,156100,182900
143425100500000,SECTION 42,COMMERCIAL,0,26800,26800,0,156100,182900
143425100600000,SW 413,EXEMPT,0,40900,40900,0,170500,211400
143425100800000,SECTION 42,COMMERCIAL,0,28300,28300,0,156100,184400
143425100900000,SECTION 42,COMMERCIAL,0,28300,28300,0,156100,184400
143425101500000,CEMETERY,EXEMPT,0,448000,448000,0,0,448000
143425101600000,FUNERAL HOME,COMMERCIAL,9552,308848,318400,24666,797534,1140600
143425101700000,CEMETERY,EXEMPT,0,1776800,1776800,0,94600,1871400
143427600100000,APARTMENT,EXEMPT,0,1230400,1230400,0,5072200,6302600
143427600200000,SW 410,RESIDENTIAL,22500,0,22500,119700,0,142200
143427600300000,SW 410,RESIDENTIAL,22100,0,22100,116700,0,138800
143427600600000,VACANT LAND,COMMERCIAL,0,23700,23700,0,0,23700
143427600700000,APARTMENT,EXEMPT,0,83100,83100,0,958700,1041800
143427600900000,APARTMENT,RESIDENTIAL,25000,0,25000,149400,0,174400
143427700100000,SW 410,RESIDENTIAL,27700,0,27700,75700,0,103400
143427800100000,SW 410,RESIDENTIAL,11800,0,11800,31900,0,43700
143427800200000,SW 410,RESIDENTIAL,23900,0,23900,0,0,23900
143427800300000,SW 410,RESIDENTIAL,22600,0,22600,112000,0,134600
143427800400000,SW 410,RESIDENTIAL,21200,0,21200,93100,0,114300
143427800500000,SW 430,RESIDENTIAL,30000,0,30000,86000,0,116000
143427800600000,SW 430,RESIDENTIAL,29700,0,29700,101000,0,130700
143427800700000,SW 430,RESIDENTIAL,27000,0,27000,98900,0,125900
143427800800000,SW 430,RESIDENTIAL,28000,0,28000,100700,0,128700
143427800900000,SW 430,RESIDENTIAL,28000,0,28000,92700,0,120700
143427801000000,SW 430,RESIDENTIAL,28000,0,28000,97900,0,125900
143427801100000,SW 430,RESIDENTIAL,28000,0,28000,93800,0,121800
143427801200000,SW 430,RESIDENTIAL,24100,0,24100,88200,0,112300
143427801300000,SW 430,RESIDENTIAL,27800,0,27800,104700,0,132500
143427801400000,SW 430,RESIDENTIAL,30700,0,30700,81100,0,111800
143427801500000,SW 410,RESIDENTIAL,25100,0,25100,78700,0,103800
143427801600000,SW 410,RESIDENTIAL,15000,0,15000,65500,0,80500
143427801700000,SW 410,RESIDENTIAL,24000,0,24000,66600,0,90600
143427801800000,SW 410,RESIDENTIAL,13800,0,13800,75400,0,89200
143427801900000,SW 410,RESIDENTIAL,13800,0,13800,39100,0,52900
143427802000000,SW 410,RESIDENTIAL,11700,0,11700,0,0,11700
143427900100000,SW 430,RESIDENTIAL,31000,0,31000,90800,0,121800
143427900200000,SW 430,RESIDENTIAL,30100,0,30100,79300,0,109400
143427900300000,SW 430,RESIDENTIAL,29800,0,29800,106400,0,136200
143427900400000,SW 430,RESIDENTIAL,26600,0,26600,82400,0,109000
143427900500000,SW 430,RESIDENTIAL,27000,0,27000,107200,0,134200
143427900600000,SW 430,RESIDENTIAL,28100,0,28100,80500,0,108600
143427900700000,SW 430,RESIDENTIAL,24800,0,24800,89800,0,114600
143427900800000,SW 430,RESIDENTIAL,24800,0,24800,105200,0,130000
143427900900000,SW 430,RESIDENTIAL,24800,0,24800,88600,0,113400
143427901000000,SW 430,RESIDENTIAL,24800,0,24800,91800,0,116600
143427901100000,SW 430,RESIDENTIAL,24800,0,24800,85000,0,109800
143427901200000,SW 430,RESIDENTIAL,24800,0,24800,89900,0,114700
143427901300000,SW 430,RESIDENTIAL,24800,0,24800,85100,0,109900
143427901400000,SW 430,RESIDENTIAL,24800,0,24800,87800,0,112600
143427901500000,SW 430,RESIDENTIAL,24800,0,24800,92100,0,116900
143427901600000,SW 430,RESIDENTIAL,24800,0,24800,106000,0,130800
143427901700000,SW 430,RESIDENTIAL,28700,0,28700,99900,0,128600
143427901800000,SW 430,RESIDENTIAL,27700,0,27700,97900,0,125600
143427901900000,SW 430,RESIDENTIAL,24800,0,24800,87500,0,112300
143427902000000,SW 430,RESIDENTIAL,24800,0,24800,75700,0,100500
143427902100000,SW 430,RESIDENTIAL,24800,0,24800,84200,0,109000
143427902200000,SW 430,RESIDENTIAL,24800,0,24800,100500,0,125300
143427902300000,SW 430,RESIDENTIAL,24800,0,24800,89400,0,114200
143427902400000,SW 430,RESIDENTIAL,24800,0,24800,91700,0,116500
143427902500000,SW 430,RESIDENTIAL,29000,0,29000,95200,0,124200
143427902600000,SW 430,RESIDENTIAL,28800,0,28800,78500,0,107300
143427902700000,SW 430,RESIDENTIAL,26700,0,26700,79700,0,106400
143428000100000,SW 430,RESIDENTIAL,28000,0,28000,90200,0,118200
143428000200000,SW 430,RESIDENTIAL,28300,0,28300,91600,0,119900
143428000300000,SW 430,RESIDENTIAL,26900,0,26900,107300,0,134200
143428000400000,SW 430,RESIDENTIAL,24700,0,24700,83300,0,108000
143428000500000,SW 430,RESIDENTIAL,27100,0,27100,84100,0,111200
143428000600000,SW 430,RESIDENTIAL,24700,0,24700,81300,0,106000
143428000700000,SW 430,RESIDENTIAL,23100,0,23100,85900,0,109000
143428000800000,SW 430,RESIDENTIAL,23300,0,23300,104400,0,127700
143428000900000,SW 430,RESIDENTIAL,23300,0,23300,81600,0,104900
143428001000000,SW 430,RESIDENTIAL,23300,0,23300,83700,0,107000
143428001100000,SW 430,RESIDENTIAL,23300,0,23300,114500,0,137800
143428001200000,SW 430,RESIDENTIAL,23300,0,23300,93900,0,117200
143428001300000,SW 430,RESIDENTIAL,23300,0,23300,89100,0,112400
143428001400000,SW 430,RESIDENTIAL,23300,0,23300,87400,0,110700
143428001500000,SW 430,RESIDENTIAL,23300,0,23300,82500,0,105800
143428001600000,SW 430,RESIDENTIAL,23300,0,23300,82400,0,105700
143428001700000,SW 430,RESIDENTIAL,23300,0,23300,81200,0,104500
143428001800000,SW 430,RESIDENTIAL,26100,0,26100,104500,0,130600
143430100100000,SW 410,RESIDENTIAL,20100,0,20100,67300,0,87400
143430100200000,SW 410,RESIDENTIAL,17000,0,17000,91000,0,108000
143430100300000,SW 410,RESIDENTIAL,17000,0,17000,59900,0,76900
143430100400000,SW 410,RESIDENTIAL,15000,0,15000,82200,0,97200
143430100500000,SW 410,RESIDENTIAL,14800,0,14800,106600,0,121400
143430100600000,SW 410,RESIDENTIAL,14800,0,14800,49600,0,64400
143430100700000,SW 410,RESIDENTIAL,19200,0,19200,115200,0,134400
143430100800000,SW 410,RESIDENTIAL,18000,0,18000,72700,0,90700
143430100900000,SW 410,RESIDENTIAL,18000,0,18000,52100,0,70100
143430101000000,SW 410,RESIDENTIAL,18000,0,18000,0,0,18000
143430101100000,SW 410,RESIDENTIAL,18000,0,18000,84700,0,102700
143430101200000,SW 410,RESIDENTIAL,18000,0,18000,82400,0,100400
143430101300000,SW 410,RESIDENTIAL,18000,0,18000,42800,0,60800
143430101400000,SW 410,RESIDENTIAL,18000,0,18000,61900,0,79900
143430101500000,SW 410,RESIDENTIAL,18000,0,18000,119000,0,137000
143430101600000,SW 410,RESIDENTIAL,18000,0,18000,57400,0,75400
143430101700000,SW 410,RESIDENTIAL,18000,0,18000,37100,0,55100
143430101800000,SW 410,RESIDENTIAL,18000,0,18000,52600,0,70600
143430101900000,SW 410,RESIDENTIAL,18000,0,18000,81600,0,99600
143430102000000,SW 410,RESIDENTIAL,18000,0,18000,87800,0,105800
143430102100000,SW 410,RESIDENTIAL,18000,0,18000,70300,0,88300
143430102200000,SW 410,RESIDENTIAL,18000,0,18000,99900,0,117900
143430102300000,SW 410,RESIDENTIAL,18000,0,18000,79500,0,97500
143430102400000,SW 410,RESIDENTIAL,18000,0,18000,93600,0,111600
143430102500000,SW 410,RESIDENTIAL,18000,0,18000,54200,0,72200
143430102600000,SW 410,RESIDENTIAL,18000,0,18000,44000,0,62000
143430102700000,SW 410,RESIDENTIAL,18000,0,18000,16300,0,34300
143430102800000,SW 410,RESIDENTIAL,17900,0,17900,42400,0,60300
143430200100000,SW 410,RESIDENTIAL,19200,0,19200,0,0,19200
143430200200000,SW 410,RESIDENTIAL,17100,0,17100,78500,0,95600
143430200300000,SW 410,RESIDENTIAL,21900,0,21900,46900,0,68800
143430200400000,SW 410,RESIDENTIAL,20300,0,20300,94000,0,114300
143430200500000,SW 410,RESIDENTIAL,17100,0,17100,86400,0,103500
143430200600000,SW 430,RESIDENTIAL,27400,0,27400,64500,0,91900
143430200700000,SW 430,RESIDENTIAL,24000,0,24000,86100,0,110100
143430200800000,SW 430,RESIDENTIAL,24500,0,24500,93300,0,117800
143430200900000,SW 430,RESIDENTIAL,24500,0,24500,76600,0,101100
143430201000000,SW 430,RESIDENTIAL,24500,0,24500,74400,0,98900
143430201100000,SW 430,RESIDENTIAL,24500,0,24500,87600,0,112100
143430201200000,SW 430,RESIDENTIAL,24500,0,24500,74900,0,99400
143430201300000,SW 430,RESIDENTIAL,24500,0,24500,84200,0,108700
143430201400000,SW 430,RESIDENTIAL,24500,0,24500,76600,0,101100
143430201500000,SW 430,RESIDENTIAL,24500,0,24500,98000,0,122500
143430201600000,SW 430,RESIDENTIAL,24500,0,24500,99200,0,123700
143430201700000,SW 430,RESIDENTIAL,26500,0,26500,103600,0,130100
143430201800000,SW 430,RESIDENTIAL,24500,0,24500,90600,0,115100
143430201900000,SW 430,RESIDENTIAL,26900,0,26900,81700,0,108600
143430202000000,SW 430,RESIDENTIAL,24100,0,24100,95100,0,119200
143430202100000,SW 430,RESIDENTIAL,25500,0,25500,81400,0,106900
143430202200000,SW 430,RESIDENTIAL,25500,0,25500,81900,0,107400
143430202300000,SW 430,RESIDENTIAL,26000,0,26000,99200,0,125200
143430202400000,SW 430,RESIDENTIAL,26000,0,26000,88200,0,114200
143430202500000,SW 430,RESIDENTIAL,28700,0,28700,75000,0,103700
143430202600000,SW 430,RESIDENTIAL,31100,0,31100,85800,0,116900
143430202700000,SW 410,RESIDENTIAL,18000,0,18000,76000,0,94000
143430202800000,SW 410,RESIDENTIAL,27000,0,27000,42600,0,69600
143430202900000,SW 410,RESIDENTIAL,18000,0,18000,30800,0,48800
143430203000000,SW 410,RESIDENTIAL,18000,0,18000,105000,0,123000
143430203100000,SW 410,RESIDENTIAL,18000,0,18000,68900,0,86900
143430203200000,SW 410,RESIDENTIAL,18000,0,18000,95800,0,113800
143430203300000,SW 410,RESIDENTIAL,18000,0,18000,121100,0,139100
143430203400000,SW 410,RESIDENTIAL,18000,0,18000,73000,0,91000
143430203500000,SW 410,RESIDENTIAL,18000,0,18000,109800,0,127800
143430203600000,SW 410,RESIDENTIAL,18000,0,18000,63200,0,81200
143430203700000,SW 410,RESIDENTIAL,18000,0,18000,49100,0,67100
143430203800000,SW 410,RESIDENTIAL,18000,0,18000,45400,0,63400
143430203900000,SW 410,RESIDENTIAL,18000,0,18000,124200,0,142200
143430204000000,SW 410,RESIDENTIAL,18000,0,18000,52500,0,70500
143430204100000,SW 410,RESIDENTIAL,18000,0,18000,50600,0,68600
143430204200000,SW 410,RESIDENTIAL,18000,0,18000,70200,0,88200
143430204300000,SW 410,RESIDENTIAL,18000,0,18000,47200,0,65200
143430204400000,SW 410,RESIDENTIAL,18000,0,18000,70300,0,88300
143430204500000,SW 410,RESIDENTIAL,18000,0,18000,94100,0,112100
143430204600000,SW 410,RESIDENTIAL,18000,0,18000,47400,0,65400
143430204700000,SW 410,RESIDENTIAL,11400,0,11400,51700,0,63100
143430204800000,SW 410,RESIDENTIAL,11400,0,11400,49200,0,60600
143430300100000,SW 430,RESIDENTIAL,24000,0,24000,104500,0,128500
143430300200000,SW 430,RESIDENTIAL,24000,0,24000,70600,0,94600
143430300300000,SW 430,RESIDENTIAL,24000,0,24000,80100,0,104100
143430300400000,SW 430,RESIDENTIAL,23700,0,23700,98400,0,122100
143430300500000,SW 430,RESIDENTIAL,24000,0,24000,90800,0,114800
143430300600000,SW 430,RESIDENTIAL,24000,0,24000,81300,0,105300
143430300700000,SW 430,RESIDENTIAL,24000,0,24000,75400,0,99400
143430300800000,SW 430,RESIDENTIAL,24000,0,24000,91600,0,115600
143430300900000,SW 430,RESIDENTIAL,24000,0,24000,107500,0,131500
143430301000000,SW 430,RESIDENTIAL,24000,0,24000,86600,0,110600
143430301100000,SW 430,RESIDENTIAL,24000,0,24000,101500,0,125500
143430301200000,SW 430,RESIDENTIAL,24000,0,24000,89800,0,113800
143430301300000,SW 430,RESIDENTIAL,24000,0,24000,99500,0,123500
143430301400000,SW 430,RESIDENTIAL,25000,0,25000,84100,0,109100
143430301500000,SW 430,RESIDENTIAL,25000,0,25000,84000,0,109000
143430301600000,SW 430,RESIDENTIAL,25900,0,25900,84700,0,110600
143430301700000,SW 430,RESIDENTIAL,21200,0,21200,100400,0,121600
143430301800000,SW 430,RESIDENTIAL,25000,0,25000,90000,0,115000
143430301900000,SW 430,RESIDENTIAL,25000,0,25000,104400,0,129400
143430302000000,SW 430,RESIDENTIAL,25500,0,25500,78900,0,104400
143430302100000,SW 430,RESIDENTIAL,25900,0,25900,107100,0,133000
143430302200000,SW 430,RESIDENTIAL,26800,0,26800,125000,0,151800
143430302300000,SW 430,RESIDENTIAL,25300,0,25300,77800,0,103100
143430302400000,SW 430,RESIDENTIAL,26000,0,26000,86300,0,112300
143430302500000,SW 430,RESIDENTIAL,24000,0,24000,116000,0,140000
143430302600000,SW 430,RESIDENTIAL,25000,0,25000,92700,0,117700
143430302700000,SW 430,RESIDENTIAL,25000,0,25000,84200,0,109200
143430302800000,SW 430,RESIDENTIAL,22800,0,22800,100300,0,123100
143430302900000,SW 430,RESIDENTIAL,27200,0,27200,75300,0,102500
143430303000000,SW 430,RESIDENTIAL,24000,0,24000,82800,0,106800
143430303100000,SW 430,RESIDENTIAL,24000,0,24000,77600,0,101600
143430303200000,SW 430,RESIDENTIAL,24000,0,24000,85300,0,109300
143430303300000,SW 430,RESIDENTIAL,24000,0,24000,91700,0,115700
143430303400000,SW 430,RESIDENTIAL,24000,0,24000,83200,0,107200
143430303500000,SW 430,RESIDENTIAL,24000,0,24000,78300,0,102300
143430303600000,SW 430,RESIDENTIAL,24000,0,24000,90500,0,114500
143430303700000,SW 430,RESIDENTIAL,24000,0,24000,82700,0,106700
143430303800000,SW 430,RESIDENTIAL,24000,0,24000,90800,0,114800
143430400100000,SW 430,RESIDENTIAL,24300,0,24300,83400,0,107700
143430400200000,SW 430,RESIDENTIAL,24000,0,24000,77300,0,101300
143430400300000,SW 430,RESIDENTIAL,24000,0,24000,77100,0,101100
143430400400000,SW 430,RESIDENTIAL,24000,0,24000,77400,0,101400
143430400500000,SW 430,RESIDENTIAL,24000,0,24000,85700,0,109700
143430400600000,SW 430,RESIDENTIAL,24000,0,24000,82900,0,106900
143430400700000,SW 430,RESIDENTIAL,24000,0,24000,116600,0,140600
143430400800000,SW 430,RESIDENTIAL,26600,0,26600,149300,0,175900
143430400900000,SW 430,RESIDENTIAL,20000,0,20000,84700,0,104700
143430401000000,SW 430,RESIDENTIAL,24000,0,24000,89100,0,113100
143430401100000,SW 430,RESIDENTIAL,24000,0,24000,79200,0,103200
143430401200000,SW 430,RESIDENTIAL,26600,0,26600,113300,0,139900
143430401300000,SW 430,RESIDENTIAL,22000,0,22000,126800,0,148800
143430401400000,SW 430,RESIDENTIAL,25000,0,25000,81900,0,106900
143430401500000,SW 430,RESIDENTIAL,25000,0,25000,96900,0,121900
143430401600000,SW 430,RESIDENTIAL,30000,0,30000,109700,0,139700
143430401700000,SW 430,RESIDENTIAL,30200,0,30200,115200,0,145400
143430401800000,SW 430,RESIDENTIAL,26400,0,26400,80900,0,107300
143430401900000,SW 430,RESIDENTIAL,33000,0,33000,95400,0,128400
143432600100000,CITY PROPERTY,EXEMPT,0,0,0,0,0,0
143432600200000,SW 414,RESIDENTIAL,21800,0,21800,51100,0,72900
143432600300000,SW 414,RESIDENTIAL,33800,0,33800,112900,0,146700
143432600400000,SW 414,RESIDENTIAL,25700,0,25700,94800,0,120500
143432600500000,SW 414,RESIDENTIAL,26600,0,26600,86400,0,113000
143432600600000,SW 414,RESIDENTIAL,26600,0,26600,82000,0,108600
143432600700000,SW 414,RESIDENTIAL,26600,0,26600,78300,0,104900
143432600800000,SW 414,RESIDENTIAL,26600,0,26600,81900,0,108500
143432600900000,SW 414,RESIDENTIAL,26600,0,26600,107100,0,133700
143432601000000,SW 414,RESIDENTIAL,26600,0,26600,100100,0,126700
143432601100000,SW 414,RESIDENTIAL,26600,0,26600,94400,0,121000
143432601200000,SW 414,RESIDENTIAL,26600,0,26600,97000,0,123600
143432601300000,SW 414,RESIDENTIAL,26600,0,26600,80200,0,106800
143432601400000,SW 414,RESIDENTIAL,26600,0,26600,90000,0,116600
143432601500000,SW 414,RESIDENTIAL,30000,0,30000,91900,0,121900
143432601600000,SW 414,RESIDENTIAL,26600,0,26600,115200,0,141800
143432601700000,SW 414,RESIDENTIAL,30800,0,30800,121400,0,152200
143432601800000,SW 414,RESIDENTIAL,31200,0,31200,98700,0,129900
143432601900000,SW 414,RESIDENTIAL,24500,0,24500,95900,0,120400
143432602000000,SW 414,RESIDENTIAL,31100,0,31100,114100,0,145200
143432700100000,SW 414,RESIDENTIAL,25400,0,25400,83700,0,109100
143432700200000,SW 414,RESIDENTIAL,31800,0,31800,84200,0,116000
143432700300000,SW 414,RESIDENTIAL,32300,0,32300,97200,0,129500
143432700400000,SW 414,RESIDENTIAL,34300,0,34300,90100,0,124400
143432700500000,SW 414,RESIDENTIAL,31900,0,31900,86500,0,118400
143432700600000,SW 414,RESIDENTIAL,22700,0,22700,107100,0,129800
143432700700000,SW 414,RESIDENTIAL,28800,0,28800,90800,0,119600
143432700800000,SW 414,RESIDENTIAL,22700,0,22700,104100,0,126800
143432700900000,SW 414,RESIDENTIAL,30200,0,30200,99200,0,129400
143432701000000,SW 414,RESIDENTIAL,29800,0,29800,85400,0,115200
143432701100000,SW 414,RESIDENTIAL,28800,0,28800,114700,0,143500
143432701200000,SW 414,RESIDENTIAL,23500,0,23500,80200,0,103700
143432701300000,SW 414,RESIDENTIAL,28800,0,28800,82700,0,111500
143432701400000,SW 414,RESIDENTIAL,23500,0,23500,83300,0,106800
143432701500000,SW 414,RESIDENTIAL,23900,0,23900,80100,0,104000
143432701600000,SW 414,RESIDENTIAL,25400,0,25400,96400,0,121800
143432701700000,SW 414,RESIDENTIAL,27400,0,27400,100000,0,127400
143432701800000,SW 414,RESIDENTIAL,22000,0,22000,90200,0,112200
143432701900000,SW 414,RESIDENTIAL,26400,0,26400,90400,0,116800
143432702000000,SW 414,RESIDENTIAL,30800,0,30800,92100,0,122900
143432702100000,SW 414,RESIDENTIAL,26600,0,26600,98200,0,124800
143432702200000,SW 414,RESIDENTIAL,30000,0,30000,98700,0,128700
143432702300000,SW 414,RESIDENTIAL,27900,0,27900,88600,0,116500
143432702400000,SW 414,RESIDENTIAL,26600,0,26600,84300,0,110900
143432702500000,SW 414,RESIDENTIAL,26200,0,26200,84900,0,111100
143432702600000,SW 414,RESIDENTIAL,26200,0,26200,77600,0,103800
143432702700000,SW 414,RESIDENTIAL,25800,0,25800,71400,0,97200
143432702800000,SW 414,RESIDENTIAL,26600,0,26600,75600,0,102200
143432702900000,SW 414,RESIDENTIAL,26200,0,26200,103400,0,129600
143432703000000,SW 414,RESIDENTIAL,26200,0,26200,87200,0,113400
143432703100000,SW 414,RESIDENTIAL,26200,0,26200,82200,0,108400
143432703200000,SW 414,RESIDENTIAL,26200,0,26200,72500,0,98700
143432703300000,SW 414,RESIDENTIAL,26400,0,26400,84500,0,110900
143432800100000,FAST FOOD,COMMERCIAL,0,84200,84200,0,150200,234400
143432800200000,SW 414,RESIDENTIAL,33200,0,33200,94100,0,127300
143432800300000,SW 414,RESIDENTIAL,25200,0,25200,82100,0,107300
143432800400000,SW 414,RESIDENTIAL,24100,0,24100,97200,0,121300
143432800500000,SW 414,RESIDENTIAL,29900,0,29900,102600,0,132500
143432800600000,SW 414,RESIDENTIAL,28500,0,28500,93900,0,122400
143432800700000,SW 414,RESIDENTIAL,28300,0,28300,100000,0,128300
143432800800000,SW 414,RESIDENTIAL,27500,0,27500,82400,0,109900
143432800900000,SW 414,RESIDENTIAL,28500,0,28500,97400,0,125900
143432801000000,SW 414,RESIDENTIAL,24300,0,24300,73400,0,97700
143432801100000,SW 414,RESIDENTIAL,25200,0,25200,84300,0,109500
143432801200000,SW 414,RESIDENTIAL,23700,0,23700,78200,0,101900
143432801300000,SW 414,RESIDENTIAL,25000,0,25000,104900,0,129900
143432801400000,SW 414,RESIDENTIAL,25200,0,25200,80000,0,105200
143432801500000,SW 414,RESIDENTIAL,23300,0,23300,93400,0,116700
143432900100000,SW 414,RESIDENTIAL,28900,0,28900,79200,0,108100
143432900200000,SW 414,RESIDENTIAL,27500,0,27500,109500,0,137000
143432900300000,SW 414,RESIDENTIAL,30000,0,30000,113200,0,143200
143432900400000,SW 414,RESIDENTIAL,23300,0,23300,117200,0,140500
143432900500000,SW 414,RESIDENTIAL,23900,0,23900,119000,0,142900
143432900600000,SW 414,RESIDENTIAL,33900,0,33900,113600,0,147500
143435100100000,SW 414,RESIDENTIAL,24700,0,24700,74000,0,98700
143435100200000,SW 414,RESIDENTIAL,25200,0,25200,83200,0,108400
143435100300000,SW 414,RESIDENTIAL,25200,0,25200,87700,0,112900
143435100400000,SW 414,RESIDENTIAL,25200,0,25200,99300,0,124500
143435100500000,SW 414,RESIDENTIAL,24800,0,24800,100000,0,124800
143435100600000,SW 414,RESIDENTIAL,24800,0,24800,94900,0,119700
143435100700000,SW 414,RESIDENTIAL,32000,0,32000,110900,0,142900
143435100800000,SW 414,RESIDENTIAL,27600,0,27600,141000,0,168600
143435100900000,SW 414,RESIDENTIAL,27200,0,27200,126400,0,153600
143435101000000,SW 414,RESIDENTIAL,32000,0,32000,104900,0,136900
143435101100000,SW 414,RESIDENTIAL,26600,0,26600,109900,0,136500
143435101200000,SW 414,RESIDENTIAL,32000,0,32000,119800,0,151800
143435101300000,SW 414,RESIDENTIAL,32000,0,32000,95500,0,127500
143435101400000,SW 414,RESIDENTIAL,32000,0,32000,98500,0,130500
143435101500000,SW 414,RESIDENTIAL,32000,0,32000,116900,0,148900
143435101600000,SW 414,RESIDENTIAL,32000,0,32000,115200,0,147200
143435101700000,SW 414,RESIDENTIAL,32000,0,32000,89000,0,121000
143435101800000,SW 414,RESIDENTIAL,32300,0,32300,100500,0,132800
143435200100000,SW 414,RESIDENTIAL,25400,0,25400,86300,0,111700
143435200200000,SW 414,RESIDENTIAL,24000,0,24000,76500,0,100500
143435200300000,SW 414,RESIDENTIAL,24000,0,24000,76300,0,100300
143435200400000,SW 414,RESIDENTIAL,24000,0,24000,66300,0,90300
143435200500000,SW 414,RESIDENTIAL,24000,0,24000,80100,0,104100
143435200600000,SW 414,RESIDENTIAL,25600,0,25600,90900,0,116500
143435200700000,SW 414,RESIDENTIAL,25100,0,25100,74400,0,99500
143435300100000,SW 414,RESIDENTIAL,24500,0,24500,70400,0,94900
143435300200000,SW 414,RESIDENTIAL,24300,0,24300,80300,0,104600
143435300300000,SW 414,RESIDENTIAL,24300,0,24300,82900,0,107200
143435300400000,SW 414,RESIDENTIAL,24000,0,24000,81500,0,105500
143435300500000,SW 414,RESIDENTIAL,26300,0,26300,90500,0,116800
143435300600000,SW 414,RESIDENTIAL,25900,0,25900,101500,0,127400
143435300700000,SW 414,RESIDENTIAL,28300,0,28300,113500,0,141800
143435300800000,SW 414,RESIDENTIAL,25900,0,25900,78300,0,104200
143435300900000,SW 414,RESIDENTIAL,25900,0,25900,88500,0,114400
143435301000000,SW 414,RESIDENTIAL,29100,0,29100,91900,0,121000
143435301100000,SW 414,RESIDENTIAL,28800,0,28800,86800,0,115600
143435301200000,SW 414,RESIDENTIAL,30900,0,30900,110100,0,141000
143435301300000,SW 414,RESIDENTIAL,27900,0,27900,96600,0,124500
143435301400000,SW 414,RESIDENTIAL,32600,0,32600,121300,0,153900
143435301500000,SW 414,RESIDENTIAL,30400,0,30400,146000,0,176400
143435301600000,SW 414,RESIDENTIAL,29800,0,29800,97600,0,127400
143435301700000,SW 414,RESIDENTIAL,26700,0,26700,104700,0,131400
143435301800000,SW 414,RESIDENTIAL,32100,0,32100,100100,0,132200
143435301900000,SW 414,RESIDENTIAL,31500,0,31500,102000,0,133500
143435302000000,SW 414,RESIDENTIAL,27700,0,27700,102400,0,130100
143435302100000,SW 414,RESIDENTIAL,26100,0,26100,93400,0,119500
143435302200000,SW 414,RESIDENTIAL,26100,0,26100,90800,0,116900
143435302300000,SW 414,RESIDENTIAL,26100,0,26100,106200,0,132300
143435302400000,SW 414,RESIDENTIAL,25500,0,25500,103200,0,128700
143435400100000,SW 414,RESIDENTIAL,25900,0,25900,74200,0,100100
143435400200000,SW 414,RESIDENTIAL,25600,0,25600,106000,0,131600
143435400300000,SW 414,RESIDENTIAL,24000,0,24000,82700,0,106700
143435400400000,SW 414,RESIDENTIAL,27200,0,27200,90800,0,118000
143435400500000,SW 414,RESIDENTIAL,28000,0,28000,88600,0,116600
143435400600000,SW 414,RESIDENTIAL,28000,0,28000,83200,0,111200
143435400700000,SW 414,RESIDENTIAL,27700,0,27700,96100,0,123800
143435400800000,SW 414,RESIDENTIAL,31500,0,31500,95200,0,126700
143435400900000,SW 414,RESIDENTIAL,28500,0,28500,85800,0,114300
143435401000000,SW 414,RESIDENTIAL,25500,0,25500,88300,0,113800
143435401100000,SW 414,RESIDENTIAL,25000,0,25000,98200,0,123200
143435401200000,SW 414,RESIDENTIAL,28200,0,28200,94500,0,122700
143435401300000,SW 414,RESIDENTIAL,29700,0,29700,112200,0,141900
143435401400000,SW 414,RESIDENTIAL,34300,0,34300,99500,0,133800
143435401500000,SW 414,RESIDENTIAL,25600,0,25600,104000,0,129600
143435401600000,SW 414,RESIDENTIAL,25600,0,25600,106700,0,132300
143435401700000,SW 414,RESIDENTIAL,25400,0,25400,137600,0,163000
143435401800000,SW 414,RESIDENTIAL,26500,0,26500,86500,0,113000
143435401900000,SW 414,RESIDENTIAL,25600,0,25600,96400,0,122000
143435402000000,SW 414,RESIDENTIAL,25600,0,25600,81300,0,106900
143435402100000,SW 414,RESIDENTIAL,25600,0,25600,100800,0,126400
143435402200000,SW 414,RESIDENTIAL,28000,0,28000,103100,0,131100
143437600100000,SW 410,RESIDENTIAL,17900,0,17900,119600,0,137500
143437600200000,SW 410,RESIDENTIAL,17600,0,17600,79700,0,97300
143437600300000,SW 410,RESIDENTIAL,17900,0,17900,54900,0,72800
143437600400000,SW 410,RESIDENTIAL,17900,0,17900,70100,0,88000
143437600500000,SW 410,RESIDENTIAL,17900,0,17900,123200,0,141100
143437600600000,SW 410,RESIDENTIAL,21400,0,21400,30300,0,51700
143437600700000,SW 410,RESIDENTIAL,21400,0,21400,83000,0,104400
143437600900000,SW 410,RESIDENTIAL,17900,0,17900,73300,0,91200
143437601000000,SW 410,RESIDENTIAL,17900,0,17900,63200,0,81100
143437601100000,SW 410,RESIDENTIAL,17900,0,17900,96900,0,114800
143437601200000,SW 410,RESIDENTIAL,21400,0,21400,50400,0,71800
143437601300000,SW 410,RESIDENTIAL,17900,0,17900,47900,0,65800
143437601400000,SW 410,RESIDENTIAL,17900,0,17900,59500,0,77400
143437601500000,SW 410,RESIDENTIAL,17900,0,17900,36800,0,54700
143437601600000,SW 410,RESIDENTIAL,17900,0,17900,75500,0,93400
143437601700000,SW 410,RESIDENTIAL,17900,0,17900,42900,0,60800
143437601800000,SW 410,RESIDENTIAL,17900,0,17900,114100,0,132000
143437601900000,SW 410,RESIDENTIAL,17900,0,17900,128000,0,145900
143437602000000,SW 410,RESIDENTIAL,17900,0,17900,64200,0,82100
143437602100000,SW 410,RESIDENTIAL,17900,0,17900,130600,0,148500
143437602200000,CITY PROPERTY,EXEMPT,0,0,0,0,0,0
143437602300000,SW 410,RESIDENTIAL,17900,0,17900,133000,0,150900
143437602400000,SW 410,RESIDENTIAL,17900,0,17900,0,0,17900
143437700100000,SW 410,RESIDENTIAL,17900,0,17900,72800,0,90700
143437700200000,CITY PROPERTY,EXEMPT,0,0,0,0,0,0
143437700300000,SW 410,RESIDENTIAL,20800,0,20800,72700,0,93500
143437700400000,SW 410,RESIDENTIAL,17900,0,17900,98600,0,116500
143437700500000,SW 410,RESIDENTIAL,17900,0,17900,139900,0,157800
143437700600000,SW 410,RESIDENTIAL,17900,0,17900,60600,0,78500
143437700700000,SW 410,RESIDENTIAL,17900,0,17900,50800,0,68700
143437700800000,SW 410,RESIDENTIAL,17900,0,17900,0,0,17900
143437700900000,SW 410,RESIDENTIAL,21400,0,21400,114500,0,135900
143437701000000,SW 410,RESIDENTIAL,21400,0,21400,38000,0,59400
143437701100000,SW 410,RESIDENTIAL,17900,0,17900,66300,0,84200
143437701200000,SW 410,RESIDENTIAL,21400,0,21400,39100,0,60500
143437701300000,SW 410,RESIDENTIAL,21400,0,21400,39200,0,60600
143437701400000,SW 410,RESIDENTIAL,17900,0,17900,51500,0,69400
143437701500000,SW 410,RESIDENTIAL,17900,0,17900,41800,0,59700
143437701600000,SW 410,RESIDENTIAL,17900,0,17900,71600,0,89500
143437701700000,SW 410,RESIDENTIAL,17900,0,17900,57200,0,75100
143437701800000,SW 410,RESIDENTIAL,17900,0,17900,97600,0,115500
143437701900000,SW 410,RESIDENTIAL,17900,0,17900,70600,0,88500
143437702000000,SW 410,RESIDENTIAL,17900,0,17900,82800,0,100700
143437702100000,SW 410,RESIDENTIAL,17900,0,17900,69900,0,87800
143437702200000,SW 410,RESIDENTIAL,17900,0,17900,90000,0,107900
143437702300000,SW 410,RESIDENTIAL,17900,0,17900,79700,0,97600
143440100100000,CITY PROPERTY,EXEMPT,0,0,0,0,0,0
143440200100000,SW 411,RESIDENTIAL,53100,0,53100,103000,0,156100
143440300100000,SW 411,RESIDENTIAL,5000,0,5000,1300,0,6300
143440300200000,SW 411,RESIDENTIAL,11800,0,11800,0,0,11800
143442600300000,SW 411,RESIDENTIAL,33500,0,33500,82600,0,116100
143442600400000,SW 411,RESIDENTIAL,33500,0,33500,57800,0,91300
143442600500000,SW 411,RESIDENTIAL,33500,0,33500,53700,0,87200
143442600600000,SW 411,RESIDENTIAL,33500,0,33500,75300,0,108800
143442600700000,SW 411,EXEMPT,0,33500,33500,0,0,33500
143442600800000,SW 411,EXEMPT,0,33500,33500,0,87800,121300
143442600900000,SW 411,EXEMPT,0,33500,33500,0,79100,112600
143442601000000,VACANT LAND,EXEMPT,0,80000,80000,0,0,80000
143442601100000,VACANT LAND,EXEMPT,0,73000,73000,0,0,73000
143442601200000,VACANT LAND,EXEMPT,0,31500,31500,0,0,31500
143442601300000,VACANT LAND,EXEMPT,0,27300,27300,0,0,27300
143442601400000,SW 411,RESIDENTIAL,50700,0,50700,188200,0,238900
143442700300000,SW 431,RESIDENTIAL,43500,0,43500,140900,0,184400
143442700400000,SW 431,RESIDENTIAL,40800,0,40800,134300,0,175100
143442700500000,SW 431,RESIDENTIAL,29800,0,29800,138500,0,168300
143442700600000,SW 431,RESIDENTIAL,36900,0,36900,128900,0,165800
143442700700000,SW 431,RESIDENTIAL,39100,0,39100,168100,0,207200
143442700800000,SW 431,RESIDENTIAL,36800,0,36800,169500,0,206300
143442700900000,SW 411,RESIDENTIAL,41800,0,41800,62100,0,103900
143442701000000,SW 411,RESIDENTIAL,34100,0,34100,0,0,34100
143442701100000,SW 431,RESIDENTIAL,35700,0,35700,144500,0,180200
143442701200000,SW 431,RESIDENTIAL,32100,0,32100,135400,0,167500
143442701300000,SW 411,RESIDENTIAL,50000,0,50000,0,0,50000
143442701400000,SW 411,RESIDENTIAL,45800,0,45800,105600,0,151400
143442800100000,SW 411,RESIDENTIAL,20800,0,20800,94800,0,115600
143442800200000,SW 411,RESIDENTIAL,20800,0,20800,0,0,20800
143442800300000,SW 411,RESIDENTIAL,20800,0,20800,0,0,20800
143442800400000,SW 411,RESIDENTIAL,27700,0,27700,72900,0,100600
143442800500000,SW 411,RESIDENTIAL,27700,0,27700,79100,0,106800
143442800600000,SW 411,RESIDENTIAL,27700,0,27700,89200,0,116900
143442800700000,SW 411,RESIDENTIAL,28300,0,28300,81500,0,109800
143442800800000,SW 411,RESIDENTIAL,31500,0,31500,136400,0,167900
143442800900000,SW 411,RESIDENTIAL,26800,0,26800,131100,0,157900
143442801000000,SW 411,RESIDENTIAL,33900,0,33900,123100,0,157000
143442801100000,SW 411,RESIDENTIAL,32700,0,32700,124400,0,157100
143442801200000,SW 411,RESIDENTIAL,26100,0,26100,28400,0,54500
143442801300000,SW 411,RESIDENTIAL,27100,0,27100,117600,0,144700
143442801400000,SW 411,RESIDENTIAL,27700,0,27700,108600,0,136300
143442801500000,SW 411,RESIDENTIAL,27700,0,27700,87000,0,114700
143442801600000,SW 411,RESIDENTIAL,27700,0,27700,93200,0,120900
143442801700000,SW 411,RESIDENTIAL,37400,0,37400,33000,0,70400
143442900100000,SW 411,RESIDENTIAL,33500,0,33500,150600,0,184100
143442900200000,SW 411,RESIDENTIAL,33500,0,33500,165500,0,199000
143442900300000,SW 411,RESIDENTIAL,33500,0,33500,123200,0,156700
143442900400000,SW 411,RESIDENTIAL,35500,0,35500,84400,0,119900
143442900500000,SW 411,RESIDENTIAL,38600,0,38600,97500,0,136100
143442900600000,SW 411,RESIDENTIAL,53800,0,53800,230800,0,284600
143442900700000,SW 411,RESIDENTIAL,45100,0,45100,79100,0,124200
143442900800000,SW 411,RESIDENTIAL,33500,0,33500,101500,0,135000
143443000100000,SW 411,RESIDENTIAL,22200,0,22200,45600,0,67800
143443000200000,SW 411,RESIDENTIAL,24600,0,24600,39200,0,63800
143443000300000,SW 411,RESIDENTIAL,47400,0,47400,61800,0,109200
143443000500000,SW 411,RESIDENTIAL,28600,0,28600,0,0,28600
143443000600000,SW 411,RESIDENTIAL,30000,0,30000,0,0,30000
143443000700000,SW 411,RESIDENTIAL,30000,0,30000,0,0,30000
143443000800000,SW 411,RESIDENTIAL,30000,0,30000,168700,0,198700
143443000900000,SW 431,RESIDENTIAL,36500,0,36500,112600,0,149100
143443001000000,SW 431,RESIDENTIAL,41300,0,41300,139300,0,180600
143443001100000,SW 431,RESIDENTIAL,39600,0,39600,133000,0,172600
143443001200000,SW 431,RESIDENTIAL,36400,0,36400,133600,0,170000
143443001300000,SW 431,RESIDENTIAL,44300,0,44300,192400,0,236700
143443001400000,SW 431,RESIDENTIAL,46900,0,46900,177100,0,224000
143443001500000,SW 411,RESIDENTIAL,28400,0,28400,51900,0,80300
143443001700000,SW 431,RESIDENTIAL,35800,0,35800,160300,0,196100
143443001800000,SW 431,RESIDENTIAL,41200,0,41200,183700,0,224900
143445100100000,SW 411,RESIDENTIAL,42600,0,42600,94500,0,137100
143445100300000,CITY PROPERTY,EXEMPT,0,0,0,0,0,0
143445100400000,SW 411,RESIDENTIAL,59300,0,59300,171600,0,230900
143445100500000,SW 411,RESIDENTIAL,45900,0,45900,92100,0,138000
143445100700000,SW 431,RESIDENTIAL,39000,0,39000,159700,0,198700
143445100800000,SW 431,RESIDENTIAL,38300,0,38300,166100,0,204400
143445101100000,SW 431,RESIDENTIAL,3600,0,3600,0,0,3600
143445101200000,SW 431,RESIDENTIAL,48000,0,48000,195500,0,243500
143445101300000,SW 431,RESIDENTIAL,54300,0,54300,165600,0,219900
143445101400000,SW 431,RESIDENTIAL,71600,0,71600,265000,0,336600
143445101500000,SW 431,RESIDENTIAL,53500,0,53500,230300,0,283800
143445101600000,CITY PROPERTY,EXEMPT,0,0,0,0,0,0
143445101700000,SW 431,RESIDENTIAL,35600,0,35600,154900,0,190500
143445101800000,SW 431,RESIDENTIAL,37200,0,37200,0,0,37200
143445200100000,SW 431,RESIDENTIAL,32200,0,32200,152300,0,184500
143445200200000,SW 431,RESIDENTIAL,42100,0,42100,150100,0,192200
143445200300000,SW 431,RESIDENTIAL,45000,0,45000,268600,0,313600
143445200400000,SW 431,RESIDENTIAL,35700,0,35700,162800,0,198500
143445200500000,SW 431,RESIDENTIAL,36800,0,36800,173900,0,210700
143447600100000,SW 411,RESIDENTIAL,47800,0,47800,55900,0,103700
143447600200000,SW 411,RESIDENTIAL,46900,0,46900,38300,0,85200
143447600300000,SW 411,RESIDENTIAL,49800,0,49800,19300,0,69100
143510100100000,SE 242,RESIDENTIAL,48700,0,48700,189400,0,238100
143510100200000,SE 242,RESIDENTIAL,86600,0,86600,122200,0,208800
143510100300000,SE 242,RESIDENTIAL,0,0,0,0,0,0
143510100400000,CITY PROPERTY,EXEMPT,0,0,0,0,0,0
143510100500000,SE 242,RESIDENTIAL,45500,0,45500,94600,0,140100
143510100600000,SE 242,RESIDENTIAL,47900,0,47900,95500,0,143400
143512600100000,SE 242,RESIDENTIAL,83100,0,83100,61500,0,144600
143515100100000,SE 242,AG DWELLING,26200,0,26200,136600,4000,166800
143515100200000,SE 242,RESIDENTIAL,24500,0,24500,83100,0,107600
143515100300000,SE 242,RESIDENTIAL,30600,0,30600,137900,0,168500
143515100400000,SE 242,AG LAND,13400,0,13400,0,0,13400
143515100500000,SE 242,AG DWELLING,7200,0,7200,130400,5400,143000
143517600100000,SE 242,AG LAND,49200,0,49200,0,0,49200
143520100100000,SE 242,RESIDENTIAL,55800,0,55800,1700,0,57500
143520100200000,SE 242,AG LAND,6600,0,6600,0,0,6600
143520100300000,SE 242,RESIDENTIAL,21000,0,21000,71600,0,92600
143520200100000,SE 242,RESIDENTIAL,35500,0,35500,95700,0,131200
143520200200000,CITY PROPERTY,EXEMPT,0,0,0,0,0,0
143520200400000,SE 242,RESIDENTIAL,24500,0,24500,98600,0,123100
143520200700000,SE 242,RESIDENTIAL,35600,0,35600,91700,0,127300
143520200800000,SE 242,RESIDENTIAL,37500,0,37500,58900,0,96400
143520200900000,SE 242,RESIDENTIAL,5000,0,5000,0,0,5000
143520201000000,SE 242,RESIDENTIAL,42400,0,42400,198100,0,240500
143520201100000,SE 242,RESIDENTIAL,32000,0,32000,43800,0,75800
143520201200000,SE 242,RESIDENTIAL,36900,0,36900,172300,0,209200
143520201300000,SE 242,RESIDENTIAL,39500,0,39500,134500,0,174000
143520201400000,SE 242,RESIDENTIAL,18700,0,18700,0,0,18700
143520201500000,SE 242,RESIDENTIAL,18700,0,18700,139200,0,157900
143520201600000,SE 242,RESIDENTIAL,26700,0,26700,173700,0,200400
143520201700000,SE 242,RESIDENTIAL,34700,0,34700,81700,0,116400
143522600100000,SE 242,RESIDENTIAL,23000,0,23000,129100,0,152100
143522600200000,SE 242,RESIDENTIAL,23000,0,23000,85900,0,108900
143522600300000,SE 242,RESIDENTIAL,25900,0,25900,149300,0,175200
143522600400000,SE 242,RESIDENTIAL,26900,0,26900,86900,0,113800
143522600500000,SE 242,RESIDENTIAL,23400,0,23400,154600,0,178000
143522600600000,SE 242,RESIDENTIAL,15700,0,15700,124500,0,140200
143522600700000,SE 242,RESIDENTIAL,20100,0,20100,83900,0,104000
143522600800000,SE 242,RESIDENTIAL,13900,0,13900,89000,0,102900
143522700100000,SE 242,RESIDENTIAL,13000,0,13000,129900,0,142900
143522700200000,SE 242,RESIDENTIAL,19500,0,19500,84800,0,104300
143522700300000,SE 242,RESIDENTIAL,19500,0,19500,194200,0,213700
143522700400000,SE 242,RESIDENTIAL,23400,0,23400,49000,0,72400
143522700500000,SE 242,RESIDENTIAL,13000,0,13000,0,0,13000
143522800100000,SE 242,RESIDENTIAL,28500,0,28500,43600,0,72100
143522800200000,SE 242,RESIDENTIAL,7800,0,7800,0,0,7800
143522800300000,SE 242,RESIDENTIAL,17100,0,17100,31700,0,48800
143522800400000,SE 242,RESIDENTIAL,26900,0,26900,116900,0,143800
143522800500000,SE 242,RESIDENTIAL,26600,0,26600,148500,0,175100
143522800600000,SE 242,RESIDENTIAL,17700,0,17700,0,0,17700
143522800900000,SE 242,RESIDENTIAL,29600,0,29600,177400,0,207000
143522801000000,SE 242,RESIDENTIAL,29300,0,29300,188900,0,218200
143522801100000,SE 242,RESIDENTIAL,28500,0,28500,131300,0,159800
143522801200000,SE 242,RESIDENTIAL,28500,0,28500,124100,0,152600
143522801300000,SE 242,RESIDENTIAL,44300,0,44300,201100,0,245400
143522801400000,SE 242,AG LAND,700,0,700,0,0,700
143522900100000,SE 242,RESIDENTIAL,27600,0,27600,58800,0,86400
143522900500000,SE 242,RESIDENTIAL,13000,0,13000,137100,0,150100
143522900600000,SE 242,RESIDENTIAL,27500,0,27500,126100,0,153600
143522900700000,SE 242,RESIDENTIAL,2900,0,2900,3300,0,6200
143522900800000,SE 242,RESIDENTIAL,20900,0,20900,126000,0,146900
143522900900000,SE 242,RESIDENTIAL,22500,0,22500,44400,0,66900
143522901000000,SE 242,RESIDENTIAL,22700,0,22700,2600,0,25300
143522901100000,SE 242,RESIDENTIAL,11700,0,11700,89000,0,100700
143522901200000,SE 242,RESIDENTIAL,11700,0,11700,115600,0,127300
143522901300000,SE 242,RESIDENTIAL,17700,0,17700,0,0,17700
143522901400000,SE 242,RESIDENTIAL,13000,0,13000,132100,0,145100
143522901500000,SE 242,RESIDENTIAL,14000,0,14000,151500,0,165500
143522901600000,SE 242,RESIDENTIAL,27300,0,27300,78100,0,105400
143525100100000,SE 242,RESIDENTIAL,12900,0,12900,0,0,12900
143525100200000,SE 242,RESIDENTIAL,14600,0,14600,90200,0,104800
143525100300000,SE 242,RESIDENTIAL,10500,0,10500,83600,0,94100
143525100400000,SE 242,RESIDENTIAL,10500,0,10500,89700,0,100200
143525200100000,SE 242,RESIDENTIAL,20000,0,20000,93300,0,113300
143525300100000,SE 242,RESIDENTIAL,10100,0,10100,34600,0,44700
143525400100000,SE 242,RESIDENTIAL,33900,0,33900,165300,0,199200
143525400400000,SE 242,RESIDENTIAL,4800,0,4800,0,0,4800
143525400500000,SE 242,RESIDENTIAL,7200,0,7200,93900,0,101100
143525400600000,SE 242,RESIDENTIAL,7200,0,7200,2000,0,9200
143525401000000,SE 242,RESIDENTIAL,8000,0,8000,72400,0,80400
143525401100000,SE 242,RESIDENTIAL,8000,0,8000,54400,0,62400
143525401200000,SE 242,RESIDENTIAL,8000,0,8000,71100,0,79100
143525401300000,SE 242,RESIDENTIAL,5200,0,5200,45400,0,50600
143525401400000,SE 242,RESIDENTIAL,14900,0,14900,0,0,14900
143525401600000,SE 242,RESIDENTIAL,18100,0,18100,82200,0,100300
143525401800000,SE 242,AG LAND,20600,0,20600,0,0,20600
143525401900000,SE 242,AG DWELLING,3200,0,3200,67700,2800,73700
143525402000000,SE 242,AG LAND,32800,0,32800,0,0,32800
143527600100000,SE 242,AG LAND,3800,0,3800,0,0,3800
143527600200000,SE 242,AG LAND,9900,0,9900,0,0,9900
143527700100000,SE 242,RESIDENTIAL,20200,0,20200,102800,0,123000
143527700200000,SE 242,RESIDENTIAL,23600,0,23600,172300,0,195900
143527700300000,SE 242,RESIDENTIAL,20800,0,20800,107800,0,128600
143527700400000,SE 242,RESIDENTIAL,21800,0,21800,53200,0,75000
143527700500000,SE 242,RESIDENTIAL,13600,0,13600,79900,0,93500
143527700600000,SE 242,RESIDENTIAL,13900,0,13900,0,0,13900
143527700700000,SE 242,RESIDENTIAL,30200,0,30200,208900,0,239100
143527700800000,SE 242,RESIDENTIAL,31000,0,31000,130100,0,161100
143527700900000,SE 242,RESIDENTIAL,31600,0,31600,110300,0,141900
143527701000000,SE 242,RESIDENTIAL,15300,0,15300,0,0,15300
143527701100000,CITY PROPERTY,EXEMPT,0,0,0,0,0,0
143527701200000,SE 242,RESIDENTIAL,11900,0,11900,64800,0,76700
143527701300000,SE 242,RESIDENTIAL,8000,0,8000,0,0,8000
143527701400000,SE 242,RESIDENTIAL,11200,0,11200,110200,0,121400
143527701500000,SE 242,RESIDENTIAL,12200,0,12200,125300,0,137500
143527701600000,SE 242,RESIDENTIAL,20200,0,20200,18600,0,38800
143527701700000,SE 242,RESIDENTIAL,12100,0,12100,77400,0,89500
143527701800000,SE 242,RESIDENTIAL,19100,0,19100,66300,0,85400
143527701900000,SE 242,RESIDENTIAL,11200,0,11200,89900,0,101100
143527702000000,SE 242,RESIDENTIAL,10800,0,10800,32500,0,43300
143530100100000,SE 242,RESIDENTIAL,25800,0,25800,79800,0,105600
143530100200000,SE 242,RESIDENTIAL,19800,0,19800,235800,0,255600
143530100300000,SE 242,RESIDENTIAL,10400,0,10400,62900,0,73300
143530100400000,SE 242,RESIDENTIAL,11000,0,11000,89500,0,100500
143530100500000,SE 242,RESIDENTIAL,13400,0,13400,66900,0,80300
143530100600000,CITY PROPERTY,EXEMPT,0,0,0,0,0,0
143530100700000,CITY PROPERTY,EXEMPT,0,0,0,0,0,0
143530100800000,SE 242,RESIDENTIAL,12600,0,12600,105100,0,117700
143530100900000,SE 242,RESIDENTIAL,10300,0,10300,135600,0,145900
143530200100000,SE 242,RESIDENTIAL,11800,0,11800,85700,0,97500
143530200200000,SE 242,RESIDENTIAL,6500,0,6500,69100,0,75600
143530200300000,SE 242,RESIDENTIAL,6500,0,6500,56400,0,62900
143530200400000,SE 242,RESIDENTIAL,6500,0,6500,57000,0,63500
143530200500000,SE 242,RESIDENTIAL,13200,0,13200,1600,0,14800
143530200600000,SE 242,RESIDENTIAL,7900,0,7900,52100,0,60000
143530200700000,SE 242,RESIDENTIAL,7900,0,7900,76200,0,84100
143530200800000,SE 242,RESIDENTIAL,7900,0,7900,65000,0,72900
143530200900000,SE 242,RESIDENTIAL,6800,0,6800,64400,0,71200
143530201000000,SE 242,RESIDENTIAL,1100,0,1100,0,0,1100
143530201100000,SE 242,RESIDENTIAL,6800,0,6800,66900,0,73700
143530201200000,SE 242,RESIDENTIAL,1100,0,1100,0,0,1100
143530201300000,SE 242,RESIDENTIAL,6800,0,6800,52900,0,59700
143530201400000,SE 242,RESIDENTIAL,1100,0,1100,0,0,1100
143530201500000,CITY PROPERTY,EXEMPT,0,0,0,0,0,0
143530201600000,SE 242,RESIDENTIAL,1100,0,1100,0,0,1100
143530201700000,SE 242,RESIDENTIAL,6800,0,6800,51500,0,58300
143530201800000,SE 242,RESIDENTIAL,1100,0,1100,0,0,1100
143530201900000,SE 242,RESIDENTIAL,11800,0,11800,2100,0,13900
143530202100000,SE 242,RESIDENTIAL,7900,0,7900,102800,0,110700
143530202200000,SE 242,RESIDENTIAL,7900,0,7900,0,0,7900
143530202300000,SE 242,RESIDENTIAL,7900,0,7900,0,0,7900
143530202400000,CITY PROPERTY,EXEMPT,0,0,0,0,0,0
143530202500000,CITY PROPERTY,EXEMPT,0,0,0,0,0,0
143530202600000,SE 242,RESIDENTIAL,11800,0,11800,39900,0,51700
143530202700000,CITY PROPERTY,EXEMPT,0,0,0,0,0,0
143530202800000,SE 242,RESIDENTIAL,8800,0,8800,108100,0,116900
143530202900000,SE 242,RESIDENTIAL,11800,0,11800,44000,0,55800
143530203000000,SE 242,RESIDENTIAL,11800,0,11800,17200,0,29000
143530203100000,SE 242,RESIDENTIAL,15400,0,15400,77300,0,92700
143530203200000,SE 242,RESIDENTIAL,11800,0,11800,44600,0,56400
143530203300000,SE 242,RESIDENTIAL,7900,0,7900,45300,0,53200
143530203400000,SE 242,RESIDENTIAL,7900,0,7900,30500,0,38400
143530203500000,SE 242,RESIDENTIAL,7900,0,7900,63700,0,71600
143530203600000,SE 242,RESIDENTIAL,7900,0,7900,69100,0,77000
143530300100000,SE 242,RESIDENTIAL,20900,0,20900,149000,0,169900
143530300300000,SE 242,RESIDENTIAL,18500,0,18500,6000,0,24500
143530300400000,CITY PROPERTY,EXEMPT,0,0,0,0,0,0
143530300500000,SE 242,RESIDENTIAL,8600,0,8600,53800,0,62400
143530300600000,CITY PROPERTY,EXEMPT,0,0,0,0,0,0
143530300700000,CITY PROPERTY,EXEMPT,0,0,0,0,0,0
143530300800000,CITY PROPERTY,EXEMPT,0,0,0,0,0,0
143530300900000,CITY PROPERTY,EXEMPT,0,0,0,0,0,0
143530301000000,SE 242,RESIDENTIAL,7700,0,7700,78600,0,86300
143530301100000,CITY PROPERTY,EXEMPT,0,0,0,0,0,0
143530301200000,CITY PROPERTY,EXEMPT,0,0,0,0,0,0
143530301500000,CITY PROPERTY,EXEMPT,0,0,0,0,0,0
143530301600000,SE 242,RESIDENTIAL,11500,0,11500,98400,0,109900
143530301700000,CITY PROPERTY,EXEMPT,0,0,0,0,0,0
143530301800000,SE 242,RESIDENTIAL,18500,0,18500,136900,0,155400
143530301900000,CITY PROPERTY,EXEMPT,0,0,0,0,0,0
143530302000000,SE 242,RESIDENTIAL,7700,0,7700,25400,0,33100
143530302100000,SE 242,RESIDENTIAL,7700,0,7700,56100,0,63800
143530302200000,CITY PROPERTY,EXEMPT,0,0,0,0,0,0
143530302300000,SE 242,RESIDENTIAL,9800,0,9800,0,0,9800
143530302400000,SE 242,RESIDENTIAL,9800,0,9800,0,0,9800
143530302500000,SE 242,RESIDENTIAL,11500,0,11500,0,0,11500
143530400100000,SE 242,RESIDENTIAL,7600,0,7600,54400,0,62000
143530400200000,CITY PROPERTY,EXEMPT,0,0,0,0,0,0
143530400300000,CITY PROPERTY,EXEMPT,0,0,0,0,0,0
143530400400000,SE 242,RESIDENTIAL,7600,0,7600,32900,0,40500
143530400500000,SE 242,RESIDENTIAL,11400,0,11400,62200,0,73600
143530400600000,SE 242,RESIDENTIAL,11400,0,11400,92500,0,103900
143530400700000,SE 242,RESIDENTIAL,7600,0,7600,64200,0,71800
143530400800000,SE 242,RESIDENTIAL,14900,0,14900,9500,0,24400
143530400900000,CITY PROPERTY,EXEMPT,0,0,0,0,0,0
143530401000000,CITY PROPERTY,EXEMPT,0,0,0,0,0,0
143530401100000,CITY PROPERTY,EXEMPT,0,0,0,0,0,0
143530401200000,CITY PROPERTY,EXEMPT,0,0,0,0,0,0
143530401300000,SE 242,RESIDENTIAL,7600,0,7600,0,0,7600
143530401400000,SE 242,RESIDENTIAL,10100,0,10100,114400,0,124500
143530401500000,SE 242,RESIDENTIAL,7600,0,7600,0,0,7600
143532600100000,SE 242,RESIDENTIAL,8000,0,8000,75300,0,83300
143532600200000,SE 242,RESIDENTIAL,8000,0,8000,64200,0,72200
143532600300000,SE 242,RESIDENTIAL,8000,0,8000,104500,0,112500
143532600400000,SE 242,RESIDENTIAL,8000,0,8000,72200,0,80200
143532600500000,SE 242,RESIDENTIAL,18100,0,18100,85500,0,103600
143532600600000,SE 242,RESIDENTIAL,8000,0,8000,41700,0,49700
143532600900000,CITY PROPERTY,EXEMPT,0,0,0,0,0,0
143532601000000,CITY PROPERTY,EXEMPT,0,0,0,0,0,0
143532601100000,SE 242,RESIDENTIAL,7500,0,7500,50600,0,58100
143532601200000,SE 242,RESIDENTIAL,8000,0,8000,55300,0,63300
143532601300000,SE 242,RESIDENTIAL,11900,0,11900,80100,0,92000
143532700100000,CITY PROPERTY,EXEMPT,0,0,0,0,0,0
143532700200000,CITY PROPERTY,EXEMPT,0,0,0,0,0,0
143532700300000,CENTRALLY ASSESSED,OTHER,0,0,0,0,0,0
143535100100000,CITY PROPERTY,EXEMPT,0,0,0,0,0,0
143537700100000,CITY PROPERTY,EXEMPT,0,0,0,0,0,0
143540100100000,SE 242,AG DWELLING,48600,0,48600,94900,3700,147200
143540100200000,SE 242,RESIDENTIAL,37100,0,37100,64700,0,101800
143540100300000,SE 242,RESIDENTIAL,22800,0,22800,173000,0,195800
143540100400000,SE 242,RESIDENTIAL,1200,0,1200,0,0,1200
143542600100000,SE 242,AG DWELLING,15700,0,15700,101300,0,117000
143542700100000,SE 242,RESIDENTIAL,17500,0,17500,0,0,17500
143542700200000,SE 242,RESIDENTIAL,15100,0,15100,89500,0,104600
143542700300000,SE 242,RESIDENTIAL,14800,0,14800,143300,0,158100
143542700400000,SE 242,RESIDENTIAL,15100,0,15100,113900,0,129000
143542700500000,CITY PROPERTY,EXEMPT,0,0,0,0,0,0
143542700600000,CITY PROPERTY,EXEMPT,0,0,0,0,0,0
143542700800000,SE 242,RESIDENTIAL,19500,0,19500,0,0,19500
143542700900000,SE 242,RESIDENTIAL,21800,0,21800,77900,0,99700
143542701000000,SE 242,RESIDENTIAL,21800,0,21800,145500,0,167300
143542701100000,SE 242,RESIDENTIAL,17400,0,17400,0,0,17400
143542701200000,SE 242,RESIDENTIAL,12200,0,12200,0,0,12200
143542701300000,SE 242,RESIDENTIAL,12200,0,12200,105600,0,117800
143542701400000,SE 242,RESIDENTIAL,17400,0,17400,106100,0,123500
143542701500000,SE 242,RESIDENTIAL,21800,0,21800,66100,0,87900
143542701600000,SE 242,RESIDENTIAL,24600,0,24600,0,0,24600
143542701700000,SE 242,RESIDENTIAL,20400,0,20400,0,0,20400
143542701800000,SE 242,RESIDENTIAL,30500,0,30500,81900,0,112400
143542701900000,SE 242,RESIDENTIAL,27000,0,27000,220400,0,247400
143542702000000,CITY PROPERTY,EXEMPT,0,0,0,0,0,0
143542702100000,SE 242,RESIDENTIAL,15900,0,15900,152700,0,168600
143542702200000,SE 242,RESIDENTIAL,15100,0,15100,43900,0,59000
143542702300000,SE 242,RESIDENTIAL,16500,0,16500,157300,0,173800
143542702400000,SE 242,RESIDENTIAL,16700,0,16700,120700,0,137400
143542702500000,SE 242,RESIDENTIAL,15100,0,15100,0,0,15100
143542702600000,CITY PROPERTY,EXEMPT,0,0,0,0,0,0
143542702700000,CITY PROPERTY,EXEMPT,0,0,0,0,0,0
143545100100000,CITY PROPERTY,EXEMPT,0,0,0,0,0,0
143545200100000,CITY PROPERTY,EXEMPT,0,0,0,0,0,0
143547600100000,SE 242,AG DWELLING,52500,0,52500,112300,8700,173500
143547700100000,CITY PROPERTY,EXEMPT,0,0,0,0,0,0
143547700200000,CENTRALLY ASSESSED,OTHER,0,0,0,0,0,0
143640200100000,CITY PROPERTY,EXEMPT,0,0,0,0,0,0
143647600200000,FLAT PARKING,COMMERCIAL,0,38800,38800,0,10400,49200
143647600300000,VACANT LAND,COMMERCIAL,0,32500,32500,0,0,32500
143647700100000,CITY PROPERTY,EXEMPT,0,0,0,0,0,0
151815100400000,SE 244,RESIDENTIAL,164800,0,164800,608700,0,773500
151815100500000,SE 244,RESIDENTIAL,130200,0,130200,0,0,130200
151815100600000,SE 244,RESIDENTIAL,143000,0,143000,0,0,143000
151815100700000,SE 244,RESIDENTIAL,137900,0,137900,0,0,137900
151815100800000,SE 244,RESIDENTIAL,209500,0,209500,710300,0,919800
151815100900000,SE 244,RESIDENTIAL,151500,0,151500,625500,0,777000
151822600900000,SE 244,RESIDENTIAL,79600,0,79600,310300,0,389900
151822601000000,SE 244,RESIDENTIAL,106900,0,106900,273200,0,380100
151822601100000,SE 244,RESIDENTIAL,116800,0,116800,459100,0,575900
151822601200000,VACANT LAND,COMMERCIAL,0,61400,61400,0,0,61400
151822601202000,ANTENNAS/TOWERS(BLL),COMMERCIAL,0,0,0,0,210700,210700
151822601300000,SE 244,RESIDENTIAL,114500,0,114500,579200,0,693700
151822601400000,SE 244,RESIDENTIAL,97700,0,97700,456200,0,553900
151822601500000,SE 244,RESIDENTIAL,98800,0,98800,371400,0,470200
151822601600000,SE 244,RESIDENTIAL,97200,0,97200,478000,0,575200
151822700100000,SE 244,RESIDENTIAL,71800,0,71800,0,0,71800
151822700400000,SE 244,RESIDENTIAL,64900,0,64900,0,0,64900
151822700500000,SE 244,RESIDENTIAL,91000,0,91000,425600,0,516600
151822700600000,SE 244,RESIDENTIAL,93800,0,93800,345900,0,439700
151822700700000,SE 244,RESIDENTIAL,92900,0,92900,430700,0,523600
151822700800000,SE 244,RESIDENTIAL,92800,0,92800,463600,0,556400
151822700900000,SE 244,RESIDENTIAL,89400,0,89400,456900,0,546300
151822701000000,SE 244,RESIDENTIAL,192000,0,192000,1014800,0,1206800
151825100500000,SE 244,RESIDENTIAL,92200,0,92200,279700,0,371900
151825100600000,SE 244,RESIDENTIAL,151900,0,151900,519900,0,671800
151825100700000,SE 244,RESIDENTIAL,98300,0,98300,458200,0,556500
151825100800000,SE 244,RESIDENTIAL,5200,0,5200,0,0,5200
151827600200000,SE 244,RESIDENTIAL,126000,0,126000,0,0,126000
151827600300000,SE 244,RESIDENTIAL,155100,0,155100,452600,0,607700
151827600400000,SE 244,RESIDENTIAL,109000,0,109000,0,0,109000
151827600500000,SE 244,RESIDENTIAL,99200,0,99200,0,0,99200
151827600800000,SE 244,RESIDENTIAL,164400,0,164400,428700,0,593100
151827600900000,SE 244,RESIDENTIAL,158900,0,158900,489500,0,648400
151827601000000,SE 244,RESIDENTIAL,164000,0,164000,621400,0,785400
151827601100000,SE 244,RESIDENTIAL,160800,0,160800,500800,0,661600
151827601200000,SE 244,RESIDENTIAL,0,0,0,0,0,0
151827700100000,SE 244,RESIDENTIAL,82700,0,82700,0,0,82700
151827700200000,SE 244,RESIDENTIAL,72000,0,72000,510700,0,582700
151827700300000,SE 244,RESIDENTIAL,52900,0,52900,0,0,52900
151827700800000,SE 244,RESIDENTIAL,84500,0,84500,160400,0,244900
151827700900000,SE 244,RESIDENTIAL,121800,0,121800,0,0,121800
151827701000000,SE 244,RESIDENTIAL,153600,0,153600,0,0,153600
151827701100000,SE 244,RESIDENTIAL,121600,0,121600,0,0,121600
151827701300000,SE 244,RESIDENTIAL,103500,0,103500,465500,0,569000
151827701400000,SE 244,RESIDENTIAL,104000,0,104000,0,0,104000
151827701500000,SE 244,RESIDENTIAL,156600,0,156600,530700,0,687300
151827800100000,SE 244,RESIDENTIAL,78000,0,78000,402400,0,480400
151827800200000,SE 244,RESIDENTIAL,110900,0,110900,507100,0,618000
151827800300000,SE 244,RESIDENTIAL,150200,0,150200,429900,0,580100
151827800400000,SE 244,RESIDENTIAL,107900,0,107900,533800,0,641700
151827800500000,SE 244,RESIDENTIAL,91700,0,91700,356800,0,448500
151827800600000,SE 244,RESIDENTIAL,173500,0,173500,609600,0,783100
151827800800000,SE 244,RESIDENTIAL,167800,0,167800,657300,0,825100
151827800900000,SE 244,RESIDENTIAL,127500,0,127500,0,0,127500
151827900100000,SE 244,RESIDENTIAL,104400,0,104400,0,0,104400
151827900200000,SE 244,RESIDENTIAL,112700,0,112700,535300,0,648000
151827900300000,SE 244,RESIDENTIAL,91000,0,91000,0,0,91000
151827900400000,SE 244,RESIDENTIAL,117000,0,117000,0,0,117000
151830100300000,SE 244,RESIDENTIAL,7600,0,7600,0,0,7600
151830100500000,SE 244,RESIDENTIAL,78000,0,78000,512400,0,590400
151830100600000,SE 244,RESIDENTIAL,109700,0,109700,493800,0,603500
151830100700000,SE 244,RESIDENTIAL,106500,0,106500,87200,0,193700
151830100800000,SE 244,RESIDENTIAL,114500,0,114500,606700,0,721200
151830100900000,SE 244,RESIDENTIAL,116400,0,116400,485300,0,601700
151830101000000,SE 244,RESIDENTIAL,152700,0,152700,659500,0,812200
151830101100000,SE 244,RESIDENTIAL,120500,0,120500,0,0,120500
151830101200000,SE 244,RESIDENTIAL,120600,0,120600,0,0,120600
151830101300000,SE 244,RESIDENTIAL,125100,0,125100,0,0,125100
151830101400000,SE 244,RESIDENTIAL,0,0,0,0,0,0
151830101500000,SE 244,RESIDENTIAL,157400,0,157400,857100,0,1014500
151830101600000,SE 244,RESIDENTIAL,163000,0,163000,932500,0,1095500
151830101700000,SE 244,RESIDENTIAL,164000,0,164000,637900,0,801900
151830101800000,SE 244,RESIDENTIAL,87000,0,87000,0,0,87000
151830101900000,SE 244,RESIDENTIAL,156100,0,156100,425500,0,581600
151830102000000,SE 244,RESIDENTIAL,113400,0,113400,0,0,113400
151830102100000,SE 244,RESIDENTIAL,120600,0,120600,0,0,120600
151830200100000,SE 244,RESIDENTIAL,156400,0,156400,605100,0,761500
151830200200000,SE 244,RESIDENTIAL,158800,0,158800,636800,0,795600
151830200300000,SE 244,RESIDENTIAL,158900,0,158900,525500,0,684400
151830200400000,SE 244,RESIDENTIAL,154500,0,154500,546700,0,701200
151830300100000,SE 244,RESIDENTIAL,109200,0,109200,0,0,109200
151830300200000,SE 244,RESIDENTIAL,126000,0,126000,844600,0,970600
151830300300000,SE 244,RESIDENTIAL,120200,0,120200,0,0,120200
151830400100000,SE 244,RESIDENTIAL,171500,0,171500,874200,0,1045700
151832600400000,SE 244,RESIDENTIAL,121400,0,121400,0,0,121400
151832600500000,SE 244,RESIDENTIAL,94000,0,94000,0,0,94000
151832600600000,SE 244,RESIDENTIAL,125300,0,125300,0,0,125300
151832600700000,SE 244,RESIDENTIAL,129300,0,129300,0,0,129300
151832600800000,SE 244,RESIDENTIAL,20600,0,20600,0,0,20600
151835100300000,SE 244,RESIDENTIAL,124600,0,124600,0,0,124600
151837600200000,SE 244,RESIDENTIAL,128400,0,128400,0,0,128400
151837600300000,SE 244,RESIDENTIAL,142200,0,142200,0,0,142200
151837600400000,SE 244,RESIDENTIAL,136400,0,136400,0,0,136400
151842600400000,SE 244,RESIDENTIAL,2100,0,2100,0,0,2100
151842600500000,SE 244,RESIDENTIAL,22600,0,22600,0,0,22600
151842600700000,SE 244,RESIDENTIAL,153300,0,153300,575200,0,728500
151842600800000,SE 244,RESIDENTIAL,159000,0,159000,647100,0,806100
151842600900000,SE 244,RESIDENTIAL,161300,0,161300,554600,0,715900
151842601000000,SE 244,RESIDENTIAL,124900,0,124900,0,0,124900
151842601100000,SE 244,RESIDENTIAL,155300,0,155300,751900,0,907200
151842601200000,SE 244,RESIDENTIAL,137500,0,137500,0,0,137500
151842601300000,SE 244,RESIDENTIAL,177000,0,177000,624700,0,801700
151842601400000,SE 244,RESIDENTIAL,96400,0,96400,0,0,96400
151842601500000,SE 244,RESIDENTIAL,136400,0,136400,879100,0,1015500
151842601600000,SE 244,RESIDENTIAL,152400,0,152400,136600,0,289000
151842601700000,SE 244,RESIDENTIAL,84800,0,84800,488400,0,573200
151842601800000,SE 244,RESIDENTIAL,0,0,0,0,0,0
151930300500000,SE 220,RESIDENTIAL,32300,0,32300,165800,0,198100
151930300600000,SE 220,RESIDENTIAL,31100,0,31100,211000,0,242100
151930300700000,SE 220,RESIDENTIAL,33200,0,33200,167700,0,200900
151930300800000,SE 220,RESIDENTIAL,32500,0,32500,0,0,32500
151930300900000,SE 220,RESIDENTIAL,33600,0,33600,239100,0,272700
151930301000000,SE 220,RESIDENTIAL,35000,0,35000,235900,0,270900
151930301100000,SE 220,RESIDENTIAL,33500,0,33500,189500,0,223000
151930301200000,SE 220,RESIDENTIAL,34200,0,34200,224200,0,258400
151930301300000,SE 220,RESIDENTIAL,36300,0,36300,206100,0,242400
151930301400000,SE 220,RESIDENTIAL,34300,0,34300,231300,0,265600
151930301500000,SE 220,RESIDENTIAL,27900,0,27900,90600,0,118500
151930400700000,SE 220,RESIDENTIAL,61800,0,61800,115300,0,177100
151932600100000,SE 220,RESIDENTIAL,37100,0,37100,151000,0,188100
151932600200000,SE 220,RESIDENTIAL,33000,0,33000,157800,0,190800
151932600300000,SE 220,RESIDENTIAL,41200,0,41200,218100,0,259300
151932600400000,SE 220,RESIDENTIAL,37100,0,37100,182000,0,219100
151932600500000,SE 220,RESIDENTIAL,37200,0,37200,228800,0,266000
151932600600000,SE 220,RESIDENTIAL,40500,0,40500,179000,0,219500
151932600700000,SE 220,RESIDENTIAL,35500,0,35500,217000,0,252500
151932600800000,SE 220,RESIDENTIAL,37100,0,37100,254600,0,291700
151932600900000,SE 220,RESIDENTIAL,37100,0,37100,221400,0,258500
151932601000000,SE 220,RESIDENTIAL,37100,0,37100,146300,0,183400
151932601100000,SE 220,RESIDENTIAL,41400,0,41400,172000,0,213400
151932601300000,SE 220,RESIDENTIAL,400,0,400,0,0,400
151932601600000,SE 220,RESIDENTIAL,200,0,200,0,0,200
151932601700000,SE 220,RESIDENTIAL,37900,0,37900,166100,0,204000
151932601800000,SE 220,RESIDENTIAL,35300,0,35300,184700,0,220000
151932601900000,SE 220,RESIDENTIAL,35300,0,35300,154500,0,189800
151932602000000,SE 220,RESIDENTIAL,35300,0,35300,155300,0,190600
151932602100000,SE 220,RESIDENTIAL,34900,0,34900,168600,0,203500
151932602200000,SE 220,RESIDENTIAL,30500,0,30500,208200,0,238700
151932602300000,SE 220,RESIDENTIAL,33800,0,33800,157200,0,191000
151932602400000,SE 220,RESIDENTIAL,33800,0,33800,149600,0,183400
151932602500000,SE 220,RESIDENTIAL,33800,0,33800,134400,0,168200
151932602600000,SE 220,RESIDENTIAL,33800,0,33800,132900,0,166700
151932602700000,SE 220,RESIDENTIAL,35600,0,35600,230100,0,265700
151932602800000,SE 220,RESIDENTIAL,39000,0,39000,193800,0,232800
151932602900000,SE 220,RESIDENTIAL,41500,0,41500,193700,0,235200
151932603000000,SE 220,RESIDENTIAL,34900,0,34900,203600,0,238500
151932603100000,SE 220,RESIDENTIAL,35600,0,35600,186800,0,222400
151932603200000,SE 220,RESIDENTIAL,35600,0,35600,237200,0,272800
151932603300000,SE 220,RESIDENTIAL,38300,0,38300,248000,0,286300
151932603400000,SE 220,RESIDENTIAL,52900,0,52900,225300,0,278200
151932603700000,SE 220,RESIDENTIAL,71400,0,71400,438800,0,510200
151932603800000,SE 220,RESIDENTIAL,37200,0,37200,157400,0,194600
151932603900000,SE 220,RESIDENTIAL,36000,0,36000,162100,0,198100
151932604000000,SE 220,RESIDENTIAL,34600,0,34600,164900,0,199500
151932604100000,SE 220,RESIDENTIAL,36400,0,36400,146200,0,182600
151932604200000,SE 220,RESIDENTIAL,36700,0,36700,169000,0,205700
151932604300000,SE 220,RESIDENTIAL,37100,0,37100,124200,0,161300
151932604400000,SE 220,RESIDENTIAL,39300,0,39300,190700,0,230000
151932604500000,SE 220,RESIDENTIAL,39900,0,39900,236900,0,276800
151932604600000,SE 220,RESIDENTIAL,34500,0,34500,159900,0,194400
151932604700000,SE 220,RESIDENTIAL,32000,0,32000,171700,0,203700
151932604800000,SE 220,RESIDENTIAL,32700,0,32700,146000,0,178700
151932604900000,SE 220,RESIDENTIAL,32400,0,32400,139700,0,172100
151932605000000,SE 220,RESIDENTIAL,32400,0,32400,231000,0,263400
151932605100000,SE 220,RESIDENTIAL,32400,0,32400,145600,0,178000
151932605200000,SE 220,RESIDENTIAL,39000,0,39000,168500,0,207500
151932605300000,SE 220,RESIDENTIAL,33700,0,33700,150700,0,184400
151932605400000,SE 220,RESIDENTIAL,32800,0,32800,123400,0,156200
151932605500000,SE 220,RESIDENTIAL,28500,0,28500,166500,0,195000
151932605600000,SE 220,RESIDENTIAL,5100,0,5100,0,0,5100
151932605700000,SE 220,RESIDENTIAL,21800,0,21800,0,0,21800
151935100400000,SE 220,RESIDENTIAL,48400,0,48400,170000,0,218400
151935100500000,SE 220,RESIDENTIAL,39400,0,39400,292200,0,331600
151935100600000,SE 220,RESIDENTIAL,45200,0,45200,301000,0,346200
151935100700000,SE 220,RESIDENTIAL,47800,0,47800,241400,0,289200
151935100800000,SE 220,RESIDENTIAL,46700,0,46700,275900,0,322600
151935100900000,SE 220,RESIDENTIAL,46300,0,46300,282800,0,329100
151935101000000,SE 220,RESIDENTIAL,47100,0,47100,291600,0,338700
151935101100000,SE 220,RESIDENTIAL,31600,0,31600,0,0,31600
151935101200000,SE 220,RESIDENTIAL,45700,0,45700,235400,0,281100
151935101300000,SE 220,RESIDENTIAL,62400,0,62400,325600,0,388000
151935101400000,SE 220,RESIDENTIAL,51300,0,51300,252400,0,303700
151935101500000,SE 220,RESIDENTIAL,51200,0,51200,298300,0,349500
151935101600000,SE 220,RESIDENTIAL,51000,0,51000,284000,0,335000
151935101700000,SE 220,RESIDENTIAL,47800,0,47800,0,0,47800
151935101800000,SE 220,RESIDENTIAL,45300,0,45300,319300,0,364600
151935103000000,SE 220,RESIDENTIAL,0,0,0,0,0,0
151935103300000,SHOP,COMMERCIAL,0,24800,24800,0,86800,111600
151935103400000,SE 220,RESIDENTIAL,16900,0,16900,0,0,16900
152935100200000,CITY PROPERTY,EXEMPT,0,0,0,0,0,0
153032600200000,SE 246,RESIDENTIAL,161400,0,161400,245400,0,406800
153032600300000,SE 246,RESIDENTIAL,192100,0,192100,873500,0,1065600
153032600400000,SE 246,RESIDENTIAL,130000,0,130000,229700,0,359700
153040300100000,CITY PROPERTY,EXEMPT,0,0,0,0,0,0
153210200100000,CITY PROPERTY,EXEMPT,0,0,0,0,0,0
153212600200000,CENTRALLY ASSESSED,OTHER,0,0,0,0,0,0
153222600100000,CITY PROPERTY,EXEMPT,0,0,0,0,0,0
153322700100000,CENTRALLY ASSESSED,OTHER,0,0,0,0,0,0
153322700102000,ANTENNAS/TOWERS(BLL),EXEMPT,0,0,0,0,0,0
153325100100000,CITY PROPERTY,EXEMPT,0,0,0,0,0,0
153330100100000,CITY PROPERTY,EXEMPT,0,0,0,0,0,0
153332600100000,CITY PROPERTY,EXEMPT,0,0,0,0,0,0
153335100100000,CITY PROPERTY,EXEMPT,0,0,0,0,0,0
153337700100000,CITY PROPERTY,EXEMPT,0,0,0,0,0,0
180622600100000,SW 422,RESIDENTIAL,383800,0,383800,0,0,383800
180625100100000,SW 422,RESIDENTIAL,411500,0,411500,0,0,411500
180632600200000,SW 422,RESIDENTIAL,200000,0,200000,0,0,200000
180635100200000,SW 422,RESIDENTIAL,15000,0,15000,0,0,15000
180715100200000,SW 448,RESIDENTIAL,132300,0,132300,521900,0,654200
180715200100000,SW 448,RESIDENTIAL,104000,0,104000,0,0,104000
180715200200000,SW 448,RESIDENTIAL,105400,0,105400,0,0,105400
180715200300000,SW 448,RESIDENTIAL,122800,0,122800,638900,0,761700
180715200400000,SW 448,RESIDENTIAL,123700,0,123700,0,0,123700
180715200500000,SW 448,RESIDENTIAL,146800,0,146800,378300,0,525100
180715200600000,SW 448,RESIDENTIAL,130300,0,130300,489200,0,619500
180715200700000,SW 448,RESIDENTIAL,1000,0,1000,0,0,1000
180715200800000,SW 448,RESIDENTIAL,1700,0,1700,0,0,1700
180715200900000,SW 448,RESIDENTIAL,1500,0,1500,0,0,1500
180715201000000,SW 448,RESIDENTIAL,1300,0,1300,0,0,1300
180715201100000,SW 448,RESIDENTIAL,1500,0,1500,0,0,1500
180715201200000,SW 448,RESIDENTIAL,139000,0,139000,476200,0,615200
180720100900000,SW 448,RESIDENTIAL,107400,0,107400,0,0,107400
180720101000000,SW 448,RESIDENTIAL,133900,0,133900,384400,0,518300
180720101100000,SW 448,RESIDENTIAL,164200,0,164200,0,0,164200
180720101200000,SW 448,RESIDENTIAL,129800,0,129800,414400,0,544200
180720200100000,SW 448,RESIDENTIAL,107600,0,107600,0,0,107600
180720200200000,SW 448,RESIDENTIAL,110200,0,110200,0,0,110200
180727700100000,SW 448,RESIDENTIAL,111200,0,111200,0,0,111200
180727700200000,SW 448,RESIDENTIAL,114600,0,114600,0,0,114600
180727700300000,SW 448,RESIDENTIAL,131800,0,131800,133400,0,265200
180727700400000,SW 448,RESIDENTIAL,130600,0,130600,0,0,130600
180727700500000,SW 448,RESIDENTIAL,124900,0,124900,0,0,124900
180727700600000,SW 448,RESIDENTIAL,115800,0,115800,0,0,115800
180727700700000,SW 448,RESIDENTIAL,108600,0,108600,0,0,108600
180727700800000,SW 448,RESIDENTIAL,0,0,0,0,0,0
180727800100000,SW 448,RESIDENTIAL,144400,0,144400,710300,0,854700
180727800200000,SW 448,RESIDENTIAL,115600,0,115600,773095,0,888695
180727800300000,SW 448,RESIDENTIAL,132100,0,132100,837900,0,970000
180727900100000,SW 448,RESIDENTIAL,111700,0,111700,0,0,111700
190110100100000,VACANT LAND,COMMERCIAL,0,112500,112500,0,0,112500
190115100100000,VACANT LAND,COMMERCIAL,0,171500,171500,0,0,171500
190117600100000,SW 422,RESIDENTIAL,400000,0,400000,0,0,400000
190140100100000,SW 422,RESIDENTIAL,400000,0,400000,0,0,400000
190142600100000,SW 422,RESIDENTIAL,400000,0,400000,0,0,400000
190145100100000,SW 422,RESIDENTIAL,400000,0,400000,0,0,400000
190147600100000,SW 422,RESIDENTIAL,400000,0,400000,0,0,400000
190210100100000,CITY PROPERTY,EXEMPT,0,0,0,0,0,0
190210100300000,SW 422,AG LAND,52700,0,52700,0,0,52700
190212600100000,CITY PROPERTY,EXEMPT,0,0,0,0,0,0
190215100100000,CITY PROPERTY,EXEMPT,0,0,0,0,0,0
190215200100000,SW 422,RESIDENTIAL,51100,0,51100,233400,0,284500
190215200200000,SW 422,AG LAND,3500,0,3500,0,0,3500
190215200400000,SW 422,AG LAND,7900,0,7900,0,0,7900
190217600100000,CITY PROPERTY,EXEMPT,0,0,0,0,0,0
190217700100000,SW 422,RESIDENTIAL,3800,0,3800,0,0,3800
190217700200000,SW 422,RESIDENTIAL,4900,0,4900,7900,0,12800
190217700300000,SW 422,RESIDENTIAL,9200,0,9200,0,0,9200
190217800100000,SW 422,RESIDENTIAL,60300,0,60300,167200,0,227500
190217800300000,SW 422,RESIDENTIAL,77300,0,77300,122900,0,200200
190220100100000,CITY PROPERTY,EXEMPT,0,0,0,0,0,0
190220200100000,CENTRALLY ASSESSED,OTHER,0,0,0,0,0,0
190222600100000,CITY PROPERTY,EXEMPT,0,0,0,0,0,0
190222700100000,SHOP,COMMERCIAL,0,41600,41600,0,86100,127700
190222700200000,SW 422,RESIDENTIAL,33400,0,33400,127200,0,160600
190222800100000,CENTRALLY ASSESSED,OTHER,0,0,0,0,0,0
190225100100000,CENTRALLY ASSESSED,OTHER,0,0,0,0,0,0
190225100200000,CENTRALLY ASSESSED,OTHER,0,0,0,0,0,0
190225200100000,VACANT LAND,COMMERCIAL,0,24200,24200,0,0,24200
190225200200000,CENTRALLY ASSESSED,OTHER,0,0,0,0,0,0
190225300100000,SW 422,RESIDENTIAL,52800,0,52800,224300,0,277100
190225300200000,SW 422,RESIDENTIAL,63300,0,63300,24100,0,87400
190225300300000,ANTENNAS/TOWERS(BLL),COMMERCIAL,0,27500,27500,0,206200,233700
190225400100000,CENTRALLY ASSESSED,OTHER,0,0,0,0,0,0
190225400200000,CENTRALLY ASSESSED,OTHER,0,0,0,0,0,0
190227600100000,CENTRALLY ASSESSED,OTHER,0,0,0,0,0,0
190227600200000,CITY PROPERTY,EXEMPT,0,0,0,0,0,0
190227700100000,SHOP,COMMERCIAL,0,170400,170400,0,282500,452900
190227700200000,SW 422,RESIDENTIAL,86300,0,86300,0,0,86300
190227700300000,VACANT LAND,COMMERCIAL,0,77200,77200,0,0,77200
190227700600000,ANTENNAS/TOWERS(BLL),COMMERCIAL,0,90900,90900,0,98400,189300
190227700800000,BARS/LOUNGE,COMMERCIAL,0,9100,9100,0,83600,92700
190227700900000,VACANT LAND,COMMERCIAL,0,48800,48800,0,0,48800
190227701000000,SHOP,COMMERCIAL,0,65300,65300,0,69300,134600
190230100100000,SW 422,AG LAND,7700,0,7700,0,0,7700
190230100200000,SW 422,AG LAND,54500,0,54500,0,0,54500
190232600100000,SW 422,RESIDENTIAL,53900,0,53900,91000,0,144900
190232600200000,CEMETERY,EXEMPT,0,129600,129600,0,0,129600
190232700100000,SW 422,AG LAND,14600,0,14600,0,0,14600
190232800100000,VACANT LAND,COMMERCIAL,0,32100,32100,0,0,32100
190232800200000,VACANT LAND,COMMERCIAL,0,103800,103800,0,0,103800
190235100100000,SW 422,RESIDENTIAL,40100,0,40100,99700,0,139800
190235200100000,SW 422,AG LAND,1800,0,1800,0,0,1800
190235300100000,VACANT LAND,COMMERCIAL,0,1100,1100,0,0,1100
190235300200000,EQUIPMENT MFG;INDUST,INDUSTRIAL,0,640500,640500,0,4104900,4745400
190235300300000,VACANT LAND,COMMERCIAL,0,91200,91200,0,0,91200
190235300400000,MISCELLANEOUS,COMMERCIAL,0,7900,7900,0,24400,32300
190237600100000,SW 422,RESIDENTIAL,50000,0,50000,123000,0,173000
190237600200000,SW 422,AG DWELLING,18900,0,18900,150400,15300,184600
190237600300000,SW 422,RESIDENTIAL,51600,0,51600,103700,0,155300
190237600400000,SW 422,RESIDENTIAL,29700,0,29700,122800,0,152500
190237600500000,SW 422,RESIDENTIAL,51100,0,51100,137500,0,188600
190237600600000,SW 422,RESIDENTIAL,28300,0,28300,63000,0,91300
190237600700000,SW 422,RESIDENTIAL,12700,0,12700,0,0,12700
190237600800000,SW 422,RESIDENTIAL,69000,0,69000,81700,0,150700
190240100100000,SW 422,RESIDENTIAL,70000,0,70000,678600,0,748600
190240100300000,SW 422,AG LAND,44600,0,44600,0,0,44600
190242600200000,SW 422,RESIDENTIAL,71700,0,71700,36400,0,108100
190242600300000,SW 422,AG DWELLING,54300,0,54300,19400,400,74100
190245100100000,SW 422,AG LAND,84600,0,84600,0,0,84600
190245100200000,SW 422,RESIDENTIAL,11400,0,11400,0,0,11400
190247600300000,SW 422,RESIDENTIAL,55900,0,55900,156000,0,211900
190247600400000,SW 422,AG LAND,50700,0,50700,0,2700,53400
190310100100000,CITY PROPERTY,EXEMPT,0,0,0,0,0,0
190310100200000,CENTRALLY ASSESSED,OTHER,0,0,0,0,0,0
190315100100000,VACANT LAND,INDUSTRIAL,0,140800,140800,0,0,140800
190317600100000,CENTRALLY ASSESSED,OTHER,0,0,0,0,0,0
190317600200000,CENTRALLY ASSESSED,OTHER,0,0,0,0,0,0
190317600300000,VACANT LAND,INDUSTRIAL,0,500400,500400,0,0,500400
190317600400000,VACANT LAND,INDUSTRIAL,0,209300,209300,0,0,209300
190320100100000,CITY PROPERTY,EXEMPT,0,0,0,0,0,0
190322600300000,SW 415,RESIDENTIAL,40600,0,40600,82700,0,123300
190322600400000,SW 415,RESIDENTIAL,23500,0,23500,82900,0,106400
190322600500000,SW 415,RESIDENTIAL,25000,0,25000,82200,0,107200
190322600600000,SW 415,RESIDENTIAL,21600,0,21600,90400,0,112000
190322600700000,SW 415,RESIDENTIAL,21900,0,21900,101400,0,123300
190322600800000,VACANT LAND,COMMERCIAL,0,12500,12500,0,0,12500
190322600900000,SW 415,RESIDENTIAL,22500,0,22500,101300,0,123800
190322601000000,SW 415,RESIDENTIAL,29100,0,29100,122000,0,151100
190322601100000,SW 415,RESIDENTIAL,24200,0,24200,80500,0,104700
190322601200000,SW 415,RESIDENTIAL,21400,0,21400,81500,0,102900
190322601300000,SW 415,RESIDENTIAL,22300,0,22300,88700,0,111000
190322601400000,SW 415,RESIDENTIAL,19900,0,19900,105300,0,125200
190322601500000,SW 415,RESIDENTIAL,21200,0,21200,101500,0,122700
190322601600000,SW 415,RESIDENTIAL,21200,0,21200,91200,0,112400
190322601700000,SW 415,RESIDENTIAL,21200,0,21200,97100,0,118300
190322601800000,SW 415,RESIDENTIAL,30300,0,30300,108800,0,139100
190322601900000,SW 415,RESIDENTIAL,30300,0,30300,100500,0,130800
190322602000000,SW 415,RESIDENTIAL,31500,0,31500,90400,0,121900
190322602100000,SW 415,RESIDENTIAL,31500,0,31500,100100,0,131600
190322700100000,SW 415,RESIDENTIAL,21000,0,21000,83900,0,104900
190322700200000,SW 415,RESIDENTIAL,21000,0,21000,78500,0,99500
190322700300000,SW 415,RESIDENTIAL,21300,0,21300,101300,0,122600
190322700400000,SW 415,RESIDENTIAL,24200,0,24200,111400,0,135600
190322700500000,SW 415,RESIDENTIAL,20600,0,20600,132300,0,152900
190322700600000,SW 415,RESIDENTIAL,21900,0,21900,131600,0,153500
190322700700000,SW 415,RESIDENTIAL,22300,0,22300,104600,0,126900
190322700800000,SW 415,RESIDENTIAL,21600,0,21600,103900,0,125500
190322700900000,SW 415,RESIDENTIAL,5500,0,5500,0,0,5500
190322701000000,SW 415,RESIDENTIAL,26100,0,26100,92400,0,118500
190322701100000,SW 415,RESIDENTIAL,29000,0,29000,71500,0,100500
190322701200000,SW 415,RESIDENTIAL,29400,0,29400,105800,0,135200
190322701300000,SW 415,RESIDENTIAL,24400,0,24400,85800,0,110200
190322701400000,SW 415,RESIDENTIAL,22800,0,22800,96600,0,119400
190322701500000,SW 415,RESIDENTIAL,21600,0,21600,93900,0,115500
190322701600000,SW 415,RESIDENTIAL,19800,0,19800,89600,0,109400
190322701700000,SW 415,RESIDENTIAL,19800,0,19800,94200,0,114000
190322701800000,SW 415,RESIDENTIAL,19800,0,19800,102100,0,121900
190322701900000,SW 415,RESIDENTIAL,21300,0,21300,92100,0,113400
190322800100000,SW 415,RESIDENTIAL,21500,0,21500,88900,0,110400
190322800200000,SW 415,RESIDENTIAL,21000,0,21000,85700,0,106700
190322800300000,SW 415,RESIDENTIAL,22100,0,22100,90800,0,112900
190322800400000,SW 415,RESIDENTIAL,22100,0,22100,94300,0,116400
190322800500000,SW 415,RESIDENTIAL,22700,0,22700,107000,0,129700
190322800600000,SW 415,RESIDENTIAL,21500,0,21500,94100,0,115600
190322800700000,SW 415,RESIDENTIAL,22500,0,22500,96800,0,119300
190322800800000,SW 415,RESIDENTIAL,22500,0,22500,108400,0,130900
190325100100000,SW 415,RESIDENTIAL,36600,0,36600,128100,0,164700
190325100200000,SW 415,RESIDENTIAL,30600,0,30600,104700,0,135300
190325100300000,SW 415,RESIDENTIAL,31200,0,31200,102600,0,133800
190325100400000,SW 415,RESIDENTIAL,30000,0,30000,93200,0,123200
190325100500000,SW 415,RESIDENTIAL,30200,0,30200,105100,0,135300
190325100600000,SW 415,RESIDENTIAL,21400,0,21400,94400,0,115800
190325100700000,SW 415,RESIDENTIAL,30600,0,30600,99300,0,129900
190327600100000,CITY PROPERTY,EXEMPT,0,0,0,0,0,0
190327600200000,CENTRALLY ASSESSED,OTHER,0,0,0,0,0,0
190327600300000,CENTRALLY ASSESSED,OTHER,0,0,0,0,0,0
190327600400000,CITY PROPERTY,EXEMPT,0,0,0,0,0,0
190327600500000,CENTRALLY ASSESSED,OTHER,0,0,0,0,0,0
190330100100000,MFG HOME PARK,MULTI-RES,211800,0,211800,89100,0,300900
190330100200000,CENTRALLY ASSESSED,OTHER,0,0,0,0,0,0
190330100300000,WAREHOUSE,COMMERCIAL,0,230500,230500,0,270400,500900
190330100500000,CENTRALLY ASSESSED,OTHER,0,0,0,0,0,0
190330200100000,SW 422,RESIDENTIAL,15100,0,15100,0,0,15100
190330200200000,CENTRALLY ASSESSED,OTHER,0,0,0,0,0,0
190332600100000,SW 422,RESIDENTIAL,20100,0,20100,0,0,20100
190332600200000,CENTRALLY ASSESSED,OTHER,0,0,0,0,0,0
190332600300000,CITY PROPERTY,EXEMPT,0,0,0,0,0,0
190332600400000,CITY PROPERTY,EXEMPT,0,0,0,0,0,0
190332600500000,CENTRALLY ASSESSED,OTHER,0,0,0,0,0,0
190332700300000,SHOP,COMMERCIAL,0,91000,91000,0,219900,310900
190332700400000,SMALL RETAIL,COMMERCIAL,0,91200,91200,0,422500,513700
190332700500000,CONVENIENCE STORE,COMMERCIAL,0,162300,162300,0,329300,491600
190332700600000,WAREHOUSE,COMMERCIAL,13494,90306,103800,14846,103754,222400
190332700700000,WAREHOUSE,COMMERCIAL,0,595000,595000,0,680500,1275500
190335100100000,FLAT PARKING,COMMERCIAL,0,222500,222500,0,31700,254200
190335100200000,EQUIPMENT MFG;INDUST,INDUSTRIAL,0,1139000,1139000,0,4243100,5382100
190337600200000,SHOP,INDUSTRIAL,0,1000000,1000000,0,2451100,3451100
190337600300000,SHOP,INDUSTRIAL,0,481800,481800,0,1396000,1877800
190337600400000,WAREHOUSE,COMMERCIAL,0,176000,176000,0,930800,1106800
190337600500000,CARWASH,COMMERCIAL,0,357000,357000,0,478600,835600
190337600600000,SHOP,COMMERCIAL,0,181000,181000,0,449100,630100
190337600700000,FLAT PARKING,COMMERCIAL,0,19000,19000,0,7400,26400
190337601000000,WAREHOUSE,INDUSTRIAL,0,428000,428000,0,1555800,1983800
190340100100000,FEED/ADDITIVE;INDUST,INDUSTRIAL,0,1106800,1106800,0,14064700,15171500
190342600100000,VACANT LAND,INDUSTRIAL,0,454300,454300,0,0,454300
190345100300000,FOOD GRADE;INDUST,INDUSTRIAL,0,1075800,1075800,0,14037500,15113300
190347600200000,OFFICE,COMMERCIAL,0,468000,468000,0,882300,1350300
190347600300000,OFFICE,COMMERCIAL,0,350400,350400,0,1143500,1493900
190347600400000,VACANT LAND,COMMERCIAL,0,134000,134000,0,0,134000
190347600500000,WAREHOUSE,COMMERCIAL,0,494500,494500,0,7373300,7867800
190410100200000,SW 428,RESIDENTIAL,32000,0,32000,50300,0,82300
190410100300000,SW 428,RESIDENTIAL,31200,0,31200,106300,0,137500
190410100400000,SW 428,RESIDENTIAL,31000,0,31000,127300,0,158300
190410100500000,SW 428,RESIDENTIAL,24600,0,24600,43700,0,68300
190410100600000,SW 428,RESIDENTIAL,20000,0,20000,105300,0,125300
190410100700000,SW 428,RESIDENTIAL,20000,0,20000,114200,0,134200
190410100800000,SW 428,RESIDENTIAL,20600,0,20600,117000,0,137600
190410100900000,SW 428,RESIDENTIAL,25000,0,25000,101400,0,126400
190410101000000,SW 428,RESIDENTIAL,25000,0,25000,86300,0,111300
190410101100000,SW 428,RESIDENTIAL,25000,0,25000,126400,0,151400
190410101200000,SW 428,RESIDENTIAL,25000,0,25000,169800,0,194800
190410101300000,SW 428,RESIDENTIAL,25000,0,25000,96500,0,121500
190410101400000,SW 428,RESIDENTIAL,25000,0,25000,109900,0,134900
190410101500000,SW 428,RESIDENTIAL,25000,0,25000,64500,0,89500
190410101600000,SW 428,RESIDENTIAL,25000,0,25000,59100,0,84100
190410101700000,SW 428,RESIDENTIAL,26000,0,26000,85500,0,111500
190410101800000,SW 428,RESIDENTIAL,24000,0,24000,62900,0,86900
190410101900000,SW 428,RESIDENTIAL,21200,0,21200,70700,0,91900
190410102000000,SW 428,RESIDENTIAL,18300,0,18300,153800,0,172100
190410102100000,SW 428,RESIDENTIAL,19900,0,19900,111400,0,131300
190410102200000,SW 428,RESIDENTIAL,24300,0,24300,72400,0,96700
190410102300000,SW 428,RESIDENTIAL,24300,0,24300,91800,0,116100
190410102400000,SW 428,RESIDENTIAL,24300,0,24300,84200,0,108500
190410102500000,SW 428,RESIDENTIAL,23900,0,23900,80000,0,103900
190410102600000,SW 428,RESIDENTIAL,23900,0,23900,99600,0,123500
190410102700000,SW 428,RESIDENTIAL,23900,0,23900,125000,0,148900
190410102800000,SW 428,RESIDENTIAL,24500,0,24500,62400,0,86900
190410102900000,SW 428,RESIDENTIAL,22100,0,22100,95300,0,117400
190410103000000,SW 428,RESIDENTIAL,21300,0,21300,94100,0,115400
190410103100000,SW 428,RESIDENTIAL,21000,0,21000,84000,0,105000
190410103300000,SW 428,RESIDENTIAL,32000,0,32000,161300,0,193300
190410200100000,SW 428,RESIDENTIAL,25800,0,25800,50600,0,76400
190410200200000,SW 428,RESIDENTIAL,25800,0,25800,74800,0,100600
190410200300000,SW 428,RESIDENTIAL,35000,0,35000,47000,0,82000
190410200400000,SW 428,RESIDENTIAL,35000,0,35000,104100,0,139100
190410200500000,SW 428,RESIDENTIAL,30600,0,30600,36200,0,66800
190410200600000,SW 428,RESIDENTIAL,24500,0,24500,66700,0,91200
190410200700000,SW 428,RESIDENTIAL,25000,0,25000,87100,0,112100
190410200800000,SW 428,RESIDENTIAL,25000,0,25000,78000,0,103000
190410200900000,SW 428,RESIDENTIAL,25300,0,25300,84100,0,109400
190410201000000,SW 428,RESIDENTIAL,20000,0,20000,106200,0,126200
190410201100000,SW 428,RESIDENTIAL,18300,0,18300,91500,0,109800
190410201200000,SW 428,RESIDENTIAL,24000,0,24000,101100,0,125100
190410201300000,SW 428,RESIDENTIAL,25000,0,25000,94900,0,119900
190410201400000,SW 428,RESIDENTIAL,25000,0,25000,74900,0,99900
190410201500000,SW 428,RESIDENTIAL,16700,0,16700,82800,0,99500
190410201600000,SW 428,RESIDENTIAL,16700,0,16700,68900,0,85600
190410201700000,SW 428,RESIDENTIAL,50800,0,50800,42900,0,93700
190410201800000,SW 428,RESIDENTIAL,18700,0,18700,113100,0,131800
190410201900000,SW 428,RESIDENTIAL,18700,0,18700,0,0,18700
190410202000000,SW 428,RESIDENTIAL,20500,0,20500,65400,0,85900
190410202100000,SW 428,RESIDENTIAL,21800,0,21800,113500,0,135300
190410202200000,SW 428,RESIDENTIAL,20000,0,20000,113000,0,133000
190410202300000,SW 428,RESIDENTIAL,26000,0,26000,113800,0,139800
190410202400000,SW 428,RESIDENTIAL,21000,0,21000,82000,0,103000
190410202500000,SW 428,RESIDENTIAL,25000,0,25000,101700,0,126700
190410202600000,SW 428,RESIDENTIAL,25000,0,25000,57000,0,82000
190410202700000,SW 428,RESIDENTIAL,25000,0,25000,92100,0,117100
190410202800000,SW 428,RESIDENTIAL,25000,0,25000,78300,0,103300
190410202900000,SW 428,RESIDENTIAL,25000,0,25000,86200,0,111200
190410203000000,SW 428,RESIDENTIAL,25000,0,25000,72400,0,97400
190410203100000,SW 428,RESIDENTIAL,17400,0,17400,82100,0,99500
190410203200000,SW 428,RESIDENTIAL,17500,0,17500,103500,0,121000
190410300100000,SW 428,RESIDENTIAL,23500,0,23500,77600,0,101100
190410300200000,SW 428,RESIDENTIAL,25000,0,25000,90800,0,115800
190410300300000,SW 428,RESIDENTIAL,25000,0,25000,102000,0,127000
190410300400000,SW 428,RESIDENTIAL,15600,0,15600,77900,0,93500
190410300500000,SW 428,RESIDENTIAL,14900,0,14900,86500,0,101400
190410300600000,SW 415,RESIDENTIAL,23300,0,23300,88400,0,111700
190410300700000,SW 415,RESIDENTIAL,23400,0,23400,100000,0,123400
190410300800000,SW 428,RESIDENTIAL,28100,0,28100,121900,0,150000
190410300900000,SW 415,RESIDENTIAL,18600,0,18600,107600,0,126200
190410301000000,SW 415,RESIDENTIAL,18600,0,18600,69100,0,87700
190410301100000,SW 428,RESIDENTIAL,22000,0,22000,0,0,22000
190410301200000,SW 428,RESIDENTIAL,22800,0,22800,54800,0,77600
190410301300000,SW 428,RESIDENTIAL,21600,0,21600,103900,0,125500
190410301400000,SW 415,RESIDENTIAL,19300,0,19300,73100,0,92400
190410301500000,SW 428,RESIDENTIAL,22200,0,22200,90500,0,112700
190410301600000,SW 428,RESIDENTIAL,16700,0,16700,121500,0,138200
190410301700000,SW 428,RESIDENTIAL,16700,0,16700,85200,0,101900
190410301800000,SW 428,RESIDENTIAL,25000,0,25000,38800,0,63800
190410301900000,SW 428,RESIDENTIAL,25000,0,25000,73300,0,98300
190410302000000,SW 428,RESIDENTIAL,16700,0,16700,95100,0,111800
190410302100000,SW 428,RESIDENTIAL,16700,0,16700,94300,0,111000
190410302200000,SW 428,RESIDENTIAL,21700,0,21700,62300,0,84000
190410400100000,SW 415,RESIDENTIAL,23300,0,23300,94500,0,117800
190410500100000,SW 415,RESIDENTIAL,28200,0,28200,104600,0,132800
190410500200000,SW 415,RESIDENTIAL,31200,0,31200,103000,0,134200
190410500300000,SW 415,RESIDENTIAL,23700,0,23700,85700,0,109400
190410500400000,SW 415,RESIDENTIAL,22400,0,22400,84100,0,106500
190410500500000,SW 415,RESIDENTIAL,22400,0,22400,86000,0,108400
190410500600000,SW 415,RESIDENTIAL,22400,0,22400,92500,0,114900
190412600100000,SW 416,RESIDENTIAL,20700,0,20700,113400,0,134100
190412600200000,SW 416,RESIDENTIAL,20700,0,20700,117700,0,138400
190412600300000,SW 416,RESIDENTIAL,17700,0,17700,101300,0,119000
190412600400000,SW 416,RESIDENTIAL,16600,0,16600,103800,0,120400
190412600500000,SW 416,RESIDENTIAL,17900,0,17900,118700,0,136600
190412600600000,SW 416,RESIDENTIAL,24500,0,24500,64500,0,89000
190412600700000,SW 428,RESIDENTIAL,26600,0,26600,116900,0,143500
190412600800000,SW 428,RESIDENTIAL,25900,0,25900,69700,0,95600
190412600900000,SW 428,RESIDENTIAL,24800,0,24800,108000,0,132800
190412700100000,SW 416,RESIDENTIAL,18000,0,18000,89300,0,107300
190412700200000,SW 416,RESIDENTIAL,18300,0,18300,78700,0,97000
190412700300000,SW 416,RESIDENTIAL,22300,0,22300,87600,0,109900
190412700400000,SW 416,RESIDENTIAL,22500,0,22500,79900,0,102400
190412700500000,DAY CARE CENTER,COMMERCIAL,0,106200,106200,0,375400,481600
190412700600000,SW 415,RESIDENTIAL,36000,0,36000,134900,0,170900
190412700700000,SW 415,RESIDENTIAL,31000,0,31000,154800,0,185800
190412700800000,SW 415,RESIDENTIAL,28000,0,28000,102200,0,130200
190412700900000,SW 415,RESIDENTIAL,24500,0,24500,96100,0,120600
190412701000000,SW 415,RESIDENTIAL,25500,0,25500,83300,0,108800
190412701100000,SW 415,RESIDENTIAL,25200,0,25200,95300,0,120500
190412701200000,SW 415,RESIDENTIAL,24100,0,24100,93000,0,117100
190412701300000,SW 415,RESIDENTIAL,24100,0,24100,98700,0,122800
190412701400000,SW 415,RESIDENTIAL,24600,0,24600,104200,0,128800
190412701500000,SW 415,RESIDENTIAL,24900,0,24900,117200,0,142100
190412701600000,SW 415,RESIDENTIAL,24800,0,24800,85300,0,110100
190412701700000,SW 415,RESIDENTIAL,25500,0,25500,91000,0,116500
190412701800000,SW 415,RESIDENTIAL,24500,0,24500,79800,0,104300
190412701900000,SW 415,RESIDENTIAL,25100,0,25100,72000,0,97100
190412702000000,SW 428,RESIDENTIAL,23100,0,23100,77000,0,100100
190412702100000,SW 428,RESIDENTIAL,54800,0,54800,61900,0,116700
190412702200000,SW 428,RESIDENTIAL,21800,0,21800,88900,0,110700
190412702300000,SW 428,RESIDENTIAL,23200,0,23200,111700,0,134900
190412702400000,SW 416,RESIDENTIAL,25200,0,25200,100200,0,125400
190412702500000,SW 416,RESIDENTIAL,20700,0,20700,77200,0,97900
190412800300000,SW 416,RESIDENTIAL,21600,0,21600,136700,0,158300
190412800400000,SW 416,RESIDENTIAL,21200,0,21200,97100,0,118300
190412800500000,SW 428,RESIDENTIAL,51900,0,51900,58700,0,110600
190412800600000,SW 428,RESIDENTIAL,22000,0,22000,82600,0,104600
190412800700000,SW 428,RESIDENTIAL,20900,0,20900,144200,0,165100
190412800900000,SW 428,RESIDENTIAL,64000,0,64000,63600,0,127600
190412801000000,SW 415,RESIDENTIAL,25000,0,25000,99400,0,124400
190412801100000,SW 415,RESIDENTIAL,24800,0,24800,97700,0,122500
190412801200000,SW 415,RESIDENTIAL,23300,0,23300,86100,0,109400
190412801300000,SW 415,RESIDENTIAL,23700,0,23700,90600,0,114300
190412801400000,SW 415,RESIDENTIAL,24500,0,24500,85600,0,110100
190412801500000,SW 415,RESIDENTIAL,24500,0,24500,88300,0,112800
190412801600000,SW 415,RESIDENTIAL,25000,0,25000,103200,0,128200
190412801700000,SW 415,RESIDENTIAL,24500,0,24500,108000,0,132500
190412801800000,SW 415,RESIDENTIAL,25100,0,25100,86500,0,111600
190412802000000,SW 416,RESIDENTIAL,44800,0,44800,115200,0,160000
190412802100000,SW 416,RESIDENTIAL,32100,0,32100,133200,0,165300
190412802200000,CITY PROPERTY,EXEMPT,0,0,0,0,0,0
190412802400000,SW 428,RESIDENTIAL,33600,0,33600,92600,0,126200
190412802500000,SW 428,RESIDENTIAL,20700,0,20700,0,0,20700
190412900100000,SW 416,RESIDENTIAL,25400,0,25400,90000,0,115400
190412900200000,SW 416,RESIDENTIAL,22600,0,22600,117500,0,140100
190412900300000,SW 416,RESIDENTIAL,21900,0,21900,98800,0,120700
190412900400000,SW 416,RESIDENTIAL,21400,0,21400,87100,0,108500
190412900500000,SW 416,RESIDENTIAL,24300,0,24300,134400,0,158700
190412900600000,SW 428,RESIDENTIAL,14400,0,14400,65100,0,79500
190412900900000,SW 428,RESIDENTIAL,15800,0,15800,82800,0,98600
190412901000000,SW 428,RESIDENTIAL,15700,0,15700,74400,0,90100
190412901100000,SW 428,RESIDENTIAL,15500,0,15500,74400,0,89900
190412901200000,SW 428,RESIDENTIAL,15300,0,15300,88900,0,104200
190412901300000,SW 428,RESIDENTIAL,16500,0,16500,81100,0,97600
190412901400000,SW 428,RESIDENTIAL,15100,0,15100,77400,0,92500
190412901500000,SW 428,RESIDENTIAL,18900,0,18900,99500,0,118400
190412901600000,SW 428,RESIDENTIAL,23700,0,23700,117400,0,141100
190412901700000,SW 428,RESIDENTIAL,22000,0,22000,63900,0,85900
190412901800000,SW 428,RESIDENTIAL,9400,0,9400,0,0,9400
190412901900000,SW 428,RESIDENTIAL,9600,0,9600,0,0,9600
190412902000000,SW 428,RESIDENTIAL,60200,0,60200,0,0,60200
190412902100000,SW 428,RESIDENTIAL,7400,0,7400,0,0,7400
190412902200000,SW 428,RESIDENTIAL,9600,0,9600,0,0,9600
190412902300000,SW 428,RESIDENTIAL,9600,0,9600,0,0,9600
190412902400000,SW 428,RESIDENTIAL,9100,0,9100,0,0,9100
190412902500000,SW 428,RESIDENTIAL,19400,0,19400,89600,0,109000
190412902600000,SW 428,RESIDENTIAL,23000,0,23000,37900,0,60900
190412902700000,SW 428,RESIDENTIAL,16500,0,16500,93300,0,109800
190412902800000,SW 428,RESIDENTIAL,17200,0,17200,70200,0,87400
190412902900000,SW 428,RESIDENTIAL,21700,0,21700,77000,0,98700
190412903000000,SW 428,RESIDENTIAL,21400,0,21400,76600,0,98000
190412903100000,SW 428,RESIDENTIAL,21400,0,21400,76600,0,98000
190412903200000,SW 428,RESIDENTIAL,21900,0,21900,0,0,21900
190412903300000,SW 428,RESIDENTIAL,25200,0,25200,97600,0,122800
190412903400000,SW 428,RESIDENTIAL,24300,0,24300,78600,0,102900
190413000100000,SW 415,RESIDENTIAL,22600,0,22600,93800,0,116400
190413000200000,SW 415,RESIDENTIAL,22600,0,22600,85800,0,108400
190413000300000,SW 415,RESIDENTIAL,23000,0,23000,87000,0,110000
190413000400000,SW 415,RESIDENTIAL,25500,0,25500,105100,0,130600
190413000500000,SW 415,RESIDENTIAL,25000,0,25000,120700,0,145700
190413000600000,SW 415,RESIDENTIAL,21800,0,21800,92300,0,114100
190413000700000,SW 415,RESIDENTIAL,21800,0,21800,94000,0,115800
190413000800000,SW 415,RESIDENTIAL,23800,0,23800,77800,0,101600
190413000900000,SW 415,RESIDENTIAL,25300,0,25300,102100,0,127400
190413100100000,SW 415,RESIDENTIAL,24500,0,24500,43100,0,67600
190413100200000,SW 415,RESIDENTIAL,22400,0,22400,86300,0,108700
190413100300000,SW 415,RESIDENTIAL,22400,0,22400,105000,0,127400
190413100400000,SW 415,RESIDENTIAL,22400,0,22400,88600,0,111000
190413100500000,SW 415,RESIDENTIAL,22400,0,22400,100200,0,122600
190413100600000,SW 415,RESIDENTIAL,22400,0,22400,84600,0,107000
190413100700000,SW 415,RESIDENTIAL,22100,0,22100,93500,0,115600
190413100800000,SW 415,RESIDENTIAL,22400,0,22400,112600,0,135000
190413100900000,SW 415,RESIDENTIAL,23500,0,23500,92000,0,115500
190413101000000,SW 415,RESIDENTIAL,23500,0,23500,101100,0,124600
190413101100000,SW 415,RESIDENTIAL,23500,0,23500,85200,0,108700
190413101200000,SW 415,RESIDENTIAL,23500,0,23500,90500,0,114000
190413101300000,SW 415,RESIDENTIAL,23500,0,23500,87500,0,111000
190413101400000,SW 415,RESIDENTIAL,31000,0,31000,101200,0,132200
190413101500000,SW 415,RESIDENTIAL,28100,0,28100,77800,0,105900
190413101600000,SW 415,RESIDENTIAL,22100,0,22100,89600,0,111700
190413101700000,SW 415,RESIDENTIAL,22100,0,22100,95100,0,117200
190413101800000,SW 415,RESIDENTIAL,22400,0,22400,88200,0,110600
190413101900000,SW 415,RESIDENTIAL,22400,0,22400,92500,0,114900
190413102000000,SW 415,RESIDENTIAL,22400,0,22400,86300,0,108700
190413102100000,SW 415,RESIDENTIAL,22400,0,22400,82300,0,104700
190413102200000,SW 415,RESIDENTIAL,22400,0,22400,87500,0,109900
190413102300000,SW 415,RESIDENTIAL,22400,0,22400,84700,0,107100
190413102400000,SW 415,RESIDENTIAL,22400,0,22400,84700,0,107100
190413102500000,SW 415,RESIDENTIAL,22400,0,22400,82900,0,105300
190413102600000,SW 415,RESIDENTIAL,22400,0,22400,97200,0,119600
190413102700000,SW 415,RESIDENTIAL,22400,0,22400,95400,0,117800
190413102800000,SW 415,RESIDENTIAL,22400,0,22400,88600,0,111000
190413102900000,SW 415,RESIDENTIAL,22400,0,22400,87400,0,109800
190415100100000,SW 428,RESIDENTIAL,26300,0,26300,117200,0,143500
190415100200000,SW 428,RESIDENTIAL,26300,0,26300,90800,0,117100
190415100300000,SW 428,RESIDENTIAL,26300,0,26300,95900,0,122200
190415100400000,SW 428,RESIDENTIAL,26300,0,26300,66000,0,92300
190415100500000,SW 415,RESIDENTIAL,24700,0,24700,84100,0,108800
190415100600000,SW 415,RESIDENTIAL,24700,0,24700,93700,0,118400
190415100700000,SW 415,RESIDENTIAL,24700,0,24700,83500,0,108200
190415100800000,SW 415,RESIDENTIAL,25200,0,25200,93600,0,118800
190415100900000,SW 415,RESIDENTIAL,24900,0,24900,95700,0,120600
190415101000000,SW 415,RESIDENTIAL,23900,0,23900,89900,0,113800
190415101100000,SW 415,RESIDENTIAL,23900,0,23900,78400,0,102300
190415101200000,SW 415,RESIDENTIAL,23900,0,23900,87400,0,111300
190415101300000,SW 415,RESIDENTIAL,23300,0,23300,85600,0,108900
190415101400000,SW 415,RESIDENTIAL,32100,0,32100,71500,0,103600
190415101500000,SW 428,RESIDENTIAL,45200,0,45200,137900,0,183100
190415101600000,SW 428,RESIDENTIAL,37800,0,37800,101800,0,139600
190415101700000,SW 428,RESIDENTIAL,19100,0,19100,107800,0,126900
190415101800000,SW 428,RESIDENTIAL,20900,0,20900,119300,0,140200
190415101900000,SW 428,RESIDENTIAL,42100,0,42100,0,0,42100
190415200100000,SW 415,RESIDENTIAL,24700,0,24700,81900,0,106600
190415200400000,CONVENIENCE STORE,COMMERCIAL,0,134300,134300,0,267400,401700
190415200500000,VACANT LAND,COMMERCIAL,0,36000,36000,0,0,36000
190415200600000,VACANT LAND,COMMERCIAL,0,38000,38000,0,0,38000
190415200700000,SMALL RETAIL,COMMERCIAL,0,99600,99600,0,365500,465100
190415200800000,VACANT LAND,COMMERCIAL,0,2700,2700,0,0,2700
190415201000000,WAREHOUSE,COMMERCIAL,0,60000,60000,0,167500,227500
190415201100000,WAREHOUSE,COMMERCIAL,0,81000,81000,0,224700,305700
190415201200000,CENTRALLY ASSESSED,OTHER,0,0,0,0,0,0
190415201300000,SR/NURSING/ASSTD LIV,MULTI-RES,268800,0,268800,1251600,0,1520400
190415201400000,SW 415,RESIDENTIAL,20400,0,20400,81300,0,101700
190415201500000,SW 415,RESIDENTIAL,20400,0,20400,46100,0,66500
190415201600000,SW 415,RESIDENTIAL,18900,0,18900,40100,0,59000
190415201700000,SW 415,RESIDENTIAL,25000,0,25000,80400,0,105400
190415201800000,SW 415,RESIDENTIAL,25000,0,25000,87900,0,112900
190415201900000,SW 415,RESIDENTIAL,25000,0,25000,89700,0,114700
190415202000000,SW 415,RESIDENTIAL,25000,0,25000,103000,0,128000
190415202100000,SW 415,RESIDENTIAL,25000,0,25000,88300,0,113300
190415202200000,SW 415,RESIDENTIAL,24600,0,24600,95600,0,120200
190415202300000,SW 415,RESIDENTIAL,24700,0,24700,91300,0,116000
190415202400000,SW 415,RESIDENTIAL,24700,0,24700,93500,0,118200
190415300100000,SW 428,RESIDENTIAL,28300,0,28300,67900,0,96200
190415300200000,SW 428,RESIDENTIAL,28300,0,28300,82000,0,110300
190415300300000,SW 428,RESIDENTIAL,28300,0,28300,98700,0,127000
190415300400000,SW 428,RESIDENTIAL,28300,0,28300,84500,0,112800
190415300500000,SW 428,RESIDENTIAL,28300,0,28300,105100,0,133400
190415300600000,SW 428,RESIDENTIAL,28300,0,28300,58500,0,86800
190415300700000,SW 428,RESIDENTIAL,15000,0,15000,0,0,15000
190415300800000,SW 428,RESIDENTIAL,28800,0,28800,41400,0,70200
190415300900000,SW 428,RESIDENTIAL,28300,0,28300,77400,0,105700
190415301000000,SW 428,RESIDENTIAL,28300,0,28300,75400,0,103700
190415301100000,SW 428,RESIDENTIAL,22300,0,22300,4600,0,26900
190415301200000,SHOP,COMMERCIAL,0,102500,102500,0,160100,262600
190415301300000,SHOP,COMMERCIAL,0,74000,74000,0,185300,259300
190417600100000,SW 428,RESIDENTIAL,19300,0,19300,66500,0,85800
190417600200000,SW 428,RESIDENTIAL,15100,0,15100,95000,0,110100
190417600300000,SW 428,RESIDENTIAL,15300,0,15300,83900,0,99200
190417600400000,SW 428,RESIDENTIAL,16200,0,16200,79900,0,96100
190417600500000,SW 428,RESIDENTIAL,24800,0,24800,49100,0,73900
190417600600000,SW 428,RESIDENTIAL,30000,0,30000,100700,0,130700
190417600700000,SW 428,RESIDENTIAL,30500,0,30500,84800,0,115300
190417600800000,SW 428,RESIDENTIAL,30800,0,30800,54700,0,85500
190417600900000,SW 428,RESIDENTIAL,18000,0,18000,108500,0,126500
190417601000000,SW 428,RESIDENTIAL,21000,0,21000,49000,0,70000
190417601100000,SW 428,RESIDENTIAL,21100,0,21100,98000,0,119100
190417601200000,SW 428,RESIDENTIAL,25200,0,25200,60100,0,85300
190417601300000,SW 428,RESIDENTIAL,17000,0,17000,81200,0,98200
190417601400000,SW 428,RESIDENTIAL,17000,0,17000,57800,0,74800
190417601500000,SW 428,RESIDENTIAL,17000,0,17000,87200,0,104200
190417601600000,SW 428,RESIDENTIAL,17000,0,17000,78300,0,95300
190417700100000,SW 428,RESIDENTIAL,27000,0,27000,125300,0,152300
190417700200000,SW 428,RESIDENTIAL,26300,0,26300,203700,0,230000
190417700300000,SW 428,RESIDENTIAL,26300,0,26300,84600,0,110900
190417700400000,SW 415,RESIDENTIAL,18600,0,18600,77000,0,95600
190417700500000,SW 415,RESIDENTIAL,27100,0,27100,12700,0,39800
190417700600000,SW 415,RESIDENTIAL,27100,0,27100,0,0,27100
190417700700000,SW 415,RESIDENTIAL,24900,0,24900,93800,0,118700
190417700800000,SW 415,RESIDENTIAL,18600,0,18600,88500,0,107100
190417700900000,SW 415,RESIDENTIAL,18600,0,18600,98800,0,117400
190417701000000,SW 415,RESIDENTIAL,18900,0,18900,84500,0,103400
190417701100000,SW 415,RESIDENTIAL,18900,0,18900,85800,0,104700
190417701200000,SW 428,RESIDENTIAL,1600,0,1600,0,0,1600
190417701300000,SW 428,RESIDENTIAL,1600,0,1600,0,0,1600
190417701400000,SW 428,RESIDENTIAL,24100,0,24100,155800,0,179900
190417701500000,SW 428,RESIDENTIAL,35600,0,35600,40700,0,76300
190417701600000,SW 428,RESIDENTIAL,33900,0,33900,84300,0,118200
190417701700000,SW 428,RESIDENTIAL,54600,0,54600,64600,0,119200
190417701800000,SW 428,RESIDENTIAL,31300,0,31300,83700,0,115000
190417701900000,SW 428,RESIDENTIAL,29300,0,29300,62000,0,91300
190417702000000,SW 428,RESIDENTIAL,19100,0,19100,96700,0,115800
190417702100000,SW 428,RESIDENTIAL,26400,0,26400,114100,0,140500
190417800100000,SW 428,RESIDENTIAL,27900,0,27900,135100,0,163000
190417800200000,SW 428,RESIDENTIAL,26600,0,26600,96300,0,122900
190417800300000,SW 428,RESIDENTIAL,17700,0,17700,63000,0,80700
190417800400000,SW 428,RESIDENTIAL,17700,0,17700,62800,0,80500
190417800500000,SW 428,RESIDENTIAL,17700,0,17700,76400,0,94100
190417800600000,SW 428,RESIDENTIAL,84000,0,84000,249400,0,333400
190417800700000,SW 428,RESIDENTIAL,25500,0,25500,80100,0,105600
190417800800000,SW 428,RESIDENTIAL,29700,0,29700,91500,0,121200
190417800900000,SW 428,RESIDENTIAL,28300,0,28300,129500,0,157800
190417801000000,SW 428,RESIDENTIAL,28300,0,28300,62800,0,91100
190417801100000,SW 428,RESIDENTIAL,24100,0,24100,77900,0,102000
190417801200000,SW 428,RESIDENTIAL,29700,0,29700,72100,0,101800
190417801300000,SW 428,RESIDENTIAL,26600,0,26600,71400,0,98000
190417801400000,SW 428,RESIDENTIAL,28300,0,28300,82200,0,110500
190417900100000,COUNTY PROPERTY,EXEMPT,0,0,0,0,0,0
190417900200000,CITY PROPERTY,EXEMPT,0,0,0,0,0,0
190417900300000,VACANT LAND,INDUSTRIAL,0,38600,38600,0,0,38600
190417900400000,CENTRALLY ASSESSED,OTHER,0,0,0,0,0,0
190420100100000,APARTMENT,EXEMPT,0,737000,737000,0,7563200,8300200
190420100200000,WAREHOUSE,COMMERCIAL,0,510400,510400,0,1481300,1991700
190422600100000,APARTMENT,MULTI-RES,837000,0,837000,8517900,0,9354900
190422600200000,VACANT LAND,COMMERCIAL,0,40400,40400,0,0,40400
190422600300000,BOWLING ALLEY,COMMERCIAL,0,484300,484300,0,297200,781500
190422600400000,FLAT PARKING,COMMERCIAL,0,416500,416500,0,3500,420000
190422600500000,SMALL RETAIL,COMMERCIAL,0,283500,283500,0,256800,540300
190422600600000,FAST FOOD,COMMERCIAL,0,101700,101700,0,378600,480300
190422600700000,FLAT PARKING,COMMERCIAL,0,44700,44700,0,4300,49000
190422600800000,OFFICE,COMMERCIAL,0,59500,59500,0,25200,84700
190422600900000,FRATERNAL,COMMERCIAL,0,134900,134900,0,173300,308200
190422601000000,HOTEL,COMMERCIAL,0,241500,241500,0,741300,982800
190422601100000,HOTEL,COMMERCIAL,0,512500,512500,0,1487300,1999800
190422601200000,CONVENIENCE STORE,COMMERCIAL,0,251100,251100,0,339200,590300
190422601300000,FAST FOOD,COMMERCIAL,0,338800,338800,0,662800,1001600
190422700100000,HOTEL,COMMERCIAL,0,184800,184800,0,779200,964000
190422701400000,VACANT LAND,COMMERCIAL,0,0,0,0,0,0
190425100100000,RESTAURANT,COMMERCIAL,0,345200,345200,0,208300,553500
190425100200000,FAST FOOD,COMMERCIAL,0,231200,231200,0,636400,867600
190425100300000,FLAT PARKING,COMMERCIAL,0,174000,174000,0,8500,182500
190425100400000,HOTEL,COMMERCIAL,0,571300,571300,0,1149900,1721200
190425100500000,HOTEL,COMMERCIAL,0,533800,533800,0,1251300,1785100
190425200100000,HOTEL,COMMERCIAL,0,254400,254400,0,790500,1044900
190425200200000,HOTEL,COMMERCIAL,0,306000,306000,0,921700,1227700
190425200300000,OFFICE,COMMERCIAL,0,240000,240000,0,420400,660400
190425200400000,HOTEL,COMMERCIAL,0,538300,538300,0,2512500,3050800
190425200500000,RESTAURANT,COMMERCIAL,0,337500,337500,0,570100,907600
190425200600000,CONVENIENCE STORE,COMMERCIAL,0,388500,388500,0,992000,1380500
190425200700000,BRANCH BANK/CU,COMMERCIAL,0,390000,390000,0,582000,972000
190425200800000,VACANT LAND,COMMERCIAL,0,123400,123400,0,0,123400
190425200900000,RESTAURANT,COMMERCIAL,0,339000,339000,0,390500,729500
190425300100000,RESTAURANT,COMMERCIAL,0,482400,482400,0,607700,1090100
190425300200000,HOTEL,COMMERCIAL,0,332500,332500,0,2307700,2640200
190425300300000,OFFICE,COMMERCIAL,0,363300,363300,0,697200,1060500
190425300400000,HOTEL,COMMERCIAL,0,814800,814800,0,5121700,5936500
190425300500000,FAST FOOD,COMMERCIAL,0,362600,362600,0,784700,1147300
190425300600000,WAREHOUSE;MINI STORG,COMMERCIAL,0,483800,483800,0,579800,1063600
190425300700000,OFFICE,COMMERCIAL,0,88100,88100,0,329700,417800
190425400600000,OFFICE,COMMERCIAL,0,101900,101900,0,412700,514600
190425400700000,OFFICE,COMMERCIAL,0,101900,101900,0,371900,473800
190425400800000,WAREHOUSE,COMMERCIAL,0,146300,146300,0,393000,539300
190427600100000,SHOP,COMMERCIAL,0,280000,280000,0,589000,869000
190427600200000,SHOP,COMMERCIAL,0,216300,216300,0,649900,866200
190427600300000,SHOP,COMMERCIAL,0,149500,149500,0,439800,589300
190427600400000,SMALL RETAIL,COMMERCIAL,0,59700,59700,0,128000,187700
190427600500000,SHOP,COMMERCIAL,0,59700,59700,0,296900,356600
190427600700000,WAREHOUSE,COMMERCIAL,0,146400,146400,0,758500,904900
190427600800000,AUTO REPAIR/SALES,COMMERCIAL,0,187800,187800,0,733600,921400
190427601000000,WAREHOUSE,COMMERCIAL,0,378000,378000,0,1083600,1461600
190427601102000,BILLBOARD(BLL),COMMERCIAL,0,0,0,0,10200,10200
190427601200000,OFFICE,COMMERCIAL,0,113600,113600,0,392900,506500
190427601300000,SHOP,COMMERCIAL,0,95300,95300,0,295500,390800
190427601400000,SHOP,COMMERCIAL,0,114400,114400,0,456000,570400
190427601500000,FRATERNAL,COMMERCIAL,0,97100,97100,0,158600,255700
190427601600000,SMALL RETAIL,COMMERCIAL,0,53500,53500,0,340100,393600
190427601700000,SHOP,COMMERCIAL,0,80600,80600,0,156500,237100
190427601800000,SHOP,COMMERCIAL,0,104200,104200,0,221000,325200
190427601900000,SHOP,COMMERCIAL,0,113800,113800,0,170900,284700
190430100100000,WAREHOUSE,COMMERCIAL,0,317500,317500,0,1533800,1851300
190430200100000,CONC/ASPH;INDUSTRIAL,INDUSTRIAL,0,315700,315700,0,63800,379500
190430200102000,BILLBOARD(BLL),COMMERCIAL,0,0,0,0,44100,44100
190430200200000,SHOP,COMMERCIAL,0,95200,95200,0,181500,276700
190430200300000,FLAT PARKING,COMMERCIAL,0,21000,21000,0,1400,22400
190430200400000,SHOP,COMMERCIAL,0,77700,77700,0,258600,336300
190430200500000,VACANT LAND,COMMERCIAL,0,299900,299900,0,0,299900
190430200502000,BILLBOARD(BLL),COMMERCIAL,0,0,0,0,50700,50700
190432600100000,WAREHOUSE,COMMERCIAL,0,418500,418500,0,1753400,2171900
190432600200000,FLAT PARKING,COMMERCIAL,0,172200,172200,0,65500,237700
190435100200000,WAREHOUSE,COMMERCIAL,12360,142140,154500,40380,112120,307000
190435100300000,WAREHOUSE,COMMERCIAL,0,2000500,2000500,0,33516900,35517400
190435100302000,BILLBOARD(BLL),COMMERCIAL,0,0,0,0,51500,51500
190435200100000,SHOP,COMMERCIAL,0,137300,137300,0,79100,216400
190435200200000,STATE PROPERTY,EXEMPT,0,0,0,0,0,0
190435300100000,WAREHOUSE,COMMERCIAL,0,103700,103700,0,323800,427500
190435300200000,CENTRALLY ASSESSED,OTHER,0,0,0,0,0,0
190435300300000,COUNTY PROPERTY,EXEMPT,0,0,0,0,0,0
190435300400000,SCHOOL,EXEMPT,0,0,0,0,0,0
190435300500000,FLAT PARKING,COMMERCIAL,0,57000,57000,0,3100,60100
190437600200000,CENTRALLY ASSESSED,OTHER,0,0,0,0,0,0
190437600300000,CENTRALLY ASSESSED,OTHER,0,0,0,0,0,0
190437700100000,VACANT LAND,COMMERCIAL,0,31500,31500,0,0,31500
190437700102000,BILLBOARD(BLL),COMMERCIAL,0,0,0,0,47400,47400
190437800100000,CITY PROPERTY,EXEMPT,0,0,0,0,0,0
190440100100000,CITY PROPERTY,EXEMPT,0,0,0,0,0,0
190440100200000,CITY PROPERTY,EXEMPT,0,0,0,0,0,0
190440100300000,CITY PROPERTY,EXEMPT,0,0,0,0,0,0
190440100400000,CENTRALLY ASSESSED,OTHER,0,0,0,0,0,0
190440200200000,DAY CARE CENTER,EXEMPT,0,389000,389000,0,2012100,2401100
190440200300000,SHOP,COMMERCIAL,0,260000,260000,0,78000,338000
190440200400000,SW 422,RESIDENTIAL,77300,0,77300,56000,0,133300
190442600100000,CONC/ASPH;INDUSTRIAL,INDUSTRIAL,0,226500,226500,0,290900,517400
190442600200000,VACANT LAND,INDUSTRIAL,0,311500,311500,0,0,311500
190442600300000,WAREHOUSE,COMMERCIAL,0,208700,208700,0,98200,306900
190442600400000,SHOP,COMMERCIAL,0,466000,466000,0,405600,871600
190442600500000,CITY PROPERTY,EXEMPT,0,0,0,0,0,0
190442600600000,CENTRALLY ASSESSED,OTHER,0,0,0,0,0,0
190445100100000,CENTRALLY ASSESSED,OTHER,0,0,0,0,0,0
190445100200000,CENTRALLY ASSESSED,OTHER,0,0,0,0,0,0
190445100300000,CITY PROPERTY,EXEMPT,0,0,0,0,0,0
190445100400000,SW 422,RESIDENTIAL,187200,0,187200,110600,0,297800
190447600100000,SMALL RETAIL,COMMERCIAL,0,106000,106000,0,120900,226900
190447600200000,SW 422,RESIDENTIAL,66400,0,66400,48600,0,115000
190447600300000,WAREHOUSE,COMMERCIAL,0,63700,63700,0,91600,155300
190447600400000,WAREHOUSE,COMMERCIAL,0,137600,137600,0,247600,385200
190447600500000,SW 422,RESIDENTIAL,29800,0,29800,0,0,29800
190447600600000,SW 422,RESIDENTIAL,22600,0,22600,0,0,22600
190447600700000,SW 422,RESIDENTIAL,23200,0,23200,0,0,23200
190447600800000,SW 422,RESIDENTIAL,42800,0,42800,63600,0,106400
190447700100000,FEED/ADDITIVE;INDUST,INDUSTRIAL,0,429100,429100,0,100000,529100
190447700200000,WAREHOUSE,COMMERCIAL,0,379100,379100,0,1438100,1817200
190447700300000,CENTRALLY ASSESSED,OTHER,0,0,0,0,0,0
190447700500000,WAREHOUSE;MINI STORG,COMMERCIAL,0,31000,31000,0,147000,178000
190447700600000,MFG HOME PARK,MULTI-RES,481000,0,481000,435000,0,916000
190510100100000,WAREHOUSE,COMMERCIAL,0,360000,360000,0,105000,465000
190510100200000,VACANT LAND,COMMERCIAL,0,138000,138000,0,0,138000
190510100300000,WAREHOUSE,COMMERCIAL,0,456000,456000,0,324600,780600
190510100400000,AUTO REPAIR/SALES,COMMERCIAL,0,105000,105000,0,297800,402800
190510100500000,VACANT LAND,COMMERCIAL,0,27200,27200,0,0,27200
190510100600000,VACANT LAND,COMMERCIAL,0,136000,136000,0,0,136000
190510100700000,WAREHOUSE,COMMERCIAL,0,175000,175000,0,404700,579700
190510100800000,VACANT LAND,COMMERCIAL,0,71000,71000,0,0,71000
190510100900000,WAREHOUSE,COMMERCIAL,0,82000,82000,0,251600,333600
190510101000000,WAREHOUSE,COMMERCIAL,0,185300,185300,0,292400,477700
190510101100000,BARS/LOUNGE,COMMERCIAL,0,156800,156800,0,175300,332100
190510101200000,VACANT LAND,COMMERCIAL,0,205000,205000,0,0,205000
190510101300000,WAREHOUSE,COMMERCIAL,0,115300,115300,0,270600,385900
190510200100000,RESTAURANT,COMMERCIAL,0,135100,135100,0,92100,227200
190510200200000,COUNTY PROPERTY,EXEMPT,0,0,0,0,0,0
190510200300000,WAREHOUSE;MINI STORG,COMMERCIAL,0,116600,116600,0,147400,264000
190510200400000,FLAT PARKING,COMMERCIAL,0,73900,73900,0,2100,76000
190510200500000,WAREHOUSE,COMMERCIAL,0,57300,57300,0,168600,225900
190510201300000,WAREHOUSE,COMMERCIAL,0,61400,61400,0,137400,198800
190510201400000,OFFICE,EXEMPT,0,151000,151000,0,625000,776000
190510201402001,BILLBOARD(BLL),COMMERCIAL,0,0,0,0,11900,11900
190510201500000,OFFICE,COMMERCIAL,0,255000,255000,0,713500,968500
190510201700000,BARS/LOUNGE,COMMERCIAL,0,132300,132300,0,147800,280100
190510201800000,SHOP,COMMERCIAL,0,58300,58300,0,193300,251600
190510201900000,OFFICE,COMMERCIAL,0,504800,504800,0,3246000,3750800
190510202000000,SECTION 42,COMMERCIAL,0,161800,161800,0,121200,283000
190512600500000,STATE PROPERTY,EXEMPT,0,0,0,0,0,0
190512700100000,WAREHOUSE,COMMERCIAL,0,376000,376000,0,364300,740300
190512700200000,EQUIPMENT MFG;INDUST,INDUSTRIAL,0,150500,150500,0,607600,758100
190512700400000,OFFICE,COMMERCIAL,0,68900,68900,0,146000,214900
190512700500000,OFFICE,COMMERCIAL,0,66600,66600,0,126200,192800
190512700600000,WAREHOUSE,COMMERCIAL,0,144000,144000,0,294100,438100
190512700700000,SHOP,COMMERCIAL,0,68400,68400,0,234300,302700
190512700800000,OFFICE,COMMERCIAL,0,70400,70400,0,252400,322800
190512700900000,WAREHOUSE,COMMERCIAL,0,203000,203000,0,632100,835100
190512701000000,WAREHOUSE,COMMERCIAL,0,40600,40600,0,94000,134600
190512701100000,WAREHOUSE,COMMERCIAL,0,65700,65700,0,97300,163000
190515100101000,WAREHOUSE,COMMERCIAL,0,148200,148200,0,765900,914100
190515100101001,LG DISCOUNT/RETAIL,INDUSTRIAL,0,257600,257600,0,1877300,2134900
190515100101002,SCHOOL,EXEMPT,0,0,0,0,0,0
190515100101003,SCHOOL,EXEMPT,0,0,0,0,0,0
190515100101004,MATERIALS MFG;INDUST,INDUSTRIAL,0,16400,16400,0,171500,187900
190515100101005,MATERIALS MFG;INDUST,INDUSTRIAL,0,156400,156400,0,1322900,1479300
190515100600000,SCHOOL,EXEMPT,0,0,0,0,0,0
190515200100000,WAREHOUSE,COMMERCIAL,0,509800,509800,0,1621100,2130900
190515200200000,WAREHOUSE,COMMERCIAL,0,461000,461000,0,1737300,2198300
190515200300000,WAREHOUSE,COMMERCIAL,0,463000,463000,0,2262100,2725100
190515300100000,WAREHOUSE,COMMERCIAL,0,299000,299000,0,1074400,1373400
190515300200000,WAREHOUSE,COMMERCIAL,0,291000,291000,0,1124900,1415900
190517600200000,OFFICE,COMMERCIAL,0,61400,61400,0,454100,515500
190517600300000,OFFICE,COMMERCIAL,0,99000,99000,0,513500,612500
190517600600000,AUTO REPAIR/SALES,COMMERCIAL,0,513800,513800,0,429700,943500
190517600900000,HOTEL,COMMERCIAL,0,317500,317500,0,1276300,1593800
190517601000000,HOTEL,COMMERCIAL,0,247800,247800,0,698560,946360
190517601100000,HOTEL,COMMERCIAL,0,387800,387800,0,1037600,1425400
190517601200000,FAST FOOD,COMMERCIAL,0,402500,402500,0,854800,1257300
190517601300000,MATERIALS MFG;INDUST,INDUSTRIAL,0,89600,89600,0,323200,412800
190517601500000,WAREHOUSE,COMMERCIAL,0,761500,761500,0,4421200,5182700
190517601600000,HOTEL,COMMERCIAL,0,480000,480000,0,3036700,3516700
190517601700000,HOTEL,COMMERCIAL,0,557500,557500,0,2052800,2610300
190517700300000,AUTO REPAIR/SALES,COMMERCIAL,0,241500,241500,0,589200,830700
190517700400000,FLAT PARKING,COMMERCIAL,0,189000,189000,0,21700,210700
190517700500000,WAREHOUSE,COMMERCIAL,0,326000,326000,0,731200,1057200
190517700600000,WAREHOUSE,COMMERCIAL,0,310500,310500,0,289700,600200
190517700700000,WAREHOUSE,COMMERCIAL,0,96400,96400,0,299800,396200
190517700800000,WAREHOUSE,COMMERCIAL,0,331900,331900,0,603800,935700
190517800100000,FRATERNAL,COMMERCIAL,0,186300,186300,0,324100,510400
190517800200000,OFFICE,COMMERCIAL,0,149000,149000,0,901400,1050400
190520100300000,VACANT LAND,INDUSTRIAL,0,900,900,0,0,900
190520100400000,MISCELLANEOUS,COMMERCIAL,0,26100,26100,0,36400,62500
190520100600000,MISCELLANEOUS,COMMERCIAL,0,39300,39300,0,46400,85700
190520100700000,SHOP,COMMERCIAL,0,595400,595400,0,2677600,3273000
190520100800000,WAREHOUSE,COMMERCIAL,0,114500,114500,0,866500,981000
190520100900000,VACANT LAND,COMMERCIAL,0,315900,315900,0,0,315900
190520200200000,SW 418,AG LAND,9500,0,9500,0,0,9500
190520200300000,SW 418,AG LAND,14500,0,14500,0,0,14500
190522600100000,SW 418,AG LAND,29200,0,29200,0,0,29200
190522600200000,CENTRALLY ASSESSED,OTHER,0,0,0,0,0,0
190522700200000,CITY PROPERTY,EXEMPT,0,0,0,0,0,0
190522700600000,SW 425,RESIDENTIAL,24000,0,24000,130900,0,154900
190522700700000,SW 425,RESIDENTIAL,25900,0,25900,126400,0,152300
190522700800000,SW 425,RESIDENTIAL,1100,0,1100,0,0,1100
190522700900000,SW 425,RESIDENTIAL,27800,0,27800,127400,0,155200
190522701000000,SW 425,RESIDENTIAL,26100,0,26100,125800,0,151900
190522701100000,SW 425,RESIDENTIAL,26100,0,26100,130200,0,156300
190522701200000,SW 425,RESIDENTIAL,26100,0,26100,132100,0,158200
190522701300000,SW 425,RESIDENTIAL,22700,0,22700,89700,0,112400
190522701400000,SW 425,RESIDENTIAL,23000,0,23000,89700,0,112700
190522701500000,SW 425,RESIDENTIAL,26700,0,26700,89700,0,116400
190522701600000,SW 425,RESIDENTIAL,24400,0,24400,92100,0,116500
190522701700000,SW 425,RESIDENTIAL,23700,0,23700,94900,0,118600
190522701800000,SW 425,RESIDENTIAL,25600,0,25600,91300,0,116900
190522701900000,SW 425,RESIDENTIAL,23500,0,23500,91700,0,115200
190522702000000,SW 425,RESIDENTIAL,23500,0,23500,90000,0,113500
190522702100000,SW 425,RESIDENTIAL,23500,0,23500,94100,0,117600
190522702200000,SW 425,RESIDENTIAL,23400,0,23400,90400,0,113800
190522702700000,SW 425,RESIDENTIAL,23500,0,23500,136300,0,159800
190522702800000,SW 425,RESIDENTIAL,43600,0,43600,141500,0,185100
190522800100000,SW 425,RESIDENTIAL,32400,0,32400,144500,0,176900
190522800200000,SW 425,RESIDENTIAL,27200,0,27200,140700,0,167900
190522800300000,SW 425,RESIDENTIAL,26400,0,26400,109500,0,135900
190522800400000,SW 425,RESIDENTIAL,24900,0,24900,115200,0,140100
190522800500000,SW 425,RESIDENTIAL,30200,0,30200,93600,0,123800
190522800600000,SW 425,RESIDENTIAL,28300,0,28300,95200,0,123500
190522800700000,SW 425,RESIDENTIAL,33200,0,33200,127400,0,160600
190522800800000,SW 425,RESIDENTIAL,26400,0,26400,123400,0,149800
190522800900000,SW 425,RESIDENTIAL,25900,0,25900,125500,0,151400
190522801000000,SW 425,RESIDENTIAL,29800,0,29800,149800,0,179600
190525100100000,SW 405,AG LAND,39800,0,39800,0,0,39800
190525200100000,CITY PROPERTY,EXEMPT,0,0,0,0,0,0
190525200200000,CITY PROPERTY,EXEMPT,0,0,0,0,0,0
190525200300000,WAREHOUSE;MINI STORG,COMMERCIAL,0,180000,180000,0,89700,269700
190527600100000,MISCELLANEOUS,COMMERCIAL,0,52500,52500,0,102700,155200
190527600200000,MISCELLANEOUS,COMMERCIAL,0,47300,47300,0,238700,286000
190527700200000,SW 418,AG LAND,8800,0,8800,0,0,8800
190527800100000,SW 405,AG LAND,22200,0,22200,0,0,22200
190530100100000,SW 405,AG LAND,65700,0,65700,0,0,65700
190532600100000,SW 405,AG LAND,74300,0,74300,0,0,74300
190535100100000,CITY PROPERTY,EXEMPT,0,0,0,0,0,0
190535200100000,CENTRALLY ASSESSED,OTHER,0,0,0,0,0,0
190537600100000,VACANT LAND,COMMERCIAL,0,172900,172900,0,0,172900
190537600200000,CITY PROPERTY,EXEMPT,0,0,0,0,0,0
190537700100000,CENTRALLY ASSESSED,OTHER,0,0,0,0,0,0
190540100200000,EQUIPMENT MFG;INDUST,INDUSTRIAL,0,1204800,1204800,0,4091700,5296500
190540200100000,WAREHOUSE,COMMERCIAL,0,118800,118800,0,67600,186400
190540200200000,WAREHOUSE,COMMERCIAL,0,772600,772600,0,251800,1024400
190540200300000,VACANT LAND,COMMERCIAL,0,141100,141100,0,0,141100
190540200400000,VACANT LAND,COMMERCIAL,0,30500,30500,0,0,30500
190540200500000,VACANT LAND,COMMERCIAL,0,30300,30300,0,200,30500
190540200600000,WAREHOUSE,COMMERCIAL,0,59300,59300,0,66000,125300
190542600200000,CENTRALLY ASSESSED,OTHER,0,0,0,0,0,0
190542600300000,SW 418,AG LAND,600,0,600,0,0,600
190542600400000,SW 418,AG LAND,42500,0,42500,0,0,42500
190545100100000,SHOP,COMMERCIAL,0,252000,252000,0,73200,325200
190545100200000,VACANT LAND,COMMERCIAL,0,33500,33500,0,0,33500
190545200100000,OFFICE,COMMERCIAL,0,129100,129100,0,9100,138200
190545200102000,ANTENNAS/TOWERS(BLL),COMMERCIAL,0,0,0,0,152800,152800
190545200200000,WAREHOUSE,COMMERCIAL,0,74800,74800,0,234400,309200
190545200400000,CENTRALLY ASSESSED,OTHER,0,0,0,0,0,0
190545300200000,SW 405,RESIDENTIAL,53500,0,53500,31400,0,84900
190545300300000,SW 405,RESIDENTIAL,53100,0,53100,83300,0,136400
190547600100000,WAREHOUSE,COMMERCIAL,0,120800,120800,0,7600,128400
190547700100000,WAREHOUSE,COMMERCIAL,0,351300,351300,0,126000,477300
190547700102000,BILLBOARD(BLL),COMMERCIAL,0,0,0,0,42900,42900
190547700200000,CONC/ASPH;INDUSTRIAL,INDUSTRIAL,0,93700,93700,0,169000,262700
190547700300000,WAREHOUSE,COMMERCIAL,0,116800,116800,0,225600,342400
190547700600000,WAREHOUSE,COMMERCIAL,0,547400,547400,0,2459600,3007000
190610100500000,SW 457,RESIDENTIAL,48200,0,48200,177100,0,225300
190610100600000,SW 457,RESIDENTIAL,50400,0,50400,152200,0,202600
190610100700000,SW 457,RESIDENTIAL,50400,0,50400,202300,0,252700
190610100800000,SW 457,RESIDENTIAL,53800,0,53800,184500,0,238300
190610100900000,SW 457,RESIDENTIAL,53700,0,53700,207400,0,261100
190610101000000,SW 457,RESIDENTIAL,49900,0,49900,178000,0,227900
190610101100000,SW 457,RESIDENTIAL,57700,0,57700,205100,0,262800
190610101200000,SW 457,RESIDENTIAL,49200,0,49200,154500,0,203700
190610101300000,SW 457,RESIDENTIAL,53900,0,53900,183400,0,237300
190610101400000,SW 457,RESIDENTIAL,60000,0,60000,257500,0,317500
190610101500000,CITY PROPERTY,EXEMPT,0,0,0,0,0,0
190610101600000,SW 457,RESIDENTIAL,55000,0,55000,197900,0,252900
190610101700000,SW 457,RESIDENTIAL,54200,0,54200,260300,0,314500
190610101800000,SW 457,RESIDENTIAL,48200,0,48200,193400,0,241600
190610101900000,SW 457,RESIDENTIAL,46000,0,46000,199200,0,245200
190610102100000,SW 457,RESIDENTIAL,49700,0,49700,196300,0,246000
190610102200000,SW 457,RESIDENTIAL,43400,0,43400,226900,0,270300
190610102300000,SW 457,RESIDENTIAL,46300,0,46300,183000,0,229300
190610102400000,SW 457,RESIDENTIAL,46300,0,46300,192100,0,238400
190610102600000,SW 457,RESIDENTIAL,0,0,0,0,0,0
190610102700000,SW 457,RESIDENTIAL,44600,0,44600,157200,0,201800
190610102800000,SW 457,RESIDENTIAL,46300,0,46300,180000,0,226300
190610102900000,SW 457,RESIDENTIAL,44000,0,44000,186300,0,230300
190610103000000,SW 457,RESIDENTIAL,49100,0,49100,182800,0,231900
190610103300000,SW 457,RESIDENTIAL,52300,0,52300,4100,0,56400
190610103400000,SW 457,RESIDENTIAL,1700,0,1700,0,0,1700
190610103500000,SW 457,RESIDENTIAL,52800,0,52800,199600,0,252400
190610103600000,SW 457,RESIDENTIAL,1700,0,1700,0,0,1700
190610103700000,SW 457,RESIDENTIAL,1700,0,1700,0,0,1700
190610103800000,SW 457,RESIDENTIAL,1700,0,1700,0,0,1700
190610103900000,SW 457,RESIDENTIAL,51400,0,51400,193700,0,245100
190610104000000,SW 457,RESIDENTIAL,1700,0,1700,0,0,1700
190610104100000,SW 457,RESIDENTIAL,1600,0,1600,0,0,1600
190610104200000,SW 457,RESIDENTIAL,2000,0,2000,0,0,2000
190610104300000,SW 457,RESIDENTIAL,55600,0,55600,4100,0,59700
190610104400000,SW 457,RESIDENTIAL,1900,0,1900,0,0,1900
190610200100000,SW 457,RESIDENTIAL,44700,0,44700,170000,0,214700
190610200200000,SW 457,RESIDENTIAL,46500,0,46500,153800,0,200300
190610200300000,SW 457,RESIDENTIAL,50100,0,50100,201100,0,251200
190610200400000,SW 457,RESIDENTIAL,59400,0,59400,203400,0,262800
190610200500000,SW 457,RESIDENTIAL,200,0,200,0,0,200
190610200600000,SW 457,RESIDENTIAL,59800,0,59800,171900,0,231700
190610200700000,SW 457,RESIDENTIAL,50700,0,50700,246300,0,297000
190610200800000,SW 457,RESIDENTIAL,49600,0,49600,233100,0,282700
190610300100000,SW 457,RESIDENTIAL,51900,0,51900,224800,0,276700
190610300200000,SW 457,RESIDENTIAL,37800,0,37800,214800,0,252600
190610300300000,SW 457,RESIDENTIAL,2000,0,2000,0,0,2000
190610300400000,SW 457,RESIDENTIAL,1400,0,1400,0,0,1400
190610400100000,SW 425,RESIDENTIAL,34000,0,34000,94000,0,128000
190610400200000,SW 425,RESIDENTIAL,30900,0,30900,94900,0,125800
190610500100000,SW 425,RESIDENTIAL,24000,0,24000,90400,0,114400
190610500200000,SW 425,RESIDENTIAL,28300,0,28300,92100,0,120400
190610600100000,SW 457,RESIDENTIAL,2300,0,2300,0,0,2300
190610600200000,SW 457,RESIDENTIAL,1600,0,1600,0,0,1600
190610600300000,SW 457,RESIDENTIAL,47100,0,47100,87700,0,134800
190610600400000,SW 457,RESIDENTIAL,43500,0,43500,216600,0,260100
190610600500000,SW 457,RESIDENTIAL,1300,0,1300,0,0,1300
190610600600000,SW 457,RESIDENTIAL,1300,0,1300,0,0,1300
190610600700000,SW 457,RESIDENTIAL,43600,0,43600,193600,0,237200
190610600800000,SW 457,RESIDENTIAL,1300,0,1300,0,0,1300
190610601000000,SW 457,RESIDENTIAL,35900,0,35900,0,0,35900
190610700100000,SW 457,RESIDENTIAL,2100,0,2100,0,0,2100
190610700200000,SW 457,RESIDENTIAL,2100,0,2100,0,0,2100
190610700300000,SW 457,RESIDENTIAL,2100,0,2100,0,0,2100
190610700400000,SW 457,RESIDENTIAL,2100,0,2100,0,0,2100
190610700500000,SW 457,RESIDENTIAL,1800,0,1800,0,0,1800
190610700600000,SW 457,RESIDENTIAL,2000,0,2000,0,0,2000
190610700700000,SW 457,RESIDENTIAL,2000,0,2000,0,0,2000
190612600400000,CITY PROPERTY,EXEMPT,0,0,0,0,0,0
190612600700000,SW 457,RESIDENTIAL,51900,0,51900,213000,0,264900
190612600800000,SW 457,RESIDENTIAL,52600,0,52600,163500,0,216100
190612600900000,SW 457,RESIDENTIAL,55700,0,55700,194800,0,250500
190612601000000,SW 457,RESIDENTIAL,58000,0,58000,184000,0,242000
190612601100000,SW 457,RESIDENTIAL,50500,0,50500,213500,0,264000
190612601200000,SW 457,RESIDENTIAL,46800,0,46800,241000,0,287800
190612601300000,SW 457,RESIDENTIAL,51500,0,51500,218000,0,269500
190612601400000,SW 457,RESIDENTIAL,55700,0,55700,207800,0,263500
190612601500000,SW 457,RESIDENTIAL,45800,0,45800,251800,0,297600
190612601600000,SW 457,RESIDENTIAL,43300,0,43300,197300,0,240600
190612601700000,SW 457,RESIDENTIAL,49300,0,49300,223300,0,272600
190612601800000,SW 457,RESIDENTIAL,49400,0,49400,210500,0,259900
190612601900000,SW 457,RESIDENTIAL,48600,0,48600,207500,0,256100
190612602300000,SW 457,RESIDENTIAL,49400,0,49400,224600,0,274000
190612602400000,SW 457,RESIDENTIAL,49600,0,49600,220200,0,269800
190612602500000,SW 457,RESIDENTIAL,49400,0,49400,185100,0,234500
190612602600000,SW 457,RESIDENTIAL,42600,0,42600,161500,0,204100
190612602700000,SW 457,RESIDENTIAL,46500,0,46500,179500,0,226000
190612602800000,SW 457,RESIDENTIAL,44100,0,44100,192700,0,236800
190612602900000,SW 457,RESIDENTIAL,49000,0,49000,198500,0,247500
190612603000000,SW 457,RESIDENTIAL,46500,0,46500,196800,0,243300
190612603100000,SW 457,RESIDENTIAL,44100,0,44100,171900,0,216000
190612603200000,SW 457,RESIDENTIAL,47600,0,47600,176500,0,224100
190612603300000,SW 457,RESIDENTIAL,39600,0,39600,182000,0,221600
190612603400000,SW 457,RESIDENTIAL,46500,0,46500,180500,0,227000
190612603500000,SW 457,RESIDENTIAL,47100,0,47100,213900,0,261000
190612603600000,SW 457,RESIDENTIAL,49600,0,49600,298300,0,347900
190612603700000,SW 457,RESIDENTIAL,47100,0,47100,249800,0,296900
190612603800000,SW 457,RESIDENTIAL,53100,0,53100,252100,0,305200
190612603900000,SW 457,RESIDENTIAL,56000,0,56000,205600,0,261600
190612604000000,SW 457,RESIDENTIAL,49400,0,49400,242900,0,292300
190612604100000,SW 457,RESIDENTIAL,58400,0,58400,256100,0,314500
190612604200000,SW 457,RESIDENTIAL,54000,0,54000,209700,0,263700
190612604300000,SW 457,RESIDENTIAL,53600,0,53600,178500,0,232100
190612604400000,SW 457,RESIDENTIAL,52300,0,52300,193000,0,245300
190612604500000,SW 457,RESIDENTIAL,52100,0,52100,210600,0,262700
190612604600000,SW 457,RESIDENTIAL,48700,0,48700,221900,0,270600
190612604700000,SW 457,RESIDENTIAL,49200,0,49200,205100,0,254300
190612604800000,SW 457,RESIDENTIAL,59700,0,59700,232500,0,292200
190612604900000,CITY PROPERTY,EXEMPT,0,0,0,0,0,0
190612700100000,SW 457,RESIDENTIAL,49800,0,49800,247900,0,297700
190612700200000,SW 457,RESIDENTIAL,48400,0,48400,167500,0,215900
190612700300000,SW 457,RESIDENTIAL,46100,0,46100,213800,0,259900
190612700400000,SW 457,RESIDENTIAL,58400,0,58400,212300,0,270700
190612700500000,SW 457,RESIDENTIAL,52200,0,52200,184400,0,236600
190612700600000,SW 457,RESIDENTIAL,49000,0,49000,213600,0,262600
190612700700000,SW 457,RESIDENTIAL,42800,0,42800,185700,0,228500
190612700800000,SW 457,RESIDENTIAL,46500,0,46500,203500,0,250000
190612701200000,SW 457,RESIDENTIAL,54200,0,54200,170900,0,225100
190612701300000,SW 457,RESIDENTIAL,51300,0,51300,176800,0,228100
190612701400000,SW 457,RESIDENTIAL,52700,0,52700,171200,0,223900
190612701500000,SW 457,RESIDENTIAL,44100,0,44100,181100,0,225200
190612701700000,SW 457,RESIDENTIAL,48800,0,48800,195400,0,244200
190612701800000,SW 457,RESIDENTIAL,46500,0,46500,200600,0,247100
190612800100000,SW 457,RESIDENTIAL,39100,0,39100,181600,0,220700
190612800200000,SW 457,RESIDENTIAL,47900,0,47900,175900,0,223800
190612800300000,SW 457,RESIDENTIAL,39100,0,39100,186100,0,225200
190612800400000,SW 457,RESIDENTIAL,58600,0,58600,164700,0,223300
190612800500000,SW 457,RESIDENTIAL,42800,0,42800,169600,0,212400
190612900100000,SW 457,RESIDENTIAL,40200,0,40200,181700,0,221900
190612900200000,SW 457,RESIDENTIAL,42600,0,42600,166200,0,208800
190612900300000,SW 457,RESIDENTIAL,48000,0,48000,187700,0,235700
190612900400000,SW 457,RESIDENTIAL,42600,0,42600,179000,0,221600
190612900500000,SW 457,RESIDENTIAL,44200,0,44200,178100,0,222300
190612900600000,SW 457,RESIDENTIAL,53000,0,53000,219500,0,272500
190612900700000,SW 457,RESIDENTIAL,48800,0,48800,193500,0,242300
190612900900000,SW 457,RESIDENTIAL,47400,0,47400,191100,0,238500
190612901000000,SW 457,RESIDENTIAL,54200,0,54200,189800,0,244000
190612901100000,SW 457,RESIDENTIAL,700,0,700,0,0,700
190612901200000,SW 457,RESIDENTIAL,48300,0,48300,212900,0,261200
190612901300000,SW 457,RESIDENTIAL,59000,0,59000,192900,0,251900
190612901500000,SW 457,RESIDENTIAL,1400,0,1400,0,0,1400
190612901600000,SW 457,RESIDENTIAL,1700,0,1700,0,0,1700
190612901700000,SW 457,RESIDENTIAL,2700,0,2700,0,0,2700
190612901800000,SW 457,RESIDENTIAL,2600,0,2600,0,0,2600
190612901900000,SW 457,RESIDENTIAL,2100,0,2100,0,0,2100
190612902000000,SW 457,RESIDENTIAL,2600,0,2600,0,0,2600
190612902100000,SW 457,RESIDENTIAL,1800,0,1800,0,0,1800
190612902200000,SW 457,RESIDENTIAL,2000,0,2000,0,0,2000
190615100100000,SW 405,RESIDENTIAL,86700,0,86700,84100,0,170800
190615100200000,SW 405,RESIDENTIAL,69400,0,69400,0,0,69400
190615100300000,SW 405,RESIDENTIAL,77900,0,77900,72200,0,150100
190615100400000,SW 405,RESIDENTIAL,76500,0,76500,65400,0,141900
190615100500000,SW 405,RESIDENTIAL,78800,0,78800,96300,0,175100
190615100600000,SW 405,RESIDENTIAL,78800,0,78800,85600,0,164400
190615100700000,SW 405,RESIDENTIAL,77800,0,77800,2700,0,80500
190615100800000,SW 405,RESIDENTIAL,66800,0,66800,146300,0,213100
190617600100000,WAREHOUSE;MINI STORG,COMMERCIAL,0,128800,128800,0,214500,343300
190617600400000,SW 461,RESIDENTIAL,33100,0,33100,150100,0,183200
190617600500000,SW 461,RESIDENTIAL,35000,0,35000,159500,0,194500
190617600600000,SW 461,RESIDENTIAL,35000,0,35000,150700,0,185700
190617600700000,SW 461,RESIDENTIAL,35000,0,35000,135300,0,170300
190617600800000,SW 461,RESIDENTIAL,35000,0,35000,147400,0,182400
190617600900000,SW 461,RESIDENTIAL,35000,0,35000,151300,0,186300
190617601000000,SW 461,RESIDENTIAL,35000,0,35000,141500,0,176500
190617601100000,SW 461,RESIDENTIAL,35000,0,35000,150400,0,185400
190617601200000,SW 461,RESIDENTIAL,35000,0,35000,148500,0,183500
190617601300000,SW 461,RESIDENTIAL,35000,0,35000,153400,0,188400
190617601400000,SW 461,RESIDENTIAL,35000,0,35000,148600,0,183600
190617601500000,SW 461,RESIDENTIAL,35000,0,35000,142100,0,177100
190617601600000,SW 461,RESIDENTIAL,35100,0,35100,144100,0,179200
190617601700000,SW 461,RESIDENTIAL,38600,0,38600,134200,0,172800
190617601800000,SW 461,RESIDENTIAL,45400,0,45400,169000,0,214400
190617601900000,SW 461,RESIDENTIAL,38600,0,38600,184300,0,222900
190617602000000,SW 461,RESIDENTIAL,38600,0,38600,173500,0,212100
190617602100000,SW 461,RESIDENTIAL,39100,0,39100,178600,0,217700
190617602200000,SW 461,RESIDENTIAL,39100,0,39100,170000,0,209100
190617602300000,SW 461,RESIDENTIAL,39100,0,39100,167600,0,206700
190617602400000,SW 461,RESIDENTIAL,39100,0,39100,172500,0,211600
190617602500000,SW 461,RESIDENTIAL,39100,0,39100,170800,0,209900
190617602600000,SW 461,RESIDENTIAL,39100,0,39100,198900,0,238000
190617602700000,SW 461,RESIDENTIAL,39100,0,39100,168700,0,207800
190617602800000,SW 461,RESIDENTIAL,39100,0,39100,168000,0,207100
190617602900000,SW 461,RESIDENTIAL,39100,0,39100,153800,0,192900
190617603000000,SW 461,RESIDENTIAL,39100,0,39100,188200,0,227300
190617603100000,SW 461,RESIDENTIAL,39100,0,39100,151900,0,191000
190617603200000,SW 461,RESIDENTIAL,33700,0,33700,183300,0,217000
190617603300000,SW 461,RESIDENTIAL,39800,0,39800,193100,0,232900
190617603400000,SW 432,RESIDENTIAL,400,0,400,0,0,400
190617700100000,SW 461,RESIDENTIAL,31600,0,31600,160500,0,192100
190617700200000,SW 461,RESIDENTIAL,36000,0,36000,190000,0,226000
190617700300000,SW 461,RESIDENTIAL,35000,0,35000,133200,0,168200
190617700400000,SW 461,RESIDENTIAL,35000,0,35000,142700,0,177700
190617700500000,SW 461,RESIDENTIAL,35600,0,35600,156100,0,191700
190617700600000,SW 405,AG DWELLING,14800,0,14800,54100,11700,80600
190617700700000,SW 461,RESIDENTIAL,32600,0,32600,137100,0,169700
190617700800000,SW 461,RESIDENTIAL,35000,0,35000,146000,0,181000
190617700900000,SW 461,RESIDENTIAL,35000,0,35000,144100,0,179100
190617701000000,SW 461,RESIDENTIAL,35000,0,35000,143600,0,178600
190617701100000,SW 461,RESIDENTIAL,35000,0,35000,154000,0,189000
190617701200000,SW 461,RESIDENTIAL,35000,0,35000,141700,0,176700
190617701300000,SW 461,RESIDENTIAL,35000,0,35000,148000,0,183000
190617701400000,SW 461,RESIDENTIAL,35100,0,35100,157300,0,192400
190617800200000,SW 461,RESIDENTIAL,78700,0,78700,214500,0,293200
190617800400000,SW 461,RESIDENTIAL,44500,0,44500,197800,0,242300
190617800500000,SW 461,RESIDENTIAL,44500,0,44500,178200,0,222700
190617800600000,SW 461,RESIDENTIAL,44500,0,44500,216400,0,260900
190617800700000,SW 461,RESIDENTIAL,44500,0,44500,191300,0,235800
190617800800000,SW 461,RESIDENTIAL,44500,0,44500,184500,0,229000
190617800900000,SW 461,RESIDENTIAL,44500,0,44500,169000,0,213500
190617801000000,SW 461,RESIDENTIAL,44900,0,44900,195900,0,240800
190617801100000,SW 461,RESIDENTIAL,44900,0,44900,171700,0,216600
190617801200000,SW 461,RESIDENTIAL,40600,0,40600,150400,0,191000
190617801300000,SW 461,RESIDENTIAL,45500,0,45500,165600,0,211100
190617801400000,SW 461,RESIDENTIAL,49900,0,49900,163800,0,213700
190617801500000,SW 461,RESIDENTIAL,43500,0,43500,175400,0,218900
190617801600000,SW 461,RESIDENTIAL,38600,0,38600,159500,0,198100
190620100200000,SW 421,RESIDENTIAL,27400,0,27400,108700,0,136100
190620100300000,SW 421,RESIDENTIAL,24500,0,24500,110600,0,135100
190620100400000,SW 421,RESIDENTIAL,22700,0,22700,96200,0,118900
190620100500000,SW 421,RESIDENTIAL,22700,0,22700,99600,0,122300
190620100600000,SW 421,RESIDENTIAL,22700,0,22700,99900,0,122600
190620100700000,SW 421,RESIDENTIAL,22900,0,22900,96300,0,119200
190620100800000,SW 421,RESIDENTIAL,22900,0,22900,97600,0,120500
190620100900000,SW 421,RESIDENTIAL,22900,0,22900,85000,0,107900
190620101000000,SW 421,RESIDENTIAL,22900,0,22900,100500,0,123400
190620101100000,SW 421,RESIDENTIAL,22900,0,22900,94900,0,117800
190620101200000,SW 421,RESIDENTIAL,22900,0,22900,95000,0,117900
190620101300000,SW 421,RESIDENTIAL,23100,0,23100,79000,0,102100
190620101400000,SW 421,RESIDENTIAL,23100,0,23100,100100,0,123200
190620101500000,SW 421,RESIDENTIAL,23100,0,23100,79600,0,102700
190620101600000,SW 421,RESIDENTIAL,23100,0,23100,94700,0,117800
190620101700000,SW 421,RESIDENTIAL,25100,0,25100,107000,0,132100
190620101800000,SW 421,RESIDENTIAL,28100,0,28100,82100,0,110200
190620101900000,SW 421,RESIDENTIAL,25100,0,25100,99500,0,124600
190620102000000,SW 421,RESIDENTIAL,24300,0,24300,80700,0,105000
190620102100000,SW 421,RESIDENTIAL,24300,0,24300,89700,0,114000
190620102200000,SW 421,RESIDENTIAL,22100,0,22100,116500,0,138600
190620102300000,SW 421,RESIDENTIAL,26500,0,26500,94000,0,120500
190620102400000,SW 421,RESIDENTIAL,27100,0,27100,95600,0,122700
190620102500000,SW 421,RESIDENTIAL,25200,0,25200,96800,0,122000
190620102600000,SW 421,RESIDENTIAL,23400,0,23400,76000,0,99400
190620102700000,SW 421,RESIDENTIAL,23400,0,23400,87000,0,110400
190620102800000,SW 421,RESIDENTIAL,23400,0,23400,101400,0,124800
190620102900000,SW 421,RESIDENTIAL,23400,0,23400,81100,0,104500
190620103000000,SW 421,RESIDENTIAL,23400,0,23400,89900,0,113300
190620103100000,SW 421,RESIDENTIAL,23400,0,23400,100600,0,124000
190620103200000,SW 421,RESIDENTIAL,23400,0,23400,100200,0,123600
190620103300000,SW 421,RESIDENTIAL,23400,0,23400,90700,0,114100
190620103400000,SW 421,RESIDENTIAL,23400,0,23400,69400,0,92800
190620103500000,SW 421,RESIDENTIAL,23400,0,23400,96800,0,120200
190620103600000,SW 421,RESIDENTIAL,23400,0,23400,87200,0,110600
190620103700000,SW 421,RESIDENTIAL,25500,0,25500,98800,0,124300
190620103800000,SW 421,RESIDENTIAL,25500,0,25500,105700,0,131200
190620103900000,SW 421,RESIDENTIAL,24200,0,24200,91700,0,115900
190620104000000,SW 421,RESIDENTIAL,27000,0,27000,98700,0,125700
190620104100000,SW 421,RESIDENTIAL,26800,0,26800,94200,0,121000
190620104200000,SW 421,RESIDENTIAL,24200,0,24200,89700,0,113900
190620104300000,SW 421,RESIDENTIAL,24200,0,24200,86600,0,110800
190620104400000,SW 421,RESIDENTIAL,24200,0,24200,100900,0,125100
190620104500000,SW 421,RESIDENTIAL,23400,0,23400,87100,0,110500
190620104600000,SW 421,RESIDENTIAL,23400,0,23400,83800,0,107200
190620104700000,SW 421,RESIDENTIAL,23400,0,23400,82100,0,105500
190620104800000,SW 421,RESIDENTIAL,23400,0,23400,80000,0,103400
190620104900000,SW 421,RESIDENTIAL,23400,0,23400,90400,0,113800
190620105000000,SW 421,RESIDENTIAL,23400,0,23400,98800,0,122200
190620105100000,SW 421,RESIDENTIAL,23400,0,23400,96900,0,120300
190620105200000,SW 421,RESIDENTIAL,23400,0,23400,77200,0,100600
190620105300000,SW 421,RESIDENTIAL,23400,0,23400,98500,0,121900
190620105400000,SW 421,RESIDENTIAL,23400,0,23400,90400,0,113800
190620105500000,SW 421,RESIDENTIAL,23400,0,23400,99900,0,123300
190620105600000,SW 421,RESIDENTIAL,23400,0,23400,94900,0,118300
190620105700000,SW 421,RESIDENTIAL,23400,0,23400,89300,0,112700
190620105800000,SW 421,RESIDENTIAL,23400,0,23400,96900,0,120300
190620105900000,SW 421,RESIDENTIAL,23400,0,23400,94000,0,117400
190620106000000,SW 421,RESIDENTIAL,23400,0,23400,92000,0,115400
190620106100000,SW 421,RESIDENTIAL,26000,0,26000,116500,0,142500
190620106200000,SW 421,RESIDENTIAL,22700,0,22700,96400,0,119100
190620106300000,SW 421,RESIDENTIAL,21400,0,21400,96100,0,117500
190620106400000,SW 421,RESIDENTIAL,23000,0,23000,102100,0,125100
190620106500000,SW 421,RESIDENTIAL,26400,0,26400,101100,0,127500
190620106600000,SW 421,RESIDENTIAL,27500,0,27500,118600,0,146100
190620106700000,SW 421,RESIDENTIAL,28300,0,28300,104600,0,132900
190620106800000,SW 421,RESIDENTIAL,28300,0,28300,105400,0,133700
190620106900000,SW 421,RESIDENTIAL,28000,0,28000,95000,0,123000
190620107000000,SW 421,RESIDENTIAL,27100,0,27100,94800,0,121900
190620107100000,SCHOOL,EXEMPT,0,104400,104400,0,76600,181000
190620107300000,SW 457,RESIDENTIAL,45400,0,45400,196200,0,241600
190620107400000,SW 457,RESIDENTIAL,42000,0,42000,186200,0,228200
190620107500000,SW 457,RESIDENTIAL,43000,0,43000,170100,0,213100
190620107600000,SW 457,RESIDENTIAL,41100,0,41100,169800,0,210900
190620107700000,SW 457,RESIDENTIAL,38500,0,38500,185400,0,223900
190620107800000,SW 457,RESIDENTIAL,42600,0,42600,176300,0,218900
190620107900000,SW 457,RESIDENTIAL,41200,0,41200,169400,0,210600
190620108000000,SW 457,RESIDENTIAL,43200,0,43200,191200,0,234400
190620108100000,SW 457,RESIDENTIAL,43200,0,43200,156900,0,200100
190620108200000,SW 457,RESIDENTIAL,48800,0,48800,172900,0,221700
190620108300000,SW 457,RESIDENTIAL,45700,0,45700,161800,0,207500
190620108400000,SW 457,RESIDENTIAL,44300,0,44300,194600,0,238900
190620108500000,SW 457,RESIDENTIAL,46700,0,46700,185600,0,232300
190620108600000,SW 457,RESIDENTIAL,45800,0,45800,209900,0,255700
190620108700000,SW 457,RESIDENTIAL,44800,0,44800,142100,0,186900
190620108800000,SW 457,RESIDENTIAL,50700,0,50700,197000,0,247700
190620108900000,SW 457,RESIDENTIAL,48500,0,48500,206000,0,254500
190620109000000,SW 457,RESIDENTIAL,49300,0,49300,200100,0,249400
190620109100000,SW 457,RESIDENTIAL,49600,0,49600,159600,0,209200
190620109200000,SW 457,RESIDENTIAL,42400,0,42400,162800,0,205200
190620109300000,SW 457,RESIDENTIAL,46600,0,46600,170900,0,217500
190620109400000,SW 457,RESIDENTIAL,49900,0,49900,233700,0,283600
190620109500000,SW 457,RESIDENTIAL,44200,0,44200,201500,0,245700
190620109600000,SW 457,RESIDENTIAL,45500,0,45500,188100,0,233600
190620109700000,SW 457,RESIDENTIAL,51800,0,51800,217400,0,269200
190620200100000,SW 421,RESIDENTIAL,25200,0,25200,112500,0,137700
190620200200000,SW 421,RESIDENTIAL,26800,0,26800,98800,0,125600
190620200300000,SW 421,RESIDENTIAL,24200,0,24200,95400,0,119600
190620200400000,SW 421,RESIDENTIAL,24200,0,24200,82900,0,107100
190620200500000,SW 421,RESIDENTIAL,24200,0,24200,104500,0,128700
190620200600000,SW 421,RESIDENTIAL,25500,0,25500,83200,0,108700
190620200700000,SW 421,RESIDENTIAL,24200,0,24200,90500,0,114700
190620200800000,SW 421,RESIDENTIAL,24200,0,24200,102100,0,126300
190620200900000,SW 421,RESIDENTIAL,24200,0,24200,101500,0,125700
190620201000000,SW 421,RESIDENTIAL,25500,0,25500,63400,0,88900
190620201100000,SW 421,RESIDENTIAL,23400,0,23400,86500,0,109900
190620201200000,SW 421,RESIDENTIAL,23400,0,23400,85200,0,108600
190620201300000,SW 421,RESIDENTIAL,23400,0,23400,92600,0,116000
190620201400000,SW 421,RESIDENTIAL,23400,0,23400,91000,0,114400
190620201500000,SW 421,RESIDENTIAL,23400,0,23400,80400,0,103800
190620201600000,SW 421,RESIDENTIAL,25000,0,25000,82200,0,107200
190620201700000,SW 421,RESIDENTIAL,24800,0,24800,98200,0,123000
190620201800000,SW 421,RESIDENTIAL,23100,0,23100,98200,0,121300
190620201900000,SW 421,RESIDENTIAL,23100,0,23100,102100,0,125200
190620202000000,SW 421,RESIDENTIAL,23100,0,23100,90000,0,113100
190620202100000,SW 421,RESIDENTIAL,23100,0,23100,93300,0,116400
190620202200000,SW 421,RESIDENTIAL,23100,0,23100,85400,0,108500
190620202300000,SW 421,RESIDENTIAL,24000,0,24000,98300,0,122300
190620202400000,SW 421,RESIDENTIAL,24000,0,24000,101000,0,125000
190620202500000,SW 421,RESIDENTIAL,24000,0,24000,97900,0,121900
190620202600000,SW 421,RESIDENTIAL,24000,0,24000,98800,0,122800
190620202700000,SW 421,RESIDENTIAL,24000,0,24000,96700,0,120700
190620202800000,SW 421,RESIDENTIAL,25200,0,25200,100600,0,125800
190620202900000,SW 421,RESIDENTIAL,24000,0,24000,95300,0,119300
190620203000000,SW 421,RESIDENTIAL,24000,0,24000,106300,0,130300
190620300100000,CITY PROPERTY,EXEMPT,0,0,0,0,0,0
190620300200000,SW 457,RESIDENTIAL,45200,0,45200,198300,0,243500
190620300300000,SW 457,RESIDENTIAL,40200,0,40200,224700,0,264900
190620300400000,SW 457,RESIDENTIAL,42000,0,42000,190800,0,232800
190620300500000,SW 457,RESIDENTIAL,42300,0,42300,212800,0,255100
190620300600000,SW 457,RESIDENTIAL,41500,0,41500,263900,0,305400
190620300700000,SW 457,RESIDENTIAL,43700,0,43700,190500,0,234200
190620300800000,SW 457,RESIDENTIAL,43200,0,43200,163600,0,206800
190620300900000,SW 457,RESIDENTIAL,44000,0,44000,185800,0,229800
190620301000000,SW 457,RESIDENTIAL,47800,0,47800,184400,0,232200
190620301100000,SW 457,RESIDENTIAL,49800,0,49800,158200,0,208000
190620301200000,SW 457,RESIDENTIAL,45600,0,45600,173000,0,218600
190620301300000,SW 457,RESIDENTIAL,46900,0,46900,184600,0,231500
190620301400000,SW 457,RESIDENTIAL,42800,0,42800,172300,0,215100
190620301500000,SW 457,RESIDENTIAL,42000,0,42000,182600,0,224600
190620301600000,SW 457,RESIDENTIAL,39600,0,39600,192500,0,232100
190620301700000,SW 457,RESIDENTIAL,41600,0,41600,180100,0,221700
190620301800000,SW 457,RESIDENTIAL,40600,0,40600,139500,0,180100
190620301900000,SW 457,RESIDENTIAL,39200,0,39200,172900,0,212100
190620302000000,SW 457,RESIDENTIAL,41600,0,41600,202300,0,243900
190620302100000,SW 457,RESIDENTIAL,41600,0,41600,184700,0,226300
190620302200000,SW 457,RESIDENTIAL,42800,0,42800,232600,0,275400
190620302300000,SW 457,RESIDENTIAL,45800,0,45800,200100,0,245900
190620302400000,SW 457,RESIDENTIAL,39200,0,39200,164500,0,203700
190620302500000,SW 457,RESIDENTIAL,41600,0,41600,197800,0,239400
190620302600000,SW 457,RESIDENTIAL,41600,0,41600,176000,0,217600
190620302700000,SW 457,RESIDENTIAL,48900,0,48900,211900,0,260800
190620302800000,SW 457,RESIDENTIAL,50600,0,50600,205300,0,255900
190622600100000,SW 421,RESIDENTIAL,25400,0,25400,99000,0,124400
190622600200000,SW 421,RESIDENTIAL,23300,0,23300,85200,0,108500
190622600300000,SW 421,RESIDENTIAL,22200,0,22200,72400,0,94600
190622600400000,SW 421,RESIDENTIAL,22900,0,22900,93600,0,116500
190622600500000,SW 421,RESIDENTIAL,22600,0,22600,79400,0,102000
190622600600000,SW 421,RESIDENTIAL,22600,0,22600,92700,0,115300
190622600700000,SW 421,RESIDENTIAL,23900,0,23900,104500,0,128400
190622600800000,SW 421,RESIDENTIAL,23900,0,23900,85200,0,109100
190622600900000,SW 421,RESIDENTIAL,22600,0,22600,96100,0,118700
190622601000000,SW 421,RESIDENTIAL,22600,0,22600,106800,0,129400
190622601100000,SW 421,RESIDENTIAL,22600,0,22600,91200,0,113800
190622601200000,SW 421,RESIDENTIAL,22600,0,22600,104000,0,126600
190622601300000,SW 421,RESIDENTIAL,23900,0,23900,100900,0,124800
190622601400000,SW 421,RESIDENTIAL,23900,0,23900,89000,0,112900
190622601500000,SW 421,RESIDENTIAL,22600,0,22600,105200,0,127800
190622601600000,SW 421,RESIDENTIAL,22600,0,22600,85600,0,108200
190622601700000,SW 421,RESIDENTIAL,22600,0,22600,103700,0,126300
190622601800000,SW 421,RESIDENTIAL,25600,0,25600,99600,0,125200
190622601900000,SW 421,RESIDENTIAL,27200,0,27200,87100,0,114300
190622602000000,SW 421,RESIDENTIAL,24000,0,24000,106800,0,130800
190622602100000,SW 421,RESIDENTIAL,24000,0,24000,79100,0,103100
190622602200000,SW 421,RESIDENTIAL,24000,0,24000,86500,0,110500
190622602300000,SW 421,RESIDENTIAL,25400,0,25400,83000,0,108400
190622602400000,SW 421,RESIDENTIAL,25400,0,25400,108500,0,133900
190622602500000,SW 421,RESIDENTIAL,24000,0,24000,85200,0,109200
190622602600000,SW 421,RESIDENTIAL,24000,0,24000,90400,0,114400
190622602700000,SW 421,RESIDENTIAL,24000,0,24000,59400,0,83400
190622602800000,SW 421,RESIDENTIAL,24000,0,24000,94900,0,118900
190622602900000,SW 421,RESIDENTIAL,25400,0,25400,85900,0,111300
190622603000000,SW 421,RESIDENTIAL,25400,0,25400,70100,0,95500
190622603100000,SW 421,RESIDENTIAL,24000,0,24000,93400,0,117400
190622603200000,SW 421,RESIDENTIAL,24000,0,24000,85600,0,109600
190622603300000,SW 421,RESIDENTIAL,24000,0,24000,96600,0,120600
190622603400000,SW 421,RESIDENTIAL,24000,0,24000,82500,0,106500
190622603500000,SW 421,RESIDENTIAL,26100,0,26100,102400,0,128500
190622603600000,SW 421,RESIDENTIAL,27000,0,27000,98400,0,125400
190622700100000,SW 421,RESIDENTIAL,19900,0,19900,97800,0,117700
190622700200000,SW 421,RESIDENTIAL,19900,0,19900,94100,0,114000
190622700300000,SW 421,RESIDENTIAL,25500,0,25500,88000,0,113500
190622700400000,SW 421,RESIDENTIAL,23500,0,23500,72600,0,96100
190622700500000,SW 421,RESIDENTIAL,23500,0,23500,66800,0,90300
190622700600000,SW 421,RESIDENTIAL,23500,0,23500,78900,0,102400
190622700700000,SW 421,RESIDENTIAL,23100,0,23100,65300,0,88400
190622700800000,SW 421,RESIDENTIAL,22800,0,22800,92600,0,115400
190622700900000,SW 421,RESIDENTIAL,22800,0,22800,77300,0,100100
190622701000000,SW 421,RESIDENTIAL,22600,0,22600,107100,0,129700
190622701100000,SW 421,RESIDENTIAL,22600,0,22600,92400,0,115000
190622701200000,SW 421,RESIDENTIAL,26300,0,26300,84400,0,110700
190622800100000,SW 421,RESIDENTIAL,27000,0,27000,104200,0,131200
190622800200000,SW 421,RESIDENTIAL,27400,0,27400,85900,0,113300
190622800300000,SW 421,RESIDENTIAL,24000,0,24000,91600,0,115600
190622800400000,SW 421,RESIDENTIAL,24000,0,24000,97300,0,121300
190622800500000,SW 421,RESIDENTIAL,24000,0,24000,101200,0,125200
190622800600000,SW 421,RESIDENTIAL,24000,0,24000,98800,0,122800
190622800700000,SW 421,RESIDENTIAL,25400,0,25400,92300,0,117700
190622800800000,SW 421,RESIDENTIAL,25400,0,25400,84100,0,109500
190622800900000,SW 421,RESIDENTIAL,24000,0,24000,91500,0,115500
190622801000000,SW 421,RESIDENTIAL,24000,0,24000,92600,0,116600
190622801100000,SW 421,RESIDENTIAL,24000,0,24000,90700,0,114700
190622801200000,SW 421,RESIDENTIAL,24000,0,24000,96900,0,120900
190622801300000,SW 421,RESIDENTIAL,25400,0,25400,102400,0,127800
190622801400000,SW 421,RESIDENTIAL,25400,0,25400,90000,0,115400
190622801500000,SW 421,RESIDENTIAL,24000,0,24000,93000,0,117000
190622801600000,SW 421,RESIDENTIAL,24000,0,24000,87900,0,111900
190622801700000,SW 421,RESIDENTIAL,24000,0,24000,103800,0,127800
190622801800000,SW 421,RESIDENTIAL,25800,0,25800,98600,0,124400
190622801900000,SW 421,RESIDENTIAL,25800,0,25800,93500,0,119300
190622802000000,SW 421,RESIDENTIAL,24000,0,24000,102600,0,126600
190622802100000,SW 421,RESIDENTIAL,24000,0,24000,87900,0,111900
190622802200000,SW 421,RESIDENTIAL,24000,0,24000,90700,0,114700
190622802300000,SW 421,RESIDENTIAL,25400,0,25400,97800,0,123200
190622802400000,SW 421,RESIDENTIAL,25400,0,25400,87900,0,113300
190622802500000,SW 421,RESIDENTIAL,24000,0,24000,98200,0,122200
190622802600000,SW 421,RESIDENTIAL,24000,0,24000,103200,0,127200
190622802700000,SW 421,RESIDENTIAL,24000,0,24000,89600,0,113600
190622802800000,SW 421,RESIDENTIAL,24000,0,24000,108000,0,132000
190622802900000,SW 421,RESIDENTIAL,25400,0,25400,96600,0,122000
190622803000000,SW 421,RESIDENTIAL,25400,0,25400,91900,0,117300
190622803100000,SW 421,RESIDENTIAL,24000,0,24000,106200,0,130200
190622803200000,SW 421,RESIDENTIAL,24000,0,24000,99000,0,123000
190622803300000,SW 421,RESIDENTIAL,24000,0,24000,99400,0,123400
190622803400000,SW 421,RESIDENTIAL,24000,0,24000,91500,0,115500
190622803500000,SW 421,RESIDENTIAL,28800,0,28800,83700,0,112500
190622803600000,SW 421,RESIDENTIAL,27000,0,27000,89100,0,116100
190622900100000,SW 421,RESIDENTIAL,26000,0,26000,101500,0,127500
190622900200000,SW 421,RESIDENTIAL,24700,0,24700,96900,0,121600
190622900300000,SW 421,RESIDENTIAL,25500,0,25500,88100,0,113600
190622900400000,SW 421,RESIDENTIAL,25000,0,25000,98600,0,123600
190622900500000,SW 421,RESIDENTIAL,24000,0,24000,87200,0,111200
190622900600000,SW 421,RESIDENTIAL,24000,0,24000,95400,0,119400
190622900700000,SW 421,RESIDENTIAL,24000,0,24000,96400,0,120400
190622900800000,SW 421,RESIDENTIAL,24000,0,24000,101000,0,125000
190622900900000,SW 421,RESIDENTIAL,24000,0,24000,92100,0,116100
190622901000000,SW 421,RESIDENTIAL,24000,0,24000,60500,0,84500
190622901100000,SW 421,RESIDENTIAL,24000,0,24000,96000,0,120000
190622901200000,SW 421,RESIDENTIAL,24000,0,24000,82400,0,106400
190622901300000,SW 421,RESIDENTIAL,23500,0,23500,81900,0,105400
190622901400000,SW 421,RESIDENTIAL,23600,0,23600,85400,0,109000
190622901500000,SW 421,RESIDENTIAL,24000,0,24000,85500,0,109500
190622901600000,SW 421,RESIDENTIAL,24000,0,24000,81100,0,105100
190622901700000,SW 421,RESIDENTIAL,24000,0,24000,78300,0,102300
190622901800000,SW 421,RESIDENTIAL,24000,0,24000,91400,0,115400
190622901900000,SW 421,RESIDENTIAL,24000,0,24000,102400,0,126400
190622902000000,SW 421,RESIDENTIAL,24000,0,24000,85700,0,109700
190622902100000,SW 421,RESIDENTIAL,24000,0,24000,83800,0,107800
190622902200000,SW 421,RESIDENTIAL,24000,0,24000,107700,0,131700
190622902300000,SW 421,RESIDENTIAL,24200,0,24200,81000,0,105200
190623000100000,SW 421,RESIDENTIAL,25500,0,25500,90200,0,115700
190623000200000,SW 421,RESIDENTIAL,24400,0,24400,87600,0,112000
190623000300000,SW 421,RESIDENTIAL,24700,0,24700,77200,0,101900
190623000400000,SW 421,RESIDENTIAL,24700,0,24700,89900,0,114600
190623000500000,SW 421,RESIDENTIAL,24700,0,24700,88400,0,113100
190623000600000,SW 421,RESIDENTIAL,23100,0,23100,100900,0,124000
190623000700000,SW 421,RESIDENTIAL,23100,0,23100,92800,0,115900
190623000800000,SW 421,RESIDENTIAL,23100,0,23100,97400,0,120500
190623000900000,SW 421,RESIDENTIAL,23900,0,23900,104100,0,128000
190623001000000,SW 421,RESIDENTIAL,23900,0,23900,98500,0,122400
190623001100000,SW 421,RESIDENTIAL,23100,0,23100,86500,0,109600
190623001200000,SW 421,RESIDENTIAL,23100,0,23100,102700,0,125800
190623001300000,SW 421,RESIDENTIAL,23100,0,23100,89500,0,112600
190623001400000,SW 421,RESIDENTIAL,23100,0,23100,81500,0,104600
190623001500000,SW 421,RESIDENTIAL,26000,0,26000,102000,0,128000
190623001600000,SW 421,RESIDENTIAL,26000,0,26000,103700,0,129700
190623001700000,SW 421,RESIDENTIAL,23100,0,23100,98700,0,121800
190623001800000,SW 421,RESIDENTIAL,23100,0,23100,87200,0,110300
190623001900000,SW 421,RESIDENTIAL,23100,0,23100,94200,0,117300
190623002000000,SW 421,RESIDENTIAL,23100,0,23100,98300,0,121400
190623002100000,SW 421,RESIDENTIAL,23900,0,23900,89100,0,113000
190623002200000,SW 421,RESIDENTIAL,23900,0,23900,92800,0,116700
190623002300000,SW 421,RESIDENTIAL,23100,0,23100,88500,0,111600
190623002400000,SW 421,RESIDENTIAL,23100,0,23100,109600,0,132700
190623002500000,SW 421,RESIDENTIAL,23100,0,23100,101600,0,124700
190623002600000,SW 421,RESIDENTIAL,24700,0,24700,98200,0,122900
190623002700000,SW 421,RESIDENTIAL,24700,0,24700,88300,0,113000
190623002800000,SW 421,RESIDENTIAL,24700,0,24700,99800,0,124500
190623002900000,SW 421,RESIDENTIAL,26000,0,26000,93000,0,119000
190623003000000,SW 421,RESIDENTIAL,26800,0,26800,104100,0,130900
190623100100000,SW 421,RESIDENTIAL,26000,0,26000,105000,0,131000
190623100200000,SW 421,RESIDENTIAL,24300,0,24300,133200,0,157500
190623100300000,SW 421,RESIDENTIAL,24000,0,24000,79700,0,103700
190623100400000,SW 421,RESIDENTIAL,24000,0,24000,89700,0,113700
190623100500000,SW 421,RESIDENTIAL,24000,0,24000,98000,0,122000
190623100600000,SW 421,RESIDENTIAL,24000,0,24000,87400,0,111400
190623100700000,SW 421,RESIDENTIAL,24000,0,24000,109100,0,133100
190623100800000,SW 421,RESIDENTIAL,24000,0,24000,85400,0,109400
190623100900000,SW 421,RESIDENTIAL,24000,0,24000,87800,0,111800
190623101000000,SW 421,RESIDENTIAL,24400,0,24400,83100,0,107500
190623101100000,SW 421,RESIDENTIAL,24200,0,24200,93800,0,118000
190623101200000,SW 421,RESIDENTIAL,24000,0,24000,79900,0,103900
190623101300000,SW 421,RESIDENTIAL,24000,0,24000,84200,0,108200
190623101400000,SW 421,RESIDENTIAL,24000,0,24000,101000,0,125000
190623101500000,SW 421,RESIDENTIAL,24000,0,24000,104700,0,128700
190623101600000,SW 421,RESIDENTIAL,24000,0,24000,82300,0,106300
190623101700000,SW 421,RESIDENTIAL,24000,0,24000,104700,0,128700
190623101800000,SW 421,RESIDENTIAL,24000,0,24000,103100,0,127100
190623101900000,SW 421,RESIDENTIAL,24400,0,24400,95500,0,119900
190623102000000,SW 421,RESIDENTIAL,26000,0,26000,87500,0,113500
190623200100000,SW 421,RESIDENTIAL,25500,0,25500,93500,0,119000
190623200200000,SW 421,RESIDENTIAL,24000,0,24000,89100,0,113100
190623200300000,SW 421,RESIDENTIAL,24000,0,24000,94000,0,118000
190623200400000,SW 421,RESIDENTIAL,24000,0,24000,79800,0,103800
190623200500000,SW 421,RESIDENTIAL,22600,0,22600,90000,0,112600
190623200600000,SW 421,RESIDENTIAL,24700,0,24700,82600,0,107300
190623200700000,CHURCH,EXEMPT,0,56500,56500,0,310900,367400
190623200800000,SW 421,RESIDENTIAL,31400,0,31400,138800,0,170200
190623200900000,SW 421,RESIDENTIAL,28700,0,28700,98500,0,127200
190623201000000,SW 421,RESIDENTIAL,24000,0,24000,114700,0,138700
190623201100000,SW 421,RESIDENTIAL,24500,0,24500,110900,0,135400
190623201200000,SW 421,RESIDENTIAL,23700,0,23700,109900,0,133600
190623201300000,SW 421,RESIDENTIAL,26000,0,26000,115900,0,141900
190623201400000,SW 421,RESIDENTIAL,26000,0,26000,92400,0,118400
190623201500000,SW 421,RESIDENTIAL,26000,0,26000,86300,0,112300
190623201600000,SW 421,RESIDENTIAL,25000,0,25000,97400,0,122400
190623300100000,SW 421,RESIDENTIAL,26000,0,26000,92000,0,118000
190623300200000,SW 421,RESIDENTIAL,24300,0,24300,87400,0,111700
190623300300000,SW 421,RESIDENTIAL,24000,0,24000,91900,0,115900
190623300400000,SW 421,RESIDENTIAL,24000,0,24000,93300,0,117300
190623300500000,SW 421,RESIDENTIAL,24000,0,24000,86200,0,110200
190623300600000,SW 421,RESIDENTIAL,24000,0,24000,91200,0,115200
190623300700000,SW 421,RESIDENTIAL,24000,0,24000,102600,0,126600
190623300800000,SW 421,RESIDENTIAL,24000,0,24000,94100,0,118100
190623300900000,SW 421,RESIDENTIAL,24000,0,24000,92900,0,116900
190623301000000,SW 421,RESIDENTIAL,24400,0,24400,104900,0,129300
190623301100000,SW 421,RESIDENTIAL,23000,0,23000,101900,0,124900
190623301200000,SW 421,RESIDENTIAL,22300,0,22300,101300,0,123600
190623301300000,SW 421,RESIDENTIAL,22300,0,22300,78100,0,100400
190623301400000,SW 421,RESIDENTIAL,22300,0,22300,79900,0,102200
190623301500000,SW 421,RESIDENTIAL,22300,0,22300,93100,0,115400
190623301600000,SW 421,RESIDENTIAL,22100,0,22100,86800,0,108900
190623301700000,SW 421,RESIDENTIAL,22100,0,22100,84000,0,106100
190623301800000,SW 421,RESIDENTIAL,21800,0,21800,108200,0,130000
190623301900000,SW 421,RESIDENTIAL,22100,0,22100,89000,0,111100
190623302000000,SW 421,RESIDENTIAL,23700,0,23700,98300,0,122000
190625100100000,SW 421,RESIDENTIAL,22900,0,22900,94300,0,117200
190625100200000,SW 421,RESIDENTIAL,22900,0,22900,104300,0,127200
190625100300000,SW 421,RESIDENTIAL,23300,0,23300,105300,0,128600
190625100400000,SW 421,RESIDENTIAL,23700,0,23700,103000,0,126700
190625100500000,SW 421,RESIDENTIAL,23700,0,23700,111500,0,135200
190625100600000,SW 421,RESIDENTIAL,24800,0,24800,102200,0,127000
190625100700000,SW 421,RESIDENTIAL,24400,0,24400,110500,0,134900
190625100800000,SW 421,RESIDENTIAL,23900,0,23900,101100,0,125000
190625100900000,SW 421,RESIDENTIAL,24400,0,24400,91300,0,115700
190625101000000,SW 421,RESIDENTIAL,24400,0,24400,105900,0,130300
190625101100000,SW 421,RESIDENTIAL,22800,0,22800,101700,0,124500
190625101200000,SW 421,RESIDENTIAL,23400,0,23400,100300,0,123700
190625101300000,SW 421,RESIDENTIAL,23200,0,23200,107400,0,130600
190625101400000,SW 421,RESIDENTIAL,22200,0,22200,90700,0,112900
190625101500000,SW 421,RESIDENTIAL,28300,0,28300,101500,0,129800
190625101600000,SW 421,RESIDENTIAL,26100,0,26100,100000,0,126100
190625101700000,SW 421,RESIDENTIAL,22200,0,22200,99000,0,121200
190625101800000,SW 421,RESIDENTIAL,21300,0,21300,88900,0,110200
190625101900000,SW 421,RESIDENTIAL,21300,0,21300,108400,0,129700
190625102000000,SW 421,RESIDENTIAL,24200,0,24200,102000,0,126200
190625102100000,SW 421,RESIDENTIAL,26500,0,26500,101400,0,127900
190625102200000,SW 421,RESIDENTIAL,24000,0,24000,84900,0,108900
190625102300000,SW 421,RESIDENTIAL,23600,0,23600,91500,0,115100
190625102400000,SW 421,RESIDENTIAL,23600,0,23600,95300,0,118900
190625102500000,SW 421,RESIDENTIAL,23500,0,23500,101800,0,125300
190625102600000,SW 421,RESIDENTIAL,23900,0,23900,98700,0,122600
190625102700000,SW 421,RESIDENTIAL,23700,0,23700,98900,0,122600
190625102800000,SW 421,RESIDENTIAL,23200,0,23200,107400,0,130600
190625102900000,SW 421,RESIDENTIAL,23700,0,23700,103300,0,127000
190625103000000,SW 421,RESIDENTIAL,25200,0,25200,106000,0,131200
190625103100000,SW 421,RESIDENTIAL,23600,0,23600,113600,0,137200
190625103200000,SW 421,RESIDENTIAL,24800,0,24800,109400,0,134200
190625103300000,SW 421,RESIDENTIAL,23000,0,23000,98400,0,121400
190625103400000,SW 421,RESIDENTIAL,24600,0,24600,100400,0,125000
190625103500000,SW 421,RESIDENTIAL,23400,0,23400,84100,0,107500
190625103600000,SW 421,RESIDENTIAL,23000,0,23000,96700,0,119700
190625103700000,SW 421,RESIDENTIAL,23800,0,23800,108300,0,132100
190625103800000,SW 421,RESIDENTIAL,23800,0,23800,101000,0,124800
190625103900000,SW 421,RESIDENTIAL,23800,0,23800,106000,0,129800
190625104000000,SW 421,RESIDENTIAL,24000,0,24000,101500,0,125500
190625104100000,SW 429,RESIDENTIAL,29800,0,29800,145300,0,175100
190625104200000,SW 429,RESIDENTIAL,30900,0,30900,102300,0,133200
190625104300000,SW 429,RESIDENTIAL,30900,0,30900,121100,0,152000
190625104400000,SW 429,RESIDENTIAL,30900,0,30900,120700,0,151600
190625105500000,SW 429,RESIDENTIAL,30900,0,30900,128800,0,159700
190625105600000,SW 429,RESIDENTIAL,30900,0,30900,136700,0,167600
190625105700000,SW 429,RESIDENTIAL,30900,0,30900,131700,0,162600
190625105800000,SW 429,RESIDENTIAL,30600,0,30600,118600,0,149200
190625105900000,SW 429,RESIDENTIAL,30600,0,30600,114400,0,145000
190625106000000,SW 429,RESIDENTIAL,37800,0,37800,147100,0,184900
190625106100000,SW 429,RESIDENTIAL,44400,0,44400,136400,0,180800
190625106300000,SW 429,RESIDENTIAL,35100,0,35100,146300,0,181400
190625106400000,SW 429,RESIDENTIAL,36900,0,36900,135000,0,171900
190625106500000,SW 429,RESIDENTIAL,41300,0,41300,164300,0,205600
190625106600000,SW 429,RESIDENTIAL,35800,0,35800,151800,0,187600
190625106700000,SW 429,RESIDENTIAL,32500,0,32500,132300,0,164800
190625106800000,SW 429,RESIDENTIAL,34400,0,34400,130300,0,164700
190625106900000,SW 429,RESIDENTIAL,36200,0,36200,127600,0,163800
190625107000000,SW 429,RESIDENTIAL,35200,0,35200,141600,0,176800
190625107100000,SW 429,RESIDENTIAL,34400,0,34400,137800,0,172200
190625107200000,SW 429,RESIDENTIAL,36000,0,36000,150100,0,186100
190625107300000,SW 429,RESIDENTIAL,35100,0,35100,113300,0,148400
190625107400000,SW 429,RESIDENTIAL,34100,0,34100,144300,0,178400
190625200100000,SW 421,RESIDENTIAL,25400,0,25400,89400,0,114800
190625200200000,SW 421,RESIDENTIAL,23400,0,23400,101000,0,124400
190625200300000,SW 421,RESIDENTIAL,24200,0,24200,106000,0,130200
190625200400000,SW 421,RESIDENTIAL,23600,0,23600,100600,0,124200
190625200500000,SW 421,RESIDENTIAL,23600,0,23600,92400,0,116000
190625200600000,SW 421,RESIDENTIAL,24000,0,24000,119700,0,143700
190625200700000,SW 421,RESIDENTIAL,23700,0,23700,108900,0,132600
190625200800000,SW 421,RESIDENTIAL,23500,0,23500,111900,0,135400
190625200900000,SW 421,RESIDENTIAL,25600,0,25600,94900,0,120500
190625201000000,SW 421,RESIDENTIAL,23900,0,23900,96200,0,120100
190625201100000,SW 421,RESIDENTIAL,25600,0,25600,109800,0,135400
190625201200000,SW 421,RESIDENTIAL,24300,0,24300,103100,0,127400
190625201300000,SW 421,RESIDENTIAL,24100,0,24100,103300,0,127400
190625201400000,SW 421,RESIDENTIAL,24100,0,24100,110000,0,134100
190625201500000,SW 421,RESIDENTIAL,24100,0,24100,114000,0,138100
190625201600000,SW 421,RESIDENTIAL,24100,0,24100,109500,0,133600
190625201700000,SW 421,RESIDENTIAL,24800,0,24800,95700,0,120500
190625300100000,SW 429,RESIDENTIAL,30500,0,30500,130300,0,160800
190625300200000,SW 429,RESIDENTIAL,24700,0,24700,121300,0,146000
190625300300000,SW 429,RESIDENTIAL,25000,0,25000,110100,0,135100
190625300400000,SW 429,RESIDENTIAL,26500,0,26500,132800,0,159300
190625301400000,SW 429,RESIDENTIAL,30900,0,30900,124900,0,155800
190625301500000,SW 429,RESIDENTIAL,30900,0,30900,121700,0,152600
190625301600000,SW 429,RESIDENTIAL,30900,0,30900,111600,0,142500
190625301700000,SW 429,RESIDENTIAL,30900,0,30900,126000,0,156900
190625301800000,SW 429,RESIDENTIAL,36700,0,36700,145000,0,181700
190625301900000,SW 429,RESIDENTIAL,30900,0,30900,132400,0,163300
190625302000000,SW 429,RESIDENTIAL,30900,0,30900,138400,0,169300
190625302100000,SW 429,RESIDENTIAL,30900,0,30900,120300,0,151200
190625302200000,SW 429,RESIDENTIAL,30900,0,30900,127200,0,158100
190625302300000,SW 429,RESIDENTIAL,33600,0,33600,118400,0,152000
190625302400000,SW 429,RESIDENTIAL,30900,0,30900,125700,0,156600
190625302500000,SW 429,RESIDENTIAL,33600,0,33600,106700,0,140300
190625302600000,SW 429,RESIDENTIAL,30900,0,30900,135400,0,166300
190625302700000,SW 429,RESIDENTIAL,30900,0,30900,115000,0,145900
190625302800000,SW 429,RESIDENTIAL,30900,0,30900,132900,0,163800
190625302900000,SW 429,RESIDENTIAL,30900,0,30900,131900,0,162800
190625303000000,SW 429,RESIDENTIAL,30900,0,30900,131800,0,162700
190625303100000,SW 429,RESIDENTIAL,30900,0,30900,146600,0,177500
190625303200000,SW 429,RESIDENTIAL,30900,0,30900,123800,0,154700
190625304500000,SW 429,RESIDENTIAL,30900,0,30900,134100,0,165000
190625304600000,SW 429,RESIDENTIAL,30900,0,30900,132200,0,163100
190625304700000,SW 429,RESIDENTIAL,30900,0,30900,127500,0,158400
190625304800000,SW 429,RESIDENTIAL,30900,0,30900,159500,0,190400
190625304900000,SW 429,RESIDENTIAL,30900,0,30900,122100,0,153000
190625305000000,SW 429,RESIDENTIAL,33800,0,33800,129200,0,163000
190625305100000,SW 429,RESIDENTIAL,33800,0,33800,125600,0,159400
190625305200000,SW 429,RESIDENTIAL,30900,0,30900,144800,0,175700
190625305300000,SW 429,RESIDENTIAL,30900,0,30900,125400,0,156300
190625305400000,SW 429,RESIDENTIAL,30900,0,30900,136400,0,167300
190625400100000,SW 429,RESIDENTIAL,24800,0,24800,115900,0,140700
190625400200000,SW 421,RESIDENTIAL,36200,0,36200,95000,0,131200
190625400300000,SECTION 42,COMMERCIAL,0,282000,282000,0,1528600,1810600
190625400400000,VACANT LAND,COMMERCIAL,0,310000,310000,0,0,310000
190625400500000,CONVENIENCE STORE,COMMERCIAL,0,348800,348800,0,480400,829200
190625400600000,OFFICE,COMMERCIAL,0,114600,114600,0,392800,507400
190627600100000,SW 405,RESIDENTIAL,66600,0,66600,96100,0,162700
190627600200000,SW 405,RESIDENTIAL,66600,0,66600,38700,0,105300
190627600300000,SW 405,RESIDENTIAL,35600,0,35600,105600,0,141200
190627600400000,SW 405,RESIDENTIAL,46900,0,46900,96100,0,143000
190627600500000,SW 405,RESIDENTIAL,46400,0,46400,34700,0,81100
190627600600000,SW 421,RESIDENTIAL,25400,0,25400,49200,0,74600
190627600900000,SW 421,RESIDENTIAL,45700,0,45700,176400,0,222100
190627601000000,SW 421,RESIDENTIAL,40700,0,40700,96100,0,136800
190627601100000,SW 461,AG DWELLING,3700,0,3700,75600,9300,88600
190627601200000,SW 405,RESIDENTIAL,73500,0,73500,205300,0,278800
190627601300000,SW 405,RESIDENTIAL,60000,0,60000,100200,0,160200
190627601400000,SW 405,RESIDENTIAL,73500,0,73500,158400,0,231900
190627601500000,SW 429,RESIDENTIAL,76200,0,76200,112300,0,188500
190627601600000,SW 429,RESIDENTIAL,42000,0,42000,155400,0,197400
190627601700000,SW 429,RESIDENTIAL,46500,0,46500,250500,0,297000
190627601800000,CITY PROPERTY,EXEMPT,0,0,0,0,0,0
190627601900000,SW 429,RESIDENTIAL,38200,0,38200,182800,0,221000
190627602000000,SW 429,RESIDENTIAL,42000,0,42000,219100,0,261100
190627602100000,SW 429,RESIDENTIAL,42000,0,42000,244400,0,286400
190627602200000,SW 429,RESIDENTIAL,46500,0,46500,233600,0,280100
190627602300000,SW 429,RESIDENTIAL,46500,0,46500,260300,0,306800
190627602400000,SW 429,RESIDENTIAL,46500,0,46500,266100,0,312600
190627602500000,SW 429,RESIDENTIAL,42200,0,42200,253200,0,295400
190627602600000,SW 429,RESIDENTIAL,42200,0,42200,225300,0,267500
190627602700000,SW 429,RESIDENTIAL,41900,0,41900,267900,0,309800
190627602800000,CITY PROPERTY,EXEMPT,0,0,0,0,0,0
190627602900000,SW 429,RESIDENTIAL,40600,0,40600,246200,0,286800
190627603000000,SW 429,RESIDENTIAL,71900,0,71900,257400,0,329300
190627700100000,SW 429,RESIDENTIAL,47400,0,47400,214900,0,262300
190627700200000,SW 429,RESIDENTIAL,44900,0,44900,157900,0,202800
190627700300000,SW 429,RESIDENTIAL,44900,0,44900,218500,0,263400
190627700400000,SW 429,RESIDENTIAL,44900,0,44900,235700,0,280600
190627700500000,SW 429,RESIDENTIAL,44900,0,44900,227900,0,272800
190627700600000,SW 429,RESIDENTIAL,44900,0,44900,253200,0,298100
190627700700000,SW 429,RESIDENTIAL,44900,0,44900,178100,0,223000
190627700800000,SW 429,RESIDENTIAL,44300,0,44300,0,0,44300
190627700900000,CITY PROPERTY,EXEMPT,0,0,0,0,0,0
190627800100000,SW 429,RESIDENTIAL,44600,0,44600,0,0,44600
190627800200000,SW 429,RESIDENTIAL,40400,0,40400,189800,0,230200
190627800300000,SW 429,RESIDENTIAL,40400,0,40400,0,0,40400
190627800600000,SW 429,RESIDENTIAL,51200,0,51200,222600,0,273800
190627800700000,SW 429,RESIDENTIAL,69800,0,69800,307000,0,376800
190630100100000,SW 405,RESIDENTIAL,43800,0,43800,120900,0,164700
190630100400000,SW 405,RESIDENTIAL,79400,0,79400,219400,0,298800
190630100500000,SW 405,RESIDENTIAL,72500,0,72500,204100,0,276600
190630100600000,SW 429,RESIDENTIAL,37000,0,37000,164300,0,201300
190630100700000,SW 429,RESIDENTIAL,34000,0,34000,140000,0,174000
190630100800000,SW 429,RESIDENTIAL,34000,0,34000,129900,0,163900
190630100900000,SW 429,RESIDENTIAL,34000,0,34000,141400,0,175400
190630101000000,SW 429,RESIDENTIAL,34000,0,34000,150500,0,184500
190630101100000,SW 429,RESIDENTIAL,34000,0,34000,139900,0,173900
190630101200000,SW 429,RESIDENTIAL,37100,0,37100,153100,0,190200
190630101300000,SW 429,RESIDENTIAL,37200,0,37200,148200,0,185400
190630101400000,SW 429,RESIDENTIAL,34000,0,34000,133300,0,167300
190630101500000,SW 429,RESIDENTIAL,34000,0,34000,149900,0,183900
190630101600000,SW 429,RESIDENTIAL,34000,0,34000,149900,0,183900
190630101700000,SW 429,RESIDENTIAL,34000,0,34000,147100,0,181100
190630101800000,SW 429,RESIDENTIAL,34000,0,34000,162400,0,196400
190630101900000,SW 429,RESIDENTIAL,36900,0,36900,132500,0,169400
190630200100000,CITY PROPERTY,EXEMPT,0,0,0,0,0,0
190630200200000,SW 429,RESIDENTIAL,33900,0,33900,133700,0,167600
190630200300000,SW 429,RESIDENTIAL,34900,0,34900,164400,0,199300
190630200400000,SW 429,RESIDENTIAL,35000,0,35000,145500,0,180500
190630200500000,SW 429,RESIDENTIAL,35000,0,35000,151600,0,186600
190630200600000,SW 429,RESIDENTIAL,35000,0,35000,151100,0,186100
190630200700000,SW 429,RESIDENTIAL,38800,0,38800,146200,0,185000
190630200800000,SW 429,RESIDENTIAL,35000,0,35000,145900,0,180900
190630300100000,SW 429,RESIDENTIAL,37800,0,37800,135400,0,173200
190630300200000,SW 429,RESIDENTIAL,34300,0,34300,146700,0,181000
190630300300000,SW 429,RESIDENTIAL,34000,0,34000,132700,0,166700
190630300400000,SW 429,RESIDENTIAL,34000,0,34000,140100,0,174100
190630300500000,SW 429,RESIDENTIAL,34000,0,34000,137600,0,171600
190630300600000,SW 429,RESIDENTIAL,34000,0,34000,146600,0,180600
190630300700000,SW 429,RESIDENTIAL,36700,0,36700,137600,0,174300
190630400100000,SW 429,RESIDENTIAL,38500,0,38500,232700,0,271200
190630400200000,SW 429,RESIDENTIAL,33500,0,33500,153800,0,187300
190630400300000,SW 429,RESIDENTIAL,33500,0,33500,164600,0,198100
190630400400000,SW 429,RESIDENTIAL,33500,0,33500,137900,0,171400
190630400500000,SW 429,RESIDENTIAL,33500,0,33500,128400,0,161900
190630400600000,SW 429,RESIDENTIAL,33500,0,33500,153100,0,186600
190630400700000,SW 429,RESIDENTIAL,33500,0,33500,128500,0,162000
190630400800000,SW 429,RESIDENTIAL,33500,0,33500,162200,0,195700
190630400900000,SW 429,RESIDENTIAL,33500,0,33500,176200,0,209700
190630401000000,SW 429,RESIDENTIAL,34900,0,34900,164700,0,199600
190632600100000,SW 429,RESIDENTIAL,34700,0,34700,136500,0,171200
190632600200000,SW 429,RESIDENTIAL,34600,0,34600,136800,0,171400
190632600300000,SW 429,RESIDENTIAL,32100,0,32100,152800,0,184900
190632600400000,SW 429,RESIDENTIAL,32100,0,32100,132500,0,164600
190632600500000,SW 429,RESIDENTIAL,32100,0,32100,138200,0,170300
190632600600000,SW 429,RESIDENTIAL,32100,0,32100,135800,0,167900
190632600700000,SW 429,RESIDENTIAL,32100,0,32100,135100,0,167200
190632600800000,SW 429,RESIDENTIAL,34700,0,34700,144300,0,179000
190632600900000,SW 429,RESIDENTIAL,34700,0,34700,147100,0,181800
190632601000000,SW 429,RESIDENTIAL,32100,0,32100,129700,0,161800
190632601100000,SW 429,RESIDENTIAL,32100,0,32100,132100,0,164200
190632601200000,SW 429,RESIDENTIAL,32100,0,32100,146500,0,178600
190632601300000,SW 429,RESIDENTIAL,32100,0,32100,126500,0,158600
190632601400000,SW 429,RESIDENTIAL,32100,0,32100,143800,0,175900
190632700100000,SW 429,RESIDENTIAL,34600,0,34600,141300,0,175900
190632700200000,SW 429,RESIDENTIAL,34500,0,34500,141300,0,175800
190632700300000,SW 429,RESIDENTIAL,32100,0,32100,126900,0,159000
190632700400000,SW 429,RESIDENTIAL,32100,0,32100,132600,0,164700
190632700500000,SW 429,RESIDENTIAL,32100,0,32100,138600,0,170700
190632700600000,SW 429,RESIDENTIAL,32100,0,32100,155800,0,187900
190632700700000,SW 429,RESIDENTIAL,32100,0,32100,116600,0,148700
190632700800000,SW 429,RESIDENTIAL,34700,0,34700,162000,0,196700
190632700900000,SW 429,RESIDENTIAL,34700,0,34700,135200,0,169900
190632701000000,SW 429,RESIDENTIAL,32100,0,32100,131900,0,164000
190632701100000,SW 429,RESIDENTIAL,32100,0,32100,129200,0,161300
190632701200000,SW 429,RESIDENTIAL,32100,0,32100,126000,0,158100
190632701300000,SW 429,RESIDENTIAL,32100,0,32100,146600,0,178700
190632701400000,SW 429,RESIDENTIAL,32100,0,32100,130400,0,162500
190632800200000,OFFICE,COMMERCIAL,0,1253000,1253000,0,3124500,4377500
190632800300000,OFFICE,COMMERCIAL,0,477900,477900,0,731400,1209300
190632900100000,SW 429,RESIDENTIAL,38200,0,38200,123300,0,161500
190632900200000,SW 429,RESIDENTIAL,38200,0,38200,144600,0,182800
190632900300000,SW 429,RESIDENTIAL,33900,0,33900,141100,0,175000
190632900400000,SW 429,RESIDENTIAL,33900,0,33900,136100,0,170000
190632900500000,SW 429,RESIDENTIAL,33900,0,33900,151600,0,185500
190632900600000,SW 429,RESIDENTIAL,33900,0,33900,132500,0,166400
190632900700000,SW 429,RESIDENTIAL,33900,0,33900,130000,0,163900
190632900800000,SW 429,RESIDENTIAL,33900,0,33900,123600,0,157500
190632900900000,SW 429,RESIDENTIAL,36300,0,36300,148000,0,184300
190632901000000,SW 429,RESIDENTIAL,33900,0,33900,151000,0,184900
190633000100000,SW 429,RESIDENTIAL,37300,0,37300,154100,0,191400
190633000200000,SW 429,RESIDENTIAL,34300,0,34300,137200,0,171500
190633000300000,SW 429,RESIDENTIAL,34300,0,34300,163200,0,197500
190633000400000,SW 429,RESIDENTIAL,34300,0,34300,130800,0,165100
190633000500000,SW 429,RESIDENTIAL,34300,0,34300,131200,0,165500
190633000600000,SW 429,RESIDENTIAL,34300,0,34300,133300,0,167600
190633000700000,SW 429,RESIDENTIAL,37100,0,37100,144000,0,181100
190635100100000,WAREHOUSE,COMMERCIAL,0,576300,576300,0,3100400,3676700
190635100300000,SW 418,AG LAND,500,0,500,0,0,500
190637600200000,WAREHOUSE,COMMERCIAL,0,239000,239000,0,258200,497200
190637600202000,ANTENNAS/TOWERS(BLL),COMMERCIAL,0,0,0,0,74300,74300
190637600300000,AUTO REPAIR/SALES,COMMERCIAL,0,652600,652600,0,1476200,2128800
190637600400000,VACANT LAND,AG LAND,500,0,500,0,0,500
190640100100000,SW 405,AG DWELLING,32200,0,32200,218600,1700,252500
190640100200000,CITY PROPERTY,EXEMPT,0,0,0,0,0,0
190640100300000,CENTRALLY ASSESSED,OTHER,0,0,0,0,0,0
190640200100000,SW 405,RESIDENTIAL,36500,0,36500,138900,0,175400
190642600200000,CITY PROPERTY,EXEMPT,0,0,0,0,0,0
190642600300000,SW 405,RESIDENTIAL,50300,0,50300,79500,0,129800
190642600400000,SW 405,RESIDENTIAL,36300,0,36300,46200,0,82500
190642600500000,SW 405,RESIDENTIAL,32300,0,32300,79200,0,111500
190642600600000,SW 405,RESIDENTIAL,63700,0,63700,1000,0,64700
190645100100000,CITY PROPERTY,EXEMPT,0,0,0,0,0,0
190645200100000,CENTRALLY ASSESSED,OTHER,0,0,0,0,0,0
190647600100000,CITY PROPERTY,EXEMPT,0,0,0,0,0,0
190647600200000,CENTRALLY ASSESSED,OTHER,0,0,0,0,0,0
190647700100000,CENTRALLY ASSESSED,OTHER,0,0,0,0,0,0
190647700102000,BILLBOARD(BLL),COMMERCIAL,0,0,0,0,50600,50600
190710100100000,VACANT LAND,INDUSTRIAL,0,13500,13500,0,0,13500
190710200100000,CENTRALLY ASSESSED,OTHER,0,0,0,0,0,0
190710200102000,BILLBOARD(BLL),COMMERCIAL,0,0,0,0,35600,35600
190712600100000,CENTRALLY ASSESSED,OTHER,0,0,0,0,0,0
190712600200000,SW 418,AG LAND,38500,0,38500,0,0,38500
190715100100000,SW 418,AG LAND,67000,0,67000,0,0,67000
190720100100000,CENTRALLY ASSESSED,OTHER,0,0,0,0,0,0
190720200100000,CITY PROPERTY,EXEMPT,0,0,0,0,0,0
190720200200000,VACANT LAND,COMMERCIAL,0,200,200,0,0,200
190720200300000,CENTRALLY ASSESSED,OTHER,0,0,0,0,0,0
190722600100000,VACANT LAND,AG LAND,2200,0,2200,0,0,2200
190722600200000,CITY PROPERTY,EXEMPT,0,0,0,0,0,0
190722700100000,CITY PROPERTY,EXEMPT,0,0,0,0,0,0
190722700200000,CENTRALLY ASSESSED,OTHER,0,0,0,0,0,0
190727600100000,SW 418,AG LAND,4800,0,4800,0,0,4800
190727700200000,VACANT LAND,COMMERCIAL,0,229600,229600,0,0,229600
190730100100000,VACANT LAND,COMMERCIAL,0,186900,186900,0,0,186900
190732600300000,SHOP,COMMERCIAL,0,151900,151900,0,31500,183400
190732600400000,SW 418,RESIDENTIAL,60000,0,60000,130400,0,190400
190735100100000,MATERIALS MFG;INDUST,INDUSTRIAL,0,856200,856200,0,454700,1310900
190735100200000,CENTRALLY ASSESSED,OTHER,0,0,0,0,0,0
190737600100000,VACANT LAND,COMMERCIAL,0,193500,193500,0,0,193500
190742600100000,SW 418,AG LAND,95900,0,95900,0,0,95900
190745100100000,VACANT LAND,AG LAND,123400,0,123400,0,0,123400
190747600100000,SW 418,AG LAND,37700,0,37700,0,0,37700
190810100100000,MISCELLANEOUS,EXEMPT,0,1554700,1554700,0,2247200,3801900
190812600100000,MISCELLANEOUS,COMMERCIAL,0,48000,48000,0,66000,114000
190812700100000,SW 418,RESIDENTIAL,49300,0,49300,0,0,49300
190812700200000,SW 405,RESIDENTIAL,71300,0,71300,95100,0,166400
190812700300000,CITY PROPERTY,EXEMPT,0,0,0,0,0,0
190815100100000,EQUIPMENT MFG;INDUST,INDUSTRIAL,0,288000,288000,0,1176500,1464500
190820100100000,VACANT LAND,INDUSTRIAL,0,51700,51700,0,0,51700
190820200100000,CENTRALLY ASSESSED,OTHER,0,0,0,0,0,0
190820200200000,CENTRALLY ASSESSED,OTHER,0,0,0,0,0,0
190822600100000,VACANT LAND,INDUSTRIAL,0,16300,16300,0,0,16300
190822600102000,BILLBOARD(BLL),COMMERCIAL,0,0,0,0,14100,14100
190822700100000,CENTRALLY ASSESSED,OTHER,0,0,0,0,0,0
190825100100000,CENTRALLY ASSESSED,OTHER,0,0,0,0,0,0
190825200100000,METAL;INDUSTRIAL,INDUSTRIAL,0,3657200,3657200,0,6342800,10000000
190827600400000,FOOD GRADE;INDUST,INDUSTRIAL,0,2388300,2388300,0,29917000,32305300
190830100300000,SHOP,COMMERCIAL,0,251600,251600,0,459000,710600
190830100400000,FLAT PARKING,COMMERCIAL,0,151800,151800,0,20900,172700
190830100500000,CITY PROPERTY,EXEMPT,0,0,0,0,0,0
190830100600000,SHOP,COMMERCIAL,0,106000,106000,0,285900,391900
190830100700000,VACANT LAND,INDUSTRIAL,0,175000,175000,0,0,175000
190830100800000,WAREHOUSE,COMMERCIAL,0,77500,77500,0,251600,329100
190830100900000,OFFICE,COMMERCIAL,0,51700,51700,0,104400,156100
190830101000000,WAREHOUSE,COMMERCIAL,0,80900,80900,0,285200,366100
190830101100000,CITY PROPERTY,EXEMPT,0,0,0,0,0,0
190830101200000,MATERIALS MFG;INDUST,INDUSTRIAL,0,301500,301500,0,341300,642800
190830101300000,CENTRALLY ASSESSED,OTHER,0,0,0,0,0,0
190835100100000,SW 418,AG LAND,90200,0,90200,0,0,90200
190837600200000,WAREHOUSE,COMMERCIAL,0,341300,341300,0,831700,1173000
190837600300000,SHOP,COMMERCIAL,0,342200,342200,0,415200,757400
190837600400000,SHOP,COMMERCIAL,0,345400,345400,0,363500,708900
190837600500000,SHOP,COMMERCIAL,0,320000,320000,0,405500,725500
190840100100000,SHOP,INDUSTRIAL,0,237600,237600,0,385500,623100
190840100200000,VACANT LAND,INDUSTRIAL,0,75300,75300,0,0,75300
190840100300000,VACANT LAND,INDUSTRIAL,0,16300,16300,0,0,16300
190840100400000,SHOP,COMMERCIAL,0,72100,72100,0,241200,313300
190840100600000,VACANT LAND,COMMERCIAL,0,4400,4400,0,0,4400
190840100700000,SHOP,INDUSTRIAL,0,130000,130000,0,49000,179000
190840100800000,APARTMENT,EXEMPT,0,330700,330700,0,2301100,2631800
190840100900000,SHOP,INDUSTRIAL,0,370800,370800,0,1361500,1732300
190840101000000,VACANT LAND,INDUSTRIAL,0,245400,245400,0,229600,475000
190842600100000,VACANT LAND,INDUSTRIAL,0,21500,21500,0,0,21500
190842600200000,VACANT LAND,INDUSTRIAL,0,11500,11500,0,0,11500
190842700400000,FOOD GRADE;INDUST,INDUSTRIAL,0,500300,500300,0,4101500,4601800
190845100500000,SHOP,INDUSTRIAL,0,222500,222500,0,1292600,1515100
190845100600000,SHOP,INDUSTRIAL,0,134000,134000,0,305100,439100
190845100700000,CENTRALLY ASSESSED,OTHER,0,0,0,0,0,0
190845101000000,FOOD GRADE;INDUST,INDUSTRIAL,0,99000,99000,0,0,99000
190845101002000,FOOD GRADE;INDUST,INDUSTRIAL,0,0,0,0,605500,605500
190845101800000,FOOD GRADE;INDUST,INDUSTRIAL,0,530300,530300,0,2282200,2812500
190845102000000,VACANT LAND,INDUSTRIAL,0,1500,1500,0,0,1500
190845102100000,FOOD GRADE;INDUST,INDUSTRIAL,0,1119000,1119000,0,15857500,16976500
190847600200000,SHOP,COMMERCIAL,0,427500,427500,0,240600,668100
190847600300000,MATERIALS MFG;INDUST,INDUSTRIAL,0,237500,237500,0,540500,778000
190847600400000,WAREHOUSE,COMMERCIAL,0,144000,144000,0,547800,691800
190847600500000,SHOP,COMMERCIAL,0,83900,83900,0,175400,259300
190847600600000,SHOP,COMMERCIAL,0,83900,83900,0,147500,231400
190847600700000,WAREHOUSE,COMMERCIAL,0,40300,40300,0,3900,44200
190847600800000,FLAT PARKING,COMMERCIAL,0,40800,40800,0,9200,50000
190847600900000,VACANT LAND,COMMERCIAL,0,900,900,0,0,900
190847601100000,VACANT LAND,INDUSTRIAL,0,65000,65000,0,34400,99400
190847601200000,WAREHOUSE,COMMERCIAL,0,187000,187000,0,209100,396100
190847601300000,WAREHOUSE,COMMERCIAL,0,83900,83900,0,257800,341700
190847601400000,WAREHOUSE,COMMERCIAL,0,83900,83900,0,96400,180300
190847601500000,SMALL RETAIL,COMMERCIAL,0,107300,107300,0,152000,259300
190847601600000,OFFICE,COMMERCIAL,0,211300,211300,0,537300,748600
190847601700000,AUTO REPAIR/SALES,COMMERCIAL,0,111900,111900,0,371300,483200
190847601800000,FLAT PARKING,COMMERCIAL,0,76600,76600,0,15700,92300
190847601900000,WAREHOUSE,COMMERCIAL,0,80600,80600,0,75100,155700
190847602000000,WAREHOUSE,COMMERCIAL,0,45500,45500,0,122900,168400
190847602100000,SHOP,COMMERCIAL,0,103600,103600,0,94400,198000
190847602200000,VACANT LAND,INDUSTRIAL,0,113700,113700,0,0,113700
190847602600000,VACANT LAND,INDUSTRIAL,0,5600,5600,0,0,5600
190847602700000,WAREHOUSE,INDUSTRIAL,0,201400,201400,0,1002200,1203600
190910100100000,VACANT LAND,COMMERCIAL,0,881200,881200,0,0,881200
190910100300000,PRINTING,INDUSTRIAL,0,1364800,1364800,0,3610600,4975400
190912600100000,VACANT LAND,INDUSTRIAL,0,91200,91200,0,0,91200
190912600200000,COUNTY PROPERTY,EXEMPT,0,0,0,0,0,0
190912600400000,CENTRALLY ASSESSED,OTHER,0,0,0,0,0,0
190912600500000,VACANT LAND,COMMERCIAL,0,19300,19300,0,0,19300
190912600700000,BARS/LOUNGE,COMMERCIAL,0,56700,56700,0,187800,244500
190912600702000,BILLBOARD(BLL),COMMERCIAL,0,0,0,0,20400,20400
190912600800000,OFFICE,COMMERCIAL,0,54000,54000,0,87300,141300
190912600900000,OFFICE,COMMERCIAL,0,45900,45900,0,188800,234700
190912601000000,SMALL RET; CTRL CR,COMMERCIAL,0,60100,60100,0,237700,297800
190912601100000,SW 422,RESIDENTIAL,28400,0,28400,127200,0,155600
190912601200000,SW 422,RESIDENTIAL,31500,0,31500,0,0,31500
190912601300000,SW 422,RESIDENTIAL,28400,0,28400,100800,0,129200
190912601400000,OFFICE,COMMERCIAL,0,40500,40500,0,310600,351100
190912601600000,SHOP,COMMERCIAL,0,191300,191300,0,538300,729600
190912601900000,WAREHOUSE,COMMERCIAL,0,98100,98100,0,467600,565700
190912602000000,WAREHOUSE,COMMERCIAL,0,157400,157400,0,851600,1009000
190912602100000,VACANT LAND,COMMERCIAL,0,55700,55700,0,0,55700
190912602200000,SHOP,COMMERCIAL,0,105600,105600,0,7200,112800
190912602300000,WAREHOUSE,COMMERCIAL,0,186000,186000,0,253800,439800
190912602400000,WAREHOUSE,COMMERCIAL,0,190600,190600,0,186600,377200
190912602600000,WAREHOUSE,COMMERCIAL,0,204500,204500,0,809500,1014000
190915100100000,WAREHOUSE,COMMERCIAL,0,675000,675000,0,3246100,3921100
190915100200000,CENTRALLY ASSESSED,OTHER,0,0,0,0,0,0
190915100300000,VACANT LAND,COMMERCIAL,0,25700,25700,0,0,25700
190915200100000,WAREHOUSE,COMMERCIAL,0,485600,485600,0,720600,1206200
190915200200000,COUNTY PROPERTY,EXEMPT,0,0,0,0,0,0
190915200300000,SHOP,COMMERCIAL,0,81000,81000,0,220000,301000
190915200400000,SHOP,COMMERCIAL,0,352500,352500,0,479900,832400
190915200500000,WAREHOUSE,COMMERCIAL,0,203000,203000,0,1061700,1264700
190915200600000,SCHOOL,EXEMPT,0,228000,228000,0,1336100,1564100
190917600100000,EDUCATIONAL/COLLEGE,EXEMPT,0,0,0,0,0,0
190917700100000,WAREHOUSE,COMMERCIAL,0,244000,244000,0,990400,1234400
190917700200000,VACANT LAND,INDUSTRIAL,0,439000,439000,0,0,439000
190920100100000,WAREHOUSE,COMMERCIAL,0,72000,72000,0,117200,189200
190920100200000,SHOP,COMMERCIAL,0,264000,264000,0,435900,699900
190920100300000,PRINTING,INDUSTRIAL,0,73400,73400,0,164700,238100
190920100400000,SHOP,COMMERCIAL,0,367000,367000,0,364500,731500
190920100500000,WAREHOUSE,COMMERCIAL,0,288000,288000,0,939100,1227100
190920100600000,WAREHOUSE,COMMERCIAL,0,426100,426100,0,641600,1067700
190920100700000,VACANT LAND,COMMERCIAL,0,68800,68800,0,0,68800
190920100800000,WAREHOUSE,COMMERCIAL,0,184000,184000,0,275000,459000
190920200100000,CITY PROPERTY,EXEMPT,0,0,0,0,0,0
190922600200000,WAREHOUSE,COMMERCIAL,0,381000,381000,0,1556700,1937700
190922600300000,SERVICE STATION,COMMERCIAL,0,56300,56300,0,88000,144300
190922600400000,WAREHOUSE,COMMERCIAL,0,338700,338700,0,834900,1173600
190922600500000,CONC/ASPH;INDUSTRIAL,INDUSTRIAL,0,4900,4900,0,0,4900
190922600600000,CITY PROPERTY,EXEMPT,0,0,0,0,0,0
190922600700000,CITY PROPERTY,EXEMPT,0,0,0,0,0,0
190922700100000,WAREHOUSE,COMMERCIAL,0,184500,184500,0,663500,848000
190925100100000,CITY PROPERTY,EXEMPT,0,0,0,0,0,0
190925100200000,SHOP,COMMERCIAL,0,104000,104000,0,284700,388700
190925100300000,VACANT LAND,COMMERCIAL,0,37900,37900,0,0,37900
190925100400000,FLAT PARKING,COMMERCIAL,0,19100,19100,0,11000,30100
190925100500000,CONC/ASPH;INDUSTRIAL,INDUSTRIAL,0,397800,397800,0,307200,705000
190925100600000,FLAT PARKING,COMMERCIAL,0,477400,477400,0,16800,494200
190925200100000,SHOP,COMMERCIAL,0,76000,76000,0,447800,523800
190925200200000,SHOP,COMMERCIAL,0,55700,55700,0,233400,289100
190925200300000,OFFICE,COMMERCIAL,0,53600,53600,0,217600,271200
190925200400000,WAREHOUSE,COMMERCIAL,0,384400,384400,0,320500,704900
190927600100000,FRATERNAL,COMMERCIAL,0,339000,339000,0,1344100,1683100
190927600200000,SW 422,RESIDENTIAL,35700,0,35700,71500,0,107200
190927600300000,SW 422,RESIDENTIAL,29100,0,29100,126500,0,155600
190927600400000,OFFICE,COMMERCIAL,0,32200,32200,0,152600,184800
190930100100000,WAREHOUSE;MINI STORG,COMMERCIAL,0,180600,180600,0,634700,815300
190930100200000,CITY PROPERTY,EXEMPT,0,0,0,0,0,0
190930100300000,SW 426,RESIDENTIAL,18900,0,18900,61000,0,79900
190930100400000,SW 426,RESIDENTIAL,19800,0,19800,59200,0,79000
190930100500000,SW 426,RESIDENTIAL,19800,0,19800,61600,0,81400
190930100600000,SW 426,RESIDENTIAL,19800,0,19800,66700,0,86500
190930100700000,SW 426,RESIDENTIAL,19800,0,19800,45400,0,65200
190930100800000,SW 426,RESIDENTIAL,19800,0,19800,66100,0,85900
190930100900000,SW 426,RESIDENTIAL,19800,0,19800,54400,0,74200
190930101000000,SW 426,RESIDENTIAL,19800,0,19800,49700,0,69500
190930200100000,SW 426,RESIDENTIAL,21400,0,21400,64700,0,86100
190930200200000,SW 426,RESIDENTIAL,20900,0,20900,78400,0,99300
190930200300000,SW 426,RESIDENTIAL,20900,0,20900,86900,0,107800
190930200400000,SW 426,RESIDENTIAL,21600,0,21600,78800,0,100400
190930200500000,SW 426,RESIDENTIAL,20800,0,20800,87800,0,108600
190930200600000,SW 426,RESIDENTIAL,20800,0,20800,77700,0,98500
190930300100000,SW 426,RESIDENTIAL,21000,0,21000,110800,0,131800
190930300200000,SW 426,RESIDENTIAL,21700,0,21700,72400,0,94100
190930300300000,SW 426,RESIDENTIAL,21000,0,21000,73100,0,94100
190932600100000,SHOP,COMMERCIAL,0,200000,200000,0,424600,624600
190932600200000,SHOP,COMMERCIAL,0,220000,220000,0,71800,291800
190932600300000,SHOP,COMMERCIAL,0,108000,108000,0,506400,614400
190932600400000,WAREHOUSE,COMMERCIAL,0,114000,114000,0,217600,331600
190932600500000,VACANT LAND,COMMERCIAL,0,127000,127000,0,0,127000
190932600600000,WAREHOUSE,COMMERCIAL,0,339000,339000,0,1269300,1608300
190932600800000,SHOP,COMMERCIAL,0,490200,490200,0,444400,934600
190932600900000,MFG HOME PARK,MULTI-RES,196800,0,196800,154900,0,351700
190932601000000,SHOP,COMMERCIAL,0,202500,202500,0,655200,857700
190932601100000,SHOP,COMMERCIAL,0,363400,363400,0,402500,765900
190932601200000,VACANT LAND,COMMERCIAL,0,460400,460400,0,0,460400
190935100100000,SHOP,COMMERCIAL,0,190800,190800,0,553100,743900
190935100500000,WAREHOUSE,COMMERCIAL,0,181000,181000,0,813300,994300
190935100702000,BILLBOARD(BLL),COMMERCIAL,0,0,0,0,65900,65900
190935100801000,SHOP,COMMERCIAL,0,10300,10300,0,82500,92800
190935100801001,SHOP,COMMERCIAL,0,10300,10300,0,91900,102200
190935100801002,SHOP,COMMERCIAL,0,10300,10300,0,62300,72600
190935100801003,SHOP,COMMERCIAL,0,10300,10300,0,54100,64400
190935100801004,SHOP,COMMERCIAL,0,10300,10300,0,54300,64600
190935100801005,SHOP,COMMERCIAL,0,10300,10300,0,79100,89400
190935100801006,SHOP,COMMERCIAL,0,10300,10300,0,97400,107700
190935100801007,SHOP,COMMERCIAL,0,10300,10300,0,54200,64500
190935100801008,SHOP,COMMERCIAL,0,10300,10300,0,53700,64000
190935100801009,SHOP,COMMERCIAL,0,10300,10300,0,54200,64500
190935100801010,SHOP,COMMERCIAL,0,10300,10300,0,56200,66500
190935100801011,SHOP,COMMERCIAL,0,10300,10300,0,55500,65800
190935100801012,SHOP,COMMERCIAL,0,10300,10300,0,53300,63600
190935100801013,SHOP,COMMERCIAL,0,10300,10300,0,58900,69200
190935100801014,SHOP,COMMERCIAL,0,10300,10300,0,106600,116900
190935100801015,SHOP,COMMERCIAL,0,10300,10300,0,96300,106600
190935100801016,SHOP,COMMERCIAL,0,10300,10300,0,152400,162700
190935100801017,SHOP,COMMERCIAL,0,10300,10300,0,52300,62600
190935100801018,SHOP,COMMERCIAL,0,10300,10300,0,50300,60600
190935100801019,SHOP,COMMERCIAL,0,10300,10300,0,49600,59900
190935100801020,SHOP,COMMERCIAL,0,10300,10300,0,55000,65300
190935100801021,SHOP,COMMERCIAL,0,10300,10300,0,114300,124600
190935100900000,VACANT LAND,COMMERCIAL,0,223500,223500,0,0,223500
190935200300000,WAREHOUSE,COMMERCIAL,0,253800,253800,0,179900,433700
190935200400000,WAREHOUSE,COMMERCIAL,0,179000,179000,0,537300,716300
190935200500000,SHOP,COMMERCIAL,0,128000,128000,0,240300,368300
190935200700000,FITNESS CENTER,COMMERCIAL,0,144000,144000,0,521000,665000
190935200800000,WAREHOUSE,COMMERCIAL,0,271100,271100,0,142000,413100
190935201000000,SHOP,INDUSTRIAL,0,263300,263300,0,738600,1001900
190935201100000,WAREHOUSE,COMMERCIAL,0,182400,182400,0,936200,1118600
190935201200000,WAREHOUSE,COMMERCIAL,0,94400,94400,0,468700,563100
190935300100000,SHOP,COMMERCIAL,0,117000,117000,0,270300,387300
190935300200000,FLAT PARKING,COMMERCIAL,0,73400,73400,0,53200,126600
190935300300000,WAREHOUSE,COMMERCIAL,0,81800,81800,0,165500,247300
190935300400000,SHOP,COMMERCIAL,0,163800,163800,0,483300,647100
190935300600000,SW 418,RESIDENTIAL,99700,0,99700,168000,0,267700
190935301001000,SHOP,COMMERCIAL,5000,15000,20000,38900,116700,175600
190935301001001,SHOP,COMMERCIAL,0,20000,20000,0,50600,70600
190935301001002,SHOP,COMMERCIAL,0,20000,20000,0,46800,66800
190935301001003,SHOP,COMMERCIAL,0,20000,20000,0,46800,66800
190935301001004,SHOP,COMMERCIAL,0,20000,20000,0,46800,66800
190935301100000,SW 418,INDUSTRIAL,0,452700,452700,0,0,452700
190935301200000,BARS/LOUNGE,COMMERCIAL,0,248000,248000,0,708400,956400
190937600100000,SW 426,RESIDENTIAL,20800,0,20800,80100,0,100900
190937600200000,SW 426,RESIDENTIAL,20800,0,20800,64800,0,85600
190937600300000,SW 426,RESIDENTIAL,20800,0,20800,101700,0,122500
190937600400000,SW 426,RESIDENTIAL,20800,0,20800,70900,0,91700
190937600500000,SW 426,RESIDENTIAL,20800,0,20800,51800,0,72600
190937600600000,SW 426,RESIDENTIAL,20800,0,20800,67800,0,88600
190937600700000,SW 426,RESIDENTIAL,20800,0,20800,109300,0,130100
190937600800000,SW 426,RESIDENTIAL,20800,0,20800,80600,0,101400
190937600900000,SW 426,RESIDENTIAL,20800,0,20800,67100,0,87900
190937601000000,SW 426,RESIDENTIAL,20800,0,20800,80400,0,101200
190937601100000,SW 426,RESIDENTIAL,20800,0,20800,76000,0,96800
190937601200000,SW 426,RESIDENTIAL,20800,0,20800,67000,0,87800
190937601300000,SW 426,RESIDENTIAL,20800,0,20800,66000,0,86800
190937601400000,SW 426,RESIDENTIAL,21600,0,21600,54400,0,76000
190937601500000,SW 426,RESIDENTIAL,20900,0,20900,83100,0,104000
190937601600000,SW 426,RESIDENTIAL,20900,0,20900,85900,0,106800
190937601700000,SW 426,RESIDENTIAL,21400,0,21400,66100,0,87500
190937601800000,SW 426,RESIDENTIAL,20800,0,20800,62100,0,82900
190937601900000,SW 426,RESIDENTIAL,20800,0,20800,74500,0,95300
190937602000000,SW 426,RESIDENTIAL,20800,0,20800,99900,0,120700
190937602100000,SW 426,RESIDENTIAL,20800,0,20800,65200,0,86000
190937602200000,SW 426,RESIDENTIAL,20800,0,20800,104300,0,125100
190937602300000,SW 426,RESIDENTIAL,20800,0,20800,113300,0,134100
190937602400000,SW 426,RESIDENTIAL,20800,0,20800,61900,0,82700
190937602500000,SW 426,RESIDENTIAL,20800,0,20800,77300,0,98100
190937602600000,SW 426,RESIDENTIAL,20800,0,20800,90000,0,110800
190937602700000,SW 426,RESIDENTIAL,20800,0,20800,65000,0,85800
190937602800000,SW 426,RESIDENTIAL,20800,0,20800,63200,0,84000
190937700100000,SW 426,RESIDENTIAL,21900,0,21900,63500,0,85400
190937700200000,SW 422,AG LAND,20900,0,20900,0,0,20900
190937700300000,SW 426,RESIDENTIAL,21600,0,21600,58400,0,80000
190937700400000,SW 426,RESIDENTIAL,21500,0,21500,74700,0,96200
190937700500000,SW 426,RESIDENTIAL,21900,0,21900,61500,0,83400
190937700600000,SW 426,RESIDENTIAL,22300,0,22300,91700,0,114000
190937700700000,SW 426,RESIDENTIAL,22500,0,22500,100400,0,122900
190937700800000,SW 426,RESIDENTIAL,22700,0,22700,60100,0,82800
190937700900000,SW 426,RESIDENTIAL,26700,0,26700,49000,0,75700
190937701000000,SW 426,RESIDENTIAL,22700,0,22700,78000,0,100700
190937701100000,SW 426,RESIDENTIAL,22300,0,22300,79400,0,101700
190937900100000,SW 426,RESIDENTIAL,20300,0,20300,75600,0,95900
190937900200000,SW 426,RESIDENTIAL,21100,0,21100,64300,0,85400
190937900300000,SW 426,RESIDENTIAL,21100,0,21100,89400,0,110500
190937900400000,SW 426,RESIDENTIAL,21100,0,21100,99100,0,120200
190937900500000,SW 426,RESIDENTIAL,19900,0,19900,68600,0,88500
190938000100000,SW 426,RESIDENTIAL,22100,0,22100,91400,0,113500
190938000200000,SW 426,RESIDENTIAL,21400,0,21400,68800,0,90200
190940100100000,SMALL RETAIL,COMMERCIAL,0,159000,159000,0,226100,385100
190940100200000,FLAT PARKING,COMMERCIAL,0,41700,41700,0,4800,46500
190940100300000,BARS/LOUNGE,COMMERCIAL,0,122500,122500,0,111600,234100
190940100700000,APARTMENT,MULTI-RES,51400,0,51400,214000,0,265400
190940100800000,APARTMENT,MULTI-RES,95200,0,95200,436000,0,531200
190940200100000,FAST FOOD,COMMERCIAL,0,384000,384000,0,553900,937900
190940200400000,VACANT LAND,EXEMPT,0,585000,585000,0,0,585000
190940200500000,CONVENIENCE STORE,COMMERCIAL,0,320000,320000,0,857900,1177900
190940200502000,BILLBOARD(BLL),COMMERCIAL,0,0,0,0,12200,12200
190942600100000,SW 426,RESIDENTIAL,22300,0,22300,67700,0,90000
190942600200000,SW 426,RESIDENTIAL,22300,0,22300,77900,0,100200
190942700100000,WAREHOUSE;MINI STORG,COMMERCIAL,9000,441000,450000,87066,1706634,2243700
190942700200000,SW 426,RESIDENTIAL,19800,0,19800,81000,0,100800
190942700300000,SW 426,RESIDENTIAL,19800,0,19800,84600,0,104400
190942700400000,SW 426,RESIDENTIAL,19800,0,19800,102800,0,122600
190942700500000,SW 426,RESIDENTIAL,19800,0,19800,72200,0,92000
190942700600000,SW 426,RESIDENTIAL,19800,0,19800,86800,0,106600
190942700700000,SW 426,RESIDENTIAL,22700,0,22700,79900,0,102600
190942700800000,SW 426,RESIDENTIAL,21400,0,21400,77000,0,98400
190942700900000,SW 426,RESIDENTIAL,21400,0,21400,95600,0,117000
190942701000000,SW 426,RESIDENTIAL,21400,0,21400,106700,0,128100
190942701100000,SW 426,RESIDENTIAL,21400,0,21400,64800,0,86200
190942701200000,SW 426,RESIDENTIAL,22700,0,22700,92500,0,115200
190942701300000,SW 426,RESIDENTIAL,21200,0,21200,121100,0,142300
190942701400000,SW 426,RESIDENTIAL,20600,0,20600,73200,0,93800
190942701500000,SW 426,RESIDENTIAL,20200,0,20200,65000,0,85200
190942800100000,SW 426,RESIDENTIAL,16300,0,16300,102900,0,119200
190942800200000,SW 426,RESIDENTIAL,21800,0,21800,3800,0,25600
190942800300000,SW 426,RESIDENTIAL,24400,0,24400,101500,0,125900
190942800400000,SW 426,RESIDENTIAL,13900,0,13900,63000,0,76900
190942800500000,SW 426,RESIDENTIAL,23000,0,23000,86200,0,109200
190942900100000,SW 426,RESIDENTIAL,21900,0,21900,101800,0,123700
190942900200000,SW 426,RESIDENTIAL,20800,0,20800,75000,0,95800
190942900300000,SW 426,RESIDENTIAL,21300,0,21300,75600,0,96900
190942900400000,SW 426,RESIDENTIAL,21300,0,21300,65400,0,86700
190942900500000,SW 426,RESIDENTIAL,21300,0,21300,97600,0,118900
190942900600000,SW 426,RESIDENTIAL,20700,0,20700,92200,0,112900
190942900700000,SW 426,RESIDENTIAL,20700,0,20700,113000,0,133700
190942900800000,SW 426,RESIDENTIAL,20700,0,20700,89200,0,109900
190942900900000,SW 426,RESIDENTIAL,20700,0,20700,86700,0,107400
190942901000000,SW 426,RESIDENTIAL,20700,0,20700,68800,0,89500
190943000100000,SW 426,RESIDENTIAL,21600,0,21600,90900,0,112500
190943000200000,SW 426,RESIDENTIAL,21300,0,21300,79300,0,100600
190943000300000,SW 426,RESIDENTIAL,22000,0,22000,87200,0,109200
190943000400000,SW 426,RESIDENTIAL,21000,0,21000,68400,0,89400
190943000500000,SW 426,RESIDENTIAL,21300,0,21300,68600,0,89900
190943000600000,SW 426,RESIDENTIAL,22500,0,22500,57600,0,80100
190943100100000,SW 426,RESIDENTIAL,21800,0,21800,72900,0,94700
190943100200000,SW 426,RESIDENTIAL,21500,0,21500,74500,0,96000
190943100300000,SW 426,RESIDENTIAL,20900,0,20900,63800,0,84700
190943100400000,SW 426,RESIDENTIAL,21300,0,21300,62700,0,84000
190943100500000,SW 426,RESIDENTIAL,21300,0,21300,68300,0,89600
190945100100000,SW 426,RESIDENTIAL,22300,0,22300,69700,0,92000
190945100200000,SW 426,RESIDENTIAL,21900,0,21900,77300,0,99200
190945100300000,SW 426,RESIDENTIAL,21200,0,21200,100700,0,121900
190945100400000,SW 426,RESIDENTIAL,21800,0,21800,78300,0,100100
190945100500000,SW 426,RESIDENTIAL,21700,0,21700,65500,0,87200
190945100600000,SW 426,RESIDENTIAL,21700,0,21700,67200,0,88900
190945100700000,SW 426,RESIDENTIAL,21700,0,21700,78300,0,100000
190945100800000,SW 426,RESIDENTIAL,21900,0,21900,101000,0,122900
190945100900000,SW 426,RESIDENTIAL,20700,0,20700,76400,0,97100
190945200100000,SW 426,RESIDENTIAL,20700,0,20700,96800,0,117500
190945200200000,SW 426,RESIDENTIAL,21300,0,21300,71000,0,92300
190945200300000,SW 426,RESIDENTIAL,21300,0,21300,71500,0,92800
190945200400000,SW 426,RESIDENTIAL,21300,0,21300,62200,0,83500
190945200500000,SW 426,RESIDENTIAL,21000,0,21000,104600,0,125600
190945200600000,SW 426,RESIDENTIAL,21600,0,21600,108100,0,129700
190945200700000,SW 426,RESIDENTIAL,21400,0,21400,66200,0,87600
190945200800000,SW 426,RESIDENTIAL,22300,0,22300,72200,0,94500
190945200900000,SW 426,RESIDENTIAL,21500,0,21500,67600,0,89100
190945201000000,SW 426,RESIDENTIAL,22400,0,22400,89600,0,112000
190945201100000,SW 426,RESIDENTIAL,23000,0,23000,99600,0,122600
190945201200000,SW 426,RESIDENTIAL,22300,0,22300,67300,0,89600
190945201300000,SW 426,RESIDENTIAL,23700,0,23700,79800,0,103500
190945201400000,SW 426,RESIDENTIAL,21300,0,21300,82400,0,103700
190945201500000,SW 426,RESIDENTIAL,21700,0,21700,75100,0,96800
190945201600000,SW 426,RESIDENTIAL,21400,0,21400,68700,0,90100
190945201700000,SW 426,RESIDENTIAL,21400,0,21400,89700,0,111100
190945201800000,SW 426,RESIDENTIAL,24000,0,24000,106000,0,130000
190945201900000,SW 426,RESIDENTIAL,20800,0,20800,98000,0,118800
190945202000000,SW 426,RESIDENTIAL,20700,0,20700,99900,0,120600
190945202100000,SW 426,RESIDENTIAL,20700,0,20700,113800,0,134500
190945202200000,SW 426,RESIDENTIAL,20700,0,20700,69300,0,90000
190945202300000,SW 426,RESIDENTIAL,21800,0,21800,101700,0,123500
190945202400000,SW 426,RESIDENTIAL,20700,0,20700,67800,0,88500
190945202500000,SW 426,RESIDENTIAL,20700,0,20700,66400,0,87100
190945202600000,SW 426,RESIDENTIAL,20700,0,20700,71500,0,92200
190945202700000,SW 426,RESIDENTIAL,20700,0,20700,93700,0,114400
190945300100000,SW 426,RESIDENTIAL,21300,0,21300,89600,0,110900
190945300200000,SW 426,RESIDENTIAL,21500,0,21500,67300,0,88800
190945300300000,SW 426,RESIDENTIAL,21500,0,21500,89500,0,111000
190945300400000,SW 426,RESIDENTIAL,21000,0,21000,70900,0,91900
190945300500000,SW 426,RESIDENTIAL,21500,0,21500,92600,0,114100
190945300600000,SW 426,RESIDENTIAL,22100,0,22100,64600,0,86700
190945300700000,SW 426,RESIDENTIAL,22200,0,22200,69700,0,91900
190945300800000,SW 426,RESIDENTIAL,22400,0,22400,92100,0,114500
190945300900000,SW 426,RESIDENTIAL,22400,0,22400,72100,0,94500
190945301000000,SW 426,RESIDENTIAL,23100,0,23100,74800,0,97900
190945301100000,SW 426,RESIDENTIAL,21300,0,21300,60800,0,82100
190945400100000,SW 426,RESIDENTIAL,21300,0,21300,85600,0,106900
190945400200000,SW 426,RESIDENTIAL,21300,0,21300,62200,0,83500
190945400300000,SW 426,RESIDENTIAL,21300,0,21300,73800,0,95100
190945400400000,SW 426,RESIDENTIAL,21300,0,21300,86500,0,107800
190945400500000,SW 426,RESIDENTIAL,21300,0,21300,111200,0,132500
190945400600000,SW 426,RESIDENTIAL,21300,0,21300,71400,0,92700
190945400700000,SW 426,RESIDENTIAL,21300,0,21300,67700,0,89000
190945400800000,SW 426,RESIDENTIAL,21300,0,21300,88200,0,109500
190945400900000,SW 426,RESIDENTIAL,21300,0,21300,78400,0,99700
190945401000000,SW 426,RESIDENTIAL,21300,0,21300,62700,0,84000
190945401100000,SW 426,RESIDENTIAL,21000,0,21000,104100,0,125100
190945401200000,SW 426,RESIDENTIAL,21500,0,21500,92200,0,113700
190945401300000,SW 426,RESIDENTIAL,21700,0,21700,91800,0,113500
190945401400000,SW 426,RESIDENTIAL,21300,0,21300,70300,0,91600
190945401500000,SW 426,RESIDENTIAL,21300,0,21300,76500,0,97800
190945401600000,SW 426,RESIDENTIAL,21300,0,21300,64200,0,85500
190945401700000,SW 426,RESIDENTIAL,21300,0,21300,88700,0,110000
190945401800000,SW 426,RESIDENTIAL,21300,0,21300,70900,0,92200
190945401900000,SW 426,RESIDENTIAL,21300,0,21300,73200,0,94500
190945402000000,SW 426,RESIDENTIAL,21300,0,21300,59200,0,80500
190945402100000,SW 426,RESIDENTIAL,21300,0,21300,77300,0,98600
190945500100000,SW 426,RESIDENTIAL,22300,0,22300,102900,0,125200
190945500200000,SW 426,RESIDENTIAL,20900,0,20900,70700,0,91600
190945500300000,SW 426,RESIDENTIAL,20900,0,20900,73400,0,94300
190945500400000,SW 426,RESIDENTIAL,20900,0,20900,84400,0,105300
190945600100000,SW 426,RESIDENTIAL,23400,0,23400,79100,0,102500
190945600200000,SW 426,RESIDENTIAL,2100,0,2100,0,0,2100
190945600300000,SW 426,RESIDENTIAL,21200,0,21200,84100,0,105300
190945600400000,SW 426,RESIDENTIAL,21200,0,21200,83500,0,104700
190945600500000,SW 426,RESIDENTIAL,21100,0,21100,100800,0,121900
190945600600000,SW 426,RESIDENTIAL,21500,0,21500,84000,0,105500
190945600700000,SW 426,RESIDENTIAL,21500,0,21500,78000,0,99500
190945600800000,SW 426,RESIDENTIAL,21300,0,21300,80800,0,102100
190945700100000,SW 426,RESIDENTIAL,25500,0,25500,107800,0,133300
190945700200000,SW 426,RESIDENTIAL,22500,0,22500,77500,0,100000
190945700300000,SW 426,RESIDENTIAL,20900,0,20900,77700,0,98600
190945700400000,SW 426,RESIDENTIAL,22100,0,22100,67500,0,89600
190945800100000,SW 426,RESIDENTIAL,20700,0,20700,67700,0,88400
190945800200000,SW 426,RESIDENTIAL,21300,0,21300,92000,0,113300
190945800300000,SW 426,RESIDENTIAL,21600,0,21600,77600,0,99200
190945800400000,SW 426,RESIDENTIAL,21500,0,21500,70000,0,91500
190945800500000,SW 426,RESIDENTIAL,21000,0,21000,86800,0,107800
190947600500000,SECTION 42,COMMERCIAL,0,41000,41000,0,116500,157500
190947600600000,REG SHOPPING CENTER,COMMERCIAL,0,447500,447500,0,1085200,1532700
190947600700000,SCHOOL,EXEMPT,0,969600,969600,0,3875800,4845400
190947600800000,APARTMENT,MULTI-RES,393600,0,393600,2430200,0,2823800
191010100100000,PAPER; INDUSTRIAL,INDUSTRIAL,0,2619800,2619800,0,38398500,41018300
191020100100000,CENTRALLY ASSESSED,OTHER,0,0,0,0,0,0
191020100500000,WAREHOUSE,COMMERCIAL,0,780500,780500,0,6298400,7078900
191020100700000,VACANT LAND,COMMERCIAL,0,712500,712500,0,0,712500
191020100800000,SW 422,AG LAND,700,0,700,0,0,700
191020200100000,WAREHOUSE,COMMERCIAL,0,500300,500300,0,1534500,2034800
191020200200000,SHOP,COMMERCIAL,0,249700,249700,0,676700,926400
191022600200000,VACANT LAND,INDUSTRIAL,0,55000,55000,0,0,55000
191022600300000,MATERIALS MFG;INDUST,INDUSTRIAL,0,702500,702500,0,4437700,5140200
191022600400000,WAREHOUSE,INDUSTRIAL,0,186300,186300,0,961800,1148100
191022700200000,VACANT LAND,COMMERCIAL,0,211000,211000,0,0,211000
191022700300000,EQUIPMENT MFG;INDUST,INDUSTRIAL,0,529500,529500,0,3357300,3886800
191022700400000,OFFICE,COMMERCIAL,0,400000,400000,0,950400,1350400
191025100100000,WAREHOUSE,COMMERCIAL,0,240000,240000,0,570600,810600
191025100200000,WAREHOUSE,COMMERCIAL,0,300000,300000,0,1174300,1474300
191025100300000,WAREHOUSE,COMMERCIAL,0,232000,232000,0,551800,783800
191025100400000,VACANT LAND,COMMERCIAL,0,308300,308300,0,0,308300
191025200100000,CONC/ASPH;INDUSTRIAL,INDUSTRIAL,0,810300,810300,0,1164100,1974400
191025200200000,OFFICE,COMMERCIAL,0,387200,387200,0,1663400,2050600
191027600100000,WAREHOUSE,COMMERCIAL,0,518000,518000,0,972600,1490600
191027600200000,WAREHOUSE,COMMERCIAL,0,340000,340000,0,1228600,1568600
191027700200000,WAREHOUSE,COMMERCIAL,0,804800,804800,0,1536200,2341000
191027700300000,ANTENNAS/TOWERS(BLL),COMMERCIAL,0,433300,433300,0,66000,499300
191032600200000,SW 456,AG LAND,14500,0,14500,0,0,14500
191035100100000,STATE PROPERTY,EXEMPT,0,0,0,0,0,0
191035100600000,NBHD SHOPPING CENTER,COMMERCIAL,0,214000,214000,0,594500,808500
191035101100000,OFFICE,COMMERCIAL,0,33100,33100,0,89700,122800
191035101200000,CARWASH,COMMERCIAL,0,108000,108000,0,190700,298700
191037600100000,MFG HOME PARK,MULTI-RES,3889000,0,3889000,3102500,0,6991500
191040100200000,VACANT LAND,AG LAND,4400,0,4400,0,0,4400
191040100300000,VACANT LAND,AG LAND,9900,0,9900,0,0,9900
191040100400000,OFFICE,COMMERCIAL,0,639000,639000,0,8365400,9004400
191040200100000,VACANT LAND,AG LAND,7500,0,7500,0,0,7500
191040300100000,VACANT LAND,COMMERCIAL,0,1700,1700,0,0,1700
191042600100000,VACANT LAND,AG LAND,4400,0,4400,0,0,4400
191042600200000,VACANT LAND,AG LAND,5800,0,5800,0,0,5800
191042600300000,SCHOOL,EXEMPT,0,550300,550300,0,1118900,1669200
191042600400000,VACANT LAND,AG LAND,13400,0,13400,0,0,13400
191042600500000,VACANT LAND,AG LAND,10400,0,10400,0,0,10400
191042600600000,VACANT LAND,AG LAND,11000,0,11000,0,0,11000
191042600700000,VACANT LAND,AG LAND,11100,0,11100,0,0,11100
191042600800000,VACANT LAND,AG LAND,10100,0,10100,0,0,10100
191045100200000,DAY CARE CENTER,COMMERCIAL,0,30500,30500,0,2072400,2102900
191045100300000,SW 422,AG LAND,11500,0,11500,0,0,11500
191047600200000,FLAT PARKING,COMMERCIAL,0,41500,41500,0,71500,113000
191047600300000,SW 456,AG LAND,102000,0,102000,0,2700,104700
191110100100000,SW 422,AG LAND,48000,0,48000,0,0,48000
191110100200000,SW 422,AG LAND,26900,0,26900,0,0,26900
191112600100000,SW 423,RESIDENTIAL,36300,0,36300,256700,0,293000
191112600200000,SW 423,RESIDENTIAL,36300,0,36300,129300,0,165600
191112600300000,SW 423,RESIDENTIAL,36600,0,36600,181000,0,217600
191112700100000,SW 423,AG LAND,54400,0,54400,0,0,54400
191112700200000,CITY PROPERTY,EXEMPT,0,0,0,0,0,0
191112700300000,SW 423,RESIDENTIAL,45500,0,45500,48600,0,94100
191112700400000,SW 423,RESIDENTIAL,45200,0,45200,159200,0,204400
191112700500000,SW 423,RESIDENTIAL,37500,0,37500,50600,0,88100
191112700600000,SW 423,RESIDENTIAL,36900,0,36900,100900,0,137800
191112700700000,SW 423,RESIDENTIAL,11500,0,11500,0,0,11500
191112700800000,SW 423,RESIDENTIAL,36700,0,36700,81600,0,118300
191112700900000,SW 423,RESIDENTIAL,34200,0,34200,74700,0,108900
191112701100000,SW 423,RESIDENTIAL,34200,0,34200,152100,0,186300
191112701200000,SW 423,RESIDENTIAL,35200,0,35200,51800,0,87000
191115100100000,SW 423,RESIDENTIAL,36600,0,36600,151100,0,187700
191115100200000,SW 423,RESIDENTIAL,36600,0,36600,73700,0,110300
191115100300000,SW 423,RESIDENTIAL,36600,0,36600,112800,0,149400
191115100400000,SW 423,RESIDENTIAL,36600,0,36600,113000,0,149600
191115100500000,SW 423,RESIDENTIAL,36600,0,36600,67600,0,104200
191115100600000,SW 423,RESIDENTIAL,36600,0,36600,82600,0,119200
191115100700000,SW 423,RESIDENTIAL,36900,0,36900,108500,0,145400
191115100800000,SW 423,RESIDENTIAL,58000,0,58000,74200,0,132200
191115200100000,SW 423,RESIDENTIAL,33200,0,33200,78200,0,111400
191115200200000,SW 423,RESIDENTIAL,49700,0,49700,68200,0,117900
191115200300000,SW 423,RESIDENTIAL,40200,0,40200,0,0,40200
191115200400000,SW 423,RESIDENTIAL,39500,0,39500,55500,0,95000
191115200500000,SW 423,RESIDENTIAL,43600,0,43600,36300,0,79900
191115200600000,SW 423,RESIDENTIAL,39600,0,39600,26100,0,65700
191115200700000,SW 423,RESIDENTIAL,32900,0,32900,30300,0,63200
191115200800000,SW 423,RESIDENTIAL,14300,0,14300,132700,0,147000
191115200900000,SW 423,RESIDENTIAL,22100,0,22100,59200,0,81300
191115201000000,SW 423,RESIDENTIAL,21900,0,21900,43900,0,65800
191115201100000,SW 423,RESIDENTIAL,37300,0,37300,57100,0,94400
191115201200000,SW 423,RESIDENTIAL,37000,0,37000,54900,0,91900
191115201300000,SW 423,RESIDENTIAL,37000,0,37000,61900,0,98900
191115201400000,SW 423,RESIDENTIAL,29800,0,29800,114500,0,144300
191115201500000,SW 423,RESIDENTIAL,11800,0,11800,61600,0,73400
191115300100000,SW 423,RESIDENTIAL,44500,0,44500,47600,0,92100
191115300200000,SW 423,RESIDENTIAL,47900,0,47900,69900,0,117800
191115300300000,SW 423,RESIDENTIAL,46800,0,46800,41000,0,87800
191115300400000,SW 423,RESIDENTIAL,8600,0,8600,0,0,8600
191115300500000,SW 423,RESIDENTIAL,37600,0,37600,128400,0,166000
191117600100000,SW 422,AG LAND,86100,0,86100,0,0,86100
191117800100000,SW 423,RESIDENTIAL,58800,0,58800,116000,0,174800
191120100200000,SW 423,RESIDENTIAL,33200,0,33200,92800,0,126000
191120100300000,SW 423,RESIDENTIAL,33300,0,33300,105700,0,139000
191120100400000,SW 423,RESIDENTIAL,45600,0,45600,67000,0,112600
191120100500000,SW 423,RESIDENTIAL,35400,0,35400,30300,0,65700
191120100600000,SW 423,RESIDENTIAL,35400,0,35400,145400,0,180800
191120100700000,SW 423,RESIDENTIAL,35400,0,35400,104600,0,140000
191120100800000,SW 423,RESIDENTIAL,35400,0,35400,122400,0,157800
191120100900000,SW 423,RESIDENTIAL,35700,0,35700,0,0,35700
191120101000000,SW 423,RESIDENTIAL,48900,0,48900,167700,0,216600
191120101100000,SW 423,RESIDENTIAL,45300,0,45300,56200,0,101500
191120101200000,SW 423,RESIDENTIAL,45600,0,45600,23600,0,69200
191120101300000,SW 458,RESIDENTIAL,40800,0,40800,190700,0,231500
191120101400000,SW 458,RESIDENTIAL,38800,0,38800,164100,0,202900
191120101500000,SW 458,RESIDENTIAL,34000,0,34000,137700,0,171700
191120101600000,SW 458,RESIDENTIAL,38800,0,38800,159700,0,198500
191120101700000,SW 458,RESIDENTIAL,36400,0,36400,159900,0,196300
191120101800000,SW 458,RESIDENTIAL,34000,0,34000,144700,0,178700
191120101900000,SW 458,RESIDENTIAL,36400,0,36400,193300,0,229700
191120102000000,SW 458,RESIDENTIAL,38800,0,38800,145000,0,183800
191120102100000,SW 458,RESIDENTIAL,34000,0,34000,153400,0,187400
191120102200000,SW 458,RESIDENTIAL,38800,0,38800,179300,0,218100
191120102300000,SW 458,RESIDENTIAL,38800,0,38800,159100,0,197900
191120102400000,SW 458,RESIDENTIAL,36400,0,36400,145000,0,181400
191120102500000,SW 458,RESIDENTIAL,34000,0,34000,147800,0,181800
191120102600000,SW 458,RESIDENTIAL,31500,0,31500,0,0,31500
191120102700000,SW 458,RESIDENTIAL,34000,0,34000,136600,0,170600
191120102800000,SW 458,RESIDENTIAL,31500,0,31500,155700,0,187200
191120102900000,SW 458,RESIDENTIAL,34000,0,34000,158900,0,192900
191120103000000,SW 458,RESIDENTIAL,41200,0,41200,151800,0,193000
191120200100000,SW 458,RESIDENTIAL,39000,0,39000,189700,0,228700
191120200200000,SW 458,RESIDENTIAL,41300,0,41300,200400,0,241700
191120200300000,SW 458,RESIDENTIAL,41000,0,41000,193000,0,234000
191120200400000,SW 458,RESIDENTIAL,39100,0,39100,226100,0,265200
191120200500000,SW 458,RESIDENTIAL,39500,0,39500,227200,0,266700
191120200600000,SW 458,RESIDENTIAL,39500,0,39500,243900,0,283400
191120200700000,SW 458,RESIDENTIAL,41900,0,41900,203500,0,245400
191120300100000,SW 458,RESIDENTIAL,41500,0,41500,192300,0,233800
191120300200000,SW 458,RESIDENTIAL,35900,0,35900,156300,0,192200
191120300300000,SW 458,RESIDENTIAL,34000,0,34000,159000,0,193000
191120300400000,SW 458,RESIDENTIAL,38500,0,38500,188100,0,226600
191120300500000,SW 458,RESIDENTIAL,34000,0,34000,167700,0,201700
191120300600000,SW 458,RESIDENTIAL,35900,0,35900,185500,0,221400
191120300700000,SW 458,RESIDENTIAL,34000,0,34000,153600,0,187600
191120300800000,SW 458,RESIDENTIAL,39800,0,39800,182300,0,222100
191120300900000,SW 458,RESIDENTIAL,34000,0,34000,166300,0,200300
191120301000000,SW 458,RESIDENTIAL,37400,0,37400,165500,0,202900
191120301100000,SW 458,RESIDENTIAL,41500,0,41500,124800,0,166300
191120301200000,SW 458,RESIDENTIAL,43700,0,43700,169000,0,212700
191120301300000,SW 458,RESIDENTIAL,37400,0,37400,160300,0,197700
191120301400000,SW 458,RESIDENTIAL,34000,0,34000,173600,0,207600
191120301500000,SW 458,RESIDENTIAL,39800,0,39800,176800,0,216600
191120301600000,SW 458,RESIDENTIAL,34000,0,34000,162900,0,196900
191120301700000,SW 458,RESIDENTIAL,35900,0,35900,157000,0,192900
191120301800000,SW 458,RESIDENTIAL,34000,0,34000,164400,0,198400
191120301900000,SW 458,RESIDENTIAL,39800,0,39800,158600,0,198400
191120302000000,SW 458,RESIDENTIAL,34000,0,34000,157700,0,191700
191120302100000,SW 458,RESIDENTIAL,35900,0,35900,155400,0,191300
191120302200000,SW 458,RESIDENTIAL,43700,0,43700,193500,0,237200
191120400100000,SW 458,RESIDENTIAL,41400,0,41400,179100,0,220500
191120400200000,SW 458,RESIDENTIAL,37800,0,37800,145500,0,183300
191120400300000,SW 458,RESIDENTIAL,38200,0,38200,174600,0,212800
191120400400000,CITY PROPERTY,EXEMPT,0,0,0,0,0,0
191120400500000,SW 458,RESIDENTIAL,34500,0,34500,174000,0,208500
191120400600000,SW 458,RESIDENTIAL,34500,0,34500,178500,0,213000
191120400700000,SW 458,RESIDENTIAL,32200,0,32200,188600,0,220800
191120400800000,SW 458,RESIDENTIAL,32200,0,32200,175800,0,208000
191120400900000,SW 458,RESIDENTIAL,32200,0,32200,164300,0,196500
191120401000000,SW 458,RESIDENTIAL,49300,0,49300,198000,0,247300
191120401100000,SW 458,RESIDENTIAL,54400,0,54400,205300,0,259700
191120500100000,SW 458,RESIDENTIAL,43700,0,43700,197200,0,240900
191120500200000,SW 458,RESIDENTIAL,35900,0,35900,151900,0,187800
191120500300000,SW 458,RESIDENTIAL,34000,0,34000,172200,0,206200
191120500400000,SW 458,RESIDENTIAL,39800,0,39800,188700,0,228500
191120500500000,SW 458,RESIDENTIAL,34000,0,34000,146000,0,180000
191120500600000,SW 458,RESIDENTIAL,35900,0,35900,188400,0,224300
191120500700000,SW 458,RESIDENTIAL,34000,0,34000,174500,0,208500
191120500800000,SW 458,RESIDENTIAL,39800,0,39800,192800,0,232600
191120500900000,SW 458,RESIDENTIAL,34000,0,34000,161200,0,195200
191120501000000,SW 458,RESIDENTIAL,37400,0,37400,207300,0,244700
191120501100000,SW 458,RESIDENTIAL,43700,0,43700,166000,0,209700
191120501200000,SW 458,RESIDENTIAL,43700,0,43700,191400,0,235100
191120501300000,SW 458,RESIDENTIAL,37300,0,37300,177700,0,215000
191120501400000,SW 458,RESIDENTIAL,34000,0,34000,142900,0,176900
191120501500000,SW 458,RESIDENTIAL,39800,0,39800,204700,0,244500
191120501600000,SW 458,RESIDENTIAL,34000,0,34000,175300,0,209300
191120501700000,SW 458,RESIDENTIAL,35900,0,35900,186800,0,222700
191120501800000,SW 458,RESIDENTIAL,34000,0,34000,148500,0,182500
191120501900000,SW 458,RESIDENTIAL,39800,0,39800,195700,0,235500
191120502000000,SW 458,RESIDENTIAL,34000,0,34000,161200,0,195200
191120502100000,SW 458,RESIDENTIAL,35900,0,35900,192600,0,228500
191120502200000,SW 458,RESIDENTIAL,43700,0,43700,184400,0,228100
191120600100000,SW 458,RESIDENTIAL,37800,0,37800,167200,0,205000
191120600200000,SW 458,RESIDENTIAL,34000,0,34000,148300,0,182300
191120600300000,SW 458,RESIDENTIAL,34000,0,34000,170700,0,204700
191120600400000,SW 458,RESIDENTIAL,36400,0,36400,168400,0,204800
191120600500000,SW 458,RESIDENTIAL,34000,0,34000,174100,0,208100
191120600600000,SW 458,RESIDENTIAL,34000,0,34000,184400,0,218400
191120600700000,SW 458,RESIDENTIAL,38800,0,38800,188400,0,227200
191120600800000,SW 458,RESIDENTIAL,36400,0,36400,202200,0,238600
191120600900000,SW 458,RESIDENTIAL,34000,0,34000,145500,0,179500
191120601000000,SW 458,RESIDENTIAL,34000,0,34000,172800,0,206800
191120601100000,SW 458,RESIDENTIAL,37300,0,37300,188000,0,225300
191120601200000,SW 458,RESIDENTIAL,34000,0,34000,165500,0,199500
191120601300000,SW 458,RESIDENTIAL,36400,0,36400,178800,0,215200
191120601400000,SW 458,RESIDENTIAL,38800,0,38800,164200,0,203000
191120601500000,SW 458,RESIDENTIAL,34000,0,34000,145400,0,179400
191120601600000,SW 458,RESIDENTIAL,34000,0,34000,145400,0,179400
191120601700000,SW 458,RESIDENTIAL,34000,0,34000,211200,0,245200
191120601800000,SW 458,RESIDENTIAL,59100,0,59100,249400,0,308500
191122600100000,SW 422,AG LAND,2900,0,2900,0,0,2900
191122700100000,MISCELLANEOUS,COMMERCIAL,0,20400,20400,0,48800,69200
191122700102000,BILLBOARD(BLL),COMMERCIAL,0,0,0,0,11500,11500
191122700200000,FOOD GRADE;INDUST,INDUSTRIAL,0,776500,776500,0,5957000,6733500
191122700300000,CENTRALLY ASSESSED,OTHER,0,0,0,0,0,0
191122700700000,FOOD GRADE;INDUST,INDUSTRIAL,0,512200,512200,0,3314000,3826200
191125100100000,VACANT LAND,INDUSTRIAL,0,199300,199300,0,0,199300
191127600200000,SW 423,RESIDENTIAL,45200,0,45200,51500,0,96700
191127600300000,SW 423,RESIDENTIAL,38200,0,38200,67700,0,105900
191127600400000,SW 423,RESIDENTIAL,12500,0,12500,4000,0,16500
191127600500000,SW 423,RESIDENTIAL,7500,0,7500,24600,0,32100
191127600600000,SW 423,RESIDENTIAL,24500,0,24500,0,0,24500
191127600700000,SW 423,RESIDENTIAL,2700,0,2700,0,0,2700
191127601000000,SW 423,RESIDENTIAL,40800,0,40800,236400,0,277200
191127601100000,SW 423,RESIDENTIAL,37500,0,37500,61600,0,99100
191127601200000,SW 423,RESIDENTIAL,35600,0,35600,55800,0,91400
191127601300000,SW 423,RESIDENTIAL,41600,0,41600,126800,0,168400
191127601400000,SW 423,RESIDENTIAL,37600,0,37600,106300,0,143900
191127601500000,SW 423,RESIDENTIAL,34700,0,34700,41200,0,75900
191127601600000,SW 423,RESIDENTIAL,35300,0,35300,41900,0,77200
191127601700000,SW 423,RESIDENTIAL,35700,0,35700,69800,0,105500
191127601800000,SW 423,RESIDENTIAL,45900,0,45900,65900,0,111800
191127601900000,SW 423,RESIDENTIAL,40700,0,40700,1100,0,41800
191127602000000,SW 423,RESIDENTIAL,24900,0,24900,76200,0,101100
191127602100000,SW 423,RESIDENTIAL,25800,0,25800,155600,0,181400
191127602300000,SW 423,RESIDENTIAL,37300,0,37300,163300,0,200600
191127602400000,SW 423,RESIDENTIAL,32000,0,32000,0,0,32000
191127602500000,SW 423,RESIDENTIAL,46200,0,46200,156200,0,202400
191127602600000,SW 423,RESIDENTIAL,46900,0,46900,70500,0,117400
191127700100000,SW 422,RESIDENTIAL,49400,0,49400,148000,0,197400
191127700200000,SW 422,RESIDENTIAL,50300,0,50300,90600,0,140900
191127700300000,SW 422,RESIDENTIAL,46700,0,46700,86500,0,133200
191127900100000,SW 423,RESIDENTIAL,32000,0,32000,94200,0,126200
191127900200000,SW 423,RESIDENTIAL,32800,0,32800,119400,0,152200
191127900300000,SW 423,RESIDENTIAL,48500,0,48500,136900,0,185400
191127900400000,SW 423,RESIDENTIAL,2300,0,2300,0,0,2300
191127900500000,SW 423,RESIDENTIAL,31500,0,31500,86500,0,118000
191132600100000,WAREHOUSE,COMMERCIAL,0,1095800,1095800,0,7269600,8365400
191135100200000,SW 450,RESIDENTIAL,41000,0,41000,100000,0,141000
191135100300000,SW 450,RESIDENTIAL,39000,0,39000,130000,0,169000
191135100400000,SW 450,RESIDENTIAL,39200,0,39200,165100,0,204300
191135100500000,SW 450,RESIDENTIAL,40200,0,40200,140600,0,180800
191135100600000,SW 450,RESIDENTIAL,39000,0,39000,163900,0,202900
191135100700000,SW 450,RESIDENTIAL,38700,0,38700,140700,0,179400
191135100800000,SW 450,RESIDENTIAL,39000,0,39000,143500,0,182500
191135100900000,SW 450,RESIDENTIAL,39000,0,39000,162100,0,201100
191135101000000,SW 450,RESIDENTIAL,39000,0,39000,138700,0,177700
191135101100000,SW 450,RESIDENTIAL,39000,0,39000,134800,0,173800
191135101200000,SW 450,RESIDENTIAL,39400,0,39400,154500,0,193900
191135101300000,SW 450,RESIDENTIAL,38200,0,38200,115500,0,153700
191135101600000,SW 450,RESIDENTIAL,35900,0,35900,110000,0,145900
191135101700000,SW 450,RESIDENTIAL,32200,0,32200,115400,0,147600
191135101900000,SW 450,RESIDENTIAL,41500,0,41500,138100,0,179600
191135102000000,SW 450,RESIDENTIAL,46800,0,46800,147100,0,193900
191135102100000,SW 450,RESIDENTIAL,47300,0,47300,128600,0,175900
191135102200000,SW 450,RESIDENTIAL,42000,0,42000,158100,0,200100
191135102300000,SW 450,RESIDENTIAL,50800,0,50800,159900,0,210700
191135200100000,SW 450,RESIDENTIAL,41300,0,41300,140200,0,181500
191135200200000,SW 450,RESIDENTIAL,37000,0,37000,156100,0,193100
191135300100000,SW 450,RESIDENTIAL,38800,0,38800,156400,0,195200
191135300200000,SW 450,RESIDENTIAL,41600,0,41600,155700,0,197300
191135300300000,SW 450,RESIDENTIAL,39000,0,39000,158500,0,197500
191135300400000,SW 450,RESIDENTIAL,40400,0,40400,149600,0,190000
191135400100000,SW 450,RESIDENTIAL,39000,0,39000,146000,0,185000
191135400200000,SW 450,RESIDENTIAL,39000,0,39000,177600,0,216600
191135400300000,SW 450,RESIDENTIAL,39000,0,39000,132300,0,171300
191135400400000,SW 450,RESIDENTIAL,48500,0,48500,158200,0,206700
191135400500000,SW 450,RESIDENTIAL,41000,0,41000,159200,0,200200
191135400600000,SW 450,RESIDENTIAL,41000,0,41000,161000,0,202000
191135400700000,SW 450,RESIDENTIAL,40400,0,40400,163100,0,203500
191135400800000,SW 450,RESIDENTIAL,39000,0,39000,166200,0,205200
191135500200000,CARWASH,COMMERCIAL,0,182200,182200,0,212300,394500
191135500300000,NBHD SHOPPING CENTER,COMMERCIAL,0,528600,528600,0,1704700,2233300
191135500400000,VACANT LAND,COMMERCIAL,0,175500,175500,0,0,175500
191135500500000,CONVENIENCE STORE,COMMERCIAL,0,387000,387000,0,732800,1119800
191135600100000,DAY CARE CENTER,COMMERCIAL,0,264000,264000,0,624700,888700
191135700100000,SW 450,RESIDENTIAL,39500,0,39500,177600,0,217100
191135700200000,SW 450,RESIDENTIAL,36500,0,36500,159500,0,196000
191137700200000,CITY PROPERTY,EXEMPT,0,0,0,0,0,0
191137701200000,SW 450,RESIDENTIAL,37700,0,37700,128900,0,166600
191137701300000,SW 450,RESIDENTIAL,42900,0,42900,150300,0,193200
191137701400000,SW 450,RESIDENTIAL,39500,0,39500,150400,0,189900
191137701500000,SW 450,RESIDENTIAL,40900,0,40900,175200,0,216100
191137701600000,CITY PROPERTY,EXEMPT,0,0,0,0,0,0
191137701700000,SW 450,RESIDENTIAL,41000,0,41000,137700,0,178700
191137701800000,SW 450,RESIDENTIAL,40600,0,40600,157900,0,198500
191137701900000,SW 450,RESIDENTIAL,41000,0,41000,197500,0,238500
191137702000000,SW 450,RESIDENTIAL,41800,0,41800,178800,0,220600
191137702100000,SW 450,RESIDENTIAL,41400,0,41400,145400,0,186800
191137702200000,SW 450,RESIDENTIAL,40000,0,40000,179300,0,219300
191137702300000,SW 450,RESIDENTIAL,40000,0,40000,146900,0,186900
191137702400000,SW 450,RESIDENTIAL,39700,0,39700,159000,0,198700
191137702500000,SW 450,RESIDENTIAL,39700,0,39700,183600,0,223300
191137702600000,SW 450,RESIDENTIAL,39400,0,39400,177500,0,216900
191137702700000,SW 450,RESIDENTIAL,44800,0,44800,160400,0,205200
191137702800000,SW 450,RESIDENTIAL,41700,0,41700,191100,0,232800
191137702900000,SW 450,RESIDENTIAL,45500,0,45500,156300,0,201800
191137703200000,SW 450,RESIDENTIAL,41800,0,41800,137800,0,179600
191137703300000,SW 450,RESIDENTIAL,39000,0,39000,158600,0,197600
191137703400000,SW 450,RESIDENTIAL,36200,0,36200,162700,0,198900
191137703600000,SW 450,RESIDENTIAL,48400,0,48400,147500,0,195900
191137703700000,SW 450,RESIDENTIAL,53700,0,53700,164200,0,217900
191137800100000,SW 450,RESIDENTIAL,39300,0,39300,151900,0,191200
191137800200000,SW 450,RESIDENTIAL,42000,0,42000,163700,0,205700
191137800300000,SW 450,RESIDENTIAL,42400,0,42400,144700,0,187100
191137800400000,SW 450,RESIDENTIAL,42800,0,42800,160800,0,203600
191137800500000,SW 450,RESIDENTIAL,42800,0,42800,161800,0,204600
191137800600000,SW 450,RESIDENTIAL,44700,0,44700,162200,0,206900
191137800700000,SW 450,RESIDENTIAL,40500,0,40500,195600,0,236100
191137800800000,SW 450,RESIDENTIAL,38600,0,38600,156100,0,194700
191137800900000,SW 450,RESIDENTIAL,39000,0,39000,169900,0,208900
191137801000000,SW 450,RESIDENTIAL,38900,0,38900,156200,0,195100
191222600300000,SW 447,RESIDENTIAL,50400,0,50400,215100,0,265500
191222600400000,SW 447,RESIDENTIAL,81100,0,81100,218800,0,299900
191222600500000,SW 446,RESIDENTIAL,63400,0,63400,248600,0,312000
191222600600000,SW 446,RESIDENTIAL,61700,0,61700,309200,0,370900
191222600700000,SW 446,RESIDENTIAL,64900,0,64900,351000,0,415900
191222600800000,SW 446,RESIDENTIAL,72000,0,72000,236900,0,308900
191222600900000,SW 446,RESIDENTIAL,74700,0,74700,203600,0,278300
191222601000000,SW 446,RESIDENTIAL,64200,0,64200,246400,0,310600
191222601100000,SW 446,RESIDENTIAL,56900,0,56900,243000,0,299900
191222601200000,SW 446,RESIDENTIAL,66300,0,66300,299600,0,365900
191222601300000,SW 446,RESIDENTIAL,66600,0,66600,303400,0,370000
191222601400000,SW 446,RESIDENTIAL,85000,0,85000,342100,0,427100
191222601500000,SW 446,RESIDENTIAL,71800,0,71800,315700,0,387500
191222601600000,SW 446,RESIDENTIAL,73700,0,73700,289500,0,363200
191222601700000,SW 446,RESIDENTIAL,77400,0,77400,278200,0,355600
191222601800000,SW 446,RESIDENTIAL,63700,0,63700,299400,0,363100
191222601900000,SW 446,RESIDENTIAL,63700,0,63700,248600,0,312300
191222602000000,SW 446,RESIDENTIAL,63700,0,63700,291400,0,355100
191222602100000,SW 446,RESIDENTIAL,67400,0,67400,282400,0,349800
191222602200000,SW 446,RESIDENTIAL,67400,0,67400,236900,0,304300
191222602400000,SW 446,RESIDENTIAL,48200,0,48200,0,0,48200
191222602500000,SW 446,RESIDENTIAL,59900,0,59900,281200,0,341100
191222602600000,SW 446,RESIDENTIAL,59900,0,59900,262700,0,322600
191222602700000,SW 446,RESIDENTIAL,59900,0,59900,282500,0,342400
191222602800000,SW 446,RESIDENTIAL,58400,0,58400,288600,0,347000
191222602900000,SW 446,RESIDENTIAL,94800,0,94800,369400,0,464200
191222603000000,SW 446,RESIDENTIAL,86300,0,86300,284300,0,370600
191222603100000,SW 446,RESIDENTIAL,3900,0,3900,0,0,3900
191222603200000,SW 446,RESIDENTIAL,65100,0,65100,276100,0,341200
191222603300000,SW 446,RESIDENTIAL,63800,0,63800,280600,0,344400
191222603400000,SW 446,RESIDENTIAL,60700,0,60700,311000,0,371700
191222603500000,SW 446,RESIDENTIAL,60700,0,60700,296400,0,357100
191222603600000,SW 446,RESIDENTIAL,66500,0,66500,329900,0,396400
191222603700000,SW 447,AG LAND,16400,0,16400,0,0,16400
191222700100000,SW 447,RESIDENTIAL,0,0,0,0,0,0
191225200100000,SW 447,RESIDENTIAL,0,0,0,0,0,0
191225200200000,SW 447,RESIDENTIAL,40000,0,40000,206900,0,246900
191225200300000,SW 447,RESIDENTIAL,51500,0,51500,160300,0,211800
191225200400000,SW 447,RESIDENTIAL,51500,0,51500,177300,0,228800
191225200500000,SW 447,RESIDENTIAL,51500,0,51500,167200,0,218700
191225200600000,SW 447,RESIDENTIAL,58700,0,58700,189900,0,248600
191225200700000,SW 447,RESIDENTIAL,52300,0,52300,195700,0,248000
191225200800000,SW 447,RESIDENTIAL,59100,0,59100,179800,0,238900
191225200900000,SW 447,RESIDENTIAL,53200,0,53200,180400,0,233600
191225201000000,SW 447,RESIDENTIAL,49000,0,49000,166800,0,215800
191225201100000,SW 447,RESIDENTIAL,49300,0,49300,162600,0,211900
191225201200000,SW 447,RESIDENTIAL,0,0,0,0,0,0
191225201300000,SW 447,RESIDENTIAL,42400,0,42400,168700,0,211100
191225201400000,SW 447,RESIDENTIAL,48400,0,48400,172000,0,220400
191225201500000,SW 447,RESIDENTIAL,53000,0,53000,202800,0,255800
191225201600000,SW 447,RESIDENTIAL,52500,0,52500,215200,0,267700
191225201700000,SW 447,RESIDENTIAL,50400,0,50400,254500,0,304900
191225201800000,SW 447,RESIDENTIAL,52500,0,52500,212500,0,265000
191225201900000,SW 447,RESIDENTIAL,54600,0,54600,166000,0,220600
191225202000000,SW 447,RESIDENTIAL,54600,0,54600,218600,0,273200
191225202100000,SW 447,RESIDENTIAL,50400,0,50400,237500,0,287900
191225202200000,SW 447,RESIDENTIAL,53500,0,53500,229500,0,283000
191225202300000,SW 447,RESIDENTIAL,0,0,0,0,0,0
191225300100000,SW 447,RESIDENTIAL,54600,0,54600,216600,0,271200
191225300200000,SW 447,RESIDENTIAL,56000,0,56000,195500,0,251500
191225300300000,SW 447,RESIDENTIAL,52500,0,52500,220800,0,273300
191225300400000,SW 447,RESIDENTIAL,52500,0,52500,212000,0,264500
191225300500000,SW 447,RESIDENTIAL,56000,0,56000,212500,0,268500
191225300600000,SW 447,RESIDENTIAL,52500,0,52500,168500,0,221000
191225300700000,SW 447,RESIDENTIAL,50400,0,50400,217700,0,268100
191225300800000,SW 447,RESIDENTIAL,54600,0,54600,211700,0,266300
191225300900000,SW 447,RESIDENTIAL,48900,0,48900,222400,0,271300
191225301000000,SW 447,RESIDENTIAL,0,0,0,0,0,0
191225301100000,SW 446,RESIDENTIAL,0,0,0,0,0,0
191225301200000,SW 446,RESIDENTIAL,42000,0,42000,178400,0,220400
191225301500000,SW 446,RESIDENTIAL,54900,0,54900,290500,0,345400
191225301600000,SW 446,RESIDENTIAL,56000,0,56000,390500,0,446500
191225301700000,SW 446,RESIDENTIAL,57100,0,57100,243400,0,300500
191225301800000,SW 446,RESIDENTIAL,74900,0,74900,249500,0,324400
191225301900000,SW 446,RESIDENTIAL,59000,0,59000,201200,0,260200
191225302100000,SW 446,RESIDENTIAL,59300,0,59300,275000,0,334300
191225400100000,SW 447,RESIDENTIAL,0,0,0,0,0,0
191225400200000,SW 447,RESIDENTIAL,74200,0,74200,247000,0,321200
191225400300000,SW 447,RESIDENTIAL,75700,0,75700,243900,0,319600
191225400400000,SW 447,RESIDENTIAL,60600,0,60600,219700,0,280300
191225400500000,SW 447,RESIDENTIAL,57400,0,57400,270600,0,328000
191225400600000,SW 447,RESIDENTIAL,55000,0,55000,179200,0,234200
191225400700000,SW 447,RESIDENTIAL,55000,0,55000,216300,0,271300
191225400800000,SW 447,RESIDENTIAL,55000,0,55000,212900,0,267900
191225400900000,SW 447,RESIDENTIAL,55000,0,55000,166200,0,221200
191225401000000,SW 447,RESIDENTIAL,43500,0,43500,193800,0,237300
191225401100000,SW 447,RESIDENTIAL,0,0,0,0,0,0
191225401200000,SW 447,RESIDENTIAL,73400,0,73400,273500,0,346900
191225401300000,SW 447,RESIDENTIAL,78000,0,78000,195100,0,273100
191225401400000,SW 447,RESIDENTIAL,82100,0,82100,206900,0,289000
191225401500000,SW 447,RESIDENTIAL,79600,0,79600,242701,0,322301
191225401600000,SW 447,RESIDENTIAL,81800,0,81800,196000,0,277800
191225401700000,SW 447,RESIDENTIAL,92400,0,92400,203900,0,296300
191225500100000,SW 446,RESIDENTIAL,66200,0,66200,241800,0,308000
191225500200000,SW 446,RESIDENTIAL,65700,0,65700,253300,0,319000
191225500300000,SW 446,RESIDENTIAL,67400,0,67400,237200,0,304600
191225500400000,SW 446,RESIDENTIAL,67400,0,67400,247600,0,315000
191225500500000,SW 446,RESIDENTIAL,71600,0,71600,258100,0,329700
191225600100000,SW 447,RESIDENTIAL,61800,0,61800,213100,0,274900
191225600200000,SW 447,RESIDENTIAL,62600,0,62600,160000,0,222600
191225600300000,SW 447,RESIDENTIAL,70700,0,70700,216200,0,286900
191225600400000,SW 447,RESIDENTIAL,600,0,600,0,0,600
191225600500000,SW 446,RESIDENTIAL,78100,0,78100,310600,0,388700
191225700100000,SW 446,RESIDENTIAL,0,0,0,0,0,0
191227600100000,SW 447,AG LAND,40500,0,40500,0,0,40500
191412700200000,SW 449,RESIDENTIAL,35700,0,35700,0,0,35700
191412700300000,SW 449,RESIDENTIAL,37200,0,37200,0,0,37200
191412700400000,SW 449,RESIDENTIAL,42200,0,42200,187200,0,229400
191412700500000,SW 449,RESIDENTIAL,37600,0,37600,0,0,37600
191412700600000,SW 449,RESIDENTIAL,37900,0,37900,0,0,37900
191412700700000,SW 449,RESIDENTIAL,37900,0,37900,0,0,37900
191412700800000,SW 449,RESIDENTIAL,43600,0,43600,207700,0,251300
191412700900000,SW 449,RESIDENTIAL,38300,0,38300,0,0,38300
191412800100000,SW 449,RESIDENTIAL,34900,0,34900,0,0,34900
191412800200000,SW 449,RESIDENTIAL,34500,0,34500,0,0,34500
191412800300000,SW 449,RESIDENTIAL,34900,0,34900,0,0,34900
191412800400000,SW 449,RESIDENTIAL,35100,0,35100,0,0,35100
191412800500000,SW 449,RESIDENTIAL,50700,0,50700,158100,0,208800
191412800600000,SW 449,RESIDENTIAL,52700,0,52700,268200,0,320900
191412800700000,SW 449,RESIDENTIAL,53500,0,53500,213400,0,266900
191412900100000,SW 449,RESIDENTIAL,51700,0,51700,188200,0,239900
191412900200000,SW 449,RESIDENTIAL,52300,0,52300,176000,0,228300
191412900300000,SW 449,RESIDENTIAL,52300,0,52300,204200,0,256500
191412900400000,SW 449,RESIDENTIAL,53600,0,53600,206700,0,260300
191412900500000,SW 449,RESIDENTIAL,52300,0,52300,177600,0,229900
191412900600000,SW 449,RESIDENTIAL,51700,0,51700,181100,0,232800
191412900700000,SW 449,RESIDENTIAL,54000,0,54000,190600,0,244600
191412900800000,SW 449,RESIDENTIAL,44500,0,44500,0,0,44500
191412900900000,SW 449,RESIDENTIAL,48500,0,48500,198300,0,246800
191412901000000,SW 449,RESIDENTIAL,53900,0,53900,224200,0,278100
191412901100000,SW 449,RESIDENTIAL,52800,0,52800,210900,0,263700
191412901200000,SW 449,RESIDENTIAL,46200,0,46200,0,0,46200
191412901300000,SW 449,RESIDENTIAL,61400,0,61400,289200,0,350600
191412901400000,SW 449,RESIDENTIAL,58100,0,58100,285400,0,343500
191412901500000,SW 449,RESIDENTIAL,52300,0,52300,232700,0,285000
191412901600000,SW 449,RESIDENTIAL,46900,0,46900,0,0,46900
191412901700000,SW 449,RESIDENTIAL,46700,0,46700,0,0,46700
191412901800000,SW 449,RESIDENTIAL,52700,0,52700,195800,0,248500
191412901900000,SW 449,RESIDENTIAL,54300,0,54300,171800,0,226100
191412902000000,SW 449,RESIDENTIAL,52300,0,52300,197300,0,249600
191413000100000,SW 449,RESIDENTIAL,53700,0,53700,215000,0,268700
191413000200000,SW 449,RESIDENTIAL,54300,0,54300,227600,0,281900
191413000300000,SW 449,RESIDENTIAL,56500,0,56500,198900,0,255400
191413000400000,SW 449,RESIDENTIAL,53400,0,53400,237300,0,290700
191413000500000,SW 449,RESIDENTIAL,52300,0,52300,213500,0,265800
191413000600000,SW 449,RESIDENTIAL,52300,0,52300,230800,0,283100
191413000700000,SW 449,RESIDENTIAL,52800,0,52800,180000,0,232800
191413000800000,SW 449,RESIDENTIAL,46400,0,46400,0,0,46400
191413000900000,SW 449,RESIDENTIAL,52300,0,52300,178300,0,230600
191413001000000,SW 449,RESIDENTIAL,52300,0,52300,227600,0,279900
191413001100000,SW 449,RESIDENTIAL,52300,0,52300,227800,0,280100
191413100100000,SW 449,RESIDENTIAL,52300,0,52300,238900,0,291200
191413100200000,SW 449,RESIDENTIAL,46900,0,46900,0,0,46900
191413100300000,SW 449,RESIDENTIAL,53300,0,53300,229500,0,282800
191415200200000,SW 422,AG LAND,4900,0,4900,0,0,4900
191415300100000,SW 449,RESIDENTIAL,43600,0,43600,193100,0,236700
191415300200000,SW 449,RESIDENTIAL,37900,0,37900,0,0,37900
191415400100000,SW 449,RESIDENTIAL,52300,0,52300,233700,0,286000
191415400200000,SW 449,RESIDENTIAL,52300,0,52300,238500,0,290800
191415400300000,SW 449,RESIDENTIAL,52300,0,52300,241900,0,294200
191415400400000,SW 449,RESIDENTIAL,52300,0,52300,255500,0,307800
191415400500000,SW 449,RESIDENTIAL,52300,0,52300,199900,0,252200
191415400600000,SW 449,RESIDENTIAL,52300,0,52300,233200,0,285500
191415400700000,SW 449,RESIDENTIAL,52800,0,52800,245400,0,298200
191415401000000,SW 449,RESIDENTIAL,52300,0,52300,163700,0,216000
191415401100000,SW 449,RESIDENTIAL,52300,0,52300,178100,0,230400
191415401200000,SW 449,RESIDENTIAL,54300,0,54300,273600,0,327900
191415401300000,SW 449,RESIDENTIAL,47800,0,47800,0,0,47800
191415401400000,SW 449,RESIDENTIAL,52300,0,52300,218100,0,270400
191415401500000,SW 449,RESIDENTIAL,52300,0,52300,207700,0,260000
191415401700000,SW 449,RESIDENTIAL,52300,0,52300,219900,0,272200
191415401800000,SW 449,RESIDENTIAL,52300,0,52300,223700,0,276000
191415401900000,SW 449,RESIDENTIAL,54500,0,54500,190300,0,244800
191415402000000,SW 449,RESIDENTIAL,53900,0,53900,249000,0,302900
191415402100000,SW 449,RESIDENTIAL,54500,0,54500,257800,0,312300
191415402200000,SW 449,RESIDENTIAL,55100,0,55100,163800,0,218900
191415402300000,SW 449,RESIDENTIAL,54600,0,54600,283000,0,337600
191415402400000,SW 449,RESIDENTIAL,53500,0,53500,331300,0,384800
191415402500000,SW 449,RESIDENTIAL,54600,0,54600,183400,0,238000
191415402600000,SW 449,RESIDENTIAL,55900,0,55900,251200,0,307100
191415402700000,SW 449,RESIDENTIAL,55300,0,55300,172600,0,227900
191415402800000,SW 449,RESIDENTIAL,51900,0,51900,222600,0,274500
191415402900000,SW 449,RESIDENTIAL,52900,0,52900,198600,0,251500
191415403000000,SW 449,RESIDENTIAL,53000,0,53000,212200,0,265200
191415403100000,SW 449,RESIDENTIAL,55400,0,55400,222200,0,277600
191415403200000,SW 449,RESIDENTIAL,57000,0,57000,7600,0,64600
191415403300000,SW 449,RESIDENTIAL,52500,0,52500,229600,0,282100
191415403400000,SW 449,RESIDENTIAL,54300,0,54300,191400,0,245700
191415403500000,SW 449,RESIDENTIAL,45000,0,45000,0,0,45000
191415403600000,SW 449,RESIDENTIAL,47000,0,47000,0,0,47000
191415403900000,SW 449,RESIDENTIAL,59400,0,59400,277600,0,337000
191415404000000,SW 449,RESIDENTIAL,75300,0,75300,268800,0,344100
191415500100000,SW 449,RESIDENTIAL,52300,0,52300,232800,0,285100
191415500200000,SW 449,RESIDENTIAL,50100,0,50100,239600,0,289700
191415500300000,SW 449,RESIDENTIAL,52800,0,52800,278100,0,330900
191415500400000,SW 449,RESIDENTIAL,51100,0,51100,200700,0,251800
191415500500000,SW 449,RESIDENTIAL,52200,0,52200,228800,0,281000
191415500600000,SW 449,RESIDENTIAL,57300,0,57300,264000,0,321300
191415500700000,SW 449,RESIDENTIAL,51600,0,51600,181000,0,232600
191415500800000,SW 449,RESIDENTIAL,48600,0,48600,234100,0,282700
191415500900000,SW 449,RESIDENTIAL,48600,0,48600,185000,0,233600
191415501000000,SW 449,RESIDENTIAL,48600,0,48600,206800,0,255400
191415501100000,SW 449,RESIDENTIAL,48600,0,48600,187000,0,235600
191415501200000,SW 449,RESIDENTIAL,48600,0,48600,217900,0,266500
191415501300000,SW 449,RESIDENTIAL,48100,0,48100,200100,0,248200
191415501400000,SW 449,RESIDENTIAL,51700,0,51700,185500,0,237200
191415600100000,SW 449,RESIDENTIAL,41400,0,41400,0,0,41400
191415600200000,SW 449,RESIDENTIAL,46100,0,46100,0,0,46100
191415600300000,SW 449,RESIDENTIAL,49500,0,49500,258900,0,308400
191415600400000,SW 449,RESIDENTIAL,50600,0,50600,221500,0,272100
191415600500000,SW 449,RESIDENTIAL,52300,0,52300,209900,0,262200
191415600600000,SW 449,RESIDENTIAL,53900,0,53900,203500,0,257400
191415600700000,SW 449,RESIDENTIAL,54500,0,54500,191900,0,246400
191415600800000,SW 449,RESIDENTIAL,54500,0,54500,212000,0,266500
191415600900000,SW 449,RESIDENTIAL,51000,0,51000,294800,0,345800
191415601000000,SW 449,RESIDENTIAL,54600,0,54600,266100,0,320700
191415601100000,SW 449,RESIDENTIAL,51600,0,51600,224100,0,275700
191415601200000,SW 449,RESIDENTIAL,53500,0,53500,239700,0,293200
191415601300000,SW 449,RESIDENTIAL,55600,0,55600,205300,0,260900
191415601400000,SW 449,RESIDENTIAL,55000,0,55000,234800,0,289800
191415601500000,SW 449,RESIDENTIAL,54500,0,54500,186600,0,241100
191415601600000,SW 449,RESIDENTIAL,53400,0,53400,178500,0,231900
191415601700000,SW 449,RESIDENTIAL,58000,0,58000,9100,0,67100
191415601800000,SW 449,RESIDENTIAL,44400,0,44400,0,0,44400
191415700100000,SW 449,RESIDENTIAL,43300,0,43300,0,0,43300
191415700200000,SW 449,RESIDENTIAL,55400,0,55400,234500,0,289900
191415700300000,SW 449,RESIDENTIAL,52300,0,52300,241900,0,294200
191415700400000,SW 449,RESIDENTIAL,44400,0,44400,0,0,44400
191415700500000,SW 449,RESIDENTIAL,52300,0,52300,262600,0,314900
191415700600000,SW 449,RESIDENTIAL,47300,0,47300,222400,0,269700
191415700700000,SW 449,RESIDENTIAL,53300,0,53300,255600,0,308900
191415700800000,SW 449,RESIDENTIAL,49500,0,49500,171800,0,221300
191415700900000,CITY PROPERTY,EXEMPT,0,0,0,0,0,0
191415800100000,SW 449,RESIDENTIAL,48100,0,48100,249200,0,297300
191415800200000,SW 449,RESIDENTIAL,48600,0,48600,189600,0,238200
191415800300000,SW 449,RESIDENTIAL,48600,0,48600,244900,0,293500
191415800400000,SW 449,RESIDENTIAL,48600,0,48600,224800,0,273400
191415800500000,SW 449,RESIDENTIAL,48600,0,48600,198400,0,247000
191415800600000,SW 449,RESIDENTIAL,49100,0,49100,202900,0,252000
191415800700000,CITY PROPERTY,EXEMPT,0,0,0,0,0,0
191415800800000,CITY PROPERTY,EXEMPT,0,0,0,0,0,0
191415800900000,CITY PROPERTY,EXEMPT,0,0,0,0,0,0
191415801000000,CITY PROPERTY,EXEMPT,0,0,0,0,0,0
191417700200000,SW 449,RESIDENTIAL,50500,0,50500,198300,0,248800
191417700300000,SW 449,RESIDENTIAL,51000,0,51000,298000,0,349000
191417700400000,SW 449,RESIDENTIAL,49100,0,49100,247500,0,296600
191417700500000,SW 449,RESIDENTIAL,49100,0,49100,197800,0,246900
191417700600000,SW 449,RESIDENTIAL,38600,0,38600,247200,0,285800
191417700700000,SW 449,RESIDENTIAL,44000,0,44000,0,0,44000
191417800100000,SW 449,RESIDENTIAL,55900,0,55900,216300,0,272200
191417800200000,SW 449,RESIDENTIAL,54600,0,54600,175300,0,229900
191417800300000,SW 449,RESIDENTIAL,51700,0,51700,277000,0,328700
191417800400000,SW 449,RESIDENTIAL,44400,0,44400,0,0,44400
191417900200000,SW 449,RESIDENTIAL,44300,0,44300,199000,0,243300
191417900300000,SW 449,RESIDENTIAL,42100,0,42100,226100,0,268200
191417900400000,CITY PROPERTY,EXEMPT,0,0,0,0,0,0
191417900500000,SW 449,RESIDENTIAL,3200,0,3200,0,0,3200
191417900600000,SW 449,RESIDENTIAL,30800,0,30800,0,0,30800
191418000100000,SW 449,RESIDENTIAL,47500,0,47500,192200,0,239700
191418000200000,SW 449,RESIDENTIAL,48100,0,48100,196800,0,244900
191418000300000,SW 449,RESIDENTIAL,48100,0,48100,282300,0,330400
191420100200000,VACANT LAND,EXEMPT,0,35000,35000,0,0,35000
191420100300000,SW 449,RESIDENTIAL,54300,0,54300,239700,0,294000
191420100400000,SW 449,RESIDENTIAL,53400,0,53400,191700,0,245100
191420100500000,SW 449,RESIDENTIAL,53400,0,53400,218100,0,271500
191420100600000,SW 449,RESIDENTIAL,52800,0,52800,219700,0,272500
191420100700000,SW 449,RESIDENTIAL,54800,0,54800,218000,0,272800
191420100800000,SW 449,RESIDENTIAL,63600,0,63600,231600,0,295200
191420100900000,SW 449,RESIDENTIAL,61000,0,61000,278400,0,339400
191420101000000,SW 449,RESIDENTIAL,62500,0,62500,291500,0,354000
191420101100000,SW 449,RESIDENTIAL,57400,0,57400,211900,0,269300
191420101200000,SW 449,RESIDENTIAL,54000,0,54000,197800,0,251800
191420101300000,SW 449,RESIDENTIAL,53800,0,53800,215000,0,268800
191420101400000,SW 449,RESIDENTIAL,52300,0,52300,213000,0,265300
191420101500000,SW 449,RESIDENTIAL,54400,0,54400,193000,0,247400
191420101600000,SW 449,RESIDENTIAL,55400,0,55400,220500,0,275900
191420101700000,SW 449,RESIDENTIAL,63700,0,63700,286700,0,350400
191420101800000,SW 449,RESIDENTIAL,53900,0,53900,201700,0,255600
191420101900000,SW 449,RESIDENTIAL,54500,0,54500,204100,0,258600
191420102000000,SW 449,RESIDENTIAL,53900,0,53900,233500,0,287400
191420102100000,SW 449,RESIDENTIAL,53900,0,53900,269600,0,323500
191420102200000,SW 449,RESIDENTIAL,58600,0,58600,202000,0,260600
191420102300000,SW 449,RESIDENTIAL,59700,0,59700,221700,0,281400
191420102400000,SW 449,RESIDENTIAL,56900,0,56900,211200,0,268100
191420200100000,SW 449,RESIDENTIAL,54300,0,54300,246600,0,300900
191420200200000,SW 449,RESIDENTIAL,55000,0,55000,228700,0,283700
191420200300000,SW 449,RESIDENTIAL,55700,0,55700,204100,0,259800
191420200400000,SW 449,RESIDENTIAL,52300,0,52300,212000,0,264300
191420200500000,SW 449,RESIDENTIAL,43100,0,43100,0,0,43100
191420200600000,SW 449,RESIDENTIAL,48700,0,48700,0,0,48700
191420200700000,SW 449,RESIDENTIAL,45100,0,45100,0,0,45100
191420200800000,SW 449,RESIDENTIAL,45100,0,45100,0,0,45100
191420200900000,SW 449,RESIDENTIAL,51400,0,51400,180800,0,232200
191420201000000,SW 449,RESIDENTIAL,48200,0,48200,0,0,48200
191420300100000,SW 450,RESIDENTIAL,36700,0,36700,173400,0,210100
191420300200000,SW 450,RESIDENTIAL,52100,0,52100,175100,0,227200
191420300300000,SW 450,RESIDENTIAL,800,0,800,0,0,800
191420300400000,SW 450,RESIDENTIAL,400,0,400,0,0,400
191420300600000,SW 450,RESIDENTIAL,44700,0,44700,205100,0,249800
191420300700000,SW 450,RESIDENTIAL,44900,0,44900,204300,0,249200
191420300800000,SW 450,RESIDENTIAL,44900,0,44900,213600,0,258500
191420300900000,SW 450,RESIDENTIAL,46700,0,46700,176200,0,222900
191420301000000,SW 450,RESIDENTIAL,40900,0,40900,156200,0,197100
191420400100000,SW 450,RESIDENTIAL,43900,0,43900,175100,0,219000
191422600100000,SW 456,AG DWELLING,55100,0,55100,57700,5500,118300
191422600200000,SW 456,RESIDENTIAL,66000,0,66000,90000,0,156000
191422700100000,SW 450,RESIDENTIAL,43700,0,43700,172500,0,216200
191422700200000,SW 450,RESIDENTIAL,43700,0,43700,178800,0,222500
191422700300000,SW 450,RESIDENTIAL,38400,0,38400,182700,0,221100
191422700400000,SW 450,RESIDENTIAL,38400,0,38400,165000,0,203400
191422700500000,SW 450,RESIDENTIAL,39600,0,39600,173800,0,213400
191422700600000,SW 450,RESIDENTIAL,38400,0,38400,169800,0,208200
191422700700000,SW 450,RESIDENTIAL,38400,0,38400,168800,0,207200
191422800100000,SW 450,RESIDENTIAL,43700,0,43700,175700,0,219400
191422800200000,SW 450,RESIDENTIAL,37800,0,37800,156200,0,194000
191422800300000,SW 450,RESIDENTIAL,41000,0,41000,151700,0,192700
191422800400000,SW 450,RESIDENTIAL,41000,0,41000,156200,0,197200
191422800500000,SW 450,RESIDENTIAL,38400,0,38400,139800,0,178200
191422800600000,SW 450,RESIDENTIAL,38400,0,38400,164700,0,203100
191422800700000,SW 450,RESIDENTIAL,38400,0,38400,149500,0,187900
191422800800000,SW 450,RESIDENTIAL,38400,0,38400,139400,0,177800
191422800900000,SW 450,RESIDENTIAL,43400,0,43400,158400,0,201800
191422801000000,SW 450,RESIDENTIAL,43700,0,43700,163700,0,207400
191422801100000,SW 450,RESIDENTIAL,38400,0,38400,172500,0,210900
191422801200000,SW 450,RESIDENTIAL,38400,0,38400,150400,0,188800
191422801300000,SW 450,RESIDENTIAL,38400,0,38400,151400,0,189800
191422801400000,SW 450,RESIDENTIAL,38400,0,38400,155100,0,193500
191422801500000,SW 450,RESIDENTIAL,41300,0,41300,151700,0,193000
191422801600000,SW 450,RESIDENTIAL,41300,0,41300,176500,0,217800
191422801700000,SW 450,RESIDENTIAL,37800,0,37800,182200,0,220000
191422801800000,SW 450,RESIDENTIAL,43700,0,43700,170600,0,214300
191422900100000,SW 450,RESIDENTIAL,38200,0,38200,157800,0,196000
191422900300000,SW 450,RESIDENTIAL,38600,0,38600,165400,0,204000
191422900400000,SW 450,RESIDENTIAL,38600,0,38600,163700,0,202300
191422900500000,SW 450,RESIDENTIAL,700,0,700,0,0,700
191422900600000,SW 450,RESIDENTIAL,37600,0,37600,182600,0,220200
191422900700000,SW 450,RESIDENTIAL,41200,0,41200,169600,0,210800
191422900800000,SW 450,RESIDENTIAL,41600,0,41600,169200,0,210800
191423000100000,SW 450,RESIDENTIAL,47000,0,47000,189400,0,236400
191423000200000,SW 450,RESIDENTIAL,44600,0,44600,200700,0,245300
191423000300000,SW 450,RESIDENTIAL,42300,0,42300,151900,0,194200
191423000400000,SW 450,RESIDENTIAL,39200,0,39200,158900,0,198100
191423000500000,SW 450,RESIDENTIAL,39600,0,39600,143100,0,182700
191423000600000,SW 450,RESIDENTIAL,41600,0,41600,140900,0,182500
191423000700000,SW 450,RESIDENTIAL,44600,0,44600,161000,0,205600
191423001000000,APARTMENT,MULTI-RES,26000,0,26000,314200,0,340200
191423200100000,DAY CARE CENTER,COMMERCIAL,0,478000,478000,0,1196700,1674700
191425100300000,SW 456,AG LAND,77100,0,77100,0,0,77100
191425100400000,SW 456,AG LAND,32300,0,32300,0,0,32300
191427600300000,SW 449,RESIDENTIAL,5400,0,5400,0,0,5400
191427600600000,SW 450,RESIDENTIAL,50200,0,50200,204400,0,254600
191427600800000,SW 450,RESIDENTIAL,3400,0,3400,0,0,3400
191427600900000,SW 450,RESIDENTIAL,3300,0,3300,0,0,3300
191427601000000,SW 450,RESIDENTIAL,3300,0,3300,0,0,3300
191427700100000,SW 450,RESIDENTIAL,300,0,300,0,0,300
191427700200000,SW 450,RESIDENTIAL,300,0,300,0,0,300
191427700300000,SW 450,RESIDENTIAL,2400,0,2400,0,0,2400
191427700400000,SW 450,RESIDENTIAL,2700,0,2700,0,0,2700
191427800100000,SW 450,RESIDENTIAL,3100,0,3100,0,0,3100
191427800200000,SW 450,RESIDENTIAL,3900,0,3900,0,0,3900
191427800300000,SW 450,RESIDENTIAL,3300,0,3300,0,0,3300
191427800400000,SW 450,RESIDENTIAL,3600,0,3600,0,0,3600
191427800500000,SW 450,RESIDENTIAL,3300,0,3300,0,0,3300
191427800600000,SW 450,RESIDENTIAL,3100,0,3100,0,0,3100
191427800700000,SW 450,RESIDENTIAL,2900,0,2900,0,0,2900
191427800800000,SW 450,RESIDENTIAL,4900,0,4900,0,0,4900
191427800900000,SW 450,RESIDENTIAL,5100,0,5100,0,0,5100
191427801000000,SW 450,AG LAND,81100,0,81100,0,0,81100
191510100200000,OFFICE,COMMERCIAL,0,3553800,3553800,0,23315300,26869100
191510100300000,OFFICE,COMMERCIAL,0,1066500,1066500,0,15757000,16823500
191520100100000,EDUCATIONAL/COLLEGE,EXEMPT,0,0,0,0,0,0
191525100100000,EDUCATIONAL/COLLEGE,EXEMPT,0,0,0,0,0,0
191530100101000,WAREHOUSE,COMMERCIAL,0,30300,30300,0,478600,508900
191530100101001,EDUCATIONAL/COLLEGE,EXEMPT,0,0,0,0,0,0
191530100101002,EDUCATIONAL/COLLEGE,EXEMPT,0,0,0,0,0,0
191530100101003,WAREHOUSE,COMMERCIAL,0,5200,5200,0,29200,34400
191530100102000,ANTENNAS/TOWERS(BLL),COMMERCIAL,0,0,0,0,7200,7200
191530100102001,ANTENNAS/TOWERS(BLL),COMMERCIAL,0,0,0,0,2500,2500
191530100102002,ANTENNAS/TOWERS(BLL),COMMERCIAL,0,0,0,0,3600,3600
191530100102003,ANTENNAS/TOWERS(BLL),COMMERCIAL,0,0,0,0,5100,5100
191530100200000,CITY PROPERTY,EXEMPT,0,0,0,0,0,0
191530100300000,EDUCATIONAL/COLLEGE,EXEMPT,0,0,0,0,0,0
191532600100000,OFFICE,COMMERCIAL,0,315400,315400,0,4050200,4365600
191535100100000,CITY PROPERTY,EXEMPT,0,0,0,0,0,0
191540100500000,EDUCATIONAL/COLLEGE,EXEMPT,0,0,0,0,0,0
191540200100000,SW 456,AG LAND,95700,0,95700,0,0,95700
191540200201237,NBHD SHOPPING CENTER,COMMERCIAL,0,4200,4200,0,43500,47700
191540200201238,NBHD SHOPPING CENTER,COMMERCIAL,0,4200,4200,0,43500,47700
191545100100000,EDUCATIONAL/COLLEGE,EXEMPT,0,0,0,0,0,0
191545100200000,EDUCATIONAL/COLLEGE,EXEMPT,0,0,0,0,0,0
191545200100000,EDUCATIONAL/COLLEGE,EXEMPT,0,0,0,0,0,0
191547600300000,CITY PROPERTY,EXEMPT,0,0,0,0,0,0
191547600700000,SW 426,AG LAND,113000,0,113000,0,0,113000
191547600800000,OFFICE,COMMERCIAL,0,865800,865800,0,12313600,13179400
191610100100000,SW 426,RESIDENTIAL,26100,0,26100,98800,0,124900
191610100200000,SW 426,RESIDENTIAL,25400,0,25400,87600,0,113000
191610100300000,SW 426,RESIDENTIAL,25400,0,25400,98600,0,124000
191610100400000,SW 426,RESIDENTIAL,25400,0,25400,85900,0,111300
191610100500000,SW 426,RESIDENTIAL,25400,0,25400,106000,0,131400
191610100600000,SW 426,RESIDENTIAL,25400,0,25400,95800,0,121200
191610100700000,SW 426,RESIDENTIAL,25000,0,25000,71800,0,96800
191610100800000,SW 426,RESIDENTIAL,25000,0,25000,104500,0,129500
191610100900000,SW 426,RESIDENTIAL,25000,0,25000,95200,0,120200
191610101000000,SW 426,RESIDENTIAL,25000,0,25000,96200,0,121200
191610101100000,SW 426,RESIDENTIAL,25000,0,25000,106000,0,131000
191610101200000,SW 426,RESIDENTIAL,25000,0,25000,84000,0,109000
191610101300000,SW 426,RESIDENTIAL,25000,0,25000,87100,0,112100
191610101400000,SW 426,RESIDENTIAL,25000,0,25000,79100,0,104100
191610101500000,SW 426,RESIDENTIAL,28000,0,28000,79800,0,107800
191610101600000,SW 426,RESIDENTIAL,27900,0,27900,105000,0,132900
191610101700000,SW 426,RESIDENTIAL,27700,0,27700,131600,0,159300
191610101800000,SW 426,RESIDENTIAL,26500,0,26500,70100,0,96600
191610101900000,SW 426,RESIDENTIAL,24700,0,24700,104000,0,128700
191610102000000,SW 426,RESIDENTIAL,24700,0,24700,87500,0,112200
191610102100000,SW 426,RESIDENTIAL,24700,0,24700,56400,0,81100
191610102200000,SW 426,RESIDENTIAL,24700,0,24700,94600,0,119300
191610102300000,SW 426,RESIDENTIAL,24700,0,24700,83700,0,108400
191610102400000,SW 426,RESIDENTIAL,24700,0,24700,65900,0,90600
191610200100000,SW 426,RESIDENTIAL,24300,0,24300,97000,0,121300
191610200200000,SW 426,RESIDENTIAL,24000,0,24000,101500,0,125500
191610200300000,SW 426,RESIDENTIAL,24000,0,24000,60000,0,84000
191610200400000,SW 426,RESIDENTIAL,24000,0,24000,95100,0,119100
191610200500000,SW 426,RESIDENTIAL,24000,0,24000,89100,0,113100
191610200600000,SW 426,RESIDENTIAL,24300,0,24300,100400,0,124700
191610200700000,SW 426,RESIDENTIAL,19600,0,19600,96100,0,115700
191610200800000,SW 426,RESIDENTIAL,19600,0,19600,98100,0,117700
191610200900000,SW 426,RESIDENTIAL,19600,0,19600,109400,0,129000
191610201000000,SW 426,RESIDENTIAL,20700,0,20700,107700,0,128400
191610201100000,SW 426,RESIDENTIAL,17800,0,17800,100100,0,117900
191610201200000,SW 426,RESIDENTIAL,21600,0,21600,115300,0,136900
191610201300000,SW 426,RESIDENTIAL,20400,0,20400,111800,0,132200
191610201400000,SW 426,RESIDENTIAL,18200,0,18200,100300,0,118500
191610201500000,SW 426,RESIDENTIAL,17800,0,17800,103200,0,121000
191610201600000,SW 426,RESIDENTIAL,19600,0,19600,102100,0,121700
191610201700000,SW 426,RESIDENTIAL,19400,0,19400,96400,0,115800
191610201800000,SW 426,RESIDENTIAL,19100,0,19100,100600,0,119700
191610201900000,SW 426,RESIDENTIAL,19100,0,19100,101500,0,120600
191610202000000,SW 426,RESIDENTIAL,20300,0,20300,117900,0,138200
191610202100000,SW 426,RESIDENTIAL,21500,0,21500,98400,0,119900
191610202200000,SW 426,RESIDENTIAL,21500,0,21500,123800,0,145300
191610202300000,SW 426,RESIDENTIAL,21500,0,21500,109000,0,130500
191610202400000,SW 426,RESIDENTIAL,21400,0,21400,121400,0,142800
191610202500000,SW 426,RESIDENTIAL,27300,0,27300,89200,0,116500
191610202600000,SW 426,RESIDENTIAL,26600,0,26600,120600,0,147200
191610202700000,SW 426,RESIDENTIAL,26000,0,26000,99300,0,125300
191610202800000,SW 426,RESIDENTIAL,21800,0,21800,84400,0,106200
191610202900000,SW 426,RESIDENTIAL,20100,0,20100,59800,0,79900
191610203000000,SW 426,RESIDENTIAL,21200,0,21200,68300,0,89500
191610203100000,SW 426,RESIDENTIAL,21500,0,21500,71900,0,93400
191610203200000,CITY PROPERTY,EXEMPT,0,0,0,0,0,0
191610203300000,SW 426,RESIDENTIAL,59700,0,59700,74400,0,134100
191610300100000,SW 426,RESIDENTIAL,25800,0,25800,84600,0,110400
191610300200000,SW 426,RESIDENTIAL,25500,0,25500,80300,0,105800
191610300300000,SW 426,RESIDENTIAL,25100,0,25100,93200,0,118300
191610300400000,SW 426,RESIDENTIAL,25100,0,25100,101800,0,126900
191610300500000,SW 426,RESIDENTIAL,27000,0,27000,54200,0,81200
191610300600000,SW 426,RESIDENTIAL,26500,0,26500,41300,0,67800
191610300700000,SW 426,RESIDENTIAL,26500,0,26500,72000,0,98500
191610300800000,SW 426,RESIDENTIAL,26500,0,26500,67900,0,94400
191610300900000,SW 426,RESIDENTIAL,25700,0,25700,72500,0,98200
191610301000000,SW 426,RESIDENTIAL,27900,0,27900,81700,0,109600
191610301100000,SW 426,RESIDENTIAL,26700,0,26700,82700,0,109400
191610301200000,SW 426,RESIDENTIAL,24400,0,24400,81400,0,105800
191610301300000,SW 426,RESIDENTIAL,31300,0,31300,96900,0,128200
191610301400000,SW 426,RESIDENTIAL,24200,0,24200,100500,0,124700
191610301500000,SW 426,RESIDENTIAL,20100,0,20100,97000,0,117100
191610301600000,SW 426,RESIDENTIAL,20200,0,20200,96100,0,116300
191610301700000,SW 426,RESIDENTIAL,20200,0,20200,97800,0,118000
191610301800000,SW 426,RESIDENTIAL,20200,0,20200,92500,0,112700
191610301900000,SW 426,RESIDENTIAL,20200,0,20200,96300,0,116500
191610302000000,SW 426,RESIDENTIAL,20200,0,20200,125500,0,145700
191610302100000,SW 426,RESIDENTIAL,1000,0,1000,0,0,1000
191610400100000,SW 426,RESIDENTIAL,26300,0,26300,83400,0,109700
191610400200000,SW 426,RESIDENTIAL,25500,0,25500,103200,0,128700
191610400300000,SW 426,RESIDENTIAL,25500,0,25500,88600,0,114100
191610400400000,SW 426,RESIDENTIAL,26600,0,26600,87700,0,114300
191610400500000,SW 426,RESIDENTIAL,25400,0,25400,100200,0,125600
191610400600000,SW 426,RESIDENTIAL,26300,0,26300,65400,0,91700
191610400700000,SW 426,RESIDENTIAL,26300,0,26300,65500,0,91800
191610400800000,SW 426,RESIDENTIAL,26300,0,26300,69000,0,95300
191610400900000,SW 426,RESIDENTIAL,26800,0,26800,69500,0,96300
191610401000000,SW 426,RESIDENTIAL,30500,0,30500,48300,0,78800
191610401100000,SW 426,RESIDENTIAL,17100,0,17100,0,0,17100
191610401200000,SW 426,RESIDENTIAL,17100,0,17100,72000,0,89100
191610401300000,SW 426,RESIDENTIAL,26300,0,26300,54800,0,81100
191610401400000,SW 426,RESIDENTIAL,26600,0,26600,90400,0,117000
191610500100000,SW 426,RESIDENTIAL,25700,0,25700,82000,0,107700
191610500200000,SW 426,RESIDENTIAL,25700,0,25700,121800,0,147500
191610500300000,SW 426,RESIDENTIAL,25700,0,25700,79900,0,105600
191610500400000,SW 426,RESIDENTIAL,25700,0,25700,67000,0,92700
191610500500000,SW 426,RESIDENTIAL,25700,0,25700,104400,0,130100
191610500600000,SW 426,RESIDENTIAL,25700,0,25700,73700,0,99400
191610500700000,SW 426,RESIDENTIAL,25700,0,25700,64900,0,90600
191610500800000,SW 426,RESIDENTIAL,26500,0,26500,80400,0,106900
191610500900000,SW 426,RESIDENTIAL,25600,0,25600,66900,0,92500
191610501000000,SW 426,RESIDENTIAL,26800,0,26800,76600,0,103400
191610501100000,SW 426,RESIDENTIAL,24000,0,24000,68000,0,92000
191610501200000,SW 426,RESIDENTIAL,24100,0,24100,80100,0,104200
191610501300000,SW 426,RESIDENTIAL,24800,0,24800,80600,0,105400
191610501500000,SW 426,RESIDENTIAL,25700,0,25700,109400,0,135100
191610501600000,SW 426,RESIDENTIAL,24200,0,24200,109400,0,133600
191610501700000,SW 426,RESIDENTIAL,27000,0,27000,109400,0,136400
191610501800000,SW 426,RESIDENTIAL,24600,0,24600,105800,0,130400
191610501900000,SW 426,RESIDENTIAL,21500,0,21500,105800,0,127300
191610502000000,SW 426,RESIDENTIAL,27200,0,27200,109400,0,136600
191610502100000,SW 426,RESIDENTIAL,27500,0,27500,140600,0,168100
191610502200000,SW 426,RESIDENTIAL,26800,0,26800,140600,0,167400
191610502300000,SW 426,RESIDENTIAL,24600,0,24600,110000,0,134600
191610502400000,SW 426,RESIDENTIAL,26800,0,26800,140600,0,167400
191610502500000,SW 426,RESIDENTIAL,23500,0,23500,112500,0,136000
191610502600000,SW 426,RESIDENTIAL,27600,0,27600,112500,0,140100
191610502700000,SW 426,RESIDENTIAL,26700,0,26700,112500,0,139200
191610502800000,SW 426,RESIDENTIAL,23600,0,23600,112500,0,136100
191610600100000,SW 426,RESIDENTIAL,24000,0,24000,77100,0,101100
191610600200000,SW 426,RESIDENTIAL,24000,0,24000,64600,0,88600
191610600300000,SW 426,RESIDENTIAL,24000,0,24000,72600,0,96600
191610600400000,SW 426,RESIDENTIAL,25800,0,25800,113700,0,139500
191610600500000,CITY PROPERTY,EXEMPT,0,0,0,0,0,0
191612600100000,SW 426,RESIDENTIAL,20900,0,20900,73200,0,94100
191612600200000,SW 426,RESIDENTIAL,21100,0,21100,76800,0,97900
191612600300000,SW 426,RESIDENTIAL,21100,0,21100,61700,0,82800
191612600400000,SW 426,RESIDENTIAL,21100,0,21100,79900,0,101000
191612600500000,SW 426,RESIDENTIAL,21100,0,21100,69600,0,90700
191612600600000,SW 426,RESIDENTIAL,21100,0,21100,99000,0,120100
191612600700000,SW 426,RESIDENTIAL,21100,0,21100,81100,0,102200
191612600800000,SW 426,RESIDENTIAL,19900,0,19900,85100,0,105000
191612600900000,SW 426,RESIDENTIAL,24600,0,24600,112400,0,137000
191612700100000,SW 426,RESIDENTIAL,21300,0,21300,61500,0,82800
191612700200000,SW 426,RESIDENTIAL,21100,0,21100,68000,0,89100
191612700300000,SW 426,RESIDENTIAL,21100,0,21100,82200,0,103300
191612700400000,SW 426,RESIDENTIAL,21100,0,21100,80500,0,101600
191612700500000,SW 426,RESIDENTIAL,21100,0,21100,91000,0,112100
191612700600000,SW 426,RESIDENTIAL,21100,0,21100,84400,0,105500
191612700700000,SW 426,RESIDENTIAL,21100,0,21100,98100,0,119200
191612700800000,SW 426,RESIDENTIAL,21100,0,21100,65900,0,87000
191612700900000,SW 426,RESIDENTIAL,21000,0,21000,79100,0,100100
191612701000000,SW 426,RESIDENTIAL,21300,0,21300,88500,0,109800
191612701100000,CITY PROPERTY,EXEMPT,0,0,0,0,0,0
191612701200000,CITY PROPERTY,EXEMPT,0,0,0,0,0,0
191612701300000,SW 426,RESIDENTIAL,21300,0,21300,110300,0,131600
191612701400000,SW 426,RESIDENTIAL,21300,0,21300,68500,0,89800
191612701500000,SW 426,RESIDENTIAL,21300,0,21300,72100,0,93400
191612800100000,SW 426,RESIDENTIAL,21300,0,21300,69600,0,90900
191612800200000,SW 426,RESIDENTIAL,21300,0,21300,79100,0,100400
191612800300000,SW 426,RESIDENTIAL,21300,0,21300,86200,0,107500
191612800400000,SW 426,RESIDENTIAL,21300,0,21300,75400,0,96700
191612800500000,SW 426,RESIDENTIAL,21300,0,21300,85500,0,106800
191612800600000,SW 426,RESIDENTIAL,21300,0,21300,94000,0,115300
191612800700000,SW 426,RESIDENTIAL,24300,0,24300,76500,0,100800
191612800800000,SW 426,RESIDENTIAL,21800,0,21800,73400,0,95200
191612800900000,SW 426,RESIDENTIAL,21200,0,21200,102200,0,123400
191612801000000,SW 426,RESIDENTIAL,21300,0,21300,79000,0,100300
191612801100000,SW 426,RESIDENTIAL,21300,0,21300,100900,0,122200
191612801200000,SW 426,RESIDENTIAL,21300,0,21300,73100,0,94400
191612801300000,SW 426,RESIDENTIAL,21300,0,21300,78100,0,99400
191612900100000,SW 426,RESIDENTIAL,21300,0,21300,85800,0,107100
191612900200000,SW 426,RESIDENTIAL,21300,0,21300,74000,0,95300
191612900300000,SW 426,RESIDENTIAL,21300,0,21300,80500,0,101800
191612900400000,SW 426,RESIDENTIAL,21300,0,21300,64400,0,85700
191612900500000,SW 426,RESIDENTIAL,21300,0,21300,70600,0,91900
191612900600000,SW 426,RESIDENTIAL,21300,0,21300,116500,0,137800
191612900700000,SW 426,RESIDENTIAL,21300,0,21300,72100,0,93400
191612900800000,SW 426,RESIDENTIAL,21300,0,21300,78500,0,99800
191612900900000,SW 426,RESIDENTIAL,21300,0,21300,78200,0,99500
191612901000000,SW 426,RESIDENTIAL,21300,0,21300,129500,0,150800
191612901100000,SW 426,RESIDENTIAL,21300,0,21300,94500,0,115800
191613000100000,SW 426,RESIDENTIAL,22100,0,22100,76200,0,98300
191613000200000,SW 426,RESIDENTIAL,21000,0,21000,78300,0,99300
191613000300000,SW 426,RESIDENTIAL,1700,0,1700,0,0,1700
191613000400000,SW 426,RESIDENTIAL,1700,0,1700,0,0,1700
191613000500000,SW 426,RESIDENTIAL,22100,0,22100,98400,0,120500
191613000600000,SW 426,RESIDENTIAL,21300,0,21300,77500,0,98800
191613000700000,SW 426,RESIDENTIAL,21300,0,21300,74200,0,95500
191613000800000,SW 426,RESIDENTIAL,21000,0,21000,70900,0,91900
191613000900000,SW 426,RESIDENTIAL,1700,0,1700,0,0,1700
191613001000000,SW 426,RESIDENTIAL,21000,0,21000,80700,0,101700
191613001100000,SW 426,RESIDENTIAL,22100,0,22100,132800,0,154900
191613100100000,SW 426,RESIDENTIAL,20700,0,20700,90500,0,111200
191613100200000,SW 426,RESIDENTIAL,21200,0,21200,73000,0,94200
191613100300000,SW 426,RESIDENTIAL,22400,0,22400,105600,0,128000
191613100400000,SW 426,RESIDENTIAL,21500,0,21500,85400,0,106900
191613100500000,SW 426,RESIDENTIAL,21300,0,21300,85800,0,107100
191613100600000,SW 426,RESIDENTIAL,21300,0,21300,119900,0,141200
191613100700000,SW 426,RESIDENTIAL,21300,0,21300,94600,0,115900
191613100800000,SW 426,RESIDENTIAL,13400,0,13400,89000,0,102400
191613100900000,SW 426,RESIDENTIAL,14000,0,14000,86000,0,100000
191613101000000,SW 426,RESIDENTIAL,21400,0,21400,91900,0,113300
191613101100000,SW 426,RESIDENTIAL,21300,0,21300,108800,0,130100
191613101200000,SW 426,RESIDENTIAL,21300,0,21300,89300,0,110600
191613101300000,SW 426,RESIDENTIAL,21300,0,21300,84900,0,106200
191613200100000,SW 426,RESIDENTIAL,21300,0,21300,73000,0,94300
191613200200000,SW 426,RESIDENTIAL,21300,0,21300,62600,0,83900
191613200300000,SW 426,RESIDENTIAL,21300,0,21300,91500,0,112800
191613200400000,SW 426,RESIDENTIAL,21300,0,21300,83100,0,104400
191613200500000,SW 426,RESIDENTIAL,21300,0,21300,74900,0,96200
191613200600000,SW 426,RESIDENTIAL,21300,0,21300,76100,0,97400
191613200700000,SW 426,RESIDENTIAL,21300,0,21300,85400,0,106700
191613200800000,SW 426,RESIDENTIAL,21400,0,21400,89200,0,110600
191613200900000,SW 426,RESIDENTIAL,21100,0,21100,83200,0,104300
191613201000000,SW 426,RESIDENTIAL,21300,0,21300,85800,0,107100
191613201100000,SW 426,RESIDENTIAL,21300,0,21300,94600,0,115900
191613201200000,SW 426,RESIDENTIAL,21300,0,21300,78300,0,99600
191613201300000,SW 426,RESIDENTIAL,21300,0,21300,79200,0,100500
191613300100000,SW 426,RESIDENTIAL,21700,0,21700,84100,0,105800
191613300200000,SW 426,RESIDENTIAL,1900,0,1900,0,0,1900
191613300300000,SW 426,RESIDENTIAL,1800,0,1800,0,0,1800
191613300400000,SW 426,RESIDENTIAL,21500,0,21500,76300,0,97800
191613300500000,SW 426,RESIDENTIAL,21300,0,21300,94400,0,115700
191613300600000,SW 426,RESIDENTIAL,21300,0,21300,87800,0,109100
191615200100000,SW 451,RESIDENTIAL,37800,0,37800,197600,0,235400
191615200200000,CITY PROPERTY,EXEMPT,0,0,0,0,0,0
191615200300000,SW 451,RESIDENTIAL,32100,0,32100,139200,0,171300
191615200400000,SW 451,RESIDENTIAL,34200,0,34200,143700,0,177900
191615200500000,SW 451,RESIDENTIAL,30600,0,30600,155600,0,186200
191615200600000,SW 451,RESIDENTIAL,29400,0,29400,153400,0,182800
191615200700000,SW 451,RESIDENTIAL,27300,0,27300,131300,0,158600
191615200800000,SW 451,RESIDENTIAL,24200,0,24200,127100,0,151300
191615200900000,SW 451,RESIDENTIAL,32000,0,32000,144100,0,176100
191615201000000,SW 451,RESIDENTIAL,31700,0,31700,157000,0,188700
191615201100000,SW 451,RESIDENTIAL,24800,0,24800,158700,0,183500
191615201200000,SW 451,RESIDENTIAL,25300,0,25300,128100,0,153400
191615201300000,SW 451,RESIDENTIAL,25300,0,25300,128100,0,153400
191615201400000,SW 451,RESIDENTIAL,25300,0,25300,126400,0,151700
191615201500000,SW 451,RESIDENTIAL,27200,0,27200,124400,0,151600
191615300100000,SW 451,RESIDENTIAL,29200,0,29200,133000,0,162200
191615300200000,SW 451,RESIDENTIAL,24800,0,24800,151700,0,176500
191615300300000,SW 451,RESIDENTIAL,24800,0,24800,148300,0,173100
191615300400000,SW 451,RESIDENTIAL,24800,0,24800,167800,0,192600
191615300500000,SW 451,RESIDENTIAL,24800,0,24800,151700,0,176500
191615300600000,SW 451,RESIDENTIAL,24800,0,24800,160300,0,185100
191615300700000,SW 451,RESIDENTIAL,24800,0,24800,170600,0,195400
191615300800000,SW 451,RESIDENTIAL,24800,0,24800,160300,0,185100
191615300900000,SW 451,RESIDENTIAL,24800,0,24800,131200,0,156000
191615301000000,SW 451,RESIDENTIAL,32000,0,32000,143700,0,175700
191615301100000,SW 451,RESIDENTIAL,32400,0,32400,111000,0,143400
191615301200000,SW 451,RESIDENTIAL,24800,0,24800,122000,0,146800
191615301300000,SW 451,RESIDENTIAL,24800,0,24800,111000,0,135800
191615301400000,SW 451,RESIDENTIAL,24800,0,24800,111000,0,135800
191615301500000,SW 451,RESIDENTIAL,24800,0,24800,130600,0,155400
191615301600000,SW 451,RESIDENTIAL,24800,0,24800,120200,0,145000
191615301700000,SW 451,RESIDENTIAL,24800,0,24800,111000,0,135800
191615301800000,SW 451,RESIDENTIAL,24800,0,24800,116100,0,140900
191615301900000,SW 451,RESIDENTIAL,24800,0,24800,152300,0,177100
191615302000000,SW 451,RESIDENTIAL,4600,0,4600,0,0,4600
191615400100000,SW 451,RESIDENTIAL,8900,0,8900,0,0,8900
191615400200000,SW 451,RESIDENTIAL,26000,0,26000,150700,0,176700
191615400300000,SW 451,RESIDENTIAL,32400,0,32400,153600,0,186000
191615400400000,SW 451,RESIDENTIAL,24800,0,24800,143600,0,168400
191615400500000,SW 451,RESIDENTIAL,24800,0,24800,143200,0,168000
191615400600000,SW 451,RESIDENTIAL,24800,0,24800,132000,0,156800
191615400700000,SW 451,RESIDENTIAL,24800,0,24800,143300,0,168100
191615400800000,SW 451,RESIDENTIAL,24800,0,24800,144100,0,168900
191615400900000,SW 451,RESIDENTIAL,24800,0,24800,128700,0,153500
191615401000000,SW 451,RESIDENTIAL,24800,0,24800,135200,0,160000
191615401100000,SW 451,RESIDENTIAL,24800,0,24800,139200,0,164000
191615401200000,SW 451,RESIDENTIAL,30400,0,30400,139400,0,169800
191615401300000,SW 451,RESIDENTIAL,33300,0,33300,145900,0,179200
191615401400000,SW 451,RESIDENTIAL,31800,0,31800,136500,0,168300
191615401500000,SW 451,RESIDENTIAL,34200,0,34200,133200,0,167400
191615401600000,SW 451,RESIDENTIAL,32000,0,32000,170400,0,202400
191615401700000,SW 451,RESIDENTIAL,30000,0,30000,143700,0,173700
191615401800000,SW 451,RESIDENTIAL,26100,0,26100,127100,0,153200
191615401900000,SW 451,RESIDENTIAL,25900,0,25900,154800,0,180700
191615402000000,SW 451,RESIDENTIAL,25600,0,25600,132000,0,157600
191615402100000,SW 451,RESIDENTIAL,25600,0,25600,144700,0,170300
191615402200000,SW 451,RESIDENTIAL,25600,0,25600,134800,0,160400
191615402300000,SW 451,RESIDENTIAL,3700,0,3700,0,0,3700
191615402400000,SW 451,RESIDENTIAL,3700,0,3700,0,0,3700
191615402500000,SW 451,RESIDENTIAL,4200,0,4200,0,0,4200
191615500100000,SW 451,RESIDENTIAL,31000,0,31000,136500,0,167500
191615500200000,SW 451,RESIDENTIAL,25800,0,25800,126700,0,152500
191615500300000,SW 451,RESIDENTIAL,26000,0,26000,148000,0,174000
191615500400000,SW 451,RESIDENTIAL,25300,0,25300,159000,0,184300
191615500500000,SW 451,RESIDENTIAL,25000,0,25000,156200,0,181200
191615500600000,SW 451,RESIDENTIAL,30400,0,30400,139600,0,170000
191615500700000,CITY PROPERTY,EXEMPT,0,0,0,0,0,0
191615500900000,SW 451,RESIDENTIAL,29800,0,29800,153500,0,183300
191615501000000,SW 451,RESIDENTIAL,35000,0,35000,121700,0,156700
191615501100000,SW 451,RESIDENTIAL,30400,0,30400,136800,0,167200
191615600100000,SW 451,RESIDENTIAL,32400,0,32400,170800,0,203200
191615600200000,SW 451,RESIDENTIAL,24800,0,24800,113300,0,138100
191615600300000,SW 451,RESIDENTIAL,24800,0,24800,170400,0,195200
191615600400000,SW 451,RESIDENTIAL,24800,0,24800,152900,0,177700
191615600500000,SW 451,RESIDENTIAL,24800,0,24800,157400,0,182200
191615600600000,SW 451,RESIDENTIAL,24800,0,24800,167200,0,192000
191615600700000,SW 451,RESIDENTIAL,24800,0,24800,150400,0,175200
191615600800000,SW 451,RESIDENTIAL,24800,0,24800,169400,0,194200
191615600900000,SW 451,RESIDENTIAL,24800,0,24800,158900,0,183700
191615601000000,SW 451,RESIDENTIAL,4600,0,4600,0,0,4600
191615601100000,SW 451,RESIDENTIAL,4600,0,4600,0,0,4600
191615601200000,SW 451,RESIDENTIAL,24800,0,24800,161000,0,185800
191615601300000,SW 451,RESIDENTIAL,24800,0,24800,157700,0,182500
191615601400000,SW 451,RESIDENTIAL,24800,0,24800,152900,0,177700
191615601500000,SW 451,RESIDENTIAL,24800,0,24800,150400,0,175200
191615601600000,SW 451,RESIDENTIAL,24800,0,24800,174900,0,199700
191615601700000,SW 451,RESIDENTIAL,24800,0,24800,163100,0,187900
191615601800000,SW 451,RESIDENTIAL,24800,0,24800,177400,0,202200
191615601900000,SW 451,RESIDENTIAL,24800,0,24800,133800,0,158600
191615602000000,SW 451,RESIDENTIAL,32400,0,32400,152400,0,184800
191615700100000,SW 451,RESIDENTIAL,4200,0,4200,0,0,4200
191615700200000,SW 451,RESIDENTIAL,3700,0,3700,0,0,3700
191615700300000,SW 451,RESIDENTIAL,3700,0,3700,0,0,3700
191615700400000,SW 451,RESIDENTIAL,3700,0,3700,0,0,3700
191615700500000,SW 451,RESIDENTIAL,3700,0,3700,0,0,3700
191615700600000,SW 451,RESIDENTIAL,3700,0,3700,0,0,3700
191615700700000,SW 451,RESIDENTIAL,4100,0,4100,0,0,4100
191615700800000,SW 451,RESIDENTIAL,4200,0,4200,0,0,4200
191615800100000,CITY PROPERTY,EXEMPT,0,0,0,0,0,0
191615800200000,SW 451,RESIDENTIAL,5600,0,5600,0,0,5600
191615800300000,SW 451,RESIDENTIAL,4400,0,4400,0,0,4400
191615800400000,SW 451,RESIDENTIAL,4100,0,4100,0,0,4100
191615800500000,SW 451,RESIDENTIAL,4100,0,4100,0,0,4100
191615800600000,SW 451,RESIDENTIAL,4000,0,4000,0,0,4000
191615800700000,SW 451,RESIDENTIAL,4500,0,4500,0,0,4500
191615800800000,SW 451,RESIDENTIAL,28000,0,28000,157300,0,185300
191615800900000,SW 451,RESIDENTIAL,25000,0,25000,152800,0,177800
191615801000000,SW 451,RESIDENTIAL,25700,0,25700,131200,0,156900
191615801100000,SW 451,RESIDENTIAL,26700,0,26700,131200,0,157900
191615801200000,SW 451,RESIDENTIAL,26800,0,26800,129700,0,156500
191615900100000,SW 451,RESIDENTIAL,32400,0,32400,102900,0,135300
191615900200000,SW 451,RESIDENTIAL,5100,0,5100,0,0,5100
191615900300000,SW 451,RESIDENTIAL,3800,0,3800,0,0,3800
191615900400000,SW 451,RESIDENTIAL,3800,0,3800,0,0,3800
191615900500000,SW 451,RESIDENTIAL,3800,0,3800,0,0,3800
191615900600000,SW 451,RESIDENTIAL,3700,0,3700,0,0,3700
191615900700000,SW 451,RESIDENTIAL,3700,0,3700,0,0,3700
191615900800000,SW 451,RESIDENTIAL,3600,0,3600,0,0,3600
191615900900000,SW 451,RESIDENTIAL,3600,0,3600,0,0,3600
191615901000000,SW 451,RESIDENTIAL,3500,0,3500,0,0,3500
191615901100000,SW 451,RESIDENTIAL,4500,0,4500,0,0,4500
191615901200000,SW 451,RESIDENTIAL,4600,0,4600,0,0,4600
191615901300000,SW 451,RESIDENTIAL,24800,0,24800,170500,0,195300
191615901400000,SW 451,RESIDENTIAL,24800,0,24800,166400,0,191200
191615901500000,SW 451,RESIDENTIAL,24800,0,24800,161600,0,186400
191615901600000,SW 451,RESIDENTIAL,24800,0,24800,216100,0,240900
191615901700000,SW 451,RESIDENTIAL,24800,0,24800,151400,0,176200
191615901800000,SW 451,RESIDENTIAL,24800,0,24800,152500,0,177300
191615901900000,SW 451,RESIDENTIAL,24800,0,24800,176400,0,201200
191615902000000,SW 451,RESIDENTIAL,24800,0,24800,45400,0,70200
191617600100000,SW 426,RESIDENTIAL,21500,0,21500,91800,0,113300
191617600200000,APARTMENT,RESIDENTIAL,116000,0,116000,1324100,0,1440100
191617600300000,SW 426,RESIDENTIAL,25400,0,25400,87600,0,113000
191617600500000,SW 426,RESIDENTIAL,26300,0,26300,73700,0,100000
191617600600000,SW 426,RESIDENTIAL,25700,0,25700,70700,0,96400
191617600900000,APARTMENT,MULTI-RES,36500,0,36500,182700,0,219200
191617601000000,APARTMENT,MULTI-RES,33700,0,33700,182200,0,215900
191617700100000,EDUCATIONAL/COLLEGE,EXEMPT,0,0,0,0,0,0
191617700500000,VACANT LAND,COMMERCIAL,0,22700,22700,0,0,22700
191617700700000,VACANT LAND,COMMERCIAL,0,5500,5500,0,0,5500
191620100100000,CITY PROPERTY,EXEMPT,0,0,0,0,0,0
191620100200000,CITY PROPERTY,EXEMPT,0,0,0,0,0,0
191622600100000,SW 418,INDUSTRIAL,0,823400,823400,0,0,823400
191622600200000,SW 418,INDUSTRIAL,0,578000,578000,0,0,578000
191622600300000,WAREHOUSE,COMMERCIAL,0,438800,438800,0,494000,932800
191622600400000,SW 418,AG DWELLING,32500,0,32500,50000,5600,88100
191622600500000,WAREHOUSE,COMMERCIAL,0,346600,346600,0,1067200,1413800
191625100200000,WAREHOUSE,COMMERCIAL,0,126900,126900,0,352900,479800
191625100202000,BILLBOARD(BLL),COMMERCIAL,0,0,0,0,72900,72900
191625100300000,WAREHOUSE,COMMERCIAL,0,207400,207400,0,856500,1063900
191625100400000,SMALL RETAIL,COMMERCIAL,0,206700,206700,0,263500,470200
191625100500000,WAREHOUSE,COMMERCIAL,0,643900,643900,0,1394400,2038300
191625100800000,WAREHOUSE,COMMERCIAL,0,844400,844400,0,1870800,2715200
191625200100000,SHOP,INDUSTRIAL,0,146000,146000,0,790300,936300
191625200200000,SCHOOL,EXEMPT,0,309400,309400,0,598700,908100
191625200300000,SHOP,COMMERCIAL,0,140200,140200,0,367500,507700
191625200400000,SHOP,COMMERCIAL,0,86300,86300,0,460000,546300
191627600300000,SW 426,RESIDENTIAL,51000,0,51000,132500,0,183500
191627600400000,SW 426,RESIDENTIAL,260300,0,260300,0,0,260300
191630100100000,SW 422,AG LAND,108600,0,108600,0,0,108600
191632600100000,SW 418,AG LAND,76300,0,76300,0,0,76300
191632600200000,WAREHOUSE,COMMERCIAL,0,172500,172500,0,106200,278700
191632600300000,SW 418,RESIDENTIAL,35300,0,35300,0,0,35300
191635100100000,SW 418,AG DWELLING,82400,0,82400,95500,10600,188500
191637600100000,SW 456,AG DWELLING,111900,0,111900,81700,7600,201200
191640100400000,CITY PROPERTY,EXEMPT,0,0,0,0,0,0
191640100402000,ANTENNAS/TOWERS(BLL),COMMERCIAL,0,0,0,0,39900,39900
191640100500000,CITY PROPERTY,EXEMPT,0,0,0,0,0,0
191640100600000,SW 433,RESIDENTIAL,44700,0,44700,206600,0,251300
191640100700000,SW 433,RESIDENTIAL,45700,0,45700,162600,0,208300
191640100800000,SW 433,RESIDENTIAL,46100,0,46100,202900,0,249000
191640100900000,SW 433,RESIDENTIAL,44700,0,44700,196100,0,240800
191640101000000,SW 433,RESIDENTIAL,45600,0,45600,233800,0,279400
191640101100000,SW 433,RESIDENTIAL,43700,0,43700,175500,0,219200
191640101200000,SW 433,RESIDENTIAL,48600,0,48600,218200,0,266800
191640101300000,SW 433,RESIDENTIAL,47000,0,47000,233500,0,280500
191640101400000,SW 433,RESIDENTIAL,36900,0,36900,209200,0,246100
191640101500000,SW 433,RESIDENTIAL,42500,0,42500,219100,0,261600
191640101600000,SW 433,RESIDENTIAL,42800,0,42800,234800,0,277600
191640101700000,SW 433,RESIDENTIAL,39400,0,39400,190600,0,230000
191640101800000,SW 433,RESIDENTIAL,44900,0,44900,226000,0,270900
191640101900000,SW 433,RESIDENTIAL,43100,0,43100,240400,0,283500
191640102000000,SW 433,RESIDENTIAL,44500,0,44500,193500,0,238000
191640102300000,SW 433,RESIDENTIAL,46600,0,46600,224400,0,271000
191640102400000,SW 433,RESIDENTIAL,40800,0,40800,208400,0,249200
191640102500000,SW 433,RESIDENTIAL,38700,0,38700,227400,0,266100
191640102600000,SW 433,RESIDENTIAL,42500,0,42500,232900,0,275400
191640102700000,SW 433,RESIDENTIAL,46900,0,46900,209200,0,256100
191640102800000,SW 433,RESIDENTIAL,46200,0,46200,206600,0,252800
191640102900000,SW 433,RESIDENTIAL,43900,0,43900,211200,0,255100
191640103000000,SW 433,RESIDENTIAL,39500,0,39500,239900,0,279400
191640103100000,SW 433,RESIDENTIAL,37600,0,37600,216100,0,253700
191640103400000,SW 433,RESIDENTIAL,32800,0,32800,171800,0,204600
191640103500000,SW 433,RESIDENTIAL,50100,0,50100,197200,0,247300
191640103600000,SW 433,RESIDENTIAL,36700,0,36700,198800,0,235500
191640103800000,SW 433,RESIDENTIAL,41600,0,41600,207400,0,249000
191640103900000,SW 433,RESIDENTIAL,48000,0,48000,189600,0,237600
191640200100000,SW 433,RESIDENTIAL,38000,0,38000,168000,0,206000
191640200200000,SW 433,RESIDENTIAL,38000,0,38000,177900,0,215900
191640200300000,SW 433,RESIDENTIAL,32200,0,32200,185300,0,217500
191640200400000,SW 433,RESIDENTIAL,38000,0,38000,190000,0,228000
191640200500000,SW 433,RESIDENTIAL,38000,0,38000,175000,0,213000
191640200600000,SW 433,RESIDENTIAL,32900,0,32900,184200,0,217100
191640200700000,SW 433,RESIDENTIAL,32900,0,32900,180600,0,213500
191640200800000,SW 433,RESIDENTIAL,32900,0,32900,173200,0,206100
191640200900000,SW 433,RESIDENTIAL,32900,0,32900,149400,0,182300
191640201000000,SW 433,RESIDENTIAL,32900,0,32900,164500,0,197400
191640201100000,SW 433,RESIDENTIAL,32900,0,32900,159600,0,192500
191640300100000,SW 433,RESIDENTIAL,41200,0,41200,218800,0,260000
191640300200000,SW 433,RESIDENTIAL,38200,0,38200,200500,0,238700
191640300300000,SW 433,RESIDENTIAL,37600,0,37600,209500,0,247100
191640300400000,SW 433,RESIDENTIAL,38300,0,38300,234700,0,273000
191640300500000,SW 433,RESIDENTIAL,38600,0,38600,221800,0,260400
191640300600000,SW 433,RESIDENTIAL,39300,0,39300,201500,0,240800
191640300700000,SW 433,RESIDENTIAL,39600,0,39600,207100,0,246700
191640300800000,SW 433,RESIDENTIAL,40400,0,40400,232700,0,273100
191640300900000,SW 433,RESIDENTIAL,41100,0,41100,233400,0,274500
191640301000000,SW 433,RESIDENTIAL,39600,0,39600,186800,0,226400
191640301100000,SW 433,RESIDENTIAL,40600,0,40600,218300,0,258900
191640301200000,SW 433,RESIDENTIAL,41200,0,41200,194200,0,235400
191640301300000,SW 433,RESIDENTIAL,40200,0,40200,190000,0,230200
191640301400000,SW 433,RESIDENTIAL,40500,0,40500,242300,0,282800
191640301500000,SW 433,RESIDENTIAL,41200,0,41200,238100,0,279300
191640301600000,SW 433,RESIDENTIAL,41900,0,41900,191100,0,233000
191640301700000,SW 433,RESIDENTIAL,41200,0,41200,193000,0,234200
191640301800000,SW 433,RESIDENTIAL,41200,0,41200,248300,0,289500
191640301900000,SW 433,RESIDENTIAL,36800,0,36800,165400,0,202200
191640400100000,SW 433,RESIDENTIAL,29900,0,29900,166000,0,195900
191640400200000,SW 433,RESIDENTIAL,33300,0,33300,160200,0,193500
191640400300000,SW 433,RESIDENTIAL,32600,0,32600,160400,0,193000
191640400400000,SW 433,RESIDENTIAL,33300,0,33300,168300,0,201600
191640400500000,SW 433,RESIDENTIAL,34100,0,34100,171800,0,205900
191640400600000,SW 433,RESIDENTIAL,35100,0,35100,197400,0,232500
191640400700000,SW 433,RESIDENTIAL,35700,0,35700,188600,0,224300
191640400800000,SW 433,RESIDENTIAL,33300,0,33300,163700,0,197000
191640400900000,SW 433,RESIDENTIAL,32000,0,32000,174800,0,206800
191640401000000,SW 433,RESIDENTIAL,32500,0,32500,153600,0,186100
191640401100000,SW 433,RESIDENTIAL,31200,0,31200,169800,0,201000
191640401200000,SW 433,RESIDENTIAL,29500,0,29500,166600,0,196100
191640401300000,SW 433,RESIDENTIAL,30000,0,30000,179300,0,209300
191642600100000,SW 422,AG LAND,119000,0,119000,0,0,119000
191645100100000,SW 456,AG DWELLING,113500,0,113500,68100,6000,187600
191647600200000,SCHOOL,EXEMPT,0,0,0,0,0,0
191647600300000,SW 422,RESIDENTIAL,41100,0,41100,9300,0,50400
191647600400000,SW 422,RESIDENTIAL,23200,0,23200,110400,0,133600
191647600500000,SW 433,RESIDENTIAL,33500,0,33500,157300,0,190800
191647600600000,SW 433,RESIDENTIAL,32400,0,32400,143600,0,176000
191647600700000,SW 433,RESIDENTIAL,32900,0,32900,155100,0,188000
191647600800000,SW 433,RESIDENTIAL,32900,0,32900,164600,0,197500
191647600900000,SW 433,RESIDENTIAL,32900,0,32900,169100,0,202000
191647601000000,SW 433,RESIDENTIAL,30600,0,30600,155300,0,185900
191647601100000,SW 433,RESIDENTIAL,34900,0,34900,122000,0,156900
191647601200000,SW 433,RESIDENTIAL,41000,0,41000,156700,0,197700
191647601300000,SW 433,RESIDENTIAL,38800,0,38800,184600,0,223400
191647601400000,SW 433,RESIDENTIAL,38000,0,38000,139000,0,177000
191647601500000,SW 433,RESIDENTIAL,39100,0,39100,107100,0,146200
191647601600000,SW 433,RESIDENTIAL,33400,0,33400,138400,0,171800
191647601700000,SW 433,RESIDENTIAL,34600,0,34600,128100,0,162700
191647601800000,SW 433,RESIDENTIAL,34700,0,34700,176900,0,211600
191647601900000,SW 433,RESIDENTIAL,34600,0,34600,0,0,34600
191647602000000,SW 433,RESIDENTIAL,43300,0,43300,202800,0,246100
191647602100000,SW 433,RESIDENTIAL,43200,0,43200,221700,0,264900
191647602200000,SW 433,RESIDENTIAL,47800,0,47800,236900,0,284700
191647602300000,SW 433,RESIDENTIAL,44700,0,44700,187800,0,232500
191647602400000,SW 433,RESIDENTIAL,44700,0,44700,221700,0,266400
191647602500000,SW 433,RESIDENTIAL,46500,0,46500,216600,0,263100
191647602600000,SW 433,RESIDENTIAL,43400,0,43400,200700,0,244100
191647602700000,SW 433,RESIDENTIAL,39300,0,39300,176600,0,215900
191647602800000,SW 433,RESIDENTIAL,46900,0,46900,219600,0,266500
191647602900000,SW 433,RESIDENTIAL,48000,0,48000,189200,0,237200
191647603000000,SW 433,RESIDENTIAL,42200,0,42200,185300,0,227500
191647603100000,SW 433,RESIDENTIAL,33800,0,33800,161300,0,195100
191647603200000,SW 433,RESIDENTIAL,33100,0,33100,139600,0,172700
191647603300000,SW 433,RESIDENTIAL,32300,0,32300,162400,0,194700
191647603400000,SW 433,RESIDENTIAL,37400,0,37400,184400,0,221800
191647603500000,SW 433,RESIDENTIAL,37300,0,37300,206400,0,243700
191647603600000,SW 433,RESIDENTIAL,30500,0,30500,180400,0,210900
191647700100000,SW 433,RESIDENTIAL,41200,0,41200,194300,0,235500
191647700200000,SW 433,RESIDENTIAL,41900,0,41900,194100,0,236000
191647700300000,CITY PROPERTY,EXEMPT,0,0,0,0,0,0
191647700400000,SW 433,RESIDENTIAL,42400,0,42400,206900,0,249300
191647700500000,SW 433,RESIDENTIAL,39000,0,39000,182600,0,221600
191647700600000,SW 433,RESIDENTIAL,39700,0,39700,157300,0,197000
191647700700000,SW 433,RESIDENTIAL,38000,0,38000,148800,0,186800
191647700800000,SW 433,RESIDENTIAL,40700,0,40700,169000,0,209700
191647700900000,SW 433,RESIDENTIAL,41700,0,41700,157000,0,198700
191647701000000,SW 433,RESIDENTIAL,46800,0,46800,171300,0,218100
191647701100000,SW 433,RESIDENTIAL,42200,0,42200,173500,0,215700
191647701200000,SW 433,RESIDENTIAL,34700,0,34700,177700,0,212400
191647701300000,SW 433,RESIDENTIAL,34700,0,34700,153300,0,188000
191647701400000,SW 433,RESIDENTIAL,34300,0,34300,137400,0,171700
191647701500000,SW 433,RESIDENTIAL,32900,0,32900,150600,0,183500
191647701600000,SW 433,RESIDENTIAL,32900,0,32900,158900,0,191800
191647701700000,SW 433,RESIDENTIAL,32900,0,32900,150300,0,183200
191647701800000,SW 433,RESIDENTIAL,34300,0,34300,179700,0,214000
191647701900000,SW 433,RESIDENTIAL,32500,0,32500,167900,0,200400
191647702000000,SW 433,RESIDENTIAL,36300,0,36300,210500,0,246800
191647702100000,SW 433,RESIDENTIAL,36500,0,36500,201000,0,237500
191647702200000,SW 433,RESIDENTIAL,39300,0,39300,210600,0,249900
191647702300000,SW 433,RESIDENTIAL,35400,0,35400,186100,0,221500
191647702400000,SW 433,RESIDENTIAL,36100,0,36100,153200,0,189300
191647702500000,SW 433,RESIDENTIAL,37000,0,37000,192200,0,229200
191647702600000,SW 433,RESIDENTIAL,37000,0,37000,188800,0,225800
191647702700000,SW 433,RESIDENTIAL,37900,0,37900,187200,0,225100
191647702800000,SW 433,RESIDENTIAL,37500,0,37500,110800,0,148300
191647702900000,SW 433,RESIDENTIAL,35300,0,35300,156900,0,192200
191647800100000,SW 433,RESIDENTIAL,32900,0,32900,155200,0,188100
191647800200000,SW 433,RESIDENTIAL,32900,0,32900,155900,0,188800
191647800300000,SW 433,RESIDENTIAL,32900,0,32900,133800,0,166700
191647800400000,SW 433,RESIDENTIAL,32900,0,32900,162500,0,195400
191647800500000,SW 433,RESIDENTIAL,32900,0,32900,149000,0,181900
191647800600000,SW 433,RESIDENTIAL,32900,0,32900,126700,0,159600
191647800700000,SW 433,RESIDENTIAL,32900,0,32900,155600,0,188500
191710100100000,VACANT LAND,INDUSTRIAL,0,99400,99400,0,0,99400
191710100300000,SHOP,COMMERCIAL,0,196300,196300,0,524900,721200
191710100400000,SHOP,COMMERCIAL,0,55000,55000,0,176900,231900
191710100500000,SHOP,COMMERCIAL,0,48000,48000,0,174900,222900
191710200100000,VETERINARY CLINIC,COMMERCIAL,0,61700,61700,0,117400,179100
191710200200000,SW 418,RESIDENTIAL,54600,0,54600,88500,0,143100
191710200300000,FLAT PARKING,COMMERCIAL,0,192500,192500,0,59500,252000
191710200700000,VACANT LAND,INDUSTRIAL,0,102300,102300,0,0,102300
191710200800000,WAREHOUSE,COMMERCIAL,0,162300,162300,0,555000,717300
191710201401000,SHOP,COMMERCIAL,0,272000,272000,0,1058300,1330300
191710201401001,WAREHOUSE,COMMERCIAL,0,164900,164900,0,583200,748100
191710201500000,WAREHOUSE,COMMERCIAL,0,285000,285000,0,660900,945900
191710201700000,WAREHOUSE,COMMERCIAL,0,73600,73600,0,224700,298300
191710201800000,WAREHOUSE,COMMERCIAL,0,58700,58700,0,242400,301100
191710202000000,CONC/ASPH;INDUSTRIAL,INDUSTRIAL,0,278200,278200,0,409600,687800
191710202100000,VACANT LAND,INDUSTRIAL,0,138700,138700,0,0,138700
191710202200000,WAREHOUSE,COMMERCIAL,0,141600,141600,0,474800,616400
191710202301000,SHOP,COMMERCIAL,0,55000,55000,0,303000,358000
191710202301001,SHOP,COMMERCIAL,0,22900,22900,0,160200,183100
191710202301002,SHOP,COMMERCIAL,0,11500,11500,0,68300,79800
191710202301003,SHOP,COMMERCIAL,0,11500,11500,0,68300,79800
191710202301004,SHOP,COMMERCIAL,0,27500,27500,0,124200,151700
191712600100000,WAREHOUSE,COMMERCIAL,0,35800,35800,0,158700,194500
191712600200000,SW 418,RESIDENTIAL,67500,0,67500,93400,0,160900
191712600300000,WAREHOUSE,COMMERCIAL,0,45500,45500,0,195200,240700
191712600400000,CITY PROPERTY,EXEMPT,0,0,0,0,0,0
191712600500000,WAREHOUSE,COMMERCIAL,0,221000,221000,0,379300,600300
191712600600000,WAREHOUSE,COMMERCIAL,0,533200,533200,0,374700,907900
191712600800000,WAREHOUSE,COMMERCIAL,0,450000,450000,0,619500,1069500
191712600900000,CENTRALLY ASSESSED,OTHER,0,0,0,0,0,0
191712601000000,EQUIPMENT MFG;INDUST,INDUSTRIAL,0,238000,238000,0,1295200,1533200
191712601100000,WAREHOUSE,COMMERCIAL,0,184000,184000,0,315100,499100
191712700100000,WAREHOUSE,COMMERCIAL,0,310000,310000,0,1224200,1534200
191712700200000,SHOP,COMMERCIAL,0,114300,114300,0,379600,493900
191712700300000,SHOP,COMMERCIAL,0,132600,132600,0,40100,172700
191712700400000,VACANT LAND,COMMERCIAL,0,202000,202000,0,0,202000
191712700500000,WAREHOUSE,COMMERCIAL,0,171000,171000,0,293300,464300
191715100100000,FOOD GRADE;INDUST,INDUSTRIAL,0,541700,541700,0,219900,761600
191715200100000,VACANT LAND,COMMERCIAL,0,326000,326000,0,0,326000
191715200200000,FLAT PARKING,COMMERCIAL,0,318000,318000,0,40600,358600
191715200300000,WAREHOUSE,COMMERCIAL,0,124000,124000,0,327700,451700
191715200400000,WAREHOUSE,COMMERCIAL,0,190800,190800,0,258400,449200
191715300100000,WAREHOUSE,COMMERCIAL,0,413000,413000,0,490800,903800
191715300200000,FLAT PARKING,COMMERCIAL,0,41300,41300,0,29400,70700
191715300300000,FLAT PARKING,COMMERCIAL,0,217700,217700,0,63000,280700
191715400100000,SHOP,COMMERCIAL,0,295200,295200,0,601900,897100
191717600100000,WAREHOUSE,COMMERCIAL,0,226000,226000,0,314100,540100
191717600200000,WAR VETERANS,COMMERCIAL,0,145800,145800,0,386500,532300
191717600300000,VACANT LAND,COMMERCIAL,0,71600,71600,0,0,71600
191717600400000,SHOP,INDUSTRIAL,0,419800,419800,0,1542700,1962500
191717600500000,WAREHOUSE,COMMERCIAL,0,60300,60300,0,145600,205900
191717600600000,WAREHOUSE,COMMERCIAL,0,72200,72200,0,226500,298700
191717600700000,SMALL RETAIL,COMMERCIAL,0,27900,27900,0,98600,126500
191717600800000,WAREHOUSE,COMMERCIAL,0,48800,48800,0,109100,157900
191717600900000,VETERINARY CLINIC,EXEMPT,0,53600,53600,0,115600,169200
191717601000000,VACANT LAND,EXEMPT,0,39000,39000,0,0,39000
191717601002000,BILLBOARD(BLL),COMMERCIAL,0,0,0,0,12100,12100
191717700100000,LG DISCOUNT/RETAIL,COMMERCIAL,0,187500,187500,0,286600,474100
191717700200000,WAREHOUSE,COMMERCIAL,0,84300,84300,0,126200,210500
191717700300000,WAREHOUSE,COMMERCIAL,0,77500,77500,0,239000,316500
191717700400000,WAREHOUSE,COMMERCIAL,0,75000,75000,0,92000,167000
191717700500000,WAREHOUSE,COMMERCIAL,0,380000,380000,0,810300,1190300
191717700600000,WAREHOUSE,COMMERCIAL,0,59500,59500,0,136000,195500
191717700700000,SHOP,COMMERCIAL,4740,153260,158000,7779,251521,417300
191717800100000,EQUIPMENT MFG;INDUST,INDUSTRIAL,0,101100,101100,0,573300,674400
191717800200000,WAREHOUSE,COMMERCIAL,0,431700,431700,0,1527900,1959600
191717800400000,WAREHOUSE,COMMERCIAL,0,145000,145000,0,156300,301300
191717800500000,WAREHOUSE,COMMERCIAL,0,140700,140700,0,287600,428300
191722600100000,SW 418,AG LAND,72200,0,72200,0,0,72200
191725100100000,SW 418,AG LAND,76700,0,76700,0,0,76700
191727600100000,FOOD GRADE;INDUST,INDUSTRIAL,0,4329600,4329600,0,68404300,72733900
191732600100000,SW 418,AG LAND,76200,0,76200,0,0,76200
191735100100000,SW 418,AG LAND,63400,0,63400,0,0,63400
191737600300000,VACANT LAND,COMMERCIAL,0,143500,143500,0,0,143500
191737600700000,WAREHOUSE,COMMERCIAL,0,619000,619000,0,3411000,4030000
191737600900000,VACANT LAND,INDUSTRIAL,0,237400,237400,0,0,237400
191737700100000,EQUIPMENT MFG;INDUST,INDUSTRIAL,0,844000,844000,0,4898700,5742700
191737700200000,WAREHOUSE,INDUSTRIAL,0,92300,92300,0,214500,306800
191740100100000,SW 418,AG DWELLING,105200,0,105200,100000,9300,214500
191742600100000,SW 418,AG LAND,84500,0,84500,0,0,84500
191745100100000,SW 418,AG LAND,115200,0,115200,0,0,115200
191747600100000,SW 418,AG LAND,110100,0,110100,0,0,110100
191810100100000,SW 418,AG DWELLING,97000,0,97000,77100,11900,186000
191812600200000,FOOD GRADE;INDUST,INDUSTRIAL,0,794800,794800,0,8917000,9711800
191812600300000,VACANT LAND,AG LAND,59200,0,59200,0,0,59200
191815100100000,SW 418,AG LAND,110900,0,110900,0,0,110900
191817600100000,SW 418,AG LAND,112600,0,112600,0,0,112600
191820100100000,WAREHOUSE,COMMERCIAL,0,302000,302000,0,75000,377000
191820100200000,SW 418,RESIDENTIAL,82400,0,82400,86900,0,169300
191822600100000,SW 418,AG LAND,103800,0,103800,0,0,103800
191825100100000,SW 418,AG LAND,112200,0,112200,0,1200,113400
191825100200000,SW 418,RESIDENTIAL,95100,0,95100,130100,0,225200
191827600100000,SW 418,AG LAND,111700,0,111700,0,0,111700
191830100100000,SW 418,AG LAND,106600,0,106600,0,0,106600
191832600100000,SW 418,AG LAND,116900,0,116900,0,0,116900
191835100100000,SW 418,AG LAND,114500,0,114500,0,0,114500
191837600100000,SW 418,AG DWELLING,113100,0,113100,44300,4400,161800
191840100100000,SW 418,AG LAND,115100,0,115100,0,0,115100
191842600100000,SW 418,AG LAND,115800,0,115800,0,0,115800
191845100100000,SW 418,AG LAND,112800,0,112800,0,0,112800
191847600300000,SW 418,AG LAND,81900,0,81900,0,0,81900
191910100100000,WAREHOUSE,COMMERCIAL,0,904800,904800,0,22074200,22979000
191917600100000,CITY PROPERTY,EXEMPT,0,0,0,0,0,0
191920100100000,CITY PROPERTY,EXEMPT,0,0,0,0,0,0
192010100200000,SW 418,AG DWELLING,44200,0,44200,0,0,44200
192010100300000,SW 418,AG DWELLING,65200,0,65200,118000,1000,184200
192012600100000,SW 418,AG LAND,118400,0,118400,0,0,118400
192015100100000,SW 418,AG LAND,119900,0,119900,0,0,119900
192017600100000,WAREHOUSE,COMMERCIAL,0,1602900,1602900,0,3489700,5092600
192020100100000,EQUIPMENT MFG;INDUST,INDUSTRIAL,0,881300,881300,0,5157100,6038400
192020100200000,OFFICE,COMMERCIAL,72360,329640,402000,60616,268684,731300
192020100300000,SW 418,AG LAND,18100,0,18100,0,0,18100
192022600100000,CITY PROPERTY,EXEMPT,0,0,0,0,0,0
192022600200000,SW 418,AG LAND,50200,0,50200,0,0,50200
192025100100000,SW 418,AG DWELLING,99200,0,99200,0,0,99200
192027600100000,SW 418,AG LAND,111100,0,111100,0,0,111100
192030100400000,CITY PROPERTY,EXEMPT,0,0,0,0,0,0
192032600100000,CITY PROPERTY,EXEMPT,0,0,0,0,0,0
192037600200000,CITY PROPERTY,EXEMPT,0,0,0,0,0,0
192037600400000,CITY PROPERTY,EXEMPT,0,0,0,0,0,0
192037600600000,CITY PROPERTY,EXEMPT,0,0,0,0,0,0
192037600700000,CITY PROPERTY,EXEMPT,0,0,0,0,0,0
192040100100000,SW 418,AG LAND,107500,0,107500,0,8800,116300
192040100102000,BILLBOARD(BLL),COMMERCIAL,0,0,0,0,16400,16400
192042600100000,SW 418,AG LAND,120300,0,120300,0,0,120300
192045100100000,SW 418,AG LAND,89800,0,89800,0,0,89800
192045200100000,SW 418,AG LAND,30700,0,30700,0,0,30700
192045200102000,BILLBOARD(BLL),COMMERCIAL,0,0,0,0,17700,17700
192047600300000,FLAT PARKING,COMMERCIAL,0,194000,194000,0,7300,201300
192047600400000,CONVENIENCE STORE,COMMERCIAL,0,214000,214000,0,555700,769700
192047600500000,VACANT LAND,COMMERCIAL,0,522700,522700,0,0,522700
192047600600000,VACANT LAND,COMMERCIAL,0,14000,14000,0,0,14000
192047600700000,VACANT LAND,COMMERCIAL,0,34200,34200,0,0,34200
192047600800000,VACANT LAND,COMMERCIAL,0,392000,392000,0,0,392000
192047700100000,HOTEL,COMMERCIAL,0,430000,430000,0,1992600,2422600
192047800100000,VACANT LAND,COMMERCIAL,0,370100,370100,0,0,370100
192047800200000,HOTEL,COMMERCIAL,0,415000,415000,0,1587600,2002600
192110100100000,SCHOOL,EXEMPT,0,0,0,0,0,0
192112600100000,SCHOOL,EXEMPT,0,0,0,0,0,0
192115100200000,SCHOOL,EXEMPT,0,0,0,0,0,0
192117600100000,SCHOOL,EXEMPT,0,0,0,0,0,0
192122600100000,SW 418,AG LAND,81100,0,81100,0,0,81100
192125100100000,SW 418,AG DWELLING,86700,0,86700,44700,8000,139400
192125100102000,BILLBOARD(BLL),COMMERCIAL,0,0,0,0,30600,30600
192130100100000,SW 456,AG LAND,103000,0,103000,0,0,103000
192132600100000,AUTO REPAIR/SALES,COMMERCIAL,0,1063300,1063300,0,3095500,4158800
192132600300000,VACANT LAND,AG LAND,22800,0,22800,0,0,22800
192132700200000,VACANT LAND,COMMERCIAL,0,8300,8300,0,0,8300
192132700300000,VACANT LAND,AG LAND,16500,0,16500,0,0,16500
192135100500000,FAST FOOD,COMMERCIAL,0,408000,408000,0,807600,1215600
192135100600000,VACANT LAND,COMMERCIAL,0,319800,319800,0,0,319800
192135100700000,VACANT LAND,COMMERCIAL,0,275200,275200,0,0,275200
192135101000000,CONVENIENCE STORE,COMMERCIAL,0,917300,917300,0,1735800,2653100
192135101100000,VACANT LAND,AG LAND,15400,0,15400,0,0,15400
192135200500000,SMALL RETAIL,COMMERCIAL,0,444500,444500,0,469600,914100
192135200800000,VACANT LAND,COMMERCIAL,0,100,100,0,0,100
192135200900000,VACANT LAND,AG LAND,7900,0,7900,0,0,7900
192137600100000,SW 456,AG LAND,72100,0,72100,0,0,72100
192140100200000,SW 452,RESIDENTIAL,21200,0,21200,114800,0,136000
192140100300000,SW 452,RESIDENTIAL,21200,0,21200,113600,0,134800
192140100400000,SW 452,RESIDENTIAL,21000,0,21000,113400,0,134400
192140100500000,SW 452,RESIDENTIAL,21000,0,21000,113400,0,134400
192140100600000,SW 452,RESIDENTIAL,21000,0,21000,113400,0,134400
192140100700000,SW 452,RESIDENTIAL,21000,0,21000,113400,0,134400
192140100800000,SW 452,RESIDENTIAL,21000,0,21000,113400,0,134400
192140100900000,SW 452,RESIDENTIAL,21000,0,21000,113400,0,134400
192140101000000,SW 452,RESIDENTIAL,23500,0,23500,113400,0,136900
192140101100000,SW 452,RESIDENTIAL,22900,0,22900,113400,0,136300
192140101200000,SW 452,RESIDENTIAL,23600,0,23600,117600,0,141200
192140101300000,SW 452,RESIDENTIAL,27600,0,27600,119000,0,146600
192140101400000,SW 452,RESIDENTIAL,29000,0,29000,133400,0,162400
192140101500000,SW 452,RESIDENTIAL,24700,0,24700,139200,0,163900
192140101600000,SW 452,RESIDENTIAL,23200,0,23200,119000,0,142200
192140101700000,SW 452,RESIDENTIAL,24400,0,24400,136000,0,160400
192140101800000,SW 452,RESIDENTIAL,24200,0,24200,141000,0,165200
192140101900000,SW 452,RESIDENTIAL,24200,0,24200,122700,0,146900
192140102000000,SW 452,RESIDENTIAL,24200,0,24200,138200,0,162400
192140102100000,SW 452,RESIDENTIAL,24200,0,24200,130600,0,154800
192140102200000,SW 452,RESIDENTIAL,23800,0,23800,125100,0,148900
192140102300000,SW 452,RESIDENTIAL,23900,0,23900,126700,0,150600
192140102400000,SW 452,RESIDENTIAL,7000,0,7000,0,0,7000
192140102500000,SW 452,RESIDENTIAL,63600,0,63600,146600,0,210200
192140102600000,SW 452,RESIDENTIAL,36200,0,36200,156100,0,192300
192140102700000,SW 452,RESIDENTIAL,34700,0,34700,179400,0,214100
192140102800000,SW 452,RESIDENTIAL,34700,0,34700,150300,0,185000
192140102900000,SW 452,RESIDENTIAL,34700,0,34700,144600,0,179300
192140103000000,SW 452,RESIDENTIAL,34700,0,34700,168700,0,203400
192140103100000,SW 452,RESIDENTIAL,40900,0,40900,181400,0,222300
192140103200000,SW 452,RESIDENTIAL,41800,0,41800,158700,0,200500
192140103300000,SW 452,RESIDENTIAL,37400,0,37400,190100,0,227500
192140103400000,SW 452,RESIDENTIAL,38400,0,38400,190300,0,228700
192140103500000,SW 452,RESIDENTIAL,47000,0,47000,166400,0,213400
192140103600000,SW 452,RESIDENTIAL,41300,0,41300,148400,0,189700
192140103700000,SW 452,RESIDENTIAL,37500,0,37500,160800,0,198300
192140103800000,SW 452,RESIDENTIAL,52200,0,52200,151700,0,203900
192140103900000,SW 452,RESIDENTIAL,48300,0,48300,152200,0,200500
192140104000000,SW 452,RESIDENTIAL,47900,0,47900,156000,0,203900
192140104100000,SW 452,RESIDENTIAL,53900,0,53900,146400,0,200300
192140104200000,SW 452,RESIDENTIAL,51600,0,51600,154400,0,206000
192140104300000,SW 452,RESIDENTIAL,43000,0,43000,157100,0,200100
192140104400000,SW 452,RESIDENTIAL,42400,0,42400,159200,0,201600
192140104500000,SW 452,RESIDENTIAL,35500,0,35500,140700,0,176200
192140104600000,SW 452,RESIDENTIAL,61100,0,61100,193300,0,254400
192140104700000,SW 452,RESIDENTIAL,46500,0,46500,138700,0,185200
192140104800000,SW 452,RESIDENTIAL,45100,0,45100,176700,0,221800
192140104900000,SW 452,RESIDENTIAL,44700,0,44700,143300,0,188000
192140105000000,SW 452,RESIDENTIAL,43000,0,43000,166500,0,209500
192140105800000,SW 452,RESIDENTIAL,39300,0,39300,162300,0,201600
192140105900000,SW 452,RESIDENTIAL,44900,0,44900,158700,0,203600
192140106000000,SW 452,RESIDENTIAL,46200,0,46200,151600,0,197800
192140106100000,SW 452,RESIDENTIAL,42100,0,42100,171600,0,213700
192140106200000,SW 452,RESIDENTIAL,42800,0,42800,165500,0,208300
192140106300000,SW 452,RESIDENTIAL,42800,0,42800,167700,0,210500
192140106400000,SW 452,RESIDENTIAL,42800,0,42800,146600,0,189400
192140106500000,SW 452,RESIDENTIAL,42800,0,42800,158600,0,201400
192140106600000,SW 452,RESIDENTIAL,40100,0,40100,170300,0,210400
192140200100000,SW 452,RESIDENTIAL,47100,0,47100,134200,0,181300
192140200200000,SW 452,RESIDENTIAL,36300,0,36300,154700,0,191000
192140200300000,SW 452,RESIDENTIAL,38100,0,38100,182400,0,220500
192140200400000,SW 452,RESIDENTIAL,38100,0,38100,157500,0,195600
192140200500000,SW 452,RESIDENTIAL,38100,0,38100,147000,0,185100
192140200600000,SW 452,RESIDENTIAL,30200,0,30200,152800,0,183000
192140200700000,SW 452,RESIDENTIAL,37900,0,37900,134200,0,172100
192140200800000,SW 452,RESIDENTIAL,37900,0,37900,146000,0,183900
192140200900000,SW 452,RESIDENTIAL,37900,0,37900,129700,0,167600
192140201000000,SW 452,RESIDENTIAL,37900,0,37900,148800,0,186700
192140201100000,SW 452,RESIDENTIAL,37900,0,37900,147900,0,185800
192140201200000,SW 452,RESIDENTIAL,42400,0,42400,172900,0,215300
192140201300000,SW 452,RESIDENTIAL,38100,0,38100,153400,0,191500
192140201400000,SW 452,RESIDENTIAL,38100,0,38100,167500,0,205600
192140201500000,SW 452,RESIDENTIAL,38100,0,38100,141000,0,179100
192140201600000,SW 452,RESIDENTIAL,45200,0,45200,153100,0,198300
192140300100000,SW 452,RESIDENTIAL,40000,0,40000,140300,0,180300
192140300200000,SW 452,RESIDENTIAL,39900,0,39900,145100,0,185000
192140300300000,SW 452,RESIDENTIAL,38200,0,38200,153900,0,192100
192140300400000,SW 452,RESIDENTIAL,38200,0,38200,138200,0,176400
192140300500000,SW 452,RESIDENTIAL,38200,0,38200,137400,0,175600
192140300600000,SW 452,RESIDENTIAL,44100,0,44100,144600,0,188700
192140301100000,SW 452,RESIDENTIAL,40700,0,40700,147400,0,188100
192140301500000,SW 452,RESIDENTIAL,39500,0,39500,162900,0,202400
192140301600000,SW 452,RESIDENTIAL,40300,0,40300,145500,0,185800
192140301700000,SW 452,RESIDENTIAL,44400,0,44400,151300,0,195700
192140301800000,SW 452,RESIDENTIAL,31600,0,31600,166600,0,198200
192140301900000,SW 452,RESIDENTIAL,41300,0,41300,145300,0,186600
192140302000000,SW 452,RESIDENTIAL,46800,0,46800,173300,0,220100
192140302100000,SW 452,RESIDENTIAL,42000,0,42000,160800,0,202800
192140302200000,SW 452,RESIDENTIAL,43300,0,43300,169700,0,213000
192140302300000,SW 452,RESIDENTIAL,46900,0,46900,165800,0,212700
192140302500000,SW 452,RESIDENTIAL,36200,0,36200,185000,0,221200
192140302600000,SW 452,RESIDENTIAL,51800,0,51800,153900,0,205700
192140302700000,SW 452,RESIDENTIAL,0,0,0,0,0,0
192140400200000,SW 452,RESIDENTIAL,37000,0,37000,117200,0,154200
192140400300000,SW 452,RESIDENTIAL,37000,0,37000,115800,0,152800
192140400400000,SW 452,RESIDENTIAL,37000,0,37000,127000,0,164000
192140400500000,SW 452,RESIDENTIAL,38500,0,38500,119600,0,158100
192140400600000,SW 452,RESIDENTIAL,53700,0,53700,118200,0,171900
192140400700000,SW 452,RESIDENTIAL,37000,0,37000,127000,0,164000
192142600100000,SW 456,AG LAND,118800,0,118800,0,0,118800
192145100200000,SW 456,AG LAND,12400,0,12400,0,0,12400
192145100300000,OFFICE,COMMERCIAL,0,512000,512000,0,2289200,2801200
192145100500000,SW 456,AG LAND,7100,0,7100,0,0,7100
192145100600000,SW 456,AG LAND,7800,0,7800,0,0,7800
192145200100000,OFFICE,COMMERCIAL,0,551700,551700,0,3908900,4460600
192145200200000,SW 456,AG LAND,42000,0,42000,0,0,42000
192145200300000,SW 456,AG LAND,7100,0,7100,0,0,7100
192147600300000,SW 456,AG LAND,99300,0,99300,0,0,99300
192147600400000,SW 452,RESIDENTIAL,39500,0,39500,156200,0,195700
192147600500000,SW 452,RESIDENTIAL,39900,0,39900,143600,0,183500
192147600600000,SW 452,RESIDENTIAL,38000,0,38000,152900,0,190900
192147600700000,SW 452,RESIDENTIAL,33600,0,33600,169400,0,203000
192147600800000,SW 452,RESIDENTIAL,49100,0,49100,219800,0,268900
192147601000000,SW 452,RESIDENTIAL,41500,0,41500,160500,0,202000
192220100200000,VACANT LAND,COMMERCIAL,0,655000,655000,0,0,655000
192222600300000,EDUCATIONAL/COLLEGE,EXEMPT,0,0,0,0,0,0
192225100300000,SCHOOL,EXEMPT,0,0,0,0,0,0
192232600100000,SCHOOL,AG LAND,109500,0,109500,0,0,109500
192235100100000,SCHOOL,AG DWELLING,95000,0,95000,49000,1100,145100
192820100100000,VACANT LAND,COMMERCIAL,0,577000,577000,0,0,577000
192820100200000,WAREHOUSE,COMMERCIAL,0,1398000,1398000,0,7702000,9100000
192822600500000,WAREHOUSE,COMMERCIAL,0,411900,411900,0,531700,943600
192822600700000,AUTO REPAIR/SALES,COMMERCIAL,0,402100,402100,0,1074700,1476800
192822601000000,VACANT LAND,COMMERCIAL,0,877000,877000,0,0,877000
192822601200000,CONVENIENCE STORE,COMMERCIAL,0,937800,937800,0,2534400,3472200
192825100100000,SW 418,AG LAND,27600,0,27600,0,0,27600
192825100200000,WAREHOUSE,COMMERCIAL,0,807400,807400,0,3664500,4471900
192825100300000,SW 418,AG LAND,42200,0,42200,0,0,42200
192825100302000,ANTENNAS/TOWERS(BLL),COMMERCIAL,0,0,0,0,100900,100900
192827600100000,SW 418,AG LAND,91500,0,91500,0,0,91500
192830100100000,SW 418,AG LAND,93700,0,93700,0,0,93700
192832600200000,SW 418,AG LAND,190700,0,190700,0,0,190700
192835100400000,WAREHOUSE,COMMERCIAL,0,789000,789000,0,3689000,4478000
192837600100000,SW 418,AG LAND,62000,0,62000,0,0,62000
192910100100000,VACANT LAND,AG LAND,41900,0,41900,0,0,41900
192910100200000,OFFICE; MEDICAL,COMMERCIAL,0,580000,580000,0,1239100,1819100
192910200100000,OFFICE,COMMERCIAL,0,403000,403000,0,1496200,1899200
192910200200000,WAREHOUSE,COMMERCIAL,0,317400,317400,0,1267800,1585200
192910200201000,WAREHOUSE,COMMERCIAL,0,58200,58200,0,286600,344800
192910200300000,WAREHOUSE,COMMERCIAL,0,375600,375600,0,1470700,1846300
192910300100000,VACANT LAND,COMMERCIAL,0,162900,162900,0,0,162900
192910300200000,WAREHOUSE,COMMERCIAL,0,266100,266100,0,478900,745000
192910300300000,VETERINARY CLINIC,COMMERCIAL,0,180000,180000,0,741700,921700
192912600300000,SW 418,RESIDENTIAL,41000,0,41000,106600,0,147600
192912600400000,SW 418,RESIDENTIAL,32400,0,32400,125200,0,157600
192912600500000,SW 418,RESIDENTIAL,24000,0,24000,103400,0,127400
192912600600000,SW 418,RESIDENTIAL,24000,0,24000,88500,0,112500
192912600700000,CITY PROPERTY,EXEMPT,0,0,0,0,0,0
192912600800000,CITY PROPERTY,EXEMPT,0,0,0,0,0,0
192912600900000,CITY PROPERTY,EXEMPT,0,0,0,0,0,0
192912601100000,SW 418,RESIDENTIAL,37100,0,37100,125100,0,162200
192912601200000,SW 418,AG LAND,28900,0,28900,0,16700,45600
192912601400000,WAREHOUSE,COMMERCIAL,0,285000,285000,0,809600,1094600
192912601500000,SW 418,AG LAND,200,0,200,0,0,200
192912601600000,VACANT LAND,COMMERCIAL,0,57000,57000,0,0,57000
192912601800000,SHOP,COMMERCIAL,0,255600,255600,0,1116500,1372100
192912602000000,SW 418,AG LAND,7600,0,7600,0,0,7600
192912602100000,SW 418,AG LAND,17500,0,17500,0,0,17500
192912700100000,SW 418,AG LAND,10100,0,10100,0,0,10100
192915100200000,WAREHOUSE,COMMERCIAL,0,747200,747200,0,4091300,4838500
192915100300000,SW 418,AG LAND,99500,0,99500,0,0,99500
192915100400000,SW 418,AG LAND,100,0,100,0,0,100
192917600200000,WAREHOUSE,COMMERCIAL,0,268800,268800,0,162500,431300
192917600300000,SW 418,RESIDENTIAL,1000,0,1000,0,0,1000
192917600400000,CENTRALLY ASSESSED,OTHER,0,0,0,0,0,0
192917600500000,VACANT LAND,COMMERCIAL,0,253500,253500,0,0,253500
192917600600000,SW 418,AG LAND,13900,0,13900,0,0,13900
192917600700000,SW 418,AG LAND,17700,0,17700,0,0,17700
192917700100000,OFFICE,COMMERCIAL,0,475800,475800,0,1524600,2000400
192917700200000,SW 418,AG LAND,7800,0,7800,0,0,7800
192917700300000,SW 418,AG LAND,21000,0,21000,0,0,21000
192920100200000,SW 418,AG LAND,5000,0,5000,0,6700,11700
192920100300000,SW 418,AG LAND,41900,0,41900,0,0,41900
192920100400000,CITY PROPERTY,EXEMPT,0,0,0,0,0,0
192920100500000,SW 418,RESIDENTIAL,52300,0,52300,111800,0,164100
192920100600000,SW 418,RESIDENTIAL,51200,0,51200,88500,0,139700
192920100800000,SW 418,AG LAND,600,0,600,0,0,600
192920100900000,SW 418,AG LAND,500,0,500,0,0,500
192922600100000,SW 418,RESIDENTIAL,800,0,800,0,0,800
192922600300000,SW 418,RESIDENTIAL,31100,0,31100,102300,0,133400
192922600500000,SW 418,RESIDENTIAL,30900,0,30900,121800,0,152700
192922600600000,SW 418,RESIDENTIAL,30900,0,30900,182300,0,213200
192922600700000,SW 418,RESIDENTIAL,33300,0,33300,96700,0,130000
192922600800000,VACANT LAND,AG LAND,12000,0,12000,0,0,12000
192922600900000,VACANT LAND,AG LAND,15400,0,15400,0,0,15400
192922601000000,WAREHOUSE,COMMERCIAL,0,37400,37400,0,23400,60800
192922601200000,SW 418,RESIDENTIAL,47300,0,47300,115800,0,163100
192922601300000,SW 418,RESIDENTIAL,30800,0,30800,86900,0,117700
192922601400000,SW 418,RESIDENTIAL,800,0,800,0,0,800
192922601500000,WAREHOUSE,COMMERCIAL,0,138000,138000,0,357700,495700
192922601600000,SHOP,COMMERCIAL,0,162000,162000,0,0,162000
192922601800000,WAREHOUSE,COMMERCIAL,0,370000,370000,0,840300,1210300
192922601900000,WAREHOUSE,COMMERCIAL,0,329000,329000,0,1609600,1938600
192922700100000,SW 418,RESIDENTIAL,800,0,800,0,0,800
192922700200000,SW 418,RESIDENTIAL,800,0,800,0,0,800
192922700300000,SW 418,RESIDENTIAL,32200,0,32200,110400,0,142600
192922700400000,SW 418,RESIDENTIAL,35500,0,35500,97600,0,133100
192922700500000,SW 418,RESIDENTIAL,35000,0,35000,88600,0,123600
192922700600000,SW 418,RESIDENTIAL,36100,0,36100,125400,0,161500
192922700700000,SW 418,RESIDENTIAL,35500,0,35500,120500,0,156000
192922700800000,SW 418,RESIDENTIAL,30800,0,30800,83900,0,114700
192922800100000,VACANT LAND,COMMERCIAL,0,27900,27900,0,0,27900
192922800200000,CITY PROPERTY,EXEMPT,0,0,0,0,0,0
192922800300000,SW 418,RESIDENTIAL,7100,0,7100,41300,0,48400
192927600200000,SW 418,AG LAND,1800,0,1800,0,0,1800
192940100100000,SW 418,RESIDENTIAL,62700,0,62700,126600,0,189300
192940100200000,SW 418,AG LAND,110400,0,110400,0,0,110400
192942600100000,SW 418,AG LAND,122000,0,122000,0,0,122000
192947600100000,WAREHOUSE-TRANSIT,COMMERCIAL,0,625000,625000,0,412900,1037900
192947600300000,WAREHOUSE,COMMERCIAL,0,628000,628000,0,3005000,3633000
192947700100000,WAREHOUSE-TRANSIT,COMMERCIAL,0,588800,588800,0,267200,856000
192947700400000,WAREHOUSE,COMMERCIAL,0,442400,442400,0,593500,1035900
193010100100000,CITY PROPERTY,EXEMPT,0,0,0,0,0,0
193020100200000,WAREHOUSE,COMMERCIAL,0,527000,527000,0,1355900,1882900
193020100500000,CITY PROPERTY,EXEMPT,0,0,0,0,0,0
193020100700000,VACANT LAND,COMMERCIAL,0,69000,69000,0,0,69000
193020100900000,WAREHOUSE,COMMERCIAL,0,61500,61500,0,185800,247300
193020101000000,WAREHOUSE,COMMERCIAL,0,121500,121500,0,556200,677700
193037600100000,CITY PROPERTY,EXEMPT,0,0,0,0,0,0
193047600100000,STATE PROPERTY,EXEMPT,0,0,0,0,0,0
193110100100000,CITY PROPERTY,EXEMPT,0,0,0,0,0,0
193222600100000,CITY PROPERTY,EXEMPT,0,0,0,0,0,0
193240100200000,SW 418,AG DWELLING,9600,0,9600,159600,13600,182800
193242600200000,SW 418,AG LAND,222200,0,222200,0,0,222200
193322601200000,WAREHOUSE,COMMERCIAL,0,722800,722800,0,3940600,4663400
193322601300000,SW 418,AG LAND,12000,0,12000,0,0,12000
193322601400000,SW 418,AG LAND,7800,0,7800,0,0,7800
193322601500000,VACANT LAND,COMMERCIAL,0,8000,8000,0,0,8000
193325100300000,WAREHOUSE,COMMERCIAL,0,924000,924000,0,5697700,6621700
193325100800000,SW 418,AG LAND,20900,0,20900,0,0,20900
193325101100000,FLAT PARKING,COMMERCIAL,0,717000,717000,0,634500,1351500
193325101400000,VACANT LAND,COMMERCIAL,0,120000,120000,0,0,120000
193332600200000,SERVICE STATION,COMMERCIAL,0,1288500,1288500,0,527800,1816300
193332600300000,VACANT LAND,AG LAND,48400,0,48400,0,0,48400
193335100200000,SW 418,RESIDENTIAL,38400,0,38400,95800,0,134200
193335100300000,SW 418,RESIDENTIAL,33600,0,33600,69900,0,103500
193335100400000,SW 418,RESIDENTIAL,61900,0,61900,75600,0,137500
193335100700000,VACANT LAND,COMMERCIAL,0,86000,86000,0,0,86000
193335100800000,VACANT LAND,COMMERCIAL,0,77300,77300,0,0,77300
193335100900000,VACANT LAND,COMMERCIAL,0,76400,76400,0,0,76400
193335101000000,AUTO REPAIR/SALES,COMMERCIAL,0,727500,727500,0,2195000,2922500
193335200100000,VACANT LAND,COMMERCIAL,0,90300,90300,0,0,90300
193335200200000,VACANT LAND,COMMERCIAL,0,83300,83300,0,0,83300
193335200300000,VACANT LAND,COMMERCIAL,0,69500,69500,0,0,69500
193335200400000,VACANT LAND,COMMERCIAL,0,60600,60600,0,0,60600
193335200500000,VACANT LAND,COMMERCIAL,0,5200,5200,0,0,5200
193337700100000,VACANT LAND,COMMERCIAL,0,127700,127700,0,0,127700
200110100200000,LG DISCOUNT/RETAIL,COMMERCIAL,0,2709800,2709800,0,9272400,11982200
200110100300000,FAST FOOD,COMMERCIAL,0,276600,276600,0,699600,976200
200110100400000,NBHD SHOPPING CENTER,COMMERCIAL,0,764400,764400,0,2613500,3377900
200110100500000,NBHD SHOPPING CENTER,COMMERCIAL,0,335000,335000,0,837300,1172300
200110100700000,SERVICE STATION,COMMERCIAL,0,394800,394800,0,177500,572300
200110100900000,FAST FOOD,COMMERCIAL,0,368000,368000,0,529300,897300
200110101000000,CARWASH,COMMERCIAL,0,408000,408000,0,237600,645600
200110300100000,VACANT LAND,EXEMPT,0,12200,12200,0,0,12200
200112600200000,BRANCH BANK/CU,COMMERCIAL,0,497500,497500,0,1185800,1683300
200112600500000,AUTO REPAIR/SALES,COMMERCIAL,0,684200,684200,0,613500,1297700
200112701000000,VACANT LAND,COMMERCIAL,0,0,0,0,0,0
200112701001000,AUTO REP/SAL;CTRL CR,COMMERCIAL,0,257200,257200,0,664800,922000
200112701001001,LG DISCOUNT/RETAIL,COMMERCIAL,0,789500,789500,0,2716100,3505600
200112701001002,FLAT PARKING,COMMERCIAL,0,557200,557200,0,81600,638800
200112701001003,VACANT LAND,COMMERCIAL,0,206400,206400,0,0,206400
200115100100000,SW 407,AG LAND,13100,0,13100,0,0,13100
200115100200000,SW 434,RESIDENTIAL,32200,0,32200,183400,0,215600
200115100300000,SW 434,RESIDENTIAL,32200,0,32200,162600,0,194800
200115100500000,SW 434,RESIDENTIAL,32200,0,32200,221500,0,253700
200115100600000,SW 434,RESIDENTIAL,32200,0,32200,183300,0,215500
200115100700000,SW 434,RESIDENTIAL,32200,0,32200,172400,0,204600
200115100800000,SW 434,RESIDENTIAL,32200,0,32200,169300,0,201500
200115100900000,SW 434,RESIDENTIAL,32200,0,32200,156500,0,188700
200115101000000,SW 434,RESIDENTIAL,32400,0,32400,160800,0,193200
200115101100000,SW 434,RESIDENTIAL,32200,0,32200,166500,0,198700
200115101200000,SW 434,RESIDENTIAL,32200,0,32200,167300,0,199500
200115101300000,SW 434,RESIDENTIAL,34500,0,34500,164400,0,198900
200115200300000,SW 434,RESIDENTIAL,39400,0,39400,175700,0,215100
200115200400000,SW 434,RESIDENTIAL,36800,0,36800,170400,0,207200
200115200500000,SW 434,RESIDENTIAL,36800,0,36800,211400,0,248200
200115200600000,SW 434,RESIDENTIAL,36800,0,36800,196700,0,233500
200115200700000,SW 434,RESIDENTIAL,39400,0,39400,211600,0,251000
200115200900000,SW 434,RESIDENTIAL,38000,0,38000,177200,0,215200
200115201000000,SW 434,RESIDENTIAL,36800,0,36800,180000,0,216800
200115201100000,SW 434,RESIDENTIAL,36800,0,36800,165900,0,202700
200115201200000,SW 434,RESIDENTIAL,36800,0,36800,165600,0,202400
200115201300000,SW 434,RESIDENTIAL,39500,0,39500,155900,0,195400
200115300100000,SW 434,RESIDENTIAL,35200,0,35200,164000,0,199200
200115300200000,SW 434,RESIDENTIAL,36800,0,36800,168700,0,205500
200115300300000,SW 434,RESIDENTIAL,36800,0,36800,174700,0,211500
200115300400000,SW 434,RESIDENTIAL,36800,0,36800,162100,0,198900
200115300500000,SW 434,RESIDENTIAL,37200,0,37200,180800,0,218000
200115400100000,SW 434,RESIDENTIAL,32200,0,32200,168900,0,201100
200115400200000,SW 434,RESIDENTIAL,32200,0,32200,170200,0,202400
200115400300000,SW 434,RESIDENTIAL,32200,0,32200,162600,0,194800
200115400400000,SW 434,RESIDENTIAL,31900,0,31900,160400,0,192300
200115400500000,SW 434,RESIDENTIAL,32200,0,32200,160100,0,192300
200115400600000,SW 434,RESIDENTIAL,36800,0,36800,175500,0,212300
200115500100000,SW 434,RESIDENTIAL,39000,0,39000,171200,0,210200
200115500200000,SW 434,RESIDENTIAL,38400,0,38400,175200,0,213600
200115500300000,SW 434,RESIDENTIAL,38400,0,38400,160900,0,199300
200115500400000,SW 434,RESIDENTIAL,38400,0,38400,163800,0,202200
200115500500000,SW 434,RESIDENTIAL,38000,0,38000,172600,0,210600
200115500600000,SW 434,RESIDENTIAL,44200,0,44200,174900,0,219100
200115500700000,SW 434,RESIDENTIAL,33900,0,33900,159500,0,193400
200115500800000,SW 434,RESIDENTIAL,34600,0,34600,146800,0,181400
200115500900000,SW 434,RESIDENTIAL,34600,0,34600,200100,0,234700
200115501000000,SW 434,RESIDENTIAL,37400,0,37400,174200,0,211600
200115600100000,SW 434,RESIDENTIAL,36800,0,36800,156900,0,193700
200115600200000,SW 434,RESIDENTIAL,32700,0,32700,147500,0,180200
200115600300000,SW 434,RESIDENTIAL,37600,0,37600,178600,0,216200
200115600400000,SW 434,RESIDENTIAL,44400,0,44400,199700,0,244100
200115600500000,SW 434,RESIDENTIAL,47900,0,47900,208500,0,256400
200115600600000,SW 434,RESIDENTIAL,40800,0,40800,158200,0,199000
200115600700000,SW 434,RESIDENTIAL,35600,0,35600,189900,0,225500
200115600800000,SW 434,RESIDENTIAL,35100,0,35100,175000,0,210100
200115600900000,SW 434,RESIDENTIAL,35100,0,35100,194300,0,229400
200115601000000,SW 434,RESIDENTIAL,35500,0,35500,190700,0,226200
200115601100000,SW 434,RESIDENTIAL,35500,0,35500,193600,0,229100
200115601200000,SW 434,RESIDENTIAL,35500,0,35500,182300,0,217800
200115601300000,SW 434,RESIDENTIAL,37500,0,37500,202500,0,240000
200115601500000,CITY PROPERTY,EXEMPT,0,0,0,0,0,0
200115700200000,CITY PROPERTY,EXEMPT,0,0,0,0,0,0
200117600300000,NBHD SHOPPING CENTER,COMMERCIAL,0,728000,728000,0,1582900,2310900
200117600400000,FAST FOOD,COMMERCIAL,0,396000,396000,0,733300,1129300
200117600500000,LG DISCOUNT/RETAIL,COMMERCIAL,0,2244000,2244000,0,5389100,7633100
200117700100000,CHURCH,EXEMPT,0,941400,941400,0,1859700,2801100
200117700200000,SW 434,RESIDENTIAL,32900,0,32900,189200,0,222100
200117700300000,SW 434,RESIDENTIAL,37900,0,37900,211900,0,249800
200117700400000,SW 434,RESIDENTIAL,39100,0,39100,150400,0,189500
200117700500000,SW 434,RESIDENTIAL,37500,0,37500,166000,0,203500
200117700600000,SW 434,RESIDENTIAL,37100,0,37100,135900,0,173000
200117700700000,SW 434,RESIDENTIAL,38300,0,38300,149200,0,187500
200117800100000,SW 434,RESIDENTIAL,36700,0,36700,144200,0,180900
200117800200000,SW 434,RESIDENTIAL,37600,0,37600,130400,0,168000
200117800300000,SW 434,RESIDENTIAL,38000,0,38000,168700,0,206700
200117800400000,SW 434,RESIDENTIAL,37100,0,37100,225100,0,262200
200117800500000,SW 434,RESIDENTIAL,38700,0,38700,204100,0,242800
200117800600000,SW 434,RESIDENTIAL,34100,0,34100,199200,0,233300
200117800700000,SW 434,RESIDENTIAL,34800,0,34800,152800,0,187600
200117800800000,SW 434,RESIDENTIAL,38200,0,38200,164800,0,203000
200117800900000,SW 434,RESIDENTIAL,37100,0,37100,162500,0,199600
200117801000000,SW 434,RESIDENTIAL,50800,0,50800,214200,0,265000
200117801100000,SW 434,RESIDENTIAL,39000,0,39000,165500,0,204500
200117900100000,SW 434,RESIDENTIAL,45300,0,45300,176300,0,221600
200117900200000,SW 434,RESIDENTIAL,34900,0,34900,175500,0,210400
200117900300000,SW 434,RESIDENTIAL,34500,0,34500,196800,0,231300
200117900400000,SW 434,RESIDENTIAL,34500,0,34500,142700,0,177200
200117900500000,SW 434,RESIDENTIAL,35300,0,35300,154400,0,189700
200118000100000,SW 434,RESIDENTIAL,39400,0,39400,165700,0,205100
200118000200000,SW 434,RESIDENTIAL,37700,0,37700,200200,0,237900
200118000300000,SW 434,RESIDENTIAL,36000,0,36000,162000,0,198000
200118000400000,SW 434,RESIDENTIAL,35400,0,35400,174500,0,209900
200118000500000,SW 434,RESIDENTIAL,35000,0,35000,178100,0,213100
200118000600000,SW 434,RESIDENTIAL,32200,0,32200,162200,0,194400
200118000700000,SW 434,RESIDENTIAL,32200,0,32200,149800,0,182000
200118100100000,SW 434,RESIDENTIAL,32200,0,32200,174100,0,206300
200118100200000,SW 434,RESIDENTIAL,32200,0,32200,146000,0,178200
200120101000000,SW 407,AG LAND,16900,0,16900,0,0,16900
200120500400000,APARTMENT,MULTI-RES,29600,0,29600,310900,0,340500
200120600200000,VACANT LAND,EXEMPT,0,11400,11400,0,0,11400
200122700200000,NW 329,AG LAND,11300,0,11300,0,0,11300
200132600100000,SW 418,AG LAND,89000,0,89000,0,0,89000
200132600200000,SW 460,RESIDENTIAL,54000,0,54000,192400,0,246400
200132600300000,SW 460,RESIDENTIAL,102000,0,102000,255200,0,357200
200137600300000,SW 460,RESIDENTIAL,26000,0,26000,0,0,26000
200137600400000,SW 460,RESIDENTIAL,56400,0,56400,244800,0,301200
200137600500000,SW 460,RESIDENTIAL,62700,0,62700,205500,0,268200
200137600600000,SW 460,RESIDENTIAL,56400,0,56400,246900,0,303300
200137600700000,SW 460,RESIDENTIAL,56400,0,56400,232400,0,288800
200137600800000,SW 460,RESIDENTIAL,62700,0,62700,82400,0,145100
200137600900000,SW 460,RESIDENTIAL,57000,0,57000,257300,0,314300
200137601000000,SW 460,RESIDENTIAL,56700,0,56700,418100,0,474800
200137601100000,SW 460,RESIDENTIAL,84400,0,84400,351700,0,436100
200140100500000,BRANCH BANK/CU,COMMERCIAL,0,480600,480600,0,868200,1348800
200140100600000,VACANT LAND,COMMERCIAL,0,341400,341400,0,0,341400
200142900300000,CITY PROPERTY,EXEMPT,0,0,0,0,0,0
200145100300000,WAREHOUSE,COMMERCIAL,0,925000,925000,0,5952600,6877600
200145100500000,WAREHOUSE,COMMERCIAL,0,833300,833300,0,3704300,4537600
200145200100000,WAREHOUSE,COMMERCIAL,0,251000,251000,0,853000,1104000
200145200200000,WAREHOUSE,COMMERCIAL,0,328800,328800,0,41200,370000
200147600100000,VACANT LAND,COMMERCIAL,0,588500,588500,0,0,588500
200210100600000,SW 453,RESIDENTIAL,181300,0,181300,0,0,181300
200210300200000,SW 459,RESIDENTIAL,1700,0,1700,0,0,1700
200210300300000,SW 459,RESIDENTIAL,1600,0,1600,0,0,1600
200210300400000,SW 459,RESIDENTIAL,1600,0,1600,0,0,1600
200210300500000,SW 459,RESIDENTIAL,1600,0,1600,0,0,1600
200210300600000,SW 459,RESIDENTIAL,2000,0,2000,0,0,2000
200210300700000,SW 453,RESIDENTIAL,2800,0,2800,0,0,2800
200210300800000,SW 453,RESIDENTIAL,2500,0,2500,0,0,2500
200210300900000,SW 453,RESIDENTIAL,2500,0,2500,0,0,2500
200210301000000,SW 453,RESIDENTIAL,2700,0,2700,0,0,2700
200210301200000,SW 459,RESIDENTIAL,2400,0,2400,0,0,2400
200210400100000,SW 459,RESIDENTIAL,1400,0,1400,0,0,1400
200210400200000,SW 459,RESIDENTIAL,1400,0,1400,0,0,1400
200210400300000,SW 459,RESIDENTIAL,1400,0,1400,0,0,1400
200210400400000,SW 459,RESIDENTIAL,1600,0,1600,0,0,1600
200210400500000,SW 459,RESIDENTIAL,19500,0,19500,89100,0,108600
200210400600000,SW 459,RESIDENTIAL,39300,0,39300,89100,0,128400
200210400700000,SW 453,RESIDENTIAL,1900,0,1900,0,0,1900
200210400800000,SW 453,RESIDENTIAL,1500,0,1500,0,0,1500
200210400900000,SW 453,RESIDENTIAL,1500,0,1500,0,0,1500
200210401000000,SW 453,RESIDENTIAL,1500,0,1500,0,0,1500
200210401100000,SW 453,RESIDENTIAL,1500,0,1500,0,0,1500
200210401200000,SW 453,RESIDENTIAL,1500,0,1500,0,0,1500
200210500100000,SW 453,RESIDENTIAL,2800,0,2800,0,0,2800
200210500200000,SW 453,RESIDENTIAL,2400,0,2400,0,0,2400
200210500300000,SW 453,RESIDENTIAL,33000,0,33000,162800,0,195800
200210500400000,SW 453,RESIDENTIAL,33000,0,33000,164200,0,197200
200210500500000,SW 453,RESIDENTIAL,33000,0,33000,166000,0,199000
200210500600000,SW 453,RESIDENTIAL,33000,0,33000,71800,0,104800
200210500700000,SW 453,RESIDENTIAL,33000,0,33000,165100,0,198100
200210500800000,SW 453,RESIDENTIAL,33000,0,33000,153300,0,186300
200210500900000,SW 453,RESIDENTIAL,3000,0,3000,0,0,3000
200210501000000,SW 453,RESIDENTIAL,36700,0,36700,174400,0,211100
200210501100000,SW 453,RESIDENTIAL,35000,0,35000,166300,0,201300
200210600100000,SW 453,RESIDENTIAL,38300,0,38300,157300,0,195600
200210600200000,SW 453,RESIDENTIAL,37200,0,37200,46200,0,83400
200210600300000,SW 453,RESIDENTIAL,38900,0,38900,157200,0,196100
200210600400000,SW 453,RESIDENTIAL,2900,0,2900,0,0,2900
200210600500000,SW 453,RESIDENTIAL,3400,0,3400,0,0,3400
200210600600000,SW 453,RESIDENTIAL,3300,0,3300,0,0,3300
200210600700000,SW 453,RESIDENTIAL,2600,0,2600,0,0,2600
200210600800000,SW 453,RESIDENTIAL,2600,0,2600,0,0,2600
200210600900000,SW 453,RESIDENTIAL,3100,0,3100,0,0,3100
200210700100000,SW 453,RESIDENTIAL,36100,0,36100,164400,0,200500
200210700200000,SW 453,RESIDENTIAL,33300,0,33300,154600,0,187900
200210700300000,SW 453,RESIDENTIAL,33300,0,33300,163700,0,197000
200210700400000,SW 453,RESIDENTIAL,36700,0,36700,158100,0,194800
200210700500000,SW 453,RESIDENTIAL,2800,0,2800,0,0,2800
200210700600000,SW 453,RESIDENTIAL,2600,0,2600,0,0,2600
200210700700000,SW 453,RESIDENTIAL,2600,0,2600,0,0,2600
200210700800000,SW 453,RESIDENTIAL,2800,0,2800,0,0,2800
200212600300000,SW 453,RESIDENTIAL,44500,0,44500,162400,0,206900
200212600400000,SW 453,RESIDENTIAL,40600,0,40600,163900,0,204500
200212600500000,SW 453,RESIDENTIAL,40600,0,40600,154800,0,195400
200212600600000,SW 453,RESIDENTIAL,40600,0,40600,171700,0,212300
200212600700000,SW 453,RESIDENTIAL,40600,0,40600,155700,0,196300
200212600800000,SW 453,RESIDENTIAL,40600,0,40600,152500,0,193100
200212600900000,SW 453,RESIDENTIAL,40600,0,40600,153200,0,193800
200212601000000,SW 453,RESIDENTIAL,40600,0,40600,165100,0,205700
200212601100000,SW 453,RESIDENTIAL,40600,0,40600,150800,0,191400
200212601200000,SW 453,RESIDENTIAL,40600,0,40600,174000,0,214600
200212601300000,SW 453,RESIDENTIAL,40600,0,40600,183400,0,224000
200212601400000,SW 453,RESIDENTIAL,40600,0,40600,184800,0,225400
200212601500000,SW 453,RESIDENTIAL,40600,0,40600,161800,0,202400
200212601600000,SW 453,RESIDENTIAL,40600,0,40600,160500,0,201100
200212601700000,SW 453,RESIDENTIAL,40600,0,40600,173200,0,213800
200212601800000,SW 453,RESIDENTIAL,41000,0,41000,173600,0,214600
200212602000000,CITY PROPERTY,EXEMPT,0,0,0,0,0,0
200212602100000,SW 453,RESIDENTIAL,40600,0,40600,149800,0,190400
200212602200000,SW 453,RESIDENTIAL,41100,0,41100,141200,0,182300
200212602300000,SW 453,RESIDENTIAL,41000,0,41000,144200,0,185200
200212602400000,SW 453,RESIDENTIAL,41000,0,41000,138100,0,179100
200212602500000,SW 453,RESIDENTIAL,40600,0,40600,172000,0,212600
200212602600000,SW 453,RESIDENTIAL,40600,0,40600,140700,0,181300
200212602700000,SW 453,RESIDENTIAL,40600,0,40600,157000,0,197600
200212602800000,SW 453,RESIDENTIAL,40600,0,40600,148200,0,188800
200212602900000,SW 453,RESIDENTIAL,40600,0,40600,160500,0,201100
200212603000000,SW 453,RESIDENTIAL,40600,0,40600,149700,0,190300
200212603100000,SW 453,RESIDENTIAL,40600,0,40600,151900,0,192500
200212603200000,SW 453,RESIDENTIAL,40600,0,40600,160000,0,200600
200212603300000,SW 453,RESIDENTIAL,40600,0,40600,158600,0,199200
200212603400000,SW 453,RESIDENTIAL,40600,0,40600,161700,0,202300
200212603500000,SW 453,RESIDENTIAL,40600,0,40600,166000,0,206600
200212603600000,SW 453,RESIDENTIAL,45000,0,45000,150200,0,195200
200212700100000,SW 453,RESIDENTIAL,45000,0,45000,167100,0,212100
200212700200000,SW 453,RESIDENTIAL,39600,0,39600,179100,0,218700
200212700300000,SW 453,RESIDENTIAL,39600,0,39600,153700,0,193300
200212700400000,SW 453,RESIDENTIAL,39600,0,39600,168700,0,208300
200212700500000,SW 453,RESIDENTIAL,39600,0,39600,157300,0,196900
200212700600000,SW 453,RESIDENTIAL,39600,0,39600,180200,0,219800
200212700700000,SW 453,RESIDENTIAL,43800,0,43800,179200,0,223000
200212700800000,SW 453,RESIDENTIAL,41300,0,41300,177400,0,218700
200212700900000,SW 453,RESIDENTIAL,41300,0,41300,165100,0,206400
200212701000000,SW 453,RESIDENTIAL,41300,0,41300,168800,0,210100
200212701100000,SW 453,RESIDENTIAL,40700,0,40700,166200,0,206900
200212701200000,SW 453,RESIDENTIAL,40700,0,40700,163700,0,204400
200212701300000,SW 453,RESIDENTIAL,41100,0,41100,141600,0,182700
200212701400000,SW 453,RESIDENTIAL,41100,0,41100,142300,0,183400
200212701500000,SW 453,RESIDENTIAL,41500,0,41500,145300,0,186800
200212701600000,SW 453,RESIDENTIAL,41100,0,41100,177100,0,218200
200212701800000,SW 453,RESIDENTIAL,41300,0,41300,154100,0,195400
200212701900000,SW 459,RESIDENTIAL,34700,0,34700,131100,0,165800
200212702000000,SW 459,RESIDENTIAL,22200,0,22200,135800,0,158000
200212702100000,SW 459,RESIDENTIAL,20600,0,20600,129200,0,149800
200212702200000,SW 459,RESIDENTIAL,22400,0,22400,129200,0,151600
200212702300000,SW 459,RESIDENTIAL,25800,0,25800,129400,0,155200
200212702400000,SW 459,RESIDENTIAL,20800,0,20800,129400,0,150200
200212702500000,SW 459,RESIDENTIAL,20800,0,20800,129400,0,150200
200212702600000,SW 459,RESIDENTIAL,20600,0,20600,129400,0,150000
200212702700000,SW 459,RESIDENTIAL,20400,0,20400,129400,0,149800
200212702800000,SW 459,RESIDENTIAL,20400,0,20400,129400,0,149800
200212702900000,SW 459,RESIDENTIAL,20000,0,20000,148400,0,168400
200212703000000,SW 459,RESIDENTIAL,20100,0,20100,133400,0,153500
200212703100000,SW 459,RESIDENTIAL,20100,0,20100,133600,0,153700
200212703200000,SW 459,RESIDENTIAL,20100,0,20100,133400,0,153500
200212703300000,SW 459,RESIDENTIAL,20100,0,20100,134000,0,154100
200212703400000,SW 459,RESIDENTIAL,20100,0,20100,135000,0,155100
200212703500000,SW 459,RESIDENTIAL,20100,0,20100,138100,0,158200
200212703600000,SW 459,RESIDENTIAL,29400,0,29400,138100,0,167500
200212703700000,SW 459,RESIDENTIAL,20100,0,20100,139600,0,159700
200212703800000,SW 459,RESIDENTIAL,20100,0,20100,139600,0,159700
200212703900000,SW 459,RESIDENTIAL,20100,0,20100,141300,0,161400
200212704000000,SW 459,RESIDENTIAL,20100,0,20100,141300,0,161400
200212704100000,SW 459,RESIDENTIAL,20100,0,20100,132900,0,153000
200212704200000,SW 459,RESIDENTIAL,20100,0,20100,142800,0,162900
200212704300000,SW 459,RESIDENTIAL,20100,0,20100,141200,0,161300
200212704400000,SW 459,RESIDENTIAL,20100,0,20100,141200,0,161300
200212704500000,SW 459,RESIDENTIAL,20100,0,20100,126100,0,146200
200212704600000,SW 459,RESIDENTIAL,20100,0,20100,126100,0,146200
200212704700000,SW 459,RESIDENTIAL,20100,0,20100,93900,0,114000
200212704800000,SW 459,RESIDENTIAL,20100,0,20100,93900,0,114000
200212704900000,SW 459,RESIDENTIAL,1600,0,1600,0,0,1600
200212705000000,SW 459,RESIDENTIAL,2000,0,2000,0,0,2000
200212800100000,SW 453,RESIDENTIAL,44000,0,44000,151300,0,195300
200212800200000,SW 453,RESIDENTIAL,40200,0,40200,142100,0,182300
200212800300000,SW 453,RESIDENTIAL,40200,0,40200,159500,0,199700
200212800400000,SW 453,RESIDENTIAL,40200,0,40200,187200,0,227400
200212800500000,SW 453,RESIDENTIAL,41300,0,41300,144900,0,186200
200212800600000,SW 453,RESIDENTIAL,41300,0,41300,168700,0,210000
200212800700000,SW 453,RESIDENTIAL,40200,0,40200,150400,0,190600
200212800800000,SW 453,RESIDENTIAL,40200,0,40200,156500,0,196700
200212800900000,SW 453,RESIDENTIAL,40200,0,40200,137300,0,177500
200212801000000,SW 453,RESIDENTIAL,41500,0,41500,143500,0,185000
200212801100000,SW 453,RESIDENTIAL,41500,0,41500,142100,0,183600
200212801200000,SW 453,RESIDENTIAL,41300,0,41300,137600,0,178900
200212801300000,SW 453,RESIDENTIAL,42100,0,42100,147000,0,189100
200212801400000,SW 453,RESIDENTIAL,41800,0,41800,145100,0,186900
200212801500000,SW 453,RESIDENTIAL,42200,0,42200,139700,0,181900
200212801600000,SW 453,RESIDENTIAL,42200,0,42200,155000,0,197200
200212801700000,SW 453,RESIDENTIAL,43300,0,43300,152600,0,195900
200212801800000,SW 453,RESIDENTIAL,42700,0,42700,141500,0,184200
200212900100000,SW 459,RESIDENTIAL,44200,0,44200,145300,0,189500
200212900200000,SW 459,RESIDENTIAL,20100,0,20100,145900,0,166000
200212900300000,SW 459,RESIDENTIAL,20100,0,20100,7800,0,27900
200212900400000,SW 459,RESIDENTIAL,20400,0,20400,7800,0,28200
200212900500000,SW 459,RESIDENTIAL,20400,0,20400,136300,0,156700
200212900600000,SW 459,RESIDENTIAL,20600,0,20600,136300,0,156900
200212900700000,SW 459,RESIDENTIAL,20600,0,20600,136300,0,156900
200212900800000,SW 459,RESIDENTIAL,20800,0,20800,136300,0,157100
200212900900000,SW 459,RESIDENTIAL,20800,0,20800,143300,0,164100
200212901000000,SW 459,RESIDENTIAL,20800,0,20800,143300,0,164100
200212901100000,SW 459,RESIDENTIAL,21000,0,21000,144100,0,165100
200212901200000,SW 459,RESIDENTIAL,21000,0,21000,144100,0,165100
200212901300000,SW 459,RESIDENTIAL,21200,0,21200,143500,0,164700
200212901400000,SW 459,RESIDENTIAL,21200,0,21200,144200,0,165400
200212901500000,SW 459,RESIDENTIAL,21400,0,21400,141800,0,163200
200212901600000,SW 459,RESIDENTIAL,21400,0,21400,141800,0,163200
200212901700000,SW 459,RESIDENTIAL,21400,0,21400,141800,0,163200
200212901800000,SW 459,RESIDENTIAL,21600,0,21600,141800,0,163400
200212901900000,SW 459,RESIDENTIAL,21600,0,21600,138700,0,160300
200212902000000,SW 459,RESIDENTIAL,21800,0,21800,138700,0,160500
200212902100000,SW 459,RESIDENTIAL,21800,0,21800,133400,0,155200
200212902200000,SW 459,RESIDENTIAL,21800,0,21800,133400,0,155200
200212902300000,CITY PROPERTY,EXEMPT,0,0,0,0,0,0
200215100100000,SW 432,AG LAND,50000,0,50000,0,12300,62300
200220100100000,NW 329,AG LAND,56400,0,56400,0,0,56400
200222600100000,SW 453,AG LAND,10800,0,10800,0,0,10800
200222600200000,SW 453,RESIDENTIAL,1300,0,1300,0,0,1300
200225100200000,SW 432,RESIDENTIAL,62200,0,62200,117400,0,179600
200225100300000,SW 432,RESIDENTIAL,66000,0,66000,136300,0,202300
200225100400000,SW 432,RESIDENTIAL,72400,0,72400,114600,0,187000
200225100700000,SW 432,RESIDENTIAL,2013,0,2013,0,0,2013
200227600400000,CONVENIENCE STORE,COMMERCIAL,0,525000,525000,0,911100,1436100
200227600500000,VACANT LAND,COMMERCIAL,0,852300,852300,0,0,852300
200227800100000,SW 432,AG DWELLING,4500,0,4500,192200,15100,211800
200230200100000,SW 432,RESIDENTIAL,55800,0,55800,80600,0,136400
200232800200000,SW 432,RESIDENTIAL,38800,0,38800,168600,0,207400
200232800300000,SW 432,RESIDENTIAL,39400,0,39400,182200,0,221600
200232800400000,SW 432,RESIDENTIAL,36900,0,36900,195200,0,232100
200232800500000,SW 432,RESIDENTIAL,32400,0,32400,180700,0,213100
200232800600000,SW 432,RESIDENTIAL,31800,0,31800,183500,0,215300
200232800700000,SW 432,RESIDENTIAL,33200,0,33200,183300,0,216500
200232800800000,SW 432,RESIDENTIAL,35600,0,35600,185500,0,221100
200232800900000,SW 432,RESIDENTIAL,44600,0,44600,176800,0,221400
200232801000000,SW 432,RESIDENTIAL,42400,0,42400,229000,0,271400
200232801100000,SW 432,RESIDENTIAL,35000,0,35000,169400,0,204400
200232801200000,SW 432,RESIDENTIAL,35000,0,35000,173700,0,208700
200232801300000,SW 432,RESIDENTIAL,31200,0,31200,162100,0,193300
200232801400000,SW 432,RESIDENTIAL,36000,0,36000,167000,0,203000
200232801500000,SW 432,RESIDENTIAL,41000,0,41000,205900,0,246900
200232801600000,SW 432,RESIDENTIAL,51600,0,51600,206500,0,258100
200232801700000,SW 432,RESIDENTIAL,41400,0,41400,187500,0,228900
200232801800000,SW 432,RESIDENTIAL,35800,0,35800,184700,0,220500
200232801900000,SW 432,RESIDENTIAL,35800,0,35800,213700,0,249500
200232802000000,SW 432,RESIDENTIAL,35800,0,35800,174600,0,210400
200232802100000,SW 432,RESIDENTIAL,44600,0,44600,193800,0,238400
200232802200000,SW 432,RESIDENTIAL,40981,0,40981,183793,0,224774
200232802300000,SW 432,RESIDENTIAL,43000,0,43000,187200,0,230200
200232802400000,SW 432,RESIDENTIAL,42200,0,42200,188200,0,230400
200232802500000,SW 432,RESIDENTIAL,4100,0,4100,0,0,4100
200232802600000,SW 432,RESIDENTIAL,5300,0,5300,0,0,5300
200232900100000,SW 432,RESIDENTIAL,35000,0,35000,170700,0,205700
200232900200000,SW 432,RESIDENTIAL,43600,0,43600,199700,0,243300
200232900300000,SW 432,RESIDENTIAL,33600,0,33600,202100,0,235700
200232900400000,SW 432,RESIDENTIAL,31200,0,31200,148800,0,180000
200232900500000,SW 432,RESIDENTIAL,32000,0,32000,146400,0,178400
200232900600000,SW 432,RESIDENTIAL,30700,0,30700,181300,0,212000
200232900700000,SW 432,RESIDENTIAL,33800,0,33800,194000,0,227800
200232900800000,SW 432,RESIDENTIAL,40400,0,40400,258400,0,298800
200232900900000,SW 432,RESIDENTIAL,34300,0,34300,163600,0,197900
200240100200000,SW 460,AG LAND,73500,0,73500,0,0,73500
200245100600000,SW 460,AG DWELLING,3900,0,3900,92200,2900,99000
200247600100000,SW 460,RESIDENTIAL,38000,0,38000,175000,0,213000
200247600200000,SW 460,RESIDENTIAL,38200,0,38200,122500,0,160700
200247600300000,SW 460,RESIDENTIAL,38200,0,38200,99900,0,138100
200247600400000,SW 460,RESIDENTIAL,38200,0,38200,118100,0,156300
200247600500000,SW 460,RESIDENTIAL,38200,0,38200,146700,0,184900
200247600600000,SW 460,RESIDENTIAL,38200,0,38200,96700,0,134900
200247600700000,SW 460,RESIDENTIAL,46500,0,46500,138600,0,185100
200247600800000,SW 460,RESIDENTIAL,39800,0,39800,131100,0,170900
200247600900000,SW 460,RESIDENTIAL,34500,0,34500,95500,0,130000
200247601000000,SW 460,RESIDENTIAL,78300,0,78300,6800,0,85100
200247601100000,SW 460,RESIDENTIAL,46100,0,46100,143100,0,189200
200247601300000,SW 460,AG LAND,13200,0,13200,0,0,13200
200247601400000,SW 460,AG LAND,42100,0,42100,0,0,42100
200247601500000,SW 460,RESIDENTIAL,82000,0,82000,180300,0,262300
200310100200000,SW 432,RESIDENTIAL,36100,0,36100,266300,0,302400
200310100300000,SW 432,RESIDENTIAL,36400,0,36400,193700,0,230100
200310100400000,SW 432,RESIDENTIAL,36500,0,36500,215100,0,251600
200310100500000,SW 432,RESIDENTIAL,33500,0,33500,186800,0,220300
200310100600000,SW 432,RESIDENTIAL,34900,0,34900,165800,0,200700
200310100700000,SW 432,RESIDENTIAL,34700,0,34700,195100,0,229800
200310100800000,SW 432,RESIDENTIAL,35800,0,35800,217200,0,253000
200310100900000,SW 432,RESIDENTIAL,39100,0,39100,202700,0,241800
200310101000000,SW 432,RESIDENTIAL,27800,0,27800,0,0,27800
200310101100000,SW 432,RESIDENTIAL,36400,0,36400,161500,0,197900
200310101200000,SW 432,RESIDENTIAL,35000,0,35000,214600,0,249600
200310101300000,SW 432,RESIDENTIAL,34700,0,34700,184600,0,219300
200310101400000,SW 432,RESIDENTIAL,38200,0,38200,181700,0,219900
200310101500000,SW 432,RESIDENTIAL,39600,0,39600,140300,0,179900
200310101600000,SW 432,RESIDENTIAL,38800,0,38800,144900,0,183700
200310101700000,SW 432,RESIDENTIAL,37800,0,37800,140300,0,178100
200310101800000,SW 432,RESIDENTIAL,37800,0,37800,148700,0,186500
200310101900000,SW 432,RESIDENTIAL,30800,0,30800,0,0,30800
200310102000000,SW 432,RESIDENTIAL,29900,0,29900,0,0,29900
200310102100000,SW 432,RESIDENTIAL,30000,0,30000,0,0,30000
200310102200000,SW 432,RESIDENTIAL,2000,0,2000,0,0,2000
200310200100000,SW 432,RESIDENTIAL,31500,0,31500,178300,0,209800
200310200200000,SW 432,RESIDENTIAL,33500,0,33500,199000,0,232500
200310300200000,SW 432,RESIDENTIAL,37800,0,37800,170800,0,208600
200310300300000,SW 432,RESIDENTIAL,34500,0,34500,207500,0,242000
200310300400000,SW 432,RESIDENTIAL,34400,0,34400,196100,0,230500
200310300500000,SW 432,RESIDENTIAL,37200,0,37200,193200,0,230400
200310300600000,SW 432,RESIDENTIAL,35700,0,35700,160100,0,195800
200310300700000,SW 432,RESIDENTIAL,31300,0,31300,149100,0,180400
200310300800000,SW 432,RESIDENTIAL,31500,0,31500,175600,0,207100
200310400100000,SW 432,RESIDENTIAL,34800,0,34800,156200,0,191000
200310400200000,SW 432,RESIDENTIAL,34000,0,34000,132100,0,166100
200310400300000,SW 432,RESIDENTIAL,31500,0,31500,129200,0,160700
200310400400000,SW 432,RESIDENTIAL,31500,0,31500,158100,0,189600
200310500100000,SW 432,RESIDENTIAL,35200,0,35200,143100,0,178300
200310500200000,SW 432,RESIDENTIAL,36200,0,36200,222500,0,258700
200310500300000,SW 432,RESIDENTIAL,37100,0,37100,189900,0,227000
200310500400000,SW 432,RESIDENTIAL,36800,0,36800,159500,0,196300
200310500500000,SW 432,RESIDENTIAL,35400,0,35400,210000,0,245400
200310500600000,SW 432,RESIDENTIAL,59200,0,59200,235600,0,294800
200310500700000,SW 432,RESIDENTIAL,37200,0,37200,186300,0,223500
200310500800000,SW 432,RESIDENTIAL,39800,0,39800,185800,0,225600
200310500900000,SW 432,RESIDENTIAL,28700,0,28700,0,0,28700
200310501000000,SW 432,RESIDENTIAL,39800,0,39800,249400,0,289200
200310501100000,SW 432,RESIDENTIAL,36900,0,36900,210200,0,247100
200310501200000,SW 432,RESIDENTIAL,38000,0,38000,203900,0,241900
200310501300000,SW 432,RESIDENTIAL,40200,0,40200,210900,0,251100
200310501400000,SW 432,RESIDENTIAL,40700,0,40700,239500,0,280200
200310501500000,SW 432,RESIDENTIAL,29200,0,29200,0,0,29200
200310501600000,SW 432,RESIDENTIAL,48500,0,48500,217400,0,265900
200310501700000,SW 432,RESIDENTIAL,37600,0,37600,246000,0,283600
200310501800000,SW 432,RESIDENTIAL,32300,0,32300,205800,0,238100
200310501900000,SW 432,RESIDENTIAL,28600,0,28600,0,0,28600
200310502000000,SW 432,RESIDENTIAL,39500,0,39500,235100,0,274600
200310502100000,SW 432,RESIDENTIAL,37600,0,37600,0,0,37600
200310502200000,SW 432,RESIDENTIAL,38700,0,38700,245700,0,284400
200310502300000,SW 432,RESIDENTIAL,30800,0,30800,0,0,30800
200310502400000,SW 432,RESIDENTIAL,34700,0,34700,187200,0,221900
200310502500000,SW 432,RESIDENTIAL,40400,0,40400,267200,0,307600
200310502600000,SW 432,RESIDENTIAL,28300,0,28300,0,0,28300
200310502700000,SW 432,RESIDENTIAL,38800,0,38800,182600,0,221400
200310502800000,SW 432,RESIDENTIAL,37000,0,37000,249500,0,286500
200310502900000,SW 432,RESIDENTIAL,38200,0,38200,187500,0,225700
200310503000000,SW 432,RESIDENTIAL,38200,0,38200,259000,0,297200
200310503100000,SW 432,RESIDENTIAL,37800,0,37800,193900,0,231700
200310503200000,SW 432,RESIDENTIAL,36800,0,36800,276300,0,313100
200310503300000,SW 432,RESIDENTIAL,37900,0,37900,190700,0,228600
200310503400000,STATE PROPERTY,OTHER,0,0,0,0,0,0
200317600200000,SW 432,RESIDENTIAL,36400,0,36400,207500,0,243900
200317600300000,SW 432,RESIDENTIAL,42100,0,42100,249300,0,291400
200317600400000,SW 432,RESIDENTIAL,37200,0,37200,224600,0,261800
200317600500000,SW 432,RESIDENTIAL,28000,0,28000,0,0,28000
200317600600000,SW 432,RESIDENTIAL,36200,0,36200,199200,0,235400
200317600700000,SW 432,RESIDENTIAL,35400,0,35400,207900,0,243300
200317600800000,SW 432,RESIDENTIAL,35000,0,35000,203500,0,238500
200317600900000,SW 432,RESIDENTIAL,37300,0,37300,169800,0,207100
200317601100000,SW 432,RESIDENTIAL,32300,0,32300,162700,0,195000
200317601200000,SW 432,RESIDENTIAL,32300,0,32300,136400,0,168700
200317601300000,SW 432,RESIDENTIAL,32200,0,32200,166300,0,198500
200317601400000,SW 432,RESIDENTIAL,34300,0,34300,156600,0,190900
200317601500000,SW 432,RESIDENTIAL,31200,0,31200,152900,0,184100
200317601600000,SW 432,RESIDENTIAL,39100,0,39100,184400,0,223500
200317601700000,SW 432,RESIDENTIAL,35200,0,35200,174500,0,209700
200317601800000,SW 432,RESIDENTIAL,33600,0,33600,128900,0,162500
200317601900000,SW 432,RESIDENTIAL,32900,0,32900,133900,0,166800
200317602000000,SW 432,RESIDENTIAL,31800,0,31800,130100,0,161900
200317602100000,SW 432,RESIDENTIAL,31800,0,31800,131700,0,163500
200317602200000,SW 432,RESIDENTIAL,31800,0,31800,133400,0,165200
200317602300000,SW 432,RESIDENTIAL,31800,0,31800,130100,0,161900
200317602500000,SW 432,RESIDENTIAL,31800,0,31800,129900,0,161700
200317602600000,SW 432,RESIDENTIAL,31800,0,31800,135700,0,167500
200317602700000,SW 432,RESIDENTIAL,35200,0,35200,195900,0,231100
200317602800000,SW 432,RESIDENTIAL,36400,0,36400,152400,0,188800
200317602900000,SW 432,RESIDENTIAL,35900,0,35900,168400,0,204300
200317603000000,SW 432,RESIDENTIAL,35700,0,35700,146400,0,182100
200317603100000,SW 432,RESIDENTIAL,36000,0,36000,167800,0,203800
200317603200000,SW 432,RESIDENTIAL,35500,0,35500,184300,0,219800
200317603300000,SW 432,RESIDENTIAL,34800,0,34800,166000,0,200800
200317603400000,SW 432,RESIDENTIAL,49000,0,49000,234800,0,283800
200317700100000,SW 432,RESIDENTIAL,34000,0,34000,153300,0,187300
200317700200000,SW 432,RESIDENTIAL,31500,0,31500,156100,0,187600
200317700300000,SW 432,RESIDENTIAL,31500,0,31500,147800,0,179300
200317700400000,SW 432,RESIDENTIAL,34000,0,34000,142500,0,176500
200317700500000,SW 432,RESIDENTIAL,31500,0,31500,136000,0,167500
200317700600000,SW 432,RESIDENTIAL,31500,0,31500,140000,0,171500
200317700700000,SW 432,RESIDENTIAL,34000,0,34000,162900,0,196900
200317700800000,SW 432,RESIDENTIAL,31500,0,31500,139600,0,171100
200317700900000,SW 432,RESIDENTIAL,31500,0,31500,126400,0,157900
200317701000000,SW 432,RESIDENTIAL,34000,0,34000,155700,0,189700
200317701100000,SW 432,RESIDENTIAL,31500,0,31500,137300,0,168800
200317701200000,SW 432,RESIDENTIAL,31500,0,31500,143800,0,175300
200317701300000,SW 432,RESIDENTIAL,34000,0,34000,110600,0,144600
200317701400000,SW 432,RESIDENTIAL,31500,0,31500,139600,0,171100
200317701500000,SW 432,RESIDENTIAL,31500,0,31500,143500,0,175000
200317701600000,SW 432,RESIDENTIAL,34400,0,34400,156400,0,190800
200317800100000,SW 432,RESIDENTIAL,35300,0,35300,133100,0,168400
200317800200000,SW 432,RESIDENTIAL,33700,0,33700,155500,0,189200
200317800300000,SW 432,RESIDENTIAL,33400,0,33400,136800,0,170200
200317800400000,SW 432,RESIDENTIAL,34900,0,34900,143500,0,178400
200317800500000,SW 432,RESIDENTIAL,32300,0,32300,184400,0,216700
200317800600000,SW 432,RESIDENTIAL,35600,0,35600,127800,0,163400
200317800700000,SW 432,RESIDENTIAL,32100,0,32100,132000,0,164100
200317800800000,SW 432,RESIDENTIAL,32100,0,32100,116400,0,148500
200317800900000,SW 432,RESIDENTIAL,32100,0,32100,135900,0,168000
200317801000000,SW 432,RESIDENTIAL,32100,0,32100,119400,0,151500
200317801100000,SW 432,RESIDENTIAL,32900,0,32900,140300,0,173200
200317801200000,SW 432,RESIDENTIAL,33000,0,33000,151700,0,184700
200317801300000,SW 432,RESIDENTIAL,35800,0,35800,130100,0,165900
200317801400000,SW 432,RESIDENTIAL,36500,0,36500,177300,0,213800
200317801500000,SW 432,RESIDENTIAL,33000,0,33000,167600,0,200600
200317801600000,SW 432,RESIDENTIAL,32100,0,32100,160000,0,192100
200317801700000,SW 432,RESIDENTIAL,32100,0,32100,142300,0,174400
200317900100000,SW 432,RESIDENTIAL,35200,0,35200,147500,0,182700
200317900200000,SW 432,RESIDENTIAL,31800,0,31800,126800,0,158600
200317900300000,SW 432,RESIDENTIAL,31800,0,31800,145200,0,177000
200317900400000,SW 432,RESIDENTIAL,31800,0,31800,129400,0,161200
200317900500000,SW 432,RESIDENTIAL,31800,0,31800,143200,0,175000
200317900600000,SW 432,RESIDENTIAL,31800,0,31800,132300,0,164100
200317900700000,SW 432,RESIDENTIAL,31800,0,31800,157500,0,189300
200317900800000,SW 432,RESIDENTIAL,31800,0,31800,143200,0,175000
200317900900000,SW 432,RESIDENTIAL,31800,0,31800,135900,0,167700
200317901000000,SW 432,RESIDENTIAL,31800,0,31800,129400,0,161200
200317901100000,SW 432,RESIDENTIAL,33400,0,33400,162100,0,195500
200317901200000,SW 432,RESIDENTIAL,33400,0,33400,144000,0,177400
200317901300000,SW 432,RESIDENTIAL,33800,0,33800,136300,0,170100
200317901400000,SW 432,RESIDENTIAL,34100,0,34100,147600,0,181700
200317901500000,SW 432,RESIDENTIAL,33700,0,33700,198800,0,232500
200317901600000,SW 432,RESIDENTIAL,31500,0,31500,135600,0,167100
200317901700000,SW 432,RESIDENTIAL,32400,0,32400,127700,0,160100
200317901800000,SW 432,RESIDENTIAL,32100,0,32100,137100,0,169200
200317901900000,SW 432,RESIDENTIAL,32100,0,32100,155800,0,187900
200317902000000,SW 432,RESIDENTIAL,32100,0,32100,157200,0,189300
200317902100000,SW 432,RESIDENTIAL,32100,0,32100,192700,0,224800
200317902200000,SW 432,RESIDENTIAL,32100,0,32100,163000,0,195100
200317902300000,SW 432,RESIDENTIAL,35900,0,35900,168400,0,204300
200318000100000,SW 432,RESIDENTIAL,49300,0,49300,153500,0,202800
200318000200000,SW 432,RESIDENTIAL,35700,0,35700,150100,0,185800
200318000300000,SW 432,RESIDENTIAL,35700,0,35700,132800,0,168500
200318000400000,SW 432,RESIDENTIAL,35700,0,35700,108800,0,144500
200318000500000,SW 432,RESIDENTIAL,35700,0,35700,125700,0,161400
200318000600000,SW 432,RESIDENTIAL,35700,0,35700,135000,0,170700
200318000700000,SW 432,RESIDENTIAL,35700,0,35700,123400,0,159100
200318000800000,SW 432,RESIDENTIAL,36100,0,36100,142100,0,178200
200318100100000,SW 432,RESIDENTIAL,35100,0,35100,137100,0,172200
200318100200000,SW 432,RESIDENTIAL,31900,0,31900,171500,0,203400
200318100300000,SW 432,RESIDENTIAL,31900,0,31900,134300,0,166200
200318100400000,SW 432,RESIDENTIAL,31900,0,31900,156100,0,188000
200318100500000,SW 432,RESIDENTIAL,31900,0,31900,135600,0,167500
200318100600000,SW 432,RESIDENTIAL,31900,0,31900,146500,0,178400
200318100700000,SW 432,RESIDENTIAL,31900,0,31900,136600,0,168500
200318100800000,SW 432,RESIDENTIAL,33700,0,33700,164400,0,198100
200340100200000,SW 432,RESIDENTIAL,38100,0,38100,168600,0,206700
200340100300000,SW 432,RESIDENTIAL,30600,0,30600,161900,0,192500
200340100400000,SW 432,RESIDENTIAL,30600,0,30600,162100,0,192700
200340100500000,SW 432,RESIDENTIAL,30600,0,30600,157500,0,188100
200340100600000,SW 432,RESIDENTIAL,30600,0,30600,131000,0,161600
200340100700000,SW 432,RESIDENTIAL,30600,0,30600,182700,0,213300
200340100800000,SW 432,RESIDENTIAL,30600,0,30600,147500,0,178100
200340100900000,SW 432,RESIDENTIAL,30600,0,30600,181600,0,212200
200340101000000,SW 432,RESIDENTIAL,30600,0,30600,153400,0,184000
200340101100000,SW 432,RESIDENTIAL,30600,0,30600,164300,0,194900
200340101300000,SW 432,RESIDENTIAL,0,0,0,0,0,0
200340101500000,SW 432,RESIDENTIAL,6300,0,6300,0,0,6300
200340101600000,SW 432,RESIDENTIAL,19100,0,19100,1700,0,20800
200340102500000,SW 432,RESIDENTIAL,58300,0,58300,968800,0,1027100
200342600400000,SW 432,RESIDENTIAL,0,0,0,0,0,0
200342600500000,SW 432,RESIDENTIAL,0,0,0,0,0,0
201110100100000,SW 460,AG LAND,100900,0,100900,0,0,100900
201112600300000,SW 460,AG LAND,124400,0,124400,0,0,124400
201212600100000,FOOD GRADE;INDUST,INDUSTRIAL,0,2395200,2395200,0,16604800,19000000
201232600500000,SW 418,AG LAND,88500,0,88500,0,0,88500
201237700100000,SW 418,AG LAND,3900,0,3900,0,0,3900
201240100100000,SW 418,AG LAND,32800,0,32800,0,0,32800
201240100200000,CENTRALLY ASSESSED,OTHER,0,0,0,0,0,0
201245100100000,SW 418,AG LAND,65500,0,65500,0,0,65500
201247600100000,SW 418,AG LAND,109000,0,109000,0,0,109000
202410100100000,CITY PROPERTY,EXEMPT,0,0,0,0,0,0
202525100100000,CITY PROPERTY,EXEMPT,0,0,0,0,0,0
202610100100000,CITY PROPERTY,EXEMPT,0,0,0,0,0,0
202612600100000,CITY PROPERTY,EXEMPT,0,0,0,0,0,0
